PokerStars Hand #151941592328:  Hold'em No Limit ($1/$2 USD) - 2016/04/15 12:50:47 CET [2016/04/15 6:50:47 ET]
Table 'Patroclus II' 9-max Seat #8 is the button
Seat 1: TonnaMunz ($211.46 in chips) 
Seat 2: rmanjkeee ($83.05 in chips) 
Seat 3: Koolniknik ($161.67 in chips) 
Seat 4: tipner ($200 in chips) 
Seat 5: butcheN18 ($200 in chips) 
Seat 7: matiko09 ($202 in chips) 
Seat 8: Glushchenko ($200 in chips) 
Seat 9: Fish4trips ($206.35 in chips) 
Fish4trips: posts small blind $1
TonnaMunz: posts big blind $2
*** HOLE CARDS ***
Dealt to matiko09 [7c 8h]
rmanjkeee: raises $3 to $5
Koolniknik: folds 
tipner: folds 
butcheN18: calls $5
matiko09: folds 
Glushchenko: folds 
Fish4trips: folds 
TonnaMunz: folds 
*** FLOP *** [Tc Qs Qc]
rmanjkeee: bets $8
butcheN18: folds 
Uncalled bet ($8) returned to rmanjkeee
rmanjkeee collected $12.35 from pot
rmanjkeee: doesn't show hand 
*** SUMMARY ***
Total pot $13 | Rake $0.65 
Board [Tc Qs Qc]
Seat 1: TonnaMunz (big blind) folded before Flop
Seat 2: rmanjkeee collected ($12.35)
Seat 3: Koolniknik folded before Flop (didn't bet)
Seat 4: tipner folded before Flop (didn't bet)
Seat 5: butcheN18 folded on the Flop
Seat 7: matiko09 folded before Flop (didn't bet)
Seat 8: Glushchenko (button) folded before Flop (didn't bet)
Seat 9: Fish4trips (small blind) folded before Flop





PokerStars Hand #151941599836:  Hold'em No Limit (€0.25/€0.50 EUR) - 2016/04/15 12:51:04 CET [2016/04/15 6:51:04 ET]
Table 'Anius III' 9-max Seat #9 is the button
Seat 2: tibi_c87 (€50 in chips) 
Seat 3: Effort92 (€111.29 in chips) 
Seat 6: Muinmyheart (€54.60 in chips) 
Seat 7: matiko09 (€50 in chips) 
Seat 9: ASG2016 (€54.22 in chips) 
tibi_c87: posts small blind €0.25
Effort92: posts big blind €0.50
*** HOLE CARDS ***
Dealt to matiko09 [Kh 4d]
Muinmyheart: folds 
matiko09: folds 
ASG2016: raises €0.75 to €1.25
tibi_c87: raises €3.25 to €4.50
Effort92: folds 
ASG2016: folds 
Uncalled bet (€3.25) returned to tibi_c87
tibi_c87 collected €3 from pot
*** SUMMARY ***
Total pot €3 | Rake €0 
Seat 2: tibi_c87 (small blind) collected (€3)
Seat 3: Effort92 (big blind) folded before Flop
Seat 6: Muinmyheart folded before Flop (didn't bet)
Seat 7: matiko09 folded before Flop (didn't bet)
Seat 9: ASG2016 (button) folded before Flop





PokerStars Hand #151941604717:  Hold'em No Limit ($0.50/$1.00 USD) - 2016/04/15 12:51:15 CET [2016/04/15 6:51:15 ET]
Table 'Lamberta III' 9-max Seat #1 is the button
Seat 1: di0d80 ($100 in chips) 
Seat 2: Vermm ($82.32 in chips) 
Seat 3: butcheN18 ($110.59 in chips) 
Seat 4: spunkbubble9 ($40 in chips) 
Seat 5: tipner ($100 in chips) 
Seat 6: aseban11 ($101.50 in chips) 
Seat 8: djammusic ($39 in chips) 
Seat 9: matiko09 ($100 in chips) 
Vermm: posts small blind $0.50
butcheN18: posts big blind $1
spunkbubble9: posts big blind $1
ardo888: sits out 
*** HOLE CARDS ***
Dealt to matiko09 [4s 5s]
spunkbubble9: checks 
tipner: folds 
aseban11: folds 
djammusic: folds 
matiko09: folds 
di0d80: folds 
Vermm: raises $2 to $3
butcheN18: folds 
spunkbubble9: folds 
Uncalled bet ($2) returned to Vermm
Vermm collected $3 from pot
Vermm: doesn't show hand 
*** SUMMARY ***
Total pot $3 | Rake $0 
Seat 1: di0d80 (button) folded before Flop (didn't bet)
Seat 2: Vermm (small blind) collected ($3)
Seat 3: butcheN18 (big blind) folded before Flop
Seat 4: spunkbubble9 folded before Flop
Seat 5: tipner folded before Flop (didn't bet)
Seat 6: aseban11 folded before Flop (didn't bet)
Seat 8: djammusic folded before Flop (didn't bet)
Seat 9: matiko09 folded before Flop (didn't bet)





PokerStars Hand #151941606630:  Hold'em No Limit ($1/$2 USD) - 2016/04/15 12:51:20 CET [2016/04/15 6:51:20 ET]
Table 'Adele II' 9-max Seat #5 is the button
Seat 1: coinflip_si ($203 in chips) 
Seat 2: Fish4trips ($200 in chips) 
Seat 3: matiko09 ($399.67 in chips) 
Seat 4: Glushchenko ($200 in chips) 
Seat 5: T0ny Adams ($91.04 in chips) 
Seat 7: tipner ($200 in chips) 
TonnaMunz will be allowed to play after the button
tipner: posts small blind $1
coinflip_si: posts big blind $2
*** HOLE CARDS ***
Dealt to matiko09 [9h 3h]
Fish4trips: folds 
matiko09: folds 
Glushchenko: folds 
T0ny Adams: folds 
tipner: raises $4 to $6
coinflip_si: raises $14 to $20
tipner: calls $14
*** FLOP *** [6d 9c Qc]
tipner: checks 
docmarc777 joins the table at seat #8 
coinflip_si: bets $14.54
tipner: calls $14.54
*** TURN *** [6d 9c Qc] [4c]
tipner: checks 
coinflip_si: checks 
*** RIVER *** [6d 9c Qc 4c] [4s]
tipner: checks 
coinflip_si: checks 
*** SHOW DOWN ***
tipner: shows [Ac Ts] (a pair of Fours)
coinflip_si: shows [8c 6h] (two pair, Sixes and Fours)
coinflip_si collected $66.33 from pot
*** SUMMARY ***
Total pot $69.08 | Rake $2.75 
Board [6d 9c Qc 4c 4s]
Seat 1: coinflip_si (big blind) showed [8c 6h] and won ($66.33) with two pair, Sixes and Fours
Seat 2: Fish4trips folded before Flop (didn't bet)
Seat 3: matiko09 folded before Flop (didn't bet)
Seat 4: Glushchenko folded before Flop (didn't bet)
Seat 5: T0ny Adams (button) folded before Flop (didn't bet)
Seat 7: tipner (small blind) showed [Ac Ts] and lost with a pair of Fours





PokerStars Hand #151941610434:  Hold'em No Limit ($0.50/$1.00 USD) - 2016/04/15 12:51:28 CET [2016/04/15 6:51:28 ET]
Table 'Chiny II' 9-max Seat #4 is the button
Seat 1: CI58 ($140.34 in chips) 
Seat 2: AceFarky ($100 in chips) 
Seat 3: powerbel ($39 in chips) 
Seat 4: 1000karlos ($91.27 in chips) 
Seat 5: Yaaaazz ($124.78 in chips) 
Seat 6: choupai ($35.38 in chips) 
Seat 7: matiko09 ($101.50 in chips) 
Seat 8: djammusic ($40 in chips) 
Seat 9: ardo888 ($105.12 in chips) 
Yaaaazz: posts small blind $0.50
choupai: posts big blind $1
*** HOLE CARDS ***
Dealt to matiko09 [Jh 4s]
matiko09: folds 
djammusic: folds 
ardo888: raises $2 to $3
CI58: folds 
AceFarky: folds 
powerbel: folds 
1000karlos: folds 
Yaaaazz: folds 
choupai: folds 
Uncalled bet ($2) returned to ardo888
ardo888 collected $2.50 from pot
ardo888: doesn't show hand 
*** SUMMARY ***
Total pot $2.50 | Rake $0 
Seat 1: CI58 folded before Flop (didn't bet)
Seat 2: AceFarky folded before Flop (didn't bet)
Seat 3: powerbel folded before Flop (didn't bet)
Seat 4: 1000karlos (button) folded before Flop (didn't bet)
Seat 5: Yaaaazz (small blind) folded before Flop
Seat 6: choupai (big blind) folded before Flop
Seat 7: matiko09 folded before Flop (didn't bet)
Seat 8: djammusic folded before Flop (didn't bet)
Seat 9: ardo888 collected ($2.50)





PokerStars Hand #151941616851:  Hold'em No Limit ($1/$2 USD) - 2016/04/15 12:51:43 CET [2016/04/15 6:51:43 ET]
Table 'Patroclus II' 9-max Seat #9 is the button
Seat 1: TonnaMunz ($209.46 in chips) 
Seat 2: rmanjkeee ($90.40 in chips) 
Seat 3: Koolniknik ($161.67 in chips) 
Seat 4: tipner ($200 in chips) 
Seat 5: butcheN18 ($200 in chips) 
Seat 7: matiko09 ($202 in chips) 
Seat 8: Glushchenko ($200 in chips) 
Seat 9: Fish4trips ($205.35 in chips) 
TonnaMunz: posts small blind $1
rmanjkeee: posts big blind $2
*** HOLE CARDS ***
Dealt to matiko09 [Kd 5c]
Koolniknik: folds 
tipner: folds 
butcheN18: folds 
matiko09: folds 
Glushchenko: raises $3 to $5
Fish4trips: folds 
TonnaMunz: raises $12 to $17
rmanjkeee: folds 
Glushchenko: folds 
Uncalled bet ($12) returned to TonnaMunz
TonnaMunz collected $12 from pot
TonnaMunz: doesn't show hand 
*** SUMMARY ***
Total pot $12 | Rake $0 
Seat 1: TonnaMunz (small blind) collected ($12)
Seat 2: rmanjkeee (big blind) folded before Flop
Seat 3: Koolniknik folded before Flop (didn't bet)
Seat 4: tipner folded before Flop (didn't bet)
Seat 5: butcheN18 folded before Flop (didn't bet)
Seat 7: matiko09 folded before Flop (didn't bet)
Seat 8: Glushchenko folded before Flop
Seat 9: Fish4trips (button) folded before Flop (didn't bet)





PokerStars Hand #151941618754:  Hold'em No Limit ($0.50/$1.00 USD) - 2016/04/15 12:51:47 CET [2016/04/15 6:51:47 ET]
Table 'Lamberta III' 9-max Seat #2 is the button
Seat 1: di0d80 ($100 in chips) 
Seat 2: Vermm ($84.32 in chips) 
Seat 3: butcheN18 ($109.59 in chips) 
Seat 4: spunkbubble9 ($39 in chips) 
Seat 5: tipner ($100 in chips) 
Seat 6: aseban11 ($101.50 in chips) 
Seat 8: djammusic ($39 in chips) 
Seat 9: matiko09 ($100 in chips) 
butcheN18: posts small blind $0.50
spunkbubble9: posts big blind $1
ardo888: sits out 
*** HOLE CARDS ***
Dealt to matiko09 [8c 5s]
tipner: folds 
aseban11: folds 
djammusic: raises $1.15 to $2.15
matiko09: folds 
di0d80: folds 
Vermm: folds 
butcheN18: calls $1.65
spunkbubble9: folds 
*** FLOP *** [Tc 7c 9s]
butcheN18: checks 
djammusic: bets $3.28
butcheN18: folds 
Uncalled bet ($3.28) returned to djammusic
djammusic collected $5.04 from pot
djammusic: doesn't show hand 
*** SUMMARY ***
Total pot $5.30 | Rake $0.26 
Board [Tc 7c 9s]
Seat 1: di0d80 folded before Flop (didn't bet)
Seat 2: Vermm (button) folded before Flop (didn't bet)
Seat 3: butcheN18 (small blind) folded on the Flop
Seat 4: spunkbubble9 (big blind) folded before Flop
Seat 5: tipner folded before Flop (didn't bet)
Seat 6: aseban11 folded before Flop (didn't bet)
Seat 8: djammusic collected ($5.04)
Seat 9: matiko09 folded before Flop (didn't bet)





PokerStars Hand #151941620404:  Hold'em No Limit ($0.50/$1.00 USD) - 2016/04/15 12:51:51 CET [2016/04/15 6:51:51 ET]
Table 'Chiny II' 9-max Seat #5 is the button
Seat 1: CI58 ($140.34 in chips) 
Seat 2: AceFarky ($100 in chips) 
Seat 3: powerbel ($39 in chips) 
Seat 4: 1000karlos ($91.27 in chips) 
Seat 5: Yaaaazz ($124.28 in chips) 
Seat 6: choupai ($34.38 in chips) 
Seat 7: matiko09 ($101.50 in chips) 
Seat 8: djammusic ($40 in chips) 
Seat 9: ardo888 ($106.62 in chips) 
choupai: posts small blind $0.50
matiko09: posts big blind $1
*** HOLE CARDS ***
Dealt to matiko09 [6d 8d]
djammusic: folds 
ardo888: folds 
CI58: calls $1
AceFarky: folds 
powerbel: folds 
1000karlos: calls $1
Yaaaazz: folds 
choupai: calls $0.50
matiko09: raises $7 to $8
CI58: calls $7
1000karlos: folds 
choupai: folds 
*** FLOP *** [6h 5h As]
matiko09: bets $10
CI58: folds 
Uncalled bet ($10) returned to matiko09
matiko09 collected $17.10 from pot
matiko09: doesn't show hand 
*** SUMMARY ***
Total pot $18 | Rake $0.90 
Board [6h 5h As]
Seat 1: CI58 folded on the Flop
Seat 2: AceFarky folded before Flop (didn't bet)
Seat 3: powerbel folded before Flop (didn't bet)
Seat 4: 1000karlos folded before Flop
Seat 5: Yaaaazz (button) folded before Flop (didn't bet)
Seat 6: choupai (small blind) folded before Flop
Seat 7: matiko09 (big blind) collected ($17.10)
Seat 8: djammusic folded before Flop (didn't bet)
Seat 9: ardo888 folded before Flop (didn't bet)





PokerStars Hand #151941629995:  Hold'em No Limit ($1/$2 USD) - 2016/04/15 12:52:12 CET [2016/04/15 6:52:12 ET]
Table 'Patroclus II' 9-max Seat #1 is the button
Seat 1: TonnaMunz ($216.46 in chips) 
Seat 2: rmanjkeee ($88.40 in chips) 
Seat 3: Koolniknik ($161.67 in chips) 
Seat 4: tipner ($200 in chips) 
Seat 5: butcheN18 ($200 in chips) 
Seat 7: matiko09 ($202 in chips) 
Seat 8: Glushchenko ($200 in chips) 
Seat 9: Fish4trips ($205.35 in chips) 
rmanjkeee: posts small blind $1
Koolniknik: posts big blind $2
*** HOLE CARDS ***
Dealt to matiko09 [5d Kd]
tipner: folds 
butcheN18: folds 
matiko09: folds 
Glushchenko: folds 
Fish4trips: folds 
TonnaMunz: raises $2.96 to $4.96
rmanjkeee: folds 
Koolniknik: folds 
Uncalled bet ($2.96) returned to TonnaMunz
TonnaMunz collected $5 from pot
TonnaMunz: doesn't show hand 
*** SUMMARY ***
Total pot $5 | Rake $0 
Seat 1: TonnaMunz (button) collected ($5)
Seat 2: rmanjkeee (small blind) folded before Flop
Seat 3: Koolniknik (big blind) folded before Flop
Seat 4: tipner folded before Flop (didn't bet)
Seat 5: butcheN18 folded before Flop (didn't bet)
Seat 7: matiko09 folded before Flop (didn't bet)
Seat 8: Glushchenko folded before Flop (didn't bet)
Seat 9: Fish4trips folded before Flop (didn't bet)





PokerStars Hand #151941631093:  Hold'em No Limit ($0.50/$1.00 USD) - 2016/04/15 12:52:15 CET [2016/04/15 6:52:15 ET]
Table 'Cheruskia II' 9-max Seat #1 is the button
Seat 1: flk.Dasas ($122.10 in chips) 
Seat 3: Glushchenko ($182.13 in chips) 
Seat 4: di0d80 ($100 in chips) 
Seat 5: matiko09 ($100 in chips) 
Seat 6: StarsAbove ($108 in chips) 
Seat 7: picka4u ($63 in chips) 
Seat 8: vitor adl ($184.94 in chips) 
Seat 9: vrnMike ($105.45 in chips) 
Glushchenko: posts small blind $0.50
di0d80: posts big blind $1
*** HOLE CARDS ***
Dealt to matiko09 [2h 7h]
matiko09: folds 
StarsAbove: folds 
picka4u: raises $1.25 to $2.25
vitor adl: folds 
vrnMike: calls $2.25
flk.Dasas: folds 
Glushchenko: folds 
vitor adl leaves the table
di0d80: folds 
*** FLOP *** [Td Ks 9s]
picka4u: bets $3
vrnMike: calls $3
*** TURN *** [Td Ks 9s] [6h]
picka4u: checks 
aseban11 leaves the table
vrnMike: bets $4.50
picka4u: calls $4.50
*** RIVER *** [Td Ks 9s 6h] [8d]
picka4u: checks 
vrnMike: checks 
*** SHOW DOWN ***
picka4u: shows [9c Jc] (a pair of Nines)
vrnMike: mucks hand 
picka4u collected $19.95 from pot
*** SUMMARY ***
Total pot $21 | Rake $1.05 
Board [Td Ks 9s 6h 8d]
Seat 1: flk.Dasas (button) folded before Flop (didn't bet)
Seat 3: Glushchenko (small blind) folded before Flop
Seat 4: di0d80 (big blind) folded before Flop
Seat 5: matiko09 folded before Flop (didn't bet)
Seat 6: StarsAbove folded before Flop (didn't bet)
Seat 7: picka4u showed [9c Jc] and won ($19.95) with a pair of Nines
Seat 8: vitor adl folded before Flop (didn't bet)
Seat 9: vrnMike mucked [Ac Qd]





PokerStars Hand #151941633725:  Hold'em No Limit ($0.50/$1.00 USD) - 2016/04/15 12:52:21 CET [2016/04/15 6:52:21 ET]
Table 'Matterania III' 9-max Seat #3 is the button
Seat 1: di0d80 ($102.70 in chips) 
Seat 2: aseban11 ($100 in chips) 
Seat 3: ardo888 ($120.27 in chips) 
Seat 5: Vermm ($92.80 in chips) 
Seat 6: matiko09 ($100 in chips) 
Seat 7: Yaaaazz ($110.36 in chips) 
Seat 8: haoyuan541 ($102.12 in chips) 
Seat 9: flk.Dasas ($103.90 in chips) 
Vermm: posts small blind $0.50
matiko09: posts big blind $1
di0d80: posts the ante $0.20
aseban11: posts the ante $0.20
ardo888: posts the ante $0.20
Vermm: posts the ante $0.20
matiko09: posts the ante $0.20
Yaaaazz: posts the ante $0.20
haoyuan541: posts the ante $0.20
flk.Dasas: posts the ante $0.20
*** HOLE CARDS ***
Dealt to matiko09 [Ah 8d]
Yaaaazz: folds 
haoyuan541: folds 
flk.Dasas: folds 
di0d80: folds 
aseban11: raises $2 to $3
ardo888: calls $3
Vermm: folds 
matiko09: folds 
*** FLOP *** [Tc 2c Qs]
aseban11: bets $6.48
ardo888: folds 
Uncalled bet ($6.48) returned to aseban11
aseban11 collected $8.64 from pot
aseban11: doesn't show hand 
*** SUMMARY ***
Total pot $9.10 | Rake $0.46 
Board [Tc 2c Qs]
Seat 1: di0d80 folded before Flop (didn't bet)
Seat 2: aseban11 collected ($8.64)
Seat 3: ardo888 (button) folded on the Flop
Seat 5: Vermm (small blind) folded before Flop
Seat 6: matiko09 (big blind) folded before Flop
Seat 7: Yaaaazz folded before Flop (didn't bet)
Seat 8: haoyuan541 folded before Flop (didn't bet)
Seat 9: flk.Dasas folded before Flop (didn't bet)





PokerStars Hand #151941634396:  Hold'em No Limit ($0.50/$1.00 USD) - 2016/04/15 12:52:22 CET [2016/04/15 6:52:22 ET]
Table 'Lamberta III' 9-max Seat #3 is the button
Seat 1: di0d80 ($100 in chips) 
Seat 2: Vermm ($84.32 in chips) 
Seat 3: butcheN18 ($107.44 in chips) 
Seat 4: spunkbubble9 ($38 in chips) 
Seat 5: tipner ($100 in chips) 
Seat 6: aseban11 ($101.50 in chips) 
Seat 8: djammusic ($41.89 in chips) 
Seat 9: matiko09 ($100 in chips) 
spunkbubble9: posts small blind $0.50
tipner: posts big blind $1
ardo888: sits out 
*** HOLE CARDS ***
Dealt to matiko09 [Ks Kc]
aseban11: folds 
djammusic: folds 
matiko09: raises $2 to $3
di0d80: folds 
Vermm: calls $3
butcheN18: folds 
spunkbubble9: calls $2.50
tipner: calls $2
*** FLOP *** [3d 5s 9h]
spunkbubble9: checks 
tipner: checks 
matiko09: bets $7
Vermm: folds 
spunkbubble9: calls $7
tipner: folds 
*** TURN *** [3d 5s 9h] [8s]
spunkbubble9: checks 
matiko09: bets $16
spunkbubble9: raises $12 to $28 and is all-in
matiko09: calls $12
*** RIVER *** [3d 5s 9h 8s] [Kd]
*** SHOW DOWN ***
spunkbubble9: shows [5c 5d] (three of a kind, Fives)
matiko09: shows [Ks Kc] (three of a kind, Kings)
matiko09 collected $79.50 from pot
*** SUMMARY ***
Total pot $82 | Rake $2.50 
Board [3d 5s 9h 8s Kd]
Seat 1: di0d80 folded before Flop (didn't bet)
Seat 2: Vermm folded on the Flop
Seat 3: butcheN18 (button) folded before Flop (didn't bet)
Seat 4: spunkbubble9 (small blind) showed [5c 5d] and lost with three of a kind, Fives
Seat 5: tipner (big blind) folded on the Flop
Seat 6: aseban11 folded before Flop (didn't bet)
Seat 8: djammusic folded before Flop (didn't bet)
Seat 9: matiko09 showed [Ks Kc] and won ($79.50) with three of a kind, Kings





PokerStars Hand #151941643100:  Hold'em No Limit ($0.50/$1.00 USD) - 2016/04/15 12:52:42 CET [2016/04/15 6:52:42 ET]
Table 'Chiny II' 9-max Seat #6 is the button
Seat 1: CI58 ($132.34 in chips) 
Seat 2: AceFarky ($100 in chips) 
Seat 3: powerbel ($39 in chips) 
Seat 4: 1000karlos ($90.27 in chips) 
Seat 5: Yaaaazz ($124.28 in chips) 
Seat 6: choupai ($33.38 in chips) 
Seat 7: matiko09 ($110.60 in chips) 
Seat 8: djammusic ($40 in chips) 
Seat 9: ardo888 ($106.62 in chips) 
matiko09: posts small blind $0.50
djammusic: posts big blind $1
*** HOLE CARDS ***
Dealt to matiko09 [6h 6d]
ardo888: raises $2 to $3
CI58: folds 
AceFarky: folds 
powerbel: folds 
1000karlos: folds 
Yaaaazz: folds 
choupai: folds 
matiko09: folds 
djammusic: folds 
Uncalled bet ($2) returned to ardo888
ardo888 collected $2.50 from pot
ardo888: doesn't show hand 
*** SUMMARY ***
Total pot $2.50 | Rake $0 
Seat 1: CI58 folded before Flop (didn't bet)
Seat 2: AceFarky folded before Flop (didn't bet)
Seat 3: powerbel folded before Flop (didn't bet)
Seat 4: 1000karlos folded before Flop (didn't bet)
Seat 5: Yaaaazz folded before Flop (didn't bet)
Seat 6: choupai (button) folded before Flop (didn't bet)
Seat 7: matiko09 (small blind) folded before Flop
Seat 8: djammusic (big blind) folded before Flop
Seat 9: ardo888 collected ($2.50)





PokerStars Hand #151941644358:  Hold'em No Limit ($1/$2 USD) - 2016/04/15 12:52:45 CET [2016/04/15 6:52:45 ET]
Table 'Adele II' 9-max Seat #7 is the button
Seat 1: coinflip_si ($234.79 in chips) 
Seat 2: Fish4trips ($200 in chips) 
Seat 3: matiko09 ($399.67 in chips) 
Seat 4: Glushchenko ($200 in chips) 
Seat 5: T0ny Adams ($91.04 in chips) 
Seat 7: tipner ($200 in chips) 
docmarc777 will be allowed to play after the button
RyanHuJun will be allowed to play after the button
coinflip_si: posts small blind $1
Fish4trips: posts big blind $2
TonnaMunz: sits out 
*** HOLE CARDS ***
Dealt to matiko09 [5d Kh]
matiko09: folds 
Glushchenko: folds 
T0ny Adams: raises $2.68 to $4.68
tipner: folds 
coinflip_si: folds 
Fish4trips: folds 
Uncalled bet ($2.68) returned to T0ny Adams
T0ny Adams collected $5 from pot
T0ny Adams: doesn't show hand 
*** SUMMARY ***
Total pot $5 | Rake $0 
Seat 1: coinflip_si (small blind) folded before Flop
Seat 2: Fish4trips (big blind) folded before Flop
Seat 3: matiko09 folded before Flop (didn't bet)
Seat 4: Glushchenko folded before Flop (didn't bet)
Seat 5: T0ny Adams collected ($5)
Seat 7: tipner (button) folded before Flop (didn't bet)





PokerStars Hand #151941644647:  Hold'em No Limit ($0.50/$1.00 USD) - 2016/04/15 12:52:45 CET [2016/04/15 6:52:45 ET]
Table 'Matterania III' 9-max Seat #5 is the button
Seat 1: di0d80 ($102.50 in chips) 
Seat 2: aseban11 ($105.44 in chips) 
Seat 3: ardo888 ($117.07 in chips) 
Seat 5: Vermm ($92.10 in chips) 
Seat 6: matiko09 ($100 in chips) 
Seat 7: Yaaaazz ($110.16 in chips) 
Seat 8: haoyuan541 ($101.92 in chips) 
Seat 9: flk.Dasas ($103.70 in chips) 
matiko09: posts small blind $0.50
Yaaaazz: posts big blind $1
di0d80: posts the ante $0.20
aseban11: posts the ante $0.20
ardo888: posts the ante $0.20
Vermm: posts the ante $0.20
matiko09: posts the ante $0.20
Yaaaazz: posts the ante $0.20
haoyuan541: posts the ante $0.20
flk.Dasas: posts the ante $0.20
*** HOLE CARDS ***
Dealt to matiko09 [2s Jh]
haoyuan541: folds 
flk.Dasas: folds 
di0d80: folds 
aseban11: folds 
ardo888: raises $2 to $3
Vermm: calls $3
matiko09: folds 
Yaaaazz: folds 
*** FLOP *** [As 7h 9s]
ardo888: bets $5
Vermm: folds 
Uncalled bet ($5) returned to ardo888
ardo888 collected $8.64 from pot
ardo888: doesn't show hand 
*** SUMMARY ***
Total pot $9.10 | Rake $0.46 
Board [As 7h 9s]
Seat 1: di0d80 folded before Flop (didn't bet)
Seat 2: aseban11 folded before Flop (didn't bet)
Seat 3: ardo888 collected ($8.64)
Seat 5: Vermm (button) folded on the Flop
Seat 6: matiko09 (small blind) folded before Flop
Seat 7: Yaaaazz (big blind) folded before Flop
Seat 8: haoyuan541 folded before Flop (didn't bet)
Seat 9: flk.Dasas folded before Flop (didn't bet)





PokerStars Hand #151941649409:  Hold'em No Limit ($1/$2 USD) - 2016/04/15 12:52:56 CET [2016/04/15 6:52:56 ET]
Table 'Patroclus II' 9-max Seat #2 is the button
Seat 1: TonnaMunz ($219.46 in chips) 
Seat 2: rmanjkeee ($87.40 in chips) 
Seat 3: Koolniknik ($159.67 in chips) 
Seat 4: tipner ($200 in chips) 
Seat 5: butcheN18 ($200 in chips) 
Seat 7: matiko09 ($202 in chips) 
Seat 8: Glushchenko ($200 in chips) 
Seat 9: Fish4trips ($205.35 in chips) 
Koolniknik: posts small blind $1
tipner: posts big blind $2
*** HOLE CARDS ***
Dealt to matiko09 [2h 6s]
butcheN18: folds 
matiko09: folds 
Glushchenko: folds 
Fish4trips: folds 
TonnaMunz: folds 
rmanjkeee: folds 
Koolniknik: raises $4 to $6
tipner: calls $4
*** FLOP *** [Kh 7c 3s]
Koolniknik: bets $5.70
tipner: calls $5.70
*** TURN *** [Kh 7c 3s] [Kc]
Koolniknik: bets $22.23
tipner: folds 
Uncalled bet ($22.23) returned to Koolniknik
Koolniknik collected $22.23 from pot
Koolniknik: doesn't show hand 
*** SUMMARY ***
Total pot $23.40 | Rake $1.17 
Board [Kh 7c 3s Kc]
Seat 1: TonnaMunz folded before Flop (didn't bet)
Seat 2: rmanjkeee (button) folded before Flop (didn't bet)
Seat 3: Koolniknik (small blind) collected ($22.23)
Seat 4: tipner (big blind) folded on the Turn
Seat 5: butcheN18 folded before Flop (didn't bet)
Seat 7: matiko09 folded before Flop (didn't bet)
Seat 8: Glushchenko folded before Flop (didn't bet)
Seat 9: Fish4trips folded before Flop (didn't bet)





PokerStars Hand #151941655011:  Hold'em No Limit ($0.50/$1.00 USD) - 2016/04/15 12:53:09 CET [2016/04/15 6:53:09 ET]
Table 'Cheruskia II' 9-max Seat #3 is the button
Seat 1: flk.Dasas ($122.10 in chips) 
Seat 3: Glushchenko ($181.63 in chips) 
Seat 4: di0d80 ($100 in chips) 
Seat 5: matiko09 ($100 in chips) 
Seat 6: StarsAbove ($108 in chips) 
Seat 7: picka4u ($73.20 in chips) 
Seat 9: vrnMike ($100 in chips) 
di0d80: posts small blind $0.50
matiko09: posts big blind $1
*** HOLE CARDS ***
Dealt to matiko09 [Kc 5h]
StarsAbove: folds 
picka4u: folds 
vrnMike: folds 
flk.Dasas: folds 
Glushchenko: folds 
di0d80: raises $2 to $3
matiko09: folds 
Uncalled bet ($2) returned to di0d80
di0d80 collected $2 from pot
di0d80: doesn't show hand 
*** SUMMARY ***
Total pot $2 | Rake $0 
Seat 1: flk.Dasas folded before Flop (didn't bet)
Seat 3: Glushchenko (button) folded before Flop (didn't bet)
Seat 4: di0d80 (small blind) collected ($2)
Seat 5: matiko09 (big blind) folded before Flop
Seat 6: StarsAbove folded before Flop (didn't bet)
Seat 7: picka4u folded before Flop (didn't bet)
Seat 9: vrnMike folded before Flop (didn't bet)





PokerStars Hand #151941655329:  Hold'em No Limit ($1/$2 USD) - 2016/04/15 12:53:09 CET [2016/04/15 6:53:09 ET]
Table 'Adele II' 9-max Seat #1 is the button
Seat 1: coinflip_si ($233.79 in chips) 
Seat 2: Fish4trips ($200 in chips) 
Seat 3: matiko09 ($399.67 in chips) 
Seat 4: Glushchenko ($200 in chips) 
Seat 5: T0ny Adams ($94.04 in chips) 
Seat 7: tipner ($200 in chips) 
Seat 9: RyanHuJun ($200 in chips) 
Fish4trips: posts small blind $1
matiko09: posts big blind $2
TonnaMunz: sits out 
docmarc777: sits out 
RyanHuJun: posts small & big blinds $3
*** HOLE CARDS ***
Dealt to matiko09 [Ts 3s]
Glushchenko: folds 
T0ny Adams: folds 
tipner: folds 
RyanHuJun: raises $4 to $6
coinflip_si: raises $10 to $16
Fish4trips: folds 
matiko09: folds 
RyanHuJun: calls $10
*** FLOP *** [Jh 6d 3d]
RyanHuJun: checks 
coinflip_si: bets $19.15
RyanHuJun: raises $23.15 to $42.30
coinflip_si: folds 
Uncalled bet ($23.15) returned to RyanHuJun
RyanHuJun collected $71.55 from pot
RyanHuJun: doesn't show hand 
*** SUMMARY ***
Total pot $74.30 | Rake $2.75 
Board [Jh 6d 3d]
Seat 1: coinflip_si (button) folded on the Flop
Seat 2: Fish4trips (small blind) folded before Flop
Seat 3: matiko09 (big blind) folded before Flop
Seat 4: Glushchenko folded before Flop (didn't bet)
Seat 5: T0ny Adams folded before Flop (didn't bet)
Seat 7: tipner folded before Flop (didn't bet)
Seat 9: RyanHuJun collected ($71.55)





PokerStars Hand #151941657437:  Hold'em No Limit ($0.50/$1.00 USD) - 2016/04/15 12:53:14 CET [2016/04/15 6:53:14 ET]
Table 'Chiny II' 9-max Seat #7 is the button
Seat 1: CI58 ($132.34 in chips) 
Seat 2: AceFarky ($100 in chips) 
Seat 3: powerbel ($39 in chips) 
Seat 4: 1000karlos ($90.27 in chips) 
Seat 5: Yaaaazz ($124.28 in chips) 
Seat 6: choupai ($33.38 in chips) 
Seat 7: matiko09 ($110.10 in chips) 
Seat 8: djammusic ($39 in chips) 
Seat 9: ardo888 ($108.12 in chips) 
djammusic: posts small blind $0.50
ardo888: posts big blind $1
*** HOLE CARDS ***
Dealt to matiko09 [2s Kc]
CI58: folds 
AceFarky: folds 
powerbel: folds 
1000karlos: folds 
Yaaaazz: raises $2 to $3
choupai: folds 
matiko09: folds 
djammusic: folds 
ardo888: folds 
Uncalled bet ($2) returned to Yaaaazz
Yaaaazz collected $2.50 from pot
*** SUMMARY ***
Total pot $2.50 | Rake $0 
Seat 1: CI58 folded before Flop (didn't bet)
Seat 2: AceFarky folded before Flop (didn't bet)
Seat 3: powerbel folded before Flop (didn't bet)
Seat 4: 1000karlos folded before Flop (didn't bet)
Seat 5: Yaaaazz collected ($2.50)
Seat 6: choupai folded before Flop (didn't bet)
Seat 7: matiko09 (button) folded before Flop (didn't bet)
Seat 8: djammusic (small blind) folded before Flop
Seat 9: ardo888 (big blind) folded before Flop





PokerStars Hand #151941660725:  Hold'em No Limit ($0.50/$1.00 USD) - 2016/04/15 12:53:22 CET [2016/04/15 6:53:22 ET]
Table 'Matterania III' 9-max Seat #6 is the button
Seat 1: di0d80 ($102.30 in chips) 
Seat 2: aseban11 ($105.24 in chips) 
Seat 3: ardo888 ($122.51 in chips) 
Seat 5: Vermm ($88.90 in chips) 
Seat 6: matiko09 ($100 in chips) 
Seat 7: Yaaaazz ($108.96 in chips) 
Seat 8: haoyuan541 ($101.72 in chips) 
Seat 9: flk.Dasas ($103.50 in chips) 
Yaaaazz: posts small blind $0.50
haoyuan541: posts big blind $1
di0d80: posts the ante $0.20
aseban11: posts the ante $0.20
ardo888: posts the ante $0.20
Vermm: posts the ante $0.20
matiko09: posts the ante $0.20
Yaaaazz: posts the ante $0.20
haoyuan541: posts the ante $0.20
flk.Dasas: posts the ante $0.20
*** HOLE CARDS ***
Dealt to matiko09 [7s 5c]
flk.Dasas: folds 
di0d80: folds 
aseban11: folds 
ardo888: folds 
Vermm: folds 
matiko09: folds 
Yaaaazz: folds 
Uncalled bet ($0.50) returned to haoyuan541
haoyuan541 collected $2.60 from pot
*** SUMMARY ***
Total pot $2.60 | Rake $0 
Seat 1: di0d80 folded before Flop (didn't bet)
Seat 2: aseban11 folded before Flop (didn't bet)
Seat 3: ardo888 folded before Flop (didn't bet)
Seat 5: Vermm folded before Flop (didn't bet)
Seat 6: matiko09 (button) folded before Flop (didn't bet)
Seat 7: Yaaaazz (small blind) folded before Flop
Seat 8: haoyuan541 (big blind) collected ($2.60)
Seat 9: flk.Dasas folded before Flop (didn't bet)





PokerStars Hand #151941667560:  Hold'em No Limit ($0.50/$1.00 USD) - 2016/04/15 12:53:37 CET [2016/04/15 6:53:37 ET]
Table 'Cheruskia II' 9-max Seat #4 is the button
Seat 1: flk.Dasas ($122.10 in chips) 
Seat 3: Glushchenko ($181.63 in chips) 
Seat 4: di0d80 ($101 in chips) 
Seat 5: matiko09 ($100 in chips) 
Seat 6: StarsAbove ($108 in chips) 
Seat 7: picka4u ($73.20 in chips) 
Seat 9: vrnMike ($100 in chips) 
matiko09: posts small blind $0.50
StarsAbove: posts big blind $1
*** HOLE CARDS ***
Dealt to matiko09 [Td 6h]
picka4u: folds 
vrnMike: folds 
flk.Dasas: folds 
Glushchenko: folds 
di0d80: raises $1 to $2
matiko09: folds 
visez873 joins the table at seat #8 
StarsAbove: raises $5 to $7
tipner joins the table at seat #2 
di0d80: calls $5
*** FLOP *** [As 7d Ts]
StarsAbove: checks 
di0d80: checks 
*** TURN *** [As 7d Ts] [2d]
StarsAbove: checks 
di0d80: checks 
*** RIVER *** [As 7d Ts 2d] [Jh]
tipner leaves the table
aseban11 joins the table at seat #2 
StarsAbove: checks 
di0d80: checks 
*** SHOW DOWN ***
StarsAbove: shows [Qd Th] (a pair of Tens)
di0d80: mucks hand 
StarsAbove collected $13.78 from pot
*** SUMMARY ***
Total pot $14.50 | Rake $0.72 
Board [As 7d Ts 2d Jh]
Seat 1: flk.Dasas folded before Flop (didn't bet)
Seat 3: Glushchenko folded before Flop (didn't bet)
Seat 4: di0d80 (button) mucked [4c Kc]
Seat 5: matiko09 (small blind) folded before Flop
Seat 6: StarsAbove (big blind) showed [Qd Th] and won ($13.78) with a pair of Tens
Seat 7: picka4u folded before Flop (didn't bet)
Seat 9: vrnMike folded before Flop (didn't bet)





PokerStars Hand #151941671453:  Hold'em No Limit ($1/$2 USD) - 2016/04/15 12:53:46 CET [2016/04/15 6:53:46 ET]
Table 'Patroclus II' 9-max Seat #3 is the button
Seat 1: TonnaMunz ($219.46 in chips) 
Seat 2: rmanjkeee ($87.40 in chips) 
Seat 3: Koolniknik ($170.20 in chips) 
Seat 4: tipner ($200 in chips) 
Seat 5: butcheN18 ($200 in chips) 
Seat 7: matiko09 ($202 in chips) 
Seat 8: Glushchenko ($200 in chips) 
Seat 9: Fish4trips ($205.35 in chips) 
tipner: posts small blind $1
butcheN18: posts big blind $2
*** HOLE CARDS ***
Dealt to matiko09 [Ad Ks]
matiko09: raises $3 to $5
Glushchenko: folds 
Fish4trips: folds 
TonnaMunz: folds 
rmanjkeee: folds 
Koolniknik: folds 
tipner: folds 
butcheN18: folds 
Uncalled bet ($3) returned to matiko09
matiko09 collected $5 from pot
matiko09: doesn't show hand 
*** SUMMARY ***
Total pot $5 | Rake $0 
Seat 1: TonnaMunz folded before Flop (didn't bet)
Seat 2: rmanjkeee folded before Flop (didn't bet)
Seat 3: Koolniknik (button) folded before Flop (didn't bet)
Seat 4: tipner (small blind) folded before Flop
Seat 5: butcheN18 (big blind) folded before Flop
Seat 7: matiko09 collected ($5)
Seat 8: Glushchenko folded before Flop (didn't bet)
Seat 9: Fish4trips folded before Flop (didn't bet)





PokerStars Hand #151941671952:  Hold'em No Limit ($0.50/$1.00 USD) - 2016/04/15 12:53:47 CET [2016/04/15 6:53:47 ET]
Table 'Chiny II' 9-max Seat #8 is the button
Seat 1: CI58 ($132.34 in chips) 
Seat 2: AceFarky ($100 in chips) 
Seat 3: powerbel ($39 in chips) 
Seat 4: 1000karlos ($90.27 in chips) 
Seat 5: Yaaaazz ($125.78 in chips) 
Seat 6: choupai ($33.38 in chips) 
Seat 7: matiko09 ($110.10 in chips) 
Seat 8: djammusic ($38.50 in chips) 
Seat 9: ardo888 ($107.12 in chips) 
ardo888: posts small blind $0.50
CI58: posts big blind $1
*** HOLE CARDS ***
Dealt to matiko09 [Jc Jh]
AceFarky: folds 
powerbel: folds 
1000karlos: folds 
Yaaaazz: folds 
choupai: folds 
matiko09: raises $1.50 to $2.50
djammusic: folds 
ardo888: folds 
CI58: folds 
Uncalled bet ($1.50) returned to matiko09
matiko09 collected $2.50 from pot
matiko09: doesn't show hand 
*** SUMMARY ***
Total pot $2.50 | Rake $0 
Seat 1: CI58 (big blind) folded before Flop
Seat 2: AceFarky folded before Flop (didn't bet)
Seat 3: powerbel folded before Flop (didn't bet)
Seat 4: 1000karlos folded before Flop (didn't bet)
Seat 5: Yaaaazz folded before Flop (didn't bet)
Seat 6: choupai folded before Flop (didn't bet)
Seat 7: matiko09 collected ($2.50)
Seat 8: djammusic (button) folded before Flop (didn't bet)
Seat 9: ardo888 (small blind) folded before Flop





PokerStars Hand #151941672784:  Hold'em No Limit ($0.50/$1.00 USD) - 2016/04/15 12:53:49 CET [2016/04/15 6:53:49 ET]
Table 'Lamberta III' 9-max Seat #5 is the button
Seat 1: di0d80 ($100 in chips) 
Seat 2: Vermm ($81.32 in chips) 
Seat 3: butcheN18 ($107.44 in chips) 
Seat 5: tipner ($100 in chips) 
Seat 6: aseban11 ($101.50 in chips) 
Seat 7: ardo888 ($100 in chips) 
Seat 8: djammusic ($41.89 in chips) 
Seat 9: matiko09 ($141.50 in chips) 
aseban11: posts small blind $0.50
ardo888: posts big blind $1
*** HOLE CARDS ***
Dealt to matiko09 [Jh Jd]
djammusic: folds 
matiko09: raises $2 to $3
di0d80: folds 
Vermm: folds 
spunkbubble9 leaves the table
butcheN18: folds 
tipner: folds 
aseban11: folds 
ardo888: raises $7 to $10
matiko09: calls $7
*** FLOP *** [5d 3s 8c]
ardo888: bets $10.32
matiko09: calls $10.32
*** TURN *** [5d 3s 8c] [Qd]
ardo888: bets $20.71
Filojoes joins the table at seat #4 
matiko09: folds 
Uncalled bet ($20.71) returned to ardo888
ardo888 collected $39.08 from pot
ardo888: doesn't show hand 
*** SUMMARY ***
Total pot $41.14 | Rake $2.06 
Board [5d 3s 8c Qd]
Seat 1: di0d80 folded before Flop (didn't bet)
Seat 2: Vermm folded before Flop (didn't bet)
Seat 3: butcheN18 folded before Flop (didn't bet)
Seat 5: tipner (button) folded before Flop (didn't bet)
Seat 6: aseban11 (small blind) folded before Flop
Seat 7: ardo888 (big blind) collected ($39.08)
Seat 8: djammusic folded before Flop (didn't bet)
Seat 9: matiko09 folded on the Turn





PokerStars Hand #151941677173:  Hold'em No Limit ($0.50/$1.00 USD) - 2016/04/15 12:53:59 CET [2016/04/15 6:53:59 ET]
Table 'Matterania III' 9-max Seat #7 is the button
Seat 1: di0d80 ($102.10 in chips) 
Seat 2: aseban11 ($105.04 in chips) 
Seat 3: ardo888 ($122.31 in chips) 
Seat 5: Vermm ($88.70 in chips) 
Seat 6: matiko09 ($100 in chips) 
Seat 7: Yaaaazz ($108.26 in chips) 
Seat 8: haoyuan541 ($103.62 in chips) 
Seat 9: flk.Dasas ($103.30 in chips) 
haoyuan541: posts small blind $0.50
flk.Dasas: posts big blind $1
di0d80: posts the ante $0.20
aseban11: posts the ante $0.20
ardo888: posts the ante $0.20
Vermm: posts the ante $0.20
matiko09: posts the ante $0.20
Yaaaazz: posts the ante $0.20
haoyuan541: posts the ante $0.20
flk.Dasas: posts the ante $0.20
*** HOLE CARDS ***
Dealt to matiko09 [6s 8d]
di0d80: raises $1.50 to $2.50
aseban11: folds 
ardo888: folds 
Vermm: calls $2.50
matiko09: folds 
Yaaaazz: folds 
haoyuan541: folds 
flk.Dasas: folds 
*** FLOP *** [3c Kd Qs]
di0d80: checks 
Vermm: bets $3.85
wangzhuoming joins the table at seat #4 
di0d80: calls $3.85
*** TURN *** [3c Kd Qs] [3s]
di0d80: checks 
Vermm: checks 
*** RIVER *** [3c Kd Qs 3s] [As]
di0d80: checks 
Vermm: checks 
*** SHOW DOWN ***
di0d80: shows [Qc Jc] (two pair, Queens and Threes)
Vermm: mucks hand 
di0d80 collected $15.01 from pot
*** SUMMARY ***
Total pot $15.80 | Rake $0.79 
Board [3c Kd Qs 3s As]
Seat 1: di0d80 showed [Qc Jc] and won ($15.01) with two pair, Queens and Threes
Seat 2: aseban11 folded before Flop (didn't bet)
Seat 3: ardo888 folded before Flop (didn't bet)
Seat 5: Vermm mucked [7c 7s]
Seat 6: matiko09 folded before Flop (didn't bet)
Seat 7: Yaaaazz (button) folded before Flop (didn't bet)
Seat 8: haoyuan541 (small blind) folded before Flop
Seat 9: flk.Dasas (big blind) folded before Flop





PokerStars Hand #151941683019:  Hold'em No Limit ($1/$2 USD) - 2016/04/15 12:54:12 CET [2016/04/15 6:54:12 ET]
Table 'Patroclus II' 9-max Seat #4 is the button
Seat 1: TonnaMunz ($219.46 in chips) 
Seat 2: rmanjkeee ($87.40 in chips) 
Seat 3: Koolniknik ($170.20 in chips) 
Seat 4: tipner ($200 in chips) 
Seat 5: butcheN18 ($200 in chips) 
Seat 7: matiko09 ($205 in chips) 
Seat 8: Glushchenko ($200 in chips) 
Seat 9: Fish4trips ($205.35 in chips) 
butcheN18: posts small blind $1
matiko09: posts big blind $2
*** HOLE CARDS ***
Dealt to matiko09 [3c 7d]
Glushchenko: folds 
Fish4trips: folds 
TonnaMunz: folds 
rmanjkeee: raises $3 to $5
Koolniknik: calls $5
tipner: folds 
butcheN18: folds 
matiko09: folds 
*** FLOP *** [7h Ts 3h]
rmanjkeee: bets $8
Koolniknik: calls $8
*** TURN *** [7h Ts 3h] [7s]
rmanjkeee: checks 
Koolniknik: bets $13.77
rmanjkeee: folds 
Uncalled bet ($13.77) returned to Koolniknik
Koolniknik collected $27.55 from pot
Koolniknik: doesn't show hand 
*** SUMMARY ***
Total pot $29 | Rake $1.45 
Board [7h Ts 3h 7s]
Seat 1: TonnaMunz folded before Flop (didn't bet)
Seat 2: rmanjkeee folded on the Turn
Seat 3: Koolniknik collected ($27.55)
Seat 4: tipner (button) folded before Flop (didn't bet)
Seat 5: butcheN18 (small blind) folded before Flop
Seat 7: matiko09 (big blind) folded before Flop
Seat 8: Glushchenko folded before Flop (didn't bet)
Seat 9: Fish4trips folded before Flop (didn't bet)





PokerStars Hand #151941691240:  Hold'em No Limit ($0.50/$1.00 USD) - 2016/04/15 12:54:30 CET [2016/04/15 6:54:30 ET]
Table 'Chiny II' 9-max Seat #9 is the button
Seat 1: CI58 ($131.34 in chips) 
Seat 2: AceFarky ($100 in chips) 
Seat 3: powerbel ($39 in chips) 
Seat 4: 1000karlos ($90.27 in chips) 
Seat 5: Yaaaazz ($125.78 in chips) 
Seat 6: choupai ($33.38 in chips) 
Seat 7: matiko09 ($111.60 in chips) 
Seat 8: djammusic ($38.50 in chips) 
Seat 9: ardo888 ($106.62 in chips) 
CI58: posts small blind $0.50
AceFarky: posts big blind $1
*** HOLE CARDS ***
Dealt to matiko09 [Qh 5c]
powerbel: folds 
1000karlos: folds 
Yaaaazz: folds 
choupai: folds 
matiko09: folds 
djammusic: raises $1.02 to $2.02
ardo888: folds 
CI58: folds 
AceFarky: folds 
Uncalled bet ($1.02) returned to djammusic
djammusic collected $2.50 from pot
djammusic: doesn't show hand 
*** SUMMARY ***
Total pot $2.50 | Rake $0 
Seat 1: CI58 (small blind) folded before Flop
Seat 2: AceFarky (big blind) folded before Flop
Seat 3: powerbel folded before Flop (didn't bet)
Seat 4: 1000karlos folded before Flop (didn't bet)
Seat 5: Yaaaazz folded before Flop (didn't bet)
Seat 6: choupai folded before Flop (didn't bet)
Seat 7: matiko09 folded before Flop (didn't bet)
Seat 8: djammusic collected ($2.50)
Seat 9: ardo888 (button) folded before Flop (didn't bet)





PokerStars Hand #151941696084:  Hold'em No Limit ($1/$2 USD) - 2016/04/15 12:54:41 CET [2016/04/15 6:54:41 ET]
Table 'Adele II' 9-max Seat #2 is the button
Seat 1: coinflip_si ($200 in chips) 
Seat 2: Fish4trips ($200 in chips) 
Seat 3: matiko09 ($397.67 in chips) 
Seat 4: Glushchenko ($200 in chips) 
Seat 5: T0ny Adams ($94.04 in chips) 
Seat 7: tipner ($200 in chips) 
Seat 9: RyanHuJun ($235.40 in chips) 
matiko09: posts small blind $1
Glushchenko: posts big blind $2
TonnaMunz: sits out 
docmarc777: sits out 
*** HOLE CARDS ***
Dealt to matiko09 [7h Qs]
T0ny Adams: folds 
tipner: folds 
RyanHuJun: folds 
coinflip_si: folds 
Fish4trips: raises $2 to $4
matiko09: folds 
Glushchenko: folds 
Uncalled bet ($2) returned to Fish4trips
Fish4trips collected $5 from pot
Fish4trips: doesn't show hand 
*** SUMMARY ***
Total pot $5 | Rake $0 
Seat 1: coinflip_si folded before Flop (didn't bet)
Seat 2: Fish4trips (button) collected ($5)
Seat 3: matiko09 (small blind) folded before Flop
Seat 4: Glushchenko (big blind) folded before Flop
Seat 5: T0ny Adams folded before Flop (didn't bet)
Seat 7: tipner folded before Flop (didn't bet)
Seat 9: RyanHuJun folded before Flop (didn't bet)





PokerStars Hand #151941696194:  Hold'em No Limit ($0.50/$1.00 USD) - 2016/04/15 12:54:42 CET [2016/04/15 6:54:42 ET]
Table 'Cheruskia II' 9-max Seat #5 is the button
Seat 1: flk.Dasas ($122.10 in chips) 
Seat 3: Glushchenko ($181.63 in chips) 
Seat 4: di0d80 ($100 in chips) 
Seat 5: matiko09 ($100 in chips) 
Seat 6: StarsAbove ($114.78 in chips) 
Seat 8: visez873 ($40 in chips) 
Seat 9: vrnMike ($100 in chips) 
StarsAbove: posts small blind $0.50
picka4u: is sitting out 
visez873: posts big blind $1
*** HOLE CARDS ***
Dealt to matiko09 [6s 8d]
vrnMike: folds 
flk.Dasas: folds 
Glushchenko: folds 
di0d80: raises $1.50 to $2.50
matiko09: folds 
StarsAbove: folds 
visez873: calls $1.50
*** FLOP *** [Qs 3c Qh]
visez873: checks 
di0d80: checks 
*** TURN *** [Qs 3c Qh] [Js]
visez873: checks 
di0d80: bets $3
visez873: calls $3
*** RIVER *** [Qs 3c Qh Js] [6c]
visez873: checks 
di0d80: bets $6
visez873: folds 
Uncalled bet ($6) returned to di0d80
di0d80 collected $10.92 from pot
di0d80: doesn't show hand 
*** SUMMARY ***
Total pot $11.50 | Rake $0.58 
Board [Qs 3c Qh Js 6c]
Seat 1: flk.Dasas folded before Flop (didn't bet)
Seat 3: Glushchenko folded before Flop (didn't bet)
Seat 4: di0d80 collected ($10.92)
Seat 5: matiko09 (button) folded before Flop (didn't bet)
Seat 6: StarsAbove (small blind) folded before Flop
Seat 8: visez873 (big blind) folded on the River
Seat 9: vrnMike folded before Flop (didn't bet)





PokerStars Hand #151941699677:  Hold'em No Limit ($0.50/$1.00 USD) - 2016/04/15 12:54:50 CET [2016/04/15 6:54:50 ET]
Table 'Lamberta III' 9-max Seat #6 is the button
Seat 1: di0d80 ($100 in chips) 
Seat 2: Vermm ($81.32 in chips) 
Seat 3: butcheN18 ($107.44 in chips) 
Seat 5: tipner ($100 in chips) 
Seat 6: aseban11 ($101 in chips) 
Seat 7: ardo888 ($118.76 in chips) 
Seat 8: djammusic ($41.89 in chips) 
Seat 9: matiko09 ($121.18 in chips) 
ardo888: posts small blind $0.50
djammusic: posts big blind $1
Filojoes: sits out 
*** HOLE CARDS ***
Dealt to matiko09 [Qc 4c]
matiko09: folds 
di0d80: folds 
Vermm: folds 
butcheN18: folds 
tipner: folds 
aseban11: folds 
ardo888: raises $2 to $3
djammusic: calls $2
*** FLOP *** [9c Th 2c]
ardo888: checks 
djammusic: bets $3.70
ardo888: calls $3.70
*** TURN *** [9c Th 2c] [2h]
ardo888: checks 
djammusic: checks 
*** RIVER *** [9c Th 2c 2h] [5d]
ardo888: bets $9.29
djammusic: folds 
Uncalled bet ($9.29) returned to ardo888
ardo888 collected $12.73 from pot
ardo888: doesn't show hand 
*** SUMMARY ***
Total pot $13.40 | Rake $0.67 
Board [9c Th 2c 2h 5d]
Seat 1: di0d80 folded before Flop (didn't bet)
Seat 2: Vermm folded before Flop (didn't bet)
Seat 3: butcheN18 folded before Flop (didn't bet)
Seat 5: tipner folded before Flop (didn't bet)
Seat 6: aseban11 (button) folded before Flop (didn't bet)
Seat 7: ardo888 (small blind) collected ($12.73)
Seat 8: djammusic (big blind) folded on the River
Seat 9: matiko09 folded before Flop (didn't bet)





PokerStars Hand #151941707405:  Hold'em No Limit ($0.50/$1.00 USD) - 2016/04/15 12:55:07 CET [2016/04/15 6:55:07 ET]
Table 'Matterania III' 9-max Seat #8 is the button
Seat 1: di0d80 ($110.56 in chips) 
Seat 2: aseban11 ($104.84 in chips) 
Seat 3: ardo888 ($122.11 in chips) 
Seat 5: Vermm ($82.15 in chips) 
Seat 6: matiko09 ($100 in chips) 
Seat 7: Yaaaazz ($108.06 in chips) 
Seat 8: haoyuan541 ($102.92 in chips) 
Seat 9: flk.Dasas ($102.10 in chips) 
flk.Dasas: posts small blind $0.50
di0d80: posts big blind $1
wangzhuoming: sits out 
di0d80: posts the ante $0.20
aseban11: posts the ante $0.20
ardo888: posts the ante $0.20
Vermm: posts the ante $0.20
matiko09: posts the ante $0.20
Yaaaazz: posts the ante $0.20
haoyuan541: posts the ante $0.20
flk.Dasas: posts the ante $0.20
*** HOLE CARDS ***
Dealt to matiko09 [7d Ts]
aseban11: folds 
ardo888: folds 
Vermm: folds 
matiko09: folds 
Yaaaazz: raises $1.50 to $2.50
haoyuan541: folds 
flk.Dasas: folds 
di0d80: folds 
Uncalled bet ($1.50) returned to Yaaaazz
Yaaaazz collected $4.10 from pot
*** SUMMARY ***
Total pot $4.10 | Rake $0 
Seat 1: di0d80 (big blind) folded before Flop
Seat 2: aseban11 folded before Flop (didn't bet)
Seat 3: ardo888 folded before Flop (didn't bet)
Seat 5: Vermm folded before Flop (didn't bet)
Seat 6: matiko09 folded before Flop (didn't bet)
Seat 7: Yaaaazz collected ($4.10)
Seat 8: haoyuan541 (button) folded before Flop (didn't bet)
Seat 9: flk.Dasas (small blind) folded before Flop





PokerStars Hand #151941707730:  Hold'em No Limit ($0.50/$1.00 USD) - 2016/04/15 12:55:08 CET [2016/04/15 6:55:08 ET]
Table 'Chiny II' 9-max Seat #1 is the button
Seat 1: CI58 ($130.84 in chips) 
Seat 2: AceFarky ($100 in chips) 
Seat 3: powerbel ($39 in chips) 
Seat 4: 1000karlos ($90.27 in chips) 
Seat 5: Yaaaazz ($125.78 in chips) 
Seat 6: choupai ($33.38 in chips) 
Seat 7: matiko09 ($111.60 in chips) 
Seat 8: djammusic ($40 in chips) 
Seat 9: ardo888 ($106.62 in chips) 
AceFarky: posts small blind $0.50
powerbel: posts big blind $1
*** HOLE CARDS ***
Dealt to matiko09 [4s 9c]
1000karlos: folds 
Yaaaazz: folds 
choupai: folds 
matiko09: folds 
djammusic: folds 
ardo888: folds 
CI58: raises $1.25 to $2.25
AceFarky: folds 
powerbel: calls $1.25
*** FLOP *** [Ts Td 4c]
powerbel: checks 
CI58: checks 
*** TURN *** [Ts Td 4c] [Qh]
powerbel: checks 
CI58: checks 
*** RIVER *** [Ts Td 4c Qh] [Jd]
powerbel: bets $2
CI58: folds 
Uncalled bet ($2) returned to powerbel
powerbel collected $4.75 from pot
powerbel: doesn't show hand 
*** SUMMARY ***
Total pot $5 | Rake $0.25 
Board [Ts Td 4c Qh Jd]
Seat 1: CI58 (button) folded on the River
Seat 2: AceFarky (small blind) folded before Flop
Seat 3: powerbel (big blind) collected ($4.75)
Seat 4: 1000karlos folded before Flop (didn't bet)
Seat 5: Yaaaazz folded before Flop (didn't bet)
Seat 6: choupai folded before Flop (didn't bet)
Seat 7: matiko09 folded before Flop (didn't bet)
Seat 8: djammusic folded before Flop (didn't bet)
Seat 9: ardo888 folded before Flop (didn't bet)





PokerStars Hand #151941712706:  Hold'em No Limit ($1/$2 USD) - 2016/04/15 12:55:20 CET [2016/04/15 6:55:20 ET]
Table 'Adele II' 9-max Seat #3 is the button
Seat 1: coinflip_si ($200 in chips) 
Seat 2: Fish4trips ($203 in chips) 
Seat 3: matiko09 ($396.67 in chips) 
Seat 4: Glushchenko ($200 in chips) 
Seat 5: T0ny Adams ($94.04 in chips) 
Seat 7: tipner ($200 in chips) 
Seat 9: RyanHuJun ($235.40 in chips) 
Glushchenko: posts small blind $1
T0ny Adams: posts big blind $2
TonnaMunz: sits out 
docmarc777: sits out 
*** HOLE CARDS ***
Dealt to matiko09 [Kc 7h]
tipner: folds 
RyanHuJun: folds 
coinflip_si: folds 
Fish4trips: raises $3 to $5
matiko09: folds 
Glushchenko: folds 
T0ny Adams: folds 
Uncalled bet ($3) returned to Fish4trips
Fish4trips collected $5 from pot
Fish4trips: doesn't show hand 
*** SUMMARY ***
Total pot $5 | Rake $0 
Seat 1: coinflip_si folded before Flop (didn't bet)
Seat 2: Fish4trips collected ($5)
Seat 3: matiko09 (button) folded before Flop (didn't bet)
Seat 4: Glushchenko (small blind) folded before Flop
Seat 5: T0ny Adams (big blind) folded before Flop
Seat 7: tipner folded before Flop (didn't bet)
Seat 9: RyanHuJun folded before Flop (didn't bet)





PokerStars Hand #151941721521:  Hold'em No Limit ($0.50/$1.00 USD) - 2016/04/15 12:55:42 CET [2016/04/15 6:55:42 ET]
Table 'Cheruskia II' 9-max Seat #6 is the button
Seat 1: flk.Dasas ($122.10 in chips) 
Seat 3: Glushchenko ($181.63 in chips) 
Seat 4: di0d80 ($105.42 in chips) 
Seat 5: matiko09 ($100 in chips) 
Seat 6: StarsAbove ($114.28 in chips) 
Seat 8: visez873 ($34.50 in chips) 
Seat 9: vrnMike ($100 in chips) 
visez873: posts small blind $0.50
vrnMike: posts big blind $1
*** HOLE CARDS ***
Dealt to matiko09 [4c Td]
flk.Dasas: folds 
Glushchenko: folds 
di0d80: raises $1.50 to $2.50
matiko09: folds 
StarsAbove: folds 
visez873: folds 
vrnMike: folds 
Uncalled bet ($1.50) returned to di0d80
di0d80 collected $2.50 from pot
di0d80: doesn't show hand 
*** SUMMARY ***
Total pot $2.50 | Rake $0 
Seat 1: flk.Dasas folded before Flop (didn't bet)
Seat 3: Glushchenko folded before Flop (didn't bet)
Seat 4: di0d80 collected ($2.50)
Seat 5: matiko09 folded before Flop (didn't bet)
Seat 6: StarsAbove (button) folded before Flop (didn't bet)
Seat 8: visez873 (small blind) folded before Flop
Seat 9: vrnMike (big blind) folded before Flop





PokerStars Hand #151941723281:  Hold'em No Limit ($0.50/$1.00 USD) - 2016/04/15 12:55:47 CET [2016/04/15 6:55:47 ET]
Table 'Matterania III' 9-max Seat #9 is the button
Seat 1: di0d80 ($109.36 in chips) 
Seat 3: ardo888 ($121.91 in chips) 
Seat 5: Vermm ($81.95 in chips) 
Seat 6: matiko09 ($100 in chips) 
Seat 7: Yaaaazz ($110.96 in chips) 
Seat 8: haoyuan541 ($102.72 in chips) 
Seat 9: flk.Dasas ($101.40 in chips) 
di0d80: posts small blind $0.50
aseban11: is sitting out 
ardo888: posts big blind $1
wangzhuoming: sits out 
di0d80: posts the ante $0.20
ardo888: posts the ante $0.20
Vermm: posts the ante $0.20
matiko09: posts the ante $0.20
Yaaaazz: posts the ante $0.20
haoyuan541: posts the ante $0.20
flk.Dasas: posts the ante $0.20
*** HOLE CARDS ***
Dealt to matiko09 [Qh 8d]
Vermm: folds 
matiko09: folds 
Yaaaazz: folds 
haoyuan541: folds 
flk.Dasas: folds 
di0d80: raises $2 to $3
ardo888: calls $2
*** FLOP *** [6s Td 6h]
di0d80: checks 
ardo888: bets $3.72
di0d80: calls $3.72
*** TURN *** [6s Td 6h] [2h]
di0d80: checks 
ardo888: checks 
*** RIVER *** [6s Td 6h 2h] [4h]
di0d80: checks 
ardo888: checks 
*** SHOW DOWN ***
di0d80: shows [9d Ac] (a pair of Sixes)
ardo888: shows [3s 3d] (two pair, Sixes and Threes)
ardo888 collected $14.10 from pot
*** SUMMARY ***
Total pot $14.84 | Rake $0.74 
Board [6s Td 6h 2h 4h]
Seat 1: di0d80 (small blind) showed [9d Ac] and lost with a pair of Sixes
Seat 3: ardo888 (big blind) showed [3s 3d] and won ($14.10) with two pair, Sixes and Threes
Seat 5: Vermm folded before Flop (didn't bet)
Seat 6: matiko09 folded before Flop (didn't bet)
Seat 7: Yaaaazz folded before Flop (didn't bet)
Seat 8: haoyuan541 folded before Flop (didn't bet)
Seat 9: flk.Dasas (button) folded before Flop (didn't bet)





PokerStars Hand #151941725156:  Hold'em No Limit ($1/$2 USD) - 2016/04/15 12:55:51 CET [2016/04/15 6:55:51 ET]
Table 'Adele II' 9-max Seat #4 is the button
Seat 1: coinflip_si ($200 in chips) 
Seat 2: Fish4trips ($206 in chips) 
Seat 3: matiko09 ($396.67 in chips) 
Seat 4: Glushchenko ($200 in chips) 
Seat 5: T0ny Adams ($92.04 in chips) 
Seat 6: TonnaMunz ($200 in chips) 
Seat 7: tipner ($200 in chips) 
Seat 9: RyanHuJun ($235.40 in chips) 
T0ny Adams: posts small blind $1
TonnaMunz: posts big blind $2
docmarc777: sits out 
*** HOLE CARDS ***
Dealt to matiko09 [7d 5s]
tipner: folds 
RyanHuJun: folds 
coinflip_si: folds 
Fish4trips: folds 
matiko09: folds 
Glushchenko: folds 
T0ny Adams: folds 
Uncalled bet ($1) returned to TonnaMunz
TonnaMunz collected $2 from pot
TonnaMunz: doesn't show hand 
*** SUMMARY ***
Total pot $2 | Rake $0 
Seat 1: coinflip_si folded before Flop (didn't bet)
Seat 2: Fish4trips folded before Flop (didn't bet)
Seat 3: matiko09 folded before Flop (didn't bet)
Seat 4: Glushchenko (button) folded before Flop (didn't bet)
Seat 5: T0ny Adams (small blind) folded before Flop
Seat 6: TonnaMunz (big blind) collected ($2)
Seat 7: tipner folded before Flop (didn't bet)
Seat 9: RyanHuJun folded before Flop (didn't bet)





PokerStars Hand #151941728052:  Hold'em No Limit ($1/$2 USD) - 2016/04/15 12:55:59 CET [2016/04/15 6:55:59 ET]
Table 'Patroclus II' 9-max Seat #5 is the button
Seat 1: TonnaMunz ($219.46 in chips) 
Seat 2: rmanjkeee ($80 in chips) 
Seat 3: Koolniknik ($184.75 in chips) 
Seat 4: tipner ($200 in chips) 
Seat 5: butcheN18 ($200 in chips) 
Seat 7: matiko09 ($203 in chips) 
Seat 8: Glushchenko ($200 in chips) 
Seat 9: Fish4trips ($205.35 in chips) 
matiko09: posts small blind $1
Glushchenko: posts big blind $2
*** HOLE CARDS ***
Dealt to matiko09 [3c 6h]
Fish4trips: folds 
TonnaMunz: folds 
rmanjkeee: folds 
Koolniknik: folds 
tipner: folds 
butcheN18: raises $2.28 to $4.28
matiko09: folds 
Glushchenko: calls $2.28
*** FLOP *** [7h 2s 3h]
Glushchenko: checks 
butcheN18: checks 
*** TURN *** [7h 2s 3h] [Kd]
Glushchenko: checks 
butcheN18: checks 
*** RIVER *** [7h 2s 3h Kd] [5d]
Glushchenko: bets $6.81
butcheN18: raises $14.52 to $21.33
Glushchenko: calls $14.52
*** SHOW DOWN ***
butcheN18: shows [Ad 4d] (a straight, Ace to Five)
Glushchenko: mucks hand 
butcheN18 collected $49.61 from pot
*** SUMMARY ***
Total pot $52.22 | Rake $2.61 
Board [7h 2s 3h Kd 5d]
Seat 1: TonnaMunz folded before Flop (didn't bet)
Seat 2: rmanjkeee folded before Flop (didn't bet)
Seat 3: Koolniknik folded before Flop (didn't bet)
Seat 4: tipner folded before Flop (didn't bet)
Seat 5: butcheN18 (button) showed [Ad 4d] and won ($49.61) with a straight, Ace to Five
Seat 7: matiko09 (small blind) folded before Flop
Seat 8: Glushchenko (big blind) mucked [7c 5c]
Seat 9: Fish4trips folded before Flop (didn't bet)





PokerStars Hand #151941731672:  Hold'em No Limit ($0.50/$1.00 USD) - 2016/04/15 12:56:08 CET [2016/04/15 6:56:08 ET]
Table 'Cheruskia II' 9-max Seat #8 is the button
Seat 1: flk.Dasas ($122.10 in chips) 
Seat 3: Glushchenko ($181.63 in chips) 
Seat 4: di0d80 ($106.92 in chips) 
Seat 5: matiko09 ($100 in chips) 
Seat 6: StarsAbove ($114.28 in chips) 
Seat 8: visez873 ($34 in chips) 
Seat 9: vrnMike ($100 in chips) 
vrnMike: posts small blind $0.50
flk.Dasas: posts big blind $1
*** HOLE CARDS ***
Dealt to matiko09 [4d 3d]
Glushchenko: folds 
di0d80: folds 
matiko09: folds 
StarsAbove: raises $1.50 to $2.50
visez873: folds 
vrnMike: folds 
flk.Dasas: folds 
Uncalled bet ($1.50) returned to StarsAbove
StarsAbove collected $2.50 from pot
StarsAbove: doesn't show hand 
*** SUMMARY ***
Total pot $2.50 | Rake $0 
Seat 1: flk.Dasas (big blind) folded before Flop
Seat 3: Glushchenko folded before Flop (didn't bet)
Seat 4: di0d80 folded before Flop (didn't bet)
Seat 5: matiko09 folded before Flop (didn't bet)
Seat 6: StarsAbove collected ($2.50)
Seat 8: visez873 (button) folded before Flop (didn't bet)
Seat 9: vrnMike (small blind) folded before Flop





PokerStars Hand #151941733066:  Hold'em No Limit ($0.50/$1.00 USD) - 2016/04/15 12:56:11 CET [2016/04/15 6:56:11 ET]
Table 'Chiny II' 9-max Seat #2 is the button
Seat 1: CI58 ($128.59 in chips) 
Seat 2: AceFarky ($100 in chips) 
Seat 3: powerbel ($41.50 in chips) 
Seat 4: 1000karlos ($90.27 in chips) 
Seat 5: Yaaaazz ($125.78 in chips) 
Seat 6: choupai ($33.38 in chips) 
Seat 7: matiko09 ($111.60 in chips) 
Seat 8: djammusic ($40 in chips) 
Seat 9: ardo888 ($106.62 in chips) 
powerbel: posts small blind $0.50
1000karlos: posts big blind $1
*** HOLE CARDS ***
Dealt to matiko09 [Ts 9h]
Yaaaazz: folds 
choupai: folds 
matiko09: folds 
djammusic: folds 
ardo888: folds 
CI58: folds 
AceFarky: raises $1.20 to $2.20
powerbel: calls $1.70
1000karlos: folds 
*** FLOP *** [4h 6d 3c]
powerbel: checks 
AceFarky: bets $5.13
powerbel: folds 
Uncalled bet ($5.13) returned to AceFarky
AceFarky collected $5.13 from pot
AceFarky: doesn't show hand 
*** SUMMARY ***
Total pot $5.40 | Rake $0.27 
Board [4h 6d 3c]
Seat 1: CI58 folded before Flop (didn't bet)
Seat 2: AceFarky (button) collected ($5.13)
Seat 3: powerbel (small blind) folded on the Flop
Seat 4: 1000karlos (big blind) folded before Flop
Seat 5: Yaaaazz folded before Flop (didn't bet)
Seat 6: choupai folded before Flop (didn't bet)
Seat 7: matiko09 folded before Flop (didn't bet)
Seat 8: djammusic folded before Flop (didn't bet)
Seat 9: ardo888 folded before Flop (didn't bet)





PokerStars Hand #151941733080:  Hold'em No Limit ($0.50/$1.00 USD) - 2016/04/15 12:56:11 CET [2016/04/15 6:56:11 ET]
Table 'Lamberta III' 9-max Seat #7 is the button
Seat 1: di0d80 ($100 in chips) 
Seat 2: Vermm ($81.32 in chips) 
Seat 3: butcheN18 ($107.44 in chips) 
Seat 5: tipner ($100 in chips) 
Seat 6: aseban11 ($101 in chips) 
Seat 7: ardo888 ($124.79 in chips) 
Seat 8: djammusic ($35.19 in chips) 
Seat 9: matiko09 ($121.18 in chips) 
djammusic: posts small blind $0.50
matiko09: posts big blind $1
Filojoes: sits out 
*** HOLE CARDS ***
Dealt to matiko09 [6h 6s]
di0d80: folds 
Vermm: folds 
butcheN18: folds 
tipner: folds 
aseban11: folds 
ardo888: folds 
djammusic: raises $1.15 to $2.15
matiko09: raises $4.85 to $7
djammusic: raises $28 to $35
matiko09: raises $59.90 to $94.90
djammusic: calls $0.19 and is all-in
Uncalled bet ($59.71) returned to matiko09
*** FLOP *** [2c Js Qh]
*** TURN *** [2c Js Qh] [6c]
*** RIVER *** [2c Js Qh 6c] [Ac]
*** SHOW DOWN ***
djammusic: shows [8d 8c] (a pair of Eights)
matiko09: shows [6h 6s] (three of a kind, Sixes)
matiko09 collected $67.88 from pot
*** SUMMARY ***
Total pot $70.38 | Rake $2.50 
Board [2c Js Qh 6c Ac]
Seat 1: di0d80 folded before Flop (didn't bet)
Seat 2: Vermm folded before Flop (didn't bet)
Seat 3: butcheN18 folded before Flop (didn't bet)
Seat 5: tipner folded before Flop (didn't bet)
Seat 6: aseban11 folded before Flop (didn't bet)
Seat 7: ardo888 (button) folded before Flop (didn't bet)
Seat 8: djammusic (small blind) showed [8d 8c] and lost with a pair of Eights
Seat 9: matiko09 (big blind) showed [6h 6s] and won ($67.88) with three of a kind, Sixes





PokerStars Hand #151941735346:  Hold'em No Limit ($1/$2 USD) - 2016/04/15 12:56:17 CET [2016/04/15 6:56:17 ET]
Table 'Adele II' 9-max Seat #5 is the button
Seat 1: coinflip_si ($200 in chips) 
Seat 2: Fish4trips ($206 in chips) 
Seat 3: matiko09 ($396.67 in chips) 
Seat 4: Glushchenko ($200 in chips) 
Seat 5: T0ny Adams ($91.04 in chips) 
Seat 6: TonnaMunz ($201 in chips) 
Seat 7: tipner ($200 in chips) 
Seat 9: RyanHuJun ($235.40 in chips) 
TonnaMunz: posts small blind $1
tipner: posts big blind $2
docmarc777: sits out 
*** HOLE CARDS ***
Dealt to matiko09 [5d Jh]
RyanHuJun: folds 
coinflip_si: folds 
Fish4trips: folds 
matiko09: folds 
Glushchenko: folds 
T0ny Adams: raises $2.28 to $4.28
TonnaMunz: folds 
tipner: folds 
Uncalled bet ($2.28) returned to T0ny Adams
T0ny Adams collected $5 from pot
T0ny Adams: doesn't show hand 
*** SUMMARY ***
Total pot $5 | Rake $0 
Seat 1: coinflip_si folded before Flop (didn't bet)
Seat 2: Fish4trips folded before Flop (didn't bet)
Seat 3: matiko09 folded before Flop (didn't bet)
Seat 4: Glushchenko folded before Flop (didn't bet)
Seat 5: T0ny Adams (button) collected ($5)
Seat 6: TonnaMunz (small blind) folded before Flop
Seat 7: tipner (big blind) folded before Flop
Seat 9: RyanHuJun folded before Flop (didn't bet)





PokerStars Hand #151941745508:  Hold'em No Limit ($0.50/$1.00 USD) - 2016/04/15 12:56:43 CET [2016/04/15 6:56:43 ET]
Table 'Matterania III' 9-max Seat #1 is the button
Seat 1: di0d80 ($102.44 in chips) 
Seat 3: ardo888 ($129.09 in chips) 
Seat 4: wangzhuoming ($100 in chips) 
Seat 5: Vermm ($81.75 in chips) 
Seat 6: matiko09 ($100 in chips) 
Seat 7: Yaaaazz ($110.76 in chips) 
Seat 8: haoyuan541 ($102.52 in chips) 
Seat 9: flk.Dasas ($101.20 in chips) 
ardo888: posts small blind $0.50
wangzhuoming: posts big blind $1
di0d80: posts the ante $0.20
ardo888: posts the ante $0.20
wangzhuoming: posts the ante $0.20
Vermm: posts the ante $0.20
matiko09: posts the ante $0.20
Yaaaazz: posts the ante $0.20
haoyuan541: posts the ante $0.20
flk.Dasas: posts the ante $0.20
*** HOLE CARDS ***
Dealt to matiko09 [3c Ad]
Vermm: folds 
matiko09: folds 
Yaaaazz: folds 
haoyuan541: folds 
flk.Dasas: folds 
di0d80: folds 
ardo888: folds 
Uncalled bet ($0.50) returned to wangzhuoming
wangzhuoming collected $2.60 from pot
wangzhuoming: doesn't show hand 
*** SUMMARY ***
Total pot $2.60 | Rake $0 
Seat 1: di0d80 (button) folded before Flop (didn't bet)
Seat 3: ardo888 (small blind) folded before Flop
Seat 4: wangzhuoming (big blind) collected ($2.60)
Seat 5: Vermm folded before Flop (didn't bet)
Seat 6: matiko09 folded before Flop (didn't bet)
Seat 7: Yaaaazz folded before Flop (didn't bet)
Seat 8: haoyuan541 folded before Flop (didn't bet)
Seat 9: flk.Dasas folded before Flop (didn't bet)





PokerStars Hand #151941745942:  Hold'em No Limit ($1/$2 USD) - 2016/04/15 12:56:44 CET [2016/04/15 6:56:44 ET]
Table 'Adele II' 9-max Seat #6 is the button
Seat 1: coinflip_si ($200 in chips) 
Seat 2: Fish4trips ($206 in chips) 
Seat 3: matiko09 ($396.67 in chips) 
Seat 4: Glushchenko ($200 in chips) 
Seat 5: T0ny Adams ($94.04 in chips) 
Seat 6: TonnaMunz ($200 in chips) 
Seat 7: tipner ($200 in chips) 
Seat 8: docmarc777 ($200 in chips) 
Seat 9: RyanHuJun ($235.40 in chips) 
tipner: posts small blind $1
docmarc777: posts big blind $2
*** HOLE CARDS ***
Dealt to matiko09 [Jd Ac]
RyanHuJun: folds 
coinflip_si: raises $3 to $5
Fish4trips: folds 
matiko09: folds 
Glushchenko: folds 
T0ny Adams: folds 
TonnaMunz: folds 
tipner: folds 
docmarc777: folds 
Uncalled bet ($3) returned to coinflip_si
coinflip_si collected $5 from pot
coinflip_si: doesn't show hand 
*** SUMMARY ***
Total pot $5 | Rake $0 
Seat 1: coinflip_si collected ($5)
Seat 2: Fish4trips folded before Flop (didn't bet)
Seat 3: matiko09 folded before Flop (didn't bet)
Seat 4: Glushchenko folded before Flop (didn't bet)
Seat 5: T0ny Adams folded before Flop (didn't bet)
Seat 6: TonnaMunz (button) folded before Flop (didn't bet)
Seat 7: tipner (small blind) folded before Flop
Seat 8: docmarc777 (big blind) folded before Flop
Seat 9: RyanHuJun folded before Flop (didn't bet)





PokerStars Hand #151941751177:  Hold'em No Limit ($0.50/$1.00 USD) - 2016/04/15 12:56:57 CET [2016/04/15 6:56:57 ET]
Table 'Chiny II' 9-max Seat #3 is the button
Seat 1: CI58 ($128.59 in chips) 
Seat 2: AceFarky ($102.93 in chips) 
Seat 3: powerbel ($39.30 in chips) 
Seat 4: 1000karlos ($89.27 in chips) 
Seat 5: Yaaaazz ($125.78 in chips) 
Seat 6: choupai ($33.38 in chips) 
Seat 7: matiko09 ($111.60 in chips) 
Seat 8: djammusic ($40 in chips) 
Seat 9: ardo888 ($106.62 in chips) 
1000karlos: posts small blind $0.50
Yaaaazz: posts big blind $1
*** HOLE CARDS ***
Dealt to matiko09 [6s Qd]
choupai: folds 
matiko09: folds 
djammusic: folds 
ardo888: folds 
CI58: folds 
AceFarky: folds 
powerbel: folds 
1000karlos: raises $2 to $3
Yaaaazz: folds 
Uncalled bet ($2) returned to 1000karlos
1000karlos collected $2 from pot
*** SUMMARY ***
Total pot $2 | Rake $0 
Seat 1: CI58 folded before Flop (didn't bet)
Seat 2: AceFarky folded before Flop (didn't bet)
Seat 3: powerbel (button) folded before Flop (didn't bet)
Seat 4: 1000karlos (small blind) collected ($2)
Seat 5: Yaaaazz (big blind) folded before Flop
Seat 6: choupai folded before Flop (didn't bet)
Seat 7: matiko09 folded before Flop (didn't bet)
Seat 8: djammusic folded before Flop (didn't bet)
Seat 9: ardo888 folded before Flop (didn't bet)





PokerStars Hand #151941751166:  Hold'em No Limit ($1/$2 USD) - 2016/04/15 12:56:57 CET [2016/04/15 6:56:57 ET]
Table 'Patroclus II' 9-max Seat #7 is the button
Seat 1: TonnaMunz ($219.46 in chips) 
Seat 2: rmanjkeee ($80 in chips) 
Seat 3: Koolniknik ($184.75 in chips) 
Seat 4: tipner ($200 in chips) 
Seat 5: butcheN18 ($224 in chips) 
Seat 7: matiko09 ($202 in chips) 
Seat 8: Glushchenko ($200 in chips) 
Seat 9: Fish4trips ($205.35 in chips) 
Glushchenko: posts small blind $1
Fish4trips: posts big blind $2
*** HOLE CARDS ***
Dealt to matiko09 [7c 8c]
TonnaMunz: raises $2.96 to $4.96
rmanjkeee: folds 
Koolniknik: folds 
tipner: folds 
butcheN18: folds 
matiko09: folds 
Glushchenko: folds 
Fish4trips: folds 
Uncalled bet ($2.96) returned to TonnaMunz
TonnaMunz collected $5 from pot
TonnaMunz: doesn't show hand 
*** SUMMARY ***
Total pot $5 | Rake $0 
Seat 1: TonnaMunz collected ($5)
Seat 2: rmanjkeee folded before Flop (didn't bet)
Seat 3: Koolniknik folded before Flop (didn't bet)
Seat 4: tipner folded before Flop (didn't bet)
Seat 5: butcheN18 folded before Flop (didn't bet)
Seat 7: matiko09 (button) folded before Flop (didn't bet)
Seat 8: Glushchenko (small blind) folded before Flop
Seat 9: Fish4trips (big blind) folded before Flop





PokerStars Hand #151941756314:  Hold'em No Limit ($0.50/$1.00 USD) - 2016/04/15 12:57:09 CET [2016/04/15 6:57:09 ET]
Table 'Matterania III' 9-max Seat #3 is the button
Seat 1: di0d80 ($102.24 in chips) 
Seat 3: ardo888 ($128.39 in chips) 
Seat 4: wangzhuoming ($101.90 in chips) 
Seat 5: Vermm ($81.55 in chips) 
Seat 6: matiko09 ($100 in chips) 
Seat 7: Yaaaazz ($110.56 in chips) 
Seat 8: haoyuan541 ($102.32 in chips) 
Seat 9: flk.Dasas ($101 in chips) 
wangzhuoming: posts small blind $0.50
Vermm: posts big blind $1
di0d80: posts the ante $0.20
ardo888: posts the ante $0.20
wangzhuoming: posts the ante $0.20
Vermm: posts the ante $0.20
matiko09: posts the ante $0.20
Yaaaazz: posts the ante $0.20
haoyuan541: posts the ante $0.20
flk.Dasas: posts the ante $0.20
*** HOLE CARDS ***
Dealt to matiko09 [Td 2h]
matiko09: folds 
Yaaaazz: folds 
haoyuan541: folds 
flk.Dasas: folds 
di0d80: folds 
ardo888: raises $1.50 to $2.50
wangzhuoming: calls $2
Vermm: folds 
*** FLOP *** [4s Kc 9c]
wangzhuoming: checks 
ardo888: bets $3.82
wangzhuoming: raises $5.18 to $9
ardo888: folds 
Uncalled bet ($5.18) returned to wangzhuoming
wangzhuoming collected $14.48 from pot
wangzhuoming: doesn't show hand 
*** SUMMARY ***
Total pot $15.24 | Rake $0.76 
Board [4s Kc 9c]
Seat 1: di0d80 folded before Flop (didn't bet)
Seat 3: ardo888 (button) folded on the Flop
Seat 4: wangzhuoming (small blind) collected ($14.48)
Seat 5: Vermm (big blind) folded before Flop
Seat 6: matiko09 folded before Flop (didn't bet)
Seat 7: Yaaaazz folded before Flop (didn't bet)
Seat 8: haoyuan541 folded before Flop (didn't bet)
Seat 9: flk.Dasas folded before Flop (didn't bet)





PokerStars Hand #151941757479:  Hold'em No Limit ($0.50/$1.00 USD) - 2016/04/15 12:57:12 CET [2016/04/15 6:57:12 ET]
Table 'Lamberta III' 9-max Seat #8 is the button
Seat 2: Vermm ($81.32 in chips) 
Seat 3: butcheN18 ($107.44 in chips) 
Seat 5: tipner ($100 in chips) 
Seat 7: ardo888 ($124.79 in chips) 
Seat 8: djammusic ($40 in chips) 
Seat 9: matiko09 ($153.87 in chips) 
matiko09: posts small blind $0.50
di0d80: is sitting out 
Vermm: posts big blind $1
Filojoes: sits out 
*** HOLE CARDS ***
Dealt to matiko09 [Qc 6c]
di0d80 leaves the table
butcheN18: folds 
vrnMike joins the table at seat #1 
tipner: raises $2 to $3
ardo888: folds 
djammusic: folds 
matiko09: folds 
Vermm: calls $2
*** FLOP *** [9h 8h 4d]
Vermm: checks 
tipner: checks 
*** TURN *** [9h 8h 4d] [8c]
Vermm: bets $4
tipner: calls $4
*** RIVER *** [9h 8h 4d 8c] [As]
Vermm: bets $6.89
tipner: calls $6.89
*** SHOW DOWN ***
Vermm: shows [8s Qs] (three of a kind, Eights)
tipner: mucks hand 
Vermm collected $26.87 from pot
*** SUMMARY ***
Total pot $28.28 | Rake $1.41 
Board [9h 8h 4d 8c As]
Seat 2: Vermm (big blind) showed [8s Qs] and won ($26.87) with three of a kind, Eights
Seat 3: butcheN18 folded before Flop (didn't bet)
Seat 5: tipner mucked [Ac Tc]
Seat 7: ardo888 folded before Flop (didn't bet)
Seat 8: djammusic (button) folded before Flop (didn't bet)
Seat 9: matiko09 (small blind) folded before Flop





PokerStars Hand #151941761303:  Hold'em No Limit ($1/$2 USD) - 2016/04/15 12:57:22 CET [2016/04/15 6:57:22 ET]
Table 'Adele II' 9-max Seat #7 is the button
Seat 1: coinflip_si ($203 in chips) 
Seat 2: Fish4trips ($206 in chips) 
Seat 3: matiko09 ($396.67 in chips) 
Seat 4: Glushchenko ($200 in chips) 
Seat 5: T0ny Adams ($94.04 in chips) 
Seat 6: TonnaMunz ($200 in chips) 
Seat 7: tipner ($200 in chips) 
Seat 8: docmarc777 ($200 in chips) 
Seat 9: RyanHuJun ($235.40 in chips) 
docmarc777: posts small blind $1
RyanHuJun: posts big blind $2
*** HOLE CARDS ***
Dealt to matiko09 [3c 4s]
coinflip_si: folds 
Fish4trips: folds 
matiko09: folds 
Glushchenko: folds 
T0ny Adams: folds 
TonnaMunz: folds 
tipner: raises $3 to $5
docmarc777: calls $4
RyanHuJun: calls $3
*** FLOP *** [4h 2s Jh]
docmarc777: checks 
RyanHuJun: checks 
tipner: bets $8
docmarc777: calls $8
RyanHuJun: calls $8
*** TURN *** [4h 2s Jh] [8s]
docmarc777: checks 
RyanHuJun: checks 
tipner: bets $20
docmarc777: folds 
RyanHuJun: calls $20
*** RIVER *** [4h 2s Jh 8s] [Kc]
RyanHuJun: checks 
tipner: checks 
*** SHOW DOWN ***
RyanHuJun: shows [9c Th] (high card King)
tipner: mucks hand 
RyanHuJun collected $76.25 from pot
*** SUMMARY ***
Total pot $79 | Rake $2.75 
Board [4h 2s Jh 8s Kc]
Seat 1: coinflip_si folded before Flop (didn't bet)
Seat 2: Fish4trips folded before Flop (didn't bet)
Seat 3: matiko09 folded before Flop (didn't bet)
Seat 4: Glushchenko folded before Flop (didn't bet)
Seat 5: T0ny Adams folded before Flop (didn't bet)
Seat 6: TonnaMunz folded before Flop (didn't bet)
Seat 7: tipner (button) mucked [6h 9h]
Seat 8: docmarc777 (small blind) folded on the Turn
Seat 9: RyanHuJun (big blind) showed [9c Th] and won ($76.25) with high card King





PokerStars Hand #151941761785:  Hold'em No Limit ($1/$2 USD) - 2016/04/15 12:57:23 CET [2016/04/15 6:57:23 ET]
Table 'Patroclus II' 9-max Seat #8 is the button
Seat 1: TonnaMunz ($222.46 in chips) 
Seat 2: rmanjkeee ($80 in chips) 
Seat 3: Koolniknik ($184.75 in chips) 
Seat 4: tipner ($200 in chips) 
Seat 5: butcheN18 ($224 in chips) 
Seat 7: matiko09 ($202 in chips) 
Seat 8: Glushchenko ($200 in chips) 
Seat 9: Fish4trips ($203.35 in chips) 
Fish4trips: posts small blind $1
TonnaMunz: posts big blind $2
*** HOLE CARDS ***
Dealt to matiko09 [2d Qc]
rmanjkeee: folds 
Koolniknik: folds 
tipner has timed out
tipner: folds 
butcheN18: folds 
chaps1988 leaves the table
matiko09: folds 
Glushchenko: folds 
Fish4trips: raises $3 to $5
di0d80 joins the table at seat #6 
TonnaMunz: folds 
Uncalled bet ($3) returned to Fish4trips
Fish4trips collected $4 from pot
Fish4trips: doesn't show hand 
*** SUMMARY ***
Total pot $4 | Rake $0 
Seat 1: TonnaMunz (big blind) folded before Flop
Seat 2: rmanjkeee folded before Flop (didn't bet)
Seat 3: Koolniknik folded before Flop (didn't bet)
Seat 4: tipner folded before Flop (didn't bet)
Seat 5: butcheN18 folded before Flop (didn't bet)
Seat 7: matiko09 folded before Flop (didn't bet)
Seat 8: Glushchenko (button) folded before Flop (didn't bet)
Seat 9: Fish4trips (small blind) collected ($4)





PokerStars Hand #151941762848:  Hold'em No Limit ($0.50/$1.00 USD) - 2016/04/15 12:57:26 CET [2016/04/15 6:57:26 ET]
Table 'Chiny II' 9-max Seat #4 is the button
Seat 1: CI58 ($128.59 in chips) 
Seat 2: AceFarky ($102.93 in chips) 
Seat 3: powerbel ($39.30 in chips) 
Seat 4: 1000karlos ($90.27 in chips) 
Seat 5: Yaaaazz ($124.78 in chips) 
Seat 6: choupai ($33.38 in chips) 
Seat 7: matiko09 ($111.60 in chips) 
Seat 8: djammusic ($40 in chips) 
Seat 9: ardo888 ($106.62 in chips) 
Yaaaazz: posts small blind $0.50
choupai: posts big blind $1
*** HOLE CARDS ***
Dealt to matiko09 [3s Ts]
matiko09: folds 
djammusic: folds 
ardo888: folds 
CI58: folds 
AceFarky: folds 
powerbel: raises $1 to $2
1000karlos: folds 
Yaaaazz: raises $5.50 to $7.50
choupai: folds 
powerbel: calls $5.50
*** FLOP *** [3h 3c Ac]
Yaaaazz: checks 
powerbel: bets $31.80 and is all-in
Yaaaazz: folds 
Uncalled bet ($31.80) returned to powerbel
powerbel collected $15.20 from pot
powerbel: doesn't show hand 
*** SUMMARY ***
Total pot $16 | Rake $0.80 
Board [3h 3c Ac]
Seat 1: CI58 folded before Flop (didn't bet)
Seat 2: AceFarky folded before Flop (didn't bet)
Seat 3: powerbel collected ($15.20)
Seat 4: 1000karlos (button) folded before Flop (didn't bet)
Seat 5: Yaaaazz (small blind) folded on the Flop
Seat 6: choupai (big blind) folded before Flop
Seat 7: matiko09 folded before Flop (didn't bet)
Seat 8: djammusic folded before Flop (didn't bet)
Seat 9: ardo888 folded before Flop (didn't bet)





PokerStars Hand #151941764397:  Hold'em No Limit ($0.50/$1.00 USD) - 2016/04/15 12:57:29 CET [2016/04/15 6:57:29 ET]
Table 'Navi' 9-max Seat #7 is the button
Seat 1: vrnMike ($139.33 in chips) 
Seat 2: butcheN18 ($100 in chips) 
Seat 4: Effort92 ($138.01 in chips) 
Seat 5: StarsAbove ($103.18 in chips) 
Seat 6: Glushchenko ($111.66 in chips) 
Seat 7: yoshidao ($80.53 in chips) 
Seat 8: SPmaka ($142.55 in chips) 
Seat 9: matiko09 ($100 in chips) 
SPmaka: posts small blind $0.50
matiko09: posts big blind $1
*** HOLE CARDS ***
Dealt to matiko09 [9c Th]
vrnMike: folds 
butcheN18: folds 
Effort92: raises $2 to $3
StarsAbove: folds 
Glushchenko: folds 
yoshidao: calls $3
SPmaka: folds 
matiko09: calls $2
*** FLOP *** [Ts 5h Qd]
SPmaka leaves the table
matiko09: checks 
Effort92: bets $5
yoshidao: calls $5
matiko09: folds 
*** TURN *** [Ts 5h Qd] [8d]
djammusic joins the table at seat #8 
Effort92: bets $13
yoshidao: folds 
Uncalled bet ($13) returned to Effort92
Effort92 collected $18.52 from pot
Effort92: doesn't show hand 
*** SUMMARY ***
Total pot $19.50 | Rake $0.98 
Board [Ts 5h Qd 8d]
Seat 1: vrnMike folded before Flop (didn't bet)
Seat 2: butcheN18 folded before Flop (didn't bet)
Seat 4: Effort92 collected ($18.52)
Seat 5: StarsAbove folded before Flop (didn't bet)
Seat 6: Glushchenko folded before Flop (didn't bet)
Seat 7: yoshidao (button) folded on the Turn
Seat 8: SPmaka (small blind) folded before Flop
Seat 9: matiko09 (big blind) folded on the Flop





PokerStars Hand #151941767326:  Hold'em No Limit ($0.50/$1.00 USD) - 2016/04/15 12:57:37 CET [2016/04/15 6:57:37 ET]
Table 'Matterania III' 9-max Seat #4 is the button
Seat 1: di0d80 ($102.04 in chips) 
Seat 3: ardo888 ($121.87 in chips) 
Seat 4: wangzhuoming ($109.86 in chips) 
Seat 5: Vermm ($80.35 in chips) 
Seat 6: matiko09 ($100 in chips) 
Seat 7: Yaaaazz ($110.36 in chips) 
Seat 8: haoyuan541 ($102.12 in chips) 
Seat 9: flk.Dasas ($100.80 in chips) 
Vermm: posts small blind $0.50
matiko09: posts big blind $1
aseban11: sits out 
di0d80: posts the ante $0.20
ardo888: posts the ante $0.20
wangzhuoming: posts the ante $0.20
Vermm: posts the ante $0.20
matiko09: posts the ante $0.20
Yaaaazz: posts the ante $0.20
haoyuan541: posts the ante $0.20
flk.Dasas: posts the ante $0.20
*** HOLE CARDS ***
Dealt to matiko09 [2h 3c]
Yaaaazz: folds 
haoyuan541: folds 
flk.Dasas: folds 
di0d80: folds 
ardo888: folds 
wangzhuoming: folds 
Vermm: folds 
Uncalled bet ($0.50) returned to matiko09
matiko09 collected $2.60 from pot
matiko09: doesn't show hand 
*** SUMMARY ***
Total pot $2.60 | Rake $0 
Seat 1: di0d80 folded before Flop (didn't bet)
Seat 3: ardo888 folded before Flop (didn't bet)
Seat 4: wangzhuoming (button) folded before Flop (didn't bet)
Seat 5: Vermm (small blind) folded before Flop
Seat 6: matiko09 (big blind) collected ($2.60)
Seat 7: Yaaaazz folded before Flop (didn't bet)
Seat 8: haoyuan541 folded before Flop (didn't bet)
Seat 9: flk.Dasas folded before Flop (didn't bet)





PokerStars Hand #151941782250:  Hold'em No Limit ($0.50/$1.00 USD) - 2016/04/15 12:58:14 CET [2016/04/15 6:58:14 ET]
Table 'Lamberta III' 9-max Seat #9 is the button
Seat 2: Vermm ($94.30 in chips) 
Seat 3: butcheN18 ($107.44 in chips) 
Seat 5: tipner ($100 in chips) 
Seat 6: aseban11 ($101 in chips) 
Seat 7: ardo888 ($124.79 in chips) 
Seat 8: djammusic ($40 in chips) 
Seat 9: matiko09 ($153.37 in chips) 
vrnMike will be allowed to play after the button
Vermm: posts small blind $0.50
butcheN18: posts big blind $1
Filojoes: sits out 
*** HOLE CARDS ***
Dealt to matiko09 [Td 5c]
tipner: raises $2 to $3
aseban11: folds 
ardo888: folds 
djammusic: folds 
matiko09: folds 
Vermm: calls $2.50
butcheN18: folds 
*** FLOP *** [2d As Jc]
Vermm: checks 
tipner: checks 
*** TURN *** [2d As Jc] [8d]
Vermm: checks 
tipner: checks 
*** RIVER *** [2d As Jc 8d] [9s]
Vermm: checks 
tipner: checks 
*** SHOW DOWN ***
Vermm: shows [9d 6c] (a pair of Nines)
tipner: mucks hand 
Vermm collected $6.65 from pot
*** SUMMARY ***
Total pot $7 | Rake $0.35 
Board [2d As Jc 8d 9s]
Seat 2: Vermm (small blind) showed [9d 6c] and won ($6.65) with a pair of Nines
Seat 3: butcheN18 (big blind) folded before Flop
Seat 5: tipner mucked [7s 7d]
Seat 6: aseban11 folded before Flop (didn't bet)
Seat 7: ardo888 folded before Flop (didn't bet)
Seat 8: djammusic folded before Flop (didn't bet)
Seat 9: matiko09 (button) folded before Flop (didn't bet)





PokerStars Hand #151941783220:  Hold'em No Limit ($0.50/$1.00 USD) - 2016/04/15 12:58:16 CET [2016/04/15 6:58:16 ET]
Table 'Matterania III' 9-max Seat #5 is the button
Seat 1: di0d80 ($101.84 in chips) 
Seat 3: ardo888 ($121.67 in chips) 
Seat 4: wangzhuoming ($109.66 in chips) 
Seat 5: Vermm ($79.65 in chips) 
Seat 6: matiko09 ($101.90 in chips) 
Seat 7: Yaaaazz ($110.16 in chips) 
Seat 8: haoyuan541 ($101.92 in chips) 
Seat 9: flk.Dasas ($100.60 in chips) 
matiko09: posts small blind $0.50
Yaaaazz: posts big blind $1
aseban11: sits out 
di0d80: posts the ante $0.20
ardo888: posts the ante $0.20
wangzhuoming: posts the ante $0.20
Vermm: posts the ante $0.20
matiko09: posts the ante $0.20
Yaaaazz: posts the ante $0.20
haoyuan541: posts the ante $0.20
flk.Dasas: posts the ante $0.20
*** HOLE CARDS ***
Dealt to matiko09 [5s Jd]
haoyuan541: folds 
flk.Dasas: folds 
di0d80: folds 
ardo888: raises $2 to $3
wangzhuoming: folds 
Vermm: folds 
matiko09: folds 
Yaaaazz: folds 
Uncalled bet ($2) returned to ardo888
ardo888 collected $4.10 from pot
ardo888: doesn't show hand 
*** SUMMARY ***
Total pot $4.10 | Rake $0 
Seat 1: di0d80 folded before Flop (didn't bet)
Seat 3: ardo888 collected ($4.10)
Seat 4: wangzhuoming folded before Flop (didn't bet)
Seat 5: Vermm (button) folded before Flop (didn't bet)
Seat 6: matiko09 (small blind) folded before Flop
Seat 7: Yaaaazz (big blind) folded before Flop
Seat 8: haoyuan541 folded before Flop (didn't bet)
Seat 9: flk.Dasas folded before Flop (didn't bet)





PokerStars Hand #151941788531:  Hold'em No Limit ($1/$2 USD) - 2016/04/15 12:58:30 CET [2016/04/15 6:58:30 ET]
Table 'Patroclus II' 9-max Seat #9 is the button
Seat 1: TonnaMunz ($220.46 in chips) 
Seat 3: Koolniknik ($184.75 in chips) 
Seat 5: butcheN18 ($224 in chips) 
Seat 7: matiko09 ($202 in chips) 
Seat 8: Glushchenko ($200 in chips) 
Seat 9: Fish4trips ($205.35 in chips) 
TonnaMunz: posts small blind $1
rmanjkeee: is sitting out 
Koolniknik: posts big blind $2
di0d80: sits out 
*** HOLE CARDS ***
Dealt to matiko09 [7c Jd]
butcheN18: folds 
matiko09: folds 
Glushchenko: folds 
Fish4trips: folds 
TonnaMunz: raises $3.88 to $5.88
rmanjkeee leaves the table
Koolniknik is disconnected 
Koolniknik is connected 
Moemors joins the table at seat #2 
Koolniknik: folds 
Uncalled bet ($3.88) returned to TonnaMunz
TonnaMunz collected $4 from pot
TonnaMunz: doesn't show hand 
*** SUMMARY ***
Total pot $4 | Rake $0 
Seat 1: TonnaMunz (small blind) collected ($4)
Seat 3: Koolniknik (big blind) folded before Flop
Seat 5: butcheN18 folded before Flop (didn't bet)
Seat 7: matiko09 folded before Flop (didn't bet)
Seat 8: Glushchenko folded before Flop (didn't bet)
Seat 9: Fish4trips (button) folded before Flop (didn't bet)





PokerStars Hand #151941790991:  Hold'em No Limit ($0.50/$1.00 USD) - 2016/04/15 12:58:36 CET [2016/04/15 6:58:36 ET]
Table 'Chiny II' 9-max Seat #5 is the button
Seat 1: CI58 ($128.59 in chips) 
Seat 2: AceFarky ($102.93 in chips) 
Seat 3: powerbel ($47 in chips) 
Seat 4: 1000karlos ($90.27 in chips) 
Seat 5: Yaaaazz ($117.28 in chips) 
Seat 6: choupai ($32.38 in chips) 
Seat 7: matiko09 ($111.60 in chips) 
Seat 8: djammusic ($40 in chips) 
Seat 9: ardo888 ($106.62 in chips) 
choupai: posts small blind $0.50
matiko09: posts big blind $1
*** HOLE CARDS ***
Dealt to matiko09 [Ad Kc]
djammusic: folds 
ardo888: folds 
CI58: folds 
AceFarky: folds 
powerbel: folds 
djammusic leaves the table
1000karlos has timed out
1000karlos: folds 
Yaaaazz: folds 
choupai: raises $2 to $3
matiko09: raises $5.50 to $8.50
SanychStar joins the table at seat #8 
choupai: calls $5.50
*** FLOP *** [Jh Qd 6c]
choupai: bets $23.88 and is all-in
matiko09: calls $23.88
*** TURN *** [Jh Qd 6c] [As]
*** RIVER *** [Jh Qd 6c As] [Td]
*** SHOW DOWN ***
choupai: shows [7c 7h] (a pair of Sevens)
matiko09: shows [Ad Kc] (a straight, Ten to Ace)
matiko09 collected $62.26 from pot
*** SUMMARY ***
Total pot $64.76 | Rake $2.50 
Board [Jh Qd 6c As Td]
Seat 1: CI58 folded before Flop (didn't bet)
Seat 2: AceFarky folded before Flop (didn't bet)
Seat 3: powerbel folded before Flop (didn't bet)
Seat 4: 1000karlos folded before Flop (didn't bet)
Seat 5: Yaaaazz (button) folded before Flop (didn't bet)
Seat 6: choupai (small blind) showed [7c 7h] and lost with a pair of Sevens
Seat 7: matiko09 (big blind) showed [Ad Kc] and won ($62.26) with a straight, Ten to Ace
Seat 8: djammusic folded before Flop (didn't bet)
Seat 9: ardo888 folded before Flop (didn't bet)





PokerStars Hand #151941798058:  Hold'em No Limit ($0.50/$1.00 USD) - 2016/04/15 12:58:53 CET [2016/04/15 6:58:53 ET]
Table 'Navi' 9-max Seat #9 is the button
Seat 1: vrnMike ($139.33 in chips) 
Seat 2: butcheN18 ($100 in chips) 
Seat 4: Effort92 ($148.53 in chips) 
Seat 5: StarsAbove ($103.18 in chips) 
Seat 6: Glushchenko ($111.66 in chips) 
Seat 7: yoshidao ($72.53 in chips) 
Seat 9: matiko09 ($100 in chips) 
vrnMike: posts small blind $0.50
butcheN18: posts big blind $1
djammusic: sits out 
*** HOLE CARDS ***
Dealt to matiko09 [Jd Td]
Effort92: raises $1.50 to $2.50
StarsAbove: folds 
Glushchenko: raises $7 to $9.50
yoshidao: folds 
matiko09: folds 
vrnMike: folds 
butcheN18: folds 
Effort92: folds 
Uncalled bet ($7) returned to Glushchenko
Glushchenko collected $6.50 from pot
*** SUMMARY ***
Total pot $6.50 | Rake $0 
Seat 1: vrnMike (small blind) folded before Flop
Seat 2: butcheN18 (big blind) folded before Flop
Seat 4: Effort92 folded before Flop
Seat 5: StarsAbove folded before Flop (didn't bet)
Seat 6: Glushchenko collected ($6.50)
Seat 7: yoshidao folded before Flop (didn't bet)
Seat 9: matiko09 (button) folded before Flop (didn't bet)





PokerStars Hand #151941798198:  Hold'em No Limit ($0.50/$1.00 USD) - 2016/04/15 12:58:54 CET [2016/04/15 6:58:54 ET]
Table 'Matterania III' 9-max Seat #6 is the button
Seat 1: di0d80 ($101.64 in chips) 
Seat 3: ardo888 ($124.57 in chips) 
Seat 4: wangzhuoming ($109.46 in chips) 
Seat 5: Vermm ($79.45 in chips) 
Seat 6: matiko09 ($101.20 in chips) 
Seat 7: Yaaaazz ($108.96 in chips) 
Seat 9: flk.Dasas ($100.40 in chips) 
Yaaaazz: posts small blind $0.50
flk.Dasas: posts big blind $1
aseban11: sits out 
di0d80: posts the ante $0.20
ardo888: posts the ante $0.20
wangzhuoming: posts the ante $0.20
Vermm: posts the ante $0.20
matiko09: posts the ante $0.20
Yaaaazz: posts the ante $0.20
flk.Dasas: posts the ante $0.20
*** HOLE CARDS ***
Dealt to matiko09 [Ks 7s]
di0d80: folds 
ardo888: folds 
wangzhuoming: raises $2 to $3
Vermm: calls $3
matiko09: folds 
Yaaaazz: folds 
flk.Dasas: calls $2
*** FLOP *** [4s Ts Kh]
flk.Dasas: checks 
wangzhuoming: bets $5
Vermm: folds 
haoyuan541 is disconnected 
flk.Dasas: folds 
Uncalled bet ($5) returned to wangzhuoming
wangzhuoming collected $10.36 from pot
wangzhuoming: doesn't show hand 
*** SUMMARY ***
Total pot $10.90 | Rake $0.54 
Board [4s Ts Kh]
Seat 1: di0d80 folded before Flop (didn't bet)
Seat 3: ardo888 folded before Flop (didn't bet)
Seat 4: wangzhuoming collected ($10.36)
Seat 5: Vermm folded on the Flop
Seat 6: matiko09 (button) folded before Flop (didn't bet)
Seat 7: Yaaaazz (small blind) folded before Flop
Seat 9: flk.Dasas (big blind) folded on the Flop





PokerStars Hand #151941801476:  Hold'em No Limit ($0.50/$1.00 USD) - 2016/04/15 12:59:02 CET [2016/04/15 6:59:02 ET]
Table 'Lamberta III' 9-max Seat #2 is the button
Seat 2: Vermm ($97.95 in chips) 
Seat 3: butcheN18 ($106.44 in chips) 
Seat 4: Filojoes ($100 in chips) 
Seat 5: tipner ($100 in chips) 
Seat 6: aseban11 ($101 in chips) 
Seat 7: ardo888 ($124.79 in chips) 
Seat 8: djammusic ($40 in chips) 
Seat 9: matiko09 ($153.37 in chips) 
butcheN18: posts small blind $0.50
Filojoes: posts big blind $1
vrnMike: sits out 
*** HOLE CARDS ***
Dealt to matiko09 [5c Qh]
tipner: raises $2 to $3
aseban11: folds 
ardo888: folds 
djammusic: folds 
matiko09: folds 
Vermm: calls $3
butcheN18: folds 
Filojoes: folds 
*** FLOP *** [7h Ad 4h]
tipner: bets $4
Vermm: calls $4
*** TURN *** [7h Ad 4h] [2c]
tipner: checks 
Vermm: bets $7.36
tipner: calls $7.36
*** RIVER *** [7h Ad 4h 2c] [Qd]
tipner: checks 
Vermm: checks 
*** SHOW DOWN ***
tipner: shows [Kc Kh] (a pair of Kings)
Vermm: mucks hand 
tipner collected $28.71 from pot
*** SUMMARY ***
Total pot $30.22 | Rake $1.51 
Board [7h Ad 4h 2c Qd]
Seat 2: Vermm (button) mucked [8d 6h]
Seat 3: butcheN18 (small blind) folded before Flop
Seat 4: Filojoes (big blind) folded before Flop
Seat 5: tipner showed [Kc Kh] and won ($28.71) with a pair of Kings
Seat 6: aseban11 folded before Flop (didn't bet)
Seat 7: ardo888 folded before Flop (didn't bet)
Seat 8: djammusic folded before Flop (didn't bet)
Seat 9: matiko09 folded before Flop (didn't bet)





PokerStars Hand #151941805707:  Hold'em No Limit ($1/$2 USD) - 2016/04/15 12:59:12 CET [2016/04/15 6:59:12 ET]
Table 'Adele II' 9-max Seat #8 is the button
Seat 1: coinflip_si ($203 in chips) 
Seat 2: Fish4trips ($206 in chips) 
Seat 3: matiko09 ($396.67 in chips) 
Seat 4: Glushchenko ($200 in chips) 
Seat 5: T0ny Adams ($94.04 in chips) 
Seat 6: TonnaMunz ($200 in chips) 
Seat 7: tipner ($200 in chips) 
Seat 8: docmarc777 ($200 in chips) 
Seat 9: RyanHuJun ($278.65 in chips) 
RyanHuJun: posts small blind $1
coinflip_si: posts big blind $2
*** HOLE CARDS ***
Dealt to matiko09 [4d 5s]
Fish4trips: folds 
matiko09: folds 
Glushchenko: folds 
T0ny Adams: raises $2.68 to $4.68
TonnaMunz: folds 
tipner: folds 
docmarc777: folds 
RyanHuJun: calls $3.68
coinflip_si: folds 
*** FLOP *** [6s 5h 5c]
RyanHuJun: checks 
T0ny Adams: checks 
*** TURN *** [6s 5h 5c] [9d]
RyanHuJun: bets $6
T0ny Adams: calls $6
*** RIVER *** [6s 5h 5c 9d] [As]
RyanHuJun: checks 
T0ny Adams: bets $7
RyanHuJun: folds 
Uncalled bet ($7) returned to T0ny Adams
T0ny Adams collected $22.19 from pot
T0ny Adams: doesn't show hand 
*** SUMMARY ***
Total pot $23.36 | Rake $1.17 
Board [6s 5h 5c 9d As]
Seat 1: coinflip_si (big blind) folded before Flop
Seat 2: Fish4trips folded before Flop (didn't bet)
Seat 3: matiko09 folded before Flop (didn't bet)
Seat 4: Glushchenko folded before Flop (didn't bet)
Seat 5: T0ny Adams collected ($22.19)
Seat 6: TonnaMunz folded before Flop (didn't bet)
Seat 7: tipner folded before Flop (didn't bet)
Seat 8: docmarc777 (button) folded before Flop (didn't bet)
Seat 9: RyanHuJun (small blind) folded on the River





PokerStars Hand #151941806881:  Hold'em No Limit ($0.50/$1.00 USD) - 2016/04/15 12:59:15 CET [2016/04/15 6:59:15 ET]
Table 'Navi' 9-max Seat #1 is the button
Seat 1: vrnMike ($138.83 in chips) 
Seat 2: butcheN18 ($100 in chips) 
Seat 4: Effort92 ($146.03 in chips) 
Seat 5: StarsAbove ($103.18 in chips) 
Seat 6: Glushchenko ($115.66 in chips) 
Seat 7: yoshidao ($72.53 in chips) 
Seat 9: matiko09 ($100 in chips) 
butcheN18: posts small blind $0.50
Effort92: posts big blind $1
djammusic: sits out 
*** HOLE CARDS ***
Dealt to matiko09 [9h Qd]
StarsAbove: folds 
Glushchenko: folds 
yoshidao: calls $1
matiko09: folds 
vrnMike: raises $3.50 to $4.50
butcheN18: folds 
Effort92: folds 
yoshidao: calls $3.50
*** FLOP *** [4s Qc 3s]
yoshidao: bets $6
vrnMike: folds 
Uncalled bet ($6) returned to yoshidao
yoshidao collected $9.98 from pot
yoshidao: doesn't show hand 
*** SUMMARY ***
Total pot $10.50 | Rake $0.52 
Board [4s Qc 3s]
Seat 1: vrnMike (button) folded on the Flop
Seat 2: butcheN18 (small blind) folded before Flop
Seat 4: Effort92 (big blind) folded before Flop
Seat 5: StarsAbove folded before Flop (didn't bet)
Seat 6: Glushchenko folded before Flop (didn't bet)
Seat 7: yoshidao collected ($9.98)
Seat 9: matiko09 folded before Flop (didn't bet)





PokerStars Hand #151941807355:  Hold'em No Limit ($0.50/$1.00 USD) - 2016/04/15 12:59:16 CET [2016/04/15 6:59:16 ET]
Table 'Gase II' 9-max Seat #1 is the button
Seat 1: maxxmeister ($101.75 in chips) 
Seat 5: Paul6999 ($40.50 in chips) 
Seat 6: matiko09 ($100 in chips) 
Seat 8: choupai ($122.67 in chips) 
Paul6999: posts small blind $0.50
matiko09: posts big blind $1
*** HOLE CARDS ***
Dealt to matiko09 [Ac Js]
choupai: folds 
UberLycan joins the table at seat #9 
maxxmeister: folds 
Paul6999: folds 
Uncalled bet ($0.50) returned to matiko09
matiko09 collected $1 from pot
matiko09: doesn't show hand 
*** SUMMARY ***
Total pot $1 | Rake $0 
Seat 1: maxxmeister (button) folded before Flop (didn't bet)
Seat 5: Paul6999 (small blind) folded before Flop
Seat 6: matiko09 (big blind) collected ($1)
Seat 8: choupai folded before Flop (didn't bet)





PokerStars Hand #151941810687:  Hold'em No Limit ($1/$2 USD) - 2016/04/15 12:59:25 CET [2016/04/15 6:59:25 ET]
Table 'Patroclus II' 9-max Seat #1 is the button
Seat 1: TonnaMunz ($222.46 in chips) 
Seat 3: Koolniknik ($182.75 in chips) 
Seat 4: tipner ($200 in chips) 
Seat 5: butcheN18 ($224 in chips) 
Seat 7: matiko09 ($202 in chips) 
Seat 8: Glushchenko ($200 in chips) 
Seat 9: Fish4trips ($205.35 in chips) 
Moemors will be allowed to play after the button
Koolniknik: posts small blind $1
tipner: posts big blind $2
di0d80: sits out 
*** HOLE CARDS ***
Dealt to matiko09 [6c 4h]
butcheN18: folds 
matiko09: folds 
Glushchenko: folds 
Fish4trips: folds 
TonnaMunz: folds 
Koolniknik: raises $4 to $6
tipner: raises $12 to $18
Koolniknik: folds 
Uncalled bet ($12) returned to tipner
tipner collected $12 from pot
tipner: doesn't show hand 
*** SUMMARY ***
Total pot $12 | Rake $0 
Seat 1: TonnaMunz (button) folded before Flop (didn't bet)
Seat 3: Koolniknik (small blind) folded before Flop
Seat 4: tipner (big blind) collected ($12)
Seat 5: butcheN18 folded before Flop (didn't bet)
Seat 7: matiko09 folded before Flop (didn't bet)
Seat 8: Glushchenko folded before Flop (didn't bet)
Seat 9: Fish4trips folded before Flop (didn't bet)





PokerStars Hand #151941810625:  Hold'em No Limit ($0.50/$1.00 USD) - 2016/04/15 12:59:25 CET [2016/04/15 6:59:25 ET]
Table 'Gase II' 9-max Seat #5 is the button
Seat 1: maxxmeister ($101.75 in chips) 
Seat 5: Paul6999 ($40 in chips) 
Seat 6: matiko09 ($100.50 in chips) 
Seat 8: choupai ($122.67 in chips) 
matiko09: posts small blind $0.50
choupai: posts big blind $1
UberLycan: sits out 
*** HOLE CARDS ***
Dealt to matiko09 [2c Ks]
maxxmeister: folds 
aseban11 joins the table at seat #2 
Paul6999: folds 
tipner joins the table at seat #3 
Filojoes joins the table at seat #4 
matiko09: folds 
Uncalled bet ($0.50) returned to choupai
choupai collected $1 from pot
*** SUMMARY ***
Total pot $1 | Rake $0 
Seat 1: maxxmeister folded before Flop (didn't bet)
Seat 5: Paul6999 (button) folded before Flop (didn't bet)
Seat 6: matiko09 (small blind) folded before Flop
Seat 8: choupai (big blind) collected ($1)





PokerStars Hand #151941817855:  Hold'em No Limit ($0.50/$1.00 USD) - 2016/04/15 12:59:42 CET [2016/04/15 6:59:42 ET]
Table 'Gase II' 9-max Seat #6 is the button
Seat 1: maxxmeister ($101.75 in chips) 
Seat 5: Paul6999 ($40 in chips) 
Seat 6: matiko09 ($100 in chips) 
Seat 8: choupai ($123.17 in chips) 
Seat 9: UberLycan ($85.70 in chips) 
choupai: posts small blind $0.50
UberLycan: posts big blind $1
aseban11: sits out 
tipner: sits out 
Filojoes: sits out 
*** HOLE CARDS ***
Dealt to matiko09 [Ts 4d]
maxxmeister: raises $2.50 to $3.50
Paul6999: folds 
matiko09: folds 
choupai: folds 
UberLycan: folds 
Uncalled bet ($2.50) returned to maxxmeister
maxxmeister collected $2.50 from pot
maxxmeister: doesn't show hand 
*** SUMMARY ***
Total pot $2.50 | Rake $0 
Seat 1: maxxmeister collected ($2.50)
Seat 5: Paul6999 folded before Flop (didn't bet)
Seat 6: matiko09 (button) folded before Flop (didn't bet)
Seat 8: choupai (small blind) folded before Flop
Seat 9: UberLycan (big blind) folded before Flop





PokerStars Hand #151941818190:  Hold'em No Limit ($0.50/$1.00 USD) - 2016/04/15 12:59:43 CET [2016/04/15 6:59:43 ET]
Table 'Chiny II' 9-max Seat #7 is the button
Seat 1: CI58 ($128.59 in chips) 
Seat 2: AceFarky ($102.93 in chips) 
Seat 3: powerbel ($47 in chips) 
Seat 4: 1000karlos ($90.27 in chips) 
Seat 5: Yaaaazz ($117.28 in chips) 
Seat 7: matiko09 ($141.48 in chips) 
Seat 9: ardo888 ($106.62 in chips) 
ardo888: posts small blind $0.50
CI58: posts big blind $1
*** HOLE CARDS ***
Dealt to matiko09 [7c 4s]
AceFarky: folds 
powerbel: raises $1 to $2
1000karlos: folds 
Yaaaazz: raises $5.50 to $7.50
matiko09: folds 
ardo888: folds 
CI58: folds 
choupai is disconnected 
powerbel: raises $5.50 to $13
Yaaaazz: raises $104.28 to $117.28 and is all-in
powerbel: calls $34 and is all-in
Uncalled bet ($70.28) returned to Yaaaazz
*** FIRST FLOP *** [Td 8s Kd]
*** FIRST TURN *** [Td 8s Kd] [3c]
*** FIRST RIVER *** [Td 8s Kd 3c] [Qh]
*** SECOND FLOP *** [4d Jh 2h]
*** SECOND TURN *** [4d Jh 2h] [Th]
*** SECOND RIVER *** [4d Jh 2h Th] [Js]
*** FIRST SHOW DOWN ***
powerbel: shows [Kh Jd] (a pair of Kings)
Yaaaazz: shows [Ah Kc] (a pair of Kings - Ace kicker)
Yaaaazz collected $46.50 from pot
*** SECOND SHOW DOWN ***
powerbel: shows [Kh Jd] (three of a kind, Jacks)
Yaaaazz: shows [Ah Kc] (a pair of Jacks)
powerbel collected $46.50 from pot
*** SUMMARY ***
Total pot $95.50 | Rake $2.50 
Hand was run twice
FIRST Board [Td 8s Kd 3c Qh]
SECOND Board [4d Jh 2h Th Js]
Seat 1: CI58 (big blind) folded before Flop
Seat 2: AceFarky folded before Flop (didn't bet)
Seat 3: powerbel showed [Kh Jd] and lost with a pair of Kings, and won ($46.50) with three of a kind, Jacks
Seat 4: 1000karlos folded before Flop (didn't bet)
Seat 5: Yaaaazz showed [Ah Kc] and won ($46.50) with a pair of Kings, and lost with a pair of Jacks
Seat 7: matiko09 (button) folded before Flop (didn't bet)
Seat 9: ardo888 (small blind) folded before Flop





PokerStars Hand #151941823553:  Hold'em No Limit ($0.50/$1.00 USD) - 2016/04/15 12:59:57 CET [2016/04/15 6:59:57 ET]
Table 'Matterania III' 9-max Seat #7 is the button
Seat 1: di0d80 ($101.44 in chips) 
Seat 3: ardo888 ($124.37 in chips) 
Seat 4: wangzhuoming ($116.62 in chips) 
Seat 5: Vermm ($76.25 in chips) 
Seat 6: matiko09 ($101 in chips) 
Seat 7: Yaaaazz ($108.26 in chips) 
Seat 9: flk.Dasas ($100 in chips) 
flk.Dasas: posts small blind $0.50
di0d80: posts big blind $1
aseban11: sits out 
di0d80: posts the ante $0.20
ardo888: posts the ante $0.20
wangzhuoming: posts the ante $0.20
Vermm: posts the ante $0.20
matiko09: posts the ante $0.20
Yaaaazz: posts the ante $0.20
flk.Dasas: posts the ante $0.20
*** HOLE CARDS ***
Dealt to matiko09 [8c Qs]
ardo888: folds 
wangzhuoming: folds 
Vermm: folds 
matiko09: folds 
Yaaaazz: folds 
flk.Dasas: folds 
Uncalled bet ($0.50) returned to di0d80
di0d80 collected $2.40 from pot
di0d80: doesn't show hand 
*** SUMMARY ***
Total pot $2.40 | Rake $0 
Seat 1: di0d80 (big blind) collected ($2.40)
Seat 3: ardo888 folded before Flop (didn't bet)
Seat 4: wangzhuoming folded before Flop (didn't bet)
Seat 5: Vermm folded before Flop (didn't bet)
Seat 6: matiko09 folded before Flop (didn't bet)
Seat 7: Yaaaazz (button) folded before Flop (didn't bet)
Seat 9: flk.Dasas (small blind) folded before Flop





PokerStars Hand #151941824324:  Hold'em No Limit ($0.50/$1.00 USD) - 2016/04/15 12:59:58 CET [2016/04/15 6:59:58 ET]
Table 'Gase II' 9-max Seat #8 is the button
Seat 1: maxxmeister ($103.25 in chips) 
Seat 5: Paul6999 ($40 in chips) 
Seat 6: matiko09 ($100 in chips) 
Seat 8: choupai ($122.67 in chips) 
Seat 9: UberLycan ($84.70 in chips) 
UberLycan: posts small blind $0.50
maxxmeister: posts big blind $1
aseban11: sits out 
tipner: sits out 
Filojoes: sits out 
*** HOLE CARDS ***
Dealt to matiko09 [3d 5c]
Paul6999: folds 
matiko09: folds 
tipner leaves the table
danbo577 joins the table at seat #7 
choupai is disconnected 
djammusic joins the table at seat #3 
choupai is connected 
choupai: folds 
UberLycan: raises $2 to $3
maxxmeister: calls $2
*** FLOP *** [5d Ac 9s]
UberLycan: bets $3
maxxmeister: raises $7 to $10
UberLycan: calls $7
*** TURN *** [5d Ac 9s] [2h]
UberLycan: checks 
maxxmeister: bets $15.48
UberLycan: calls $15.48
*** RIVER *** [5d Ac 9s 2h] [Qh]
UberLycan: checks 
maxxmeister: checks 
*** SHOW DOWN ***
UberLycan: shows [Ks As] (a pair of Aces)
maxxmeister: mucks hand 
UberLycan collected $54.46 from pot
*** SUMMARY ***
Total pot $56.96 | Rake $2.50 
Board [5d Ac 9s 2h Qh]
Seat 1: maxxmeister (big blind) mucked [Qd 4d]
Seat 5: Paul6999 folded before Flop (didn't bet)
Seat 6: matiko09 folded before Flop (didn't bet)
Seat 8: choupai (button) folded before Flop (didn't bet)
Seat 9: UberLycan (small blind) showed [Ks As] and won ($54.46) with a pair of Aces





PokerStars Hand #151941824731:  Hold'em No Limit ($1/$2 USD) - 2016/04/15 12:59:59 CET [2016/04/15 6:59:59 ET]
Table 'Patroclus II' 9-max Seat #3 is the button
Seat 1: TonnaMunz ($222.46 in chips) 
Seat 2: Moemors ($150.89 in chips) 
Seat 3: Koolniknik ($176.75 in chips) 
Seat 4: tipner ($206 in chips) 
Seat 5: butcheN18 ($224 in chips) 
Seat 7: matiko09 ($202 in chips) 
Seat 8: Glushchenko ($200 in chips) 
Seat 9: Fish4trips ($205.35 in chips) 
tipner: posts small blind $1
butcheN18: posts big blind $2
di0d80: sits out 
Moemors: posts big blind $2
*** HOLE CARDS ***
Dealt to matiko09 [Tc 7s]
matiko09: folds 
Glushchenko: folds 
Fish4trips: folds 
TonnaMunz: folds 
Moemors: checks 
Koolniknik: raises $4 to $6
tipner: folds 
butcheN18: folds 
Moemors: folds 
Uncalled bet ($4) returned to Koolniknik
Koolniknik collected $7 from pot
Koolniknik: doesn't show hand 
*** SUMMARY ***
Total pot $7 | Rake $0 
Seat 1: TonnaMunz folded before Flop (didn't bet)
Seat 2: Moemors folded before Flop
Seat 3: Koolniknik (button) collected ($7)
Seat 4: tipner (small blind) folded before Flop
Seat 5: butcheN18 (big blind) folded before Flop
Seat 7: matiko09 folded before Flop (didn't bet)
Seat 8: Glushchenko folded before Flop (didn't bet)
Seat 9: Fish4trips folded before Flop (didn't bet)





PokerStars Hand #151941828296:  Hold'em No Limit ($0.50/$1.00 USD) - 2016/04/15 13:00:08 CET [2016/04/15 7:00:08 ET]
Table 'Navi' 9-max Seat #2 is the button
Seat 1: vrnMike ($134.33 in chips) 
Seat 2: butcheN18 ($100 in chips) 
Seat 4: Effort92 ($145.03 in chips) 
Seat 5: StarsAbove ($103.18 in chips) 
Seat 6: Glushchenko ($115.66 in chips) 
Seat 7: yoshidao ($78.01 in chips) 
Seat 9: matiko09 ($100 in chips) 
Effort92: posts small blind $0.50
StarsAbove: posts big blind $1
djammusic: sits out 
*** HOLE CARDS ***
Dealt to matiko09 [Th Jc]
Glushchenko: folds 
yoshidao: folds 
matiko09: folds 
vrnMike: folds 
butcheN18: folds 
Effort92: raises $1.50 to $2.50
StarsAbove: folds 
Uncalled bet ($1.50) returned to Effort92
Effort92 collected $2 from pot
Effort92: doesn't show hand 
*** SUMMARY ***
Total pot $2 | Rake $0 
Seat 1: vrnMike folded before Flop (didn't bet)
Seat 2: butcheN18 (button) folded before Flop (didn't bet)
Seat 4: Effort92 (small blind) collected ($2)
Seat 5: StarsAbove (big blind) folded before Flop
Seat 6: Glushchenko folded before Flop (didn't bet)
Seat 7: yoshidao folded before Flop (didn't bet)
Seat 9: matiko09 folded before Flop (didn't bet)





PokerStars Hand #151941828626:  Hold'em No Limit ($0.50/$1.00 USD) - 2016/04/15 13:00:08 CET [2016/04/15 7:00:08 ET]
Table 'Lamberta III' 9-max Seat #3 is the button
Seat 2: Vermm ($83.59 in chips) 
Seat 3: butcheN18 ($105.94 in chips) 
Seat 4: Filojoes ($100 in chips) 
Seat 6: aseban11 ($101 in chips) 
Seat 7: ardo888 ($124.79 in chips) 
Seat 8: djammusic ($40 in chips) 
Seat 9: matiko09 ($153.37 in chips) 
Filojoes: posts small blind $0.50
tipner: is sitting out 
aseban11: posts big blind $1
vrnMike: sits out 
*** HOLE CARDS ***
Dealt to matiko09 [6s 5d]
ardo888: folds 
djammusic: folds 
matiko09: folds 
Vermm: folds 
butcheN18: folds 
Filojoes: raises $1.50 to $2.50
aseban11: folds 
Uncalled bet ($1.50) returned to Filojoes
Filojoes collected $2 from pot
Filojoes: doesn't show hand 
*** SUMMARY ***
Total pot $2 | Rake $0 
Seat 2: Vermm folded before Flop (didn't bet)
Seat 3: butcheN18 (button) folded before Flop (didn't bet)
Seat 4: Filojoes (small blind) collected ($2)
Seat 6: aseban11 (big blind) folded before Flop
Seat 7: ardo888 folded before Flop (didn't bet)
Seat 8: djammusic folded before Flop (didn't bet)
Seat 9: matiko09 folded before Flop (didn't bet)





PokerStars Hand #151941836124:  Hold'em No Limit ($0.50/$1.00 USD) - 2016/04/15 13:00:27 CET [2016/04/15 7:00:27 ET]
Table 'Matterania III' 9-max Seat #9 is the button
Seat 1: di0d80 ($103.14 in chips) 
Seat 2: aseban11 ($104.64 in chips) 
Seat 3: ardo888 ($124.17 in chips) 
Seat 4: wangzhuoming ($116.42 in chips) 
Seat 5: Vermm ($76.05 in chips) 
Seat 6: matiko09 ($100.80 in chips) 
Seat 7: Yaaaazz ($108.06 in chips) 
Seat 9: flk.Dasas ($100 in chips) 
di0d80: posts small blind $0.50
aseban11: posts big blind $1
di0d80: posts the ante $0.20
aseban11: posts the ante $0.20
ardo888: posts the ante $0.20
wangzhuoming: posts the ante $0.20
Vermm: posts the ante $0.20
matiko09: posts the ante $0.20
Yaaaazz: posts the ante $0.20
flk.Dasas: posts the ante $0.20
*** HOLE CARDS ***
Dealt to matiko09 [Ks 5d]
ardo888: folds 
wangzhuoming: raises $2 to $3
Vermm: calls $3
matiko09: folds 
Yaaaazz: folds 
flk.Dasas: folds 
di0d80: folds 
aseban11: calls $2
*** FLOP *** [2s As 3h]
aseban11: checks 
wangzhuoming: checks 
Vermm: checks 
*** TURN *** [2s As 3h] [3s]
aseban11: bets $5.27
wangzhuoming: folds 
Vermm: calls $5.27
*** RIVER *** [2s As 3h 3s] [6s]
aseban11: checks 
Vermm: bets $67.58 and is all-in
aseban11: folds 
Uncalled bet ($67.58) returned to Vermm
Vermm collected $20.56 from pot
Vermm: doesn't show hand 
*** SUMMARY ***
Total pot $21.64 | Rake $1.08 
Board [2s As 3h 3s 6s]
Seat 1: di0d80 (small blind) folded before Flop
Seat 2: aseban11 (big blind) folded on the River
Seat 3: ardo888 folded before Flop (didn't bet)
Seat 4: wangzhuoming folded on the Turn
Seat 5: Vermm collected ($20.56)
Seat 6: matiko09 folded before Flop (didn't bet)
Seat 7: Yaaaazz folded before Flop (didn't bet)
Seat 9: flk.Dasas (button) folded before Flop (didn't bet)





PokerStars Hand #151941837634:  Hold'em No Limit ($0.50/$1.00 USD) - 2016/04/15 13:00:30 CET [2016/04/15 7:00:30 ET]
Table 'Lamberta III' 9-max Seat #4 is the button
Seat 2: Vermm ($83.59 in chips) 
Seat 3: butcheN18 ($105.94 in chips) 
Seat 4: Filojoes ($101 in chips) 
Seat 6: aseban11 ($100 in chips) 
Seat 7: ardo888 ($124.79 in chips) 
Seat 8: djammusic ($40 in chips) 
Seat 9: matiko09 ($153.37 in chips) 
tipner will be allowed to play after the button
aseban11: posts small blind $0.50
ardo888: posts big blind $1
vrnMike: sits out 
*** HOLE CARDS ***
Dealt to matiko09 [Th 8h]
djammusic: folds 
djammusic leaves the table
matiko09: folds 
Vermm: folds 
wangzhuoming joins the table at seat #8 
butcheN18: folds 
Filojoes: raises $1 to $2
aseban11: folds 
ardo888: folds 
Uncalled bet ($1) returned to Filojoes
Filojoes collected $2.50 from pot
Filojoes: doesn't show hand 
vrnMike leaves the table
*** SUMMARY ***
Total pot $2.50 | Rake $0 
Seat 2: Vermm folded before Flop (didn't bet)
Seat 3: butcheN18 folded before Flop (didn't bet)
Seat 4: Filojoes (button) collected ($2.50)
Seat 6: aseban11 (small blind) folded before Flop
Seat 7: ardo888 (big blind) folded before Flop
Seat 8: djammusic folded before Flop (didn't bet)
Seat 9: matiko09 folded before Flop (didn't bet)





PokerStars Hand #151941839046:  Hold'em No Limit ($0.50/$1.00 USD) - 2016/04/15 13:00:34 CET [2016/04/15 7:00:34 ET]
Table 'Navi' 9-max Seat #4 is the button
Seat 1: vrnMike ($134.33 in chips) 
Seat 2: butcheN18 ($100 in chips) 
Seat 4: Effort92 ($146.03 in chips) 
Seat 5: StarsAbove ($102.18 in chips) 
Seat 6: Glushchenko ($115.66 in chips) 
Seat 7: yoshidao ($78.01 in chips) 
Seat 9: matiko09 ($100 in chips) 
StarsAbove: posts small blind $0.50
Glushchenko: posts big blind $1
djammusic: sits out 
*** HOLE CARDS ***
Dealt to matiko09 [Td Ts]
yoshidao: folds 
matiko09: raises $2 to $3
vrnMike: calls $3
butcheN18: folds 
Effort92: folds 
StarsAbove: folds 
Glushchenko: folds 
*** FLOP *** [7h Ad 7d]
matiko09: checks 
vrnMike: bets $3.50
matiko09: calls $3.50
*** TURN *** [7h Ad 7d] [Qs]
matiko09: checks 
vrnMike: bets $10
matiko09: folds 
Uncalled bet ($10) returned to vrnMike
vrnMike collected $13.78 from pot
*** SUMMARY ***
Total pot $14.50 | Rake $0.72 
Board [7h Ad 7d Qs]
Seat 1: vrnMike collected ($13.78)
Seat 2: butcheN18 folded before Flop (didn't bet)
Seat 4: Effort92 (button) folded before Flop (didn't bet)
Seat 5: StarsAbove (small blind) folded before Flop
Seat 6: Glushchenko (big blind) folded before Flop
Seat 7: yoshidao folded before Flop (didn't bet)
Seat 9: matiko09 folded on the Turn





PokerStars Hand #151941845088:  Hold'em No Limit ($1/$2 USD) - 2016/04/15 13:00:48 CET [2016/04/15 7:00:48 ET]
Table 'Patroclus II' 9-max Seat #4 is the button
Seat 1: TonnaMunz ($222.46 in chips) 
Seat 2: Moemors ($148.89 in chips) 
Seat 3: Koolniknik ($181.75 in chips) 
Seat 4: tipner ($205 in chips) 
Seat 5: butcheN18 ($222 in chips) 
Seat 6: di0d80 ($200 in chips) 
Seat 7: matiko09 ($202 in chips) 
Seat 8: Glushchenko ($200 in chips) 
Seat 9: Fish4trips ($205.35 in chips) 
butcheN18: posts small blind $1
di0d80: posts big blind $2
*** HOLE CARDS ***
Dealt to matiko09 [2h 3c]
matiko09: folds 
Glushchenko: folds 
Fish4trips: folds 
TonnaMunz: raises $2.96 to $4.96
Moemors: folds 
Koolniknik: folds 
tipner: folds 
butcheN18: folds 
di0d80: folds 
Uncalled bet ($2.96) returned to TonnaMunz
TonnaMunz collected $5 from pot
TonnaMunz: doesn't show hand 
*** SUMMARY ***
Total pot $5 | Rake $0 
Seat 1: TonnaMunz collected ($5)
Seat 2: Moemors folded before Flop (didn't bet)
Seat 3: Koolniknik folded before Flop (didn't bet)
Seat 4: tipner (button) folded before Flop (didn't bet)
Seat 5: butcheN18 (small blind) folded before Flop
Seat 6: di0d80 (big blind) folded before Flop
Seat 7: matiko09 folded before Flop (didn't bet)
Seat 8: Glushchenko folded before Flop (didn't bet)
Seat 9: Fish4trips folded before Flop (didn't bet)





PokerStars Hand #151941847491:  Hold'em No Limit ($1/$2 USD) - 2016/04/15 13:00:54 CET [2016/04/15 7:00:54 ET]
Table 'Adele II' 9-max Seat #9 is the button
Seat 1: coinflip_si ($201 in chips) 
Seat 2: Fish4trips ($206 in chips) 
Seat 3: matiko09 ($396.67 in chips) 
Seat 4: Glushchenko ($200 in chips) 
Seat 5: T0ny Adams ($105.55 in chips) 
Seat 6: TonnaMunz ($200 in chips) 
Seat 7: tipner ($200 in chips) 
Seat 8: docmarc777 ($200 in chips) 
Seat 9: RyanHuJun ($267.97 in chips) 
coinflip_si: posts small blind $1
Fish4trips: posts big blind $2
*** HOLE CARDS ***
Dealt to matiko09 [Jc 7c]
matiko09: folds 
Glushchenko: folds 
T0ny Adams: folds 
TonnaMunz: folds 
tipner: folds 
docmarc777: raises $4 to $6
RyanHuJun: folds 
coinflip_si: folds 
Fish4trips: folds 
Uncalled bet ($4) returned to docmarc777
docmarc777 collected $5 from pot
*** SUMMARY ***
Total pot $5 | Rake $0 
Seat 1: coinflip_si (small blind) folded before Flop
Seat 2: Fish4trips (big blind) folded before Flop
Seat 3: matiko09 folded before Flop (didn't bet)
Seat 4: Glushchenko folded before Flop (didn't bet)
Seat 5: T0ny Adams folded before Flop (didn't bet)
Seat 6: TonnaMunz folded before Flop (didn't bet)
Seat 7: tipner folded before Flop (didn't bet)
Seat 8: docmarc777 collected ($5)
Seat 9: RyanHuJun (button) folded before Flop (didn't bet)





PokerStars Hand #151941850019:  Hold'em No Limit ($0.50/$1.00 USD) - 2016/04/15 13:01:00 CET [2016/04/15 7:01:00 ET]
Table 'Chiny II' 9-max Seat #9 is the button
Seat 1: CI58 ($127.59 in chips) 
Seat 2: AceFarky ($102.93 in chips) 
Seat 3: powerbel ($46.50 in chips) 
Seat 4: 1000karlos ($90.27 in chips) 
Seat 5: Yaaaazz ($116.78 in chips) 
Seat 6: choupai ($40 in chips) 
Seat 7: matiko09 ($141.48 in chips) 
Seat 9: ardo888 ($106.12 in chips) 
CI58: posts small blind $0.50
AceFarky: posts big blind $1
SanychStar: sits out 
*** HOLE CARDS ***
Dealt to matiko09 [5h 5d]
powerbel: folds 
1000karlos: folds 
Yaaaazz: folds 
choupai: folds 
matiko09: raises $1.50 to $2.50
ardo888: raises $6.50 to $9
CI58: folds 
AceFarky: folds 
matiko09: folds 
Uncalled bet ($6.50) returned to ardo888
ardo888 collected $6.50 from pot
ardo888: doesn't show hand 
*** SUMMARY ***
Total pot $6.50 | Rake $0 
Seat 1: CI58 (small blind) folded before Flop
Seat 2: AceFarky (big blind) folded before Flop
Seat 3: powerbel folded before Flop (didn't bet)
Seat 4: 1000karlos folded before Flop (didn't bet)
Seat 5: Yaaaazz folded before Flop (didn't bet)
Seat 6: choupai folded before Flop (didn't bet)
Seat 7: matiko09 folded before Flop
Seat 9: ardo888 (button) collected ($6.50)





PokerStars Hand #151941850636:  Hold'em No Limit ($0.50/$1.00 USD) - 2016/04/15 13:01:01 CET [2016/04/15 7:01:01 ET]
Table 'Lamberta III' 9-max Seat #6 is the button
Seat 2: Vermm ($83.59 in chips) 
Seat 3: butcheN18 ($105.94 in chips) 
Seat 4: Filojoes ($102.50 in chips) 
Seat 6: aseban11 ($100 in chips) 
Seat 7: ardo888 ($123.79 in chips) 
Seat 8: wangzhuoming ($100 in chips) 
Seat 9: matiko09 ($153.37 in chips) 
ardo888: posts small blind $0.50
wangzhuoming: posts big blind $1
tipner: sits out 
*** HOLE CARDS ***
Dealt to matiko09 [Kd Ad]
matiko09: raises $2 to $3
Vermm: folds 
butcheN18: folds 
Filojoes: folds 
Westpants joins the table at seat #1 
aseban11: folds 
ardo888: folds 
wangzhuoming: folds 
Uncalled bet ($2) returned to matiko09
matiko09 collected $2.50 from pot
matiko09: doesn't show hand 
*** SUMMARY ***
Total pot $2.50 | Rake $0 
Seat 2: Vermm folded before Flop (didn't bet)
Seat 3: butcheN18 folded before Flop (didn't bet)
Seat 4: Filojoes folded before Flop (didn't bet)
Seat 6: aseban11 (button) folded before Flop (didn't bet)
Seat 7: ardo888 (small blind) folded before Flop
Seat 8: wangzhuoming (big blind) folded before Flop
Seat 9: matiko09 collected ($2.50)





PokerStars Hand #151941859416:  Hold'em No Limit ($0.50/$1.00 USD) - 2016/04/15 13:01:22 CET [2016/04/15 7:01:22 ET]
Table 'Katja II' 9-max Seat #1 is the button
Seat 1: vrnMike ($120.63 in chips) 
Seat 2: TheJokerMen1 ($110.23 in chips) 
Seat 3: matiko09 ($100 in chips) 
Seat 4: Sutt_420 ($52.70 in chips) 
Seat 5: Dachish ($84.35 in chips) 
Seat 6: ASG2016 ($112.04 in chips) 
Seat 7: Effort92 ($115.42 in chips) 
Seat 8: Glushchenko ($100 in chips) 
TheJokerMen1: posts small blind $0.50
matiko09: posts big blind $1
*** HOLE CARDS ***
Dealt to matiko09 [7h 5s]
aseban11 joins the table at seat #9 
Sutt_420: raises $1 to $2
Dachish: folds 
ASG2016: folds 
Effort92: folds 
Glushchenko: folds 
vrnMike: folds 
TheJokerMen1: calls $1.50
matiko09: folds 
*** FLOP *** [9c Qc 3h]
TheJokerMen1: bets $2.50
Sutt_420: raises $8.50 to $11
TheJokerMen1: calls $8.50
*** TURN *** [9c Qc 3h] [Qs]
TheJokerMen1: checks 
Sutt_420: bets $16
TheJokerMen1: calls $16
*** RIVER *** [9c Qc 3h Qs] [Qh]
TheJokerMen1: checks 
Sutt_420: bets $23.70 and is all-in
TheJokerMen1: folds 
Uncalled bet ($23.70) returned to Sutt_420
Sutt_420 collected $56.50 from pot
*** SUMMARY ***
Total pot $59 | Rake $2.50 
Board [9c Qc 3h Qs Qh]
Seat 1: vrnMike (button) folded before Flop (didn't bet)
Seat 2: TheJokerMen1 (small blind) folded on the River
Seat 3: matiko09 (big blind) folded before Flop
Seat 4: Sutt_420 collected ($56.50)
Seat 5: Dachish folded before Flop (didn't bet)
Seat 6: ASG2016 folded before Flop (didn't bet)
Seat 7: Effort92 folded before Flop (didn't bet)
Seat 8: Glushchenko folded before Flop (didn't bet)





PokerStars Hand #151941859854:  Hold'em No Limit ($1/$2 USD) - 2016/04/15 13:01:23 CET [2016/04/15 7:01:23 ET]
Table 'Adele II' 9-max Seat #1 is the button
Seat 1: coinflip_si ($200 in chips) 
Seat 2: Fish4trips ($204 in chips) 
Seat 3: matiko09 ($396.67 in chips) 
Seat 4: Glushchenko ($200 in chips) 
Seat 5: T0ny Adams ($105.55 in chips) 
Seat 6: TonnaMunz ($200 in chips) 
Seat 7: tipner ($200 in chips) 
Seat 8: docmarc777 ($203 in chips) 
Seat 9: RyanHuJun ($267.97 in chips) 
Fish4trips: posts small blind $1
matiko09: posts big blind $2
*** HOLE CARDS ***
Dealt to matiko09 [6h 3s]
Glushchenko: folds 
T0ny Adams: folds 
TonnaMunz: folds 
tipner: raises $4 to $6
docmarc777: folds 
RyanHuJun: calls $6
coinflip_si: folds 
Fish4trips: folds 
matiko09: folds 
*** FLOP *** [6c Kh Ah]
tipner: checks 
RyanHuJun: bets $8
tipner: calls $8
*** TURN *** [6c Kh Ah] [Jd]
tipner: checks 
RyanHuJun: bets $18
tipner: calls $18
*** RIVER *** [6c Kh Ah Jd] [3h]
tipner: checks 
RyanHuJun: checks 
*** SHOW DOWN ***
tipner: shows [Kd Qd] (a pair of Kings)
RyanHuJun: mucks hand 
tipner collected $64.25 from pot
*** SUMMARY ***
Total pot $67 | Rake $2.75 
Board [6c Kh Ah Jd 3h]
Seat 1: coinflip_si (button) folded before Flop (didn't bet)
Seat 2: Fish4trips (small blind) folded before Flop
Seat 3: matiko09 (big blind) folded before Flop
Seat 4: Glushchenko folded before Flop (didn't bet)
Seat 5: T0ny Adams folded before Flop (didn't bet)
Seat 6: TonnaMunz folded before Flop (didn't bet)
Seat 7: tipner showed [Kd Qd] and won ($64.25) with a pair of Kings
Seat 8: docmarc777 folded before Flop (didn't bet)
Seat 9: RyanHuJun mucked [Kc Th]





PokerStars Hand #151941860350:  Hold'em No Limit ($0.50/$1.00 USD) - 2016/04/15 13:01:24 CET [2016/04/15 7:01:24 ET]
Table 'Navi' 9-max Seat #5 is the button
Seat 1: vrnMike ($141.61 in chips) 
Seat 2: butcheN18 ($100 in chips) 
Seat 4: Effort92 ($146.03 in chips) 
Seat 5: StarsAbove ($101.68 in chips) 
Seat 6: Glushchenko ($114.66 in chips) 
Seat 7: yoshidao ($78.01 in chips) 
Seat 9: matiko09 ($100 in chips) 
Glushchenko: posts small blind $0.50
yoshidao: posts big blind $1
djammusic: sits out 
*** HOLE CARDS ***
Dealt to matiko09 [Ac Kc]
matiko09: raises $2 to $3
vrnMike: raises $6.50 to $9.50
butcheN18: folds 
Effort92: folds 
StarsAbove: folds 
Glushchenko: folds 
yoshidao: folds 
matiko09: calls $6.50
*** FLOP *** [6c 4s Th]
matiko09: checks 
vrnMike: checks 
*** TURN *** [6c 4s Th] [9d]
matiko09: checks 
vrnMike: checks 
*** RIVER *** [6c 4s Th 9d] [9h]
matiko09: checks 
vrnMike: checks 
*** SHOW DOWN ***
matiko09: shows [Ac Kc] (a pair of Nines)
vrnMike: shows [Kh Ah] (a pair of Nines)
matiko09 collected $9.74 from pot
vrnMike collected $9.74 from pot
*** SUMMARY ***
Total pot $20.50 | Rake $1.02 
Board [6c 4s Th 9d 9h]
Seat 1: vrnMike showed [Kh Ah] and won ($9.74) with a pair of Nines
Seat 2: butcheN18 folded before Flop (didn't bet)
Seat 4: Effort92 folded before Flop (didn't bet)
Seat 5: StarsAbove (button) folded before Flop (didn't bet)
Seat 6: Glushchenko (small blind) folded before Flop
Seat 7: yoshidao (big blind) folded before Flop
Seat 9: matiko09 showed [Ac Kc] and won ($9.74) with a pair of Nines





PokerStars Hand #151941861557:  Hold'em No Limit ($1/$2 USD) - 2016/04/15 13:01:27 CET [2016/04/15 7:01:27 ET]
Table 'Patroclus II' 9-max Seat #5 is the button
Seat 1: TonnaMunz ($225.46 in chips) 
Seat 2: Moemors ($148.89 in chips) 
Seat 3: Koolniknik ($181.75 in chips) 
Seat 4: tipner ($205 in chips) 
Seat 5: butcheN18 ($221 in chips) 
Seat 6: di0d80 ($200 in chips) 
Seat 7: matiko09 ($202 in chips) 
Seat 8: Glushchenko ($200 in chips) 
Seat 9: Fish4trips ($205.35 in chips) 
di0d80: posts small blind $1
matiko09: posts big blind $2
*** HOLE CARDS ***
Dealt to matiko09 [4h 7s]
Glushchenko: folds 
Fish4trips: raises $3 to $5
TonnaMunz: folds 
Moemors: folds 
Koolniknik: calls $5
tipner: calls $5
butcheN18: folds 
di0d80: folds 
matiko09: folds 
*** FLOP *** [Ks Th 2h]
Fish4trips: checks 
Koolniknik: bets $8.55
tipner: folds 
Fish4trips: folds 
Uncalled bet ($8.55) returned to Koolniknik
Koolniknik collected $17.10 from pot
Koolniknik: doesn't show hand 
*** SUMMARY ***
Total pot $18 | Rake $0.90 
Board [Ks Th 2h]
Seat 1: TonnaMunz folded before Flop (didn't bet)
Seat 2: Moemors folded before Flop (didn't bet)
Seat 3: Koolniknik collected ($17.10)
Seat 4: tipner folded on the Flop
Seat 5: butcheN18 (button) folded before Flop (didn't bet)
Seat 6: di0d80 (small blind) folded before Flop
Seat 7: matiko09 (big blind) folded before Flop
Seat 8: Glushchenko folded before Flop (didn't bet)
Seat 9: Fish4trips folded on the Flop





PokerStars Hand #151941865767:  Hold'em No Limit ($0.50/$1.00 USD) - 2016/04/15 13:01:36 CET [2016/04/15 7:01:36 ET]
Table 'Lamberta III' 9-max Seat #7 is the button
Seat 2: Vermm ($83.59 in chips) 
Seat 3: butcheN18 ($105.94 in chips) 
Seat 4: Filojoes ($102.50 in chips) 
Seat 6: aseban11 ($100 in chips) 
Seat 7: ardo888 ($123.29 in chips) 
Seat 8: wangzhuoming ($99 in chips) 
Seat 9: matiko09 ($154.87 in chips) 
wangzhuoming: posts small blind $0.50
matiko09: posts big blind $1
Westpants: sits out 
tipner: sits out 
*** HOLE CARDS ***
Dealt to matiko09 [3s Td]
Vermm: folds 
butcheN18: raises $2 to $3
Filojoes: folds 
aseban11: folds 
ardo888: folds 
wangzhuoming: folds 
matiko09: folds 
Uncalled bet ($2) returned to butcheN18
butcheN18 collected $2.50 from pot
butcheN18: doesn't show hand 
*** SUMMARY ***
Total pot $2.50 | Rake $0 
Seat 2: Vermm folded before Flop (didn't bet)
Seat 3: butcheN18 collected ($2.50)
Seat 4: Filojoes folded before Flop (didn't bet)
Seat 6: aseban11 folded before Flop (didn't bet)
Seat 7: ardo888 (button) folded before Flop (didn't bet)
Seat 8: wangzhuoming (small blind) folded before Flop
Seat 9: matiko09 (big blind) folded before Flop





PokerStars Hand #151941868566:  Hold'em No Limit ($0.50/$1.00 USD) - 2016/04/15 13:01:43 CET [2016/04/15 7:01:43 ET]
Table 'Matterania III' 9-max Seat #1 is the button
Seat 1: di0d80 ($102.44 in chips) 
Seat 2: aseban11 ($100 in chips) 
Seat 3: ardo888 ($123.97 in chips) 
Seat 4: wangzhuoming ($113.22 in chips) 
Seat 5: Vermm ($88.14 in chips) 
Seat 6: matiko09 ($100.60 in chips) 
Seat 7: Yaaaazz ($107.86 in chips) 
Seat 9: flk.Dasas ($100 in chips) 
aseban11: posts small blind $0.50
ardo888: posts big blind $1
di0d80: posts the ante $0.20
aseban11: posts the ante $0.20
ardo888: posts the ante $0.20
wangzhuoming: posts the ante $0.20
Vermm: posts the ante $0.20
matiko09: posts the ante $0.20
Yaaaazz: posts the ante $0.20
flk.Dasas: posts the ante $0.20
*** HOLE CARDS ***
Dealt to matiko09 [Tc 3d]
wangzhuoming: folds 
Vermm: raises $1 to $2
matiko09: folds 
Yaaaazz: folds 
flk.Dasas: calls $2
di0d80: folds 
aseban11: calls $1.50
ardo888: folds 
*** FLOP *** [8h 4h Js]
aseban11: checks 
Vermm: checks 
flk.Dasas: bets $5.56
aseban11: folds 
Vermm: folds 
Uncalled bet ($5.56) returned to flk.Dasas
flk.Dasas collected $8.17 from pot
flk.Dasas: doesn't show hand 
*** SUMMARY ***
Total pot $8.60 | Rake $0.43 
Board [8h 4h Js]
Seat 1: di0d80 (button) folded before Flop (didn't bet)
Seat 2: aseban11 (small blind) folded on the Flop
Seat 3: ardo888 (big blind) folded before Flop
Seat 4: wangzhuoming folded before Flop (didn't bet)
Seat 5: Vermm folded on the Flop
Seat 6: matiko09 folded before Flop (didn't bet)
Seat 7: Yaaaazz folded before Flop (didn't bet)
Seat 9: flk.Dasas collected ($8.17)





PokerStars Hand #151941868682:  Hold'em No Limit ($0.50/$1.00 USD) - 2016/04/15 13:01:43 CET [2016/04/15 7:01:43 ET]
Table 'Chiny II' 9-max Seat #1 is the button
Seat 1: CI58 ($127.09 in chips) 
Seat 2: AceFarky ($101.93 in chips) 
Seat 3: powerbel ($46.50 in chips) 
Seat 4: 1000karlos ($90.27 in chips) 
Seat 5: Yaaaazz ($116.78 in chips) 
Seat 6: choupai ($40 in chips) 
Seat 7: matiko09 ($138.98 in chips) 
Seat 9: ardo888 ($110.12 in chips) 
AceFarky: posts small blind $0.50
powerbel: posts big blind $1
SanychStar: sits out 
*** HOLE CARDS ***
Dealt to matiko09 [Ks 9h]
1000karlos has timed out
1000karlos: folds 
Yaaaazz: folds 
choupai: folds 
matiko09: folds 
ardo888: folds 
CI58: raises $1.25 to $2.25
AceFarky: folds 
powerbel: calls $1.25
*** FLOP *** [Jh 8s 7s]
powerbel: bets $2
CI58: folds 
Uncalled bet ($2) returned to powerbel
powerbel collected $4.75 from pot
powerbel: doesn't show hand 
*** SUMMARY ***
Total pot $5 | Rake $0.25 
Board [Jh 8s 7s]
Seat 1: CI58 (button) folded on the Flop
Seat 2: AceFarky (small blind) folded before Flop
Seat 3: powerbel (big blind) collected ($4.75)
Seat 4: 1000karlos folded before Flop (didn't bet)
Seat 5: Yaaaazz folded before Flop (didn't bet)
Seat 6: choupai folded before Flop (didn't bet)
Seat 7: matiko09 folded before Flop (didn't bet)
Seat 9: ardo888 folded before Flop (didn't bet)





PokerStars Hand #151941879487:  Hold'em No Limit ($0.50/$1.00 USD) - 2016/04/15 13:02:06 CET [2016/04/15 7:02:06 ET]
Table 'Lamberta III' 9-max Seat #8 is the button
Seat 1: Westpants ($100 in chips) 
Seat 2: Vermm ($83.59 in chips) 
Seat 3: butcheN18 ($107.44 in chips) 
Seat 4: Filojoes ($102.50 in chips) 
Seat 6: aseban11 ($100 in chips) 
Seat 7: ardo888 ($123.29 in chips) 
Seat 8: wangzhuoming ($98.50 in chips) 
Seat 9: matiko09 ($153.87 in chips) 
matiko09: posts small blind $0.50
Westpants: posts big blind $1
tipner: sits out 
*** HOLE CARDS ***
Dealt to matiko09 [8s 6h]
Vermm: folds 
butcheN18: folds 
Filojoes: folds 
aseban11: raises $1.50 to $2.50
ardo888: folds 
wangzhuoming: calls $2.50
matiko09: folds 
Westpants: folds 
*** FLOP *** [3s 3d Js]
aseban11: checks 
wangzhuoming: checks 
*** TURN *** [3s 3d Js] [Jh]
aseban11: bets $3.50
wangzhuoming: folds 
Uncalled bet ($3.50) returned to aseban11
aseban11 collected $6.18 from pot
aseban11: doesn't show hand 
*** SUMMARY ***
Total pot $6.50 | Rake $0.32 
Board [3s 3d Js Jh]
Seat 1: Westpants (big blind) folded before Flop
Seat 2: Vermm folded before Flop (didn't bet)
Seat 3: butcheN18 folded before Flop (didn't bet)
Seat 4: Filojoes folded before Flop (didn't bet)
Seat 6: aseban11 collected ($6.18)
Seat 7: ardo888 folded before Flop (didn't bet)
Seat 8: wangzhuoming (button) folded on the Turn
Seat 9: matiko09 (small blind) folded before Flop





PokerStars Hand #151941883220:  Hold'em No Limit ($0.50/$1.00 USD) - 2016/04/15 13:02:15 CET [2016/04/15 7:02:15 ET]
Table 'Navi' 9-max Seat #6 is the button
Seat 1: vrnMike ($141.85 in chips) 
Seat 2: butcheN18 ($100 in chips) 
Seat 4: Effort92 ($146.03 in chips) 
Seat 5: StarsAbove ($101.68 in chips) 
Seat 6: Glushchenko ($114.16 in chips) 
Seat 7: yoshidao ($77.01 in chips) 
Seat 8: djammusic ($40 in chips) 
Seat 9: matiko09 ($100.24 in chips) 
yoshidao: posts small blind $0.50
djammusic: posts big blind $1
*** HOLE CARDS ***
Dealt to matiko09 [7d Th]
matiko09: folds 
vrnMike: folds 
butcheN18: folds 
Effort92: folds 
StarsAbove: folds 
Glushchenko: folds 
yoshidao: calls $0.50
djammusic: checks 
*** FLOP *** [2s Ac 3c]
yoshidao: bets $5
djammusic: folds 
Uncalled bet ($5) returned to yoshidao
yoshidao collected $1.90 from pot
yoshidao: doesn't show hand 
*** SUMMARY ***
Total pot $2 | Rake $0.10 
Board [2s Ac 3c]
Seat 1: vrnMike folded before Flop (didn't bet)
Seat 2: butcheN18 folded before Flop (didn't bet)
Seat 4: Effort92 folded before Flop (didn't bet)
Seat 5: StarsAbove folded before Flop (didn't bet)
Seat 6: Glushchenko (button) folded before Flop (didn't bet)
Seat 7: yoshidao (small blind) collected ($1.90)
Seat 8: djammusic (big blind) folded on the Flop
Seat 9: matiko09 folded before Flop (didn't bet)





PokerStars Hand #151941885231:  Hold'em No Limit ($0.50/$1.00 USD) - 2016/04/15 13:02:19 CET [2016/04/15 7:02:19 ET]
Table 'Gase II' 9-max Seat #9 is the button
Seat 1: maxxmeister ($100 in chips) 
Seat 2: aseban11 ($100 in chips) 
Seat 5: Paul6999 ($40 in chips) 
Seat 6: matiko09 ($100 in chips) 
Seat 8: choupai ($122.67 in chips) 
Seat 9: UberLycan ($110.68 in chips) 
maxxmeister: posts small blind $0.50
aseban11: posts big blind $1
djammusic: sits out 
Filojoes: sits out 
danbo577: sits out 
*** HOLE CARDS ***
Dealt to matiko09 [3c Tc]
Paul6999: folds 
matiko09: folds 
choupai: folds 
UberLycan: folds 
maxxmeister: raises $2.50 to $3.50
aseban11: calls $2.50
*** FLOP *** [Ad 9d Qs]
maxxmeister: checks 
aseban11: bets $4.98
maxxmeister: folds 
Uncalled bet ($4.98) returned to aseban11
aseban11 collected $6.65 from pot
aseban11: doesn't show hand 
*** SUMMARY ***
Total pot $7 | Rake $0.35 
Board [Ad 9d Qs]
Seat 1: maxxmeister (small blind) folded on the Flop
Seat 2: aseban11 (big blind) collected ($6.65)
Seat 5: Paul6999 folded before Flop (didn't bet)
Seat 6: matiko09 folded before Flop (didn't bet)
Seat 8: choupai folded before Flop (didn't bet)
Seat 9: UberLycan (button) folded before Flop (didn't bet)





PokerStars Hand #151941897599:  Hold'em No Limit ($1/$2 USD) - 2016/04/15 13:02:47 CET [2016/04/15 7:02:47 ET]
Table 'Patroclus II' 9-max Seat #6 is the button
Seat 1: TonnaMunz ($225.46 in chips) 
Seat 2: Moemors ($148.89 in chips) 
Seat 3: Koolniknik ($193.85 in chips) 
Seat 4: tipner ($200 in chips) 
Seat 5: butcheN18 ($221 in chips) 
Seat 6: di0d80 ($200 in chips) 
Seat 7: matiko09 ($200 in chips) 
Seat 8: Glushchenko ($200 in chips) 
Seat 9: Fish4trips ($200.35 in chips) 
matiko09: posts small blind $1
Glushchenko: posts big blind $2
*** HOLE CARDS ***
Dealt to matiko09 [2c Th]
Fish4trips: folds 
TonnaMunz: folds 
Moemors: folds 
Koolniknik: raises $4 to $6
tipner: folds 
butcheN18: folds 
di0d80: folds 
matiko09: folds 
Glushchenko: folds 
Uncalled bet ($4) returned to Koolniknik
Koolniknik collected $5 from pot
Koolniknik: doesn't show hand 
*** SUMMARY ***
Total pot $5 | Rake $0 
Seat 1: TonnaMunz folded before Flop (didn't bet)
Seat 2: Moemors folded before Flop (didn't bet)
Seat 3: Koolniknik collected ($5)
Seat 4: tipner folded before Flop (didn't bet)
Seat 5: butcheN18 folded before Flop (didn't bet)
Seat 6: di0d80 (button) folded before Flop (didn't bet)
Seat 7: matiko09 (small blind) folded before Flop
Seat 8: Glushchenko (big blind) folded before Flop
Seat 9: Fish4trips folded before Flop (didn't bet)





PokerStars Hand #151941898184:  Hold'em No Limit ($0.50/$1.00 USD) - 2016/04/15 13:02:48 CET [2016/04/15 7:02:48 ET]
Table 'Matterania III' 9-max Seat #2 is the button
Seat 1: di0d80 ($102.24 in chips) 
Seat 2: aseban11 ($100 in chips) 
Seat 3: ardo888 ($122.77 in chips) 
Seat 4: wangzhuoming ($113.02 in chips) 
Seat 5: Vermm ($85.94 in chips) 
Seat 6: matiko09 ($100.40 in chips) 
Seat 7: Yaaaazz ($107.66 in chips) 
Seat 9: flk.Dasas ($105.97 in chips) 
ardo888: posts small blind $0.50
wangzhuoming: posts big blind $1
di0d80: posts the ante $0.20
aseban11: posts the ante $0.20
ardo888: posts the ante $0.20
wangzhuoming: posts the ante $0.20
Vermm: posts the ante $0.20
matiko09: posts the ante $0.20
Yaaaazz: posts the ante $0.20
flk.Dasas: posts the ante $0.20
*** HOLE CARDS ***
Dealt to matiko09 [7s Ah]
Vermm: folds 
matiko09: folds 
Yaaaazz: folds 
flk.Dasas: folds 
di0d80: folds 
aseban11: raises $2 to $3
ardo888: folds 
wangzhuoming: folds 
Uncalled bet ($2) returned to aseban11
aseban11 collected $4.10 from pot
aseban11: doesn't show hand 
*** SUMMARY ***
Total pot $4.10 | Rake $0 
Seat 1: di0d80 folded before Flop (didn't bet)
Seat 2: aseban11 (button) collected ($4.10)
Seat 3: ardo888 (small blind) folded before Flop
Seat 4: wangzhuoming (big blind) folded before Flop
Seat 5: Vermm folded before Flop (didn't bet)
Seat 6: matiko09 folded before Flop (didn't bet)
Seat 7: Yaaaazz folded before Flop (didn't bet)
Seat 9: flk.Dasas folded before Flop (didn't bet)





PokerStars Hand #151941898975:  Hold'em No Limit ($0.50/$1.00 USD) - 2016/04/15 13:02:50 CET [2016/04/15 7:02:50 ET]
Table 'Chiny II' 9-max Seat #2 is the button
Seat 1: CI58 ($124.84 in chips) 
Seat 2: AceFarky ($101.43 in chips) 
Seat 3: powerbel ($49 in chips) 
Seat 5: Yaaaazz ($116.78 in chips) 
Seat 6: choupai ($40 in chips) 
Seat 7: matiko09 ($138.98 in chips) 
Seat 9: ardo888 ($110.12 in chips) 
powerbel: posts small blind $0.50
Yaaaazz: posts big blind $1
SanychStar: sits out 
*** HOLE CARDS ***
Dealt to matiko09 [7s Qh]
choupai: folds 
matiko09: folds 
ardo888: folds 
CI58: folds 
AceFarky: folds 
powerbel: calls $0.50
Yaaaazz: raises $2 to $3
powerbel: folds 
Uncalled bet ($2) returned to Yaaaazz
Yaaaazz collected $2 from pot
*** SUMMARY ***
Total pot $2 | Rake $0 
Seat 1: CI58 folded before Flop (didn't bet)
Seat 2: AceFarky (button) folded before Flop (didn't bet)
Seat 3: powerbel (small blind) folded before Flop
Seat 5: Yaaaazz (big blind) collected ($2)
Seat 6: choupai folded before Flop (didn't bet)
Seat 7: matiko09 folded before Flop (didn't bet)
Seat 9: ardo888 folded before Flop (didn't bet)





PokerStars Hand #151941899121:  Hold'em No Limit ($0.50/$1.00 USD) - 2016/04/15 13:02:50 CET [2016/04/15 7:02:50 ET]
Table 'Navi' 9-max Seat #7 is the button
Seat 1: vrnMike ($141.85 in chips) 
Seat 2: butcheN18 ($100 in chips) 
Seat 4: Effort92 ($146.03 in chips) 
Seat 5: StarsAbove ($101.68 in chips) 
Seat 6: Glushchenko ($114.16 in chips) 
Seat 7: yoshidao ($77.91 in chips) 
Seat 8: djammusic ($39 in chips) 
Seat 9: matiko09 ($100.24 in chips) 
djammusic: posts small blind $0.50
matiko09: posts big blind $1
*** HOLE CARDS ***
Dealt to matiko09 [Ah 7s]
vrnMike: folds 
butcheN18: folds 
Effort92: folds 
StarsAbove: folds 
Glushchenko: raises $1.50 to $2.50
yoshidao: folds 
djammusic: folds 
matiko09: folds 
Uncalled bet ($1.50) returned to Glushchenko
Glushchenko collected $2.50 from pot
*** SUMMARY ***
Total pot $2.50 | Rake $0 
Seat 1: vrnMike folded before Flop (didn't bet)
Seat 2: butcheN18 folded before Flop (didn't bet)
Seat 4: Effort92 folded before Flop (didn't bet)
Seat 5: StarsAbove folded before Flop (didn't bet)
Seat 6: Glushchenko collected ($2.50)
Seat 7: yoshidao (button) folded before Flop (didn't bet)
Seat 8: djammusic (small blind) folded before Flop
Seat 9: matiko09 (big blind) folded before Flop





PokerStars Hand #151941900030:  Hold'em No Limit ($0.50/$1.00 USD) - 2016/04/15 13:02:52 CET [2016/04/15 7:02:52 ET]
Table 'Lamberta III' 9-max Seat #9 is the button
Seat 1: Westpants ($100 in chips) 
Seat 2: Vermm ($83.59 in chips) 
Seat 3: butcheN18 ($107.44 in chips) 
Seat 4: Filojoes ($102.50 in chips) 
Seat 6: aseban11 ($103.68 in chips) 
Seat 7: ardo888 ($123.29 in chips) 
Seat 8: wangzhuoming ($96 in chips) 
Seat 9: matiko09 ($153.37 in chips) 
Westpants: posts small blind $0.50
Vermm: posts big blind $1
tipner: sits out 
*** HOLE CARDS ***
Dealt to matiko09 [Qc Jc]
butcheN18: folds 
Filojoes: raises $2 to $3
aseban11: folds 
ardo888: folds 
wangzhuoming: calls $3
matiko09: calls $3
Westpants: folds 
Vermm: folds 
*** FLOP *** [8c Ts Td]
Filojoes: checks 
wangzhuoming: checks 
matiko09: checks 
*** TURN *** [8c Ts Td] [Jd]
Filojoes: bets $5.99
wangzhuoming: folds 
matiko09: calls $5.99
*** RIVER *** [8c Ts Td Jd] [8s]
Filojoes: checks 
matiko09: checks 
*** SHOW DOWN ***
Filojoes: shows [Qh Ah] (two pair, Tens and Eights)
matiko09: shows [Qc Jc] (two pair, Jacks and Tens)
matiko09 collected $21.36 from pot
*** SUMMARY ***
Total pot $22.48 | Rake $1.12 
Board [8c Ts Td Jd 8s]
Seat 1: Westpants (small blind) folded before Flop
Seat 2: Vermm (big blind) folded before Flop
Seat 3: butcheN18 folded before Flop (didn't bet)
Seat 4: Filojoes showed [Qh Ah] and lost with two pair, Tens and Eights
Seat 6: aseban11 folded before Flop (didn't bet)
Seat 7: ardo888 folded before Flop (didn't bet)
Seat 8: wangzhuoming folded on the Turn
Seat 9: matiko09 (button) showed [Qc Jc] and won ($21.36) with two pair, Jacks and Tens





PokerStars Hand #151941903802:  Hold'em No Limit ($1/$2 USD) - 2016/04/15 13:03:00 CET [2016/04/15 7:03:00 ET]
Table 'Adele II' 9-max Seat #2 is the button
Seat 1: coinflip_si ($200 in chips) 
Seat 2: Fish4trips ($203 in chips) 
Seat 3: matiko09 ($394.67 in chips) 
Seat 4: Glushchenko ($200 in chips) 
Seat 5: T0ny Adams ($105.55 in chips) 
Seat 6: TonnaMunz ($200 in chips) 
Seat 7: tipner ($232.25 in chips) 
Seat 8: docmarc777 ($203 in chips) 
matiko09: posts small blind $1
Glushchenko: posts big blind $2
*** HOLE CARDS ***
Dealt to matiko09 [Jh Ah]
T0ny Adams: folds 
TonnaMunz: folds 
tipner: folds 
docmarc777: raises $3.90 to $5.90
coinflip_si: folds 
Fish4trips: calls $5.90
RyanHuJun is disconnected 
matiko09: raises $18.10 to $24
Glushchenko: folds 
docmarc777: raises $28 to $52
Fish4trips: folds 
matiko09: folds 
Uncalled bet ($28) returned to docmarc777
docmarc777 collected $55.90 from pot
docmarc777: doesn't show hand 
*** SUMMARY ***
Total pot $55.90 | Rake $0 
Seat 1: coinflip_si folded before Flop (didn't bet)
Seat 2: Fish4trips (button) folded before Flop
Seat 3: matiko09 (small blind) folded before Flop
Seat 4: Glushchenko (big blind) folded before Flop
Seat 5: T0ny Adams folded before Flop (didn't bet)
Seat 6: TonnaMunz folded before Flop (didn't bet)
Seat 7: tipner folded before Flop (didn't bet)
Seat 8: docmarc777 collected ($55.90)





PokerStars Hand #151941910080:  Hold'em No Limit ($0.50/$1.00 USD) - 2016/04/15 13:03:14 CET [2016/04/15 7:03:14 ET]
Table 'Navi' 9-max Seat #8 is the button
Seat 2: butcheN18 ($100 in chips) 
Seat 4: Effort92 ($146.03 in chips) 
Seat 5: StarsAbove ($101.68 in chips) 
Seat 6: Glushchenko ($115.66 in chips) 
Seat 7: yoshidao ($77.91 in chips) 
Seat 8: djammusic ($38.50 in chips) 
Seat 9: matiko09 ($100 in chips) 
matiko09: posts small blind $0.50
vrnMike: is sitting out 
butcheN18: posts big blind $1
*** HOLE CARDS ***
Dealt to matiko09 [Qd 5s]
vrnMike leaves the table
Effort92: folds 
StarsAbove: folds 
tipner joins the table at seat #1 
Glushchenko: folds 
yoshidao: calls $1
djammusic: raises $3 to $4
matiko09: folds 
butcheN18: folds 
yoshidao: folds 
Uncalled bet ($3) returned to djammusic
djammusic collected $3.50 from pot
djammusic: doesn't show hand 
*** SUMMARY ***
Total pot $3.50 | Rake $0 
Seat 2: butcheN18 (big blind) folded before Flop
Seat 4: Effort92 folded before Flop (didn't bet)
Seat 5: StarsAbove folded before Flop (didn't bet)
Seat 6: Glushchenko folded before Flop (didn't bet)
Seat 7: yoshidao folded before Flop
Seat 8: djammusic (button) collected ($3.50)
Seat 9: matiko09 (small blind) folded before Flop





PokerStars Hand #151941910370:  Hold'em No Limit ($0.50/$1.00 USD) - 2016/04/15 13:03:15 CET [2016/04/15 7:03:15 ET]
Table 'Chiny II' 9-max Seat #3 is the button
Seat 1: CI58 ($124.84 in chips) 
Seat 2: AceFarky ($101.43 in chips) 
Seat 3: powerbel ($48 in chips) 
Seat 5: Yaaaazz ($117.78 in chips) 
Seat 6: choupai ($40 in chips) 
Seat 7: matiko09 ($138.98 in chips) 
Seat 9: ardo888 ($110.12 in chips) 
Yaaaazz: posts small blind $0.50
choupai: posts big blind $1
SanychStar: sits out 
*** HOLE CARDS ***
Dealt to matiko09 [8h Qs]
matiko09: folds 
ardo888: folds 
CI58: folds 
AceFarky: folds 
powerbel: folds 
Yaaaazz: raises $1.51 to $2.51
choupai: folds 
Uncalled bet ($1.51) returned to Yaaaazz
Yaaaazz collected $2 from pot
*** SUMMARY ***
Total pot $2 | Rake $0 
Seat 1: CI58 folded before Flop (didn't bet)
Seat 2: AceFarky folded before Flop (didn't bet)
Seat 3: powerbel (button) folded before Flop (didn't bet)
Seat 5: Yaaaazz (small blind) collected ($2)
Seat 6: choupai (big blind) folded before Flop
Seat 7: matiko09 folded before Flop (didn't bet)
Seat 9: ardo888 folded before Flop (didn't bet)





PokerStars Hand #151941910632:  Hold'em No Limit ($1/$2 USD) - 2016/04/15 13:03:15 CET [2016/04/15 7:03:15 ET]
Table 'Patroclus II' 9-max Seat #7 is the button
Seat 1: TonnaMunz ($225.46 in chips) 
Seat 2: Moemors ($148.89 in chips) 
Seat 3: Koolniknik ($196.85 in chips) 
Seat 4: tipner ($200 in chips) 
Seat 5: butcheN18 ($221 in chips) 
Seat 6: di0d80 ($200 in chips) 
Seat 7: matiko09 ($200 in chips) 
Seat 8: Glushchenko ($200 in chips) 
Seat 9: Fish4trips ($200.35 in chips) 
Glushchenko: posts small blind $1
Fish4trips: posts big blind $2
*** HOLE CARDS ***
Dealt to matiko09 [2s 8s]
TonnaMunz: folds 
Moemors: folds 
Koolniknik: folds 
tipner: folds 
butcheN18: folds 
di0d80: folds 
matiko09: folds 
Glushchenko: folds 
Uncalled bet ($1) returned to Fish4trips
Fish4trips collected $2 from pot
Fish4trips: doesn't show hand 
*** SUMMARY ***
Total pot $2 | Rake $0 
Seat 1: TonnaMunz folded before Flop (didn't bet)
Seat 2: Moemors folded before Flop (didn't bet)
Seat 3: Koolniknik folded before Flop (didn't bet)
Seat 4: tipner folded before Flop (didn't bet)
Seat 5: butcheN18 folded before Flop (didn't bet)
Seat 6: di0d80 folded before Flop (didn't bet)
Seat 7: matiko09 (button) folded before Flop (didn't bet)
Seat 8: Glushchenko (small blind) folded before Flop
Seat 9: Fish4trips (big blind) collected ($2)





PokerStars Hand #151941911489:  Hold'em No Limit ($0.50/$1.00 USD) - 2016/04/15 13:03:17 CET [2016/04/15 7:03:17 ET]
Table 'Gase II' 9-max Seat #1 is the button
Seat 1: maxxmeister ($100 in chips) 
Seat 2: aseban11 ($103.15 in chips) 
Seat 3: djammusic ($40 in chips) 
Seat 5: Paul6999 ($40 in chips) 
Seat 6: matiko09 ($100 in chips) 
Seat 8: choupai ($122.67 in chips) 
Seat 9: UberLycan ($110.68 in chips) 
aseban11: posts small blind $0.50
djammusic: posts big blind $1
Filojoes: sits out 
danbo577: sits out 
*** HOLE CARDS ***
Dealt to matiko09 [8c 4h]
Paul6999: folds 
Paul6999 leaves the table
matiko09: folds 
choupai: folds 
UberLycan: raises $2 to $3
maxxmeister: raises $8 to $11
aseban11: folds 
djammusic: folds 
UberLycan: folds 
Uncalled bet ($8) returned to maxxmeister
maxxmeister collected $7.50 from pot
maxxmeister: doesn't show hand 
*** SUMMARY ***
Total pot $7.50 | Rake $0 
Seat 1: maxxmeister (button) collected ($7.50)
Seat 2: aseban11 (small blind) folded before Flop
Seat 3: djammusic (big blind) folded before Flop
Seat 5: Paul6999 folded before Flop (didn't bet)
Seat 6: matiko09 folded before Flop (didn't bet)
Seat 8: choupai folded before Flop (didn't bet)
Seat 9: UberLycan folded before Flop





PokerStars Hand #151941913103:  Hold'em No Limit ($0.50/$1.00 USD) - 2016/04/15 13:03:21 CET [2016/04/15 7:03:21 ET]
Table 'Matterania III' 9-max Seat #3 is the button
Seat 1: di0d80 ($102.04 in chips) 
Seat 2: aseban11 ($102.90 in chips) 
Seat 3: ardo888 ($122.07 in chips) 
Seat 4: wangzhuoming ($111.82 in chips) 
Seat 5: Vermm ($85.74 in chips) 
Seat 6: matiko09 ($100.20 in chips) 
Seat 7: Yaaaazz ($107.46 in chips) 
Seat 9: flk.Dasas ($105.77 in chips) 
wangzhuoming: posts small blind $0.50
Vermm: posts big blind $1
di0d80: posts the ante $0.20
aseban11: posts the ante $0.20
ardo888: posts the ante $0.20
wangzhuoming: posts the ante $0.20
Vermm: posts the ante $0.20
matiko09: posts the ante $0.20
Yaaaazz: posts the ante $0.20
flk.Dasas: posts the ante $0.20
*** HOLE CARDS ***
Dealt to matiko09 [3d 9d]
matiko09: folds 
Yaaaazz: folds 
flk.Dasas: raises $3 to $4
di0d80: folds 
aseban11: folds 
ardo888: folds 
wangzhuoming: folds 
Vermm: folds 
Uncalled bet ($3) returned to flk.Dasas
flk.Dasas collected $4.10 from pot
flk.Dasas: doesn't show hand 
*** SUMMARY ***
Total pot $4.10 | Rake $0 
Seat 1: di0d80 folded before Flop (didn't bet)
Seat 2: aseban11 folded before Flop (didn't bet)
Seat 3: ardo888 (button) folded before Flop (didn't bet)
Seat 4: wangzhuoming (small blind) folded before Flop
Seat 5: Vermm (big blind) folded before Flop
Seat 6: matiko09 folded before Flop (didn't bet)
Seat 7: Yaaaazz folded before Flop (didn't bet)
Seat 9: flk.Dasas collected ($4.10)





PokerStars Hand #151941925964:  Hold'em No Limit ($0.50/$1.00 USD) - 2016/04/15 13:03:48 CET [2016/04/15 7:03:48 ET]
Table 'Navi' 9-max Seat #9 is the button
Seat 2: butcheN18 ($100 in chips) 
Seat 4: Effort92 ($146.03 in chips) 
Seat 5: StarsAbove ($101.68 in chips) 
Seat 6: Glushchenko ($115.66 in chips) 
Seat 7: yoshidao ($76.91 in chips) 
Seat 8: djammusic ($41 in chips) 
Seat 9: matiko09 ($100 in chips) 
tipner will be allowed to play after the button
butcheN18: posts small blind $0.50
Effort92: posts big blind $1
*** HOLE CARDS ***
Dealt to matiko09 [4c 8h]
StarsAbove: raises $2 to $3
Glushchenko: folds 
yoshidao: calls $3
djammusic: folds 
matiko09: folds 
butcheN18: calls $2.50
Effort92: folds 
*** FLOP *** [As 9s 8c]
butcheN18: checks 
StarsAbove: bets $9
yoshidao: calls $9
butcheN18: folds 
*** TURN *** [As 9s 8c] [3h]
StarsAbove: bets $22
yoshidao: calls $22
*** RIVER *** [As 9s 8c 3h] [Qs]
StarsAbove: checks 
yoshidao: bets $42.91 and is all-in
StarsAbove: folds 
Uncalled bet ($42.91) returned to yoshidao
yoshidao collected $69.50 from pot
yoshidao: doesn't show hand 
*** SUMMARY ***
Total pot $72 | Rake $2.50 
Board [As 9s 8c 3h Qs]
Seat 2: butcheN18 (small blind) folded on the Flop
Seat 4: Effort92 (big blind) folded before Flop
Seat 5: StarsAbove folded on the River
Seat 6: Glushchenko folded before Flop (didn't bet)
Seat 7: yoshidao collected ($69.50)
Seat 8: djammusic folded before Flop (didn't bet)
Seat 9: matiko09 (button) folded before Flop (didn't bet)





PokerStars Hand #151941926132:  Hold'em No Limit ($0.50/$1.00 USD) - 2016/04/15 13:03:49 CET [2016/04/15 7:03:49 ET]
Table 'Chiny II' 9-max Seat #5 is the button
Seat 1: CI58 ($124.84 in chips) 
Seat 2: AceFarky ($101.43 in chips) 
Seat 3: powerbel ($48 in chips) 
Seat 5: Yaaaazz ($118.78 in chips) 
Seat 6: choupai ($39 in chips) 
Seat 7: matiko09 ($138.98 in chips) 
Seat 9: ardo888 ($110.12 in chips) 
choupai: posts small blind $0.50
matiko09: posts big blind $1
SanychStar: sits out 
*** HOLE CARDS ***
Dealt to matiko09 [3h Ts]
ardo888: folds 
CI58: folds 
AceFarky: folds 
powerbel: folds 
Yaaaazz: folds 
choupai: raises $2 to $3
matiko09: folds 
Uncalled bet ($2) returned to choupai
choupai collected $2 from pot
choupai: doesn't show hand 
*** SUMMARY ***
Total pot $2 | Rake $0 
Seat 1: CI58 folded before Flop (didn't bet)
Seat 2: AceFarky folded before Flop (didn't bet)
Seat 3: powerbel folded before Flop (didn't bet)
Seat 5: Yaaaazz (button) folded before Flop (didn't bet)
Seat 6: choupai (small blind) collected ($2)
Seat 7: matiko09 (big blind) folded before Flop
Seat 9: ardo888 folded before Flop (didn't bet)





PokerStars Hand #151941928441:  Hold'em No Limit ($0.50/$1.00 USD) - 2016/04/15 13:03:54 CET [2016/04/15 7:03:54 ET]
Table 'Gase II' 9-max Seat #2 is the button
Seat 1: maxxmeister ($104.50 in chips) 
Seat 2: aseban11 ($102.65 in chips) 
Seat 3: djammusic ($39 in chips) 
Seat 4: Filojoes ($100 in chips) 
Seat 6: matiko09 ($100 in chips) 
Seat 8: choupai ($122.67 in chips) 
Seat 9: UberLycan ($107.68 in chips) 
djammusic: posts small blind $0.50
Filojoes: posts big blind $1
danbo577: sits out 
*** HOLE CARDS ***
Dealt to matiko09 [7h Tc]
matiko09: folds 
choupai: folds 
UberLycan: folds 
maxxmeister: folds 
aseban11: folds 
djammusic: raises $1.15 to $2.15
Filojoes: calls $1.15
*** FLOP *** [8s 5c 9s]
djammusic: checks 
Filojoes: checks 
*** TURN *** [8s 5c 9s] [5h]
djammusic: checks 
Filojoes: bets $2.85
djammusic: folds 
Uncalled bet ($2.85) returned to Filojoes
Filojoes collected $4.08 from pot
Filojoes: doesn't show hand 
*** SUMMARY ***
Total pot $4.30 | Rake $0.22 
Board [8s 5c 9s 5h]
Seat 1: maxxmeister folded before Flop (didn't bet)
Seat 2: aseban11 (button) folded before Flop (didn't bet)
Seat 3: djammusic (small blind) folded on the Turn
Seat 4: Filojoes (big blind) collected ($4.08)
Seat 6: matiko09 folded before Flop (didn't bet)
Seat 8: choupai folded before Flop (didn't bet)
Seat 9: UberLycan folded before Flop (didn't bet)





PokerStars Hand #151941931507:  Hold'em No Limit ($1/$2 USD) - 2016/04/15 13:04:00 CET [2016/04/15 7:04:00 ET]
Table 'Patroclus II' 9-max Seat #8 is the button
Seat 1: TonnaMunz ($225.46 in chips) 
Seat 2: Moemors ($148.89 in chips) 
Seat 3: Koolniknik ($196.85 in chips) 
Seat 4: tipner ($200 in chips) 
Seat 5: butcheN18 ($221 in chips) 
Seat 6: di0d80 ($200 in chips) 
Seat 7: matiko09 ($200 in chips) 
Seat 8: Glushchenko ($200 in chips) 
Seat 9: Fish4trips ($201.35 in chips) 
Fish4trips: posts small blind $1
TonnaMunz: posts big blind $2
*** HOLE CARDS ***
Dealt to matiko09 [6s 4s]
Moemors: calls $2
Koolniknik: folds 
tipner: raises $6 to $8
butcheN18: folds 
di0d80: folds 
matiko09: folds 
Glushchenko: folds 
Fish4trips: folds 
TonnaMunz: folds 
Moemors: calls $6
*** FLOP *** [5h As 8s]
Moemors: checks 
tipner: bets $10
Moemors: calls $10
*** TURN *** [5h As 8s] [7s]
Moemors: checks 
tipner: bets $32
Moemors: folds 
Uncalled bet ($32) returned to tipner
tipner collected $37.05 from pot
tipner: doesn't show hand 
*** SUMMARY ***
Total pot $39 | Rake $1.95 
Board [5h As 8s 7s]
Seat 1: TonnaMunz (big blind) folded before Flop
Seat 2: Moemors folded on the Turn
Seat 3: Koolniknik folded before Flop (didn't bet)
Seat 4: tipner collected ($37.05)
Seat 5: butcheN18 folded before Flop (didn't bet)
Seat 6: di0d80 folded before Flop (didn't bet)
Seat 7: matiko09 folded before Flop (didn't bet)
Seat 8: Glushchenko (button) folded before Flop (didn't bet)
Seat 9: Fish4trips (small blind) folded before Flop





PokerStars Hand #151941934573:  Hold'em No Limit ($0.50/$1.00 USD) - 2016/04/15 13:04:07 CET [2016/04/15 7:04:07 ET]
Table 'Matterania III' 9-max Seat #4 is the button
Seat 1: di0d80 ($101.84 in chips) 
Seat 2: aseban11 ($102.70 in chips) 
Seat 3: ardo888 ($121.87 in chips) 
Seat 4: wangzhuoming ($111.12 in chips) 
Seat 5: Vermm ($84.54 in chips) 
Seat 6: matiko09 ($100 in chips) 
Seat 7: Yaaaazz ($107.26 in chips) 
Seat 9: flk.Dasas ($108.67 in chips) 
Vermm: posts small blind $0.50
matiko09: posts big blind $1
di0d80: posts the ante $0.20
aseban11: posts the ante $0.20
ardo888: posts the ante $0.20
wangzhuoming: posts the ante $0.20
Vermm: posts the ante $0.20
matiko09: posts the ante $0.20
Yaaaazz: posts the ante $0.20
flk.Dasas: posts the ante $0.20
*** HOLE CARDS ***
Dealt to matiko09 [2d 9h]
Yaaaazz: folds 
flk.Dasas: raises $3 to $4
di0d80: folds 
aseban11: calls $4
ardo888: folds 
wangzhuoming: folds 
Vermm: calls $3.50
matiko09: folds 
*** FLOP *** [Jd Ac 2h]
Vermm: checks 
flk.Dasas: bets $8.18
aseban11: calls $8.18
Vermm: folds 
*** TURN *** [Jd Ac 2h] [Kd]
flk.Dasas: checks 
aseban11: checks 
*** RIVER *** [Jd Ac 2h Kd] [Kh]
flk.Dasas: checks 
aseban11: checks 
*** SHOW DOWN ***
flk.Dasas: shows [Ah Th] (two pair, Aces and Kings)
aseban11: shows [3s As] (two pair, Aces and Kings)
flk.Dasas collected $14.71 from pot
aseban11 collected $14.70 from pot
*** SUMMARY ***
Total pot $30.96 | Rake $1.55 
Board [Jd Ac 2h Kd Kh]
Seat 1: di0d80 folded before Flop (didn't bet)
Seat 2: aseban11 showed [3s As] and won ($14.70) with two pair, Aces and Kings
Seat 3: ardo888 folded before Flop (didn't bet)
Seat 4: wangzhuoming (button) folded before Flop (didn't bet)
Seat 5: Vermm (small blind) folded on the Flop
Seat 6: matiko09 (big blind) folded before Flop
Seat 7: Yaaaazz folded before Flop (didn't bet)
Seat 9: flk.Dasas showed [Ah Th] and won ($14.71) with two pair, Aces and Kings





PokerStars Hand #151941937478:  Hold'em No Limit ($0.50/$1.00 USD) - 2016/04/15 13:04:14 CET [2016/04/15 7:04:14 ET]
Table 'Lamberta III' 9-max Seat #1 is the button
Seat 1: Westpants ($100 in chips) 
Seat 2: Vermm ($82.59 in chips) 
Seat 3: butcheN18 ($107.44 in chips) 
Seat 4: Filojoes ($100 in chips) 
Seat 6: aseban11 ($103.68 in chips) 
Seat 7: ardo888 ($123.29 in chips) 
Seat 8: wangzhuoming ($93 in chips) 
Seat 9: matiko09 ($165.74 in chips) 
Vermm: posts small blind $0.50
butcheN18: posts big blind $1
tipner: sits out 
*** HOLE CARDS ***
Dealt to matiko09 [4d 9c]
Filojoes: folds 
aseban11: raises $2 to $3
ardo888: folds 
wangzhuoming: folds 
matiko09: folds 
Westpants: folds 
Vermm: folds 
butcheN18: folds 
Uncalled bet ($2) returned to aseban11
aseban11 collected $2.50 from pot
aseban11: doesn't show hand 
*** SUMMARY ***
Total pot $2.50 | Rake $0 
Seat 1: Westpants (button) folded before Flop (didn't bet)
Seat 2: Vermm (small blind) folded before Flop
Seat 3: butcheN18 (big blind) folded before Flop
Seat 4: Filojoes folded before Flop (didn't bet)
Seat 6: aseban11 collected ($2.50)
Seat 7: ardo888 folded before Flop (didn't bet)
Seat 8: wangzhuoming folded before Flop (didn't bet)
Seat 9: matiko09 folded before Flop (didn't bet)





PokerStars Hand #151941938840:  Hold'em No Limit ($0.50/$1.00 USD) - 2016/04/15 13:04:17 CET [2016/04/15 7:04:17 ET]
Table 'Chiny II' 9-max Seat #6 is the button
Seat 1: CI58 ($124.84 in chips) 
Seat 2: AceFarky ($101.43 in chips) 
Seat 3: powerbel ($48 in chips) 
Seat 4: 1000karlos ($90.27 in chips) 
Seat 5: Yaaaazz ($118.78 in chips) 
Seat 6: choupai ($40 in chips) 
Seat 7: matiko09 ($137.98 in chips) 
Seat 8: SanychStar ($100 in chips) 
Seat 9: ardo888 ($110.12 in chips) 
matiko09: posts small blind $0.50
SanychStar: posts big blind $1
1000karlos: posts small & big blinds $1.50
*** HOLE CARDS ***
Dealt to matiko09 [Jh Qh]
ardo888: folds 
CI58: folds 
AceFarky: folds 
powerbel: folds 
1000karlos: checks 
Yaaaazz: folds 
choupai: raises $2 to $3
matiko09: calls $2.50
SanychStar: calls $2
1000karlos: calls $2
*** FLOP *** [3c Jc As]
matiko09: checks 
SanychStar: checks 
1000karlos: checks 
choupai: checks 
*** TURN *** [3c Jc As] [Ah]
matiko09: checks 
SanychStar: checks 
1000karlos: checks 
choupai: checks 
*** RIVER *** [3c Jc As Ah] [3s]
matiko09: checks 
SanychStar: checks 
1000karlos: checks 
choupai: checks 
*** SHOW DOWN ***
matiko09: shows [Jh Qh] (two pair, Aces and Jacks)
SanychStar: mucks hand 
1000karlos: mucks hand 
choupai: mucks hand 
matiko09 collected $11.88 from pot
*** SUMMARY ***
Total pot $12.50 | Rake $0.62 
Board [3c Jc As Ah 3s]
Seat 1: CI58 folded before Flop (didn't bet)
Seat 2: AceFarky folded before Flop (didn't bet)
Seat 3: powerbel folded before Flop (didn't bet)
Seat 4: 1000karlos mucked [9s 6d]
Seat 5: Yaaaazz folded before Flop (didn't bet)
Seat 6: choupai (button) mucked [Qs 9c]
Seat 7: matiko09 (small blind) showed [Jh Qh] and won ($11.88) with two pair, Aces and Jacks
Seat 8: SanychStar (big blind) mucked [2s 2d]
Seat 9: ardo888 folded before Flop (didn't bet)





PokerStars Hand #151941946857:  Hold'em No Limit ($1/$2 USD) - 2016/04/15 13:04:34 CET [2016/04/15 7:04:34 ET]
Table 'Adele II' 9-max Seat #3 is the button
Seat 1: coinflip_si ($200 in chips) 
Seat 2: Fish4trips ($200 in chips) 
Seat 3: matiko09 ($370.67 in chips) 
Seat 4: Glushchenko ($200 in chips) 
Seat 6: TonnaMunz ($200 in chips) 
Seat 7: tipner ($232.25 in chips) 
Seat 8: docmarc777 ($234.90 in chips) 
Glushchenko: posts small blind $1
T0ny Adams: is sitting out 
TonnaMunz: posts big blind $2
*** HOLE CARDS ***
Dealt to matiko09 [3h 2h]
tipner: folds 
docmarc777: folds 
coinflip_si: raises $3 to $5
Fish4trips: folds 
matiko09: folds 
Glushchenko: folds 
TonnaMunz: folds 
Uncalled bet ($3) returned to coinflip_si
coinflip_si collected $5 from pot
coinflip_si: doesn't show hand 
*** SUMMARY ***
Total pot $5 | Rake $0 
Seat 1: coinflip_si collected ($5)
Seat 2: Fish4trips folded before Flop (didn't bet)
Seat 3: matiko09 (button) folded before Flop (didn't bet)
Seat 4: Glushchenko (small blind) folded before Flop
Seat 6: TonnaMunz (big blind) folded before Flop
Seat 7: tipner folded before Flop (didn't bet)
Seat 8: docmarc777 folded before Flop (didn't bet)





PokerStars Hand #151941948225:  Hold'em No Limit ($0.50/$1.00 USD) - 2016/04/15 13:04:37 CET [2016/04/15 7:04:37 ET]
Table 'Katja II' 9-max Seat #2 is the button
Seat 1: vrnMike ($120.63 in chips) 
Seat 2: TheJokerMen1 ($81.23 in chips) 
Seat 3: matiko09 ($100 in chips) 
Seat 4: Sutt_420 ($80.20 in chips) 
Seat 5: Dachish ($84.35 in chips) 
Seat 6: ASG2016 ($112.04 in chips) 
Seat 7: Effort92 ($115.42 in chips) 
Seat 8: Glushchenko ($100 in chips) 
matiko09: posts small blind $0.50
Sutt_420: posts big blind $1
*** HOLE CARDS ***
Dealt to matiko09 [6d Th]
Dachish: folds 
ASG2016: folds 
Effort92: folds 
Glushchenko: folds 
vrnMike: raises $1 to $2
TheJokerMen1: folds 
matiko09: folds 
Sutt_420: folds 
Uncalled bet ($1) returned to vrnMike
vrnMike collected $2.50 from pot
*** SUMMARY ***
Total pot $2.50 | Rake $0 
Seat 1: vrnMike collected ($2.50)
Seat 2: TheJokerMen1 (button) folded before Flop (didn't bet)
Seat 3: matiko09 (small blind) folded before Flop
Seat 4: Sutt_420 (big blind) folded before Flop
Seat 5: Dachish folded before Flop (didn't bet)
Seat 6: ASG2016 folded before Flop (didn't bet)
Seat 7: Effort92 folded before Flop (didn't bet)
Seat 8: Glushchenko folded before Flop (didn't bet)





PokerStars Hand #151941949308:  Hold'em No Limit ($0.50/$1.00 USD) - 2016/04/15 13:04:39 CET [2016/04/15 7:04:39 ET]
Table 'Gase II' 9-max Seat #3 is the button
Seat 1: maxxmeister ($104.50 in chips) 
Seat 2: aseban11 ($102.65 in chips) 
Seat 3: djammusic ($36.85 in chips) 
Seat 4: Filojoes ($101.93 in chips) 
Seat 6: matiko09 ($100 in chips) 
Seat 8: choupai ($122.67 in chips) 
Seat 9: UberLycan ($107.68 in chips) 
Filojoes: posts small blind $0.50
matiko09: posts big blind $1
danbo577: sits out 
*** HOLE CARDS ***
Dealt to matiko09 [4d 9h]
choupai: folds 
UberLycan: raises $2 to $3
maxxmeister: folds 
aseban11: folds 
djammusic: raises $4.50 to $7.50
Filojoes: folds 
matiko09: folds 
UberLycan: calls $4.50
*** FLOP *** [6c 7s Jc]
UberLycan: checks 
djammusic: bets $6.27
UberLycan: folds 
Uncalled bet ($6.27) returned to djammusic
djammusic collected $15.68 from pot
djammusic: doesn't show hand 
*** SUMMARY ***
Total pot $16.50 | Rake $0.82 
Board [6c 7s Jc]
Seat 1: maxxmeister folded before Flop (didn't bet)
Seat 2: aseban11 folded before Flop (didn't bet)
Seat 3: djammusic (button) collected ($15.68)
Seat 4: Filojoes (small blind) folded before Flop
Seat 6: matiko09 (big blind) folded before Flop
Seat 8: choupai folded before Flop (didn't bet)
Seat 9: UberLycan folded on the Flop





PokerStars Hand #151941952173:  Hold'em No Limit ($0.50/$1.00 USD) - 2016/04/15 13:04:45 CET [2016/04/15 7:04:45 ET]
Table 'Lamberta III' 9-max Seat #2 is the button
Seat 1: Westpants ($100 in chips) 
Seat 2: Vermm ($82.09 in chips) 
Seat 3: butcheN18 ($106.44 in chips) 
Seat 4: Filojoes ($100 in chips) 
Seat 6: aseban11 ($105.18 in chips) 
Seat 7: ardo888 ($123.29 in chips) 
Seat 8: wangzhuoming ($93 in chips) 
Seat 9: matiko09 ($165.74 in chips) 
butcheN18: posts small blind $0.50
Filojoes: posts big blind $1
tipner: sits out 
*** HOLE CARDS ***
Dealt to matiko09 [Tc 7c]
aseban11: folds 
ardo888: folds 
wangzhuoming: folds 
matiko09: folds 
Westpants: folds 
Vermm: folds 
butcheN18: folds 
Uncalled bet ($0.50) returned to Filojoes
Filojoes collected $1 from pot
Filojoes: doesn't show hand 
*** SUMMARY ***
Total pot $1 | Rake $0 
Seat 1: Westpants folded before Flop (didn't bet)
Seat 2: Vermm (button) folded before Flop (didn't bet)
Seat 3: butcheN18 (small blind) folded before Flop
Seat 4: Filojoes (big blind) collected ($1)
Seat 6: aseban11 folded before Flop (didn't bet)
Seat 7: ardo888 folded before Flop (didn't bet)
Seat 8: wangzhuoming folded before Flop (didn't bet)
Seat 9: matiko09 folded before Flop (didn't bet)





PokerStars Hand #151941957810:  Hold'em No Limit ($1/$2 USD) - 2016/04/15 13:04:58 CET [2016/04/15 7:04:58 ET]
Table 'Adele II' 9-max Seat #4 is the button
Seat 1: coinflip_si ($203 in chips) 
Seat 2: Fish4trips ($200 in chips) 
Seat 3: matiko09 ($370.67 in chips) 
Seat 4: Glushchenko ($200 in chips) 
Seat 6: TonnaMunz ($200 in chips) 
Seat 7: tipner ($232.25 in chips) 
Seat 8: docmarc777 ($234.90 in chips) 
TonnaMunz: posts small blind $1
tipner: posts big blind $2
*** HOLE CARDS ***
Dealt to matiko09 [5s Kh]
docmarc777: folds 
coinflip_si: folds 
Fish4trips: folds 
matiko09: folds 
Glushchenko: folds 
TonnaMunz: raises $3.88 to $5.88
tipner: folds 
Uncalled bet ($3.88) returned to TonnaMunz
TonnaMunz collected $4 from pot
*** SUMMARY ***
Total pot $4 | Rake $0 
Seat 1: coinflip_si folded before Flop (didn't bet)
Seat 2: Fish4trips folded before Flop (didn't bet)
Seat 3: matiko09 folded before Flop (didn't bet)
Seat 4: Glushchenko (button) folded before Flop (didn't bet)
Seat 6: TonnaMunz (small blind) collected ($4)
Seat 7: tipner (big blind) folded before Flop
Seat 8: docmarc777 folded before Flop (didn't bet)





PokerStars Hand #151941961254:  Hold'em No Limit ($0.50/$1.00 USD) - 2016/04/15 13:05:05 CET [2016/04/15 7:05:05 ET]
Table 'Lamberta III' 9-max Seat #3 is the button
Seat 1: Westpants ($100 in chips) 
Seat 2: Vermm ($82.09 in chips) 
Seat 3: butcheN18 ($105.94 in chips) 
Seat 4: Filojoes ($100.50 in chips) 
Seat 5: tipner ($114.35 in chips) 
Seat 6: aseban11 ($105.18 in chips) 
Seat 7: ardo888 ($123.29 in chips) 
Seat 8: wangzhuoming ($93 in chips) 
Seat 9: matiko09 ($165.74 in chips) 
Filojoes: posts small blind $0.50
tipner: posts big blind $1
*** HOLE CARDS ***
Dealt to matiko09 [5s Kc]
aseban11: folds 
ardo888: folds 
wangzhuoming: folds 
matiko09: folds 
Westpants: folds 
Vermm: folds 
butcheN18: folds 
Filojoes: folds 
Uncalled bet ($0.50) returned to tipner
tipner collected $1 from pot
tipner: doesn't show hand 
*** SUMMARY ***
Total pot $1 | Rake $0 
Seat 1: Westpants folded before Flop (didn't bet)
Seat 2: Vermm folded before Flop (didn't bet)
Seat 3: butcheN18 (button) folded before Flop (didn't bet)
Seat 4: Filojoes (small blind) folded before Flop
Seat 5: tipner (big blind) collected ($1)
Seat 6: aseban11 folded before Flop (didn't bet)
Seat 7: ardo888 folded before Flop (didn't bet)
Seat 8: wangzhuoming folded before Flop (didn't bet)
Seat 9: matiko09 folded before Flop (didn't bet)





PokerStars Hand #151941963201:  Hold'em No Limit ($1/$2 USD) - 2016/04/15 13:05:09 CET [2016/04/15 7:05:09 ET]
Table 'Patroclus II' 9-max Seat #9 is the button
Seat 1: TonnaMunz ($223.46 in chips) 
Seat 2: Moemors ($130.89 in chips) 
Seat 3: Koolniknik ($196.85 in chips) 
Seat 4: tipner ($219.05 in chips) 
Seat 5: butcheN18 ($221 in chips) 
Seat 6: di0d80 ($200 in chips) 
Seat 7: matiko09 ($200 in chips) 
Seat 8: Glushchenko ($200 in chips) 
Seat 9: Fish4trips ($200.35 in chips) 
TonnaMunz: posts small blind $1
Moemors: posts big blind $2
*** HOLE CARDS ***
Dealt to matiko09 [Td 6s]
Koolniknik: folds 
tipner: folds 
butcheN18: folds 
di0d80: folds 
matiko09: folds 
Glushchenko: folds 
Fish4trips: raises $2 to $4
TonnaMunz: folds 
Moemors: folds 
Uncalled bet ($2) returned to Fish4trips
Fish4trips collected $5 from pot
Fish4trips: doesn't show hand 
*** SUMMARY ***
Total pot $5 | Rake $0 
Seat 1: TonnaMunz (small blind) folded before Flop
Seat 2: Moemors (big blind) folded before Flop
Seat 3: Koolniknik folded before Flop (didn't bet)
Seat 4: tipner folded before Flop (didn't bet)
Seat 5: butcheN18 folded before Flop (didn't bet)
Seat 6: di0d80 folded before Flop (didn't bet)
Seat 7: matiko09 folded before Flop (didn't bet)
Seat 8: Glushchenko folded before Flop (didn't bet)
Seat 9: Fish4trips (button) collected ($5)





PokerStars Hand #151941967336:  Hold'em No Limit ($0.50/$1.00 USD) - 2016/04/15 13:05:18 CET [2016/04/15 7:05:18 ET]
Table 'Katja II' 9-max Seat #3 is the button
Seat 1: vrnMike ($122.13 in chips) 
Seat 2: TheJokerMen1 ($81.23 in chips) 
Seat 3: matiko09 ($100 in chips) 
Seat 4: Sutt_420 ($79.20 in chips) 
Seat 5: Dachish ($84.35 in chips) 
Seat 6: ASG2016 ($112.04 in chips) 
Seat 7: Effort92 ($115.42 in chips) 
Seat 8: Glushchenko ($100 in chips) 
Sutt_420: posts small blind $0.50
Dachish: posts big blind $1
*** HOLE CARDS ***
Dealt to matiko09 [Td 9d]
ASG2016: folds 
Effort92: folds 
Glushchenko: folds 
vrnMike: folds 
TheJokerMen1: folds 
matiko09: raises $1.27 to $2.27
Sutt_420: folds 
Dachish: folds 
Uncalled bet ($1.27) returned to matiko09
matiko09 collected $2.50 from pot
matiko09: doesn't show hand 
*** SUMMARY ***
Total pot $2.50 | Rake $0 
Seat 1: vrnMike folded before Flop (didn't bet)
Seat 2: TheJokerMen1 folded before Flop (didn't bet)
Seat 3: matiko09 (button) collected ($2.50)
Seat 4: Sutt_420 (small blind) folded before Flop
Seat 5: Dachish (big blind) folded before Flop
Seat 6: ASG2016 folded before Flop (didn't bet)
Seat 7: Effort92 folded before Flop (didn't bet)
Seat 8: Glushchenko folded before Flop (didn't bet)





PokerStars Hand #151941972884:  Hold'em No Limit ($0.50/$1.00 USD) - 2016/04/15 13:05:30 CET [2016/04/15 7:05:30 ET]
Table 'Navi' 9-max Seat #2 is the button
Seat 2: butcheN18 ($100 in chips) 
Seat 4: Effort92 ($145.03 in chips) 
Seat 5: StarsAbove ($100 in chips) 
Seat 6: Glushchenko ($115.66 in chips) 
Seat 7: yoshidao ($112.41 in chips) 
Seat 8: djammusic ($41 in chips) 
Seat 9: matiko09 ($100 in chips) 
Effort92: posts small blind $0.50
StarsAbove: posts big blind $1
tipner: sits out 
*** HOLE CARDS ***
Dealt to matiko09 [Td 4d]
Glushchenko: folds 
yoshidao: calls $1
djammusic: folds 
matiko09: folds 
butcheN18: folds 
Effort92: folds 
StarsAbove: checks 
*** FLOP *** [8d 9s 5d]
StarsAbove: checks 
yoshidao: checks 
*** TURN *** [8d 9s 5d] [Th]
StarsAbove: checks 
yoshidao: checks 
*** RIVER *** [8d 9s 5d Th] [Ks]
StarsAbove: checks 
yoshidao: bets $5
StarsAbove: calls $5
*** SHOW DOWN ***
yoshidao: shows [Qs Kh] (a pair of Kings)
StarsAbove: mucks hand 
yoshidao collected $11.88 from pot
*** SUMMARY ***
Total pot $12.50 | Rake $0.62 
Board [8d 9s 5d Th Ks]
Seat 2: butcheN18 (button) folded before Flop (didn't bet)
Seat 4: Effort92 (small blind) folded before Flop
Seat 5: StarsAbove (big blind) mucked [Kc 4h]
Seat 6: Glushchenko folded before Flop (didn't bet)
Seat 7: yoshidao showed [Qs Kh] and won ($11.88) with a pair of Kings
Seat 8: djammusic folded before Flop (didn't bet)
Seat 9: matiko09 folded before Flop (didn't bet)





PokerStars Hand #151941973052:  Hold'em No Limit ($1/$2 USD) - 2016/04/15 13:05:31 CET [2016/04/15 7:05:31 ET]
Table 'Adele II' 9-max Seat #6 is the button
Seat 1: coinflip_si ($203 in chips) 
Seat 2: Fish4trips ($200 in chips) 
Seat 3: matiko09 ($370.67 in chips) 
Seat 4: Glushchenko ($200 in chips) 
Seat 6: TonnaMunz ($202 in chips) 
Seat 7: tipner ($230.25 in chips) 
Seat 8: docmarc777 ($234.90 in chips) 
tipner: posts small blind $1
docmarc777: posts big blind $2
*** HOLE CARDS ***
Dealt to matiko09 [Kc 2c]
coinflip_si: raises $3 to $5
Fish4trips: folds 
matiko09: folds 
Glushchenko: folds 
TonnaMunz: folds 
tipner: folds 
docmarc777: calls $3
*** FLOP *** [Ks Tc 7c]
docmarc777: bets $6
coinflip_si: folds 
Uncalled bet ($6) returned to docmarc777
docmarc777 collected $10.45 from pot
*** SUMMARY ***
Total pot $11 | Rake $0.55 
Board [Ks Tc 7c]
Seat 1: coinflip_si folded on the Flop
Seat 2: Fish4trips folded before Flop (didn't bet)
Seat 3: matiko09 folded before Flop (didn't bet)
Seat 4: Glushchenko folded before Flop (didn't bet)
Seat 6: TonnaMunz (button) folded before Flop (didn't bet)
Seat 7: tipner (small blind) folded before Flop
Seat 8: docmarc777 (big blind) collected ($10.45)





PokerStars Hand #151941973477:  Hold'em No Limit ($0.50/$1.00 USD) - 2016/04/15 13:05:31 CET [2016/04/15 7:05:31 ET]
Table 'Lamberta III' 9-max Seat #4 is the button
Seat 1: Westpants ($100 in chips) 
Seat 2: Vermm ($82.09 in chips) 
Seat 3: butcheN18 ($105.94 in chips) 
Seat 4: Filojoes ($100 in chips) 
Seat 5: tipner ($114.85 in chips) 
Seat 6: aseban11 ($105.18 in chips) 
Seat 7: ardo888 ($123.29 in chips) 
Seat 8: wangzhuoming ($93 in chips) 
Seat 9: matiko09 ($165.74 in chips) 
tipner: posts small blind $0.50
aseban11: posts big blind $1
*** HOLE CARDS ***
Dealt to matiko09 [7c Jc]
ardo888: folds 
wangzhuoming: folds 
matiko09: folds 
Westpants: raises $2 to $3
Vermm: folds 
butcheN18: folds 
Filojoes: folds 
tipner: folds 
aseban11: folds 
Uncalled bet ($2) returned to Westpants
Westpants collected $2.50 from pot
*** SUMMARY ***
Total pot $2.50 | Rake $0 
Seat 1: Westpants collected ($2.50)
Seat 2: Vermm folded before Flop (didn't bet)
Seat 3: butcheN18 folded before Flop (didn't bet)
Seat 4: Filojoes (button) folded before Flop (didn't bet)
Seat 5: tipner (small blind) folded before Flop
Seat 6: aseban11 (big blind) folded before Flop
Seat 7: ardo888 folded before Flop (didn't bet)
Seat 8: wangzhuoming folded before Flop (didn't bet)
Seat 9: matiko09 folded before Flop (didn't bet)





PokerStars Hand #151941975235:  Hold'em No Limit ($0.50/$1.00 USD) - 2016/04/15 13:05:35 CET [2016/04/15 7:05:35 ET]
Table 'Matterania III' 9-max Seat #5 is the button
Seat 1: di0d80 ($101.64 in chips) 
Seat 2: aseban11 ($105.02 in chips) 
Seat 3: ardo888 ($121.67 in chips) 
Seat 4: wangzhuoming ($110.92 in chips) 
Seat 5: Vermm ($80.34 in chips) 
Seat 6: matiko09 ($100 in chips) 
matiko09: posts small blind $0.50
Yaaaazz: is sitting out 
flk.Dasas: is sitting out 
di0d80: posts big blind $1
di0d80: posts the ante $0.20
aseban11: posts the ante $0.20
ardo888: posts the ante $0.20
wangzhuoming: posts the ante $0.20
Vermm: posts the ante $0.20
matiko09: posts the ante $0.20
*** HOLE CARDS ***
Dealt to matiko09 [As 8s]
flk.Dasas leaves the table
aseban11: raises $2 to $3
ardo888: folds 
Yaaaazz leaves the table
wangzhuoming: folds 
Vermm: calls $3
Filojoes joins the table at seat #7 
matiko09: folds 
di0d80: folds 
*** FLOP *** [2d Th 8d]
aseban11: checks 
Vermm: bets $5
aseban11: folds 
Uncalled bet ($5) returned to Vermm
Vermm collected $8.26 from pot
Vermm: doesn't show hand 
*** SUMMARY ***
Total pot $8.70 | Rake $0.44 
Board [2d Th 8d]
Seat 1: di0d80 (big blind) folded before Flop
Seat 2: aseban11 folded on the Flop
Seat 3: ardo888 folded before Flop (didn't bet)
Seat 4: wangzhuoming folded before Flop (didn't bet)
Seat 5: Vermm (button) collected ($8.26)
Seat 6: matiko09 (small blind) folded before Flop





PokerStars Hand #151941978676:  Hold'em No Limit ($1/$2 USD) - 2016/04/15 13:05:43 CET [2016/04/15 7:05:43 ET]
Table 'Patroclus II' 9-max Seat #1 is the button
Seat 1: TonnaMunz ($222.46 in chips) 
Seat 2: Moemors ($128.89 in chips) 
Seat 3: Koolniknik ($196.85 in chips) 
Seat 4: tipner ($219.05 in chips) 
Seat 5: butcheN18 ($221 in chips) 
Seat 6: di0d80 ($200 in chips) 
Seat 7: matiko09 ($200 in chips) 
Seat 8: Glushchenko ($200 in chips) 
Seat 9: Fish4trips ($203.35 in chips) 
Moemors: posts small blind $1
Koolniknik: posts big blind $2
*** HOLE CARDS ***
Dealt to matiko09 [7c 3c]
tipner: folds 
butcheN18: folds 
di0d80: folds 
matiko09: folds 
Glushchenko: folds 
Fish4trips: folds 
TonnaMunz: raises $2.96 to $4.96
Moemors: calls $3.96
Koolniknik: folds 
*** FLOP *** [9s 6s Td]
Moemors: checks 
TonnaMunz: bets $8
Moemors: raises $8 to $16
TonnaMunz: calls $8
*** TURN *** [9s 6s Td] [7h]
Moemors: bets $20
TonnaMunz: folds 
Uncalled bet ($20) returned to Moemors
Moemors collected $41.72 from pot
Moemors: doesn't show hand 
*** SUMMARY ***
Total pot $43.92 | Rake $2.20 
Board [9s 6s Td 7h]
Seat 1: TonnaMunz (button) folded on the Turn
Seat 2: Moemors (small blind) collected ($41.72)
Seat 3: Koolniknik (big blind) folded before Flop
Seat 4: tipner folded before Flop (didn't bet)
Seat 5: butcheN18 folded before Flop (didn't bet)
Seat 6: di0d80 folded before Flop (didn't bet)
Seat 7: matiko09 folded before Flop (didn't bet)
Seat 8: Glushchenko folded before Flop (didn't bet)
Seat 9: Fish4trips folded before Flop (didn't bet)





PokerStars Hand #151941982100:  Hold'em No Limit ($0.50/$1.00 USD) - 2016/04/15 13:05:50 CET [2016/04/15 7:05:50 ET]
Table 'Katja II' 9-max Seat #4 is the button
Seat 1: vrnMike ($122.13 in chips) 
Seat 2: TheJokerMen1 ($81.23 in chips) 
Seat 3: matiko09 ($101.50 in chips) 
Seat 4: Sutt_420 ($78.70 in chips) 
Seat 5: Dachish ($83.35 in chips) 
Seat 6: ASG2016 ($112.04 in chips) 
Seat 7: Effort92 ($115.42 in chips) 
Seat 8: Glushchenko ($100 in chips) 
Dachish: posts small blind $0.50
ASG2016: posts big blind $1
*** HOLE CARDS ***
Dealt to matiko09 [Ks Ts]
Effort92: folds 
Glushchenko: folds 
vrnMike: folds 
TheJokerMen1: raises $2 to $3
matiko09: calls $3
Sutt_420: folds 
Dachish: folds 
ASG2016: folds 
*** FLOP *** [Kd 2d Th]
TheJokerMen1: bets $5
matiko09: raises $10 to $15
TheJokerMen1: calls $10
*** TURN *** [Kd 2d Th] [7d]
TheJokerMen1: checks 
matiko09: bets $18
TheJokerMen1: folds 
Uncalled bet ($18) returned to matiko09
matiko09 collected $35.62 from pot
matiko09: doesn't show hand 
*** SUMMARY ***
Total pot $37.50 | Rake $1.88 
Board [Kd 2d Th 7d]
Seat 1: vrnMike folded before Flop (didn't bet)
Seat 2: TheJokerMen1 folded on the Turn
Seat 3: matiko09 collected ($35.62)
Seat 4: Sutt_420 (button) folded before Flop (didn't bet)
Seat 5: Dachish (small blind) folded before Flop
Seat 6: ASG2016 (big blind) folded before Flop
Seat 7: Effort92 folded before Flop (didn't bet)
Seat 8: Glushchenko folded before Flop (didn't bet)





PokerStars Hand #151941982549:  Hold'em No Limit ($0.50/$1.00 USD) - 2016/04/15 13:05:51 CET [2016/04/15 7:05:51 ET]
Table 'Kreusa II' 9-max Seat #5 is the button
Seat 1: Biscuit270 ($52.95 in chips) 
Seat 4: Glushchenko ($123.26 in chips) 
Seat 5: aseban11 ($119.78 in chips) 
Seat 6: NOLEN09 ($152.61 in chips) 
Seat 7: matiko09 ($100 in chips) 
Seat 8: djammusic ($44.85 in chips) 
Seat 9: Yaaaazz ($100.68 in chips) 
NOLEN09: posts small blind $0.50
matiko09: posts big blind $1
*** HOLE CARDS ***
Dealt to matiko09 [Ks 4s]
djammusic: folds 
Yaaaazz: folds 
Biscuit270: folds 
Glushchenko: folds 
aseban11: folds 
NOLEN09: folds 
Uncalled bet ($0.50) returned to matiko09
NOLEN09 leaves the table
matiko09 collected $1 from pot
matiko09: doesn't show hand 
*** SUMMARY ***
Total pot $1 | Rake $0 
Seat 1: Biscuit270 folded before Flop (didn't bet)
Seat 4: Glushchenko folded before Flop (didn't bet)
Seat 5: aseban11 (button) folded before Flop (didn't bet)
Seat 6: NOLEN09 (small blind) folded before Flop
Seat 7: matiko09 (big blind) collected ($1)
Seat 8: djammusic folded before Flop (didn't bet)
Seat 9: Yaaaazz folded before Flop (didn't bet)





PokerStars Hand #151941984013:  Hold'em No Limit ($0.50/$1.00 USD) - 2016/04/15 13:05:54 CET [2016/04/15 7:05:54 ET]
Table 'Gase II' 9-max Seat #4 is the button
Seat 1: maxxmeister ($104.50 in chips) 
Seat 2: aseban11 ($102.65 in chips) 
Seat 3: djammusic ($45.03 in chips) 
Seat 4: Filojoes ($101.43 in chips) 
Seat 6: matiko09 ($100 in chips) 
Seat 7: danbo577 ($80 in chips) 
Seat 8: choupai ($122.67 in chips) 
Seat 9: UberLycan ($100.18 in chips) 
matiko09: posts small blind $0.50
danbo577: posts big blind $1
*** HOLE CARDS ***
Dealt to matiko09 [8d 4d]
choupai: folds 
UberLycan: folds 
choupai leaves the table
maxxmeister: folds 
aseban11: folds 
djammusic: raises $1.02 to $2.02
Filojoes: raises $3.98 to $6
matiko09: folds 
danbo577: folds 
butcheN18 joins the table at seat #8 
djammusic: folds 
Uncalled bet ($3.98) returned to Filojoes
Filojoes collected $5.54 from pot
Filojoes: doesn't show hand 
*** SUMMARY ***
Total pot $5.54 | Rake $0 
Seat 1: maxxmeister folded before Flop (didn't bet)
Seat 2: aseban11 folded before Flop (didn't bet)
Seat 3: djammusic folded before Flop
Seat 4: Filojoes (button) collected ($5.54)
Seat 6: matiko09 (small blind) folded before Flop
Seat 7: danbo577 (big blind) folded before Flop
Seat 8: choupai folded before Flop (didn't bet)
Seat 9: UberLycan folded before Flop (didn't bet)





PokerStars Hand #151941990363:  Hold'em No Limit ($0.50/$1.00 USD) - 2016/04/15 13:06:08 CET [2016/04/15 7:06:08 ET]
Table 'Chiny II' 9-max Seat #7 is the button
Seat 1: CI58 ($124.84 in chips) 
Seat 2: AceFarky ($101.43 in chips) 
Seat 3: powerbel ($48 in chips) 
Seat 4: 1000karlos ($86.77 in chips) 
Seat 5: Yaaaazz ($118.78 in chips) 
Seat 6: choupai ($37 in chips) 
Seat 7: matiko09 ($146.86 in chips) 
Seat 8: SanychStar ($100 in chips) 
Seat 9: ardo888 ($110.12 in chips) 
SanychStar: posts small blind $0.50
ardo888: posts big blind $1
*** HOLE CARDS ***
Dealt to matiko09 [3s 8h]
CI58: folds 
AceFarky: folds 
powerbel: folds 
1000karlos: folds 
Yaaaazz: folds 
choupai: folds 
matiko09: folds 
SanychStar: raises $1.50 to $2.50
ardo888: folds 
Uncalled bet ($1.50) returned to SanychStar
SanychStar collected $2 from pot
*** SUMMARY ***
Total pot $2 | Rake $0 
Seat 1: CI58 folded before Flop (didn't bet)
Seat 2: AceFarky folded before Flop (didn't bet)
Seat 3: powerbel folded before Flop (didn't bet)
Seat 4: 1000karlos folded before Flop (didn't bet)
Seat 5: Yaaaazz folded before Flop (didn't bet)
Seat 6: choupai folded before Flop (didn't bet)
Seat 7: matiko09 (button) folded before Flop (didn't bet)
Seat 8: SanychStar (small blind) collected ($2)
Seat 9: ardo888 (big blind) folded before Flop





PokerStars Hand #151941992235:  Hold'em No Limit ($0.50/$1.00 USD) - 2016/04/15 13:06:13 CET [2016/04/15 7:06:13 ET]
Table 'Kreusa II' 9-max Seat #7 is the button
Seat 1: Biscuit270 ($52.95 in chips) 
Seat 4: Glushchenko ($123.26 in chips) 
Seat 5: aseban11 ($119.78 in chips) 
Seat 7: matiko09 ($100.50 in chips) 
Seat 8: djammusic ($44.85 in chips) 
djammusic: posts small blind $0.50
Yaaaazz: is sitting out 
Biscuit270: posts big blind $1
*** HOLE CARDS ***
Dealt to matiko09 [Ks Js]
Glushchenko: raises $2 to $3
aseban11: folds 
matiko09: calls $3
djammusic: folds 
Biscuit270: folds 
*** FLOP *** [6s Kh 9d]
Yaaaazz leaves the table
Filojoes joins the table at seat #6 
Filojoes leaves the table
Glushchenko: checks 
matiko09: bets $4.15
Glushchenko: calls $4.15
*** TURN *** [6s Kh 9d] [Ac]
Glushchenko: checks 
matiko09: checks 
*** RIVER *** [6s Kh 9d Ac] [9c]
Glushchenko: checks 
matiko09: checks 
*** SHOW DOWN ***
Glushchenko: shows [As Ts] (two pair, Aces and Nines)
matiko09: mucks hand 
Glushchenko collected $15.01 from pot
*** SUMMARY ***
Total pot $15.80 | Rake $0.79 
Board [6s Kh 9d Ac 9c]
Seat 1: Biscuit270 (big blind) folded before Flop
Seat 4: Glushchenko showed [As Ts] and won ($15.01) with two pair, Aces and Nines
Seat 5: aseban11 folded before Flop (didn't bet)
Seat 7: matiko09 (button) mucked [Ks Js]
Seat 8: djammusic (small blind) folded before Flop





PokerStars Hand #151941992694:  Hold'em No Limit ($0.50/$1.00 USD) - 2016/04/15 13:06:14 CET [2016/04/15 7:06:14 ET]
Table 'Matterania III' 9-max Seat #6 is the button
Seat 1: di0d80 ($100.44 in chips) 
Seat 2: aseban11 ($101.82 in chips) 
Seat 3: ardo888 ($121.47 in chips) 
Seat 4: wangzhuoming ($110.72 in chips) 
Seat 5: Vermm ($85.40 in chips) 
Seat 6: matiko09 ($100 in chips) 
Filojoes will be allowed to play after the button
di0d80: posts small blind $0.50
aseban11: posts big blind $1
di0d80: posts the ante $0.20
aseban11: posts the ante $0.20
ardo888: posts the ante $0.20
wangzhuoming: posts the ante $0.20
Vermm: posts the ante $0.20
matiko09: posts the ante $0.20
*** HOLE CARDS ***
Dealt to matiko09 [Jd 4c]
ardo888: folds 
wangzhuoming: folds 
Vermm: folds 
butcheN18 joins the table at seat #9 
matiko09: folds 
di0d80: raises $2 to $3
aseban11: folds 
Uncalled bet ($2) returned to di0d80
di0d80 collected $3.20 from pot
di0d80: doesn't show hand 
*** SUMMARY ***
Total pot $3.20 | Rake $0 
Seat 1: di0d80 (small blind) collected ($3.20)
Seat 2: aseban11 (big blind) folded before Flop
Seat 3: ardo888 folded before Flop (didn't bet)
Seat 4: wangzhuoming folded before Flop (didn't bet)
Seat 5: Vermm folded before Flop (didn't bet)
Seat 6: matiko09 (button) folded before Flop (didn't bet)





PokerStars Hand #151941993252:  Hold'em No Limit ($1/$2 USD) - 2016/04/15 13:06:15 CET [2016/04/15 7:06:15 ET]
Table 'Adele II' 9-max Seat #7 is the button
Seat 1: coinflip_si ($200 in chips) 
Seat 2: Fish4trips ($200 in chips) 
Seat 3: matiko09 ($370.67 in chips) 
Seat 4: Glushchenko ($200 in chips) 
Seat 6: TonnaMunz ($202 in chips) 
Seat 7: tipner ($229.25 in chips) 
Seat 8: docmarc777 ($240.35 in chips) 
docmarc777: posts small blind $1
coinflip_si: posts big blind $2
*** HOLE CARDS ***
Dealt to matiko09 [8h 4d]
Fish4trips: folds 
matiko09: folds 
Glushchenko: raises $4 to $6
TonnaMunz: calls $6
tipner: folds 
docmarc777: folds 
coinflip_si: folds 
*** FLOP *** [9h Ad Qd]
Glushchenko: checks 
TonnaMunz: checks 
*** TURN *** [9h Ad Qd] [Qh]
Glushchenko: checks 
TonnaMunz: checks 
*** RIVER *** [9h Ad Qd Qh] [Ts]
Glushchenko: checks 
TonnaMunz: checks 
*** SHOW DOWN ***
Glushchenko: shows [8c 8d] (two pair, Queens and Eights)
TonnaMunz: shows [Ac 3c] (two pair, Aces and Queens)
TonnaMunz collected $14.25 from pot
*** SUMMARY ***
Total pot $15 | Rake $0.75 
Board [9h Ad Qd Qh Ts]
Seat 1: coinflip_si (big blind) folded before Flop
Seat 2: Fish4trips folded before Flop (didn't bet)
Seat 3: matiko09 folded before Flop (didn't bet)
Seat 4: Glushchenko showed [8c 8d] and lost with two pair, Queens and Eights
Seat 6: TonnaMunz showed [Ac 3c] and won ($14.25) with two pair, Aces and Queens
Seat 7: tipner (button) folded before Flop (didn't bet)
Seat 8: docmarc777 (small blind) folded before Flop





PokerStars Hand #151941995727:  Hold'em No Limit ($0.50/$1.00 USD) - 2016/04/15 13:06:20 CET [2016/04/15 7:06:20 ET]
Table 'Navi' 9-max Seat #4 is the button
Seat 2: butcheN18 ($100 in chips) 
Seat 4: Effort92 ($144.53 in chips) 
Seat 5: StarsAbove ($100 in chips) 
Seat 6: Glushchenko ($115.66 in chips) 
Seat 7: yoshidao ($118.29 in chips) 
Seat 8: djammusic ($41 in chips) 
Seat 9: matiko09 ($100 in chips) 
StarsAbove: posts small blind $0.50
Glushchenko: posts big blind $1
tipner: sits out 
*** HOLE CARDS ***
Dealt to matiko09 [8s 2h]
yoshidao: calls $1
djammusic: folds 
matiko09: folds 
butcheN18: raises $3.18 to $4.18
Effort92: folds 
StarsAbove: folds 
Glushchenko: folds 
yoshidao: calls $3.18
*** FLOP *** [4c 8h 5s]
yoshidao: bets $5
butcheN18: folds 
Uncalled bet ($5) returned to yoshidao
yoshidao collected $9.37 from pot
yoshidao: doesn't show hand 
*** SUMMARY ***
Total pot $9.86 | Rake $0.49 
Board [4c 8h 5s]
Seat 2: butcheN18 folded on the Flop
Seat 4: Effort92 (button) folded before Flop (didn't bet)
Seat 5: StarsAbove (small blind) folded before Flop
Seat 6: Glushchenko (big blind) folded before Flop
Seat 7: yoshidao collected ($9.37)
Seat 8: djammusic folded before Flop (didn't bet)
Seat 9: matiko09 folded before Flop (didn't bet)





PokerStars Hand #151941996066:  Hold'em No Limit ($0.50/$1.00 USD) - 2016/04/15 13:06:21 CET [2016/04/15 7:06:21 ET]
Table 'Lamberta III' 9-max Seat #5 is the button
Seat 1: Westpants ($101.50 in chips) 
Seat 2: Vermm ($82.09 in chips) 
Seat 3: butcheN18 ($105.94 in chips) 
Seat 4: Filojoes ($100 in chips) 
Seat 5: tipner ($114.35 in chips) 
Seat 6: aseban11 ($104.18 in chips) 
Seat 7: ardo888 ($123.29 in chips) 
Seat 8: wangzhuoming ($93 in chips) 
Seat 9: matiko09 ($165.74 in chips) 
aseban11: posts small blind $0.50
ardo888: posts big blind $1
*** HOLE CARDS ***
Dealt to matiko09 [4h 6d]
wangzhuoming has timed out while being disconnected
wangzhuoming: folds 
wangzhuoming is disconnected 
matiko09: folds 
Westpants: folds 
Vermm: raises $2 to $3
butcheN18: folds 
Filojoes: folds 
tipner: folds 
aseban11: folds 
ardo888: folds 
Uncalled bet ($2) returned to Vermm
Vermm collected $2.50 from pot
Vermm: doesn't show hand 
*** SUMMARY ***
Total pot $2.50 | Rake $0 
Seat 1: Westpants folded before Flop (didn't bet)
Seat 2: Vermm collected ($2.50)
Seat 3: butcheN18 folded before Flop (didn't bet)
Seat 4: Filojoes folded before Flop (didn't bet)
Seat 5: tipner (button) folded before Flop (didn't bet)
Seat 6: aseban11 (small blind) folded before Flop
Seat 7: ardo888 (big blind) folded before Flop
Seat 8: wangzhuoming folded before Flop (didn't bet)
Seat 9: matiko09 folded before Flop (didn't bet)





PokerStars Hand #151942001862:  Hold'em No Limit ($0.50/$1.00 USD) - 2016/04/15 13:06:34 CET [2016/04/15 7:06:34 ET]
Table 'Chiny II' 9-max Seat #8 is the button
Seat 2: AceFarky ($101.43 in chips) 
Seat 3: powerbel ($48 in chips) 
Seat 4: 1000karlos ($86.77 in chips) 
Seat 5: Yaaaazz ($118.78 in chips) 
Seat 6: choupai ($37 in chips) 
Seat 7: matiko09 ($146.86 in chips) 
Seat 8: SanychStar ($101 in chips) 
Seat 9: ardo888 ($109.12 in chips) 
ardo888: posts small blind $0.50
CI58: is sitting out 
AceFarky: posts big blind $1
*** HOLE CARDS ***
Dealt to matiko09 [8d 7h]
CI58 leaves the table
powerbel: folds 
1000karlos: folds 
Yaaaazz: folds 
choupai: folds 
matiko09: folds 
SanychStar: folds 
ardo888: folds 
Uncalled bet ($0.50) returned to AceFarky
AceFarky collected $1 from pot
AceFarky: doesn't show hand 
*** SUMMARY ***
Total pot $1 | Rake $0 
Seat 2: AceFarky (big blind) collected ($1)
Seat 3: powerbel folded before Flop (didn't bet)
Seat 4: 1000karlos folded before Flop (didn't bet)
Seat 5: Yaaaazz folded before Flop (didn't bet)
Seat 6: choupai folded before Flop (didn't bet)
Seat 7: matiko09 folded before Flop (didn't bet)
Seat 8: SanychStar (button) folded before Flop (didn't bet)
Seat 9: ardo888 (small blind) folded before Flop





PokerStars Hand #151942002741:  Hold'em No Limit ($0.50/$1.00 USD) - 2016/04/15 13:06:36 CET [2016/04/15 7:06:36 ET]
Table 'Matterania III' 9-max Seat #1 is the button
Seat 1: di0d80 ($102.44 in chips) 
Seat 2: aseban11 ($100.62 in chips) 
Seat 3: ardo888 ($121.27 in chips) 
Seat 4: wangzhuoming ($110.52 in chips) 
Seat 5: Vermm ($85.20 in chips) 
Seat 6: matiko09 ($100 in chips) 
aseban11: posts small blind $0.50
ardo888: posts big blind $1
Filojoes: sits out 
butcheN18: sits out 
di0d80: posts the ante $0.20
aseban11: posts the ante $0.20
ardo888: posts the ante $0.20
wangzhuoming: posts the ante $0.20
Vermm: posts the ante $0.20
matiko09: posts the ante $0.20
*** HOLE CARDS ***
Dealt to matiko09 [6h 2d]
wangzhuoming is disconnected 
wangzhuoming is connected 
wangzhuoming: raises $2 to $3
Vermm: calls $3
matiko09: folds 
di0d80: folds 
aseban11: folds 
ardo888: raises $10.50 to $13.50
wangzhuoming: raises $17.50 to $31
Vermm: folds 
ardo888: raises $90.07 to $121.07 and is all-in
wangzhuoming: folds 
Uncalled bet ($90.07) returned to ardo888
ardo888 collected $66.70 from pot
ardo888: doesn't show hand 
*** SUMMARY ***
Total pot $66.70 | Rake $0 
Seat 1: di0d80 (button) folded before Flop (didn't bet)
Seat 2: aseban11 (small blind) folded before Flop
Seat 3: ardo888 (big blind) collected ($66.70)
Seat 4: wangzhuoming folded before Flop
Seat 5: Vermm folded before Flop
Seat 6: matiko09 folded before Flop (didn't bet)





PokerStars Hand #151942009764:  Hold'em No Limit ($0.50/$1.00 USD) - 2016/04/15 13:06:51 CET [2016/04/15 7:06:51 ET]
Table 'Chiny II' 9-max Seat #9 is the button
Seat 2: AceFarky ($101.93 in chips) 
Seat 3: powerbel ($48 in chips) 
Seat 4: 1000karlos ($86.77 in chips) 
Seat 5: Yaaaazz ($118.78 in chips) 
Seat 6: choupai ($37 in chips) 
Seat 7: matiko09 ($146.86 in chips) 
Seat 8: SanychStar ($101 in chips) 
Seat 9: ardo888 ($108.62 in chips) 
AceFarky: posts small blind $0.50
powerbel: posts big blind $1
*** HOLE CARDS ***
Dealt to matiko09 [9h 9d]
aseban11 joins the table at seat #1 
1000karlos has timed out
1000karlos: folds 
Yaaaazz: folds 
choupai: folds 
matiko09: raises $2 to $3
SanychStar: folds 
ardo888: folds 
AceFarky: folds 
powerbel: folds 
Uncalled bet ($2) returned to matiko09
matiko09 collected $2.50 from pot
matiko09: doesn't show hand 
*** SUMMARY ***
Total pot $2.50 | Rake $0 
Seat 2: AceFarky (small blind) folded before Flop
Seat 3: powerbel (big blind) folded before Flop
Seat 4: 1000karlos folded before Flop (didn't bet)
Seat 5: Yaaaazz folded before Flop (didn't bet)
Seat 6: choupai folded before Flop (didn't bet)
Seat 7: matiko09 collected ($2.50)
Seat 8: SanychStar folded before Flop (didn't bet)
Seat 9: ardo888 (button) folded before Flop (didn't bet)





PokerStars Hand #151942011980:  Hold'em No Limit ($0.50/$1.00 USD) - 2016/04/15 13:06:56 CET [2016/04/15 7:06:56 ET]
Table 'Gase II' 9-max Seat #6 is the button
Seat 1: maxxmeister ($104.50 in chips) 
Seat 2: aseban11 ($102.65 in chips) 
Seat 3: djammusic ($43.01 in chips) 
Seat 4: Filojoes ($104.95 in chips) 
Seat 6: matiko09 ($100 in chips) 
Seat 7: danbo577 ($79 in chips) 
Seat 8: butcheN18 ($100 in chips) 
Seat 9: UberLycan ($100.18 in chips) 
danbo577: posts small blind $0.50
butcheN18: posts big blind $1
*** HOLE CARDS ***
Dealt to matiko09 [4h 7d]
UberLycan: raises $2 to $3
maxxmeister: folds 
aseban11: folds 
djammusic: folds 
Filojoes: folds 
tipner joins the table at seat #5 
matiko09: folds 
danbo577: folds 
butcheN18: folds 
Uncalled bet ($2) returned to UberLycan
UberLycan collected $2.50 from pot
UberLycan: doesn't show hand 
*** SUMMARY ***
Total pot $2.50 | Rake $0 
Seat 1: maxxmeister folded before Flop (didn't bet)
Seat 2: aseban11 folded before Flop (didn't bet)
Seat 3: djammusic folded before Flop (didn't bet)
Seat 4: Filojoes folded before Flop (didn't bet)
Seat 6: matiko09 (button) folded before Flop (didn't bet)
Seat 7: danbo577 (small blind) folded before Flop
Seat 8: butcheN18 (big blind) folded before Flop
Seat 9: UberLycan collected ($2.50)





PokerStars Hand #151942014628:  Hold'em No Limit ($1/$2 USD) - 2016/04/15 13:07:02 CET [2016/04/15 7:07:02 ET]
Table 'Patroclus II' 9-max Seat #2 is the button
Seat 1: TonnaMunz ($201.50 in chips) 
Seat 2: Moemors ($149.65 in chips) 
Seat 3: Koolniknik ($194.85 in chips) 
Seat 4: tipner ($219.05 in chips) 
Seat 5: butcheN18 ($221 in chips) 
Seat 6: di0d80 ($200 in chips) 
Seat 7: matiko09 ($200 in chips) 
Seat 8: Glushchenko ($200 in chips) 
Seat 9: Fish4trips ($203.35 in chips) 
Koolniknik: posts small blind $1
tipner: posts big blind $2
*** HOLE CARDS ***
Dealt to matiko09 [2c 5c]
butcheN18: folds 
di0d80: folds 
matiko09: folds 
Glushchenko: folds 
Fish4trips: raises $3 to $5
TonnaMunz: folds 
Moemors: folds 
Koolniknik: folds 
tipner: folds 
Uncalled bet ($3) returned to Fish4trips
Fish4trips collected $5 from pot
Fish4trips: doesn't show hand 
*** SUMMARY ***
Total pot $5 | Rake $0 
Seat 1: TonnaMunz folded before Flop (didn't bet)
Seat 2: Moemors (button) folded before Flop (didn't bet)
Seat 3: Koolniknik (small blind) folded before Flop
Seat 4: tipner (big blind) folded before Flop
Seat 5: butcheN18 folded before Flop (didn't bet)
Seat 6: di0d80 folded before Flop (didn't bet)
Seat 7: matiko09 folded before Flop (didn't bet)
Seat 8: Glushchenko folded before Flop (didn't bet)
Seat 9: Fish4trips collected ($5)





PokerStars Hand #151942016633:  Hold'em No Limit ($0.50/$1.00 USD) - 2016/04/15 13:07:06 CET [2016/04/15 7:07:06 ET]
Table 'Navi' 9-max Seat #5 is the button
Seat 2: butcheN18 ($100 in chips) 
Seat 4: Effort92 ($144.53 in chips) 
Seat 5: StarsAbove ($100 in chips) 
Seat 6: Glushchenko ($114.66 in chips) 
Seat 7: yoshidao ($123.48 in chips) 
Seat 8: djammusic ($41 in chips) 
Seat 9: matiko09 ($100 in chips) 
Glushchenko: posts small blind $0.50
yoshidao: posts big blind $1
tipner: sits out 
*** HOLE CARDS ***
Dealt to matiko09 [Qd Jd]
djammusic: folds 
matiko09: raises $2 to $3
butcheN18: folds 
Effort92: calls $3
StarsAbove: folds 
Glushchenko: folds 
yoshidao: folds 
*** FLOP *** [7c Th 5d]
matiko09: bets $4.63
Effort92: calls $4.63
*** TURN *** [7c Th 5d] [5s]
matiko09: checks 
Effort92: checks 
*** RIVER *** [7c Th 5d 5s] [2d]
picka4u leaves the table
matiko09: checks 
di0d80 joins the table at seat #3 
Effort92: checks 
*** SHOW DOWN ***
matiko09: shows [Qd Jd] (a pair of Fives)
Effort92: shows [Ah Ks] (a pair of Fives - Ace kicker)
Effort92 collected $15.92 from pot
*** SUMMARY ***
Total pot $16.76 | Rake $0.84 
Board [7c Th 5d 5s 2d]
Seat 2: butcheN18 folded before Flop (didn't bet)
Seat 4: Effort92 showed [Ah Ks] and won ($15.92) with a pair of Fives
Seat 5: StarsAbove (button) folded before Flop (didn't bet)
Seat 6: Glushchenko (small blind) folded before Flop
Seat 7: yoshidao (big blind) folded before Flop
Seat 8: djammusic folded before Flop (didn't bet)
Seat 9: matiko09 showed [Qd Jd] and lost with a pair of Fives





PokerStars Hand #151942025460:  Hold'em No Limit ($0.50/$1.00 USD) - 2016/04/15 13:07:25 CET [2016/04/15 7:07:25 ET]
Table 'Gase II' 9-max Seat #7 is the button
Seat 1: maxxmeister ($104.50 in chips) 
Seat 2: aseban11 ($102.65 in chips) 
Seat 3: djammusic ($43.01 in chips) 
Seat 4: Filojoes ($104.95 in chips) 
Seat 6: matiko09 ($100 in chips) 
Seat 7: danbo577 ($78.50 in chips) 
Seat 8: butcheN18 ($100 in chips) 
Seat 9: UberLycan ($101.68 in chips) 
butcheN18: posts small blind $0.50
UberLycan: posts big blind $1
*** HOLE CARDS ***
Dealt to matiko09 [Th 2h]
maxxmeister: folds 
aseban11: folds 
djammusic: folds 
Filojoes: raises $2 to $3
matiko09: folds 
tipner leaves the table
danbo577: calls $3
butcheN18: folds 
UberLycan: folds 
*** FLOP *** [6s Ad 7h]
Filojoes: bets $4.27
danbo577: folds 
Uncalled bet ($4.27) returned to Filojoes
Filojoes collected $7.12 from pot
Filojoes: doesn't show hand 
*** SUMMARY ***
Total pot $7.50 | Rake $0.38 
Board [6s Ad 7h]
Seat 1: maxxmeister folded before Flop (didn't bet)
Seat 2: aseban11 folded before Flop (didn't bet)
Seat 3: djammusic folded before Flop (didn't bet)
Seat 4: Filojoes collected ($7.12)
Seat 6: matiko09 folded before Flop (didn't bet)
Seat 7: danbo577 (button) folded on the Flop
Seat 8: butcheN18 (small blind) folded before Flop
Seat 9: UberLycan (big blind) folded before Flop





PokerStars Hand #151942025734:  Hold'em No Limit ($0.50/$1.00 USD) - 2016/04/15 13:07:26 CET [2016/04/15 7:07:26 ET]
Table 'Lamberta III' 9-max Seat #6 is the button
Seat 1: Westpants ($101.50 in chips) 
Seat 2: Vermm ($83.59 in chips) 
Seat 3: butcheN18 ($105.94 in chips) 
Seat 4: Filojoes ($100 in chips) 
Seat 5: tipner ($114.35 in chips) 
Seat 6: aseban11 ($103.68 in chips) 
Seat 7: ardo888 ($122.29 in chips) 
Seat 8: wangzhuoming ($93 in chips) 
Seat 9: matiko09 ($165.74 in chips) 
ardo888: posts small blind $0.50
wangzhuoming: posts big blind $1
*** HOLE CARDS ***
Dealt to matiko09 [4s Kc]
matiko09: folds 
Westpants: folds 
Vermm: raises $1 to $2
butcheN18: folds 
Filojoes: folds 
tipner: folds 
aseban11: folds 
ardo888: folds 
wangzhuoming: folds 
Uncalled bet ($1) returned to Vermm
Vermm collected $2.50 from pot
Vermm: doesn't show hand 
*** SUMMARY ***
Total pot $2.50 | Rake $0 
Seat 1: Westpants folded before Flop (didn't bet)
Seat 2: Vermm collected ($2.50)
Seat 3: butcheN18 folded before Flop (didn't bet)
Seat 4: Filojoes folded before Flop (didn't bet)
Seat 5: tipner folded before Flop (didn't bet)
Seat 6: aseban11 (button) folded before Flop (didn't bet)
Seat 7: ardo888 (small blind) folded before Flop
Seat 8: wangzhuoming (big blind) folded before Flop
Seat 9: matiko09 folded before Flop (didn't bet)





PokerStars Hand #151942026093:  Hold'em No Limit ($1/$2 USD) - 2016/04/15 13:07:27 CET [2016/04/15 7:07:27 ET]
Table 'Adele II' 9-max Seat #8 is the button
Seat 1: coinflip_si ($200 in chips) 
Seat 2: Fish4trips ($200 in chips) 
Seat 3: matiko09 ($370.67 in chips) 
Seat 4: Glushchenko ($200 in chips) 
Seat 6: TonnaMunz ($210.25 in chips) 
Seat 7: tipner ($229.25 in chips) 
Seat 8: docmarc777 ($239.35 in chips) 
coinflip_si: posts small blind $1
Fish4trips: posts big blind $2
*** HOLE CARDS ***
Dealt to matiko09 [2s Tc]
matiko09: folds 
Glushchenko: folds 
TonnaMunz: folds 
tipner: folds 
docmarc777: folds 
coinflip_si: folds 
Uncalled bet ($1) returned to Fish4trips
Fish4trips collected $2 from pot
Fish4trips: doesn't show hand 
*** SUMMARY ***
Total pot $2 | Rake $0 
Seat 1: coinflip_si (small blind) folded before Flop
Seat 2: Fish4trips (big blind) collected ($2)
Seat 3: matiko09 folded before Flop (didn't bet)
Seat 4: Glushchenko folded before Flop (didn't bet)
Seat 6: TonnaMunz folded before Flop (didn't bet)
Seat 7: tipner folded before Flop (didn't bet)
Seat 8: docmarc777 (button) folded before Flop (didn't bet)





PokerStars Hand #151942027476:  Hold'em No Limit ($0.50/$1.00 USD) - 2016/04/15 13:07:30 CET [2016/04/15 7:07:30 ET]
Table 'Katja II' 9-max Seat #5 is the button
Seat 1: vrnMike ($122.13 in chips) 
Seat 2: TheJokerMen1 ($63.23 in chips) 
Seat 3: matiko09 ($119.12 in chips) 
Seat 4: Sutt_420 ($78.70 in chips) 
Seat 5: Dachish ($82.85 in chips) 
Seat 6: ASG2016 ($111.04 in chips) 
Seat 7: Effort92 ($115.42 in chips) 
Seat 8: Glushchenko ($100 in chips) 
ASG2016: posts small blind $0.50
Effort92: posts big blind $1
aseban11: sits out 
*** HOLE CARDS ***
Dealt to matiko09 [Ts 7h]
Glushchenko: raises $2 to $3
vrnMike: folds 
TheJokerMen1: folds 
matiko09: folds 
Sutt_420: folds 
Dachish: folds 
ASG2016: folds 
Effort92: folds 
Uncalled bet ($2) returned to Glushchenko
Glushchenko collected $2.50 from pot
*** SUMMARY ***
Total pot $2.50 | Rake $0 
Seat 1: vrnMike folded before Flop (didn't bet)
Seat 2: TheJokerMen1 folded before Flop (didn't bet)
Seat 3: matiko09 folded before Flop (didn't bet)
Seat 4: Sutt_420 folded before Flop (didn't bet)
Seat 5: Dachish (button) folded before Flop (didn't bet)
Seat 6: ASG2016 (small blind) folded before Flop
Seat 7: Effort92 (big blind) folded before Flop
Seat 8: Glushchenko collected ($2.50)





PokerStars Hand #151942029876:  Hold'em No Limit ($0.50/$1.00 USD) - 2016/04/15 13:07:35 CET [2016/04/15 7:07:35 ET]
Table 'Chiny II' 9-max Seat #2 is the button
Seat 2: AceFarky ($101.43 in chips) 
Seat 3: powerbel ($47 in chips) 
Seat 4: 1000karlos ($86.77 in chips) 
Seat 5: Yaaaazz ($118.78 in chips) 
Seat 6: choupai ($37 in chips) 
Seat 7: matiko09 ($148.36 in chips) 
Seat 8: SanychStar ($101 in chips) 
Seat 9: ardo888 ($108.62 in chips) 
powerbel: posts small blind $0.50
1000karlos: posts big blind $1
*** HOLE CARDS ***
Dealt to matiko09 [Jd Kc]
Yaaaazz: folds 
choupai: folds 
matiko09: folds 
SanychStar: raises $1.50 to $2.50
ardo888: folds 
AceFarky: folds 
powerbel: folds 
1000karlos: calls $1.50
*** FLOP *** [9s 9d 6h]
1000karlos: checks 
SanychStar: bets $3
1000karlos: folds 
Uncalled bet ($3) returned to SanychStar
SanychStar collected $5.22 from pot
*** SUMMARY ***
Total pot $5.50 | Rake $0.28 
Board [9s 9d 6h]
Seat 2: AceFarky (button) folded before Flop (didn't bet)
Seat 3: powerbel (small blind) folded before Flop
Seat 4: 1000karlos (big blind) folded on the Flop
Seat 5: Yaaaazz folded before Flop (didn't bet)
Seat 6: choupai folded before Flop (didn't bet)
Seat 7: matiko09 folded before Flop (didn't bet)
Seat 8: SanychStar collected ($5.22)
Seat 9: ardo888 folded before Flop (didn't bet)





PokerStars Hand #151942033113:  Hold'em No Limit ($1/$2 USD) - 2016/04/15 13:07:42 CET [2016/04/15 7:07:42 ET]
Table 'Patroclus II' 9-max Seat #3 is the button
Seat 1: TonnaMunz ($201.50 in chips) 
Seat 2: Moemors ($149.65 in chips) 
Seat 3: Koolniknik ($193.85 in chips) 
Seat 4: tipner ($217.05 in chips) 
Seat 5: butcheN18 ($221 in chips) 
Seat 6: di0d80 ($200 in chips) 
Seat 7: matiko09 ($200 in chips) 
Seat 8: Glushchenko ($200 in chips) 
Seat 9: Fish4trips ($206.35 in chips) 
tipner: posts small blind $1
butcheN18: posts big blind $2
*** HOLE CARDS ***
Dealt to matiko09 [Qs As]
di0d80: folds 
matiko09: raises $3 to $5
Glushchenko: folds 
Fish4trips: folds 
TonnaMunz: folds 
Moemors: folds 
Koolniknik: folds 
tipner: folds 
butcheN18: folds 
Uncalled bet ($3) returned to matiko09
matiko09 collected $5 from pot
matiko09: doesn't show hand 
*** SUMMARY ***
Total pot $5 | Rake $0 
Seat 1: TonnaMunz folded before Flop (didn't bet)
Seat 2: Moemors folded before Flop (didn't bet)
Seat 3: Koolniknik (button) folded before Flop (didn't bet)
Seat 4: tipner (small blind) folded before Flop
Seat 5: butcheN18 (big blind) folded before Flop
Seat 6: di0d80 folded before Flop (didn't bet)
Seat 7: matiko09 collected ($5)
Seat 8: Glushchenko folded before Flop (didn't bet)
Seat 9: Fish4trips folded before Flop (didn't bet)





PokerStars Hand #151942034622:  Hold'em No Limit ($1/$2 USD) - 2016/04/15 13:07:46 CET [2016/04/15 7:07:46 ET]
Table 'Adele II' 9-max Seat #1 is the button
Seat 1: coinflip_si ($200 in chips) 
Seat 2: Fish4trips ($201 in chips) 
Seat 3: matiko09 ($370.67 in chips) 
Seat 4: Glushchenko ($200 in chips) 
Seat 6: TonnaMunz ($210.25 in chips) 
Seat 7: tipner ($229.25 in chips) 
Seat 8: docmarc777 ($239.35 in chips) 
Fish4trips: posts small blind $1
matiko09: posts big blind $2
*** HOLE CARDS ***
Dealt to matiko09 [5c Ac]
Glushchenko: folds 
TonnaMunz: folds 
tipner: folds 
docmarc777: raises $3.35 to $5.35
coinflip_si: folds 
Fish4trips: folds 
matiko09: calls $3.35
*** FLOP *** [9c 4d 3d]
matiko09: checks 
docmarc777: bets $6
matiko09: raises $12 to $18
docmarc777: calls $12
*** TURN *** [9c 4d 3d] [7c]
matiko09: bets $30
docmarc777: calls $30
*** RIVER *** [9c 4d 3d 7c] [Qh]
matiko09: checks 
docmarc777: checks 
*** SHOW DOWN ***
matiko09: shows [5c Ac] (high card Ace)
docmarc777: shows [9d Th] (a pair of Nines)
docmarc777 collected $104.95 from pot
*** SUMMARY ***
Total pot $107.70 | Rake $2.75 
Board [9c 4d 3d 7c Qh]
Seat 1: coinflip_si (button) folded before Flop (didn't bet)
Seat 2: Fish4trips (small blind) folded before Flop
Seat 3: matiko09 (big blind) showed [5c Ac] and lost with high card Ace
Seat 4: Glushchenko folded before Flop (didn't bet)
Seat 6: TonnaMunz folded before Flop (didn't bet)
Seat 7: tipner folded before Flop (didn't bet)
Seat 8: docmarc777 showed [9d Th] and won ($104.95) with a pair of Nines





PokerStars Hand #151942037064:  Hold'em No Limit ($0.50/$1.00 USD) - 2016/04/15 13:07:51 CET [2016/04/15 7:07:51 ET]
Table 'Katja II' 9-max Seat #6 is the button
Seat 1: vrnMike ($122.13 in chips) 
Seat 2: TheJokerMen1 ($63.23 in chips) 
Seat 3: matiko09 ($119.12 in chips) 
Seat 4: Sutt_420 ($78.70 in chips) 
Seat 5: Dachish ($82.85 in chips) 
Seat 6: ASG2016 ($110.54 in chips) 
Seat 7: Effort92 ($114.42 in chips) 
Seat 8: Glushchenko ($101.50 in chips) 
Effort92: posts small blind $0.50
Glushchenko: posts big blind $1
aseban11: sits out 
*** HOLE CARDS ***
Dealt to matiko09 [Ad 2c]
vrnMike: folds 
TheJokerMen1: folds 
matiko09: folds 
Sutt_420: folds 
Dachish: raises $1 to $2
ASG2016: folds 
Effort92: folds 
Glushchenko: folds 
Uncalled bet ($1) returned to Dachish
Dachish collected $2.50 from pot
Dachish: doesn't show hand 
*** SUMMARY ***
Total pot $2.50 | Rake $0 
Seat 1: vrnMike folded before Flop (didn't bet)
Seat 2: TheJokerMen1 folded before Flop (didn't bet)
Seat 3: matiko09 folded before Flop (didn't bet)
Seat 4: Sutt_420 folded before Flop (didn't bet)
Seat 5: Dachish collected ($2.50)
Seat 6: ASG2016 (button) folded before Flop (didn't bet)
Seat 7: Effort92 (small blind) folded before Flop
Seat 8: Glushchenko (big blind) folded before Flop





PokerStars Hand #151942039477:  Hold'em No Limit ($0.50/$1.00 USD) - 2016/04/15 13:07:56 CET [2016/04/15 7:07:56 ET]
Table 'Matterania III' 9-max Seat #2 is the button
Seat 1: di0d80 ($102.24 in chips) 
Seat 2: aseban11 ($100 in chips) 
Seat 3: ardo888 ($156.77 in chips) 
Seat 4: wangzhuoming ($79.32 in chips) 
Seat 5: Vermm ($82 in chips) 
Seat 6: matiko09 ($100 in chips) 
ardo888: posts small blind $0.50
wangzhuoming: posts big blind $1
Filojoes: sits out 
butcheN18: sits out 
di0d80: posts the ante $0.20
aseban11: posts the ante $0.20
ardo888: posts the ante $0.20
wangzhuoming: posts the ante $0.20
Vermm: posts the ante $0.20
matiko09: posts the ante $0.20
*** HOLE CARDS ***
Dealt to matiko09 [Ac 3d]
Vermm: folds 
matiko09: folds 
di0d80: folds 
aseban11: folds 
ardo888: folds 
Uncalled bet ($0.50) returned to wangzhuoming
wangzhuoming collected $2.20 from pot
wangzhuoming: doesn't show hand 
*** SUMMARY ***
Total pot $2.20 | Rake $0 
Seat 1: di0d80 folded before Flop (didn't bet)
Seat 2: aseban11 (button) folded before Flop (didn't bet)
Seat 3: ardo888 (small blind) folded before Flop
Seat 4: wangzhuoming (big blind) collected ($2.20)
Seat 5: Vermm folded before Flop (didn't bet)
Seat 6: matiko09 folded before Flop (didn't bet)





PokerStars Hand #151942042561:  Hold'em No Limit ($0.50/$1.00 USD) - 2016/04/15 13:08:03 CET [2016/04/15 7:08:03 ET]
Table 'Gase II' 9-max Seat #8 is the button
Seat 2: aseban11 ($102.65 in chips) 
Seat 3: djammusic ($43.01 in chips) 
Seat 4: Filojoes ($109.07 in chips) 
Seat 6: matiko09 ($100 in chips) 
Seat 7: danbo577 ($75.50 in chips) 
Seat 8: butcheN18 ($100 in chips) 
Seat 9: UberLycan ($100.68 in chips) 
UberLycan: posts small blind $0.50
maxxmeister: is sitting out 
aseban11: posts big blind $1
*** HOLE CARDS ***
Dealt to matiko09 [2h 7s]
djammusic: folds 
Filojoes: folds 
matiko09: folds 
danbo577: raises $2 to $3
butcheN18: folds 
UberLycan: folds 
aseban11: folds 
Uncalled bet ($2) returned to danbo577
danbo577 collected $2.50 from pot
danbo577: doesn't show hand 
*** SUMMARY ***
Total pot $2.50 | Rake $0 
Seat 2: aseban11 (big blind) folded before Flop
Seat 3: djammusic folded before Flop (didn't bet)
Seat 4: Filojoes folded before Flop (didn't bet)
Seat 6: matiko09 folded before Flop (didn't bet)
Seat 7: danbo577 collected ($2.50)
Seat 8: butcheN18 (button) folded before Flop (didn't bet)
Seat 9: UberLycan (small blind) folded before Flop





PokerStars Hand #151942044577:  Hold'em No Limit ($0.50/$1.00 USD) - 2016/04/15 13:08:07 CET [2016/04/15 7:08:07 ET]
Table 'Lamberta III' 9-max Seat #7 is the button
Seat 1: Westpants ($101.50 in chips) 
Seat 2: Vermm ($85.09 in chips) 
Seat 3: butcheN18 ($105.94 in chips) 
Seat 4: Filojoes ($100 in chips) 
Seat 5: tipner ($114.35 in chips) 
Seat 6: aseban11 ($103.68 in chips) 
Seat 7: ardo888 ($121.79 in chips) 
Seat 8: wangzhuoming ($92 in chips) 
Seat 9: matiko09 ($165.74 in chips) 
wangzhuoming: posts small blind $0.50
matiko09: posts big blind $1
*** HOLE CARDS ***
Dealt to matiko09 [4s 9d]
Westpants: folds 
Vermm: folds 
butcheN18: raises $2 to $3
Filojoes: folds 
tipner: folds 
aseban11: folds 
ardo888: folds 
wangzhuoming: folds 
matiko09: folds 
Uncalled bet ($2) returned to butcheN18
butcheN18 collected $2.50 from pot
butcheN18: doesn't show hand 
*** SUMMARY ***
Total pot $2.50 | Rake $0 
Seat 1: Westpants folded before Flop (didn't bet)
Seat 2: Vermm folded before Flop (didn't bet)
Seat 3: butcheN18 collected ($2.50)
Seat 4: Filojoes folded before Flop (didn't bet)
Seat 5: tipner folded before Flop (didn't bet)
Seat 6: aseban11 folded before Flop (didn't bet)
Seat 7: ardo888 (button) folded before Flop (didn't bet)
Seat 8: wangzhuoming (small blind) folded before Flop
Seat 9: matiko09 (big blind) folded before Flop





PokerStars Hand #151942046048:  Hold'em No Limit ($0.50/$1.00 USD) - 2016/04/15 13:08:10 CET [2016/04/15 7:08:10 ET]
Table 'Matterania III' 9-max Seat #3 is the button
Seat 1: di0d80 ($102.04 in chips) 
Seat 2: aseban11 ($100 in chips) 
Seat 3: ardo888 ($156.07 in chips) 
Seat 4: wangzhuoming ($80.82 in chips) 
Seat 5: Vermm ($81.80 in chips) 
Seat 6: matiko09 ($100 in chips) 
wangzhuoming: posts small blind $0.50
Vermm: posts big blind $1
Filojoes: sits out 
butcheN18: sits out 
di0d80: posts the ante $0.20
aseban11: posts the ante $0.20
ardo888: posts the ante $0.20
wangzhuoming: posts the ante $0.20
Vermm: posts the ante $0.20
matiko09: posts the ante $0.20
*** HOLE CARDS ***
Dealt to matiko09 [2h 6h]
matiko09: folds 
di0d80: raises $1.50 to $2.50
aseban11: calls $2.50
ardo888: folds 
wangzhuoming: calls $2
Vermm: calls $1.50
*** FLOP *** [6d 6s Qs]
wangzhuoming: checks 
Vermm: checks 
di0d80: bets $7
aseban11: folds 
wangzhuoming: folds 
Vermm: folds 
Uncalled bet ($7) returned to di0d80
di0d80 collected $10.64 from pot
di0d80: doesn't show hand 
*** SUMMARY ***
Total pot $11.20 | Rake $0.56 
Board [6d 6s Qs]
Seat 1: di0d80 collected ($10.64)
Seat 2: aseban11 folded on the Flop
Seat 3: ardo888 (button) folded before Flop (didn't bet)
Seat 4: wangzhuoming (small blind) folded on the Flop
Seat 5: Vermm (big blind) folded on the Flop
Seat 6: matiko09 folded before Flop (didn't bet)





PokerStars Hand #151942048978:  Hold'em No Limit ($0.50/$1.00 USD) - 2016/04/15 13:08:17 CET [2016/04/15 7:08:17 ET]
Table 'Katja II' 9-max Seat #7 is the button
Seat 1: vrnMike ($122.13 in chips) 
Seat 2: TheJokerMen1 ($63.23 in chips) 
Seat 3: matiko09 ($119.12 in chips) 
Seat 4: Sutt_420 ($78.70 in chips) 
Seat 5: Dachish ($84.35 in chips) 
Seat 6: ASG2016 ($110.54 in chips) 
Seat 7: Effort92 ($113.92 in chips) 
Seat 8: Glushchenko ($100.50 in chips) 
Seat 9: aseban11 ($100 in chips) 
Glushchenko: posts small blind $0.50
aseban11: posts big blind $1
*** HOLE CARDS ***
Dealt to matiko09 [9h Kh]
vrnMike: folds 
TheJokerMen1: folds 
matiko09: folds 
Sutt_420: folds 
Dachish: raises $1 to $2
ASG2016: folds 
Effort92: folds 
Glushchenko: folds 
aseban11: folds 
Uncalled bet ($1) returned to Dachish
Dachish collected $2.50 from pot
Dachish: doesn't show hand 
*** SUMMARY ***
Total pot $2.50 | Rake $0 
Seat 1: vrnMike folded before Flop (didn't bet)
Seat 2: TheJokerMen1 folded before Flop (didn't bet)
Seat 3: matiko09 folded before Flop (didn't bet)
Seat 4: Sutt_420 folded before Flop (didn't bet)
Seat 5: Dachish collected ($2.50)
Seat 6: ASG2016 folded before Flop (didn't bet)
Seat 7: Effort92 (button) folded before Flop (didn't bet)
Seat 8: Glushchenko (small blind) folded before Flop
Seat 9: aseban11 (big blind) folded before Flop





PokerStars Hand #151942050094:  Hold'em No Limit ($1/$2 USD) - 2016/04/15 13:08:19 CET [2016/04/15 7:08:19 ET]
Table 'Patroclus II' 9-max Seat #4 is the button
Seat 1: TonnaMunz ($201.50 in chips) 
Seat 2: Moemors ($149.65 in chips) 
Seat 3: Koolniknik ($193.85 in chips) 
Seat 4: tipner ($216.05 in chips) 
Seat 5: butcheN18 ($219 in chips) 
Seat 6: di0d80 ($200 in chips) 
Seat 7: matiko09 ($203 in chips) 
Seat 8: Glushchenko ($200 in chips) 
Seat 9: Fish4trips ($206.35 in chips) 
butcheN18: posts small blind $1
di0d80: posts big blind $2
*** HOLE CARDS ***
Dealt to matiko09 [Ks 3d]
matiko09: folds 
Glushchenko: raises $4 to $6
Fish4trips: folds 
TonnaMunz: folds 
Moemors: folds 
Koolniknik: folds 
tipner: folds 
butcheN18: folds 
di0d80: calls $4
*** FLOP *** [8h Td 7h]
di0d80: checks 
Glushchenko: checks 
*** TURN *** [8h Td 7h] [8c]
di0d80: bets $8
Glushchenko: folds 
Uncalled bet ($8) returned to di0d80
di0d80 collected $12.35 from pot
di0d80: doesn't show hand 
*** SUMMARY ***
Total pot $13 | Rake $0.65 
Board [8h Td 7h 8c]
Seat 1: TonnaMunz folded before Flop (didn't bet)
Seat 2: Moemors folded before Flop (didn't bet)
Seat 3: Koolniknik folded before Flop (didn't bet)
Seat 4: tipner (button) folded before Flop (didn't bet)
Seat 5: butcheN18 (small blind) folded before Flop
Seat 6: di0d80 (big blind) collected ($12.35)
Seat 7: matiko09 folded before Flop (didn't bet)
Seat 8: Glushchenko folded on the Turn
Seat 9: Fish4trips folded before Flop (didn't bet)





PokerStars Hand #151942053694:  Hold'em No Limit ($0.50/$1.00 USD) - 2016/04/15 13:08:27 CET [2016/04/15 7:08:27 ET]
Table 'Gase II' 9-max Seat #9 is the button
Seat 2: aseban11 ($101.65 in chips) 
Seat 3: djammusic ($43.01 in chips) 
Seat 4: Filojoes ($109.07 in chips) 
Seat 6: matiko09 ($100 in chips) 
Seat 7: danbo577 ($77 in chips) 
Seat 8: butcheN18 ($100 in chips) 
Seat 9: UberLycan ($100.18 in chips) 
aseban11: posts small blind $0.50
djammusic: posts big blind $1
*** HOLE CARDS ***
Dealt to matiko09 [4h Kd]
Filojoes: folds 
matiko09: folds 
danbo577: folds 
butcheN18: folds 
UberLycan: folds 
aseban11: raises $2 to $3
delaiwangka joins the table at seat #5 
djammusic: raises $4.50 to $7.50
aseban11: calls $4.50
*** FLOP *** [4c 7h Qh]
aseban11: checks 
djammusic: bets $6
delaiwangka said, "嘿中国的朋友"
aseban11: calls $6
*** TURN *** [4c 7h Qh] [3d]
aseban11: checks 
djammusic: checks 
*** RIVER *** [4c 7h Qh 3d] [5d]
aseban11: bets $12.82
danbo577 said, "..."
djammusic: folds 
Uncalled bet ($12.82) returned to aseban11
aseban11 collected $25.65 from pot
aseban11: doesn't show hand 
*** SUMMARY ***
Total pot $27 | Rake $1.35 
Board [4c 7h Qh 3d 5d]
Seat 2: aseban11 (small blind) collected ($25.65)
Seat 3: djammusic (big blind) folded on the River
Seat 4: Filojoes folded before Flop (didn't bet)
Seat 6: matiko09 folded before Flop (didn't bet)
Seat 7: danbo577 folded before Flop (didn't bet)
Seat 8: butcheN18 folded before Flop (didn't bet)
Seat 9: UberLycan (button) folded before Flop (didn't bet)





PokerStars Hand #151942056199:  Hold'em No Limit ($0.50/$1.00 USD) - 2016/04/15 13:08:32 CET [2016/04/15 7:08:32 ET]
Table 'Lamberta III' 9-max Seat #8 is the button
Seat 1: Westpants ($101.50 in chips) 
Seat 2: Vermm ($85.09 in chips) 
Seat 3: butcheN18 ($107.44 in chips) 
Seat 4: Filojoes ($100 in chips) 
Seat 5: tipner ($114.35 in chips) 
Seat 6: aseban11 ($103.68 in chips) 
Seat 7: ardo888 ($121.79 in chips) 
Seat 8: wangzhuoming ($91.50 in chips) 
Seat 9: matiko09 ($164.74 in chips) 
matiko09: posts small blind $0.50
Westpants: posts big blind $1
*** HOLE CARDS ***
Dealt to matiko09 [8d Js]
Vermm: calls $1
butcheN18: folds 
Filojoes: folds 
tipner: folds 
aseban11: folds 
ardo888: folds 
wangzhuoming: raises $2 to $3
matiko09: folds 
Westpants: folds 
Vermm: calls $2
*** FLOP *** [4d 9s 3d]
Vermm: checks 
wangzhuoming: checks 
*** TURN *** [4d 9s 3d] [Ah]
Vermm: bets $3
wangzhuoming: raises $5 to $8
Vermm: calls $5
*** RIVER *** [4d 9s 3d Ah] [Kd]
Vermm: checks 
wangzhuoming: bets $9
Vermm: calls $9
*** SHOW DOWN ***
wangzhuoming: shows [9d Ad] (a flush, Ace high)
Vermm: mucks hand 
wangzhuoming collected $39.42 from pot
*** SUMMARY ***
Total pot $41.50 | Rake $2.08 
Board [4d 9s 3d Ah Kd]
Seat 1: Westpants (big blind) folded before Flop
Seat 2: Vermm mucked [Jd Ac]
Seat 3: butcheN18 folded before Flop (didn't bet)
Seat 4: Filojoes folded before Flop (didn't bet)
Seat 5: tipner folded before Flop (didn't bet)
Seat 6: aseban11 folded before Flop (didn't bet)
Seat 7: ardo888 folded before Flop (didn't bet)
Seat 8: wangzhuoming (button) showed [9d Ad] and won ($39.42) with a flush, Ace high
Seat 9: matiko09 (small blind) folded before Flop





PokerStars Hand #151942061204:  Hold'em No Limit ($0.50/$1.00 USD) - 2016/04/15 13:08:43 CET [2016/04/15 7:08:43 ET]
Table 'Chiny II' 9-max Seat #3 is the button
Seat 2: AceFarky ($101.43 in chips) 
Seat 3: powerbel ($46.50 in chips) 
Seat 4: 1000karlos ($84.27 in chips) 
Seat 5: Yaaaazz ($118.78 in chips) 
Seat 6: choupai ($37 in chips) 
Seat 7: matiko09 ($148.36 in chips) 
Seat 8: SanychStar ($103.72 in chips) 
Seat 9: ardo888 ($108.62 in chips) 
1000karlos: posts small blind $0.50
Yaaaazz: posts big blind $1
*** HOLE CARDS ***
Dealt to matiko09 [2c Th]
choupai: calls $1
matiko09: folds 
SanychStar: folds 
ardo888: folds 
AceFarky: raises $2 to $3
powerbel: calls $3
1000karlos: folds 
Yaaaazz: folds 
choupai: calls $2
*** FLOP *** [Ks Kd 7c]
choupai: checks 
AceFarky: checks 
powerbel: checks 
*** TURN *** [Ks Kd 7c] [4h]
choupai: checks 
AceFarky: bets $7
powerbel: folds 
choupai: folds 
Uncalled bet ($7) returned to AceFarky
AceFarky collected $9.98 from pot
AceFarky: doesn't show hand 
*** SUMMARY ***
Total pot $10.50 | Rake $0.52 
Board [Ks Kd 7c 4h]
Seat 2: AceFarky collected ($9.98)
Seat 3: powerbel (button) folded on the Turn
Seat 4: 1000karlos (small blind) folded before Flop
Seat 5: Yaaaazz (big blind) folded before Flop
Seat 6: choupai folded on the Turn
Seat 7: matiko09 folded before Flop (didn't bet)
Seat 8: SanychStar folded before Flop (didn't bet)
Seat 9: ardo888 folded before Flop (didn't bet)





PokerStars Hand #151942062914:  Hold'em No Limit ($1/$2 USD) - 2016/04/15 13:08:47 CET [2016/04/15 7:08:47 ET]
Table 'Adele II' 9-max Seat #2 is the button
Seat 1: coinflip_si ($200 in chips) 
Seat 2: Fish4trips ($200 in chips) 
Seat 3: matiko09 ($317.32 in chips) 
Seat 4: Glushchenko ($200 in chips) 
Seat 6: TonnaMunz ($210.25 in chips) 
Seat 7: tipner ($229.25 in chips) 
Seat 8: docmarc777 ($290.95 in chips) 
matiko09: posts small blind $1
Glushchenko: posts big blind $2
*** HOLE CARDS ***
Dealt to matiko09 [7c Kd]
TonnaMunz: folds 
tipner: folds 
docmarc777: raises $4 to $6
coinflip_si: folds 
Fish4trips: folds 
matiko09: folds 
Glushchenko: folds 
Uncalled bet ($4) returned to docmarc777
docmarc777 collected $5 from pot
docmarc777: doesn't show hand 
*** SUMMARY ***
Total pot $5 | Rake $0 
Seat 1: coinflip_si folded before Flop (didn't bet)
Seat 2: Fish4trips (button) folded before Flop (didn't bet)
Seat 3: matiko09 (small blind) folded before Flop
Seat 4: Glushchenko (big blind) folded before Flop
Seat 6: TonnaMunz folded before Flop (didn't bet)
Seat 7: tipner folded before Flop (didn't bet)
Seat 8: docmarc777 collected ($5)





PokerStars Hand #151942064000:  Hold'em No Limit ($0.50/$1.00 USD) - 2016/04/15 13:08:49 CET [2016/04/15 7:08:49 ET]
Table 'Katja II' 9-max Seat #8 is the button
Seat 2: TheJokerMen1 ($63.23 in chips) 
Seat 3: matiko09 ($119.12 in chips) 
Seat 4: Sutt_420 ($78.70 in chips) 
Seat 5: Dachish ($85.85 in chips) 
Seat 6: ASG2016 ($110.54 in chips) 
Seat 7: Effort92 ($113.92 in chips) 
Seat 8: Glushchenko ($100 in chips) 
Seat 9: aseban11 ($100 in chips) 
aseban11: posts small blind $0.50
vrnMike: is sitting out 
TheJokerMen1: posts big blind $1
*** HOLE CARDS ***
Dealt to matiko09 [5d 7c]
vrnMike leaves the table
Filojoes joins the table at seat #1 
matiko09: folds 
Sutt_420: folds 
Dachish: raises $2 to $3
ASG2016: folds 
Effort92: calls $3
Glushchenko: folds 
aseban11: folds 
TheJokerMen1: folds 
*** FLOP *** [Ad As Td]
Dachish: checks 
Effort92: checks 
*** TURN *** [Ad As Td] [Qs]
Dachish: checks 
Effort92: checks 
*** RIVER *** [Ad As Td Qs] [Jh]
Dachish: checks 
Effort92: checks 
*** SHOW DOWN ***
Dachish: shows [Qc Kc] (a straight, Ten to Ace)
Effort92: mucks hand 
Dachish collected $7.12 from pot
*** SUMMARY ***
Total pot $7.50 | Rake $0.38 
Board [Ad As Td Qs Jh]
Seat 2: TheJokerMen1 (big blind) folded before Flop
Seat 3: matiko09 folded before Flop (didn't bet)
Seat 4: Sutt_420 folded before Flop (didn't bet)
Seat 5: Dachish showed [Qc Kc] and won ($7.12) with a straight, Ten to Ace
Seat 6: ASG2016 folded before Flop (didn't bet)
Seat 7: Effort92 mucked [5s 5h]
Seat 8: Glushchenko (button) folded before Flop (didn't bet)
Seat 9: aseban11 (small blind) folded before Flop





PokerStars Hand #151942064811:  Hold'em No Limit ($0.50/$1.00 USD) - 2016/04/15 13:08:51 CET [2016/04/15 7:08:51 ET]
Table 'Navi' 9-max Seat #6 is the button
Seat 2: butcheN18 ($100 in chips) 
Seat 4: Effort92 ($152.82 in chips) 
Seat 5: StarsAbove ($100 in chips) 
Seat 6: Glushchenko ($114.16 in chips) 
Seat 7: yoshidao ($122.48 in chips) 
Seat 8: djammusic ($41 in chips) 
Seat 9: matiko09 ($100 in chips) 
yoshidao: posts small blind $0.50
djammusic: posts big blind $1
tipner: sits out 
di0d80: sits out 
*** HOLE CARDS ***
Dealt to matiko09 [7s 3h]
matiko09: folds 
di0d80 leaves the table
butcheN18: folds 
Effort92: raises $1.50 to $2.50
StarsAbove: folds 
Glushchenko: folds 
yoshidao: calls $2
djammusic: folds 
*** FLOP *** [Kh Ks 5s]
aseban11 joins the table at seat #3 
yoshidao: checks 
Effort92: bets $2.39
yoshidao: calls $2.39
*** TURN *** [Kh Ks 5s] [6s]
yoshidao: bets $9
Effort92: calls $9
*** RIVER *** [Kh Ks 5s 6s] [Js]
yoshidao: bets $5
Effort92: calls $5
*** SHOW DOWN ***
yoshidao: shows [Ah 8s] (a flush, King high)
Effort92: mucks hand 
yoshidao collected $36.84 from pot
*** SUMMARY ***
Total pot $38.78 | Rake $1.94 
Board [Kh Ks 5s 6s Js]
Seat 2: butcheN18 folded before Flop (didn't bet)
Seat 4: Effort92 mucked [8h 8d]
Seat 5: StarsAbove folded before Flop (didn't bet)
Seat 6: Glushchenko (button) folded before Flop (didn't bet)
Seat 7: yoshidao (small blind) showed [Ah 8s] and won ($36.84) with a flush, King high
Seat 8: djammusic (big blind) folded before Flop
Seat 9: matiko09 folded before Flop (didn't bet)





PokerStars Hand #151942076218:  Hold'em No Limit ($1/$2 USD) - 2016/04/15 13:09:16 CET [2016/04/15 7:09:16 ET]
Table 'Adele II' 9-max Seat #3 is the button
Seat 1: coinflip_si ($200 in chips) 
Seat 2: Fish4trips ($200 in chips) 
Seat 3: matiko09 ($316.32 in chips) 
Seat 4: Glushchenko ($200 in chips) 
Seat 6: TonnaMunz ($210.25 in chips) 
Seat 7: tipner ($229.25 in chips) 
Seat 8: docmarc777 ($293.95 in chips) 
Glushchenko: posts small blind $1
TonnaMunz: posts big blind $2
*** HOLE CARDS ***
Dealt to matiko09 [5s 8h]
tipner: folds 
docmarc777: folds 
coinflip_si: folds 
Fish4trips: folds 
matiko09: folds 
Glushchenko: raises $3 to $5
TonnaMunz: folds 
Uncalled bet ($3) returned to Glushchenko
Glushchenko collected $4 from pot
*** SUMMARY ***
Total pot $4 | Rake $0 
Seat 1: coinflip_si folded before Flop (didn't bet)
Seat 2: Fish4trips folded before Flop (didn't bet)
Seat 3: matiko09 (button) folded before Flop (didn't bet)
Seat 4: Glushchenko (small blind) collected ($4)
Seat 6: TonnaMunz (big blind) folded before Flop
Seat 7: tipner folded before Flop (didn't bet)
Seat 8: docmarc777 folded before Flop (didn't bet)





PokerStars Hand #151942078294:  Hold'em No Limit ($1/$2 USD) - 2016/04/15 13:09:20 CET [2016/04/15 7:09:20 ET]
Table 'Patroclus II' 9-max Seat #5 is the button
Seat 1: TonnaMunz ($201.50 in chips) 
Seat 2: Moemors ($149.65 in chips) 
Seat 3: Koolniknik ($193.85 in chips) 
Seat 4: tipner ($216.05 in chips) 
Seat 5: butcheN18 ($218 in chips) 
Seat 6: di0d80 ($206.35 in chips) 
Seat 7: matiko09 ($203 in chips) 
Seat 8: Glushchenko ($200 in chips) 
Seat 9: Fish4trips ($206.35 in chips) 
di0d80: posts small blind $1
matiko09: posts big blind $2
*** HOLE CARDS ***
Dealt to matiko09 [3s 7s]
Glushchenko: folds 
Fish4trips: folds 
TonnaMunz: folds 
Moemors: folds 
Koolniknik: raises $4 to $6
tipner: raises $11 to $17
butcheN18: folds 
di0d80: folds 
matiko09: folds 
Koolniknik: raises $34 to $51
tipner: folds 
Uncalled bet ($34) returned to Koolniknik
Koolniknik collected $37 from pot
Koolniknik: doesn't show hand 
*** SUMMARY ***
Total pot $37 | Rake $0 
Seat 1: TonnaMunz folded before Flop (didn't bet)
Seat 2: Moemors folded before Flop (didn't bet)
Seat 3: Koolniknik collected ($37)
Seat 4: tipner folded before Flop
Seat 5: butcheN18 (button) folded before Flop (didn't bet)
Seat 6: di0d80 (small blind) folded before Flop
Seat 7: matiko09 (big blind) folded before Flop
Seat 8: Glushchenko folded before Flop (didn't bet)
Seat 9: Fish4trips folded before Flop (didn't bet)





PokerStars Hand #151942083307:  Hold'em No Limit ($0.50/$1.00 USD) - 2016/04/15 13:09:31 CET [2016/04/15 7:09:31 ET]
Table 'Matterania III' 9-max Seat #4 is the button
Seat 1: di0d80 ($109.98 in chips) 
Seat 2: aseban11 ($100 in chips) 
Seat 3: ardo888 ($155.87 in chips) 
Seat 4: wangzhuoming ($78.12 in chips) 
Seat 5: Vermm ($79.10 in chips) 
Seat 6: matiko09 ($100 in chips) 
Vermm: posts small blind $0.50
matiko09: posts big blind $1
Filojoes: sits out 
butcheN18: sits out 
di0d80: posts the ante $0.20
aseban11: posts the ante $0.20
ardo888: posts the ante $0.20
wangzhuoming: posts the ante $0.20
Vermm: posts the ante $0.20
matiko09: posts the ante $0.20
*** HOLE CARDS ***
Dealt to matiko09 [4s 6h]
di0d80: folds 
aseban11: raises $2.50 to $3.50
haoyuan541 was removed from the table for failing to post
ardo888: folds 
wangzhuoming: folds 
Vermm: folds 
matiko09: folds 
Uncalled bet ($2.50) returned to aseban11
aseban11 collected $3.70 from pot
aseban11: doesn't show hand 
*** SUMMARY ***
Total pot $3.70 | Rake $0 
Seat 1: di0d80 folded before Flop (didn't bet)
Seat 2: aseban11 collected ($3.70)
Seat 3: ardo888 folded before Flop (didn't bet)
Seat 4: wangzhuoming (button) folded before Flop (didn't bet)
Seat 5: Vermm (small blind) folded before Flop
Seat 6: matiko09 (big blind) folded before Flop





PokerStars Hand #151942084696:  Hold'em No Limit ($1/$2 USD) - 2016/04/15 13:09:34 CET [2016/04/15 7:09:34 ET]
Table 'Adele II' 9-max Seat #4 is the button
Seat 1: coinflip_si ($200 in chips) 
Seat 2: Fish4trips ($200 in chips) 
Seat 3: matiko09 ($316.32 in chips) 
Seat 4: Glushchenko ($202 in chips) 
Seat 6: TonnaMunz ($208.25 in chips) 
Seat 7: tipner ($229.25 in chips) 
Seat 8: docmarc777 ($293.95 in chips) 
TonnaMunz: posts small blind $1
tipner: posts big blind $2
*** HOLE CARDS ***
Dealt to matiko09 [7s Qc]
docmarc777: folds 
coinflip_si: folds 
Fish4trips: folds 
matiko09: folds 
Glushchenko: raises $2 to $4
TonnaMunz: folds 
tipner: calls $2
*** FLOP *** [9d 7h 8s]
tipner: checks 
Glushchenko: bets $6
tipner: calls $6
*** TURN *** [9d 7h 8s] [6d]
tipner: checks 
Glushchenko: checks 
*** RIVER *** [9d 7h 8s 6d] [8d]
tipner: bets $12
Glushchenko: folds 
Uncalled bet ($12) returned to tipner
tipner collected $19.95 from pot
tipner: doesn't show hand 
*** SUMMARY ***
Total pot $21 | Rake $1.05 
Board [9d 7h 8s 6d 8d]
Seat 1: coinflip_si folded before Flop (didn't bet)
Seat 2: Fish4trips folded before Flop (didn't bet)
Seat 3: matiko09 folded before Flop (didn't bet)
Seat 4: Glushchenko (button) folded on the River
Seat 6: TonnaMunz (small blind) folded before Flop
Seat 7: tipner (big blind) collected ($19.95)
Seat 8: docmarc777 folded before Flop (didn't bet)





PokerStars Hand #151942088839:  Hold'em No Limit ($0.50/$1.00 USD) - 2016/04/15 13:09:43 CET [2016/04/15 7:09:43 ET]
Table 'Chiny II' 9-max Seat #4 is the button
Seat 2: AceFarky ($108.41 in chips) 
Seat 3: powerbel ($43.50 in chips) 
Seat 4: 1000karlos ($83.77 in chips) 
Seat 5: Yaaaazz ($117.78 in chips) 
Seat 6: choupai ($34 in chips) 
Seat 7: matiko09 ($148.36 in chips) 
Seat 8: SanychStar ($103.72 in chips) 
Seat 9: ardo888 ($108.62 in chips) 
Yaaaazz: posts small blind $0.50
choupai: posts big blind $1
*** HOLE CARDS ***
Dealt to matiko09 [Jh 9d]
matiko09: folds 
SanychStar: folds 
ardo888: folds 
AceFarky: folds 
powerbel: raises $1 to $2
1000karlos: calls $2
Yaaaazz: folds 
choupai: calls $1
*** FLOP *** [4c Td Qc]
choupai: checks 
powerbel: checks 
1000karlos: bets $3
choupai: folds 
powerbel: calls $3
*** TURN *** [4c Td Qc] [Qh]
powerbel: checks 
1000karlos: checks 
*** RIVER *** [4c Td Qc Qh] [9s]
powerbel: bets $38.50 and is all-in
1000karlos: folds 
Uncalled bet ($38.50) returned to powerbel
powerbel collected $11.88 from pot
powerbel: doesn't show hand 
*** SUMMARY ***
Total pot $12.50 | Rake $0.62 
Board [4c Td Qc Qh 9s]
Seat 2: AceFarky folded before Flop (didn't bet)
Seat 3: powerbel collected ($11.88)
Seat 4: 1000karlos (button) folded on the River
Seat 5: Yaaaazz (small blind) folded before Flop
Seat 6: choupai (big blind) folded on the Flop
Seat 7: matiko09 folded before Flop (didn't bet)
Seat 8: SanychStar folded before Flop (didn't bet)
Seat 9: ardo888 folded before Flop (didn't bet)





PokerStars Hand #151942095801:  Hold'em No Limit ($0.50/$1.00 USD) - 2016/04/15 13:09:59 CET [2016/04/15 7:09:59 ET]
Table 'Matterania III' 9-max Seat #5 is the button
Seat 1: di0d80 ($109.78 in chips) 
Seat 2: aseban11 ($102.50 in chips) 
Seat 3: ardo888 ($155.67 in chips) 
Seat 4: wangzhuoming ($77.92 in chips) 
Seat 5: Vermm ($78.40 in chips) 
Seat 6: matiko09 ($100 in chips) 
Seat 7: Filojoes ($100 in chips) 
matiko09: posts small blind $0.50
Filojoes: posts big blind $1
butcheN18: sits out 
di0d80: posts the ante $0.20
aseban11: posts the ante $0.20
ardo888: posts the ante $0.20
wangzhuoming: posts the ante $0.20
Vermm: posts the ante $0.20
matiko09: posts the ante $0.20
Filojoes: posts the ante $0.20
*** HOLE CARDS ***
Dealt to matiko09 [7h 9h]
di0d80: folds 
aseban11: folds 
ardo888: folds 
wangzhuoming: folds 
Vermm: folds 
matiko09: raises $2 to $3
Filojoes: raises $6 to $9
matiko09: folds 
Uncalled bet ($6) returned to Filojoes
Filojoes collected $7.40 from pot
Filojoes: doesn't show hand 
*** SUMMARY ***
Total pot $7.40 | Rake $0 
Seat 1: di0d80 folded before Flop (didn't bet)
Seat 2: aseban11 folded before Flop (didn't bet)
Seat 3: ardo888 folded before Flop (didn't bet)
Seat 4: wangzhuoming folded before Flop (didn't bet)
Seat 5: Vermm (button) folded before Flop (didn't bet)
Seat 6: matiko09 (small blind) folded before Flop
Seat 7: Filojoes (big blind) collected ($7.40)





PokerStars Hand #151942097460:  Hold'em No Limit ($0.50/$1.00 USD) - 2016/04/15 13:10:02 CET [2016/04/15 7:10:02 ET]
Table 'Lamberta III' 9-max Seat #9 is the button
Seat 1: Westpants ($100.50 in chips) 
Seat 2: Vermm ($65.09 in chips) 
Seat 3: butcheN18 ($107.44 in chips) 
Seat 4: Filojoes ($100 in chips) 
Seat 5: tipner ($114.35 in chips) 
Seat 6: aseban11 ($103.68 in chips) 
Seat 7: ardo888 ($121.79 in chips) 
Seat 8: wangzhuoming ($110.92 in chips) 
Seat 9: matiko09 ($164.24 in chips) 
Westpants: posts small blind $0.50
Vermm: posts big blind $1
*** HOLE CARDS ***
Dealt to matiko09 [Qs Ts]
butcheN18: folds 
Filojoes: folds 
tipner: folds 
aseban11: folds 
ardo888: folds 
wangzhuoming: folds 
matiko09: raises $1.27 to $2.27
Westpants: folds 
Vermm: folds 
Uncalled bet ($1.27) returned to matiko09
matiko09 collected $2.50 from pot
matiko09: doesn't show hand 
*** SUMMARY ***
Total pot $2.50 | Rake $0 
Seat 1: Westpants (small blind) folded before Flop
Seat 2: Vermm (big blind) folded before Flop
Seat 3: butcheN18 folded before Flop (didn't bet)
Seat 4: Filojoes folded before Flop (didn't bet)
Seat 5: tipner folded before Flop (didn't bet)
Seat 6: aseban11 folded before Flop (didn't bet)
Seat 7: ardo888 folded before Flop (didn't bet)
Seat 8: wangzhuoming folded before Flop (didn't bet)
Seat 9: matiko09 (button) collected ($2.50)





PokerStars Hand #151942100953:  Hold'em No Limit ($0.50/$1.00 USD) - 2016/04/15 13:10:10 CET [2016/04/15 7:10:10 ET]
Table 'Gase II' 9-max Seat #2 is the button
Seat 2: aseban11 ($113.80 in chips) 
Seat 3: djammusic ($40 in chips) 
Seat 4: Filojoes ($109.07 in chips) 
Seat 6: matiko09 ($100 in chips) 
Seat 7: danbo577 ($77 in chips) 
Seat 8: butcheN18 ($100 in chips) 
Seat 9: UberLycan ($100.18 in chips) 
djammusic: posts small blind $0.50
Filojoes: posts big blind $1
delaiwangka: sits out 
*** HOLE CARDS ***
Dealt to matiko09 [Ts 2s]
matiko09: folds 
delaiwangka said, "NL100好打么"
danbo577: raises $1 to $2
butcheN18: folds 
UberLycan: folds 
danbo577 said, "buhao da"
aseban11: folds 
djammusic: folds 
delaiwangka said, "刚上来三条输三条掉了100"
Filojoes: folds 
Uncalled bet ($1) returned to danbo577
danbo577 collected $2.50 from pot
danbo577: doesn't show hand 
*** SUMMARY ***
Total pot $2.50 | Rake $0 
Seat 2: aseban11 (button) folded before Flop (didn't bet)
Seat 3: djammusic (small blind) folded before Flop
Seat 4: Filojoes (big blind) folded before Flop
Seat 6: matiko09 folded before Flop (didn't bet)
Seat 7: danbo577 collected ($2.50)
Seat 8: butcheN18 folded before Flop (didn't bet)
Seat 9: UberLycan folded before Flop (didn't bet)





PokerStars Hand #151942103456:  Hold'em No Limit ($0.50/$1.00 USD) - 2016/04/15 13:10:15 CET [2016/04/15 7:10:15 ET]
Table 'Katja II' 9-max Seat #9 is the button
Seat 2: TheJokerMen1 ($62.23 in chips) 
Seat 3: matiko09 ($119.12 in chips) 
Seat 4: Sutt_420 ($78.70 in chips) 
Seat 5: Dachish ($89.97 in chips) 
Seat 6: ASG2016 ($110.54 in chips) 
Seat 7: Effort92 ($110.92 in chips) 
Seat 8: Glushchenko ($100 in chips) 
Seat 9: aseban11 ($100 in chips) 
Filojoes will be allowed to play after the button
TheJokerMen1: posts small blind $0.50
matiko09: posts big blind $1
*** HOLE CARDS ***
Dealt to matiko09 [4h 8h]
Sutt_420: folds 
Dachish: folds 
ASG2016: folds 
Effort92: folds 
Glushchenko: folds 
aseban11: folds 
TheJokerMen1: raises $2 to $3
matiko09: folds 
Uncalled bet ($2) returned to TheJokerMen1
TheJokerMen1 collected $2 from pot
TheJokerMen1: doesn't show hand 
*** SUMMARY ***
Total pot $2 | Rake $0 
Seat 2: TheJokerMen1 (small blind) collected ($2)
Seat 3: matiko09 (big blind) folded before Flop
Seat 4: Sutt_420 folded before Flop (didn't bet)
Seat 5: Dachish folded before Flop (didn't bet)
Seat 6: ASG2016 folded before Flop (didn't bet)
Seat 7: Effort92 folded before Flop (didn't bet)
Seat 8: Glushchenko folded before Flop (didn't bet)
Seat 9: aseban11 (button) folded before Flop (didn't bet)





PokerStars Hand #151942104731:  Hold'em No Limit ($1/$2 USD) - 2016/04/15 13:10:18 CET [2016/04/15 7:10:18 ET]
Table 'Patroclus II' 9-max Seat #6 is the button
Seat 1: TonnaMunz ($201.50 in chips) 
Seat 2: Moemors ($149.65 in chips) 
Seat 3: Koolniknik ($213.85 in chips) 
Seat 4: tipner ($200 in chips) 
Seat 5: butcheN18 ($218 in chips) 
Seat 6: di0d80 ($205.35 in chips) 
Seat 7: matiko09 ($201 in chips) 
Seat 8: Glushchenko ($200 in chips) 
Seat 9: Fish4trips ($206.35 in chips) 
matiko09: posts small blind $1
Glushchenko: posts big blind $2
*** HOLE CARDS ***
Dealt to matiko09 [2c 2s]
Fish4trips: folds 
TonnaMunz: folds 
Moemors: calls $2
Koolniknik: raises $4 to $6
tipner: folds 
butcheN18: folds 
di0d80: folds 
matiko09: calls $5
Glushchenko: folds 
Moemors: calls $4
*** FLOP *** [5c Qd Jd]
matiko09: checks 
Moemors: bets $16
Koolniknik: folds 
matiko09: folds 
Uncalled bet ($16) returned to Moemors
Moemors collected $19 from pot
Moemors: doesn't show hand 
*** SUMMARY ***
Total pot $20 | Rake $1 
Board [5c Qd Jd]
Seat 1: TonnaMunz folded before Flop (didn't bet)
Seat 2: Moemors collected ($19)
Seat 3: Koolniknik folded on the Flop
Seat 4: tipner folded before Flop (didn't bet)
Seat 5: butcheN18 folded before Flop (didn't bet)
Seat 6: di0d80 (button) folded before Flop (didn't bet)
Seat 7: matiko09 (small blind) folded on the Flop
Seat 8: Glushchenko (big blind) folded before Flop
Seat 9: Fish4trips folded before Flop (didn't bet)





PokerStars Hand #151942106927:  Hold'em No Limit ($0.50/$1.00 USD) - 2016/04/15 13:10:23 CET [2016/04/15 7:10:23 ET]
Table 'Navi' 9-max Seat #7 is the button
Seat 2: butcheN18 ($100 in chips) 
Seat 4: Effort92 ($133.93 in chips) 
Seat 5: StarsAbove ($100 in chips) 
Seat 6: Glushchenko ($114.16 in chips) 
Seat 7: yoshidao ($140.43 in chips) 
Seat 8: djammusic ($40 in chips) 
Seat 9: matiko09 ($100 in chips) 
djammusic: posts small blind $0.50
matiko09: posts big blind $1
tipner: sits out 
aseban11: sits out 
*** HOLE CARDS ***
Dealt to matiko09 [9c 6h]
butcheN18: folds 
Effort92: folds 
StarsAbove: folds 
Glushchenko: folds 
yoshidao: calls $1
djammusic: calls $0.50
matiko09: checks 
*** FLOP *** [8c 9d Qs]
djammusic: checks 
Effort92 said, "nh"
matiko09: checks 
yoshidao: checks 
*** TURN *** [8c 9d Qs] [4h]
djammusic: bets $1.48
matiko09: folds 
yoshidao: calls $1.48
*** RIVER *** [8c 9d Qs 4h] [As]
djammusic: checks 
yoshidao: bets $4
djammusic: calls $4
*** SHOW DOWN ***
yoshidao: shows [7c Jc] (high card Ace)
djammusic: shows [Js 9s] (a pair of Nines)
djammusic collected $13.26 from pot
*** SUMMARY ***
Total pot $13.96 | Rake $0.70 
Board [8c 9d Qs 4h As]
Seat 2: butcheN18 folded before Flop (didn't bet)
Seat 4: Effort92 folded before Flop (didn't bet)
Seat 5: StarsAbove folded before Flop (didn't bet)
Seat 6: Glushchenko folded before Flop (didn't bet)
Seat 7: yoshidao (button) showed [7c Jc] and lost with high card Ace
Seat 8: djammusic (small blind) showed [Js 9s] and won ($13.26) with a pair of Nines
Seat 9: matiko09 (big blind) folded on the Turn





PokerStars Hand #151942114929:  Hold'em No Limit ($0.50/$1.00 USD) - 2016/04/15 13:10:40 CET [2016/04/15 7:10:40 ET]
Table 'Matterania III' 9-max Seat #6 is the button
Seat 1: di0d80 ($109.58 in chips) 
Seat 2: aseban11 ($102.30 in chips) 
Seat 3: ardo888 ($155.47 in chips) 
Seat 4: wangzhuoming ($77.72 in chips) 
Seat 5: Vermm ($78.20 in chips) 
Seat 6: matiko09 ($100 in chips) 
Seat 7: Filojoes ($104.20 in chips) 
Seat 9: butcheN18 ($101.80 in chips) 
Filojoes: posts small blind $0.50
butcheN18: posts big blind $1
di0d80: posts the ante $0.20
aseban11: posts the ante $0.20
ardo888: posts the ante $0.20
wangzhuoming: posts the ante $0.20
Vermm: posts the ante $0.20
matiko09: posts the ante $0.20
Filojoes: posts the ante $0.20
butcheN18: posts the ante $0.20
*** HOLE CARDS ***
Dealt to matiko09 [8c Kc]
di0d80: folds 
aseban11: folds 
ardo888: folds 
wangzhuoming: folds 
Vermm: raises $2 to $3
matiko09: folds 
Filojoes: folds 
butcheN18: folds 
Uncalled bet ($2) returned to Vermm
Vermm collected $4.10 from pot
Vermm: doesn't show hand 
*** SUMMARY ***
Total pot $4.10 | Rake $0 
Seat 1: di0d80 folded before Flop (didn't bet)
Seat 2: aseban11 folded before Flop (didn't bet)
Seat 3: ardo888 folded before Flop (didn't bet)
Seat 4: wangzhuoming folded before Flop (didn't bet)
Seat 5: Vermm collected ($4.10)
Seat 6: matiko09 (button) folded before Flop (didn't bet)
Seat 7: Filojoes (small blind) folded before Flop
Seat 9: butcheN18 (big blind) folded before Flop





PokerStars Hand #151942114583:  Hold'em No Limit ($0.50/$1.00 USD) - 2016/04/15 13:10:40 CET [2016/04/15 7:10:40 ET]
Table 'Gase II' 9-max Seat #3 is the button
Seat 2: aseban11 ($113.80 in chips) 
Seat 3: djammusic ($39.50 in chips) 
Seat 4: Filojoes ($108.07 in chips) 
Seat 5: delaiwangka ($100 in chips) 
Seat 6: matiko09 ($100 in chips) 
Seat 7: danbo577 ($78.50 in chips) 
Seat 8: butcheN18 ($100 in chips) 
Seat 9: UberLycan ($100.18 in chips) 
Filojoes: posts small blind $0.50
delaiwangka: posts big blind $1
*** HOLE CARDS ***
Dealt to matiko09 [4h 5h]
matiko09: folds 
danbo577: folds 
butcheN18: folds 
UberLycan: raises $2 to $3
aseban11: raises $6 to $9
djammusic: folds 
danbo577 said, "冤家牌没办法的"
Filojoes: folds 
delaiwangka: calls $8
delaiwangka said, "第一把啊"
UberLycan: raises $19 to $28
aseban11: folds 
danbo577 said, "这个也是第一把"
delaiwangka: folds 
Uncalled bet ($19) returned to UberLycan
UberLycan collected $27.50 from pot
UberLycan: doesn't show hand 
*** SUMMARY ***
Total pot $27.50 | Rake $0 
Seat 2: aseban11 folded before Flop
Seat 3: djammusic (button) folded before Flop (didn't bet)
Seat 4: Filojoes (small blind) folded before Flop
Seat 5: delaiwangka (big blind) folded before Flop
Seat 6: matiko09 folded before Flop (didn't bet)
Seat 7: danbo577 folded before Flop (didn't bet)
Seat 8: butcheN18 folded before Flop (didn't bet)
Seat 9: UberLycan collected ($27.50)





PokerStars Hand #151942115842:  Hold'em No Limit ($0.50/$1.00 USD) - 2016/04/15 13:10:42 CET [2016/04/15 7:10:42 ET]
Table 'Katja II' 9-max Seat #2 is the button
Seat 2: TheJokerMen1 ($63.23 in chips) 
Seat 3: matiko09 ($118.12 in chips) 
Seat 4: Sutt_420 ($78.70 in chips) 
Seat 5: Dachish ($89.97 in chips) 
Seat 6: ASG2016 ($110.54 in chips) 
Seat 7: Effort92 ($110.92 in chips) 
Seat 8: Glushchenko ($100 in chips) 
Seat 9: aseban11 ($100 in chips) 
matiko09: posts small blind $0.50
Sutt_420: posts big blind $1
Filojoes: sits out 
*** HOLE CARDS ***
Dealt to matiko09 [2h 9d]
Dachish: folds 
ASG2016: raises $2 to $3
Effort92: folds 
Glushchenko: folds 
aseban11: folds 
TheJokerMen1: folds 
matiko09: folds 
Sutt_420: folds 
Uncalled bet ($2) returned to ASG2016
ASG2016 collected $2.50 from pot
ASG2016: doesn't show hand 
*** SUMMARY ***
Total pot $2.50 | Rake $0 
Seat 2: TheJokerMen1 (button) folded before Flop (didn't bet)
Seat 3: matiko09 (small blind) folded before Flop
Seat 4: Sutt_420 (big blind) folded before Flop
Seat 5: Dachish folded before Flop (didn't bet)
Seat 6: ASG2016 collected ($2.50)
Seat 7: Effort92 folded before Flop (didn't bet)
Seat 8: Glushchenko folded before Flop (didn't bet)
Seat 9: aseban11 folded before Flop (didn't bet)





PokerStars Hand #151942118203:  Hold'em No Limit ($0.50/$1.00 USD) - 2016/04/15 13:10:47 CET [2016/04/15 7:10:47 ET]
Table 'Chiny II' 9-max Seat #5 is the button
Seat 2: AceFarky ($108.41 in chips) 
Seat 3: powerbel ($50.38 in chips) 
Seat 4: 1000karlos ($78.77 in chips) 
Seat 5: Yaaaazz ($117.28 in chips) 
Seat 6: choupai ($32 in chips) 
Seat 7: matiko09 ($148.36 in chips) 
Seat 8: SanychStar ($103.72 in chips) 
Seat 9: ardo888 ($108.62 in chips) 
choupai: posts small blind $0.50
matiko09: posts big blind $1
*** HOLE CARDS ***
Dealt to matiko09 [9d 5h]
SanychStar: folds 
ardo888: folds 
AceFarky: folds 
powerbel: folds 
1000karlos: folds 
Yaaaazz: raises $1.20 to $2.20
choupai: folds 
matiko09: folds 
Uncalled bet ($1.20) returned to Yaaaazz
Yaaaazz collected $2.50 from pot
*** SUMMARY ***
Total pot $2.50 | Rake $0 
Seat 2: AceFarky folded before Flop (didn't bet)
Seat 3: powerbel folded before Flop (didn't bet)
Seat 4: 1000karlos folded before Flop (didn't bet)
Seat 5: Yaaaazz (button) collected ($2.50)
Seat 6: choupai (small blind) folded before Flop
Seat 7: matiko09 (big blind) folded before Flop
Seat 8: SanychStar folded before Flop (didn't bet)
Seat 9: ardo888 folded before Flop (didn't bet)





PokerStars Hand #151942118915:  Hold'em No Limit ($1/$2 USD) - 2016/04/15 13:10:49 CET [2016/04/15 7:10:49 ET]
Table 'Adele II' 9-max Seat #6 is the button
Seat 1: coinflip_si ($200 in chips) 
Seat 2: Fish4trips ($200 in chips) 
Seat 3: matiko09 ($316.32 in chips) 
Seat 4: Glushchenko ($200 in chips) 
Seat 6: TonnaMunz ($207.25 in chips) 
Seat 7: tipner ($239.20 in chips) 
Seat 8: docmarc777 ($293.95 in chips) 
tipner: posts small blind $1
docmarc777: posts big blind $2
*** HOLE CARDS ***
Dealt to matiko09 [Qs Kc]
coinflip_si: folds 
Fish4trips: folds 
matiko09: raises $3 to $5
Glushchenko: folds 
TonnaMunz: folds 
tipner: folds 
docmarc777: calls $3
*** FLOP *** [7h Kd Kh]
docmarc777: checks 
matiko09: bets $6.79
docmarc777: calls $6.79
*** TURN *** [7h Kd Kh] [7c]
docmarc777: checks 
T0ny Adams leaves the table
di0d80 joins the table at seat #5 
matiko09: bets $12.14
docmarc777: raises $12.14 to $24.28
matiko09: calls $12.14
*** RIVER *** [7h Kd Kh 7c] [2d]
docmarc777: checks 
matiko09: bets $36.60
docmarc777: folds 
Uncalled bet ($36.60) returned to matiko09
matiko09 collected $70.39 from pot
matiko09: doesn't show hand 
*** SUMMARY ***
Total pot $73.14 | Rake $2.75 
Board [7h Kd Kh 7c 2d]
Seat 1: coinflip_si folded before Flop (didn't bet)
Seat 2: Fish4trips folded before Flop (didn't bet)
Seat 3: matiko09 collected ($70.39)
Seat 4: Glushchenko folded before Flop (didn't bet)
Seat 6: TonnaMunz (button) folded before Flop (didn't bet)
Seat 7: tipner (small blind) folded before Flop
Seat 8: docmarc777 (big blind) folded on the River





PokerStars Hand #151942122789:  Hold'em No Limit ($0.50/$1.00 USD) - 2016/04/15 13:10:57 CET [2016/04/15 7:10:57 ET]
Table 'Lamberta III' 9-max Seat #1 is the button
Seat 1: Westpants ($100 in chips) 
Seat 2: Vermm ($64.09 in chips) 
Seat 3: butcheN18 ($107.44 in chips) 
Seat 4: Filojoes ($100 in chips) 
Seat 5: tipner ($114.35 in chips) 
Seat 6: aseban11 ($103.68 in chips) 
Seat 7: ardo888 ($121.79 in chips) 
Seat 8: wangzhuoming ($110.92 in chips) 
Seat 9: matiko09 ($165.74 in chips) 
Vermm: posts small blind $0.50
butcheN18: posts big blind $1
*** HOLE CARDS ***
Dealt to matiko09 [8s 3s]
Filojoes: folds 
tipner: folds 
aseban11: folds 
ardo888: folds 
wangzhuoming: folds 
matiko09: folds 
Westpants: folds 
Vermm: folds 
Uncalled bet ($0.50) returned to butcheN18
butcheN18 collected $1 from pot
butcheN18: doesn't show hand 
*** SUMMARY ***
Total pot $1 | Rake $0 
Seat 1: Westpants (button) folded before Flop (didn't bet)
Seat 2: Vermm (small blind) folded before Flop
Seat 3: butcheN18 (big blind) collected ($1)
Seat 4: Filojoes folded before Flop (didn't bet)
Seat 5: tipner folded before Flop (didn't bet)
Seat 6: aseban11 folded before Flop (didn't bet)
Seat 7: ardo888 folded before Flop (didn't bet)
Seat 8: wangzhuoming folded before Flop (didn't bet)
Seat 9: matiko09 folded before Flop (didn't bet)





PokerStars Hand #151942131757:  Hold'em No Limit ($1/$2 USD) - 2016/04/15 13:11:17 CET [2016/04/15 7:11:17 ET]
Table 'Patroclus II' 9-max Seat #7 is the button
Seat 1: TonnaMunz ($201.50 in chips) 
Seat 2: Moemors ($162.65 in chips) 
Seat 3: Koolniknik ($207.85 in chips) 
Seat 4: tipner ($200 in chips) 
Seat 5: butcheN18 ($218 in chips) 
Seat 6: di0d80 ($205.35 in chips) 
Seat 7: matiko09 ($200 in chips) 
Seat 8: Glushchenko ($200 in chips) 
Seat 9: Fish4trips ($206.35 in chips) 
Glushchenko: posts small blind $1
Fish4trips: posts big blind $2
*** HOLE CARDS ***
Dealt to matiko09 [Tc Js]
TonnaMunz: folds 
Moemors: folds 
Koolniknik: folds 
tipner: folds 
butcheN18: folds 
di0d80: folds 
matiko09: raises $2.54 to $4.54
Glushchenko: folds 
Fish4trips: folds 
Uncalled bet ($2.54) returned to matiko09
matiko09 collected $5 from pot
matiko09: doesn't show hand 
*** SUMMARY ***
Total pot $5 | Rake $0 
Seat 1: TonnaMunz folded before Flop (didn't bet)
Seat 2: Moemors folded before Flop (didn't bet)
Seat 3: Koolniknik folded before Flop (didn't bet)
Seat 4: tipner folded before Flop (didn't bet)
Seat 5: butcheN18 folded before Flop (didn't bet)
Seat 6: di0d80 folded before Flop (didn't bet)
Seat 7: matiko09 (button) collected ($5)
Seat 8: Glushchenko (small blind) folded before Flop
Seat 9: Fish4trips (big blind) folded before Flop





PokerStars Hand #151942132762:  Hold'em No Limit ($0.50/$1.00 USD) - 2016/04/15 13:11:19 CET [2016/04/15 7:11:19 ET]
Table 'Matterania III' 9-max Seat #7 is the button
Seat 1: di0d80 ($109.38 in chips) 
Seat 2: aseban11 ($102.10 in chips) 
Seat 3: ardo888 ($155.27 in chips) 
Seat 4: wangzhuoming ($77.52 in chips) 
Seat 5: Vermm ($81.10 in chips) 
Seat 6: matiko09 ($100 in chips) 
Seat 7: Filojoes ($103.50 in chips) 
Seat 9: butcheN18 ($100.60 in chips) 
butcheN18: posts small blind $0.50
di0d80: posts big blind $1
di0d80: posts the ante $0.20
aseban11: posts the ante $0.20
ardo888: posts the ante $0.20
wangzhuoming: posts the ante $0.20
Vermm: posts the ante $0.20
matiko09: posts the ante $0.20
Filojoes: posts the ante $0.20
butcheN18: posts the ante $0.20
*** HOLE CARDS ***
Dealt to matiko09 [3d 3h]
aseban11: folds 
ardo888: folds 
wangzhuoming: folds 
Vermm: folds 
matiko09: raises $1.50 to $2.50
Filojoes: folds 
butcheN18: folds 
di0d80: raises $5.50 to $8
matiko09: folds 
Uncalled bet ($5.50) returned to di0d80
di0d80 collected $7.10 from pot
di0d80: doesn't show hand 
*** SUMMARY ***
Total pot $7.10 | Rake $0 
Seat 1: di0d80 (big blind) collected ($7.10)
Seat 2: aseban11 folded before Flop (didn't bet)
Seat 3: ardo888 folded before Flop (didn't bet)
Seat 4: wangzhuoming folded before Flop (didn't bet)
Seat 5: Vermm folded before Flop (didn't bet)
Seat 6: matiko09 folded before Flop
Seat 7: Filojoes (button) folded before Flop (didn't bet)
Seat 9: butcheN18 (small blind) folded before Flop





PokerStars Hand #151942138515:  Hold'em No Limit ($0.50/$1.00 USD) - 2016/04/15 13:11:32 CET [2016/04/15 7:11:32 ET]
Table 'Chiny II' 9-max Seat #6 is the button
Seat 2: AceFarky ($108.41 in chips) 
Seat 3: powerbel ($50.38 in chips) 
Seat 4: 1000karlos ($78.77 in chips) 
Seat 5: Yaaaazz ($118.78 in chips) 
Seat 6: choupai ($31.50 in chips) 
Seat 7: matiko09 ($147.36 in chips) 
matiko09: posts small blind $0.50
SanychStar: is sitting out 
ardo888: is sitting out 
AceFarky: posts big blind $1
*** HOLE CARDS ***
Dealt to matiko09 [4c 9d]
SanychStar leaves the table
Filojoes joins the table at seat #8 
ardo888 leaves the table
powerbel: folds 
1000karlos: folds 
Yaaaazz: folds 
choupai: raises $2 to $3
matiko09: folds 
AceFarky: folds 
Uncalled bet ($2) returned to choupai
choupai collected $2.50 from pot
*** SUMMARY ***
Total pot $2.50 | Rake $0 
Seat 2: AceFarky (big blind) folded before Flop
Seat 3: powerbel folded before Flop (didn't bet)
Seat 4: 1000karlos folded before Flop (didn't bet)
Seat 5: Yaaaazz folded before Flop (didn't bet)
Seat 6: choupai (button) collected ($2.50)
Seat 7: matiko09 (small blind) folded before Flop





PokerStars Hand #151942139247:  Hold'em No Limit ($0.50/$1.00 USD) - 2016/04/15 13:11:33 CET [2016/04/15 7:11:33 ET]
Table 'Lamberta III' 9-max Seat #2 is the button
Seat 1: Westpants ($100 in chips) 
Seat 2: Vermm ($63.59 in chips) 
Seat 3: butcheN18 ($107.94 in chips) 
Seat 4: Filojoes ($100 in chips) 
Seat 5: tipner ($114.35 in chips) 
Seat 6: aseban11 ($103.68 in chips) 
Seat 7: ardo888 ($121.79 in chips) 
Seat 8: wangzhuoming ($110.92 in chips) 
Seat 9: matiko09 ($165.74 in chips) 
butcheN18: posts small blind $0.50
Filojoes: posts big blind $1
*** HOLE CARDS ***
Dealt to matiko09 [3h Jc]
tipner: folds 
aseban11: folds 
ardo888: folds 
wangzhuoming: folds 
matiko09: folds 
Westpants: folds 
Vermm: raises $2 to $3
butcheN18: raises $7 to $10
Filojoes: folds 
Vermm: calls $7
*** FLOP *** [8c Td 8d]
butcheN18: bets $12.76
Vermm: calls $12.76
*** TURN *** [8c Td 8d] [8h]
butcheN18: bets $28
Vermm: raises $12.83 to $40.83 and is all-in
butcheN18: calls $12.83
*** RIVER *** [8c Td 8d 8h] [7s]
*** SHOW DOWN ***
butcheN18: shows [Jh Js] (a full house, Eights full of Jacks)
Vermm: shows [Kh Th] (a full house, Eights full of Tens)
butcheN18 collected $125.68 from pot
*** SUMMARY ***
Total pot $128.18 | Rake $2.50 
Board [8c Td 8d 8h 7s]
Seat 1: Westpants folded before Flop (didn't bet)
Seat 2: Vermm (button) showed [Kh Th] and lost with a full house, Eights full of Tens
Seat 3: butcheN18 (small blind) showed [Jh Js] and won ($125.68) with a full house, Eights full of Jacks
Seat 4: Filojoes (big blind) folded before Flop
Seat 5: tipner folded before Flop (didn't bet)
Seat 6: aseban11 folded before Flop (didn't bet)
Seat 7: ardo888 folded before Flop (didn't bet)
Seat 8: wangzhuoming folded before Flop (didn't bet)
Seat 9: matiko09 folded before Flop (didn't bet)





PokerStars Hand #151942140098:  Hold'em No Limit ($0.50/$1.00 USD) - 2016/04/15 13:11:35 CET [2016/04/15 7:11:35 ET]
Table 'Gase II' 9-max Seat #4 is the button
Seat 2: aseban11 ($104.80 in chips) 
Seat 3: djammusic ($39.50 in chips) 
Seat 4: Filojoes ($107.57 in chips) 
Seat 5: delaiwangka ($91 in chips) 
Seat 6: matiko09 ($100 in chips) 
Seat 7: danbo577 ($78.50 in chips) 
Seat 8: butcheN18 ($100 in chips) 
Seat 9: UberLycan ($118.68 in chips) 
delaiwangka: posts small blind $0.50
matiko09: posts big blind $1
*** HOLE CARDS ***
Dealt to matiko09 [6h 7d]
danbo577: raises $1 to $2
butcheN18: folds 
UberLycan: folds 
aseban11: folds 
djammusic: folds 
Filojoes: calls $2
delaiwangka: folds 
matiko09: folds 
*** FLOP *** [3s 4c Kc]
danbo577: checks 
delaiwangka said, "高张同花还想进去看看结果"
Filojoes: checks 
*** TURN *** [3s 4c Kc] [Qc]
danbo577: checks 
Filojoes: checks 
*** RIVER *** [3s 4c Kc Qc] [Td]
danbo577: bets $3
Filojoes: folds 
Uncalled bet ($3) returned to danbo577
danbo577 collected $5.22 from pot
danbo577: doesn't show hand 
*** SUMMARY ***
Total pot $5.50 | Rake $0.28 
Board [3s 4c Kc Qc Td]
Seat 2: aseban11 folded before Flop (didn't bet)
Seat 3: djammusic folded before Flop (didn't bet)
Seat 4: Filojoes (button) folded on the River
Seat 5: delaiwangka (small blind) folded before Flop
Seat 6: matiko09 (big blind) folded before Flop
Seat 7: danbo577 collected ($5.22)
Seat 8: butcheN18 folded before Flop (didn't bet)
Seat 9: UberLycan folded before Flop (didn't bet)





PokerStars Hand #151942140530:  Hold'em No Limit ($0.50/$1.00 USD) - 2016/04/15 13:11:36 CET [2016/04/15 7:11:36 ET]
Table 'Katja II' 9-max Seat #3 is the button
Seat 2: TheJokerMen1 ($63.23 in chips) 
Seat 3: matiko09 ($117.62 in chips) 
Seat 4: Sutt_420 ($77.70 in chips) 
Seat 5: Dachish ($89.97 in chips) 
Seat 6: ASG2016 ($112.04 in chips) 
Seat 7: Effort92 ($110.92 in chips) 
Seat 8: Glushchenko ($100 in chips) 
Seat 9: aseban11 ($100 in chips) 
Sutt_420: posts small blind $0.50
Dachish: posts big blind $1
Filojoes: sits out 
*** HOLE CARDS ***
Dealt to matiko09 [2d 8c]
ASG2016: folds 
Effort92: raises $1.50 to $2.50
Glushchenko: folds 
aseban11: folds 
TheJokerMen1: calls $2.50
matiko09: folds 
Sutt_420: folds 
Dachish: folds 
*** FLOP *** [9s Ad 5c]
Effort92: checks 
TheJokerMen1: checks 
*** TURN *** [9s Ad 5c] [4h]
Effort92: bets $3
TheJokerMen1: calls $3
*** RIVER *** [9s Ad 5c 4h] [6c]
Effort92: checks 
TheJokerMen1: checks 
*** SHOW DOWN ***
Effort92: shows [8d 9d] (a pair of Nines)
TheJokerMen1: shows [Jc 9h] (a pair of Nines - Ace+Jack kicker)
TheJokerMen1 collected $11.88 from pot
*** SUMMARY ***
Total pot $12.50 | Rake $0.62 
Board [9s Ad 5c 4h 6c]
Seat 2: TheJokerMen1 showed [Jc 9h] and won ($11.88) with a pair of Nines
Seat 3: matiko09 (button) folded before Flop (didn't bet)
Seat 4: Sutt_420 (small blind) folded before Flop
Seat 5: Dachish (big blind) folded before Flop
Seat 6: ASG2016 folded before Flop (didn't bet)
Seat 7: Effort92 showed [8d 9d] and lost with a pair of Nines
Seat 8: Glushchenko folded before Flop (didn't bet)
Seat 9: aseban11 folded before Flop (didn't bet)





PokerStars Hand #151942145162:  Hold'em No Limit ($0.50/$1.00 USD) - 2016/04/15 13:11:46 CET [2016/04/15 7:11:46 ET]
Table 'Cheruskia II' 9-max Seat #5 is the button
Seat 5: Paul6999 ($38.50 in chips) 
Seat 6: hammerwife ($122.60 in chips) 
Seat 7: matiko09 ($100 in chips) 
Seat 9: rycho222 ($99.50 in chips) 
hammerwife: posts small blind $0.50
matiko09: posts big blind $1
*** HOLE CARDS ***
Dealt to matiko09 [6h Qh]
rycho222: folds 
Paul6999: folds 
hammerwife: raises $1.60 to $2.60
matiko09: folds 
Uncalled bet ($1.60) returned to hammerwife
hammerwife collected $2 from pot
hammerwife: doesn't show hand 
*** SUMMARY ***
Total pot $2 | Rake $0 
Seat 5: Paul6999 (button) folded before Flop (didn't bet)
Seat 6: hammerwife (small blind) collected ($2)
Seat 7: matiko09 (big blind) folded before Flop
Seat 9: rycho222 folded before Flop (didn't bet)





PokerStars Hand #151942145253:  Hold'em No Limit ($0.50/$1.00 USD) - 2016/04/15 13:11:46 CET [2016/04/15 7:11:46 ET]
Table 'Navi' 9-max Seat #8 is the button
Seat 1: tipner ($100 in chips) 
Seat 2: butcheN18 ($100 in chips) 
Seat 4: Effort92 ($133.93 in chips) 
Seat 5: StarsAbove ($100 in chips) 
Seat 6: Glushchenko ($114.16 in chips) 
Seat 7: yoshidao ($133.95 in chips) 
Seat 8: djammusic ($46.78 in chips) 
Seat 9: matiko09 ($100 in chips) 
matiko09: posts small blind $0.50
tipner: posts big blind $1
aseban11: sits out 
*** HOLE CARDS ***
Dealt to matiko09 [7d 9h]
butcheN18: folds 
Effort92: folds 
StarsAbove: folds 
Glushchenko: folds 
yoshidao: folds 
djammusic: folds 
matiko09: folds 
Uncalled bet ($0.50) returned to tipner
tipner collected $1 from pot
tipner: doesn't show hand 
*** SUMMARY ***
Total pot $1 | Rake $0 
Seat 1: tipner (big blind) collected ($1)
Seat 2: butcheN18 folded before Flop (didn't bet)
Seat 4: Effort92 folded before Flop (didn't bet)
Seat 5: StarsAbove folded before Flop (didn't bet)
Seat 6: Glushchenko folded before Flop (didn't bet)
Seat 7: yoshidao folded before Flop (didn't bet)
Seat 8: djammusic (button) folded before Flop (didn't bet)
Seat 9: matiko09 (small blind) folded before Flop





PokerStars Hand #151942145198:  Hold'em No Limit ($1/$2 USD) - 2016/04/15 13:11:46 CET [2016/04/15 7:11:46 ET]
Table 'Patroclus II' 9-max Seat #8 is the button
Seat 1: TonnaMunz ($201.50 in chips) 
Seat 2: Moemors ($162.65 in chips) 
Seat 3: Koolniknik ($207.85 in chips) 
Seat 4: tipner ($200 in chips) 
Seat 5: butcheN18 ($218 in chips) 
Seat 6: di0d80 ($205.35 in chips) 
Seat 7: matiko09 ($203 in chips) 
Seat 8: Glushchenko ($200 in chips) 
Seat 9: Fish4trips ($204.35 in chips) 
Fish4trips: posts small blind $1
TonnaMunz: posts big blind $2
*** HOLE CARDS ***
Dealt to matiko09 [4h 4s]
Moemors: folds 
Koolniknik: folds 
tipner: raises $4 to $6
butcheN18: folds 
di0d80: folds 
matiko09: folds 
Glushchenko: folds 
Fish4trips: folds 
TonnaMunz: folds 
Uncalled bet ($4) returned to tipner
tipner collected $5 from pot
tipner: doesn't show hand 
*** SUMMARY ***
Total pot $5 | Rake $0 
Seat 1: TonnaMunz (big blind) folded before Flop
Seat 2: Moemors folded before Flop (didn't bet)
Seat 3: Koolniknik folded before Flop (didn't bet)
Seat 4: tipner collected ($5)
Seat 5: butcheN18 folded before Flop (didn't bet)
Seat 6: di0d80 folded before Flop (didn't bet)
Seat 7: matiko09 folded before Flop (didn't bet)
Seat 8: Glushchenko (button) folded before Flop (didn't bet)
Seat 9: Fish4trips (small blind) folded before Flop





PokerStars Hand #151942148801:  Hold'em No Limit ($1/$2 USD) - 2016/04/15 13:11:54 CET [2016/04/15 7:11:54 ET]
Table 'Adele II' 9-max Seat #7 is the button
Seat 1: coinflip_si ($200 in chips) 
Seat 2: Fish4trips ($200 in chips) 
Seat 3: matiko09 ($350.64 in chips) 
Seat 4: Glushchenko ($200 in chips) 
Seat 6: TonnaMunz ($207.25 in chips) 
Seat 7: tipner ($238.20 in chips) 
Seat 8: docmarc777 ($257.88 in chips) 
docmarc777: posts small blind $1
coinflip_si: posts big blind $2
di0d80: sits out 
*** HOLE CARDS ***
Dealt to matiko09 [9c Kc]
Fish4trips: folds 
matiko09: folds 
Glushchenko: raises $4 to $6
TonnaMunz: folds 
tipner: folds 
docmarc777: folds 
coinflip_si: folds 
Uncalled bet ($4) returned to Glushchenko
Glushchenko collected $5 from pot
*** SUMMARY ***
Total pot $5 | Rake $0 
Seat 1: coinflip_si (big blind) folded before Flop
Seat 2: Fish4trips folded before Flop (didn't bet)
Seat 3: matiko09 folded before Flop (didn't bet)
Seat 4: Glushchenko collected ($5)
Seat 6: TonnaMunz folded before Flop (didn't bet)
Seat 7: tipner (button) folded before Flop (didn't bet)
Seat 8: docmarc777 (small blind) folded before Flop





PokerStars Hand #151942151876:  Hold'em No Limit ($0.50/$1.00 USD) - 2016/04/15 13:12:01 CET [2016/04/15 7:12:01 ET]
Table 'Navi' 9-max Seat #9 is the button
Seat 1: tipner ($100.50 in chips) 
Seat 2: butcheN18 ($100 in chips) 
Seat 4: Effort92 ($133.93 in chips) 
Seat 5: StarsAbove ($100 in chips) 
Seat 6: Glushchenko ($114.16 in chips) 
Seat 7: yoshidao ($133.95 in chips) 
Seat 8: djammusic ($46.78 in chips) 
Seat 9: matiko09 ($100 in chips) 
tipner: posts small blind $0.50
butcheN18: posts big blind $1
aseban11: sits out 
*** HOLE CARDS ***
Dealt to matiko09 [2s 7c]
Effort92: folds 
StarsAbove: folds 
Glushchenko: raises $2 to $3
yoshidao: folds 
djammusic: raises $4.50 to $7.50
matiko09: folds 
tipner: folds 
butcheN18: folds 
Glushchenko: folds 
Uncalled bet ($4.50) returned to djammusic
djammusic collected $7.50 from pot
djammusic: doesn't show hand 
*** SUMMARY ***
Total pot $7.50 | Rake $0 
Seat 1: tipner (small blind) folded before Flop
Seat 2: butcheN18 (big blind) folded before Flop
Seat 4: Effort92 folded before Flop (didn't bet)
Seat 5: StarsAbove folded before Flop (didn't bet)
Seat 6: Glushchenko folded before Flop
Seat 7: yoshidao folded before Flop (didn't bet)
Seat 8: djammusic collected ($7.50)
Seat 9: matiko09 (button) folded before Flop (didn't bet)





PokerStars Hand #151942153395:  Hold'em No Limit ($0.50/$1.00 USD) - 2016/04/15 13:12:04 CET [2016/04/15 7:12:04 ET]
Table 'Cheruskia II' 9-max Seat #6 is the button
Seat 5: Paul6999 ($38.50 in chips) 
Seat 6: hammerwife ($123.60 in chips) 
Seat 7: matiko09 ($100 in chips) 
Seat 9: rycho222 ($99.50 in chips) 
matiko09: posts small blind $0.50
rycho222: posts big blind $1
*** HOLE CARDS ***
Dealt to matiko09 [7d As]
Paul6999: folds 
maxxmeister joins the table at seat #8 
hammerwife: folds 
vicus1972 joins the table at seat #1 
matiko09: raises $1.50 to $2.50
rycho222: raises $5 to $7.50
matiko09: folds 
Uncalled bet ($5) returned to rycho222
rycho222 collected $5 from pot
rycho222: doesn't show hand 
*** SUMMARY ***
Total pot $5 | Rake $0 
Seat 5: Paul6999 folded before Flop (didn't bet)
Seat 6: hammerwife (button) folded before Flop (didn't bet)
Seat 7: matiko09 (small blind) folded before Flop
Seat 9: rycho222 (big blind) collected ($5)





PokerStars Hand #151942154613:  Hold'em No Limit ($0.50/$1.00 USD) - 2016/04/15 13:12:07 CET [2016/04/15 7:12:07 ET]
Table 'Chiny II' 9-max Seat #7 is the button
Seat 2: AceFarky ($107.41 in chips) 
Seat 3: powerbel ($50.38 in chips) 
Seat 4: 1000karlos ($78.77 in chips) 
Seat 5: Yaaaazz ($118.78 in chips) 
Seat 6: choupai ($33 in chips) 
Seat 7: matiko09 ($146.86 in chips) 
Filojoes will be allowed to play after the button
AceFarky: posts small blind $0.50
powerbel: posts big blind $1
*** HOLE CARDS ***
Dealt to matiko09 [Qc Kc]
butcheN18 joins the table at seat #9 
1000karlos: folds 
Yaaaazz: folds 
choupai: folds 
matiko09: raises $1.27 to $2.27
AceFarky: folds 
powerbel: calls $1.27
*** FLOP *** [Ah 2h As]
powerbel: checks 
matiko09: checks 
*** TURN *** [Ah 2h As] [4s]
powerbel: checks 
matiko09: bets $2.49
powerbel: folds 
Uncalled bet ($2.49) returned to matiko09
matiko09 collected $4.79 from pot
matiko09: doesn't show hand 
*** SUMMARY ***
Total pot $5.04 | Rake $0.25 
Board [Ah 2h As 4s]
Seat 2: AceFarky (small blind) folded before Flop
Seat 3: powerbel (big blind) folded on the Turn
Seat 4: 1000karlos folded before Flop (didn't bet)
Seat 5: Yaaaazz folded before Flop (didn't bet)
Seat 6: choupai folded before Flop (didn't bet)
Seat 7: matiko09 (button) collected ($4.79)





PokerStars Hand #151942155962:  Hold'em No Limit ($0.50/$1.00 USD) - 2016/04/15 13:12:10 CET [2016/04/15 7:12:10 ET]
Table 'Matterania III' 9-max Seat #9 is the button
Seat 1: di0d80 ($113.78 in chips) 
Seat 3: ardo888 ($155.07 in chips) 
Seat 4: wangzhuoming ($77.32 in chips) 
Seat 5: Vermm ($80.90 in chips) 
Seat 6: matiko09 ($100 in chips) 
Seat 7: Filojoes ($103.30 in chips) 
Seat 9: butcheN18 ($100 in chips) 
di0d80: posts small blind $0.50
aseban11: is sitting out 
ardo888: posts big blind $1
di0d80: posts the ante $0.20
ardo888: posts the ante $0.20
wangzhuoming: posts the ante $0.20
Vermm: posts the ante $0.20
matiko09: posts the ante $0.20
Filojoes: posts the ante $0.20
butcheN18: posts the ante $0.20
*** HOLE CARDS ***
Dealt to matiko09 [Kd 6s]
wangzhuoming: folds 
Vermm: folds 
matiko09: folds 
Filojoes: folds 
butcheN18: folds 
di0d80: folds 
Uncalled bet ($0.50) returned to ardo888
aseban11 leaves the table
ardo888 collected $2.40 from pot
ardo888: doesn't show hand 
*** SUMMARY ***
Total pot $2.40 | Rake $0 
Seat 1: di0d80 (small blind) folded before Flop
Seat 3: ardo888 (big blind) collected ($2.40)
Seat 4: wangzhuoming folded before Flop (didn't bet)
Seat 5: Vermm folded before Flop (didn't bet)
Seat 6: matiko09 folded before Flop (didn't bet)
Seat 7: Filojoes folded before Flop (didn't bet)
Seat 9: butcheN18 (button) folded before Flop (didn't bet)





PokerStars Hand #151942156462:  Hold'em No Limit ($1/$2 USD) - 2016/04/15 13:12:11 CET [2016/04/15 7:12:11 ET]
Table 'Adele II' 9-max Seat #8 is the button
Seat 1: coinflip_si ($200 in chips) 
Seat 2: Fish4trips ($200 in chips) 
Seat 3: matiko09 ($350.64 in chips) 
Seat 4: Glushchenko ($203 in chips) 
Seat 6: TonnaMunz ($207.25 in chips) 
Seat 7: tipner ($238.20 in chips) 
Seat 8: docmarc777 ($256.88 in chips) 
coinflip_si: posts small blind $1
Fish4trips: posts big blind $2
di0d80: sits out 
*** HOLE CARDS ***
Dealt to matiko09 [7c 9d]
matiko09: folds 
Glushchenko: folds 
TonnaMunz: folds 
tipner: raises $2 to $4
docmarc777: calls $4
coinflip_si: folds 
Fish4trips: folds 
*** FLOP *** [Kh Kc 3h]
tipner: bets $6
docmarc777: folds 
Uncalled bet ($6) returned to tipner
tipner collected $10.45 from pot
tipner: doesn't show hand 
*** SUMMARY ***
Total pot $11 | Rake $0.55 
Board [Kh Kc 3h]
Seat 1: coinflip_si (small blind) folded before Flop
Seat 2: Fish4trips (big blind) folded before Flop
Seat 3: matiko09 folded before Flop (didn't bet)
Seat 4: Glushchenko folded before Flop (didn't bet)
Seat 6: TonnaMunz folded before Flop (didn't bet)
Seat 7: tipner collected ($10.45)
Seat 8: docmarc777 (button) folded on the Flop





PokerStars Hand #151942161307:  Hold'em No Limit ($1/$2 USD) - 2016/04/15 13:12:21 CET [2016/04/15 7:12:21 ET]
Table 'Patroclus II' 9-max Seat #9 is the button
Seat 1: TonnaMunz ($200 in chips) 
Seat 2: Moemors ($162.65 in chips) 
Seat 3: Koolniknik ($207.85 in chips) 
Seat 4: tipner ($203 in chips) 
Seat 5: butcheN18 ($218 in chips) 
Seat 6: di0d80 ($205.35 in chips) 
Seat 7: matiko09 ($203 in chips) 
Seat 8: Glushchenko ($200 in chips) 
Seat 9: Fish4trips ($203.35 in chips) 
TonnaMunz: posts small blind $1
Moemors: posts big blind $2
*** HOLE CARDS ***
Dealt to matiko09 [Jh Jc]
Koolniknik: folds 
tipner: raises $4 to $6
butcheN18: folds 
di0d80: folds 
matiko09: calls $6
Glushchenko: folds 
Fish4trips: folds 
TonnaMunz: folds 
Moemors: calls $4
*** FLOP *** [Ad 3s 6c]
Moemors: checks 
tipner: checks 
matiko09: checks 
*** TURN *** [Ad 3s 6c] [3c]
Moemors: checks 
tipner: checks 
matiko09: bets $9.38
Moemors: folds 
tipner: folds 
Uncalled bet ($9.38) returned to matiko09
matiko09 collected $18.05 from pot
matiko09: doesn't show hand 
*** SUMMARY ***
Total pot $19 | Rake $0.95 
Board [Ad 3s 6c 3c]
Seat 1: TonnaMunz (small blind) folded before Flop
Seat 2: Moemors (big blind) folded on the Turn
Seat 3: Koolniknik folded before Flop (didn't bet)
Seat 4: tipner folded on the Turn
Seat 5: butcheN18 folded before Flop (didn't bet)
Seat 6: di0d80 folded before Flop (didn't bet)
Seat 7: matiko09 collected ($18.05)
Seat 8: Glushchenko folded before Flop (didn't bet)
Seat 9: Fish4trips (button) folded before Flop (didn't bet)





PokerStars Hand #151942164794:  Hold'em No Limit ($0.50/$1.00 USD) - 2016/04/15 13:12:29 CET [2016/04/15 7:12:29 ET]
Table 'Matterania III' 9-max Seat #1 is the button
Seat 1: di0d80 ($113.08 in chips) 
Seat 3: ardo888 ($156.77 in chips) 
Seat 4: wangzhuoming ($77.12 in chips) 
Seat 5: Vermm ($80.70 in chips) 
Seat 6: matiko09 ($100 in chips) 
Seat 7: Filojoes ($103.10 in chips) 
Seat 9: butcheN18 ($100 in chips) 
ardo888: posts small blind $0.50
wangzhuoming: posts big blind $1
di0d80: posts the ante $0.20
ardo888: posts the ante $0.20
wangzhuoming: posts the ante $0.20
Vermm: posts the ante $0.20
matiko09: posts the ante $0.20
Filojoes: posts the ante $0.20
butcheN18: posts the ante $0.20
*** HOLE CARDS ***
Dealt to matiko09 [Td 5c]
Vermm: folds 
matiko09: folds 
Filojoes: folds 
Jimy Tiltman joins the table at seat #8 
butcheN18: raises $2 to $3
di0d80: folds 
ardo888: folds 
wangzhuoming: folds 
Uncalled bet ($2) returned to butcheN18
butcheN18 collected $3.90 from pot
butcheN18: doesn't show hand 
*** SUMMARY ***
Total pot $3.90 | Rake $0 
Seat 1: di0d80 (button) folded before Flop (didn't bet)
Seat 3: ardo888 (small blind) folded before Flop
Seat 4: wangzhuoming (big blind) folded before Flop
Seat 5: Vermm folded before Flop (didn't bet)
Seat 6: matiko09 folded before Flop (didn't bet)
Seat 7: Filojoes folded before Flop (didn't bet)
Seat 9: butcheN18 collected ($3.90)





PokerStars Hand #151942166665:  Hold'em No Limit ($0.50/$1.00 USD) - 2016/04/15 13:12:33 CET [2016/04/15 7:12:33 ET]
Table 'Navi' 9-max Seat #1 is the button
Seat 1: tipner ($100 in chips) 
Seat 2: butcheN18 ($100 in chips) 
Seat 3: aseban11 ($100 in chips) 
Seat 4: Effort92 ($133.93 in chips) 
Seat 5: StarsAbove ($100 in chips) 
Seat 6: Glushchenko ($111.16 in chips) 
Seat 7: yoshidao ($133.95 in chips) 
Seat 8: djammusic ($51.28 in chips) 
Seat 9: matiko09 ($100 in chips) 
butcheN18: posts small blind $0.50
aseban11: posts big blind $1
*** HOLE CARDS ***
Dealt to matiko09 [9d 7h]
Effort92: folds 
StarsAbove: folds 
Glushchenko: folds 
yoshidao: calls $1
djammusic: folds 
matiko09: folds 
tipner: folds 
butcheN18: folds 
aseban11: raises $2.50 to $3.50
yoshidao: calls $2.50
*** FLOP *** [Jc 4c 9h]
aseban11: bets $5.34
yoshidao: raises $5.34 to $10.68
aseban11: folds 
Uncalled bet ($5.34) returned to yoshidao
yoshidao collected $17.27 from pot
yoshidao: doesn't show hand 
*** SUMMARY ***
Total pot $18.18 | Rake $0.91 
Board [Jc 4c 9h]
Seat 1: tipner (button) folded before Flop (didn't bet)
Seat 2: butcheN18 (small blind) folded before Flop
Seat 3: aseban11 (big blind) folded on the Flop
Seat 4: Effort92 folded before Flop (didn't bet)
Seat 5: StarsAbove folded before Flop (didn't bet)
Seat 6: Glushchenko folded before Flop (didn't bet)
Seat 7: yoshidao collected ($17.27)
Seat 8: djammusic folded before Flop (didn't bet)
Seat 9: matiko09 folded before Flop (didn't bet)





PokerStars Hand #151942167173:  Hold'em No Limit ($0.50/$1.00 USD) - 2016/04/15 13:12:34 CET [2016/04/15 7:12:34 ET]
Table 'Cheruskia II' 9-max Seat #7 is the button
Seat 1: vicus1972 ($100 in chips) 
Seat 5: Paul6999 ($38.50 in chips) 
Seat 6: hammerwife ($123.60 in chips) 
Seat 7: matiko09 ($100 in chips) 
Seat 9: rycho222 ($102 in chips) 
rycho222: posts small blind $0.50
vicus1972: posts big blind $1
*** HOLE CARDS ***
Dealt to matiko09 [Qs 5h]
Paul6999: folds 
SerAlGog joins the table at seat #2 
hammerwife: raises $1.50 to $2.50
matiko09: folds 
rycho222: folds 
butcheN18 joins the table at seat #3 
djammusic joins the table at seat #4 
vicus1972: folds 
Uncalled bet ($1.50) returned to hammerwife
hammerwife collected $2.50 from pot
hammerwife: doesn't show hand 
*** SUMMARY ***
Total pot $2.50 | Rake $0 
Seat 1: vicus1972 (big blind) folded before Flop
Seat 5: Paul6999 folded before Flop (didn't bet)
Seat 6: hammerwife collected ($2.50)
Seat 7: matiko09 (button) folded before Flop (didn't bet)
Seat 9: rycho222 (small blind) folded before Flop





PokerStars Hand #151942167567:  Hold'em No Limit ($0.50/$1.00 USD) - 2016/04/15 13:12:35 CET [2016/04/15 7:12:35 ET]
Table 'Lamberta III' 9-max Seat #3 is the button
Seat 1: Westpants ($100 in chips) 
Seat 3: butcheN18 ($170.03 in chips) 
Seat 4: Filojoes ($100 in chips) 
Seat 5: tipner ($114.35 in chips) 
Seat 6: aseban11 ($103.68 in chips) 
Seat 7: ardo888 ($121.79 in chips) 
Seat 8: wangzhuoming ($110.92 in chips) 
Seat 9: matiko09 ($165.74 in chips) 
Filojoes: posts small blind $0.50
tipner: posts big blind $1
*** HOLE CARDS ***
Dealt to matiko09 [5c 5s]
Vermm leaves the table
aseban11: folds 
Biscuit270 joins the table at seat #2 
ardo888: folds 
wangzhuoming: folds 
matiko09: raises $2 to $3
Westpants: folds 
butcheN18: calls $3
Filojoes: folds 
tipner: folds 
*** FLOP *** [Qd Qs 4h]
matiko09: checks 
butcheN18: bets $4
matiko09: calls $4
*** TURN *** [Qd Qs 4h] [3h]
matiko09: checks 
butcheN18: bets $7.65
matiko09: folds 
Uncalled bet ($7.65) returned to butcheN18
butcheN18 collected $14.72 from pot
butcheN18: doesn't show hand 
*** SUMMARY ***
Total pot $15.50 | Rake $0.78 
Board [Qd Qs 4h 3h]
Seat 1: Westpants folded before Flop (didn't bet)
Seat 3: butcheN18 (button) collected ($14.72)
Seat 4: Filojoes (small blind) folded before Flop
Seat 5: tipner (big blind) folded before Flop
Seat 6: aseban11 folded before Flop (didn't bet)
Seat 7: ardo888 folded before Flop (didn't bet)
Seat 8: wangzhuoming folded before Flop (didn't bet)
Seat 9: matiko09 folded on the Turn





PokerStars Hand #151942169530:  Hold'em No Limit ($0.50/$1.00 USD) - 2016/04/15 13:12:39 CET [2016/04/15 7:12:39 ET]
Table 'Gase II' 9-max Seat #5 is the button
Seat 2: aseban11 ($104.80 in chips) 
Seat 3: djammusic ($39.50 in chips) 
Seat 4: Filojoes ($105.57 in chips) 
Seat 5: delaiwangka ($90.50 in chips) 
Seat 6: matiko09 ($100 in chips) 
Seat 7: danbo577 ($81.72 in chips) 
Seat 8: butcheN18 ($100 in chips) 
Seat 9: UberLycan ($118.68 in chips) 
matiko09: posts small blind $0.50
danbo577: posts big blind $1
*** HOLE CARDS ***
Dealt to matiko09 [Jc 9d]
butcheN18: folds 
UberLycan: folds 
aseban11: folds 
djammusic: folds 
Filojoes: folds 
delaiwangka: folds 
danbo577 said, "刚才KK都拿不到价值"
matiko09: raises $1.50 to $2.50
danbo577: calls $1.50
*** FLOP *** [Tc Kh 6s]
matiko09: bets $3.09
danbo577: folds 
Uncalled bet ($3.09) returned to matiko09
matiko09 collected $4.75 from pot
matiko09: doesn't show hand 
*** SUMMARY ***
Total pot $5 | Rake $0.25 
Board [Tc Kh 6s]
Seat 2: aseban11 folded before Flop (didn't bet)
Seat 3: djammusic folded before Flop (didn't bet)
Seat 4: Filojoes folded before Flop (didn't bet)
Seat 5: delaiwangka (button) folded before Flop (didn't bet)
Seat 6: matiko09 (small blind) collected ($4.75)
Seat 7: danbo577 (big blind) folded on the Flop
Seat 8: butcheN18 folded before Flop (didn't bet)
Seat 9: UberLycan folded before Flop (didn't bet)





PokerStars Hand #151942172696:  Hold'em No Limit ($0.50/$1.00 USD) - 2016/04/15 13:12:46 CET [2016/04/15 7:12:46 ET]
Table 'Matterania III' 9-max Seat #3 is the button
Seat 1: di0d80 ($112.88 in chips) 
Seat 3: ardo888 ($156.07 in chips) 
Seat 4: wangzhuoming ($75.92 in chips) 
Seat 5: Vermm ($80.50 in chips) 
Seat 6: matiko09 ($100 in chips) 
Seat 7: Filojoes ($102.90 in chips) 
Seat 9: butcheN18 ($102.70 in chips) 
wangzhuoming: posts small blind $0.50
Vermm: posts big blind $1
Jimy Tiltman: sits out 
di0d80: posts the ante $0.20
ardo888: posts the ante $0.20
wangzhuoming: posts the ante $0.20
Vermm: posts the ante $0.20
matiko09: posts the ante $0.20
Filojoes: posts the ante $0.20
butcheN18: posts the ante $0.20
*** HOLE CARDS ***
Dealt to matiko09 [Th Jd]
matiko09: folds 
Filojoes: folds 
butcheN18: raises $2 to $3
di0d80: folds 
ardo888: folds 
wangzhuoming: folds 
Vermm: folds 
Uncalled bet ($2) returned to butcheN18
butcheN18 collected $3.90 from pot
butcheN18: doesn't show hand 
*** SUMMARY ***
Total pot $3.90 | Rake $0 
Seat 1: di0d80 folded before Flop (didn't bet)
Seat 3: ardo888 (button) folded before Flop (didn't bet)
Seat 4: wangzhuoming (small blind) folded before Flop
Seat 5: Vermm (big blind) folded before Flop
Seat 6: matiko09 folded before Flop (didn't bet)
Seat 7: Filojoes folded before Flop (didn't bet)
Seat 9: butcheN18 collected ($3.90)





PokerStars Hand #151942175868:  Hold'em No Limit ($0.50/$1.00 USD) - 2016/04/15 13:12:52 CET [2016/04/15 7:12:52 ET]
Table 'Katja II' 9-max Seat #4 is the button
Seat 2: TheJokerMen1 ($69.61 in chips) 
Seat 3: matiko09 ($117.62 in chips) 
Seat 4: Sutt_420 ($77.20 in chips) 
Seat 5: Dachish ($88.97 in chips) 
Seat 6: ASG2016 ($112.04 in chips) 
Seat 7: Effort92 ($105.42 in chips) 
Seat 8: Glushchenko ($100 in chips) 
Seat 9: aseban11 ($100 in chips) 
Dachish: posts small blind $0.50
ASG2016: posts big blind $1
Filojoes: sits out 
*** HOLE CARDS ***
Dealt to matiko09 [9s Kh]
Effort92: folds 
Glushchenko: folds 
aseban11: folds 
TheJokerMen1: folds 
matiko09: folds 
Sutt_420: folds 
Dachish: folds 
Uncalled bet ($0.50) returned to ASG2016
ASG2016 collected $1 from pot
ASG2016: doesn't show hand 
*** SUMMARY ***
Total pot $1 | Rake $0 
Seat 2: TheJokerMen1 folded before Flop (didn't bet)
Seat 3: matiko09 folded before Flop (didn't bet)
Seat 4: Sutt_420 (button) folded before Flop (didn't bet)
Seat 5: Dachish (small blind) folded before Flop
Seat 6: ASG2016 (big blind) collected ($1)
Seat 7: Effort92 folded before Flop (didn't bet)
Seat 8: Glushchenko folded before Flop (didn't bet)
Seat 9: aseban11 folded before Flop (didn't bet)





PokerStars Hand #151942176032:  Hold'em No Limit ($1/$2 USD) - 2016/04/15 13:12:53 CET [2016/04/15 7:12:53 ET]
Table 'Adele II' 9-max Seat #1 is the button
Seat 1: coinflip_si ($200 in chips) 
Seat 2: Fish4trips ($200 in chips) 
Seat 3: matiko09 ($350.64 in chips) 
Seat 4: Glushchenko ($203 in chips) 
Seat 6: TonnaMunz ($207.25 in chips) 
Seat 7: tipner ($244.65 in chips) 
Seat 8: docmarc777 ($252.88 in chips) 
Fish4trips: posts small blind $1
matiko09: posts big blind $2
di0d80: sits out 
*** HOLE CARDS ***
Dealt to matiko09 [9h 9s]
Glushchenko: folds 
TonnaMunz: folds 
tipner: folds 
docmarc777: raises $3.88 to $5.88
coinflip_si: folds 
Fish4trips: raises $14.12 to $20
matiko09: folds 
docmarc777: calls $14.12
*** FLOP *** [7h 2c 6c]
Fish4trips: checks 
docmarc777: bets $20
Fish4trips: folds 
Uncalled bet ($20) returned to docmarc777
docmarc777 collected $39.90 from pot
docmarc777: doesn't show hand 
*** SUMMARY ***
Total pot $42 | Rake $2.10 
Board [7h 2c 6c]
Seat 1: coinflip_si (button) folded before Flop (didn't bet)
Seat 2: Fish4trips (small blind) folded on the Flop
Seat 3: matiko09 (big blind) folded before Flop
Seat 4: Glushchenko folded before Flop (didn't bet)
Seat 6: TonnaMunz folded before Flop (didn't bet)
Seat 7: tipner folded before Flop (didn't bet)
Seat 8: docmarc777 collected ($39.90)





PokerStars Hand #151942178741:  Hold'em No Limit ($0.50/$1.00 USD) - 2016/04/15 13:12:59 CET [2016/04/15 7:12:59 ET]
Table 'Chiny II' 9-max Seat #2 is the button
Seat 2: AceFarky ($106.91 in chips) 
Seat 3: powerbel ($48.11 in chips) 
Seat 4: 1000karlos ($78.77 in chips) 
Seat 5: Yaaaazz ($118.78 in chips) 
Seat 6: choupai ($33 in chips) 
Seat 7: matiko09 ($149.38 in chips) 
powerbel: posts small blind $0.50
1000karlos: posts big blind $1
Filojoes: sits out 
butcheN18: sits out 
*** HOLE CARDS ***
Dealt to matiko09 [Jd Td]
Yaaaazz: folds 
choupai: folds 
matiko09: raises $1.50 to $2.50
AceFarky: folds 
powerbel: folds 
1000karlos: folds 
Uncalled bet ($1.50) returned to matiko09
matiko09 collected $2.50 from pot
matiko09: doesn't show hand 
*** SUMMARY ***
Total pot $2.50 | Rake $0 
Seat 2: AceFarky (button) folded before Flop (didn't bet)
Seat 3: powerbel (small blind) folded before Flop
Seat 4: 1000karlos (big blind) folded before Flop
Seat 5: Yaaaazz folded before Flop (didn't bet)
Seat 6: choupai folded before Flop (didn't bet)
Seat 7: matiko09 collected ($2.50)





PokerStars Hand #151942182672:  Hold'em No Limit ($0.50/$1.00 USD) - 2016/04/15 13:13:07 CET [2016/04/15 7:13:07 ET]
Table 'Katja II' 9-max Seat #5 is the button
Seat 2: TheJokerMen1 ($69.61 in chips) 
Seat 3: matiko09 ($117.62 in chips) 
Seat 4: Sutt_420 ($77.20 in chips) 
Seat 5: Dachish ($88.47 in chips) 
Seat 6: ASG2016 ($112.54 in chips) 
Seat 7: Effort92 ($105.42 in chips) 
Seat 8: Glushchenko ($100 in chips) 
Seat 9: aseban11 ($100 in chips) 
ASG2016: posts small blind $0.50
Effort92: posts big blind $1
Filojoes: sits out 
*** HOLE CARDS ***
Dealt to matiko09 [5s 3d]
Glushchenko: folds 
aseban11: raises $2 to $3
TheJokerMen1: calls $3
matiko09: folds 
Sutt_420: folds 
Dachish: raises $10.50 to $13.50
ASG2016: folds 
Effort92: folds 
aseban11: folds 
TheJokerMen1: calls $10.50
*** FLOP *** [Ac Tc 4c]
TheJokerMen1: checks 
Dachish: bets $19
TheJokerMen1: folds 
Uncalled bet ($19) returned to Dachish
Dachish collected $29.92 from pot
Dachish: doesn't show hand 
*** SUMMARY ***
Total pot $31.50 | Rake $1.58 
Board [Ac Tc 4c]
Seat 2: TheJokerMen1 folded on the Flop
Seat 3: matiko09 folded before Flop (didn't bet)
Seat 4: Sutt_420 folded before Flop (didn't bet)
Seat 5: Dachish (button) collected ($29.92)
Seat 6: ASG2016 (small blind) folded before Flop
Seat 7: Effort92 (big blind) folded before Flop
Seat 8: Glushchenko folded before Flop (didn't bet)
Seat 9: aseban11 folded before Flop





PokerStars Hand #151942183736:  Hold'em No Limit ($0.50/$1.00 USD) - 2016/04/15 13:13:10 CET [2016/04/15 7:13:10 ET]
Table 'Gase II' 9-max Seat #6 is the button
Seat 2: aseban11 ($104.80 in chips) 
Seat 3: djammusic ($39.50 in chips) 
Seat 4: Filojoes ($105.57 in chips) 
Seat 5: delaiwangka ($90.50 in chips) 
Seat 6: matiko09 ($102.25 in chips) 
Seat 7: danbo577 ($79.22 in chips) 
Seat 8: butcheN18 ($100 in chips) 
Seat 9: UberLycan ($118.68 in chips) 
danbo577: posts small blind $0.50
butcheN18: posts big blind $1
*** HOLE CARDS ***
Dealt to matiko09 [As 6c]
UberLycan: folds 
aseban11: folds 
djammusic: folds 
Filojoes: folds 
delaiwangka: folds 
matiko09: raises $1.27 to $2.27
danbo577: calls $1.77
butcheN18: raises $9.73 to $12
matiko09: folds 
danbo577: raises $9.73 to $21.73
butcheN18: raises $78.27 to $100 and is all-in
danbo577: folds 
Uncalled bet ($78.27) returned to butcheN18
butcheN18 collected $45.73 from pot
butcheN18: doesn't show hand 
*** SUMMARY ***
Total pot $45.73 | Rake $0 
Seat 2: aseban11 folded before Flop (didn't bet)
Seat 3: djammusic folded before Flop (didn't bet)
Seat 4: Filojoes folded before Flop (didn't bet)
Seat 5: delaiwangka folded before Flop (didn't bet)
Seat 6: matiko09 (button) folded before Flop
Seat 7: danbo577 (small blind) folded before Flop
Seat 8: butcheN18 (big blind) collected ($45.73)
Seat 9: UberLycan folded before Flop (didn't bet)





PokerStars Hand #151942184981:  Hold'em No Limit ($0.50/$1.00 USD) - 2016/04/15 13:13:12 CET [2016/04/15 7:13:12 ET]
Table 'Matterania III' 9-max Seat #4 is the button
Seat 1: di0d80 ($112.68 in chips) 
Seat 3: ardo888 ($155.87 in chips) 
Seat 4: wangzhuoming ($75.22 in chips) 
Seat 5: Vermm ($79.30 in chips) 
Seat 6: matiko09 ($100 in chips) 
Seat 7: Filojoes ($102.70 in chips) 
Seat 9: butcheN18 ($105.40 in chips) 
Vermm: posts small blind $0.50
matiko09: posts big blind $1
Jimy Tiltman: sits out 
di0d80: posts the ante $0.20
ardo888: posts the ante $0.20
wangzhuoming: posts the ante $0.20
Vermm: posts the ante $0.20
matiko09: posts the ante $0.20
Filojoes: posts the ante $0.20
butcheN18: posts the ante $0.20
*** HOLE CARDS ***
Dealt to matiko09 [Qc 2s]
Filojoes: folds 
butcheN18: folds 
di0d80: folds 
ardo888: raises $1.50 to $2.50
wangzhuoming: folds 
Vermm: calls $2
matiko09: folds 
*** FLOP *** [Ad Ah 9d]
Vermm: checks 
ardo888: bets $3.50
Vermm: folds 
Uncalled bet ($3.50) returned to ardo888
ardo888 collected $7.03 from pot
ardo888: doesn't show hand 
*** SUMMARY ***
Total pot $7.40 | Rake $0.37 
Board [Ad Ah 9d]
Seat 1: di0d80 folded before Flop (didn't bet)
Seat 3: ardo888 collected ($7.03)
Seat 4: wangzhuoming (button) folded before Flop (didn't bet)
Seat 5: Vermm (small blind) folded on the Flop
Seat 6: matiko09 (big blind) folded before Flop
Seat 7: Filojoes folded before Flop (didn't bet)
Seat 9: butcheN18 folded before Flop (didn't bet)





PokerStars Hand #151942188121:  Hold'em No Limit ($0.50/$1.00 USD) - 2016/04/15 13:13:19 CET [2016/04/15 7:13:19 ET]
Table 'Cheruskia II' 9-max Seat #9 is the button
Seat 1: vicus1972 ($99 in chips) 
Seat 2: SerAlGog ($100 in chips) 
Seat 5: Paul6999 ($38.50 in chips) 
Seat 6: hammerwife ($125.10 in chips) 
Seat 7: matiko09 ($100 in chips) 
Seat 9: rycho222 ($101.50 in chips) 
vicus1972: posts small blind $0.50
SerAlGog: posts big blind $1
butcheN18: sits out 
djammusic: sits out 
*** HOLE CARDS ***
Dealt to matiko09 [7h As]
maxxmeister leaves the table
Paul6999: folds 
hammerwife: folds 
ardo888 joins the table at seat #8 
matiko09: folds 
rycho222: raises $2 to $3
vicus1972: folds 
SerAlGog: folds 
Uncalled bet ($2) returned to rycho222
rycho222 collected $2.50 from pot
rycho222: doesn't show hand 
*** SUMMARY ***
Total pot $2.50 | Rake $0 
Seat 1: vicus1972 (small blind) folded before Flop
Seat 2: SerAlGog (big blind) folded before Flop
Seat 5: Paul6999 folded before Flop (didn't bet)
Seat 6: hammerwife folded before Flop (didn't bet)
Seat 7: matiko09 folded before Flop (didn't bet)
Seat 9: rycho222 (button) collected ($2.50)





PokerStars Hand #151942189395:  Hold'em No Limit ($0.50/$1.00 USD) - 2016/04/15 13:13:21 CET [2016/04/15 7:13:21 ET]
Table 'Navi' 9-max Seat #2 is the button
Seat 1: tipner ($100 in chips) 
Seat 2: butcheN18 ($100 in chips) 
Seat 3: aseban11 ($100 in chips) 
Seat 4: Effort92 ($133.93 in chips) 
Seat 5: StarsAbove ($100 in chips) 
Seat 6: Glushchenko ($111.16 in chips) 
Seat 7: yoshidao ($142.38 in chips) 
Seat 8: djammusic ($51.28 in chips) 
Seat 9: matiko09 ($100 in chips) 
aseban11: posts small blind $0.50
Effort92: posts big blind $1
*** HOLE CARDS ***
Dealt to matiko09 [2h 3d]
StarsAbove: folds 
Glushchenko: folds 
yoshidao: folds 
djammusic: folds 
matiko09: folds 
tipner: folds 
butcheN18: folds 
aseban11: raises $2 to $3
Effort92: calls $2
*** FLOP *** [9c Kc 6d]
aseban11: checks 
Effort92: bets $3
aseban11: folds 
Uncalled bet ($3) returned to Effort92
Effort92 collected $5.70 from pot
Effort92: doesn't show hand 
*** SUMMARY ***
Total pot $6 | Rake $0.30 
Board [9c Kc 6d]
Seat 1: tipner folded before Flop (didn't bet)
Seat 2: butcheN18 (button) folded before Flop (didn't bet)
Seat 3: aseban11 (small blind) folded on the Flop
Seat 4: Effort92 (big blind) collected ($5.70)
Seat 5: StarsAbove folded before Flop (didn't bet)
Seat 6: Glushchenko folded before Flop (didn't bet)
Seat 7: yoshidao folded before Flop (didn't bet)
Seat 8: djammusic folded before Flop (didn't bet)
Seat 9: matiko09 folded before Flop (didn't bet)





PokerStars Hand #151942190736:  Hold'em No Limit ($0.50/$1.00 USD) - 2016/04/15 13:13:24 CET [2016/04/15 7:13:24 ET]
Table 'Chiny II' 9-max Seat #3 is the button
Seat 2: AceFarky ($106.91 in chips) 
Seat 3: powerbel ($47.61 in chips) 
Seat 4: 1000karlos ($77.77 in chips) 
Seat 5: Yaaaazz ($118.78 in chips) 
Seat 6: choupai ($33 in chips) 
Seat 7: matiko09 ($150.88 in chips) 
1000karlos: posts small blind $0.50
Yaaaazz: posts big blind $1
Filojoes: sits out 
butcheN18: sits out 
*** HOLE CARDS ***
Dealt to matiko09 [Kc Ts]
choupai: folds 
matiko09: folds 
AceFarky: raises $1.20 to $2.20
powerbel: folds 
1000karlos: folds 
Yaaaazz: folds 
Uncalled bet ($1.20) returned to AceFarky
AceFarky collected $2.50 from pot
AceFarky: doesn't show hand 
*** SUMMARY ***
Total pot $2.50 | Rake $0 
Seat 2: AceFarky collected ($2.50)
Seat 3: powerbel (button) folded before Flop (didn't bet)
Seat 4: 1000karlos (small blind) folded before Flop
Seat 5: Yaaaazz (big blind) folded before Flop
Seat 6: choupai folded before Flop (didn't bet)
Seat 7: matiko09 folded before Flop (didn't bet)





PokerStars Hand #151942192741:  Hold'em No Limit ($1/$2 USD) - 2016/04/15 13:13:29 CET [2016/04/15 7:13:29 ET]
Table 'Patroclus II' 9-max Seat #1 is the button
Seat 1: TonnaMunz ($200 in chips) 
Seat 2: Moemors ($156.65 in chips) 
Seat 3: Koolniknik ($207.85 in chips) 
Seat 4: tipner ($200 in chips) 
Seat 5: butcheN18 ($218 in chips) 
Seat 6: di0d80 ($205.35 in chips) 
Seat 7: matiko09 ($215.05 in chips) 
Seat 8: Glushchenko ($200 in chips) 
Seat 9: Fish4trips ($203.35 in chips) 
Moemors: posts small blind $1
Koolniknik: posts big blind $2
*** HOLE CARDS ***
Dealt to matiko09 [Qs 9s]
tipner: folds 
butcheN18: raises $4 to $6
di0d80: folds 
matiko09: folds 
Glushchenko: folds 
Fish4trips: calls $6
TonnaMunz: folds 
Moemors: folds 
Koolniknik: folds 
*** FLOP *** [Ts Js 3d]
butcheN18: bets $9.12
Fish4trips: calls $9.12
*** TURN *** [Ts Js 3d] [3h]
butcheN18: bets $22
Fish4trips: calls $22
*** RIVER *** [Ts Js 3d 3h] [8c]
butcheN18: checks 
Fish4trips: bets $45
butcheN18: folds 
Uncalled bet ($45) returned to Fish4trips
Fish4trips collected $74.49 from pot
Fish4trips: doesn't show hand 
*** SUMMARY ***
Total pot $77.24 | Rake $2.75 
Board [Ts Js 3d 3h 8c]
Seat 1: TonnaMunz (button) folded before Flop (didn't bet)
Seat 2: Moemors (small blind) folded before Flop
Seat 3: Koolniknik (big blind) folded before Flop
Seat 4: tipner folded before Flop (didn't bet)
Seat 5: butcheN18 folded on the River
Seat 6: di0d80 folded before Flop (didn't bet)
Seat 7: matiko09 folded before Flop (didn't bet)
Seat 8: Glushchenko folded before Flop (didn't bet)
Seat 9: Fish4trips collected ($74.49)





PokerStars Hand #151942197236:  Hold'em No Limit ($0.50/$1.00 USD) - 2016/04/15 13:13:38 CET [2016/04/15 7:13:38 ET]
Table 'Lamberta III' 9-max Seat #4 is the button
Seat 1: Westpants ($100 in chips) 
Seat 3: butcheN18 ($177.75 in chips) 
Seat 4: Filojoes ($100 in chips) 
Seat 5: tipner ($113.35 in chips) 
Seat 6: aseban11 ($103.68 in chips) 
Seat 7: ardo888 ($121.79 in chips) 
Seat 8: wangzhuoming ($110.92 in chips) 
Seat 9: matiko09 ($158.74 in chips) 
tipner: posts small blind $0.50
aseban11: posts big blind $1
Biscuit270: sits out 
*** HOLE CARDS ***
Dealt to matiko09 [8h 2c]
ardo888: folds 
ardo888 leaves the table
wangzhuoming: folds 
matiko09: folds 
Westpants: folds 
butcheN18: folds 
Filojoes: folds 
tipner: folds 
Uncalled bet ($0.50) returned to aseban11
aseban11 collected $1 from pot
aseban11: doesn't show hand 
*** SUMMARY ***
Total pot $1 | Rake $0 
Seat 1: Westpants folded before Flop (didn't bet)
Seat 3: butcheN18 folded before Flop (didn't bet)
Seat 4: Filojoes (button) folded before Flop (didn't bet)
Seat 5: tipner (small blind) folded before Flop
Seat 6: aseban11 (big blind) collected ($1)
Seat 7: ardo888 folded before Flop (didn't bet)
Seat 8: wangzhuoming folded before Flop (didn't bet)
Seat 9: matiko09 folded before Flop (didn't bet)





PokerStars Hand #151942205064:  Hold'em No Limit ($0.50/$1.00 USD) - 2016/04/15 13:13:55 CET [2016/04/15 7:13:55 ET]
Table 'Chiny II' 9-max Seat #4 is the button
Seat 2: AceFarky ($108.41 in chips) 
Seat 3: powerbel ($47.61 in chips) 
Seat 4: 1000karlos ($77.27 in chips) 
Seat 5: Yaaaazz ($117.78 in chips) 
Seat 6: choupai ($33 in chips) 
Seat 7: matiko09 ($150.88 in chips) 
Yaaaazz: posts small blind $0.50
choupai: posts big blind $1
Filojoes: sits out 
butcheN18: sits out 
*** HOLE CARDS ***
Dealt to matiko09 [7h Kh]
matiko09: folds 
AceFarky: raises $1.20 to $2.20
powerbel: folds 
1000karlos: calls $2.20
Yaaaazz: calls $1.70
choupai: calls $1.20
*** FLOP *** [5d Th 9c]
Yaaaazz: checks 
choupai: checks 
AceFarky: bets $7
1000karlos: folds 
Yaaaazz: folds 
choupai: folds 
Uncalled bet ($7) returned to AceFarky
AceFarky collected $8.36 from pot
AceFarky: doesn't show hand 
*** SUMMARY ***
Total pot $8.80 | Rake $0.44 
Board [5d Th 9c]
Seat 2: AceFarky collected ($8.36)
Seat 3: powerbel folded before Flop (didn't bet)
Seat 4: 1000karlos (button) folded on the Flop
Seat 5: Yaaaazz (small blind) folded on the Flop
Seat 6: choupai (big blind) folded on the Flop
Seat 7: matiko09 folded before Flop (didn't bet)





PokerStars Hand #151942206457:  Hold'em No Limit ($0.50/$1.00 USD) - 2016/04/15 13:13:58 CET [2016/04/15 7:13:58 ET]
Table 'Matterania III' 9-max Seat #5 is the button
Seat 1: di0d80 ($112.48 in chips) 
Seat 3: ardo888 ($160.20 in chips) 
Seat 4: wangzhuoming ($75.02 in chips) 
Seat 5: Vermm ($76.60 in chips) 
Seat 6: matiko09 ($100 in chips) 
Seat 7: Filojoes ($102.50 in chips) 
Seat 9: butcheN18 ($105.20 in chips) 
matiko09: posts small blind $0.50
Filojoes: posts big blind $1
Jimy Tiltman: sits out 
di0d80: posts the ante $0.20
ardo888: posts the ante $0.20
wangzhuoming: posts the ante $0.20
Vermm: posts the ante $0.20
matiko09: posts the ante $0.20
Filojoes: posts the ante $0.20
butcheN18: posts the ante $0.20
*** HOLE CARDS ***
Dealt to matiko09 [Qc 3d]
butcheN18: raises $2 to $3
di0d80: folds 
ardo888: folds 
wangzhuoming: folds 
Vermm: folds 
matiko09: folds 
Filojoes: folds 
Uncalled bet ($2) returned to butcheN18
butcheN18 collected $3.90 from pot
butcheN18: doesn't show hand 
*** SUMMARY ***
Total pot $3.90 | Rake $0 
Seat 1: di0d80 folded before Flop (didn't bet)
Seat 3: ardo888 folded before Flop (didn't bet)
Seat 4: wangzhuoming folded before Flop (didn't bet)
Seat 5: Vermm (button) folded before Flop (didn't bet)
Seat 6: matiko09 (small blind) folded before Flop
Seat 7: Filojoes (big blind) folded before Flop
Seat 9: butcheN18 collected ($3.90)





PokerStars Hand #151942206297:  Hold'em No Limit ($0.50/$1.00 USD) - 2016/04/15 13:13:58 CET [2016/04/15 7:13:58 ET]
Table 'Cheruskia II' 9-max Seat #1 is the button
Seat 1: vicus1972 ($98.50 in chips) 
Seat 2: SerAlGog ($100 in chips) 
Seat 3: butcheN18 ($140.55 in chips) 
Seat 5: Paul6999 ($38.50 in chips) 
Seat 6: hammerwife ($125.10 in chips) 
Seat 7: matiko09 ($100 in chips) 
Seat 9: rycho222 ($103 in chips) 
SerAlGog: posts small blind $0.50
butcheN18: posts big blind $1
djammusic: sits out 
ardo888: sits out 
*** HOLE CARDS ***
Dealt to matiko09 [3h Kc]
Paul6999: folds 
hammerwife: folds 
matiko09: folds 
rycho222: raises $1 to $2
vicus1972: folds 
SerAlGog: folds 
butcheN18: folds 
Uncalled bet ($1) returned to rycho222
rycho222 collected $2.50 from pot
rycho222: doesn't show hand 
*** SUMMARY ***
Total pot $2.50 | Rake $0 
Seat 1: vicus1972 (button) folded before Flop (didn't bet)
Seat 2: SerAlGog (small blind) folded before Flop
Seat 3: butcheN18 (big blind) folded before Flop
Seat 5: Paul6999 folded before Flop (didn't bet)
Seat 6: hammerwife folded before Flop (didn't bet)
Seat 7: matiko09 folded before Flop (didn't bet)
Seat 9: rycho222 collected ($2.50)





PokerStars Hand #151942210081:  Hold'em No Limit ($1/$2 USD) - 2016/04/15 13:14:06 CET [2016/04/15 7:14:06 ET]
Table 'Adele II' 9-max Seat #2 is the button
Seat 1: coinflip_si ($200 in chips) 
Seat 2: Fish4trips ($200 in chips) 
Seat 3: matiko09 ($348.64 in chips) 
Seat 5: di0d80 ($200 in chips) 
Seat 6: TonnaMunz ($207.25 in chips) 
Seat 7: tipner ($244.65 in chips) 
Seat 8: docmarc777 ($272.78 in chips) 
matiko09: posts small blind $1
Glushchenko: is sitting out 
di0d80: posts big blind $2
*** HOLE CARDS ***
Dealt to matiko09 [5h 4s]
RyanHuJun was removed from the table for failing to post
TonnaMunz: folds 
tipner: folds 
TonnaMunz leaves the table
docmarc777: raises $2.78 to $4.78
coinflip_si: folds 
Fish4trips: folds 
matiko09: folds 
di0d80: folds 
Uncalled bet ($2.78) returned to docmarc777
docmarc777 collected $5 from pot
docmarc777: doesn't show hand 
*** SUMMARY ***
Total pot $5 | Rake $0 
Seat 1: coinflip_si folded before Flop (didn't bet)
Seat 2: Fish4trips (button) folded before Flop (didn't bet)
Seat 3: matiko09 (small blind) folded before Flop
Seat 5: di0d80 (big blind) folded before Flop
Seat 6: TonnaMunz folded before Flop (didn't bet)
Seat 7: tipner folded before Flop (didn't bet)
Seat 8: docmarc777 collected ($5)





PokerStars Hand #151942212787:  Hold'em No Limit ($0.50/$1.00 USD) - 2016/04/15 13:14:12 CET [2016/04/15 7:14:12 ET]
Table 'Lamberta III' 9-max Seat #5 is the button
Seat 1: Westpants ($100 in chips) 
Seat 3: butcheN18 ($177.75 in chips) 
Seat 4: Filojoes ($100 in chips) 
Seat 5: tipner ($112.85 in chips) 
Seat 6: aseban11 ($104.18 in chips) 
Seat 8: wangzhuoming ($110.92 in chips) 
Seat 9: matiko09 ($158.74 in chips) 
aseban11: posts small blind $0.50
wangzhuoming: posts big blind $1
Biscuit270: sits out 
*** HOLE CARDS ***
Dealt to matiko09 [3d Qh]
matiko09: folds 
Westpants: folds 
butcheN18: raises $2 to $3
Filojoes: folds 
tipner: folds 
aseban11: folds 
wangzhuoming: folds 
Uncalled bet ($2) returned to butcheN18
butcheN18 collected $2.50 from pot
butcheN18: doesn't show hand 
*** SUMMARY ***
Total pot $2.50 | Rake $0 
Seat 1: Westpants folded before Flop (didn't bet)
Seat 3: butcheN18 collected ($2.50)
Seat 4: Filojoes folded before Flop (didn't bet)
Seat 5: tipner (button) folded before Flop (didn't bet)
Seat 6: aseban11 (small blind) folded before Flop
Seat 8: wangzhuoming (big blind) folded before Flop
Seat 9: matiko09 folded before Flop (didn't bet)





PokerStars Hand #151942216255:  Hold'em No Limit ($0.50/$1.00 USD) - 2016/04/15 13:14:19 CET [2016/04/15 7:14:19 ET]
Table 'Navi' 9-max Seat #3 is the button
Seat 1: tipner ($100 in chips) 
Seat 2: butcheN18 ($100 in chips) 
Seat 3: aseban11 ($100 in chips) 
Seat 4: Effort92 ($136.63 in chips) 
Seat 5: StarsAbove ($100 in chips) 
Seat 6: Glushchenko ($111.16 in chips) 
Seat 7: yoshidao ($142.38 in chips) 
Seat 8: djammusic ($51.28 in chips) 
Seat 9: matiko09 ($100 in chips) 
Effort92: posts small blind $0.50
StarsAbove: posts big blind $1
*** HOLE CARDS ***
Dealt to matiko09 [Kd 7h]
Glushchenko: folds 
yoshidao: calls $1
djammusic: folds 
matiko09: folds 
tipner: folds 
butcheN18: folds 
aseban11: raises $2.50 to $3.50
Effort92: folds 
StarsAbove: folds 
yoshidao: folds 
Uncalled bet ($2.50) returned to aseban11
aseban11 collected $3.50 from pot
aseban11: doesn't show hand 
*** SUMMARY ***
Total pot $3.50 | Rake $0 
Seat 1: tipner folded before Flop (didn't bet)
Seat 2: butcheN18 folded before Flop (didn't bet)
Seat 3: aseban11 (button) collected ($3.50)
Seat 4: Effort92 (small blind) folded before Flop
Seat 5: StarsAbove (big blind) folded before Flop
Seat 6: Glushchenko folded before Flop (didn't bet)
Seat 7: yoshidao folded before Flop
Seat 8: djammusic folded before Flop (didn't bet)
Seat 9: matiko09 folded before Flop (didn't bet)





PokerStars Hand #151942219703:  Hold'em No Limit ($0.50/$1.00 USD) - 2016/04/15 13:14:27 CET [2016/04/15 7:14:27 ET]
Table 'Gase II' 9-max Seat #7 is the button
Seat 2: aseban11 ($104.80 in chips) 
Seat 3: djammusic ($39.50 in chips) 
Seat 4: Filojoes ($105.57 in chips) 
Seat 5: delaiwangka ($90.50 in chips) 
Seat 6: matiko09 ($100 in chips) 
Seat 7: danbo577 ($57.49 in chips) 
Seat 8: butcheN18 ($124 in chips) 
Seat 9: UberLycan ($118.68 in chips) 
butcheN18: posts small blind $0.50
UberLycan: posts big blind $1
*** HOLE CARDS ***
Dealt to matiko09 [7c Qh]
aseban11: folds 
djammusic: folds 
Filojoes: raises $2 to $3
delaiwangka: folds 
matiko09: folds 
danbo577: raises $3 to $6
butcheN18: raises $12 to $18
UberLycan: folds 
Filojoes: folds 
danbo577: calls $12
*** FLOP *** [Ad 2s Ks]
butcheN18: checks 
danbo577: bets $19
butcheN18: raises $22 to $41
danbo577: calls $20.49 and is all-in
Uncalled bet ($1.51) returned to butcheN18
*** TURN *** [Ad 2s Ks] [3s]
*** RIVER *** [Ad 2s Ks 3s] [6c]
*** SHOW DOWN ***
butcheN18: shows [Ac Qc] (a pair of Aces)
danbo577: shows [9c Qd] (high card Ace)
butcheN18 collected $116.48 from pot
danbo577 leaves the table
*** SUMMARY ***
Total pot $118.98 | Rake $2.50 
Board [Ad 2s Ks 3s 6c]
Seat 2: aseban11 folded before Flop (didn't bet)
Seat 3: djammusic folded before Flop (didn't bet)
Seat 4: Filojoes folded before Flop
Seat 5: delaiwangka folded before Flop (didn't bet)
Seat 6: matiko09 folded before Flop (didn't bet)
Seat 7: danbo577 (button) showed [9c Qd] and lost with high card Ace
Seat 8: butcheN18 (small blind) showed [Ac Qc] and won ($116.48) with a pair of Aces
Seat 9: UberLycan (big blind) folded before Flop





PokerStars Hand #151942222188:  Hold'em No Limit ($0.50/$1.00 USD) - 2016/04/15 13:14:32 CET [2016/04/15 7:14:32 ET]
Table 'Matterania III' 9-max Seat #6 is the button
Seat 1: di0d80 ($112.28 in chips) 
Seat 3: ardo888 ($160 in chips) 
Seat 4: wangzhuoming ($74.82 in chips) 
Seat 5: Vermm ($76.40 in chips) 
Seat 6: matiko09 ($100 in chips) 
Seat 7: Filojoes ($101.30 in chips) 
Seat 8: Jimy Tiltman ($100 in chips) 
Seat 9: butcheN18 ($107.90 in chips) 
Filojoes: posts small blind $0.50
Jimy Tiltman: posts big blind $1
di0d80: posts the ante $0.20
ardo888: posts the ante $0.20
wangzhuoming: posts the ante $0.20
Vermm: posts the ante $0.20
matiko09: posts the ante $0.20
Filojoes: posts the ante $0.20
Jimy Tiltman: posts the ante $0.20
butcheN18: posts the ante $0.20
*** HOLE CARDS ***
Dealt to matiko09 [4s 2s]
butcheN18: folds 
di0d80: folds 
ardo888: folds 
wangzhuoming: folds 
Vermm: folds 
matiko09: folds 
Filojoes: raises $2 to $3
Jimy Tiltman: folds 
Uncalled bet ($2) returned to Filojoes
Filojoes collected $3.60 from pot
Filojoes: doesn't show hand 
*** SUMMARY ***
Total pot $3.60 | Rake $0 
Seat 1: di0d80 folded before Flop (didn't bet)
Seat 3: ardo888 folded before Flop (didn't bet)
Seat 4: wangzhuoming folded before Flop (didn't bet)
Seat 5: Vermm folded before Flop (didn't bet)
Seat 6: matiko09 (button) folded before Flop (didn't bet)
Seat 7: Filojoes (small blind) collected ($3.60)
Seat 8: Jimy Tiltman (big blind) folded before Flop
Seat 9: butcheN18 folded before Flop (didn't bet)





PokerStars Hand #151942226709:  Hold'em No Limit ($0.50/$1.00 USD) - 2016/04/15 13:14:41 CET [2016/04/15 7:14:41 ET]
Table 'Lamberta III' 9-max Seat #6 is the button
Seat 1: Westpants ($100 in chips) 
Seat 3: butcheN18 ($179.25 in chips) 
Seat 4: Filojoes ($100 in chips) 
Seat 5: tipner ($112.85 in chips) 
Seat 6: aseban11 ($103.68 in chips) 
Seat 8: wangzhuoming ($109.92 in chips) 
Seat 9: matiko09 ($158.74 in chips) 
wangzhuoming: posts small blind $0.50
matiko09: posts big blind $1
aleks2112198 joins the table at seat #7 
Biscuit270: sits out 
*** HOLE CARDS ***
Dealt to matiko09 [8d Ts]
Westpants: folds 
butcheN18: folds 
Filojoes: folds 
tipner: raises $1 to $2
aseban11: folds 
wangzhuoming: calls $1.50
matiko09: folds 
*** FLOP *** [Qd 2s 6s]
wangzhuoming: checks 
tipner: bets $3
wangzhuoming: folds 
Uncalled bet ($3) returned to tipner
tipner collected $4.75 from pot
tipner: doesn't show hand 
*** SUMMARY ***
Total pot $5 | Rake $0.25 
Board [Qd 2s 6s]
Seat 1: Westpants folded before Flop (didn't bet)
Seat 3: butcheN18 folded before Flop (didn't bet)
Seat 4: Filojoes folded before Flop (didn't bet)
Seat 5: tipner collected ($4.75)
Seat 6: aseban11 (button) folded before Flop (didn't bet)
Seat 8: wangzhuoming (small blind) folded on the Flop
Seat 9: matiko09 (big blind) folded before Flop





PokerStars Hand #151942226300:  Hold'em No Limit ($1/$2 USD) - 2016/04/15 13:14:41 CET [2016/04/15 7:14:41 ET]
Table 'Adele II' 9-max Seat #3 is the button
Seat 1: coinflip_si ($200 in chips) 
Seat 2: Fish4trips ($200 in chips) 
Seat 3: matiko09 ($347.64 in chips) 
Seat 5: di0d80 ($200 in chips) 
Seat 8: docmarc777 ($275.78 in chips) 
di0d80: posts small blind $1
tipner: is sitting out 
docmarc777: posts big blind $2
*** HOLE CARDS ***
Dealt to matiko09 [Qs 4h]
MiiFuxU joins the table at seat #9 
coinflip_si: folds 
tipner leaves the table
Fish4trips: folds 
matiko09: folds 
di0d80: folds 
Uncalled bet ($1) returned to docmarc777
docmarc777 collected $2 from pot
docmarc777: doesn't show hand 
wiseyoyo joins the table at seat #6 
*** SUMMARY ***
Total pot $2 | Rake $0 
Seat 1: coinflip_si folded before Flop (didn't bet)
Seat 2: Fish4trips folded before Flop (didn't bet)
Seat 3: matiko09 (button) folded before Flop (didn't bet)
Seat 5: di0d80 (small blind) folded before Flop
Seat 8: docmarc777 (big blind) collected ($2)





PokerStars Hand #151942226813:  Hold'em No Limit ($0.50/$1.00 USD) - 2016/04/15 13:14:42 CET [2016/04/15 7:14:42 ET]
Table 'Katja II' 9-max Seat #6 is the button
Seat 1: Filojoes ($100 in chips) 
Seat 2: TheJokerMen1 ($56.11 in chips) 
Seat 3: matiko09 ($117.62 in chips) 
Seat 4: Sutt_420 ($77.20 in chips) 
Seat 5: Dachish ($104.89 in chips) 
Seat 6: ASG2016 ($112.04 in chips) 
Seat 7: Effort92 ($104.42 in chips) 
Effort92: posts small blind $0.50
Glushchenko: is sitting out 
aseban11: is sitting out 
Filojoes: posts big blind $1
*** HOLE CARDS ***
Dealt to matiko09 [Ks 3d]
TheJokerMen1: folds 
aseban11 leaves the table
matiko09: folds 
Sutt_420: folds 
Dachish: folds 
ASG2016: folds 
Effort92: raises $1.50 to $2.50
Filojoes: calls $1.50
*** FLOP *** [2d 6h 8d]
Effort92: bets $2.84
Filojoes: folds 
Uncalled bet ($2.84) returned to Effort92
Effort92 collected $4.75 from pot
Effort92: doesn't show hand 
*** SUMMARY ***
Total pot $5 | Rake $0.25 
Board [2d 6h 8d]
Seat 1: Filojoes (big blind) folded on the Flop
Seat 2: TheJokerMen1 folded before Flop (didn't bet)
Seat 3: matiko09 folded before Flop (didn't bet)
Seat 4: Sutt_420 folded before Flop (didn't bet)
Seat 5: Dachish folded before Flop (didn't bet)
Seat 6: ASG2016 (button) folded before Flop (didn't bet)
Seat 7: Effort92 (small blind) collected ($4.75)





PokerStars Hand #151942228125:  Hold'em No Limit ($0.50/$1.00 USD) - 2016/04/15 13:14:44 CET [2016/04/15 7:14:44 ET]
Table 'Cheruskia II' 9-max Seat #2 is the button
Seat 1: vicus1972 ($98.50 in chips) 
Seat 2: SerAlGog ($100 in chips) 
Seat 3: butcheN18 ($139.55 in chips) 
Seat 4: djammusic ($40 in chips) 
Seat 5: Paul6999 ($38.50 in chips) 
Seat 6: hammerwife ($125.10 in chips) 
Seat 7: matiko09 ($100 in chips) 
Seat 9: rycho222 ($104.50 in chips) 
butcheN18: posts small blind $0.50
djammusic: posts big blind $1
ardo888: sits out 
*** HOLE CARDS ***
Dealt to matiko09 [6s 9s]
Paul6999: folds 
hammerwife: folds 
matiko09: folds 
rycho222: folds 
vicus1972: folds 
SerAlGog: folds 
butcheN18: folds 
Uncalled bet ($0.50) returned to djammusic
djammusic collected $1 from pot
djammusic: doesn't show hand 
*** SUMMARY ***
Total pot $1 | Rake $0 
Seat 1: vicus1972 folded before Flop (didn't bet)
Seat 2: SerAlGog (button) folded before Flop (didn't bet)
Seat 3: butcheN18 (small blind) folded before Flop
Seat 4: djammusic (big blind) collected ($1)
Seat 5: Paul6999 folded before Flop (didn't bet)
Seat 6: hammerwife folded before Flop (didn't bet)
Seat 7: matiko09 folded before Flop (didn't bet)
Seat 9: rycho222 folded before Flop (didn't bet)





PokerStars Hand #151942233872:  Hold'em No Limit ($0.50/$1.00 USD) - 2016/04/15 13:14:57 CET [2016/04/15 7:14:57 ET]
Table 'Chiny II' 9-max Seat #5 is the button
Seat 2: AceFarky ($114.57 in chips) 
Seat 3: powerbel ($47.61 in chips) 
Seat 4: 1000karlos ($75.07 in chips) 
Seat 5: Yaaaazz ($115.58 in chips) 
Seat 6: choupai ($30.80 in chips) 
Seat 7: matiko09 ($150.88 in chips) 
choupai: posts small blind $0.50
matiko09: posts big blind $1
Filojoes: sits out 
butcheN18: sits out 
*** HOLE CARDS ***
Dealt to matiko09 [Td 8c]
AceFarky: folds 
powerbel: folds 
1000karlos: folds 
Yaaaazz: raises $1.20 to $2.20
choupai: raises $5.40 to $7.60
matiko09: folds 
Yaaaazz: raises $107.98 to $115.58 and is all-in
choupai: calls $23.20 and is all-in
Uncalled bet ($84.78) returned to Yaaaazz
*** FLOP *** [Kd 7s Jh]
*** TURN *** [Kd 7s Jh] [2d]
*** RIVER *** [Kd 7s Jh 2d] [2s]
*** SHOW DOWN ***
choupai: shows [8d 8h] (two pair, Eights and Deuces)
Yaaaazz: shows [Ac 7c] (two pair, Sevens and Deuces)
choupai collected $60.10 from pot
*** SUMMARY ***
Total pot $62.60 | Rake $2.50 
Board [Kd 7s Jh 2d 2s]
Seat 2: AceFarky folded before Flop (didn't bet)
Seat 3: powerbel folded before Flop (didn't bet)
Seat 4: 1000karlos folded before Flop (didn't bet)
Seat 5: Yaaaazz (button) showed [Ac 7c] and lost with two pair, Sevens and Deuces
Seat 6: choupai (small blind) showed [8d 8h] and won ($60.10) with two pair, Eights and Deuces
Seat 7: matiko09 (big blind) folded before Flop





PokerStars Hand #151942236625:  Hold'em No Limit ($1/$2 USD) - 2016/04/15 13:15:03 CET [2016/04/15 7:15:03 ET]
Table 'Adele II' 9-max Seat #5 is the button
Seat 1: coinflip_si ($200 in chips) 
Seat 2: Fish4trips ($200 in chips) 
Seat 3: matiko09 ($347.64 in chips) 
Seat 5: di0d80 ($200 in chips) 
Seat 8: docmarc777 ($276.78 in chips) 
Seat 9: MiiFuxU ($200 in chips) 
wiseyoyo will be allowed to play after the button
docmarc777: posts small blind $1
MiiFuxU: posts big blind $2
*** HOLE CARDS ***
Dealt to matiko09 [Qc Qh]
coinflip_si: folds 
Fish4trips: folds 
matiko09: raises $3 to $5
di0d80: folds 
docmarc777: calls $4
MiiFuxU: folds 
*** FLOP *** [Ac Kc Tc]
docmarc777: checks 
matiko09: checks 
*** TURN *** [Ac Kc Tc] [9s]
docmarc777: folds 
matiko09 collected $11.40 from pot
matiko09: doesn't show hand 
*** SUMMARY ***
Total pot $12 | Rake $0.60 
Board [Ac Kc Tc 9s]
Seat 1: coinflip_si folded before Flop (didn't bet)
Seat 2: Fish4trips folded before Flop (didn't bet)
Seat 3: matiko09 collected ($11.40)
Seat 5: di0d80 (button) folded before Flop (didn't bet)
Seat 8: docmarc777 (small blind) folded on the Turn
Seat 9: MiiFuxU (big blind) folded before Flop





PokerStars Hand #151942239019:  Hold'em No Limit ($0.50/$1.00 USD) - 2016/04/15 13:15:08 CET [2016/04/15 7:15:08 ET]
Table 'Navi' 9-max Seat #4 is the button
Seat 1: tipner ($100 in chips) 
Seat 2: butcheN18 ($100 in chips) 
Seat 3: aseban11 ($102.50 in chips) 
Seat 4: Effort92 ($136.13 in chips) 
Seat 5: StarsAbove ($100 in chips) 
Seat 7: yoshidao ($141.38 in chips) 
Seat 8: djammusic ($51.28 in chips) 
Seat 9: matiko09 ($100 in chips) 
StarsAbove: posts small blind $0.50
yoshidao: posts big blind $1
*** HOLE CARDS ***
Dealt to matiko09 [3s Td]
djammusic: folds 
matiko09: folds 
tipner: folds 
butcheN18: raises $2 to $3
aseban11: folds 
Effort92: calls $3
StarsAbove: raises $12 to $15
yoshidao: folds 
butcheN18: folds 
Effort92: folds 
Uncalled bet ($12) returned to StarsAbove
StarsAbove collected $10 from pot
StarsAbove: doesn't show hand 
*** SUMMARY ***
Total pot $10 | Rake $0 
Seat 1: tipner folded before Flop (didn't bet)
Seat 2: butcheN18 folded before Flop
Seat 3: aseban11 folded before Flop (didn't bet)
Seat 4: Effort92 (button) folded before Flop
Seat 5: StarsAbove (small blind) collected ($10)
Seat 7: yoshidao (big blind) folded before Flop
Seat 8: djammusic folded before Flop (didn't bet)
Seat 9: matiko09 folded before Flop (didn't bet)





PokerStars Hand #151942240373:  Hold'em No Limit ($0.50/$1.00 USD) - 2016/04/15 13:15:11 CET [2016/04/15 7:15:11 ET]
Table 'Cheruskia II' 9-max Seat #3 is the button
Seat 1: vicus1972 ($98.50 in chips) 
Seat 2: SerAlGog ($100 in chips) 
Seat 3: butcheN18 ($139.05 in chips) 
Seat 4: djammusic ($40.50 in chips) 
Seat 5: Paul6999 ($38.50 in chips) 
Seat 6: hammerwife ($125.10 in chips) 
Seat 7: matiko09 ($100 in chips) 
Seat 9: rycho222 ($104.50 in chips) 
djammusic: posts small blind $0.50
Paul6999: posts big blind $1
ardo888: sits out 
*** HOLE CARDS ***
Dealt to matiko09 [Jc 4d]
hammerwife: folds 
matiko09: folds 
rycho222: folds 
vicus1972: raises $1.20 to $2.20
SerAlGog: folds 
butcheN18: folds 
djammusic: raises $4.80 to $7
Paul6999: folds 
vicus1972: folds 
Uncalled bet ($4.80) returned to djammusic
djammusic collected $5.40 from pot
djammusic: doesn't show hand 
*** SUMMARY ***
Total pot $5.40 | Rake $0 
Seat 1: vicus1972 folded before Flop
Seat 2: SerAlGog folded before Flop (didn't bet)
Seat 3: butcheN18 (button) folded before Flop (didn't bet)
Seat 4: djammusic (small blind) collected ($5.40)
Seat 5: Paul6999 (big blind) folded before Flop
Seat 6: hammerwife folded before Flop (didn't bet)
Seat 7: matiko09 folded before Flop (didn't bet)
Seat 9: rycho222 folded before Flop (didn't bet)





PokerStars Hand #151942245433:  Hold'em No Limit ($0.50/$1.00 USD) - 2016/04/15 13:15:21 CET [2016/04/15 7:15:21 ET]
Table 'Matterania III' 9-max Seat #7 is the button
Seat 1: di0d80 ($112.08 in chips) 
Seat 3: ardo888 ($159.80 in chips) 
Seat 4: wangzhuoming ($74.62 in chips) 
Seat 5: Vermm ($76.20 in chips) 
Seat 6: matiko09 ($100 in chips) 
Seat 7: Filojoes ($103.70 in chips) 
Seat 8: Jimy Tiltman ($100 in chips) 
Seat 9: butcheN18 ($107.70 in chips) 
Jimy Tiltman: posts small blind $0.50
butcheN18: posts big blind $1
di0d80: posts the ante $0.20
ardo888: posts the ante $0.20
wangzhuoming: posts the ante $0.20
Vermm: posts the ante $0.20
matiko09: posts the ante $0.20
Filojoes: posts the ante $0.20
Jimy Tiltman: posts the ante $0.20
butcheN18: posts the ante $0.20
*** HOLE CARDS ***
Dealt to matiko09 [4d Kd]
di0d80: folds 
ardo888: folds 
wangzhuoming: folds 
Vermm: raises $2 to $3
matiko09: folds 
Filojoes: folds 
Jimy Tiltman: folds 
butcheN18: folds 
Uncalled bet ($2) returned to Vermm
Vermm collected $4.10 from pot
Vermm: doesn't show hand 
*** SUMMARY ***
Total pot $4.10 | Rake $0 
Seat 1: di0d80 folded before Flop (didn't bet)
Seat 3: ardo888 folded before Flop (didn't bet)
Seat 4: wangzhuoming folded before Flop (didn't bet)
Seat 5: Vermm collected ($4.10)
Seat 6: matiko09 folded before Flop (didn't bet)
Seat 7: Filojoes (button) folded before Flop (didn't bet)
Seat 8: Jimy Tiltman (small blind) folded before Flop
Seat 9: butcheN18 (big blind) folded before Flop





PokerStars Hand #151942245147:  Hold'em No Limit ($0.50/$1.00 USD) - 2016/04/15 13:15:21 CET [2016/04/15 7:15:21 ET]
Table 'Katja II' 9-max Seat #7 is the button
Seat 1: Filojoes ($100 in chips) 
Seat 3: matiko09 ($117.62 in chips) 
Seat 4: Sutt_420 ($77.20 in chips) 
Seat 5: Dachish ($104.89 in chips) 
Seat 6: ASG2016 ($112.04 in chips) 
Seat 7: Effort92 ($106.67 in chips) 
Filojoes: posts small blind $0.50
TheJokerMen1 is disconnected 
TheJokerMen1 has timed out while disconnected
TheJokerMen1: is sitting out 
matiko09: posts big blind $1
*** HOLE CARDS ***
Dealt to matiko09 [5c 7h]
Sutt_420: folds 
Dachish: raises $1 to $2
ASG2016: folds 
Effort92: folds 
Filojoes: folds 
matiko09: folds 
Uncalled bet ($1) returned to Dachish
Dachish collected $2.50 from pot
Dachish: doesn't show hand 
*** SUMMARY ***
Total pot $2.50 | Rake $0 
Seat 1: Filojoes (small blind) folded before Flop
Seat 3: matiko09 (big blind) folded before Flop
Seat 4: Sutt_420 folded before Flop (didn't bet)
Seat 5: Dachish collected ($2.50)
Seat 6: ASG2016 folded before Flop (didn't bet)
Seat 7: Effort92 (button) folded before Flop (didn't bet)





PokerStars Hand #151942245699:  Hold'em No Limit ($0.50/$1.00 USD) - 2016/04/15 13:15:22 CET [2016/04/15 7:15:22 ET]
Table 'Lamberta III' 9-max Seat #8 is the button
Seat 1: Westpants ($100 in chips) 
Seat 3: butcheN18 ($179.25 in chips) 
Seat 4: Filojoes ($100 in chips) 
Seat 5: tipner ($115.60 in chips) 
Seat 6: aseban11 ($103.68 in chips) 
Seat 8: wangzhuoming ($107.92 in chips) 
Seat 9: matiko09 ($157.74 in chips) 
matiko09: posts small blind $0.50
Westpants: posts big blind $1
Biscuit270: sits out 
aleks2112198: sits out 
*** HOLE CARDS ***
Dealt to matiko09 [8c 2s]
butcheN18: folds 
Filojoes: folds 
tipner: folds 
aseban11: folds 
wangzhuoming: calls $1
matiko09: folds 
Westpants: checks 
*** FLOP *** [7s 5c 5d]
Westpants: checks 
wangzhuoming: bets $2
Westpants: folds 
Uncalled bet ($2) returned to wangzhuoming
wangzhuoming collected $2.38 from pot
wangzhuoming: doesn't show hand 
*** SUMMARY ***
Total pot $2.50 | Rake $0.12 
Board [7s 5c 5d]
Seat 1: Westpants (big blind) folded on the Flop
Seat 3: butcheN18 folded before Flop (didn't bet)
Seat 4: Filojoes folded before Flop (didn't bet)
Seat 5: tipner folded before Flop (didn't bet)
Seat 6: aseban11 folded before Flop (didn't bet)
Seat 8: wangzhuoming (button) collected ($2.38)
Seat 9: matiko09 (small blind) folded before Flop





PokerStars Hand #151942246724:  Hold'em No Limit ($1/$2 USD) - 2016/04/15 13:15:24 CET [2016/04/15 7:15:24 ET]
Table 'Adele II' 9-max Seat #8 is the button
Seat 2: Fish4trips ($200 in chips) 
Seat 3: matiko09 ($354.04 in chips) 
Seat 5: di0d80 ($200 in chips) 
Seat 8: docmarc777 ($271.78 in chips) 
Seat 9: MiiFuxU ($200 in chips) 
MiiFuxU: posts small blind $1
coinflip_si: is sitting out 
Fish4trips: posts big blind $2
wiseyoyo: sits out 
*** HOLE CARDS ***
Dealt to matiko09 [2d 9s]
coinflip_si leaves the table
matiko09: folds 
di0d80: raises $3 to $5
docmarc777: folds 
MiiFuxU: folds 
Fish4trips: folds 
Uncalled bet ($3) returned to di0d80
di0d80 collected $5 from pot
di0d80: doesn't show hand 
*** SUMMARY ***
Total pot $5 | Rake $0 
Seat 2: Fish4trips (big blind) folded before Flop
Seat 3: matiko09 folded before Flop (didn't bet)
Seat 5: di0d80 collected ($5)
Seat 8: docmarc777 (button) folded before Flop (didn't bet)
Seat 9: MiiFuxU (small blind) folded before Flop





PokerStars Hand #151942247562:  Hold'em No Limit ($1/$2 USD) - 2016/04/15 13:15:26 CET [2016/04/15 7:15:26 ET]
Table 'Patroclus II' 9-max Seat #2 is the button
Seat 1: TonnaMunz ($200 in chips) 
Seat 2: Moemors ($155.65 in chips) 
Seat 3: Koolniknik ($205.85 in chips) 
Seat 4: tipner ($200 in chips) 
Seat 5: butcheN18 ($200 in chips) 
Seat 6: di0d80 ($205.35 in chips) 
Seat 7: matiko09 ($215.05 in chips) 
Seat 8: Glushchenko ($200 in chips) 
Seat 9: Fish4trips ($240.72 in chips) 
Koolniknik: posts small blind $1
tipner: posts big blind $2
*** HOLE CARDS ***
Dealt to matiko09 [8s Ah]
butcheN18: folds 
di0d80: folds 
matiko09: folds 
Glushchenko: folds 
Fish4trips: folds 
TonnaMunz: folds 
Moemors: folds 
Koolniknik: raises $4 to $6
tipner: folds 
Uncalled bet ($4) returned to Koolniknik
Koolniknik collected $4 from pot
Koolniknik: doesn't show hand 
*** SUMMARY ***
Total pot $4 | Rake $0 
Seat 1: TonnaMunz folded before Flop (didn't bet)
Seat 2: Moemors (button) folded before Flop (didn't bet)
Seat 3: Koolniknik (small blind) collected ($4)
Seat 4: tipner (big blind) folded before Flop
Seat 5: butcheN18 folded before Flop (didn't bet)
Seat 6: di0d80 folded before Flop (didn't bet)
Seat 7: matiko09 folded before Flop (didn't bet)
Seat 8: Glushchenko folded before Flop (didn't bet)
Seat 9: Fish4trips folded before Flop (didn't bet)





PokerStars Hand #151942254913:  Hold'em No Limit ($1/$2 USD) - 2016/04/15 13:15:42 CET [2016/04/15 7:15:42 ET]
Table 'Adele II' 9-max Seat #9 is the button
Seat 2: Fish4trips ($200 in chips) 
Seat 3: matiko09 ($354.04 in chips) 
Seat 5: di0d80 ($203 in chips) 
Seat 8: docmarc777 ($271.78 in chips) 
Seat 9: MiiFuxU ($200 in chips) 
Fish4trips: posts small blind $1
matiko09: posts big blind $2
wiseyoyo: sits out 
*** HOLE CARDS ***
Dealt to matiko09 [Tc 4s]
di0d80: folds 
docmarc777: raises $2.78 to $4.78
MiiFuxU: raises $7.22 to $12
Fish4trips: folds 
matiko09: folds 
docmarc777: raises $33 to $45
MiiFuxU: folds 
Uncalled bet ($33) returned to docmarc777
docmarc777 collected $27 from pot
*** SUMMARY ***
Total pot $27 | Rake $0 
Seat 2: Fish4trips (small blind) folded before Flop
Seat 3: matiko09 (big blind) folded before Flop
Seat 5: di0d80 folded before Flop (didn't bet)
Seat 8: docmarc777 collected ($27)
Seat 9: MiiFuxU (button) folded before Flop





PokerStars Hand #151942257369:  Hold'em No Limit ($0.50/$1.00 USD) - 2016/04/15 13:15:47 CET [2016/04/15 7:15:47 ET]
Table 'Navi' 9-max Seat #5 is the button
Seat 1: tipner ($100 in chips) 
Seat 2: butcheN18 ($100 in chips) 
Seat 3: aseban11 ($102.50 in chips) 
Seat 4: Effort92 ($133.13 in chips) 
Seat 5: StarsAbove ($107 in chips) 
Seat 7: yoshidao ($140.38 in chips) 
Seat 8: djammusic ($51.28 in chips) 
Seat 9: matiko09 ($100 in chips) 
yoshidao: posts small blind $0.50
djammusic: posts big blind $1
*** HOLE CARDS ***
Dealt to matiko09 [Ad Ks]
matiko09: raises $2 to $3
tipner: folds 
butcheN18: folds 
aseban11: folds 
Effort92: folds 
StarsAbove: folds 
yoshidao: folds 
djammusic: folds 
Uncalled bet ($2) returned to matiko09
matiko09 collected $2.50 from pot
matiko09: doesn't show hand 
*** SUMMARY ***
Total pot $2.50 | Rake $0 
Seat 1: tipner folded before Flop (didn't bet)
Seat 2: butcheN18 folded before Flop (didn't bet)
Seat 3: aseban11 folded before Flop (didn't bet)
Seat 4: Effort92 folded before Flop (didn't bet)
Seat 5: StarsAbove (button) folded before Flop (didn't bet)
Seat 7: yoshidao (small blind) folded before Flop
Seat 8: djammusic (big blind) folded before Flop
Seat 9: matiko09 collected ($2.50)





PokerStars Hand #151942259577:  Hold'em No Limit ($0.50/$1.00 USD) - 2016/04/15 13:15:52 CET [2016/04/15 7:15:52 ET]
Table 'Matterania III' 9-max Seat #8 is the button
Seat 1: di0d80 ($111.88 in chips) 
Seat 3: ardo888 ($159.60 in chips) 
Seat 4: wangzhuoming ($74.42 in chips) 
Seat 5: Vermm ($79.10 in chips) 
Seat 6: matiko09 ($100 in chips) 
Seat 7: Filojoes ($103.50 in chips) 
Seat 8: Jimy Tiltman ($100 in chips) 
Seat 9: butcheN18 ($106.50 in chips) 
butcheN18: posts small blind $0.50
di0d80: posts big blind $1
di0d80: posts the ante $0.20
ardo888: posts the ante $0.20
wangzhuoming: posts the ante $0.20
Vermm: posts the ante $0.20
matiko09: posts the ante $0.20
Filojoes: posts the ante $0.20
Jimy Tiltman: posts the ante $0.20
butcheN18: posts the ante $0.20
*** HOLE CARDS ***
Dealt to matiko09 [Kd Td]
ardo888: folds 
wangzhuoming: folds 
Vermm: folds 
matiko09: raises $2 to $3
Filojoes: folds 
Jimy Tiltman: folds 
butcheN18: folds 
di0d80: folds 
Uncalled bet ($2) returned to matiko09
matiko09 collected $4.10 from pot
matiko09: doesn't show hand 
*** SUMMARY ***
Total pot $4.10 | Rake $0 
Seat 1: di0d80 (big blind) folded before Flop
Seat 3: ardo888 folded before Flop (didn't bet)
Seat 4: wangzhuoming folded before Flop (didn't bet)
Seat 5: Vermm folded before Flop (didn't bet)
Seat 6: matiko09 collected ($4.10)
Seat 7: Filojoes folded before Flop (didn't bet)
Seat 8: Jimy Tiltman (button) folded before Flop (didn't bet)
Seat 9: butcheN18 (small blind) folded before Flop





PokerStars Hand #151942260114:  Hold'em No Limit ($0.50/$1.00 USD) - 2016/04/15 13:15:53 CET [2016/04/15 7:15:53 ET]
Table 'Chiny II' 9-max Seat #6 is the button
Seat 2: AceFarky ($114.57 in chips) 
Seat 3: powerbel ($47.61 in chips) 
Seat 4: 1000karlos ($75.07 in chips) 
Seat 5: Yaaaazz ($100 in chips) 
Seat 6: choupai ($60.10 in chips) 
Seat 7: matiko09 ($149.88 in chips) 
Seat 8: Filojoes ($100 in chips) 
matiko09: posts small blind $0.50
Filojoes: posts big blind $1
butcheN18: sits out 
aseban11: sits out 
*** HOLE CARDS ***
Dealt to matiko09 [7s 8c]
AceFarky: folds 
powerbel: raises $1 to $2
1000karlos: folds 
Yaaaazz: folds 
choupai: folds 
matiko09: folds 
Filojoes: calls $1
*** FLOP *** [3d 6s As]
Filojoes: bets $2.57
powerbel: calls $2.57
*** TURN *** [3d 6s As] [5d]
Filojoes: bets $6.41
powerbel: folds 
Uncalled bet ($6.41) returned to Filojoes
Filojoes collected $9.16 from pot
Filojoes: doesn't show hand 
*** SUMMARY ***
Total pot $9.64 | Rake $0.48 
Board [3d 6s As 5d]
Seat 2: AceFarky folded before Flop (didn't bet)
Seat 3: powerbel folded on the Turn
Seat 4: 1000karlos folded before Flop (didn't bet)
Seat 5: Yaaaazz folded before Flop (didn't bet)
Seat 6: choupai (button) folded before Flop (didn't bet)
Seat 7: matiko09 (small blind) folded before Flop
Seat 8: Filojoes (big blind) collected ($9.16)





PokerStars Hand #151942262930:  Hold'em No Limit ($0.50/$1.00 USD) - 2016/04/15 13:15:59 CET [2016/04/15 7:15:59 ET]
Table 'Lamberta III' 9-max Seat #9 is the button
Seat 1: Westpants ($100 in chips) 
Seat 2: Biscuit270 ($50 in chips) 
Seat 3: butcheN18 ($179.25 in chips) 
Seat 4: Filojoes ($100 in chips) 
Seat 5: tipner ($115.60 in chips) 
Seat 6: aseban11 ($103.68 in chips) 
Seat 8: wangzhuoming ($109.30 in chips) 
Seat 9: matiko09 ($157.24 in chips) 
Westpants: posts small blind $0.50
Biscuit270: posts big blind $1
aleks2112198: sits out 
*** HOLE CARDS ***
Dealt to matiko09 [Ah Qs]
butcheN18: folds 
Filojoes: folds 
tipner: folds 
aseban11: raises $2 to $3
wangzhuoming: folds 
matiko09: calls $3
Westpants: folds 
Biscuit270: folds 
*** FLOP *** [4s 3h As]
aseban11: checks 
matiko09: bets $4.63
aseban11: folds 
Uncalled bet ($4.63) returned to matiko09
matiko09 collected $7.12 from pot
matiko09: doesn't show hand 
*** SUMMARY ***
Total pot $7.50 | Rake $0.38 
Board [4s 3h As]
Seat 1: Westpants (small blind) folded before Flop
Seat 2: Biscuit270 (big blind) folded before Flop
Seat 3: butcheN18 folded before Flop (didn't bet)
Seat 4: Filojoes folded before Flop (didn't bet)
Seat 5: tipner folded before Flop (didn't bet)
Seat 6: aseban11 folded on the Flop
Seat 8: wangzhuoming folded before Flop (didn't bet)
Seat 9: matiko09 (button) collected ($7.12)





PokerStars Hand #151942266613:  Hold'em No Limit ($0.50/$1.00 USD) - 2016/04/15 13:16:07 CET [2016/04/15 7:16:07 ET]
Table 'Navi' 9-max Seat #7 is the button
Seat 1: tipner ($100 in chips) 
Seat 2: butcheN18 ($100 in chips) 
Seat 3: aseban11 ($102.50 in chips) 
Seat 4: Effort92 ($133.13 in chips) 
Seat 5: StarsAbove ($107 in chips) 
Seat 7: yoshidao ($139.88 in chips) 
Seat 8: djammusic ($50.28 in chips) 
Seat 9: matiko09 ($101.50 in chips) 
djammusic: posts small blind $0.50
matiko09: posts big blind $1
*** HOLE CARDS ***
Dealt to matiko09 [4s Qc]
tipner: raises $2 to $3
butcheN18: folds 
aseban11: calls $3
Effort92: folds 
StarsAbove: folds 
yoshidao: folds 
djammusic: folds 
matiko09: folds 
*** FLOP *** [4h Kc Kh]
tipner: checks 
aseban11: bets $5.34
tipner: calls $5.34
*** TURN *** [4h Kc Kh] [3c]
tipner: checks 
aseban11: bets $9.50
tipner: calls $9.50
*** RIVER *** [4h Kc Kh 3c] [Ad]
tipner: checks 
aseban11: checks 
*** SHOW DOWN ***
tipner: shows [9d 9h] (two pair, Kings and Nines)
aseban11: shows [Jh Jd] (two pair, Kings and Jacks)
aseban11 collected $35.32 from pot
*** SUMMARY ***
Total pot $37.18 | Rake $1.86 
Board [4h Kc Kh 3c Ad]
Seat 1: tipner showed [9d 9h] and lost with two pair, Kings and Nines
Seat 2: butcheN18 folded before Flop (didn't bet)
Seat 3: aseban11 showed [Jh Jd] and won ($35.32) with two pair, Kings and Jacks
Seat 4: Effort92 folded before Flop (didn't bet)
Seat 5: StarsAbove folded before Flop (didn't bet)
Seat 7: yoshidao (button) folded before Flop (didn't bet)
Seat 8: djammusic (small blind) folded before Flop
Seat 9: matiko09 (big blind) folded before Flop





PokerStars Hand #151942267597:  Hold'em No Limit ($0.50/$1.00 USD) - 2016/04/15 13:16:09 CET [2016/04/15 7:16:09 ET]
Table 'Cheruskia II' 9-max Seat #4 is the button
Seat 1: vicus1972 ($96.30 in chips) 
Seat 2: SerAlGog ($100 in chips) 
Seat 3: butcheN18 ($139.05 in chips) 
Seat 4: djammusic ($43.70 in chips) 
Seat 5: Paul6999 ($37.50 in chips) 
Seat 6: hammerwife ($125.10 in chips) 
Seat 7: matiko09 ($100 in chips) 
Seat 9: rycho222 ($104.50 in chips) 
Paul6999: posts small blind $0.50
hammerwife: posts big blind $1
ardo888: sits out 
*** HOLE CARDS ***
Dealt to matiko09 [Ks Qd]
matiko09: raises $2 to $3
rycho222: folds 
vicus1972: folds 
SerAlGog: folds 
butcheN18: folds 
djammusic: folds 
Paul6999: folds 
hammerwife: folds 
Uncalled bet ($2) returned to matiko09
matiko09 collected $2.50 from pot
matiko09: doesn't show hand 
*** SUMMARY ***
Total pot $2.50 | Rake $0 
Seat 1: vicus1972 folded before Flop (didn't bet)
Seat 2: SerAlGog folded before Flop (didn't bet)
Seat 3: butcheN18 folded before Flop (didn't bet)
Seat 4: djammusic (button) folded before Flop (didn't bet)
Seat 5: Paul6999 (small blind) folded before Flop
Seat 6: hammerwife (big blind) folded before Flop
Seat 7: matiko09 collected ($2.50)
Seat 9: rycho222 folded before Flop (didn't bet)





PokerStars Hand #151942268921:  Hold'em No Limit ($0.50/$1.00 USD) - 2016/04/15 13:16:12 CET [2016/04/15 7:16:12 ET]
Table 'Gase II' 9-max Seat #8 is the button
Seat 2: aseban11 ($104.80 in chips) 
Seat 3: djammusic ($39.50 in chips) 
Seat 4: Filojoes ($102.57 in chips) 
Seat 5: delaiwangka ($90.50 in chips) 
Seat 6: matiko09 ($100 in chips) 
Seat 8: butcheN18 ($182.99 in chips) 
Seat 9: UberLycan ($117.68 in chips) 
UberLycan: posts small blind $0.50
aseban11: posts big blind $1
*** HOLE CARDS ***
Dealt to matiko09 [4c 4d]
djammusic: folds 
Glushchenko joins the table at seat #7 
Filojoes: folds 
delaiwangka: folds 
matiko09: raises $2 to $3
butcheN18: folds 
UberLycan: folds 
aseban11: folds 
Uncalled bet ($2) returned to matiko09
matiko09 collected $2.50 from pot
matiko09: doesn't show hand 
*** SUMMARY ***
Total pot $2.50 | Rake $0 
Seat 2: aseban11 (big blind) folded before Flop
Seat 3: djammusic folded before Flop (didn't bet)
Seat 4: Filojoes folded before Flop (didn't bet)
Seat 5: delaiwangka folded before Flop (didn't bet)
Seat 6: matiko09 collected ($2.50)
Seat 8: butcheN18 (button) folded before Flop (didn't bet)
Seat 9: UberLycan (small blind) folded before Flop





PokerStars Hand #151942269223:  Hold'em No Limit ($1/$2 USD) - 2016/04/15 13:16:12 CET [2016/04/15 7:16:12 ET]
Table 'Patroclus II' 9-max Seat #3 is the button
Seat 1: TonnaMunz ($200 in chips) 
Seat 2: Moemors ($155.65 in chips) 
Seat 3: Koolniknik ($207.85 in chips) 
Seat 4: tipner ($200 in chips) 
Seat 5: butcheN18 ($200 in chips) 
Seat 6: di0d80 ($205.35 in chips) 
Seat 7: matiko09 ($215.05 in chips) 
Seat 8: Glushchenko ($200 in chips) 
Seat 9: Fish4trips ($240.72 in chips) 
tipner: posts small blind $1
butcheN18: posts big blind $2
*** HOLE CARDS ***
Dealt to matiko09 [Qc Ts]
di0d80: folds 
matiko09: folds 
Glushchenko: folds 
Fish4trips: folds 
TonnaMunz: folds 
Moemors: folds 
Koolniknik: raises $4 to $6
tipner: raises $12 to $18
butcheN18: folds 
Koolniknik: folds 
Uncalled bet ($12) returned to tipner
tipner collected $14 from pot
tipner: doesn't show hand 
*** SUMMARY ***
Total pot $14 | Rake $0 
Seat 1: TonnaMunz folded before Flop (didn't bet)
Seat 2: Moemors folded before Flop (didn't bet)
Seat 3: Koolniknik (button) folded before Flop
Seat 4: tipner (small blind) collected ($14)
Seat 5: butcheN18 (big blind) folded before Flop
Seat 6: di0d80 folded before Flop (didn't bet)
Seat 7: matiko09 folded before Flop (didn't bet)
Seat 8: Glushchenko folded before Flop (didn't bet)
Seat 9: Fish4trips folded before Flop (didn't bet)





PokerStars Hand #151942273683:  Hold'em No Limit ($1/$2 USD) - 2016/04/15 13:16:22 CET [2016/04/15 7:16:22 ET]
Table 'Adele II' 9-max Seat #2 is the button
Seat 2: Fish4trips ($200 in chips) 
Seat 3: matiko09 ($352.04 in chips) 
Seat 6: wiseyoyo ($200 in chips) 
Seat 8: docmarc777 ($286.78 in chips) 
Seat 9: MiiFuxU ($200 in chips) 
matiko09: posts small blind $1
di0d80: is sitting out 
wiseyoyo: posts big blind $2
*** HOLE CARDS ***
Dealt to matiko09 [4h 6c]
docmarc777: folds 
MiiFuxU: folds 
Fish4trips: folds 
matiko09: folds 
Uncalled bet ($1) returned to wiseyoyo
wiseyoyo collected $2 from pot
wiseyoyo: doesn't show hand 
*** SUMMARY ***
Total pot $2 | Rake $0 
Seat 2: Fish4trips (button) folded before Flop (didn't bet)
Seat 3: matiko09 (small blind) folded before Flop
Seat 6: wiseyoyo (big blind) collected ($2)
Seat 8: docmarc777 folded before Flop (didn't bet)
Seat 9: MiiFuxU folded before Flop (didn't bet)





PokerStars Hand #151942275893:  Hold'em No Limit ($0.50/$1.00 USD) - 2016/04/15 13:16:27 CET [2016/04/15 7:16:27 ET]
Table 'Katja II' 9-max Seat #1 is the button
Seat 1: Filojoes ($100 in chips) 
Seat 3: matiko09 ($116.62 in chips) 
Seat 4: Sutt_420 ($77.20 in chips) 
Seat 5: Dachish ($106.39 in chips) 
Seat 6: ASG2016 ($112.04 in chips) 
Seat 7: Effort92 ($106.67 in chips) 
TheJokerMen1 will be allowed to play after the button
matiko09: posts small blind $0.50
Sutt_420: posts big blind $1
*** HOLE CARDS ***
Dealt to matiko09 [5d 7c]
Dachish: folds 
ASG2016: folds 
Effort92: folds 
Filojoes: folds 
matiko09: raises $2 to $3
Sutt_420: folds 
Uncalled bet ($2) returned to matiko09
matiko09 collected $2 from pot
matiko09: doesn't show hand 
*** SUMMARY ***
Total pot $2 | Rake $0 
Seat 1: Filojoes (button) folded before Flop (didn't bet)
Seat 3: matiko09 (small blind) collected ($2)
Seat 4: Sutt_420 (big blind) folded before Flop
Seat 5: Dachish folded before Flop (didn't bet)
Seat 6: ASG2016 folded before Flop (didn't bet)
Seat 7: Effort92 folded before Flop (didn't bet)





PokerStars Hand #151942277300:  Hold'em No Limit ($1/$2 USD) - 2016/04/15 13:16:30 CET [2016/04/15 7:16:30 ET]
Table 'Adele II' 9-max Seat #3 is the button
Seat 2: Fish4trips ($200 in chips) 
Seat 3: matiko09 ($351.04 in chips) 
Seat 6: wiseyoyo ($201 in chips) 
Seat 8: docmarc777 ($286.78 in chips) 
Seat 9: MiiFuxU ($200 in chips) 
wiseyoyo: posts small blind $1
docmarc777: posts big blind $2
*** HOLE CARDS ***
Dealt to matiko09 [7h Jh]
MiiFuxU: folds 
Fish4trips: folds 
matiko09: raises $2.54 to $4.54
wiseyoyo: folds 
docmarc777: calls $2.54
*** FLOP *** [5s 5c Ad]
docmarc777: checks 
matiko09: bets $5.05
docmarc777: calls $5.05
*** TURN *** [5s 5c Ad] [Qs]
docmarc777: checks 
matiko09: checks 
*** RIVER *** [5s 5c Ad Qs] [9s]
docmarc777: bets $20
matiko09: folds 
Uncalled bet ($20) returned to docmarc777
docmarc777 collected $19.17 from pot
docmarc777: shows [Ac 5h] (a full house, Fives full of Aces)
*** SUMMARY ***
Total pot $20.18 | Rake $1.01 
Board [5s 5c Ad Qs 9s]
Seat 2: Fish4trips folded before Flop (didn't bet)
Seat 3: matiko09 (button) folded on the River
Seat 6: wiseyoyo (small blind) folded before Flop
Seat 8: docmarc777 (big blind) collected ($19.17)
Seat 9: MiiFuxU folded before Flop (didn't bet)





PokerStars Hand #151942282684:  Hold'em No Limit ($0.50/$1.00 USD) - 2016/04/15 13:16:41 CET [2016/04/15 7:16:41 ET]
Table 'Matterania III' 9-max Seat #9 is the button
Seat 1: di0d80 ($110.68 in chips) 
Seat 3: ardo888 ($159.40 in chips) 
Seat 4: wangzhuoming ($74.22 in chips) 
Seat 5: Vermm ($78.90 in chips) 
Seat 6: matiko09 ($102.90 in chips) 
Seat 7: Filojoes ($103.30 in chips) 
Seat 8: Jimy Tiltman ($100 in chips) 
Seat 9: butcheN18 ($105.80 in chips) 
di0d80: posts small blind $0.50
ardo888: posts big blind $1
di0d80: posts the ante $0.20
ardo888: posts the ante $0.20
wangzhuoming: posts the ante $0.20
Vermm: posts the ante $0.20
matiko09: posts the ante $0.20
Filojoes: posts the ante $0.20
Jimy Tiltman: posts the ante $0.20
butcheN18: posts the ante $0.20
*** HOLE CARDS ***
Dealt to matiko09 [2c 4h]
wangzhuoming: raises $2 to $3
Vermm: calls $3
matiko09: folds 
Filojoes: folds 
Jimy Tiltman: folds 
butcheN18: calls $3
di0d80: folds 
ardo888: calls $2
*** FLOP *** [9h Kh 9c]
ardo888: checks 
wangzhuoming: bets $8
Vermm: folds 
butcheN18: folds 
ardo888: folds 
Uncalled bet ($8) returned to wangzhuoming
wangzhuoming collected $13.40 from pot
wangzhuoming: doesn't show hand 
*** SUMMARY ***
Total pot $14.10 | Rake $0.70 
Board [9h Kh 9c]
Seat 1: di0d80 (small blind) folded before Flop
Seat 3: ardo888 (big blind) folded on the Flop
Seat 4: wangzhuoming collected ($13.40)
Seat 5: Vermm folded on the Flop
Seat 6: matiko09 folded before Flop (didn't bet)
Seat 7: Filojoes folded before Flop (didn't bet)
Seat 8: Jimy Tiltman folded before Flop (didn't bet)
Seat 9: butcheN18 (button) folded on the Flop





PokerStars Hand #151942287538:  Hold'em No Limit ($0.50/$1.00 USD) - 2016/04/15 13:16:51 CET [2016/04/15 7:16:51 ET]
Table 'Gase II' 9-max Seat #9 is the button
Seat 2: aseban11 ($103.80 in chips) 
Seat 4: Filojoes ($102.57 in chips) 
Seat 5: delaiwangka ($90.50 in chips) 
Seat 6: matiko09 ($101.50 in chips) 
Seat 8: butcheN18 ($182.99 in chips) 
Seat 9: UberLycan ($117.18 in chips) 
aseban11: posts small blind $0.50
djammusic: is sitting out 
Filojoes: posts big blind $1
*** HOLE CARDS ***
Dealt to matiko09 [9d 3c]
Glushchenko leaves the table
delaiwangka: folds 
djammusic leaves the table
matiko09: folds 
butcheN18: folds 
Effort92 joins the table at seat #7 
UberLycan: raises $2 to $3
aseban11: calls $2.50
Filojoes: folds 
*** FLOP *** [5d Jc 8h]
aseban11: checks 
Jimy Tiltman joins the table at seat #3 
UberLycan: checks 
*** TURN *** [5d Jc 8h] [9h]
aseban11: bets $4.98
UberLycan: calls $4.98
*** RIVER *** [5d Jc 8h 9h] [9s]
aseban11: checks 
UberLycan: bets $10
aseban11: calls $10
*** SHOW DOWN ***
UberLycan: shows [Tc 2c] (a pair of Nines)
aseban11: shows [Qd Jd] (two pair, Jacks and Nines)
aseban11 collected $35.11 from pot
*** SUMMARY ***
Total pot $36.96 | Rake $1.85 
Board [5d Jc 8h 9h 9s]
Seat 2: aseban11 (small blind) showed [Qd Jd] and won ($35.11) with two pair, Jacks and Nines
Seat 4: Filojoes (big blind) folded before Flop
Seat 5: delaiwangka folded before Flop (didn't bet)
Seat 6: matiko09 folded before Flop (didn't bet)
Seat 8: butcheN18 folded before Flop (didn't bet)
Seat 9: UberLycan (button) showed [Tc 2c] and lost with a pair of Nines





PokerStars Hand #151942288872:  Hold'em No Limit ($0.50/$1.00 USD) - 2016/04/15 13:16:54 CET [2016/04/15 7:16:54 ET]
Table 'Cheruskia II' 9-max Seat #5 is the button
Seat 1: vicus1972 ($96.30 in chips) 
Seat 2: SerAlGog ($100 in chips) 
Seat 3: butcheN18 ($139.05 in chips) 
Seat 4: djammusic ($43.70 in chips) 
Seat 5: Paul6999 ($37 in chips) 
Seat 6: hammerwife ($124.10 in chips) 
Seat 7: matiko09 ($101.50 in chips) 
Seat 9: rycho222 ($104.50 in chips) 
hammerwife: posts small blind $0.50
matiko09: posts big blind $1
ardo888: sits out 
*** HOLE CARDS ***
Dealt to matiko09 [7c 3h]
rycho222: folds 
vicus1972: folds 
SerAlGog: raises $1.50 to $2.50
butcheN18: folds 
djammusic: folds 
Paul6999: raises $2.50 to $5
hammerwife: folds 
matiko09: folds 
SerAlGog: calls $2.50
*** FLOP *** [2d 6h Qc]
SerAlGog: checks 
Paul6999: bets $7
SerAlGog: calls $7
*** TURN *** [2d 6h Qc] [5c]
SerAlGog: checks 
Paul6999: bets $25 and is all-in
SerAlGog: calls $25
*** RIVER *** [2d 6h Qc 5c] [8s]
*** SHOW DOWN ***
SerAlGog: shows [Kh Qh] (a pair of Queens)
Paul6999: shows [Ks Kc] (a pair of Kings)
Paul6999 collected $73 from pot
*** SUMMARY ***
Total pot $75.50 | Rake $2.50 
Board [2d 6h Qc 5c 8s]
Seat 1: vicus1972 folded before Flop (didn't bet)
Seat 2: SerAlGog showed [Kh Qh] and lost with a pair of Queens
Seat 3: butcheN18 folded before Flop (didn't bet)
Seat 4: djammusic folded before Flop (didn't bet)
Seat 5: Paul6999 (button) showed [Ks Kc] and won ($73) with a pair of Kings
Seat 6: hammerwife (small blind) folded before Flop
Seat 7: matiko09 (big blind) folded before Flop
Seat 9: rycho222 folded before Flop (didn't bet)





PokerStars Hand #151942289835:  Hold'em No Limit ($0.50/$1.00 USD) - 2016/04/15 13:16:56 CET [2016/04/15 7:16:56 ET]
Table 'Chiny II' 9-max Seat #7 is the button
Seat 2: AceFarky ($114.57 in chips) 
Seat 3: powerbel ($43.04 in chips) 
Seat 4: 1000karlos ($75.07 in chips) 
Seat 5: Yaaaazz ($100 in chips) 
Seat 6: choupai ($60.10 in chips) 
Seat 7: matiko09 ($149.38 in chips) 
Seat 8: Filojoes ($104.59 in chips) 
Seat 9: butcheN18 ($100 in chips) 
Filojoes: posts small blind $0.50
butcheN18: posts big blind $1
aseban11: sits out 
*** HOLE CARDS ***
Dealt to matiko09 [3s Ks]
AceFarky: folds 
powerbel: folds 
1000karlos: folds 
Yaaaazz: folds 
choupai: raises $2 to $3
matiko09: folds 
Filojoes: folds 
butcheN18: folds 
Uncalled bet ($2) returned to choupai
choupai collected $2.50 from pot
choupai: doesn't show hand 
*** SUMMARY ***
Total pot $2.50 | Rake $0 
Seat 2: AceFarky folded before Flop (didn't bet)
Seat 3: powerbel folded before Flop (didn't bet)
Seat 4: 1000karlos folded before Flop (didn't bet)
Seat 5: Yaaaazz folded before Flop (didn't bet)
Seat 6: choupai collected ($2.50)
Seat 7: matiko09 (button) folded before Flop (didn't bet)
Seat 8: Filojoes (small blind) folded before Flop
Seat 9: butcheN18 (big blind) folded before Flop





PokerStars Hand #151942290876:  Hold'em No Limit ($0.50/$1.00 USD) - 2016/04/15 13:16:58 CET [2016/04/15 7:16:58 ET]
Table 'Navi' 9-max Seat #8 is the button
Seat 1: tipner ($100 in chips) 
Seat 2: butcheN18 ($100 in chips) 
Seat 3: aseban11 ($119.98 in chips) 
Seat 4: Effort92 ($133.13 in chips) 
Seat 5: StarsAbove ($107 in chips) 
Seat 7: yoshidao ($139.88 in chips) 
Seat 8: djammusic ($49.78 in chips) 
Seat 9: matiko09 ($100.50 in chips) 
matiko09: posts small blind $0.50
tipner: posts big blind $1
*** HOLE CARDS ***
Dealt to matiko09 [6c Ad]
butcheN18: folds 
aseban11: folds 
Effort92: folds 
StarsAbove: folds 
yoshidao: folds 
djammusic: raises $1.02 to $2.02
matiko09: folds 
tipner: calls $1.02
*** FLOP *** [Jc 6d 5d]
tipner: checks 
djammusic: bets $2.80
tipner: calls $2.80
*** TURN *** [Jc 6d 5d] [Ah]
tipner: checks 
djammusic: bets $7
tipner: folds 
Uncalled bet ($7) returned to djammusic
djammusic collected $9.63 from pot
djammusic: doesn't show hand 
*** SUMMARY ***
Total pot $10.14 | Rake $0.51 
Board [Jc 6d 5d Ah]
Seat 1: tipner (big blind) folded on the Turn
Seat 2: butcheN18 folded before Flop (didn't bet)
Seat 3: aseban11 folded before Flop (didn't bet)
Seat 4: Effort92 folded before Flop (didn't bet)
Seat 5: StarsAbove folded before Flop (didn't bet)
Seat 7: yoshidao folded before Flop (didn't bet)
Seat 8: djammusic (button) collected ($9.63)
Seat 9: matiko09 (small blind) folded before Flop





PokerStars Hand #151942293642:  Hold'em No Limit ($0.50/$1.00 USD) - 2016/04/15 13:17:04 CET [2016/04/15 7:17:04 ET]
Table 'Katja II' 9-max Seat #3 is the button
Seat 1: Filojoes ($100 in chips) 
Seat 2: TheJokerMen1 ($56.11 in chips) 
Seat 3: matiko09 ($117.62 in chips) 
Seat 4: Sutt_420 ($76.20 in chips) 
Seat 6: ASG2016 ($112.04 in chips) 
Seat 7: Effort92 ($106.67 in chips) 
Sutt_420: posts small blind $0.50
ASG2016: posts big blind $1
TheJokerMen1: posts small & big blinds $1.50
*** HOLE CARDS ***
Dealt to matiko09 [7d Kd]
hardeep13 joins the table at seat #9 
Effort92: folds 
Filojoes: calls $1
TheJokerMen1: checks 
matiko09: raises $4.50 to $5.50
Sutt_420: folds 
ASG2016 is disconnected 
ASG2016 is connected 
ASG2016: folds 
Filojoes: raises $12.50 to $18
TheJokerMen1: folds 
matiko09: raises $15 to $33
Filojoes: folds 
Uncalled bet ($15) returned to matiko09
matiko09 collected $39 from pot
matiko09: doesn't show hand 
*** SUMMARY ***
Total pot $39 | Rake $0 
Seat 1: Filojoes folded before Flop
Seat 2: TheJokerMen1 folded before Flop
Seat 3: matiko09 (button) collected ($39)
Seat 4: Sutt_420 (small blind) folded before Flop
Seat 6: ASG2016 (big blind) folded before Flop
Seat 7: Effort92 folded before Flop (didn't bet)





PokerStars Hand #151942295172:  Hold'em No Limit ($0.50/$1.00 USD) - 2016/04/15 13:17:08 CET [2016/04/15 7:17:08 ET]
Table 'Lamberta III' 9-max Seat #1 is the button
Seat 1: Westpants ($100 in chips) 
Seat 2: Biscuit270 ($49 in chips) 
Seat 3: butcheN18 ($179.25 in chips) 
Seat 4: Filojoes ($100 in chips) 
Seat 5: tipner ($115.60 in chips) 
Seat 6: aseban11 ($100.68 in chips) 
Seat 8: wangzhuoming ($109.30 in chips) 
Seat 9: matiko09 ($161.36 in chips) 
Biscuit270: posts small blind $0.50
butcheN18: posts big blind $1
aleks2112198: sits out 
*** HOLE CARDS ***
Dealt to matiko09 [Ac 9c]
Filojoes: folds 
tipner: folds 
aseban11: folds 
wangzhuoming: folds 
matiko09: raises $1.50 to $2.50
Westpants: raises $5.50 to $8
Biscuit270: folds 
butcheN18: folds 
matiko09: folds 
Uncalled bet ($5.50) returned to Westpants
Westpants collected $6.50 from pot
*** SUMMARY ***
Total pot $6.50 | Rake $0 
Seat 1: Westpants (button) collected ($6.50)
Seat 2: Biscuit270 (small blind) folded before Flop
Seat 3: butcheN18 (big blind) folded before Flop
Seat 4: Filojoes folded before Flop (didn't bet)
Seat 5: tipner folded before Flop (didn't bet)
Seat 6: aseban11 folded before Flop (didn't bet)
Seat 8: wangzhuoming folded before Flop (didn't bet)
Seat 9: matiko09 folded before Flop





PokerStars Hand #151942297745:  Hold'em No Limit ($1/$2 USD) - 2016/04/15 13:17:13 CET [2016/04/15 7:17:13 ET]
Table 'Patroclus II' 9-max Seat #4 is the button
Seat 1: TonnaMunz ($200 in chips) 
Seat 2: Moemors ($155.65 in chips) 
Seat 3: Koolniknik ($201.85 in chips) 
Seat 4: tipner ($208 in chips) 
Seat 5: butcheN18 ($200 in chips) 
Seat 6: di0d80 ($205.35 in chips) 
Seat 7: matiko09 ($215.05 in chips) 
Seat 8: Glushchenko ($200 in chips) 
Seat 9: Fish4trips ($240.72 in chips) 
butcheN18: posts small blind $1
di0d80: posts big blind $2
*** HOLE CARDS ***
Dealt to matiko09 [Ks Js]
matiko09: raises $3 to $5
Glushchenko: folds 
Fish4trips: folds 
TonnaMunz: folds 
Moemors: folds 
Koolniknik: raises $10 to $15
tipner: folds 
butcheN18: folds 
di0d80: folds 
matiko09: folds 
Uncalled bet ($10) returned to Koolniknik
Koolniknik collected $13 from pot
Koolniknik: doesn't show hand 
*** SUMMARY ***
Total pot $13 | Rake $0 
Seat 1: TonnaMunz folded before Flop (didn't bet)
Seat 2: Moemors folded before Flop (didn't bet)
Seat 3: Koolniknik collected ($13)
Seat 4: tipner (button) folded before Flop (didn't bet)
Seat 5: butcheN18 (small blind) folded before Flop
Seat 6: di0d80 (big blind) folded before Flop
Seat 7: matiko09 folded before Flop
Seat 8: Glushchenko folded before Flop (didn't bet)
Seat 9: Fish4trips folded before Flop (didn't bet)





PokerStars Hand #151942301695:  Hold'em No Limit ($1/$2 USD) - 2016/04/15 13:17:22 CET [2016/04/15 7:17:22 ET]
Table 'Adele II' 9-max Seat #6 is the button
Seat 2: Fish4trips ($200 in chips) 
Seat 3: matiko09 ($341.45 in chips) 
Seat 6: wiseyoyo ($200 in chips) 
Seat 8: docmarc777 ($296.36 in chips) 
Seat 9: MiiFuxU ($200 in chips) 
docmarc777: posts small blind $1
MiiFuxU: posts big blind $2
*** HOLE CARDS ***
Dealt to matiko09 [5s 8h]
Fish4trips: folds 
matiko09: folds 
wiseyoyo: raises $2 to $4
docmarc777: folds 
MiiFuxU: calls $2
*** FLOP *** [Qc Td 9d]
MiiFuxU: checks 
wiseyoyo: checks 
*** TURN *** [Qc Td 9d] [5d]
MiiFuxU: bets $5.19
RyanHuJun joins the table at seat #1 
wiseyoyo: folds 
Uncalled bet ($5.19) returned to MiiFuxU
MiiFuxU collected $8.55 from pot
MiiFuxU: doesn't show hand 
*** SUMMARY ***
Total pot $9 | Rake $0.45 
Board [Qc Td 9d 5d]
Seat 2: Fish4trips folded before Flop (didn't bet)
Seat 3: matiko09 folded before Flop (didn't bet)
Seat 6: wiseyoyo (button) folded on the Turn
Seat 8: docmarc777 (small blind) folded before Flop
Seat 9: MiiFuxU (big blind) collected ($8.55)





PokerStars Hand #151942308405:  Hold'em No Limit ($0.50/$1.00 USD) - 2016/04/15 13:17:36 CET [2016/04/15 7:17:36 ET]
Table 'Chiny II' 9-max Seat #8 is the button
Seat 1: aseban11 ($100 in chips) 
Seat 2: AceFarky ($114.57 in chips) 
Seat 3: powerbel ($43.04 in chips) 
Seat 4: 1000karlos ($75.07 in chips) 
Seat 5: Yaaaazz ($100 in chips) 
Seat 6: choupai ($61.60 in chips) 
Seat 7: matiko09 ($149.38 in chips) 
Seat 8: Filojoes ($104.09 in chips) 
Seat 9: butcheN18 ($100 in chips) 
butcheN18: posts small blind $0.50
aseban11: posts big blind $1
*** HOLE CARDS ***
Dealt to matiko09 [5s 6h]
AceFarky: folds 
powerbel: folds 
1000karlos: folds 
Yaaaazz: folds 
choupai: folds 
matiko09: folds 
Filojoes: raises $1 to $2
butcheN18: folds 
aseban11: folds 
Uncalled bet ($1) returned to Filojoes
Filojoes collected $2.50 from pot
Filojoes: doesn't show hand 
*** SUMMARY ***
Total pot $2.50 | Rake $0 
Seat 1: aseban11 (big blind) folded before Flop
Seat 2: AceFarky folded before Flop (didn't bet)
Seat 3: powerbel folded before Flop (didn't bet)
Seat 4: 1000karlos folded before Flop (didn't bet)
Seat 5: Yaaaazz folded before Flop (didn't bet)
Seat 6: choupai folded before Flop (didn't bet)
Seat 7: matiko09 folded before Flop (didn't bet)
Seat 8: Filojoes (button) collected ($2.50)
Seat 9: butcheN18 (small blind) folded before Flop





PokerStars Hand #151942310573:  Hold'em No Limit ($0.50/$1.00 USD) - 2016/04/15 13:17:40 CET [2016/04/15 7:17:40 ET]
Table 'Lamberta III' 9-max Seat #2 is the button
Seat 1: Westpants ($104 in chips) 
Seat 2: Biscuit270 ($48.50 in chips) 
Seat 3: butcheN18 ($178.25 in chips) 
Seat 4: Filojoes ($100 in chips) 
Seat 5: tipner ($115.60 in chips) 
Seat 6: aseban11 ($100.68 in chips) 
Seat 8: wangzhuoming ($109.30 in chips) 
Seat 9: matiko09 ($158.86 in chips) 
butcheN18: posts small blind $0.50
Filojoes: posts big blind $1
aleks2112198: sits out 
*** HOLE CARDS ***
Dealt to matiko09 [7h Th]
tipner: folds 
aseban11: folds 
wangzhuoming: folds 
matiko09: folds 
Westpants: folds 
Biscuit270: folds 
butcheN18: raises $1.14 to $2.14
Filojoes: folds 
Uncalled bet ($1.14) returned to butcheN18
butcheN18 collected $2 from pot
butcheN18: doesn't show hand 
*** SUMMARY ***
Total pot $2 | Rake $0 
Seat 1: Westpants folded before Flop (didn't bet)
Seat 2: Biscuit270 (button) folded before Flop (didn't bet)
Seat 3: butcheN18 (small blind) collected ($2)
Seat 4: Filojoes (big blind) folded before Flop
Seat 5: tipner folded before Flop (didn't bet)
Seat 6: aseban11 folded before Flop (didn't bet)
Seat 8: wangzhuoming folded before Flop (didn't bet)
Seat 9: matiko09 folded before Flop (didn't bet)





PokerStars Hand #151942314723:  Hold'em No Limit ($0.50/$1.00 USD) - 2016/04/15 13:17:49 CET [2016/04/15 7:17:49 ET]
Table 'Matterania III' 9-max Seat #1 is the button
Seat 1: di0d80 ($109.98 in chips) 
Seat 3: ardo888 ($156.20 in chips) 
Seat 4: wangzhuoming ($84.42 in chips) 
Seat 5: Vermm ($75.70 in chips) 
Seat 6: matiko09 ($102.70 in chips) 
Seat 7: Filojoes ($103.10 in chips) 
Seat 8: Jimy Tiltman ($100 in chips) 
Seat 9: butcheN18 ($102.60 in chips) 
ardo888: posts small blind $0.50
wangzhuoming: posts big blind $1
di0d80: posts the ante $0.20
ardo888: posts the ante $0.20
wangzhuoming: posts the ante $0.20
Vermm: posts the ante $0.20
matiko09: posts the ante $0.20
Filojoes: posts the ante $0.20
Jimy Tiltman: posts the ante $0.20
butcheN18: posts the ante $0.20
*** HOLE CARDS ***
Dealt to matiko09 [Qh 2c]
Vermm: folds 
matiko09: folds 
Filojoes: folds 
Jimy Tiltman: raises $2 to $3
butcheN18: folds 
di0d80: folds 
ardo888: folds 
wangzhuoming: folds 
Uncalled bet ($2) returned to Jimy Tiltman
Jimy Tiltman collected $4.10 from pot
Jimy Tiltman: doesn't show hand 
*** SUMMARY ***
Total pot $4.10 | Rake $0 
Seat 1: di0d80 (button) folded before Flop (didn't bet)
Seat 3: ardo888 (small blind) folded before Flop
Seat 4: wangzhuoming (big blind) folded before Flop
Seat 5: Vermm folded before Flop (didn't bet)
Seat 6: matiko09 folded before Flop (didn't bet)
Seat 7: Filojoes folded before Flop (didn't bet)
Seat 8: Jimy Tiltman collected ($4.10)
Seat 9: butcheN18 folded before Flop (didn't bet)





PokerStars Hand #151942317844:  Hold'em No Limit ($0.50/$1.00 USD) - 2016/04/15 13:17:56 CET [2016/04/15 7:17:56 ET]
Table 'Lamberta III' 9-max Seat #3 is the button
Seat 1: Westpants ($104 in chips) 
Seat 2: Biscuit270 ($48.50 in chips) 
Seat 3: butcheN18 ($179.25 in chips) 
Seat 4: Filojoes ($100 in chips) 
Seat 6: aseban11 ($100.68 in chips) 
Seat 8: wangzhuoming ($109.30 in chips) 
Seat 9: matiko09 ($158.86 in chips) 
Filojoes: posts small blind $0.50
tipner: is sitting out 
aseban11: posts big blind $1
aleks2112198: sits out 
*** HOLE CARDS ***
Dealt to matiko09 [6s Ks]
wangzhuoming: folds 
matiko09: folds 
Westpants: folds 
Biscuit270: folds 
butcheN18: folds 
Filojoes: folds 
Uncalled bet ($0.50) returned to aseban11
aseban11 collected $1 from pot
aseban11: doesn't show hand 
*** SUMMARY ***
Total pot $1 | Rake $0 
Seat 1: Westpants folded before Flop (didn't bet)
Seat 2: Biscuit270 folded before Flop (didn't bet)
Seat 3: butcheN18 (button) folded before Flop (didn't bet)
Seat 4: Filojoes (small blind) folded before Flop
Seat 6: aseban11 (big blind) collected ($1)
Seat 8: wangzhuoming folded before Flop (didn't bet)
Seat 9: matiko09 folded before Flop (didn't bet)





PokerStars Hand #151942320812:  Hold'em No Limit ($0.50/$1.00 USD) - 2016/04/15 13:18:02 CET [2016/04/15 7:18:02 ET]
Table 'Navi' 9-max Seat #9 is the button
Seat 1: tipner ($100 in chips) 
Seat 2: butcheN18 ($100 in chips) 
Seat 3: aseban11 ($119.98 in chips) 
Seat 4: Effort92 ($133.13 in chips) 
Seat 5: StarsAbove ($107 in chips) 
Seat 7: yoshidao ($139.88 in chips) 
Seat 8: djammusic ($54.59 in chips) 
Seat 9: matiko09 ($100 in chips) 
tipner: posts small blind $0.50
butcheN18: posts big blind $1
*** HOLE CARDS ***
Dealt to matiko09 [Ah 8c]
aseban11: folds 
Effort92: folds 
StarsAbove: folds 
yoshidao: calls $1
djammusic: folds 
matiko09: raises $3 to $4
tipner: folds 
butcheN18: folds 
yoshidao: calls $3
*** FLOP *** [Jd 6s Qd]
yoshidao: bets $2
matiko09: folds 
Uncalled bet ($2) returned to yoshidao
yoshidao collected $9.02 from pot
yoshidao: doesn't show hand 
*** SUMMARY ***
Total pot $9.50 | Rake $0.48 
Board [Jd 6s Qd]
Seat 1: tipner (small blind) folded before Flop
Seat 2: butcheN18 (big blind) folded before Flop
Seat 3: aseban11 folded before Flop (didn't bet)
Seat 4: Effort92 folded before Flop (didn't bet)
Seat 5: StarsAbove folded before Flop (didn't bet)
Seat 7: yoshidao collected ($9.02)
Seat 8: djammusic folded before Flop (didn't bet)
Seat 9: matiko09 (button) folded on the Flop





PokerStars Hand #151942322122:  Hold'em No Limit ($1/$2 USD) - 2016/04/15 13:18:05 CET [2016/04/15 7:18:05 ET]
Table 'Patroclus II' 9-max Seat #5 is the button
Seat 1: TonnaMunz ($200 in chips) 
Seat 2: Moemors ($155.65 in chips) 
Seat 3: Koolniknik ($209.85 in chips) 
Seat 4: tipner ($208 in chips) 
Seat 5: butcheN18 ($200 in chips) 
Seat 6: di0d80 ($203.35 in chips) 
Seat 7: matiko09 ($210.05 in chips) 
Seat 9: Fish4trips ($240.72 in chips) 
di0d80: posts small blind $1
matiko09: posts big blind $2
*** HOLE CARDS ***
Dealt to matiko09 [Th 4s]
Fish4trips: folds 
TonnaMunz: folds 
Moemors: folds 
Koolniknik: raises $4 to $6
tipner: folds 
butcheN18: raises $12 to $18
di0d80: folds 
matiko09: folds 
Koolniknik: folds 
Uncalled bet ($12) returned to butcheN18
butcheN18 collected $15 from pot
butcheN18: doesn't show hand 
*** SUMMARY ***
Total pot $15 | Rake $0 
Seat 1: TonnaMunz folded before Flop (didn't bet)
Seat 2: Moemors folded before Flop (didn't bet)
Seat 3: Koolniknik folded before Flop
Seat 4: tipner folded before Flop (didn't bet)
Seat 5: butcheN18 (button) collected ($15)
Seat 6: di0d80 (small blind) folded before Flop
Seat 7: matiko09 (big blind) folded before Flop
Seat 9: Fish4trips folded before Flop (didn't bet)





PokerStars Hand #151942324326:  Hold'em No Limit ($0.50/$1.00 USD) - 2016/04/15 13:18:09 CET [2016/04/15 7:18:09 ET]
Table 'Chiny II' 9-max Seat #9 is the button
Seat 1: aseban11 ($100 in chips) 
Seat 2: AceFarky ($114.57 in chips) 
Seat 3: powerbel ($43.04 in chips) 
Seat 4: 1000karlos ($75.07 in chips) 
Seat 5: Yaaaazz ($100 in chips) 
Seat 6: choupai ($61.60 in chips) 
Seat 7: matiko09 ($149.38 in chips) 
Seat 8: Filojoes ($105.59 in chips) 
Seat 9: butcheN18 ($100 in chips) 
aseban11: posts small blind $0.50
AceFarky: posts big blind $1
*** HOLE CARDS ***
Dealt to matiko09 [Td 5d]
powerbel: folds 
1000karlos: folds 
Yaaaazz: folds 
choupai: folds 
matiko09: folds 
Filojoes: folds 
butcheN18: folds 
aseban11: folds 
Uncalled bet ($0.50) returned to AceFarky
AceFarky collected $1 from pot
AceFarky: doesn't show hand 
*** SUMMARY ***
Total pot $1 | Rake $0 
Seat 1: aseban11 (small blind) folded before Flop
Seat 2: AceFarky (big blind) collected ($1)
Seat 3: powerbel folded before Flop (didn't bet)
Seat 4: 1000karlos folded before Flop (didn't bet)
Seat 5: Yaaaazz folded before Flop (didn't bet)
Seat 6: choupai folded before Flop (didn't bet)
Seat 7: matiko09 folded before Flop (didn't bet)
Seat 8: Filojoes folded before Flop (didn't bet)
Seat 9: butcheN18 (button) folded before Flop (didn't bet)





PokerStars Hand #151942324729:  Hold'em No Limit ($1/$2 USD) - 2016/04/15 13:18:10 CET [2016/04/15 7:18:10 ET]
Table 'Adele II' 9-max Seat #8 is the button
Seat 1: RyanHuJun ($235.97 in chips) 
Seat 2: Fish4trips ($200 in chips) 
Seat 3: matiko09 ($341.45 in chips) 
Seat 6: wiseyoyo ($200 in chips) 
Seat 8: docmarc777 ($295.36 in chips) 
Seat 9: MiiFuxU ($204.55 in chips) 
MiiFuxU: posts small blind $1
RyanHuJun: posts big blind $2
*** HOLE CARDS ***
Dealt to matiko09 [Td Ad]
Fish4trips: folds 
matiko09: raises $3 to $5
wiseyoyo: raises $13 to $18
docmarc777: folds 
MiiFuxU: folds 
RyanHuJun: folds 
matiko09: folds 
Uncalled bet ($13) returned to wiseyoyo
wiseyoyo collected $13 from pot
wiseyoyo: doesn't show hand 
*** SUMMARY ***
Total pot $13 | Rake $0 
Seat 1: RyanHuJun (big blind) folded before Flop
Seat 2: Fish4trips folded before Flop (didn't bet)
Seat 3: matiko09 folded before Flop
Seat 6: wiseyoyo collected ($13)
Seat 8: docmarc777 (button) folded before Flop (didn't bet)
Seat 9: MiiFuxU (small blind) folded before Flop





PokerStars Hand #151942326245:  Hold'em No Limit ($0.50/$1.00 USD) - 2016/04/15 13:18:13 CET [2016/04/15 7:18:13 ET]
Table 'Cheruskia II' 9-max Seat #6 is the button
Seat 1: vicus1972 ($96.30 in chips) 
Seat 2: SerAlGog ($100 in chips) 
Seat 3: butcheN18 ($139.05 in chips) 
Seat 4: djammusic ($43.70 in chips) 
Seat 5: Paul6999 ($73 in chips) 
Seat 6: hammerwife ($123.60 in chips) 
Seat 7: matiko09 ($100.50 in chips) 
Seat 8: ardo888 ($100 in chips) 
Seat 9: rycho222 ($104.50 in chips) 
matiko09: posts small blind $0.50
ardo888: posts big blind $1
*** HOLE CARDS ***
Dealt to matiko09 [6c 9h]
rycho222: folds 
vicus1972: folds 
SerAlGog: raises $2 to $3
SerAlGog said, "nh"
butcheN18: folds 
djammusic: folds 
Paul6999: folds 
hammerwife: folds 
matiko09: folds 
ardo888: folds 
Uncalled bet ($2) returned to SerAlGog
SerAlGog collected $2.50 from pot
SerAlGog: doesn't show hand 
*** SUMMARY ***
Total pot $2.50 | Rake $0 
Seat 1: vicus1972 folded before Flop (didn't bet)
Seat 2: SerAlGog collected ($2.50)
Seat 3: butcheN18 folded before Flop (didn't bet)
Seat 4: djammusic folded before Flop (didn't bet)
Seat 5: Paul6999 folded before Flop (didn't bet)
Seat 6: hammerwife (button) folded before Flop (didn't bet)
Seat 7: matiko09 (small blind) folded before Flop
Seat 8: ardo888 (big blind) folded before Flop
Seat 9: rycho222 folded before Flop (didn't bet)





PokerStars Hand #151942326811:  Hold'em No Limit ($0.50/$1.00 USD) - 2016/04/15 13:18:15 CET [2016/04/15 7:18:15 ET]
Table 'Kreusa II' 9-max Seat #2 is the button
Seat 1: Frosch1907 ($47.13 in chips) 
Seat 2: azzad2007 ($101 in chips) 
Seat 4: Filojoes ($100 in chips) 
Seat 5: matiko09 ($100 in chips) 
Seat 8: rycho222 ($102 in chips) 
Filojoes: posts small blind $0.50
matiko09: posts big blind $1
tipner: sits out 
*** HOLE CARDS ***
Dealt to matiko09 [4h 9c]
djammusic joins the table at seat #7 
rycho222: folds 
Frosch1907: folds 
azzad2007: raises $1.40 to $2.40
Filojoes: folds 
tipner leaves the table
matiko09: folds 
Uncalled bet ($1.40) returned to azzad2007
azzad2007 collected $2.50 from pot
azzad2007: doesn't show hand 
*** SUMMARY ***
Total pot $2.50 | Rake $0 
Seat 1: Frosch1907 folded before Flop (didn't bet)
Seat 2: azzad2007 (button) collected ($2.50)
Seat 4: Filojoes (small blind) folded before Flop
Seat 5: matiko09 (big blind) folded before Flop
Seat 8: rycho222 folded before Flop (didn't bet)





PokerStars Hand #151942331097:  Hold'em No Limit ($0.50/$1.00 USD) - 2016/04/15 13:18:24 CET [2016/04/15 7:18:24 ET]
Table 'Matterania III' 9-max Seat #3 is the button
Seat 1: di0d80 ($109.78 in chips) 
Seat 3: ardo888 ($155.50 in chips) 
Seat 4: wangzhuoming ($83.22 in chips) 
Seat 5: Vermm ($75.50 in chips) 
Seat 6: matiko09 ($102.50 in chips) 
Seat 7: Filojoes ($102.90 in chips) 
Seat 8: Jimy Tiltman ($102.90 in chips) 
Seat 9: butcheN18 ($102.40 in chips) 
wangzhuoming: posts small blind $0.50
Vermm: posts big blind $1
di0d80: posts the ante $0.20
ardo888: posts the ante $0.20
wangzhuoming: posts the ante $0.20
Vermm: posts the ante $0.20
matiko09: posts the ante $0.20
Filojoes: posts the ante $0.20
Jimy Tiltman: posts the ante $0.20
butcheN18: posts the ante $0.20
*** HOLE CARDS ***
Dealt to matiko09 [7s 5h]
matiko09: folds 
Filojoes: folds 
Jimy Tiltman: folds 
butcheN18: raises $2 to $3
di0d80: folds 
ardo888: folds 
wangzhuoming: folds 
Vermm: folds 
Uncalled bet ($2) returned to butcheN18
butcheN18 collected $4.10 from pot
butcheN18: doesn't show hand 
*** SUMMARY ***
Total pot $4.10 | Rake $0 
Seat 1: di0d80 folded before Flop (didn't bet)
Seat 3: ardo888 (button) folded before Flop (didn't bet)
Seat 4: wangzhuoming (small blind) folded before Flop
Seat 5: Vermm (big blind) folded before Flop
Seat 6: matiko09 folded before Flop (didn't bet)
Seat 7: Filojoes folded before Flop (didn't bet)
Seat 8: Jimy Tiltman folded before Flop (didn't bet)
Seat 9: butcheN18 collected ($4.10)





PokerStars Hand #151942331528:  Hold'em No Limit ($0.50/$1.00 USD) - 2016/04/15 13:18:25 CET [2016/04/15 7:18:25 ET]
Table 'Lamberta III' 9-max Seat #4 is the button
Seat 1: Westpants ($104 in chips) 
Seat 2: Biscuit270 ($48.50 in chips) 
Seat 3: butcheN18 ($179.25 in chips) 
Seat 4: Filojoes ($100 in chips) 
Seat 6: aseban11 ($101.18 in chips) 
Seat 7: aleks2112198 ($80 in chips) 
Seat 8: wangzhuoming ($109.30 in chips) 
Seat 9: matiko09 ($158.86 in chips) 
tipner will be allowed to play after the button
aseban11: posts small blind $0.50
aleks2112198: posts big blind $1
*** HOLE CARDS ***
Dealt to matiko09 [Qs Tc]
wangzhuoming: folds 
matiko09: folds 
Westpants: folds 
Biscuit270: folds 
butcheN18: folds 
Filojoes: raises $1 to $2
aseban11: folds 
aleks2112198: calls $1
*** FLOP *** [2c 2s Qc]
aleks2112198: checks 
Filojoes: bets $2.57
aleks2112198: calls $2.57
*** TURN *** [2c 2s Qc] [7d]
aleks2112198: checks 
Filojoes: checks 
*** RIVER *** [2c 2s Qc 7d] [As]
aleks2112198: checks 
Filojoes: checks 
*** SHOW DOWN ***
aleks2112198: shows [4c 9c] (a pair of Deuces)
Filojoes: shows [Js 9d] (a pair of Deuces - Ace+Queen+Jack kicker)
Filojoes collected $9.16 from pot
*** SUMMARY ***
Total pot $9.64 | Rake $0.48 
Board [2c 2s Qc 7d As]
Seat 1: Westpants folded before Flop (didn't bet)
Seat 2: Biscuit270 folded before Flop (didn't bet)
Seat 3: butcheN18 folded before Flop (didn't bet)
Seat 4: Filojoes (button) showed [Js 9d] and won ($9.16) with a pair of Deuces
Seat 6: aseban11 (small blind) folded before Flop
Seat 7: aleks2112198 (big blind) showed [4c 9c] and lost with a pair of Deuces
Seat 8: wangzhuoming folded before Flop (didn't bet)
Seat 9: matiko09 folded before Flop (didn't bet)





PokerStars Hand #151942340732:  Hold'em No Limit ($1/$2 USD) - 2016/04/15 13:18:45 CET [2016/04/15 7:18:45 ET]
Table 'Adele II' 9-max Seat #9 is the button
Seat 1: RyanHuJun ($233.97 in chips) 
Seat 2: Fish4trips ($200 in chips) 
Seat 3: matiko09 ($336.45 in chips) 
Seat 6: wiseyoyo ($208 in chips) 
Seat 8: docmarc777 ($295.36 in chips) 
Seat 9: MiiFuxU ($203.55 in chips) 
RyanHuJun: posts small blind $1
Fish4trips: posts big blind $2
*** HOLE CARDS ***
Dealt to matiko09 [Ks As]
Iggso joins the table at seat #7 
matiko09: raises $3 to $5
wiseyoyo: folds 
docmarc777: calls $5
MiiFuxU: folds 
RyanHuJun is disconnected 
RyanHuJun is connected 
RyanHuJun: folds 
Fish4trips: folds 
*** FLOP *** [5c 8c 7c]
matiko09: checks 
docmarc777: bets $2
matiko09: folds 
Uncalled bet ($2) returned to docmarc777
docmarc777 collected $12.35 from pot
*** SUMMARY ***
Total pot $13 | Rake $0.65 
Board [5c 8c 7c]
Seat 1: RyanHuJun (small blind) folded before Flop
Seat 2: Fish4trips (big blind) folded before Flop
Seat 3: matiko09 folded on the Flop
Seat 6: wiseyoyo folded before Flop (didn't bet)
Seat 8: docmarc777 collected ($12.35)
Seat 9: MiiFuxU (button) folded before Flop (didn't bet)





PokerStars Hand #151942340641:  Hold'em No Limit ($0.50/$1.00 USD) - 2016/04/15 13:18:45 CET [2016/04/15 7:18:45 ET]
Table 'Chiny II' 9-max Seat #1 is the button
Seat 1: aseban11 ($100 in chips) 
Seat 2: AceFarky ($115.07 in chips) 
Seat 3: powerbel ($43.04 in chips) 
Seat 4: 1000karlos ($75.07 in chips) 
Seat 5: Yaaaazz ($100 in chips) 
Seat 6: choupai ($61.60 in chips) 
Seat 7: matiko09 ($149.38 in chips) 
Seat 8: Filojoes ($105.59 in chips) 
Seat 9: butcheN18 ($100 in chips) 
AceFarky: posts small blind $0.50
powerbel: posts big blind $1
*** HOLE CARDS ***
Dealt to matiko09 [Qs 5h]
1000karlos: raises $1 to $2
Yaaaazz: folds 
choupai: calls $2
matiko09: folds 
Filojoes: folds 
butcheN18: calls $2
aseban11: folds 
AceFarky: folds 
powerbel: folds 
*** FLOP *** [4s 7d 9c]
1000karlos: checks 
choupai: bets $4
butcheN18: folds 
1000karlos: calls $4
*** TURN *** [4s 7d 9c] [Js]
1000karlos: checks 
choupai: checks 
*** RIVER *** [4s 7d 9c Js] [Ts]
1000karlos: checks 
choupai: bets $8
1000karlos: calls $8
*** SHOW DOWN ***
choupai: shows [As Ac] (a pair of Aces)
1000karlos: shows [4d 4c] (three of a kind, Fours)
1000karlos collected $29.92 from pot
*** SUMMARY ***
Total pot $31.50 | Rake $1.58 
Board [4s 7d 9c Js Ts]
Seat 1: aseban11 (button) folded before Flop (didn't bet)
Seat 2: AceFarky (small blind) folded before Flop
Seat 3: powerbel (big blind) folded before Flop
Seat 4: 1000karlos showed [4d 4c] and won ($29.92) with three of a kind, Fours
Seat 5: Yaaaazz folded before Flop (didn't bet)
Seat 6: choupai showed [As Ac] and lost with a pair of Aces
Seat 7: matiko09 folded before Flop (didn't bet)
Seat 8: Filojoes folded before Flop (didn't bet)
Seat 9: butcheN18 folded on the Flop





PokerStars Hand #151942341914:  Hold'em No Limit ($0.50/$1.00 USD) - 2016/04/15 13:18:48 CET [2016/04/15 7:18:48 ET]
Table 'Cheruskia II' 9-max Seat #7 is the button
Seat 1: vicus1972 ($96.30 in chips) 
Seat 2: SerAlGog ($101.50 in chips) 
Seat 3: butcheN18 ($139.05 in chips) 
Seat 4: djammusic ($43.70 in chips) 
Seat 5: Paul6999 ($73 in chips) 
Seat 6: hammerwife ($123.60 in chips) 
Seat 7: matiko09 ($100 in chips) 
Seat 8: ardo888 ($100 in chips) 
Seat 9: rycho222 ($104.50 in chips) 
ardo888: posts small blind $0.50
rycho222: posts big blind $1
*** HOLE CARDS ***
Dealt to matiko09 [5s Kd]
vicus1972: folds 
SerAlGog: folds 
butcheN18: folds 
djammusic: folds 
Paul6999: folds 
hammerwife: raises $1.50 to $2.50
matiko09: folds 
ardo888: folds 
rycho222: folds 
Uncalled bet ($1.50) returned to hammerwife
hammerwife collected $2.50 from pot
hammerwife: doesn't show hand 
*** SUMMARY ***
Total pot $2.50 | Rake $0 
Seat 1: vicus1972 folded before Flop (didn't bet)
Seat 2: SerAlGog folded before Flop (didn't bet)
Seat 3: butcheN18 folded before Flop (didn't bet)
Seat 4: djammusic folded before Flop (didn't bet)
Seat 5: Paul6999 folded before Flop (didn't bet)
Seat 6: hammerwife collected ($2.50)
Seat 7: matiko09 (button) folded before Flop (didn't bet)
Seat 8: ardo888 (small blind) folded before Flop
Seat 9: rycho222 (big blind) folded before Flop





PokerStars Hand #151942342682:  Hold'em No Limit ($0.50/$1.00 USD) - 2016/04/15 13:18:49 CET [2016/04/15 7:18:49 ET]
Table 'Matterania III' 9-max Seat #4 is the button
Seat 1: di0d80 ($109.58 in chips) 
Seat 3: ardo888 ($155.30 in chips) 
Seat 4: wangzhuoming ($82.52 in chips) 
Seat 5: Vermm ($74.30 in chips) 
Seat 6: matiko09 ($102.30 in chips) 
Seat 7: Filojoes ($102.70 in chips) 
Seat 8: Jimy Tiltman ($102.70 in chips) 
Seat 9: butcheN18 ($105.30 in chips) 
Vermm: posts small blind $0.50
matiko09: posts big blind $1
di0d80: posts the ante $0.20
ardo888: posts the ante $0.20
wangzhuoming: posts the ante $0.20
Vermm: posts the ante $0.20
matiko09: posts the ante $0.20
Filojoes: posts the ante $0.20
Jimy Tiltman: posts the ante $0.20
butcheN18: posts the ante $0.20
*** HOLE CARDS ***
Dealt to matiko09 [4s 8h]
Filojoes: folds 
Jimy Tiltman: folds 
butcheN18: folds 
di0d80: folds 
ardo888: folds 
wangzhuoming: folds 
Vermm: raises $2 to $3
matiko09: folds 
Uncalled bet ($2) returned to Vermm
Vermm collected $3.60 from pot
Vermm: doesn't show hand 
*** SUMMARY ***
Total pot $3.60 | Rake $0 
Seat 1: di0d80 folded before Flop (didn't bet)
Seat 3: ardo888 folded before Flop (didn't bet)
Seat 4: wangzhuoming (button) folded before Flop (didn't bet)
Seat 5: Vermm (small blind) collected ($3.60)
Seat 6: matiko09 (big blind) folded before Flop
Seat 7: Filojoes folded before Flop (didn't bet)
Seat 8: Jimy Tiltman folded before Flop (didn't bet)
Seat 9: butcheN18 folded before Flop (didn't bet)





PokerStars Hand #151942344245:  Hold'em No Limit ($0.50/$1.00 USD) - 2016/04/15 13:18:53 CET [2016/04/15 7:18:53 ET]
Table 'Kreusa II' 9-max Seat #4 is the button
Seat 1: Frosch1907 ($47.13 in chips) 
Seat 2: azzad2007 ($102.50 in chips) 
Seat 4: Filojoes ($100 in chips) 
Seat 5: matiko09 ($100 in chips) 
Seat 7: djammusic ($40 in chips) 
Seat 8: rycho222 ($102 in chips) 
matiko09: posts small blind $0.50
djammusic: posts big blind $1
*** HOLE CARDS ***
Dealt to matiko09 [Ad As]
rycho222: raises $1 to $2
Frosch1907: calls $2
azzad2007: folds 
Filojoes: folds 
matiko09: raises $8 to $10
djammusic: folds 
rycho222: calls $8
Frosch1907: folds 
*** FLOP *** [7h Kc 7s]
matiko09: bets $9.99
rycho222: calls $9.99
*** TURN *** [7h Kc 7s] [6c]
matiko09: bets $19.99
rycho222: folds 
Uncalled bet ($19.99) returned to matiko09
matiko09 collected $40.83 from pot
matiko09: doesn't show hand 
*** SUMMARY ***
Total pot $42.98 | Rake $2.15 
Board [7h Kc 7s 6c]
Seat 1: Frosch1907 folded before Flop
Seat 2: azzad2007 folded before Flop (didn't bet)
Seat 4: Filojoes (button) folded before Flop (didn't bet)
Seat 5: matiko09 (small blind) collected ($40.83)
Seat 7: djammusic (big blind) folded before Flop
Seat 8: rycho222 folded on the Turn





PokerStars Hand #151942345135:  Hold'em No Limit ($1/$2 USD) - 2016/04/15 13:18:54 CET [2016/04/15 7:18:54 ET]
Table 'Patroclus II' 9-max Seat #6 is the button
Seat 1: TonnaMunz ($200 in chips) 
Seat 2: Moemors ($155.65 in chips) 
Seat 3: Koolniknik ($203.85 in chips) 
Seat 4: tipner ($208 in chips) 
Seat 5: butcheN18 ($209 in chips) 
Seat 6: di0d80 ($202.35 in chips) 
Seat 7: matiko09 ($208.05 in chips) 
Seat 9: Fish4trips ($240.72 in chips) 
matiko09: posts small blind $1
Fish4trips: posts big blind $2
*** HOLE CARDS ***
Dealt to matiko09 [Qc 6s]
TonnaMunz: folds 
Moemors: raises $2 to $4
Koolniknik: folds 
tipner: calls $4
butcheN18: folds 
di0d80: calls $4
matiko09: folds 
Fish4trips: folds 
*** FLOP *** [8c 2s 5c]
Moemors: checks 
tipner: bets $8
di0d80: calls $8
Moemors: folds 
*** TURN *** [8c 2s 5c] [5h]
tipner: checks 
di0d80: bets $16
tipner: raises $44 to $60
di0d80: folds 
Uncalled bet ($44) returned to tipner
tipner collected $60.25 from pot
tipner: doesn't show hand 
*** SUMMARY ***
Total pot $63 | Rake $2.75 
Board [8c 2s 5c 5h]
Seat 1: TonnaMunz folded before Flop (didn't bet)
Seat 2: Moemors folded on the Flop
Seat 3: Koolniknik folded before Flop (didn't bet)
Seat 4: tipner collected ($60.25)
Seat 5: butcheN18 folded before Flop (didn't bet)
Seat 6: di0d80 (button) folded on the Turn
Seat 7: matiko09 (small blind) folded before Flop
Seat 9: Fish4trips (big blind) folded before Flop





PokerStars Hand #151942346026:  Hold'em No Limit ($0.50/$1.00 USD) - 2016/04/15 13:18:56 CET [2016/04/15 7:18:56 ET]
Table 'Navi' 9-max Seat #1 is the button
Seat 1: tipner ($100 in chips) 
Seat 2: butcheN18 ($100 in chips) 
Seat 3: aseban11 ($119.98 in chips) 
Seat 4: Effort92 ($133.13 in chips) 
Seat 5: StarsAbove ($107 in chips) 
Seat 7: yoshidao ($144.90 in chips) 
Seat 8: djammusic ($54.59 in chips) 
Seat 9: matiko09 ($100 in chips) 
butcheN18: posts small blind $0.50
aseban11: posts big blind $1
*** HOLE CARDS ***
Dealt to matiko09 [5s Qc]
Effort92: folds 
StarsAbove: folds 
yoshidao: calls $1
djammusic: folds 
matiko09: folds 
tipner: folds 
butcheN18: folds 
aseban11: checks 
*** FLOP *** [Ks Js 9d]
aseban11: bets $2.38
yoshidao: calls $2.38
*** TURN *** [Ks Js 9d] [7d]
aseban11: bets $5.17
yoshidao: raises $9.83 to $15
aseban11: folds 
Uncalled bet ($9.83) returned to yoshidao
yoshidao collected $16.72 from pot
yoshidao: doesn't show hand 
*** SUMMARY ***
Total pot $17.60 | Rake $0.88 
Board [Ks Js 9d 7d]
Seat 1: tipner (button) folded before Flop (didn't bet)
Seat 2: butcheN18 (small blind) folded before Flop
Seat 3: aseban11 (big blind) folded on the Turn
Seat 4: Effort92 folded before Flop (didn't bet)
Seat 5: StarsAbove folded before Flop (didn't bet)
Seat 7: yoshidao collected ($16.72)
Seat 8: djammusic folded before Flop (didn't bet)
Seat 9: matiko09 folded before Flop (didn't bet)





PokerStars Hand #151942348693:  Hold'em No Limit ($0.50/$1.00 USD) - 2016/04/15 13:19:02 CET [2016/04/15 7:19:02 ET]
Table 'Lamberta III' 9-max Seat #6 is the button
Seat 1: Westpants ($104 in chips) 
Seat 2: Biscuit270 ($48.50 in chips) 
Seat 3: butcheN18 ($179.25 in chips) 
Seat 4: Filojoes ($104.59 in chips) 
Seat 6: aseban11 ($100.68 in chips) 
Seat 7: aleks2112198 ($75.43 in chips) 
Seat 8: wangzhuoming ($109.30 in chips) 
Seat 9: matiko09 ($158.86 in chips) 
aleks2112198: posts small blind $0.50
wangzhuoming: posts big blind $1
tipner: sits out 
*** HOLE CARDS ***
Dealt to matiko09 [6s 8h]
matiko09: folds 
Westpants: folds 
Biscuit270: calls $1
butcheN18: raises $3.18 to $4.18
Filojoes: folds 
aseban11: folds 
aleks2112198: calls $3.68
wangzhuoming: folds 
Biscuit270: folds 
*** FLOP *** [Qc Jd 4s]
aleks2112198: checks 
butcheN18: bets $6.29
aleks2112198: folds 
Uncalled bet ($6.29) returned to butcheN18
butcheN18 collected $9.84 from pot
butcheN18: doesn't show hand 
*** SUMMARY ***
Total pot $10.36 | Rake $0.52 
Board [Qc Jd 4s]
Seat 1: Westpants folded before Flop (didn't bet)
Seat 2: Biscuit270 folded before Flop
Seat 3: butcheN18 collected ($9.84)
Seat 4: Filojoes folded before Flop (didn't bet)
Seat 6: aseban11 (button) folded before Flop (didn't bet)
Seat 7: aleks2112198 (small blind) folded on the Flop
Seat 8: wangzhuoming (big blind) folded before Flop
Seat 9: matiko09 folded before Flop (didn't bet)





PokerStars Hand #151942355788:  Hold'em No Limit ($0.50/$1.00 USD) - 2016/04/15 13:19:17 CET [2016/04/15 7:19:17 ET]
Table 'Katja II' 9-max Seat #4 is the button
Seat 1: Filojoes ($100 in chips) 
Seat 2: TheJokerMen1 ($54.61 in chips) 
Seat 3: matiko09 ($138.62 in chips) 
Seat 4: Sutt_420 ($75.70 in chips) 
Seat 6: ASG2016 ($111.04 in chips) 
Seat 7: Effort92 ($106.67 in chips) 
Seat 9: hardeep13 ($58.29 in chips) 
ASG2016: posts small blind $0.50
Effort92: posts big blind $1
hardeep13: posts big blind $1
*** HOLE CARDS ***
Dealt to matiko09 [5s Kc]
hardeep13: checks 
Filojoes: raises $2 to $3
TheJokerMen1: folds 
matiko09: folds 
Sutt_420: folds 
ASG2016: folds 
Effort92: folds 
hardeep13: calls $2
*** FLOP *** [7s 9h Tc]
hardeep13: bets $5
Filojoes: folds 
Uncalled bet ($5) returned to hardeep13
hardeep13 collected $7.12 from pot
hardeep13: doesn't show hand 
*** SUMMARY ***
Total pot $7.50 | Rake $0.38 
Board [7s 9h Tc]
Seat 1: Filojoes folded on the Flop
Seat 2: TheJokerMen1 folded before Flop (didn't bet)
Seat 3: matiko09 folded before Flop (didn't bet)
Seat 4: Sutt_420 (button) folded before Flop (didn't bet)
Seat 6: ASG2016 (small blind) folded before Flop
Seat 7: Effort92 (big blind) folded before Flop
Seat 9: hardeep13 collected ($7.12)





PokerStars Hand #151942360199:  Hold'em No Limit ($0.50/$1.00 USD) - 2016/04/15 13:19:26 CET [2016/04/15 7:19:26 ET]
Table 'Cheruskia II' 9-max Seat #8 is the button
Seat 1: vicus1972 ($96.30 in chips) 
Seat 2: SerAlGog ($101.50 in chips) 
Seat 3: butcheN18 ($139.05 in chips) 
Seat 4: djammusic ($43.70 in chips) 
Seat 5: Paul6999 ($73 in chips) 
Seat 6: hammerwife ($125.10 in chips) 
Seat 7: matiko09 ($100 in chips) 
Seat 8: ardo888 ($100 in chips) 
Seat 9: rycho222 ($103.50 in chips) 
rycho222: posts small blind $0.50
vicus1972: posts big blind $1
*** HOLE CARDS ***
Dealt to matiko09 [7d 4c]
SerAlGog: folds 
butcheN18: folds 
djammusic: folds 
Paul6999: raises $1 to $2
hammerwife: folds 
matiko09: folds 
ardo888: folds 
rycho222: folds 
vicus1972: folds 
Uncalled bet ($1) returned to Paul6999
Paul6999 collected $2.50 from pot
Paul6999: doesn't show hand 
*** SUMMARY ***
Total pot $2.50 | Rake $0 
Seat 1: vicus1972 (big blind) folded before Flop
Seat 2: SerAlGog folded before Flop (didn't bet)
Seat 3: butcheN18 folded before Flop (didn't bet)
Seat 4: djammusic folded before Flop (didn't bet)
Seat 5: Paul6999 collected ($2.50)
Seat 6: hammerwife folded before Flop (didn't bet)
Seat 7: matiko09 folded before Flop (didn't bet)
Seat 8: ardo888 (button) folded before Flop (didn't bet)
Seat 9: rycho222 (small blind) folded before Flop





PokerStars Hand #151942361903:  Hold'em No Limit ($0.50/$1.00 USD) - 2016/04/15 13:19:30 CET [2016/04/15 7:19:30 ET]
Table 'Matterania III' 9-max Seat #5 is the button
Seat 1: di0d80 ($109.38 in chips) 
Seat 3: ardo888 ($155.10 in chips) 
Seat 4: wangzhuoming ($82.32 in chips) 
Seat 5: Vermm ($76.70 in chips) 
Seat 6: matiko09 ($101.10 in chips) 
Seat 7: Filojoes ($102.50 in chips) 
Seat 8: Jimy Tiltman ($102.50 in chips) 
Seat 9: butcheN18 ($105.10 in chips) 
matiko09: posts small blind $0.50
Filojoes: posts big blind $1
di0d80: posts the ante $0.20
ardo888: posts the ante $0.20
wangzhuoming: posts the ante $0.20
Vermm: posts the ante $0.20
matiko09: posts the ante $0.20
Filojoes: posts the ante $0.20
Jimy Tiltman: posts the ante $0.20
butcheN18: posts the ante $0.20
*** HOLE CARDS ***
Dealt to matiko09 [7h Kh]
Jimy Tiltman: folds 
butcheN18: folds 
di0d80: folds 
ardo888: folds 
wangzhuoming: raises $2 to $3
haoyuan541 joins the table at seat #2 
Vermm: calls $3
matiko09: folds 
Filojoes: folds 
*** FLOP *** [Jd 9d Ad]
wangzhuoming: checks 
Vermm: bets $5
wangzhuoming: folds 
Uncalled bet ($5) returned to Vermm
Vermm collected $8.64 from pot
Vermm: doesn't show hand 
*** SUMMARY ***
Total pot $9.10 | Rake $0.46 
Board [Jd 9d Ad]
Seat 1: di0d80 folded before Flop (didn't bet)
Seat 3: ardo888 folded before Flop (didn't bet)
Seat 4: wangzhuoming folded on the Flop
Seat 5: Vermm (button) collected ($8.64)
Seat 6: matiko09 (small blind) folded before Flop
Seat 7: Filojoes (big blind) folded before Flop
Seat 8: Jimy Tiltman folded before Flop (didn't bet)
Seat 9: butcheN18 folded before Flop (didn't bet)





PokerStars Hand #151942371524:  Hold'em No Limit ($0.50/$1.00 USD) - 2016/04/15 13:19:51 CET [2016/04/15 7:19:51 ET]
Table 'Navi' 9-max Seat #2 is the button
Seat 1: tipner ($100 in chips) 
Seat 2: butcheN18 ($100 in chips) 
Seat 3: aseban11 ($111.43 in chips) 
Seat 4: Effort92 ($133.13 in chips) 
Seat 5: StarsAbove ($107 in chips) 
Seat 7: yoshidao ($153.07 in chips) 
Seat 8: djammusic ($54.59 in chips) 
Seat 9: matiko09 ($100 in chips) 
aseban11: posts small blind $0.50
Effort92: posts big blind $1
*** HOLE CARDS ***
Dealt to matiko09 [2c Ks]
StarsAbove: raises $2 to $3
yoshidao: folds 
djammusic: folds 
matiko09: folds 
tipner: folds 
butcheN18: folds 
aseban11: folds 
Effort92: calls $2
*** FLOP *** [Th 5d Kc]
Effort92: checks 
StarsAbove: checks 
*** TURN *** [Th 5d Kc] [8c]
Effort92: checks 
StarsAbove: bets $4
Effort92: folds 
Uncalled bet ($4) returned to StarsAbove
StarsAbove collected $6.18 from pot
StarsAbove: doesn't show hand 
*** SUMMARY ***
Total pot $6.50 | Rake $0.32 
Board [Th 5d Kc 8c]
Seat 1: tipner folded before Flop (didn't bet)
Seat 2: butcheN18 (button) folded before Flop (didn't bet)
Seat 3: aseban11 (small blind) folded before Flop
Seat 4: Effort92 (big blind) folded on the Turn
Seat 5: StarsAbove collected ($6.18)
Seat 7: yoshidao folded before Flop (didn't bet)
Seat 8: djammusic folded before Flop (didn't bet)
Seat 9: matiko09 folded before Flop (didn't bet)





PokerStars Hand #151942371854:  Hold'em No Limit ($0.50/$1.00 USD) - 2016/04/15 13:19:51 CET [2016/04/15 7:19:51 ET]
Table 'Lamberta III' 9-max Seat #7 is the button
Seat 1: Westpants ($104 in chips) 
Seat 2: Biscuit270 ($47.50 in chips) 
Seat 3: butcheN18 ($184.91 in chips) 
Seat 4: Filojoes ($104.59 in chips) 
Seat 6: aseban11 ($100.68 in chips) 
Seat 7: aleks2112198 ($71.25 in chips) 
Seat 8: wangzhuoming ($108.30 in chips) 
Seat 9: matiko09 ($158.86 in chips) 
wangzhuoming: posts small blind $0.50
matiko09: posts big blind $1
tipner: sits out 
*** HOLE CARDS ***
Dealt to matiko09 [Ks Qc]
Westpants: folds 
Biscuit270: folds 
butcheN18: folds 
Filojoes: folds 
aseban11: folds 
aleks2112198: calls $1
wangzhuoming: folds 
matiko09: raises $3 to $4
aleks2112198: calls $3
*** FLOP *** [8d 4d Tc]
matiko09: checks 
aleks2112198: checks 
*** TURN *** [8d 4d Tc] [9d]
matiko09: checks 
aleks2112198: checks 
*** RIVER *** [8d 4d Tc 9d] [9c]
matiko09: checks 
aleks2112198: bets $5
matiko09: folds 
Uncalled bet ($5) returned to aleks2112198
aleks2112198 collected $8.08 from pot
aleks2112198: doesn't show hand 
*** SUMMARY ***
Total pot $8.50 | Rake $0.42 
Board [8d 4d Tc 9d 9c]
Seat 1: Westpants folded before Flop (didn't bet)
Seat 2: Biscuit270 folded before Flop (didn't bet)
Seat 3: butcheN18 folded before Flop (didn't bet)
Seat 4: Filojoes folded before Flop (didn't bet)
Seat 6: aseban11 folded before Flop (didn't bet)
Seat 7: aleks2112198 (button) collected ($8.08)
Seat 8: wangzhuoming (small blind) folded before Flop
Seat 9: matiko09 (big blind) folded on the River





PokerStars Hand #151942372540:  Hold'em No Limit ($0.50/$1.00 USD) - 2016/04/15 13:19:53 CET [2016/04/15 7:19:53 ET]
Table 'Kreusa II' 9-max Seat #5 is the button
Seat 1: Frosch1907 ($45.13 in chips) 
Seat 2: azzad2007 ($102.50 in chips) 
Seat 4: Filojoes ($100 in chips) 
Seat 5: matiko09 ($120.84 in chips) 
Seat 7: djammusic ($39 in chips) 
Seat 8: rycho222 ($82.01 in chips) 
djammusic: posts small blind $0.50
rycho222: posts big blind $1
*** HOLE CARDS ***
Dealt to matiko09 [6s Td]
Frosch1907: folds 
azzad2007: folds 
Filojoes: raises $1.50 to $2.50
mr. four-eye joins the table at seat #6 
matiko09: folds 
djammusic: folds 
rycho222: folds 
Uncalled bet ($1.50) returned to Filojoes
Filojoes collected $2.50 from pot
Filojoes: doesn't show hand 
*** SUMMARY ***
Total pot $2.50 | Rake $0 
Seat 1: Frosch1907 folded before Flop (didn't bet)
Seat 2: azzad2007 folded before Flop (didn't bet)
Seat 4: Filojoes collected ($2.50)
Seat 5: matiko09 (button) folded before Flop (didn't bet)
Seat 7: djammusic (small blind) folded before Flop
Seat 8: rycho222 (big blind) folded before Flop





PokerStars Hand #151942381982:  Hold'em No Limit ($1/$2 USD) - 2016/04/15 13:20:13 CET [2016/04/15 7:20:13 ET]
Table 'Adele II' 9-max Seat #1 is the button
Seat 1: RyanHuJun ($232.97 in chips) 
Seat 2: Fish4trips ($200 in chips) 
Seat 3: matiko09 ($331.45 in chips) 
Seat 6: wiseyoyo ($208 in chips) 
Seat 8: docmarc777 ($302.71 in chips) 
Seat 9: MiiFuxU ($203.55 in chips) 
Fish4trips: posts small blind $1
matiko09: posts big blind $2
Iggso: sits out 
*** HOLE CARDS ***
Dealt to matiko09 [3c Th]
wiseyoyo: raises $4 to $6
docmarc777: calls $6
MiiFuxU: raises $15.53 to $21.53
RyanHuJun: folds 
Fish4trips: folds 
matiko09: folds 
wiseyoyo: calls $15.53
docmarc777: calls $15.53
*** FLOP *** [6s 5c 4d]
wiseyoyo: checks 
docmarc777: checks 
MiiFuxU: checks 
*** TURN *** [6s 5c 4d] [5d]
wiseyoyo: bets $19.45
docmarc777: calls $19.45
MiiFuxU: calls $19.45
*** RIVER *** [6s 5c 4d 5d] [Jd]
wiseyoyo: checks 
docmarc777: bets $58
MiiFuxU: folds 
wiseyoyo: folds 
Uncalled bet ($58) returned to docmarc777
docmarc777 collected $123.19 from pot
*** SUMMARY ***
Total pot $125.94 | Rake $2.75 
Board [6s 5c 4d 5d Jd]
Seat 1: RyanHuJun (button) folded before Flop (didn't bet)
Seat 2: Fish4trips (small blind) folded before Flop
Seat 3: matiko09 (big blind) folded before Flop
Seat 6: wiseyoyo folded on the River
Seat 8: docmarc777 collected ($123.19)
Seat 9: MiiFuxU folded on the River





PokerStars Hand #151942382420:  Hold'em No Limit ($0.50/$1.00 USD) - 2016/04/15 13:20:14 CET [2016/04/15 7:20:14 ET]
Table 'Chiny II' 9-max Seat #2 is the button
Seat 1: aseban11 ($100 in chips) 
Seat 2: AceFarky ($114.57 in chips) 
Seat 3: powerbel ($42.04 in chips) 
Seat 4: 1000karlos ($90.99 in chips) 
Seat 5: Yaaaazz ($100 in chips) 
Seat 6: choupai ($47.60 in chips) 
Seat 7: matiko09 ($149.38 in chips) 
Seat 8: Filojoes ($105.59 in chips) 
Seat 9: butcheN18 ($100 in chips) 
powerbel: posts small blind $0.50
1000karlos: posts big blind $1
*** HOLE CARDS ***
Dealt to matiko09 [5s Qd]
Yaaaazz: folds 
choupai: folds 
matiko09: folds 
Filojoes: raises $2 to $3
butcheN18: folds 
aseban11: folds 
AceFarky: folds 
powerbel: folds 
1000karlos: folds 
Uncalled bet ($2) returned to Filojoes
Filojoes collected $2.50 from pot
Filojoes: doesn't show hand 
*** SUMMARY ***
Total pot $2.50 | Rake $0 
Seat 1: aseban11 folded before Flop (didn't bet)
Seat 2: AceFarky (button) folded before Flop (didn't bet)
Seat 3: powerbel (small blind) folded before Flop
Seat 4: 1000karlos (big blind) folded before Flop
Seat 5: Yaaaazz folded before Flop (didn't bet)
Seat 6: choupai folded before Flop (didn't bet)
Seat 7: matiko09 folded before Flop (didn't bet)
Seat 8: Filojoes collected ($2.50)
Seat 9: butcheN18 folded before Flop (didn't bet)





PokerStars Hand #151942383338:  Hold'em No Limit ($0.50/$1.00 USD) - 2016/04/15 13:20:16 CET [2016/04/15 7:20:16 ET]
Table 'Cheruskia II' 9-max Seat #9 is the button
Seat 1: vicus1972 ($95.30 in chips) 
Seat 2: SerAlGog ($101.50 in chips) 
Seat 3: butcheN18 ($139.05 in chips) 
Seat 4: djammusic ($43.70 in chips) 
Seat 5: Paul6999 ($74.50 in chips) 
Seat 6: hammerwife ($125.10 in chips) 
Seat 7: matiko09 ($100 in chips) 
Seat 8: ardo888 ($100 in chips) 
Seat 9: rycho222 ($103 in chips) 
vicus1972: posts small blind $0.50
SerAlGog: posts big blind $1
*** HOLE CARDS ***
Dealt to matiko09 [7c 8s]
butcheN18: folds 
djammusic: raises $1.25 to $2.25
Paul6999: folds 
hammerwife: folds 
matiko09: folds 
ardo888: calls $2.25
rycho222: folds 
vicus1972: folds 
SerAlGog: folds 
*** FLOP *** [Kh Th 4s]
djammusic: bets $3.70
ardo888: folds 
Uncalled bet ($3.70) returned to djammusic
djammusic collected $5.70 from pot
djammusic: doesn't show hand 
*** SUMMARY ***
Total pot $6 | Rake $0.30 
Board [Kh Th 4s]
Seat 1: vicus1972 (small blind) folded before Flop
Seat 2: SerAlGog (big blind) folded before Flop
Seat 3: butcheN18 folded before Flop (didn't bet)
Seat 4: djammusic collected ($5.70)
Seat 5: Paul6999 folded before Flop (didn't bet)
Seat 6: hammerwife folded before Flop (didn't bet)
Seat 7: matiko09 folded before Flop (didn't bet)
Seat 8: ardo888 folded on the Flop
Seat 9: rycho222 (button) folded before Flop (didn't bet)





PokerStars Hand #151942384718:  Hold'em No Limit ($0.50/$1.00 USD) - 2016/04/15 13:20:19 CET [2016/04/15 7:20:19 ET]
Table 'Katja II' 9-max Seat #6 is the button
Seat 1: Filojoes ($100 in chips) 
Seat 2: TheJokerMen1 ($54.61 in chips) 
Seat 3: matiko09 ($138.62 in chips) 
Seat 4: Sutt_420 ($75.70 in chips) 
Seat 6: ASG2016 ($110.54 in chips) 
Seat 7: Effort92 ($105.67 in chips) 
Seat 9: hardeep13 ($62.41 in chips) 
Effort92: posts small blind $0.50
hardeep13: posts big blind $1
*** HOLE CARDS ***
Dealt to matiko09 [Ac 6h]
Filojoes: folds 
TheJokerMen1: raises $1 to $2
matiko09: folds 
Sutt_420: folds 
ASG2016: folds 
Effort92: folds 
hardeep13: folds 
Uncalled bet ($1) returned to TheJokerMen1
TheJokerMen1 collected $2.50 from pot
TheJokerMen1: doesn't show hand 
*** SUMMARY ***
Total pot $2.50 | Rake $0 
Seat 1: Filojoes folded before Flop (didn't bet)
Seat 2: TheJokerMen1 collected ($2.50)
Seat 3: matiko09 folded before Flop (didn't bet)
Seat 4: Sutt_420 folded before Flop (didn't bet)
Seat 6: ASG2016 (button) folded before Flop (didn't bet)
Seat 7: Effort92 (small blind) folded before Flop
Seat 9: hardeep13 (big blind) folded before Flop





PokerStars Hand #151942386798:  Hold'em No Limit ($0.50/$1.00 USD) - 2016/04/15 13:20:23 CET [2016/04/15 7:20:23 ET]
Table 'Matterania III' 9-max Seat #6 is the button
Seat 1: di0d80 ($109.18 in chips) 
Seat 3: ardo888 ($154.90 in chips) 
Seat 4: wangzhuoming ($79.12 in chips) 
Seat 5: Vermm ($82.14 in chips) 
Seat 6: matiko09 ($100.40 in chips) 
Seat 7: Filojoes ($101.30 in chips) 
Seat 8: Jimy Tiltman ($102.30 in chips) 
Seat 9: butcheN18 ($104.90 in chips) 
Filojoes: posts small blind $0.50
Jimy Tiltman: posts big blind $1
haoyuan541: sits out 
di0d80: posts the ante $0.20
ardo888: posts the ante $0.20
wangzhuoming: posts the ante $0.20
Vermm: posts the ante $0.20
matiko09: posts the ante $0.20
Filojoes: posts the ante $0.20
Jimy Tiltman: posts the ante $0.20
butcheN18: posts the ante $0.20
*** HOLE CARDS ***
Dealt to matiko09 [Jc Ah]
butcheN18: folds 
di0d80: folds 
ardo888: folds 
wangzhuoming: folds 
Vermm: folds 
matiko09: raises $1.50 to $2.50
Filojoes: folds 
Jimy Tiltman: calls $1.50
*** FLOP *** [6h Js 7s]
Jimy Tiltman: checks 
matiko09: bets $4.38
Jimy Tiltman: folds 
Uncalled bet ($4.38) returned to matiko09
matiko09 collected $6.74 from pot
matiko09: doesn't show hand 
*** SUMMARY ***
Total pot $7.10 | Rake $0.36 
Board [6h Js 7s]
Seat 1: di0d80 folded before Flop (didn't bet)
Seat 3: ardo888 folded before Flop (didn't bet)
Seat 4: wangzhuoming folded before Flop (didn't bet)
Seat 5: Vermm folded before Flop (didn't bet)
Seat 6: matiko09 (button) collected ($6.74)
Seat 7: Filojoes (small blind) folded before Flop
Seat 8: Jimy Tiltman (big blind) folded on the Flop
Seat 9: butcheN18 folded before Flop (didn't bet)





PokerStars Hand #151942390245:  Hold'em No Limit ($0.50/$1.00 USD) - 2016/04/15 13:20:30 CET [2016/04/15 7:20:30 ET]
Table 'Kreusa II' 9-max Seat #7 is the button
Seat 1: Frosch1907 ($45.13 in chips) 
Seat 2: azzad2007 ($102.50 in chips) 
Seat 4: Filojoes ($101.50 in chips) 
Seat 5: matiko09 ($120.84 in chips) 
Seat 6: mr. four-eye ($100 in chips) 
Seat 7: djammusic ($38.50 in chips) 
Seat 8: rycho222 ($100 in chips) 
rycho222: posts small blind $0.50
Frosch1907: posts big blind $1
mr. four-eye: posts big blind $1
*** HOLE CARDS ***
Dealt to matiko09 [6h 4s]
azzad2007: raises $3 to $4
Filojoes: folds 
matiko09: folds 
mr. four-eye: folds 
djammusic: folds 
rycho222: raises $10 to $14
Frosch1907: folds 
azzad2007: folds 
Uncalled bet ($10) returned to rycho222
rycho222 collected $10 from pot
rycho222: doesn't show hand 
*** SUMMARY ***
Total pot $10 | Rake $0 
Seat 1: Frosch1907 (big blind) folded before Flop
Seat 2: azzad2007 folded before Flop
Seat 4: Filojoes folded before Flop (didn't bet)
Seat 5: matiko09 folded before Flop (didn't bet)
Seat 6: mr. four-eye folded before Flop
Seat 7: djammusic (button) folded before Flop (didn't bet)
Seat 8: rycho222 (small blind) collected ($10)





PokerStars Hand #151942395151:  Hold'em No Limit ($0.50/$1.00 USD) - 2016/04/15 13:20:41 CET [2016/04/15 7:20:41 ET]
Table 'Lamberta III' 9-max Seat #8 is the button
Seat 1: Westpants ($104 in chips) 
Seat 2: Biscuit270 ($47.50 in chips) 
Seat 3: butcheN18 ($184.91 in chips) 
Seat 4: Filojoes ($104.59 in chips) 
Seat 6: aseban11 ($100.68 in chips) 
Seat 7: aleks2112198 ($75.33 in chips) 
Seat 8: wangzhuoming ($107.80 in chips) 
Seat 9: matiko09 ($154.86 in chips) 
matiko09: posts small blind $0.50
Westpants: posts big blind $1
tipner: sits out 
*** HOLE CARDS ***
Dealt to matiko09 [6c Qh]
Biscuit270: calls $1
butcheN18: folds 
Filojoes: folds 
aseban11: raises $3.50 to $4.50
aleks2112198: calls $4.50
wangzhuoming: folds 
matiko09: folds 
Westpants: folds 
Biscuit270: calls $3.50
*** FLOP *** [9c 2h Js]
Biscuit270: checks 
aseban11: bets $10.68
aleks2112198: calls $10.68
Biscuit270: calls $10.68
*** TURN *** [9c 2h Js] [7c]
Biscuit270: checks 
aseban11: checks 
aleks2112198: bets $60.15 and is all-in
Biscuit270: calls $32.32 and is all-in
aseban11: folds 
Uncalled bet ($27.83) returned to aleks2112198
*** RIVER *** [9c 2h Js 7c] [4d]
*** SHOW DOWN ***
Biscuit270: shows [2s 2d] (three of a kind, Deuces)
aleks2112198: shows [7d Jd] (two pair, Jacks and Sevens)
Biscuit270 collected $109.18 from pot
*** SUMMARY ***
Total pot $111.68 | Rake $2.50 
Board [9c 2h Js 7c 4d]
Seat 1: Westpants (big blind) folded before Flop
Seat 2: Biscuit270 showed [2s 2d] and won ($109.18) with three of a kind, Deuces
Seat 3: butcheN18 folded before Flop (didn't bet)
Seat 4: Filojoes folded before Flop (didn't bet)
Seat 6: aseban11 folded on the Turn
Seat 7: aleks2112198 showed [7d Jd] and lost with two pair, Jacks and Sevens
Seat 8: wangzhuoming (button) folded before Flop (didn't bet)
Seat 9: matiko09 (small blind) folded before Flop





PokerStars Hand #151942402120:  Hold'em No Limit ($0.50/$1.00 USD) - 2016/04/15 13:20:55 CET [2016/04/15 7:20:55 ET]
Table 'Navi' 9-max Seat #3 is the button
Seat 1: tipner ($100 in chips) 
Seat 2: butcheN18 ($100 in chips) 
Seat 3: aseban11 ($110.93 in chips) 
Seat 4: Effort92 ($130.13 in chips) 
Seat 7: yoshidao ($153.07 in chips) 
Seat 8: djammusic ($54.59 in chips) 
Seat 9: matiko09 ($100 in chips) 
Effort92: posts small blind $0.50
StarsAbove: is sitting out 
yoshidao: posts big blind $1
*** HOLE CARDS ***
Dealt to matiko09 [6h 8h]
djammusic: folds 
StarsAbove leaves the table
matiko09: folds 
hammerwife joins the table at seat #5 
tipner: folds 
butcheN18: raises $1.44 to $2.44
aseban11 has timed out
aseban11: folds 
Effort92: folds 
yoshidao: folds 
Uncalled bet ($1.44) returned to butcheN18
butcheN18 collected $2.50 from pot
butcheN18: doesn't show hand 
*** SUMMARY ***
Total pot $2.50 | Rake $0 
Seat 1: tipner folded before Flop (didn't bet)
Seat 2: butcheN18 collected ($2.50)
Seat 3: aseban11 (button) folded before Flop (didn't bet)
Seat 4: Effort92 (small blind) folded before Flop
Seat 7: yoshidao (big blind) folded before Flop
Seat 8: djammusic folded before Flop (didn't bet)
Seat 9: matiko09 folded before Flop (didn't bet)





PokerStars Hand #151942406006:  Hold'em No Limit ($0.50/$1.00 USD) - 2016/04/15 13:21:04 CET [2016/04/15 7:21:04 ET]
Table 'Chiny II' 9-max Seat #3 is the button
Seat 1: aseban11 ($100 in chips) 
Seat 2: AceFarky ($114.57 in chips) 
Seat 3: powerbel ($41.54 in chips) 
Seat 4: 1000karlos ($89.99 in chips) 
Seat 5: Yaaaazz ($100 in chips) 
Seat 6: choupai ($47.60 in chips) 
Seat 7: matiko09 ($149.38 in chips) 
Seat 8: Filojoes ($107.09 in chips) 
Seat 9: butcheN18 ($100 in chips) 
1000karlos: posts small blind $0.50
Yaaaazz: posts big blind $1
*** HOLE CARDS ***
Dealt to matiko09 [3s Th]
choupai: raises $2 to $3
matiko09: folds 
Filojoes: folds 
butcheN18: folds 
aseban11: folds 
AceFarky: folds 
powerbel: calls $3
1000karlos: folds 
Yaaaazz: folds 
*** FLOP *** [9c Qh 8h]
choupai: bets $4
powerbel: calls $4
*** TURN *** [9c Qh 8h] [Jh]
choupai: checks 
powerbel: checks 
*** RIVER *** [9c Qh 8h Jh] [9s]
choupai: checks 
powerbel: checks 
*** SHOW DOWN ***
choupai: shows [Ad Kd] (a pair of Nines)
powerbel: shows [As Kc] (a pair of Nines)
choupai collected $7.36 from pot
powerbel collected $7.36 from pot
*** SUMMARY ***
Total pot $15.50 | Rake $0.78 
Board [9c Qh 8h Jh 9s]
Seat 1: aseban11 folded before Flop (didn't bet)
Seat 2: AceFarky folded before Flop (didn't bet)
Seat 3: powerbel (button) showed [As Kc] and won ($7.36) with a pair of Nines
Seat 4: 1000karlos (small blind) folded before Flop
Seat 5: Yaaaazz (big blind) folded before Flop
Seat 6: choupai showed [Ad Kd] and won ($7.36) with a pair of Nines
Seat 7: matiko09 folded before Flop (didn't bet)
Seat 8: Filojoes folded before Flop (didn't bet)
Seat 9: butcheN18 folded before Flop (didn't bet)





PokerStars Hand #151942408036:  Hold'em No Limit ($0.50/$1.00 USD) - 2016/04/15 13:21:08 CET [2016/04/15 7:21:08 ET]
Table 'Kreusa II' 9-max Seat #8 is the button
Seat 1: Frosch1907 ($44.13 in chips) 
Seat 2: azzad2007 ($100 in chips) 
Seat 4: Filojoes ($101.50 in chips) 
Seat 5: matiko09 ($120.84 in chips) 
Seat 6: mr. four-eye ($99 in chips) 
Seat 7: djammusic ($38.50 in chips) 
Seat 8: rycho222 ($106 in chips) 
Frosch1907: posts small blind $0.50
azzad2007: posts big blind $1
*** HOLE CARDS ***
Dealt to matiko09 [Qs 3s]
Filojoes: folds 
matiko09: folds 
mr. four-eye: folds 
djammusic: raises $1.02 to $2.02
rycho222: calls $2.02
Frosch1907: calls $1.52
azzad2007: folds 
*** FLOP *** [7s As Ts]
Frosch1907: checks 
djammusic: checks 
rycho222: checks 
*** TURN *** [7s As Ts] [Kd]
Frosch1907: checks 
djammusic: bets $2.68
rycho222: folds 
Frosch1907: folds 
Uncalled bet ($2.68) returned to djammusic
djammusic collected $6.71 from pot
djammusic: doesn't show hand 
*** SUMMARY ***
Total pot $7.06 | Rake $0.35 
Board [7s As Ts Kd]
Seat 1: Frosch1907 (small blind) folded on the Turn
Seat 2: azzad2007 (big blind) folded before Flop
Seat 4: Filojoes folded before Flop (didn't bet)
Seat 5: matiko09 folded before Flop (didn't bet)
Seat 6: mr. four-eye folded before Flop (didn't bet)
Seat 7: djammusic collected ($6.71)
Seat 8: rycho222 (button) folded on the Turn





PokerStars Hand #151942409627:  Hold'em No Limit ($0.50/$1.00 USD) - 2016/04/15 13:21:11 CET [2016/04/15 7:21:11 ET]
Table 'Matterania III' 9-max Seat #7 is the button
Seat 1: di0d80 ($108.98 in chips) 
Seat 3: ardo888 ($154.70 in chips) 
Seat 4: wangzhuoming ($78.92 in chips) 
Seat 5: Vermm ($81.94 in chips) 
Seat 6: matiko09 ($104.44 in chips) 
Seat 7: Filojoes ($100.60 in chips) 
Seat 8: Jimy Tiltman ($100 in chips) 
Seat 9: butcheN18 ($104.70 in chips) 
Jimy Tiltman: posts small blind $0.50
butcheN18: posts big blind $1
haoyuan541: sits out 
di0d80: posts the ante $0.20
ardo888: posts the ante $0.20
wangzhuoming: posts the ante $0.20
Vermm: posts the ante $0.20
matiko09: posts the ante $0.20
Filojoes: posts the ante $0.20
Jimy Tiltman: posts the ante $0.20
butcheN18: posts the ante $0.20
*** HOLE CARDS ***
Dealt to matiko09 [Jh 2d]
di0d80: folds 
ardo888: folds 
wangzhuoming: folds 
Vermm: raises $2 to $3
matiko09: folds 
Filojoes: raises $6 to $9
Jimy Tiltman: folds 
butcheN18: folds 
Vermm: raises $12 to $21
Filojoes: calls $12
*** FLOP *** [6h 4h Td]
Vermm: bets $21.42
Filojoes: folds 
Uncalled bet ($21.42) returned to Vermm
Vermm collected $42.84 from pot
Vermm: doesn't show hand 
*** SUMMARY ***
Total pot $45.10 | Rake $2.26 
Board [6h 4h Td]
Seat 1: di0d80 folded before Flop (didn't bet)
Seat 3: ardo888 folded before Flop (didn't bet)
Seat 4: wangzhuoming folded before Flop (didn't bet)
Seat 5: Vermm collected ($42.84)
Seat 6: matiko09 folded before Flop (didn't bet)
Seat 7: Filojoes (button) folded on the Flop
Seat 8: Jimy Tiltman (small blind) folded before Flop
Seat 9: butcheN18 (big blind) folded before Flop





PokerStars Hand #151942410984:  Hold'em No Limit ($1/$2 USD) - 2016/04/15 13:21:14 CET [2016/04/15 7:21:14 ET]
Table 'Oceax' 9-max Seat #6 is the button
Seat 1: matiko09 ($200 in chips) 
Seat 2: Fish4trips ($318.36 in chips) 
Seat 3: MiiFuxU ($200 in chips) 
Seat 4: butcheN18 ($230.17 in chips) 
Seat 5: di0d80 ($206 in chips) 
Seat 6: Iggso ($200 in chips) 
Seat 7: djlaw321 ($158 in chips) 
djlaw321: posts small blind $1
Olddogtom888 has timed out while being disconnected
Olddogtom888: is sitting out 
matiko09: posts big blind $2
*** HOLE CARDS ***
Dealt to matiko09 [5s Jd]
Fish4trips: raises $3 to $5
MiiFuxU: folds 
Olddogtom888 is disconnected 
Poroxide joins the table at seat #8 
butcheN18: folds 
di0d80: folds 
Iggso: raises $13.26 to $18.26
djlaw321: folds 
matiko09: folds 
Fish4trips: folds 
Uncalled bet ($13.26) returned to Iggso
Iggso collected $13 from pot
Iggso: doesn't show hand 
*** SUMMARY ***
Total pot $13 | Rake $0 
Seat 1: matiko09 (big blind) folded before Flop
Seat 2: Fish4trips folded before Flop
Seat 3: MiiFuxU folded before Flop (didn't bet)
Seat 4: butcheN18 folded before Flop (didn't bet)
Seat 5: di0d80 folded before Flop (didn't bet)
Seat 6: Iggso (button) collected ($13)
Seat 7: djlaw321 (small blind) folded before Flop





PokerStars Hand #151942411631:  Hold'em No Limit ($1/$2 USD) - 2016/04/15 13:21:16 CET [2016/04/15 7:21:16 ET]
Table 'Patroclus II' 9-max Seat #7 is the button
Seat 1: TonnaMunz ($200 in chips) 
Seat 2: Moemors ($151.65 in chips) 
Seat 3: Koolniknik ($203.85 in chips) 
Seat 4: tipner ($240.25 in chips) 
Seat 5: butcheN18 ($209 in chips) 
Seat 6: di0d80 ($200 in chips) 
Seat 7: matiko09 ($207.05 in chips) 
Seat 9: Fish4trips ($238.72 in chips) 
Fish4trips: posts small blind $1
TonnaMunz: posts big blind $2
*** HOLE CARDS ***
Dealt to matiko09 [Kh Tc]
Moemors: folds 
Koolniknik: folds 
tipner: folds 
butcheN18: folds 
di0d80: folds 
matiko09: raises $2.54 to $4.54
Fish4trips: folds 
TonnaMunz: calls $2.54
*** FLOP *** [Kc Jh 7s]
TonnaMunz: checks 
matiko09: checks 
*** TURN *** [Kc Jh 7s] [As]
TonnaMunz: bets $16
matiko09: folds 
Uncalled bet ($16) returned to TonnaMunz
TonnaMunz collected $9.58 from pot
TonnaMunz: doesn't show hand 
*** SUMMARY ***
Total pot $10.08 | Rake $0.50 
Board [Kc Jh 7s As]
Seat 1: TonnaMunz (big blind) collected ($9.58)
Seat 2: Moemors folded before Flop (didn't bet)
Seat 3: Koolniknik folded before Flop (didn't bet)
Seat 4: tipner folded before Flop (didn't bet)
Seat 5: butcheN18 folded before Flop (didn't bet)
Seat 6: di0d80 folded before Flop (didn't bet)
Seat 7: matiko09 (button) folded on the Turn
Seat 9: Fish4trips (small blind) folded before Flop





PokerStars Hand #151942412237:  Hold'em No Limit ($0.50/$1.00 USD) - 2016/04/15 13:21:17 CET [2016/04/15 7:21:17 ET]
Table 'Katja II' 9-max Seat #7 is the button
Seat 1: Filojoes ($100 in chips) 
Seat 2: TheJokerMen1 ($56.11 in chips) 
Seat 3: matiko09 ($138.62 in chips) 
Seat 4: Sutt_420 ($75.70 in chips) 
Seat 6: ASG2016 ($110.54 in chips) 
Seat 7: Effort92 ($105.17 in chips) 
Seat 9: hardeep13 ($61.41 in chips) 
hardeep13: posts small blind $0.50
Filojoes: posts big blind $1
*** HOLE CARDS ***
Dealt to matiko09 [7h 6c]
TheJokerMen1: folds 
matiko09: folds 
Sutt_420: raises $1 to $2
ASG2016: folds 
Effort92: folds 
hardeep13: calls $1.50
Filojoes: folds 
*** FLOP *** [4h Qs 9h]
Dachish is disconnected 
hardeep13: bets $3
Sutt_420: calls $3
*** TURN *** [4h Qs 9h] [3h]
hardeep13: bets $8
Sutt_420: folds 
Uncalled bet ($8) returned to hardeep13
hardeep13 collected $10.45 from pot
hardeep13: doesn't show hand 
*** SUMMARY ***
Total pot $11 | Rake $0.55 
Board [4h Qs 9h 3h]
Seat 1: Filojoes (big blind) folded before Flop
Seat 2: TheJokerMen1 folded before Flop (didn't bet)
Seat 3: matiko09 folded before Flop (didn't bet)
Seat 4: Sutt_420 folded on the Turn
Seat 6: ASG2016 folded before Flop (didn't bet)
Seat 7: Effort92 (button) folded before Flop (didn't bet)
Seat 9: hardeep13 (small blind) collected ($10.45)





PokerStars Hand #151942418545:  Hold'em No Limit ($1/$2 USD) - 2016/04/15 13:21:30 CET [2016/04/15 7:21:30 ET]
Table 'Adele II' 9-max Seat #2 is the button
Seat 1: RyanHuJun ($232.97 in chips) 
Seat 2: Fish4trips ($200 in chips) 
Seat 3: matiko09 ($329.45 in chips) 
Seat 6: wiseyoyo ($200 in chips) 
Seat 8: docmarc777 ($384.92 in chips) 
Seat 9: MiiFuxU ($200 in chips) 
matiko09: posts small blind $1
wiseyoyo: posts big blind $2
Iggso: sits out 
*** HOLE CARDS ***
Dealt to matiko09 [2s 2c]
docmarc777: folds 
MiiFuxU: folds 
RyanHuJun: raises $2 to $4
Fish4trips: folds 
matiko09: calls $3
wiseyoyo: raises $16 to $20
RyanHuJun: folds 
matiko09: folds 
Uncalled bet ($16) returned to wiseyoyo
wiseyoyo collected $12 from pot
wiseyoyo: doesn't show hand 
*** SUMMARY ***
Total pot $12 | Rake $0 
Seat 1: RyanHuJun folded before Flop
Seat 2: Fish4trips (button) folded before Flop (didn't bet)
Seat 3: matiko09 (small blind) folded before Flop
Seat 6: wiseyoyo (big blind) collected ($12)
Seat 8: docmarc777 folded before Flop (didn't bet)
Seat 9: MiiFuxU folded before Flop (didn't bet)





PokerStars Hand #151942423613:  Hold'em No Limit ($0.50/$1.00 USD) - 2016/04/15 13:21:41 CET [2016/04/15 7:21:41 ET]
Table 'Parvulesco II' 9-max Seat #1 is the button
Seat 1: bilukm ($76.98 in chips) 
Seat 2: SerAlGog ($245.75 in chips) 
Seat 3: matiko09 ($100 in chips) 
Seat 4: butcheN18 ($101.81 in chips) 
Seat 5: bronbeek ($72.77 in chips) 
Seat 7: djammusic ($40 in chips) 
Seat 9: hammerwife ($211.38 in chips) 
SerAlGog: posts small blind $0.50
matiko09: posts big blind $1
Jimy Tiltman: sits out 
*** HOLE CARDS ***
Dealt to matiko09 [8h 5c]
butcheN18: folds 
bronbeek: calls $1
djammusic: folds 
hammerwife: folds 
bilukm: raises $3.50 to $4.50
SerAlGog: raises $9 to $13.50
matiko09: folds 
bronbeek: folds 
bilukm: calls $9
*** FLOP *** [Ks 2d 4h]
SerAlGog: bets $14.05
bilukm: calls $14.05
*** TURN *** [Ks 2d 4h] [Ts]
SerAlGog: checks 
bilukm: checks 
*** RIVER *** [Ks 2d 4h Ts] [Ac]
SerAlGog: checks 
bilukm: checks 
*** SHOW DOWN ***
SerAlGog: shows [Qh Qs] (a pair of Queens)
bilukm: mucks hand 
SerAlGog collected $54.60 from pot
*** SUMMARY ***
Total pot $57.10 | Rake $2.50 
Board [Ks 2d 4h Ts Ac]
Seat 1: bilukm (button) mucked [8c 8d]
Seat 2: SerAlGog (small blind) showed [Qh Qs] and won ($54.60) with a pair of Queens
Seat 3: matiko09 (big blind) folded before Flop
Seat 4: butcheN18 folded before Flop (didn't bet)
Seat 5: bronbeek folded before Flop
Seat 7: djammusic folded before Flop (didn't bet)
Seat 9: hammerwife folded before Flop (didn't bet)





PokerStars Hand #151942423974:  Hold'em No Limit ($0.50/$1.00 USD) - 2016/04/15 13:21:42 CET [2016/04/15 7:21:42 ET]
Table 'Cheruskia II' 9-max Seat #1 is the button
Seat 1: vicus1972 ($94.80 in chips) 
Seat 2: SerAlGog ($100.50 in chips) 
Seat 3: butcheN18 ($139.05 in chips) 
Seat 4: djammusic ($47.15 in chips) 
Seat 5: Paul6999 ($74.50 in chips) 
Seat 6: hammerwife ($125.10 in chips) 
Seat 7: matiko09 ($100 in chips) 
Seat 8: ardo888 ($100 in chips) 
Seat 9: rycho222 ($103 in chips) 
SerAlGog: posts small blind $0.50
butcheN18: posts big blind $1
*** HOLE CARDS ***
Dealt to matiko09 [3d 8s]
djammusic: folds 
Paul6999: raises $1 to $2
hammerwife: folds 
matiko09: folds 
ardo888: folds 
rycho222: folds 
vicus1972: folds 
SerAlGog: folds 
butcheN18: folds 
Uncalled bet ($1) returned to Paul6999
Paul6999 collected $2.50 from pot
Paul6999: doesn't show hand 
*** SUMMARY ***
Total pot $2.50 | Rake $0 
Seat 1: vicus1972 (button) folded before Flop (didn't bet)
Seat 2: SerAlGog (small blind) folded before Flop
Seat 3: butcheN18 (big blind) folded before Flop
Seat 4: djammusic folded before Flop (didn't bet)
Seat 5: Paul6999 collected ($2.50)
Seat 6: hammerwife folded before Flop (didn't bet)
Seat 7: matiko09 folded before Flop (didn't bet)
Seat 8: ardo888 folded before Flop (didn't bet)
Seat 9: rycho222 folded before Flop (didn't bet)





PokerStars Hand #151942425136:  Hold'em No Limit ($0.50/$1.00 USD) - 2016/04/15 13:21:44 CET [2016/04/15 7:21:44 ET]
Table 'Lamberta III' 9-max Seat #9 is the button
Seat 1: Westpants ($103 in chips) 
Seat 2: Biscuit270 ($109.18 in chips) 
Seat 3: butcheN18 ($184.91 in chips) 
Seat 4: Filojoes ($104.59 in chips) 
Seat 6: aseban11 ($100 in chips) 
Seat 7: aleks2112198 ($27.83 in chips) 
Seat 8: wangzhuoming ($107.80 in chips) 
Seat 9: matiko09 ($154.36 in chips) 
Westpants: posts small blind $0.50
Biscuit270: posts big blind $1
tipner: sits out 
*** HOLE CARDS ***
Dealt to matiko09 [Jc 9h]
butcheN18: raises $2 to $3
Filojoes: folds 
aseban11: folds 
aleks2112198: calls $3
wangzhuoming: folds 
matiko09: folds 
Westpants: folds 
Biscuit270: folds 
*** FLOP *** [4d Js 2s]
butcheN18: bets $5
aleks2112198: calls $5
*** TURN *** [4d Js 2s] [6h]
butcheN18: bets $10.63
aleks2112198: calls $10.63
*** RIVER *** [4d Js 2s 6h] [6d]
butcheN18: bets $12
aleks2112198: folds 
Uncalled bet ($12) returned to butcheN18
butcheN18 collected $36.82 from pot
butcheN18: doesn't show hand 
*** SUMMARY ***
Total pot $38.76 | Rake $1.94 
Board [4d Js 2s 6h 6d]
Seat 1: Westpants (small blind) folded before Flop
Seat 2: Biscuit270 (big blind) folded before Flop
Seat 3: butcheN18 collected ($36.82)
Seat 4: Filojoes folded before Flop (didn't bet)
Seat 6: aseban11 folded before Flop (didn't bet)
Seat 7: aleks2112198 folded on the River
Seat 8: wangzhuoming folded before Flop (didn't bet)
Seat 9: matiko09 (button) folded before Flop (didn't bet)





PokerStars Hand #151942427784:  Hold'em No Limit ($0.50/$1.00 USD) - 2016/04/15 13:21:50 CET [2016/04/15 7:21:50 ET]
Table 'Navi' 9-max Seat #4 is the button
Seat 1: tipner ($100 in chips) 
Seat 2: butcheN18 ($101.50 in chips) 
Seat 4: Effort92 ($129.63 in chips) 
Seat 7: yoshidao ($152.07 in chips) 
Seat 8: djammusic ($54.59 in chips) 
Seat 9: matiko09 ($100 in chips) 
hammerwife will be allowed to play after the button
yoshidao: posts small blind $0.50
djammusic: posts big blind $1
*** HOLE CARDS ***
Dealt to matiko09 [Kc Ks]
matiko09: raises $2 to $3
tipner: folds 
butcheN18: folds 
Effort92: folds 
yoshidao: calls $2.50
djammusic: folds 
*** FLOP *** [6d 9s 8h]
yoshidao: bets $7
matiko09: calls $7
*** TURN *** [6d 9s 8h] [8c]
yoshidao: checks 
matiko09: bets $12.50
yoshidao: folds 
Uncalled bet ($12.50) returned to matiko09
matiko09 collected $19.95 from pot
matiko09: doesn't show hand 
*** SUMMARY ***
Total pot $21 | Rake $1.05 
Board [6d 9s 8h 8c]
Seat 1: tipner folded before Flop (didn't bet)
Seat 2: butcheN18 folded before Flop (didn't bet)
Seat 4: Effort92 (button) folded before Flop (didn't bet)
Seat 7: yoshidao (small blind) folded on the Turn
Seat 8: djammusic (big blind) folded before Flop
Seat 9: matiko09 collected ($19.95)





PokerStars Hand #151942431727:  Hold'em No Limit ($1/$2 USD) - 2016/04/15 13:21:58 CET [2016/04/15 7:21:58 ET]
Table 'Adele II' 9-max Seat #3 is the button
Seat 1: RyanHuJun ($228.97 in chips) 
Seat 2: Fish4trips ($200 in chips) 
Seat 3: matiko09 ($325.45 in chips) 
Seat 6: wiseyoyo ($208 in chips) 
Seat 7: Iggso ($200 in chips) 
Seat 8: docmarc777 ($384.92 in chips) 
Seat 9: MiiFuxU ($200 in chips) 
wiseyoyo: posts small blind $1
Iggso: posts big blind $2
*** HOLE CARDS ***
Dealt to matiko09 [4s Kd]
docmarc777: folds 
MiiFuxU: folds 
RyanHuJun: folds 
Fish4trips: folds 
matiko09: folds 
wiseyoyo: raises $3.02 to $5.02
Iggso: calls $3.02
*** FLOP *** [Jh 8h 9d]
wiseyoyo: checks 
Iggso: bets $6.01
wiseyoyo: calls $6.01
*** TURN *** [Jh 8h 9d] [9c]
wiseyoyo: checks 
Iggso: checks 
*** RIVER *** [Jh 8h 9d 9c] [7h]
wiseyoyo: checks 
Iggso: checks 
*** SHOW DOWN ***
wiseyoyo: shows [Js 5s] (two pair, Jacks and Nines)
Iggso: mucks hand 
wiseyoyo collected $20.96 from pot
*** SUMMARY ***
Total pot $22.06 | Rake $1.10 
Board [Jh 8h 9d 9c 7h]
Seat 1: RyanHuJun folded before Flop (didn't bet)
Seat 2: Fish4trips folded before Flop (didn't bet)
Seat 3: matiko09 (button) folded before Flop (didn't bet)
Seat 6: wiseyoyo (small blind) showed [Js 5s] and won ($20.96) with two pair, Jacks and Nines
Seat 7: Iggso (big blind) mucked [2c 4c]
Seat 8: docmarc777 folded before Flop (didn't bet)
Seat 9: MiiFuxU folded before Flop (didn't bet)





PokerStars Hand #151942433025:  Hold'em No Limit ($1/$2 USD) - 2016/04/15 13:22:00 CET [2016/04/15 7:22:00 ET]
Table 'Patroclus II' 9-max Seat #9 is the button
Seat 1: TonnaMunz ($205.04 in chips) 
Seat 2: Moemors ($151.65 in chips) 
Seat 3: Koolniknik ($203.85 in chips) 
Seat 4: tipner ($240.25 in chips) 
Seat 5: butcheN18 ($209 in chips) 
Seat 6: di0d80 ($200 in chips) 
Seat 7: matiko09 ($202.51 in chips) 
Seat 9: Fish4trips ($237.72 in chips) 
TonnaMunz: posts small blind $1
Moemors: posts big blind $2
*** HOLE CARDS ***
Dealt to matiko09 [6c As]
Koolniknik: folds 
tipner: raises $4 to $6
butcheN18: calls $6
di0d80: folds 
matiko09: folds 
Fish4trips: calls $6
TonnaMunz: folds 
Moemors: folds 
*** FLOP *** [6h 5s Td]
tipner: checks 
butcheN18: bets $12.76
Fish4trips: folds 
tipner: calls $12.76
*** TURN *** [6h 5s Td] [6d]
tipner: checks 
butcheN18: bets $28.28
tipner: calls $28.28
*** RIVER *** [6h 5s Td 6d] [Kh]
tipner: checks 
butcheN18: checks 
*** SHOW DOWN ***
tipner: shows [Tc 8c] (two pair, Tens and Sixes)
butcheN18: shows [Qc Qd] (two pair, Queens and Sixes)
butcheN18 collected $100.33 from pot
*** SUMMARY ***
Total pot $103.08 | Rake $2.75 
Board [6h 5s Td 6d Kh]
Seat 1: TonnaMunz (small blind) folded before Flop
Seat 2: Moemors (big blind) folded before Flop
Seat 3: Koolniknik folded before Flop (didn't bet)
Seat 4: tipner showed [Tc 8c] and lost with two pair, Tens and Sixes
Seat 5: butcheN18 showed [Qc Qd] and won ($100.33) with two pair, Queens and Sixes
Seat 6: di0d80 folded before Flop (didn't bet)
Seat 7: matiko09 folded before Flop (didn't bet)
Seat 9: Fish4trips (button) folded on the Flop





PokerStars Hand #151942437912:  Hold'em No Limit ($0.50/$1.00 USD) - 2016/04/15 13:22:11 CET [2016/04/15 7:22:11 ET]
Table 'Cheruskia II' 9-max Seat #2 is the button
Seat 1: vicus1972 ($94.80 in chips) 
Seat 2: SerAlGog ($100 in chips) 
Seat 3: butcheN18 ($138.05 in chips) 
Seat 4: djammusic ($47.15 in chips) 
Seat 5: Paul6999 ($76 in chips) 
Seat 6: hammerwife ($125.10 in chips) 
Seat 7: matiko09 ($100 in chips) 
Seat 8: ardo888 ($100 in chips) 
Seat 9: rycho222 ($103 in chips) 
butcheN18: posts small blind $0.50
djammusic: posts big blind $1
*** HOLE CARDS ***
Dealt to matiko09 [Tc 5d]
Paul6999: folds 
hammerwife: folds 
matiko09: folds 
ardo888: folds 
rycho222: folds 
vicus1972: raises $1.20 to $2.20
SerAlGog: folds 
butcheN18: folds 
djammusic: folds 
Uncalled bet ($1.20) returned to vicus1972
vicus1972 collected $2.50 from pot
*** SUMMARY ***
Total pot $2.50 | Rake $0 
Seat 1: vicus1972 collected ($2.50)
Seat 2: SerAlGog (button) folded before Flop (didn't bet)
Seat 3: butcheN18 (small blind) folded before Flop
Seat 4: djammusic (big blind) folded before Flop
Seat 5: Paul6999 folded before Flop (didn't bet)
Seat 6: hammerwife folded before Flop (didn't bet)
Seat 7: matiko09 folded before Flop (didn't bet)
Seat 8: ardo888 folded before Flop (didn't bet)
Seat 9: rycho222 folded before Flop (didn't bet)





PokerStars Hand #151942439718:  Hold'em No Limit ($1/$2 USD) - 2016/04/15 13:22:14 CET [2016/04/15 7:22:14 ET]
Table 'Oceax' 9-max Seat #7 is the button
Seat 1: matiko09 ($200 in chips) 
Seat 2: Fish4trips ($313.36 in chips) 
Seat 3: MiiFuxU ($200 in chips) 
Seat 4: butcheN18 ($230.17 in chips) 
Seat 5: di0d80 ($206 in chips) 
Seat 6: Iggso ($208 in chips) 
Seat 7: djlaw321 ($157 in chips) 
Poroxide will be allowed to play after the button
Olddogtom888 will be allowed to play after the button
matiko09: posts small blind $1
Fish4trips: posts big blind $2
*** HOLE CARDS ***
Dealt to matiko09 [Jh Qc]
MiiFuxU: folds 
butcheN18: raises $4 to $6
di0d80: folds 
Iggso: folds 
djlaw321: calls $6
matiko09: folds 
Fish4trips: folds 
*** FLOP *** [Ah Td 3s]
butcheN18: bets $9.12
djlaw321: folds 
Uncalled bet ($9.12) returned to butcheN18
butcheN18 collected $14.25 from pot
butcheN18: doesn't show hand 
*** SUMMARY ***
Total pot $15 | Rake $0.75 
Board [Ah Td 3s]
Seat 1: matiko09 (small blind) folded before Flop
Seat 2: Fish4trips (big blind) folded before Flop
Seat 3: MiiFuxU folded before Flop (didn't bet)
Seat 4: butcheN18 collected ($14.25)
Seat 5: di0d80 folded before Flop (didn't bet)
Seat 6: Iggso folded before Flop (didn't bet)
Seat 7: djlaw321 (button) folded on the Flop





PokerStars Hand #151942444581:  Hold'em No Limit ($0.50/$1.00 USD) - 2016/04/15 13:22:25 CET [2016/04/15 7:22:25 ET]
Table 'Chiny II' 9-max Seat #4 is the button
Seat 1: aseban11 ($100 in chips) 
Seat 2: AceFarky ($114.57 in chips) 
Seat 3: powerbel ($41.90 in chips) 
Seat 4: 1000karlos ($89.49 in chips) 
Seat 5: Yaaaazz ($100 in chips) 
Seat 6: choupai ($47.96 in chips) 
Seat 7: matiko09 ($149.38 in chips) 
Seat 8: Filojoes ($107.09 in chips) 
Seat 9: butcheN18 ($100 in chips) 
Yaaaazz: posts small blind $0.50
choupai: posts big blind $1
*** HOLE CARDS ***
Dealt to matiko09 [8d Js]
matiko09: folds 
Filojoes: folds 
butcheN18: folds 
aseban11: folds 
AceFarky: folds 
powerbel: folds 
1000karlos: folds 
Yaaaazz: folds 
Uncalled bet ($0.50) returned to choupai
choupai collected $1 from pot
choupai: doesn't show hand 
*** SUMMARY ***
Total pot $1 | Rake $0 
Seat 1: aseban11 folded before Flop (didn't bet)
Seat 2: AceFarky folded before Flop (didn't bet)
Seat 3: powerbel folded before Flop (didn't bet)
Seat 4: 1000karlos (button) folded before Flop (didn't bet)
Seat 5: Yaaaazz (small blind) folded before Flop
Seat 6: choupai (big blind) collected ($1)
Seat 7: matiko09 folded before Flop (didn't bet)
Seat 8: Filojoes folded before Flop (didn't bet)
Seat 9: butcheN18 folded before Flop (didn't bet)





PokerStars Hand #151942445012:  Hold'em No Limit ($0.50/$1.00 USD) - 2016/04/15 13:22:25 CET [2016/04/15 7:22:25 ET]
Table 'Kreusa II' 9-max Seat #1 is the button
Seat 1: Frosch1907 ($42.11 in chips) 
Seat 2: azzad2007 ($100 in chips) 
Seat 4: Filojoes ($101.50 in chips) 
Seat 5: matiko09 ($120.84 in chips) 
Seat 6: mr. four-eye ($99 in chips) 
Seat 7: djammusic ($43.19 in chips) 
Seat 8: rycho222 ($103.98 in chips) 
azzad2007: posts small blind $0.50
Filojoes: posts big blind $1
*** HOLE CARDS ***
Dealt to matiko09 [8d Th]
matiko09: folds 
mr. four-eye: folds 
djammusic: folds 
rycho222: raises $2 to $3
Frosch1907: folds 
azzad2007: folds 
Filojoes: calls $2
*** FLOP *** [Td Jh 2s]
Filojoes: checks 
rycho222: bets $6
Filojoes: calls $6
*** TURN *** [Td Jh 2s] [Jd]
Filojoes: checks 
rycho222: checks 
*** RIVER *** [Td Jh 2s Jd] [7c]
Filojoes: bets $8.79
rycho222: calls $8.79
*** SHOW DOWN ***
Filojoes: shows [2h 5h] (two pair, Jacks and Deuces)
rycho222: shows [9s 9c] (two pair, Jacks and Nines)
rycho222 collected $34.28 from pot
*** SUMMARY ***
Total pot $36.08 | Rake $1.80 
Board [Td Jh 2s Jd 7c]
Seat 1: Frosch1907 (button) folded before Flop (didn't bet)
Seat 2: azzad2007 (small blind) folded before Flop
Seat 4: Filojoes (big blind) showed [2h 5h] and lost with two pair, Jacks and Deuces
Seat 5: matiko09 folded before Flop (didn't bet)
Seat 6: mr. four-eye folded before Flop (didn't bet)
Seat 7: djammusic folded before Flop (didn't bet)
Seat 8: rycho222 showed [9s 9c] and won ($34.28) with two pair, Jacks and Nines





PokerStars Hand #151942444849:  Hold'em No Limit ($0.50/$1.00 USD) - 2016/04/15 13:22:25 CET [2016/04/15 7:22:25 ET]
Table 'Matterania III' 9-max Seat #8 is the button
Seat 1: di0d80 ($108.78 in chips) 
Seat 3: ardo888 ($154.50 in chips) 
Seat 4: wangzhuoming ($78.72 in chips) 
Seat 5: Vermm ($103.58 in chips) 
Seat 6: matiko09 ($104.24 in chips) 
Seat 7: Filojoes ($100 in chips) 
Seat 8: Jimy Tiltman ($100 in chips) 
Seat 9: butcheN18 ($103.50 in chips) 
butcheN18: posts small blind $0.50
di0d80: posts big blind $1
haoyuan541: sits out 
di0d80: posts the ante $0.20
ardo888: posts the ante $0.20
wangzhuoming: posts the ante $0.20
Vermm: posts the ante $0.20
matiko09: posts the ante $0.20
Filojoes: posts the ante $0.20
Jimy Tiltman: posts the ante $0.20
butcheN18: posts the ante $0.20
*** HOLE CARDS ***
Dealt to matiko09 [9c 5d]
ardo888: folds 
wangzhuoming: folds 
Vermm: calls $1
matiko09: folds 
Filojoes: folds 
Jimy Tiltman: raises $2.50 to $3.50
butcheN18: folds 
di0d80: folds 
Vermm: calls $2.50
*** FLOP *** [3c Th 7s]
Vermm: checks 
Jimy Tiltman: bets $6
Vermm: calls $6
*** TURN *** [3c Th 7s] [Jh]
Vermm: checks 
Jimy Tiltman: checks 
*** RIVER *** [3c Th 7s Jh] [6c]
Vermm: bets $12
Jimy Tiltman: folds 
Uncalled bet ($12) returned to Vermm
Vermm collected $21 from pot
Vermm: doesn't show hand 
*** SUMMARY ***
Total pot $22.10 | Rake $1.10 
Board [3c Th 7s Jh 6c]
Seat 1: di0d80 (big blind) folded before Flop
Seat 3: ardo888 folded before Flop (didn't bet)
Seat 4: wangzhuoming folded before Flop (didn't bet)
Seat 5: Vermm collected ($21)
Seat 6: matiko09 folded before Flop (didn't bet)
Seat 7: Filojoes folded before Flop (didn't bet)
Seat 8: Jimy Tiltman (button) folded on the River
Seat 9: butcheN18 (small blind) folded before Flop





PokerStars Hand #151942451800:  Hold'em No Limit ($0.50/$1.00 USD) - 2016/04/15 13:22:40 CET [2016/04/15 7:22:40 ET]
Table 'Katja II' 9-max Seat #9 is the button
Seat 1: Filojoes ($100 in chips) 
Seat 2: TheJokerMen1 ($56.11 in chips) 
Seat 3: matiko09 ($138.62 in chips) 
Seat 4: Sutt_420 ($70.70 in chips) 
Seat 6: ASG2016 ($110.54 in chips) 
Seat 7: Effort92 ($105.17 in chips) 
Seat 9: hardeep13 ($66.86 in chips) 
Filojoes: posts small blind $0.50
TheJokerMen1: posts big blind $1
*** HOLE CARDS ***
Dealt to matiko09 [Ac 7c]
matiko09: folds 
Sutt_420: folds 
ASG2016: folds 
Effort92: raises $1.50 to $2.50
hardeep13: calls $2.50
Filojoes: folds 
TheJokerMen1: calls $1.50
*** FLOP *** [6d 3c 7d]
TheJokerMen1: checks 
Effort92: checks 
hardeep13: checks 
*** TURN *** [6d 3c 7d] [Kc]
TheJokerMen1: checks 
Effort92: checks 
hardeep13: bets $3
TheJokerMen1: folds 
Effort92: folds 
Uncalled bet ($3) returned to hardeep13
hardeep13 collected $7.60 from pot
hardeep13: doesn't show hand 
*** SUMMARY ***
Total pot $8 | Rake $0.40 
Board [6d 3c 7d Kc]
Seat 1: Filojoes (small blind) folded before Flop
Seat 2: TheJokerMen1 (big blind) folded on the Turn
Seat 3: matiko09 folded before Flop (didn't bet)
Seat 4: Sutt_420 folded before Flop (didn't bet)
Seat 6: ASG2016 folded before Flop (didn't bet)
Seat 7: Effort92 folded on the Turn
Seat 9: hardeep13 (button) collected ($7.60)





PokerStars Hand #151942452210:  Hold'em No Limit ($0.50/$1.00 USD) - 2016/04/15 13:22:41 CET [2016/04/15 7:22:41 ET]
Table 'Lamberta III' 9-max Seat #1 is the button
Seat 1: Westpants ($102.50 in chips) 
Seat 2: Biscuit270 ($108.18 in chips) 
Seat 3: butcheN18 ($203.10 in chips) 
Seat 4: Filojoes ($104.59 in chips) 
Seat 6: aseban11 ($100 in chips) 
Seat 7: aleks2112198 ($9.20 in chips) 
Seat 8: wangzhuoming ($107.80 in chips) 
Seat 9: matiko09 ($154.36 in chips) 
Biscuit270: posts small blind $0.50
butcheN18: posts big blind $1
tipner: sits out 
*** HOLE CARDS ***
Dealt to matiko09 [4d 9c]
Filojoes: folds 
aseban11: folds 
aleks2112198: folds 
aleks2112198 leaves the table
wangzhuoming: folds 
matiko09: folds 
Westpants: folds 
Biscuit270: folds 
Uncalled bet ($0.50) returned to butcheN18
butcheN18 collected $1 from pot
butcheN18: doesn't show hand 
*** SUMMARY ***
Total pot $1 | Rake $0 
Seat 1: Westpants (button) folded before Flop (didn't bet)
Seat 2: Biscuit270 (small blind) folded before Flop
Seat 3: butcheN18 (big blind) collected ($1)
Seat 4: Filojoes folded before Flop (didn't bet)
Seat 6: aseban11 folded before Flop (didn't bet)
Seat 7: aleks2112198 folded before Flop (didn't bet)
Seat 8: wangzhuoming folded before Flop (didn't bet)
Seat 9: matiko09 folded before Flop (didn't bet)





PokerStars Hand #151942457395:  Hold'em No Limit ($1/$2 USD) - 2016/04/15 13:22:51 CET [2016/04/15 7:22:51 ET]
Table 'Oceax' 9-max Seat #1 is the button
Seat 1: matiko09 ($200 in chips) 
Seat 2: Fish4trips ($311.36 in chips) 
Seat 3: MiiFuxU ($200 in chips) 
Seat 4: butcheN18 ($238.42 in chips) 
Seat 5: di0d80 ($206 in chips) 
Seat 6: Iggso ($208 in chips) 
Seat 7: djlaw321 ($151 in chips) 
Seat 9: Olddogtom888 ($293.78 in chips) 
Fish4trips: posts small blind $1
MiiFuxU: posts big blind $2
Poroxide: sits out 
Olddogtom888: posts small & big blinds $3
*** HOLE CARDS ***
Dealt to matiko09 [Ks 7d]
butcheN18: folds 
di0d80: folds 
Iggso: folds 
djlaw321: folds 
Olddogtom888: checks 
matiko09: raises $6 to $8
Fish4trips: folds 
MiiFuxU: folds 
Olddogtom888: folds 
Uncalled bet ($6) returned to matiko09
matiko09 collected $8 from pot
matiko09: doesn't show hand 
*** SUMMARY ***
Total pot $8 | Rake $0 
Seat 1: matiko09 (button) collected ($8)
Seat 2: Fish4trips (small blind) folded before Flop
Seat 3: MiiFuxU (big blind) folded before Flop
Seat 4: butcheN18 folded before Flop (didn't bet)
Seat 5: di0d80 folded before Flop (didn't bet)
Seat 6: Iggso folded before Flop (didn't bet)
Seat 7: djlaw321 folded before Flop (didn't bet)
Seat 9: Olddogtom888 folded before Flop





PokerStars Hand #151942459051:  Hold'em No Limit ($0.50/$1.00 USD) - 2016/04/15 13:22:55 CET [2016/04/15 7:22:55 ET]
Table 'Chiny II' 9-max Seat #5 is the button
Seat 1: aseban11 ($100 in chips) 
Seat 2: AceFarky ($114.57 in chips) 
Seat 3: powerbel ($41.90 in chips) 
Seat 4: 1000karlos ($89.49 in chips) 
Seat 5: Yaaaazz ($100 in chips) 
Seat 6: choupai ($48.46 in chips) 
Seat 7: matiko09 ($149.38 in chips) 
Seat 8: Filojoes ($107.09 in chips) 
Seat 9: butcheN18 ($100 in chips) 
choupai: posts small blind $0.50
matiko09: posts big blind $1
*** HOLE CARDS ***
Dealt to matiko09 [Kh 6d]
Filojoes: folds 
butcheN18: folds 
aseban11: raises $1.50 to $2.50
AceFarky: folds 
powerbel: folds 
1000karlos: folds 
Yaaaazz: folds 
choupai: folds 
matiko09: folds 
Uncalled bet ($1.50) returned to aseban11
aseban11 collected $2.50 from pot
aseban11: doesn't show hand 
*** SUMMARY ***
Total pot $2.50 | Rake $0 
Seat 1: aseban11 collected ($2.50)
Seat 2: AceFarky folded before Flop (didn't bet)
Seat 3: powerbel folded before Flop (didn't bet)
Seat 4: 1000karlos folded before Flop (didn't bet)
Seat 5: Yaaaazz (button) folded before Flop (didn't bet)
Seat 6: choupai (small blind) folded before Flop
Seat 7: matiko09 (big blind) folded before Flop
Seat 8: Filojoes folded before Flop (didn't bet)
Seat 9: butcheN18 folded before Flop (didn't bet)





PokerStars Hand #151942461622:  Hold'em No Limit ($0.50/$1.00 USD) - 2016/04/15 13:23:00 CET [2016/04/15 7:23:00 ET]
Table 'Cheruskia II' 9-max Seat #3 is the button
Seat 1: vicus1972 ($96.30 in chips) 
Seat 2: SerAlGog ($100 in chips) 
Seat 3: butcheN18 ($137.55 in chips) 
Seat 4: djammusic ($46.15 in chips) 
Seat 6: hammerwife ($125.10 in chips) 
Seat 7: matiko09 ($100 in chips) 
Seat 8: ardo888 ($100 in chips) 
Seat 9: rycho222 ($103 in chips) 
djammusic: posts small blind $0.50
Paul6999: is sitting out 
hammerwife: posts big blind $1
*** HOLE CARDS ***
Dealt to matiko09 [Qh 6s]
matiko09: folds 
Paul6999 leaves the table
ardo888: raises $2 to $3
rycho222: folds 
vicus1972: calls $3
SerAlGog: folds 
butcheN18: folds 
djammusic: folds 
hammerwife: folds 
*** FLOP *** [4s 8h 7c]
ardo888: bets $4
vicus1972: raises $8 to $12
ardo888: calls $8
*** TURN *** [4s 8h 7c] [6h]
ardo888: bets $21.84
Filojoes joins the table at seat #5 
vicus1972: calls $21.84
*** RIVER *** [4s 8h 7c 6h] [Td]
ardo888: bets $63.16 and is all-in
vicus1972: folds 
Uncalled bet ($63.16) returned to ardo888
ardo888 collected $72.68 from pot
ardo888: doesn't show hand 
*** SUMMARY ***
Total pot $75.18 | Rake $2.50 
Board [4s 8h 7c 6h Td]
Seat 1: vicus1972 folded on the River
Seat 2: SerAlGog folded before Flop (didn't bet)
Seat 3: butcheN18 (button) folded before Flop (didn't bet)
Seat 4: djammusic (small blind) folded before Flop
Seat 6: hammerwife (big blind) folded before Flop
Seat 7: matiko09 folded before Flop (didn't bet)
Seat 8: ardo888 collected ($72.68)
Seat 9: rycho222 folded before Flop (didn't bet)





PokerStars Hand #151942462794:  Hold'em No Limit ($0.50/$1.00 USD) - 2016/04/15 13:23:03 CET [2016/04/15 7:23:03 ET]
Table 'Lamberta III' 9-max Seat #2 is the button
Seat 1: Westpants ($102.50 in chips) 
Seat 2: Biscuit270 ($107.68 in chips) 
Seat 3: butcheN18 ($203.60 in chips) 
Seat 4: Filojoes ($104.59 in chips) 
Seat 6: aseban11 ($100 in chips) 
Seat 8: wangzhuoming ($107.80 in chips) 
Seat 9: matiko09 ($154.36 in chips) 
butcheN18: posts small blind $0.50
Filojoes: posts big blind $1
tipner: sits out 
*** HOLE CARDS ***
Dealt to matiko09 [6h 7d]
aseban11: folds 
wangzhuoming: folds 
matiko09: folds 
Westpants: folds 
Biscuit270: raises $2 to $3
butcheN18: folds 
Filojoes: folds 
Uncalled bet ($2) returned to Biscuit270
Biscuit270 collected $2.50 from pot
Biscuit270: doesn't show hand 
*** SUMMARY ***
Total pot $2.50 | Rake $0 
Seat 1: Westpants folded before Flop (didn't bet)
Seat 2: Biscuit270 (button) collected ($2.50)
Seat 3: butcheN18 (small blind) folded before Flop
Seat 4: Filojoes (big blind) folded before Flop
Seat 6: aseban11 folded before Flop (didn't bet)
Seat 8: wangzhuoming folded before Flop (didn't bet)
Seat 9: matiko09 folded before Flop (didn't bet)





PokerStars Hand #151942467613:  Hold'em No Limit ($1/$2 USD) - 2016/04/15 13:23:13 CET [2016/04/15 7:23:13 ET]
Table 'Adele II' 9-max Seat #6 is the button
Seat 1: RyanHuJun ($228.97 in chips) 
Seat 2: Fish4trips ($200 in chips) 
Seat 3: matiko09 ($325.45 in chips) 
Seat 6: wiseyoyo ($217.93 in chips) 
Seat 7: Iggso ($200 in chips) 
Seat 8: docmarc777 ($384.92 in chips) 
Seat 9: MiiFuxU ($200 in chips) 
Iggso: posts small blind $1
docmarc777: posts big blind $2
Glushchenko: sits out 
*** HOLE CARDS ***
Dealt to matiko09 [4d 2s]
MiiFuxU: folds 
RyanHuJun: calls $2
Fish4trips: folds 
matiko09: folds 
wiseyoyo: folds 
Iggso: folds 
docmarc777: checks 
*** FLOP *** [Qs 6c Jc]
docmarc777: checks 
RyanHuJun: bets $2
docmarc777: calls $2
*** TURN *** [Qs 6c Jc] [5s]
docmarc777: checks 
MiiFuxU leaves the table
RyanHuJun: bets $8
docmarc777: folds 
Uncalled bet ($8) returned to RyanHuJun
RyanHuJun collected $8.55 from pot
RyanHuJun: doesn't show hand 
*** SUMMARY ***
Total pot $9 | Rake $0.45 
Board [Qs 6c Jc 5s]
Seat 1: RyanHuJun collected ($8.55)
Seat 2: Fish4trips folded before Flop (didn't bet)
Seat 3: matiko09 folded before Flop (didn't bet)
Seat 6: wiseyoyo (button) folded before Flop (didn't bet)
Seat 7: Iggso (small blind) folded before Flop
Seat 8: docmarc777 (big blind) folded on the Turn
Seat 9: MiiFuxU folded before Flop (didn't bet)





PokerStars Hand #151942471512:  Hold'em No Limit ($1/$2 USD) - 2016/04/15 13:23:21 CET [2016/04/15 7:23:21 ET]
Table 'Patroclus II' 9-max Seat #1 is the button
Seat 1: TonnaMunz ($204.04 in chips) 
Seat 2: Moemors ($149.65 in chips) 
Seat 3: Koolniknik ($203.85 in chips) 
Seat 4: tipner ($200 in chips) 
Seat 5: butcheN18 ($262.29 in chips) 
Seat 6: di0d80 ($200 in chips) 
Seat 7: matiko09 ($202.51 in chips) 
Seat 9: Fish4trips ($231.72 in chips) 
Moemors: posts small blind $1
Koolniknik: posts big blind $2
Glushchenko: sits out 
*** HOLE CARDS ***
Dealt to matiko09 [Td Kc]
tipner: folds 
butcheN18: folds 
di0d80: folds 
matiko09: raises $3 to $5
Fish4trips: folds 
TonnaMunz: folds 
Moemors: calls $4
Koolniknik: calls $3
*** FLOP *** [6d 6s Ks]
Moemors: bets $18
Koolniknik: folds 
matiko09: calls $18
*** TURN *** [6d 6s Ks] [9c]
Moemors: checks 
matiko09: checks 
*** RIVER *** [6d 6s Ks 9c] [Jc]
Moemors: checks 
matiko09: bets $24
Moemors: calls $24
*** SHOW DOWN ***
matiko09: shows [Td Kc] (two pair, Kings and Sixes)
Moemors: mucks hand 
matiko09 collected $96.25 from pot
*** SUMMARY ***
Total pot $99 | Rake $2.75 
Board [6d 6s Ks 9c Jc]
Seat 1: TonnaMunz (button) folded before Flop (didn't bet)
Seat 2: Moemors (small blind) mucked [3d 3c]
Seat 3: Koolniknik (big blind) folded on the Flop
Seat 4: tipner folded before Flop (didn't bet)
Seat 5: butcheN18 folded before Flop (didn't bet)
Seat 6: di0d80 folded before Flop (didn't bet)
Seat 7: matiko09 showed [Td Kc] and won ($96.25) with two pair, Kings and Sixes
Seat 9: Fish4trips folded before Flop (didn't bet)





PokerStars Hand #151942473070:  Hold'em No Limit ($0.50/$1.00 USD) - 2016/04/15 13:23:24 CET [2016/04/15 7:23:24 ET]
Table 'Parvulesco II' 9-max Seat #2 is the button
Seat 1: bilukm ($49.43 in chips) 
Seat 2: SerAlGog ($272.80 in chips) 
Seat 3: matiko09 ($100 in chips) 
Seat 4: butcheN18 ($101.81 in chips) 
Seat 5: bronbeek ($71.77 in chips) 
Seat 7: djammusic ($40 in chips) 
Seat 9: hammerwife ($211.38 in chips) 
matiko09: posts small blind $0.50
butcheN18: posts big blind $1
Glushchenko: sits out 
Jimy Tiltman: sits out 
*** HOLE CARDS ***
Dealt to matiko09 [Kc 6s]
bronbeek: folds 
djammusic: raises $1.15 to $2.15
hammerwife: folds 
bilukm: calls $2.15
SerAlGog: folds 
matiko09: folds 
butcheN18: folds 
*** FLOP *** [3h 8h 8s]
djammusic: bets $3.20
bilukm: folds 
Uncalled bet ($3.20) returned to djammusic
djammusic collected $5.51 from pot
djammusic: doesn't show hand 
*** SUMMARY ***
Total pot $5.80 | Rake $0.29 
Board [3h 8h 8s]
Seat 1: bilukm folded on the Flop
Seat 2: SerAlGog (button) folded before Flop (didn't bet)
Seat 3: matiko09 (small blind) folded before Flop
Seat 4: butcheN18 (big blind) folded before Flop
Seat 5: bronbeek folded before Flop (didn't bet)
Seat 7: djammusic collected ($5.51)
Seat 9: hammerwife folded before Flop (didn't bet)





PokerStars Hand #151942473167:  Hold'em No Limit ($0.50/$1.00 USD) - 2016/04/15 13:23:25 CET [2016/04/15 7:23:25 ET]
Table 'Lamberta III' 9-max Seat #3 is the button
Seat 1: Westpants ($102.50 in chips) 
Seat 2: Biscuit270 ($109.18 in chips) 
Seat 3: butcheN18 ($203.10 in chips) 
Seat 4: Filojoes ($103.59 in chips) 
Seat 5: tipner ($115.60 in chips) 
Seat 6: aseban11 ($100 in chips) 
Seat 8: wangzhuoming ($107.80 in chips) 
Seat 9: matiko09 ($154.36 in chips) 
Filojoes: posts small blind $0.50
tipner: posts big blind $1
*** HOLE CARDS ***
Dealt to matiko09 [4c 8h]
Yaaaazz joins the table at seat #7 
aseban11: folds 
wangzhuoming: folds 
Yaaaazz leaves the table
matiko09: folds 
Westpants: raises $2 to $3
Biscuit270: calls $3
butcheN18: folds 
Filojoes: folds 
tipner: calls $2
*** FLOP *** [6s 5c 4s]
tipner: checks 
Westpants: bets $4.55
Biscuit270: calls $4.55
rycho222 joins the table at seat #7 
tipner: folds 
*** TURN *** [6s 5c 4s] [7c]
Westpants: checks 
Biscuit270: bets $12
Westpants: folds 
Uncalled bet ($12) returned to Biscuit270
Biscuit270 collected $17.67 from pot
Biscuit270: doesn't show hand 
*** SUMMARY ***
Total pot $18.60 | Rake $0.93 
Board [6s 5c 4s 7c]
Seat 1: Westpants folded on the Turn
Seat 2: Biscuit270 collected ($17.67)
Seat 3: butcheN18 (button) folded before Flop (didn't bet)
Seat 4: Filojoes (small blind) folded before Flop
Seat 5: tipner (big blind) folded on the Flop
Seat 6: aseban11 folded before Flop (didn't bet)
Seat 8: wangzhuoming folded before Flop (didn't bet)
Seat 9: matiko09 folded before Flop (didn't bet)





PokerStars Hand #151942473719:  Hold'em No Limit ($0.50/$1.00 USD) - 2016/04/15 13:23:26 CET [2016/04/15 7:23:26 ET]
Table 'Kreusa II' 9-max Seat #2 is the button
Seat 1: Frosch1907 ($42.11 in chips) 
Seat 2: azzad2007 ($100 in chips) 
Seat 4: Filojoes ($100 in chips) 
Seat 5: matiko09 ($120.84 in chips) 
Seat 6: mr. four-eye ($99 in chips) 
Seat 7: djammusic ($43.19 in chips) 
Seat 8: rycho222 ($120.47 in chips) 
Filojoes: posts small blind $0.50
matiko09: posts big blind $1
Glushchenko: sits out 
*** HOLE CARDS ***
Dealt to matiko09 [8d 7c]
mr. four-eye: folds 
djammusic: folds 
rycho222: folds 
Frosch1907: folds 
azzad2007: raises $1.40 to $2.40
Filojoes: folds 
matiko09: folds 
Uncalled bet ($1.40) returned to azzad2007
azzad2007 collected $2.50 from pot
azzad2007: doesn't show hand 
*** SUMMARY ***
Total pot $2.50 | Rake $0 
Seat 1: Frosch1907 folded before Flop (didn't bet)
Seat 2: azzad2007 (button) collected ($2.50)
Seat 4: Filojoes (small blind) folded before Flop
Seat 5: matiko09 (big blind) folded before Flop
Seat 6: mr. four-eye folded before Flop (didn't bet)
Seat 7: djammusic folded before Flop (didn't bet)
Seat 8: rycho222 folded before Flop (didn't bet)





PokerStars Hand #151942474718:  Hold'em No Limit ($0.50/$1.00 USD) - 2016/04/15 13:23:28 CET [2016/04/15 7:23:28 ET]
Table 'Chiny II' 9-max Seat #6 is the button
Seat 1: aseban11 ($101.50 in chips) 
Seat 2: AceFarky ($114.57 in chips) 
Seat 3: powerbel ($41.90 in chips) 
Seat 4: 1000karlos ($89.49 in chips) 
Seat 5: Yaaaazz ($100 in chips) 
Seat 6: choupai ($47.96 in chips) 
Seat 7: matiko09 ($148.38 in chips) 
Seat 8: Filojoes ($107.09 in chips) 
Seat 9: butcheN18 ($100 in chips) 
matiko09: posts small blind $0.50
Filojoes: posts big blind $1
*** HOLE CARDS ***
Dealt to matiko09 [Jd 9s]
butcheN18: folds 
aseban11: folds 
AceFarky: folds 
powerbel: folds 
1000karlos: folds 
Yaaaazz: raises $1.50 to $2.50
choupai: raises $5.50 to $8
matiko09: folds 
Filojoes: folds 
Yaaaazz: raises $92 to $100 and is all-in
choupai: folds 
Uncalled bet ($92) returned to Yaaaazz
Yaaaazz collected $17.50 from pot
*** SUMMARY ***
Total pot $17.50 | Rake $0 
Seat 1: aseban11 folded before Flop (didn't bet)
Seat 2: AceFarky folded before Flop (didn't bet)
Seat 3: powerbel folded before Flop (didn't bet)
Seat 4: 1000karlos folded before Flop (didn't bet)
Seat 5: Yaaaazz collected ($17.50)
Seat 6: choupai (button) folded before Flop
Seat 7: matiko09 (small blind) folded before Flop
Seat 8: Filojoes (big blind) folded before Flop
Seat 9: butcheN18 folded before Flop (didn't bet)





PokerStars Hand #151942474819:  Hold'em No Limit ($0.50/$1.00 USD) - 2016/04/15 13:23:28 CET [2016/04/15 7:23:28 ET]
Table 'Navi' 9-max Seat #7 is the button
Seat 1: tipner ($100 in chips) 
Seat 2: butcheN18 ($101.50 in chips) 
Seat 3: aseban11 ($110.93 in chips) 
Seat 4: Effort92 ($129.63 in chips) 
Seat 7: yoshidao ($142.07 in chips) 
Seat 8: djammusic ($53.59 in chips) 
Seat 9: matiko09 ($109.95 in chips) 
djammusic: posts small blind $0.50
matiko09: posts big blind $1
hammerwife: sits out 
Glushchenko: sits out 
*** HOLE CARDS ***
Dealt to matiko09 [3s Qs]
tipner: folds 
butcheN18: raises $2 to $3
aseban11: folds 
Effort92: raises $6 to $9
yoshidao: calls $9
djammusic: folds 
matiko09: folds 
butcheN18: folds 
*** FLOP *** [Td 3d 6d]
Effort92: checks 
yoshidao: checks 
*** TURN *** [Td 3d 6d] [Qd]
Effort92: checks 
yoshidao: bets $15
Effort92: folds 
Uncalled bet ($15) returned to yoshidao
yoshidao collected $21.38 from pot
yoshidao: doesn't show hand 
*** SUMMARY ***
Total pot $22.50 | Rake $1.12 
Board [Td 3d 6d Qd]
Seat 1: tipner folded before Flop (didn't bet)
Seat 2: butcheN18 folded before Flop
Seat 3: aseban11 folded before Flop (didn't bet)
Seat 4: Effort92 folded on the Turn
Seat 7: yoshidao (button) collected ($21.38)
Seat 8: djammusic (small blind) folded before Flop
Seat 9: matiko09 (big blind) folded before Flop





PokerStars Hand #151942477246:  Hold'em No Limit ($0.50/$1.00 USD) - 2016/04/15 13:23:33 CET [2016/04/15 7:23:33 ET]
Table 'Adelgunde III' 9-max Seat #3 is the button
Seat 1: valimiu ($59.65 in chips) 
Seat 2: djammusic ($46.88 in chips) 
Seat 3: tipner ($100 in chips) 
Seat 4: hammerwife ($100 in chips) 
Seat 5: matiko09 ($100 in chips) 
Seat 6: Pominator92 ($46.54 in chips) 
hammerwife: posts small blind $0.50
matiko09: posts big blind $1
Foton18: sits out 
aseban11: sits out 
Kukuryzka: sits out 
*** HOLE CARDS ***
Dealt to matiko09 [Tc 7h]
Pominator92: folds 
valimiu: calls $1
djammusic: folds 
tipner: raises $3 to $4
hammerwife: folds 
matiko09: folds 
valimiu: calls $3
*** FLOP *** [Jd Ah 6c]
valimiu: checks 
tipner: bets $5
valimiu: folds 
Uncalled bet ($5) returned to tipner
tipner collected $9.02 from pot
tipner: doesn't show hand 
*** SUMMARY ***
Total pot $9.50 | Rake $0.48 
Board [Jd Ah 6c]
Seat 1: valimiu folded on the Flop
Seat 2: djammusic folded before Flop (didn't bet)
Seat 3: tipner (button) collected ($9.02)
Seat 4: hammerwife (small blind) folded before Flop
Seat 5: matiko09 (big blind) folded before Flop
Seat 6: Pominator92 folded before Flop (didn't bet)





PokerStars Hand #151942477437:  Hold'em No Limit ($1/$2 USD) - 2016/04/15 13:23:34 CET [2016/04/15 7:23:34 ET]
Table 'Oceax' 9-max Seat #2 is the button
Seat 1: matiko09 ($206 in chips) 
Seat 2: Fish4trips ($310.36 in chips) 
Seat 3: MiiFuxU ($200 in chips) 
Seat 4: butcheN18 ($238.42 in chips) 
Seat 5: di0d80 ($206 in chips) 
Seat 6: Iggso ($208 in chips) 
Seat 7: djlaw321 ($151 in chips) 
Seat 9: Olddogtom888 ($290.78 in chips) 
MiiFuxU: posts small blind $1
butcheN18: posts big blind $2
Poroxide: sits out 
*** HOLE CARDS ***
Dealt to matiko09 [Qd Th]
di0d80: folds 
Iggso: folds 
djlaw321: folds 
Olddogtom888: folds 
matiko09: raises $3 to $5
Fish4trips: folds 
MiiFuxU: folds 
butcheN18: folds 
Uncalled bet ($3) returned to matiko09
matiko09 collected $5 from pot
matiko09: doesn't show hand 
*** SUMMARY ***
Total pot $5 | Rake $0 
Seat 1: matiko09 collected ($5)
Seat 2: Fish4trips (button) folded before Flop (didn't bet)
Seat 3: MiiFuxU (small blind) folded before Flop
Seat 4: butcheN18 (big blind) folded before Flop
Seat 5: di0d80 folded before Flop (didn't bet)
Seat 6: Iggso folded before Flop (didn't bet)
Seat 7: djlaw321 folded before Flop (didn't bet)
Seat 9: Olddogtom888 folded before Flop (didn't bet)





PokerStars Hand #151942486176:  Hold'em No Limit ($0.50/$1.00 USD) - 2016/04/15 13:23:52 CET [2016/04/15 7:23:52 ET]
Table 'Matterania III' 9-max Seat #9 is the button
Seat 1: di0d80 ($107.58 in chips) 
Seat 2: haoyuan541 ($101.72 in chips) 
Seat 3: ardo888 ($154.30 in chips) 
Seat 4: wangzhuoming ($78.52 in chips) 
Seat 5: Vermm ($114.88 in chips) 
Seat 6: matiko09 ($104.04 in chips) 
Seat 7: Filojoes ($100 in chips) 
Seat 8: Jimy Tiltman ($100 in chips) 
Seat 9: butcheN18 ($102.80 in chips) 
di0d80: posts small blind $0.50
haoyuan541: posts big blind $1
di0d80: posts the ante $0.20
haoyuan541: posts the ante $0.20
ardo888: posts the ante $0.20
wangzhuoming: posts the ante $0.20
Vermm: posts the ante $0.20
matiko09: posts the ante $0.20
Filojoes: posts the ante $0.20
Jimy Tiltman: posts the ante $0.20
butcheN18: posts the ante $0.20
*** HOLE CARDS ***
Dealt to matiko09 [5d 6h]
ardo888: folds 
wangzhuoming: folds 
Vermm: folds 
matiko09: folds 
Filojoes: raises $2 to $3
Jimy Tiltman: folds 
butcheN18: folds 
di0d80: folds 
haoyuan541: folds 
Uncalled bet ($2) returned to Filojoes
Filojoes collected $4.30 from pot
Filojoes: doesn't show hand 
*** SUMMARY ***
Total pot $4.30 | Rake $0 
Seat 1: di0d80 (small blind) folded before Flop
Seat 2: haoyuan541 (big blind) folded before Flop
Seat 3: ardo888 folded before Flop (didn't bet)
Seat 4: wangzhuoming folded before Flop (didn't bet)
Seat 5: Vermm folded before Flop (didn't bet)
Seat 6: matiko09 folded before Flop (didn't bet)
Seat 7: Filojoes collected ($4.30)
Seat 8: Jimy Tiltman folded before Flop (didn't bet)
Seat 9: butcheN18 (button) folded before Flop (didn't bet)





PokerStars Hand #151942486789:  Hold'em No Limit ($0.50/$1.00 USD) - 2016/04/15 13:23:54 CET [2016/04/15 7:23:54 ET]
Table 'Kreusa II' 9-max Seat #4 is the button
Seat 1: Frosch1907 ($42.11 in chips) 
Seat 2: azzad2007 ($101.50 in chips) 
Seat 4: Filojoes ($100 in chips) 
Seat 5: matiko09 ($119.84 in chips) 
Seat 6: mr. four-eye ($99 in chips) 
Seat 7: djammusic ($43.19 in chips) 
Seat 8: rycho222 ($120.47 in chips) 
matiko09: posts small blind $0.50
mr. four-eye: posts big blind $1
Glushchenko: sits out 
*** HOLE CARDS ***
Dealt to matiko09 [5h 7c]
djammusic: folds 
rycho222: folds 
Frosch1907: folds 
azzad2007: folds 
Filojoes: raises $1 to $2
matiko09: folds 
mr. four-eye: calls $1
*** FLOP *** [Qc 4c 9d]
mr. four-eye: bets $2.14
Filojoes: folds 
Uncalled bet ($2.14) returned to mr. four-eye
mr. four-eye collected $4.28 from pot
mr. four-eye: doesn't show hand 
*** SUMMARY ***
Total pot $4.50 | Rake $0.22 
Board [Qc 4c 9d]
Seat 1: Frosch1907 folded before Flop (didn't bet)
Seat 2: azzad2007 folded before Flop (didn't bet)
Seat 4: Filojoes (button) folded on the Flop
Seat 5: matiko09 (small blind) folded before Flop
Seat 6: mr. four-eye (big blind) collected ($4.28)
Seat 7: djammusic folded before Flop (didn't bet)
Seat 8: rycho222 folded before Flop (didn't bet)





PokerStars Hand #151942487377:  Hold'em No Limit ($1/$2 USD) - 2016/04/15 13:23:55 CET [2016/04/15 7:23:55 ET]
Table 'Oceax' 9-max Seat #3 is the button
Seat 1: matiko09 ($209 in chips) 
Seat 2: Fish4trips ($310.36 in chips) 
Seat 3: MiiFuxU ($200 in chips) 
Seat 4: butcheN18 ($236.42 in chips) 
Seat 5: di0d80 ($206 in chips) 
Seat 6: Iggso ($208 in chips) 
Seat 7: djlaw321 ($151 in chips) 
Seat 9: Olddogtom888 ($290.78 in chips) 
butcheN18: posts small blind $1
di0d80: posts big blind $2
Poroxide: sits out 
*** HOLE CARDS ***
Dealt to matiko09 [9d Kh]
Iggso: folds 
djlaw321: folds 
Olddogtom888: calls $2
matiko09: folds 
Fish4trips: folds 
MiiFuxU: folds 
butcheN18: folds 
di0d80: checks 
*** FLOP *** [8s Jc 8d]
di0d80: checks 
Olddogtom888: bets $3
di0d80: folds 
Uncalled bet ($3) returned to Olddogtom888
Olddogtom888 collected $4.75 from pot
Olddogtom888: doesn't show hand 
*** SUMMARY ***
Total pot $5 | Rake $0.25 
Board [8s Jc 8d]
Seat 1: matiko09 folded before Flop (didn't bet)
Seat 2: Fish4trips folded before Flop (didn't bet)
Seat 3: MiiFuxU (button) folded before Flop (didn't bet)
Seat 4: butcheN18 (small blind) folded before Flop
Seat 5: di0d80 (big blind) folded on the Flop
Seat 6: Iggso folded before Flop (didn't bet)
Seat 7: djlaw321 folded before Flop (didn't bet)
Seat 9: Olddogtom888 collected ($4.75)





PokerStars Hand #151942488439:  Hold'em No Limit ($1/$2 USD) - 2016/04/15 13:23:57 CET [2016/04/15 7:23:57 ET]
Table 'Adele II' 9-max Seat #7 is the button
Seat 1: RyanHuJun ($233.52 in chips) 
Seat 2: Fish4trips ($200 in chips) 
Seat 3: matiko09 ($325.45 in chips) 
Seat 6: wiseyoyo ($217.93 in chips) 
Seat 7: Iggso ($200 in chips) 
Seat 8: docmarc777 ($380.92 in chips) 
docmarc777: posts small blind $1
SanychStar joins the table at seat #9 
RyanHuJun: posts big blind $2
Glushchenko: sits out 
*** HOLE CARDS ***
Dealt to matiko09 [Qc Th]
Fish4trips: raises $3 to $5
matiko09: folds 
wiseyoyo: folds 
Iggso: calls $5
docmarc777: calls $4
RyanHuJun: calls $3
*** FLOP *** [2s 5s 7d]
docmarc777: checks 
RyanHuJun: checks 
Fish4trips: checks 
Iggso: checks 
*** TURN *** [2s 5s 7d] [Kh]
docmarc777: checks 
RyanHuJun: checks 
Fish4trips: checks 
Iggso: checks 
*** RIVER *** [2s 5s 7d Kh] [Jd]
docmarc777: checks 
RyanHuJun: checks 
Fish4trips: checks 
Iggso: checks 
*** SHOW DOWN ***
docmarc777: shows [Ac 9c] (high card Ace)
RyanHuJun: shows [Kc 4s] (a pair of Kings)
Fish4trips: mucks hand 
Iggso: mucks hand 
RyanHuJun collected $19 from pot
*** SUMMARY ***
Total pot $20 | Rake $1 
Board [2s 5s 7d Kh Jd]
Seat 1: RyanHuJun (big blind) showed [Kc 4s] and won ($19) with a pair of Kings
Seat 2: Fish4trips mucked [Ad Qh]
Seat 3: matiko09 folded before Flop (didn't bet)
Seat 6: wiseyoyo folded before Flop (didn't bet)
Seat 7: Iggso (button) mucked [As Qd]
Seat 8: docmarc777 (small blind) showed [Ac 9c] and lost with high card Ace





PokerStars Hand #151942489990:  Hold'em No Limit ($0.50/$1.00 USD) - 2016/04/15 13:24:00 CET [2016/04/15 7:24:00 ET]
Table 'Parvulesco II' 9-max Seat #3 is the button
Seat 1: bilukm ($47.28 in chips) 
Seat 2: SerAlGog ($272.80 in chips) 
Seat 3: matiko09 ($100 in chips) 
Seat 4: butcheN18 ($100.81 in chips) 
Seat 5: bronbeek ($71.77 in chips) 
Seat 7: djammusic ($43.36 in chips) 
Seat 9: hammerwife ($211.38 in chips) 
butcheN18: posts small blind $0.50
bronbeek: posts big blind $1
Glushchenko: sits out 
Jimy Tiltman: sits out 
*** HOLE CARDS ***
Dealt to matiko09 [Tc Qd]
djammusic: folds 
hammerwife: folds 
bilukm: raises $2 to $3
SerAlGog: folds 
matiko09: folds 
butcheN18: folds 
bronbeek: folds 
Uncalled bet ($2) returned to bilukm
bilukm collected $2.50 from pot
bilukm: doesn't show hand 
*** SUMMARY ***
Total pot $2.50 | Rake $0 
Seat 1: bilukm collected ($2.50)
Seat 2: SerAlGog folded before Flop (didn't bet)
Seat 3: matiko09 (button) folded before Flop (didn't bet)
Seat 4: butcheN18 (small blind) folded before Flop
Seat 5: bronbeek (big blind) folded before Flop
Seat 7: djammusic folded before Flop (didn't bet)
Seat 9: hammerwife folded before Flop (didn't bet)





PokerStars Hand #151942489960:  Hold'em No Limit ($1/$2 USD) - 2016/04/15 13:24:00 CET [2016/04/15 7:24:00 ET]
Table 'Irmgard II' 9-max Seat #9 is the button
Seat 2: Iggso ($211.71 in chips) 
Seat 3: matiko09 ($200 in chips) 
Seat 7: TonnaMunz ($200 in chips) 
Seat 9: maximax04 ($200 in chips) 
T0ny Adams will be allowed to play after the button
Iggso: posts small blind $1
matiko09: posts big blind $2
vezunchik79: sits out 
*** HOLE CARDS ***
Dealt to matiko09 [Tc 3s]
TonnaMunz: folds 
maximax04: raises $6 to $8
Iggso: folds 
di0d80 joins the table at seat #4 
matiko09: folds 
Uncalled bet ($6) returned to maximax04
maximax04 collected $5 from pot
maximax04: doesn't show hand 
*** SUMMARY ***
Total pot $5 | Rake $0 
Seat 2: Iggso (small blind) folded before Flop
Seat 3: matiko09 (big blind) folded before Flop
Seat 7: TonnaMunz folded before Flop (didn't bet)
Seat 9: maximax04 (button) collected ($5)





PokerStars Hand #151942490854:  Hold'em No Limit ($0.50/$1.00 USD) - 2016/04/15 13:24:02 CET [2016/04/15 7:24:02 ET]
Table 'Adelgunde III' 9-max Seat #4 is the button
Seat 1: valimiu ($55.65 in chips) 
Seat 2: djammusic ($46.88 in chips) 
Seat 3: tipner ($105.02 in chips) 
Seat 4: hammerwife ($100 in chips) 
Seat 5: matiko09 ($100 in chips) 
Seat 6: Pominator92 ($46.54 in chips) 
matiko09: posts small blind $0.50
Pominator92: posts big blind $1
Foton18: sits out 
aseban11: sits out 
Kukuryzka: sits out 
*** HOLE CARDS ***
Dealt to matiko09 [5s 5c]
valimiu: folds 
djammusic: folds 
tipner: raises $1 to $2
hammerwife: folds 
matiko09: calls $1.50
Pominator92: calls $1
*** FLOP *** [7s 2h 7c]
matiko09: checks 
Pominator92: bets $3
tipner: folds 
matiko09: calls $3
*** TURN *** [7s 2h 7c] [Td]
matiko09: checks 
Pominator92: bets $6
matiko09: folds 
Uncalled bet ($6) returned to Pominator92
Pominator92 collected $11.40 from pot
*** SUMMARY ***
Total pot $12 | Rake $0.60 
Board [7s 2h 7c Td]
Seat 1: valimiu folded before Flop (didn't bet)
Seat 2: djammusic folded before Flop (didn't bet)
Seat 3: tipner folded on the Flop
Seat 4: hammerwife (button) folded before Flop (didn't bet)
Seat 5: matiko09 (small blind) folded on the Turn
Seat 6: Pominator92 (big blind) collected ($11.40)





PokerStars Hand #151942499173:  Hold'em No Limit ($0.50/$1.00 USD) - 2016/04/15 13:24:20 CET [2016/04/15 7:24:20 ET]
Table 'Parvulesco II' 9-max Seat #4 is the button
Seat 1: bilukm ($48.78 in chips) 
Seat 2: SerAlGog ($272.80 in chips) 
Seat 3: matiko09 ($100 in chips) 
Seat 4: butcheN18 ($100.31 in chips) 
Seat 5: bronbeek ($70.77 in chips) 
Seat 6: Glushchenko ($125.04 in chips) 
Seat 7: djammusic ($43.36 in chips) 
Seat 9: hammerwife ($211.38 in chips) 
bronbeek: posts small blind $0.50
Glushchenko: posts big blind $1
Jimy Tiltman: sits out 
*** HOLE CARDS ***
Dealt to matiko09 [4c Ah]
djammusic: folds 
hammerwife: raises $2 to $3
bilukm: folds 
SerAlGog: folds 
matiko09: folds 
butcheN18: folds 
bronbeek: folds 
Glushchenko: folds 
Uncalled bet ($2) returned to hammerwife
hammerwife collected $2.50 from pot
hammerwife: doesn't show hand 
*** SUMMARY ***
Total pot $2.50 | Rake $0 
Seat 1: bilukm folded before Flop (didn't bet)
Seat 2: SerAlGog folded before Flop (didn't bet)
Seat 3: matiko09 folded before Flop (didn't bet)
Seat 4: butcheN18 (button) folded before Flop (didn't bet)
Seat 5: bronbeek (small blind) folded before Flop
Seat 6: Glushchenko (big blind) folded before Flop
Seat 7: djammusic folded before Flop (didn't bet)
Seat 9: hammerwife collected ($2.50)





PokerStars Hand #151942499302:  Hold'em No Limit ($1/$2 USD) - 2016/04/15 13:24:20 CET [2016/04/15 7:24:20 ET]
Table 'Irmgard II' 9-max Seat #2 is the button
Seat 2: Iggso ($210.71 in chips) 
Seat 3: matiko09 ($200 in chips) 
Seat 4: di0d80 ($200 in chips) 
Seat 7: TonnaMunz ($200 in chips) 
Seat 9: maximax04 ($203 in chips) 
matiko09: posts small blind $1
di0d80: posts big blind $2
djammusic joins the table at seat #6 
vezunchik79: sits out 
T0ny Adams: sits out 
*** HOLE CARDS ***
Dealt to matiko09 [9h 4s]
TonnaMunz: folds 
tipner joins the table at seat #8 
maximax04: calls $2
Iggso: folds 
matiko09: folds 
di0d80: checks 
*** FLOP *** [5h Qh Kc]
tipner leaves the table
di0d80: checks 
maximax04: bets $6
di0d80: folds 
Uncalled bet ($6) returned to maximax04
maximax04 collected $4.75 from pot
maximax04: doesn't show hand 
*** SUMMARY ***
Total pot $5 | Rake $0.25 
Board [5h Qh Kc]
Seat 2: Iggso (button) folded before Flop (didn't bet)
Seat 3: matiko09 (small blind) folded before Flop
Seat 4: di0d80 (big blind) folded on the Flop
Seat 7: TonnaMunz folded before Flop (didn't bet)
Seat 9: maximax04 collected ($4.75)





PokerStars Hand #151942500507:  Hold'em No Limit ($0.50/$1.00 USD) - 2016/04/15 13:24:23 CET [2016/04/15 7:24:23 ET]
Table 'Lamberta III' 9-max Seat #4 is the button
Seat 1: Westpants ($100 in chips) 
Seat 2: Biscuit270 ($119.30 in chips) 
Seat 3: butcheN18 ($203.10 in chips) 
Seat 4: Filojoes ($103.09 in chips) 
Seat 5: tipner ($112.60 in chips) 
Seat 6: aseban11 ($100 in chips) 
Seat 7: rycho222 ($100 in chips) 
Seat 8: wangzhuoming ($107.80 in chips) 
Seat 9: matiko09 ($154.36 in chips) 
tipner: posts small blind $0.50
aseban11: posts big blind $1
rycho222: posts big blind $1
*** HOLE CARDS ***
Dealt to matiko09 [Js 5d]
rycho222: checks 
wangzhuoming: folds 
matiko09: folds 
Westpants: folds 
Biscuit270: folds 
butcheN18: folds 
Filojoes: folds 
tipner: folds 
aseban11: checks 
*** FLOP *** [Ah 6s 6c]
aseban11: checks 
rycho222: checks 
*** TURN *** [Ah 6s 6c] [Jc]
aseban11: bets $1.50
rycho222: calls $1.50
*** RIVER *** [Ah 6s 6c Jc] [3h]
aseban11: bets $3.50
rycho222: folds 
Uncalled bet ($3.50) returned to aseban11
aseban11 collected $5.22 from pot
aseban11: doesn't show hand 
*** SUMMARY ***
Total pot $5.50 | Rake $0.28 
Board [Ah 6s 6c Jc 3h]
Seat 1: Westpants folded before Flop (didn't bet)
Seat 2: Biscuit270 folded before Flop (didn't bet)
Seat 3: butcheN18 folded before Flop (didn't bet)
Seat 4: Filojoes (button) folded before Flop (didn't bet)
Seat 5: tipner (small blind) folded before Flop
Seat 6: aseban11 (big blind) collected ($5.22)
Seat 7: rycho222 folded on the River
Seat 8: wangzhuoming folded before Flop (didn't bet)
Seat 9: matiko09 folded before Flop (didn't bet)





PokerStars Hand #151942504587:  Hold'em No Limit ($0.50/$1.00 USD) - 2016/04/15 13:24:32 CET [2016/04/15 7:24:32 ET]
Table 'Matterania III' 9-max Seat #1 is the button
Seat 1: di0d80 ($106.88 in chips) 
Seat 2: haoyuan541 ($100.52 in chips) 
Seat 3: ardo888 ($154.10 in chips) 
Seat 4: wangzhuoming ($78.32 in chips) 
Seat 5: Vermm ($114.68 in chips) 
Seat 6: matiko09 ($103.84 in chips) 
Seat 7: Filojoes ($103.10 in chips) 
Seat 8: Jimy Tiltman ($100 in chips) 
Seat 9: butcheN18 ($102.60 in chips) 
haoyuan541: posts small blind $0.50
ardo888: posts big blind $1
di0d80: posts the ante $0.20
haoyuan541: posts the ante $0.20
ardo888: posts the ante $0.20
wangzhuoming: posts the ante $0.20
Vermm: posts the ante $0.20
matiko09: posts the ante $0.20
Filojoes: posts the ante $0.20
Jimy Tiltman: posts the ante $0.20
butcheN18: posts the ante $0.20
*** HOLE CARDS ***
Dealt to matiko09 [8d Kc]
wangzhuoming: folds 
Vermm: folds 
matiko09: folds 
Filojoes: folds 
Jimy Tiltman: folds 
butcheN18: raises $2 to $3
di0d80: calls $3
haoyuan541: folds 
ardo888: folds 
*** FLOP *** [Ac Ah Td]
butcheN18: bets $4.59
di0d80: calls $4.59
*** TURN *** [Ac Ah Td] [2s]
butcheN18: checks 
di0d80: checks 
*** RIVER *** [Ac Ah Td 2s] [4s]
butcheN18: checks 
di0d80: checks 
*** SHOW DOWN ***
butcheN18: shows [Jd 9d] (a pair of Aces)
di0d80: shows [Th 7h] (two pair, Aces and Tens)
di0d80 collected $17.56 from pot
*** SUMMARY ***
Total pot $18.48 | Rake $0.92 
Board [Ac Ah Td 2s 4s]
Seat 1: di0d80 (button) showed [Th 7h] and won ($17.56) with two pair, Aces and Tens
Seat 2: haoyuan541 (small blind) folded before Flop
Seat 3: ardo888 (big blind) folded before Flop
Seat 4: wangzhuoming folded before Flop (didn't bet)
Seat 5: Vermm folded before Flop (didn't bet)
Seat 6: matiko09 folded before Flop (didn't bet)
Seat 7: Filojoes folded before Flop (didn't bet)
Seat 8: Jimy Tiltman folded before Flop (didn't bet)
Seat 9: butcheN18 showed [Jd 9d] and lost with a pair of Aces





PokerStars Hand #151942505567:  Hold'em No Limit ($0.50/$1.00 USD) - 2016/04/15 13:24:34 CET [2016/04/15 7:24:34 ET]
Table 'Kreusa II' 9-max Seat #5 is the button
Seat 1: Frosch1907 ($42.11 in chips) 
Seat 2: azzad2007 ($101.50 in chips) 
Seat 4: Filojoes ($100 in chips) 
Seat 5: matiko09 ($119.34 in chips) 
Seat 6: mr. four-eye ($101.28 in chips) 
Seat 7: djammusic ($43.19 in chips) 
Seat 8: rycho222 ($120.47 in chips) 
mr. four-eye: posts small blind $0.50
djammusic: posts big blind $1
Glushchenko: sits out 
*** HOLE CARDS ***
Dealt to matiko09 [Ah Jh]
rycho222: folds 
Frosch1907: folds 
azzad2007: folds 
Filojoes: folds 
matiko09: raises $1.27 to $2.27
mr. four-eye: calls $1.77
djammusic: folds 
*** FLOP *** [8c 5d 4c]
mr. four-eye: checks 
matiko09: checks 
*** TURN *** [8c 5d 4c] [Ac]
mr. four-eye: checks 
matiko09: bets $4
mr. four-eye: folds 
Uncalled bet ($4) returned to matiko09
matiko09 collected $5.26 from pot
matiko09: doesn't show hand 
*** SUMMARY ***
Total pot $5.54 | Rake $0.28 
Board [8c 5d 4c Ac]
Seat 1: Frosch1907 folded before Flop (didn't bet)
Seat 2: azzad2007 folded before Flop (didn't bet)
Seat 4: Filojoes folded before Flop (didn't bet)
Seat 5: matiko09 (button) collected ($5.26)
Seat 6: mr. four-eye (small blind) folded on the Turn
Seat 7: djammusic (big blind) folded before Flop
Seat 8: rycho222 folded before Flop (didn't bet)





PokerStars Hand #151942505848:  Hold'em No Limit ($0.50/$1.00 USD) - 2016/04/15 13:24:34 CET [2016/04/15 7:24:34 ET]
Table 'Chiny II' 9-max Seat #7 is the button
Seat 1: aseban11 ($101.50 in chips) 
Seat 2: AceFarky ($114.57 in chips) 
Seat 3: powerbel ($41.90 in chips) 
Seat 4: 1000karlos ($89.49 in chips) 
Seat 5: Yaaaazz ($109.50 in chips) 
Seat 6: choupai ($39.96 in chips) 
Seat 7: matiko09 ($147.88 in chips) 
Seat 8: Filojoes ($106.09 in chips) 
Filojoes: posts small blind $0.50
butcheN18: is sitting out 
aseban11: posts big blind $1
*** HOLE CARDS ***
Dealt to matiko09 [Qh 4h]
butcheN18 leaves the table
AceFarky: folds 
powerbel: folds 
1000karlos: folds 
Yaaaazz: folds 
choupai: folds 
matiko09: folds 
maxxmeister joins the table at seat #9 
Filojoes: raises $1.50 to $2.50
aseban11: calls $1.50
*** FLOP *** [Kh 7d As]
Filojoes: bets $2.85
aseban11: folds 
Uncalled bet ($2.85) returned to Filojoes
Filojoes collected $4.75 from pot
Filojoes: doesn't show hand 
*** SUMMARY ***
Total pot $5 | Rake $0.25 
Board [Kh 7d As]
Seat 1: aseban11 (big blind) folded on the Flop
Seat 2: AceFarky folded before Flop (didn't bet)
Seat 3: powerbel folded before Flop (didn't bet)
Seat 4: 1000karlos folded before Flop (didn't bet)
Seat 5: Yaaaazz folded before Flop (didn't bet)
Seat 6: choupai folded before Flop (didn't bet)
Seat 7: matiko09 (button) folded before Flop (didn't bet)
Seat 8: Filojoes (small blind) collected ($4.75)





PokerStars Hand #151942508046:  Hold'em No Limit ($1/$2 USD) - 2016/04/15 13:24:39 CET [2016/04/15 7:24:39 ET]
Table 'Oceax' 9-max Seat #4 is the button
Seat 1: matiko09 ($209 in chips) 
Seat 2: Fish4trips ($310.36 in chips) 
Seat 3: MiiFuxU ($200 in chips) 
Seat 4: butcheN18 ($235.42 in chips) 
Seat 5: di0d80 ($204 in chips) 
Seat 6: Iggso ($208 in chips) 
Seat 7: djlaw321 ($151 in chips) 
Seat 9: Olddogtom888 ($293.53 in chips) 
di0d80: posts small blind $1
Iggso: posts big blind $2
Poroxide: sits out 
*** HOLE CARDS ***
Dealt to matiko09 [Jd 2d]
djlaw321: folds 
Olddogtom888: folds 
matiko09: folds 
Fish4trips: raises $3 to $5
MiiFuxU: folds 
MiiFuxU leaves the table
butcheN18: folds 
Yaaaazz joins the table at seat #3 
di0d80: folds 
Iggso: folds 
Uncalled bet ($3) returned to Fish4trips
Fish4trips collected $5 from pot
Fish4trips: doesn't show hand 
*** SUMMARY ***
Total pot $5 | Rake $0 
Seat 1: matiko09 folded before Flop (didn't bet)
Seat 2: Fish4trips collected ($5)
Seat 3: MiiFuxU folded before Flop (didn't bet)
Seat 4: butcheN18 (button) folded before Flop (didn't bet)
Seat 5: di0d80 (small blind) folded before Flop
Seat 6: Iggso (big blind) folded before Flop
Seat 7: djlaw321 folded before Flop (didn't bet)
Seat 9: Olddogtom888 folded before Flop (didn't bet)





PokerStars Hand #151942512040:  Hold'em No Limit ($1/$2 USD) - 2016/04/15 13:24:48 CET [2016/04/15 7:24:48 ET]
Table 'Patroclus II' 9-max Seat #2 is the button
Seat 1: TonnaMunz ($204.04 in chips) 
Seat 2: Moemors ($102.65 in chips) 
Seat 3: Koolniknik ($198.85 in chips) 
Seat 4: tipner ($200 in chips) 
Seat 5: butcheN18 ($262.29 in chips) 
Seat 6: di0d80 ($200 in chips) 
Seat 7: matiko09 ($251.76 in chips) 
Seat 9: Fish4trips ($231.72 in chips) 
Koolniknik: posts small blind $1
tipner: posts big blind $2
Glushchenko: sits out 
*** HOLE CARDS ***
Dealt to matiko09 [4h Qh]
butcheN18: raises $4 to $6
di0d80: folds 
matiko09: folds 
Fish4trips: folds 
TonnaMunz: raises $14 to $20
Moemors: folds 
Koolniknik: folds 
tipner: folds 
butcheN18: folds 
Uncalled bet ($14) returned to TonnaMunz
TonnaMunz collected $15 from pot
*** SUMMARY ***
Total pot $15 | Rake $0 
Seat 1: TonnaMunz collected ($15)
Seat 2: Moemors (button) folded before Flop (didn't bet)
Seat 3: Koolniknik (small blind) folded before Flop
Seat 4: tipner (big blind) folded before Flop
Seat 5: butcheN18 folded before Flop
Seat 6: di0d80 folded before Flop (didn't bet)
Seat 7: matiko09 folded before Flop (didn't bet)
Seat 9: Fish4trips folded before Flop (didn't bet)





PokerStars Hand #151942513421:  Hold'em No Limit ($0.50/$1.00 USD) - 2016/04/15 13:24:50 CET [2016/04/15 7:24:50 ET]
Table 'Parvulesco II' 9-max Seat #5 is the button
Seat 1: bilukm ($48.78 in chips) 
Seat 2: SerAlGog ($272.80 in chips) 
Seat 3: matiko09 ($100 in chips) 
Seat 4: butcheN18 ($100.31 in chips) 
Seat 5: bronbeek ($70.27 in chips) 
Seat 6: Glushchenko ($124.04 in chips) 
Seat 7: djammusic ($43.36 in chips) 
Seat 9: hammerwife ($212.88 in chips) 
Glushchenko: posts small blind $0.50
djammusic: posts big blind $1
Jimy Tiltman: sits out 
*** HOLE CARDS ***
Dealt to matiko09 [Qd 2s]
hammerwife: folds 
bilukm: raises $1 to $2
SerAlGog: folds 
matiko09: folds 
butcheN18: folds 
bronbeek: folds 
Glushchenko: folds 
djammusic: folds 
Uncalled bet ($1) returned to bilukm
bilukm collected $2.50 from pot
bilukm: doesn't show hand 
*** SUMMARY ***
Total pot $2.50 | Rake $0 
Seat 1: bilukm collected ($2.50)
Seat 2: SerAlGog folded before Flop (didn't bet)
Seat 3: matiko09 folded before Flop (didn't bet)
Seat 4: butcheN18 folded before Flop (didn't bet)
Seat 5: bronbeek (button) folded before Flop (didn't bet)
Seat 6: Glushchenko (small blind) folded before Flop
Seat 7: djammusic (big blind) folded before Flop
Seat 9: hammerwife folded before Flop (didn't bet)





PokerStars Hand #151942515364:  Hold'em No Limit ($1/$2 USD) - 2016/04/15 13:24:55 CET [2016/04/15 7:24:55 ET]
Table 'Irmgard II' 9-max Seat #3 is the button
Seat 2: Iggso ($210.71 in chips) 
Seat 3: matiko09 ($200 in chips) 
Seat 4: di0d80 ($200 in chips) 
Seat 5: vezunchik79 ($200 in chips) 
Seat 7: TonnaMunz ($200 in chips) 
Seat 9: maximax04 ($205.75 in chips) 
di0d80: posts small blind $1
vezunchik79: posts big blind $2
djammusic: sits out 
T0ny Adams: sits out 
*** HOLE CARDS ***
Dealt to matiko09 [5h 3s]
TonnaMunz: folds 
maximax04: folds 
Iggso: folds 
matiko09: folds 
di0d80: folds 
Uncalled bet ($1) returned to vezunchik79
vezunchik79 collected $2 from pot
*** SUMMARY ***
Total pot $2 | Rake $0 
Seat 2: Iggso folded before Flop (didn't bet)
Seat 3: matiko09 (button) folded before Flop (didn't bet)
Seat 4: di0d80 (small blind) folded before Flop
Seat 5: vezunchik79 (big blind) collected ($2)
Seat 7: TonnaMunz folded before Flop (didn't bet)
Seat 9: maximax04 folded before Flop (didn't bet)





PokerStars Hand #151942516038:  Hold'em No Limit ($0.50/$1.00 USD) - 2016/04/15 13:24:56 CET [2016/04/15 7:24:56 ET]
Table 'Cheruskia II' 9-max Seat #4 is the button
Seat 1: vicus1972 ($59.46 in chips) 
Seat 2: SerAlGog ($100 in chips) 
Seat 3: butcheN18 ($137.55 in chips) 
Seat 4: djammusic ($45.65 in chips) 
Seat 6: hammerwife ($124.10 in chips) 
Seat 7: matiko09 ($100 in chips) 
Seat 8: ardo888 ($135.84 in chips) 
Seat 9: rycho222 ($103 in chips) 
Filojoes will be allowed to play after the button
hammerwife: posts small blind $0.50
matiko09: posts big blind $1
*** HOLE CARDS ***
Dealt to matiko09 [7s Tc]
ardo888: folds 
rycho222: folds 
vicus1972: folds 
SerAlGog: folds 
butcheN18: folds 
djammusic: folds 
hammerwife: folds 
Uncalled bet ($0.50) returned to matiko09
matiko09 collected $1 from pot
matiko09: doesn't show hand 
*** SUMMARY ***
Total pot $1 | Rake $0 
Seat 1: vicus1972 folded before Flop (didn't bet)
Seat 2: SerAlGog folded before Flop (didn't bet)
Seat 3: butcheN18 folded before Flop (didn't bet)
Seat 4: djammusic (button) folded before Flop (didn't bet)
Seat 6: hammerwife (small blind) folded before Flop
Seat 7: matiko09 (big blind) collected ($1)
Seat 8: ardo888 folded before Flop (didn't bet)
Seat 9: rycho222 folded before Flop (didn't bet)





PokerStars Hand #151942517172:  Hold'em No Limit ($0.50/$1.00 USD) - 2016/04/15 13:24:58 CET [2016/04/15 7:24:58 ET]
Table 'Navi' 9-max Seat #8 is the button
Seat 1: tipner ($100 in chips) 
Seat 2: butcheN18 ($100 in chips) 
Seat 3: aseban11 ($110.93 in chips) 
Seat 4: Effort92 ($120.63 in chips) 
Seat 7: yoshidao ($154.45 in chips) 
Seat 8: djammusic ($53.09 in chips) 
Seat 9: matiko09 ($108.95 in chips) 
matiko09: posts small blind $0.50
tipner: posts big blind $1
hammerwife: sits out 
Glushchenko: sits out 
*** HOLE CARDS ***
Dealt to matiko09 [8s Ts]
butcheN18: folds 
aseban11: raises $2 to $3
Effort92: folds 
yoshidao: folds 
djammusic: folds 
matiko09: folds 
tipner: folds 
Uncalled bet ($2) returned to aseban11
aseban11 collected $2.50 from pot
aseban11: doesn't show hand 
*** SUMMARY ***
Total pot $2.50 | Rake $0 
Seat 1: tipner (big blind) folded before Flop
Seat 2: butcheN18 folded before Flop (didn't bet)
Seat 3: aseban11 collected ($2.50)
Seat 4: Effort92 folded before Flop (didn't bet)
Seat 7: yoshidao folded before Flop (didn't bet)
Seat 8: djammusic (button) folded before Flop (didn't bet)
Seat 9: matiko09 (small blind) folded before Flop





PokerStars Hand #151942517828:  Hold'em No Limit ($0.50/$1.00 USD) - 2016/04/15 13:25:00 CET [2016/04/15 7:25:00 ET]
Table 'Katja II' 9-max Seat #1 is the button
Seat 1: Filojoes ($100 in chips) 
Seat 2: TheJokerMen1 ($53.61 in chips) 
Seat 3: matiko09 ($138.62 in chips) 
Seat 4: Sutt_420 ($70.70 in chips) 
Seat 6: ASG2016 ($110.54 in chips) 
Seat 7: Effort92 ($102.67 in chips) 
Seat 9: hardeep13 ($71.96 in chips) 
TheJokerMen1: posts small blind $0.50
matiko09: posts big blind $1
Glushchenko: sits out 
*** HOLE CARDS ***
Dealt to matiko09 [8s Tc]
Sutt_420: folds 
ASG2016: folds 
Effort92: folds 
hardeep13: folds 
Filojoes: raises $1 to $2
TheJokerMen1: folds 
matiko09: folds 
Uncalled bet ($1) returned to Filojoes
Filojoes collected $2.50 from pot
Filojoes: doesn't show hand 
*** SUMMARY ***
Total pot $2.50 | Rake $0 
Seat 1: Filojoes (button) collected ($2.50)
Seat 2: TheJokerMen1 (small blind) folded before Flop
Seat 3: matiko09 (big blind) folded before Flop
Seat 4: Sutt_420 folded before Flop (didn't bet)
Seat 6: ASG2016 folded before Flop (didn't bet)
Seat 7: Effort92 folded before Flop (didn't bet)
Seat 9: hardeep13 folded before Flop (didn't bet)





PokerStars Hand #151942518572:  Hold'em No Limit ($1/$2 USD) - 2016/04/15 13:25:01 CET [2016/04/15 7:25:01 ET]
Table 'Adele II' 9-max Seat #8 is the button
Seat 1: RyanHuJun ($247.52 in chips) 
Seat 2: Fish4trips ($200 in chips) 
Seat 3: matiko09 ($325.45 in chips) 
Seat 6: wiseyoyo ($217.93 in chips) 
Seat 7: Iggso ($200 in chips) 
Seat 8: docmarc777 ($375.92 in chips) 
SanychStar will be allowed to play after the button
RyanHuJun: posts small blind $1
Fish4trips: posts big blind $2
Glushchenko: sits out 
*** HOLE CARDS ***
Dealt to matiko09 [9h 6c]
matiko09: folds 
wiseyoyo: raises $3 to $5
Iggso: calls $5
docmarc777: folds 
RyanHuJun: calls $4
Fish4trips: folds 
*** FLOP *** [4h Jc 8h]
RyanHuJun: checks 
wiseyoyo: checks 
Iggso: bets $10.17
RyanHuJun: folds 
wiseyoyo: calls $10.17
*** TURN *** [4h Jc 8h] [6s]
wiseyoyo: checks 
Iggso: checks 
*** RIVER *** [4h Jc 8h 6s] [2h]
wiseyoyo: checks 
Iggso: checks 
*** SHOW DOWN ***
wiseyoyo: shows [8s 7s] (a pair of Eights)
Iggso: mucks hand 
wiseyoyo collected $35.47 from pot
*** SUMMARY ***
Total pot $37.34 | Rake $1.87 
Board [4h Jc 8h 6s 2h]
Seat 1: RyanHuJun (small blind) folded on the Flop
Seat 2: Fish4trips (big blind) folded before Flop
Seat 3: matiko09 folded before Flop (didn't bet)
Seat 6: wiseyoyo showed [8s 7s] and won ($35.47) with a pair of Eights
Seat 7: Iggso mucked [Ac Th]
Seat 8: docmarc777 (button) folded before Flop (didn't bet)





PokerStars Hand #151942520279:  Hold'em No Limit ($0.50/$1.00 USD) - 2016/04/15 13:25:05 CET [2016/04/15 7:25:05 ET]
Table 'Adelgunde III' 9-max Seat #5 is the button
Seat 1: valimiu ($55.65 in chips) 
Seat 2: djammusic ($46.88 in chips) 
Seat 3: tipner ($103.02 in chips) 
Seat 4: hammerwife ($100 in chips) 
Seat 5: matiko09 ($100 in chips) 
Seat 6: Pominator92 ($52.94 in chips) 
Seat 7: Foton18 ($80 in chips) 
Pominator92: posts small blind $0.50
Foton18: posts big blind $1
aseban11: sits out 
Kukuryzka: sits out 
*** HOLE CARDS ***
Dealt to matiko09 [7s 2c]
valimiu: calls $1
djammusic: folds 
tipner: folds 
hammerwife: folds 
matiko09: folds 
Pominator92: raises $2 to $3
Foton18: folds 
valimiu: calls $2
*** FLOP *** [3c Kh 3d]
Pominator92: bets $3
valimiu: folds 
Uncalled bet ($3) returned to Pominator92
Pominator92 collected $6.65 from pot
Pominator92: doesn't show hand 
*** SUMMARY ***
Total pot $7 | Rake $0.35 
Board [3c Kh 3d]
Seat 1: valimiu folded on the Flop
Seat 2: djammusic folded before Flop (didn't bet)
Seat 3: tipner folded before Flop (didn't bet)
Seat 4: hammerwife folded before Flop (didn't bet)
Seat 5: matiko09 (button) folded before Flop (didn't bet)
Seat 6: Pominator92 (small blind) collected ($6.65)
Seat 7: Foton18 (big blind) folded before Flop





PokerStars Hand #151942522946:  Hold'em No Limit ($0.50/$1.00 USD) - 2016/04/15 13:25:11 CET [2016/04/15 7:25:11 ET]
Table 'Kreusa II' 9-max Seat #6 is the button
Seat 1: Frosch1907 ($42.11 in chips) 
Seat 2: azzad2007 ($101.50 in chips) 
Seat 4: Filojoes ($100 in chips) 
Seat 5: matiko09 ($122.33 in chips) 
Seat 6: mr. four-eye ($99.01 in chips) 
Seat 7: djammusic ($42.19 in chips) 
Seat 8: rycho222 ($120.47 in chips) 
djammusic: posts small blind $0.50
rycho222: posts big blind $1
Glushchenko: sits out 
*** HOLE CARDS ***
Dealt to matiko09 [4c Ah]
Frosch1907: calls $1
azzad2007: folds 
Filojoes: folds 
matiko09: folds 
mr. four-eye: folds 
djammusic: folds 
rycho222: checks 
*** FLOP *** [2h 2s Jd]
rycho222: checks 
Frosch1907: bets $2
rycho222: folds 
Uncalled bet ($2) returned to Frosch1907
Frosch1907 collected $2.38 from pot
*** SUMMARY ***
Total pot $2.50 | Rake $0.12 
Board [2h 2s Jd]
Seat 1: Frosch1907 collected ($2.38)
Seat 2: azzad2007 folded before Flop (didn't bet)
Seat 4: Filojoes folded before Flop (didn't bet)
Seat 5: matiko09 folded before Flop (didn't bet)
Seat 6: mr. four-eye (button) folded before Flop (didn't bet)
Seat 7: djammusic (small blind) folded before Flop
Seat 8: rycho222 (big blind) folded on the Flop





PokerStars Hand #151942523307:  Hold'em No Limit ($0.50/$1.00 USD) - 2016/04/15 13:25:12 CET [2016/04/15 7:25:12 ET]
Table 'Cheruskia II' 9-max Seat #6 is the button
Seat 1: vicus1972 ($59.46 in chips) 
Seat 2: SerAlGog ($100 in chips) 
Seat 3: butcheN18 ($137.55 in chips) 
Seat 4: djammusic ($45.65 in chips) 
Seat 6: hammerwife ($123.60 in chips) 
Seat 7: matiko09 ($100.50 in chips) 
Seat 8: ardo888 ($135.84 in chips) 
Seat 9: rycho222 ($103 in chips) 
matiko09: posts small blind $0.50
ardo888: posts big blind $1
Filojoes: sits out 
*** HOLE CARDS ***
Dealt to matiko09 [Qd 9s]
rycho222: raises $1 to $2
vicus1972: folds 
SerAlGog: raises $6 to $8
butcheN18: folds 
djammusic: folds 
hammerwife: folds 
matiko09: folds 
ardo888: folds 
rycho222: calls $6
*** FLOP *** [Ah 6c 8c]
rycho222: checks 
SerAlGog: bets $8.47
rycho222: calls $8.47
*** TURN *** [Ah 6c 8c] [2c]
rycho222: checks 
SerAlGog: checks 
*** RIVER *** [Ah 6c 8c 2c] [6d]
rycho222: bets $16
SerAlGog: calls $16
*** SHOW DOWN ***
rycho222: shows [Jh Ac] (two pair, Aces and Sixes)
SerAlGog: mucks hand 
rycho222 collected $63.94 from pot
*** SUMMARY ***
Total pot $66.44 | Rake $2.50 
Board [Ah 6c 8c 2c 6d]
Seat 1: vicus1972 folded before Flop (didn't bet)
Seat 2: SerAlGog mucked [Qc Qh]
Seat 3: butcheN18 folded before Flop (didn't bet)
Seat 4: djammusic folded before Flop (didn't bet)
Seat 6: hammerwife (button) folded before Flop (didn't bet)
Seat 7: matiko09 (small blind) folded before Flop
Seat 8: ardo888 (big blind) folded before Flop
Seat 9: rycho222 showed [Jh Ac] and won ($63.94) with two pair, Aces and Sixes





PokerStars Hand #151942524149:  Hold'em No Limit ($1/$2 USD) - 2016/04/15 13:25:13 CET [2016/04/15 7:25:13 ET]
Table 'Irmgard II' 9-max Seat #4 is the button
Seat 2: Iggso ($210.71 in chips) 
Seat 3: matiko09 ($200 in chips) 
Seat 4: di0d80 ($200 in chips) 
Seat 5: vezunchik79 ($201 in chips) 
Seat 6: djammusic ($80 in chips) 
Seat 7: TonnaMunz ($200 in chips) 
Seat 9: maximax04 ($205.75 in chips) 
vezunchik79: posts small blind $1
djammusic: posts big blind $2
T0ny Adams: sits out 
*** HOLE CARDS ***
Dealt to matiko09 [6s 9c]
TonnaMunz: folds 
TonnaMunz leaves the table
maximax04: folds 
Iggso: folds 
matiko09: folds 
di0d80: raises $2 to $4
vezunchik79: folds 
djammusic: folds 
Uncalled bet ($2) returned to di0d80
di0d80 collected $5 from pot
di0d80: doesn't show hand 
*** SUMMARY ***
Total pot $5 | Rake $0 
Seat 2: Iggso folded before Flop (didn't bet)
Seat 3: matiko09 folded before Flop (didn't bet)
Seat 4: di0d80 (button) collected ($5)
Seat 5: vezunchik79 (small blind) folded before Flop
Seat 6: djammusic (big blind) folded before Flop
Seat 7: TonnaMunz folded before Flop (didn't bet)
Seat 9: maximax04 folded before Flop (didn't bet)





PokerStars Hand #151942523734:  Hold'em No Limit ($1/$2 USD) - 2016/04/15 13:25:13 CET [2016/04/15 7:25:13 ET]
Table 'Oceax' 9-max Seat #5 is the button
Seat 1: matiko09 ($209 in chips) 
Seat 2: Fish4trips ($313.36 in chips) 
Seat 4: butcheN18 ($235.42 in chips) 
Seat 5: di0d80 ($203 in chips) 
Seat 6: Iggso ($206 in chips) 
Seat 7: djlaw321 ($151 in chips) 
Seat 9: Olddogtom888 ($293.53 in chips) 
Iggso: posts small blind $1
djlaw321: posts big blind $2
Poroxide: sits out 
Yaaaazz: sits out 
*** HOLE CARDS ***
Dealt to matiko09 [Ah 2d]
Olddogtom888: folds 
matiko09: folds 
Fish4trips: folds 
butcheN18: folds 
di0d80: raises $2 to $4
Iggso: folds 
djlaw321: folds 
Uncalled bet ($2) returned to di0d80
di0d80 collected $5 from pot
di0d80: doesn't show hand 
*** SUMMARY ***
Total pot $5 | Rake $0 
Seat 1: matiko09 folded before Flop (didn't bet)
Seat 2: Fish4trips folded before Flop (didn't bet)
Seat 4: butcheN18 folded before Flop (didn't bet)
Seat 5: di0d80 (button) collected ($5)
Seat 6: Iggso (small blind) folded before Flop
Seat 7: djlaw321 (big blind) folded before Flop
Seat 9: Olddogtom888 folded before Flop (didn't bet)





PokerStars Hand #151942526701:  Hold'em No Limit ($0.50/$1.00 USD) - 2016/04/15 13:25:19 CET [2016/04/15 7:25:19 ET]
Table 'Navi' 9-max Seat #9 is the button
Seat 1: tipner ($100 in chips) 
Seat 2: butcheN18 ($100 in chips) 
Seat 3: aseban11 ($112.43 in chips) 
Seat 4: Effort92 ($120.63 in chips) 
Seat 7: yoshidao ($154.45 in chips) 
Seat 8: djammusic ($53.09 in chips) 
Seat 9: matiko09 ($108.45 in chips) 
tipner: posts small blind $0.50
butcheN18: posts big blind $1
hammerwife: sits out 
Glushchenko: sits out 
*** HOLE CARDS ***
Dealt to matiko09 [Th Jd]
aseban11: folds 
Effort92: raises $1.50 to $2.50
yoshidao: folds 
djammusic: folds 
matiko09: folds 
tipner: folds 
butcheN18: folds 
Uncalled bet ($1.50) returned to Effort92
Effort92 collected $2.50 from pot
Effort92: doesn't show hand 
*** SUMMARY ***
Total pot $2.50 | Rake $0 
Seat 1: tipner (small blind) folded before Flop
Seat 2: butcheN18 (big blind) folded before Flop
Seat 3: aseban11 folded before Flop (didn't bet)
Seat 4: Effort92 collected ($2.50)
Seat 7: yoshidao folded before Flop (didn't bet)
Seat 8: djammusic folded before Flop (didn't bet)
Seat 9: matiko09 (button) folded before Flop (didn't bet)





PokerStars Hand #151942527473:  Hold'em No Limit ($0.50/$1.00 USD) - 2016/04/15 13:25:21 CET [2016/04/15 7:25:21 ET]
Table 'Parvulesco II' 9-max Seat #6 is the button
Seat 1: bilukm ($50.28 in chips) 
Seat 2: SerAlGog ($272.80 in chips) 
Seat 3: matiko09 ($100 in chips) 
Seat 4: butcheN18 ($100.31 in chips) 
Seat 5: bronbeek ($70.27 in chips) 
Seat 6: Glushchenko ($123.54 in chips) 
Seat 7: djammusic ($42.36 in chips) 
Seat 8: Jimy Tiltman ($100 in chips) 
Seat 9: hammerwife ($212.88 in chips) 
djammusic: posts small blind $0.50
Jimy Tiltman: posts big blind $1
*** HOLE CARDS ***
Dealt to matiko09 [9c Kd]
hammerwife: folds 
bilukm: raises $1 to $2
SerAlGog: folds 
matiko09: folds 
butcheN18: folds 
bronbeek: folds 
Glushchenko: folds 
djammusic: folds 
Jimy Tiltman: calls $1
*** FLOP *** [7c 3d 8d]
Jimy Tiltman: checks 
bilukm: bets $4.28
Jimy Tiltman: folds 
Uncalled bet ($4.28) returned to bilukm
bilukm collected $4.28 from pot
bilukm: doesn't show hand 
*** SUMMARY ***
Total pot $4.50 | Rake $0.22 
Board [7c 3d 8d]
Seat 1: bilukm collected ($4.28)
Seat 2: SerAlGog folded before Flop (didn't bet)
Seat 3: matiko09 folded before Flop (didn't bet)
Seat 4: butcheN18 folded before Flop (didn't bet)
Seat 5: bronbeek folded before Flop (didn't bet)
Seat 6: Glushchenko (button) folded before Flop (didn't bet)
Seat 7: djammusic (small blind) folded before Flop
Seat 8: Jimy Tiltman (big blind) folded on the Flop
Seat 9: hammerwife folded before Flop (didn't bet)





PokerStars Hand #151942528455:  Hold'em No Limit ($1/$2 USD) - 2016/04/15 13:25:23 CET [2016/04/15 7:25:23 ET]
Table 'Patroclus II' 9-max Seat #3 is the button
Seat 1: TonnaMunz ($213.04 in chips) 
Seat 2: Moemors ($102.65 in chips) 
Seat 3: Koolniknik ($197.85 in chips) 
Seat 4: tipner ($200 in chips) 
Seat 5: butcheN18 ($256.29 in chips) 
Seat 6: di0d80 ($200 in chips) 
Seat 7: matiko09 ($251.76 in chips) 
Seat 9: Fish4trips ($231.72 in chips) 
tipner: posts small blind $1
butcheN18: posts big blind $2
Glushchenko: sits out 
*** HOLE CARDS ***
Dealt to matiko09 [5h 8d]
di0d80: folds 
matiko09: folds 
Fish4trips: folds 
TonnaMunz: folds 
Moemors: calls $2
Koolniknik: raises $4 to $6
tipner: folds 
butcheN18: folds 
Moemors: calls $4
*** FLOP *** [4c 9d Th]
Moemors: checks 
Koolniknik: bets $7.12
Moemors: calls $7.12
*** TURN *** [4c 9d Th] [5s]
Moemors: checks 
Koolniknik: checks 
*** RIVER *** [4c 9d Th 5s] [6c]
Moemors: checks 
Koolniknik: bets $13.89
Moemors: folds 
Uncalled bet ($13.89) returned to Koolniknik
Koolniknik collected $27.78 from pot
Koolniknik: doesn't show hand 
*** SUMMARY ***
Total pot $29.24 | Rake $1.46 
Board [4c 9d Th 5s 6c]
Seat 1: TonnaMunz folded before Flop (didn't bet)
Seat 2: Moemors folded on the River
Seat 3: Koolniknik (button) collected ($27.78)
Seat 4: tipner (small blind) folded before Flop
Seat 5: butcheN18 (big blind) folded before Flop
Seat 6: di0d80 folded before Flop (didn't bet)
Seat 7: matiko09 folded before Flop (didn't bet)
Seat 9: Fish4trips folded before Flop (didn't bet)





PokerStars Hand #151942529870:  Hold'em No Limit ($0.50/$1.00 USD) - 2016/04/15 13:25:26 CET [2016/04/15 7:25:26 ET]
Table 'Chiny II' 9-max Seat #8 is the button
Seat 1: aseban11 ($100 in chips) 
Seat 3: powerbel ($41.90 in chips) 
Seat 4: 1000karlos ($89.49 in chips) 
Seat 5: Yaaaazz ($109.50 in chips) 
Seat 6: choupai ($39.96 in chips) 
Seat 7: matiko09 ($147.88 in chips) 
Seat 8: Filojoes ($108.34 in chips) 
aseban11: posts small blind $0.50
AceFarky: is sitting out 
powerbel: posts big blind $1
*** HOLE CARDS ***
Dealt to matiko09 [5d Js]
1000karlos: folds 
Yaaaazz: folds 
AceFarky leaves the table
choupai: folds 
Glushchenko joins the table at seat #2 
matiko09: folds 
Filojoes: folds 
aseban11: folds 
Uncalled bet ($0.50) returned to powerbel
powerbel collected $1 from pot
powerbel: doesn't show hand 
*** SUMMARY ***
Total pot $1 | Rake $0 
Seat 1: aseban11 (small blind) folded before Flop
Seat 3: powerbel (big blind) collected ($1)
Seat 4: 1000karlos folded before Flop (didn't bet)
Seat 5: Yaaaazz folded before Flop (didn't bet)
Seat 6: choupai folded before Flop (didn't bet)
Seat 7: matiko09 folded before Flop (didn't bet)
Seat 8: Filojoes (button) folded before Flop (didn't bet)





PokerStars Hand #151942533101:  Hold'em No Limit ($0.50/$1.00 USD) - 2016/04/15 13:25:32 CET [2016/04/15 7:25:32 ET]
Table 'Lamberta III' 9-max Seat #5 is the button
Seat 1: Westpants ($100 in chips) 
Seat 2: Biscuit270 ($119.30 in chips) 
Seat 3: butcheN18 ($203.10 in chips) 
Seat 4: Filojoes ($103.09 in chips) 
Seat 5: tipner ($112.10 in chips) 
Seat 6: aseban11 ($102.72 in chips) 
Seat 7: rycho222 ($97.50 in chips) 
Seat 8: wangzhuoming ($107.80 in chips) 
Seat 9: matiko09 ($154.36 in chips) 
aseban11: posts small blind $0.50
rycho222: posts big blind $1
*** HOLE CARDS ***
Dealt to matiko09 [7c 8h]
wangzhuoming: raises $2 to $3
matiko09: folds 
Westpants: folds 
Biscuit270: folds 
butcheN18: folds 
Filojoes: folds 
tipner: folds 
aseban11: folds 
rycho222: folds 
Uncalled bet ($2) returned to wangzhuoming
wangzhuoming collected $2.50 from pot
wangzhuoming: doesn't show hand 
*** SUMMARY ***
Total pot $2.50 | Rake $0 
Seat 1: Westpants folded before Flop (didn't bet)
Seat 2: Biscuit270 folded before Flop (didn't bet)
Seat 3: butcheN18 folded before Flop (didn't bet)
Seat 4: Filojoes folded before Flop (didn't bet)
Seat 5: tipner (button) folded before Flop (didn't bet)
Seat 6: aseban11 (small blind) folded before Flop
Seat 7: rycho222 (big blind) folded before Flop
Seat 8: wangzhuoming collected ($2.50)
Seat 9: matiko09 folded before Flop (didn't bet)





PokerStars Hand #151942535134:  Hold'em No Limit ($1/$2 USD) - 2016/04/15 13:25:37 CET [2016/04/15 7:25:37 ET]
Table 'Oceax' 9-max Seat #6 is the button
Seat 1: matiko09 ($209 in chips) 
Seat 4: butcheN18 ($235.42 in chips) 
Seat 5: di0d80 ($206 in chips) 
Seat 6: Iggso ($205 in chips) 
Seat 7: djlaw321 ($149 in chips) 
Seat 8: Poroxide ($200 in chips) 
Seat 9: Olddogtom888 ($293.53 in chips) 
djlaw321: posts small blind $1
Poroxide: posts big blind $2
Yaaaazz: sits out 
*** HOLE CARDS ***
Dealt to matiko09 [4d 4s]
Olddogtom888: folds 
matiko09: folds 
butcheN18: folds 
di0d80: folds 
Iggso: raises $4 to $6
djlaw321: folds 
Poroxide: calls $4
*** FLOP *** [8s 6d Qh]
Poroxide: bets $6
Iggso: folds 
Uncalled bet ($6) returned to Poroxide
Poroxide collected $12.35 from pot
Poroxide: doesn't show hand 
*** SUMMARY ***
Total pot $13 | Rake $0.65 
Board [8s 6d Qh]
Seat 1: matiko09 folded before Flop (didn't bet)
Seat 4: butcheN18 folded before Flop (didn't bet)
Seat 5: di0d80 folded before Flop (didn't bet)
Seat 6: Iggso (button) folded on the Flop
Seat 7: djlaw321 (small blind) folded before Flop
Seat 8: Poroxide (big blind) collected ($12.35)
Seat 9: Olddogtom888 folded before Flop (didn't bet)





PokerStars Hand #151942539570:  Hold'em No Limit ($1/$2 USD) - 2016/04/15 13:25:47 CET [2016/04/15 7:25:47 ET]
Table 'Irmgard II' 9-max Seat #5 is the button
Seat 2: Iggso ($210.71 in chips) 
Seat 3: matiko09 ($200 in chips) 
Seat 4: di0d80 ($203 in chips) 
Seat 5: vezunchik79 ($200 in chips) 
Seat 6: djammusic ($78 in chips) 
Seat 9: maximax04 ($205.75 in chips) 
djammusic: posts small blind $1
maximax04: posts big blind $2
T0ny Adams: sits out 
*** HOLE CARDS ***
Dealt to matiko09 [2s 4h]
Iggso: raises $4 to $6
matiko09: folds 
di0d80: folds 
vezunchik79: folds 
djammusic: folds 
maximax04: folds 
Uncalled bet ($4) returned to Iggso
Iggso collected $5 from pot
Iggso: doesn't show hand 
*** SUMMARY ***
Total pot $5 | Rake $0 
Seat 2: Iggso collected ($5)
Seat 3: matiko09 folded before Flop (didn't bet)
Seat 4: di0d80 folded before Flop (didn't bet)
Seat 5: vezunchik79 (button) folded before Flop (didn't bet)
Seat 6: djammusic (small blind) folded before Flop
Seat 9: maximax04 (big blind) folded before Flop





PokerStars Hand #151942542611:  Hold'em No Limit ($0.50/$1.00 USD) - 2016/04/15 13:25:53 CET [2016/04/15 7:25:53 ET]
Table 'Katja II' 9-max Seat #2 is the button
Seat 1: Filojoes ($101.50 in chips) 
Seat 2: TheJokerMen1 ($53.11 in chips) 
Seat 3: matiko09 ($137.62 in chips) 
Seat 4: Sutt_420 ($70.70 in chips) 
Seat 6: ASG2016 ($110.54 in chips) 
Seat 7: Effort92 ($102.67 in chips) 
Seat 9: hardeep13 ($71.96 in chips) 
matiko09: posts small blind $0.50
Sutt_420: posts big blind $1
Glushchenko: sits out 
*** HOLE CARDS ***
Dealt to matiko09 [Jh 5c]
ASG2016: raises $2 to $3
Effort92: folds 
hardeep13: calls $3
Filojoes: folds 
TheJokerMen1: calls $3
matiko09: folds 
Sutt_420: folds 
*** FLOP *** [3d 3c Qs]
ASG2016: bets $6
hardeep13: folds 
TheJokerMen1: folds 
Uncalled bet ($6) returned to ASG2016
ASG2016 collected $9.98 from pot
ASG2016: doesn't show hand 
*** SUMMARY ***
Total pot $10.50 | Rake $0.52 
Board [3d 3c Qs]
Seat 1: Filojoes folded before Flop (didn't bet)
Seat 2: TheJokerMen1 (button) folded on the Flop
Seat 3: matiko09 (small blind) folded before Flop
Seat 4: Sutt_420 (big blind) folded before Flop
Seat 6: ASG2016 collected ($9.98)
Seat 7: Effort92 folded before Flop (didn't bet)
Seat 9: hardeep13 folded on the Flop





PokerStars Hand #151942542700:  Hold'em No Limit ($0.50/$1.00 USD) - 2016/04/15 13:25:53 CET [2016/04/15 7:25:53 ET]
Table 'Adelgunde III' 9-max Seat #6 is the button
Seat 1: valimiu ($52.65 in chips) 
Seat 2: djammusic ($46.88 in chips) 
Seat 3: tipner ($103.02 in chips) 
Seat 4: hammerwife ($100 in chips) 
Seat 5: matiko09 ($100 in chips) 
Seat 6: Pominator92 ($56.59 in chips) 
Seat 7: Foton18 ($79 in chips) 
Seat 8: aseban11 ($100 in chips) 
Foton18: posts small blind $0.50
aseban11: posts big blind $1
Kukuryzka: sits out 
*** HOLE CARDS ***
Dealt to matiko09 [Ac Ad]
valimiu: calls $1
djammusic: folds 
tipner: raises $3 to $4
hammerwife: folds 
matiko09: calls $4
Pominator92: folds 
Foton18: folds 
aseban11: folds 
valimiu: folds 
*** FLOP *** [Jh Ks 2d]
tipner: checks 
matiko09: checks 
*** TURN *** [Jh Ks 2d] [Kc]
tipner: checks 
matiko09: bets $5.18
tipner: folds 
Uncalled bet ($5.18) returned to matiko09
matiko09 collected $9.98 from pot
matiko09: doesn't show hand 
*** SUMMARY ***
Total pot $10.50 | Rake $0.52 
Board [Jh Ks 2d Kc]
Seat 1: valimiu folded before Flop
Seat 2: djammusic folded before Flop (didn't bet)
Seat 3: tipner folded on the Turn
Seat 4: hammerwife folded before Flop (didn't bet)
Seat 5: matiko09 collected ($9.98)
Seat 6: Pominator92 (button) folded before Flop (didn't bet)
Seat 7: Foton18 (small blind) folded before Flop
Seat 8: aseban11 (big blind) folded before Flop





PokerStars Hand #151942543340:  Hold'em No Limit ($0.50/$1.00 USD) - 2016/04/15 13:25:54 CET [2016/04/15 7:25:54 ET]
Table 'Chiny II' 9-max Seat #1 is the button
Seat 1: aseban11 ($100 in chips) 
Seat 3: powerbel ($42.40 in chips) 
Seat 4: 1000karlos ($89.49 in chips) 
Seat 5: Yaaaazz ($109.50 in chips) 
Seat 6: choupai ($39.96 in chips) 
Seat 7: matiko09 ($147.88 in chips) 
Seat 8: Filojoes ($108.34 in chips) 
Glushchenko will be allowed to play after the button
powerbel: posts small blind $0.50
1000karlos: posts big blind $1
*** HOLE CARDS ***
Dealt to matiko09 [Kd Qc]
Yaaaazz: folds 
choupai: raises $2 to $3
matiko09: folds 
Filojoes: folds 
aseban11: calls $3
powerbel: folds 
1000karlos: folds 
*** FLOP *** [7h 2s Td]
choupai: checks 
aseban11: bets $4.50
choupai: folds 
Uncalled bet ($4.50) returned to aseban11
aseban11 collected $7.12 from pot
aseban11: doesn't show hand 
*** SUMMARY ***
Total pot $7.50 | Rake $0.38 
Board [7h 2s Td]
Seat 1: aseban11 (button) collected ($7.12)
Seat 3: powerbel (small blind) folded before Flop
Seat 4: 1000karlos (big blind) folded before Flop
Seat 5: Yaaaazz folded before Flop (didn't bet)
Seat 6: choupai folded on the Flop
Seat 7: matiko09 folded before Flop (didn't bet)
Seat 8: Filojoes folded before Flop (didn't bet)





PokerStars Hand #151942543596:  Hold'em No Limit ($1/$2 USD) - 2016/04/15 13:25:55 CET [2016/04/15 7:25:55 ET]
Table 'Adele II' 9-max Seat #1 is the button
Seat 1: RyanHuJun ($242.52 in chips) 
Seat 3: matiko09 ($325.45 in chips) 
Seat 4: Glushchenko ($203 in chips) 
Seat 6: wiseyoyo ($238.23 in chips) 
Seat 7: Iggso ($200 in chips) 
Seat 8: docmarc777 ($375.92 in chips) 
matiko09: posts small blind $1
Glushchenko: posts big blind $2
SanychStar: sits out 
*** HOLE CARDS ***
Dealt to matiko09 [3c Js]
wiseyoyo: folds 
Iggso: folds 
docmarc777: folds 
RyanHuJun: raises $4 to $6
matiko09: folds 
Glushchenko: calls $4
*** FLOP *** [Jd Jc 5d]
Glushchenko: checks 
RyanHuJun: checks 
*** TURN *** [Jd Jc 5d] [Jh]
Glushchenko: checks 
RyanHuJun: checks 
*** RIVER *** [Jd Jc 5d Jh] [7s]
Glushchenko: checks 
RyanHuJun: bets $8
Glushchenko: folds 
Uncalled bet ($8) returned to RyanHuJun
RyanHuJun collected $12.35 from pot
*** SUMMARY ***
Total pot $13 | Rake $0.65 
Board [Jd Jc 5d Jh 7s]
Seat 1: RyanHuJun (button) collected ($12.35)
Seat 3: matiko09 (small blind) folded before Flop
Seat 4: Glushchenko (big blind) folded on the River
Seat 6: wiseyoyo folded before Flop (didn't bet)
Seat 7: Iggso folded before Flop (didn't bet)
Seat 8: docmarc777 folded before Flop (didn't bet)





PokerStars Hand #151942544366:  Hold'em No Limit ($0.50/$1.00 USD) - 2016/04/15 13:25:57 CET [2016/04/15 7:25:57 ET]
Table 'Navi' 9-max Seat #1 is the button
Seat 1: tipner ($100 in chips) 
Seat 2: butcheN18 ($100 in chips) 
Seat 3: aseban11 ($112.43 in chips) 
Seat 4: Effort92 ($122.13 in chips) 
Seat 7: yoshidao ($154.45 in chips) 
Seat 8: djammusic ($53.09 in chips) 
Seat 9: matiko09 ($108.45 in chips) 
butcheN18: posts small blind $0.50
aseban11: posts big blind $1
hammerwife: sits out 
Glushchenko: sits out 
*** HOLE CARDS ***
Dealt to matiko09 [5s 2s]
Effort92: folds 
yoshidao: folds 
djammusic: raises $1.15 to $2.15
matiko09: folds 
tipner: calls $2.15
butcheN18: folds 
aseban11: calls $1.15
*** FLOP *** [3s 5h 3h]
aseban11: checks 
djammusic: checks 
tipner: bets $4
aseban11: folds 
djammusic: folds 
Uncalled bet ($4) returned to tipner
tipner collected $6.60 from pot
tipner: doesn't show hand 
*** SUMMARY ***
Total pot $6.95 | Rake $0.35 
Board [3s 5h 3h]
Seat 1: tipner (button) collected ($6.60)
Seat 2: butcheN18 (small blind) folded before Flop
Seat 3: aseban11 (big blind) folded on the Flop
Seat 4: Effort92 folded before Flop (didn't bet)
Seat 7: yoshidao folded before Flop (didn't bet)
Seat 8: djammusic folded on the Flop
Seat 9: matiko09 folded before Flop (didn't bet)





PokerStars Hand #151942545435:  Hold'em No Limit ($0.50/$1.00 USD) - 2016/04/15 13:25:59 CET [2016/04/15 7:25:59 ET]
Table 'Kreusa II' 9-max Seat #7 is the button
Seat 1: Frosch1907 ($43.49 in chips) 
Seat 2: azzad2007 ($101.50 in chips) 
Seat 4: Filojoes ($100 in chips) 
Seat 5: matiko09 ($122.33 in chips) 
Seat 6: mr. four-eye ($99.01 in chips) 
Seat 7: djammusic ($41.69 in chips) 
Seat 8: rycho222 ($119.47 in chips) 
Seat 9: Glushchenko ($100 in chips) 
rycho222: posts small blind $0.50
Glushchenko: posts big blind $1
*** HOLE CARDS ***
Dealt to matiko09 [Td Qh]
Frosch1907: folds 
azzad2007: folds 
Filojoes: folds 
Frosch1907 leaves the table
matiko09: folds 
mr. four-eye: folds 
djammusic: folds 
rycho222: folds 
Uncalled bet ($0.50) returned to Glushchenko
Glushchenko collected $1 from pot
*** SUMMARY ***
Total pot $1 | Rake $0 
Seat 1: Frosch1907 folded before Flop (didn't bet)
Seat 2: azzad2007 folded before Flop (didn't bet)
Seat 4: Filojoes folded before Flop (didn't bet)
Seat 5: matiko09 folded before Flop (didn't bet)
Seat 6: mr. four-eye folded before Flop (didn't bet)
Seat 7: djammusic (button) folded before Flop (didn't bet)
Seat 8: rycho222 (small blind) folded before Flop
Seat 9: Glushchenko (big blind) collected ($1)





PokerStars Hand #151942545699:  Hold'em No Limit ($0.50/$1.00 USD) - 2016/04/15 13:25:59 CET [2016/04/15 7:25:59 ET]
Table 'Parvulesco II' 9-max Seat #7 is the button
Seat 1: bilukm ($52.56 in chips) 
Seat 2: SerAlGog ($272.80 in chips) 
Seat 3: matiko09 ($100 in chips) 
Seat 4: butcheN18 ($100.31 in chips) 
Seat 5: bronbeek ($70.27 in chips) 
Seat 6: Glushchenko ($123.54 in chips) 
Seat 7: djammusic ($41.86 in chips) 
Seat 8: Jimy Tiltman ($100 in chips) 
Seat 9: hammerwife ($212.88 in chips) 
Jimy Tiltman: posts small blind $0.50
hammerwife: posts big blind $1
*** HOLE CARDS ***
Dealt to matiko09 [As 7c]
bilukm: raises $2.50 to $3.50
SerAlGog: folds 
matiko09: folds 
butcheN18: folds 
bronbeek: folds 
Glushchenko: folds 
djammusic: folds 
Jimy Tiltman: folds 
hammerwife: calls $2.50
*** FLOP *** [Jc 2h Ah]
hammerwife: checks 
bilukm: checks 
*** TURN *** [Jc 2h Ah] [7h]
hammerwife: bets $5
bilukm: folds 
Uncalled bet ($5) returned to hammerwife
hammerwife collected $7.12 from pot
hammerwife: doesn't show hand 
*** SUMMARY ***
Total pot $7.50 | Rake $0.38 
Board [Jc 2h Ah 7h]
Seat 1: bilukm folded on the Turn
Seat 2: SerAlGog folded before Flop (didn't bet)
Seat 3: matiko09 folded before Flop (didn't bet)
Seat 4: butcheN18 folded before Flop (didn't bet)
Seat 5: bronbeek folded before Flop (didn't bet)
Seat 6: Glushchenko folded before Flop (didn't bet)
Seat 7: djammusic (button) folded before Flop (didn't bet)
Seat 8: Jimy Tiltman (small blind) folded before Flop
Seat 9: hammerwife (big blind) collected ($7.12)





PokerStars Hand #151942546464:  Hold'em No Limit ($0.50/$1.00 USD) - 2016/04/15 13:26:01 CET [2016/04/15 7:26:01 ET]
Table 'Matterania III' 9-max Seat #2 is the button
Seat 1: di0d80 ($116.65 in chips) 
Seat 2: haoyuan541 ($99.82 in chips) 
Seat 3: ardo888 ($152.90 in chips) 
Seat 4: wangzhuoming ($78.12 in chips) 
Seat 5: Vermm ($114.48 in chips) 
Seat 6: matiko09 ($103.64 in chips) 
Seat 7: Filojoes ($102.90 in chips) 
Seat 8: Jimy Tiltman ($100 in chips) 
Seat 9: butcheN18 ($100 in chips) 
ardo888: posts small blind $0.50
wangzhuoming: posts big blind $1
di0d80: posts the ante $0.20
haoyuan541: posts the ante $0.20
ardo888: posts the ante $0.20
wangzhuoming: posts the ante $0.20
Vermm: posts the ante $0.20
matiko09: posts the ante $0.20
Filojoes: posts the ante $0.20
Jimy Tiltman: posts the ante $0.20
butcheN18: posts the ante $0.20
*** HOLE CARDS ***
Dealt to matiko09 [2s 6c]
Vermm: raises $2 to $3
matiko09: folds 
Filojoes: folds 
Jimy Tiltman: folds 
butcheN18: raises $7 to $10
di0d80: folds 
haoyuan541: folds 
ardo888: folds 
wangzhuoming: folds 
Vermm: calls $7
*** FLOP *** [3s 6d Kd]
Vermm: checks 
butcheN18: bets $14
Vermm: calls $14
*** TURN *** [3s 6d Kd] [Ks]
Vermm: checks 
butcheN18: checks 
*** RIVER *** [3s 6d Kd Ks] [5c]
Vermm: checks 
butcheN18: bets $20
Vermm: folds 
Uncalled bet ($20) returned to butcheN18
butcheN18 collected $48.80 from pot
butcheN18: doesn't show hand 
*** SUMMARY ***
Total pot $51.30 | Rake $2.50 
Board [3s 6d Kd Ks 5c]
Seat 1: di0d80 folded before Flop (didn't bet)
Seat 2: haoyuan541 (button) folded before Flop (didn't bet)
Seat 3: ardo888 (small blind) folded before Flop
Seat 4: wangzhuoming (big blind) folded before Flop
Seat 5: Vermm folded on the River
Seat 6: matiko09 folded before Flop (didn't bet)
Seat 7: Filojoes folded before Flop (didn't bet)
Seat 8: Jimy Tiltman folded before Flop (didn't bet)
Seat 9: butcheN18 collected ($48.80)





PokerStars Hand #151942548811:  Hold'em No Limit ($1/$2 USD) - 2016/04/15 13:26:06 CET [2016/04/15 7:26:06 ET]
Table 'Irmgard II' 9-max Seat #6 is the button
Seat 1: T0ny Adams ($80 in chips) 
Seat 2: Iggso ($213.71 in chips) 
Seat 3: matiko09 ($200 in chips) 
Seat 4: di0d80 ($203 in chips) 
Seat 5: vezunchik79 ($200 in chips) 
Seat 6: djammusic ($77 in chips) 
Seat 9: maximax04 ($203.75 in chips) 
maximax04: posts small blind $1
T0ny Adams: posts big blind $2
*** HOLE CARDS ***
Dealt to matiko09 [4s Ah]
Iggso: raises $4 to $6
matiko09: folds 
di0d80: folds 
vezunchik79: folds 
djammusic: folds 
maximax04: calls $5
T0ny Adams: folds 
*** FLOP *** [Kh Td 5c]
maximax04: checks 
Iggso: checks 
*** TURN *** [Kh Td 5c] [Ks]
maximax04: bets $8
Iggso: calls $8
*** RIVER *** [Kh Td 5c Ks] [2s]
maximax04: bets $10
Iggso: calls $10
*** SHOW DOWN ***
maximax04: shows [Jh Ts] (two pair, Kings and Tens)
Iggso: shows [Qc Tc] (two pair, Kings and Tens - Queen kicker)
Iggso collected $47.50 from pot
*** SUMMARY ***
Total pot $50 | Rake $2.50 
Board [Kh Td 5c Ks 2s]
Seat 1: T0ny Adams (big blind) folded before Flop
Seat 2: Iggso showed [Qc Tc] and won ($47.50) with two pair, Kings and Tens
Seat 3: matiko09 folded before Flop (didn't bet)
Seat 4: di0d80 folded before Flop (didn't bet)
Seat 5: vezunchik79 folded before Flop (didn't bet)
Seat 6: djammusic (button) folded before Flop (didn't bet)
Seat 9: maximax04 (small blind) showed [Jh Ts] and lost with two pair, Kings and Tens





PokerStars Hand #151942550198:  Hold'em No Limit ($0.50/$1.00 USD) - 2016/04/15 13:26:09 CET [2016/04/15 7:26:09 ET]
Table 'Lamberta III' 9-max Seat #6 is the button
Seat 1: Westpants ($100 in chips) 
Seat 2: Biscuit270 ($119.30 in chips) 
Seat 3: butcheN18 ($203.10 in chips) 
Seat 4: Filojoes ($103.09 in chips) 
Seat 5: tipner ($112.10 in chips) 
Seat 6: aseban11 ($102.22 in chips) 
Seat 7: rycho222 ($96.50 in chips) 
Seat 8: wangzhuoming ($109.30 in chips) 
Seat 9: matiko09 ($154.36 in chips) 
rycho222: posts small blind $0.50
wangzhuoming: posts big blind $1
*** HOLE CARDS ***
Dealt to matiko09 [3c Jc]
matiko09: folds 
Westpants: folds 
Biscuit270: raises $2 to $3
butcheN18: folds 
Filojoes: folds 
tipner: folds 
aseban11: folds 
rycho222: folds 
wangzhuoming: folds 
Uncalled bet ($2) returned to Biscuit270
Biscuit270 collected $2.50 from pot
Biscuit270: doesn't show hand 
*** SUMMARY ***
Total pot $2.50 | Rake $0 
Seat 1: Westpants folded before Flop (didn't bet)
Seat 2: Biscuit270 collected ($2.50)
Seat 3: butcheN18 folded before Flop (didn't bet)
Seat 4: Filojoes folded before Flop (didn't bet)
Seat 5: tipner folded before Flop (didn't bet)
Seat 6: aseban11 (button) folded before Flop (didn't bet)
Seat 7: rycho222 (small blind) folded before Flop
Seat 8: wangzhuoming (big blind) folded before Flop
Seat 9: matiko09 folded before Flop (didn't bet)





PokerStars Hand #151942557118:  Hold'em No Limit ($0.50/$1.00 USD) - 2016/04/15 13:26:24 CET [2016/04/15 7:26:24 ET]
Table 'Kreusa II' 9-max Seat #8 is the button
Seat 2: azzad2007 ($101.50 in chips) 
Seat 4: Filojoes ($100 in chips) 
Seat 5: matiko09 ($122.33 in chips) 
Seat 6: mr. four-eye ($99.01 in chips) 
Seat 7: djammusic ($41.69 in chips) 
Seat 8: rycho222 ($118.97 in chips) 
Seat 9: Glushchenko ($100.50 in chips) 
Glushchenko: posts small blind $0.50
azzad2007: posts big blind $1
*** HOLE CARDS ***
Dealt to matiko09 [Js 7d]
Filojoes: folds 
matiko09: folds 
mr. four-eye: folds 
djammusic: folds 
rycho222: raises $1 to $2
Glushchenko: folds 
azzad2007: folds 
Uncalled bet ($1) returned to rycho222
rycho222 collected $2.50 from pot
rycho222: doesn't show hand 
*** SUMMARY ***
Total pot $2.50 | Rake $0 
Seat 2: azzad2007 (big blind) folded before Flop
Seat 4: Filojoes folded before Flop (didn't bet)
Seat 5: matiko09 folded before Flop (didn't bet)
Seat 6: mr. four-eye folded before Flop (didn't bet)
Seat 7: djammusic folded before Flop (didn't bet)
Seat 8: rycho222 (button) collected ($2.50)
Seat 9: Glushchenko (small blind) folded before Flop





PokerStars Hand #151942558172:  Hold'em No Limit ($0.50/$1.00 USD) - 2016/04/15 13:26:26 CET [2016/04/15 7:26:26 ET]
Table 'Chiny II' 9-max Seat #3 is the button
Seat 1: aseban11 ($104.12 in chips) 
Seat 3: powerbel ($41.90 in chips) 
Seat 4: 1000karlos ($88.49 in chips) 
Seat 5: Yaaaazz ($109.50 in chips) 
Seat 6: choupai ($36.96 in chips) 
Seat 7: matiko09 ($147.88 in chips) 
Seat 8: Filojoes ($108.34 in chips) 
1000karlos: posts small blind $0.50
Yaaaazz: posts big blind $1
Glushchenko: sits out 
*** HOLE CARDS ***
Dealt to matiko09 [6c As]
choupai: folds 
matiko09: folds 
Filojoes: raises $2 to $3
aseban11: folds 
powerbel: folds 
1000karlos: folds 
Yaaaazz: folds 
Uncalled bet ($2) returned to Filojoes
Filojoes collected $2.50 from pot
Filojoes: doesn't show hand 
*** SUMMARY ***
Total pot $2.50 | Rake $0 
Seat 1: aseban11 folded before Flop (didn't bet)
Seat 3: powerbel (button) folded before Flop (didn't bet)
Seat 4: 1000karlos (small blind) folded before Flop
Seat 5: Yaaaazz (big blind) folded before Flop
Seat 6: choupai folded before Flop (didn't bet)
Seat 7: matiko09 folded before Flop (didn't bet)
Seat 8: Filojoes collected ($2.50)





PokerStars Hand #151942561559:  Hold'em No Limit ($1/$2 USD) - 2016/04/15 13:26:33 CET [2016/04/15 7:26:33 ET]
Table 'Oceax' 9-max Seat #7 is the button
Seat 1: matiko09 ($209 in chips) 
Seat 4: butcheN18 ($235.42 in chips) 
Seat 5: di0d80 ($206 in chips) 
Seat 6: Iggso ($200 in chips) 
Seat 7: djlaw321 ($148 in chips) 
Seat 8: Poroxide ($206.35 in chips) 
Seat 9: Olddogtom888 ($293.53 in chips) 
Poroxide: posts small blind $1
Olddogtom888: posts big blind $2
Yaaaazz: sits out 
*** HOLE CARDS ***
Dealt to matiko09 [Ah 3h]
matiko09: folds 
butcheN18: raises $4 to $6
di0d80: folds 
Iggso: folds 
djlaw321: raises $14 to $20
Poroxide: folds 
Olddogtom888: folds 
butcheN18: folds 
Uncalled bet ($14) returned to djlaw321
djlaw321 collected $15 from pot
djlaw321: doesn't show hand 
*** SUMMARY ***
Total pot $15 | Rake $0 
Seat 1: matiko09 folded before Flop (didn't bet)
Seat 4: butcheN18 folded before Flop
Seat 5: di0d80 folded before Flop (didn't bet)
Seat 6: Iggso folded before Flop (didn't bet)
Seat 7: djlaw321 (button) collected ($15)
Seat 8: Poroxide (small blind) folded before Flop
Seat 9: Olddogtom888 (big blind) folded before Flop





PokerStars Hand #151942565446:  Hold'em No Limit ($0.50/$1.00 USD) - 2016/04/15 13:26:41 CET [2016/04/15 7:26:41 ET]
Table 'Kreusa II' 9-max Seat #9 is the button
Seat 2: azzad2007 ($100.50 in chips) 
Seat 4: Filojoes ($100 in chips) 
Seat 5: matiko09 ($122.33 in chips) 
Seat 6: mr. four-eye ($99.01 in chips) 
Seat 7: djammusic ($41.69 in chips) 
Seat 8: rycho222 ($120.47 in chips) 
Seat 9: Glushchenko ($100 in chips) 
azzad2007: posts small blind $0.50
Filojoes: posts big blind $1
*** HOLE CARDS ***
Dealt to matiko09 [7d 7c]
matiko09: raises $2 to $3
Jimy Tiltman joins the table at seat #1 
aseban11 leaves the table
mr. four-eye: folds 
djammusic: folds 
rycho222: folds 
Glushchenko: folds 
azzad2007: folds 
Filojoes: folds 
Uncalled bet ($2) returned to matiko09
matiko09 collected $2.50 from pot
matiko09: doesn't show hand 
*** SUMMARY ***
Total pot $2.50 | Rake $0 
Seat 2: azzad2007 (small blind) folded before Flop
Seat 4: Filojoes (big blind) folded before Flop
Seat 5: matiko09 collected ($2.50)
Seat 6: mr. four-eye folded before Flop (didn't bet)
Seat 7: djammusic folded before Flop (didn't bet)
Seat 8: rycho222 folded before Flop (didn't bet)
Seat 9: Glushchenko (button) folded before Flop (didn't bet)





PokerStars Hand #151942570039:  Hold'em No Limit ($0.50/$1.00 USD) - 2016/04/15 13:26:51 CET [2016/04/15 7:26:51 ET]
Table 'Navi' 9-max Seat #2 is the button
Seat 1: tipner ($104.45 in chips) 
Seat 2: butcheN18 ($100 in chips) 
Seat 3: aseban11 ($110.28 in chips) 
Seat 4: Effort92 ($122.13 in chips) 
Seat 7: yoshidao ($154.45 in chips) 
Seat 8: djammusic ($50.94 in chips) 
Seat 9: matiko09 ($108.45 in chips) 
aseban11: posts small blind $0.50
Effort92: posts big blind $1
hammerwife: sits out 
Glushchenko: sits out 
*** HOLE CARDS ***
Dealt to matiko09 [Qs As]
yoshidao: calls $1
djammusic: raises $3 to $4
matiko09: calls $4
tipner: folds 
butcheN18: folds 
aseban11: folds 
Effort92: folds 
yoshidao: folds 
*** FLOP *** [Kh 9s Qh]
djammusic: checks 
matiko09: checks 
*** TURN *** [Kh 9s Qh] [Qc]
djammusic: bets $7.50
matiko09: calls $7.50
*** RIVER *** [Kh 9s Qh Qc] [Jc]
djammusic: checks 
matiko09: checks 
*** SHOW DOWN ***
djammusic: shows [Ac Jd] (two pair, Queens and Jacks)
matiko09: shows [Qs As] (three of a kind, Queens)
matiko09 collected $24.22 from pot
*** SUMMARY ***
Total pot $25.50 | Rake $1.28 
Board [Kh 9s Qh Qc Jc]
Seat 1: tipner folded before Flop (didn't bet)
Seat 2: butcheN18 (button) folded before Flop (didn't bet)
Seat 3: aseban11 (small blind) folded before Flop
Seat 4: Effort92 (big blind) folded before Flop
Seat 7: yoshidao folded before Flop
Seat 8: djammusic showed [Ac Jd] and lost with two pair, Queens and Jacks
Seat 9: matiko09 showed [Qs As] and won ($24.22) with three of a kind, Queens





PokerStars Hand #151942571722:  Hold'em No Limit ($0.50/$1.00 USD) - 2016/04/15 13:26:55 CET [2016/04/15 7:26:55 ET]
Table 'Adelgunde III' 9-max Seat #7 is the button
Seat 1: valimiu ($51.65 in chips) 
Seat 2: djammusic ($46.88 in chips) 
Seat 3: tipner ($100 in chips) 
Seat 4: hammerwife ($100 in chips) 
Seat 5: matiko09 ($105.98 in chips) 
Seat 6: Pominator92 ($56.59 in chips) 
Seat 7: Foton18 ($78.50 in chips) 
Seat 8: aseban11 ($100 in chips) 
Seat 9: Kukuryzka ($100 in chips) 
aseban11: posts small blind $0.50
Kukuryzka: posts big blind $1
*** HOLE CARDS ***
Dealt to matiko09 [7s 5s]
valimiu: calls $1
djammusic: folds 
tipner: raises $3 to $4
hammerwife: calls $4
matiko09: folds 
Pominator92: folds 
Foton18: calls $4
aseban11: calls $3.50
Kukuryzka: folds 
valimiu: calls $3
*** FLOP *** [7h 6s 7d]
aseban11: checks 
valimiu: checks 
tipner: checks 
hammerwife: bets $9.97
Foton18: folds 
aseban11: folds 
valimiu: folds 
tipner: folds 
Uncalled bet ($9.97) returned to hammerwife
hammerwife collected $19.95 from pot
hammerwife: doesn't show hand 
*** SUMMARY ***
Total pot $21 | Rake $1.05 
Board [7h 6s 7d]
Seat 1: valimiu folded on the Flop
Seat 2: djammusic folded before Flop (didn't bet)
Seat 3: tipner folded on the Flop
Seat 4: hammerwife collected ($19.95)
Seat 5: matiko09 folded before Flop (didn't bet)
Seat 6: Pominator92 folded before Flop (didn't bet)
Seat 7: Foton18 (button) folded on the Flop
Seat 8: aseban11 (small blind) folded on the Flop
Seat 9: Kukuryzka (big blind) folded before Flop





PokerStars Hand #151942572444:  Hold'em No Limit ($0.50/$1.00 USD) - 2016/04/15 13:26:56 CET [2016/04/15 7:26:56 ET]
Table 'Katja II' 9-max Seat #3 is the button
Seat 1: Filojoes ($101.50 in chips) 
Seat 2: TheJokerMen1 ($50.11 in chips) 
Seat 3: matiko09 ($137.12 in chips) 
Seat 4: Sutt_420 ($69.70 in chips) 
Seat 6: ASG2016 ($117.52 in chips) 
Seat 7: Effort92 ($102.67 in chips) 
Seat 9: hardeep13 ($68.96 in chips) 
Sutt_420: posts small blind $0.50
ASG2016: posts big blind $1
Glushchenko: sits out 
*** HOLE CARDS ***
Dealt to matiko09 [3d Qc]
Effort92: raises $1.50 to $2.50
hardeep13: folds 
Filojoes: raises $6 to $8.50
TheJokerMen1: folds 
matiko09: folds 
Sutt_420: folds 
ASG2016: folds 
Effort92: folds 
Uncalled bet ($6) returned to Filojoes
Filojoes collected $6.50 from pot
Filojoes: doesn't show hand 
*** SUMMARY ***
Total pot $6.50 | Rake $0 
Seat 1: Filojoes collected ($6.50)
Seat 2: TheJokerMen1 folded before Flop (didn't bet)
Seat 3: matiko09 (button) folded before Flop (didn't bet)
Seat 4: Sutt_420 (small blind) folded before Flop
Seat 6: ASG2016 (big blind) folded before Flop
Seat 7: Effort92 folded before Flop
Seat 9: hardeep13 folded before Flop (didn't bet)





PokerStars Hand #151942572353:  Hold'em No Limit ($1/$2 USD) - 2016/04/15 13:26:56 CET [2016/04/15 7:26:56 ET]
Table 'Irmgard II' 9-max Seat #9 is the button
Seat 1: T0ny Adams ($78 in chips) 
Seat 3: matiko09 ($200 in chips) 
Seat 4: di0d80 ($203 in chips) 
Seat 5: vezunchik79 ($200 in chips) 
Seat 6: djammusic ($77 in chips) 
Seat 9: maximax04 ($179.75 in chips) 
T0ny Adams: posts small blind $1
Iggso: is sitting out 
matiko09: posts big blind $2
*** HOLE CARDS ***
Dealt to matiko09 [Kc 3h]
di0d80: folds 
vezunchik79: folds 
djammusic: folds 
Iggso leaves the table
MoeAA11 joins the table at seat #8 
maximax04: calls $2
erfk1958 joins the table at seat #7 
Kukuryzka joins the table at seat #2 
T0ny Adams: calls $1
matiko09: checks 
*** FLOP *** [7s 4s Ts]
T0ny Adams: checks 
matiko09: checks 
maximax04: bets $6
T0ny Adams: folds 
matiko09: folds 
Uncalled bet ($6) returned to maximax04
maximax04 collected $5.70 from pot
maximax04: doesn't show hand 
*** SUMMARY ***
Total pot $6 | Rake $0.30 
Board [7s 4s Ts]
Seat 1: T0ny Adams (small blind) folded on the Flop
Seat 3: matiko09 (big blind) folded on the Flop
Seat 4: di0d80 folded before Flop (didn't bet)
Seat 5: vezunchik79 folded before Flop (didn't bet)
Seat 6: djammusic folded before Flop (didn't bet)
Seat 9: maximax04 (button) collected ($5.70)





PokerStars Hand #151942572263:  Hold'em No Limit ($0.50/$1.00 USD) - 2016/04/15 13:26:56 CET [2016/04/15 7:26:56 ET]
Table 'Cheruskia II' 9-max Seat #7 is the button
Seat 1: vicus1972 ($59.46 in chips) 
Seat 2: SerAlGog ($100 in chips) 
Seat 3: butcheN18 ($137.55 in chips) 
Seat 4: djammusic ($45.65 in chips) 
Seat 6: hammerwife ($123.60 in chips) 
Seat 7: matiko09 ($100 in chips) 
Seat 8: ardo888 ($134.84 in chips) 
Seat 9: rycho222 ($134.47 in chips) 
ardo888: posts small blind $0.50
rycho222: posts big blind $1
Filojoes: sits out 
*** HOLE CARDS ***
Dealt to matiko09 [2s 3c]
vicus1972: folds 
SerAlGog: folds 
butcheN18: folds 
djammusic: folds 
hammerwife: folds 
matiko09: folds 
ardo888: raises $2 to $3
rycho222: folds 
Uncalled bet ($2) returned to ardo888
ardo888 collected $2 from pot
ardo888: doesn't show hand 
*** SUMMARY ***
Total pot $2 | Rake $0 
Seat 1: vicus1972 folded before Flop (didn't bet)
Seat 2: SerAlGog folded before Flop (didn't bet)
Seat 3: butcheN18 folded before Flop (didn't bet)
Seat 4: djammusic folded before Flop (didn't bet)
Seat 6: hammerwife folded before Flop (didn't bet)
Seat 7: matiko09 (button) folded before Flop (didn't bet)
Seat 8: ardo888 (small blind) collected ($2)
Seat 9: rycho222 (big blind) folded before Flop





PokerStars Hand #151942573768:  Hold'em No Limit ($1/$2 USD) - 2016/04/15 13:26:59 CET [2016/04/15 7:26:59 ET]
Table 'Patroclus II' 9-max Seat #4 is the button
Seat 1: TonnaMunz ($213.04 in chips) 
Seat 2: Moemors ($186.88 in chips) 
Seat 3: Koolniknik ($212.51 in chips) 
Seat 4: tipner ($200 in chips) 
Seat 5: butcheN18 ($254.29 in chips) 
Seat 6: di0d80 ($200 in chips) 
Seat 7: matiko09 ($251.76 in chips) 
butcheN18: posts small blind $1
di0d80: posts big blind $2
Glushchenko: sits out 
*** HOLE CARDS ***
Dealt to matiko09 [Ah 3h]
matiko09: folds 
TonnaMunz: folds 
Moemors: folds 
Koolniknik: raises $4 to $6
tipner: folds 
butcheN18: folds 
di0d80: folds 
Uncalled bet ($4) returned to Koolniknik
Koolniknik collected $5 from pot
*** SUMMARY ***
Total pot $5 | Rake $0 
Seat 1: TonnaMunz folded before Flop (didn't bet)
Seat 2: Moemors folded before Flop (didn't bet)
Seat 3: Koolniknik collected ($5)
Seat 4: tipner (button) folded before Flop (didn't bet)
Seat 5: butcheN18 (small blind) folded before Flop
Seat 6: di0d80 (big blind) folded before Flop
Seat 7: matiko09 folded before Flop (didn't bet)





PokerStars Hand #151942574833:  Hold'em No Limit ($1/$2 USD) - 2016/04/15 13:27:01 CET [2016/04/15 7:27:01 ET]
Table 'Oceax' 9-max Seat #8 is the button
Seat 1: matiko09 ($209 in chips) 
Seat 2: Fish4trips ($313.36 in chips) 
Seat 4: butcheN18 ($229.42 in chips) 
Seat 5: di0d80 ($206 in chips) 
Seat 6: Iggso ($200 in chips) 
Seat 7: djlaw321 ($157 in chips) 
Seat 8: Poroxide ($205.35 in chips) 
Olddogtom888 has timed out while being disconnected
Olddogtom888: is sitting out 
Olddogtom888 is disconnected 
matiko09: posts small blind $1
Fish4trips: posts big blind $2
Yaaaazz: sits out 
*** HOLE CARDS ***
Dealt to matiko09 [Ks 7d]
butcheN18: folds 
di0d80: folds 
Iggso: folds 
djlaw321: raises $4 to $6
Poroxide: folds 
matiko09: folds 
Fish4trips: folds 
Uncalled bet ($4) returned to djlaw321
djlaw321 collected $5 from pot
djlaw321: doesn't show hand 
*** SUMMARY ***
Total pot $5 | Rake $0 
Seat 1: matiko09 (small blind) folded before Flop
Seat 2: Fish4trips (big blind) folded before Flop
Seat 4: butcheN18 folded before Flop (didn't bet)
Seat 5: di0d80 folded before Flop (didn't bet)
Seat 6: Iggso folded before Flop (didn't bet)
Seat 7: djlaw321 collected ($5)
Seat 8: Poroxide (button) folded before Flop (didn't bet)





PokerStars Hand #151942576272:  Hold'em No Limit ($0.50/$1.00 USD) - 2016/04/15 13:27:04 CET [2016/04/15 7:27:04 ET]
Table 'Chiny II' 9-max Seat #4 is the button
Seat 1: aseban11 ($104.12 in chips) 
Seat 3: powerbel ($41.90 in chips) 
Seat 4: 1000karlos ($87.99 in chips) 
Seat 5: Yaaaazz ($108.50 in chips) 
Seat 6: choupai ($36.96 in chips) 
Seat 7: matiko09 ($147.88 in chips) 
Seat 8: Filojoes ($109.84 in chips) 
Yaaaazz: posts small blind $0.50
choupai: posts big blind $1
Glushchenko: sits out 
*** HOLE CARDS ***
Dealt to matiko09 [8h Ac]
matiko09: folds 
Filojoes: folds 
aseban11: folds 
powerbel: folds 
1000karlos: raises $1 to $2
Yaaaazz: folds 
choupai: folds 
Uncalled bet ($1) returned to 1000karlos
1000karlos collected $2.50 from pot
*** SUMMARY ***
Total pot $2.50 | Rake $0 
Seat 1: aseban11 folded before Flop (didn't bet)
Seat 3: powerbel folded before Flop (didn't bet)
Seat 4: 1000karlos (button) collected ($2.50)
Seat 5: Yaaaazz (small blind) folded before Flop
Seat 6: choupai (big blind) folded before Flop
Seat 7: matiko09 folded before Flop (didn't bet)
Seat 8: Filojoes folded before Flop (didn't bet)





PokerStars Hand #151942576763:  Hold'em No Limit ($0.50/$1.00 USD) - 2016/04/15 13:27:05 CET [2016/04/15 7:27:05 ET]
Table 'Parvulesco II' 9-max Seat #8 is the button
Seat 1: bilukm ($49.06 in chips) 
Seat 2: SerAlGog ($272.80 in chips) 
Seat 3: matiko09 ($100 in chips) 
Seat 4: butcheN18 ($100.31 in chips) 
Seat 5: bronbeek ($70.27 in chips) 
Seat 6: Glushchenko ($123.54 in chips) 
Seat 7: djammusic ($41.86 in chips) 
Seat 8: Jimy Tiltman ($100 in chips) 
Seat 9: hammerwife ($216.50 in chips) 
hammerwife: posts small blind $0.50
bilukm: posts big blind $1
*** HOLE CARDS ***
Dealt to matiko09 [Tc 8c]
SerAlGog: folds 
matiko09: folds 
butcheN18: folds 
bronbeek: folds 
Glushchenko: raises $2 to $3
djammusic: folds 
Jimy Tiltman: folds 
hammerwife: folds 
bilukm: folds 
Uncalled bet ($2) returned to Glushchenko
Glushchenko collected $2.50 from pot
*** SUMMARY ***
Total pot $2.50 | Rake $0 
Seat 1: bilukm (big blind) folded before Flop
Seat 2: SerAlGog folded before Flop (didn't bet)
Seat 3: matiko09 folded before Flop (didn't bet)
Seat 4: butcheN18 folded before Flop (didn't bet)
Seat 5: bronbeek folded before Flop (didn't bet)
Seat 6: Glushchenko collected ($2.50)
Seat 7: djammusic folded before Flop (didn't bet)
Seat 8: Jimy Tiltman (button) folded before Flop (didn't bet)
Seat 9: hammerwife (small blind) folded before Flop





PokerStars Hand #151942579045:  Hold'em No Limit ($1/$2 USD) - 2016/04/15 13:27:10 CET [2016/04/15 7:27:10 ET]
Table 'Adele II' 9-max Seat #3 is the button
Seat 1: RyanHuJun ($248.87 in chips) 
Seat 3: matiko09 ($324.45 in chips) 
Seat 4: Glushchenko ($200 in chips) 
Seat 6: wiseyoyo ($238.23 in chips) 
Seat 7: Iggso ($200 in chips) 
Seat 8: docmarc777 ($375.92 in chips) 
Glushchenko: posts small blind $1
wiseyoyo: posts big blind $2
SanychStar: sits out 
Fish4trips: sits out 
*** HOLE CARDS ***
Dealt to matiko09 [Ks 8h]
Iggso: folds 
docmarc777: folds 
RyanHuJun: raises $4 to $6
matiko09: folds 
Glushchenko: folds 
wiseyoyo: calls $4
*** FLOP *** [7s Jd Jc]
wiseyoyo: checks 
RyanHuJun: checks 
*** TURN *** [7s Jd Jc] [4d]
wiseyoyo: checks 
RyanHuJun: checks 
*** RIVER *** [7s Jd Jc 4d] [As]
wiseyoyo: checks 
RyanHuJun: checks 
*** SHOW DOWN ***
wiseyoyo: shows [7h 8d] (two pair, Jacks and Sevens)
RyanHuJun: mucks hand 
wiseyoyo collected $12.35 from pot
*** SUMMARY ***
Total pot $13 | Rake $0.65 
Board [7s Jd Jc 4d As]
Seat 1: RyanHuJun mucked [Qd Th]
Seat 3: matiko09 (button) folded before Flop (didn't bet)
Seat 4: Glushchenko (small blind) folded before Flop
Seat 6: wiseyoyo (big blind) showed [7h 8d] and won ($12.35) with two pair, Jacks and Sevens
Seat 7: Iggso folded before Flop (didn't bet)
Seat 8: docmarc777 folded before Flop (didn't bet)





PokerStars Hand #151942584009:  Hold'em No Limit ($0.50/$1.00 USD) - 2016/04/15 13:27:21 CET [2016/04/15 7:27:21 ET]
Table 'Cheruskia II' 9-max Seat #8 is the button
Seat 1: vicus1972 ($59.46 in chips) 
Seat 2: SerAlGog ($100 in chips) 
Seat 3: butcheN18 ($137.55 in chips) 
Seat 4: djammusic ($45.65 in chips) 
Seat 6: hammerwife ($123.60 in chips) 
Seat 7: matiko09 ($100 in chips) 
Seat 8: ardo888 ($135.84 in chips) 
Seat 9: rycho222 ($133.47 in chips) 
rycho222: posts small blind $0.50
vicus1972: posts big blind $1
Filojoes: sits out 
*** HOLE CARDS ***
Dealt to matiko09 [Tc 9h]
SerAlGog: folds 
butcheN18: folds 
djammusic: folds 
hammerwife: folds 
matiko09: folds 
ardo888: raises $1.50 to $2.50
rycho222: folds 
vicus1972: folds 
Uncalled bet ($1.50) returned to ardo888
ardo888 collected $2.50 from pot
ardo888: doesn't show hand 
*** SUMMARY ***
Total pot $2.50 | Rake $0 
Seat 1: vicus1972 (big blind) folded before Flop
Seat 2: SerAlGog folded before Flop (didn't bet)
Seat 3: butcheN18 folded before Flop (didn't bet)
Seat 4: djammusic folded before Flop (didn't bet)
Seat 6: hammerwife folded before Flop (didn't bet)
Seat 7: matiko09 folded before Flop (didn't bet)
Seat 8: ardo888 (button) collected ($2.50)
Seat 9: rycho222 (small blind) folded before Flop





PokerStars Hand #151942585219:  Hold'em No Limit ($0.50/$1.00 USD) - 2016/04/15 13:27:23 CET [2016/04/15 7:27:23 ET]
Table 'Matterania III' 9-max Seat #3 is the button
Seat 1: di0d80 ($116.45 in chips) 
Seat 2: haoyuan541 ($99.62 in chips) 
Seat 3: ardo888 ($152.20 in chips) 
Seat 4: wangzhuoming ($76.92 in chips) 
Seat 5: Vermm ($90.28 in chips) 
Seat 6: matiko09 ($103.44 in chips) 
Seat 7: Filojoes ($102.70 in chips) 
Seat 8: Jimy Tiltman ($100 in chips) 
Seat 9: butcheN18 ($124.60 in chips) 
wangzhuoming: posts small blind $0.50
Vermm: posts big blind $1
di0d80: posts the ante $0.20
haoyuan541: posts the ante $0.20
ardo888: posts the ante $0.20
wangzhuoming: posts the ante $0.20
Vermm: posts the ante $0.20
matiko09: posts the ante $0.20
Filojoes: posts the ante $0.20
Jimy Tiltman: posts the ante $0.20
butcheN18: posts the ante $0.20
*** HOLE CARDS ***
Dealt to matiko09 [9h 4c]
matiko09: folds 
Filojoes: folds 
Jimy Tiltman: raises $2 to $3
butcheN18: folds 
di0d80: folds 
haoyuan541: folds 
ardo888: folds 
wangzhuoming: folds 
Vermm: folds 
Uncalled bet ($2) returned to Jimy Tiltman
Jimy Tiltman collected $4.30 from pot
Jimy Tiltman: doesn't show hand 
*** SUMMARY ***
Total pot $4.30 | Rake $0 
Seat 1: di0d80 folded before Flop (didn't bet)
Seat 2: haoyuan541 folded before Flop (didn't bet)
Seat 3: ardo888 (button) folded before Flop (didn't bet)
Seat 4: wangzhuoming (small blind) folded before Flop
Seat 5: Vermm (big blind) folded before Flop
Seat 6: matiko09 folded before Flop (didn't bet)
Seat 7: Filojoes folded before Flop (didn't bet)
Seat 8: Jimy Tiltman collected ($4.30)
Seat 9: butcheN18 folded before Flop (didn't bet)





PokerStars Hand #151942588450:  Hold'em No Limit ($1/$2 USD) - 2016/04/15 13:27:30 CET [2016/04/15 7:27:30 ET]
Table 'Patroclus II' 9-max Seat #5 is the button
Seat 1: TonnaMunz ($213.04 in chips) 
Seat 2: Moemors ($186.88 in chips) 
Seat 3: Koolniknik ($215.51 in chips) 
Seat 4: tipner ($200 in chips) 
Seat 5: butcheN18 ($253.29 in chips) 
Seat 6: di0d80 ($200 in chips) 
Seat 7: matiko09 ($251.76 in chips) 
Seat 9: Fish4trips ($231.72 in chips) 
di0d80: posts small blind $1
matiko09: posts big blind $2
Glushchenko: sits out 
*** HOLE CARDS ***
Dealt to matiko09 [9c 5s]
Fish4trips: folds 
TonnaMunz: folds 
Moemors: folds 
Koolniknik: raises $4 to $6
tipner: raises $11 to $17
butcheN18: folds 
di0d80: folds 
matiko09: folds 
Koolniknik: folds 
Uncalled bet ($11) returned to tipner
tipner collected $15 from pot
tipner: doesn't show hand 
*** SUMMARY ***
Total pot $15 | Rake $0 
Seat 1: TonnaMunz folded before Flop (didn't bet)
Seat 2: Moemors folded before Flop (didn't bet)
Seat 3: Koolniknik folded before Flop
Seat 4: tipner collected ($15)
Seat 5: butcheN18 (button) folded before Flop (didn't bet)
Seat 6: di0d80 (small blind) folded before Flop
Seat 7: matiko09 (big blind) folded before Flop
Seat 9: Fish4trips folded before Flop (didn't bet)





PokerStars Hand #151942593401:  Hold'em No Limit ($1/$2 USD) - 2016/04/15 13:27:40 CET [2016/04/15 7:27:40 ET]
Table 'Irmgard II' 9-max Seat #1 is the button
Seat 1: T0ny Adams ($76 in chips) 
Seat 3: matiko09 ($200 in chips) 
Seat 4: di0d80 ($203 in chips) 
Seat 5: vezunchik79 ($200 in chips) 
Seat 6: djammusic ($77 in chips) 
Seat 8: MoeAA11 ($80 in chips) 
Seat 9: maximax04 ($183.45 in chips) 
Kukuryzka will be allowed to play after the button
matiko09: posts small blind $1
di0d80: posts big blind $2
erfk1958: sits out 
MoeAA11: posts big blind $2
*** HOLE CARDS ***
Dealt to matiko09 [3h 9h]
vezunchik79: raises $3 to $5
djammusic: folds 
MoeAA11: calls $3
maximax04: folds 
T0ny Adams: folds 
matiko09: folds 
di0d80: folds 
*** FLOP *** [4s 4h 6h]
vezunchik79: bets $12
MoeAA11: folds 
Uncalled bet ($12) returned to vezunchik79
vezunchik79 collected $12.35 from pot
*** SUMMARY ***
Total pot $13 | Rake $0.65 
Board [4s 4h 6h]
Seat 1: T0ny Adams (button) folded before Flop (didn't bet)
Seat 3: matiko09 (small blind) folded before Flop
Seat 4: di0d80 (big blind) folded before Flop
Seat 5: vezunchik79 collected ($12.35)
Seat 6: djammusic folded before Flop (didn't bet)
Seat 8: MoeAA11 folded on the Flop
Seat 9: maximax04 folded before Flop (didn't bet)





PokerStars Hand #151942596351:  Hold'em No Limit ($0.50/$1.00 USD) - 2016/04/15 13:27:47 CET [2016/04/15 7:27:47 ET]
Table 'Parvulesco II' 9-max Seat #9 is the button
Seat 1: bilukm ($48.06 in chips) 
Seat 3: matiko09 ($100 in chips) 
Seat 4: butcheN18 ($100.31 in chips) 
Seat 5: bronbeek ($70.27 in chips) 
Seat 6: Glushchenko ($125.04 in chips) 
Seat 7: djammusic ($41.86 in chips) 
Seat 8: Jimy Tiltman ($100 in chips) 
Seat 9: hammerwife ($216 in chips) 
bilukm: posts small blind $0.50
matiko09: posts big blind $1
*** HOLE CARDS ***
Dealt to matiko09 [9c 8c]
butcheN18: folds 
bronbeek: calls $1
Glushchenko: folds 
djammusic: folds 
Jimy Tiltman: raises $2.50 to $3.50
hammerwife: folds 
bilukm: calls $3
matiko09: calls $2.50
bronbeek: calls $2.50
*** FLOP *** [5d 2d Jh]
bilukm: checks 
matiko09: checks 
bronbeek: checks 
Jimy Tiltman: bets $9.97
bilukm: calls $9.97
matiko09: folds 
bronbeek: raises $56.80 to $66.77 and is all-in
Jimy Tiltman: folds 
bilukm: folds 
Uncalled bet ($56.80) returned to bronbeek
bronbeek collected $41.71 from pot
bronbeek: doesn't show hand 
*** SUMMARY ***
Total pot $43.91 | Rake $2.20 
Board [5d 2d Jh]
Seat 1: bilukm (small blind) folded on the Flop
Seat 3: matiko09 (big blind) folded on the Flop
Seat 4: butcheN18 folded before Flop (didn't bet)
Seat 5: bronbeek collected ($41.71)
Seat 6: Glushchenko folded before Flop (didn't bet)
Seat 7: djammusic folded before Flop (didn't bet)
Seat 8: Jimy Tiltman folded on the Flop
Seat 9: hammerwife (button) folded before Flop (didn't bet)





PokerStars Hand #151942597238:  Hold'em No Limit ($0.50/$1.00 USD) - 2016/04/15 13:27:48 CET [2016/04/15 7:27:48 ET]
Table 'Cheruskia II' 9-max Seat #9 is the button
Seat 1: vicus1972 ($58.46 in chips) 
Seat 3: butcheN18 ($137.55 in chips) 
Seat 4: djammusic ($45.65 in chips) 
Seat 6: hammerwife ($123.60 in chips) 
Seat 7: matiko09 ($100 in chips) 
Seat 8: ardo888 ($137.34 in chips) 
Seat 9: rycho222 ($132.97 in chips) 
vicus1972: posts small blind $0.50
butcheN18: posts big blind $1
Filojoes: sits out 
*** HOLE CARDS ***
Dealt to matiko09 [6h Jd]
djammusic: raises $1.25 to $2.25
hammerwife: raises $4.25 to $6.50
matiko09: folds 
ardo888: folds 
rycho222: folds 
vicus1972: folds 
butcheN18: folds 
djammusic: folds 
Uncalled bet ($4.25) returned to hammerwife
hammerwife collected $6 from pot
hammerwife: doesn't show hand 
*** SUMMARY ***
Total pot $6 | Rake $0 
Seat 1: vicus1972 (small blind) folded before Flop
Seat 3: butcheN18 (big blind) folded before Flop
Seat 4: djammusic folded before Flop
Seat 6: hammerwife collected ($6)
Seat 7: matiko09 folded before Flop (didn't bet)
Seat 8: ardo888 folded before Flop (didn't bet)
Seat 9: rycho222 (button) folded before Flop (didn't bet)





PokerStars Hand #151942597547:  Hold'em No Limit ($0.50/$1.00 USD) - 2016/04/15 13:27:49 CET [2016/04/15 7:27:49 ET]
Table 'Matterania III' 9-max Seat #4 is the button
Seat 1: di0d80 ($116.25 in chips) 
Seat 2: haoyuan541 ($99.42 in chips) 
Seat 3: ardo888 ($152 in chips) 
Seat 4: wangzhuoming ($76.22 in chips) 
Seat 5: Vermm ($89.08 in chips) 
Seat 6: matiko09 ($103.24 in chips) 
Seat 7: Filojoes ($102.50 in chips) 
Seat 8: Jimy Tiltman ($103.10 in chips) 
Seat 9: butcheN18 ($124.40 in chips) 
Vermm: posts small blind $0.50
matiko09: posts big blind $1
di0d80: posts the ante $0.20
haoyuan541: posts the ante $0.20
ardo888: posts the ante $0.20
wangzhuoming: posts the ante $0.20
Vermm: posts the ante $0.20
matiko09: posts the ante $0.20
Filojoes: posts the ante $0.20
Jimy Tiltman: posts the ante $0.20
butcheN18: posts the ante $0.20
*** HOLE CARDS ***
Dealt to matiko09 [8d Qd]
Filojoes: folds 
Jimy Tiltman: raises $2 to $3
butcheN18: folds 
di0d80: folds 
haoyuan541: folds 
ardo888: folds 
wangzhuoming: calls $3
Vermm: folds 
matiko09: folds 
*** FLOP *** [7s Jh Qh]
Jimy Tiltman: bets $5.40
wangzhuoming is disconnected 
wangzhuoming is connected 
wangzhuoming: folds 
Uncalled bet ($5.40) returned to Jimy Tiltman
Jimy Tiltman collected $8.84 from pot
Jimy Tiltman: doesn't show hand 
*** SUMMARY ***
Total pot $9.30 | Rake $0.46 
Board [7s Jh Qh]
Seat 1: di0d80 folded before Flop (didn't bet)
Seat 2: haoyuan541 folded before Flop (didn't bet)
Seat 3: ardo888 folded before Flop (didn't bet)
Seat 4: wangzhuoming (button) folded on the Flop
Seat 5: Vermm (small blind) folded before Flop
Seat 6: matiko09 (big blind) folded before Flop
Seat 7: Filojoes folded before Flop (didn't bet)
Seat 8: Jimy Tiltman collected ($8.84)
Seat 9: butcheN18 folded before Flop (didn't bet)





PokerStars Hand #151942597404:  Hold'em No Limit ($1/$2 USD) - 2016/04/15 13:27:49 CET [2016/04/15 7:27:49 ET]
Table 'Oceax' 9-max Seat #1 is the button
Seat 1: matiko09 ($208 in chips) 
Seat 2: Fish4trips ($311.36 in chips) 
Seat 3: Yaaaazz ($200 in chips) 
Seat 4: butcheN18 ($229.42 in chips) 
Seat 5: di0d80 ($206 in chips) 
Seat 6: Iggso ($200 in chips) 
Seat 7: djlaw321 ($160 in chips) 
Seat 8: Poroxide ($205.35 in chips) 
Seat 9: Olddogtom888 ($291.53 in chips) 
Fish4trips: posts small blind $1
Yaaaazz: posts big blind $2
Olddogtom888: posts small blind $1
*** HOLE CARDS ***
Dealt to matiko09 [Kc 7h]
butcheN18: folds 
di0d80: folds 
Iggso: folds 
djlaw321: calls $2
Poroxide: folds 
Olddogtom888: folds 
matiko09: raises $6 to $8
Fish4trips: folds 
Yaaaazz: folds 
djlaw321: calls $6
*** FLOP *** [8c Th 5c]
djlaw321: bets $14
matiko09: folds 
Uncalled bet ($14) returned to djlaw321
djlaw321 collected $19 from pot
djlaw321: doesn't show hand 
*** SUMMARY ***
Total pot $20 | Rake $1 
Board [8c Th 5c]
Seat 1: matiko09 (button) folded on the Flop
Seat 2: Fish4trips (small blind) folded before Flop
Seat 3: Yaaaazz (big blind) folded before Flop
Seat 4: butcheN18 folded before Flop (didn't bet)
Seat 5: di0d80 folded before Flop (didn't bet)
Seat 6: Iggso folded before Flop (didn't bet)
Seat 7: djlaw321 collected ($19)
Seat 8: Poroxide folded before Flop (didn't bet)
Seat 9: Olddogtom888 folded before Flop





PokerStars Hand #151942602256:  Hold'em No Limit ($0.50/$1.00 USD) - 2016/04/15 13:27:59 CET [2016/04/15 7:27:59 ET]
Table 'Katja II' 9-max Seat #4 is the button
Seat 1: Filojoes ($105.50 in chips) 
Seat 2: TheJokerMen1 ($50.11 in chips) 
Seat 3: matiko09 ($137.12 in chips) 
Seat 4: Sutt_420 ($69.20 in chips) 
Seat 6: ASG2016 ($116.52 in chips) 
Seat 7: Effort92 ($100.17 in chips) 
Seat 9: hardeep13 ($68.96 in chips) 
ASG2016: posts small blind $0.50
Effort92: posts big blind $1
Glushchenko: sits out 
*** HOLE CARDS ***
Dealt to matiko09 [8c 9d]
hardeep13 has timed out
hardeep13: folds 
Filojoes: folds 
TheJokerMen1: calls $1
matiko09: folds 
Sutt_420: folds 
ASG2016: folds 
Effort92: checks 
*** FLOP *** [Kh 2d Qc]
Effort92: checks 
TheJokerMen1: bets $1
Effort92: folds 
Uncalled bet ($1) returned to TheJokerMen1
TheJokerMen1 collected $2.38 from pot
TheJokerMen1: doesn't show hand 
*** SUMMARY ***
Total pot $2.50 | Rake $0.12 
Board [Kh 2d Qc]
Seat 1: Filojoes folded before Flop (didn't bet)
Seat 2: TheJokerMen1 collected ($2.38)
Seat 3: matiko09 folded before Flop (didn't bet)
Seat 4: Sutt_420 (button) folded before Flop (didn't bet)
Seat 6: ASG2016 (small blind) folded before Flop
Seat 7: Effort92 (big blind) folded on the Flop
Seat 9: hardeep13 folded before Flop (didn't bet)





PokerStars Hand #151942608618:  Hold'em No Limit ($1/$2 USD) - 2016/04/15 13:28:13 CET [2016/04/15 7:28:13 ET]
Table 'Patroclus II' 9-max Seat #6 is the button
Seat 1: TonnaMunz ($213.04 in chips) 
Seat 2: Moemors ($186.88 in chips) 
Seat 3: Koolniknik ($209.51 in chips) 
Seat 4: tipner ($209 in chips) 
Seat 5: butcheN18 ($253.29 in chips) 
Seat 6: di0d80 ($200 in chips) 
Seat 7: matiko09 ($249.76 in chips) 
Seat 8: Glushchenko ($200 in chips) 
Seat 9: Fish4trips ($231.72 in chips) 
matiko09: posts small blind $1
Glushchenko: posts big blind $2
*** HOLE CARDS ***
Dealt to matiko09 [3d Kc]
Fish4trips: folds 
TonnaMunz: folds 
Moemors: folds 
Koolniknik: folds 
tipner: raises $4 to $6
butcheN18: folds 
di0d80: folds 
matiko09: folds 
Glushchenko: folds 
Uncalled bet ($4) returned to tipner
tipner collected $5 from pot
tipner: doesn't show hand 
*** SUMMARY ***
Total pot $5 | Rake $0 
Seat 1: TonnaMunz folded before Flop (didn't bet)
Seat 2: Moemors folded before Flop (didn't bet)
Seat 3: Koolniknik folded before Flop (didn't bet)
Seat 4: tipner collected ($5)
Seat 5: butcheN18 folded before Flop (didn't bet)
Seat 6: di0d80 (button) folded before Flop (didn't bet)
Seat 7: matiko09 (small blind) folded before Flop
Seat 8: Glushchenko (big blind) folded before Flop
Seat 9: Fish4trips folded before Flop (didn't bet)





PokerStars Hand #151942609311:  Hold'em No Limit ($1/$2 USD) - 2016/04/15 13:28:14 CET [2016/04/15 7:28:14 ET]
Table 'Adele II' 9-max Seat #4 is the button
Seat 1: RyanHuJun ($242.87 in chips) 
Seat 3: matiko09 ($324.45 in chips) 
Seat 4: Glushchenko ($200 in chips) 
Seat 6: wiseyoyo ($244.58 in chips) 
Seat 7: Iggso ($200 in chips) 
Seat 8: docmarc777 ($375.92 in chips) 
wiseyoyo: posts small blind $1
Iggso: posts big blind $2
SanychStar: sits out 
Fish4trips: sits out 
*** HOLE CARDS ***
Dealt to matiko09 [Qd 9h]
docmarc777: folds 
RyanHuJun: raises $4 to $6
matiko09: folds 
Glushchenko: folds 
wiseyoyo: folds 
Iggso: folds 
Uncalled bet ($4) returned to RyanHuJun
RyanHuJun collected $5 from pot
RyanHuJun: doesn't show hand 
*** SUMMARY ***
Total pot $5 | Rake $0 
Seat 1: RyanHuJun collected ($5)
Seat 3: matiko09 folded before Flop (didn't bet)
Seat 4: Glushchenko (button) folded before Flop (didn't bet)
Seat 6: wiseyoyo (small blind) folded before Flop
Seat 7: Iggso (big blind) folded before Flop
Seat 8: docmarc777 folded before Flop (didn't bet)





PokerStars Hand #151942612428:  Hold'em No Limit ($1/$2 USD) - 2016/04/15 13:28:20 CET [2016/04/15 7:28:20 ET]
Table 'Irmgard II' 9-max Seat #3 is the button
Seat 1: T0ny Adams ($76 in chips) 
Seat 3: matiko09 ($200 in chips) 
Seat 4: di0d80 ($201 in chips) 
Seat 5: vezunchik79 ($207.35 in chips) 
Seat 6: djammusic ($77 in chips) 
Seat 8: MoeAA11 ($75 in chips) 
Seat 9: maximax04 ($183.45 in chips) 
di0d80: posts small blind $1
vezunchik79: posts big blind $2
erfk1958: sits out 
Kukuryzka: sits out 
*** HOLE CARDS ***
Dealt to matiko09 [5d 6h]
djammusic: folds 
MoeAA11: folds 
maximax04: folds 
T0ny Adams: folds 
matiko09: folds 
di0d80: raises $4 to $6
vezunchik79: raises $12 to $18
di0d80: calls $12
*** FLOP *** [3s 7s Kh]
di0d80: checks 
vezunchik79: bets $24
di0d80: folds 
Uncalled bet ($24) returned to vezunchik79
vezunchik79 collected $34.20 from pot
*** SUMMARY ***
Total pot $36 | Rake $1.80 
Board [3s 7s Kh]
Seat 1: T0ny Adams folded before Flop (didn't bet)
Seat 3: matiko09 (button) folded before Flop (didn't bet)
Seat 4: di0d80 (small blind) folded on the Flop
Seat 5: vezunchik79 (big blind) collected ($34.20)
Seat 6: djammusic folded before Flop (didn't bet)
Seat 8: MoeAA11 folded before Flop (didn't bet)
Seat 9: maximax04 folded before Flop (didn't bet)





PokerStars Hand #151942613461:  Hold'em No Limit ($0.50/$1.00 USD) - 2016/04/15 13:28:23 CET [2016/04/15 7:28:23 ET]
Table 'Navi' 9-max Seat #3 is the button
Seat 1: tipner ($104.45 in chips) 
Seat 2: butcheN18 ($100 in chips) 
Seat 3: aseban11 ($109.78 in chips) 
Seat 4: Effort92 ($121.13 in chips) 
Seat 5: hammerwife ($100 in chips) 
Seat 7: yoshidao ($153.45 in chips) 
Seat 8: djammusic ($39.44 in chips) 
Seat 9: matiko09 ($121.17 in chips) 
Effort92: posts small blind $0.50
hammerwife: posts big blind $1
Glushchenko: sits out 
*** HOLE CARDS ***
Dealt to matiko09 [5s Ah]
yoshidao: folds 
djammusic: folds 
matiko09: folds 
tipner: folds 
butcheN18: folds 
aseban11: folds 
Effort92: raises $1.50 to $2.50
hammerwife: calls $1.50
*** FLOP *** [Js 7d 5h]
Effort92: bets $1.99
hammerwife: folds 
Uncalled bet ($1.99) returned to Effort92
Effort92 collected $4.75 from pot
Effort92: doesn't show hand 
*** SUMMARY ***
Total pot $5 | Rake $0.25 
Board [Js 7d 5h]
Seat 1: tipner folded before Flop (didn't bet)
Seat 2: butcheN18 folded before Flop (didn't bet)
Seat 3: aseban11 (button) folded before Flop (didn't bet)
Seat 4: Effort92 (small blind) collected ($4.75)
Seat 5: hammerwife (big blind) folded on the Flop
Seat 7: yoshidao folded before Flop (didn't bet)
Seat 8: djammusic folded before Flop (didn't bet)
Seat 9: matiko09 folded before Flop (didn't bet)





PokerStars Hand #151942616791:  Hold'em No Limit ($0.50/$1.00 USD) - 2016/04/15 13:28:30 CET [2016/04/15 7:28:30 ET]
Table 'Cheruskia II' 9-max Seat #1 is the button
Seat 1: vicus1972 ($57.96 in chips) 
Seat 3: butcheN18 ($136.55 in chips) 
Seat 5: Filojoes ($103 in chips) 
Seat 6: hammerwife ($127.35 in chips) 
Seat 7: matiko09 ($100 in chips) 
Seat 8: ardo888 ($137.34 in chips) 
Seat 9: rycho222 ($132.97 in chips) 
butcheN18: posts small blind $0.50
djammusic: is sitting out 
Filojoes: posts big blind $1
*** HOLE CARDS ***
Dealt to matiko09 [Th 3h]
hammerwife: folds 
matiko09: folds 
ardo888: folds 
rycho222: folds 
hammerwife leaves the table
vicus1972: folds 
butcheN18: raises $1.44 to $2.44
Jimy Tiltman joins the table at seat #6 
Filojoes: calls $1.44
*** FLOP *** [Jh 2d 6c]
butcheN18: checks 
Jimy Tiltman leaves the table
Filojoes: bets $2.78
butcheN18: folds 
Uncalled bet ($2.78) returned to Filojoes
Filojoes collected $4.64 from pot
Filojoes: doesn't show hand 
*** SUMMARY ***
Total pot $4.88 | Rake $0.24 
Board [Jh 2d 6c]
Seat 1: vicus1972 (button) folded before Flop (didn't bet)
Seat 3: butcheN18 (small blind) folded on the Flop
Seat 5: Filojoes (big blind) collected ($4.64)
Seat 6: hammerwife folded before Flop (didn't bet)
Seat 7: matiko09 folded before Flop (didn't bet)
Seat 8: ardo888 folded before Flop (didn't bet)
Seat 9: rycho222 folded before Flop (didn't bet)





PokerStars Hand #151942617539:  Hold'em No Limit ($1/$2 USD) - 2016/04/15 13:28:31 CET [2016/04/15 7:28:31 ET]
Table 'Adele II' 9-max Seat #6 is the button
Seat 1: RyanHuJun ($245.87 in chips) 
Seat 3: matiko09 ($324.45 in chips) 
Seat 4: Glushchenko ($200 in chips) 
Seat 6: wiseyoyo ($243.58 in chips) 
Seat 7: Iggso ($200 in chips) 
Seat 8: docmarc777 ($375.92 in chips) 
Iggso: posts small blind $1
docmarc777: posts big blind $2
SanychStar: sits out 
Fish4trips: sits out 
*** HOLE CARDS ***
Dealt to matiko09 [Js 5h]
RyanHuJun: folds 
matiko09: folds 
Glushchenko: folds 
wiseyoyo: folds 
Iggso: raises $4 to $6
docmarc777: raises $14 to $20
Iggso: folds 
Uncalled bet ($14) returned to docmarc777
docmarc777 collected $12 from pot
docmarc777: doesn't show hand 
*** SUMMARY ***
Total pot $12 | Rake $0 
Seat 1: RyanHuJun folded before Flop (didn't bet)
Seat 3: matiko09 folded before Flop (didn't bet)
Seat 4: Glushchenko folded before Flop (didn't bet)
Seat 6: wiseyoyo (button) folded before Flop (didn't bet)
Seat 7: Iggso (small blind) folded before Flop
Seat 8: docmarc777 (big blind) collected ($12)





PokerStars Hand #151942618746:  Hold'em No Limit ($0.50/$1.00 USD) - 2016/04/15 13:28:34 CET [2016/04/15 7:28:34 ET]
Table 'Adelgunde III' 9-max Seat #8 is the button
Seat 1: valimiu ($47.65 in chips) 
Seat 2: djammusic ($46.88 in chips) 
Seat 3: tipner ($100 in chips) 
Seat 4: hammerwife ($115.95 in chips) 
Seat 5: matiko09 ($105.98 in chips) 
Seat 6: Pominator92 ($56.59 in chips) 
Seat 7: Foton18 ($74.50 in chips) 
Seat 8: aseban11 ($100 in chips) 
Seat 9: Kukuryzka ($99 in chips) 
Kukuryzka: posts small blind $0.50
valimiu: posts big blind $1
*** HOLE CARDS ***
Dealt to matiko09 [Jc 4h]
djammusic: folds 
tipner: folds 
hammerwife: folds 
matiko09: folds 
Pominator92: calls $1
Foton18: raises $3.50 to $4.50
aseban11: folds 
Kukuryzka: folds 
valimiu: calls $3.50
Pominator92: calls $3.50
*** FLOP *** [9h 8s Jd]
valimiu: checks 
Pominator92: checks 
Foton18: bets $8
valimiu: folds 
Pominator92: raises $14 to $22
Foton18: calls $14
*** TURN *** [9h 8s Jd] [5h]
Pominator92: bets $30.09 and is all-in
Foton18: calls $30.09
*** RIVER *** [9h 8s Jd 5h] [Kc]
*** SHOW DOWN ***
Pominator92: shows [Th 7c] (a straight, Seven to Jack)
Foton18: shows [Js Ah] (a pair of Jacks)
Pominator92 collected $115.68 from pot
*** SUMMARY ***
Total pot $118.18 | Rake $2.50 
Board [9h 8s Jd 5h Kc]
Seat 1: valimiu (big blind) folded on the Flop
Seat 2: djammusic folded before Flop (didn't bet)
Seat 3: tipner folded before Flop (didn't bet)
Seat 4: hammerwife folded before Flop (didn't bet)
Seat 5: matiko09 folded before Flop (didn't bet)
Seat 6: Pominator92 showed [Th 7c] and won ($115.68) with a straight, Seven to Jack
Seat 7: Foton18 showed [Js Ah] and lost with a pair of Jacks
Seat 8: aseban11 (button) folded before Flop (didn't bet)
Seat 9: Kukuryzka (small blind) folded before Flop





PokerStars Hand #151942624737:  Hold'em No Limit ($1/$2 USD) - 2016/04/15 13:28:46 CET [2016/04/15 7:28:46 ET]
Table 'Oceax' 9-max Seat #2 is the button
Seat 1: matiko09 ($200 in chips) 
Seat 2: Fish4trips ($310.36 in chips) 
Seat 3: Yaaaazz ($200 in chips) 
Seat 4: butcheN18 ($229.42 in chips) 
Seat 5: di0d80 ($206 in chips) 
Seat 6: Iggso ($200 in chips) 
Seat 7: djlaw321 ($171 in chips) 
Seat 8: Poroxide ($205.35 in chips) 
Seat 9: Olddogtom888 ($290.53 in chips) 
Yaaaazz: posts small blind $1
butcheN18: posts big blind $2
*** HOLE CARDS ***
Dealt to matiko09 [Qh 7s]
di0d80: folds 
Iggso: raises $4 to $6
djlaw321: folds 
Poroxide: folds 
Olddogtom888: calls $6
matiko09: folds 
Fish4trips: folds 
Yaaaazz: folds 
butcheN18: folds 
*** FLOP *** [4s 9s 9h]
Iggso: bets $7.12
Olddogtom888: folds 
Uncalled bet ($7.12) returned to Iggso
Iggso collected $14.25 from pot
Iggso: doesn't show hand 
*** SUMMARY ***
Total pot $15 | Rake $0.75 
Board [4s 9s 9h]
Seat 1: matiko09 folded before Flop (didn't bet)
Seat 2: Fish4trips (button) folded before Flop (didn't bet)
Seat 3: Yaaaazz (small blind) folded before Flop
Seat 4: butcheN18 (big blind) folded before Flop
Seat 5: di0d80 folded before Flop (didn't bet)
Seat 6: Iggso collected ($14.25)
Seat 7: djlaw321 folded before Flop (didn't bet)
Seat 8: Poroxide folded before Flop (didn't bet)
Seat 9: Olddogtom888 folded on the Flop





PokerStars Hand #151942629713:  Hold'em No Limit ($1/$2 USD) - 2016/04/15 13:28:57 CET [2016/04/15 7:28:57 ET]
Table 'Patroclus II' 9-max Seat #7 is the button
Seat 1: TonnaMunz ($213.04 in chips) 
Seat 2: Moemors ($186.88 in chips) 
Seat 3: Koolniknik ($209.51 in chips) 
Seat 4: tipner ($212 in chips) 
Seat 5: butcheN18 ($253.29 in chips) 
Seat 6: di0d80 ($200 in chips) 
Seat 7: matiko09 ($248.76 in chips) 
Seat 8: Glushchenko ($200 in chips) 
Seat 9: Fish4trips ($231.72 in chips) 
Glushchenko: posts small blind $1
Fish4trips: posts big blind $2
*** HOLE CARDS ***
Dealt to matiko09 [Jh 5c]
TonnaMunz: folds 
Moemors: folds 
Koolniknik is disconnected 
Koolniknik has timed out while disconnected
Koolniknik: folds 
tipner: folds 
butcheN18: raises $4 to $6
di0d80: folds 
matiko09: folds 
Glushchenko: folds 
Fish4trips: folds 
Uncalled bet ($4) returned to butcheN18
butcheN18 collected $5 from pot
butcheN18: doesn't show hand 
*** SUMMARY ***
Total pot $5 | Rake $0 
Seat 1: TonnaMunz folded before Flop (didn't bet)
Seat 2: Moemors folded before Flop (didn't bet)
Seat 3: Koolniknik folded before Flop (didn't bet)
Seat 4: tipner folded before Flop (didn't bet)
Seat 5: butcheN18 collected ($5)
Seat 6: di0d80 folded before Flop (didn't bet)
Seat 7: matiko09 (button) folded before Flop (didn't bet)
Seat 8: Glushchenko (small blind) folded before Flop
Seat 9: Fish4trips (big blind) folded before Flop





PokerStars Hand #151942630939:  Hold'em No Limit ($1/$2 USD) - 2016/04/15 13:29:00 CET [2016/04/15 7:29:00 ET]
Table 'Adele II' 9-max Seat #7 is the button
Seat 1: RyanHuJun ($245.87 in chips) 
Seat 3: matiko09 ($324.45 in chips) 
Seat 4: Glushchenko ($200 in chips) 
Seat 6: wiseyoyo ($243.58 in chips) 
Seat 7: Iggso ($200 in chips) 
Seat 8: docmarc777 ($381.92 in chips) 
Seat 9: SanychStar ($200 in chips) 
docmarc777: posts small blind $1
SanychStar: posts big blind $2
Fish4trips: sits out 
*** HOLE CARDS ***
Dealt to matiko09 [Jd Qs]
RyanHuJun: folds 
matiko09: raises $3 to $5
Glushchenko: folds 
wiseyoyo: calls $5
Iggso: folds 
docmarc777: calls $4
SanychStar: folds 
*** FLOP *** [3h 5s 3c]
docmarc777: checks 
matiko09: checks 
wiseyoyo: checks 
*** TURN *** [3h 5s 3c] [9d]
docmarc777: checks 
matiko09: checks 
wiseyoyo: checks 
*** RIVER *** [3h 5s 3c 9d] [9h]
docmarc777: bets $8
matiko09: folds 
wiseyoyo: calls $8
*** SHOW DOWN ***
docmarc777: shows [Td 8d] (two pair, Nines and Threes)
wiseyoyo: shows [As Qh] (two pair, Nines and Threes - Ace kicker)
wiseyoyo collected $31.35 from pot
*** SUMMARY ***
Total pot $33 | Rake $1.65 
Board [3h 5s 3c 9d 9h]
Seat 1: RyanHuJun folded before Flop (didn't bet)
Seat 3: matiko09 folded on the River
Seat 4: Glushchenko folded before Flop (didn't bet)
Seat 6: wiseyoyo showed [As Qh] and won ($31.35) with two pair, Nines and Threes
Seat 7: Iggso (button) folded before Flop (didn't bet)
Seat 8: docmarc777 (small blind) showed [Td 8d] and lost with two pair, Nines and Threes
Seat 9: SanychStar (big blind) folded before Flop





PokerStars Hand #151942636114:  Hold'em No Limit ($0.50/$1.00 USD) - 2016/04/15 13:29:11 CET [2016/04/15 7:29:11 ET]
Table 'Parvulesco II' 9-max Seat #1 is the button
Seat 1: bilukm ($34.59 in chips) 
Seat 3: matiko09 ($100 in chips) 
Seat 4: butcheN18 ($100.31 in chips) 
Seat 5: bronbeek ($98.51 in chips) 
Seat 6: Glushchenko ($125.04 in chips) 
Seat 7: djammusic ($41.86 in chips) 
Seat 8: Jimy Tiltman ($100 in chips) 
Seat 9: hammerwife ($216 in chips) 
matiko09: posts small blind $0.50
butcheN18: posts big blind $1
*** HOLE CARDS ***
Dealt to matiko09 [Tc Qs]
bronbeek: folds 
Glushchenko: raises $2 to $3
djammusic: calls $3
Jimy Tiltman: folds 
hammerwife: folds 
bilukm: folds 
matiko09: folds 
butcheN18: folds 
*** FLOP *** [4c 6d 8c]
Glushchenko: checks 
djammusic: bets $4.50
Glushchenko: calls $4.50
*** TURN *** [4c 6d 8c] [Kh]
Glushchenko: checks 
djammusic: checks 
*** RIVER *** [4c 6d 8c Kh] [8d]
Glushchenko: checks 
djammusic: checks 
*** SHOW DOWN ***
Glushchenko: shows [9h 9d] (two pair, Nines and Eights)
djammusic: mucks hand 
SerAlGog leaves the table
Glushchenko collected $15.68 from pot
*** SUMMARY ***
Total pot $16.50 | Rake $0.82 
Board [4c 6d 8c Kh 8d]
Seat 1: bilukm (button) folded before Flop (didn't bet)
Seat 3: matiko09 (small blind) folded before Flop
Seat 4: butcheN18 (big blind) folded before Flop
Seat 5: bronbeek folded before Flop (didn't bet)
Seat 6: Glushchenko showed [9h 9d] and won ($15.68) with two pair, Nines and Eights
Seat 7: djammusic mucked [Qd Ad]
Seat 8: Jimy Tiltman folded before Flop (didn't bet)
Seat 9: hammerwife folded before Flop (didn't bet)





PokerStars Hand #151942637405:  Hold'em No Limit ($0.50/$1.00 USD) - 2016/04/15 13:29:13 CET [2016/04/15 7:29:13 ET]
Table 'Navi' 9-max Seat #4 is the button
Seat 1: tipner ($104.45 in chips) 
Seat 2: butcheN18 ($100 in chips) 
Seat 3: aseban11 ($109.78 in chips) 
Seat 4: Effort92 ($123.38 in chips) 
Seat 5: hammerwife ($100 in chips) 
Seat 6: Glushchenko ($111.16 in chips) 
Seat 7: yoshidao ($153.45 in chips) 
Seat 8: djammusic ($39.44 in chips) 
Seat 9: matiko09 ($121.17 in chips) 
hammerwife: posts small blind $0.50
Glushchenko: posts big blind $1
*** HOLE CARDS ***
Dealt to matiko09 [As Qc]
yoshidao: calls $1
djammusic: folds 
matiko09: raises $3 to $4
tipner: folds 
butcheN18: folds 
aseban11: calls $4
Effort92: calls $4
hammerwife: folds 
Glushchenko: folds 
yoshidao: folds 
*** FLOP *** [Js Qs 7s]
matiko09: checks 
aseban11: checks 
Effort92: checks 
*** TURN *** [Js Qs 7s] [6s]
matiko09: checks 
aseban11: checks 
Effort92: checks 
*** RIVER *** [Js Qs 7s 6s] [5s]
matiko09: bets $7
aseban11: folds 
Effort92: folds 
Uncalled bet ($7) returned to matiko09
matiko09 collected $13.78 from pot
matiko09: doesn't show hand 
*** SUMMARY ***
Total pot $14.50 | Rake $0.72 
Board [Js Qs 7s 6s 5s]
Seat 1: tipner folded before Flop (didn't bet)
Seat 2: butcheN18 folded before Flop (didn't bet)
Seat 3: aseban11 folded on the River
Seat 4: Effort92 (button) folded on the River
Seat 5: hammerwife (small blind) folded before Flop
Seat 6: Glushchenko (big blind) folded before Flop
Seat 7: yoshidao folded before Flop
Seat 8: djammusic folded before Flop (didn't bet)
Seat 9: matiko09 collected ($13.78)





PokerStars Hand #151942639283:  Hold'em No Limit ($1/$2 USD) - 2016/04/15 13:29:17 CET [2016/04/15 7:29:17 ET]
Table 'Oceax' 9-max Seat #3 is the button
Seat 1: matiko09 ($200 in chips) 
Seat 2: Fish4trips ($310.36 in chips) 
Seat 3: Yaaaazz ($200 in chips) 
Seat 4: butcheN18 ($227.42 in chips) 
Seat 5: di0d80 ($206 in chips) 
Seat 6: Iggso ($208.25 in chips) 
Seat 7: djlaw321 ($171 in chips) 
Seat 8: Poroxide ($205.35 in chips) 
Seat 9: Olddogtom888 ($284.53 in chips) 
butcheN18: posts small blind $1
di0d80: posts big blind $2
*** HOLE CARDS ***
Dealt to matiko09 [2h 8s]
Iggso: folds 
djlaw321: folds 
Poroxide: folds 
Olddogtom888: raises $4 to $6
matiko09: folds 
Fish4trips: folds 
Yaaaazz: folds 
butcheN18: folds 
di0d80: calls $4
*** FLOP *** [Js 6h Ts]
di0d80: checks 
Olddogtom888: bets $6.50
di0d80: folds 
Uncalled bet ($6.50) returned to Olddogtom888
Olddogtom888 collected $12.35 from pot
Olddogtom888: doesn't show hand 
*** SUMMARY ***
Total pot $13 | Rake $0.65 
Board [Js 6h Ts]
Seat 1: matiko09 folded before Flop (didn't bet)
Seat 2: Fish4trips folded before Flop (didn't bet)
Seat 3: Yaaaazz (button) folded before Flop (didn't bet)
Seat 4: butcheN18 (small blind) folded before Flop
Seat 5: di0d80 (big blind) folded on the Flop
Seat 6: Iggso folded before Flop (didn't bet)
Seat 7: djlaw321 folded before Flop (didn't bet)
Seat 8: Poroxide folded before Flop (didn't bet)
Seat 9: Olddogtom888 collected ($12.35)





PokerStars Hand #151942640374:  Hold'em No Limit ($0.50/$1.00 USD) - 2016/04/15 13:29:20 CET [2016/04/15 7:29:20 ET]
Table 'Katja II' 9-max Seat #6 is the button
Seat 1: Filojoes ($105.50 in chips) 
Seat 2: TheJokerMen1 ($51.49 in chips) 
Seat 3: matiko09 ($137.12 in chips) 
Seat 4: Sutt_420 ($69.20 in chips) 
Seat 6: ASG2016 ($116.02 in chips) 
Seat 7: Effort92 ($100 in chips) 
Seat 8: Glushchenko ($100 in chips) 
Seat 9: hardeep13 ($68.96 in chips) 
Effort92: posts small blind $0.50
Glushchenko: posts big blind $1
*** HOLE CARDS ***
Dealt to matiko09 [Ad 2h]
hardeep13: calls $1
Filojoes: folds 
TheJokerMen1: folds 
matiko09: folds 
Sutt_420: calls $1
ASG2016: folds 
Effort92: folds 
Glushchenko: checks 
*** FLOP *** [8s 6s 5s]
Glushchenko: checks 
hardeep13: bets $3
Sutt_420: folds 
Glushchenko: calls $3
*** TURN *** [8s 6s 5s] [5h]
Glushchenko: checks 
hardeep13: bets $7
Glushchenko: folds 
Uncalled bet ($7) returned to hardeep13
hardeep13 collected $9.02 from pot
hardeep13: doesn't show hand 
*** SUMMARY ***
Total pot $9.50 | Rake $0.48 
Board [8s 6s 5s 5h]
Seat 1: Filojoes folded before Flop (didn't bet)
Seat 2: TheJokerMen1 folded before Flop (didn't bet)
Seat 3: matiko09 folded before Flop (didn't bet)
Seat 4: Sutt_420 folded on the Flop
Seat 6: ASG2016 (button) folded before Flop (didn't bet)
Seat 7: Effort92 (small blind) folded before Flop
Seat 8: Glushchenko (big blind) folded on the Turn
Seat 9: hardeep13 collected ($9.02)





PokerStars Hand #151942642866:  Hold'em No Limit ($1/$2 USD) - 2016/04/15 13:29:25 CET [2016/04/15 7:29:25 ET]
Table 'Irmgard II' 9-max Seat #4 is the button
Seat 1: T0ny Adams ($76 in chips) 
Seat 3: matiko09 ($200 in chips) 
Seat 4: di0d80 ($200 in chips) 
Seat 5: vezunchik79 ($223.55 in chips) 
Seat 6: djammusic ($77 in chips) 
Seat 8: MoeAA11 ($75 in chips) 
Seat 9: maximax04 ($183.45 in chips) 
vezunchik79: posts small blind $1
djammusic: posts big blind $2
erfk1958: sits out 
Kukuryzka: sits out 
*** HOLE CARDS ***
Dealt to matiko09 [Qs 3h]
MoeAA11: folds 
maximax04: folds 
T0ny Adams: folds 
matiko09: folds 
di0d80: raises $2 to $4
vezunchik79: calls $3
djammusic: folds 
*** FLOP *** [Jc 5s Qh]
vezunchik79: checks 
di0d80: bets $6
vezunchik79: calls $6
*** TURN *** [Jc 5s Qh] [9c]
vezunchik79: checks 
di0d80: checks 
*** RIVER *** [Jc 5s Qh 9c] [Kd]
vezunchik79: checks 
di0d80: checks 
*** SHOW DOWN ***
vezunchik79: shows [Ac Td] (a straight, Ten to Ace)
di0d80: mucks hand 
vezunchik79 collected $20.90 from pot
*** SUMMARY ***
Total pot $22 | Rake $1.10 
Board [Jc 5s Qh 9c Kd]
Seat 1: T0ny Adams folded before Flop (didn't bet)
Seat 3: matiko09 folded before Flop (didn't bet)
Seat 4: di0d80 (button) mucked [9h 8c]
Seat 5: vezunchik79 (small blind) showed [Ac Td] and won ($20.90) with a straight, Ten to Ace
Seat 6: djammusic (big blind) folded before Flop
Seat 8: MoeAA11 folded before Flop (didn't bet)
Seat 9: maximax04 folded before Flop (didn't bet)





PokerStars Hand #151942643252:  Hold'em No Limit ($0.50/$1.00 USD) - 2016/04/15 13:29:26 CET [2016/04/15 7:29:26 ET]
Table 'Matterania III' 9-max Seat #5 is the button
Seat 1: di0d80 ($116.05 in chips) 
Seat 2: haoyuan541 ($99.22 in chips) 
Seat 3: ardo888 ($151.80 in chips) 
Seat 4: wangzhuoming ($73.02 in chips) 
Seat 5: Vermm ($88.38 in chips) 
Seat 6: matiko09 ($102.04 in chips) 
Seat 7: Filojoes ($102.30 in chips) 
Seat 8: Jimy Tiltman ($108.74 in chips) 
Seat 9: butcheN18 ($124.20 in chips) 
matiko09: posts small blind $0.50
Filojoes: posts big blind $1
di0d80: posts the ante $0.20
haoyuan541: posts the ante $0.20
ardo888: posts the ante $0.20
wangzhuoming: posts the ante $0.20
Vermm: posts the ante $0.20
matiko09: posts the ante $0.20
Filojoes: posts the ante $0.20
Jimy Tiltman: posts the ante $0.20
butcheN18: posts the ante $0.20
*** HOLE CARDS ***
Dealt to matiko09 [3c 5d]
Jimy Tiltman: folds 
butcheN18: folds 
di0d80: folds 
haoyuan541: raises $1 to $2
ardo888: calls $2
wangzhuoming: folds 
Vermm: folds 
matiko09: folds 
Filojoes: folds 
*** FLOP *** [3d 2h 4h]
haoyuan541: bets $3
ardo888: calls $3
*** TURN *** [3d 2h 4h] [Th]
haoyuan541: checks 
ardo888: checks 
*** RIVER *** [3d 2h 4h Th] [6h]
haoyuan541: checks 
ardo888: bets $6.69
haoyuan541: folds 
Uncalled bet ($6.69) returned to ardo888
ardo888 collected $12.64 from pot
ardo888: doesn't show hand 
*** SUMMARY ***
Total pot $13.30 | Rake $0.66 
Board [3d 2h 4h Th 6h]
Seat 1: di0d80 folded before Flop (didn't bet)
Seat 2: haoyuan541 folded on the River
Seat 3: ardo888 collected ($12.64)
Seat 4: wangzhuoming folded before Flop (didn't bet)
Seat 5: Vermm (button) folded before Flop (didn't bet)
Seat 6: matiko09 (small blind) folded before Flop
Seat 7: Filojoes (big blind) folded before Flop
Seat 8: Jimy Tiltman folded before Flop (didn't bet)
Seat 9: butcheN18 folded before Flop (didn't bet)





PokerStars Hand #151942649378:  Hold'em No Limit ($0.50/$1.00 USD) - 2016/04/15 13:29:38 CET [2016/04/15 7:29:38 ET]
Table 'Adelgunde III' 9-max Seat #9 is the button
Seat 1: valimiu ($43.15 in chips) 
Seat 2: djammusic ($46.88 in chips) 
Seat 3: tipner ($100 in chips) 
Seat 4: hammerwife ($115.95 in chips) 
Seat 5: matiko09 ($105.98 in chips) 
Seat 6: Pominator92 ($115.68 in chips) 
Seat 7: Foton18 ($17.91 in chips) 
Seat 8: aseban11 ($100 in chips) 
Seat 9: Kukuryzka ($100 in chips) 
valimiu: posts small blind $0.50
djammusic: posts big blind $1
*** HOLE CARDS ***
Dealt to matiko09 [7s 4s]
tipner: raises $2 to $3
hammerwife: folds 
matiko09: folds 
Pominator92: folds 
Foton18: raises $14.91 to $17.91 and is all-in
aseban11: folds 
Kukuryzka: folds 
valimiu: folds 
djammusic: folds 
tipner: folds 
Uncalled bet ($14.91) returned to Foton18
Foton18 collected $7.50 from pot
Foton18: doesn't show hand 
*** SUMMARY ***
Total pot $7.50 | Rake $0 
Seat 1: valimiu (small blind) folded before Flop
Seat 2: djammusic (big blind) folded before Flop
Seat 3: tipner folded before Flop
Seat 4: hammerwife folded before Flop (didn't bet)
Seat 5: matiko09 folded before Flop (didn't bet)
Seat 6: Pominator92 folded before Flop (didn't bet)
Seat 7: Foton18 collected ($7.50)
Seat 8: aseban11 folded before Flop (didn't bet)
Seat 9: Kukuryzka (button) folded before Flop (didn't bet)





PokerStars Hand #151942654091:  Hold'em No Limit ($1/$2 USD) - 2016/04/15 13:29:48 CET [2016/04/15 7:29:48 ET]
Table 'Patroclus II' 9-max Seat #8 is the button
Seat 1: TonnaMunz ($213.04 in chips) 
Seat 2: Moemors ($186.88 in chips) 
Seat 3: Koolniknik ($209.51 in chips) 
Seat 4: tipner ($212 in chips) 
Seat 5: butcheN18 ($256.29 in chips) 
Seat 6: di0d80 ($200 in chips) 
Seat 7: matiko09 ($248.76 in chips) 
Seat 8: Glushchenko ($200 in chips) 
Seat 9: Fish4trips ($229.72 in chips) 
Fish4trips: posts small blind $1
TonnaMunz: posts big blind $2
*** HOLE CARDS ***
Dealt to matiko09 [Ks Tc]
Moemors: folds 
Koolniknik: raises $4 to $6
tipner: calls $6
butcheN18: folds 
di0d80: folds 
matiko09: folds 
Glushchenko: folds 
Fish4trips: folds 
TonnaMunz: folds 
*** FLOP *** [2h Qc 9s]
Koolniknik: bets $7.12
tipner: folds 
Uncalled bet ($7.12) returned to Koolniknik
Koolniknik collected $14.25 from pot
*** SUMMARY ***
Total pot $15 | Rake $0.75 
Board [2h Qc 9s]
Seat 1: TonnaMunz (big blind) folded before Flop
Seat 2: Moemors folded before Flop (didn't bet)
Seat 3: Koolniknik collected ($14.25)
Seat 4: tipner folded on the Flop
Seat 5: butcheN18 folded before Flop (didn't bet)
Seat 6: di0d80 folded before Flop (didn't bet)
Seat 7: matiko09 folded before Flop (didn't bet)
Seat 8: Glushchenko (button) folded before Flop (didn't bet)
Seat 9: Fish4trips (small blind) folded before Flop





PokerStars Hand #151942658216:  Hold'em No Limit ($1/$2 USD) - 2016/04/15 13:29:57 CET [2016/04/15 7:29:57 ET]
Table 'Oceax' 9-max Seat #4 is the button
Seat 1: matiko09 ($200 in chips) 
Seat 2: Fish4trips ($310.36 in chips) 
Seat 3: Yaaaazz ($200 in chips) 
Seat 4: butcheN18 ($226.42 in chips) 
Seat 5: di0d80 ($200 in chips) 
Seat 6: Iggso ($208.25 in chips) 
Seat 7: djlaw321 ($171 in chips) 
Seat 8: Poroxide ($205.35 in chips) 
Seat 9: Olddogtom888 ($290.88 in chips) 
di0d80: posts small blind $1
Iggso: posts big blind $2
*** HOLE CARDS ***
Dealt to matiko09 [6s 2s]
djlaw321: folds 
Poroxide: folds 
Olddogtom888: folds 
matiko09: folds 
Fish4trips: folds 
Yaaaazz: folds 
butcheN18: folds 
di0d80: folds 
Uncalled bet ($1) returned to Iggso
Iggso collected $2 from pot
Iggso: doesn't show hand 
*** SUMMARY ***
Total pot $2 | Rake $0 
Seat 1: matiko09 folded before Flop (didn't bet)
Seat 2: Fish4trips folded before Flop (didn't bet)
Seat 3: Yaaaazz folded before Flop (didn't bet)
Seat 4: butcheN18 (button) folded before Flop (didn't bet)
Seat 5: di0d80 (small blind) folded before Flop
Seat 6: Iggso (big blind) collected ($2)
Seat 7: djlaw321 folded before Flop (didn't bet)
Seat 8: Poroxide folded before Flop (didn't bet)
Seat 9: Olddogtom888 folded before Flop (didn't bet)





PokerStars Hand #151942665413:  Hold'em No Limit ($0.50/$1.00 USD) - 2016/04/15 13:30:10 CET [2016/04/15 7:30:10 ET]
Table 'Parvulesco II' 9-max Seat #3 is the button
Seat 1: bilukm ($34.59 in chips) 
Seat 3: matiko09 ($100 in chips) 
Seat 4: butcheN18 ($100 in chips) 
Seat 5: bronbeek ($98.51 in chips) 
Seat 6: Glushchenko ($133.22 in chips) 
Seat 7: djammusic ($40 in chips) 
Seat 8: Jimy Tiltman ($100 in chips) 
Seat 9: hammerwife ($216 in chips) 
butcheN18: posts small blind $0.50
bronbeek: posts big blind $1
*** HOLE CARDS ***
Dealt to matiko09 [Ts Kd]
Glushchenko: folds 
djammusic: folds 
Filojoes joins the table at seat #2 
Jimy Tiltman: raises $2 to $3
hammerwife: folds 
bilukm: folds 
matiko09: folds 
butcheN18: folds 
bronbeek: folds 
Uncalled bet ($2) returned to Jimy Tiltman
Jimy Tiltman collected $2.50 from pot
Jimy Tiltman: doesn't show hand 
*** SUMMARY ***
Total pot $2.50 | Rake $0 
Seat 1: bilukm folded before Flop (didn't bet)
Seat 3: matiko09 (button) folded before Flop (didn't bet)
Seat 4: butcheN18 (small blind) folded before Flop
Seat 5: bronbeek (big blind) folded before Flop
Seat 6: Glushchenko folded before Flop (didn't bet)
Seat 7: djammusic folded before Flop (didn't bet)
Seat 8: Jimy Tiltman collected ($2.50)
Seat 9: hammerwife folded before Flop (didn't bet)





PokerStars Hand #151942667295:  Hold'em No Limit ($0.50/$1.00 USD) - 2016/04/15 13:30:14 CET [2016/04/15 7:30:14 ET]
Table 'Thabit' 9-max Seat #7 is the button
Seat 1: Yaaaazz ($103.18 in chips) 
Seat 2: butcheN18 ($138.76 in chips) 
Seat 3: choupai ($24.67 in chips) 
Seat 5: spunkbubble9 ($25.56 in chips) 
Seat 7: maxxmeister ($100 in chips) 
Seat 8: Filojoes ($135.60 in chips) 
Seat 9: matiko09 ($100 in chips) 
Filojoes: posts small blind $0.50
matiko09: posts big blind $1
*** HOLE CARDS ***
Dealt to matiko09 [Td Kd]
Yaaaazz: folds 
butcheN18: folds 
choupai: folds 
spunkbubble9: folds 
maxxmeister: raises $2.50 to $3.50
Filojoes: folds 
matiko09: calls $2.50
*** FLOP *** [Kh 9h 3d]
matiko09: checks 
maxxmeister: bets $4.37
matiko09: calls $4.37
*** TURN *** [Kh 9h 3d] [As]
matiko09: checks 
maxxmeister: checks 
*** RIVER *** [Kh 9h 3d As] [3s]
matiko09: checks 
maxxmeister: bets $8
matiko09: calls $8
*** SHOW DOWN ***
maxxmeister: shows [Ah 6d] (two pair, Aces and Threes)
matiko09: mucks hand 
maxxmeister collected $30.63 from pot
*** SUMMARY ***
Total pot $32.24 | Rake $1.61 
Board [Kh 9h 3d As 3s]
Seat 1: Yaaaazz folded before Flop (didn't bet)
Seat 2: butcheN18 folded before Flop (didn't bet)
Seat 3: choupai folded before Flop (didn't bet)
Seat 5: spunkbubble9 folded before Flop (didn't bet)
Seat 7: maxxmeister (button) showed [Ah 6d] and won ($30.63) with two pair, Aces and Threes
Seat 8: Filojoes (small blind) folded before Flop
Seat 9: matiko09 (big blind) mucked [Td Kd]





PokerStars Hand #151942669131:  Hold'em No Limit ($0.50/$1.00 USD) - 2016/04/15 13:30:18 CET [2016/04/15 7:30:18 ET]
Table 'Adelgunde III' 9-max Seat #1 is the button
Seat 1: valimiu ($42.65 in chips) 
Seat 2: djammusic ($45.88 in chips) 
Seat 3: tipner ($100 in chips) 
Seat 4: hammerwife ($115.95 in chips) 
Seat 5: matiko09 ($105.98 in chips) 
Seat 6: Pominator92 ($115.68 in chips) 
Seat 7: Foton18 ($22.41 in chips) 
Seat 8: aseban11 ($100 in chips) 
Seat 9: Kukuryzka ($100 in chips) 
djammusic: posts small blind $0.50
tipner: posts big blind $1
*** HOLE CARDS ***
Dealt to matiko09 [2c 4h]
hammerwife: folds 
matiko09: folds 
Pominator92: calls $1
Foton18: raises $3.50 to $4.50
aseban11: folds 
Kukuryzka: folds 
valimiu: folds 
djammusic: folds 
tipner: folds 
Pominator92: calls $3.50
*** FLOP *** [7d 9s 3s]
Pominator92: checks 
Foton18: bets $5
Pominator92: raises $19.98 to $24.98
Foton18: folds 
Uncalled bet ($19.98) returned to Pominator92
Pominator92 collected $19.48 from pot
Pominator92: doesn't show hand 
*** SUMMARY ***
Total pot $20.50 | Rake $1.02 
Board [7d 9s 3s]
Seat 1: valimiu (button) folded before Flop (didn't bet)
Seat 2: djammusic (small blind) folded before Flop
Seat 3: tipner (big blind) folded before Flop
Seat 4: hammerwife folded before Flop (didn't bet)
Seat 5: matiko09 folded before Flop (didn't bet)
Seat 6: Pominator92 collected ($19.48)
Seat 7: Foton18 folded on the Flop
Seat 8: aseban11 folded before Flop (didn't bet)
Seat 9: Kukuryzka folded before Flop (didn't bet)





PokerStars Hand #151942674149:  Hold'em No Limit ($0.50/$1.00 USD) - 2016/04/15 13:30:28 CET [2016/04/15 7:30:28 ET]
Table 'Parvulesco II' 9-max Seat #4 is the button
Seat 1: bilukm ($34.59 in chips) 
Seat 3: matiko09 ($100 in chips) 
Seat 4: butcheN18 ($100 in chips) 
Seat 5: bronbeek ($97.51 in chips) 
Seat 6: Glushchenko ($133.22 in chips) 
Seat 7: djammusic ($40 in chips) 
Seat 8: Jimy Tiltman ($101.50 in chips) 
Seat 9: hammerwife ($216 in chips) 
bronbeek: posts small blind $0.50
Glushchenko: posts big blind $1
Filojoes: sits out 
*** HOLE CARDS ***
Dealt to matiko09 [Qs 3c]
djammusic: folds 
Jimy Tiltman: raises $2 to $3
hammerwife: folds 
bilukm: calls $3
matiko09: folds 
butcheN18: folds 
bronbeek: folds 
Glushchenko: folds 
*** FLOP *** [Ac 7s 4c]
djammusic leaves the table
Jimy Tiltman: bets $4
bilukm: calls $4
*** TURN *** [Ac 7s 4c] [Ks]
Jimy Tiltman: checks 
bilukm: bets $7.36
Jimy Tiltman: folds 
Uncalled bet ($7.36) returned to bilukm
bilukm collected $14.72 from pot
bilukm: doesn't show hand 
*** SUMMARY ***
Total pot $15.50 | Rake $0.78 
Board [Ac 7s 4c Ks]
Seat 1: bilukm collected ($14.72)
Seat 3: matiko09 folded before Flop (didn't bet)
Seat 4: butcheN18 (button) folded before Flop (didn't bet)
Seat 5: bronbeek (small blind) folded before Flop
Seat 6: Glushchenko (big blind) folded before Flop
Seat 7: djammusic folded before Flop (didn't bet)
Seat 8: Jimy Tiltman folded on the Turn
Seat 9: hammerwife folded before Flop (didn't bet)





PokerStars Hand #151942678872:  Hold'em No Limit ($0.50/$1.00 USD) - 2016/04/15 13:30:38 CET [2016/04/15 7:30:38 ET]
Table 'Katja II' 9-max Seat #7 is the button
Seat 1: Filojoes ($105.50 in chips) 
Seat 2: TheJokerMen1 ($51.49 in chips) 
Seat 3: matiko09 ($137.12 in chips) 
Seat 4: Sutt_420 ($68.20 in chips) 
Seat 6: ASG2016 ($116.02 in chips) 
Seat 7: Effort92 ($100 in chips) 
Seat 8: Glushchenko ($100 in chips) 
Seat 9: hardeep13 ($73.98 in chips) 
Glushchenko: posts small blind $0.50
hardeep13: posts big blind $1
*** HOLE CARDS ***
Dealt to matiko09 [2d 4c]
Filojoes: folds 
TheJokerMen1: calls $1
matiko09: folds 
Sutt_420: folds 
ASG2016: folds 
Effort92: folds 
Glushchenko: raises $4 to $5
hardeep13: folds 
TheJokerMen1: calls $4
*** FLOP *** [Qh Jd 2s]
Glushchenko: bets $6.96
TheJokerMen1: calls $6.96
*** TURN *** [Qh Jd 2s] [9d]
Glushchenko: bets $12
TheJokerMen1: calls $12
*** RIVER *** [Qh Jd 2s 9d] [3c]
Glushchenko: bets $30.97
TheJokerMen1: calls $27.53 and is all-in
Uncalled bet ($3.44) returned to Glushchenko
*** SHOW DOWN ***
Glushchenko: shows [Ks Kd] (a pair of Kings)
TheJokerMen1: shows [Qs 5s] (a pair of Queens)
Glushchenko collected $101.48 from pot
*** SUMMARY ***
Total pot $103.98 | Rake $2.50 
Board [Qh Jd 2s 9d 3c]
Seat 1: Filojoes folded before Flop (didn't bet)
Seat 2: TheJokerMen1 showed [Qs 5s] and lost with a pair of Queens
Seat 3: matiko09 folded before Flop (didn't bet)
Seat 4: Sutt_420 folded before Flop (didn't bet)
Seat 6: ASG2016 folded before Flop (didn't bet)
Seat 7: Effort92 (button) folded before Flop (didn't bet)
Seat 8: Glushchenko (small blind) showed [Ks Kd] and won ($101.48) with a pair of Kings
Seat 9: hardeep13 (big blind) folded before Flop





PokerStars Hand #151942679596:  Hold'em No Limit ($1/$2 USD) - 2016/04/15 13:30:39 CET [2016/04/15 7:30:39 ET]
Table 'Oceax' 9-max Seat #5 is the button
Seat 1: matiko09 ($200 in chips) 
Seat 2: Fish4trips ($310.36 in chips) 
Seat 3: Yaaaazz ($200 in chips) 
Seat 4: butcheN18 ($226.42 in chips) 
Seat 5: di0d80 ($200 in chips) 
Seat 6: Iggso ($209.25 in chips) 
Seat 7: djlaw321 ($171 in chips) 
Seat 8: Poroxide ($205.35 in chips) 
Seat 9: Olddogtom888 ($290.88 in chips) 
Iggso: posts small blind $1
djlaw321: posts big blind $2
*** HOLE CARDS ***
Dealt to matiko09 [Qh 4d]
Poroxide: folds 
Olddogtom888: folds 
matiko09: folds 
Fish4trips: raises $3 to $5
Yaaaazz: folds 
butcheN18: folds 
di0d80: folds 
Iggso: folds 
djlaw321: folds 
Uncalled bet ($3) returned to Fish4trips
Fish4trips collected $5 from pot
Fish4trips: doesn't show hand 
*** SUMMARY ***
Total pot $5 | Rake $0 
Seat 1: matiko09 folded before Flop (didn't bet)
Seat 2: Fish4trips collected ($5)
Seat 3: Yaaaazz folded before Flop (didn't bet)
Seat 4: butcheN18 folded before Flop (didn't bet)
Seat 5: di0d80 (button) folded before Flop (didn't bet)
Seat 6: Iggso (small blind) folded before Flop
Seat 7: djlaw321 (big blind) folded before Flop
Seat 8: Poroxide folded before Flop (didn't bet)
Seat 9: Olddogtom888 folded before Flop (didn't bet)





PokerStars Hand #151942684063:  Hold'em No Limit ($1/$2 USD) - 2016/04/15 13:30:48 CET [2016/04/15 7:30:48 ET]
Table 'Adele II' 9-max Seat #8 is the button
Seat 1: RyanHuJun ($245.87 in chips) 
Seat 3: matiko09 ($319.45 in chips) 
Seat 4: Glushchenko ($200 in chips) 
Seat 6: wiseyoyo ($261.93 in chips) 
Seat 7: Iggso ($200 in chips) 
Seat 8: docmarc777 ($368.92 in chips) 
Seat 9: SanychStar ($200 in chips) 
SanychStar: posts small blind $1
RyanHuJun: posts big blind $2
Fish4trips: sits out 
*** HOLE CARDS ***
Dealt to matiko09 [9d 3d]
matiko09: folds 
Glushchenko: folds 
wiseyoyo: folds 
Iggso: folds 
docmarc777: raises $2 to $4
SanychStar: folds 
RyanHuJun: calls $2
*** FLOP *** [9c Th 6h]
RyanHuJun: checks 
docmarc777: checks 
*** TURN *** [9c Th 6h] [Td]
RyanHuJun: bets $4
docmarc777: calls $4
*** RIVER *** [9c Th 6h Td] [Jh]
RyanHuJun: checks 
docmarc777: bets $8
RyanHuJun: calls $8
*** SHOW DOWN ***
docmarc777: shows [Kc Ac] (a pair of Tens)
RyanHuJun: shows [6c Kh] (two pair, Tens and Sixes)
RyanHuJun collected $31.35 from pot
*** SUMMARY ***
Total pot $33 | Rake $1.65 
Board [9c Th 6h Td Jh]
Seat 1: RyanHuJun (big blind) showed [6c Kh] and won ($31.35) with two pair, Tens and Sixes
Seat 3: matiko09 folded before Flop (didn't bet)
Seat 4: Glushchenko folded before Flop (didn't bet)
Seat 6: wiseyoyo folded before Flop (didn't bet)
Seat 7: Iggso folded before Flop (didn't bet)
Seat 8: docmarc777 (button) showed [Kc Ac] and lost with a pair of Tens
Seat 9: SanychStar (small blind) folded before Flop





PokerStars Hand #151942685250:  Hold'em No Limit ($1/$2 USD) - 2016/04/15 13:30:50 CET [2016/04/15 7:30:50 ET]
Table 'Patroclus II' 9-max Seat #9 is the button
Seat 1: TonnaMunz ($211.04 in chips) 
Seat 2: Moemors ($186.88 in chips) 
Seat 3: Koolniknik ($217.76 in chips) 
Seat 4: tipner ($206 in chips) 
Seat 5: butcheN18 ($256.29 in chips) 
Seat 6: di0d80 ($200 in chips) 
Seat 7: matiko09 ($248.76 in chips) 
Seat 8: Glushchenko ($200 in chips) 
Seat 9: Fish4trips ($228.72 in chips) 
TonnaMunz: posts small blind $1
Moemors: posts big blind $2
*** HOLE CARDS ***
Dealt to matiko09 [5h Ad]
Koolniknik: raises $4 to $6
tipner: calls $6
butcheN18: folds 
di0d80: folds 
matiko09: folds 
Glushchenko: folds 
Fish4trips: folds 
TonnaMunz: folds 
Moemors: folds 
*** FLOP *** [4s 4h Ts]
Koolniknik: bets $7.12
tipner: calls $7.12
*** TURN *** [4s 4h Ts] [7d]
Koolniknik: bets $13.89
tipner: calls $13.89
*** RIVER *** [4s 4h Ts 7d] [7h]
Koolniknik: bets $54.27
tipner: calls $54.27
*** SHOW DOWN ***
Koolniknik: shows [Td Th] (a full house, Tens full of Sevens)
tipner: mucks hand 
Koolniknik collected $162.81 from pot
*** SUMMARY ***
Total pot $165.56 | Rake $2.75 
Board [4s 4h Ts 7d 7h]
Seat 1: TonnaMunz (small blind) folded before Flop
Seat 2: Moemors (big blind) folded before Flop
Seat 3: Koolniknik showed [Td Th] and won ($162.81) with a full house, Tens full of Sevens
Seat 4: tipner mucked [9s 9c]
Seat 5: butcheN18 folded before Flop (didn't bet)
Seat 6: di0d80 folded before Flop (didn't bet)
Seat 7: matiko09 folded before Flop (didn't bet)
Seat 8: Glushchenko folded before Flop (didn't bet)
Seat 9: Fish4trips (button) folded before Flop (didn't bet)





PokerStars Hand #151942685990:  Hold'em No Limit ($0.50/$1.00 USD) - 2016/04/15 13:30:52 CET [2016/04/15 7:30:52 ET]
Table 'Navi' 9-max Seat #5 is the button
Seat 1: tipner ($104.45 in chips) 
Seat 2: butcheN18 ($100 in chips) 
Seat 3: aseban11 ($105.78 in chips) 
Seat 4: Effort92 ($119.38 in chips) 
Seat 5: hammerwife ($100 in chips) 
Seat 6: Glushchenko ($110.16 in chips) 
Seat 7: yoshidao ($152.45 in chips) 
Seat 8: djammusic ($39.44 in chips) 
Seat 9: matiko09 ($130.95 in chips) 
Glushchenko: posts small blind $0.50
yoshidao: posts big blind $1
*** HOLE CARDS ***
Dealt to matiko09 [2c 8h]
djammusic: raises $1.25 to $2.25
matiko09: folds 
tipner: folds 
butcheN18: folds 
aseban11: folds 
Effort92: calls $2.25
hammerwife: folds 
Glushchenko: folds 
yoshidao: calls $1.25
*** FLOP *** [3c 9c Tc]
yoshidao: bets $5
djammusic: folds 
Effort92: calls $5
*** TURN *** [3c 9c Tc] [Th]
yoshidao: bets $5
Effort92: raises $13 to $18
yoshidao: calls $13
*** RIVER *** [3c 9c Tc Th] [4h]
yoshidao: bets $8
Effort92: raises $30 to $38
yoshidao: folds 
Uncalled bet ($30) returned to Effort92
Effort92 collected $66.75 from pot
Effort92: doesn't show hand 
*** SUMMARY ***
Total pot $69.25 | Rake $2.50 
Board [3c 9c Tc Th 4h]
Seat 1: tipner folded before Flop (didn't bet)
Seat 2: butcheN18 folded before Flop (didn't bet)
Seat 3: aseban11 folded before Flop (didn't bet)
Seat 4: Effort92 collected ($66.75)
Seat 5: hammerwife (button) folded before Flop (didn't bet)
Seat 6: Glushchenko (small blind) folded before Flop
Seat 7: yoshidao (big blind) folded on the River
Seat 8: djammusic folded on the Flop
Seat 9: matiko09 folded before Flop (didn't bet)





PokerStars Hand #151942687071:  Hold'em No Limit ($1/$2 USD) - 2016/04/15 13:30:54 CET [2016/04/15 7:30:54 ET]
Table 'Irmgard II' 9-max Seat #5 is the button
Seat 1: T0ny Adams ($76 in chips) 
Seat 3: matiko09 ($200 in chips) 
Seat 4: di0d80 ($200 in chips) 
Seat 5: vezunchik79 ($234.45 in chips) 
Seat 6: djammusic ($75 in chips) 
Seat 7: erfk1958 ($122 in chips) 
Seat 8: MoeAA11 ($75 in chips) 
Seat 9: maximax04 ($183.45 in chips) 
djammusic: posts small blind $1
erfk1958: posts big blind $2
Kukuryzka: sits out 
*** HOLE CARDS ***
Dealt to matiko09 [Qs Ac]
MoeAA11: raises $6 to $8
maximax04: folds 
T0ny Adams: folds 
matiko09: calls $8
di0d80: folds 
vezunchik79: folds 
djammusic: folds 
erfk1958: folds 
*** FLOP *** [6d Td 8s]
MoeAA11: bets $6
matiko09: calls $6
*** TURN *** [6d Td 8s] [8c]
MoeAA11: bets $12
matiko09: folds 
Uncalled bet ($12) returned to MoeAA11
MoeAA11 collected $29.45 from pot
MoeAA11: doesn't show hand 
*** SUMMARY ***
Total pot $31 | Rake $1.55 
Board [6d Td 8s 8c]
Seat 1: T0ny Adams folded before Flop (didn't bet)
Seat 3: matiko09 folded on the Turn
Seat 4: di0d80 folded before Flop (didn't bet)
Seat 5: vezunchik79 (button) folded before Flop (didn't bet)
Seat 6: djammusic (small blind) folded before Flop
Seat 7: erfk1958 (big blind) folded before Flop
Seat 8: MoeAA11 collected ($29.45)
Seat 9: maximax04 folded before Flop (didn't bet)





PokerStars Hand #151942692976:  Hold'em No Limit ($0.50/$1.00 USD) - 2016/04/15 13:31:05 CET [2016/04/15 7:31:05 ET]
Table 'Matterania III' 9-max Seat #6 is the button
Seat 1: di0d80 ($115.85 in chips) 
Seat 2: haoyuan541 ($94.02 in chips) 
Seat 3: ardo888 ($159.24 in chips) 
Seat 4: wangzhuoming ($72.82 in chips) 
Seat 6: matiko09 ($101.34 in chips) 
Seat 7: Filojoes ($101.10 in chips) 
Seat 8: Jimy Tiltman ($108.54 in chips) 
Seat 9: butcheN18 ($124 in chips) 
Filojoes: posts small blind $0.50
Jimy Tiltman: posts big blind $1
di0d80: posts the ante $0.20
haoyuan541: posts the ante $0.20
ardo888: posts the ante $0.20
wangzhuoming: posts the ante $0.20
matiko09: posts the ante $0.20
Filojoes: posts the ante $0.20
Jimy Tiltman: posts the ante $0.20
butcheN18: posts the ante $0.20
*** HOLE CARDS ***
Dealt to matiko09 [Th 5d]
butcheN18: folds 
di0d80: folds 
haoyuan541: folds 
ardo888: folds 
wangzhuoming: folds 
matiko09: folds 
Filojoes: folds 
Uncalled bet ($0.50) returned to Jimy Tiltman
Jimy Tiltman collected $2.60 from pot
Jimy Tiltman: doesn't show hand 
*** SUMMARY ***
Total pot $2.60 | Rake $0 
Seat 1: di0d80 folded before Flop (didn't bet)
Seat 2: haoyuan541 folded before Flop (didn't bet)
Seat 3: ardo888 folded before Flop (didn't bet)
Seat 4: wangzhuoming folded before Flop (didn't bet)
Seat 6: matiko09 (button) folded before Flop (didn't bet)
Seat 7: Filojoes (small blind) folded before Flop
Seat 8: Jimy Tiltman (big blind) collected ($2.60)
Seat 9: butcheN18 folded before Flop (didn't bet)





PokerStars Hand #151942694030:  Hold'em No Limit ($1/$2 USD) - 2016/04/15 13:31:07 CET [2016/04/15 7:31:07 ET]
Table 'Oceax' 9-max Seat #6 is the button
Seat 1: matiko09 ($200 in chips) 
Seat 2: Fish4trips ($313.36 in chips) 
Seat 3: Yaaaazz ($200 in chips) 
Seat 4: butcheN18 ($226.42 in chips) 
Seat 5: di0d80 ($200 in chips) 
Seat 6: Iggso ($208.25 in chips) 
Seat 7: djlaw321 ($169 in chips) 
Seat 8: Poroxide ($205.35 in chips) 
Seat 9: Olddogtom888 ($290.88 in chips) 
djlaw321: posts small blind $1
Poroxide: posts big blind $2
*** HOLE CARDS ***
Dealt to matiko09 [3h 8h]
Olddogtom888: calls $2
matiko09: folds 
Fish4trips: raises $6 to $8
Yaaaazz: folds 
butcheN18: raises $16 to $24
di0d80: folds 
Iggso: folds 
djlaw321: folds 
Poroxide: folds 
Olddogtom888: folds 
Fish4trips: folds 
Uncalled bet ($16) returned to butcheN18
butcheN18 collected $21 from pot
butcheN18: doesn't show hand 
*** SUMMARY ***
Total pot $21 | Rake $0 
Seat 1: matiko09 folded before Flop (didn't bet)
Seat 2: Fish4trips folded before Flop
Seat 3: Yaaaazz folded before Flop (didn't bet)
Seat 4: butcheN18 collected ($21)
Seat 5: di0d80 folded before Flop (didn't bet)
Seat 6: Iggso (button) folded before Flop (didn't bet)
Seat 7: djlaw321 (small blind) folded before Flop
Seat 8: Poroxide (big blind) folded before Flop
Seat 9: Olddogtom888 folded before Flop





PokerStars Hand #151942697504:  Hold'em No Limit ($0.50/$1.00 USD) - 2016/04/15 13:31:15 CET [2016/04/15 7:31:15 ET]
Table 'Parvulesco II' 9-max Seat #5 is the button
Seat 1: bilukm ($42.31 in chips) 
Seat 3: matiko09 ($100 in chips) 
Seat 4: butcheN18 ($100 in chips) 
Seat 5: bronbeek ($97.01 in chips) 
Seat 6: Glushchenko ($132.22 in chips) 
Seat 8: Jimy Tiltman ($100 in chips) 
Seat 9: hammerwife ($216 in chips) 
Glushchenko: posts small blind $0.50
Jimy Tiltman: posts big blind $1
Filojoes: sits out 
*** HOLE CARDS ***
Dealt to matiko09 [Qh 3h]
hammerwife: folds 
bilukm: raises $1 to $2
matiko09: folds 
butcheN18: folds 
bronbeek: folds 
Glushchenko: folds 
Kukuryzka joins the table at seat #7 
Jimy Tiltman: folds 
Uncalled bet ($1) returned to bilukm
bilukm collected $2.50 from pot
bilukm: doesn't show hand 
*** SUMMARY ***
Total pot $2.50 | Rake $0 
Seat 1: bilukm collected ($2.50)
Seat 3: matiko09 folded before Flop (didn't bet)
Seat 4: butcheN18 folded before Flop (didn't bet)
Seat 5: bronbeek (button) folded before Flop (didn't bet)
Seat 6: Glushchenko (small blind) folded before Flop
Seat 8: Jimy Tiltman (big blind) folded before Flop
Seat 9: hammerwife folded before Flop (didn't bet)





PokerStars Hand #151942698917:  Hold'em No Limit ($0.50/$1.00 USD) - 2016/04/15 13:31:17 CET [2016/04/15 7:31:17 ET]
Table 'Adelgunde III' 9-max Seat #2 is the button
Seat 1: valimiu ($42.65 in chips) 
Seat 2: djammusic ($45.38 in chips) 
Seat 3: tipner ($100 in chips) 
Seat 4: hammerwife ($115.95 in chips) 
Seat 5: matiko09 ($105.98 in chips) 
Seat 6: Pominator92 ($125.66 in chips) 
Seat 7: Foton18 ($12.91 in chips) 
Seat 8: aseban11 ($100 in chips) 
Seat 9: Kukuryzka ($100 in chips) 
tipner: posts small blind $0.50
hammerwife: posts big blind $1
*** HOLE CARDS ***
Dealt to matiko09 [2d Ks]
matiko09: folds 
Pominator92: folds 
Foton18: raises $2 to $3
aseban11: folds 
Kukuryzka: folds 
valimiu: calls $3
djammusic: folds 
tipner: folds 
hammerwife: folds 
*** FLOP *** [Ts 5c Jh]
Foton18: checks 
valimiu: checks 
*** TURN *** [Ts 5c Jh] [3d]
Foton18: checks 
valimiu: checks 
*** RIVER *** [Ts 5c Jh 3d] [7d]
Foton18: checks 
valimiu: bets $5
Foton18: folds 
Uncalled bet ($5) returned to valimiu
valimiu collected $7.12 from pot
valimiu: doesn't show hand 
*** SUMMARY ***
Total pot $7.50 | Rake $0.38 
Board [Ts 5c Jh 3d 7d]
Seat 1: valimiu collected ($7.12)
Seat 2: djammusic (button) folded before Flop (didn't bet)
Seat 3: tipner (small blind) folded before Flop
Seat 4: hammerwife (big blind) folded before Flop
Seat 5: matiko09 folded before Flop (didn't bet)
Seat 6: Pominator92 folded before Flop (didn't bet)
Seat 7: Foton18 folded on the River
Seat 8: aseban11 folded before Flop (didn't bet)
Seat 9: Kukuryzka folded before Flop (didn't bet)





PokerStars Hand #151942704824:  Hold'em No Limit ($0.50/$1.00 USD) - 2016/04/15 13:31:29 CET [2016/04/15 7:31:29 ET]
Table 'Thabit' 9-max Seat #8 is the button
Seat 1: Yaaaazz ($103.18 in chips) 
Seat 2: butcheN18 ($138.76 in chips) 
Seat 3: choupai ($24.67 in chips) 
Seat 5: spunkbubble9 ($25.56 in chips) 
Seat 7: maxxmeister ($114.76 in chips) 
Seat 8: Filojoes ($135.10 in chips) 
Seat 9: matiko09 ($100 in chips) 
matiko09: posts small blind $0.50
Yaaaazz: posts big blind $1
*** HOLE CARDS ***
Dealt to matiko09 [4s 6d]
butcheN18: folds 
choupai: folds 
spunkbubble9: folds 
maxxmeister: folds 
Filojoes: folds 
matiko09: folds 
Uncalled bet ($0.50) returned to Yaaaazz
Yaaaazz collected $1 from pot
*** SUMMARY ***
Total pot $1 | Rake $0 
Seat 1: Yaaaazz (big blind) collected ($1)
Seat 2: butcheN18 folded before Flop (didn't bet)
Seat 3: choupai folded before Flop (didn't bet)
Seat 5: spunkbubble9 folded before Flop (didn't bet)
Seat 7: maxxmeister folded before Flop (didn't bet)
Seat 8: Filojoes (button) folded before Flop (didn't bet)
Seat 9: matiko09 (small blind) folded before Flop





PokerStars Hand #151942708621:  Hold'em No Limit ($0.50/$1.00 USD) - 2016/04/15 13:31:37 CET [2016/04/15 7:31:37 ET]
Table 'Matterania III' 9-max Seat #7 is the button
Seat 1: di0d80 ($115.65 in chips) 
Seat 2: haoyuan541 ($93.82 in chips) 
Seat 3: ardo888 ($159.04 in chips) 
Seat 4: wangzhuoming ($72.62 in chips) 
Seat 6: matiko09 ($101.14 in chips) 
Seat 7: Filojoes ($100.40 in chips) 
Seat 8: Jimy Tiltman ($110.44 in chips) 
Seat 9: butcheN18 ($123.80 in chips) 
Jimy Tiltman: posts small blind $0.50
butcheN18: posts big blind $1
di0d80: posts the ante $0.20
haoyuan541: posts the ante $0.20
ardo888: posts the ante $0.20
wangzhuoming: posts the ante $0.20
matiko09: posts the ante $0.20
Filojoes: posts the ante $0.20
Jimy Tiltman: posts the ante $0.20
butcheN18: posts the ante $0.20
*** HOLE CARDS ***
Dealt to matiko09 [9h Qh]
di0d80: folds 
haoyuan541: folds 
ardo888: folds 
wangzhuoming: folds 
matiko09: raises $1.50 to $2.50
Filojoes: folds 
Jimy Tiltman: folds 
butcheN18: folds 
Uncalled bet ($1.50) returned to matiko09
matiko09 collected $4.10 from pot
matiko09: doesn't show hand 
*** SUMMARY ***
Total pot $4.10 | Rake $0 
Seat 1: di0d80 folded before Flop (didn't bet)
Seat 2: haoyuan541 folded before Flop (didn't bet)
Seat 3: ardo888 folded before Flop (didn't bet)
Seat 4: wangzhuoming folded before Flop (didn't bet)
Seat 6: matiko09 collected ($4.10)
Seat 7: Filojoes (button) folded before Flop (didn't bet)
Seat 8: Jimy Tiltman (small blind) folded before Flop
Seat 9: butcheN18 (big blind) folded before Flop





PokerStars Hand #151942713007:  Hold'em No Limit ($1/$2 USD) - 2016/04/15 13:31:45 CET [2016/04/15 7:31:45 ET]
Table 'Adele II' 9-max Seat #9 is the button
Seat 1: RyanHuJun ($261.22 in chips) 
Seat 2: Fish4trips ($200 in chips) 
Seat 3: matiko09 ($319.45 in chips) 
Seat 4: Glushchenko ($200 in chips) 
Seat 6: wiseyoyo ($261.93 in chips) 
Seat 7: Iggso ($200 in chips) 
Seat 8: docmarc777 ($352.92 in chips) 
Seat 9: SanychStar ($200 in chips) 
RyanHuJun: posts small blind $1
Fish4trips: posts big blind $2
*** HOLE CARDS ***
Dealt to matiko09 [7d 4d]
matiko09: folds 
Glushchenko: folds 
wiseyoyo: raises $4 to $6
Iggso: folds 
docmarc777: folds 
SanychStar: folds 
RyanHuJun: calls $5
Fish4trips: raises $19 to $25
wiseyoyo: calls $19
RyanHuJun: calls $19
*** FLOP *** [Qd 3s 8h]
RyanHuJun: checks 
Fish4trips: bets $29.62
wiseyoyo: folds 
RyanHuJun: calls $29.62
*** TURN *** [Qd 3s 8h] [Jh]
RyanHuJun: checks 
Fish4trips: bets $53
RyanHuJun: calls $53
*** RIVER *** [Qd 3s 8h Jh] [Ah]
RyanHuJun: checks 
Fish4trips: bets $92.38 and is all-in
RyanHuJun: calls $92.38
*** SHOW DOWN ***
Fish4trips: shows [Ac As] (three of a kind, Aces)
RyanHuJun: mucks hand 
Fish4trips collected $422.25 from pot
*** SUMMARY ***
Total pot $425 | Rake $2.75 
Board [Qd 3s 8h Jh Ah]
Seat 1: RyanHuJun (small blind) mucked [Qs Jd]
Seat 2: Fish4trips (big blind) showed [Ac As] and won ($422.25) with three of a kind, Aces
Seat 3: matiko09 folded before Flop (didn't bet)
Seat 4: Glushchenko folded before Flop (didn't bet)
Seat 6: wiseyoyo folded on the Flop
Seat 7: Iggso folded before Flop (didn't bet)
Seat 8: docmarc777 folded before Flop (didn't bet)
Seat 9: SanychStar (button) folded before Flop (didn't bet)





PokerStars Hand #151942716624:  Hold'em No Limit ($0.50/$1.00 USD) - 2016/04/15 13:31:52 CET [2016/04/15 7:31:52 ET]
Table 'Parvulesco II' 9-max Seat #6 is the button
Seat 1: bilukm ($43.81 in chips) 
Seat 3: matiko09 ($100 in chips) 
Seat 4: butcheN18 ($100 in chips) 
Seat 5: bronbeek ($97.01 in chips) 
Seat 6: Glushchenko ($131.72 in chips) 
Seat 8: Jimy Tiltman ($100 in chips) 
Seat 9: hammerwife ($216 in chips) 
Kukuryzka will be allowed to play after the button
Jimy Tiltman: posts small blind $0.50
hammerwife: posts big blind $1
Filojoes: sits out 
*** HOLE CARDS ***
Dealt to matiko09 [Js Qc]
bilukm: calls $1
matiko09: folds 
butcheN18: folds 
bronbeek: folds 
Glushchenko: folds 
Jimy Tiltman: folds 
hammerwife: checks 
*** FLOP *** [Kh 5c Kd]
hammerwife: checks 
bilukm: checks 
*** TURN *** [Kh 5c Kd] [5d]
hammerwife: checks 
bilukm: checks 
*** RIVER *** [Kh 5c Kd 5d] [2c]
hammerwife: checks 
bilukm: checks 
*** SHOW DOWN ***
hammerwife: shows [2s 4c] (two pair, Kings and Fives)
bilukm: shows [7s 8h] (two pair, Kings and Fives - Eight kicker)
bilukm collected $2.38 from pot
*** SUMMARY ***
Total pot $2.50 | Rake $0.12 
Board [Kh 5c Kd 5d 2c]
Seat 1: bilukm showed [7s 8h] and won ($2.38) with two pair, Kings and Fives
Seat 3: matiko09 folded before Flop (didn't bet)
Seat 4: butcheN18 folded before Flop (didn't bet)
Seat 5: bronbeek folded before Flop (didn't bet)
Seat 6: Glushchenko (button) folded before Flop (didn't bet)
Seat 8: Jimy Tiltman (small blind) folded before Flop
Seat 9: hammerwife (big blind) showed [2s 4c] and lost with two pair, Kings and Fives





PokerStars Hand #151942717135:  Hold'em No Limit ($1/$2 USD) - 2016/04/15 13:31:53 CET [2016/04/15 7:31:53 ET]
Table 'Oceax' 9-max Seat #7 is the button
Seat 1: matiko09 ($200 in chips) 
Seat 2: Fish4trips ($305.36 in chips) 
Seat 3: Yaaaazz ($200 in chips) 
Seat 4: butcheN18 ($239.42 in chips) 
Seat 5: di0d80 ($200 in chips) 
Seat 6: Iggso ($208.25 in chips) 
Seat 7: djlaw321 ($168 in chips) 
Seat 8: Poroxide ($203.35 in chips) 
Seat 9: Olddogtom888 ($288.88 in chips) 
Poroxide: posts small blind $1
Olddogtom888: posts big blind $2
*** HOLE CARDS ***
Dealt to matiko09 [Kc Ac]
matiko09: raises $3 to $5
Fish4trips: folds 
Yaaaazz: folds 
butcheN18: folds 
di0d80: calls $5
Iggso: folds 
djlaw321: calls $5
Poroxide: calls $4
Olddogtom888: calls $3
*** FLOP *** [9s 6c Jd]
Poroxide: bets $4
Olddogtom888: folds 
matiko09: calls $4
di0d80: folds 
djlaw321: calls $4
*** TURN *** [9s 6c Jd] [Ad]
Poroxide: checks 
matiko09: bets $18
djlaw321: folds 
Poroxide: calls $18
*** RIVER *** [9s 6c Jd Ad] [Qc]
Poroxide: bets $36
djlaw321 leaves the table
coinflip_si joins the table at seat #7 
matiko09: folds 
Uncalled bet ($36) returned to Poroxide
Poroxide collected $70.25 from pot
Poroxide: doesn't show hand 
*** SUMMARY ***
Total pot $73 | Rake $2.75 
Board [9s 6c Jd Ad Qc]
Seat 1: matiko09 folded on the River
Seat 2: Fish4trips folded before Flop (didn't bet)
Seat 3: Yaaaazz folded before Flop (didn't bet)
Seat 4: butcheN18 folded before Flop (didn't bet)
Seat 5: di0d80 folded on the Flop
Seat 6: Iggso folded before Flop (didn't bet)
Seat 7: djlaw321 (button) folded on the Turn
Seat 8: Poroxide (small blind) collected ($70.25)
Seat 9: Olddogtom888 (big blind) folded on the Flop





PokerStars Hand #151942718018:  Hold'em No Limit ($0.50/$1.00 USD) - 2016/04/15 13:31:55 CET [2016/04/15 7:31:55 ET]
Table 'Thabit' 9-max Seat #9 is the button
Seat 1: Yaaaazz ($103.68 in chips) 
Seat 2: butcheN18 ($138.76 in chips) 
Seat 3: choupai ($24.67 in chips) 
Seat 5: spunkbubble9 ($25.56 in chips) 
Seat 7: maxxmeister ($114.76 in chips) 
Seat 8: Filojoes ($135.10 in chips) 
Seat 9: matiko09 ($100 in chips) 
Yaaaazz: posts small blind $0.50
butcheN18: posts big blind $1
*** HOLE CARDS ***
Dealt to matiko09 [9c As]
choupai: folds 
spunkbubble9: raises $2 to $3
maxxmeister: folds 
Filojoes: folds 
matiko09: folds 
Yaaaazz: folds 
butcheN18: raises $27 to $30
spunkbubble9: folds 
Uncalled bet ($27) returned to butcheN18
butcheN18 collected $6.50 from pot
butcheN18: doesn't show hand 
*** SUMMARY ***
Total pot $6.50 | Rake $0 
Seat 1: Yaaaazz (small blind) folded before Flop
Seat 2: butcheN18 (big blind) collected ($6.50)
Seat 3: choupai folded before Flop (didn't bet)
Seat 5: spunkbubble9 folded before Flop
Seat 7: maxxmeister folded before Flop (didn't bet)
Seat 8: Filojoes folded before Flop (didn't bet)
Seat 9: matiko09 (button) folded before Flop (didn't bet)





PokerStars Hand #151942720121:  Hold'em No Limit ($1/$2 USD) - 2016/04/15 13:31:59 CET [2016/04/15 7:31:59 ET]
Table 'Irmgard II' 9-max Seat #6 is the button
Seat 1: T0ny Adams ($76 in chips) 
Seat 3: matiko09 ($200 in chips) 
Seat 4: di0d80 ($200 in chips) 
Seat 5: vezunchik79 ($234.45 in chips) 
Seat 6: djammusic ($74 in chips) 
Seat 7: erfk1958 ($120 in chips) 
Seat 8: MoeAA11 ($90.45 in chips) 
Seat 9: maximax04 ($183.45 in chips) 
erfk1958: posts small blind $1
MoeAA11: posts big blind $2
Kukuryzka: sits out 
*** HOLE CARDS ***
Dealt to matiko09 [8h 9d]
maximax04: calls $2
T0ny Adams: folds 
matiko09: folds 
di0d80: folds 
vezunchik79: folds 
djammusic: folds 
erfk1958: folds 
MoeAA11: checks 
*** FLOP *** [Ah Th 7c]
MoeAA11: bets $4
maximax04: calls $4
*** TURN *** [Ah Th 7c] [5c]
MoeAA11: bets $4
maximax04: calls $4
*** RIVER *** [Ah Th 7c 5c] [3c]
MoeAA11: checks 
maximax04: bets $10
MoeAA11: calls $10
*** SHOW DOWN ***
maximax04: shows [Ad Jc] (a pair of Aces)
MoeAA11: shows [7d Ac] (two pair, Aces and Sevens)
MoeAA11 collected $38.95 from pot
*** SUMMARY ***
Total pot $41 | Rake $2.05 
Board [Ah Th 7c 5c 3c]
Seat 1: T0ny Adams folded before Flop (didn't bet)
Seat 3: matiko09 folded before Flop (didn't bet)
Seat 4: di0d80 folded before Flop (didn't bet)
Seat 5: vezunchik79 folded before Flop (didn't bet)
Seat 6: djammusic (button) folded before Flop (didn't bet)
Seat 7: erfk1958 (small blind) folded before Flop
Seat 8: MoeAA11 (big blind) showed [7d Ac] and won ($38.95) with two pair, Aces and Sevens
Seat 9: maximax04 showed [Ad Jc] and lost with a pair of Aces





PokerStars Hand #151942721929:  Hold'em No Limit ($0.50/$1.00 USD) - 2016/04/15 13:32:03 CET [2016/04/15 7:32:03 ET]
Table 'Matterania III' 9-max Seat #8 is the button
Seat 1: di0d80 ($115.45 in chips) 
Seat 2: haoyuan541 ($93.62 in chips) 
Seat 3: ardo888 ($158.84 in chips) 
Seat 4: wangzhuoming ($72.42 in chips) 
Seat 6: matiko09 ($104.04 in chips) 
Seat 7: Filojoes ($100.20 in chips) 
Seat 8: Jimy Tiltman ($109.74 in chips) 
Seat 9: butcheN18 ($122.60 in chips) 
butcheN18: posts small blind $0.50
di0d80: posts big blind $1
di0d80: posts the ante $0.20
haoyuan541: posts the ante $0.20
ardo888: posts the ante $0.20
wangzhuoming: posts the ante $0.20
matiko09: posts the ante $0.20
Filojoes: posts the ante $0.20
Jimy Tiltman: posts the ante $0.20
butcheN18: posts the ante $0.20
*** HOLE CARDS ***
Dealt to matiko09 [9c Ad]
haoyuan541: folds 
ardo888: folds 
wangzhuoming: folds 
matiko09: folds 
Filojoes: folds 
Jimy Tiltman: raises $1 to $2
butcheN18: folds 
di0d80: folds 
Uncalled bet ($1) returned to Jimy Tiltman
Jimy Tiltman collected $4.10 from pot
Jimy Tiltman: doesn't show hand 
*** SUMMARY ***
Total pot $4.10 | Rake $0 
Seat 1: di0d80 (big blind) folded before Flop
Seat 2: haoyuan541 folded before Flop (didn't bet)
Seat 3: ardo888 folded before Flop (didn't bet)
Seat 4: wangzhuoming folded before Flop (didn't bet)
Seat 6: matiko09 folded before Flop (didn't bet)
Seat 7: Filojoes folded before Flop (didn't bet)
Seat 8: Jimy Tiltman (button) collected ($4.10)
Seat 9: butcheN18 (small blind) folded before Flop





PokerStars Hand #151942725089:  Hold'em No Limit ($0.50/$1.00 USD) - 2016/04/15 13:32:09 CET [2016/04/15 7:32:09 ET]
Table 'Katja II' 9-max Seat #8 is the button
Seat 1: Filojoes ($105.50 in chips) 
Seat 3: matiko09 ($137.12 in chips) 
Seat 4: Sutt_420 ($68.20 in chips) 
Seat 6: ASG2016 ($116.02 in chips) 
Seat 7: Effort92 ($100 in chips) 
Seat 8: Glushchenko ($149.99 in chips) 
Seat 9: hardeep13 ($72.98 in chips) 
hardeep13: posts small blind $0.50
Filojoes: posts big blind $1
*** HOLE CARDS ***
Dealt to matiko09 [9c Qs]
matiko09: folds 
Sutt_420: folds 
Dachish was removed from the table for failing to post
TheJokerMen1 leaves the table
ASG2016: raises $2 to $3
djammusic joins the table at seat #5 
hammerwife joins the table at seat #2 
Effort92: raises $6 to $9
Glushchenko: folds 
hardeep13: folds 
Filojoes: folds 
ASG2016: folds 
Uncalled bet ($6) returned to Effort92
Effort92 collected $7.50 from pot
Effort92: doesn't show hand 
*** SUMMARY ***
Total pot $7.50 | Rake $0 
Seat 1: Filojoes (big blind) folded before Flop
Seat 3: matiko09 folded before Flop (didn't bet)
Seat 4: Sutt_420 folded before Flop (didn't bet)
Seat 6: ASG2016 folded before Flop
Seat 7: Effort92 collected ($7.50)
Seat 8: Glushchenko (button) folded before Flop (didn't bet)
Seat 9: hardeep13 (small blind) folded before Flop





PokerStars Hand #151942730238:  Hold'em No Limit ($1/$2 USD) - 2016/04/15 13:32:19 CET [2016/04/15 7:32:19 ET]
Table 'Patroclus II' 9-max Seat #1 is the button
Seat 1: TonnaMunz ($210.04 in chips) 
Seat 2: Moemors ($184.88 in chips) 
Seat 3: Koolniknik ($299.29 in chips) 
Seat 4: tipner ($200 in chips) 
Seat 5: butcheN18 ($256.29 in chips) 
Seat 6: di0d80 ($200 in chips) 
Seat 7: matiko09 ($248.76 in chips) 
Seat 8: Glushchenko ($200 in chips) 
Seat 9: Fish4trips ($228.72 in chips) 
Moemors: posts small blind $1
Koolniknik: posts big blind $2
*** HOLE CARDS ***
Dealt to matiko09 [Ah Td]
tipner: folds 
butcheN18: folds 
di0d80: folds 
matiko09: raises $3 to $5
Glushchenko: folds 
Fish4trips: folds 
TonnaMunz: folds 
Moemors: folds 
Koolniknik: raises $10 to $15
matiko09: folds 
Uncalled bet ($10) returned to Koolniknik
Koolniknik collected $11 from pot
Koolniknik: doesn't show hand 
*** SUMMARY ***
Total pot $11 | Rake $0 
Seat 1: TonnaMunz (button) folded before Flop (didn't bet)
Seat 2: Moemors (small blind) folded before Flop
Seat 3: Koolniknik (big blind) collected ($11)
Seat 4: tipner folded before Flop (didn't bet)
Seat 5: butcheN18 folded before Flop (didn't bet)
Seat 6: di0d80 folded before Flop (didn't bet)
Seat 7: matiko09 folded before Flop
Seat 8: Glushchenko folded before Flop (didn't bet)
Seat 9: Fish4trips folded before Flop (didn't bet)





PokerStars Hand #151942737624:  Hold'em No Limit ($0.50/$1.00 USD) - 2016/04/15 13:32:34 CET [2016/04/15 7:32:34 ET]
Table 'Matterania III' 9-max Seat #9 is the button
Seat 1: di0d80 ($114.25 in chips) 
Seat 2: haoyuan541 ($93.42 in chips) 
Seat 3: ardo888 ($158.64 in chips) 
Seat 4: wangzhuoming ($72.22 in chips) 
Seat 6: matiko09 ($103.84 in chips) 
Seat 7: Filojoes ($100 in chips) 
Seat 8: Jimy Tiltman ($112.64 in chips) 
Seat 9: butcheN18 ($121.90 in chips) 
di0d80: posts small blind $0.50
haoyuan541: posts big blind $1
di0d80: posts the ante $0.20
haoyuan541: posts the ante $0.20
ardo888: posts the ante $0.20
wangzhuoming: posts the ante $0.20
matiko09: posts the ante $0.20
Filojoes: posts the ante $0.20
Jimy Tiltman: posts the ante $0.20
butcheN18: posts the ante $0.20
*** HOLE CARDS ***
Dealt to matiko09 [4d 7c]
ardo888: folds 
wangzhuoming: folds 
matiko09: folds 
Filojoes: raises $2 to $3
Jimy Tiltman: folds 
butcheN18: folds 
di0d80: folds 
haoyuan541: calls $2
*** FLOP *** [3h 8c Ac]
haoyuan541: bets $3
Filojoes: calls $3
*** TURN *** [3h 8c Ac] [4c]
haoyuan541: checks 
Filojoes: checks 
*** RIVER *** [3h 8c Ac 4c] [2s]
haoyuan541: bets $7
Filojoes: folds 
Uncalled bet ($7) returned to haoyuan541
haoyuan541 collected $13.40 from pot
*** SUMMARY ***
Total pot $14.10 | Rake $0.70 
Board [3h 8c Ac 4c 2s]
Seat 1: di0d80 (small blind) folded before Flop
Seat 2: haoyuan541 (big blind) collected ($13.40)
Seat 3: ardo888 folded before Flop (didn't bet)
Seat 4: wangzhuoming folded before Flop (didn't bet)
Seat 6: matiko09 folded before Flop (didn't bet)
Seat 7: Filojoes folded on the River
Seat 8: Jimy Tiltman folded before Flop (didn't bet)
Seat 9: butcheN18 (button) folded before Flop (didn't bet)





PokerStars Hand #151942737429:  Hold'em No Limit ($0.50/$1.00 USD) - 2016/04/15 13:32:34 CET [2016/04/15 7:32:34 ET]
Table 'Thabit' 9-max Seat #1 is the button
Seat 1: Yaaaazz ($103.18 in chips) 
Seat 2: butcheN18 ($142.26 in chips) 
Seat 3: choupai ($24.67 in chips) 
Seat 5: spunkbubble9 ($22.56 in chips) 
Seat 7: maxxmeister ($114.76 in chips) 
Seat 8: Filojoes ($135.10 in chips) 
Seat 9: matiko09 ($100 in chips) 
butcheN18: posts small blind $0.50
choupai: posts big blind $1
*** HOLE CARDS ***
Dealt to matiko09 [8d Th]
spunkbubble9: folds 
maxxmeister: raises $2 to $3
Filojoes: folds 
matiko09: folds 
Yaaaazz: folds 
butcheN18: folds 
choupai: folds 
Uncalled bet ($2) returned to maxxmeister
maxxmeister collected $2.50 from pot
maxxmeister: doesn't show hand 
*** SUMMARY ***
Total pot $2.50 | Rake $0 
Seat 1: Yaaaazz (button) folded before Flop (didn't bet)
Seat 2: butcheN18 (small blind) folded before Flop
Seat 3: choupai (big blind) folded before Flop
Seat 5: spunkbubble9 folded before Flop (didn't bet)
Seat 7: maxxmeister collected ($2.50)
Seat 8: Filojoes folded before Flop (didn't bet)
Seat 9: matiko09 folded before Flop (didn't bet)





PokerStars Hand #151942738062:  Hold'em No Limit ($0.50/$1.00 USD) - 2016/04/15 13:32:35 CET [2016/04/15 7:32:35 ET]
Table 'Adelgunde III' 9-max Seat #3 is the button
Seat 1: valimiu ($46.77 in chips) 
Seat 2: djammusic ($45.38 in chips) 
Seat 3: tipner ($100 in chips) 
Seat 4: hammerwife ($114.95 in chips) 
Seat 5: matiko09 ($105.98 in chips) 
Seat 6: Pominator92 ($125.66 in chips) 
Seat 7: Foton18 ($9.91 in chips) 
Seat 8: aseban11 ($100 in chips) 
Seat 9: Kukuryzka ($100 in chips) 
hammerwife: posts small blind $0.50
matiko09: posts big blind $1
*** HOLE CARDS ***
Dealt to matiko09 [Tc Qc]
Pominator92: calls $1
Foton18: folds 
aseban11: folds 
Kukuryzka: folds 
valimiu: calls $1
Foton18 leaves the table
djammusic: raises $3.50 to $4.50
tipner: calls $4.50
Yaaaazz joins the table at seat #7 
hammerwife: folds 
matiko09: calls $3.50
Pominator92: calls $3.50
valimiu: folds 
*** FLOP *** [4c 9c 8h]
matiko09: checks 
Pominator92: checks 
djammusic: bets $14
tipner: folds 
matiko09: raises $31 to $45
Pominator92: folds 
djammusic: calls $26.88 and is all-in
Uncalled bet ($4.12) returned to matiko09
*** TURN *** [4c 9c 8h] [Kh]
*** RIVER *** [4c 9c 8h Kh] [6c]
*** SHOW DOWN ***
matiko09: shows [Tc Qc] (a flush, Queen high)
djammusic: mucks hand 
matiko09 collected $98.76 from pot
*** SUMMARY ***
Total pot $101.26 | Rake $2.50 
Board [4c 9c 8h Kh 6c]
Seat 1: valimiu folded before Flop
Seat 2: djammusic mucked [Ah Ad]
Seat 3: tipner (button) folded on the Flop
Seat 4: hammerwife (small blind) folded before Flop
Seat 5: matiko09 (big blind) showed [Tc Qc] and won ($98.76) with a flush, Queen high
Seat 6: Pominator92 folded on the Flop
Seat 7: Foton18 folded before Flop (didn't bet)
Seat 8: aseban11 folded before Flop (didn't bet)
Seat 9: Kukuryzka folded before Flop (didn't bet)





PokerStars Hand #151942742101:  Hold'em No Limit ($1/$2 USD) - 2016/04/15 13:32:43 CET [2016/04/15 7:32:43 ET]
Table 'Irmgard II' 9-max Seat #7 is the button
Seat 1: T0ny Adams ($76 in chips) 
Seat 3: matiko09 ($200 in chips) 
Seat 4: di0d80 ($200 in chips) 
Seat 5: vezunchik79 ($234.45 in chips) 
Seat 6: djammusic ($74 in chips) 
Seat 7: erfk1958 ($119 in chips) 
Seat 8: MoeAA11 ($109.40 in chips) 
Seat 9: maximax04 ($163.45 in chips) 
MoeAA11: posts small blind $1
maximax04: posts big blind $2
Kukuryzka: sits out 
*** HOLE CARDS ***
Dealt to matiko09 [6h 4d]
T0ny Adams: folds 
matiko09: folds 
di0d80: folds 
vezunchik79 has timed out
vezunchik79: folds 
djammusic: raises $3 to $5
erfk1958: calls $5
MoeAA11: calls $4
maximax04: raises $158.45 to $163.45 and is all-in
djammusic: calls $69 and is all-in
erfk1958: folds 
MoeAA11: folds 
Uncalled bet ($89.45) returned to maximax04
*** FLOP *** [2h Ks Jh]
*** TURN *** [2h Ks Jh] [7s]
*** RIVER *** [2h Ks Jh 7s] [4s]
*** SHOW DOWN ***
maximax04: shows [9c 9h] (a pair of Nines)
djammusic: shows [Kc Kh] (three of a kind, Kings)
djammusic collected $155.25 from pot
*** SUMMARY ***
Total pot $158 | Rake $2.75 
Board [2h Ks Jh 7s 4s]
Seat 1: T0ny Adams folded before Flop (didn't bet)
Seat 3: matiko09 folded before Flop (didn't bet)
Seat 4: di0d80 folded before Flop (didn't bet)
Seat 5: vezunchik79 folded before Flop (didn't bet)
Seat 6: djammusic showed [Kc Kh] and won ($155.25) with three of a kind, Kings
Seat 7: erfk1958 (button) folded before Flop
Seat 8: MoeAA11 (small blind) folded before Flop
Seat 9: maximax04 (big blind) showed [9c 9h] and lost with a pair of Nines





PokerStars Hand #151942745387:  Hold'em No Limit ($1/$2 USD) - 2016/04/15 13:32:49 CET [2016/04/15 7:32:49 ET]
Table 'Patroclus II' 9-max Seat #2 is the button
Seat 1: TonnaMunz ($210.04 in chips) 
Seat 2: Moemors ($183.88 in chips) 
Seat 3: Koolniknik ($305.29 in chips) 
Seat 4: tipner ($200 in chips) 
Seat 5: butcheN18 ($256.29 in chips) 
Seat 6: di0d80 ($200 in chips) 
Seat 7: matiko09 ($243.76 in chips) 
Seat 8: Glushchenko ($200 in chips) 
Seat 9: Fish4trips ($228.72 in chips) 
Koolniknik: posts small blind $1
tipner: posts big blind $2
*** HOLE CARDS ***
Dealt to matiko09 [9s 6h]
butcheN18: folds 
di0d80: folds 
matiko09: folds 
Glushchenko: folds 
Fish4trips: folds 
TonnaMunz: raises $2.96 to $4.96
Moemors: folds 
Koolniknik: folds 
tipner: folds 
Uncalled bet ($2.96) returned to TonnaMunz
TonnaMunz collected $5 from pot
TonnaMunz: doesn't show hand 
*** SUMMARY ***
Total pot $5 | Rake $0 
Seat 1: TonnaMunz collected ($5)
Seat 2: Moemors (button) folded before Flop (didn't bet)
Seat 3: Koolniknik (small blind) folded before Flop
Seat 4: tipner (big blind) folded before Flop
Seat 5: butcheN18 folded before Flop (didn't bet)
Seat 6: di0d80 folded before Flop (didn't bet)
Seat 7: matiko09 folded before Flop (didn't bet)
Seat 8: Glushchenko folded before Flop (didn't bet)
Seat 9: Fish4trips folded before Flop (didn't bet)





PokerStars Hand #151942746737:  Hold'em No Limit ($0.50/$1.00 USD) - 2016/04/15 13:32:52 CET [2016/04/15 7:32:52 ET]
Table 'Katja II' 9-max Seat #9 is the button
Seat 1: Filojoes ($104.50 in chips) 
Seat 3: matiko09 ($137.12 in chips) 
Seat 4: Sutt_420 ($68.20 in chips) 
Seat 6: ASG2016 ($113.02 in chips) 
Seat 7: Effort92 ($104.50 in chips) 
Seat 8: Glushchenko ($149.99 in chips) 
Seat 9: hardeep13 ($72.48 in chips) 
Filojoes: posts small blind $0.50
matiko09: posts big blind $1
djammusic: sits out 
*** HOLE CARDS ***
Dealt to matiko09 [5c Js]
Sutt_420: folds 
ASG2016: folds 
Effort92: folds 
Glushchenko: folds 
hardeep13: folds 
Filojoes: raises $1.50 to $2.50
matiko09: folds 
Uncalled bet ($1.50) returned to Filojoes
hammerwife leaves the table
Filojoes collected $2 from pot
Filojoes: doesn't show hand 
*** SUMMARY ***
Total pot $2 | Rake $0 
Seat 1: Filojoes (small blind) collected ($2)
Seat 3: matiko09 (big blind) folded before Flop
Seat 4: Sutt_420 folded before Flop (didn't bet)
Seat 6: ASG2016 folded before Flop (didn't bet)
Seat 7: Effort92 folded before Flop (didn't bet)
Seat 8: Glushchenko folded before Flop (didn't bet)
Seat 9: hardeep13 (button) folded before Flop (didn't bet)





PokerStars Hand #151942747026:  Hold'em No Limit ($0.50/$1.00 USD) - 2016/04/15 13:32:52 CET [2016/04/15 7:32:52 ET]
Table 'Navi' 9-max Seat #6 is the button
Seat 1: tipner ($104.45 in chips) 
Seat 2: butcheN18 ($100 in chips) 
Seat 3: aseban11 ($105.78 in chips) 
Seat 4: Effort92 ($152.88 in chips) 
Seat 5: hammerwife ($100 in chips) 
Seat 6: Glushchenko ($109.66 in chips) 
Seat 7: yoshidao ($119.20 in chips) 
Seat 8: djammusic ($37.19 in chips) 
Seat 9: matiko09 ($130.95 in chips) 
yoshidao: posts small blind $0.50
djammusic: posts big blind $1
*** HOLE CARDS ***
Dealt to matiko09 [9c 4s]
matiko09: folds 
tipner: folds 
butcheN18: folds 
aseban11: folds 
Effort92: folds 
hammerwife: folds 
Glushchenko: raises $1 to $2
yoshidao: calls $1.50
djammusic: folds 
*** FLOP *** [Ts 8s 3c]
yoshidao: checks 
Glushchenko: checks 
*** TURN *** [Ts 8s 3c] [9d]
yoshidao: checks 
Glushchenko: checks 
*** RIVER *** [Ts 8s 3c 9d] [7c]
yoshidao: checks 
Glushchenko: checks 
*** SHOW DOWN ***
yoshidao: shows [8c Ac] (a pair of Eights)
Glushchenko: mucks hand 
yoshidao collected $4.75 from pot
*** SUMMARY ***
Total pot $5 | Rake $0.25 
Board [Ts 8s 3c 9d 7c]
Seat 1: tipner folded before Flop (didn't bet)
Seat 2: butcheN18 folded before Flop (didn't bet)
Seat 3: aseban11 folded before Flop (didn't bet)
Seat 4: Effort92 folded before Flop (didn't bet)
Seat 5: hammerwife folded before Flop (didn't bet)
Seat 6: Glushchenko (button) mucked [Qh Kh]
Seat 7: yoshidao (small blind) showed [8c Ac] and won ($4.75) with a pair of Eights
Seat 8: djammusic (big blind) folded before Flop
Seat 9: matiko09 folded before Flop (didn't bet)





PokerStars Hand #151942752518:  Hold'em No Limit ($0.50/$1.00 USD) - 2016/04/15 13:33:03 CET [2016/04/15 7:33:03 ET]
Table 'Parvulesco II' 9-max Seat #8 is the button
Seat 1: bilukm ($45.19 in chips) 
Seat 3: matiko09 ($100 in chips) 
Seat 4: butcheN18 ($100 in chips) 
Seat 5: bronbeek ($97.01 in chips) 
Seat 6: Glushchenko ($131.72 in chips) 
Seat 8: Jimy Tiltman ($100 in chips) 
Seat 9: hammerwife ($215 in chips) 
hammerwife: posts small blind $0.50
bilukm: posts big blind $1
Filojoes: sits out 
Kukuryzka: sits out 
*** HOLE CARDS ***
Dealt to matiko09 [Td 3s]
matiko09: folds 
butcheN18: raises $2 to $3
bronbeek: calls $3
Glushchenko: folds 
Jimy Tiltman: folds 
hammerwife: folds 
bilukm: folds 
*** FLOP *** [9s 7h 6c]
butcheN18: bets $4.55
bronbeek: folds 
Uncalled bet ($4.55) returned to butcheN18
butcheN18 collected $7.12 from pot
butcheN18: doesn't show hand 
*** SUMMARY ***
Total pot $7.50 | Rake $0.38 
Board [9s 7h 6c]
Seat 1: bilukm (big blind) folded before Flop
Seat 3: matiko09 folded before Flop (didn't bet)
Seat 4: butcheN18 collected ($7.12)
Seat 5: bronbeek folded on the Flop
Seat 6: Glushchenko folded before Flop (didn't bet)
Seat 8: Jimy Tiltman (button) folded before Flop (didn't bet)
Seat 9: hammerwife (small blind) folded before Flop





PokerStars Hand #151942758267:  Hold'em No Limit ($1/$2 USD) - 2016/04/15 13:33:14 CET [2016/04/15 7:33:14 ET]
Table 'Patroclus II' 9-max Seat #3 is the button
Seat 1: TonnaMunz ($213.04 in chips) 
Seat 2: Moemors ($183.88 in chips) 
Seat 3: Koolniknik ($304.29 in chips) 
Seat 4: tipner ($200 in chips) 
Seat 5: butcheN18 ($256.29 in chips) 
Seat 6: di0d80 ($200 in chips) 
Seat 7: matiko09 ($243.76 in chips) 
Seat 8: Glushchenko ($200 in chips) 
Seat 9: Fish4trips ($228.72 in chips) 
tipner: posts small blind $1
butcheN18: posts big blind $2
*** HOLE CARDS ***
Dealt to matiko09 [Qd Kh]
di0d80: folds 
matiko09: folds 
Glushchenko: folds 
Fish4trips: raises $3 to $5
TonnaMunz: folds 
Moemors: folds 
Koolniknik: calls $5
tipner: folds 
butcheN18: calls $3
*** FLOP *** [8h 6s 5d]
butcheN18: checks 
Fish4trips: bets $9.58
Koolniknik: folds 
butcheN18: folds 
Uncalled bet ($9.58) returned to Fish4trips
Fish4trips collected $15.20 from pot
Fish4trips: doesn't show hand 
*** SUMMARY ***
Total pot $16 | Rake $0.80 
Board [8h 6s 5d]
Seat 1: TonnaMunz folded before Flop (didn't bet)
Seat 2: Moemors folded before Flop (didn't bet)
Seat 3: Koolniknik (button) folded on the Flop
Seat 4: tipner (small blind) folded before Flop
Seat 5: butcheN18 (big blind) folded on the Flop
Seat 6: di0d80 folded before Flop (didn't bet)
Seat 7: matiko09 folded before Flop (didn't bet)
Seat 8: Glushchenko folded before Flop (didn't bet)
Seat 9: Fish4trips collected ($15.20)





PokerStars Hand #151942759182:  Hold'em No Limit ($0.50/$1.00 USD) - 2016/04/15 13:33:16 CET [2016/04/15 7:33:16 ET]
Table 'Thabit' 9-max Seat #2 is the button
Seat 1: Yaaaazz ($103.18 in chips) 
Seat 2: butcheN18 ($141.76 in chips) 
Seat 3: choupai ($23.67 in chips) 
Seat 5: spunkbubble9 ($22.56 in chips) 
Seat 7: maxxmeister ($116.26 in chips) 
Seat 8: Filojoes ($135.10 in chips) 
Seat 9: matiko09 ($100 in chips) 
choupai: posts small blind $0.50
NOLEN09 was removed from the table for failing to post
spunkbubble9: posts big blind $1
*** HOLE CARDS ***
Dealt to matiko09 [Kh 3h]
maxxmeister: folds 
Filojoes: folds 
matiko09: folds 
Yaaaazz: folds 
butcheN18: raises $1.44 to $2.44
choupai: folds 
spunkbubble9: calls $1.44
*** FLOP *** [5c 5d Ts]
spunkbubble9: checks 
butcheN18: checks 
*** TURN *** [5c 5d Ts] [8s]
spunkbubble9: checks 
butcheN18: checks 
*** RIVER *** [5c 5d Ts 8s] [7c]
aseban11 joins the table at seat #4 
spunkbubble9: checks 
aseban11 leaves the table
butcheN18: checks 
*** SHOW DOWN ***
spunkbubble9: shows [6c Jc] (a pair of Fives)
butcheN18: shows [Ah Qc] (a pair of Fives - Ace kicker)
butcheN18 collected $5.11 from pot
*** SUMMARY ***
Total pot $5.38 | Rake $0.27 
Board [5c 5d Ts 8s 7c]
Seat 1: Yaaaazz folded before Flop (didn't bet)
Seat 2: butcheN18 (button) showed [Ah Qc] and won ($5.11) with a pair of Fives
Seat 3: choupai (small blind) folded before Flop
Seat 5: spunkbubble9 (big blind) showed [6c Jc] and lost with a pair of Fives
Seat 7: maxxmeister folded before Flop (didn't bet)
Seat 8: Filojoes folded before Flop (didn't bet)
Seat 9: matiko09 folded before Flop (didn't bet)





PokerStars Hand #151942765824:  Hold'em No Limit ($0.50/$1.00 USD) - 2016/04/15 13:33:29 CET [2016/04/15 7:33:29 ET]
Table 'Katja II' 9-max Seat #1 is the button
Seat 1: Filojoes ($105.50 in chips) 
Seat 3: matiko09 ($136.12 in chips) 
Seat 4: Sutt_420 ($68.20 in chips) 
Seat 6: ASG2016 ($113.02 in chips) 
Seat 7: Effort92 ($104.50 in chips) 
Seat 8: Glushchenko ($149.99 in chips) 
Seat 9: hardeep13 ($72.48 in chips) 
matiko09: posts small blind $0.50
Sutt_420: posts big blind $1
djammusic: sits out 
*** HOLE CARDS ***
Dealt to matiko09 [Ad 2c]
ASG2016: folds 
Effort92: folds 
Glushchenko: raises $1 to $2
hardeep13: folds 
Filojoes: folds 
aseban11 joins the table at seat #2 
matiko09: folds 
Sutt_420: folds 
Uncalled bet ($1) returned to Glushchenko
Glushchenko collected $2.50 from pot
*** SUMMARY ***
Total pot $2.50 | Rake $0 
Seat 1: Filojoes (button) folded before Flop (didn't bet)
Seat 3: matiko09 (small blind) folded before Flop
Seat 4: Sutt_420 (big blind) folded before Flop
Seat 6: ASG2016 folded before Flop (didn't bet)
Seat 7: Effort92 folded before Flop (didn't bet)
Seat 8: Glushchenko collected ($2.50)
Seat 9: hardeep13 folded before Flop (didn't bet)





PokerStars Hand #151942768389:  Hold'em No Limit ($0.50/$1.00 USD) - 2016/04/15 13:33:34 CET [2016/04/15 7:33:34 ET]
Table 'Parvulesco II' 9-max Seat #9 is the button
Seat 1: bilukm ($44.19 in chips) 
Seat 2: Filojoes ($100 in chips) 
Seat 3: matiko09 ($100 in chips) 
Seat 4: butcheN18 ($104.12 in chips) 
Seat 5: bronbeek ($94.01 in chips) 
Seat 6: Glushchenko ($131.72 in chips) 
Seat 8: Jimy Tiltman ($100 in chips) 
Seat 9: hammerwife ($214.50 in chips) 
bilukm: posts small blind $0.50
Filojoes: posts big blind $1
Kukuryzka: sits out 
*** HOLE CARDS ***
Dealt to matiko09 [2d Kh]
matiko09: folds 
butcheN18: folds 
bronbeek: folds 
Glushchenko: raises $2 to $3
Jimy Tiltman: calls $3
hammerwife: folds 
bilukm: calls $2.50
Filojoes: folds 
*** FLOP *** [8s 5s 7c]
bilukm: checks 
Glushchenko: checks 
Jimy Tiltman: bets $7
bilukm: calls $7
Glushchenko: folds 
*** TURN *** [8s 5s 7c] [Tc]
bilukm: bets $1
Jimy Tiltman: raises $15 to $16
bilukm: folds 
Uncalled bet ($15) returned to Jimy Tiltman
Jimy Tiltman collected $24.70 from pot
Jimy Tiltman: doesn't show hand 
*** SUMMARY ***
Total pot $26 | Rake $1.30 
Board [8s 5s 7c Tc]
Seat 1: bilukm (small blind) folded on the Turn
Seat 2: Filojoes (big blind) folded before Flop
Seat 3: matiko09 folded before Flop (didn't bet)
Seat 4: butcheN18 folded before Flop (didn't bet)
Seat 5: bronbeek folded before Flop (didn't bet)
Seat 6: Glushchenko folded on the Flop
Seat 8: Jimy Tiltman collected ($24.70)
Seat 9: hammerwife (button) folded before Flop (didn't bet)





PokerStars Hand #151942772624:  Hold'em No Limit ($0.50/$1.00 USD) - 2016/04/15 13:33:43 CET [2016/04/15 7:33:43 ET]
Table 'Navi' 9-max Seat #7 is the button
Seat 1: tipner ($104.45 in chips) 
Seat 2: butcheN18 ($100 in chips) 
Seat 3: aseban11 ($105.78 in chips) 
Seat 4: Effort92 ($152.88 in chips) 
Seat 5: hammerwife ($100 in chips) 
Seat 6: Glushchenko ($107.66 in chips) 
Seat 7: yoshidao ($121.95 in chips) 
Seat 8: djammusic ($36.19 in chips) 
Seat 9: matiko09 ($130.95 in chips) 
djammusic: posts small blind $0.50
matiko09: posts big blind $1
*** HOLE CARDS ***
Dealt to matiko09 [3s 2h]
tipner: folds 
butcheN18: folds 
aseban11: folds 
Effort92: folds 
hammerwife: folds 
Glushchenko: folds 
yoshidao: folds 
djammusic: folds 
Uncalled bet ($0.50) returned to matiko09
matiko09 collected $1 from pot
matiko09: doesn't show hand 
*** SUMMARY ***
Total pot $1 | Rake $0 
Seat 1: tipner folded before Flop (didn't bet)
Seat 2: butcheN18 folded before Flop (didn't bet)
Seat 3: aseban11 folded before Flop (didn't bet)
Seat 4: Effort92 folded before Flop (didn't bet)
Seat 5: hammerwife folded before Flop (didn't bet)
Seat 6: Glushchenko folded before Flop (didn't bet)
Seat 7: yoshidao (button) folded before Flop (didn't bet)
Seat 8: djammusic (small blind) folded before Flop
Seat 9: matiko09 (big blind) collected ($1)





PokerStars Hand #151942774658:  Hold'em No Limit ($1/$2 USD) - 2016/04/15 13:33:47 CET [2016/04/15 7:33:47 ET]
Table 'Irmgard II' 9-max Seat #8 is the button
Seat 2: Kukuryzka ($200 in chips) 
Seat 3: matiko09 ($200 in chips) 
Seat 4: di0d80 ($200 in chips) 
Seat 6: djammusic ($155.25 in chips) 
Seat 7: erfk1958 ($114 in chips) 
Seat 8: MoeAA11 ($104.40 in chips) 
Seat 9: maximax04 ($89.45 in chips) 
maximax04: posts small blind $1
Kukuryzka: posts big blind $2
*** HOLE CARDS ***
Dealt to matiko09 [Jh 4c]
matiko09: folds 
di0d80: folds 
djammusic: raises $3 to $5
erfk1958: folds 
MoeAA11: calls $5
maximax04: calls $4
Kukuryzka: folds 
*** FLOP *** [9d 5c Ts]
maximax04: checks 
djammusic: checks 
MoeAA11: checks 
*** TURN *** [9d 5c Ts] [Ks]
maximax04: checks 
djammusic: checks 
MoeAA11: checks 
*** RIVER *** [9d 5c Ts Ks] [Kh]
maximax04: folds 
T0ny Adams leaves the table
djammusic: checks 
MoeAA11: checks 
*** SHOW DOWN ***
djammusic: shows [Ac 6c] (a pair of Kings)
MoeAA11: shows [3s 3h] (two pair, Kings and Threes)
Iggso joins the table at seat #1 
MoeAA11 collected $16.15 from pot
*** SUMMARY ***
Total pot $17 | Rake $0.85 
Board [9d 5c Ts Ks Kh]
Seat 2: Kukuryzka (big blind) folded before Flop
Seat 3: matiko09 folded before Flop (didn't bet)
Seat 4: di0d80 folded before Flop (didn't bet)
Seat 6: djammusic showed [Ac 6c] and lost with a pair of Kings
Seat 7: erfk1958 folded before Flop (didn't bet)
Seat 8: MoeAA11 (button) showed [3s 3h] and won ($16.15) with two pair, Kings and Threes
Seat 9: maximax04 (small blind) folded on the River





PokerStars Hand #151942779002:  Hold'em No Limit ($0.50/$1.00 USD) - 2016/04/15 13:33:55 CET [2016/04/15 7:33:55 ET]
Table 'Matterania III' 9-max Seat #1 is the button
Seat 1: di0d80 ($113.55 in chips) 
Seat 2: haoyuan541 ($100.62 in chips) 
Seat 4: wangzhuoming ($72.02 in chips) 
Seat 6: matiko09 ($103.64 in chips) 
Seat 7: Filojoes ($100 in chips) 
Seat 8: Jimy Tiltman ($112.44 in chips) 
Seat 9: butcheN18 ($121.70 in chips) 
haoyuan541: posts small blind $0.50
ardo888: is sitting out 
wangzhuoming: posts big blind $1
di0d80: posts the ante $0.20
haoyuan541: posts the ante $0.20
wangzhuoming: posts the ante $0.20
matiko09: posts the ante $0.20
Filojoes: posts the ante $0.20
Jimy Tiltman: posts the ante $0.20
butcheN18: posts the ante $0.20
*** HOLE CARDS ***
Dealt to matiko09 [Qc 4d]
ardo888 leaves the table
Yaaaazz joins the table at seat #3 
matiko09: folds 
Filojoes: folds 
Jimy Tiltman: folds 
butcheN18: folds 
di0d80: raises $1 to $2
haoyuan541: folds 
wangzhuoming: calls $1
*** FLOP *** [Td 9d Tc]
wangzhuoming: checks 
di0d80: bets $4
wangzhuoming: folds 
Uncalled bet ($4) returned to di0d80
di0d80 collected $5.60 from pot
di0d80: doesn't show hand 
*** SUMMARY ***
Total pot $5.90 | Rake $0.30 
Board [Td 9d Tc]
Seat 1: di0d80 (button) collected ($5.60)
Seat 2: haoyuan541 (small blind) folded before Flop
Seat 4: wangzhuoming (big blind) folded on the Flop
Seat 6: matiko09 folded before Flop (didn't bet)
Seat 7: Filojoes folded before Flop (didn't bet)
Seat 8: Jimy Tiltman folded before Flop (didn't bet)
Seat 9: butcheN18 folded before Flop (didn't bet)





PokerStars Hand #151942781389:  Hold'em No Limit ($1/$2 USD) - 2016/04/15 13:34:00 CET [2016/04/15 7:34:00 ET]
Table 'Adele II' 9-max Seat #1 is the button
Seat 1: RyanHuJun ($61.22 in chips) 
Seat 2: Fish4trips ($422.25 in chips) 
Seat 3: matiko09 ($319.45 in chips) 
Seat 4: Glushchenko ($200 in chips) 
Seat 6: wiseyoyo ($236.93 in chips) 
Seat 7: Iggso ($200 in chips) 
Seat 8: docmarc777 ($352.92 in chips) 
Seat 9: SanychStar ($200 in chips) 
Fish4trips: posts small blind $1
matiko09: posts big blind $2
*** HOLE CARDS ***
Dealt to matiko09 [8d 9d]
Glushchenko: folds 
wiseyoyo: folds 
Iggso: folds 
docmarc777: raises $3.92 to $5.92
SanychStar: calls $5.92
RyanHuJun: calls $5.92
Fish4trips: folds 
matiko09: calls $3.92
*** FLOP *** [2c Kh Qh]
matiko09: checks 
docmarc777: bets $14
SanychStar: calls $14
RyanHuJun: calls $14
matiko09: folds 
*** TURN *** [2c Kh Qh] [4d]
docmarc777: bets $33
SanychStar: calls $33
RyanHuJun: folds 
*** RIVER *** [2c Kh Qh 4d] [7s]
docmarc777: checks 
SanychStar: checks 
*** SHOW DOWN ***
docmarc777: shows [7h Ah] (a pair of Sevens)
SanychStar: shows [Js Ks] (a pair of Kings)
SanychStar collected $129.93 from pot
*** SUMMARY ***
Total pot $132.68 | Rake $2.75 
Board [2c Kh Qh 4d 7s]
Seat 1: RyanHuJun (button) folded on the Turn
Seat 2: Fish4trips (small blind) folded before Flop
Seat 3: matiko09 (big blind) folded on the Flop
Seat 4: Glushchenko folded before Flop (didn't bet)
Seat 6: wiseyoyo folded before Flop (didn't bet)
Seat 7: Iggso folded before Flop (didn't bet)
Seat 8: docmarc777 showed [7h Ah] and lost with a pair of Sevens
Seat 9: SanychStar showed [Js Ks] and won ($129.93) with a pair of Kings





PokerStars Hand #151942784352:  Hold'em No Limit ($0.50/$1.00 USD) - 2016/04/15 13:34:06 CET [2016/04/15 7:34:06 ET]
Table 'Adelgunde III' 9-max Seat #4 is the button
Seat 1: valimiu ($45.77 in chips) 
Seat 2: djammusic ($40 in chips) 
Seat 3: tipner ($100 in chips) 
Seat 4: hammerwife ($114.45 in chips) 
Seat 5: matiko09 ($159.36 in chips) 
Seat 6: Pominator92 ($121.16 in chips) 
Seat 8: aseban11 ($100 in chips) 
Seat 9: Kukuryzka ($100 in chips) 
matiko09: posts small blind $0.50
Pominator92: posts big blind $1
Yaaaazz: sits out 
*** HOLE CARDS ***
Dealt to matiko09 [8d Qd]
aseban11: folds 
Kukuryzka: folds 
valimiu: calls $1
djammusic: folds 
tipner: folds 
hammerwife: folds 
matiko09: calls $0.50
Pominator92: raises $4 to $5
valimiu: folds 
matiko09: folds 
Uncalled bet ($4) returned to Pominator92
Pominator92 collected $3 from pot
Pominator92: doesn't show hand 
*** SUMMARY ***
Total pot $3 | Rake $0 
Seat 1: valimiu folded before Flop
Seat 2: djammusic folded before Flop (didn't bet)
Seat 3: tipner folded before Flop (didn't bet)
Seat 4: hammerwife (button) folded before Flop (didn't bet)
Seat 5: matiko09 (small blind) folded before Flop
Seat 6: Pominator92 (big blind) collected ($3)
Seat 8: aseban11 folded before Flop (didn't bet)
Seat 9: Kukuryzka folded before Flop (didn't bet)





PokerStars Hand #151942785344:  Hold'em No Limit ($0.50/$1.00 USD) - 2016/04/15 13:34:08 CET [2016/04/15 7:34:08 ET]
Table 'Thabit' 9-max Seat #3 is the button
Seat 1: Yaaaazz ($103.18 in chips) 
Seat 2: butcheN18 ($144.43 in chips) 
Seat 3: choupai ($23.17 in chips) 
Seat 5: spunkbubble9 ($20.12 in chips) 
Seat 6: Zuckinio1909 ($52.32 in chips) 
Seat 7: maxxmeister ($116.26 in chips) 
Seat 8: Filojoes ($135.10 in chips) 
Seat 9: matiko09 ($100 in chips) 
spunkbubble9: posts small blind $0.50
Zuckinio1909: posts big blind $1
*** HOLE CARDS ***
Dealt to matiko09 [As 4d]
maxxmeister: folds 
Filojoes: folds 
matiko09: folds 
Yaaaazz: folds 
butcheN18: folds 
choupai: folds 
spunkbubble9: folds 
Uncalled bet ($0.50) returned to Zuckinio1909
Zuckinio1909 collected $1 from pot
*** SUMMARY ***
Total pot $1 | Rake $0 
Seat 1: Yaaaazz folded before Flop (didn't bet)
Seat 2: butcheN18 folded before Flop (didn't bet)
Seat 3: choupai (button) folded before Flop (didn't bet)
Seat 5: spunkbubble9 (small blind) folded before Flop
Seat 6: Zuckinio1909 (big blind) collected ($1)
Seat 7: maxxmeister folded before Flop (didn't bet)
Seat 8: Filojoes folded before Flop (didn't bet)
Seat 9: matiko09 folded before Flop (didn't bet)





PokerStars Hand #151942786895:  Hold'em No Limit ($0.50/$1.00 USD) - 2016/04/15 13:34:11 CET [2016/04/15 7:34:11 ET]
Table 'Katja II' 9-max Seat #3 is the button
Seat 1: Filojoes ($105.50 in chips) 
Seat 3: matiko09 ($135.62 in chips) 
Seat 4: Sutt_420 ($67.20 in chips) 
Seat 5: djammusic ($40 in chips) 
Seat 6: ASG2016 ($113.02 in chips) 
Seat 7: Effort92 ($104.50 in chips) 
Seat 8: Glushchenko ($151.49 in chips) 
Seat 9: hardeep13 ($72.48 in chips) 
Sutt_420: posts small blind $0.50
djammusic: posts big blind $1
*** HOLE CARDS ***
Dealt to matiko09 [5d Ks]
ASG2016: folds 
Effort92: folds 
Glushchenko: folds 
hardeep13: calls $1
Filojoes: folds 
matiko09: folds 
Sutt_420: folds 
djammusic: checks 
*** FLOP *** [5s 7s 7c]
djammusic: bets $1.55
hardeep13: calls $1.55
*** TURN *** [5s 7s 7c] [Ah]
djammusic: checks 
hardeep13: bets $3
djammusic: folds 
Uncalled bet ($3) returned to hardeep13
hardeep13 collected $5.32 from pot
hardeep13: doesn't show hand 
*** SUMMARY ***
Total pot $5.60 | Rake $0.28 
Board [5s 7s 7c Ah]
Seat 1: Filojoes folded before Flop (didn't bet)
Seat 3: matiko09 (button) folded before Flop (didn't bet)
Seat 4: Sutt_420 (small blind) folded before Flop
Seat 5: djammusic (big blind) folded on the Turn
Seat 6: ASG2016 folded before Flop (didn't bet)
Seat 7: Effort92 folded before Flop (didn't bet)
Seat 8: Glushchenko folded before Flop (didn't bet)
Seat 9: hardeep13 collected ($5.32)





PokerStars Hand #151942787539:  Hold'em No Limit ($1/$2 USD) - 2016/04/15 13:34:12 CET [2016/04/15 7:34:12 ET]
Table 'Patroclus II' 9-max Seat #4 is the button
Seat 1: TonnaMunz ($213.04 in chips) 
Seat 2: Moemors ($183.88 in chips) 
Seat 3: Koolniknik ($299.29 in chips) 
Seat 4: tipner ($200 in chips) 
Seat 5: butcheN18 ($251.29 in chips) 
Seat 7: matiko09 ($243.76 in chips) 
Seat 8: Glushchenko ($200 in chips) 
Seat 9: Fish4trips ($238.92 in chips) 
butcheN18: posts small blind $1
di0d80: is sitting out 
matiko09: posts big blind $2
*** HOLE CARDS ***
Dealt to matiko09 [5h 3h]
Glushchenko: folds 
Fish4trips: folds 
TonnaMunz: raises $2.96 to $4.96
Moemors: folds 
Koolniknik: folds 
tipner: folds 
butcheN18: folds 
matiko09: folds 
Uncalled bet ($2.96) returned to TonnaMunz
TonnaMunz collected $5 from pot
TonnaMunz: doesn't show hand 
*** SUMMARY ***
Total pot $5 | Rake $0 
Seat 1: TonnaMunz collected ($5)
Seat 2: Moemors folded before Flop (didn't bet)
Seat 3: Koolniknik folded before Flop (didn't bet)
Seat 4: tipner (button) folded before Flop (didn't bet)
Seat 5: butcheN18 (small blind) folded before Flop
Seat 7: matiko09 (big blind) folded before Flop
Seat 8: Glushchenko folded before Flop (didn't bet)
Seat 9: Fish4trips folded before Flop (didn't bet)





PokerStars Hand #151942787623:  Hold'em No Limit ($0.50/$1.00 USD) - 2016/04/15 13:34:12 CET [2016/04/15 7:34:12 ET]
Table 'Navi' 9-max Seat #8 is the button
Seat 1: tipner ($104.45 in chips) 
Seat 2: butcheN18 ($100 in chips) 
Seat 3: aseban11 ($105.78 in chips) 
Seat 4: Effort92 ($152.88 in chips) 
Seat 5: hammerwife ($100 in chips) 
Seat 6: Glushchenko ($107.66 in chips) 
Seat 7: yoshidao ($121.95 in chips) 
Seat 8: djammusic ($35.69 in chips) 
Seat 9: matiko09 ($131.45 in chips) 
matiko09: posts small blind $0.50
tipner: posts big blind $1
*** HOLE CARDS ***
Dealt to matiko09 [8h Qd]
butcheN18: folds 
aseban11: raises $2 to $3
Effort92: folds 
hammerwife: folds 
Glushchenko: folds 
yoshidao: folds 
djammusic: folds 
matiko09: folds 
tipner: folds 
Uncalled bet ($2) returned to aseban11
aseban11 collected $2.50 from pot
aseban11: doesn't show hand 
*** SUMMARY ***
Total pot $2.50 | Rake $0 
Seat 1: tipner (big blind) folded before Flop
Seat 2: butcheN18 folded before Flop (didn't bet)
Seat 3: aseban11 collected ($2.50)
Seat 4: Effort92 folded before Flop (didn't bet)
Seat 5: hammerwife folded before Flop (didn't bet)
Seat 6: Glushchenko folded before Flop (didn't bet)
Seat 7: yoshidao folded before Flop (didn't bet)
Seat 8: djammusic (button) folded before Flop (didn't bet)
Seat 9: matiko09 (small blind) folded before Flop





PokerStars Hand #151942795047:  Hold'em No Limit ($1/$2 USD) - 2016/04/15 13:34:27 CET [2016/04/15 7:34:27 ET]
Table 'Oceax' 9-max Seat #8 is the button
Seat 1: matiko09 ($200 in chips) 
Seat 2: Fish4trips ($305.36 in chips) 
Seat 3: Yaaaazz ($200 in chips) 
Seat 4: butcheN18 ($239.42 in chips) 
Seat 5: di0d80 ($200 in chips) 
Seat 6: Iggso ($208.25 in chips) 
Seat 8: Poroxide ($246.60 in chips) 
Seat 9: Olddogtom888 ($283.88 in chips) 
Olddogtom888: posts small blind $1
matiko09: posts big blind $2
coinflip_si: sits out 
*** HOLE CARDS ***
Dealt to matiko09 [7s 4d]
Fish4trips: folds 
Yaaaazz: folds 
butcheN18: folds 
di0d80: raises $3 to $5
Iggso: folds 
Poroxide: folds 
Olddogtom888: folds 
matiko09: folds 
Uncalled bet ($3) returned to di0d80
di0d80 collected $5 from pot
di0d80: doesn't show hand 
*** SUMMARY ***
Total pot $5 | Rake $0 
Seat 1: matiko09 (big blind) folded before Flop
Seat 2: Fish4trips folded before Flop (didn't bet)
Seat 3: Yaaaazz folded before Flop (didn't bet)
Seat 4: butcheN18 folded before Flop (didn't bet)
Seat 5: di0d80 collected ($5)
Seat 6: Iggso folded before Flop (didn't bet)
Seat 8: Poroxide (button) folded before Flop (didn't bet)
Seat 9: Olddogtom888 (small blind) folded before Flop





PokerStars Hand #151942796173:  Hold'em No Limit ($0.50/$1.00 USD) - 2016/04/15 13:34:29 CET [2016/04/15 7:34:29 ET]
Table 'Thabit' 9-max Seat #5 is the button
Seat 1: Yaaaazz ($103.18 in chips) 
Seat 2: butcheN18 ($144.43 in chips) 
Seat 3: choupai ($23.17 in chips) 
Seat 5: spunkbubble9 ($19.62 in chips) 
Seat 6: Zuckinio1909 ($52.82 in chips) 
Seat 8: Filojoes ($135.10 in chips) 
Seat 9: matiko09 ($100 in chips) 
Zuckinio1909: posts small blind $0.50
Filojoes: posts big blind $1
*** HOLE CARDS ***
Dealt to matiko09 [8d 7d]
matiko09: raises $2 to $3
Yaaaazz: folds 
butcheN18: raises $6 to $9
choupai: folds 
spunkbubble9: folds 
Zuckinio1909: raises $43.82 to $52.82 and is all-in
Filojoes: folds 
matiko09: folds 
butcheN18: calls $43.82
*** FLOP *** [5c 2c Qc]
*** TURN *** [5c 2c Qc] [7h]
*** RIVER *** [5c 2c Qc 7h] [Qh]
*** SHOW DOWN ***
Zuckinio1909: shows [Js Jd] (two pair, Queens and Jacks)
butcheN18: shows [Kh Kd] (two pair, Kings and Queens)
butcheN18 collected $107.14 from pot
*** SUMMARY ***
Total pot $109.64 | Rake $2.50 
Board [5c 2c Qc 7h Qh]
Seat 1: Yaaaazz folded before Flop (didn't bet)
Seat 2: butcheN18 showed [Kh Kd] and won ($107.14) with two pair, Kings and Queens
Seat 3: choupai folded before Flop (didn't bet)
Seat 5: spunkbubble9 (button) folded before Flop (didn't bet)
Seat 6: Zuckinio1909 (small blind) showed [Js Jd] and lost with two pair, Queens and Jacks
Seat 8: Filojoes (big blind) folded before Flop
Seat 9: matiko09 folded before Flop





PokerStars Hand #151942800397:  Hold'em No Limit ($1/$2 USD) - 2016/04/15 13:34:37 CET [2016/04/15 7:34:37 ET]
Table 'Patroclus II' 9-max Seat #5 is the button
Seat 1: TonnaMunz ($216.04 in chips) 
Seat 2: Moemors ($183.88 in chips) 
Seat 3: Koolniknik ($299.29 in chips) 
Seat 4: tipner ($200 in chips) 
Seat 5: butcheN18 ($250.29 in chips) 
Seat 7: matiko09 ($241.76 in chips) 
Seat 8: Glushchenko ($200 in chips) 
Seat 9: Fish4trips ($238.92 in chips) 
matiko09: posts small blind $1
Glushchenko: posts big blind $2
*** HOLE CARDS ***
Dealt to matiko09 [Qc 8h]
Fish4trips: folds 
TonnaMunz: folds 
Moemors: raises $2 to $4
Koolniknik: folds 
tipner: folds 
butcheN18: folds 
matiko09: folds 
Glushchenko: folds 
Uncalled bet ($2) returned to Moemors
Moemors collected $5 from pot
Moemors: doesn't show hand 
*** SUMMARY ***
Total pot $5 | Rake $0 
Seat 1: TonnaMunz folded before Flop (didn't bet)
Seat 2: Moemors collected ($5)
Seat 3: Koolniknik folded before Flop (didn't bet)
Seat 4: tipner folded before Flop (didn't bet)
Seat 5: butcheN18 (button) folded before Flop (didn't bet)
Seat 7: matiko09 (small blind) folded before Flop
Seat 8: Glushchenko (big blind) folded before Flop
Seat 9: Fish4trips folded before Flop (didn't bet)





PokerStars Hand #151942801628:  Hold'em No Limit ($0.50/$1.00 USD) - 2016/04/15 13:34:40 CET [2016/04/15 7:34:40 ET]
Table 'Navi' 9-max Seat #9 is the button
Seat 1: tipner ($103.45 in chips) 
Seat 2: butcheN18 ($100 in chips) 
Seat 3: aseban11 ($107.28 in chips) 
Seat 4: Effort92 ($152.88 in chips) 
Seat 5: hammerwife ($100 in chips) 
Seat 6: Glushchenko ($107.66 in chips) 
Seat 7: yoshidao ($121.95 in chips) 
Seat 8: djammusic ($35.69 in chips) 
Seat 9: matiko09 ($130.95 in chips) 
tipner: posts small blind $0.50
butcheN18: posts big blind $1
*** HOLE CARDS ***
Dealt to matiko09 [2h Th]
aseban11: folds 
Effort92: folds 
hammerwife: folds 
Glushchenko: folds 
yoshidao: folds 
djammusic: raises $1.02 to $2.02
matiko09: folds 
tipner: raises $4.98 to $7
butcheN18: folds 
djammusic: folds 
Uncalled bet ($4.98) returned to tipner
tipner collected $5.04 from pot
tipner: doesn't show hand 
*** SUMMARY ***
Total pot $5.04 | Rake $0 
Seat 1: tipner (small blind) collected ($5.04)
Seat 2: butcheN18 (big blind) folded before Flop
Seat 3: aseban11 folded before Flop (didn't bet)
Seat 4: Effort92 folded before Flop (didn't bet)
Seat 5: hammerwife folded before Flop (didn't bet)
Seat 6: Glushchenko folded before Flop (didn't bet)
Seat 7: yoshidao folded before Flop (didn't bet)
Seat 8: djammusic folded before Flop
Seat 9: matiko09 (button) folded before Flop (didn't bet)





PokerStars Hand #151942808196:  Hold'em No Limit ($1/$2 USD) - 2016/04/15 13:34:52 CET [2016/04/15 7:34:52 ET]
Table 'Irmgard II' 9-max Seat #9 is the button
Seat 2: Kukuryzka ($198 in chips) 
Seat 3: matiko09 ($200 in chips) 
Seat 4: di0d80 ($200 in chips) 
Seat 5: vezunchik79 ($234.45 in chips) 
Seat 6: djammusic ($150.25 in chips) 
Seat 7: erfk1958 ($114 in chips) 
Seat 8: MoeAA11 ($115.55 in chips) 
Seat 9: maximax04 ($84.45 in chips) 
Iggso will be allowed to play after the button
Kukuryzka: posts small blind $1
matiko09: posts big blind $2
*** HOLE CARDS ***
Dealt to matiko09 [Td 8d]
di0d80: folds 
vezunchik79: folds 
djammusic: folds 
erfk1958: folds 
MoeAA11: calls $2
maximax04: folds 
Kukuryzka: folds 
matiko09: checks 
*** FLOP *** [4s 3h Ac]
matiko09: checks 
MoeAA11: checks 
*** TURN *** [4s 3h Ac] [Qh]
matiko09: checks 
MoeAA11: checks 
*** RIVER *** [4s 3h Ac Qh] [Ad]
matiko09: checks 
MoeAA11: checks 
*** SHOW DOWN ***
matiko09: shows [Td 8d] (a pair of Aces)
MoeAA11: shows [5h Kh] (a pair of Aces - King kicker)
MoeAA11 collected $4.75 from pot
*** SUMMARY ***
Total pot $5 | Rake $0.25 
Board [4s 3h Ac Qh Ad]
Seat 2: Kukuryzka (small blind) folded before Flop
Seat 3: matiko09 (big blind) showed [Td 8d] and lost with a pair of Aces
Seat 4: di0d80 folded before Flop (didn't bet)
Seat 5: vezunchik79 folded before Flop (didn't bet)
Seat 6: djammusic folded before Flop (didn't bet)
Seat 7: erfk1958 folded before Flop (didn't bet)
Seat 8: MoeAA11 showed [5h Kh] and won ($4.75) with a pair of Aces
Seat 9: maximax04 (button) folded before Flop (didn't bet)





PokerStars Hand #151942809156:  Hold'em No Limit ($0.50/$1.00 USD) - 2016/04/15 13:34:54 CET [2016/04/15 7:34:54 ET]
Table 'Adelgunde III' 9-max Seat #5 is the button
Seat 1: valimiu ($44.77 in chips) 
Seat 2: djammusic ($40 in chips) 
Seat 3: tipner ($100 in chips) 
Seat 4: hammerwife ($114.45 in chips) 
Seat 5: matiko09 ($158.36 in chips) 
Seat 6: Pominator92 ($123.16 in chips) 
Seat 7: Yaaaazz ($100 in chips) 
Seat 8: aseban11 ($100 in chips) 
Seat 9: Kukuryzka ($100 in chips) 
Pominator92: posts small blind $0.50
Yaaaazz: posts big blind $1
*** HOLE CARDS ***
Dealt to matiko09 [Kh 7d]
aseban11: folds 
Kukuryzka: folds 
valimiu: calls $1
djammusic: folds 
tipner: folds 
hammerwife: folds 
matiko09: folds 
Pominator92: calls $0.50
Yaaaazz: checks 
*** FLOP *** [Tc 9d 4d]
Pominator92: bets $2
Yaaaazz: folds 
valimiu: folds 
Uncalled bet ($2) returned to Pominator92
Pominator92 collected $2.85 from pot
Pominator92: doesn't show hand 
*** SUMMARY ***
Total pot $3 | Rake $0.15 
Board [Tc 9d 4d]
Seat 1: valimiu folded on the Flop
Seat 2: djammusic folded before Flop (didn't bet)
Seat 3: tipner folded before Flop (didn't bet)
Seat 4: hammerwife folded before Flop (didn't bet)
Seat 5: matiko09 (button) folded before Flop (didn't bet)
Seat 6: Pominator92 (small blind) collected ($2.85)
Seat 7: Yaaaazz (big blind) folded on the Flop
Seat 8: aseban11 folded before Flop (didn't bet)
Seat 9: Kukuryzka folded before Flop (didn't bet)





PokerStars Hand #151942810302:  Hold'em No Limit ($1/$2 USD) - 2016/04/15 13:34:57 CET [2016/04/15 7:34:57 ET]
Table 'Oceax' 9-max Seat #9 is the button
Seat 1: matiko09 ($200 in chips) 
Seat 2: Fish4trips ($305.36 in chips) 
Seat 3: Yaaaazz ($200 in chips) 
Seat 4: butcheN18 ($239.42 in chips) 
Seat 5: di0d80 ($203 in chips) 
Seat 6: Iggso ($208.25 in chips) 
Seat 8: Poroxide ($246.60 in chips) 
Seat 9: Olddogtom888 ($282.88 in chips) 
matiko09: posts small blind $1
Fish4trips: posts big blind $2
coinflip_si: sits out 
*** HOLE CARDS ***
Dealt to matiko09 [7s Qs]
Yaaaazz: folds 
butcheN18: folds 
di0d80: folds 
Iggso: folds 
Poroxide: folds 
Olddogtom888: raises $4 to $6
matiko09: folds 
Fish4trips: folds 
Uncalled bet ($4) returned to Olddogtom888
Olddogtom888 collected $5 from pot
Olddogtom888: doesn't show hand 
*** SUMMARY ***
Total pot $5 | Rake $0 
Seat 1: matiko09 (small blind) folded before Flop
Seat 2: Fish4trips (big blind) folded before Flop
Seat 3: Yaaaazz folded before Flop (didn't bet)
Seat 4: butcheN18 folded before Flop (didn't bet)
Seat 5: di0d80 folded before Flop (didn't bet)
Seat 6: Iggso folded before Flop (didn't bet)
Seat 8: Poroxide folded before Flop (didn't bet)
Seat 9: Olddogtom888 (button) collected ($5)





PokerStars Hand #151942812743:  Hold'em No Limit ($1/$2 USD) - 2016/04/15 13:35:02 CET [2016/04/15 7:35:02 ET]
Table 'Patroclus II' 9-max Seat #7 is the button
Seat 1: TonnaMunz ($216.04 in chips) 
Seat 2: Moemors ($186.88 in chips) 
Seat 3: Koolniknik ($299.29 in chips) 
Seat 4: tipner ($200 in chips) 
Seat 5: butcheN18 ($250.29 in chips) 
Seat 7: matiko09 ($240.76 in chips) 
Seat 8: Glushchenko ($200 in chips) 
Seat 9: Fish4trips ($238.92 in chips) 
Glushchenko: posts small blind $1
Fish4trips: posts big blind $2
*** HOLE CARDS ***
Dealt to matiko09 [8d Qc]
TonnaMunz: folds 
Moemors: folds 
Koolniknik: raises $4 to $6
tipner: folds 
butcheN18: folds 
matiko09: folds 
Glushchenko: folds 
Fish4trips: folds 
Uncalled bet ($4) returned to Koolniknik
Koolniknik collected $5 from pot
Koolniknik: doesn't show hand 
*** SUMMARY ***
Total pot $5 | Rake $0 
Seat 1: TonnaMunz folded before Flop (didn't bet)
Seat 2: Moemors folded before Flop (didn't bet)
Seat 3: Koolniknik collected ($5)
Seat 4: tipner folded before Flop (didn't bet)
Seat 5: butcheN18 folded before Flop (didn't bet)
Seat 7: matiko09 (button) folded before Flop (didn't bet)
Seat 8: Glushchenko (small blind) folded before Flop
Seat 9: Fish4trips (big blind) folded before Flop





PokerStars Hand #151942813465:  Hold'em No Limit ($0.50/$1.00 USD) - 2016/04/15 13:35:03 CET [2016/04/15 7:35:03 ET]
Table 'Katja II' 9-max Seat #4 is the button
Seat 1: Filojoes ($105.50 in chips) 
Seat 3: matiko09 ($135.62 in chips) 
Seat 4: Sutt_420 ($66.70 in chips) 
Seat 5: djammusic ($37.45 in chips) 
Seat 6: ASG2016 ($113.02 in chips) 
Seat 7: Effort92 ($104.50 in chips) 
Seat 8: Glushchenko ($151.49 in chips) 
Seat 9: hardeep13 ($75.25 in chips) 
djammusic: posts small blind $0.50
ASG2016: posts big blind $1
*** HOLE CARDS ***
Dealt to matiko09 [7d 4d]
Effort92: folds 
Glushchenko: raises $2 to $3
hardeep13: calls $3
Filojoes: folds 
matiko09: folds 
Sutt_420: raises $7 to $10
djammusic: folds 
ASG2016: folds 
Glushchenko: calls $7
hardeep13: calls $7
*** FLOP *** [Kd Qd 7s]
Glushchenko: checks 
hardeep13: checks 
Sutt_420: bets $26
Glushchenko: folds 
hardeep13: folds 
Uncalled bet ($26) returned to Sutt_420
Sutt_420 collected $29.92 from pot
*** SUMMARY ***
Total pot $31.50 | Rake $1.58 
Board [Kd Qd 7s]
Seat 1: Filojoes folded before Flop (didn't bet)
Seat 3: matiko09 folded before Flop (didn't bet)
Seat 4: Sutt_420 (button) collected ($29.92)
Seat 5: djammusic (small blind) folded before Flop
Seat 6: ASG2016 (big blind) folded before Flop
Seat 7: Effort92 folded before Flop (didn't bet)
Seat 8: Glushchenko folded on the Flop
Seat 9: hardeep13 folded on the Flop





PokerStars Hand #151942816890:  Hold'em No Limit ($0.50/$1.00 USD) - 2016/04/15 13:35:10 CET [2016/04/15 7:35:10 ET]
Table 'Parvulesco II' 9-max Seat #1 is the button
Seat 1: bilukm ($33.19 in chips) 
Seat 2: Filojoes ($100 in chips) 
Seat 3: matiko09 ($100 in chips) 
Seat 4: butcheN18 ($104.12 in chips) 
Seat 5: bronbeek ($94.01 in chips) 
Seat 6: Glushchenko ($128.72 in chips) 
Seat 8: Jimy Tiltman ($113.70 in chips) 
Seat 9: hammerwife ($214.50 in chips) 
Filojoes: posts small blind $0.50
matiko09: posts big blind $1
Kukuryzka: sits out 
*** HOLE CARDS ***
Dealt to matiko09 [6h Jd]
butcheN18: folds 
bronbeek: folds 
Glushchenko: raises $2 to $3
Jimy Tiltman: folds 
hammerwife: folds 
bilukm: calls $3
Filojoes: folds 
matiko09: folds 
*** FLOP *** [Kd 3h 6s]
Glushchenko: checks 
bilukm: checks 
*** TURN *** [Kd 3h 6s] [5s]
Glushchenko: bets $4.74
bilukm: folds 
Uncalled bet ($4.74) returned to Glushchenko
Glushchenko collected $7.12 from pot
*** SUMMARY ***
Total pot $7.50 | Rake $0.38 
Board [Kd 3h 6s 5s]
Seat 1: bilukm (button) folded on the Turn
Seat 2: Filojoes (small blind) folded before Flop
Seat 3: matiko09 (big blind) folded before Flop
Seat 4: butcheN18 folded before Flop (didn't bet)
Seat 5: bronbeek folded before Flop (didn't bet)
Seat 6: Glushchenko collected ($7.12)
Seat 8: Jimy Tiltman folded before Flop (didn't bet)
Seat 9: hammerwife folded before Flop (didn't bet)





PokerStars Hand #151942821172:  Hold'em No Limit ($0.50/$1.00 USD) - 2016/04/15 13:35:18 CET [2016/04/15 7:35:18 ET]
Table 'Thabit' 9-max Seat #8 is the button
Seat 1: Yaaaazz ($103.18 in chips) 
Seat 3: choupai ($23.17 in chips) 
Seat 5: spunkbubble9 ($19.62 in chips) 
Seat 8: Filojoes ($134.10 in chips) 
Seat 9: matiko09 ($100 in chips) 
matiko09: posts small blind $0.50
Yaaaazz: posts big blind $1
maxxmeister: sits out 
*** HOLE CARDS ***
Dealt to matiko09 [9h 6h]
choupai: folds 
Zuckinio1909 leaves the table
spunkbubble9: raises $2 to $3
tipner joins the table at seat #6 
Filojoes: folds 
matiko09: folds 
Yaaaazz: calls $2
*** FLOP *** [3h 4h 3c]
Yaaaazz: checks 
spunkbubble9: checks 
*** TURN *** [3h 4h 3c] [8c]
Yaaaazz: checks 
spunkbubble9: checks 
*** RIVER *** [3h 4h 3c 8c] [9c]
Yaaaazz: bets $4
spunkbubble9: folds 
Uncalled bet ($4) returned to Yaaaazz
Yaaaazz collected $6.18 from pot
*** SUMMARY ***
Total pot $6.50 | Rake $0.32 
Board [3h 4h 3c 8c 9c]
Seat 1: Yaaaazz (big blind) collected ($6.18)
Seat 3: choupai folded before Flop (didn't bet)
Seat 5: spunkbubble9 folded on the River
Seat 8: Filojoes (button) folded before Flop (didn't bet)
Seat 9: matiko09 (small blind) folded before Flop





PokerStars Hand #151942831413:  Hold'em No Limit ($1/$2 USD) - 2016/04/15 13:35:21 CET [2016/04/15 7:35:21 ET]
Table 'Patroclus II' 9-max Seat #8 is the button
Seat 1: TonnaMunz ($216.04 in chips) 
Seat 2: Moemors ($186.88 in chips) 
Seat 3: Koolniknik ($302.29 in chips) 
Seat 4: tipner ($200 in chips) 
Seat 7: matiko09 ($240.76 in chips) 
Seat 8: Glushchenko ($200 in chips) 
Seat 9: Fish4trips ($236.92 in chips) 
Fish4trips: posts small blind $1
TonnaMunz: posts big blind $2
*** HOLE CARDS ***
Dealt to matiko09 [2c Qc]
Moemors: calls $2
Koolniknik: folds 
tipner: folds 
matiko09: folds 
Glushchenko: folds 
Fish4trips: folds 
TonnaMunz: raises $6 to $8
Moemors: raises $6 to $14
TonnaMunz: calls $6
*** FLOP *** [Kh 6s Kc]
TonnaMunz: checks 
Moemors: bets $70
TonnaMunz: folds 
Uncalled bet ($70) returned to Moemors
Moemors collected $27.55 from pot
Moemors: doesn't show hand 
*** SUMMARY ***
Total pot $29 | Rake $1.45 
Board [Kh 6s Kc]
Seat 1: TonnaMunz (big blind) folded on the Flop
Seat 2: Moemors collected ($27.55)
Seat 3: Koolniknik folded before Flop (didn't bet)
Seat 4: tipner folded before Flop (didn't bet)
Seat 7: matiko09 folded before Flop (didn't bet)
Seat 8: Glushchenko (button) folded before Flop (didn't bet)
Seat 9: Fish4trips (small blind) folded before Flop





PokerStars Hand #151942832026:  Hold'em No Limit ($0.50/$1.00 USD) - 2016/04/15 13:35:22 CET [2016/04/15 7:35:22 ET]
Table 'Matterania III' 9-max Seat #2 is the button
Seat 1: di0d80 ($116.95 in chips) 
Seat 2: haoyuan541 ($99.92 in chips) 
Seat 4: wangzhuoming ($69.82 in chips) 
Seat 6: matiko09 ($103.44 in chips) 
Seat 7: Filojoes ($100 in chips) 
Seat 8: Jimy Tiltman ($112.24 in chips) 
Yaaaazz will be allowed to play after the button
wangzhuoming: posts small blind $0.50
matiko09: posts big blind $1
di0d80: posts the ante $0.20
haoyuan541: posts the ante $0.20
wangzhuoming: posts the ante $0.20
matiko09: posts the ante $0.20
Filojoes: posts the ante $0.20
Jimy Tiltman: posts the ante $0.20
*** HOLE CARDS ***
Dealt to matiko09 [5h 4s]
Filojoes: folds 
Jimy Tiltman: folds 
di0d80: raises $1.50 to $2.50
haoyuan541: folds 
wangzhuoming: folds 
matiko09: folds 
Uncalled bet ($1.50) returned to di0d80
di0d80 collected $3.70 from pot
di0d80: doesn't show hand 
*** SUMMARY ***
Total pot $3.70 | Rake $0 
Seat 1: di0d80 collected ($3.70)
Seat 2: haoyuan541 (button) folded before Flop (didn't bet)
Seat 4: wangzhuoming (small blind) folded before Flop
Seat 6: matiko09 (big blind) folded before Flop
Seat 7: Filojoes folded before Flop (didn't bet)
Seat 8: Jimy Tiltman folded before Flop (didn't bet)





PokerStars Hand #151942832962:  Hold'em No Limit ($1/$2 USD) - 2016/04/15 13:35:24 CET [2016/04/15 7:35:24 ET]
Table 'Oceax' 9-max Seat #1 is the button
Seat 1: matiko09 ($200 in chips) 
Seat 2: Fish4trips ($303.36 in chips) 
Seat 3: Yaaaazz ($200 in chips) 
Seat 5: di0d80 ($203 in chips) 
Seat 6: Iggso ($208.25 in chips) 
Seat 8: Poroxide ($246.60 in chips) 
Seat 9: Olddogtom888 ($285.88 in chips) 
Fish4trips: posts small blind $1
Yaaaazz: posts big blind $2
coinflip_si: sits out 
*** HOLE CARDS ***
Dealt to matiko09 [6c 5s]
di0d80: raises $3 to $5
Iggso: folds 
Poroxide: raises $11 to $16
Olddogtom888: folds 
matiko09: folds 
Fish4trips: folds 
Yaaaazz: folds 
di0d80: folds 
Uncalled bet ($11) returned to Poroxide
Poroxide collected $13 from pot
Poroxide: doesn't show hand 
*** SUMMARY ***
Total pot $13 | Rake $0 
Seat 1: matiko09 (button) folded before Flop (didn't bet)
Seat 2: Fish4trips (small blind) folded before Flop
Seat 3: Yaaaazz (big blind) folded before Flop
Seat 5: di0d80 folded before Flop
Seat 6: Iggso folded before Flop (didn't bet)
Seat 8: Poroxide collected ($13)
Seat 9: Olddogtom888 folded before Flop (didn't bet)





PokerStars Hand #151942834256:  Hold'em No Limit ($0.50/$1.00 USD) - 2016/04/15 13:35:27 CET [2016/04/15 7:35:27 ET]
Table 'Adelgunde III' 9-max Seat #6 is the button
Seat 1: valimiu ($43.77 in chips) 
Seat 2: djammusic ($40 in chips) 
Seat 3: tipner ($100 in chips) 
Seat 4: hammerwife ($114.45 in chips) 
Seat 5: matiko09 ($158.36 in chips) 
Seat 6: Pominator92 ($125.01 in chips) 
Seat 7: Yaaaazz ($100 in chips) 
Seat 8: aseban11 ($100 in chips) 
Seat 9: Kukuryzka ($100 in chips) 
Yaaaazz: posts small blind $0.50
aseban11: posts big blind $1
*** HOLE CARDS ***
Dealt to matiko09 [Tc 4h]
Kukuryzka: folds 
valimiu: calls $1
djammusic: folds 
tipner: folds 
hammerwife: raises $3.50 to $4.50
matiko09: folds 
Pominator92: calls $4.50
Yaaaazz: folds 
aseban11: folds 
valimiu: folds 
*** FLOP *** [5s 2h 9h]
hammerwife: bets $5.46
Pominator92: calls $5.46
*** TURN *** [5s 2h 9h] [2c]
hammerwife: bets $4.50
Pominator92: calls $4.50
*** RIVER *** [5s 2h 9h 2c] [Jd]
hammerwife: checks 
Pominator92: checks 
*** SHOW DOWN ***
hammerwife: shows [Th Kh] (a pair of Deuces)
Pominator92: shows [6c 6h] (two pair, Sixes and Deuces)
Pominator92 collected $29.85 from pot
*** SUMMARY ***
Total pot $31.42 | Rake $1.57 
Board [5s 2h 9h 2c Jd]
Seat 1: valimiu folded before Flop
Seat 2: djammusic folded before Flop (didn't bet)
Seat 3: tipner folded before Flop (didn't bet)
Seat 4: hammerwife showed [Th Kh] and lost with a pair of Deuces
Seat 5: matiko09 folded before Flop (didn't bet)
Seat 6: Pominator92 (button) showed [6c 6h] and won ($29.85) with two pair, Sixes and Deuces
Seat 7: Yaaaazz (small blind) folded before Flop
Seat 8: aseban11 (big blind) folded before Flop
Seat 9: Kukuryzka folded before Flop (didn't bet)





PokerStars Hand #151942834257:  Hold'em No Limit ($1/$2 USD) - 2016/04/15 13:35:27 CET [2016/04/15 7:35:27 ET]
Table 'Irmgard II' 9-max Seat #2 is the button
Seat 2: Kukuryzka ($200 in chips) 
Seat 3: matiko09 ($200 in chips) 
Seat 5: vezunchik79 ($234.45 in chips) 
Seat 6: djammusic ($150.25 in chips) 
Seat 7: erfk1958 ($114 in chips) 
Seat 8: MoeAA11 ($118.30 in chips) 
Seat 9: maximax04 ($84.45 in chips) 
matiko09: posts small blind $1
di0d80: is sitting out 
vezunchik79: posts big blind $2
Iggso: sits out 
*** HOLE CARDS ***
Dealt to matiko09 [5h Th]
djammusic: folds 
erfk1958: folds 
MoeAA11: folds 
maximax04: raises $4 to $6
Kukuryzka: folds 
matiko09: folds 
vezunchik79: folds 
Uncalled bet ($4) returned to maximax04
maximax04 collected $5 from pot
maximax04: doesn't show hand 
*** SUMMARY ***
Total pot $5 | Rake $0 
Seat 2: Kukuryzka (button) folded before Flop (didn't bet)
Seat 3: matiko09 (small blind) folded before Flop
Seat 5: vezunchik79 (big blind) folded before Flop
Seat 6: djammusic folded before Flop (didn't bet)
Seat 7: erfk1958 folded before Flop (didn't bet)
Seat 8: MoeAA11 folded before Flop (didn't bet)
Seat 9: maximax04 collected ($5)





PokerStars Hand #151942834980:  Hold'em No Limit ($0.50/$1.00 USD) - 2016/04/15 13:35:28 CET [2016/04/15 7:35:28 ET]
Table 'Navi' 9-max Seat #1 is the button
Seat 1: tipner ($106.47 in chips) 
Seat 3: aseban11 ($107.28 in chips) 
Seat 4: Effort92 ($152.88 in chips) 
Seat 5: hammerwife ($100 in chips) 
Seat 6: Glushchenko ($107.66 in chips) 
Seat 7: yoshidao ($121.95 in chips) 
Seat 8: djammusic ($40 in chips) 
Seat 9: matiko09 ($130.95 in chips) 
aseban11: posts small blind $0.50
Effort92: posts big blind $1
*** HOLE CARDS ***
Dealt to matiko09 [8d 9h]
hammerwife: folds 
Glushchenko: folds 
yoshidao: calls $1
djammusic: folds 
matiko09: folds 
tipner: raises $3 to $4
aseban11: folds 
Effort92: folds 
yoshidao: calls $3
*** FLOP *** [As Jd Jc]
yoshidao: bets $5
tipner: folds 
Uncalled bet ($5) returned to yoshidao
yoshidao collected $9.02 from pot
yoshidao: doesn't show hand 
*** SUMMARY ***
Total pot $9.50 | Rake $0.48 
Board [As Jd Jc]
Seat 1: tipner (button) folded on the Flop
Seat 3: aseban11 (small blind) folded before Flop
Seat 4: Effort92 (big blind) folded before Flop
Seat 5: hammerwife folded before Flop (didn't bet)
Seat 6: Glushchenko folded before Flop (didn't bet)
Seat 7: yoshidao collected ($9.02)
Seat 8: djammusic folded before Flop (didn't bet)
Seat 9: matiko09 folded before Flop (didn't bet)





PokerStars Hand #151942840431:  Hold'em No Limit ($1/$2 USD) - 2016/04/15 13:35:39 CET [2016/04/15 7:35:39 ET]
Table 'Adele II' 9-max Seat #2 is the button
Seat 1: RyanHuJun ($200 in chips) 
Seat 2: Fish4trips ($421.25 in chips) 
Seat 3: matiko09 ($313.53 in chips) 
Seat 4: Glushchenko ($200 in chips) 
Seat 6: wiseyoyo ($236.93 in chips) 
Seat 7: Iggso ($200 in chips) 
Seat 8: docmarc777 ($300 in chips) 
Seat 9: SanychStar ($277.01 in chips) 
matiko09: posts small blind $1
Glushchenko: posts big blind $2
*** HOLE CARDS ***
Dealt to matiko09 [4h 7s]
wiseyoyo: folds 
Iggso: raises $4 to $6
docmarc777: folds 
SanychStar: folds 
RyanHuJun: calls $6
Fish4trips: folds 
matiko09: folds 
Glushchenko: calls $4
*** FLOP *** [2s 7h 4s]
Glushchenko: checks 
Iggso: bets $13.53
RyanHuJun: folds 
Glushchenko: calls $13.53
*** TURN *** [2s 7h 4s] [Kd]
Glushchenko: checks 
Iggso: bets $27.56
Glushchenko: calls $27.56
*** RIVER *** [2s 7h 4s Kd] [Ad]
Glushchenko: checks 
Iggso: bets $62.01
Glushchenko: folds 
Uncalled bet ($62.01) returned to Iggso
Iggso collected $98.43 from pot
Iggso: doesn't show hand 
*** SUMMARY ***
Total pot $101.18 | Rake $2.75 
Board [2s 7h 4s Kd Ad]
Seat 1: RyanHuJun folded on the Flop
Seat 2: Fish4trips (button) folded before Flop (didn't bet)
Seat 3: matiko09 (small blind) folded before Flop
Seat 4: Glushchenko (big blind) folded on the River
Seat 6: wiseyoyo folded before Flop (didn't bet)
Seat 7: Iggso collected ($98.43)
Seat 8: docmarc777 folded before Flop (didn't bet)
Seat 9: SanychStar folded before Flop (didn't bet)





PokerStars Hand #151942844810:  Hold'em No Limit ($1/$2 USD) - 2016/04/15 13:35:47 CET [2016/04/15 7:35:47 ET]
Table 'Irmgard II' 9-max Seat #3 is the button
Seat 2: Kukuryzka ($200 in chips) 
Seat 3: matiko09 ($200 in chips) 
Seat 5: vezunchik79 ($232.45 in chips) 
Seat 6: djammusic ($150.25 in chips) 
Seat 7: erfk1958 ($114 in chips) 
Seat 8: MoeAA11 ($118.30 in chips) 
Seat 9: maximax04 ($87.45 in chips) 
vezunchik79: posts small blind $1
djammusic: posts big blind $2
Iggso: sits out 
*** HOLE CARDS ***
Dealt to matiko09 [4s 9s]
erfk1958: folds 
MoeAA11: folds 
maximax04: folds 
Kukuryzka: raises $3 to $5
matiko09: folds 
vezunchik79: raises $11 to $16
djammusic: folds 
Kukuryzka: folds 
Uncalled bet ($11) returned to vezunchik79
vezunchik79 collected $12 from pot
*** SUMMARY ***
Total pot $12 | Rake $0 
Seat 2: Kukuryzka folded before Flop
Seat 3: matiko09 (button) folded before Flop (didn't bet)
Seat 5: vezunchik79 (small blind) collected ($12)
Seat 6: djammusic (big blind) folded before Flop
Seat 7: erfk1958 folded before Flop (didn't bet)
Seat 8: MoeAA11 folded before Flop (didn't bet)
Seat 9: maximax04 folded before Flop (didn't bet)





PokerStars Hand #151942845604:  Hold'em No Limit ($1/$2 USD) - 2016/04/15 13:35:49 CET [2016/04/15 7:35:49 ET]
Table 'Oceax' 9-max Seat #2 is the button
Seat 1: matiko09 ($200 in chips) 
Seat 2: Fish4trips ($302.36 in chips) 
Seat 3: Yaaaazz ($200 in chips) 
Seat 6: Iggso ($208.25 in chips) 
Seat 8: Poroxide ($254.60 in chips) 
Seat 9: Olddogtom888 ($285.88 in chips) 
Yaaaazz: posts small blind $1
di0d80: is sitting out 
Iggso: posts big blind $2
coinflip_si: sits out 
*** HOLE CARDS ***
Dealt to matiko09 [Ad Qs]
Poroxide: raises $4 to $6
Olddogtom888 is disconnected 
Olddogtom888 has timed out while disconnected
Olddogtom888: folds 
matiko09: calls $6
Fish4trips: folds 
Yaaaazz: folds 
Iggso: calls $4
*** FLOP *** [9h 2s 4h]
Iggso: checks 
Poroxide: bets $6
matiko09: folds 
Iggso: calls $6
*** TURN *** [9h 2s 4h] [7s]
Iggso: checks 
Poroxide: bets $16
Iggso: calls $16
*** RIVER *** [9h 2s 4h 7s] [6c]
Iggso: checks 
Poroxide: bets $30
Iggso: calls $30
*** SHOW DOWN ***
Poroxide: shows [Qd Kd] (high card King)
Iggso: shows [9c Jh] (a pair of Nines)
Iggso collected $120.25 from pot
*** SUMMARY ***
Total pot $123 | Rake $2.75 
Board [9h 2s 4h 7s 6c]
Seat 1: matiko09 folded on the Flop
Seat 2: Fish4trips (button) folded before Flop (didn't bet)
Seat 3: Yaaaazz (small blind) folded before Flop
Seat 6: Iggso (big blind) showed [9c Jh] and won ($120.25) with a pair of Nines
Seat 8: Poroxide showed [Qd Kd] and lost with high card King
Seat 9: Olddogtom888 folded before Flop (didn't bet)





PokerStars Hand #151942846861:  Hold'em No Limit ($0.50/$1.00 USD) - 2016/04/15 13:35:51 CET [2016/04/15 7:35:51 ET]
Table 'Parvulesco II' 9-max Seat #2 is the button
Seat 1: bilukm ($30.19 in chips) 
Seat 2: Filojoes ($100 in chips) 
Seat 3: matiko09 ($100 in chips) 
Seat 5: bronbeek ($94.01 in chips) 
Seat 6: Glushchenko ($132.84 in chips) 
Seat 8: Jimy Tiltman ($113.70 in chips) 
Seat 9: hammerwife ($214.50 in chips) 
matiko09: posts small blind $0.50
bronbeek: posts big blind $1
Kukuryzka: sits out 
*** HOLE CARDS ***
Dealt to matiko09 [Js 4h]
Glushchenko: folds 
Jimy Tiltman: folds 
Glushchenko leaves the table
hammerwife: folds 
bilukm: folds 
Filojoes: raises $1 to $2
matiko09: folds 
bronbeek: folds 
Uncalled bet ($1) returned to Filojoes
Filojoes collected $2.50 from pot
Filojoes: doesn't show hand 
*** SUMMARY ***
Total pot $2.50 | Rake $0 
Seat 1: bilukm folded before Flop (didn't bet)
Seat 2: Filojoes (button) collected ($2.50)
Seat 3: matiko09 (small blind) folded before Flop
Seat 5: bronbeek (big blind) folded before Flop
Seat 6: Glushchenko folded before Flop (didn't bet)
Seat 8: Jimy Tiltman folded before Flop (didn't bet)
Seat 9: hammerwife folded before Flop (didn't bet)





PokerStars Hand #151942847551:  Hold'em No Limit ($0.50/$1.00 USD) - 2016/04/15 13:35:53 CET [2016/04/15 7:35:53 ET]
Table 'Matterania III' 9-max Seat #4 is the button
Seat 1: di0d80 ($119.45 in chips) 
Seat 2: haoyuan541 ($99.72 in chips) 
Seat 4: wangzhuoming ($69.12 in chips) 
Seat 6: matiko09 ($102.24 in chips) 
Seat 7: Filojoes ($100 in chips) 
Seat 8: Jimy Tiltman ($112.04 in chips) 
matiko09: posts small blind $0.50
Filojoes: posts big blind $1
Yaaaazz: sits out 
di0d80: posts the ante $0.20
haoyuan541: posts the ante $0.20
wangzhuoming: posts the ante $0.20
matiko09: posts the ante $0.20
Filojoes: posts the ante $0.20
Jimy Tiltman: posts the ante $0.20
*** HOLE CARDS ***
Dealt to matiko09 [3h Js]
Jimy Tiltman: folds 
di0d80: folds 
haoyuan541: folds 
wangzhuoming: folds 
Jimy Tiltman leaves the table
matiko09: folds 
Uncalled bet ($0.50) returned to Filojoes
Filojoes collected $2.20 from pot
Filojoes: doesn't show hand 
*** SUMMARY ***
Total pot $2.20 | Rake $0 
Seat 1: di0d80 folded before Flop (didn't bet)
Seat 2: haoyuan541 folded before Flop (didn't bet)
Seat 4: wangzhuoming (button) folded before Flop (didn't bet)
Seat 6: matiko09 (small blind) folded before Flop
Seat 7: Filojoes (big blind) collected ($2.20)
Seat 8: Jimy Tiltman folded before Flop (didn't bet)





PokerStars Hand #151942855378:  Hold'em No Limit ($0.50/$1.00 USD) - 2016/04/15 13:36:08 CET [2016/04/15 7:36:08 ET]
Table 'Matterania III' 9-max Seat #6 is the button
Seat 2: haoyuan541 ($99.52 in chips) 
Seat 4: wangzhuoming ($68.92 in chips) 
Seat 6: matiko09 ($101.54 in chips) 
Seat 7: Filojoes ($101.50 in chips) 
Filojoes: posts small blind $0.50
di0d80: is sitting out 
maxxmeister joins the table at seat #8 
haoyuan541: posts big blind $1
Yaaaazz: sits out 
haoyuan541: posts the ante $0.20
wangzhuoming: posts the ante $0.20
matiko09: posts the ante $0.20
Filojoes: posts the ante $0.20
*** HOLE CARDS ***
Dealt to matiko09 [7s 9s]
wangzhuoming: raises $2 to $3
matiko09: folds 
Filojoes: calls $2.50
haoyuan541: folds 
*** FLOP *** [4s 2h 2s]
Filojoes: checks 
wangzhuoming: bets $5
Filojoes: folds 
Uncalled bet ($5) returned to wangzhuoming
wangzhuoming collected $7.41 from pot
wangzhuoming: doesn't show hand 
*** SUMMARY ***
Total pot $7.80 | Rake $0.39 
Board [4s 2h 2s]
Seat 2: haoyuan541 (big blind) folded before Flop
Seat 4: wangzhuoming collected ($7.41)
Seat 6: matiko09 (button) folded before Flop (didn't bet)
Seat 7: Filojoes (small blind) folded on the Flop





PokerStars Hand #151942855977:  Hold'em No Limit ($0.50/$1.00 USD) - 2016/04/15 13:36:10 CET [2016/04/15 7:36:10 ET]
Table 'Thabit' 9-max Seat #9 is the button
Seat 1: Yaaaazz ($106.36 in chips) 
Seat 3: choupai ($23.17 in chips) 
Seat 5: spunkbubble9 ($16.62 in chips) 
Seat 8: Filojoes ($134.10 in chips) 
Seat 9: matiko09 ($100 in chips) 
Yaaaazz: posts small blind $0.50
choupai: posts big blind $1
tipner: sits out 
*** HOLE CARDS ***
Dealt to matiko09 [6h 6s]
spunkbubble9: raises $2 to $3
Filojoes: folds 
matiko09: raises $6 to $9
Yaaaazz: folds 
choupai: folds 
spunkbubble9: calls $6
*** FLOP *** [3s 3d 2d]
spunkbubble9: bets $7.62 and is all-in
matiko09: calls $7.62
*** TURN *** [3s 3d 2d] [Ks]
*** RIVER *** [3s 3d 2d Ks] [4s]
*** SHOW DOWN ***
spunkbubble9: shows [Ah Td] (a pair of Threes)
matiko09: shows [6h 6s] (two pair, Sixes and Threes)
matiko09 collected $33 from pot
*** SUMMARY ***
Total pot $34.74 | Rake $1.74 
Board [3s 3d 2d Ks 4s]
Seat 1: Yaaaazz (small blind) folded before Flop
Seat 3: choupai (big blind) folded before Flop
Seat 5: spunkbubble9 showed [Ah Td] and lost with a pair of Threes
Seat 8: Filojoes folded before Flop (didn't bet)
Seat 9: matiko09 (button) showed [6h 6s] and won ($33) with two pair, Sixes and Threes





PokerStars Hand #151942856776:  Hold'em No Limit ($0.50/$1.00 USD) - 2016/04/15 13:36:11 CET [2016/04/15 7:36:11 ET]
Table 'Parvulesco II' 9-max Seat #3 is the button
Seat 1: bilukm ($30.19 in chips) 
Seat 2: Filojoes ($101.50 in chips) 
Seat 3: matiko09 ($100 in chips) 
Seat 5: bronbeek ($93.01 in chips) 
Seat 7: Kukuryzka ($131.55 in chips) 
Seat 8: Jimy Tiltman ($113.70 in chips) 
Seat 9: hammerwife ($214.50 in chips) 
bronbeek: posts small blind $0.50
Kukuryzka: posts big blind $1
*** HOLE CARDS ***
Dealt to matiko09 [8c 7d]
Jimy Tiltman: raises $2 to $3
hammerwife: folds 
bilukm: folds 
Filojoes: folds 
matiko09: folds 
maxxmeister joins the table at seat #6 
bronbeek: folds 
Kukuryzka: folds 
Uncalled bet ($2) returned to Jimy Tiltman
Jimy Tiltman collected $2.50 from pot
Jimy Tiltman: doesn't show hand 
*** SUMMARY ***
Total pot $2.50 | Rake $0 
Seat 1: bilukm folded before Flop (didn't bet)
Seat 2: Filojoes folded before Flop (didn't bet)
Seat 3: matiko09 (button) folded before Flop (didn't bet)
Seat 5: bronbeek (small blind) folded before Flop
Seat 7: Kukuryzka (big blind) folded before Flop
Seat 8: Jimy Tiltman collected ($2.50)
Seat 9: hammerwife folded before Flop (didn't bet)





PokerStars Hand #151942858679:  Hold'em No Limit ($0.50/$1.00 USD) - 2016/04/15 13:36:15 CET [2016/04/15 7:36:15 ET]
Table 'Navi' 9-max Seat #3 is the button
Seat 1: tipner ($102.47 in chips) 
Seat 3: aseban11 ($106.78 in chips) 
Seat 4: Effort92 ($151.88 in chips) 
Seat 5: hammerwife ($100 in chips) 
Seat 6: Glushchenko ($107.66 in chips) 
Seat 7: yoshidao ($126.97 in chips) 
Seat 8: djammusic ($40 in chips) 
Seat 9: matiko09 ($130.95 in chips) 
Effort92: posts small blind $0.50
hammerwife: posts big blind $1
*** HOLE CARDS ***
Dealt to matiko09 [8h 6h]
Glushchenko: folds 
yoshidao: folds 
djammusic: folds 
matiko09: folds 
tipner: folds 
aseban11: raises $1.50 to $2.50
Effort92: folds 
hammerwife: calls $1.50
*** FLOP *** [9c Kc Tc]
hammerwife: checks 
aseban11: bets $4
hammerwife: calls $4
*** TURN *** [9c Kc Tc] [Js]
hammerwife: checks 
aseban11: checks 
*** RIVER *** [9c Kc Tc Js] [3d]
hammerwife: checks 
aseban11: checks 
*** SHOW DOWN ***
hammerwife: shows [5c 8c] (a flush, King high)
aseban11: mucks hand 
hammerwife collected $12.82 from pot
*** SUMMARY ***
Total pot $13.50 | Rake $0.68 
Board [9c Kc Tc Js 3d]
Seat 1: tipner folded before Flop (didn't bet)
Seat 3: aseban11 (button) mucked [Kd 5d]
Seat 4: Effort92 (small blind) folded before Flop
Seat 5: hammerwife (big blind) showed [5c 8c] and won ($12.82) with a flush, King high
Seat 6: Glushchenko folded before Flop (didn't bet)
Seat 7: yoshidao folded before Flop (didn't bet)
Seat 8: djammusic folded before Flop (didn't bet)
Seat 9: matiko09 folded before Flop (didn't bet)





PokerStars Hand #151942862553:  Hold'em No Limit ($1/$2 USD) - 2016/04/15 13:36:23 CET [2016/04/15 7:36:23 ET]
Table 'Irmgard II' 9-max Seat #5 is the button
Seat 2: Kukuryzka ($200 in chips) 
Seat 3: matiko09 ($200 in chips) 
Seat 5: vezunchik79 ($239.45 in chips) 
Seat 6: djammusic ($148.25 in chips) 
Seat 7: erfk1958 ($114 in chips) 
Seat 8: MoeAA11 ($118.30 in chips) 
Seat 9: maximax04 ($87.45 in chips) 
djammusic: posts small blind $1
erfk1958: posts big blind $2
Iggso: sits out 
*** HOLE CARDS ***
Dealt to matiko09 [Js Ah]
MoeAA11: folds 
maximax04: raises $2 to $4
Kukuryzka: folds 
matiko09: calls $4
vezunchik79: folds 
djammusic: folds 
erfk1958: calls $2
*** FLOP *** [3s 4s 7d]
erfk1958: checks 
maximax04: bets $6
matiko09: folds 
erfk1958: folds 
Uncalled bet ($6) returned to maximax04
maximax04 collected $12.35 from pot
maximax04: doesn't show hand 
*** SUMMARY ***
Total pot $13 | Rake $0.65 
Board [3s 4s 7d]
Seat 2: Kukuryzka folded before Flop (didn't bet)
Seat 3: matiko09 folded on the Flop
Seat 5: vezunchik79 (button) folded before Flop (didn't bet)
Seat 6: djammusic (small blind) folded before Flop
Seat 7: erfk1958 (big blind) folded on the Flop
Seat 8: MoeAA11 folded before Flop (didn't bet)
Seat 9: maximax04 collected ($12.35)





PokerStars Hand #151942863019:  Hold'em No Limit ($1/$2 USD) - 2016/04/15 13:36:24 CET [2016/04/15 7:36:24 ET]
Table 'Patroclus II' 9-max Seat #9 is the button
Seat 1: TonnaMunz ($202.04 in chips) 
Seat 2: Moemors ($200.43 in chips) 
Seat 3: Koolniknik ($302.29 in chips) 
Seat 4: tipner ($200 in chips) 
Seat 7: matiko09 ($240.76 in chips) 
Seat 8: Glushchenko ($200 in chips) 
Seat 9: Fish4trips ($235.92 in chips) 
TonnaMunz: posts small blind $1
Moemors: posts big blind $2
*** HOLE CARDS ***
Dealt to matiko09 [Ks Qc]
Koolniknik: folds 
tipner: folds 
matiko09: raises $3 to $5
Glushchenko: folds 
Fish4trips: folds 
TonnaMunz: folds 
Moemors: folds 
Uncalled bet ($3) returned to matiko09
matiko09 collected $5 from pot
matiko09: doesn't show hand 
*** SUMMARY ***
Total pot $5 | Rake $0 
Seat 1: TonnaMunz (small blind) folded before Flop
Seat 2: Moemors (big blind) folded before Flop
Seat 3: Koolniknik folded before Flop (didn't bet)
Seat 4: tipner folded before Flop (didn't bet)
Seat 7: matiko09 collected ($5)
Seat 8: Glushchenko folded before Flop (didn't bet)
Seat 9: Fish4trips (button) folded before Flop (didn't bet)





PokerStars Hand #151942871158:  Hold'em No Limit ($0.50/$1.00 USD) - 2016/04/15 13:36:40 CET [2016/04/15 7:36:40 ET]
Table 'Adelgunde III' 9-max Seat #7 is the button
Seat 1: valimiu ($42.77 in chips) 
Seat 2: djammusic ($40 in chips) 
Seat 3: tipner ($100 in chips) 
Seat 4: hammerwife ($100 in chips) 
Seat 5: matiko09 ($158.36 in chips) 
Seat 6: Pominator92 ($140.40 in chips) 
Seat 7: Yaaaazz ($100 in chips) 
Seat 8: aseban11 ($100 in chips) 
Seat 9: Kukuryzka ($100 in chips) 
aseban11: posts small blind $0.50
Kukuryzka: posts big blind $1
*** HOLE CARDS ***
Dealt to matiko09 [4c 5h]
valimiu: calls $1
djammusic: folds 
tipner: folds 
hammerwife: folds 
matiko09: folds 
Pominator92: folds 
Yaaaazz: folds 
aseban11: calls $0.50
Kukuryzka: checks 
*** FLOP *** [7s Qs Ks]
valimiu said, "cmoooooooon"
aseban11: checks 
Kukuryzka: checks 
valimiu: checks 
*** TURN *** [7s Qs Ks] [4h]
aseban11: checks 
Kukuryzka: checks 
valimiu: bets $4
aseban11: folds 
Kukuryzka: folds 
Uncalled bet ($4) returned to valimiu
valimiu collected $2.85 from pot
valimiu: doesn't show hand 
*** SUMMARY ***
Total pot $3 | Rake $0.15 
Board [7s Qs Ks 4h]
Seat 1: valimiu collected ($2.85)
Seat 2: djammusic folded before Flop (didn't bet)
Seat 3: tipner folded before Flop (didn't bet)
Seat 4: hammerwife folded before Flop (didn't bet)
Seat 5: matiko09 folded before Flop (didn't bet)
Seat 6: Pominator92 folded before Flop (didn't bet)
Seat 7: Yaaaazz (button) folded before Flop (didn't bet)
Seat 8: aseban11 (small blind) folded on the Turn
Seat 9: Kukuryzka (big blind) folded on the Turn





PokerStars Hand #151942877774:  Hold'em No Limit ($1/$2 USD) - 2016/04/15 13:36:53 CET [2016/04/15 7:36:53 ET]
Table 'Irmgard II' 9-max Seat #6 is the button
Seat 2: Kukuryzka ($200 in chips) 
Seat 3: matiko09 ($200 in chips) 
Seat 5: vezunchik79 ($239.45 in chips) 
Seat 6: djammusic ($147.25 in chips) 
Seat 7: erfk1958 ($110 in chips) 
Seat 8: MoeAA11 ($118.30 in chips) 
Seat 9: maximax04 ($95.80 in chips) 
erfk1958: posts small blind $1
MoeAA11: posts big blind $2
Iggso: sits out 
*** HOLE CARDS ***
Dealt to matiko09 [2c 4d]
maximax04: folds 
Kukuryzka: folds 
matiko09: folds 
vezunchik79: raises $4 to $6
djammusic: folds 
erfk1958: folds 
MoeAA11: calls $4
*** FLOP *** [Jd Kd Tc]
MoeAA11: checks 
vezunchik79: bets $8
MoeAA11: folds 
Uncalled bet ($8) returned to vezunchik79
vezunchik79 collected $12.35 from pot
*** SUMMARY ***
Total pot $13 | Rake $0.65 
Board [Jd Kd Tc]
Seat 2: Kukuryzka folded before Flop (didn't bet)
Seat 3: matiko09 folded before Flop (didn't bet)
Seat 5: vezunchik79 collected ($12.35)
Seat 6: djammusic (button) folded before Flop (didn't bet)
Seat 7: erfk1958 (small blind) folded before Flop
Seat 8: MoeAA11 (big blind) folded on the Flop
Seat 9: maximax04 folded before Flop (didn't bet)





PokerStars Hand #151942879337:  Hold'em No Limit ($1/$2 USD) - 2016/04/15 13:36:56 CET [2016/04/15 7:36:56 ET]
Table 'Patroclus II' 9-max Seat #1 is the button
Seat 1: TonnaMunz ($201.04 in chips) 
Seat 2: Moemors ($198.43 in chips) 
Seat 3: Koolniknik ($302.29 in chips) 
Seat 4: tipner ($200 in chips) 
Seat 7: matiko09 ($243.76 in chips) 
Seat 8: Glushchenko ($200 in chips) 
Seat 9: Fish4trips ($235.92 in chips) 
Moemors: posts small blind $1
Koolniknik: posts big blind $2
*** HOLE CARDS ***
Dealt to matiko09 [3h 9c]
tipner: folds 
matiko09: folds 
Glushchenko: folds 
Fish4trips: folds 
TonnaMunz: folds 
Moemors: folds 
Uncalled bet ($1) returned to Koolniknik
Koolniknik collected $2 from pot
*** SUMMARY ***
Total pot $2 | Rake $0 
Seat 1: TonnaMunz (button) folded before Flop (didn't bet)
Seat 2: Moemors (small blind) folded before Flop
Seat 3: Koolniknik (big blind) collected ($2)
Seat 4: tipner folded before Flop (didn't bet)
Seat 7: matiko09 folded before Flop (didn't bet)
Seat 8: Glushchenko folded before Flop (didn't bet)
Seat 9: Fish4trips folded before Flop (didn't bet)





PokerStars Hand #151942879543:  Hold'em No Limit ($0.50/$1.00 USD) - 2016/04/15 13:36:56 CET [2016/04/15 7:36:56 ET]
Table 'Matterania III' 9-max Seat #7 is the button
Seat 2: haoyuan541 ($98.32 in chips) 
Seat 3: Yaaaazz ($107.06 in chips) 
Seat 4: wangzhuoming ($73.13 in chips) 
Seat 6: matiko09 ($101.34 in chips) 
Seat 7: Filojoes ($100 in chips) 
maxxmeister will be allowed to play after the button
haoyuan541: posts small blind $0.50
Yaaaazz: posts big blind $1
haoyuan541: posts the ante $0.20
Yaaaazz: posts the ante $0.20
wangzhuoming: posts the ante $0.20
matiko09: posts the ante $0.20
Filojoes: posts the ante $0.20
*** HOLE CARDS ***
Dealt to matiko09 [9h Jc]
wangzhuoming: folds 
matiko09: folds 
Filojoes: raises $1 to $2
haoyuan541: folds 
Yaaaazz: calls $1
*** FLOP *** [9d 5h Ad]
Yaaaazz: checks 
Filojoes: checks 
*** TURN *** [9d 5h Ad] [Js]
Yaaaazz: bets $3.45
Filojoes: folds 
Uncalled bet ($3.45) returned to Yaaaazz
Yaaaazz collected $5.22 from pot
*** SUMMARY ***
Total pot $5.50 | Rake $0.28 
Board [9d 5h Ad Js]
Seat 2: haoyuan541 (small blind) folded before Flop
Seat 3: Yaaaazz (big blind) collected ($5.22)
Seat 4: wangzhuoming folded before Flop (didn't bet)
Seat 6: matiko09 folded before Flop (didn't bet)
Seat 7: Filojoes (button) folded on the Turn





PokerStars Hand #151942879340:  Hold'em No Limit ($0.50/$1.00 USD) - 2016/04/15 13:36:56 CET [2016/04/15 7:36:56 ET]
Table 'Parvulesco II' 9-max Seat #5 is the button
Seat 1: bilukm ($30.19 in chips) 
Seat 2: Filojoes ($101.50 in chips) 
Seat 3: matiko09 ($100 in chips) 
Seat 5: bronbeek ($92.51 in chips) 
Seat 7: Kukuryzka ($130.55 in chips) 
Seat 8: Jimy Tiltman ($115.20 in chips) 
Seat 9: hammerwife ($214.50 in chips) 
maxxmeister will be allowed to play after the button
Kukuryzka: posts small blind $0.50
Jimy Tiltman: posts big blind $1
*** HOLE CARDS ***
Dealt to matiko09 [7s Js]
hammerwife: raises $2 to $3
bilukm: calls $3
Filojoes: calls $3
matiko09: folds 
bronbeek: folds 
Kukuryzka: folds 
Jimy Tiltman: folds 
*** FLOP *** [7d Qc 3d]
hammerwife: bets $5.50
bilukm: folds 
Filojoes: raises $8.50 to $14
hammerwife: calls $8.50
*** TURN *** [7d Qc 3d] [Kd]
hammerwife: checks 
Filojoes: checks 
*** RIVER *** [7d Qc 3d Kd] [4c]
maxxmeister leaves the table
hammerwife: checks 
Filojoes: checks 
*** SHOW DOWN ***
hammerwife: shows [Ah Ks] (a pair of Kings)
Filojoes: shows [7c 7h] (three of a kind, Sevens)
Filojoes collected $36.58 from pot
*** SUMMARY ***
Total pot $38.50 | Rake $1.92 
Board [7d Qc 3d Kd 4c]
Seat 1: bilukm folded on the Flop
Seat 2: Filojoes showed [7c 7h] and won ($36.58) with three of a kind, Sevens
Seat 3: matiko09 folded before Flop (didn't bet)
Seat 5: bronbeek (button) folded before Flop (didn't bet)
Seat 7: Kukuryzka (small blind) folded before Flop
Seat 8: Jimy Tiltman (big blind) folded before Flop
Seat 9: hammerwife showed [Ah Ks] and lost with a pair of Kings





PokerStars Hand #151942882625:  Hold'em No Limit ($0.50/$1.00 USD) - 2016/04/15 13:37:03 CET [2016/04/15 7:37:03 ET]
Table 'Katja II' 9-max Seat #5 is the button
Seat 1: Filojoes ($105.50 in chips) 
Seat 3: matiko09 ($135.62 in chips) 
Seat 4: Sutt_420 ($86.62 in chips) 
Seat 5: djammusic ($36.95 in chips) 
Seat 6: ASG2016 ($112.02 in chips) 
Seat 7: Effort92 ($104.50 in chips) 
Seat 8: Glushchenko ($141.49 in chips) 
Seat 9: hardeep13 ($65.25 in chips) 
ASG2016: posts small blind $0.50
Effort92: posts big blind $1
*** HOLE CARDS ***
Dealt to matiko09 [9d Jc]
Glushchenko: folds 
hardeep13: folds 
hardeep13 leaves the table
Filojoes: folds 
matiko09: folds 
Sutt_420: folds 
djammusic: folds 
ASG2016: folds 
Uncalled bet ($0.50) returned to Effort92
Effort92 collected $1 from pot
Effort92: doesn't show hand 
*** SUMMARY ***
Total pot $1 | Rake $0 
Seat 1: Filojoes folded before Flop (didn't bet)
Seat 3: matiko09 folded before Flop (didn't bet)
Seat 4: Sutt_420 folded before Flop (didn't bet)
Seat 5: djammusic (button) folded before Flop (didn't bet)
Seat 6: ASG2016 (small blind) folded before Flop
Seat 7: Effort92 (big blind) collected ($1)
Seat 8: Glushchenko folded before Flop (didn't bet)
Seat 9: hardeep13 folded before Flop (didn't bet)





PokerStars Hand #151942886788:  Hold'em No Limit ($0.50/$1.00 USD) - 2016/04/15 13:37:11 CET [2016/04/15 7:37:11 ET]
Table 'Navi' 9-max Seat #4 is the button
Seat 1: tipner ($102.47 in chips) 
Seat 3: aseban11 ($100.28 in chips) 
Seat 4: Effort92 ($151.38 in chips) 
Seat 5: hammerwife ($106.32 in chips) 
Seat 6: Glushchenko ($107.66 in chips) 
Seat 7: yoshidao ($126.97 in chips) 
Seat 8: djammusic ($40 in chips) 
Seat 9: matiko09 ($130.95 in chips) 
hammerwife: posts small blind $0.50
Glushchenko: posts big blind $1
*** HOLE CARDS ***
Dealt to matiko09 [5s 3d]
yoshidao: calls $1
djammusic: folds 
matiko09: folds 
tipner: folds 
aseban11: folds 
Effort92: raises $3 to $4
hammerwife: folds 
Glushchenko: folds 
yoshidao: folds 
Uncalled bet ($3) returned to Effort92
Effort92 collected $3.50 from pot
Effort92: doesn't show hand 
*** SUMMARY ***
Total pot $3.50 | Rake $0 
Seat 1: tipner folded before Flop (didn't bet)
Seat 3: aseban11 folded before Flop (didn't bet)
Seat 4: Effort92 (button) collected ($3.50)
Seat 5: hammerwife (small blind) folded before Flop
Seat 6: Glushchenko (big blind) folded before Flop
Seat 7: yoshidao folded before Flop
Seat 8: djammusic folded before Flop (didn't bet)
Seat 9: matiko09 folded before Flop (didn't bet)





PokerStars Hand #151942891536:  Hold'em No Limit ($1/$2 USD) - 2016/04/15 13:37:20 CET [2016/04/15 7:37:20 ET]
Table 'Adele II' 9-max Seat #3 is the button
Seat 1: RyanHuJun ($200 in chips) 
Seat 2: Fish4trips ($421.25 in chips) 
Seat 3: matiko09 ($312.53 in chips) 
Seat 4: Glushchenko ($200 in chips) 
Seat 6: wiseyoyo ($236.93 in chips) 
Seat 7: Iggso ($251.34 in chips) 
Seat 8: docmarc777 ($300 in chips) 
Seat 9: SanychStar ($277.01 in chips) 
Glushchenko: posts small blind $1
wiseyoyo: posts big blind $2
*** HOLE CARDS ***
Dealt to matiko09 [7s 6d]
Iggso: folds 
docmarc777: folds 
SanychStar: raises $3 to $5
RyanHuJun: folds 
Fish4trips: calls $5
matiko09: folds 
Glushchenko: folds 
wiseyoyo: folds 
*** FLOP *** [3s Td 2h]
SanychStar: bets $8.15
Fish4trips: calls $8.15
*** TURN *** [3s Td 2h] [Kd]
SanychStar: checks 
Fish4trips: checks 
*** RIVER *** [3s Td 2h Kd] [Qs]
SanychStar: checks 
Fish4trips: checks 
*** SHOW DOWN ***
SanychStar: shows [Jh Jd] (a pair of Jacks)
Fish4trips: mucks hand 
SanychStar collected $27.84 from pot
*** SUMMARY ***
Total pot $29.30 | Rake $1.46 
Board [3s Td 2h Kd Qs]
Seat 1: RyanHuJun folded before Flop (didn't bet)
Seat 2: Fish4trips mucked [7c 7d]
Seat 3: matiko09 (button) folded before Flop (didn't bet)
Seat 4: Glushchenko (small blind) folded before Flop
Seat 6: wiseyoyo (big blind) folded before Flop
Seat 7: Iggso folded before Flop (didn't bet)
Seat 8: docmarc777 folded before Flop (didn't bet)
Seat 9: SanychStar showed [Jh Jd] and won ($27.84) with a pair of Jacks





PokerStars Hand #151942893802:  Hold'em No Limit ($1/$2 USD) - 2016/04/15 13:37:25 CET [2016/04/15 7:37:25 ET]
Table 'Oceax' 9-max Seat #3 is the button
Seat 1: matiko09 ($200 in chips) 
Seat 2: Fish4trips ($302.36 in chips) 
Seat 3: Yaaaazz ($200 in chips) 
Seat 6: Iggso ($270.50 in chips) 
Seat 7: coinflip_si ($227.65 in chips) 
Seat 8: Poroxide ($196.60 in chips) 
Iggso: posts small blind $1
coinflip_si: posts big blind $2
*** HOLE CARDS ***
Dealt to matiko09 [5d 7c]
Poroxide: folds 
matiko09: folds 
Fish4trips: folds 
Yaaaazz: raises $2.40 to $4.40
Iggso: folds 
coinflip_si: calls $2.40
*** FLOP *** [3h 6h Qh]
coinflip_si: checks 
Yaaaazz: bets $6.20
coinflip_si: folds 
Uncalled bet ($6.20) returned to Yaaaazz
Yaaaazz collected $9.31 from pot
*** SUMMARY ***
Total pot $9.80 | Rake $0.49 
Board [3h 6h Qh]
Seat 1: matiko09 folded before Flop (didn't bet)
Seat 2: Fish4trips folded before Flop (didn't bet)
Seat 3: Yaaaazz (button) collected ($9.31)
Seat 6: Iggso (small blind) folded before Flop
Seat 7: coinflip_si (big blind) folded on the Flop
Seat 8: Poroxide folded before Flop (didn't bet)





PokerStars Hand #151942896557:  Hold'em No Limit ($1/$2 USD) - 2016/04/15 13:37:30 CET [2016/04/15 7:37:30 ET]
Table 'Patroclus II' 9-max Seat #2 is the button
Seat 1: TonnaMunz ($201.04 in chips) 
Seat 2: Moemors ($197.43 in chips) 
Seat 3: Koolniknik ($303.29 in chips) 
Seat 4: tipner ($200 in chips) 
Seat 7: matiko09 ($243.76 in chips) 
Seat 8: Glushchenko ($200 in chips) 
Seat 9: Fish4trips ($235.92 in chips) 
Koolniknik: posts small blind $1
tipner: posts big blind $2
*** HOLE CARDS ***
Dealt to matiko09 [3c 4h]
matiko09: folds 
Glushchenko: folds 
Fish4trips: folds 
TonnaMunz: folds 
Moemors: raises $2 to $4
Koolniknik: folds 
tipner: folds 
Uncalled bet ($2) returned to Moemors
Moemors collected $5 from pot
Moemors: doesn't show hand 
*** SUMMARY ***
Total pot $5 | Rake $0 
Seat 1: TonnaMunz folded before Flop (didn't bet)
Seat 2: Moemors (button) collected ($5)
Seat 3: Koolniknik (small blind) folded before Flop
Seat 4: tipner (big blind) folded before Flop
Seat 7: matiko09 folded before Flop (didn't bet)
Seat 8: Glushchenko folded before Flop (didn't bet)
Seat 9: Fish4trips folded before Flop (didn't bet)





PokerStars Hand #151942897477:  Hold'em No Limit ($1/$2 USD) - 2016/04/15 13:37:32 CET [2016/04/15 7:37:32 ET]
Table 'Irmgard II' 9-max Seat #7 is the button
Seat 2: Kukuryzka ($200 in chips) 
Seat 3: matiko09 ($200 in chips) 
Seat 5: vezunchik79 ($245.80 in chips) 
Seat 6: djammusic ($147.25 in chips) 
Seat 7: erfk1958 ($109 in chips) 
Seat 8: MoeAA11 ($112.30 in chips) 
Seat 9: maximax04 ($95.80 in chips) 
MoeAA11: posts small blind $1
maximax04: posts big blind $2
Iggso: sits out 
*** HOLE CARDS ***
Dealt to matiko09 [Td 4d]
Kukuryzka: folds 
matiko09: folds 
vezunchik79: folds 
djammusic: raises $3 to $5
erfk1958: calls $5
MoeAA11: folds 
maximax04: calls $3
*** FLOP *** [Jd 9h 8d]
maximax04: checks 
djammusic: checks 
erfk1958: bets $6
maximax04: folds 
djammusic: folds 
Uncalled bet ($6) returned to erfk1958
erfk1958 collected $15.20 from pot
erfk1958: doesn't show hand 
*** SUMMARY ***
Total pot $16 | Rake $0.80 
Board [Jd 9h 8d]
Seat 2: Kukuryzka folded before Flop (didn't bet)
Seat 3: matiko09 folded before Flop (didn't bet)
Seat 5: vezunchik79 folded before Flop (didn't bet)
Seat 6: djammusic folded on the Flop
Seat 7: erfk1958 (button) collected ($15.20)
Seat 8: MoeAA11 (small blind) folded before Flop
Seat 9: maximax04 (big blind) folded on the Flop





PokerStars Hand #151942902539:  Hold'em No Limit ($0.50/$1.00 USD) - 2016/04/15 13:37:42 CET [2016/04/15 7:37:42 ET]
Table 'Katja II' 9-max Seat #6 is the button
Seat 1: Filojoes ($105.50 in chips) 
Seat 3: matiko09 ($135.62 in chips) 
Seat 4: Sutt_420 ($86.62 in chips) 
Seat 5: djammusic ($36.95 in chips) 
Seat 6: ASG2016 ($111.52 in chips) 
Seat 7: Effort92 ($105 in chips) 
Seat 8: Glushchenko ($141.49 in chips) 
Effort92: posts small blind $0.50
Glushchenko: posts big blind $1
*** HOLE CARDS ***
Dealt to matiko09 [9s 5s]
Filojoes: folds 
Filojoes leaves the table
matiko09: folds 
Sutt_420: folds 
djammusic: raises $1.02 to $2.02
Dachish joins the table at seat #9 
ASG2016: folds 
Effort92: folds 
Glushchenko: raises $4.65 to $6.67
djammusic: folds 
Uncalled bet ($4.65) returned to Glushchenko
Glushchenko collected $4.54 from pot
*** SUMMARY ***
Total pot $4.54 | Rake $0 
Seat 1: Filojoes folded before Flop (didn't bet)
Seat 3: matiko09 folded before Flop (didn't bet)
Seat 4: Sutt_420 folded before Flop (didn't bet)
Seat 5: djammusic folded before Flop
Seat 6: ASG2016 (button) folded before Flop (didn't bet)
Seat 7: Effort92 (small blind) folded before Flop
Seat 8: Glushchenko (big blind) collected ($4.54)





PokerStars Hand #151942906070:  Hold'em No Limit ($0.50/$1.00 USD) - 2016/04/15 13:37:49 CET [2016/04/15 7:37:49 ET]
Table 'Navi' 9-max Seat #5 is the button
Seat 1: tipner ($102.47 in chips) 
Seat 3: aseban11 ($100.28 in chips) 
Seat 4: Effort92 ($153.88 in chips) 
Seat 5: hammerwife ($105.82 in chips) 
Seat 6: Glushchenko ($106.66 in chips) 
Seat 7: yoshidao ($125.97 in chips) 
Seat 8: djammusic ($40 in chips) 
Seat 9: matiko09 ($130.95 in chips) 
Glushchenko: posts small blind $0.50
yoshidao: posts big blind $1
butcheN18: sits out 
*** HOLE CARDS ***
Dealt to matiko09 [6c Jd]
djammusic: raises $1.25 to $2.25
matiko09: folds 
tipner: folds 
aseban11: folds 
Effort92: folds 
hammerwife: folds 
Glushchenko: folds 
yoshidao: folds 
Uncalled bet ($1.25) returned to djammusic
djammusic collected $2.50 from pot
djammusic: doesn't show hand 
*** SUMMARY ***
Total pot $2.50 | Rake $0 
Seat 1: tipner folded before Flop (didn't bet)
Seat 3: aseban11 folded before Flop (didn't bet)
Seat 4: Effort92 folded before Flop (didn't bet)
Seat 5: hammerwife (button) folded before Flop (didn't bet)
Seat 6: Glushchenko (small blind) folded before Flop
Seat 7: yoshidao (big blind) folded before Flop
Seat 8: djammusic collected ($2.50)
Seat 9: matiko09 folded before Flop (didn't bet)





PokerStars Hand #151942907418:  Hold'em No Limit ($1/$2 USD) - 2016/04/15 13:37:52 CET [2016/04/15 7:37:52 ET]
Table 'Patroclus II' 9-max Seat #3 is the button
Seat 1: TonnaMunz ($201.04 in chips) 
Seat 2: Moemors ($200.43 in chips) 
Seat 3: Koolniknik ($302.29 in chips) 
Seat 4: tipner ($200 in chips) 
Seat 5: butcheN18 ($250.29 in chips) 
Seat 7: matiko09 ($243.76 in chips) 
Seat 8: Glushchenko ($200 in chips) 
Seat 9: Fish4trips ($235.92 in chips) 
tipner: posts small blind $1
butcheN18: posts big blind $2
*** HOLE CARDS ***
Dealt to matiko09 [Kd 5s]
matiko09: folds 
Glushchenko: folds 
Fish4trips: folds 
TonnaMunz: folds 
Moemors: folds 
Koolniknik: raises $4 to $6
tipner: folds 
butcheN18: folds 
Uncalled bet ($4) returned to Koolniknik
Koolniknik collected $5 from pot
Koolniknik: doesn't show hand 
*** SUMMARY ***
Total pot $5 | Rake $0 
Seat 1: TonnaMunz folded before Flop (didn't bet)
Seat 2: Moemors folded before Flop (didn't bet)
Seat 3: Koolniknik (button) collected ($5)
Seat 4: tipner (small blind) folded before Flop
Seat 5: butcheN18 (big blind) folded before Flop
Seat 7: matiko09 folded before Flop (didn't bet)
Seat 8: Glushchenko folded before Flop (didn't bet)
Seat 9: Fish4trips folded before Flop (didn't bet)





PokerStars Hand #151942911116:  Hold'em No Limit ($1/$2 USD) - 2016/04/15 13:37:59 CET [2016/04/15 7:37:59 ET]
Table 'Oceax' 9-max Seat #6 is the button
Seat 1: matiko09 ($200 in chips) 
Seat 2: Fish4trips ($302.36 in chips) 
Seat 3: Yaaaazz ($204.91 in chips) 
Seat 6: Iggso ($269.50 in chips) 
Seat 7: coinflip_si ($223.25 in chips) 
Seat 8: Poroxide ($196.60 in chips) 
coinflip_si: posts small blind $1
Poroxide: posts big blind $2
butcheN18: sits out 
*** HOLE CARDS ***
Dealt to matiko09 [3s 4d]
matiko09: folds 
Fish4trips: raises $3 to $5
Yaaaazz: folds 
Iggso: folds 
coinflip_si: folds 
Poroxide: calls $3
*** FLOP *** [Ts Ad Qc]
Poroxide: checks 
Fish4trips: bets $6.58
Poroxide: calls $6.58
*** TURN *** [Ts Ad Qc] [3d]
Poroxide: checks 
Fish4trips: checks 
*** RIVER *** [Ts Ad Qc 3d] [5s]
Poroxide: bets $12
Fish4trips: folds 
Uncalled bet ($12) returned to Poroxide
Poroxide collected $22.95 from pot
Poroxide: doesn't show hand 
*** SUMMARY ***
Total pot $24.16 | Rake $1.21 
Board [Ts Ad Qc 3d 5s]
Seat 1: matiko09 folded before Flop (didn't bet)
Seat 2: Fish4trips folded on the River
Seat 3: Yaaaazz folded before Flop (didn't bet)
Seat 6: Iggso (button) folded before Flop (didn't bet)
Seat 7: coinflip_si (small blind) folded before Flop
Seat 8: Poroxide (big blind) collected ($22.95)





PokerStars Hand #151942911674:  Hold'em No Limit ($0.50/$1.00 USD) - 2016/04/15 13:38:00 CET [2016/04/15 7:38:00 ET]
Table 'Adelgunde III' 9-max Seat #8 is the button
Seat 1: valimiu ($44.62 in chips) 
Seat 2: djammusic ($40 in chips) 
Seat 3: tipner ($100 in chips) 
Seat 4: hammerwife ($100 in chips) 
Seat 5: matiko09 ($158.36 in chips) 
Seat 6: Pominator92 ($140.40 in chips) 
Seat 7: Yaaaazz ($100 in chips) 
Seat 8: aseban11 ($100 in chips) 
Seat 9: Kukuryzka ($99 in chips) 
Kukuryzka: posts small blind $0.50
valimiu: posts big blind $1
*** HOLE CARDS ***
Dealt to matiko09 [2h Tc]
djammusic: folds 
tipner: folds 
hammerwife: folds 
matiko09: folds 
Pominator92: folds 
Yaaaazz: raises $1.50 to $2.50
aseban11: folds 
Kukuryzka: folds 
valimiu: calls $1.50
*** FLOP *** [9h Jc Ac]
valimiu: checks 
Yaaaazz: checks 
*** TURN *** [9h Jc Ac] [5h]
valimiu: checks 
Yaaaazz: checks 
*** RIVER *** [9h Jc Ac 5h] [Qc]
valimiu: bets $6
Yaaaazz: folds 
Uncalled bet ($6) returned to valimiu
valimiu collected $5.22 from pot
valimiu: doesn't show hand 
*** SUMMARY ***
Total pot $5.50 | Rake $0.28 
Board [9h Jc Ac 5h Qc]
Seat 1: valimiu (big blind) collected ($5.22)
Seat 2: djammusic folded before Flop (didn't bet)
Seat 3: tipner folded before Flop (didn't bet)
Seat 4: hammerwife folded before Flop (didn't bet)
Seat 5: matiko09 folded before Flop (didn't bet)
Seat 6: Pominator92 folded before Flop (didn't bet)
Seat 7: Yaaaazz folded on the River
Seat 8: aseban11 (button) folded before Flop (didn't bet)
Seat 9: Kukuryzka (small blind) folded before Flop





PokerStars Hand #151942914615:  Hold'em No Limit ($0.50/$1.00 USD) - 2016/04/15 13:38:06 CET [2016/04/15 7:38:06 ET]
Table 'Matterania III' 9-max Seat #2 is the button
Seat 2: haoyuan541 ($97.62 in chips) 
Seat 3: Yaaaazz ($110.08 in chips) 
Seat 4: wangzhuoming ($72.93 in chips) 
Seat 6: matiko09 ($101.14 in chips) 
Seat 7: Filojoes ($100 in chips) 
Yaaaazz: posts small blind $0.50
wangzhuoming: posts big blind $1
maxxmeister: sits out 
butcheN18: sits out 
haoyuan541: posts the ante $0.20
Yaaaazz: posts the ante $0.20
wangzhuoming: posts the ante $0.20
matiko09: posts the ante $0.20
Filojoes: posts the ante $0.20
*** HOLE CARDS ***
Dealt to matiko09 [6c Qd]
matiko09: folds 
Filojoes: raises $2 to $3
haoyuan541: folds 
Yaaaazz: folds 
wangzhuoming: folds 
Uncalled bet ($2) returned to Filojoes
Filojoes collected $3.50 from pot
Filojoes: doesn't show hand 
*** SUMMARY ***
Total pot $3.50 | Rake $0 
Seat 2: haoyuan541 (button) folded before Flop (didn't bet)
Seat 3: Yaaaazz (small blind) folded before Flop
Seat 4: wangzhuoming (big blind) folded before Flop
Seat 6: matiko09 folded before Flop (didn't bet)
Seat 7: Filojoes collected ($3.50)





PokerStars Hand #151942918618:  Hold'em No Limit ($1/$2 USD) - 2016/04/15 13:38:14 CET [2016/04/15 7:38:14 ET]
Table 'Irmgard II' 9-max Seat #8 is the button
Seat 1: Iggso ($237.21 in chips) 
Seat 2: Kukuryzka ($200 in chips) 
Seat 3: matiko09 ($200 in chips) 
Seat 5: vezunchik79 ($245.80 in chips) 
Seat 6: djammusic ($142.25 in chips) 
Seat 7: erfk1958 ($119.20 in chips) 
Seat 8: MoeAA11 ($111.30 in chips) 
Seat 9: maximax04 ($90.80 in chips) 
maximax04: posts small blind $1
Iggso: posts big blind $2
*** HOLE CARDS ***
Dealt to matiko09 [Jc 2s]
Kukuryzka: folds 
matiko09: folds 
vezunchik79 is disconnected 
vezunchik79 has timed out while disconnected
vezunchik79: folds 
djammusic: folds 
erfk1958: raises $2 to $4
MoeAA11: calls $4
maximax04: calls $3
Iggso: folds 
*** FLOP *** [8s 6h 4s]
maximax04: checks 
erfk1958: checks 
MoeAA11: checks 
*** TURN *** [8s 6h 4s] [5c]
maximax04: checks 
erfk1958: checks 
MoeAA11: checks 
*** RIVER *** [8s 6h 4s 5c] [Ah]
maximax04: bets $13.30
erfk1958: calls $13.30
MoeAA11: folds 
*** SHOW DOWN ***
maximax04: shows [6s 7d] (a straight, Four to Eight)
erfk1958: mucks hand 
maximax04 collected $38.57 from pot
*** SUMMARY ***
Total pot $40.60 | Rake $2.03 
Board [8s 6h 4s 5c Ah]
Seat 1: Iggso (big blind) folded before Flop
Seat 2: Kukuryzka folded before Flop (didn't bet)
Seat 3: matiko09 folded before Flop (didn't bet)
Seat 5: vezunchik79 folded before Flop (didn't bet)
Seat 6: djammusic folded before Flop (didn't bet)
Seat 7: erfk1958 mucked [Ad 5d]
Seat 8: MoeAA11 (button) folded on the River
Seat 9: maximax04 (small blind) showed [6s 7d] and won ($38.57) with a straight, Four to Eight





PokerStars Hand #151942923144:  Hold'em No Limit ($0.50/$1.00 USD) - 2016/04/15 13:38:23 CET [2016/04/15 7:38:23 ET]
Table 'Navi' 9-max Seat #6 is the button
Seat 1: tipner ($102.47 in chips) 
Seat 3: aseban11 ($100.28 in chips) 
Seat 4: Effort92 ($153.88 in chips) 
Seat 5: hammerwife ($105.82 in chips) 
Seat 6: Glushchenko ($106.16 in chips) 
Seat 7: yoshidao ($124.97 in chips) 
Seat 8: djammusic ($41.50 in chips) 
Seat 9: matiko09 ($130.95 in chips) 
yoshidao: posts small blind $0.50
djammusic: posts big blind $1
butcheN18: sits out 
*** HOLE CARDS ***
Dealt to matiko09 [As Ac]
matiko09: raises $2 to $3
tipner: folds 
aseban11: folds 
Effort92: folds 
hammerwife: folds 
Glushchenko: folds 
yoshidao: folds 
djammusic: calls $2
*** FLOP *** [Qs 6s 9c]
djammusic: checks 
matiko09: bets $5
djammusic: calls $5
*** TURN *** [Qs 6s 9c] [2c]
djammusic: checks 
matiko09: bets $13
djammusic: folds 
Uncalled bet ($13) returned to matiko09
matiko09 collected $15.68 from pot
matiko09: doesn't show hand 
*** SUMMARY ***
Total pot $16.50 | Rake $0.82 
Board [Qs 6s 9c 2c]
Seat 1: tipner folded before Flop (didn't bet)
Seat 3: aseban11 folded before Flop (didn't bet)
Seat 4: Effort92 folded before Flop (didn't bet)
Seat 5: hammerwife folded before Flop (didn't bet)
Seat 6: Glushchenko (button) folded before Flop (didn't bet)
Seat 7: yoshidao (small blind) folded before Flop
Seat 8: djammusic (big blind) folded on the Turn
Seat 9: matiko09 collected ($15.68)





PokerStars Hand #151942925142:  Hold'em No Limit ($1/$2 USD) - 2016/04/15 13:38:27 CET [2016/04/15 7:38:27 ET]
Table 'Patroclus II' 9-max Seat #4 is the button
Seat 1: TonnaMunz ($201.04 in chips) 
Seat 2: Moemors ($200.43 in chips) 
Seat 3: Koolniknik ($305.29 in chips) 
Seat 4: tipner ($200 in chips) 
Seat 5: butcheN18 ($248.29 in chips) 
Seat 7: matiko09 ($243.76 in chips) 
Seat 8: Glushchenko ($200 in chips) 
Seat 9: Fish4trips ($235.92 in chips) 
butcheN18: posts small blind $1
matiko09: posts big blind $2
*** HOLE CARDS ***
Dealt to matiko09 [Tc Ts]
Glushchenko: raises $4 to $6
Fish4trips: folds 
TonnaMunz: calls $6
Moemors: folds 
Koolniknik: folds 
tipner: folds 
butcheN18: folds 
matiko09: calls $4
*** FLOP *** [9h Qh 7s]
matiko09: checks 
Glushchenko: checks 
TonnaMunz: checks 
*** TURN *** [9h Qh 7s] [6s]
matiko09: checks 
Glushchenko: bets $12.03
TonnaMunz: folds 
matiko09: calls $12.03
*** RIVER *** [9h Qh 7s 6s] [Td]
matiko09: checks 
Glushchenko: checks 
*** SHOW DOWN ***
matiko09: shows [Tc Ts] (three of a kind, Tens)
Glushchenko: mucks hand 
matiko09 collected $40.91 from pot
*** SUMMARY ***
Total pot $43.06 | Rake $2.15 
Board [9h Qh 7s 6s Td]
Seat 1: TonnaMunz folded on the Turn
Seat 2: Moemors folded before Flop (didn't bet)
Seat 3: Koolniknik folded before Flop (didn't bet)
Seat 4: tipner (button) folded before Flop (didn't bet)
Seat 5: butcheN18 (small blind) folded before Flop
Seat 7: matiko09 (big blind) showed [Tc Ts] and won ($40.91) with three of a kind, Tens
Seat 8: Glushchenko mucked [As Qd]
Seat 9: Fish4trips folded before Flop (didn't bet)





PokerStars Hand #151942929936:  Hold'em No Limit ($0.50/$1.00 USD) - 2016/04/15 13:38:37 CET [2016/04/15 7:38:37 ET]
Table 'Katja II' 9-max Seat #7 is the button
Seat 3: matiko09 ($135.62 in chips) 
Seat 4: Sutt_420 ($86.62 in chips) 
Seat 5: djammusic ($40 in chips) 
Seat 6: ASG2016 ($111.52 in chips) 
Seat 7: Effort92 ($104.50 in chips) 
Seat 8: Glushchenko ($144.01 in chips) 
Seat 9: Dachish ($106.39 in chips) 
Glushchenko: posts small blind $0.50
Dachish: posts big blind $1
*** HOLE CARDS ***
Dealt to matiko09 [Qh 3s]
matiko09: folds 
Sutt_420: folds 
djammusic: folds 
ASG2016: folds 
Effort92: folds 
Glushchenko: folds 
Uncalled bet ($0.50) returned to Dachish
Dachish collected $1 from pot
Dachish: doesn't show hand 
*** SUMMARY ***
Total pot $1 | Rake $0 
Seat 3: matiko09 folded before Flop (didn't bet)
Seat 4: Sutt_420 folded before Flop (didn't bet)
Seat 5: djammusic folded before Flop (didn't bet)
Seat 6: ASG2016 folded before Flop (didn't bet)
Seat 7: Effort92 (button) folded before Flop (didn't bet)
Seat 8: Glushchenko (small blind) folded before Flop
Seat 9: Dachish (big blind) collected ($1)





PokerStars Hand #151942931358:  Hold'em No Limit ($0.50/$1.00 USD) - 2016/04/15 13:38:39 CET [2016/04/15 7:38:39 ET]
Table 'Adelgunde III' 9-max Seat #9 is the button
Seat 1: valimiu ($47.34 in chips) 
Seat 2: djammusic ($40 in chips) 
Seat 3: tipner ($100 in chips) 
Seat 4: hammerwife ($100 in chips) 
Seat 5: matiko09 ($158.36 in chips) 
Seat 6: Pominator92 ($140.40 in chips) 
Seat 7: Yaaaazz ($100 in chips) 
Seat 8: aseban11 ($100 in chips) 
Seat 9: Kukuryzka ($100 in chips) 
valimiu: posts small blind $0.50
djammusic: posts big blind $1
*** HOLE CARDS ***
Dealt to matiko09 [Ks Qd]
tipner: folds 
hammerwife: folds 
matiko09: raises $2 to $3
Pominator92: raises $5 to $8
Yaaaazz: folds 
aseban11: calls $8
Kukuryzka: folds 
valimiu: folds 
djammusic: folds 
matiko09: folds 
*** FLOP *** [8c Qh 8h]
Pominator92: bets $12
aseban11: folds 
Uncalled bet ($12) returned to Pominator92
Pominator92 collected $19.48 from pot
Pominator92: doesn't show hand 
*** SUMMARY ***
Total pot $20.50 | Rake $1.02 
Board [8c Qh 8h]
Seat 1: valimiu (small blind) folded before Flop
Seat 2: djammusic (big blind) folded before Flop
Seat 3: tipner folded before Flop (didn't bet)
Seat 4: hammerwife folded before Flop (didn't bet)
Seat 5: matiko09 folded before Flop
Seat 6: Pominator92 collected ($19.48)
Seat 7: Yaaaazz folded before Flop (didn't bet)
Seat 8: aseban11 folded on the Flop
Seat 9: Kukuryzka (button) folded before Flop (didn't bet)





PokerStars Hand #151942931049:  Hold'em No Limit ($0.50/$1.00 USD) - 2016/04/15 13:38:39 CET [2016/04/15 7:38:39 ET]
Table 'Parvulesco II' 9-max Seat #7 is the button
Seat 1: bilukm ($27.19 in chips) 
Seat 2: Filojoes ($121.08 in chips) 
Seat 3: matiko09 ($100 in chips) 
Seat 5: bronbeek ($92.51 in chips) 
Seat 7: Kukuryzka ($130.05 in chips) 
Seat 8: Jimy Tiltman ($114.20 in chips) 
Seat 9: hammerwife ($197.50 in chips) 
Jimy Tiltman: posts small blind $0.50
hammerwife: posts big blind $1
butcheN18: sits out 
*** HOLE CARDS ***
Dealt to matiko09 [8d Jc]
bilukm: calls $1
Filojoes: folds 
matiko09: folds 
bronbeek: folds 
Kukuryzka: raises $3 to $4
Jimy Tiltman: folds 
hammerwife: folds 
bilukm: calls $3
*** FLOP *** [Kd Qc 4d]
bilukm: bets $2
Kukuryzka: raises $5 to $7
bilukm: calls $5
*** TURN *** [Kd Qc 4d] [Ks]
bilukm: checks 
Kukuryzka: checks 
*** RIVER *** [Kd Qc 4d Ks] [7s]
bilukm: checks 
Kukuryzka: checks 
*** SHOW DOWN ***
bilukm: shows [9h Qs] (two pair, Kings and Queens)
Kukuryzka: mucks hand 
bilukm collected $22.32 from pot
*** SUMMARY ***
Total pot $23.50 | Rake $1.18 
Board [Kd Qc 4d Ks 7s]
Seat 1: bilukm showed [9h Qs] and won ($22.32) with two pair, Kings and Queens
Seat 2: Filojoes folded before Flop (didn't bet)
Seat 3: matiko09 folded before Flop (didn't bet)
Seat 5: bronbeek folded before Flop (didn't bet)
Seat 7: Kukuryzka (button) mucked [9c Jd]
Seat 8: Jimy Tiltman (small blind) folded before Flop
Seat 9: hammerwife (big blind) folded before Flop





PokerStars Hand #151942936212:  Hold'em No Limit ($0.50/$1.00 USD) - 2016/04/15 13:38:49 CET [2016/04/15 7:38:49 ET]
Table 'Matterania III' 9-max Seat #3 is the button
Seat 2: haoyuan541 ($97.42 in chips) 
Seat 3: Yaaaazz ($109.38 in chips) 
Seat 4: wangzhuoming ($71.73 in chips) 
Seat 6: matiko09 ($100.94 in chips) 
Seat 7: Filojoes ($102.30 in chips) 
wangzhuoming: posts small blind $0.50
matiko09: posts big blind $1
maxxmeister: sits out 
butcheN18: sits out 
haoyuan541: posts the ante $0.20
Yaaaazz: posts the ante $0.20
wangzhuoming: posts the ante $0.20
matiko09: posts the ante $0.20
Filojoes: posts the ante $0.20
*** HOLE CARDS ***
Dealt to matiko09 [Ad 5s]
Filojoes: folds 
haoyuan541: folds 
Yaaaazz: folds 
wangzhuoming: folds 
Uncalled bet ($0.50) returned to matiko09
matiko09 collected $2 from pot
matiko09: doesn't show hand 
*** SUMMARY ***
Total pot $2 | Rake $0 
Seat 2: haoyuan541 folded before Flop (didn't bet)
Seat 3: Yaaaazz (button) folded before Flop (didn't bet)
Seat 4: wangzhuoming (small blind) folded before Flop
Seat 6: matiko09 (big blind) collected ($2)
Seat 7: Filojoes folded before Flop (didn't bet)





PokerStars Hand #151942940966:  Hold'em No Limit ($0.50/$1.00 USD) - 2016/04/15 13:38:59 CET [2016/04/15 7:38:59 ET]
Table 'Matterania III' 9-max Seat #4 is the button
Seat 2: haoyuan541 ($97.22 in chips) 
Seat 3: Yaaaazz ($109.18 in chips) 
Seat 4: wangzhuoming ($71.03 in chips) 
Seat 6: matiko09 ($102.24 in chips) 
Seat 8: maxxmeister ($124.27 in chips) 
matiko09: posts small blind $0.50
Filojoes: is sitting out 
maxxmeister: posts big blind $1
Filojoes leaves the table
butcheN18: sits out 
haoyuan541: posts the ante $0.20
Yaaaazz: posts the ante $0.20
wangzhuoming: posts the ante $0.20
matiko09: posts the ante $0.20
maxxmeister: posts the ante $0.20
*** HOLE CARDS ***
Dealt to matiko09 [6d 3c]
haoyuan541: raises $1 to $2
Yaaaazz: folds 
wangzhuoming: folds 
matiko09: folds 
maxxmeister: raises $6 to $8
haoyuan541: folds 
Uncalled bet ($6) returned to maxxmeister
maxxmeister collected $5.50 from pot
maxxmeister: doesn't show hand 
*** SUMMARY ***
Total pot $5.50 | Rake $0 
Seat 2: haoyuan541 folded before Flop
Seat 3: Yaaaazz folded before Flop (didn't bet)
Seat 4: wangzhuoming (button) folded before Flop (didn't bet)
Seat 6: matiko09 (small blind) folded before Flop
Seat 8: maxxmeister (big blind) collected ($5.50)





PokerStars Hand #151942947397:  Hold'em No Limit ($0.50/$1.00 USD) - 2016/04/15 13:39:11 CET [2016/04/15 7:39:11 ET]
Table 'Katja II' 9-max Seat #8 is the button
Seat 3: matiko09 ($135.62 in chips) 
Seat 4: Sutt_420 ($86.62 in chips) 
Seat 5: djammusic ($40 in chips) 
Seat 6: ASG2016 ($111.52 in chips) 
Seat 7: Effort92 ($104.50 in chips) 
Seat 8: Glushchenko ($143.51 in chips) 
Seat 9: Dachish ($106.89 in chips) 
Dachish: posts small blind $0.50
matiko09: posts big blind $1
*** HOLE CARDS ***
Dealt to matiko09 [Th 8c]
Sutt_420: folds 
djammusic: raises $1.15 to $2.15
ASG2016: folds 
Effort92: folds 
Glushchenko: folds 
aseban11 leaves the table
Dachish: folds 
matiko09: folds 
Uncalled bet ($1.15) returned to djammusic
djammusic collected $2.50 from pot
djammusic: doesn't show hand 
*** SUMMARY ***
Total pot $2.50 | Rake $0 
Seat 3: matiko09 (big blind) folded before Flop
Seat 4: Sutt_420 folded before Flop (didn't bet)
Seat 5: djammusic collected ($2.50)
Seat 6: ASG2016 folded before Flop (didn't bet)
Seat 7: Effort92 folded before Flop (didn't bet)
Seat 8: Glushchenko (button) folded before Flop (didn't bet)
Seat 9: Dachish (small blind) folded before Flop





PokerStars Hand #151942947697:  Hold'em No Limit ($1/$2 USD) - 2016/04/15 13:39:12 CET [2016/04/15 7:39:12 ET]
Table 'Oceax' 9-max Seat #7 is the button
Seat 1: matiko09 ($200 in chips) 
Seat 2: Fish4trips ($290.78 in chips) 
Seat 3: Yaaaazz ($204.91 in chips) 
Seat 6: Iggso ($269.50 in chips) 
Seat 7: coinflip_si ($222.25 in chips) 
Seat 8: Poroxide ($207.97 in chips) 
Poroxide: posts small blind $1
matiko09: posts big blind $2
butcheN18: sits out 
*** HOLE CARDS ***
Dealt to matiko09 [9c 9d]
Fish4trips: folds 
Yaaaazz: folds 
Iggso: folds 
coinflip_si: folds 
Poroxide: folds 
Uncalled bet ($1) returned to matiko09
matiko09 collected $2 from pot
matiko09: doesn't show hand 
*** SUMMARY ***
Total pot $2 | Rake $0 
Seat 1: matiko09 (big blind) collected ($2)
Seat 2: Fish4trips folded before Flop (didn't bet)
Seat 3: Yaaaazz folded before Flop (didn't bet)
Seat 6: Iggso folded before Flop (didn't bet)
Seat 7: coinflip_si (button) folded before Flop (didn't bet)
Seat 8: Poroxide (small blind) folded before Flop





PokerStars Hand #151942948614:  Hold'em No Limit ($1/$2 USD) - 2016/04/15 13:39:14 CET [2016/04/15 7:39:14 ET]
Table 'Adele II' 9-max Seat #4 is the button
Seat 1: RyanHuJun ($200 in chips) 
Seat 2: Fish4trips ($408.10 in chips) 
Seat 3: matiko09 ($312.53 in chips) 
Seat 4: Glushchenko ($200 in chips) 
Seat 6: wiseyoyo ($234.93 in chips) 
Seat 7: Iggso ($251.34 in chips) 
Seat 8: docmarc777 ($300 in chips) 
Seat 9: SanychStar ($291.70 in chips) 
wiseyoyo: posts small blind $1
Iggso: posts big blind $2
*** HOLE CARDS ***
Dealt to matiko09 [Th 3d]
docmarc777: folds 
SanychStar: folds 
RyanHuJun: folds 
Fish4trips: raises $3 to $5
matiko09: folds 
Glushchenko: folds 
wiseyoyo: folds 
Iggso: folds 
Uncalled bet ($3) returned to Fish4trips
Fish4trips collected $5 from pot
Fish4trips: doesn't show hand 
*** SUMMARY ***
Total pot $5 | Rake $0 
Seat 1: RyanHuJun folded before Flop (didn't bet)
Seat 2: Fish4trips collected ($5)
Seat 3: matiko09 folded before Flop (didn't bet)
Seat 4: Glushchenko (button) folded before Flop (didn't bet)
Seat 6: wiseyoyo (small blind) folded before Flop
Seat 7: Iggso (big blind) folded before Flop
Seat 8: docmarc777 folded before Flop (didn't bet)
Seat 9: SanychStar folded before Flop (didn't bet)





PokerStars Hand #151942949359:  Hold'em No Limit ($0.50/$1.00 USD) - 2016/04/15 13:39:15 CET [2016/04/15 7:39:15 ET]
Table 'Adelgunde III' 9-max Seat #1 is the button
Seat 1: valimiu ($46.84 in chips) 
Seat 2: djammusic ($39 in chips) 
Seat 3: tipner ($100 in chips) 
Seat 4: hammerwife ($100 in chips) 
Seat 5: matiko09 ($155.36 in chips) 
Seat 6: Pominator92 ($151.88 in chips) 
Seat 7: Yaaaazz ($100 in chips) 
Seat 8: aseban11 ($100 in chips) 
Seat 9: Kukuryzka ($100 in chips) 
djammusic: posts small blind $0.50
tipner: posts big blind $1
*** HOLE CARDS ***
Dealt to matiko09 [Qd 6d]
hammerwife: folds 
matiko09: folds 
Pominator92: folds 
Yaaaazz: folds 
aseban11: raises $2 to $3
Kukuryzka: folds 
valimiu: folds 
djammusic: folds 
tipner: raises $7 to $10
aseban11: calls $7
*** FLOP *** [Qh 7c Kd]
tipner: checks 
aseban11: checks 
*** TURN *** [Qh 7c Kd] [9s]
tipner: checks 
aseban11: bets $14.61
valimiu said, "10J"
tipner: folds 
Uncalled bet ($14.61) returned to aseban11
aseban11 collected $19.48 from pot
aseban11: doesn't show hand 
*** SUMMARY ***
Total pot $20.50 | Rake $1.02 
Board [Qh 7c Kd 9s]
Seat 1: valimiu (button) folded before Flop (didn't bet)
Seat 2: djammusic (small blind) folded before Flop
Seat 3: tipner (big blind) folded on the Turn
Seat 4: hammerwife folded before Flop (didn't bet)
Seat 5: matiko09 folded before Flop (didn't bet)
Seat 6: Pominator92 folded before Flop (didn't bet)
Seat 7: Yaaaazz folded before Flop (didn't bet)
Seat 8: aseban11 collected ($19.48)
Seat 9: Kukuryzka folded before Flop (didn't bet)





PokerStars Hand #151942951780:  Hold'em No Limit ($0.50/$1.00 USD) - 2016/04/15 13:39:20 CET [2016/04/15 7:39:20 ET]
Table 'Matterania III' 9-max Seat #6 is the button
Seat 2: haoyuan541 ($95.02 in chips) 
Seat 3: Yaaaazz ($108.98 in chips) 
Seat 4: wangzhuoming ($70.83 in chips) 
Seat 6: matiko09 ($101.54 in chips) 
Seat 8: maxxmeister ($127.57 in chips) 
Seat 9: butcheN18 ($121.50 in chips) 
maxxmeister: posts small blind $0.50
butcheN18: posts big blind $1
haoyuan541: posts the ante $0.20
Yaaaazz: posts the ante $0.20
wangzhuoming: posts the ante $0.20
matiko09: posts the ante $0.20
maxxmeister: posts the ante $0.20
butcheN18: posts the ante $0.20
*** HOLE CARDS ***
Dealt to matiko09 [Ah Kh]
haoyuan541: raises $1 to $2
Yaaaazz: folds 
wangzhuoming: folds 
matiko09: raises $4 to $6
maxxmeister: folds 
butcheN18: folds 
haoyuan541: calls $4
*** FLOP *** [7s 6c Qc]
haoyuan541: bets $7
matiko09: folds 
Uncalled bet ($7) returned to haoyuan541
haoyuan541 collected $13.96 from pot
*** SUMMARY ***
Total pot $14.70 | Rake $0.74 
Board [7s 6c Qc]
Seat 2: haoyuan541 collected ($13.96)
Seat 3: Yaaaazz folded before Flop (didn't bet)
Seat 4: wangzhuoming folded before Flop (didn't bet)
Seat 6: matiko09 (button) folded on the Flop
Seat 8: maxxmeister (small blind) folded before Flop
Seat 9: butcheN18 (big blind) folded before Flop





PokerStars Hand #151942952824:  Hold'em No Limit ($1/$2 USD) - 2016/04/15 13:39:22 CET [2016/04/15 7:39:22 ET]
Table 'Oceax' 9-max Seat #8 is the button
Seat 1: matiko09 ($201 in chips) 
Seat 2: Fish4trips ($290.78 in chips) 
Seat 3: Yaaaazz ($204.91 in chips) 
Seat 6: Iggso ($269.50 in chips) 
Seat 7: coinflip_si ($222.25 in chips) 
Seat 8: Poroxide ($206.97 in chips) 
matiko09: posts small blind $1
Fish4trips: posts big blind $2
butcheN18: sits out 
*** HOLE CARDS ***
Dealt to matiko09 [8c 5d]
Yaaaazz: folds 
Iggso: folds 
coinflip_si: folds 
Poroxide: folds 
matiko09: folds 
Uncalled bet ($1) returned to Fish4trips
Fish4trips collected $2 from pot
Fish4trips: doesn't show hand 
*** SUMMARY ***
Total pot $2 | Rake $0 
Seat 1: matiko09 (small blind) folded before Flop
Seat 2: Fish4trips (big blind) collected ($2)
Seat 3: Yaaaazz folded before Flop (didn't bet)
Seat 6: Iggso folded before Flop (didn't bet)
Seat 7: coinflip_si folded before Flop (didn't bet)
Seat 8: Poroxide (button) folded before Flop (didn't bet)





PokerStars Hand #151942957679:  Hold'em No Limit ($0.50/$1.00 USD) - 2016/04/15 13:39:32 CET [2016/04/15 7:39:32 ET]
Table 'Emma II' 9-max Seat #2 is the button
Seat 1: Yaaaazz ($120.56 in chips) 
Seat 2: Filojoes ($100 in chips) 
Seat 3: Glushchenko ($230.16 in chips) 
Seat 4: matiko09 ($100 in chips) 
Seat 6: Tirka ($124.52 in chips) 
Seat 8: maxxmeister ($117.43 in chips) 
Seat 9: Foton18 ($105.52 in chips) 
Glushchenko: posts small blind $0.50
matiko09: posts big blind $1
*** HOLE CARDS ***
Dealt to matiko09 [4h Ac]
Tirka: folds 
maxxmeister: folds 
Foton18: folds 
Yaaaazz: folds 
Filojoes: raises $1 to $2
Glushchenko: folds 
matiko09: calls $1
*** FLOP *** [5d 7h 8h]
matiko09: checks 
Filojoes: checks 
*** TURN *** [5d 7h 8h] [Jd]
matiko09: checks 
Filojoes: bets $2.99
matiko09: folds 
Uncalled bet ($2.99) returned to Filojoes
Filojoes collected $4.28 from pot
Filojoes: doesn't show hand 
*** SUMMARY ***
Total pot $4.50 | Rake $0.22 
Board [5d 7h 8h Jd]
Seat 1: Yaaaazz folded before Flop (didn't bet)
Seat 2: Filojoes (button) collected ($4.28)
Seat 3: Glushchenko (small blind) folded before Flop
Seat 4: matiko09 (big blind) folded on the Turn
Seat 6: Tirka folded before Flop (didn't bet)
Seat 8: maxxmeister folded before Flop (didn't bet)
Seat 9: Foton18 folded before Flop (didn't bet)





PokerStars Hand #151942960305:  Hold'em No Limit ($0.50/$1.00 USD) - 2016/04/15 13:39:37 CET [2016/04/15 7:39:37 ET]
Table 'Navi' 9-max Seat #7 is the button
Seat 1: tipner ($102.47 in chips) 
Seat 3: aseban11 ($100.28 in chips) 
Seat 4: Effort92 ($153.88 in chips) 
Seat 5: hammerwife ($105.82 in chips) 
Seat 6: Glushchenko ($106.16 in chips) 
Seat 7: yoshidao ($124.47 in chips) 
Seat 8: djammusic ($40 in chips) 
Seat 9: matiko09 ($138.63 in chips) 
djammusic: posts small blind $0.50
matiko09: posts big blind $1
butcheN18: sits out 
*** HOLE CARDS ***
Dealt to matiko09 [7d 5h]
tipner: raises $2 to $3
aseban11: calls $3
Effort92: folds 
hammerwife: folds 
Glushchenko: calls $3
yoshidao: folds 
djammusic: folds 
matiko09: folds 
*** FLOP *** [2c 2d Qc]
tipner: checks 
aseban11: checks 
Glushchenko: checks 
*** TURN *** [2c 2d Qc] [Th]
tipner: bets $6
aseban11: folds 
Glushchenko: folds 
Uncalled bet ($6) returned to tipner
tipner collected $9.98 from pot
tipner: doesn't show hand 
*** SUMMARY ***
Total pot $10.50 | Rake $0.52 
Board [2c 2d Qc Th]
Seat 1: tipner collected ($9.98)
Seat 3: aseban11 folded on the Turn
Seat 4: Effort92 folded before Flop (didn't bet)
Seat 5: hammerwife folded before Flop (didn't bet)
Seat 6: Glushchenko folded on the Turn
Seat 7: yoshidao (button) folded before Flop (didn't bet)
Seat 8: djammusic (small blind) folded before Flop
Seat 9: matiko09 (big blind) folded before Flop





PokerStars Hand #151942962075:  Hold'em No Limit ($1/$2 USD) - 2016/04/15 13:39:40 CET [2016/04/15 7:39:40 ET]
Table 'Oceax' 9-max Seat #1 is the button
Seat 1: matiko09 ($200 in chips) 
Seat 2: Fish4trips ($291.78 in chips) 
Seat 4: butcheN18 ($239.42 in chips) 
Seat 6: Iggso ($269.50 in chips) 
Seat 7: coinflip_si ($222.25 in chips) 
Seat 8: Poroxide ($206.97 in chips) 
Fish4trips: posts small blind $1
Yaaaazz: is sitting out 
butcheN18: posts big blind $2
*** HOLE CARDS ***
Dealt to matiko09 [Th 8c]
Iggso: folds 
coinflip_si: folds 
Poroxide: folds 
Yaaaazz leaves the table
matiko09: folds 
Fish4trips: folds 
Uncalled bet ($1) returned to butcheN18
butcheN18 collected $2 from pot
butcheN18: doesn't show hand 
*** SUMMARY ***
Total pot $2 | Rake $0 
Seat 1: matiko09 (button) folded before Flop (didn't bet)
Seat 2: Fish4trips (small blind) folded before Flop
Seat 4: butcheN18 (big blind) collected ($2)
Seat 6: Iggso folded before Flop (didn't bet)
Seat 7: coinflip_si folded before Flop (didn't bet)
Seat 8: Poroxide folded before Flop (didn't bet)





PokerStars Hand #151942962351:  Hold'em No Limit ($1/$2 USD) - 2016/04/15 13:39:41 CET [2016/04/15 7:39:41 ET]
Table 'Adele II' 9-max Seat #6 is the button
Seat 1: RyanHuJun ($200 in chips) 
Seat 2: Fish4trips ($411.10 in chips) 
Seat 3: matiko09 ($312.53 in chips) 
Seat 4: Glushchenko ($200 in chips) 
Seat 6: wiseyoyo ($233.93 in chips) 
Seat 7: Iggso ($249.34 in chips) 
Seat 8: docmarc777 ($300 in chips) 
Seat 9: SanychStar ($291.70 in chips) 
Iggso: posts small blind $1
docmarc777: posts big blind $2
*** HOLE CARDS ***
Dealt to matiko09 [6c 5d]
SanychStar: folds 
RyanHuJun: calls $2
Fish4trips: folds 
matiko09: folds 
Glushchenko: folds 
wiseyoyo: folds 
Iggso: raises $7 to $9
docmarc777: folds 
RyanHuJun: calls $7
*** FLOP *** [4s 4c 7h]
Iggso: bets $9.50
RyanHuJun: calls $9.50
*** TURN *** [4s 4c 7h] [4d]
Iggso: checks 
RyanHuJun: bets $24
Iggso: calls $24
*** RIVER *** [4s 4c 7h 4d] [6s]
Iggso: checks 
RyanHuJun: checks 
*** SHOW DOWN ***
Iggso: shows [As 2s] (three of a kind, Fours)
RyanHuJun: shows [2d 2c] (a full house, Fours full of Deuces)
RyanHuJun collected $84.25 from pot
*** SUMMARY ***
Total pot $87 | Rake $2.75 
Board [4s 4c 7h 4d 6s]
Seat 1: RyanHuJun showed [2d 2c] and won ($84.25) with a full house, Fours full of Deuces
Seat 2: Fish4trips folded before Flop (didn't bet)
Seat 3: matiko09 folded before Flop (didn't bet)
Seat 4: Glushchenko folded before Flop (didn't bet)
Seat 6: wiseyoyo (button) folded before Flop (didn't bet)
Seat 7: Iggso (small blind) showed [As 2s] and lost with three of a kind, Fours
Seat 8: docmarc777 (big blind) folded before Flop
Seat 9: SanychStar folded before Flop (didn't bet)





PokerStars Hand #151942962527:  Hold'em No Limit ($1/$2 USD) - 2016/04/15 13:39:41 CET [2016/04/15 7:39:41 ET]
Table 'Irmgard II' 9-max Seat #9 is the button
Seat 1: Iggso ($235.21 in chips) 
Seat 2: Kukuryzka ($200 in chips) 
Seat 3: matiko09 ($200 in chips) 
Seat 6: djammusic ($142.25 in chips) 
Seat 7: erfk1958 ($101.90 in chips) 
Seat 8: MoeAA11 ($107.30 in chips) 
Seat 9: maximax04 ($112.07 in chips) 
Iggso: posts small blind $1
Kukuryzka: posts big blind $2
*** HOLE CARDS ***
Dealt to matiko09 [Kh 3s]
matiko09: folds 
djammusic: folds 
erfk1958: folds 
MoeAA11: raises $6 to $8
maximax04: calls $8
Iggso: folds 
Kukuryzka: folds 
*** FLOP *** [Td Jc 4h]
MoeAA11: bets $6
maximax04: calls $6
*** TURN *** [Td Jc 4h] [9c]
MoeAA11: bets $8
maximax04: calls $8
*** RIVER *** [Td Jc 4h 9c] [4s]
MoeAA11: checks 
maximax04: checks 
*** SHOW DOWN ***
MoeAA11: shows [Kd Ah] (a pair of Fours)
maximax04: shows [Qc Tc] (two pair, Tens and Fours)
maximax04 collected $44.65 from pot
*** SUMMARY ***
Total pot $47 | Rake $2.35 
Board [Td Jc 4h 9c 4s]
Seat 1: Iggso (small blind) folded before Flop
Seat 2: Kukuryzka (big blind) folded before Flop
Seat 3: matiko09 folded before Flop (didn't bet)
Seat 6: djammusic folded before Flop (didn't bet)
Seat 7: erfk1958 folded before Flop (didn't bet)
Seat 8: MoeAA11 showed [Kd Ah] and lost with a pair of Fours
Seat 9: maximax04 (button) showed [Qc Tc] and won ($44.65) with two pair, Tens and Fours





PokerStars Hand #151942963651:  Hold'em No Limit ($0.50/$1.00 USD) - 2016/04/15 13:39:43 CET [2016/04/15 7:39:43 ET]
Table 'Katja II' 9-max Seat #9 is the button
Seat 3: matiko09 ($134.62 in chips) 
Seat 4: Sutt_420 ($86.62 in chips) 
Seat 5: djammusic ($41.50 in chips) 
Seat 6: ASG2016 ($111.52 in chips) 
Seat 7: Effort92 ($104.50 in chips) 
Seat 8: Glushchenko ($143.51 in chips) 
Seat 9: Dachish ($106.39 in chips) 
matiko09: posts small blind $0.50
Sutt_420: posts big blind $1
*** HOLE CARDS ***
Dealt to matiko09 [7h 2s]
djammusic: folds 
ASG2016: folds 
Effort92: raises $1.50 to $2.50
Glushchenko: folds 
Dachish: folds 
matiko09: folds 
Sutt_420: folds 
Uncalled bet ($1.50) returned to Effort92
Effort92 collected $2.50 from pot
Effort92: doesn't show hand 
*** SUMMARY ***
Total pot $2.50 | Rake $0 
Seat 3: matiko09 (small blind) folded before Flop
Seat 4: Sutt_420 (big blind) folded before Flop
Seat 5: djammusic folded before Flop (didn't bet)
Seat 6: ASG2016 folded before Flop (didn't bet)
Seat 7: Effort92 collected ($2.50)
Seat 8: Glushchenko folded before Flop (didn't bet)
Seat 9: Dachish (button) folded before Flop (didn't bet)





PokerStars Hand #151942964441:  Hold'em No Limit ($0.50/$1.00 USD) - 2016/04/15 13:39:45 CET [2016/04/15 7:39:45 ET]
Table 'Parvulesco II' 9-max Seat #8 is the button
Seat 1: bilukm ($38.51 in chips) 
Seat 2: Filojoes ($121.08 in chips) 
Seat 3: matiko09 ($100 in chips) 
Seat 5: bronbeek ($92.51 in chips) 
Seat 7: Kukuryzka ($119.05 in chips) 
Seat 8: Jimy Tiltman ($113.70 in chips) 
Seat 9: hammerwife ($196.50 in chips) 
hammerwife: posts small blind $0.50
bilukm: posts big blind $1
butcheN18: sits out 
*** HOLE CARDS ***
Dealt to matiko09 [As Qh]
Filojoes: raises $2 to $3
matiko09: raises $7 to $10
bronbeek: folds 
Kukuryzka: folds 
Jimy Tiltman: folds 
hammerwife: folds 
bilukm: folds 
Filojoes: folds 
Uncalled bet ($7) returned to matiko09
matiko09 collected $7.50 from pot
matiko09: doesn't show hand 
*** SUMMARY ***
Total pot $7.50 | Rake $0 
Seat 1: bilukm (big blind) folded before Flop
Seat 2: Filojoes folded before Flop
Seat 3: matiko09 collected ($7.50)
Seat 5: bronbeek folded before Flop (didn't bet)
Seat 7: Kukuryzka folded before Flop (didn't bet)
Seat 8: Jimy Tiltman (button) folded before Flop (didn't bet)
Seat 9: hammerwife (small blind) folded before Flop





PokerStars Hand #151942969260:  Hold'em No Limit ($1/$2 USD) - 2016/04/15 13:39:54 CET [2016/04/15 7:39:54 ET]
Table 'Oceax' 9-max Seat #2 is the button
Seat 1: matiko09 ($200 in chips) 
Seat 2: Fish4trips ($290.78 in chips) 
Seat 4: butcheN18 ($240.42 in chips) 
Seat 6: Iggso ($269.50 in chips) 
Seat 7: coinflip_si ($222.25 in chips) 
Seat 8: Poroxide ($206.97 in chips) 
butcheN18: posts small blind $1
Iggso: posts big blind $2
*** HOLE CARDS ***
Dealt to matiko09 [Qc Ac]
coinflip_si: folds 
Poroxide: folds 
matiko09: raises $3 to $5
Fish4trips: raises $10 to $15
butcheN18: folds 
Iggso: folds 
matiko09: calls $10
*** FLOP *** [5s Ks Jc]
matiko09: checks 
Fish4trips: checks 
*** TURN *** [5s Ks Jc] [2d]
matiko09: bets $18
Fish4trips: calls $18
*** RIVER *** [5s Ks Jc 2d] [3c]
GB223 joins the table at seat #3 
matiko09: checks 
Fish4trips: checks 
*** SHOW DOWN ***
matiko09: shows [Qc Ac] (high card Ace)
Fish4trips: shows [9d Jd] (a pair of Jacks)
Fish4trips collected $66.25 from pot
*** SUMMARY ***
Total pot $69 | Rake $2.75 
Board [5s Ks Jc 2d 3c]
Seat 1: matiko09 showed [Qc Ac] and lost with high card Ace
Seat 2: Fish4trips (button) showed [9d Jd] and won ($66.25) with a pair of Jacks
Seat 4: butcheN18 (small blind) folded before Flop
Seat 6: Iggso (big blind) folded before Flop
Seat 7: coinflip_si folded before Flop (didn't bet)
Seat 8: Poroxide folded before Flop (didn't bet)





PokerStars Hand #151942971422:  Hold'em No Limit ($0.50/$1.00 USD) - 2016/04/15 13:39:59 CET [2016/04/15 7:39:59 ET]
Table 'Matterania III' 9-max Seat #8 is the button
Seat 2: haoyuan541 ($102.78 in chips) 
Seat 3: Yaaaazz ($108.78 in chips) 
Seat 4: wangzhuoming ($70.63 in chips) 
Seat 6: matiko09 ($100 in chips) 
Seat 8: maxxmeister ($126.87 in chips) 
Seat 9: butcheN18 ($120.30 in chips) 
butcheN18: posts small blind $0.50
haoyuan541: posts big blind $1
haoyuan541: posts the ante $0.20
Yaaaazz: posts the ante $0.20
wangzhuoming: posts the ante $0.20
matiko09: posts the ante $0.20
maxxmeister: posts the ante $0.20
butcheN18: posts the ante $0.20
*** HOLE CARDS ***
Dealt to matiko09 [Td 3c]
Yaaaazz: folds 
wangzhuoming: folds 
matiko09: folds 
maxxmeister: raises $2 to $3
butcheN18: folds 
haoyuan541: folds 
Uncalled bet ($2) returned to maxxmeister
maxxmeister collected $3.70 from pot
maxxmeister: doesn't show hand 
*** SUMMARY ***
Total pot $3.70 | Rake $0 
Seat 2: haoyuan541 (big blind) folded before Flop
Seat 3: Yaaaazz folded before Flop (didn't bet)
Seat 4: wangzhuoming folded before Flop (didn't bet)
Seat 6: matiko09 folded before Flop (didn't bet)
Seat 8: maxxmeister (button) collected ($3.70)
Seat 9: butcheN18 (small blind) folded before Flop





PokerStars Hand #151942974613:  Hold'em No Limit ($0.50/$1.00 USD) - 2016/04/15 13:40:05 CET [2016/04/15 7:40:05 ET]
Table 'Parvulesco II' 9-max Seat #9 is the button
Seat 1: bilukm ($37.51 in chips) 
Seat 2: Filojoes ($118.08 in chips) 
Seat 3: matiko09 ($104.50 in chips) 
Seat 5: bronbeek ($92.51 in chips) 
Seat 7: Kukuryzka ($119.05 in chips) 
Seat 8: Jimy Tiltman ($113.70 in chips) 
Seat 9: hammerwife ($196 in chips) 
bilukm: posts small blind $0.50
Filojoes: posts big blind $1
butcheN18: sits out 
*** HOLE CARDS ***
Dealt to matiko09 [7c Qh]
matiko09: folds 
bronbeek: folds 
Kukuryzka: folds 
Jimy Tiltman: folds 
hammerwife: raises $1.01 to $2.01
bilukm is disconnected 
bilukm is connected 
bilukm: calls $1.51
Filojoes: calls $1.01
*** FLOP *** [9c 9d 8s]
bilukm: bets $2.86
Filojoes: folds 
hammerwife: calls $2.86
*** TURN *** [9c 9d 8s] [3s]
bilukm: bets $5.58
ruslik_by joins the table at seat #6 
hammerwife: calls $5.58
*** RIVER *** [9c 9d 8s 3s] [Ts]
bilukm: bets $1
hammerwife: calls $1
*** SHOW DOWN ***
bilukm: shows [8h 6d] (two pair, Nines and Eights)
hammerwife: shows [Kc Kd] (two pair, Kings and Nines)
hammerwife collected $23.66 from pot
*** SUMMARY ***
Total pot $24.91 | Rake $1.25 
Board [9c 9d 8s 3s Ts]
Seat 1: bilukm (small blind) showed [8h 6d] and lost with two pair, Nines and Eights
Seat 2: Filojoes (big blind) folded on the Flop
Seat 3: matiko09 folded before Flop (didn't bet)
Seat 5: bronbeek folded before Flop (didn't bet)
Seat 7: Kukuryzka folded before Flop (didn't bet)
Seat 8: Jimy Tiltman folded before Flop (didn't bet)
Seat 9: hammerwife (button) showed [Kc Kd] and won ($23.66) with two pair, Kings and Nines





PokerStars Hand #151942975481:  Hold'em No Limit ($1/$2 USD) - 2016/04/15 13:40:07 CET [2016/04/15 7:40:07 ET]
Table 'Patroclus II' 9-max Seat #5 is the button
Seat 1: TonnaMunz ($200 in chips) 
Seat 2: Moemors ($200.43 in chips) 
Seat 3: Koolniknik ($305.29 in chips) 
Seat 4: tipner ($200 in chips) 
Seat 5: butcheN18 ($247.29 in chips) 
Seat 7: matiko09 ($266.64 in chips) 
Seat 8: Glushchenko ($200 in chips) 
Seat 9: Fish4trips ($235.92 in chips) 
matiko09: posts small blind $1
Glushchenko: posts big blind $2
*** HOLE CARDS ***
Dealt to matiko09 [As Qc]
Fish4trips: folds 
TonnaMunz: folds 
Moemors: folds 
Koolniknik: raises $4 to $6
tipner: folds 
butcheN18: folds 
matiko09: raises $14 to $20
Glushchenko: calls $18
Koolniknik: calls $14
*** FLOP *** [8s 3s 4s]
matiko09: bets $32
Glushchenko: folds 
Koolniknik: folds 
Uncalled bet ($32) returned to matiko09
matiko09 collected $57.25 from pot
matiko09: doesn't show hand 
*** SUMMARY ***
Total pot $60 | Rake $2.75 
Board [8s 3s 4s]
Seat 1: TonnaMunz folded before Flop (didn't bet)
Seat 2: Moemors folded before Flop (didn't bet)
Seat 3: Koolniknik folded on the Flop
Seat 4: tipner folded before Flop (didn't bet)
Seat 5: butcheN18 (button) folded before Flop (didn't bet)
Seat 7: matiko09 (small blind) collected ($57.25)
Seat 8: Glushchenko (big blind) folded on the Flop
Seat 9: Fish4trips folded before Flop (didn't bet)





PokerStars Hand #151942982364:  Hold'em No Limit ($0.50/$1.00 USD) - 2016/04/15 13:40:21 CET [2016/04/15 7:40:21 ET]
Table 'Katja II' 9-max Seat #3 is the button
Seat 3: matiko09 ($134.12 in chips) 
Seat 4: Sutt_420 ($85.62 in chips) 
Seat 6: ASG2016 ($111.52 in chips) 
Seat 7: Effort92 ($106 in chips) 
Seat 8: Glushchenko ($143.51 in chips) 
Seat 9: Dachish ($106.39 in chips) 
Sutt_420: posts small blind $0.50
djammusic: is sitting out 
ASG2016: posts big blind $1
*** HOLE CARDS ***
Dealt to matiko09 [5s Ah]
Effort92: folds 
Glushchenko: folds 
Dachish: raises $2 to $3
matiko09: folds 
Sutt_420: folds 
ASG2016: folds 
Uncalled bet ($2) returned to Dachish
Dachish collected $2.50 from pot
Dachish: doesn't show hand 
*** SUMMARY ***
Total pot $2.50 | Rake $0 
Seat 3: matiko09 (button) folded before Flop (didn't bet)
Seat 4: Sutt_420 (small blind) folded before Flop
Seat 6: ASG2016 (big blind) folded before Flop
Seat 7: Effort92 folded before Flop (didn't bet)
Seat 8: Glushchenko folded before Flop (didn't bet)
Seat 9: Dachish collected ($2.50)





PokerStars Hand #151942982694:  Hold'em No Limit ($0.50/$1.00 USD) - 2016/04/15 13:40:22 CET [2016/04/15 7:40:22 ET]
Table 'Matterania III' 9-max Seat #9 is the button
Seat 2: haoyuan541 ($101.58 in chips) 
Seat 4: wangzhuoming ($70.43 in chips) 
Seat 6: matiko09 ($100 in chips) 
Seat 8: maxxmeister ($129.37 in chips) 
Seat 9: butcheN18 ($119.60 in chips) 
haoyuan541: posts small blind $0.50
Yaaaazz: is sitting out 
wangzhuoming: posts big blind $1
haoyuan541: posts the ante $0.20
wangzhuoming: posts the ante $0.20
matiko09: posts the ante $0.20
maxxmeister: posts the ante $0.20
butcheN18: posts the ante $0.20
*** HOLE CARDS ***
Dealt to matiko09 [7h Td]
matiko09: folds 
maxxmeister: raises $2.50 to $3.50
butcheN18: folds 
haoyuan541: folds 
wangzhuoming: folds 
Uncalled bet ($2.50) returned to maxxmeister
maxxmeister collected $3.50 from pot
maxxmeister: doesn't show hand 
*** SUMMARY ***
Total pot $3.50 | Rake $0 
Seat 2: haoyuan541 (small blind) folded before Flop
Seat 4: wangzhuoming (big blind) folded before Flop
Seat 6: matiko09 folded before Flop (didn't bet)
Seat 8: maxxmeister collected ($3.50)
Seat 9: butcheN18 (button) folded before Flop (didn't bet)





PokerStars Hand #151942988451:  Hold'em No Limit ($1/$2 USD) - 2016/04/15 13:40:33 CET [2016/04/15 7:40:33 ET]
Table 'Irmgard II' 9-max Seat #1 is the button
Seat 1: Iggso ($234.21 in chips) 
Seat 2: Kukuryzka ($198 in chips) 
Seat 3: matiko09 ($200 in chips) 
Seat 6: djammusic ($142.25 in chips) 
Seat 7: erfk1958 ($101.90 in chips) 
Seat 8: MoeAA11 ($85.30 in chips) 
Seat 9: maximax04 ($134.72 in chips) 
Kukuryzka: posts small blind $1
matiko09: posts big blind $2
*** HOLE CARDS ***
Dealt to matiko09 [Ad 9c]
djammusic: folds 
erfk1958: raises $2 to $4
MoeAA11: folds 
maximax04: calls $4
Iggso: folds 
Kukuryzka: folds 
matiko09: calls $2
*** FLOP *** [2d Qd As]
matiko09: checks 
erfk1958: checks 
maximax04: checks 
*** TURN *** [2d Qd As] [7h]
matiko09: bets $8.03
erfk1958: folds 
maximax04: folds 
Uncalled bet ($8.03) returned to matiko09
matiko09 collected $12.35 from pot
matiko09: doesn't show hand 
*** SUMMARY ***
Total pot $13 | Rake $0.65 
Board [2d Qd As 7h]
Seat 1: Iggso (button) folded before Flop (didn't bet)
Seat 2: Kukuryzka (small blind) folded before Flop
Seat 3: matiko09 (big blind) collected ($12.35)
Seat 6: djammusic folded before Flop (didn't bet)
Seat 7: erfk1958 folded on the Turn
Seat 8: MoeAA11 folded before Flop (didn't bet)
Seat 9: maximax04 folded on the Turn





PokerStars Hand #151942990766:  Hold'em No Limit ($0.50/$1.00 USD) - 2016/04/15 13:40:38 CET [2016/04/15 7:40:38 ET]
Table 'Emma II' 9-max Seat #3 is the button
Seat 1: Yaaaazz ($120.56 in chips) 
Seat 2: Filojoes ($102.28 in chips) 
Seat 3: Glushchenko ($229.66 in chips) 
Seat 4: matiko09 ($100 in chips) 
Seat 6: Tirka ($124.52 in chips) 
Seat 8: maxxmeister ($117.43 in chips) 
Seat 9: Foton18 ($105.52 in chips) 
matiko09: posts small blind $0.50
Tirka: posts big blind $1
*** HOLE CARDS ***
Dealt to matiko09 [3h 2s]
maxxmeister: folds 
Foton18: folds 
Yaaaazz: folds 
Filojoes: folds 
Glushchenko: folds 
matiko09: folds 
Uncalled bet ($0.50) returned to Tirka
Tirka collected $1 from pot
Tirka: doesn't show hand 
*** SUMMARY ***
Total pot $1 | Rake $0 
Seat 1: Yaaaazz folded before Flop (didn't bet)
Seat 2: Filojoes folded before Flop (didn't bet)
Seat 3: Glushchenko (button) folded before Flop (didn't bet)
Seat 4: matiko09 (small blind) folded before Flop
Seat 6: Tirka (big blind) collected ($1)
Seat 8: maxxmeister folded before Flop (didn't bet)
Seat 9: Foton18 folded before Flop (didn't bet)





PokerStars Hand #151942991299:  Hold'em No Limit ($0.50/$1.00 USD) - 2016/04/15 13:40:39 CET [2016/04/15 7:40:39 ET]
Table 'Matterania III' 9-max Seat #2 is the button
Seat 2: haoyuan541 ($100.88 in chips) 
Seat 4: wangzhuoming ($69.23 in chips) 
Seat 6: matiko09 ($100 in chips) 
Seat 8: maxxmeister ($131.67 in chips) 
Seat 9: butcheN18 ($119.40 in chips) 
Yaaaazz will be allowed to play after the button
wangzhuoming: posts small blind $0.50
matiko09: posts big blind $1
haoyuan541: posts the ante $0.20
wangzhuoming: posts the ante $0.20
matiko09: posts the ante $0.20
maxxmeister: posts the ante $0.20
butcheN18: posts the ante $0.20
*** HOLE CARDS ***
Dealt to matiko09 [4c Th]
maxxmeister: folds 
butcheN18: folds 
haoyuan541: folds 
wangzhuoming: folds 
Uncalled bet ($0.50) returned to matiko09
matiko09 collected $2 from pot
matiko09: doesn't show hand 
*** SUMMARY ***
Total pot $2 | Rake $0 
Seat 2: haoyuan541 (button) folded before Flop (didn't bet)
Seat 4: wangzhuoming (small blind) folded before Flop
Seat 6: matiko09 (big blind) collected ($2)
Seat 8: maxxmeister folded before Flop (didn't bet)
Seat 9: butcheN18 folded before Flop (didn't bet)





PokerStars Hand #151942991834:  Hold'em No Limit ($0.50/$1.00 USD) - 2016/04/15 13:40:40 CET [2016/04/15 7:40:40 ET]
Table 'Adelgunde III' 9-max Seat #2 is the button
Seat 1: valimiu ($46.84 in chips) 
Seat 2: djammusic ($38.50 in chips) 
Seat 3: tipner ($100 in chips) 
Seat 4: hammerwife ($100 in chips) 
Seat 5: matiko09 ($155.36 in chips) 
Seat 6: Pominator92 ($151.88 in chips) 
Seat 7: Yaaaazz ($100 in chips) 
Seat 8: aseban11 ($109.48 in chips) 
Seat 9: Kukuryzka ($100 in chips) 
tipner: posts small blind $0.50
hammerwife: posts big blind $1
*** HOLE CARDS ***
Dealt to matiko09 [Ac 9s]
matiko09: folds 
Pominator92: folds 
Yaaaazz: folds 
aseban11: folds 
Kukuryzka: folds 
valimiu: calls $1
djammusic: folds 
tipner: folds 
hammerwife: checks 
*** FLOP *** [Ad 5d As]
hammerwife: checks 
valimiu: checks 
*** TURN *** [Ad 5d As] [7s]
hammerwife: checks 
valimiu: checks 
*** RIVER *** [Ad 5d As 7s] [5s]
hammerwife: checks 
valimiu: checks 
*** SHOW DOWN ***
hammerwife: shows [3s Td] (two pair, Aces and Fives)
valimiu: shows [Js 2d] (two pair, Aces and Fives - Jack kicker)
valimiu collected $2.38 from pot
*** SUMMARY ***
Total pot $2.50 | Rake $0.12 
Board [Ad 5d As 7s 5s]
Seat 1: valimiu showed [Js 2d] and won ($2.38) with two pair, Aces and Fives
Seat 2: djammusic (button) folded before Flop (didn't bet)
Seat 3: tipner (small blind) folded before Flop
Seat 4: hammerwife (big blind) showed [3s Td] and lost with two pair, Aces and Fives
Seat 5: matiko09 folded before Flop (didn't bet)
Seat 6: Pominator92 folded before Flop (didn't bet)
Seat 7: Yaaaazz folded before Flop (didn't bet)
Seat 8: aseban11 folded before Flop (didn't bet)
Seat 9: Kukuryzka folded before Flop (didn't bet)





PokerStars Hand #151942992421:  Hold'em No Limit ($0.50/$1.00 USD) - 2016/04/15 13:40:41 CET [2016/04/15 7:40:41 ET]
Table 'Navi' 9-max Seat #8 is the button
Seat 1: tipner ($109.45 in chips) 
Seat 3: aseban11 ($100 in chips) 
Seat 4: Effort92 ($153.88 in chips) 
Seat 5: hammerwife ($105.82 in chips) 
Seat 6: Glushchenko ($103.16 in chips) 
Seat 7: yoshidao ($124.47 in chips) 
Seat 8: djammusic ($39.50 in chips) 
Seat 9: matiko09 ($137.63 in chips) 
matiko09: posts small blind $0.50
tipner: posts big blind $1
butcheN18: sits out 
*** HOLE CARDS ***
Dealt to matiko09 [8s 7d]
aseban11: folds 
Effort92: folds 
hammerwife: folds 
Glushchenko: folds 
yoshidao: calls $1
djammusic: folds 
matiko09: folds 
tipner: checks 
*** FLOP *** [7h 2c Ac]
tipner: bets $2
yoshidao: folds 
Uncalled bet ($2) returned to tipner
tipner collected $2.38 from pot
tipner: doesn't show hand 
*** SUMMARY ***
Total pot $2.50 | Rake $0.12 
Board [7h 2c Ac]
Seat 1: tipner (big blind) collected ($2.38)
Seat 3: aseban11 folded before Flop (didn't bet)
Seat 4: Effort92 folded before Flop (didn't bet)
Seat 5: hammerwife folded before Flop (didn't bet)
Seat 6: Glushchenko folded before Flop (didn't bet)
Seat 7: yoshidao folded on the Flop
Seat 8: djammusic (button) folded before Flop (didn't bet)
Seat 9: matiko09 (small blind) folded before Flop





PokerStars Hand #151942996240:  Hold'em No Limit ($0.50/$1.00 USD) - 2016/04/15 13:40:49 CET [2016/04/15 7:40:49 ET]
Table 'Matterania III' 9-max Seat #4 is the button
Seat 2: haoyuan541 ($100.68 in chips) 
Seat 4: wangzhuoming ($68.53 in chips) 
Seat 6: matiko09 ($101.30 in chips) 
matiko09: posts small blind $0.50
maxxmeister: is sitting out 
butcheN18: is sitting out 
butcheN18 leaves the table
haoyuan541: posts big blind $1
Yaaaazz: sits out 
haoyuan541: posts the ante $0.20
wangzhuoming: posts the ante $0.20
matiko09: posts the ante $0.20
*** HOLE CARDS ***
Dealt to matiko09 [Ks 5s]
Filojoes joins the table at seat #7 
wangzhuoming: folds 
Filojoes leaves the table
matiko09: raises $1.50 to $2.50
haoyuan541: folds 
Uncalled bet ($1.50) returned to matiko09
matiko09 collected $2.60 from pot
matiko09: doesn't show hand 
*** SUMMARY ***
Total pot $2.60 | Rake $0 
Seat 2: haoyuan541 (big blind) folded before Flop
Seat 4: wangzhuoming (button) folded before Flop (didn't bet)
Seat 6: matiko09 (small blind) collected ($2.60)





PokerStars Hand #151942999283:  Hold'em No Limit ($0.50/$1.00 USD) - 2016/04/15 13:40:55 CET [2016/04/15 7:40:55 ET]
Table 'Katja II' 9-max Seat #4 is the button
Seat 3: matiko09 ($134.12 in chips) 
Seat 4: Sutt_420 ($85.12 in chips) 
Seat 6: ASG2016 ($110.52 in chips) 
Seat 7: Effort92 ($106 in chips) 
Seat 8: Glushchenko ($143.51 in chips) 
Seat 9: Dachish ($107.89 in chips) 
ASG2016: posts small blind $0.50
Effort92: posts big blind $1
*** HOLE CARDS ***
Dealt to matiko09 [4d Tc]
Glushchenko: folds 
Dachish: folds 
Glushchenko leaves the table
matiko09: folds 
Sutt_420: folds 
ASG2016: folds 
Uncalled bet ($0.50) returned to Effort92
Effort92 collected $1 from pot
Effort92: doesn't show hand 
*** SUMMARY ***
Total pot $1 | Rake $0 
Seat 3: matiko09 folded before Flop (didn't bet)
Seat 4: Sutt_420 (button) folded before Flop (didn't bet)
Seat 6: ASG2016 (small blind) folded before Flop
Seat 7: Effort92 (big blind) collected ($1)
Seat 8: Glushchenko folded before Flop (didn't bet)
Seat 9: Dachish folded before Flop (didn't bet)





PokerStars Hand #151943001398:  Hold'em No Limit ($0.50/$1.00 USD) - 2016/04/15 13:40:59 CET [2016/04/15 7:40:59 ET]
Table 'Emma II' 9-max Seat #4 is the button
Seat 1: Yaaaazz ($120.56 in chips) 
Seat 2: Filojoes ($102.28 in chips) 
Seat 3: Glushchenko ($229.66 in chips) 
Seat 4: matiko09 ($100 in chips) 
Seat 6: Tirka ($125.02 in chips) 
Seat 9: Foton18 ($105.52 in chips) 
Tirka: posts small blind $0.50
maxxmeister: is sitting out 
Foton18: posts big blind $1
*** HOLE CARDS ***
Dealt to matiko09 [Td Jc]
Yaaaazz: folds 
Filojoes: folds 
maxxmeister leaves the table
Glushchenko: folds 
matiko09: raises $1.27 to $2.27
Tirka: folds 
Foton18: calls $1.27
*** FLOP *** [6d Ts 2s]
Foton18: checks 
matiko09: bets $3.11
Foton18: folds 
Uncalled bet ($3.11) returned to matiko09
matiko09 collected $4.79 from pot
matiko09: doesn't show hand 
*** SUMMARY ***
Total pot $5.04 | Rake $0.25 
Board [6d Ts 2s]
Seat 1: Yaaaazz folded before Flop (didn't bet)
Seat 2: Filojoes folded before Flop (didn't bet)
Seat 3: Glushchenko folded before Flop (didn't bet)
Seat 4: matiko09 (button) collected ($4.79)
Seat 6: Tirka (small blind) folded before Flop
Seat 9: Foton18 (big blind) folded on the Flop





PokerStars Hand #151943001970:  Hold'em No Limit ($1/$2 USD) - 2016/04/15 13:41:00 CET [2016/04/15 7:41:00 ET]
Table 'Oceax' 9-max Seat #4 is the button
Seat 1: matiko09 ($200 in chips) 
Seat 2: Fish4trips ($324.03 in chips) 
Seat 4: butcheN18 ($239.42 in chips) 
Seat 6: Iggso ($267.50 in chips) 
Seat 7: coinflip_si ($222.25 in chips) 
Seat 8: Poroxide ($206.97 in chips) 
Iggso: posts small blind $1
coinflip_si: posts big blind $2
GB223: sits out 
*** HOLE CARDS ***
Dealt to matiko09 [Qd Td]
Poroxide: folds 
matiko09: raises $3 to $5
Fish4trips: folds 
butcheN18: folds 
Iggso: folds 
coinflip_si: folds 
Uncalled bet ($3) returned to matiko09
matiko09 collected $5 from pot
matiko09: doesn't show hand 
*** SUMMARY ***
Total pot $5 | Rake $0 
Seat 1: matiko09 collected ($5)
Seat 2: Fish4trips folded before Flop (didn't bet)
Seat 4: butcheN18 (button) folded before Flop (didn't bet)
Seat 6: Iggso (small blind) folded before Flop
Seat 7: coinflip_si (big blind) folded before Flop
Seat 8: Poroxide folded before Flop (didn't bet)





PokerStars Hand #151943003319:  Hold'em No Limit ($1/$2 USD) - 2016/04/15 13:41:03 CET [2016/04/15 7:41:03 ET]
Table 'Adele II' 9-max Seat #7 is the button
Seat 1: RyanHuJun ($241.75 in chips) 
Seat 2: Fish4trips ($411.10 in chips) 
Seat 3: matiko09 ($312.53 in chips) 
Seat 4: Glushchenko ($200 in chips) 
Seat 6: wiseyoyo ($233.93 in chips) 
Seat 7: Iggso ($206.84 in chips) 
Seat 8: docmarc777 ($298 in chips) 
Seat 9: SanychStar ($291.70 in chips) 
docmarc777: posts small blind $1
SanychStar: posts big blind $2
*** HOLE CARDS ***
Dealt to matiko09 [5d 8d]
RyanHuJun: folds 
Fish4trips: folds 
matiko09: folds 
Glushchenko: folds 
wiseyoyo: raises $2.42 to $4.42
Iggso: folds 
docmarc777: folds 
SanychStar: folds 
Uncalled bet ($2.42) returned to wiseyoyo
wiseyoyo collected $5 from pot
wiseyoyo: doesn't show hand 
*** SUMMARY ***
Total pot $5 | Rake $0 
Seat 1: RyanHuJun folded before Flop (didn't bet)
Seat 2: Fish4trips folded before Flop (didn't bet)
Seat 3: matiko09 folded before Flop (didn't bet)
Seat 4: Glushchenko folded before Flop (didn't bet)
Seat 6: wiseyoyo collected ($5)
Seat 7: Iggso (button) folded before Flop (didn't bet)
Seat 8: docmarc777 (small blind) folded before Flop
Seat 9: SanychStar (big blind) folded before Flop





PokerStars Hand #151943004541:  Hold'em No Limit ($0.50/$1.00 USD) - 2016/04/15 13:41:05 CET [2016/04/15 7:41:05 ET]
Table 'Matterania III' 9-max Seat #6 is the button
Seat 2: haoyuan541 ($99.48 in chips) 
Seat 4: wangzhuoming ($68.33 in chips) 
Seat 6: matiko09 ($102.70 in chips) 
maxxmeister will be allowed to play after the button
haoyuan541: posts small blind $0.50
wangzhuoming: posts big blind $1
haoyuan541: posts the ante $0.20
wangzhuoming: posts the ante $0.20
matiko09: posts the ante $0.20
*** HOLE CARDS ***
Dealt to matiko09 [5s 7d]
matiko09: folds 
haoyuan541: raises $2 to $3
wangzhuoming: folds 
Uncalled bet ($2) returned to haoyuan541
haoyuan541 collected $2.60 from pot
*** SUMMARY ***
Total pot $2.60 | Rake $0 
Seat 2: haoyuan541 (small blind) collected ($2.60)
Seat 4: wangzhuoming (big blind) folded before Flop
Seat 6: matiko09 (button) folded before Flop (didn't bet)





PokerStars Hand #151943014832:  Hold'em No Limit ($1/$2 USD) - 2016/04/15 13:41:26 CET [2016/04/15 7:41:26 ET]
Table 'Oceax' 9-max Seat #6 is the button
Seat 1: matiko09 ($203 in chips) 
Seat 2: Fish4trips ($324.03 in chips) 
Seat 4: butcheN18 ($239.42 in chips) 
Seat 6: Iggso ($266.50 in chips) 
Seat 7: coinflip_si ($220.25 in chips) 
Seat 8: Poroxide ($206.97 in chips) 
coinflip_si: posts small blind $1
Poroxide: posts big blind $2
GB223: sits out 
*** HOLE CARDS ***
Dealt to matiko09 [6c As]
matiko09: folds 
Fish4trips: raises $3 to $5
butcheN18: folds 
Iggso: folds 
coinflip_si: folds 
Poroxide: folds 
Uncalled bet ($3) returned to Fish4trips
Fish4trips collected $5 from pot
Fish4trips: doesn't show hand 
*** SUMMARY ***
Total pot $5 | Rake $0 
Seat 1: matiko09 folded before Flop (didn't bet)
Seat 2: Fish4trips collected ($5)
Seat 4: butcheN18 folded before Flop (didn't bet)
Seat 6: Iggso (button) folded before Flop (didn't bet)
Seat 7: coinflip_si (small blind) folded before Flop
Seat 8: Poroxide (big blind) folded before Flop





PokerStars Hand #151943016494:  Hold'em No Limit ($0.50/$1.00 USD) - 2016/04/15 13:41:29 CET [2016/04/15 7:41:29 ET]
Table 'Katja II' 9-max Seat #6 is the button
Seat 3: matiko09 ($134.12 in chips) 
Seat 4: Sutt_420 ($85.12 in chips) 
Seat 6: ASG2016 ($110.02 in chips) 
Seat 7: Effort92 ($106.50 in chips) 
Seat 9: Dachish ($107.89 in chips) 
Effort92: posts small blind $0.50
Dachish: posts big blind $1
djammusic: sits out 
*** HOLE CARDS ***
Dealt to matiko09 [7h 4s]
matiko09: folds 
matiko09 leaves the table
Sutt_420: folds 
ASG2016: folds 
Effort92: folds 
Uncalled bet ($0.50) returned to Dachish
Dachish collected $1 from pot
Dachish: doesn't show hand 
*** SUMMARY ***
Total pot $1 | Rake $0 
Seat 3: matiko09 folded before Flop (didn't bet)
Seat 4: Sutt_420 folded before Flop (didn't bet)
Seat 6: ASG2016 (button) folded before Flop (didn't bet)
Seat 7: Effort92 (small blind) folded before Flop
Seat 9: Dachish (big blind) collected ($1)





PokerStars Hand #151943017241:  Hold'em No Limit ($0.50/$1.00 USD) - 2016/04/15 13:41:30 CET [2016/04/15 7:41:30 ET]
Table 'Matterania III' 9-max Seat #2 is the button
Seat 2: haoyuan541 ($100.88 in chips) 
Seat 4: wangzhuoming ($67.13 in chips) 
Seat 6: matiko09 ($102.50 in chips) 
wangzhuoming: posts small blind $0.50
matiko09: posts big blind $1
maxxmeister: sits out 
haoyuan541: posts the ante $0.20
wangzhuoming: posts the ante $0.20
matiko09: posts the ante $0.20
*** HOLE CARDS ***
Dealt to matiko09 [9c Ad]
haoyuan541: raises $2 to $3
wangzhuoming: calls $2.50
matiko09: folds 
*** FLOP *** [Tc 6h 5c]
wangzhuoming: checks 
haoyuan541: bets $4
wangzhuoming: calls $4
*** TURN *** [Tc 6h 5c] [8h]
wangzhuoming: checks 
haoyuan541: bets $15
myatiy 96 joins the table at seat #7 
wangzhuoming: calls $15
*** RIVER *** [Tc 6h 5c 8h] [Ac]
wangzhuoming: checks 
haoyuan541: bets $22
wangzhuoming: folds 
Uncalled bet ($22) returned to haoyuan541
haoyuan541 collected $44.60 from pot
*** SUMMARY ***
Total pot $45.60 | Rake $1 
Board [Tc 6h 5c 8h Ac]
Seat 2: haoyuan541 (button) collected ($44.60)
Seat 4: wangzhuoming (small blind) folded on the River
Seat 6: matiko09 (big blind) folded before Flop





PokerStars Hand #151943018558:  Hold'em No Limit ($0.50/$1.00 USD) - 2016/04/15 13:41:33 CET [2016/04/15 7:41:33 ET]
Table 'Emma II' 9-max Seat #6 is the button
Seat 2: Filojoes ($102.28 in chips) 
Seat 3: Glushchenko ($229.66 in chips) 
Seat 4: matiko09 ($102.52 in chips) 
Seat 6: Tirka ($124.52 in chips) 
Seat 9: Foton18 ($103.25 in chips) 
Foton18: posts small blind $0.50
Yaaaazz: is sitting out 
Filojoes: posts big blind $1
*** HOLE CARDS ***
Dealt to matiko09 [7s 4s]
Glushchenko: folds 
matiko09: folds 
Tirka: folds 
Foton18: calls $0.50
Filojoes: checks 
*** FLOP *** [Td 4h 5s]
Foton18: checks 
Filojoes: checks 
*** TURN *** [Td 4h 5s] [3s]
Foton18: checks 
Filojoes: checks 
*** RIVER *** [Td 4h 5s 3s] [6s]
Foton18: checks 
Filojoes: checks 
*** SHOW DOWN ***
Foton18: shows [7c 6h] (a straight, Three to Seven)
Filojoes: mucks hand 
Foton18 collected $1.90 from pot
*** SUMMARY ***
Total pot $2 | Rake $0.10 
Board [Td 4h 5s 3s 6s]
Seat 2: Filojoes (big blind) mucked [5h Js]
Seat 3: Glushchenko folded before Flop (didn't bet)
Seat 4: matiko09 folded before Flop (didn't bet)
Seat 6: Tirka (button) folded before Flop (didn't bet)
Seat 9: Foton18 (small blind) showed [7c 6h] and won ($1.90) with a straight, Three to Seven





PokerStars Hand #151943020417:  Hold'em No Limit ($1/$2 USD) - 2016/04/15 13:41:37 CET [2016/04/15 7:41:37 ET]
Table 'Irmgard II' 9-max Seat #2 is the button
Seat 1: Iggso ($234.21 in chips) 
Seat 2: Kukuryzka ($200 in chips) 
Seat 3: matiko09 ($208.35 in chips) 
Seat 6: djammusic ($142.25 in chips) 
Seat 7: erfk1958 ($97.90 in chips) 
Seat 8: MoeAA11 ($85.30 in chips) 
Seat 9: maximax04 ($130.72 in chips) 
matiko09: posts small blind $1
djammusic: posts big blind $2
*** HOLE CARDS ***
Dealt to matiko09 [Kd 8c]
erfk1958: folds 
MoeAA11: folds 
maximax04: raises $6 to $8
Iggso: folds 
Kukuryzka: folds 
matiko09: folds 
djammusic: folds 
Uncalled bet ($6) returned to maximax04
maximax04 collected $5 from pot
maximax04: doesn't show hand 
*** SUMMARY ***
Total pot $5 | Rake $0 
Seat 1: Iggso folded before Flop (didn't bet)
Seat 2: Kukuryzka (button) folded before Flop (didn't bet)
Seat 3: matiko09 (small blind) folded before Flop
Seat 6: djammusic (big blind) folded before Flop
Seat 7: erfk1958 folded before Flop (didn't bet)
Seat 8: MoeAA11 folded before Flop (didn't bet)
Seat 9: maximax04 collected ($5)





PokerStars Hand #151943022732:  Hold'em No Limit ($0.50/$1.00 USD) - 2016/04/15 13:41:41 CET [2016/04/15 7:41:41 ET]
Table 'Adelgunde III' 9-max Seat #3 is the button
Seat 1: valimiu ($48.22 in chips) 
Seat 2: djammusic ($38.50 in chips) 
Seat 3: tipner ($100 in chips) 
Seat 4: hammerwife ($100 in chips) 
Seat 5: matiko09 ($155.36 in chips) 
Seat 6: Pominator92 ($151.88 in chips) 
Seat 7: Yaaaazz ($100 in chips) 
Seat 8: aseban11 ($109.48 in chips) 
Seat 9: Kukuryzka ($100 in chips) 
hammerwife: posts small blind $0.50
matiko09: posts big blind $1
*** HOLE CARDS ***
Dealt to matiko09 [3c 5s]
Pominator92: calls $1
Yaaaazz: folds 
aseban11: raises $2.50 to $3.50
Kukuryzka: folds 
valimiu: calls $3.50
djammusic: calls $3.50
tipner: calls $3.50
hammerwife: folds 
matiko09: folds 
Pominator92: calls $2.50
*** FLOP *** [3s Kh 8c]
Pominator92: checks 
aseban11: checks 
valimiu: bets $24
djammusic: folds 
tipner: folds 
Pominator92: folds 
aseban11: folds 
Uncalled bet ($24) returned to valimiu
valimiu collected $18.05 from pot
valimiu: doesn't show hand 
*** SUMMARY ***
Total pot $19 | Rake $0.95 
Board [3s Kh 8c]
Seat 1: valimiu collected ($18.05)
Seat 2: djammusic folded on the Flop
Seat 3: tipner (button) folded on the Flop
Seat 4: hammerwife (small blind) folded before Flop
Seat 5: matiko09 (big blind) folded before Flop
Seat 6: Pominator92 folded on the Flop
Seat 7: Yaaaazz folded before Flop (didn't bet)
Seat 8: aseban11 folded on the Flop
Seat 9: Kukuryzka folded before Flop (didn't bet)





PokerStars Hand #151943023547:  Hold'em No Limit ($1/$2 USD) - 2016/04/15 13:41:43 CET [2016/04/15 7:41:43 ET]
Table 'Patroclus II' 9-max Seat #7 is the button
Seat 1: TonnaMunz ($200 in chips) 
Seat 2: Moemors ($200.43 in chips) 
Seat 3: Koolniknik ($285.29 in chips) 
Seat 4: tipner ($200 in chips) 
Seat 5: butcheN18 ($247.29 in chips) 
Seat 7: matiko09 ($303.89 in chips) 
Seat 8: Glushchenko ($200 in chips) 
Seat 9: Fish4trips ($235.92 in chips) 
Glushchenko: posts small blind $1
Fish4trips: posts big blind $2
*** HOLE CARDS ***
Dealt to matiko09 [9h 6d]
TonnaMunz: folds 
Moemors: raises $2 to $4
Koolniknik: folds 
tipner: folds 
butcheN18: folds 
matiko09: folds 
Glushchenko: folds 
Fish4trips: folds 
Uncalled bet ($2) returned to Moemors
Moemors collected $5 from pot
Moemors: doesn't show hand 
*** SUMMARY ***
Total pot $5 | Rake $0 
Seat 1: TonnaMunz folded before Flop (didn't bet)
Seat 2: Moemors collected ($5)
Seat 3: Koolniknik folded before Flop (didn't bet)
Seat 4: tipner folded before Flop (didn't bet)
Seat 5: butcheN18 folded before Flop (didn't bet)
Seat 7: matiko09 (button) folded before Flop (didn't bet)
Seat 8: Glushchenko (small blind) folded before Flop
Seat 9: Fish4trips (big blind) folded before Flop





PokerStars Hand #151943025777:  Hold'em No Limit ($0.50/$1.00 USD) - 2016/04/15 13:41:47 CET [2016/04/15 7:41:47 ET]
Table 'Navi' 9-max Seat #9 is the button
Seat 1: tipner ($110.83 in chips) 
Seat 2: butcheN18 ($100 in chips) 
Seat 3: aseban11 ($100 in chips) 
Seat 4: Effort92 ($153.88 in chips) 
Seat 5: hammerwife ($105.82 in chips) 
Seat 6: Glushchenko ($103.16 in chips) 
Seat 7: yoshidao ($123.47 in chips) 
Seat 8: djammusic ($39.50 in chips) 
Seat 9: matiko09 ($137.13 in chips) 
tipner: posts small blind $0.50
butcheN18: posts big blind $1
*** HOLE CARDS ***
Dealt to matiko09 [Th 9d]
aseban11: raises $1.50 to $2.50
Effort92: folds 
hammerwife: folds 
Glushchenko: folds 
yoshidao: calls $2.50
djammusic: folds 
matiko09: folds 
tipner: folds 
butcheN18: folds 
*** FLOP *** [8h 7d 9s]
aseban11: checks 
yoshidao: bets $5
aseban11: folds 
Uncalled bet ($5) returned to yoshidao
yoshidao collected $6.18 from pot
yoshidao: doesn't show hand 
*** SUMMARY ***
Total pot $6.50 | Rake $0.32 
Board [8h 7d 9s]
Seat 1: tipner (small blind) folded before Flop
Seat 2: butcheN18 (big blind) folded before Flop
Seat 3: aseban11 folded on the Flop
Seat 4: Effort92 folded before Flop (didn't bet)
Seat 5: hammerwife folded before Flop (didn't bet)
Seat 6: Glushchenko folded before Flop (didn't bet)
Seat 7: yoshidao collected ($6.18)
Seat 8: djammusic folded before Flop (didn't bet)
Seat 9: matiko09 (button) folded before Flop (didn't bet)





PokerStars Hand #151943028140:  Hold'em No Limit ($1/$2 USD) - 2016/04/15 13:41:52 CET [2016/04/15 7:41:52 ET]
Table 'Adele II' 9-max Seat #8 is the button
Seat 1: RyanHuJun ($241.75 in chips) 
Seat 2: Fish4trips ($411.10 in chips) 
Seat 3: matiko09 ($312.53 in chips) 
Seat 4: Glushchenko ($200 in chips) 
Seat 6: wiseyoyo ($236.93 in chips) 
Seat 7: Iggso ($206.84 in chips) 
Seat 8: docmarc777 ($297 in chips) 
Seat 9: SanychStar ($289.70 in chips) 
SanychStar: posts small blind $1
RyanHuJun: posts big blind $2
*** HOLE CARDS ***
Dealt to matiko09 [4c Ah]
Fish4trips: folds 
matiko09: folds 
Glushchenko: folds 
wiseyoyo: folds 
Iggso: folds 
docmarc777: raises $3.90 to $5.90
SanychStar: folds 
RyanHuJun: calls $3.90
*** FLOP *** [2h 6c Js]
RyanHuJun: checks 
docmarc777: bets $7.10
RyanHuJun: raises $7.10 to $14.20
docmarc777: calls $7.10
*** TURN *** [2h 6c Js] [Jc]
RyanHuJun: checks 
docmarc777: bets $20
RyanHuJun: calls $20
*** RIVER *** [2h 6c Js Jc] [7c]
RyanHuJun: checks 
docmarc777: folds 
RyanHuJun collected $78.45 from pot
RyanHuJun: doesn't show hand 
*** SUMMARY ***
Total pot $81.20 | Rake $2.75 
Board [2h 6c Js Jc 7c]
Seat 1: RyanHuJun (big blind) collected ($78.45)
Seat 2: Fish4trips folded before Flop (didn't bet)
Seat 3: matiko09 folded before Flop (didn't bet)
Seat 4: Glushchenko folded before Flop (didn't bet)
Seat 6: wiseyoyo folded before Flop (didn't bet)
Seat 7: Iggso folded before Flop (didn't bet)
Seat 8: docmarc777 (button) folded on the River
Seat 9: SanychStar (small blind) folded before Flop





PokerStars Hand #151943029469:  Hold'em No Limit ($1/$2 USD) - 2016/04/15 13:41:55 CET [2016/04/15 7:41:55 ET]
Table 'Irmgard II' 9-max Seat #3 is the button
Seat 1: Iggso ($234.21 in chips) 
Seat 2: Kukuryzka ($200 in chips) 
Seat 3: matiko09 ($207.35 in chips) 
Seat 6: djammusic ($140.25 in chips) 
Seat 7: erfk1958 ($97.90 in chips) 
Seat 8: MoeAA11 ($85.30 in chips) 
Seat 9: maximax04 ($133.72 in chips) 
vezunchik79 will be allowed to play after the button
djammusic: posts small blind $1
erfk1958: posts big blind $2
*** HOLE CARDS ***
Dealt to matiko09 [6d Qc]
MoeAA11: folds 
maximax04: folds 
Iggso: folds 
Kukuryzka: folds 
matiko09: folds 
djammusic: folds 
Uncalled bet ($1) returned to erfk1958
erfk1958 collected $2 from pot
erfk1958: doesn't show hand 
*** SUMMARY ***
Total pot $2 | Rake $0 
Seat 1: Iggso folded before Flop (didn't bet)
Seat 2: Kukuryzka folded before Flop (didn't bet)
Seat 3: matiko09 (button) folded before Flop (didn't bet)
Seat 6: djammusic (small blind) folded before Flop
Seat 7: erfk1958 (big blind) collected ($2)
Seat 8: MoeAA11 folded before Flop (didn't bet)
Seat 9: maximax04 folded before Flop (didn't bet)





PokerStars Hand #151943030596:  Hold'em No Limit ($1/$2 USD) - 2016/04/15 13:41:57 CET [2016/04/15 7:41:57 ET]
Table 'Oceax' 9-max Seat #7 is the button
Seat 1: matiko09 ($203 in chips) 
Seat 2: Fish4trips ($327.03 in chips) 
Seat 4: butcheN18 ($239.42 in chips) 
Seat 6: Iggso ($266.50 in chips) 
Seat 7: coinflip_si ($219.25 in chips) 
Seat 8: Poroxide ($204.97 in chips) 
Poroxide: posts small blind $1
matiko09: posts big blind $2
GB223: sits out 
*** HOLE CARDS ***
Dealt to matiko09 [Qs 8d]
Fish4trips: folds 
butcheN18: folds 
Iggso: folds 
coinflip_si: folds 
Poroxide: raises $4 to $6
matiko09: calls $4
*** FLOP *** [Jc 3d Kc]
Poroxide: bets $6
matiko09: folds 
Uncalled bet ($6) returned to Poroxide
Poroxide collected $11.40 from pot
Poroxide: doesn't show hand 
*** SUMMARY ***
Total pot $12 | Rake $0.60 
Board [Jc 3d Kc]
Seat 1: matiko09 (big blind) folded on the Flop
Seat 2: Fish4trips folded before Flop (didn't bet)
Seat 4: butcheN18 folded before Flop (didn't bet)
Seat 6: Iggso folded before Flop (didn't bet)
Seat 7: coinflip_si (button) folded before Flop (didn't bet)
Seat 8: Poroxide (small blind) collected ($11.40)





PokerStars Hand #151943036912:  Hold'em No Limit ($0.50/$1.00 USD) - 2016/04/15 13:42:09 CET [2016/04/15 7:42:09 ET]
Table 'Parvulesco II' 9-max Seat #1 is the button
Seat 1: bilukm ($26.06 in chips) 
Seat 2: Filojoes ($116.07 in chips) 
Seat 3: matiko09 ($104.50 in chips) 
Seat 5: bronbeek ($92.51 in chips) 
Seat 7: Kukuryzka ($119.05 in chips) 
Seat 8: Jimy Tiltman ($113.70 in chips) 
Seat 9: hammerwife ($208.21 in chips) 
Filojoes: posts small blind $0.50
matiko09: posts big blind $1
butcheN18: sits out 
ruslik_by: sits out 
*** HOLE CARDS ***
Dealt to matiko09 [3s 2d]
bronbeek: calls $1
Kukuryzka: folds 
Jimy Tiltman: folds 
hammerwife: raises $3.50 to $4.50
bilukm: calls $4.50
Filojoes: folds 
matiko09: folds 
bronbeek: calls $3.50
*** FLOP *** [Qd 8h Ad]
bronbeek: checks 
hammerwife: checks 
bilukm: checks 
*** TURN *** [Qd 8h Ad] [Jc]
bronbeek: checks 
hammerwife: checks 
bilukm: checks 
*** RIVER *** [Qd 8h Ad Jc] [3h]
bronbeek: checks 
hammerwife: checks 
bilukm: checks 
*** SHOW DOWN ***
bronbeek: shows [Qc Ks] (a pair of Queens)
hammerwife: mucks hand 
bilukm: mucks hand 
bronbeek collected $14.25 from pot
*** SUMMARY ***
Total pot $15 | Rake $0.75 
Board [Qd 8h Ad Jc 3h]
Seat 1: bilukm (button) mucked [Jd Kh]
Seat 2: Filojoes (small blind) folded before Flop
Seat 3: matiko09 (big blind) folded before Flop
Seat 5: bronbeek showed [Qc Ks] and won ($14.25) with a pair of Queens
Seat 7: Kukuryzka folded before Flop (didn't bet)
Seat 8: Jimy Tiltman folded before Flop (didn't bet)
Seat 9: hammerwife mucked [7c 7d]





PokerStars Hand #151943039948:  Hold'em No Limit ($0.50/$1.00 USD) - 2016/04/15 13:42:15 CET [2016/04/15 7:42:15 ET]
Table 'Matterania III' 9-max Seat #4 is the button
Seat 2: haoyuan541 ($123.28 in chips) 
Seat 4: wangzhuoming ($44.93 in chips) 
Seat 6: matiko09 ($101.30 in chips) 
Seat 7: myatiy 96 ($100 in chips) 
matiko09: posts small blind $0.50
myatiy 96: posts big blind $1
maxxmeister: sits out 
haoyuan541: posts the ante $0.20
wangzhuoming: posts the ante $0.20
matiko09: posts the ante $0.20
myatiy 96: posts the ante $0.20
*** HOLE CARDS ***
Dealt to matiko09 [3s 2d]
haoyuan541: folds 
wangzhuoming: folds 
matiko09: folds 
Uncalled bet ($0.50) returned to myatiy 96
myatiy 96 collected $1.80 from pot
myatiy 96: doesn't show hand 
*** SUMMARY ***
Total pot $1.80 | Rake $0 
Seat 2: haoyuan541 folded before Flop (didn't bet)
Seat 4: wangzhuoming (button) folded before Flop (didn't bet)
Seat 6: matiko09 (small blind) folded before Flop
Seat 7: myatiy 96 (big blind) collected ($1.80)





PokerStars Hand #151943044639:  Hold'em No Limit ($0.50/$1.00 USD) - 2016/04/15 13:42:24 CET [2016/04/15 7:42:24 ET]
Table 'Matterania III' 9-max Seat #6 is the button
Seat 2: haoyuan541 ($123.08 in chips) 
Seat 4: wangzhuoming ($44.73 in chips) 
Seat 6: matiko09 ($100.60 in chips) 
Seat 7: myatiy 96 ($101.10 in chips) 
Seat 8: maxxmeister ($131.47 in chips) 
myatiy 96: posts small blind $0.50
maxxmeister: posts big blind $1
haoyuan541: posts the ante $0.20
wangzhuoming: posts the ante $0.20
matiko09: posts the ante $0.20
myatiy 96: posts the ante $0.20
maxxmeister: posts the ante $0.20
*** HOLE CARDS ***
Dealt to matiko09 [7h 8h]
haoyuan541: folds 
wangzhuoming: raises $2 to $3
matiko09: folds 
myatiy 96: folds 
maxxmeister: folds 
Uncalled bet ($2) returned to wangzhuoming
wangzhuoming collected $3.50 from pot
wangzhuoming: doesn't show hand 
*** SUMMARY ***
Total pot $3.50 | Rake $0 
Seat 2: haoyuan541 folded before Flop (didn't bet)
Seat 4: wangzhuoming collected ($3.50)
Seat 6: matiko09 (button) folded before Flop (didn't bet)
Seat 7: myatiy 96 (small blind) folded before Flop
Seat 8: maxxmeister (big blind) folded before Flop





PokerStars Hand #151943044414:  Hold'em No Limit ($1/$2 USD) - 2016/04/15 13:42:24 CET [2016/04/15 7:42:24 ET]
Table 'Patroclus II' 9-max Seat #8 is the button
Seat 1: TonnaMunz ($200 in chips) 
Seat 2: Moemors ($203.43 in chips) 
Seat 3: Koolniknik ($285.29 in chips) 
Seat 4: tipner ($200 in chips) 
Seat 5: butcheN18 ($247.29 in chips) 
Seat 7: matiko09 ($303.89 in chips) 
Seat 8: Glushchenko ($200 in chips) 
Seat 9: Fish4trips ($233.92 in chips) 
Fish4trips: posts small blind $1
TonnaMunz: posts big blind $2
*** HOLE CARDS ***
Dealt to matiko09 [6s Qd]
Moemors: folds 
Koolniknik: folds 
tipner: folds 
butcheN18: folds 
matiko09: folds 
Glushchenko: folds 
Fish4trips: raises $3 to $5
TonnaMunz: raises $13 to $18
Fish4trips: calls $13
*** FLOP *** [2s Kd 5h]
Fish4trips: checks 
TonnaMunz: bets $16
Fish4trips: folds 
Uncalled bet ($16) returned to TonnaMunz
TonnaMunz collected $34.20 from pot
TonnaMunz: doesn't show hand 
*** SUMMARY ***
Total pot $36 | Rake $1.80 
Board [2s Kd 5h]
Seat 1: TonnaMunz (big blind) collected ($34.20)
Seat 2: Moemors folded before Flop (didn't bet)
Seat 3: Koolniknik folded before Flop (didn't bet)
Seat 4: tipner folded before Flop (didn't bet)
Seat 5: butcheN18 folded before Flop (didn't bet)
Seat 7: matiko09 folded before Flop (didn't bet)
Seat 8: Glushchenko (button) folded before Flop (didn't bet)
Seat 9: Fish4trips (small blind) folded on the Flop





PokerStars Hand #151943046479:  Hold'em No Limit ($1/$2 USD) - 2016/04/15 13:42:28 CET [2016/04/15 7:42:28 ET]
Table 'Irmgard II' 9-max Seat #6 is the button
Seat 1: Iggso ($234.21 in chips) 
Seat 2: Kukuryzka ($200 in chips) 
Seat 3: matiko09 ($207.35 in chips) 
Seat 6: djammusic ($139.25 in chips) 
Seat 7: erfk1958 ($98.90 in chips) 
Seat 8: MoeAA11 ($85.30 in chips) 
Seat 9: maximax04 ($133.72 in chips) 
erfk1958: posts small blind $1
MoeAA11: posts big blind $2
vezunchik79 is disconnected 
vezunchik79 has timed out while disconnected
vezunchik79: is sitting out 
*** HOLE CARDS ***
Dealt to matiko09 [7c 5s]
maximax04: calls $2
Iggso: folds 
Kukuryzka: folds 
matiko09: folds 
djammusic: folds 
erfk1958: calls $1
MoeAA11: checks 
*** FLOP *** [3h Tc Qs]
erfk1958: checks 
MoeAA11: checks 
maximax04: bets $4
erfk1958: calls $4
MoeAA11: folds 
*** TURN *** [3h Tc Qs] [Jh]
erfk1958: checks 
maximax04: bets $6
erfk1958: calls $6
*** RIVER *** [3h Tc Qs Jh] [4h]
erfk1958: checks 
maximax04: bets $24.70
erfk1958: folds 
Uncalled bet ($24.70) returned to maximax04
maximax04 collected $24.70 from pot
maximax04: doesn't show hand 
*** SUMMARY ***
Total pot $26 | Rake $1.30 
Board [3h Tc Qs Jh 4h]
Seat 1: Iggso folded before Flop (didn't bet)
Seat 2: Kukuryzka folded before Flop (didn't bet)
Seat 3: matiko09 folded before Flop (didn't bet)
Seat 6: djammusic (button) folded before Flop (didn't bet)
Seat 7: erfk1958 (small blind) folded on the River
Seat 8: MoeAA11 (big blind) folded on the Flop
Seat 9: maximax04 collected ($24.70)





PokerStars Hand #151943050638:  Hold'em No Limit ($0.50/$1.00 USD) - 2016/04/15 13:42:37 CET [2016/04/15 7:42:37 ET]
Table 'Emma II' 9-max Seat #9 is the button
Seat 2: Filojoes ($101.28 in chips) 
Seat 3: Glushchenko ($229.66 in chips) 
Seat 4: matiko09 ($102.52 in chips) 
Seat 6: Tirka ($124.52 in chips) 
Seat 9: Foton18 ($104.15 in chips) 
Filojoes: posts small blind $0.50
Glushchenko: posts big blind $1
*** HOLE CARDS ***
Dealt to matiko09 [7h 3s]
matiko09: folds 
Tirka: raises $2 to $3
butcheN18 joins the table at seat #8 
Foton18: calls $3
Filojoes: folds 
Glushchenko: folds 
*** FLOP *** [5h Qh 2c]
Tirka: bets $4.74
Foton18: calls $4.74
*** TURN *** [5h Qh 2c] [6c]
Tirka: checks 
Foton18: checks 
*** RIVER *** [5h Qh 2c 6c] [5c]
Tirka: checks 
Foton18: bets $16
Tirka: folds 
Uncalled bet ($16) returned to Foton18
Foton18 collected $16.13 from pot
Foton18: doesn't show hand 
*** SUMMARY ***
Total pot $16.98 | Rake $0.85 
Board [5h Qh 2c 6c 5c]
Seat 2: Filojoes (small blind) folded before Flop
Seat 3: Glushchenko (big blind) folded before Flop
Seat 4: matiko09 folded before Flop (didn't bet)
Seat 6: Tirka folded on the River
Seat 9: Foton18 (button) collected ($16.13)





PokerStars Hand #151943051737:  Hold'em No Limit ($0.50/$1.00 USD) - 2016/04/15 13:42:39 CET [2016/04/15 7:42:39 ET]
Table 'Navi' 9-max Seat #1 is the button
Seat 1: tipner ($110.33 in chips) 
Seat 2: butcheN18 ($100 in chips) 
Seat 3: aseban11 ($100 in chips) 
Seat 4: Effort92 ($153.88 in chips) 
Seat 5: hammerwife ($105.82 in chips) 
Seat 6: Glushchenko ($103.16 in chips) 
Seat 7: yoshidao ($127.15 in chips) 
Seat 8: djammusic ($39.50 in chips) 
Seat 9: matiko09 ($137.13 in chips) 
butcheN18: posts small blind $0.50
aseban11: posts big blind $1
*** HOLE CARDS ***
Dealt to matiko09 [2d 9d]
Effort92: folds 
hammerwife: folds 
Glushchenko: folds 
yoshidao: calls $1
djammusic: folds 
matiko09: folds 
tipner: folds 
butcheN18: folds 
aseban11: checks 
*** FLOP *** [5s Ah As]
aseban11: checks 
yoshidao: checks 
*** TURN *** [5s Ah As] [Qh]
aseban11: checks 
yoshidao: checks 
*** RIVER *** [5s Ah As Qh] [Qd]
aseban11: checks 
yoshidao: bets $5
aseban11: folds 
Uncalled bet ($5) returned to yoshidao
yoshidao collected $2.38 from pot
yoshidao: doesn't show hand 
*** SUMMARY ***
Total pot $2.50 | Rake $0.12 
Board [5s Ah As Qh Qd]
Seat 1: tipner (button) folded before Flop (didn't bet)
Seat 2: butcheN18 (small blind) folded before Flop
Seat 3: aseban11 (big blind) folded on the River
Seat 4: Effort92 folded before Flop (didn't bet)
Seat 5: hammerwife folded before Flop (didn't bet)
Seat 6: Glushchenko folded before Flop (didn't bet)
Seat 7: yoshidao collected ($2.38)
Seat 8: djammusic folded before Flop (didn't bet)
Seat 9: matiko09 folded before Flop (didn't bet)





PokerStars Hand #151943052574:  Hold'em No Limit ($1/$2 USD) - 2016/04/15 13:42:40 CET [2016/04/15 7:42:40 ET]
Table 'Oceax' 9-max Seat #8 is the button
Seat 1: matiko09 ($200 in chips) 
Seat 2: Fish4trips ($327.03 in chips) 
Seat 4: butcheN18 ($239.42 in chips) 
Seat 6: Iggso ($266.50 in chips) 
Seat 7: coinflip_si ($219.25 in chips) 
Seat 8: Poroxide ($210.37 in chips) 
matiko09: posts small blind $1
Fish4trips: posts big blind $2
GB223: sits out 
*** HOLE CARDS ***
Dealt to matiko09 [9d 6c]
butcheN18: folds 
Iggso: folds 
coinflip_si: folds 
Poroxide: folds 
matiko09: folds 
Uncalled bet ($1) returned to Fish4trips
Fish4trips collected $2 from pot
Fish4trips: doesn't show hand 
*** SUMMARY ***
Total pot $2 | Rake $0 
Seat 1: matiko09 (small blind) folded before Flop
Seat 2: Fish4trips (big blind) collected ($2)
Seat 4: butcheN18 folded before Flop (didn't bet)
Seat 6: Iggso folded before Flop (didn't bet)
Seat 7: coinflip_si folded before Flop (didn't bet)
Seat 8: Poroxide (button) folded before Flop (didn't bet)





PokerStars Hand #151943054388:  Hold'em No Limit ($0.50/$1.00 USD) - 2016/04/15 13:42:44 CET [2016/04/15 7:42:44 ET]
Table 'Adelgunde III' 9-max Seat #4 is the button
Seat 1: valimiu ($62.77 in chips) 
Seat 2: djammusic ($35 in chips) 
Seat 3: tipner ($100 in chips) 
Seat 4: hammerwife ($100 in chips) 
Seat 5: matiko09 ($154.36 in chips) 
Seat 6: Pominator92 ($148.38 in chips) 
Seat 7: Yaaaazz ($100 in chips) 
Seat 8: aseban11 ($105.98 in chips) 
Seat 9: Kukuryzka ($100 in chips) 
matiko09: posts small blind $0.50
Pominator92: posts big blind $1
*** HOLE CARDS ***
Dealt to matiko09 [Ad 7h]
Yaaaazz: folds 
aseban11: folds 
Kukuryzka: folds 
valimiu: calls $1
djammusic: folds 
tipner: folds 
hammerwife: folds 
matiko09: calls $0.50
Pominator92: raises $4 to $5
valimiu: folds 
matiko09: folds 
Uncalled bet ($4) returned to Pominator92
Pominator92 collected $3 from pot
Pominator92: doesn't show hand 
*** SUMMARY ***
Total pot $3 | Rake $0 
Seat 1: valimiu folded before Flop
Seat 2: djammusic folded before Flop (didn't bet)
Seat 3: tipner folded before Flop (didn't bet)
Seat 4: hammerwife (button) folded before Flop (didn't bet)
Seat 5: matiko09 (small blind) folded before Flop
Seat 6: Pominator92 (big blind) collected ($3)
Seat 7: Yaaaazz folded before Flop (didn't bet)
Seat 8: aseban11 folded before Flop (didn't bet)
Seat 9: Kukuryzka folded before Flop (didn't bet)





PokerStars Hand #151943058272:  Hold'em No Limit ($0.50/$1.00 USD) - 2016/04/15 13:42:51 CET [2016/04/15 7:42:51 ET]
Table 'Matterania III' 9-max Seat #7 is the button
Seat 2: haoyuan541 ($122.88 in chips) 
Seat 4: wangzhuoming ($47.03 in chips) 
Seat 6: matiko09 ($100.40 in chips) 
Seat 7: myatiy 96 ($100.40 in chips) 
Seat 8: maxxmeister ($130.27 in chips) 
maxxmeister: posts small blind $0.50
haoyuan541: posts big blind $1
haoyuan541: posts the ante $0.20
wangzhuoming: posts the ante $0.20
matiko09: posts the ante $0.20
myatiy 96: posts the ante $0.20
maxxmeister: posts the ante $0.20
*** HOLE CARDS ***
Dealt to matiko09 [2h Qs]
wangzhuoming: folds 
matiko09: folds 
myatiy 96: raises $1.50 to $2.50
maxxmeister: folds 
haoyuan541: calls $1.50
*** FLOP *** [Ts 3c 7c]
haoyuan541: checks 
myatiy 96: bets $3.09
haoyuan541: folds 
Uncalled bet ($3.09) returned to myatiy 96
myatiy 96 collected $6.18 from pot
myatiy 96: doesn't show hand 
*** SUMMARY ***
Total pot $6.50 | Rake $0.32 
Board [Ts 3c 7c]
Seat 2: haoyuan541 (big blind) folded on the Flop
Seat 4: wangzhuoming folded before Flop (didn't bet)
Seat 6: matiko09 folded before Flop (didn't bet)
Seat 7: myatiy 96 (button) collected ($6.18)
Seat 8: maxxmeister (small blind) folded before Flop





PokerStars Hand #151943060628:  Hold'em No Limit ($1/$2 USD) - 2016/04/15 13:42:56 CET [2016/04/15 7:42:56 ET]
Table 'Oceax' 9-max Seat #1 is the button
Seat 1: matiko09 ($200 in chips) 
Seat 2: Fish4trips ($328.03 in chips) 
Seat 3: GB223 ($200 in chips) 
Seat 4: butcheN18 ($239.42 in chips) 
Seat 6: Iggso ($266.50 in chips) 
Seat 7: coinflip_si ($219.25 in chips) 
Seat 8: Poroxide ($210.37 in chips) 
Fish4trips: posts small blind $1
GB223: posts big blind $2
*** HOLE CARDS ***
Dealt to matiko09 [Kd 4s]
butcheN18: raises $4 to $6
Iggso: folds 
coinflip_si: folds 
Poroxide: folds 
matiko09: folds 
Fish4trips: folds 
GB223: folds 
Uncalled bet ($4) returned to butcheN18
butcheN18 collected $5 from pot
butcheN18: doesn't show hand 
*** SUMMARY ***
Total pot $5 | Rake $0 
Seat 1: matiko09 (button) folded before Flop (didn't bet)
Seat 2: Fish4trips (small blind) folded before Flop
Seat 3: GB223 (big blind) folded before Flop
Seat 4: butcheN18 collected ($5)
Seat 6: Iggso folded before Flop (didn't bet)
Seat 7: coinflip_si folded before Flop (didn't bet)
Seat 8: Poroxide folded before Flop (didn't bet)





PokerStars Hand #151943067269:  Hold'em No Limit ($1/$2 USD) - 2016/04/15 13:43:09 CET [2016/04/15 7:43:09 ET]
Table 'Adele II' 9-max Seat #9 is the button
Seat 1: RyanHuJun ($280.10 in chips) 
Seat 2: Fish4trips ($411.10 in chips) 
Seat 3: matiko09 ($312.53 in chips) 
Seat 4: Glushchenko ($200 in chips) 
Seat 6: wiseyoyo ($236.93 in chips) 
Seat 7: Iggso ($206.84 in chips) 
Seat 8: docmarc777 ($256.90 in chips) 
Seat 9: SanychStar ($288.70 in chips) 
RyanHuJun: posts small blind $1
Fish4trips: posts big blind $2
*** HOLE CARDS ***
Dealt to matiko09 [9c Qh]
matiko09: folds 
Glushchenko: folds 
wiseyoyo: folds 
Iggso: folds 
docmarc777: folds 
docmarc777 leaves the table
SanychStar: raises $3 to $5
RyanHuJun: calls $4
butcheN18 joins the table at seat #8 
Fish4trips: calls $3
*** FLOP *** [5h 4d Kh]
RyanHuJun: checks 
Fish4trips: checks 
SanychStar: checks 
*** TURN *** [5h 4d Kh] [2c]
RyanHuJun: checks 
Fish4trips: bets $8.97
SanychStar: folds 
RyanHuJun: raises $8.97 to $17.94
Fish4trips: raises $38.06 to $56
RyanHuJun: raises $38.06 to $94.06
Fish4trips: calls $38.06
*** RIVER *** [5h 4d Kh 2c] [8h]
RyanHuJun: checks 
Fish4trips: checks 
*** SHOW DOWN ***
RyanHuJun: shows [As 3d] (a straight, Ace to Five)
Fish4trips: mucks hand 
RyanHuJun collected $200.37 from pot
*** SUMMARY ***
Total pot $203.12 | Rake $2.75 
Board [5h 4d Kh 2c 8h]
Seat 1: RyanHuJun (small blind) showed [As 3d] and won ($200.37) with a straight, Ace to Five
Seat 2: Fish4trips (big blind) mucked [5d 5s]
Seat 3: matiko09 folded before Flop (didn't bet)
Seat 4: Glushchenko folded before Flop (didn't bet)
Seat 6: wiseyoyo folded before Flop (didn't bet)
Seat 7: Iggso folded before Flop (didn't bet)
Seat 8: docmarc777 folded before Flop (didn't bet)
Seat 9: SanychStar (button) folded on the Turn





PokerStars Hand #151943072524:  Hold'em No Limit ($0.50/$1.00 USD) - 2016/04/15 13:43:20 CET [2016/04/15 7:43:20 ET]
Table 'Adelgunde III' 9-max Seat #5 is the button
Seat 1: valimiu ($61.77 in chips) 
Seat 2: djammusic ($35 in chips) 
Seat 3: tipner ($100 in chips) 
Seat 4: hammerwife ($100 in chips) 
Seat 5: matiko09 ($153.36 in chips) 
Seat 6: Pominator92 ($150.38 in chips) 
Seat 8: aseban11 ($105.98 in chips) 
Seat 9: Kukuryzka ($100 in chips) 
Pominator92: posts small blind $0.50
Yaaaazz: is sitting out 
aseban11: posts big blind $1
*** HOLE CARDS ***
Dealt to matiko09 [Qh 4h]
Kukuryzka: folds 
valimiu: calls $1
djammusic: folds 
tipner: folds 
hammerwife: folds 
matiko09: folds 
Pominator92: raises $2 to $3
aseban11: folds 
valimiu: calls $2
*** FLOP *** [Qs Qd Th]
Pominator92: bets $3
valimiu: folds 
Uncalled bet ($3) returned to Pominator92
Pominator92 collected $6.65 from pot
Pominator92: doesn't show hand 
*** SUMMARY ***
Total pot $7 | Rake $0.35 
Board [Qs Qd Th]
Seat 1: valimiu folded on the Flop
Seat 2: djammusic folded before Flop (didn't bet)
Seat 3: tipner folded before Flop (didn't bet)
Seat 4: hammerwife folded before Flop (didn't bet)
Seat 5: matiko09 (button) folded before Flop (didn't bet)
Seat 6: Pominator92 (small blind) collected ($6.65)
Seat 8: aseban11 (big blind) folded before Flop
Seat 9: Kukuryzka folded before Flop (didn't bet)





PokerStars Hand #151943074129:  Hold'em No Limit ($0.50/$1.00 USD) - 2016/04/15 13:43:23 CET [2016/04/15 7:43:23 ET]
Table 'Parvulesco II' 9-max Seat #2 is the button
Seat 1: bilukm ($100 in chips) 
Seat 2: Filojoes ($115.57 in chips) 
Seat 3: matiko09 ($103.50 in chips) 
Seat 4: butcheN18 ($104.12 in chips) 
Seat 5: bronbeek ($102.26 in chips) 
Seat 7: Kukuryzka ($119.05 in chips) 
Seat 8: Jimy Tiltman ($113.70 in chips) 
Seat 9: hammerwife ($203.71 in chips) 
matiko09: posts small blind $0.50
butcheN18: posts big blind $1
ruslik_by: sits out 
*** HOLE CARDS ***
Dealt to matiko09 [3s As]
bronbeek: calls $1
Kukuryzka: folds 
Jimy Tiltman: folds 
hammerwife: folds 
bilukm: calls $1
Filojoes: calls $1
matiko09: calls $0.50
butcheN18: checks 
*** FLOP *** [5s Td Ac]
matiko09: checks 
butcheN18: checks 
bronbeek: checks 
bilukm: checks 
Filojoes: checks 
*** TURN *** [5s Td Ac] [7c]
matiko09: bets $2.47
butcheN18: folds 
bronbeek: folds 
bilukm: calls $2.47
Filojoes: folds 
*** RIVER *** [5s Td Ac 7c] [8h]
matiko09: checks 
bilukm: checks 
*** SHOW DOWN ***
matiko09: shows [3s As] (a pair of Aces)
bilukm: mucks hand 
matiko09 collected $9.44 from pot
*** SUMMARY ***
Total pot $9.94 | Rake $0.50 
Board [5s Td Ac 7c 8h]
Seat 1: bilukm mucked [Kh Qc]
Seat 2: Filojoes (button) folded on the Turn
Seat 3: matiko09 (small blind) showed [3s As] and won ($9.44) with a pair of Aces
Seat 4: butcheN18 (big blind) folded on the Turn
Seat 5: bronbeek folded on the Turn
Seat 7: Kukuryzka folded before Flop (didn't bet)
Seat 8: Jimy Tiltman folded before Flop (didn't bet)
Seat 9: hammerwife folded before Flop (didn't bet)





PokerStars Hand #151943075546:  Hold'em No Limit ($1/$2 USD) - 2016/04/15 13:43:25 CET [2016/04/15 7:43:25 ET]
Table 'Patroclus II' 9-max Seat #9 is the button
Seat 1: TonnaMunz ($216.20 in chips) 
Seat 2: Moemors ($203.43 in chips) 
Seat 3: Koolniknik ($285.29 in chips) 
Seat 4: tipner ($200 in chips) 
Seat 5: butcheN18 ($247.29 in chips) 
Seat 7: matiko09 ($303.89 in chips) 
Seat 8: Glushchenko ($200 in chips) 
Seat 9: Fish4trips ($215.92 in chips) 
TonnaMunz: posts small blind $1
Moemors: posts big blind $2
*** HOLE CARDS ***
Dealt to matiko09 [7c Qs]
Koolniknik: folds 
tipner: folds 
butcheN18: folds 
matiko09: folds 
Glushchenko: folds 
Fish4trips: raises $2 to $4
TonnaMunz: folds 
Moemors: calls $2
*** FLOP *** [Ah 9d 9c]
Moemors: checks 
Fish4trips: bets $5.39
Moemors: calls $5.39
*** TURN *** [Ah 9d 9c] [Qd]
Moemors: checks 
Fish4trips: bets $26
Moemors: folds 
Uncalled bet ($26) returned to Fish4trips
Fish4trips collected $18.79 from pot
Fish4trips: doesn't show hand 
*** SUMMARY ***
Total pot $19.78 | Rake $0.99 
Board [Ah 9d 9c Qd]
Seat 1: TonnaMunz (small blind) folded before Flop
Seat 2: Moemors (big blind) folded on the Turn
Seat 3: Koolniknik folded before Flop (didn't bet)
Seat 4: tipner folded before Flop (didn't bet)
Seat 5: butcheN18 folded before Flop (didn't bet)
Seat 7: matiko09 folded before Flop (didn't bet)
Seat 8: Glushchenko folded before Flop (didn't bet)
Seat 9: Fish4trips (button) collected ($18.79)





PokerStars Hand #151943080352:  Hold'em No Limit ($0.50/$1.00 USD) - 2016/04/15 13:43:35 CET [2016/04/15 7:43:35 ET]
Table 'Matterania III' 9-max Seat #8 is the button
Seat 2: haoyuan541 ($120.18 in chips) 
Seat 4: wangzhuoming ($46.83 in chips) 
Seat 6: matiko09 ($100.20 in chips) 
Seat 7: myatiy 96 ($103.88 in chips) 
Seat 8: maxxmeister ($129.57 in chips) 
haoyuan541: posts small blind $0.50
wangzhuoming: posts big blind $1
haoyuan541: posts the ante $0.20
wangzhuoming: posts the ante $0.20
matiko09: posts the ante $0.20
myatiy 96: posts the ante $0.20
maxxmeister: posts the ante $0.20
*** HOLE CARDS ***
Dealt to matiko09 [5d Ts]
matiko09: folds 
myatiy 96: folds 
maxxmeister: folds 
haoyuan541: raises $1 to $2
wangzhuoming: folds 
Uncalled bet ($1) returned to haoyuan541
haoyuan541 collected $3 from pot
*** SUMMARY ***
Total pot $3 | Rake $0 
Seat 2: haoyuan541 (small blind) collected ($3)
Seat 4: wangzhuoming (big blind) folded before Flop
Seat 6: matiko09 folded before Flop (didn't bet)
Seat 7: myatiy 96 folded before Flop (didn't bet)
Seat 8: maxxmeister (button) folded before Flop (didn't bet)





PokerStars Hand #151943080501:  Hold'em No Limit ($1/$2 USD) - 2016/04/15 13:43:36 CET [2016/04/15 7:43:36 ET]
Table 'Oceax' 9-max Seat #2 is the button
Seat 1: matiko09 ($200 in chips) 
Seat 2: Fish4trips ($327.03 in chips) 
Seat 3: GB223 ($200 in chips) 
Seat 4: butcheN18 ($242.42 in chips) 
Seat 6: Iggso ($266.50 in chips) 
Seat 7: coinflip_si ($219.25 in chips) 
Seat 8: Poroxide ($210.37 in chips) 
GB223: posts small blind $1
butcheN18: posts big blind $2
*** HOLE CARDS ***
Dealt to matiko09 [9d 6s]
Iggso: folds 
coinflip_si: folds 
Poroxide: folds 
matiko09: folds 
Fish4trips: folds 
GB223: raises $2.48 to $4.48
butcheN18: folds 
Uncalled bet ($2.48) returned to GB223
GB223 collected $4 from pot
GB223: doesn't show hand 
*** SUMMARY ***
Total pot $4 | Rake $0 
Seat 1: matiko09 folded before Flop (didn't bet)
Seat 2: Fish4trips (button) folded before Flop (didn't bet)
Seat 3: GB223 (small blind) collected ($4)
Seat 4: butcheN18 (big blind) folded before Flop
Seat 6: Iggso folded before Flop (didn't bet)
Seat 7: coinflip_si folded before Flop (didn't bet)
Seat 8: Poroxide folded before Flop (didn't bet)





PokerStars Hand #151943085825:  Hold'em No Limit ($0.50/$1.00 USD) - 2016/04/15 13:43:46 CET [2016/04/15 7:43:46 ET]
Table 'Matterania III' 9-max Seat #2 is the button
Seat 2: haoyuan541 ($121.98 in chips) 
Seat 4: wangzhuoming ($45.63 in chips) 
Seat 6: matiko09 ($100 in chips) 
Seat 7: myatiy 96 ($103.68 in chips) 
Seat 8: maxxmeister ($129.37 in chips) 
wangzhuoming: posts small blind $0.50
Vermm was removed from the table for failing to post
matiko09: posts big blind $1
haoyuan541: posts the ante $0.20
wangzhuoming: posts the ante $0.20
matiko09: posts the ante $0.20
myatiy 96: posts the ante $0.20
maxxmeister: posts the ante $0.20
*** HOLE CARDS ***
Dealt to matiko09 [Ad 4s]
myatiy 96: raises $2.50 to $3.50
maxxmeister: folds 
haoyuan541: folds 
wangzhuoming: folds 
matiko09: folds 
Uncalled bet ($2.50) returned to myatiy 96
myatiy 96 collected $3.50 from pot
myatiy 96: doesn't show hand 
*** SUMMARY ***
Total pot $3.50 | Rake $0 
Seat 2: haoyuan541 (button) folded before Flop (didn't bet)
Seat 4: wangzhuoming (small blind) folded before Flop
Seat 6: matiko09 (big blind) folded before Flop
Seat 7: myatiy 96 collected ($3.50)
Seat 8: maxxmeister folded before Flop (didn't bet)





PokerStars Hand #151943088067:  Hold'em No Limit ($1/$2 USD) - 2016/04/15 13:43:51 CET [2016/04/15 7:43:51 ET]
Table 'Irmgard II' 9-max Seat #7 is the button
Seat 1: Iggso ($234.21 in chips) 
Seat 2: Kukuryzka ($200 in chips) 
Seat 3: matiko09 ($207.35 in chips) 
Seat 6: djammusic ($139.25 in chips) 
Seat 7: erfk1958 ($86.90 in chips) 
Seat 8: MoeAA11 ($83.30 in chips) 
Seat 9: maximax04 ($146.42 in chips) 
MoeAA11: posts small blind $1
maximax04: posts big blind $2
*** HOLE CARDS ***
Dealt to matiko09 [2s Jc]
Iggso: folds 
Kukuryzka: folds 
matiko09: folds 
djammusic: folds 
erfk1958: raises $2 to $4
MoeAA11: folds 
maximax04: calls $2
*** FLOP *** [8s 9c 6h]
maximax04: checks 
erfk1958: bets $4
maximax04: calls $4
*** TURN *** [8s 9c 6h] [Kh]
maximax04: checks 
erfk1958: bets $8
maximax04: folds 
Uncalled bet ($8) returned to erfk1958
erfk1958 collected $16.15 from pot
erfk1958: doesn't show hand 
*** SUMMARY ***
Total pot $17 | Rake $0.85 
Board [8s 9c 6h Kh]
Seat 1: Iggso folded before Flop (didn't bet)
Seat 2: Kukuryzka folded before Flop (didn't bet)
Seat 3: matiko09 folded before Flop (didn't bet)
Seat 6: djammusic folded before Flop (didn't bet)
Seat 7: erfk1958 (button) collected ($16.15)
Seat 8: MoeAA11 (small blind) folded before Flop
Seat 9: maximax04 (big blind) folded on the Turn





PokerStars Hand #151943088691:  Hold'em No Limit ($0.50/$1.00 USD) - 2016/04/15 13:43:52 CET [2016/04/15 7:43:52 ET]
Table 'Adelgunde III' 9-max Seat #6 is the button
Seat 1: valimiu ($58.77 in chips) 
Seat 2: djammusic ($35 in chips) 
Seat 3: tipner ($100 in chips) 
Seat 4: hammerwife ($100 in chips) 
Seat 5: matiko09 ($153.36 in chips) 
Seat 6: Pominator92 ($154.03 in chips) 
Seat 8: aseban11 ($104.98 in chips) 
Seat 9: Kukuryzka ($100 in chips) 
aseban11: posts small blind $0.50
Kukuryzka: posts big blind $1
*** HOLE CARDS ***
Dealt to matiko09 [3h 2c]
valimiu: calls $1
djammusic: folds 
tipner: raises $3 to $4
hammerwife: folds 
matiko09: folds 
Pominator92: folds 
aseban11: folds 
Kukuryzka: folds 
valimiu: calls $3
*** FLOP *** [9d 2d Ac]
valimiu: bets $5
tipner: folds 
Uncalled bet ($5) returned to valimiu
valimiu collected $9.02 from pot
valimiu: doesn't show hand 
*** SUMMARY ***
Total pot $9.50 | Rake $0.48 
Board [9d 2d Ac]
Seat 1: valimiu collected ($9.02)
Seat 2: djammusic folded before Flop (didn't bet)
Seat 3: tipner folded on the Flop
Seat 4: hammerwife folded before Flop (didn't bet)
Seat 5: matiko09 folded before Flop (didn't bet)
Seat 6: Pominator92 (button) folded before Flop (didn't bet)
Seat 8: aseban11 (small blind) folded before Flop
Seat 9: Kukuryzka (big blind) folded before Flop





PokerStars Hand #151943091632:  Hold'em No Limit ($0.50/$1.00 USD) - 2016/04/15 13:43:58 CET [2016/04/15 7:43:58 ET]
Table 'Navi' 9-max Seat #2 is the button
Seat 1: tipner ($110.33 in chips) 
Seat 2: butcheN18 ($100 in chips) 
Seat 3: aseban11 ($100 in chips) 
Seat 4: Effort92 ($153.88 in chips) 
Seat 5: hammerwife ($105.82 in chips) 
Seat 6: Glushchenko ($103.16 in chips) 
Seat 7: yoshidao ($128.53 in chips) 
Seat 8: djammusic ($39.50 in chips) 
Seat 9: matiko09 ($137.13 in chips) 
aseban11: posts small blind $0.50
Effort92: posts big blind $1
*** HOLE CARDS ***
Dealt to matiko09 [8h 6h]
hammerwife: folds 
Glushchenko: folds 
yoshidao: folds 
djammusic: folds 
matiko09: raises $2 to $3
tipner: raises $6 to $9
butcheN18: folds 
aseban11: folds 
Effort92: folds 
matiko09: folds 
Uncalled bet ($6) returned to tipner
tipner collected $7.50 from pot
tipner: doesn't show hand 
*** SUMMARY ***
Total pot $7.50 | Rake $0 
Seat 1: tipner collected ($7.50)
Seat 2: butcheN18 (button) folded before Flop (didn't bet)
Seat 3: aseban11 (small blind) folded before Flop
Seat 4: Effort92 (big blind) folded before Flop
Seat 5: hammerwife folded before Flop (didn't bet)
Seat 6: Glushchenko folded before Flop (didn't bet)
Seat 7: yoshidao folded before Flop (didn't bet)
Seat 8: djammusic folded before Flop (didn't bet)
Seat 9: matiko09 folded before Flop





PokerStars Hand #151943094338:  Hold'em No Limit ($1/$2 USD) - 2016/04/15 13:44:03 CET [2016/04/15 7:44:03 ET]
Table 'Oceax' 9-max Seat #3 is the button
Seat 1: matiko09 ($200 in chips) 
Seat 2: Fish4trips ($327.03 in chips) 
Seat 3: GB223 ($202 in chips) 
Seat 4: butcheN18 ($240.42 in chips) 
Seat 6: Iggso ($266.50 in chips) 
Seat 7: coinflip_si ($219.25 in chips) 
Seat 8: Poroxide ($210.37 in chips) 
butcheN18: posts small blind $1
Iggso: posts big blind $2
*** HOLE CARDS ***
Dealt to matiko09 [Jd 6s]
coinflip_si: folds 
Poroxide: folds 
matiko09: folds 
Fish4trips: raises $3 to $5
GB223: folds 
butcheN18: folds 
Iggso: folds 
Uncalled bet ($3) returned to Fish4trips
Fish4trips collected $5 from pot
Fish4trips: doesn't show hand 
*** SUMMARY ***
Total pot $5 | Rake $0 
Seat 1: matiko09 folded before Flop (didn't bet)
Seat 2: Fish4trips collected ($5)
Seat 3: GB223 (button) folded before Flop (didn't bet)
Seat 4: butcheN18 (small blind) folded before Flop
Seat 6: Iggso (big blind) folded before Flop
Seat 7: coinflip_si folded before Flop (didn't bet)
Seat 8: Poroxide folded before Flop (didn't bet)





PokerStars Hand #151943096584:  Hold'em No Limit ($0.50/$1.00 USD) - 2016/04/15 13:44:08 CET [2016/04/15 7:44:08 ET]
Table 'Matterania III' 9-max Seat #4 is the button
Seat 2: haoyuan541 ($121.78 in chips) 
Seat 4: wangzhuoming ($44.93 in chips) 
Seat 6: matiko09 ($100 in chips) 
Seat 7: myatiy 96 ($105.98 in chips) 
Seat 8: maxxmeister ($129.17 in chips) 
matiko09: posts small blind $0.50
myatiy 96: posts big blind $1
haoyuan541: posts the ante $0.20
wangzhuoming: posts the ante $0.20
matiko09: posts the ante $0.20
myatiy 96: posts the ante $0.20
maxxmeister: posts the ante $0.20
*** HOLE CARDS ***
Dealt to matiko09 [Jh 2c]
maxxmeister: folds 
maxxmeister leaves the table
haoyuan541: folds 
wangzhuoming: raises $2 to $3
matiko09: folds 
myatiy 96: folds 
Uncalled bet ($2) returned to wangzhuoming
wangzhuoming collected $3.50 from pot
wangzhuoming: doesn't show hand 
*** SUMMARY ***
Total pot $3.50 | Rake $0 
Seat 2: haoyuan541 folded before Flop (didn't bet)
Seat 4: wangzhuoming (button) collected ($3.50)
Seat 6: matiko09 (small blind) folded before Flop
Seat 7: myatiy 96 (big blind) folded before Flop
Seat 8: maxxmeister folded before Flop (didn't bet)





PokerStars Hand #151943104752:  Hold'em No Limit ($0.50/$1.00 USD) - 2016/04/15 13:44:24 CET [2016/04/15 7:44:24 ET]
Table 'Emma II' 9-max Seat #2 is the button
Seat 2: Filojoes ($100.78 in chips) 
Seat 3: Glushchenko ($228.66 in chips) 
Seat 4: matiko09 ($102.52 in chips) 
Seat 6: Tirka ($116.78 in chips) 
Seat 9: Foton18 ($112.54 in chips) 
Glushchenko: posts small blind $0.50
matiko09: posts big blind $1
butcheN18: sits out 
*** HOLE CARDS ***
Dealt to matiko09 [Th 3c]
Tirka: raises $2 to $3
Foton18: folds 
Filojoes: folds 
Glushchenko: folds 
matiko09: folds 
Uncalled bet ($2) returned to Tirka
Tirka collected $2.50 from pot
Tirka: doesn't show hand 
*** SUMMARY ***
Total pot $2.50 | Rake $0 
Seat 2: Filojoes (button) folded before Flop (didn't bet)
Seat 3: Glushchenko (small blind) folded before Flop
Seat 4: matiko09 (big blind) folded before Flop
Seat 6: Tirka collected ($2.50)
Seat 9: Foton18 folded before Flop (didn't bet)





PokerStars Hand #151943107667:  Hold'em No Limit ($1/$2 USD) - 2016/04/15 13:44:29 CET [2016/04/15 7:44:29 ET]
Table 'Patroclus II' 9-max Seat #1 is the button
Seat 1: TonnaMunz ($215.20 in chips) 
Seat 2: Moemors ($194.04 in chips) 
Seat 3: Koolniknik ($285.29 in chips) 
Seat 4: tipner ($200 in chips) 
Seat 5: butcheN18 ($247.29 in chips) 
Seat 7: matiko09 ($303.89 in chips) 
Seat 8: Glushchenko ($200 in chips) 
Seat 9: Fish4trips ($225.32 in chips) 
Moemors: posts small blind $1
Koolniknik: posts big blind $2
*** HOLE CARDS ***
Dealt to matiko09 [Ks 9h]
tipner: folds 
butcheN18: folds 
matiko09: folds 
Glushchenko: folds 
Fish4trips: raises $3 to $5
TonnaMunz: folds 
Moemors: folds 
Koolniknik: folds 
Uncalled bet ($3) returned to Fish4trips
Fish4trips collected $5 from pot
Fish4trips: doesn't show hand 
*** SUMMARY ***
Total pot $5 | Rake $0 
Seat 1: TonnaMunz (button) folded before Flop (didn't bet)
Seat 2: Moemors (small blind) folded before Flop
Seat 3: Koolniknik (big blind) folded before Flop
Seat 4: tipner folded before Flop (didn't bet)
Seat 5: butcheN18 folded before Flop (didn't bet)
Seat 7: matiko09 folded before Flop (didn't bet)
Seat 8: Glushchenko folded before Flop (didn't bet)
Seat 9: Fish4trips collected ($5)





PokerStars Hand #151943109356:  Hold'em No Limit ($1/$2 USD) - 2016/04/15 13:44:33 CET [2016/04/15 7:44:33 ET]
Table 'Oceax' 9-max Seat #4 is the button
Seat 1: matiko09 ($200 in chips) 
Seat 2: Fish4trips ($330.03 in chips) 
Seat 3: GB223 ($202 in chips) 
Seat 4: butcheN18 ($239.42 in chips) 
Seat 6: Iggso ($264.50 in chips) 
Seat 7: coinflip_si ($219.25 in chips) 
Seat 8: Poroxide ($210.37 in chips) 
Iggso: posts small blind $1
coinflip_si: posts big blind $2
*** HOLE CARDS ***
Dealt to matiko09 [7d Js]
Poroxide: folds 
matiko09: folds 
Fish4trips: raises $3 to $5
GB223: folds 
butcheN18: folds 
Iggso: folds 
coinflip_si: folds 
Uncalled bet ($3) returned to Fish4trips
Fish4trips collected $5 from pot
Fish4trips: doesn't show hand 
*** SUMMARY ***
Total pot $5 | Rake $0 
Seat 1: matiko09 folded before Flop (didn't bet)
Seat 2: Fish4trips collected ($5)
Seat 3: GB223 folded before Flop (didn't bet)
Seat 4: butcheN18 (button) folded before Flop (didn't bet)
Seat 6: Iggso (small blind) folded before Flop
Seat 7: coinflip_si (big blind) folded before Flop
Seat 8: Poroxide folded before Flop (didn't bet)





PokerStars Hand #151943110080:  Hold'em No Limit ($0.50/$1.00 USD) - 2016/04/15 13:44:34 CET [2016/04/15 7:44:34 ET]
Table 'Navi' 9-max Seat #3 is the button
Seat 1: tipner ($114.83 in chips) 
Seat 2: butcheN18 ($100 in chips) 
Seat 3: aseban11 ($100 in chips) 
Seat 4: Effort92 ($152.88 in chips) 
Seat 5: hammerwife ($105.82 in chips) 
Seat 6: Glushchenko ($103.16 in chips) 
Seat 7: yoshidao ($128.53 in chips) 
Seat 8: djammusic ($39.50 in chips) 
Seat 9: matiko09 ($134.13 in chips) 
Effort92: posts small blind $0.50
hammerwife: posts big blind $1
*** HOLE CARDS ***
Dealt to matiko09 [Ks Js]
Glushchenko: folds 
yoshidao: calls $1
djammusic: folds 
matiko09: raises $3 to $4
tipner: folds 
butcheN18: folds 
aseban11: folds 
Effort92: folds 
hammerwife: folds 
yoshidao: folds 
Uncalled bet ($3) returned to matiko09
matiko09 collected $3.50 from pot
matiko09: doesn't show hand 
*** SUMMARY ***
Total pot $3.50 | Rake $0 
Seat 1: tipner folded before Flop (didn't bet)
Seat 2: butcheN18 folded before Flop (didn't bet)
Seat 3: aseban11 (button) folded before Flop (didn't bet)
Seat 4: Effort92 (small blind) folded before Flop
Seat 5: hammerwife (big blind) folded before Flop
Seat 6: Glushchenko folded before Flop (didn't bet)
Seat 7: yoshidao folded before Flop
Seat 8: djammusic folded before Flop (didn't bet)
Seat 9: matiko09 collected ($3.50)





PokerStars Hand #151943110215:  Hold'em No Limit ($0.50/$1.00 USD) - 2016/04/15 13:44:34 CET [2016/04/15 7:44:34 ET]
Table 'Adelgunde III' 9-max Seat #8 is the button
Seat 1: valimiu ($63.79 in chips) 
Seat 2: djammusic ($35 in chips) 
Seat 3: tipner ($100 in chips) 
Seat 4: hammerwife ($100 in chips) 
Seat 5: matiko09 ($153.36 in chips) 
Seat 6: Pominator92 ($154.03 in chips) 
Seat 8: aseban11 ($104.48 in chips) 
Seat 9: Kukuryzka ($99 in chips) 
Kukuryzka: posts small blind $0.50
valimiu: posts big blind $1
*** HOLE CARDS ***
Dealt to matiko09 [Qs 4d]
djammusic: folds 
tipner: raises $2 to $3
hammerwife: raises $6 to $9
matiko09: folds 
Pominator92: folds 
aseban11: folds 
Kukuryzka: folds 
valimiu: calls $8
tipner: calls $6
*** FLOP *** [8d 3h 5h]
valimiu: checks 
tipner: checks 
hammerwife: checks 
*** TURN *** [8d 3h 5h] [6c]
valimiu: checks 
tipner: bets $13
hammerwife has timed out
hammerwife: folds 
valimiu: folds 
Uncalled bet ($13) returned to tipner
tipner collected $26.12 from pot
tipner: doesn't show hand 
*** SUMMARY ***
Total pot $27.50 | Rake $1.38 
Board [8d 3h 5h 6c]
Seat 1: valimiu (big blind) folded on the Turn
Seat 2: djammusic folded before Flop (didn't bet)
Seat 3: tipner collected ($26.12)
Seat 4: hammerwife folded on the Turn
Seat 5: matiko09 folded before Flop (didn't bet)
Seat 6: Pominator92 folded before Flop (didn't bet)
Seat 8: aseban11 (button) folded before Flop (didn't bet)
Seat 9: Kukuryzka (small blind) folded before Flop





PokerStars Hand #151943110336:  Hold'em No Limit ($0.50/$1.00 USD) - 2016/04/15 13:44:35 CET [2016/04/15 7:44:35 ET]
Table 'Matterania III' 9-max Seat #6 is the button
Seat 2: haoyuan541 ($121.58 in chips) 
Seat 4: wangzhuoming ($47.23 in chips) 
Seat 6: matiko09 ($100 in chips) 
Seat 7: myatiy 96 ($104.78 in chips) 
myatiy 96: posts small blind $0.50
di0d80 was removed from the table for failing to post
haoyuan541: posts big blind $1
haoyuan541: posts the ante $0.20
wangzhuoming: posts the ante $0.20
matiko09: posts the ante $0.20
myatiy 96: posts the ante $0.20
*** HOLE CARDS ***
Dealt to matiko09 [5h 6s]
wangzhuoming: folds 
matiko09: folds 
myatiy 96: folds 
Uncalled bet ($0.50) returned to haoyuan541
wangzhuoming leaves the table
haoyuan541 collected $1.80 from pot
*** SUMMARY ***
Total pot $1.80 | Rake $0 
Seat 2: haoyuan541 (big blind) collected ($1.80)
Seat 4: wangzhuoming folded before Flop (didn't bet)
Seat 6: matiko09 (button) folded before Flop (didn't bet)
Seat 7: myatiy 96 (small blind) folded before Flop





PokerStars Hand #151943111817:  Hold'em No Limit ($1/$2 USD) - 2016/04/15 13:44:38 CET [2016/04/15 7:44:38 ET]
Table 'Irmgard II' 9-max Seat #8 is the button
Seat 1: Iggso ($234.21 in chips) 
Seat 2: Kukuryzka ($200 in chips) 
Seat 3: matiko09 ($207.35 in chips) 
Seat 6: djammusic ($139.25 in chips) 
Seat 7: erfk1958 ($95.05 in chips) 
Seat 8: MoeAA11 ($82.30 in chips) 
Seat 9: maximax04 ($138.42 in chips) 
maximax04: posts small blind $1
Iggso: posts big blind $2
*** HOLE CARDS ***
Dealt to matiko09 [2c 9s]
Kukuryzka: folds 
matiko09: folds 
djammusic: folds 
erfk1958: folds 
MoeAA11: folds 
maximax04: folds 
Uncalled bet ($1) returned to Iggso
Iggso collected $2 from pot
Iggso: doesn't show hand 
*** SUMMARY ***
Total pot $2 | Rake $0 
Seat 1: Iggso (big blind) collected ($2)
Seat 2: Kukuryzka folded before Flop (didn't bet)
Seat 3: matiko09 folded before Flop (didn't bet)
Seat 6: djammusic folded before Flop (didn't bet)
Seat 7: erfk1958 folded before Flop (didn't bet)
Seat 8: MoeAA11 (button) folded before Flop (didn't bet)
Seat 9: maximax04 (small blind) folded before Flop





PokerStars Hand #151943117033:  Hold'em No Limit ($1/$2 USD) - 2016/04/15 13:44:48 CET [2016/04/15 7:44:48 ET]
Table 'Oceax' 9-max Seat #6 is the button
Seat 1: matiko09 ($200 in chips) 
Seat 2: Fish4trips ($333.03 in chips) 
Seat 3: GB223 ($202 in chips) 
Seat 4: butcheN18 ($239.42 in chips) 
Seat 6: Iggso ($263.50 in chips) 
Seat 7: coinflip_si ($217.25 in chips) 
Seat 8: Poroxide ($210.37 in chips) 
coinflip_si: posts small blind $1
Poroxide: posts big blind $2
*** HOLE CARDS ***
Dealt to matiko09 [5s Ks]
matiko09: folds 
Fish4trips: raises $3 to $5
GB223: folds 
butcheN18: calls $5
Iggso: folds 
coinflip_si: folds 
Poroxide: calls $3
*** FLOP *** [7s 8c 7c]
Poroxide: checks 
Fish4trips: checks 
butcheN18: bets $10
Poroxide: calls $10
Fish4trips: folds 
*** TURN *** [7s 8c 7c] [6d]
Poroxide: checks 
butcheN18: checks 
*** RIVER *** [7s 8c 7c 6d] [2d]
Poroxide: bets $18
butcheN18: folds 
Uncalled bet ($18) returned to Poroxide
Poroxide collected $34.20 from pot
Poroxide: doesn't show hand 
*** SUMMARY ***
Total pot $36 | Rake $1.80 
Board [7s 8c 7c 6d 2d]
Seat 1: matiko09 folded before Flop (didn't bet)
Seat 2: Fish4trips folded on the Flop
Seat 3: GB223 folded before Flop (didn't bet)
Seat 4: butcheN18 folded on the River
Seat 6: Iggso (button) folded before Flop (didn't bet)
Seat 7: coinflip_si (small blind) folded before Flop
Seat 8: Poroxide (big blind) collected ($34.20)





PokerStars Hand #151943120575:  Hold'em No Limit ($0.50/$1.00 USD) - 2016/04/15 13:44:55 CET [2016/04/15 7:44:55 ET]
Table 'Parvulesco II' 9-max Seat #3 is the button
Seat 1: bilukm ($96.53 in chips) 
Seat 2: Filojoes ($114.57 in chips) 
Seat 3: matiko09 ($109.47 in chips) 
Seat 4: butcheN18 ($103.12 in chips) 
Seat 5: bronbeek ($101.26 in chips) 
Seat 7: Kukuryzka ($119.05 in chips) 
Seat 8: Jimy Tiltman ($113.70 in chips) 
Seat 9: hammerwife ($203.71 in chips) 
butcheN18: posts small blind $0.50
bronbeek: posts big blind $1
ruslik_by: sits out 
*** HOLE CARDS ***
Dealt to matiko09 [Td Kd]
Kukuryzka: raises $2 to $3
Jimy Tiltman: folds 
hammerwife: folds 
bilukm: calls $3
Filojoes: folds 
matiko09: calls $3
butcheN18: folds 
bronbeek: folds 
*** FLOP *** [Ah 5d 7h]
Kukuryzka: checks 
bilukm: checks 
matiko09: bets $7
Kukuryzka: folds 
bilukm: folds 
Uncalled bet ($7) returned to matiko09
matiko09 collected $9.98 from pot
*** SUMMARY ***
Total pot $10.50 | Rake $0.52 
Board [Ah 5d 7h]
Seat 1: bilukm folded on the Flop
Seat 2: Filojoes folded before Flop (didn't bet)
Seat 3: matiko09 (button) collected ($9.98)
Seat 4: butcheN18 (small blind) folded before Flop
Seat 5: bronbeek (big blind) folded before Flop
Seat 7: Kukuryzka folded on the Flop
Seat 8: Jimy Tiltman folded before Flop (didn't bet)
Seat 9: hammerwife folded before Flop (didn't bet)





PokerStars Hand #151943120692:  Hold'em No Limit ($1/$2 USD) - 2016/04/15 13:44:56 CET [2016/04/15 7:44:56 ET]
Table 'Irmgard II' 9-max Seat #9 is the button
Seat 1: Iggso ($235.21 in chips) 
Seat 2: Kukuryzka ($200 in chips) 
Seat 3: matiko09 ($207.35 in chips) 
Seat 6: djammusic ($139.25 in chips) 
Seat 7: erfk1958 ($95.05 in chips) 
Seat 8: MoeAA11 ($82.30 in chips) 
Seat 9: maximax04 ($137.42 in chips) 
Iggso: posts small blind $1
Kukuryzka: posts big blind $2
*** HOLE CARDS ***
Dealt to matiko09 [2c Td]
matiko09: folds 
djammusic: folds 
erfk1958: raises $2 to $4
MoeAA11: calls $4
maximax04: folds 
Iggso: folds 
Kukuryzka: folds 
*** FLOP *** [Kh 9d 3s]
erfk1958: bets $4
MoeAA11: calls $4
*** TURN *** [Kh 9d 3s] [8s]
erfk1958: checks 
MoeAA11: checks 
*** RIVER *** [Kh 9d 3s 8s] [Jh]
erfk1958: checks 
MoeAA11: checks 
*** SHOW DOWN ***
erfk1958: shows [4s 4c] (a pair of Fours)
MoeAA11: mucks hand 
erfk1958 collected $18.05 from pot
*** SUMMARY ***
Total pot $19 | Rake $0.95 
Board [Kh 9d 3s 8s Jh]
Seat 1: Iggso (small blind) folded before Flop
Seat 2: Kukuryzka (big blind) folded before Flop
Seat 3: matiko09 folded before Flop (didn't bet)
Seat 6: djammusic folded before Flop (didn't bet)
Seat 7: erfk1958 showed [4s 4c] and won ($18.05) with a pair of Fours
Seat 8: MoeAA11 mucked [3d Ac]
Seat 9: maximax04 (button) folded before Flop (didn't bet)





PokerStars Hand #151943122786:  Hold'em No Limit ($0.50/$1.00 USD) - 2016/04/15 13:45:00 CET [2016/04/15 7:45:00 ET]
Table 'Emma II' 9-max Seat #3 is the button
Seat 2: Filojoes ($100.78 in chips) 
Seat 3: Glushchenko ($228.16 in chips) 
Seat 4: matiko09 ($101.52 in chips) 
Seat 6: Tirka ($118.28 in chips) 
Seat 9: Foton18 ($112.54 in chips) 
matiko09: posts small blind $0.50
Tirka: posts big blind $1
butcheN18: sits out 
*** HOLE CARDS ***
Dealt to matiko09 [9d 4h]
Foton18: raises $2 to $3
Filojoes: folds 
Glushchenko: folds 
matiko09: folds 
Tirka: calls $2
*** FLOP *** [7h 4d 3d]
Tirka: checks 
Foton18: checks 
*** TURN *** [7h 4d 3d] [Qh]
Tirka: bets $4.11
Foton18: folds 
Uncalled bet ($4.11) returned to Tirka
Tirka collected $6.18 from pot
Tirka: doesn't show hand 
*** SUMMARY ***
Total pot $6.50 | Rake $0.32 
Board [7h 4d 3d Qh]
Seat 2: Filojoes folded before Flop (didn't bet)
Seat 3: Glushchenko (button) folded before Flop (didn't bet)
Seat 4: matiko09 (small blind) folded before Flop
Seat 6: Tirka (big blind) collected ($6.18)
Seat 9: Foton18 folded on the Turn





PokerStars Hand #151943125717:  Hold'em No Limit ($1/$2 USD) - 2016/04/15 13:45:06 CET [2016/04/15 7:45:06 ET]
Table 'Patroclus II' 9-max Seat #2 is the button
Seat 1: TonnaMunz ($215.20 in chips) 
Seat 2: Moemors ($193.04 in chips) 
Seat 3: Koolniknik ($283.29 in chips) 
Seat 4: tipner ($200 in chips) 
Seat 5: butcheN18 ($247.29 in chips) 
Seat 7: matiko09 ($303.89 in chips) 
Seat 8: Glushchenko ($200 in chips) 
Seat 9: Fish4trips ($228.32 in chips) 
Koolniknik: posts small blind $1
tipner: posts big blind $2
*** HOLE CARDS ***
Dealt to matiko09 [8c 6s]
butcheN18: folds 
matiko09: folds 
Glushchenko: folds 
Fish4trips: folds 
TonnaMunz: folds 
Moemors: folds 
Koolniknik: raises $4 to $6
tipner: raises $11 to $17
Koolniknik: calls $11
*** FLOP *** [6h Ah 9c]
Koolniknik: bets $16.15
tipner: calls $16.15
*** TURN *** [6h Ah 9c] [Kd]
Koolniknik: bets $31.77
tipner: calls $31.77
*** RIVER *** [6h Ah 9c Kd] [9s]
Koolniknik: bets $63.54
tipner: calls $63.54
*** SHOW DOWN ***
Koolniknik: shows [7c Ac] (two pair, Aces and Nines)
tipner: mucks hand 
Koolniknik collected $254.17 from pot
*** SUMMARY ***
Total pot $256.92 | Rake $2.75 
Board [6h Ah 9c Kd 9s]
Seat 1: TonnaMunz folded before Flop (didn't bet)
Seat 2: Moemors (button) folded before Flop (didn't bet)
Seat 3: Koolniknik (small blind) showed [7c Ac] and won ($254.17) with two pair, Aces and Nines
Seat 4: tipner (big blind) mucked [Ts Tc]
Seat 5: butcheN18 folded before Flop (didn't bet)
Seat 7: matiko09 folded before Flop (didn't bet)
Seat 8: Glushchenko folded before Flop (didn't bet)
Seat 9: Fish4trips folded before Flop (didn't bet)





PokerStars Hand #151943131411:  Hold'em No Limit ($0.50/$1.00 USD) - 2016/04/15 13:45:17 CET [2016/04/15 7:45:17 ET]
Table 'Navi' 9-max Seat #4 is the button
Seat 1: tipner ($114.83 in chips) 
Seat 2: butcheN18 ($100 in chips) 
Seat 3: aseban11 ($100 in chips) 
Seat 4: Effort92 ($152.38 in chips) 
Seat 5: hammerwife ($104.82 in chips) 
Seat 6: Glushchenko ($103.16 in chips) 
Seat 7: yoshidao ($127.53 in chips) 
Seat 8: djammusic ($39.50 in chips) 
Seat 9: matiko09 ($136.63 in chips) 
hammerwife: posts small blind $0.50
Glushchenko: posts big blind $1
*** HOLE CARDS ***
Dealt to matiko09 [Qs 6c]
yoshidao: folds 
djammusic: folds 
matiko09: folds 
tipner: folds 
butcheN18: folds 
aseban11: folds 
Effort92: raises $1 to $2
hammerwife: folds 
Glushchenko: raises $7 to $9
Effort92: calls $7
*** FLOP *** [Tc 4c Kd]
Glushchenko: bets $10
Effort92: calls $10
*** TURN *** [Tc 4c Kd] [Qc]
Glushchenko: checks 
Effort92: checks 
*** RIVER *** [Tc 4c Kd Qc] [2s]
Glushchenko: checks 
Effort92: checks 
*** SHOW DOWN ***
Glushchenko: shows [3h As] (high card Ace)
Effort92: shows [Qh 9h] (a pair of Queens)
Effort92 collected $36.58 from pot
*** SUMMARY ***
Total pot $38.50 | Rake $1.92 
Board [Tc 4c Kd Qc 2s]
Seat 1: tipner folded before Flop (didn't bet)
Seat 2: butcheN18 folded before Flop (didn't bet)
Seat 3: aseban11 folded before Flop (didn't bet)
Seat 4: Effort92 (button) showed [Qh 9h] and won ($36.58) with a pair of Queens
Seat 5: hammerwife (small blind) folded before Flop
Seat 6: Glushchenko (big blind) showed [3h As] and lost with high card Ace
Seat 7: yoshidao folded before Flop (didn't bet)
Seat 8: djammusic folded before Flop (didn't bet)
Seat 9: matiko09 folded before Flop (didn't bet)





PokerStars Hand #151943140297:  Hold'em No Limit ($1/$2 USD) - 2016/04/15 13:45:35 CET [2016/04/15 7:45:35 ET]
Table 'Adele II' 9-max Seat #1 is the button
Seat 1: RyanHuJun ($381.41 in chips) 
Seat 2: Fish4trips ($312.04 in chips) 
Seat 3: matiko09 ($312.53 in chips) 
Seat 4: Glushchenko ($200 in chips) 
Seat 6: wiseyoyo ($236.93 in chips) 
Seat 7: Iggso ($206.84 in chips) 
Seat 9: SanychStar ($283.70 in chips) 
Fish4trips: posts small blind $1
matiko09: posts big blind $2
butcheN18: sits out 
*** HOLE CARDS ***
Dealt to matiko09 [Qs 5d]
Glushchenko: folds 
wiseyoyo: folds 
Iggso: folds 
SanychStar: folds 
RyanHuJun: folds 
Fish4trips: raises $3 to $5
matiko09: folds 
Uncalled bet ($3) returned to Fish4trips
Fish4trips collected $4 from pot
Fish4trips: doesn't show hand 
*** SUMMARY ***
Total pot $4 | Rake $0 
Seat 1: RyanHuJun (button) folded before Flop (didn't bet)
Seat 2: Fish4trips (small blind) collected ($4)
Seat 3: matiko09 (big blind) folded before Flop
Seat 4: Glushchenko folded before Flop (didn't bet)
Seat 6: wiseyoyo folded before Flop (didn't bet)
Seat 7: Iggso folded before Flop (didn't bet)
Seat 9: SanychStar folded before Flop (didn't bet)





PokerStars Hand #151943145541:  Hold'em No Limit ($1/$2 USD) - 2016/04/15 13:45:45 CET [2016/04/15 7:45:45 ET]
Table 'Blaauw' 9-max Seat #4 is the button
Seat 1: wiseyoyo ($542.58 in chips) 
Seat 2: butcheN18 ($262.60 in chips) 
Seat 3: Glushchenko ($248.85 in chips) 
Seat 4: petro0107 ($243.54 in chips) 
Seat 5: tipner ($200 in chips) 
Seat 6: matiko09 ($200 in chips) 
Seat 7: ssljvr ($406.07 in chips) 
Seat 9: coinflip_si ($204.88 in chips) 
tipner: posts small blind $1
matiko09: posts big blind $2
djammusic: sits out 
*** HOLE CARDS ***
Dealt to matiko09 [7s 5h]
ssljvr: folds 
coinflip_si: folds 
wiseyoyo: folds 
butcheN18: folds 
Glushchenko: raises $3 to $5
petro0107: calls $5
tipner: folds 
matiko09: folds 
*** FLOP *** [Qc Jd 6s]
Glushchenko: checks 
petro0107: checks 
*** TURN *** [Qc Jd 6s] [6d]
Glushchenko: checks 
petro0107: bets $4
Glushchenko: folds 
Uncalled bet ($4) returned to petro0107
petro0107 collected $12.35 from pot
petro0107: doesn't show hand 
*** SUMMARY ***
Total pot $13 | Rake $0.65 
Board [Qc Jd 6s 6d]
Seat 1: wiseyoyo folded before Flop (didn't bet)
Seat 2: butcheN18 folded before Flop (didn't bet)
Seat 3: Glushchenko folded on the Turn
Seat 4: petro0107 (button) collected ($12.35)
Seat 5: tipner (small blind) folded before Flop
Seat 6: matiko09 (big blind) folded before Flop
Seat 7: ssljvr folded before Flop (didn't bet)
Seat 9: coinflip_si folded before Flop (didn't bet)





PokerStars Hand #151943146212:  Hold'em No Limit ($1/$2 USD) - 2016/04/15 13:45:46 CET [2016/04/15 7:45:46 ET]
Table 'Irmgard II' 9-max Seat #1 is the button
Seat 1: Iggso ($234.21 in chips) 
Seat 2: Kukuryzka ($198 in chips) 
Seat 3: matiko09 ($207.35 in chips) 
Seat 6: djammusic ($139.25 in chips) 
Seat 7: erfk1958 ($105.10 in chips) 
Seat 8: MoeAA11 ($74.30 in chips) 
Seat 9: maximax04 ($137.42 in chips) 
Kukuryzka: posts small blind $1
matiko09: posts big blind $2
*** HOLE CARDS ***
Dealt to matiko09 [Js 3s]
djammusic: folds 
erfk1958: folds 
MoeAA11: folds 
maximax04: calls $2
Iggso: folds 
Kukuryzka: folds 
matiko09: checks 
*** FLOP *** [As 8h 4s]
matiko09: bets $3.09
maximax04: folds 
Uncalled bet ($3.09) returned to matiko09
matiko09 collected $4.75 from pot
matiko09: doesn't show hand 
*** SUMMARY ***
Total pot $5 | Rake $0.25 
Board [As 8h 4s]
Seat 1: Iggso (button) folded before Flop (didn't bet)
Seat 2: Kukuryzka (small blind) folded before Flop
Seat 3: matiko09 (big blind) collected ($4.75)
Seat 6: djammusic folded before Flop (didn't bet)
Seat 7: erfk1958 folded before Flop (didn't bet)
Seat 8: MoeAA11 folded before Flop (didn't bet)
Seat 9: maximax04 folded on the Flop





PokerStars Hand #151943148965:  Hold'em No Limit ($1/$2 USD) - 2016/04/15 13:45:52 CET [2016/04/15 7:45:52 ET]
Table 'Adele II' 9-max Seat #2 is the button
Seat 1: RyanHuJun ($381.41 in chips) 
Seat 2: Fish4trips ($314.04 in chips) 
Seat 3: matiko09 ($310.53 in chips) 
Seat 4: Glushchenko ($200 in chips) 
Seat 6: wiseyoyo ($236.93 in chips) 
Seat 7: Iggso ($206.84 in chips) 
Seat 9: SanychStar ($283.70 in chips) 
matiko09: posts small blind $1
Glushchenko: posts big blind $2
butcheN18: sits out 
*** HOLE CARDS ***
Dealt to matiko09 [9s 2s]
wiseyoyo: folds 
Iggso: folds 
SanychStar: folds 
RyanHuJun: folds 
Fish4trips: folds 
matiko09: folds 
Uncalled bet ($1) returned to Glushchenko
Glushchenko collected $2 from pot
*** SUMMARY ***
Total pot $2 | Rake $0 
Seat 1: RyanHuJun folded before Flop (didn't bet)
Seat 2: Fish4trips (button) folded before Flop (didn't bet)
Seat 3: matiko09 (small blind) folded before Flop
Seat 4: Glushchenko (big blind) collected ($2)
Seat 6: wiseyoyo folded before Flop (didn't bet)
Seat 7: Iggso folded before Flop (didn't bet)
Seat 9: SanychStar folded before Flop (didn't bet)





PokerStars Hand #151943151165:  Hold'em No Limit ($0.50/$1.00 USD) - 2016/04/15 13:45:56 CET [2016/04/15 7:45:56 ET]
Table 'Emma II' 9-max Seat #4 is the button
Seat 2: Filojoes ($100.78 in chips) 
Seat 3: Glushchenko ($228.16 in chips) 
Seat 4: matiko09 ($101.02 in chips) 
Seat 6: Tirka ($121.46 in chips) 
Seat 8: butcheN18 ($148.70 in chips) 
Seat 9: Foton18 ($109.54 in chips) 
Tirka: posts small blind $0.50
butcheN18: posts big blind $1
*** HOLE CARDS ***
Dealt to matiko09 [6h Kd]
Foton18 has timed out
Foton18: folds 
Filojoes: folds 
Glushchenko: folds 
matiko09: folds 
Tirka: folds 
Uncalled bet ($0.50) returned to butcheN18
butcheN18 collected $1 from pot
butcheN18: doesn't show hand 
*** SUMMARY ***
Total pot $1 | Rake $0 
Seat 2: Filojoes folded before Flop (didn't bet)
Seat 3: Glushchenko folded before Flop (didn't bet)
Seat 4: matiko09 (button) folded before Flop (didn't bet)
Seat 6: Tirka (small blind) folded before Flop
Seat 8: butcheN18 (big blind) collected ($1)
Seat 9: Foton18 folded before Flop (didn't bet)





PokerStars Hand #151943155109:  Hold'em No Limit ($1/$2 USD) - 2016/04/15 13:46:04 CET [2016/04/15 7:46:04 ET]
Table 'Adele II' 9-max Seat #3 is the button
Seat 1: RyanHuJun ($381.41 in chips) 
Seat 2: Fish4trips ($314.04 in chips) 
Seat 3: matiko09 ($309.53 in chips) 
Seat 4: Glushchenko ($201 in chips) 
Seat 6: wiseyoyo ($236.93 in chips) 
Seat 7: Iggso ($206.84 in chips) 
Seat 9: SanychStar ($283.70 in chips) 
Glushchenko: posts small blind $1
di0d80 was removed from the table for failing to post
wiseyoyo: posts big blind $2
butcheN18: sits out 
*** HOLE CARDS ***
Dealt to matiko09 [2s Jd]
Iggso: folds 
SanychStar: folds 
RyanHuJun: folds 
Fish4trips: folds 
TonnaMunz joins the table at seat #5 
matiko09: folds 
Glushchenko: raises $3 to $5
wiseyoyo: folds 
Uncalled bet ($3) returned to Glushchenko
Glushchenko collected $4 from pot
*** SUMMARY ***
Total pot $4 | Rake $0 
Seat 1: RyanHuJun folded before Flop (didn't bet)
Seat 2: Fish4trips folded before Flop (didn't bet)
Seat 3: matiko09 (button) folded before Flop (didn't bet)
Seat 4: Glushchenko (small blind) collected ($4)
Seat 6: wiseyoyo (big blind) folded before Flop
Seat 7: Iggso folded before Flop (didn't bet)
Seat 9: SanychStar folded before Flop (didn't bet)





PokerStars Hand #151943156702:  Hold'em No Limit ($0.50/$1.00 USD) - 2016/04/15 13:46:07 CET [2016/04/15 7:46:07 ET]
Table 'Parvulesco II' 9-max Seat #4 is the button
Seat 1: bilukm ($93.53 in chips) 
Seat 2: Filojoes ($114.57 in chips) 
Seat 3: matiko09 ($116.45 in chips) 
Seat 4: butcheN18 ($102.62 in chips) 
Seat 5: bronbeek ($100.26 in chips) 
Seat 6: ruslik_by ($100 in chips) 
Seat 7: Kukuryzka ($116.05 in chips) 
Seat 8: Jimy Tiltman ($113.70 in chips) 
Seat 9: hammerwife ($203.71 in chips) 
bronbeek: posts small blind $0.50
ruslik_by: posts big blind $1
*** HOLE CARDS ***
Dealt to matiko09 [2c Qd]
Kukuryzka: folds 
Jimy Tiltman: folds 
hammerwife: folds 
bilukm: raises $1 to $2
Filojoes: calls $2
matiko09: folds 
butcheN18: calls $2
bronbeek: folds 
ruslik_by: calls $1
*** FLOP *** [9c Jd 9d]
ruslik_by: checks 
bilukm: bets $4.04
Filojoes: folds 
butcheN18: folds 
ruslik_by: folds 
Uncalled bet ($4.04) returned to bilukm
bilukm collected $8.08 from pot
bilukm: doesn't show hand 
*** SUMMARY ***
Total pot $8.50 | Rake $0.42 
Board [9c Jd 9d]
Seat 1: bilukm collected ($8.08)
Seat 2: Filojoes folded on the Flop
Seat 3: matiko09 folded before Flop (didn't bet)
Seat 4: butcheN18 (button) folded on the Flop
Seat 5: bronbeek (small blind) folded before Flop
Seat 6: ruslik_by (big blind) folded on the Flop
Seat 7: Kukuryzka folded before Flop (didn't bet)
Seat 8: Jimy Tiltman folded before Flop (didn't bet)
Seat 9: hammerwife folded before Flop (didn't bet)





PokerStars Hand #151943158083:  Hold'em No Limit ($1/$2 USD) - 2016/04/15 13:46:10 CET [2016/04/15 7:46:10 ET]
Table 'Irmgard II' 9-max Seat #2 is the button
Seat 1: Iggso ($234.21 in chips) 
Seat 2: Kukuryzka ($200 in chips) 
Seat 3: matiko09 ($210.10 in chips) 
Seat 6: djammusic ($139.25 in chips) 
Seat 7: erfk1958 ($105.10 in chips) 
Seat 8: MoeAA11 ($74.30 in chips) 
Seat 9: maximax04 ($135.42 in chips) 
matiko09: posts small blind $1
djammusic: posts big blind $2
*** HOLE CARDS ***
Dealt to matiko09 [9s 3d]
erfk1958: folds 
MoeAA11: calls $2
maximax04: folds 
Iggso: folds 
Kukuryzka: folds 
matiko09: folds 
djammusic: raises $4 to $6
MoeAA11: calls $4
*** FLOP *** [3c Th 8s]
djammusic: bets $7
MoeAA11: folds 
Uncalled bet ($7) returned to djammusic
djammusic collected $12.35 from pot
djammusic: doesn't show hand 
*** SUMMARY ***
Total pot $13 | Rake $0.65 
Board [3c Th 8s]
Seat 1: Iggso folded before Flop (didn't bet)
Seat 2: Kukuryzka (button) folded before Flop (didn't bet)
Seat 3: matiko09 (small blind) folded before Flop
Seat 6: djammusic (big blind) collected ($12.35)
Seat 7: erfk1958 folded before Flop (didn't bet)
Seat 8: MoeAA11 folded on the Flop
Seat 9: maximax04 folded before Flop (didn't bet)





PokerStars Hand #151943159364:  Hold'em No Limit ($0.50/$1.00 USD) - 2016/04/15 13:46:13 CET [2016/04/15 7:46:13 ET]
Table 'Adelgunde III' 9-max Seat #9 is the button
Seat 1: valimiu ($54.79 in chips) 
Seat 2: djammusic ($35 in chips) 
Seat 3: tipner ($117.12 in chips) 
Seat 4: hammerwife ($100 in chips) 
Seat 5: matiko09 ($153.36 in chips) 
Seat 6: Pominator92 ($154.03 in chips) 
Seat 8: aseban11 ($104.48 in chips) 
Seat 9: Kukuryzka ($100 in chips) 
valimiu: posts small blind $0.50
djammusic: posts big blind $1
*** HOLE CARDS ***
Dealt to matiko09 [Jd 4d]
tipner: folds 
hammerwife: folds 
matiko09: folds 
Pominator92: folds 
aseban11: raises $1.50 to $2.50
Kukuryzka: folds 
valimiu: folds 
djammusic: raises $4.50 to $7
aseban11: folds 
Uncalled bet ($4.50) returned to djammusic
djammusic collected $5.50 from pot
djammusic: doesn't show hand 
*** SUMMARY ***
Total pot $5.50 | Rake $0 
Seat 1: valimiu (small blind) folded before Flop
Seat 2: djammusic (big blind) collected ($5.50)
Seat 3: tipner folded before Flop (didn't bet)
Seat 4: hammerwife folded before Flop (didn't bet)
Seat 5: matiko09 folded before Flop (didn't bet)
Seat 6: Pominator92 folded before Flop (didn't bet)
Seat 8: aseban11 folded before Flop
Seat 9: Kukuryzka (button) folded before Flop (didn't bet)





PokerStars Hand #151943163159:  Hold'em No Limit ($1/$2 USD) - 2016/04/15 13:46:20 CET [2016/04/15 7:46:20 ET]
Table 'Oceax' 9-max Seat #7 is the button
Seat 1: matiko09 ($200 in chips) 
Seat 2: Fish4trips ($328.03 in chips) 
Seat 3: GB223 ($202 in chips) 
Seat 4: butcheN18 ($224.42 in chips) 
Seat 6: Iggso ($263.50 in chips) 
Seat 7: coinflip_si ($216.25 in chips) 
Seat 8: Poroxide ($229.57 in chips) 
Poroxide: posts small blind $1
matiko09: posts big blind $2
*** HOLE CARDS ***
Dealt to matiko09 [Kh 7s]
Olddogtom888 was removed from the table for failing to post
Fish4trips: folds 
erfk1958 joins the table at seat #9 
GB223: raises $3.32 to $5.32
butcheN18: folds 
Iggso: folds 
coinflip_si: folds 
Poroxide: raises $10.68 to $16
matiko09: folds 
GB223: calls $10.68
*** FLOP *** [Ad Qs 8d]
Poroxide: checks 
GB223: checks 
*** TURN *** [Ad Qs 8d] [Ah]
Poroxide: bets $18
GB223: calls $18
*** RIVER *** [Ad Qs 8d Ah] [Jh]
Poroxide: bets $36
GB223: calls $36
*** SHOW DOWN ***
Poroxide: shows [Qh Qc] (a full house, Queens full of Aces)
GB223: mucks hand 
Poroxide collected $139.25 from pot
*** SUMMARY ***
Total pot $142 | Rake $2.75 
Board [Ad Qs 8d Ah Jh]
Seat 1: matiko09 (big blind) folded before Flop
Seat 2: Fish4trips folded before Flop (didn't bet)
Seat 3: GB223 mucked [As 4s]
Seat 4: butcheN18 folded before Flop (didn't bet)
Seat 6: Iggso folded before Flop (didn't bet)
Seat 7: coinflip_si (button) folded before Flop (didn't bet)
Seat 8: Poroxide (small blind) showed [Qh Qc] and won ($139.25) with a full house, Queens full of Aces





PokerStars Hand #151943169567:  Hold'em No Limit ($0.50/$1.00 USD) - 2016/04/15 13:46:33 CET [2016/04/15 7:46:33 ET]
Table 'Emma II' 9-max Seat #6 is the button
Seat 2: Filojoes ($100.78 in chips) 
Seat 3: Glushchenko ($228.16 in chips) 
Seat 4: matiko09 ($101.02 in chips) 
Seat 6: Tirka ($120.96 in chips) 
Seat 8: butcheN18 ($149.20 in chips) 
butcheN18: posts small blind $0.50
Filojoes: posts big blind $1
*** HOLE CARDS ***
Dealt to matiko09 [2s Qd]
Glushchenko: folds 
matiko09: folds 
Tirka: folds 
butcheN18: raises $1.44 to $2.44
Filojoes: folds 
Uncalled bet ($1.44) returned to butcheN18
butcheN18 collected $2 from pot
butcheN18: doesn't show hand 
*** SUMMARY ***
Total pot $2 | Rake $0 
Seat 2: Filojoes (big blind) folded before Flop
Seat 3: Glushchenko folded before Flop (didn't bet)
Seat 4: matiko09 folded before Flop (didn't bet)
Seat 6: Tirka (button) folded before Flop (didn't bet)
Seat 8: butcheN18 (small blind) collected ($2)





PokerStars Hand #151943171152:  Hold'em No Limit ($0.50/$1.00 USD) - 2016/04/15 13:46:36 CET [2016/04/15 7:46:36 ET]
Table 'Chiny II' 9-max Seat #1 is the button
Seat 1: aseban11 ($100.62 in chips) 
Seat 2: Westpants ($128.58 in chips) 
Seat 4: matiko09 ($147.88 in chips) 
Seat 6: choupai ($25.55 in chips) 
Seat 7: tipner ($187.63 in chips) 
Seat 8: Filojoes ($145.24 in chips) 
Seat 9: butcheN18 ($101.50 in chips) 
Westpants: posts small blind $0.50
matiko09: posts big blind $1
*** HOLE CARDS ***
Dealt to matiko09 [Qs Qc]
choupai: folds 
tipner: raises $2 to $3
Filojoes: folds 
butcheN18: folds 
aseban11: calls $3
Westpants: calls $2.50
matiko09: raises $12 to $15
tipner: folds 
aseban11: folds 
Westpants: folds 
Uncalled bet ($12) returned to matiko09
matiko09 collected $12 from pot
matiko09: doesn't show hand 
*** SUMMARY ***
Total pot $12 | Rake $0 
Seat 1: aseban11 (button) folded before Flop
Seat 2: Westpants (small blind) folded before Flop
Seat 4: matiko09 (big blind) collected ($12)
Seat 6: choupai folded before Flop (didn't bet)
Seat 7: tipner folded before Flop
Seat 8: Filojoes folded before Flop (didn't bet)
Seat 9: butcheN18 folded before Flop (didn't bet)





PokerStars Hand #151943180132:  Hold'em No Limit ($1/$2 USD) - 2016/04/15 13:46:54 CET [2016/04/15 7:46:54 ET]
Table 'Blaauw' 9-max Seat #5 is the button
Seat 1: wiseyoyo ($542.58 in chips) 
Seat 2: butcheN18 ($262.60 in chips) 
Seat 3: Glushchenko ($243.85 in chips) 
Seat 4: petro0107 ($250.89 in chips) 
Seat 5: tipner ($200 in chips) 
Seat 6: matiko09 ($200 in chips) 
Seat 7: ssljvr ($406.07 in chips) 
Seat 9: coinflip_si ($204.88 in chips) 
matiko09: posts small blind $1
ssljvr: posts big blind $2
djammusic: sits out 
*** HOLE CARDS ***
Dealt to matiko09 [Kh Kd]
coinflip_si: folds 
djammusic leaves the table
wiseyoyo: folds 
butcheN18: folds 
Glushchenko: raises $4 to $6
petro0107 has timed out
petro0107: folds 
tipner: raises $12 to $18
matiko09: raises $28 to $46
ssljvr: folds 
Glushchenko: folds 
tipner: folds 
Uncalled bet ($28) returned to matiko09
matiko09 collected $44 from pot
matiko09: doesn't show hand 
*** SUMMARY ***
Total pot $44 | Rake $0 
Seat 1: wiseyoyo folded before Flop (didn't bet)
Seat 2: butcheN18 folded before Flop (didn't bet)
Seat 3: Glushchenko folded before Flop
Seat 4: petro0107 folded before Flop (didn't bet)
Seat 5: tipner (button) folded before Flop
Seat 6: matiko09 (small blind) collected ($44)
Seat 7: ssljvr (big blind) folded before Flop
Seat 9: coinflip_si folded before Flop (didn't bet)





PokerStars Hand #151943180005:  Hold'em No Limit ($0.50/$1.00 USD) - 2016/04/15 13:46:54 CET [2016/04/15 7:46:54 ET]
Table 'Navi' 9-max Seat #5 is the button
Seat 1: tipner ($114.83 in chips) 
Seat 2: butcheN18 ($100 in chips) 
Seat 3: aseban11 ($100 in chips) 
Seat 4: Effort92 ($169.96 in chips) 
Seat 5: hammerwife ($104.32 in chips) 
Seat 6: Glushchenko ($100 in chips) 
Seat 7: yoshidao ($127.53 in chips) 
Seat 8: djammusic ($39.50 in chips) 
Seat 9: matiko09 ($136.63 in chips) 
Glushchenko: posts small blind $0.50
yoshidao: posts big blind $1
*** HOLE CARDS ***
Dealt to matiko09 [9s 4d]
djammusic: raises $1.25 to $2.25
matiko09: folds 
tipner has timed out
tipner: folds 
butcheN18: folds 
aseban11: folds 
Effort92: folds 
hammerwife: folds 
Glushchenko: folds 
yoshidao: folds 
Uncalled bet ($1.25) returned to djammusic
djammusic collected $2.50 from pot
djammusic: doesn't show hand 
*** SUMMARY ***
Total pot $2.50 | Rake $0 
Seat 1: tipner folded before Flop (didn't bet)
Seat 2: butcheN18 folded before Flop (didn't bet)
Seat 3: aseban11 folded before Flop (didn't bet)
Seat 4: Effort92 folded before Flop (didn't bet)
Seat 5: hammerwife (button) folded before Flop (didn't bet)
Seat 6: Glushchenko (small blind) folded before Flop
Seat 7: yoshidao (big blind) folded before Flop
Seat 8: djammusic collected ($2.50)
Seat 9: matiko09 folded before Flop (didn't bet)





PokerStars Hand #151943183017:  Hold'em No Limit ($0.50/$1.00 USD) - 2016/04/15 13:47:00 CET [2016/04/15 7:47:00 ET]
Table 'Emma II' 9-max Seat #8 is the button
Seat 2: Filojoes ($100 in chips) 
Seat 3: Glushchenko ($228.16 in chips) 
Seat 4: matiko09 ($101.02 in chips) 
Seat 6: Tirka ($120.96 in chips) 
Seat 8: butcheN18 ($150.20 in chips) 
Filojoes: posts small blind $0.50
Glushchenko: posts big blind $1
*** HOLE CARDS ***
Dealt to matiko09 [3s 7c]
matiko09: folds 
Tirka: folds 
butcheN18: folds 
Filojoes: raises $1.50 to $2.50
Glushchenko: folds 
Uncalled bet ($1.50) returned to Filojoes
Filojoes collected $2 from pot
Filojoes: doesn't show hand 
*** SUMMARY ***
Total pot $2 | Rake $0 
Seat 2: Filojoes (small blind) collected ($2)
Seat 3: Glushchenko (big blind) folded before Flop
Seat 4: matiko09 folded before Flop (didn't bet)
Seat 6: Tirka folded before Flop (didn't bet)
Seat 8: butcheN18 (button) folded before Flop (didn't bet)





PokerStars Hand #151943184259:  Hold'em No Limit ($1/$2 USD) - 2016/04/15 13:47:02 CET [2016/04/15 7:47:02 ET]
Table 'Irmgard II' 9-max Seat #3 is the button
Seat 1: Iggso ($234.21 in chips) 
Seat 2: Kukuryzka ($200 in chips) 
Seat 3: matiko09 ($209.10 in chips) 
Seat 6: djammusic ($145.60 in chips) 
Seat 7: erfk1958 ($105.10 in chips) 
Seat 8: MoeAA11 ($68.30 in chips) 
Seat 9: maximax04 ($135.42 in chips) 
djammusic: posts small blind $1
erfk1958: posts big blind $2
*** HOLE CARDS ***
Dealt to matiko09 [4s 9h]
MoeAA11: folds 
maximax04: calls $2
Iggso: folds 
Kukuryzka: folds 
matiko09: folds 
djammusic: folds 
erfk1958: checks 
*** FLOP *** [6d Ts Kh]
erfk1958: checks 
maximax04: bets $6
erfk1958: folds 
Uncalled bet ($6) returned to maximax04
maximax04 collected $4.75 from pot
maximax04: doesn't show hand 
*** SUMMARY ***
Total pot $5 | Rake $0.25 
Board [6d Ts Kh]
Seat 1: Iggso folded before Flop (didn't bet)
Seat 2: Kukuryzka folded before Flop (didn't bet)
Seat 3: matiko09 (button) folded before Flop (didn't bet)
Seat 6: djammusic (small blind) folded before Flop
Seat 7: erfk1958 (big blind) folded on the Flop
Seat 8: MoeAA11 folded before Flop (didn't bet)
Seat 9: maximax04 collected ($4.75)





PokerStars Hand #151943185089:  Hold'em No Limit ($0.50/$1.00 USD) - 2016/04/15 13:47:04 CET [2016/04/15 7:47:04 ET]
Table 'Adelgunde III' 9-max Seat #1 is the button
Seat 1: valimiu ($54.29 in chips) 
Seat 2: djammusic ($38 in chips) 
Seat 3: tipner ($117.12 in chips) 
Seat 4: hammerwife ($100 in chips) 
Seat 5: matiko09 ($153.36 in chips) 
Seat 6: Pominator92 ($154.03 in chips) 
Seat 8: aseban11 ($101.98 in chips) 
Seat 9: Kukuryzka ($100 in chips) 
djammusic: posts small blind $0.50
tipner: posts big blind $1
*** HOLE CARDS ***
Dealt to matiko09 [Jh Qh]
hammerwife: folds 
matiko09: raises $2 to $3
Pominator92: folds 
aseban11: folds 
Kukuryzka: folds 
valimiu: folds 
djammusic: raises $4.50 to $7.50
tipner: folds 
matiko09: folds 
Uncalled bet ($4.50) returned to djammusic
djammusic collected $7 from pot
djammusic: doesn't show hand 
*** SUMMARY ***
Total pot $7 | Rake $0 
Seat 1: valimiu (button) folded before Flop (didn't bet)
Seat 2: djammusic (small blind) collected ($7)
Seat 3: tipner (big blind) folded before Flop
Seat 4: hammerwife folded before Flop (didn't bet)
Seat 5: matiko09 folded before Flop
Seat 6: Pominator92 folded before Flop (didn't bet)
Seat 8: aseban11 folded before Flop (didn't bet)
Seat 9: Kukuryzka folded before Flop (didn't bet)





PokerStars Hand #151943187603:  Hold'em No Limit ($0.50/$1.00 USD) - 2016/04/15 13:47:09 CET [2016/04/15 7:47:09 ET]
Table 'Parvulesco II' 9-max Seat #5 is the button
Seat 1: bilukm ($99.61 in chips) 
Seat 2: Filojoes ($112.57 in chips) 
Seat 3: matiko09 ($116.45 in chips) 
Seat 4: butcheN18 ($100.62 in chips) 
Seat 5: bronbeek ($99.76 in chips) 
Seat 6: ruslik_by ($100 in chips) 
Seat 7: Kukuryzka ($116.05 in chips) 
Seat 8: Jimy Tiltman ($113.70 in chips) 
Seat 9: hammerwife ($203.71 in chips) 
ruslik_by: posts small blind $0.50
Kukuryzka: posts big blind $1
*** HOLE CARDS ***
Dealt to matiko09 [Js 9h]
Jimy Tiltman: folds 
hammerwife: folds 
bilukm: raises $1 to $2
Filojoes: folds 
matiko09: folds 
butcheN18: folds 
bronbeek: folds 
ruslik_by: folds 
Kukuryzka: raises $7 to $9
bilukm: calls $7
*** FLOP *** [Qh 7s 2c]
Kukuryzka: bets $8.79
bilukm: raises $81.82 to $90.61 and is all-in
Kukuryzka: folds 
Uncalled bet ($81.82) returned to bilukm
bilukm collected $34.28 from pot
bilukm: doesn't show hand 
*** SUMMARY ***
Total pot $36.08 | Rake $1.80 
Board [Qh 7s 2c]
Seat 1: bilukm collected ($34.28)
Seat 2: Filojoes folded before Flop (didn't bet)
Seat 3: matiko09 folded before Flop (didn't bet)
Seat 4: butcheN18 folded before Flop (didn't bet)
Seat 5: bronbeek (button) folded before Flop (didn't bet)
Seat 6: ruslik_by (small blind) folded before Flop
Seat 7: Kukuryzka (big blind) folded on the Flop
Seat 8: Jimy Tiltman folded before Flop (didn't bet)
Seat 9: hammerwife folded before Flop (didn't bet)





PokerStars Hand #151943190532:  Hold'em No Limit ($1/$2 USD) - 2016/04/15 13:47:15 CET [2016/04/15 7:47:15 ET]
Table 'Adele II' 9-max Seat #4 is the button
Seat 1: RyanHuJun ($381.41 in chips) 
Seat 2: Fish4trips ($314.04 in chips) 
Seat 3: matiko09 ($309.53 in chips) 
Seat 4: Glushchenko ($203 in chips) 
Seat 6: wiseyoyo ($234.93 in chips) 
Seat 7: Iggso ($206.84 in chips) 
Seat 9: SanychStar ($283.70 in chips) 
TonnaMunz will be allowed to play after the button
wiseyoyo: posts small blind $1
Iggso: posts big blind $2
butcheN18: sits out 
*** HOLE CARDS ***
Dealt to matiko09 [9h As]
SanychStar: folds 
RyanHuJun has timed out while being disconnected
RyanHuJun: folds 
Fish4trips: folds 
RyanHuJun is disconnected 
matiko09: raises $3 to $5
Glushchenko: calls $5
wiseyoyo: folds 
Iggso: folds 
*** FLOP *** [2s 7d Kh]
wiseyoyo leaves the table
matiko09: bets $8
Kukuryzka joins the table at seat #6 
Glushchenko: folds 
Uncalled bet ($8) returned to matiko09
matiko09 collected $12.35 from pot
matiko09: doesn't show hand 
*** SUMMARY ***
Total pot $13 | Rake $0.65 
Board [2s 7d Kh]
Seat 1: RyanHuJun folded before Flop (didn't bet)
Seat 2: Fish4trips folded before Flop (didn't bet)
Seat 3: matiko09 collected ($12.35)
Seat 4: Glushchenko (button) folded on the Flop
Seat 6: wiseyoyo (small blind) folded before Flop
Seat 7: Iggso (big blind) folded before Flop
Seat 9: SanychStar folded before Flop (didn't bet)





PokerStars Hand #151943190950:  Hold'em No Limit ($0.50/$1.00 USD) - 2016/04/15 13:47:16 CET [2016/04/15 7:47:16 ET]
Table 'Emma II' 9-max Seat #2 is the button
Seat 2: Filojoes ($101 in chips) 
Seat 3: Glushchenko ($227.16 in chips) 
Seat 4: matiko09 ($101.02 in chips) 
Seat 6: Tirka ($120.96 in chips) 
Seat 8: butcheN18 ($150.20 in chips) 
Glushchenko: posts small blind $0.50
matiko09: posts big blind $1
*** HOLE CARDS ***
Dealt to matiko09 [7c 5s]
Tirka: folds 
butcheN18: raises $2 to $3
Filojoes: calls $3
Glushchenko: folds 
matiko09: folds 
*** FLOP *** [Td Qs Qc]
butcheN18: bets $3.70
Filojoes: folds 
Uncalled bet ($3.70) returned to butcheN18
ardo888 leaves the table
butcheN18 collected $7.12 from pot
butcheN18: doesn't show hand 
*** SUMMARY ***
Total pot $7.50 | Rake $0.38 
Board [Td Qs Qc]
Seat 2: Filojoes (button) folded on the Flop
Seat 3: Glushchenko (small blind) folded before Flop
Seat 4: matiko09 (big blind) folded before Flop
Seat 6: Tirka folded before Flop (didn't bet)
Seat 8: butcheN18 collected ($7.12)





PokerStars Hand #151943194442:  Hold'em No Limit ($0.50/$1.00 USD) - 2016/04/15 13:47:22 CET [2016/04/15 7:47:22 ET]
Table 'Chiny II' 9-max Seat #2 is the button
Seat 1: aseban11 ($100 in chips) 
Seat 2: Westpants ($125.58 in chips) 
Seat 4: matiko09 ($156.88 in chips) 
Seat 6: choupai ($25.55 in chips) 
Seat 7: tipner ($184.63 in chips) 
Seat 8: Filojoes ($145.24 in chips) 
Seat 9: butcheN18 ($101.50 in chips) 
matiko09: posts small blind $0.50
choupai: posts big blind $1
*** HOLE CARDS ***
Dealt to matiko09 [9h As]
tipner: folds 
Filojoes: folds 
butcheN18: raises $2 to $3
aseban11: folds 
Westpants: folds 
matiko09: folds 
choupai: folds 
Uncalled bet ($2) returned to butcheN18
butcheN18 collected $2.50 from pot
butcheN18: doesn't show hand 
*** SUMMARY ***
Total pot $2.50 | Rake $0 
Seat 1: aseban11 folded before Flop (didn't bet)
Seat 2: Westpants (button) folded before Flop (didn't bet)
Seat 4: matiko09 (small blind) folded before Flop
Seat 6: choupai (big blind) folded before Flop
Seat 7: tipner folded before Flop (didn't bet)
Seat 8: Filojoes folded before Flop (didn't bet)
Seat 9: butcheN18 collected ($2.50)





PokerStars Hand #151943197216:  Hold'em No Limit ($1/$2 USD) - 2016/04/15 13:47:28 CET [2016/04/15 7:47:28 ET]
Table 'Irmgard II' 9-max Seat #6 is the button
Seat 1: Iggso ($234.21 in chips) 
Seat 2: Kukuryzka ($200 in chips) 
Seat 3: matiko09 ($209.10 in chips) 
Seat 6: djammusic ($144.60 in chips) 
Seat 7: erfk1958 ($103.10 in chips) 
Seat 8: MoeAA11 ($68.30 in chips) 
Seat 9: maximax04 ($138.17 in chips) 
erfk1958: posts small blind $1
MoeAA11: posts big blind $2
*** HOLE CARDS ***
Dealt to matiko09 [9d Ah]
maximax04: folds 
Iggso: folds 
Kukuryzka: raises $4 to $6
matiko09: folds 
djammusic: folds 
erfk1958: folds 
MoeAA11: calls $4
*** FLOP *** [8h Qd 4c]
MoeAA11: checks 
Kukuryzka: bets $8.23
vezunchik79 is disconnected 
MoeAA11: calls $8.23
*** TURN *** [8h Qd 4c] [Kd]
MoeAA11: checks 
Kukuryzka: bets $18.65
MoeAA11: folds 
Uncalled bet ($18.65) returned to Kukuryzka
Kukuryzka collected $27.99 from pot
Kukuryzka: doesn't show hand 
*** SUMMARY ***
Total pot $29.46 | Rake $1.47 
Board [8h Qd 4c Kd]
Seat 1: Iggso folded before Flop (didn't bet)
Seat 2: Kukuryzka collected ($27.99)
Seat 3: matiko09 folded before Flop (didn't bet)
Seat 6: djammusic (button) folded before Flop (didn't bet)
Seat 7: erfk1958 (small blind) folded before Flop
Seat 8: MoeAA11 (big blind) folded on the Turn
Seat 9: maximax04 folded before Flop (didn't bet)





PokerStars Hand #151943199437:  Hold'em No Limit ($1/$2 USD) - 2016/04/15 13:47:32 CET [2016/04/15 7:47:32 ET]
Table 'Patroclus II' 9-max Seat #3 is the button
Seat 1: TonnaMunz ($215.20 in chips) 
Seat 2: Moemors ($193.04 in chips) 
Seat 3: Koolniknik ($409 in chips) 
Seat 4: tipner ($200 in chips) 
Seat 5: butcheN18 ($247.29 in chips) 
Seat 7: matiko09 ($303.89 in chips) 
Seat 8: Glushchenko ($200 in chips) 
Seat 9: Fish4trips ($228.32 in chips) 
tipner: posts small blind $1
butcheN18: posts big blind $2
*** HOLE CARDS ***
Dealt to matiko09 [Jc Jd]
matiko09: raises $3 to $5
Glushchenko: folds 
Fish4trips: folds 
TonnaMunz: folds 
Moemors: folds 
Koolniknik: folds 
tipner: folds 
butcheN18: folds 
Uncalled bet ($3) returned to matiko09
matiko09 collected $5 from pot
matiko09: doesn't show hand 
*** SUMMARY ***
Total pot $5 | Rake $0 
Seat 1: TonnaMunz folded before Flop (didn't bet)
Seat 2: Moemors folded before Flop (didn't bet)
Seat 3: Koolniknik (button) folded before Flop (didn't bet)
Seat 4: tipner (small blind) folded before Flop
Seat 5: butcheN18 (big blind) folded before Flop
Seat 7: matiko09 collected ($5)
Seat 8: Glushchenko folded before Flop (didn't bet)
Seat 9: Fish4trips folded before Flop (didn't bet)





PokerStars Hand #151943205434:  Hold'em No Limit ($0.50/$1.00 USD) - 2016/04/15 13:47:44 CET [2016/04/15 7:47:44 ET]
Table 'Adelgunde III' 9-max Seat #2 is the button
Seat 1: valimiu ($54.29 in chips) 
Seat 2: djammusic ($42 in chips) 
Seat 3: tipner ($116.12 in chips) 
Seat 4: hammerwife ($100 in chips) 
Seat 5: matiko09 ($150.36 in chips) 
Seat 6: Pominator92 ($154.03 in chips) 
Seat 8: aseban11 ($101.98 in chips) 
Seat 9: Kukuryzka ($100 in chips) 
tipner: posts small blind $0.50
hammerwife: posts big blind $1
*** HOLE CARDS ***
Dealt to matiko09 [Qd Jh]
matiko09: folds 
Pominator92: folds 
aseban11: folds 
Kukuryzka: folds 
valimiu: calls $1
djammusic: raises $3 to $4
tipner: calls $3.50
hammerwife: folds 
valimiu: folds 
*** FLOP *** [Ad 7c Ac]
tipner: checks 
djammusic: checks 
*** TURN *** [Ad 7c Ac] [9h]
tipner: checks 
djammusic: bets $5
tipner: folds 
Uncalled bet ($5) returned to djammusic
djammusic collected $9.50 from pot
djammusic: doesn't show hand 
*** SUMMARY ***
Total pot $10 | Rake $0.50 
Board [Ad 7c Ac 9h]
Seat 1: valimiu folded before Flop
Seat 2: djammusic (button) collected ($9.50)
Seat 3: tipner (small blind) folded on the Turn
Seat 4: hammerwife (big blind) folded before Flop
Seat 5: matiko09 folded before Flop (didn't bet)
Seat 6: Pominator92 folded before Flop (didn't bet)
Seat 8: aseban11 folded before Flop (didn't bet)
Seat 9: Kukuryzka folded before Flop (didn't bet)





PokerStars Hand #151943209103:  Hold'em No Limit ($0.50/$1.00 USD) - 2016/04/15 13:47:52 CET [2016/04/15 7:47:52 ET]
Table 'Chiny II' 9-max Seat #4 is the button
Seat 1: aseban11 ($100 in chips) 
Seat 2: Westpants ($125.58 in chips) 
Seat 4: matiko09 ($156.38 in chips) 
Seat 6: choupai ($24.55 in chips) 
Seat 8: Filojoes ($145.24 in chips) 
Seat 9: butcheN18 ($103 in chips) 
choupai: posts small blind $0.50
tipner: is sitting out 
Filojoes: posts big blind $1
Foton18: sits out 
*** HOLE CARDS ***
Dealt to matiko09 [7d 6c]
butcheN18: folds 
aseban11: raises $2 to $3
Westpants: calls $3
matiko09: folds 
choupai: folds 
Filojoes: folds 
*** FLOP *** [3d Js Qh]
aseban11: bets $5.34
Westpants: calls $5.34
*** TURN *** [3d Js Qh] [2d]
aseban11: checks 
Westpants: checks 
*** RIVER *** [3d Js Qh 2d] [Tc]
aseban11: bets $12.95
Westpants: raises $12.95 to $25.90
aseban11: folds 
Uncalled bet ($12.95) returned to Westpants
Westpants collected $41.88 from pot
*** SUMMARY ***
Total pot $44.08 | Rake $2.20 
Board [3d Js Qh 2d Tc]
Seat 1: aseban11 folded on the River
Seat 2: Westpants collected ($41.88)
Seat 4: matiko09 (button) folded before Flop (didn't bet)
Seat 6: choupai (small blind) folded before Flop
Seat 8: Filojoes (big blind) folded before Flop
Seat 9: butcheN18 folded before Flop (didn't bet)





PokerStars Hand #151943213255:  Hold'em No Limit ($0.50/$1.00 USD) - 2016/04/15 13:48:00 CET [2016/04/15 7:48:00 ET]
Table 'Navi' 9-max Seat #6 is the button
Seat 2: butcheN18 ($100 in chips) 
Seat 3: aseban11 ($100 in chips) 
Seat 4: Effort92 ($169.96 in chips) 
Seat 5: hammerwife ($104.32 in chips) 
Seat 6: Glushchenko ($100 in chips) 
Seat 7: yoshidao ($126.53 in chips) 
Seat 8: djammusic ($41 in chips) 
Seat 9: matiko09 ($136.63 in chips) 
yoshidao: posts small blind $0.50
djammusic: posts big blind $1
*** HOLE CARDS ***
Dealt to matiko09 [Kh 9c]
matiko09: folds 
butcheN18: raises $2 to $3
aseban11: folds 
Effort92: folds 
hammerwife: folds 
Glushchenko: folds 
yoshidao: folds 
djammusic: folds 
Uncalled bet ($2) returned to butcheN18
butcheN18 collected $2.50 from pot
butcheN18: doesn't show hand 
*** SUMMARY ***
Total pot $2.50 | Rake $0 
Seat 2: butcheN18 collected ($2.50)
Seat 3: aseban11 folded before Flop (didn't bet)
Seat 4: Effort92 folded before Flop (didn't bet)
Seat 5: hammerwife folded before Flop (didn't bet)
Seat 6: Glushchenko (button) folded before Flop (didn't bet)
Seat 7: yoshidao (small blind) folded before Flop
Seat 8: djammusic (big blind) folded before Flop
Seat 9: matiko09 folded before Flop (didn't bet)





PokerStars Hand #151943215339:  Hold'em No Limit ($1/$2 USD) - 2016/04/15 13:48:04 CET [2016/04/15 7:48:04 ET]
Table 'Patroclus II' 9-max Seat #4 is the button
Seat 1: TonnaMunz ($215.20 in chips) 
Seat 2: Moemors ($193.04 in chips) 
Seat 3: Koolniknik ($409 in chips) 
Seat 4: tipner ($200 in chips) 
Seat 5: butcheN18 ($245.29 in chips) 
Seat 7: matiko09 ($306.89 in chips) 
Seat 8: Glushchenko ($200 in chips) 
Seat 9: Fish4trips ($228.32 in chips) 
butcheN18: posts small blind $1
matiko09: posts big blind $2
*** HOLE CARDS ***
Dealt to matiko09 [Jc Qc]
Glushchenko: folds 
Fish4trips: folds 
TonnaMunz: raises $2.96 to $4.96
Moemors: folds 
Koolniknik: folds 
Koolniknik leaves the table
wiseyoyo joins the table at seat #3 
tipner: folds 
butcheN18: folds 
wiseyoyo leaves the table
matiko09: calls $2.96
*** FLOP *** [Ad 8s 5c]
matiko09: checks 
TonnaMunz: checks 
*** TURN *** [Ad 8s 5c] [2d]
matiko09: checks 
TonnaMunz: checks 
*** RIVER *** [Ad 8s 5c 2d] [Jh]
matiko09: checks 
derrocco82 joins the table at seat #3 
TonnaMunz: checks 
*** SHOW DOWN ***
matiko09: shows [Jc Qc] (a pair of Jacks)
TonnaMunz: mucks hand 
matiko09 collected $10.37 from pot
*** SUMMARY ***
Total pot $10.92 | Rake $0.55 
Board [Ad 8s 5c 2d Jh]
Seat 1: TonnaMunz mucked [3h 3c]
Seat 2: Moemors folded before Flop (didn't bet)
Seat 3: Koolniknik folded before Flop (didn't bet)
Seat 4: tipner (button) folded before Flop (didn't bet)
Seat 5: butcheN18 (small blind) folded before Flop
Seat 7: matiko09 (big blind) showed [Jc Qc] and won ($10.37) with a pair of Jacks
Seat 8: Glushchenko folded before Flop (didn't bet)
Seat 9: Fish4trips folded before Flop (didn't bet)





PokerStars Hand #151943216880:  Hold'em No Limit ($0.50/$1.00 USD) - 2016/04/15 13:48:07 CET [2016/04/15 7:48:07 ET]
Table 'Emma II' 9-max Seat #3 is the button
Seat 2: Filojoes ($100 in chips) 
Seat 3: Glushchenko ($226.66 in chips) 
Seat 4: matiko09 ($100.02 in chips) 
Seat 6: Tirka ($120.96 in chips) 
Seat 8: butcheN18 ($154.32 in chips) 
matiko09: posts small blind $0.50
Tirka: posts big blind $1
Foton18: sits out 
*** HOLE CARDS ***
Dealt to matiko09 [7c 9s]
aseban11 joins the table at seat #7 
butcheN18: folds 
Filojoes: folds 
Glushchenko: folds 
matiko09: folds 
Uncalled bet ($0.50) returned to Tirka
Tirka collected $1 from pot
Tirka: doesn't show hand 
*** SUMMARY ***
Total pot $1 | Rake $0 
Seat 2: Filojoes folded before Flop (didn't bet)
Seat 3: Glushchenko (button) folded before Flop (didn't bet)
Seat 4: matiko09 (small blind) folded before Flop
Seat 6: Tirka (big blind) collected ($1)
Seat 8: butcheN18 folded before Flop (didn't bet)





PokerStars Hand #151943218062:  Hold'em No Limit ($1/$2 USD) - 2016/04/15 13:48:10 CET [2016/04/15 7:48:10 ET]
Table 'Blaauw' 9-max Seat #6 is the button
Seat 1: wiseyoyo ($542.58 in chips) 
Seat 2: butcheN18 ($262.60 in chips) 
Seat 3: Glushchenko ($237.85 in chips) 
Seat 5: tipner ($200 in chips) 
Seat 6: matiko09 ($226 in chips) 
Seat 7: ssljvr ($404.07 in chips) 
Seat 9: coinflip_si ($204.88 in chips) 
ssljvr: posts small blind $1
coinflip_si: posts big blind $2
*** HOLE CARDS ***
Dealt to matiko09 [2d 5s]
Iggso joins the table at seat #8 
wiseyoyo: folds 
wiseyoyo leaves the table
butcheN18: folds 
Glushchenko: folds 
tipner: folds 
matiko09: folds 
ssljvr: raises $4 to $6
coinflip_si: raises $14 to $20
ssljvr: folds 
Uncalled bet ($14) returned to coinflip_si
coinflip_si collected $12 from pot
coinflip_si: doesn't show hand 
*** SUMMARY ***
Total pot $12 | Rake $0 
Seat 1: wiseyoyo folded before Flop (didn't bet)
Seat 2: butcheN18 folded before Flop (didn't bet)
Seat 3: Glushchenko folded before Flop (didn't bet)
Seat 5: tipner folded before Flop (didn't bet)
Seat 6: matiko09 (button) folded before Flop (didn't bet)
Seat 7: ssljvr (small blind) folded before Flop
Seat 9: coinflip_si (big blind) collected ($12)





PokerStars Hand #151943219373:  Hold'em No Limit ($1/$2 USD) - 2016/04/15 13:48:12 CET [2016/04/15 7:48:12 ET]
Table 'Oceax' 9-max Seat #8 is the button
Seat 1: matiko09 ($200 in chips) 
Seat 2: Fish4trips ($328.03 in chips) 
Seat 3: GB223 ($200 in chips) 
Seat 4: butcheN18 ($224.42 in chips) 
Seat 6: Iggso ($263.50 in chips) 
Seat 7: coinflip_si ($216.25 in chips) 
Seat 8: Poroxide ($298.82 in chips) 
erfk1958 will be allowed to play after the button
matiko09: posts small blind $1
Fish4trips: posts big blind $2
*** HOLE CARDS ***
Dealt to matiko09 [Kd 3d]
GB223: folds 
butcheN18: folds 
Iggso: raises $4 to $6
coinflip_si: folds 
Poroxide: folds 
matiko09: folds 
Fish4trips: folds 
Uncalled bet ($4) returned to Iggso
Iggso collected $5 from pot
Iggso: doesn't show hand 
*** SUMMARY ***
Total pot $5 | Rake $0 
Seat 1: matiko09 (small blind) folded before Flop
Seat 2: Fish4trips (big blind) folded before Flop
Seat 3: GB223 folded before Flop (didn't bet)
Seat 4: butcheN18 folded before Flop (didn't bet)
Seat 6: Iggso collected ($5)
Seat 7: coinflip_si folded before Flop (didn't bet)
Seat 8: Poroxide (button) folded before Flop (didn't bet)





PokerStars Hand #151943220974:  Hold'em No Limit ($0.50/$1.00 USD) - 2016/04/15 13:48:16 CET [2016/04/15 7:48:16 ET]
Table 'Parvulesco II' 9-max Seat #6 is the button
Seat 1: bilukm ($116.10 in chips) 
Seat 2: Filojoes ($112.57 in chips) 
Seat 3: matiko09 ($116.45 in chips) 
Seat 4: butcheN18 ($100.62 in chips) 
Seat 5: bronbeek ($99.76 in chips) 
Seat 6: ruslik_by ($100 in chips) 
Seat 7: Kukuryzka ($100 in chips) 
Seat 8: Jimy Tiltman ($113.70 in chips) 
Seat 9: hammerwife ($203.71 in chips) 
Kukuryzka: posts small blind $0.50
Jimy Tiltman: posts big blind $1
*** HOLE CARDS ***
Dealt to matiko09 [Ad 9c]
hammerwife: folds 
bilukm: folds 
Filojoes: raises $2 to $3
matiko09: folds 
butcheN18: folds 
bronbeek: folds 
ruslik_by: raises $6 to $9
Kukuryzka: folds 
Jimy Tiltman: folds 
Filojoes: folds 
Uncalled bet ($6) returned to ruslik_by
ruslik_by collected $7.50 from pot
ruslik_by: doesn't show hand 
*** SUMMARY ***
Total pot $7.50 | Rake $0 
Seat 1: bilukm folded before Flop (didn't bet)
Seat 2: Filojoes folded before Flop
Seat 3: matiko09 folded before Flop (didn't bet)
Seat 4: butcheN18 folded before Flop (didn't bet)
Seat 5: bronbeek folded before Flop (didn't bet)
Seat 6: ruslik_by (button) collected ($7.50)
Seat 7: Kukuryzka (small blind) folded before Flop
Seat 8: Jimy Tiltman (big blind) folded before Flop
Seat 9: hammerwife folded before Flop (didn't bet)





PokerStars Hand #151943225661:  Hold'em No Limit ($0.50/$1.00 USD) - 2016/04/15 13:48:25 CET [2016/04/15 7:48:25 ET]
Table 'Emma II' 9-max Seat #4 is the button
Seat 2: Filojoes ($100 in chips) 
Seat 3: Glushchenko ($226.66 in chips) 
Seat 4: matiko09 ($100 in chips) 
Seat 6: Tirka ($121.46 in chips) 
Seat 7: aseban11 ($100 in chips) 
Seat 8: butcheN18 ($154.32 in chips) 
Tirka: posts small blind $0.50
aseban11: posts big blind $1
Foton18: sits out 
*** HOLE CARDS ***
Dealt to matiko09 [4s 9h]
butcheN18: folds 
Filojoes: raises $2 to $3
Glushchenko: folds 
matiko09: folds 
Tirka: folds 
aseban11: folds 
Uncalled bet ($2) returned to Filojoes
Filojoes collected $2.50 from pot
Filojoes: doesn't show hand 
*** SUMMARY ***
Total pot $2.50 | Rake $0 
Seat 2: Filojoes collected ($2.50)
Seat 3: Glushchenko folded before Flop (didn't bet)
Seat 4: matiko09 (button) folded before Flop (didn't bet)
Seat 6: Tirka (small blind) folded before Flop
Seat 7: aseban11 (big blind) folded before Flop
Seat 8: butcheN18 folded before Flop (didn't bet)





PokerStars Hand #151943227078:  Hold'em No Limit ($1/$2 USD) - 2016/04/15 13:48:28 CET [2016/04/15 7:48:28 ET]
Table 'Irmgard II' 9-max Seat #7 is the button
Seat 1: Iggso ($234.21 in chips) 
Seat 2: Kukuryzka ($213.76 in chips) 
Seat 3: matiko09 ($209.10 in chips) 
Seat 6: djammusic ($144.60 in chips) 
Seat 7: erfk1958 ($102.10 in chips) 
Seat 8: MoeAA11 ($54.07 in chips) 
Seat 9: maximax04 ($138.17 in chips) 
MoeAA11: posts small blind $1
maximax04: posts big blind $2
di0d80: sits out 
*** HOLE CARDS ***
Dealt to matiko09 [6d Ac]
Iggso: folds 
Kukuryzka: folds 
matiko09: folds 
djammusic: raises $2.04 to $4.04
erfk1958: folds 
MoeAA11: folds 
maximax04: calls $2.04
*** FLOP *** [7d 6c 4s]
maximax04: bets $6
djammusic: folds 
Uncalled bet ($6) returned to maximax04
maximax04 collected $8.63 from pot
maximax04: doesn't show hand 
*** SUMMARY ***
Total pot $9.08 | Rake $0.45 
Board [7d 6c 4s]
Seat 1: Iggso folded before Flop (didn't bet)
Seat 2: Kukuryzka folded before Flop (didn't bet)
Seat 3: matiko09 folded before Flop (didn't bet)
Seat 6: djammusic folded on the Flop
Seat 7: erfk1958 (button) folded before Flop (didn't bet)
Seat 8: MoeAA11 (small blind) folded before Flop
Seat 9: maximax04 (big blind) collected ($8.63)





PokerStars Hand #151943231318:  Hold'em No Limit ($0.50/$1.00 USD) - 2016/04/15 13:48:36 CET [2016/04/15 7:48:36 ET]
Table 'Navi' 9-max Seat #7 is the button
Seat 2: butcheN18 ($101.50 in chips) 
Seat 3: aseban11 ($100 in chips) 
Seat 4: Effort92 ($169.96 in chips) 
Seat 5: hammerwife ($104.32 in chips) 
Seat 6: Glushchenko ($100 in chips) 
Seat 7: yoshidao ($126.03 in chips) 
Seat 8: djammusic ($40 in chips) 
Seat 9: matiko09 ($136.63 in chips) 
djammusic: posts small blind $0.50
matiko09: posts big blind $1
*** HOLE CARDS ***
Dealt to matiko09 [Qc 9h]
butcheN18: raises $2 to $3
aseban11: folds 
Effort92: calls $3
hammerwife: folds 
Glushchenko: folds 
yoshidao: folds 
djammusic: folds 
matiko09: folds 
*** FLOP *** [8h Ah 9c]
butcheN18: bets $4.55
Effort92: calls $4.55
*** TURN *** [8h Ah 9c] [Kd]
butcheN18: checks 
Effort92: bets $10.40
butcheN18: folds 
Uncalled bet ($10.40) returned to Effort92
Effort92 collected $15.77 from pot
Effort92: doesn't show hand 
*** SUMMARY ***
Total pot $16.60 | Rake $0.83 
Board [8h Ah 9c Kd]
Seat 2: butcheN18 folded on the Turn
Seat 3: aseban11 folded before Flop (didn't bet)
Seat 4: Effort92 collected ($15.77)
Seat 5: hammerwife folded before Flop (didn't bet)
Seat 6: Glushchenko folded before Flop (didn't bet)
Seat 7: yoshidao (button) folded before Flop (didn't bet)
Seat 8: djammusic (small blind) folded before Flop
Seat 9: matiko09 (big blind) folded before Flop





PokerStars Hand #151943231874:  Hold'em No Limit ($0.50/$1.00 USD) - 2016/04/15 13:48:37 CET [2016/04/15 7:48:37 ET]
Table 'Adelgunde III' 9-max Seat #3 is the button
Seat 1: valimiu ($53.29 in chips) 
Seat 2: djammusic ($47.50 in chips) 
Seat 3: tipner ($112.12 in chips) 
Seat 4: hammerwife ($100 in chips) 
Seat 5: matiko09 ($150.36 in chips) 
Seat 6: Pominator92 ($154.03 in chips) 
Seat 8: aseban11 ($101.98 in chips) 
Seat 9: Kukuryzka ($100 in chips) 
hammerwife: posts small blind $0.50
matiko09: posts big blind $1
*** HOLE CARDS ***
Dealt to matiko09 [2d 6h]
Pominator92: raises $2 to $3
aseban11: folds 
Kukuryzka: folds 
valimiu: folds 
djammusic: folds 
tipner: folds 
hammerwife: folds 
matiko09: folds 
Uncalled bet ($2) returned to Pominator92
Pominator92 collected $2.50 from pot
Pominator92: doesn't show hand 
*** SUMMARY ***
Total pot $2.50 | Rake $0 
Seat 1: valimiu folded before Flop (didn't bet)
Seat 2: djammusic folded before Flop (didn't bet)
Seat 3: tipner (button) folded before Flop (didn't bet)
Seat 4: hammerwife (small blind) folded before Flop
Seat 5: matiko09 (big blind) folded before Flop
Seat 6: Pominator92 collected ($2.50)
Seat 8: aseban11 folded before Flop (didn't bet)
Seat 9: Kukuryzka folded before Flop (didn't bet)





PokerStars Hand #151943234823:  Hold'em No Limit ($1/$2 USD) - 2016/04/15 13:48:43 CET [2016/04/15 7:48:43 ET]
Table 'Oceax' 9-max Seat #1 is the button
Seat 1: matiko09 ($200 in chips) 
Seat 2: Fish4trips ($326.03 in chips) 
Seat 4: butcheN18 ($224.42 in chips) 
Seat 6: Iggso ($266.50 in chips) 
Seat 7: coinflip_si ($216.25 in chips) 
Seat 8: Poroxide ($298.82 in chips) 
Fish4trips: posts small blind $1
GB223: is sitting out 
butcheN18: posts big blind $2
di0d80: sits out 
erfk1958: sits out 
*** HOLE CARDS ***
Dealt to matiko09 [7c 6c]
Iggso: raises $4 to $6
coinflip_si: folds 
Poroxide: folds 
matiko09: folds 
Fish4trips: folds 
butcheN18: raises $14 to $20
GB223 leaves the table
Iggso: folds 
Uncalled bet ($14) returned to butcheN18
butcheN18 collected $13 from pot
butcheN18: doesn't show hand 
*** SUMMARY ***
Total pot $13 | Rake $0 
Seat 1: matiko09 (button) folded before Flop (didn't bet)
Seat 2: Fish4trips (small blind) folded before Flop
Seat 4: butcheN18 (big blind) collected ($13)
Seat 6: Iggso folded before Flop
Seat 7: coinflip_si folded before Flop (didn't bet)
Seat 8: Poroxide folded before Flop (didn't bet)





PokerStars Hand #151943235474:  Hold'em No Limit ($1/$2 USD) - 2016/04/15 13:48:44 CET [2016/04/15 7:48:44 ET]
Table 'Blaauw' 9-max Seat #7 is the button
Seat 2: butcheN18 ($262.60 in chips) 
Seat 3: Glushchenko ($237.85 in chips) 
Seat 4: petro0107 ($250.89 in chips) 
Seat 5: tipner ($200 in chips) 
Seat 6: matiko09 ($226 in chips) 
Seat 7: ssljvr ($398.07 in chips) 
Seat 9: coinflip_si ($210.88 in chips) 
Iggso will be allowed to play after the button
coinflip_si: posts small blind $1
butcheN18: posts big blind $2
*** HOLE CARDS ***
Dealt to matiko09 [Kh 6c]
Glushchenko: folds 
petro0107: folds 
tipner: raises $4 to $6
matiko09: folds 
ssljvr: folds 
coinflip_si: folds 
butcheN18: folds 
Uncalled bet ($4) returned to tipner
tipner collected $5 from pot
tipner: doesn't show hand 
*** SUMMARY ***
Total pot $5 | Rake $0 
Seat 2: butcheN18 (big blind) folded before Flop
Seat 3: Glushchenko folded before Flop (didn't bet)
Seat 4: petro0107 folded before Flop (didn't bet)
Seat 5: tipner collected ($5)
Seat 6: matiko09 folded before Flop (didn't bet)
Seat 7: ssljvr (button) folded before Flop (didn't bet)
Seat 9: coinflip_si (small blind) folded before Flop





PokerStars Hand #151943240660:  Hold'em No Limit ($1/$2 USD) - 2016/04/15 13:48:54 CET [2016/04/15 7:48:54 ET]
Table 'Adele II' 9-max Seat #7 is the button
Seat 1: RyanHuJun ($381.41 in chips) 
Seat 2: Fish4trips ($314.04 in chips) 
Seat 3: matiko09 ($316.88 in chips) 
Seat 4: Glushchenko ($200 in chips) 
Seat 7: Iggso ($204.84 in chips) 
Seat 9: SanychStar ($283.70 in chips) 
butcheN18 will be allowed to play after the button
SanychStar: posts small blind $1
RyanHuJun: posts big blind $2
TonnaMunz: sits out 
Kukuryzka: sits out 
*** HOLE CARDS ***
Dealt to matiko09 [3c 4s]
Fish4trips: folds 
matiko09: folds 
Glushchenko: folds 
Iggso: folds 
SanychStar: raises $3 to $5
RyanHuJun: calls $3
*** FLOP *** [Kc Jd 7h]
SanychStar: checks 
RyanHuJun: checks 
*** TURN *** [Kc Jd 7h] [Kh]
SanychStar: bets $4.75
RyanHuJun: calls $4.75
*** RIVER *** [Kc Jd 7h Kh] [2h]
SanychStar: bets $7
RyanHuJun: calls $7
*** SHOW DOWN ***
SanychStar: shows [Jc Tc] (two pair, Kings and Jacks)
RyanHuJun: mucks hand 
SanychStar collected $31.82 from pot
*** SUMMARY ***
Total pot $33.50 | Rake $1.68 
Board [Kc Jd 7h Kh 2h]
Seat 1: RyanHuJun (big blind) mucked [Js 3h]
Seat 2: Fish4trips folded before Flop (didn't bet)
Seat 3: matiko09 folded before Flop (didn't bet)
Seat 4: Glushchenko folded before Flop (didn't bet)
Seat 7: Iggso (button) folded before Flop (didn't bet)
Seat 9: SanychStar (small blind) showed [Jc Tc] and won ($31.82) with two pair, Kings and Jacks





PokerStars Hand #151943243971:  Hold'em No Limit ($0.50/$1.00 USD) - 2016/04/15 13:49:01 CET [2016/04/15 7:49:01 ET]
Table 'Emma II' 9-max Seat #6 is the button
Seat 2: Filojoes ($101.50 in chips) 
Seat 3: Glushchenko ($226.66 in chips) 
Seat 4: matiko09 ($100 in chips) 
Seat 6: Tirka ($120.96 in chips) 
Seat 7: aseban11 ($100 in chips) 
Seat 8: butcheN18 ($154.32 in chips) 
aseban11: posts small blind $0.50
butcheN18: posts big blind $1
Foton18: sits out 
*** HOLE CARDS ***
Dealt to matiko09 [Qc Kh]
Filojoes: folds 
Glushchenko: folds 
matiko09: raises $2 to $3
Tirka: folds 
aseban11: folds 
butcheN18: folds 
Uncalled bet ($2) returned to matiko09
matiko09 collected $2.50 from pot
matiko09: doesn't show hand 
*** SUMMARY ***
Total pot $2.50 | Rake $0 
Seat 2: Filojoes folded before Flop (didn't bet)
Seat 3: Glushchenko folded before Flop (didn't bet)
Seat 4: matiko09 collected ($2.50)
Seat 6: Tirka (button) folded before Flop (didn't bet)
Seat 7: aseban11 (small blind) folded before Flop
Seat 8: butcheN18 (big blind) folded before Flop





PokerStars Hand #151943246840:  Hold'em No Limit ($1/$2 USD) - 2016/04/15 13:49:06 CET [2016/04/15 7:49:06 ET]
Table 'Oceax' 9-max Seat #2 is the button
Seat 1: matiko09 ($200 in chips) 
Seat 2: Fish4trips ($325.03 in chips) 
Seat 4: butcheN18 ($231.42 in chips) 
Seat 5: di0d80 ($200 in chips) 
Seat 6: Iggso ($260.50 in chips) 
Seat 7: coinflip_si ($216.25 in chips) 
Seat 8: Poroxide ($298.82 in chips) 
butcheN18: posts small blind $1
di0d80: posts big blind $2
erfk1958: sits out 
*** HOLE CARDS ***
Dealt to matiko09 [7s 8s]
Iggso: folds 
coinflip_si: folds 
Poroxide: folds 
matiko09: raises $3 to $5
Fish4trips: folds 
butcheN18: folds 
di0d80: raises $11 to $16
Glushchenko joins the table at seat #3 
matiko09: folds 
Uncalled bet ($11) returned to di0d80
di0d80 collected $11 from pot
di0d80: doesn't show hand 
*** SUMMARY ***
Total pot $11 | Rake $0 
Seat 1: matiko09 folded before Flop
Seat 2: Fish4trips (button) folded before Flop (didn't bet)
Seat 4: butcheN18 (small blind) folded before Flop
Seat 5: di0d80 (big blind) collected ($11)
Seat 6: Iggso folded before Flop (didn't bet)
Seat 7: coinflip_si folded before Flop (didn't bet)
Seat 8: Poroxide folded before Flop (didn't bet)





PokerStars Hand #151943249060:  Hold'em No Limit ($1/$2 USD) - 2016/04/15 13:49:11 CET [2016/04/15 7:49:11 ET]
Table 'Patroclus II' 9-max Seat #5 is the button
Seat 1: TonnaMunz ($210.24 in chips) 
Seat 2: Moemors ($193.04 in chips) 
Seat 4: tipner ($200 in chips) 
Seat 5: butcheN18 ($244.29 in chips) 
Seat 7: matiko09 ($312.30 in chips) 
Seat 8: Glushchenko ($200 in chips) 
Seat 9: Fish4trips ($228.32 in chips) 
di0d80 will be allowed to play after the button
matiko09: posts small blind $1
Glushchenko: posts big blind $2
derrocco82: sits out 
*** HOLE CARDS ***
Dealt to matiko09 [7d Ac]
Fish4trips: folds 
TonnaMunz: folds 
Moemors: folds 
tipner: folds 
butcheN18: folds 
tipner leaves the table
matiko09: raises $3 to $5
Glushchenko: raises $14 to $19
matiko09: folds 
Uncalled bet ($14) returned to Glushchenko
Glushchenko collected $10 from pot
*** SUMMARY ***
Total pot $10 | Rake $0 
Seat 1: TonnaMunz folded before Flop (didn't bet)
Seat 2: Moemors folded before Flop (didn't bet)
Seat 4: tipner folded before Flop (didn't bet)
Seat 5: butcheN18 (button) folded before Flop (didn't bet)
Seat 7: matiko09 (small blind) folded before Flop
Seat 8: Glushchenko (big blind) collected ($10)
Seat 9: Fish4trips folded before Flop (didn't bet)





PokerStars Hand #151943249833:  Hold'em No Limit ($1/$2 USD) - 2016/04/15 13:49:13 CET [2016/04/15 7:49:13 ET]
Table 'Blaauw' 9-max Seat #9 is the button
Seat 2: butcheN18 ($260.60 in chips) 
Seat 3: Glushchenko ($237.85 in chips) 
Seat 4: petro0107 ($250.89 in chips) 
Seat 5: tipner ($203 in chips) 
Seat 6: matiko09 ($226 in chips) 
Seat 7: ssljvr ($398.07 in chips) 
Seat 9: coinflip_si ($209.88 in chips) 
butcheN18: posts small blind $1
Glushchenko: posts big blind $2
Iggso: sits out 
*** HOLE CARDS ***
Dealt to matiko09 [Ac Tc]
petro0107: folds 
tipner: folds 
myatiy 96 joins the table at seat #1 
matiko09: raises $3 to $5
ssljvr: folds 
coinflip_si: folds 
butcheN18: folds 
Glushchenko: folds 
Uncalled bet ($3) returned to matiko09
matiko09 collected $5 from pot
matiko09: doesn't show hand 
*** SUMMARY ***
Total pot $5 | Rake $0 
Seat 2: butcheN18 (small blind) folded before Flop
Seat 3: Glushchenko (big blind) folded before Flop
Seat 4: petro0107 folded before Flop (didn't bet)
Seat 5: tipner folded before Flop (didn't bet)
Seat 6: matiko09 collected ($5)
Seat 7: ssljvr folded before Flop (didn't bet)
Seat 9: coinflip_si (button) folded before Flop (didn't bet)





PokerStars Hand #151943251248:  Hold'em No Limit ($1/$2 USD) - 2016/04/15 13:49:15 CET [2016/04/15 7:49:15 ET]
Table 'Irmgard II' 9-max Seat #8 is the button
Seat 1: Iggso ($234.21 in chips) 
Seat 2: Kukuryzka ($213.76 in chips) 
Seat 3: matiko09 ($209.10 in chips) 
Seat 6: djammusic ($140.56 in chips) 
Seat 7: erfk1958 ($102.10 in chips) 
Seat 8: MoeAA11 ($53.07 in chips) 
Seat 9: maximax04 ($142.76 in chips) 
maximax04: posts small blind $1
Iggso: posts big blind $2
di0d80: sits out 
*** HOLE CARDS ***
Dealt to matiko09 [2c 7h]
Kukuryzka: folds 
matiko09: folds 
djammusic: folds 
erfk1958: folds 
MoeAA11: calls $2
maximax04: calls $1
Iggso: checks 
*** FLOP *** [4s Jh 6d]
maximax04: bets $4
Iggso: folds 
MoeAA11: calls $4
*** TURN *** [4s Jh 6d] [9s]
maximax04: bets $6
MoeAA11: calls $6
*** RIVER *** [4s Jh 6d 9s] [2d]
maximax04: bets $8
MoeAA11: folds 
Uncalled bet ($8) returned to maximax04
maximax04 collected $24.70 from pot
maximax04: doesn't show hand 
*** SUMMARY ***
Total pot $26 | Rake $1.30 
Board [4s Jh 6d 9s 2d]
Seat 1: Iggso (big blind) folded on the Flop
Seat 2: Kukuryzka folded before Flop (didn't bet)
Seat 3: matiko09 folded before Flop (didn't bet)
Seat 6: djammusic folded before Flop (didn't bet)
Seat 7: erfk1958 folded before Flop (didn't bet)
Seat 8: MoeAA11 (button) folded on the River
Seat 9: maximax04 (small blind) collected ($24.70)





PokerStars Hand #151943251393:  Hold'em No Limit ($0.50/$1.00 USD) - 2016/04/15 13:49:16 CET [2016/04/15 7:49:16 ET]
Table 'Adelgunde III' 9-max Seat #4 is the button
Seat 1: valimiu ($53.29 in chips) 
Seat 2: djammusic ($47.50 in chips) 
Seat 3: tipner ($112.12 in chips) 
Seat 4: hammerwife ($100 in chips) 
Seat 5: matiko09 ($149.36 in chips) 
Seat 6: Pominator92 ($155.53 in chips) 
Seat 8: aseban11 ($101.98 in chips) 
Seat 9: Kukuryzka ($100 in chips) 
matiko09: posts small blind $0.50
Pominator92: posts big blind $1
*** HOLE CARDS ***
Dealt to matiko09 [8d As]
aseban11: folds 
Kukuryzka: folds 
valimiu: calls $1
djammusic: folds 
tipner: folds 
hammerwife: folds 
matiko09: calls $0.50
Pominator92: checks 
*** FLOP *** [Ks 3c Kh]
matiko09: checks 
Pominator92: bets $1
valimiu: calls $1
matiko09: folds 
*** TURN *** [Ks 3c Kh] [Js]
Pominator92: bets $3
valimiu: calls $3
*** RIVER *** [Ks 3c Kh Js] [Qs]
Pominator92: bets $5.22
valimiu: folds 
Uncalled bet ($5.22) returned to Pominator92
Pominator92 collected $10.45 from pot
Pominator92: doesn't show hand 
*** SUMMARY ***
Total pot $11 | Rake $0.55 
Board [Ks 3c Kh Js Qs]
Seat 1: valimiu folded on the River
Seat 2: djammusic folded before Flop (didn't bet)
Seat 3: tipner folded before Flop (didn't bet)
Seat 4: hammerwife (button) folded before Flop (didn't bet)
Seat 5: matiko09 (small blind) folded on the Flop
Seat 6: Pominator92 (big blind) collected ($10.45)
Seat 8: aseban11 folded before Flop (didn't bet)
Seat 9: Kukuryzka folded before Flop (didn't bet)





PokerStars Hand #151943252568:  Hold'em No Limit ($0.50/$1.00 USD) - 2016/04/15 13:49:18 CET [2016/04/15 7:49:18 ET]
Table 'Chiny II' 9-max Seat #6 is the button
Seat 1: aseban11 ($100 in chips) 
Seat 2: Westpants ($146.17 in chips) 
Seat 4: matiko09 ($156.38 in chips) 
Seat 6: choupai ($24.05 in chips) 
Seat 8: Filojoes ($144.24 in chips) 
Seat 9: butcheN18 ($103 in chips) 
Filojoes: posts small blind $0.50
butcheN18: posts big blind $1
Foton18: sits out 
*** HOLE CARDS ***
Dealt to matiko09 [Qs Ah]
aseban11: folds 
Westpants: folds 
matiko09: raises $1.50 to $2.50
choupai: calls $2.50
Filojoes: folds 
butcheN18: folds 
*** FLOP *** [5h Qd 3s]
matiko09: bets $4.02
choupai: calls $4.02
*** TURN *** [5h Qd 3s] [9c]
matiko09: bets $8.98
choupai: folds 
Uncalled bet ($8.98) returned to matiko09
matiko09 collected $13.81 from pot
matiko09: doesn't show hand 
*** SUMMARY ***
Total pot $14.54 | Rake $0.73 
Board [5h Qd 3s 9c]
Seat 1: aseban11 folded before Flop (didn't bet)
Seat 2: Westpants folded before Flop (didn't bet)
Seat 4: matiko09 collected ($13.81)
Seat 6: choupai (button) folded on the Turn
Seat 8: Filojoes (small blind) folded before Flop
Seat 9: butcheN18 (big blind) folded before Flop





PokerStars Hand #151943255048:  Hold'em No Limit ($0.50/$1.00 USD) - 2016/04/15 13:49:23 CET [2016/04/15 7:49:23 ET]
Table 'Emma II' 9-max Seat #7 is the button
Seat 2: Filojoes ($101.50 in chips) 
Seat 3: Glushchenko ($226.66 in chips) 
Seat 4: matiko09 ($101.50 in chips) 
Seat 6: Tirka ($120.96 in chips) 
Seat 7: aseban11 ($100 in chips) 
Seat 8: butcheN18 ($153.32 in chips) 
Seat 9: Foton18 ($109.54 in chips) 
butcheN18: posts small blind $0.50
Foton18: posts big blind $1
*** HOLE CARDS ***
Dealt to matiko09 [2c Qs]
Filojoes: folds 
Glushchenko: folds 
matiko09: folds 
Tirka: raises $2 to $3
aseban11: folds 
butcheN18: folds 
Foton18: calls $2
*** FLOP *** [Ts 6d 5d]
Foton18: checks 
Tirka: checks 
*** TURN *** [Ts 6d 5d] [3s]
Foton18: bets $3
Tirka: calls $3
*** RIVER *** [Ts 6d 5d 3s] [Ac]
Foton18: checks 
Tirka: bets $7.91
Foton18: folds 
Uncalled bet ($7.91) returned to Tirka
Tirka collected $11.88 from pot
Tirka: doesn't show hand 
*** SUMMARY ***
Total pot $12.50 | Rake $0.62 
Board [Ts 6d 5d 3s Ac]
Seat 2: Filojoes folded before Flop (didn't bet)
Seat 3: Glushchenko folded before Flop (didn't bet)
Seat 4: matiko09 folded before Flop (didn't bet)
Seat 6: Tirka collected ($11.88)
Seat 7: aseban11 (button) folded before Flop (didn't bet)
Seat 8: butcheN18 (small blind) folded before Flop
Seat 9: Foton18 (big blind) folded on the River





PokerStars Hand #151943256257:  Hold'em No Limit ($0.50/$1.00 USD) - 2016/04/15 13:49:25 CET [2016/04/15 7:49:25 ET]
Table 'Navi' 9-max Seat #8 is the button
Seat 1: tipner ($114.83 in chips) 
Seat 2: butcheN18 ($100 in chips) 
Seat 3: aseban11 ($100 in chips) 
Seat 4: Effort92 ($178.18 in chips) 
Seat 5: hammerwife ($104.32 in chips) 
Seat 6: Glushchenko ($100 in chips) 
Seat 7: yoshidao ($126.03 in chips) 
Seat 8: djammusic ($39.50 in chips) 
Seat 9: matiko09 ($135.63 in chips) 
matiko09: posts small blind $0.50
tipner: posts big blind $1
*** HOLE CARDS ***
Dealt to matiko09 [4s Kc]
butcheN18: folds 
aseban11: raises $2 to $3
Effort92: folds 
hammerwife: folds 
Glushchenko: calls $3
yoshidao: folds 
djammusic: folds 
matiko09: folds 
tipner: folds 
*** FLOP *** [8s Qd 6c]
aseban11: bets $5.34
Glushchenko: calls $5.34
*** TURN *** [8s Qd 6c] [Ad]
aseban11: checks 
Glushchenko: bets $11.51
aseban11: calls $11.51
*** RIVER *** [8s Qd 6c Ad] [2h]
aseban11: checks 
Glushchenko: bets $23.50
aseban11: folds 
Uncalled bet ($23.50) returned to Glushchenko
Glushchenko collected $39.14 from pot
*** SUMMARY ***
Total pot $41.20 | Rake $2.06 
Board [8s Qd 6c Ad 2h]
Seat 1: tipner (big blind) folded before Flop
Seat 2: butcheN18 folded before Flop (didn't bet)
Seat 3: aseban11 folded on the River
Seat 4: Effort92 folded before Flop (didn't bet)
Seat 5: hammerwife folded before Flop (didn't bet)
Seat 6: Glushchenko collected ($39.14)
Seat 7: yoshidao folded before Flop (didn't bet)
Seat 8: djammusic (button) folded before Flop (didn't bet)
Seat 9: matiko09 (small blind) folded before Flop





PokerStars Hand #151943257107:  Hold'em No Limit ($0.50/$1.00 USD) - 2016/04/15 13:49:27 CET [2016/04/15 7:49:27 ET]
Table 'Parvulesco II' 9-max Seat #7 is the button
Seat 1: bilukm ($116.10 in chips) 
Seat 2: Filojoes ($109.57 in chips) 
Seat 3: matiko09 ($116.45 in chips) 
Seat 4: butcheN18 ($100.62 in chips) 
Seat 5: bronbeek ($99.76 in chips) 
Seat 6: ruslik_by ($104.50 in chips) 
Seat 7: Kukuryzka ($99.50 in chips) 
Seat 8: Jimy Tiltman ($112.70 in chips) 
Seat 9: hammerwife ($203.71 in chips) 
Jimy Tiltman: posts small blind $0.50
hammerwife: posts big blind $1
*** HOLE CARDS ***
Dealt to matiko09 [Jd 8c]
bilukm: folds 
Filojoes: folds 
matiko09: folds 
butcheN18: folds 
bronbeek: folds 
ruslik_by: raises $1.50 to $2.50
Kukuryzka: folds 
Jimy Tiltman: folds 
hammerwife: folds 
Uncalled bet ($1.50) returned to ruslik_by
ruslik_by collected $2.50 from pot
ruslik_by: doesn't show hand 
*** SUMMARY ***
Total pot $2.50 | Rake $0 
Seat 1: bilukm folded before Flop (didn't bet)
Seat 2: Filojoes folded before Flop (didn't bet)
Seat 3: matiko09 folded before Flop (didn't bet)
Seat 4: butcheN18 folded before Flop (didn't bet)
Seat 5: bronbeek folded before Flop (didn't bet)
Seat 6: ruslik_by collected ($2.50)
Seat 7: Kukuryzka (button) folded before Flop (didn't bet)
Seat 8: Jimy Tiltman (small blind) folded before Flop
Seat 9: hammerwife (big blind) folded before Flop





PokerStars Hand #151943263784:  Hold'em No Limit ($1/$2 USD) - 2016/04/15 13:49:40 CET [2016/04/15 7:49:40 ET]
Table 'Blaauw' 9-max Seat #2 is the button
Seat 2: butcheN18 ($259.60 in chips) 
Seat 3: Glushchenko ($235.85 in chips) 
Seat 4: petro0107 ($250.89 in chips) 
Seat 5: tipner ($203 in chips) 
Seat 6: matiko09 ($229 in chips) 
Seat 7: ssljvr ($398.07 in chips) 
Seat 9: coinflip_si ($209.88 in chips) 
Glushchenko: posts small blind $1
petro0107: posts big blind $2
Iggso: sits out 
myatiy 96: sits out 
*** HOLE CARDS ***
Dealt to matiko09 [2s Jc]
tipner: folds 
matiko09: folds 
ssljvr: raises $4 to $6
coinflip_si: folds 
butcheN18: folds 
Glushchenko: calls $5
petro0107: calls $4
*** FLOP *** [Jd Js 4c]
Glushchenko: checks 
petro0107: checks 
ssljvr: bets $9.06
Glushchenko: calls $9.06
petro0107: folds 
*** TURN *** [Jd Js 4c] [Ah]
Glushchenko: checks 
ssljvr: checks 
*** RIVER *** [Jd Js 4c Ah] [8s]
Glushchenko: bets $22.87
ssljvr: folds 
Uncalled bet ($22.87) returned to Glushchenko
Glushchenko collected $34.31 from pot
*** SUMMARY ***
Total pot $36.12 | Rake $1.81 
Board [Jd Js 4c Ah 8s]
Seat 2: butcheN18 (button) folded before Flop (didn't bet)
Seat 3: Glushchenko (small blind) collected ($34.31)
Seat 4: petro0107 (big blind) folded on the Flop
Seat 5: tipner folded before Flop (didn't bet)
Seat 6: matiko09 folded before Flop (didn't bet)
Seat 7: ssljvr folded on the River
Seat 9: coinflip_si folded before Flop (didn't bet)





PokerStars Hand #151943272519:  Hold'em No Limit ($1/$2 USD) - 2016/04/15 13:49:57 CET [2016/04/15 7:49:57 ET]
Table 'Patroclus II' 9-max Seat #7 is the button
Seat 1: TonnaMunz ($210.24 in chips) 
Seat 2: Moemors ($193.04 in chips) 
Seat 5: butcheN18 ($244.29 in chips) 
Seat 7: matiko09 ($307.30 in chips) 
Seat 8: Glushchenko ($205 in chips) 
Seat 9: Fish4trips ($228.32 in chips) 
Glushchenko: posts small blind $1
Fish4trips: posts big blind $2
derrocco82: sits out 
di0d80: sits out 
*** HOLE CARDS ***
Dealt to matiko09 [Kd Qs]
TonnaMunz: folds 
Moemors: folds 
TonnaMunz leaves the table
myatiy 96 joins the table at seat #1 
myatiy 96 leaves the table
butcheN18: folds 
matiko09: raises $2.54 to $4.54
Glushchenko: folds 
Fish4trips: folds 
Uncalled bet ($2.54) returned to matiko09
matiko09 collected $5 from pot
matiko09: doesn't show hand 
*** SUMMARY ***
Total pot $5 | Rake $0 
Seat 1: TonnaMunz folded before Flop (didn't bet)
Seat 2: Moemors folded before Flop (didn't bet)
Seat 5: butcheN18 folded before Flop (didn't bet)
Seat 7: matiko09 (button) collected ($5)
Seat 8: Glushchenko (small blind) folded before Flop
Seat 9: Fish4trips (big blind) folded before Flop





PokerStars Hand #151943273770:  Hold'em No Limit ($1/$2 USD) - 2016/04/15 13:49:59 CET [2016/04/15 7:49:59 ET]
Table 'Oceax' 9-max Seat #4 is the button
Seat 1: matiko09 ($200 in chips) 
Seat 2: Fish4trips ($325.03 in chips) 
Seat 4: butcheN18 ($230.42 in chips) 
Seat 5: di0d80 ($206 in chips) 
Seat 6: Iggso ($260.50 in chips) 
Seat 7: coinflip_si ($216.25 in chips) 
Seat 8: Poroxide ($298.82 in chips) 
di0d80: posts small blind $1
Iggso: posts big blind $2
erfk1958: sits out 
Glushchenko: sits out 
*** HOLE CARDS ***
Dealt to matiko09 [6d 3d]
coinflip_si: raises $3 to $5
Poroxide: folds 
matiko09: folds 
Fish4trips: calls $5
butcheN18: folds 
di0d80: folds 
Iggso: folds 
*** FLOP *** [Js 7h 2s]
coinflip_si: checks 
Fish4trips: bets $6.66
coinflip_si: folds 
Uncalled bet ($6.66) returned to Fish4trips
Fish4trips collected $12.35 from pot
Fish4trips: doesn't show hand 
*** SUMMARY ***
Total pot $13 | Rake $0.65 
Board [Js 7h 2s]
Seat 1: matiko09 folded before Flop (didn't bet)
Seat 2: Fish4trips collected ($12.35)
Seat 4: butcheN18 (button) folded before Flop (didn't bet)
Seat 5: di0d80 (small blind) folded before Flop
Seat 6: Iggso (big blind) folded before Flop
Seat 7: coinflip_si folded on the Flop
Seat 8: Poroxide folded before Flop (didn't bet)





PokerStars Hand #151943279251:  Hold'em No Limit ($1/$2 USD) - 2016/04/15 13:50:11 CET [2016/04/15 7:50:11 ET]
Table 'Irmgard II' 9-max Seat #9 is the button
Seat 1: Iggso ($232.21 in chips) 
Seat 2: Kukuryzka ($213.76 in chips) 
Seat 3: matiko09 ($209.10 in chips) 
Seat 6: djammusic ($140.56 in chips) 
Seat 7: erfk1958 ($102.10 in chips) 
Seat 8: MoeAA11 ($41.07 in chips) 
Seat 9: maximax04 ($155.46 in chips) 
Iggso: posts small blind $1
Kukuryzka: posts big blind $2
di0d80: sits out 
*** HOLE CARDS ***
Dealt to matiko09 [Jc Js]
matiko09: raises $3 to $5
djammusic: folds 
erfk1958: folds 
MoeAA11: folds 
maximax04: folds 
Iggso: folds 
Kukuryzka: folds 
Uncalled bet ($3) returned to matiko09
matiko09 collected $5 from pot
matiko09: doesn't show hand 
*** SUMMARY ***
Total pot $5 | Rake $0 
Seat 1: Iggso (small blind) folded before Flop
Seat 2: Kukuryzka (big blind) folded before Flop
Seat 3: matiko09 collected ($5)
Seat 6: djammusic folded before Flop (didn't bet)
Seat 7: erfk1958 folded before Flop (didn't bet)
Seat 8: MoeAA11 folded before Flop (didn't bet)
Seat 9: maximax04 (button) folded before Flop (didn't bet)





PokerStars Hand #151943281820:  Hold'em No Limit ($0.50/$1.00 USD) - 2016/04/15 13:50:16 CET [2016/04/15 7:50:16 ET]
Table 'Adelgunde III' 9-max Seat #5 is the button
Seat 1: valimiu ($48.29 in chips) 
Seat 2: djammusic ($47.50 in chips) 
Seat 3: tipner ($112.12 in chips) 
Seat 4: hammerwife ($100 in chips) 
Seat 5: matiko09 ($148.36 in chips) 
Seat 6: Pominator92 ($160.98 in chips) 
Seat 8: aseban11 ($101.98 in chips) 
Seat 9: Kukuryzka ($100 in chips) 
Pominator92: posts small blind $0.50
aseban11: posts big blind $1
*** HOLE CARDS ***
Dealt to matiko09 [4c 8s]
Kukuryzka: raises $2 to $3
valimiu: calls $3
djammusic: folds 
tipner: folds 
hammerwife: folds 
matiko09: folds 
Pominator92: folds 
aseban11: folds 
*** FLOP *** [5s 8d 3d]
Kukuryzka: bets $5.34
valimiu: calls $5.34
*** TURN *** [5s 8d 3d] [Qh]
Kukuryzka: bets $12.09
valimiu: folds 
Uncalled bet ($12.09) returned to Kukuryzka
Kukuryzka collected $17.27 from pot
Kukuryzka: doesn't show hand 
*** SUMMARY ***
Total pot $18.18 | Rake $0.91 
Board [5s 8d 3d Qh]
Seat 1: valimiu folded on the Turn
Seat 2: djammusic folded before Flop (didn't bet)
Seat 3: tipner folded before Flop (didn't bet)
Seat 4: hammerwife folded before Flop (didn't bet)
Seat 5: matiko09 (button) folded before Flop (didn't bet)
Seat 6: Pominator92 (small blind) folded before Flop
Seat 8: aseban11 (big blind) folded before Flop
Seat 9: Kukuryzka collected ($17.27)





PokerStars Hand #151943282361:  Hold'em No Limit ($0.50/$1.00 USD) - 2016/04/15 13:50:17 CET [2016/04/15 7:50:17 ET]
Table 'Chiny II' 9-max Seat #8 is the button
Seat 1: aseban11 ($100 in chips) 
Seat 2: Westpants ($146.17 in chips) 
Seat 4: matiko09 ($163.67 in chips) 
Seat 6: choupai ($17.53 in chips) 
Seat 8: Filojoes ($143.74 in chips) 
Seat 9: butcheN18 ($102 in chips) 
butcheN18: posts small blind $0.50
aseban11: posts big blind $1
Foton18: sits out 
*** HOLE CARDS ***
Dealt to matiko09 [Th 3c]
Westpants: folds 
matiko09: folds 
choupai: folds 
Filojoes: raises $1 to $2
butcheN18: folds 
aseban11: folds 
Uncalled bet ($1) returned to Filojoes
Filojoes collected $2.50 from pot
Filojoes: doesn't show hand 
*** SUMMARY ***
Total pot $2.50 | Rake $0 
Seat 1: aseban11 (big blind) folded before Flop
Seat 2: Westpants folded before Flop (didn't bet)
Seat 4: matiko09 folded before Flop (didn't bet)
Seat 6: choupai folded before Flop (didn't bet)
Seat 8: Filojoes (button) collected ($2.50)
Seat 9: butcheN18 (small blind) folded before Flop





PokerStars Hand #151943286589:  Hold'em No Limit ($1/$2 USD) - 2016/04/15 13:50:25 CET [2016/04/15 7:50:25 ET]
Table 'Patroclus II' 9-max Seat #8 is the button
Seat 2: Moemors ($193.04 in chips) 
Seat 5: butcheN18 ($244.29 in chips) 
Seat 7: matiko09 ($310.30 in chips) 
Seat 8: Glushchenko ($204 in chips) 
Seat 9: Fish4trips ($226.32 in chips) 
Fish4trips: posts small blind $1
Moemors: posts big blind $2
derrocco82: sits out 
di0d80: sits out 
*** HOLE CARDS ***
Dealt to matiko09 [Jh 8c]
butcheN18: folds 
matiko09: folds 
Glushchenko: raises $2 to $4
Fish4trips: folds 
Moemors: folds 
Uncalled bet ($2) returned to Glushchenko
Glushchenko collected $5 from pot
*** SUMMARY ***
Total pot $5 | Rake $0 
Seat 2: Moemors (big blind) folded before Flop
Seat 5: butcheN18 folded before Flop (didn't bet)
Seat 7: matiko09 folded before Flop (didn't bet)
Seat 8: Glushchenko (button) collected ($5)
Seat 9: Fish4trips (small blind) folded before Flop





PokerStars Hand #151943286800:  Hold'em No Limit ($1/$2 USD) - 2016/04/15 13:50:25 CET [2016/04/15 7:50:25 ET]
Table 'Irmgard II' 9-max Seat #1 is the button
Seat 1: Iggso ($231.21 in chips) 
Seat 2: Kukuryzka ($211.76 in chips) 
Seat 3: matiko09 ($212.10 in chips) 
Seat 6: djammusic ($140.56 in chips) 
Seat 7: erfk1958 ($102.10 in chips) 
Seat 8: MoeAA11 ($41.07 in chips) 
Seat 9: maximax04 ($155.46 in chips) 
Kukuryzka: posts small blind $1
matiko09: posts big blind $2
di0d80: sits out 
*** HOLE CARDS ***
Dealt to matiko09 [Tc Kh]
djammusic: folds 
erfk1958: folds 
MoeAA11: folds 
maximax04: calls $2
Iggso: folds 
Kukuryzka: folds 
matiko09: raises $6 to $8
maximax04: calls $6
*** FLOP *** [Qh 5d Ts]
matiko09: checks 
maximax04: checks 
*** TURN *** [Qh 5d Ts] [Js]
matiko09: checks 
maximax04: bets $6
matiko09: calls $6
*** RIVER *** [Qh 5d Ts Js] [9c]
matiko09: checks 
maximax04: bets $8
matiko09: raises $13 to $21
maximax04: folds 
Uncalled bet ($13) returned to matiko09
matiko09 collected $42.75 from pot
matiko09: doesn't show hand 
*** SUMMARY ***
Total pot $45 | Rake $2.25 
Board [Qh 5d Ts Js 9c]
Seat 1: Iggso (button) folded before Flop (didn't bet)
Seat 2: Kukuryzka (small blind) folded before Flop
Seat 3: matiko09 (big blind) collected ($42.75)
Seat 6: djammusic folded before Flop (didn't bet)
Seat 7: erfk1958 folded before Flop (didn't bet)
Seat 8: MoeAA11 folded before Flop (didn't bet)
Seat 9: maximax04 folded on the River





PokerStars Hand #151943288969:  Hold'em No Limit ($1/$2 USD) - 2016/04/15 13:50:30 CET [2016/04/15 7:50:30 ET]
Table 'Adele II' 9-max Seat #9 is the button
Seat 1: RyanHuJun ($364.66 in chips) 
Seat 2: Fish4trips ($314.04 in chips) 
Seat 3: matiko09 ($316.88 in chips) 
Seat 4: Glushchenko ($200 in chips) 
Seat 7: Iggso ($204.84 in chips) 
Seat 9: SanychStar ($298.77 in chips) 
RyanHuJun: posts small blind $1
Fish4trips: posts big blind $2
TonnaMunz: sits out 
Kukuryzka: sits out 
butcheN18: sits out 
*** HOLE CARDS ***
Dealt to matiko09 [Js 7s]
matiko09: folds 
Glushchenko: folds 
Iggso: folds 
SanychStar: raises $3 to $5
RyanHuJun: folds 
Fish4trips: calls $3
*** FLOP *** [6s 5d Qh]
Fish4trips: checks 
SanychStar: checks 
*** TURN *** [6s 5d Qh] [7d]
Fish4trips: checks 
SanychStar: checks 
*** RIVER *** [6s 5d Qh 7d] [6d]
Fish4trips: checks 
SanychStar: checks 
*** SHOW DOWN ***
Fish4trips: shows [9d As] (a pair of Sixes)
SanychStar: mucks hand 
Fish4trips collected $10.45 from pot
*** SUMMARY ***
Total pot $11 | Rake $0.55 
Board [6s 5d Qh 7d 6d]
Seat 1: RyanHuJun (small blind) folded before Flop
Seat 2: Fish4trips (big blind) showed [9d As] and won ($10.45) with a pair of Sixes
Seat 3: matiko09 folded before Flop (didn't bet)
Seat 4: Glushchenko folded before Flop (didn't bet)
Seat 7: Iggso folded before Flop (didn't bet)
Seat 9: SanychStar (button) mucked [Ac 8s]





PokerStars Hand #151943291256:  Hold'em No Limit ($0.50/$1.00 USD) - 2016/04/15 13:50:34 CET [2016/04/15 7:50:34 ET]
Table 'Parvulesco II' 9-max Seat #8 is the button
Seat 1: bilukm ($116.10 in chips) 
Seat 2: Filojoes ($109.57 in chips) 
Seat 3: matiko09 ($116.45 in chips) 
Seat 4: butcheN18 ($100.62 in chips) 
Seat 5: bronbeek ($99.76 in chips) 
Seat 6: ruslik_by ($106 in chips) 
Seat 7: Kukuryzka ($99.50 in chips) 
Seat 8: Jimy Tiltman ($112.20 in chips) 
Seat 9: hammerwife ($202.71 in chips) 
hammerwife: posts small blind $0.50
bilukm: posts big blind $1
*** HOLE CARDS ***
Dealt to matiko09 [Ts Kd]
Filojoes: folds 
matiko09: folds 
butcheN18: folds 
bronbeek: folds 
ruslik_by: folds 
Kukuryzka: folds 
Jimy Tiltman: folds 
hammerwife: folds 
Uncalled bet ($0.50) returned to bilukm
bilukm collected $1 from pot
bilukm: doesn't show hand 
*** SUMMARY ***
Total pot $1 | Rake $0 
Seat 1: bilukm (big blind) collected ($1)
Seat 2: Filojoes folded before Flop (didn't bet)
Seat 3: matiko09 folded before Flop (didn't bet)
Seat 4: butcheN18 folded before Flop (didn't bet)
Seat 5: bronbeek folded before Flop (didn't bet)
Seat 6: ruslik_by folded before Flop (didn't bet)
Seat 7: Kukuryzka folded before Flop (didn't bet)
Seat 8: Jimy Tiltman (button) folded before Flop (didn't bet)
Seat 9: hammerwife (small blind) folded before Flop





PokerStars Hand #151943292413:  Hold'em No Limit ($0.50/$1.00 USD) - 2016/04/15 13:50:37 CET [2016/04/15 7:50:37 ET]
Table 'Chiny II' 9-max Seat #9 is the button
Seat 1: aseban11 ($100 in chips) 
Seat 2: Westpants ($146.17 in chips) 
Seat 4: matiko09 ($163.67 in chips) 
Seat 6: choupai ($17.53 in chips) 
Seat 8: Filojoes ($145.24 in chips) 
Seat 9: butcheN18 ($101.50 in chips) 
aseban11: posts small blind $0.50
Westpants: posts big blind $1
Foton18: sits out 
*** HOLE CARDS ***
Dealt to matiko09 [8s Tc]
Yaaaazz leaves the table
matiko09: folds 
choupai: folds 
omorfadramou joins the table at seat #5 
Filojoes: raises $1.50 to $2.50
butcheN18: folds 
aseban11: folds 
Westpants: folds 
Uncalled bet ($1.50) returned to Filojoes
Filojoes collected $2.50 from pot
Filojoes: doesn't show hand 
*** SUMMARY ***
Total pot $2.50 | Rake $0 
Seat 1: aseban11 (small blind) folded before Flop
Seat 2: Westpants (big blind) folded before Flop
Seat 4: matiko09 folded before Flop (didn't bet)
Seat 6: choupai folded before Flop (didn't bet)
Seat 8: Filojoes collected ($2.50)
Seat 9: butcheN18 (button) folded before Flop (didn't bet)





PokerStars Hand #151943293853:  Hold'em No Limit ($1/$2 USD) - 2016/04/15 13:50:39 CET [2016/04/15 7:50:39 ET]
Table 'Patroclus II' 9-max Seat #9 is the button
Seat 2: Moemors ($191.04 in chips) 
Seat 3: derrocco82 ($200 in chips) 
Seat 5: butcheN18 ($244.29 in chips) 
Seat 7: matiko09 ($310.30 in chips) 
Seat 8: Glushchenko ($207 in chips) 
Seat 9: Fish4trips ($225.32 in chips) 
Moemors: posts small blind $1
derrocco82: posts big blind $2
di0d80: sits out 
*** HOLE CARDS ***
Dealt to matiko09 [2d Ah]
butcheN18: folds 
matiko09: folds 
Glushchenko: folds 
Fish4trips: folds 
Moemors: calls $1
derrocco82: raises $8 to $10
Moemors: calls $8
*** FLOP *** [4h Ad Qs]
Moemors: checks 
derrocco82: bets $10
Moemors: folds 
Uncalled bet ($10) returned to derrocco82
derrocco82 collected $19 from pot
derrocco82: doesn't show hand 
*** SUMMARY ***
Total pot $20 | Rake $1 
Board [4h Ad Qs]
Seat 2: Moemors (small blind) folded on the Flop
Seat 3: derrocco82 (big blind) collected ($19)
Seat 5: butcheN18 folded before Flop (didn't bet)
Seat 7: matiko09 folded before Flop (didn't bet)
Seat 8: Glushchenko folded before Flop (didn't bet)
Seat 9: Fish4trips (button) folded before Flop (didn't bet)





PokerStars Hand #151943296513:  Hold'em No Limit ($0.50/$1.00 USD) - 2016/04/15 13:50:45 CET [2016/04/15 7:50:45 ET]
Table 'Emma II' 9-max Seat #8 is the button
Seat 2: Filojoes ($101.50 in chips) 
Seat 3: Glushchenko ($226.66 in chips) 
Seat 4: matiko09 ($101.50 in chips) 
Seat 6: Tirka ($126.84 in chips) 
Seat 7: aseban11 ($100 in chips) 
Seat 8: butcheN18 ($152.82 in chips) 
Seat 9: Foton18 ($103.54 in chips) 
Foton18: posts small blind $0.50
Filojoes: posts big blind $1
*** HOLE CARDS ***
Dealt to matiko09 [2s 7c]
Glushchenko: raises $2 to $3
matiko09: folds 
Tirka: folds 
aseban11: raises $6 to $9
butcheN18: raises $12 to $21
Foton18: folds 
Filojoes: folds 
Glushchenko: folds 
aseban11: folds 
Uncalled bet ($12) returned to butcheN18
butcheN18 collected $22.50 from pot
butcheN18: doesn't show hand 
*** SUMMARY ***
Total pot $22.50 | Rake $0 
Seat 2: Filojoes (big blind) folded before Flop
Seat 3: Glushchenko folded before Flop
Seat 4: matiko09 folded before Flop (didn't bet)
Seat 6: Tirka folded before Flop (didn't bet)
Seat 7: aseban11 folded before Flop
Seat 8: butcheN18 (button) collected ($22.50)
Seat 9: Foton18 (small blind) folded before Flop





PokerStars Hand #151943297133:  Hold'em No Limit ($0.50/$1.00 USD) - 2016/04/15 13:50:46 CET [2016/04/15 7:50:46 ET]
Table 'Navi' 9-max Seat #9 is the button
Seat 1: tipner ($113.83 in chips) 
Seat 2: butcheN18 ($100 in chips) 
Seat 3: aseban11 ($100 in chips) 
Seat 4: Effort92 ($178.18 in chips) 
Seat 5: hammerwife ($104.32 in chips) 
Seat 6: Glushchenko ($119.29 in chips) 
Seat 7: yoshidao ($126.03 in chips) 
Seat 8: djammusic ($39.50 in chips) 
Seat 9: matiko09 ($135.13 in chips) 
tipner: posts small blind $0.50
butcheN18: posts big blind $1
*** HOLE CARDS ***
Dealt to matiko09 [2h Qs]
aseban11: folds 
Effort92: folds 
hammerwife: raises $2 to $3
Glushchenko: folds 
yoshidao: folds 
djammusic: folds 
matiko09: folds 
tipner: folds 
butcheN18: folds 
Uncalled bet ($2) returned to hammerwife
hammerwife collected $2.50 from pot
hammerwife: doesn't show hand 
*** SUMMARY ***
Total pot $2.50 | Rake $0 
Seat 1: tipner (small blind) folded before Flop
Seat 2: butcheN18 (big blind) folded before Flop
Seat 3: aseban11 folded before Flop (didn't bet)
Seat 4: Effort92 folded before Flop (didn't bet)
Seat 5: hammerwife collected ($2.50)
Seat 6: Glushchenko folded before Flop (didn't bet)
Seat 7: yoshidao folded before Flop (didn't bet)
Seat 8: djammusic folded before Flop (didn't bet)
Seat 9: matiko09 (button) folded before Flop (didn't bet)





PokerStars Hand #151943303101:  Hold'em No Limit ($1/$2 USD) - 2016/04/15 13:50:58 CET [2016/04/15 7:50:58 ET]
Table 'Oceax' 9-max Seat #5 is the button
Seat 1: matiko09 ($200 in chips) 
Seat 2: Fish4trips ($332.38 in chips) 
Seat 4: butcheN18 ($230.42 in chips) 
Seat 5: di0d80 ($205 in chips) 
Seat 6: Iggso ($258.50 in chips) 
Seat 8: Poroxide ($298.82 in chips) 
Iggso: posts small blind $1
Poroxide: posts big blind $2
erfk1958: sits out 
Glushchenko: sits out 
*** HOLE CARDS ***
Dealt to matiko09 [2h 9s]
coinflip_si leaves the table
myatiy 96 joins the table at seat #7 
matiko09: folds 
Fish4trips: raises $3 to $5
butcheN18: folds 
di0d80: calls $5
Iggso: folds 
Poroxide: raises $11 to $16
Fish4trips: folds 
di0d80: calls $11
*** FLOP *** [Jh 4c 7d]
myatiy 96 leaves the table
Poroxide: bets $18
di0d80: folds 
Uncalled bet ($18) returned to Poroxide
Poroxide collected $36.10 from pot
Poroxide: doesn't show hand 
*** SUMMARY ***
Total pot $38 | Rake $1.90 
Board [Jh 4c 7d]
Seat 1: matiko09 folded before Flop (didn't bet)
Seat 2: Fish4trips folded before Flop
Seat 4: butcheN18 folded before Flop (didn't bet)
Seat 5: di0d80 (button) folded on the Flop
Seat 6: Iggso (small blind) folded before Flop
Seat 8: Poroxide (big blind) collected ($36.10)





PokerStars Hand #151943306250:  Hold'em No Limit ($0.50/$1.00 USD) - 2016/04/15 13:51:04 CET [2016/04/15 7:51:04 ET]
Table 'Chiny II' 9-max Seat #1 is the button
Seat 1: aseban11 ($100 in chips) 
Seat 2: Westpants ($145.17 in chips) 
Seat 3: Foton18 ($90 in chips) 
Seat 4: matiko09 ($163.67 in chips) 
Seat 6: choupai ($17.53 in chips) 
Seat 8: Filojoes ($146.74 in chips) 
Seat 9: butcheN18 ($101.50 in chips) 
Westpants: posts small blind $0.50
Foton18: posts big blind $1
omorfadramou: sits out 
*** HOLE CARDS ***
Dealt to matiko09 [2d 8c]
matiko09: folds 
choupai: folds 
Filojoes: folds 
butcheN18: folds 
aseban11: raises $1.50 to $2.50
Westpants: raises $4.50 to $7
Foton18: calls $6
aseban11: calls $4.50
*** FLOP *** [8s 6d 9h]
Westpants: bets $11.36
Foton18: calls $11.36
aseban11: calls $11.36
*** TURN *** [8s 6d 9h] [5c]
Westpants: checks 
Foton18: checks 
aseban11: checks 
*** RIVER *** [8s 6d 9h 5c] [3c]
Westpants: checks 
Foton18: checks 
aseban11: checks 
*** SHOW DOWN ***
Westpants: shows [8d Kd] (a pair of Eights)
Foton18: shows [Jc Jd] (a pair of Jacks)
aseban11: mucks hand 
Foton18 collected $52.58 from pot
*** SUMMARY ***
Total pot $55.08 | Rake $2.50 
Board [8s 6d 9h 5c 3c]
Seat 1: aseban11 (button) mucked [Tc Th]
Seat 2: Westpants (small blind) showed [8d Kd] and lost with a pair of Eights
Seat 3: Foton18 (big blind) showed [Jc Jd] and won ($52.58) with a pair of Jacks
Seat 4: matiko09 folded before Flop (didn't bet)
Seat 6: choupai folded before Flop (didn't bet)
Seat 8: Filojoes folded before Flop (didn't bet)
Seat 9: butcheN18 folded before Flop (didn't bet)





PokerStars Hand #151943306536:  Hold'em No Limit ($0.50/$1.00 USD) - 2016/04/15 13:51:05 CET [2016/04/15 7:51:05 ET]
Table 'Parvulesco II' 9-max Seat #9 is the button
Seat 1: bilukm ($116.60 in chips) 
Seat 2: Filojoes ($109.57 in chips) 
Seat 3: matiko09 ($116.45 in chips) 
Seat 4: butcheN18 ($100.62 in chips) 
Seat 5: bronbeek ($99.76 in chips) 
Seat 6: ruslik_by ($106 in chips) 
Seat 7: Kukuryzka ($99.50 in chips) 
Seat 8: Jimy Tiltman ($112.20 in chips) 
Seat 9: hammerwife ($202.21 in chips) 
bilukm: posts small blind $0.50
Filojoes: posts big blind $1
*** HOLE CARDS ***
Dealt to matiko09 [Kd Jh]
matiko09: folds 
butcheN18: folds 
bronbeek: folds 
ruslik_by: folds 
Kukuryzka: folds 
Jimy Tiltman: folds 
hammerwife: raises $1.01 to $2.01
bilukm: folds 
Filojoes: calls $1.01
*** FLOP *** [Jd 2s 4h]
Filojoes: checks 
hammerwife: bets $2
Filojoes: folds 
Uncalled bet ($2) returned to hammerwife
hammerwife collected $4.29 from pot
hammerwife: doesn't show hand 
*** SUMMARY ***
Total pot $4.52 | Rake $0.23 
Board [Jd 2s 4h]
Seat 1: bilukm (small blind) folded before Flop
Seat 2: Filojoes (big blind) folded on the Flop
Seat 3: matiko09 folded before Flop (didn't bet)
Seat 4: butcheN18 folded before Flop (didn't bet)
Seat 5: bronbeek folded before Flop (didn't bet)
Seat 6: ruslik_by folded before Flop (didn't bet)
Seat 7: Kukuryzka folded before Flop (didn't bet)
Seat 8: Jimy Tiltman folded before Flop (didn't bet)
Seat 9: hammerwife (button) collected ($4.29)





PokerStars Hand #151943307409:  Hold'em No Limit ($1/$2 USD) - 2016/04/15 13:51:06 CET [2016/04/15 7:51:06 ET]
Table 'Blaauw' 9-max Seat #3 is the button
Seat 2: butcheN18 ($259.60 in chips) 
Seat 3: Glushchenko ($255.10 in chips) 
Seat 4: petro0107 ($244.89 in chips) 
Seat 5: tipner ($203 in chips) 
Seat 6: matiko09 ($229 in chips) 
Seat 7: ssljvr ($383.01 in chips) 
Seat 9: coinflip_si ($209.88 in chips) 
petro0107: posts small blind $1
tipner: posts big blind $2
Iggso: sits out 
myatiy 96: sits out 
*** HOLE CARDS ***
Dealt to matiko09 [Ac 3d]
matiko09: folds 
ssljvr: folds 
coinflip_si: folds 
butcheN18: folds 
Glushchenko: folds 
petro0107: calls $1
tipner: raises $6 to $8
petro0107: folds 
Uncalled bet ($6) returned to tipner
tipner collected $4 from pot
tipner: doesn't show hand 
*** SUMMARY ***
Total pot $4 | Rake $0 
Seat 2: butcheN18 folded before Flop (didn't bet)
Seat 3: Glushchenko (button) folded before Flop (didn't bet)
Seat 4: petro0107 (small blind) folded before Flop
Seat 5: tipner (big blind) collected ($4)
Seat 6: matiko09 folded before Flop (didn't bet)
Seat 7: ssljvr folded before Flop (didn't bet)
Seat 9: coinflip_si folded before Flop (didn't bet)





PokerStars Hand #151943309690:  Hold'em No Limit ($0.50/$1.00 USD) - 2016/04/15 13:51:11 CET [2016/04/15 7:51:11 ET]
Table 'Navi' 9-max Seat #1 is the button
Seat 1: tipner ($113.33 in chips) 
Seat 2: butcheN18 ($100 in chips) 
Seat 5: hammerwife ($105.82 in chips) 
Seat 6: Glushchenko ($119.29 in chips) 
Seat 7: yoshidao ($126.03 in chips) 
Seat 8: djammusic ($39.50 in chips) 
Seat 9: matiko09 ($135.13 in chips) 
butcheN18: posts small blind $0.50
aseban11: is sitting out 
Effort92: is sitting out 
Effort92 leaves the table
hammerwife: posts big blind $1
*** HOLE CARDS ***
Dealt to matiko09 [9c 6h]
aseban11 leaves the table
Filojoes joins the table at seat #3 
Glushchenko: folds 
yoshidao: folds 
djammusic: folds 
matiko09: folds 
tipner: folds 
butcheN18: raises $1.44 to $2.44
Pvsx. joins the table at seat #4 
hammerwife: folds 
Uncalled bet ($1.44) returned to butcheN18
butcheN18 collected $2 from pot
butcheN18: doesn't show hand 
*** SUMMARY ***
Total pot $2 | Rake $0 
Seat 1: tipner (button) folded before Flop (didn't bet)
Seat 2: butcheN18 (small blind) collected ($2)
Seat 5: hammerwife (big blind) folded before Flop
Seat 6: Glushchenko folded before Flop (didn't bet)
Seat 7: yoshidao folded before Flop (didn't bet)
Seat 8: djammusic folded before Flop (didn't bet)
Seat 9: matiko09 folded before Flop (didn't bet)





PokerStars Hand #151943314106:  Hold'em No Limit ($1/$2 USD) - 2016/04/15 13:51:19 CET [2016/04/15 7:51:19 ET]
Table 'Patroclus II' 9-max Seat #2 is the button
Seat 2: Moemors ($181.04 in chips) 
Seat 3: derrocco82 ($209 in chips) 
Seat 5: butcheN18 ($244.29 in chips) 
Seat 7: matiko09 ($310.30 in chips) 
Seat 8: Glushchenko ($207 in chips) 
Seat 9: Fish4trips ($225.32 in chips) 
derrocco82: posts small blind $1
butcheN18: posts big blind $2
di0d80: sits out 
*** HOLE CARDS ***
Dealt to matiko09 [3s 4s]
matiko09: folds 
Glushchenko: folds 
Fish4trips: folds 
Moemors: folds 
derrocco82: folds 
Uncalled bet ($1) returned to butcheN18
butcheN18 collected $2 from pot
butcheN18: doesn't show hand 
*** SUMMARY ***
Total pot $2 | Rake $0 
Seat 2: Moemors (button) folded before Flop (didn't bet)
Seat 3: derrocco82 (small blind) folded before Flop
Seat 5: butcheN18 (big blind) collected ($2)
Seat 7: matiko09 folded before Flop (didn't bet)
Seat 8: Glushchenko folded before Flop (didn't bet)
Seat 9: Fish4trips folded before Flop (didn't bet)





PokerStars Hand #151943314130:  Hold'em No Limit ($0.50/$1.00 USD) - 2016/04/15 13:51:20 CET [2016/04/15 7:51:20 ET]
Table 'Adelgunde III' 9-max Seat #6 is the button
Seat 1: valimiu ($39.95 in chips) 
Seat 2: djammusic ($47.50 in chips) 
Seat 3: tipner ($112.12 in chips) 
Seat 4: hammerwife ($100 in chips) 
Seat 5: matiko09 ($148.36 in chips) 
Seat 6: Pominator92 ($160.48 in chips) 
Seat 8: aseban11 ($100.98 in chips) 
Seat 9: Kukuryzka ($108.93 in chips) 
aseban11: posts small blind $0.50
Kukuryzka: posts big blind $1
*** HOLE CARDS ***
Dealt to matiko09 [7s 2h]
valimiu: calls $1
djammusic: folds 
tipner: folds 
hammerwife: raises $1.50 to $2.50
matiko09: folds 
Pominator92: folds 
aseban11: folds 
Kukuryzka: folds 
valimiu: calls $1.50
*** FLOP *** [Th 2d 3h]
valimiu: checks 
hammerwife has timed out
hammerwife: checks 
*** TURN *** [Th 2d 3h] [Jd]
valimiu: checks 
hammerwife: bets $4
valimiu: calls $4
*** RIVER *** [Th 2d 3h Jd] [2c]
valimiu: checks 
hammerwife: checks 
*** SHOW DOWN ***
valimiu: shows [8d Qd] (a pair of Deuces)
hammerwife: shows [8s As] (a pair of Deuces - Ace kicker)
hammerwife collected $13.78 from pot
*** SUMMARY ***
Total pot $14.50 | Rake $0.72 
Board [Th 2d 3h Jd 2c]
Seat 1: valimiu showed [8d Qd] and lost with a pair of Deuces
Seat 2: djammusic folded before Flop (didn't bet)
Seat 3: tipner folded before Flop (didn't bet)
Seat 4: hammerwife showed [8s As] and won ($13.78) with a pair of Deuces
Seat 5: matiko09 folded before Flop (didn't bet)
Seat 6: Pominator92 (button) folded before Flop (didn't bet)
Seat 8: aseban11 (small blind) folded before Flop
Seat 9: Kukuryzka (big blind) folded before Flop





PokerStars Hand #151943319615:  Hold'em No Limit ($0.50/$1.00 USD) - 2016/04/15 13:51:30 CET [2016/04/15 7:51:30 ET]
Table 'Navi' 9-max Seat #2 is the button
Seat 1: tipner ($113.33 in chips) 
Seat 2: butcheN18 ($101 in chips) 
Seat 5: hammerwife ($104.82 in chips) 
Seat 6: Glushchenko ($119.29 in chips) 
Seat 7: yoshidao ($126.03 in chips) 
Seat 8: djammusic ($39.50 in chips) 
Seat 9: matiko09 ($135.13 in chips) 
Filojoes will be allowed to play after the button
Pvsx. will be allowed to play after the button
hammerwife: posts small blind $0.50
Glushchenko: posts big blind $1
*** HOLE CARDS ***
Dealt to matiko09 [7c Kc]
yoshidao: folds 
djammusic: folds 
matiko09: folds 
tipner: folds 
butcheN18: folds 
hammerwife: folds 
Uncalled bet ($0.50) returned to Glushchenko
Glushchenko collected $1 from pot
*** SUMMARY ***
Total pot $1 | Rake $0 
Seat 1: tipner folded before Flop (didn't bet)
Seat 2: butcheN18 (button) folded before Flop (didn't bet)
Seat 5: hammerwife (small blind) folded before Flop
Seat 6: Glushchenko (big blind) collected ($1)
Seat 7: yoshidao folded before Flop (didn't bet)
Seat 8: djammusic folded before Flop (didn't bet)
Seat 9: matiko09 folded before Flop (didn't bet)





PokerStars Hand #151943319837:  Hold'em No Limit ($1/$2 USD) - 2016/04/15 13:51:31 CET [2016/04/15 7:51:31 ET]
Table 'Patroclus II' 9-max Seat #3 is the button
Seat 2: Moemors ($181.04 in chips) 
Seat 3: derrocco82 ($208 in chips) 
Seat 5: butcheN18 ($245.29 in chips) 
Seat 6: di0d80 ($200 in chips) 
Seat 7: matiko09 ($310.30 in chips) 
Seat 8: Glushchenko ($207 in chips) 
Seat 9: Fish4trips ($225.32 in chips) 
butcheN18: posts small blind $1
di0d80: posts big blind $2
*** HOLE CARDS ***
Dealt to matiko09 [Jd Qc]
matiko09: folds 
Glushchenko: folds 
Fish4trips: folds 
Moemors: folds 
derrocco82: folds 
butcheN18: raises $2.88 to $4.88
di0d80: calls $2.88
*** FLOP *** [3d 3s Td]
butcheN18: bets $5.93
di0d80: calls $5.93
*** TURN *** [3d 3s Td] [9s]
butcheN18: checks 
di0d80: bets $12
butcheN18: calls $12
*** RIVER *** [3d 3s Td 9s] [8s]
butcheN18: checks 
di0d80: checks 
*** SHOW DOWN ***
butcheN18: shows [Qd 9c] (two pair, Nines and Threes)
di0d80: shows [7h Tc] (two pair, Tens and Threes)
di0d80 collected $43.34 from pot
*** SUMMARY ***
Total pot $45.62 | Rake $2.28 
Board [3d 3s Td 9s 8s]
Seat 2: Moemors folded before Flop (didn't bet)
Seat 3: derrocco82 (button) folded before Flop (didn't bet)
Seat 5: butcheN18 (small blind) showed [Qd 9c] and lost with two pair, Nines and Threes
Seat 6: di0d80 (big blind) showed [7h Tc] and won ($43.34) with two pair, Tens and Threes
Seat 7: matiko09 folded before Flop (didn't bet)
Seat 8: Glushchenko folded before Flop (didn't bet)
Seat 9: Fish4trips folded before Flop (didn't bet)





PokerStars Hand #151943321861:  Hold'em No Limit ($0.50/$1.00 USD) - 2016/04/15 13:51:35 CET [2016/04/15 7:51:35 ET]
Table 'Emma II' 9-max Seat #9 is the button
Seat 2: Filojoes ($100.50 in chips) 
Seat 3: Glushchenko ($223.66 in chips) 
Seat 4: matiko09 ($101.50 in chips) 
Seat 6: Tirka ($126.84 in chips) 
Seat 7: aseban11 ($100 in chips) 
Seat 8: butcheN18 ($166.32 in chips) 
Seat 9: Foton18 ($103.04 in chips) 
Filojoes: posts small blind $0.50
Glushchenko: posts big blind $1
*** HOLE CARDS ***
Dealt to matiko09 [5c 6c]
matiko09: folds 
Tirka: raises $2 to $3
Yaaaazz leaves the table
omorfadramou joins the table at seat #1 
aseban11: folds 
butcheN18: folds 
Foton18: folds 
Filojoes: folds 
Glushchenko: folds 
Uncalled bet ($2) returned to Tirka
Tirka collected $2.50 from pot
Tirka: doesn't show hand 
*** SUMMARY ***
Total pot $2.50 | Rake $0 
Seat 2: Filojoes (small blind) folded before Flop
Seat 3: Glushchenko (big blind) folded before Flop
Seat 4: matiko09 folded before Flop (didn't bet)
Seat 6: Tirka collected ($2.50)
Seat 7: aseban11 folded before Flop (didn't bet)
Seat 8: butcheN18 folded before Flop (didn't bet)
Seat 9: Foton18 (button) folded before Flop (didn't bet)





PokerStars Hand #151943325820:  Hold'em No Limit ($1/$2 USD) - 2016/04/15 13:51:43 CET [2016/04/15 7:51:43 ET]
Table 'Oceax' 9-max Seat #6 is the button
Seat 1: matiko09 ($200 in chips) 
Seat 2: Fish4trips ($327.38 in chips) 
Seat 4: butcheN18 ($230.42 in chips) 
Seat 5: di0d80 ($200 in chips) 
Seat 6: Iggso ($257.50 in chips) 
Seat 8: Poroxide ($318.92 in chips) 
Seat 9: erfk1958 ($122 in chips) 
Poroxide: posts small blind $1
erfk1958: posts big blind $2
Glushchenko: sits out 
*** HOLE CARDS ***
Dealt to matiko09 [Jc 8c]
matiko09: folds 
Fish4trips: folds 
butcheN18: folds 
di0d80: folds 
Iggso: raises $4 to $6
Poroxide: folds 
erfk1958: calls $4
*** FLOP *** [Td 5c 6d]
erfk1958: checks 
Iggso: checks 
*** TURN *** [Td 5c 6d] [7d]
erfk1958: checks 
Iggso: checks 
*** RIVER *** [Td 5c 6d 7d] [Jd]
erfk1958: bets $6
Iggso: folds 
Uncalled bet ($6) returned to erfk1958
erfk1958 collected $12.35 from pot
erfk1958: doesn't show hand 
*** SUMMARY ***
Total pot $13 | Rake $0.65 
Board [Td 5c 6d 7d Jd]
Seat 1: matiko09 folded before Flop (didn't bet)
Seat 2: Fish4trips folded before Flop (didn't bet)
Seat 4: butcheN18 folded before Flop (didn't bet)
Seat 5: di0d80 folded before Flop (didn't bet)
Seat 6: Iggso (button) folded on the River
Seat 8: Poroxide (small blind) folded before Flop
Seat 9: erfk1958 (big blind) collected ($12.35)





PokerStars Hand #151943326553:  Hold'em No Limit ($1/$2 USD) - 2016/04/15 13:51:44 CET [2016/04/15 7:51:44 ET]
Table 'Irmgard II' 9-max Seat #2 is the button
Seat 1: Iggso ($231.21 in chips) 
Seat 2: Kukuryzka ($210.76 in chips) 
Seat 3: matiko09 ($232.85 in chips) 
Seat 4: di0d80 ($200 in chips) 
Seat 6: djammusic ($140.56 in chips) 
Seat 7: erfk1958 ($102.10 in chips) 
Seat 8: MoeAA11 ($41.07 in chips) 
Seat 9: maximax04 ($133.46 in chips) 
matiko09: posts small blind $1
di0d80: posts big blind $2
*** HOLE CARDS ***
Dealt to matiko09 [7c 4d]
djammusic: folds 
erfk1958: folds 
MoeAA11: calls $2
maximax04: folds 
Iggso: folds 
Kukuryzka: folds 
matiko09: folds 
di0d80: checks 
*** FLOP *** [7s Th 8d]
di0d80: bets $3
MoeAA11: folds 
Uncalled bet ($3) returned to di0d80
di0d80 collected $4.75 from pot
di0d80: doesn't show hand 
*** SUMMARY ***
Total pot $5 | Rake $0.25 
Board [7s Th 8d]
Seat 1: Iggso folded before Flop (didn't bet)
Seat 2: Kukuryzka (button) folded before Flop (didn't bet)
Seat 3: matiko09 (small blind) folded before Flop
Seat 4: di0d80 (big blind) collected ($4.75)
Seat 6: djammusic folded before Flop (didn't bet)
Seat 7: erfk1958 folded before Flop (didn't bet)
Seat 8: MoeAA11 folded on the Flop
Seat 9: maximax04 folded before Flop (didn't bet)





PokerStars Hand #151943327115:  Hold'em No Limit ($1/$2 USD) - 2016/04/15 13:51:45 CET [2016/04/15 7:51:45 ET]
Table 'Blaauw' 9-max Seat #4 is the button
Seat 2: butcheN18 ($259.60 in chips) 
Seat 3: Glushchenko ($255.10 in chips) 
Seat 4: petro0107 ($242.89 in chips) 
Seat 5: tipner ($205 in chips) 
Seat 6: matiko09 ($229 in chips) 
Seat 7: ssljvr ($383.01 in chips) 
Seat 9: coinflip_si ($209.88 in chips) 
tipner: posts small blind $1
matiko09: posts big blind $2
Iggso: sits out 
myatiy 96: sits out 
*** HOLE CARDS ***
Dealt to matiko09 [3c Td]
ssljvr: raises $4 to $6
coinflip_si: folds 
butcheN18: folds 
Glushchenko: calls $6
petro0107: calls $6
tipner: calls $5
matiko09: folds 
*** FLOP *** [6h Qh 7h]
tipner: checks 
ssljvr: checks 
Glushchenko: bets $16.46
petro0107: folds 
tipner: folds 
ssljvr: folds 
Uncalled bet ($16.46) returned to Glushchenko
Glushchenko collected $24.70 from pot
*** SUMMARY ***
Total pot $26 | Rake $1.30 
Board [6h Qh 7h]
Seat 2: butcheN18 folded before Flop (didn't bet)
Seat 3: Glushchenko collected ($24.70)
Seat 4: petro0107 (button) folded on the Flop
Seat 5: tipner (small blind) folded on the Flop
Seat 6: matiko09 (big blind) folded before Flop
Seat 7: ssljvr folded on the Flop
Seat 9: coinflip_si folded before Flop (didn't bet)





PokerStars Hand #151943330741:  Hold'em No Limit ($1/$2 USD) - 2016/04/15 13:51:52 CET [2016/04/15 7:51:52 ET]
Table 'Adele II' 9-max Seat #1 is the button
Seat 1: RyanHuJun ($363.66 in chips) 
Seat 2: Fish4trips ($319.49 in chips) 
Seat 3: matiko09 ($316.88 in chips) 
Seat 4: Glushchenko ($200 in chips) 
Seat 7: Iggso ($204.84 in chips) 
Seat 9: SanychStar ($293.77 in chips) 
Fish4trips: posts small blind $1
matiko09: posts big blind $2
TonnaMunz: sits out 
Kukuryzka: sits out 
butcheN18: sits out 
*** HOLE CARDS ***
Dealt to matiko09 [Tc 3c]
Glushchenko: folds 
Iggso: raises $4 to $6
SanychStar: folds 
RyanHuJun: folds 
Fish4trips: folds 
matiko09: folds 
Uncalled bet ($4) returned to Iggso
Iggso collected $5 from pot
Iggso: doesn't show hand 
*** SUMMARY ***
Total pot $5 | Rake $0 
Seat 1: RyanHuJun (button) folded before Flop (didn't bet)
Seat 2: Fish4trips (small blind) folded before Flop
Seat 3: matiko09 (big blind) folded before Flop
Seat 4: Glushchenko folded before Flop (didn't bet)
Seat 7: Iggso collected ($5)
Seat 9: SanychStar folded before Flop (didn't bet)





PokerStars Hand #151943330322:  Hold'em No Limit ($0.50/$1.00 USD) - 2016/04/15 13:51:52 CET [2016/04/15 7:51:52 ET]
Table 'Navi' 9-max Seat #5 is the button
Seat 1: tipner ($113.33 in chips) 
Seat 2: butcheN18 ($101 in chips) 
Seat 5: hammerwife ($104.32 in chips) 
Seat 6: Glushchenko ($119.79 in chips) 
Seat 7: yoshidao ($126.03 in chips) 
Seat 8: djammusic ($39.50 in chips) 
Seat 9: matiko09 ($135.13 in chips) 
Glushchenko: posts small blind $0.50
yoshidao: posts big blind $1
Filojoes: sits out 
Pvsx.: sits out 
*** HOLE CARDS ***
Dealt to matiko09 [Ad Tc]
djammusic: folds 
matiko09: raises $2 to $3
tipner: folds 
butcheN18: folds 
hammerwife: folds 
Glushchenko: calls $2.50
yoshidao: calls $2
*** FLOP *** [2c 5s 6c]
Glushchenko: checks 
yoshidao: bets $5
matiko09: folds 
Glushchenko: raises $14 to $19
yoshidao: raises $22 to $41
Glushchenko: raises $75.79 to $116.79 and is all-in
yoshidao: calls $75.79
*** TURN *** [2c 5s 6c] [As]
*** RIVER *** [2c 5s 6c As] [4h]
*** SHOW DOWN ***
Glushchenko: shows [6h 6d] (three of a kind, Sixes)
yoshidao: shows [Kc Ks] (a pair of Kings)
Glushchenko collected $240.08 from pot
*** SUMMARY ***
Total pot $242.58 | Rake $2.50 
Board [2c 5s 6c As 4h]
Seat 1: tipner folded before Flop (didn't bet)
Seat 2: butcheN18 folded before Flop (didn't bet)
Seat 5: hammerwife (button) folded before Flop (didn't bet)
Seat 6: Glushchenko (small blind) showed [6h 6d] and won ($240.08) with three of a kind, Sixes
Seat 7: yoshidao (big blind) showed [Kc Ks] and lost with a pair of Kings
Seat 8: djammusic folded before Flop (didn't bet)
Seat 9: matiko09 folded on the Flop





PokerStars Hand #151943336172:  Hold'em No Limit ($0.50/$1.00 USD) - 2016/04/15 13:52:03 CET [2016/04/15 7:52:03 ET]
Table 'Chiny II' 9-max Seat #2 is the button
Seat 1: aseban11 ($100 in chips) 
Seat 2: Westpants ($126.81 in chips) 
Seat 3: Foton18 ($124.22 in chips) 
Seat 4: matiko09 ($163.67 in chips) 
Seat 6: choupai ($17.53 in chips) 
Seat 8: Filojoes ($146.74 in chips) 
Seat 9: butcheN18 ($101.50 in chips) 
Foton18: posts small blind $0.50
matiko09: posts big blind $1
omorfadramou: sits out 
*** HOLE CARDS ***
Dealt to matiko09 [As 5s]
choupai: folds 
Filojoes: folds 
butcheN18: folds 
aseban11: folds 
Westpants: folds 
Foton18: calls $0.50
matiko09: raises $3 to $4
Foton18: calls $3
*** FLOP *** [Ts 9c Qd]
Foton18: checks 
matiko09: checks 
*** TURN *** [Ts 9c Qd] [8s]
Foton18: bets $4
matiko09: calls $4
*** RIVER *** [Ts 9c Qd 8s] [Qs]
Foton18: checks 
matiko09: bets $12
Foton18: folds 
Uncalled bet ($12) returned to matiko09
tipner leaves the table
matiko09 collected $15.20 from pot
matiko09: doesn't show hand 
ruslik_by joins the table at seat #7 
*** SUMMARY ***
Total pot $16 | Rake $0.80 
Board [Ts 9c Qd 8s Qs]
Seat 1: aseban11 folded before Flop (didn't bet)
Seat 2: Westpants (button) folded before Flop (didn't bet)
Seat 3: Foton18 (small blind) folded on the River
Seat 4: matiko09 (big blind) collected ($15.20)
Seat 6: choupai folded before Flop (didn't bet)
Seat 8: Filojoes folded before Flop (didn't bet)
Seat 9: butcheN18 folded before Flop (didn't bet)





PokerStars Hand #151943336114:  Hold'em No Limit ($0.50/$1.00 USD) - 2016/04/15 13:52:03 CET [2016/04/15 7:52:03 ET]
Table 'Emma II' 9-max Seat #2 is the button
Seat 2: Filojoes ($100 in chips) 
Seat 3: Glushchenko ($222.66 in chips) 
Seat 4: matiko09 ($101.50 in chips) 
Seat 6: Tirka ($128.34 in chips) 
Seat 7: aseban11 ($100 in chips) 
Seat 8: butcheN18 ($166.32 in chips) 
Seat 9: Foton18 ($103.04 in chips) 
Glushchenko: posts small blind $0.50
matiko09: posts big blind $1
omorfadramou: sits out 
*** HOLE CARDS ***
Dealt to matiko09 [Js Jc]
Tirka: folds 
aseban11: raises $2 to $3
butcheN18: folds 
Foton18: folds 
Filojoes: folds 
Glushchenko: folds 
matiko09: calls $2
*** FLOP *** [Qc 7c 8d]
matiko09: checks 
aseban11: bets $4.63
matiko09: calls $4.63
*** TURN *** [Qc 7c 8d] [Qh]
matiko09: checks 
aseban11: checks 
*** RIVER *** [Qc 7c 8d Qh] [3c]
matiko09: checks 
aseban11: checks 
*** SHOW DOWN ***
matiko09: shows [Js Jc] (two pair, Queens and Jacks)
aseban11: shows [Qd Td] (three of a kind, Queens)
aseban11 collected $14.97 from pot
*** SUMMARY ***
Total pot $15.76 | Rake $0.79 
Board [Qc 7c 8d Qh 3c]
Seat 2: Filojoes (button) folded before Flop (didn't bet)
Seat 3: Glushchenko (small blind) folded before Flop
Seat 4: matiko09 (big blind) showed [Js Jc] and lost with two pair, Queens and Jacks
Seat 6: Tirka folded before Flop (didn't bet)
Seat 7: aseban11 showed [Qd Td] and won ($14.97) with three of a kind, Queens
Seat 8: butcheN18 folded before Flop (didn't bet)
Seat 9: Foton18 folded before Flop (didn't bet)





PokerStars Hand #151943341057:  Hold'em No Limit ($1/$2 USD) - 2016/04/15 13:52:13 CET [2016/04/15 7:52:13 ET]
Table 'Adele II' 9-max Seat #2 is the button
Seat 1: RyanHuJun ($363.66 in chips) 
Seat 2: Fish4trips ($318.49 in chips) 
Seat 3: matiko09 ($314.88 in chips) 
Seat 4: Glushchenko ($200 in chips) 
Seat 7: Iggso ($207.84 in chips) 
Seat 9: SanychStar ($293.77 in chips) 
matiko09: posts small blind $1
Glushchenko: posts big blind $2
TonnaMunz: sits out 
Kukuryzka: sits out 
butcheN18: sits out 
*** HOLE CARDS ***
Dealt to matiko09 [9s 6h]
Iggso: folds 
SanychStar: folds 
RyanHuJun: folds 
Fish4trips: raises $2 to $4
matiko09: folds 
Glushchenko: folds 
Uncalled bet ($2) returned to Fish4trips
Fish4trips collected $5 from pot
Fish4trips: doesn't show hand 
*** SUMMARY ***
Total pot $5 | Rake $0 
Seat 1: RyanHuJun folded before Flop (didn't bet)
Seat 2: Fish4trips (button) collected ($5)
Seat 3: matiko09 (small blind) folded before Flop
Seat 4: Glushchenko (big blind) folded before Flop
Seat 7: Iggso folded before Flop (didn't bet)
Seat 9: SanychStar folded before Flop (didn't bet)





PokerStars Hand #151943345867:  Hold'em No Limit ($0.50/$1.00 USD) - 2016/04/15 13:52:23 CET [2016/04/15 7:52:23 ET]
Table 'Parvulesco II' 9-max Seat #1 is the button
Seat 1: bilukm ($116.10 in chips) 
Seat 2: Filojoes ($107.56 in chips) 
Seat 3: matiko09 ($116.45 in chips) 
Seat 4: butcheN18 ($100.62 in chips) 
Seat 5: bronbeek ($99.76 in chips) 
Seat 6: ruslik_by ($106 in chips) 
Seat 7: Kukuryzka ($99.50 in chips) 
Seat 8: Jimy Tiltman ($112.20 in chips) 
Seat 9: hammerwife ($204.49 in chips) 
Filojoes: posts small blind $0.50
matiko09: posts big blind $1
*** HOLE CARDS ***
Dealt to matiko09 [3h 2d]
butcheN18: folds 
bronbeek: calls $1
ruslik_by: folds 
Kukuryzka: folds 
Jimy Tiltman: folds 
hammerwife: raises $3 to $4
bilukm: calls $4
Filojoes: folds 
matiko09: folds 
bronbeek: folds 
*** FLOP *** [Kh Ad Qs]
bronbeek leaves the table
maxxmeister joins the table at seat #5 
hammerwife: checks 
bilukm: checks 
*** TURN *** [Kh Ad Qs] [9c]
hammerwife: bets $7
bilukm: folds 
Uncalled bet ($7) returned to hammerwife
hammerwife collected $9.98 from pot
hammerwife: doesn't show hand 
*** SUMMARY ***
Total pot $10.50 | Rake $0.52 
Board [Kh Ad Qs 9c]
Seat 1: bilukm (button) folded on the Turn
Seat 2: Filojoes (small blind) folded before Flop
Seat 3: matiko09 (big blind) folded before Flop
Seat 4: butcheN18 folded before Flop (didn't bet)
Seat 5: bronbeek folded before Flop
Seat 6: ruslik_by folded before Flop (didn't bet)
Seat 7: Kukuryzka folded before Flop (didn't bet)
Seat 8: Jimy Tiltman folded before Flop (didn't bet)
Seat 9: hammerwife collected ($9.98)





PokerStars Hand #151943347947:  Hold'em No Limit ($1/$2 USD) - 2016/04/15 13:52:27 CET [2016/04/15 7:52:27 ET]
Table 'Irmgard II' 9-max Seat #3 is the button
Seat 1: Iggso ($231.21 in chips) 
Seat 2: Kukuryzka ($210.76 in chips) 
Seat 3: matiko09 ($231.85 in chips) 
Seat 4: di0d80 ($202.75 in chips) 
Seat 6: djammusic ($140.56 in chips) 
Seat 7: erfk1958 ($102.10 in chips) 
Seat 8: MoeAA11 ($39.07 in chips) 
Seat 9: maximax04 ($133.46 in chips) 
di0d80: posts small blind $1
djammusic: posts big blind $2
*** HOLE CARDS ***
Dealt to matiko09 [Kc Qc]
erfk1958: raises $2 to $4
MoeAA11: calls $4
maximax04: calls $4
Iggso: folds 
Kukuryzka: folds 
matiko09: raises $12 to $16
di0d80: folds 
djammusic: folds 
erfk1958: folds 
MoeAA11: calls $12
maximax04: calls $12
*** FLOP *** [As 9s Ah]
MoeAA11: bets $23.07 and is all-in
maximax04: folds 
matiko09: calls $23.07
*** TURN *** [As 9s Ah] [2s]
*** RIVER *** [As 9s Ah 2s] [Ks]
*** SHOW DOWN ***
MoeAA11: shows [9c 8c] (two pair, Aces and Nines)
matiko09: shows [Kc Qc] (two pair, Aces and Kings)
matiko09 collected $98.39 from pot
*** SUMMARY ***
Total pot $101.14 | Rake $2.75 
Board [As 9s Ah 2s Ks]
Seat 1: Iggso folded before Flop (didn't bet)
Seat 2: Kukuryzka folded before Flop (didn't bet)
Seat 3: matiko09 (button) showed [Kc Qc] and won ($98.39) with two pair, Aces and Kings
Seat 4: di0d80 (small blind) folded before Flop
Seat 6: djammusic (big blind) folded before Flop
Seat 7: erfk1958 folded before Flop
Seat 8: MoeAA11 showed [9c 8c] and lost with two pair, Aces and Nines
Seat 9: maximax04 folded on the Flop





PokerStars Hand #151943348566:  Hold'em No Limit ($1/$2 USD) - 2016/04/15 13:52:28 CET [2016/04/15 7:52:28 ET]
Table 'Oceax' 9-max Seat #8 is the button
Seat 1: matiko09 ($200 in chips) 
Seat 2: Fish4trips ($327.38 in chips) 
Seat 4: butcheN18 ($230.42 in chips) 
Seat 5: di0d80 ($200 in chips) 
Seat 6: Iggso ($251.50 in chips) 
Seat 8: Poroxide ($317.92 in chips) 
Seat 9: erfk1958 ($128.35 in chips) 
erfk1958: posts small blind $1
matiko09: posts big blind $2
Glushchenko: sits out 
*** HOLE CARDS ***
Dealt to matiko09 [Ah 3d]
Fish4trips: folds 
butcheN18: folds 
di0d80: folds 
Iggso: raises $4 to $6
Poroxide: folds 
erfk1958: calls $5
matiko09: folds 
*** FLOP *** [Ac 6d Qh]
erfk1958: checks 
Iggso: bets $8.37
myatiy 96 joins the table at seat #7 
erfk1958: folds 
Uncalled bet ($8.37) returned to Iggso
myatiy 96 leaves the table
Iggso collected $13.30 from pot
Iggso: doesn't show hand 
*** SUMMARY ***
Total pot $14 | Rake $0.70 
Board [Ac 6d Qh]
Seat 1: matiko09 (big blind) folded before Flop
Seat 2: Fish4trips folded before Flop (didn't bet)
Seat 4: butcheN18 folded before Flop (didn't bet)
Seat 5: di0d80 folded before Flop (didn't bet)
Seat 6: Iggso collected ($13.30)
Seat 8: Poroxide (button) folded before Flop (didn't bet)
Seat 9: erfk1958 (small blind) folded on the Flop





PokerStars Hand #151943355754:  Hold'em No Limit ($1/$2 USD) - 2016/04/15 13:52:43 CET [2016/04/15 7:52:43 ET]
Table 'Adele II' 9-max Seat #3 is the button
Seat 1: RyanHuJun ($363.66 in chips) 
Seat 2: Fish4trips ($321.49 in chips) 
Seat 3: matiko09 ($313.88 in chips) 
Seat 4: Glushchenko ($200 in chips) 
Seat 5: TonnaMunz ($207.25 in chips) 
Seat 7: Iggso ($207.84 in chips) 
Seat 9: SanychStar ($293.77 in chips) 
Glushchenko: posts small blind $1
TonnaMunz: posts big blind $2
Kukuryzka: sits out 
butcheN18: sits out 
*** HOLE CARDS ***
Dealt to matiko09 [2c 9h]
Iggso: raises $4 to $6
SanychStar: folds 
RyanHuJun: folds 
Fish4trips: folds 
matiko09: folds 
Glushchenko: folds 
TonnaMunz: folds 
Uncalled bet ($4) returned to Iggso
Iggso collected $5 from pot
Iggso: doesn't show hand 
*** SUMMARY ***
Total pot $5 | Rake $0 
Seat 1: RyanHuJun folded before Flop (didn't bet)
Seat 2: Fish4trips folded before Flop (didn't bet)
Seat 3: matiko09 (button) folded before Flop (didn't bet)
Seat 4: Glushchenko (small blind) folded before Flop
Seat 5: TonnaMunz (big blind) folded before Flop
Seat 7: Iggso collected ($5)
Seat 9: SanychStar folded before Flop (didn't bet)





PokerStars Hand #151943357421:  Hold'em No Limit ($0.50/$1.00 USD) - 2016/04/15 13:52:46 CET [2016/04/15 7:52:46 ET]
Table 'Adelgunde III' 9-max Seat #8 is the button
Seat 1: valimiu ($33.45 in chips) 
Seat 2: djammusic ($47.50 in chips) 
Seat 3: tipner ($112.12 in chips) 
Seat 4: hammerwife ($107.28 in chips) 
Seat 5: matiko09 ($148.36 in chips) 
Seat 6: Pominator92 ($160.48 in chips) 
Seat 8: aseban11 ($100.48 in chips) 
Seat 9: Kukuryzka ($107.93 in chips) 
Kukuryzka: posts small blind $0.50
valimiu: posts big blind $1
Yaaaazz: sits out 
*** HOLE CARDS ***
Dealt to matiko09 [Qh Jh]
djammusic: folds 
tipner: folds 
hammerwife: folds 
matiko09: raises $2 to $3
Pominator92: calls $3
aseban11: folds 
Kukuryzka: folds 
valimiu: calls $2
*** FLOP *** [4h 6c Qs]
valimiu: checks 
matiko09: bets $5.86
Pominator92: folds 
valimiu: calls $5.86
*** TURN *** [4h 6c Qs] [7s]
valimiu: checks 
matiko09: checks 
*** RIVER *** [4h 6c Qs 7s] [Ks]
valimiu: bets $10
matiko09: calls $10
*** SHOW DOWN ***
valimiu: shows [2s 3s] (a flush, King high)
matiko09: mucks hand 
valimiu collected $39.16 from pot
*** SUMMARY ***
Total pot $41.22 | Rake $2.06 
Board [4h 6c Qs 7s Ks]
Seat 1: valimiu (big blind) showed [2s 3s] and won ($39.16) with a flush, King high
Seat 2: djammusic folded before Flop (didn't bet)
Seat 3: tipner folded before Flop (didn't bet)
Seat 4: hammerwife folded before Flop (didn't bet)
Seat 5: matiko09 mucked [Qh Jh]
Seat 6: Pominator92 folded on the Flop
Seat 8: aseban11 (button) folded before Flop (didn't bet)
Seat 9: Kukuryzka (small blind) folded before Flop





PokerStars Hand #151943362326:  Hold'em No Limit ($0.50/$1.00 USD) - 2016/04/15 13:52:56 CET [2016/04/15 7:52:56 ET]
Table 'Chiny II' 9-max Seat #3 is the button
Seat 1: aseban11 ($100 in chips) 
Seat 2: Westpants ($126.81 in chips) 
Seat 3: Foton18 ($116.22 in chips) 
Seat 4: matiko09 ($170.87 in chips) 
Seat 5: omorfadramou ($100 in chips) 
Seat 6: choupai ($17.53 in chips) 
Seat 8: Filojoes ($146.74 in chips) 
Seat 9: butcheN18 ($101.50 in chips) 
matiko09: posts small blind $0.50
omorfadramou: posts big blind $1
ruslik_by: sits out 
*** HOLE CARDS ***
Dealt to matiko09 [8h Js]
choupai: folds 
Filojoes: folds 
butcheN18: folds 
aseban11: folds 
Westpants: folds 
Foton18: folds 
matiko09: raises $1.50 to $2.50
omorfadramou: calls $1.50
*** FLOP *** [2h Qc Kh]
matiko09: bets $3.09
omorfadramou: calls $3.09
*** TURN *** [2h Qc Kh] [3h]
matiko09: checks 
omorfadramou: checks 
*** RIVER *** [2h Qc Kh 3h] [6h]
matiko09: checks 
omorfadramou: checks 
*** SHOW DOWN ***
matiko09: shows [8h Js] (a flush, King high)
omorfadramou: mucks hand 
matiko09 collected $10.62 from pot
*** SUMMARY ***
Total pot $11.18 | Rake $0.56 
Board [2h Qc Kh 3h 6h]
Seat 1: aseban11 folded before Flop (didn't bet)
Seat 2: Westpants folded before Flop (didn't bet)
Seat 3: Foton18 (button) folded before Flop (didn't bet)
Seat 4: matiko09 (small blind) showed [8h Js] and won ($10.62) with a flush, King high
Seat 5: omorfadramou (big blind) mucked [Ks Jc]
Seat 6: choupai folded before Flop (didn't bet)
Seat 8: Filojoes folded before Flop (didn't bet)
Seat 9: butcheN18 folded before Flop (didn't bet)





PokerStars Hand #151943363921:  Hold'em No Limit ($0.50/$1.00 USD) - 2016/04/15 13:52:59 CET [2016/04/15 7:52:59 ET]
Table 'Emma II' 9-max Seat #3 is the button
Seat 2: Filojoes ($100 in chips) 
Seat 3: Glushchenko ($222.16 in chips) 
Seat 4: matiko09 ($100 in chips) 
Seat 6: Tirka ($128.34 in chips) 
Seat 7: aseban11 ($107.34 in chips) 
Seat 8: butcheN18 ($166.32 in chips) 
Seat 9: Foton18 ($103.04 in chips) 
matiko09: posts small blind $0.50
Tirka: posts big blind $1
omorfadramou: sits out 
*** HOLE CARDS ***
Dealt to matiko09 [Ts 7h]
aseban11: folds 
butcheN18: folds 
Foton18: folds 
Filojoes: raises $1.50 to $2.50
Glushchenko: raises $7 to $9.50
matiko09: folds 
Tirka: folds 
Filojoes: folds 
Uncalled bet ($7) returned to Glushchenko
Glushchenko collected $6.50 from pot
*** SUMMARY ***
Total pot $6.50 | Rake $0 
Seat 2: Filojoes folded before Flop
Seat 3: Glushchenko (button) collected ($6.50)
Seat 4: matiko09 (small blind) folded before Flop
Seat 6: Tirka (big blind) folded before Flop
Seat 7: aseban11 folded before Flop (didn't bet)
Seat 8: butcheN18 folded before Flop (didn't bet)
Seat 9: Foton18 folded before Flop (didn't bet)





PokerStars Hand #151943364055:  Hold'em No Limit ($0.50/$1.00 USD) - 2016/04/15 13:52:59 CET [2016/04/15 7:52:59 ET]
Table 'Navi' 9-max Seat #6 is the button
Seat 1: tipner ($113.33 in chips) 
Seat 2: butcheN18 ($101 in chips) 
Seat 5: hammerwife ($104.32 in chips) 
Seat 6: Glushchenko ($240.08 in chips) 
Seat 7: yoshidao ($6.24 in chips) 
Seat 8: djammusic ($39.50 in chips) 
Seat 9: matiko09 ($132.13 in chips) 
yoshidao: posts small blind $0.50
djammusic: posts big blind $1
Filojoes: sits out 
Pvsx.: sits out 
*** HOLE CARDS ***
Dealt to matiko09 [5h Ks]
matiko09: folds 
tipner: folds 
butcheN18: folds 
hammerwife: folds 
Glushchenko: folds 
yoshidao: calls $0.50
djammusic: raises $4 to $5
yoshidao: calls $4
*** FLOP *** [9h 3s 3h]
yoshidao: checks 
djammusic: bets $3.80
yoshidao: calls $1.24 and is all-in
Uncalled bet ($2.56) returned to djammusic
*** TURN *** [9h 3s 3h] [7h]
*** RIVER *** [9h 3s 3h 7h] [As]
*** SHOW DOWN ***
yoshidao: shows [Jc Qc] (a pair of Threes)
djammusic: shows [8c 8h] (two pair, Eights and Threes)
djammusic collected $11.86 from pot
*** SUMMARY ***
Total pot $12.48 | Rake $0.62 
Board [9h 3s 3h 7h As]
Seat 1: tipner folded before Flop (didn't bet)
Seat 2: butcheN18 folded before Flop (didn't bet)
Seat 5: hammerwife folded before Flop (didn't bet)
Seat 6: Glushchenko (button) folded before Flop (didn't bet)
Seat 7: yoshidao (small blind) showed [Jc Qc] and lost with a pair of Threes
Seat 8: djammusic (big blind) showed [8c 8h] and won ($11.86) with two pair, Eights and Threes
Seat 9: matiko09 folded before Flop (didn't bet)





PokerStars Hand #151943364951:  Hold'em No Limit ($1/$2 USD) - 2016/04/15 13:53:01 CET [2016/04/15 7:53:01 ET]
Table 'Oceax' 9-max Seat #9 is the button
Seat 1: matiko09 ($200 in chips) 
Seat 2: Fish4trips ($327.38 in chips) 
Seat 4: butcheN18 ($230.42 in chips) 
Seat 5: di0d80 ($200 in chips) 
Seat 6: Iggso ($258.80 in chips) 
Seat 8: Poroxide ($317.92 in chips) 
Seat 9: erfk1958 ($122.35 in chips) 
matiko09: posts small blind $1
Fish4trips: posts big blind $2
Glushchenko: sits out 
*** HOLE CARDS ***
Dealt to matiko09 [6d Qs]
ssljvr joins the table at seat #7 
butcheN18: folds 
di0d80: raises $3 to $5
Iggso: folds 
Poroxide: calls $5
erfk1958: folds 
matiko09: folds 
Fish4trips: folds 
*** FLOP *** [3d 5s 5h]
di0d80: checks 
Poroxide: checks 
*** TURN *** [3d 5s 5h] [Kh]
di0d80: checks 
Poroxide: checks 
*** RIVER *** [3d 5s 5h Kh] [9d]
di0d80: checks 
Poroxide: checks 
*** SHOW DOWN ***
di0d80: shows [Qd Ad] (a pair of Fives)
Poroxide: mucks hand 
di0d80 collected $12.35 from pot
*** SUMMARY ***
Total pot $13 | Rake $0.65 
Board [3d 5s 5h Kh 9d]
Seat 1: matiko09 (small blind) folded before Flop
Seat 2: Fish4trips (big blind) folded before Flop
Seat 4: butcheN18 folded before Flop (didn't bet)
Seat 5: di0d80 showed [Qd Ad] and won ($12.35) with a pair of Fives
Seat 6: Iggso folded before Flop (didn't bet)
Seat 8: Poroxide mucked [6h Ah]
Seat 9: erfk1958 (button) folded before Flop (didn't bet)





PokerStars Hand #151943366348:  Hold'em No Limit ($1/$2 USD) - 2016/04/15 13:53:03 CET [2016/04/15 7:53:03 ET]
Table 'Blaauw' 9-max Seat #5 is the button
Seat 2: butcheN18 ($259.60 in chips) 
Seat 3: Glushchenko ($273.80 in chips) 
Seat 4: petro0107 ($236.89 in chips) 
Seat 5: tipner ($200 in chips) 
Seat 6: matiko09 ($227 in chips) 
Seat 7: ssljvr ($377.01 in chips) 
Seat 9: coinflip_si ($209.88 in chips) 
matiko09: posts small blind $1
ssljvr: posts big blind $2
Iggso: sits out 
myatiy 96: sits out 
*** HOLE CARDS ***
Dealt to matiko09 [6d Ts]
coinflip_si: folds 
butcheN18: folds 
Glushchenko: folds 
petro0107: folds 
tipner: folds 
matiko09: folds 
Uncalled bet ($1) returned to ssljvr
ssljvr collected $2 from pot
ssljvr: doesn't show hand 
*** SUMMARY ***
Total pot $2 | Rake $0 
Seat 2: butcheN18 folded before Flop (didn't bet)
Seat 3: Glushchenko folded before Flop (didn't bet)
Seat 4: petro0107 folded before Flop (didn't bet)
Seat 5: tipner (button) folded before Flop (didn't bet)
Seat 6: matiko09 (small blind) folded before Flop
Seat 7: ssljvr (big blind) collected ($2)
Seat 9: coinflip_si folded before Flop (didn't bet)





PokerStars Hand #151943369875:  Hold'em No Limit ($1/$2 USD) - 2016/04/15 13:53:11 CET [2016/04/15 7:53:11 ET]
Table 'Adele II' 9-max Seat #4 is the button
Seat 1: RyanHuJun ($363.66 in chips) 
Seat 2: Fish4trips ($321.49 in chips) 
Seat 3: matiko09 ($313.88 in chips) 
Seat 4: Glushchenko ($200 in chips) 
Seat 5: TonnaMunz ($205.25 in chips) 
Seat 6: Kukuryzka ($200 in chips) 
Seat 7: Iggso ($210.84 in chips) 
Seat 9: SanychStar ($293.77 in chips) 
TonnaMunz: posts small blind $1
Kukuryzka: posts big blind $2
butcheN18: sits out 
*** HOLE CARDS ***
Dealt to matiko09 [6c As]
Iggso: folds 
SanychStar: folds 
RyanHuJun: calls $2
Fish4trips: folds 
matiko09: folds 
Glushchenko: folds 
TonnaMunz: folds 
Kukuryzka: raises $6 to $8
RyanHuJun: calls $6
*** FLOP *** [4c 5h 2h]
Kukuryzka: checks 
RyanHuJun: bets $8
Kukuryzka: calls $8
*** TURN *** [4c 5h 2h] [4d]
Kukuryzka: checks 
RyanHuJun: bets $14
Kukuryzka: calls $14
*** RIVER *** [4c 5h 2h 4d] [Qd]
Kukuryzka: checks 
RyanHuJun: checks 
*** SHOW DOWN ***
Kukuryzka: shows [8h Ah] (a pair of Fours)
RyanHuJun: mucks hand 
Kukuryzka collected $58.25 from pot
*** SUMMARY ***
Total pot $61 | Rake $2.75 
Board [4c 5h 2h 4d Qd]
Seat 1: RyanHuJun mucked [9c Ks]
Seat 2: Fish4trips folded before Flop (didn't bet)
Seat 3: matiko09 folded before Flop (didn't bet)
Seat 4: Glushchenko (button) folded before Flop (didn't bet)
Seat 5: TonnaMunz (small blind) folded before Flop
Seat 6: Kukuryzka (big blind) showed [8h Ah] and won ($58.25) with a pair of Fours
Seat 7: Iggso folded before Flop (didn't bet)
Seat 9: SanychStar folded before Flop (didn't bet)





PokerStars Hand #151943374496:  Hold'em No Limit ($1/$2 USD) - 2016/04/15 13:53:20 CET [2016/04/15 7:53:20 ET]
Table 'Blaauw' 9-max Seat #6 is the button
Seat 2: butcheN18 ($259.60 in chips) 
Seat 3: Glushchenko ($273.80 in chips) 
Seat 4: petro0107 ($236.89 in chips) 
Seat 5: tipner ($200 in chips) 
Seat 6: matiko09 ($226 in chips) 
Seat 7: ssljvr ($378.01 in chips) 
Seat 8: Iggso ($200 in chips) 
Seat 9: coinflip_si ($209.88 in chips) 
ssljvr: posts small blind $1
Iggso: posts big blind $2
myatiy 96: sits out 
*** HOLE CARDS ***
Dealt to matiko09 [9d Ah]
coinflip_si: folds 
butcheN18: folds 
Glushchenko: folds 
petro0107: folds 
tipner: folds 
matiko09: raises $2.54 to $4.54
ssljvr: folds 
Iggso: folds 
Uncalled bet ($2.54) returned to matiko09
matiko09 collected $5 from pot
*** SUMMARY ***
Total pot $5 | Rake $0 
Seat 2: butcheN18 folded before Flop (didn't bet)
Seat 3: Glushchenko folded before Flop (didn't bet)
Seat 4: petro0107 folded before Flop (didn't bet)
Seat 5: tipner folded before Flop (didn't bet)
Seat 6: matiko09 (button) collected ($5)
Seat 7: ssljvr (small blind) folded before Flop
Seat 8: Iggso (big blind) folded before Flop
Seat 9: coinflip_si folded before Flop (didn't bet)





PokerStars Hand #151943381694:  Hold'em No Limit ($1/$2 USD) - 2016/04/15 13:53:34 CET [2016/04/15 7:53:34 ET]
Table 'Irmgard II' 9-max Seat #4 is the button
Seat 1: Iggso ($231.21 in chips) 
Seat 2: Kukuryzka ($210.76 in chips) 
Seat 3: matiko09 ($291.17 in chips) 
Seat 4: di0d80 ($201.75 in chips) 
Seat 6: djammusic ($138.56 in chips) 
Seat 7: erfk1958 ($98.10 in chips) 
Seat 9: maximax04 ($117.46 in chips) 
djammusic: posts small blind $1
erfk1958: posts big blind $2
*** HOLE CARDS ***
Dealt to matiko09 [9h Ts]
maximax04: folds 
Iggso: folds 
Kukuryzka: folds 
MoeAA11 leaves the table
matiko09: folds 
di0d80: folds 
djammusic: folds 
Uncalled bet ($1) returned to erfk1958
erfk1958 collected $2 from pot
erfk1958: doesn't show hand 
*** SUMMARY ***
Total pot $2 | Rake $0 
Seat 1: Iggso folded before Flop (didn't bet)
Seat 2: Kukuryzka folded before Flop (didn't bet)
Seat 3: matiko09 folded before Flop (didn't bet)
Seat 4: di0d80 (button) folded before Flop (didn't bet)
Seat 6: djammusic (small blind) folded before Flop
Seat 7: erfk1958 (big blind) collected ($2)
Seat 9: maximax04 folded before Flop (didn't bet)





PokerStars Hand #151943384833:  Hold'em No Limit ($0.50/$1.00 USD) - 2016/04/15 13:53:40 CET [2016/04/15 7:53:40 ET]
Table 'Parvulesco II' 9-max Seat #2 is the button
Seat 1: bilukm ($112.10 in chips) 
Seat 2: Filojoes ($107.06 in chips) 
Seat 3: matiko09 ($115.45 in chips) 
Seat 4: butcheN18 ($100.62 in chips) 
Seat 6: ruslik_by ($106 in chips) 
Seat 7: Kukuryzka ($99.50 in chips) 
Seat 8: Jimy Tiltman ($112.20 in chips) 
Seat 9: hammerwife ($210.47 in chips) 
matiko09: posts small blind $0.50
butcheN18: posts big blind $1
maxxmeister: sits out 
*** HOLE CARDS ***
Dealt to matiko09 [3s 9h]
ruslik_by: folds 
Kukuryzka: raises $2 to $3
Jimy Tiltman: folds 
hammerwife: calls $3
bilukm: folds 
Filojoes: folds 
matiko09: folds 
butcheN18: folds 
*** FLOP *** [6h Th 9s]
Kukuryzka: bets $5.34
hammerwife: raises $10.16 to $15.50
Kukuryzka: calls $10.16
*** TURN *** [6h Th 9s] [9d]
Kukuryzka: checks 
hammerwife: checks 
*** RIVER *** [6h Th 9s 9d] [As]
Kukuryzka: bets $25.61
hammerwife: folds 
Uncalled bet ($25.61) returned to Kukuryzka
Kukuryzka collected $36.58 from pot
Kukuryzka: doesn't show hand 
*** SUMMARY ***
Total pot $38.50 | Rake $1.92 
Board [6h Th 9s 9d As]
Seat 1: bilukm folded before Flop (didn't bet)
Seat 2: Filojoes (button) folded before Flop (didn't bet)
Seat 3: matiko09 (small blind) folded before Flop
Seat 4: butcheN18 (big blind) folded before Flop
Seat 6: ruslik_by folded before Flop (didn't bet)
Seat 7: Kukuryzka collected ($36.58)
Seat 8: Jimy Tiltman folded before Flop (didn't bet)
Seat 9: hammerwife folded on the River





PokerStars Hand #151943385772:  Hold'em No Limit ($1/$2 USD) - 2016/04/15 13:53:42 CET [2016/04/15 7:53:42 ET]
Table 'Oceax' 9-max Seat #1 is the button
Seat 1: matiko09 ($200 in chips) 
Seat 2: Fish4trips ($325.38 in chips) 
Seat 3: Glushchenko ($200 in chips) 
Seat 4: butcheN18 ($230.42 in chips) 
Seat 5: di0d80 ($207.35 in chips) 
Seat 6: Iggso ($258.80 in chips) 
Seat 8: Poroxide ($312.92 in chips) 
Seat 9: erfk1958 ($122.35 in chips) 
Fish4trips: posts small blind $1
Glushchenko: posts big blind $2
ssljvr: sits out 
*** HOLE CARDS ***
Dealt to matiko09 [Tc Th]
butcheN18: raises $4 to $6
di0d80: folds 
Iggso: folds 
Poroxide: raises $15 to $21
erfk1958: folds 
matiko09: folds 
Fish4trips: folds 
Glushchenko: folds 
butcheN18: folds 
Uncalled bet ($15) returned to Poroxide
Poroxide collected $15 from pot
Poroxide: doesn't show hand 
*** SUMMARY ***
Total pot $15 | Rake $0 
Seat 1: matiko09 (button) folded before Flop (didn't bet)
Seat 2: Fish4trips (small blind) folded before Flop
Seat 3: Glushchenko (big blind) folded before Flop
Seat 4: butcheN18 folded before Flop
Seat 5: di0d80 folded before Flop (didn't bet)
Seat 6: Iggso folded before Flop (didn't bet)
Seat 8: Poroxide collected ($15)
Seat 9: erfk1958 folded before Flop (didn't bet)





PokerStars Hand #151943386038:  Hold'em No Limit ($0.50/$1.00 USD) - 2016/04/15 13:53:43 CET [2016/04/15 7:53:43 ET]
Table 'Emma II' 9-max Seat #4 is the button
Seat 2: Filojoes ($100 in chips) 
Seat 3: Glushchenko ($226.16 in chips) 
Seat 4: matiko09 ($100 in chips) 
Seat 6: Tirka ($127.34 in chips) 
Seat 8: butcheN18 ($166.32 in chips) 
Seat 9: Foton18 ($103.04 in chips) 
Tirka: posts small blind $0.50
aseban11: is sitting out 
aseban11 leaves the table
butcheN18: posts big blind $1
omorfadramou: sits out 
*** HOLE CARDS ***
Dealt to matiko09 [3s 9h]
Foton18: raises $2 to $3
Filojoes: folds 
Glushchenko: folds 
matiko09: folds 
Tirka: folds 
butcheN18: folds 
Uncalled bet ($2) returned to Foton18
ruslik_by joins the table at seat #7 
Foton18 collected $2.50 from pot
Foton18: doesn't show hand 
*** SUMMARY ***
Total pot $2.50 | Rake $0 
Seat 2: Filojoes folded before Flop (didn't bet)
Seat 3: Glushchenko folded before Flop (didn't bet)
Seat 4: matiko09 (button) folded before Flop (didn't bet)
Seat 6: Tirka (small blind) folded before Flop
Seat 8: butcheN18 (big blind) folded before Flop
Seat 9: Foton18 collected ($2.50)





PokerStars Hand #151943391368:  Hold'em No Limit ($0.50/$1.00 USD) - 2016/04/15 13:53:53 CET [2016/04/15 7:53:53 ET]
Table 'Navi' 9-max Seat #8 is the button
Seat 1: tipner ($113.33 in chips) 
Seat 2: butcheN18 ($101 in chips) 
Seat 5: hammerwife ($104.32 in chips) 
Seat 6: Glushchenko ($240.08 in chips) 
Seat 8: djammusic ($45.12 in chips) 
Seat 9: matiko09 ($132.13 in chips) 
matiko09: posts small blind $0.50
tipner: posts big blind $1
Filojoes: sits out 
Pvsx.: sits out 
*** HOLE CARDS ***
Dealt to matiko09 [7s 3d]
butcheN18: folds 
hammerwife: raises $1.50 to $2.50
Glushchenko: folds 
djammusic: folds 
matiko09: folds 
tipner: folds 
Uncalled bet ($1.50) returned to hammerwife
hammerwife collected $2.50 from pot
hammerwife: doesn't show hand 
*** SUMMARY ***
Total pot $2.50 | Rake $0 
Seat 1: tipner (big blind) folded before Flop
Seat 2: butcheN18 folded before Flop (didn't bet)
Seat 5: hammerwife collected ($2.50)
Seat 6: Glushchenko folded before Flop (didn't bet)
Seat 8: djammusic (button) folded before Flop (didn't bet)
Seat 9: matiko09 (small blind) folded before Flop





PokerStars Hand #151943394675:  Hold'em No Limit ($1/$2 USD) - 2016/04/15 13:53:59 CET [2016/04/15 7:53:59 ET]
Table 'Blaauw' 9-max Seat #7 is the button
Seat 2: butcheN18 ($259.60 in chips) 
Seat 3: Glushchenko ($273.80 in chips) 
Seat 4: petro0107 ($236.89 in chips) 
Seat 5: tipner ($200 in chips) 
Seat 6: matiko09 ($229 in chips) 
Seat 7: ssljvr ($377.01 in chips) 
Seat 8: Iggso ($200 in chips) 
Seat 9: coinflip_si ($209.88 in chips) 
Iggso: posts small blind $1
coinflip_si: posts big blind $2
myatiy 96: sits out 
*** HOLE CARDS ***
Dealt to matiko09 [3h 4s]
butcheN18: folds 
Glushchenko: folds 
petro0107: calls $2
tipner: folds 
matiko09: folds 
ssljvr: folds 
Iggso: calls $1
coinflip_si: checks 
*** FLOP *** [Qd Kc Qh]
Iggso: checks 
coinflip_si: checks 
petro0107: checks 
*** TURN *** [Qd Kc Qh] [Ks]
Iggso: checks 
coinflip_si: checks 
petro0107: bets $2
Iggso: calls $2
coinflip_si: folds 
*** RIVER *** [Qd Kc Qh Ks] [Ad]
Iggso: checks 
petro0107: checks 
*** SHOW DOWN ***
Iggso: shows [Ah 8d] (two pair, Aces and Kings)
petro0107: mucks hand 
Iggso collected $9.50 from pot
*** SUMMARY ***
Total pot $10 | Rake $0.50 
Board [Qd Kc Qh Ks Ad]
Seat 2: butcheN18 folded before Flop (didn't bet)
Seat 3: Glushchenko folded before Flop (didn't bet)
Seat 4: petro0107 mucked [5h 4c]
Seat 5: tipner folded before Flop (didn't bet)
Seat 6: matiko09 folded before Flop (didn't bet)
Seat 7: ssljvr (button) folded before Flop (didn't bet)
Seat 8: Iggso (small blind) showed [Ah 8d] and won ($9.50) with two pair, Aces and Kings
Seat 9: coinflip_si (big blind) folded on the Turn





PokerStars Hand #151943395992:  Hold'em No Limit ($0.50/$1.00 USD) - 2016/04/15 13:54:02 CET [2016/04/15 7:54:02 ET]
Table 'Adelgunde III' 9-max Seat #9 is the button
Seat 1: valimiu ($53.75 in chips) 
Seat 2: djammusic ($47.50 in chips) 
Seat 3: tipner ($112.12 in chips) 
Seat 4: hammerwife ($107.28 in chips) 
Seat 5: matiko09 ($129.50 in chips) 
Seat 6: Pominator92 ($157.48 in chips) 
Seat 8: aseban11 ($100.48 in chips) 
Seat 9: Kukuryzka ($107.43 in chips) 
valimiu: posts small blind $0.50
djammusic: posts big blind $1
Yaaaazz: sits out 
*** HOLE CARDS ***
Dealt to matiko09 [9s Tc]
tipner: raises $2 to $3
hammerwife: raises $6 to $9
matiko09: folds 
Pominator92: folds 
aseban11: folds 
Kukuryzka: folds 
valimiu: folds 
djammusic: folds 
tipner: folds 
Uncalled bet ($6) returned to hammerwife
hammerwife collected $7.50 from pot
hammerwife: doesn't show hand 
*** SUMMARY ***
Total pot $7.50 | Rake $0 
Seat 1: valimiu (small blind) folded before Flop
Seat 2: djammusic (big blind) folded before Flop
Seat 3: tipner folded before Flop
Seat 4: hammerwife collected ($7.50)
Seat 5: matiko09 folded before Flop (didn't bet)
Seat 6: Pominator92 folded before Flop (didn't bet)
Seat 8: aseban11 folded before Flop (didn't bet)
Seat 9: Kukuryzka (button) folded before Flop (didn't bet)





PokerStars Hand #151943398846:  Hold'em No Limit ($1/$2 USD) - 2016/04/15 13:54:08 CET [2016/04/15 7:54:08 ET]
Table 'Irmgard II' 9-max Seat #6 is the button
Seat 1: Iggso ($231.21 in chips) 
Seat 2: Kukuryzka ($210.76 in chips) 
Seat 3: matiko09 ($291.17 in chips) 
Seat 4: di0d80 ($201.75 in chips) 
Seat 6: djammusic ($137.56 in chips) 
Seat 7: erfk1958 ($99.10 in chips) 
Seat 9: maximax04 ($117.46 in chips) 
erfk1958: posts small blind $1
maximax04: posts big blind $2
*** HOLE CARDS ***
Dealt to matiko09 [5h Kd]
Iggso: folds 
Kukuryzka: folds 
Iggso leaves the table
matiko09: folds 
di0d80: folds 
djammusic: folds 
erfk1958: folds 
Uncalled bet ($1) returned to maximax04
maximax04 collected $2 from pot
maximax04: doesn't show hand 
*** SUMMARY ***
Total pot $2 | Rake $0 
Seat 1: Iggso folded before Flop (didn't bet)
Seat 2: Kukuryzka folded before Flop (didn't bet)
Seat 3: matiko09 folded before Flop (didn't bet)
Seat 4: di0d80 folded before Flop (didn't bet)
Seat 6: djammusic (button) folded before Flop (didn't bet)
Seat 7: erfk1958 (small blind) folded before Flop
Seat 9: maximax04 (big blind) collected ($2)





PokerStars Hand #151943401636:  Hold'em No Limit ($0.50/$1.00 USD) - 2016/04/15 13:54:13 CET [2016/04/15 7:54:13 ET]
Table 'Emma II' 9-max Seat #6 is the button
Seat 2: Filojoes ($100 in chips) 
Seat 3: Glushchenko ($226.16 in chips) 
Seat 4: matiko09 ($100 in chips) 
Seat 6: Tirka ($126.84 in chips) 
Seat 8: butcheN18 ($165.32 in chips) 
Seat 9: Foton18 ($104.54 in chips) 
ruslik_by will be allowed to play after the button
butcheN18: posts small blind $0.50
Foton18: posts big blind $1
omorfadramou: sits out 
*** HOLE CARDS ***
Dealt to matiko09 [7h 9h]
Filojoes: folds 
Glushchenko: folds 
matiko09: raises $1.50 to $2.50
Tirka: folds 
butcheN18: folds 
Foton18: calls $1.50
*** FLOP *** [4h Qc Kh]
Foton18: bets $4
matiko09: raises $8 to $12
Foton18: raises $26 to $38
matiko09: folds 
Uncalled bet ($26) returned to Foton18
Foton18 collected $28.02 from pot
Foton18: doesn't show hand 
*** SUMMARY ***
Total pot $29.50 | Rake $1.48 
Board [4h Qc Kh]
Seat 2: Filojoes folded before Flop (didn't bet)
Seat 3: Glushchenko folded before Flop (didn't bet)
Seat 4: matiko09 folded on the Flop
Seat 6: Tirka (button) folded before Flop (didn't bet)
Seat 8: butcheN18 (small blind) folded before Flop
Seat 9: Foton18 (big blind) collected ($28.02)





PokerStars Hand #151943409467:  Hold'em No Limit ($1/$2 USD) - 2016/04/15 13:54:29 CET [2016/04/15 7:54:29 ET]
Table 'Irmgard II' 9-max Seat #7 is the button
Seat 2: Kukuryzka ($210.76 in chips) 
Seat 3: matiko09 ($291.17 in chips) 
Seat 4: di0d80 ($201.75 in chips) 
Seat 6: djammusic ($137.56 in chips) 
Seat 7: erfk1958 ($98.10 in chips) 
Seat 9: maximax04 ($118.46 in chips) 
maximax04: posts small blind $1
Kukuryzka: posts big blind $2
*** HOLE CARDS ***
Dealt to matiko09 [6d As]
matiko09: folds 
di0d80: folds 
djammusic: folds 
erfk1958: raises $2 to $4
maximax04: calls $3
GB223 joins the table at seat #1 
Kukuryzka: raises $18 to $22
erfk1958: folds 
maximax04: calls $18
*** FLOP *** [4d 7h 7s]
maximax04: checks 
Kukuryzka: bets $22.80
maximax04: folds 
Uncalled bet ($22.80) returned to Kukuryzka
Kukuryzka collected $45.60 from pot
Kukuryzka: doesn't show hand 
*** SUMMARY ***
Total pot $48 | Rake $2.40 
Board [4d 7h 7s]
Seat 2: Kukuryzka (big blind) collected ($45.60)
Seat 3: matiko09 folded before Flop (didn't bet)
Seat 4: di0d80 folded before Flop (didn't bet)
Seat 6: djammusic folded before Flop (didn't bet)
Seat 7: erfk1958 (button) folded before Flop
Seat 9: maximax04 (small blind) folded on the Flop





PokerStars Hand #151943410446:  Hold'em No Limit ($1/$2 USD) - 2016/04/15 13:54:31 CET [2016/04/15 7:54:31 ET]
Table 'Oceax' 9-max Seat #2 is the button
Seat 1: matiko09 ($200 in chips) 
Seat 2: Fish4trips ($324.38 in chips) 
Seat 3: Glushchenko ($200 in chips) 
Seat 4: butcheN18 ($224.42 in chips) 
Seat 5: di0d80 ($207.35 in chips) 
Seat 6: Iggso ($258.80 in chips) 
Seat 8: Poroxide ($321.92 in chips) 
Seat 9: erfk1958 ($122.35 in chips) 
Glushchenko: posts small blind $1
butcheN18: posts big blind $2
ssljvr: sits out 
*** HOLE CARDS ***
Dealt to matiko09 [Tc 4s]
di0d80: folds 
Iggso: folds 
Poroxide: folds 
erfk1958: folds 
matiko09: folds 
Fish4trips: folds 
Glushchenko: folds 
Uncalled bet ($1) returned to butcheN18
butcheN18 collected $2 from pot
butcheN18: doesn't show hand 
*** SUMMARY ***
Total pot $2 | Rake $0 
Seat 1: matiko09 folded before Flop (didn't bet)
Seat 2: Fish4trips (button) folded before Flop (didn't bet)
Seat 3: Glushchenko (small blind) folded before Flop
Seat 4: butcheN18 (big blind) collected ($2)
Seat 5: di0d80 folded before Flop (didn't bet)
Seat 6: Iggso folded before Flop (didn't bet)
Seat 8: Poroxide folded before Flop (didn't bet)
Seat 9: erfk1958 folded before Flop (didn't bet)





PokerStars Hand #151943414267:  Hold'em No Limit ($0.50/$1.00 USD) - 2016/04/15 13:54:38 CET [2016/04/15 7:54:38 ET]
Table 'Chiny II' 9-max Seat #4 is the button
Seat 1: aseban11 ($100 in chips) 
Seat 2: Westpants ($126.81 in chips) 
Seat 3: Foton18 ($116.22 in chips) 
Seat 4: matiko09 ($175.90 in chips) 
Seat 5: omorfadramou ($100 in chips) 
Seat 6: choupai ($17.53 in chips) 
Seat 8: Filojoes ($146.74 in chips) 
Seat 9: butcheN18 ($101.50 in chips) 
omorfadramou: posts small blind $0.50
choupai: posts big blind $1
ruslik_by: sits out 
*** HOLE CARDS ***
Dealt to matiko09 [2h Jd]
Filojoes: folds 
butcheN18: folds 
aseban11: raises $2 to $3
Westpants: folds 
Foton18: calls $3
matiko09: folds 
omorfadramou: raises $10 to $13
choupai: folds 
aseban11: calls $10
Foton18: calls $10
*** FLOP *** [9s 2c Ks]
omorfadramou: checks 
aseban11: checks 
Foton18: bets $15
omorfadramou: calls $15
aseban11: folds 
*** TURN *** [9s 2c Ks] [3h]
omorfadramou: checks 
Foton18: checks 
*** RIVER *** [9s 2c Ks 3h] [9d]
omorfadramou: checks 
Foton18: bets $27
omorfadramou: calls $27
*** SHOW DOWN ***
Foton18: shows [Ad Qh] (a pair of Nines)
omorfadramou: shows [Qs Qd] (two pair, Queens and Nines)
omorfadramou collected $121.50 from pot
*** SUMMARY ***
Total pot $124 | Rake $2.50 
Board [9s 2c Ks 3h 9d]
Seat 1: aseban11 folded on the Flop
Seat 2: Westpants folded before Flop (didn't bet)
Seat 3: Foton18 showed [Ad Qh] and lost with a pair of Nines
Seat 4: matiko09 (button) folded before Flop (didn't bet)
Seat 5: omorfadramou (small blind) showed [Qs Qd] and won ($121.50) with two pair, Queens and Nines
Seat 6: choupai (big blind) folded before Flop
Seat 8: Filojoes folded before Flop (didn't bet)
Seat 9: butcheN18 folded before Flop (didn't bet)





PokerStars Hand #151943414940:  Hold'em No Limit ($0.50/$1.00 USD) - 2016/04/15 13:54:40 CET [2016/04/15 7:54:40 ET]
Table 'Navi' 9-max Seat #9 is the button
Seat 1: tipner ($112.33 in chips) 
Seat 2: butcheN18 ($101 in chips) 
Seat 5: hammerwife ($105.82 in chips) 
Seat 6: Glushchenko ($240.08 in chips) 
Seat 8: djammusic ($45.12 in chips) 
Seat 9: matiko09 ($131.63 in chips) 
tipner: posts small blind $0.50
butcheN18: posts big blind $1
Filojoes: sits out 
Pvsx.: sits out 
*** HOLE CARDS ***
Dealt to matiko09 [Ts 5h]
hammerwife: folds 
Glushchenko: folds 
djammusic: folds 
matiko09: folds 
tipner: folds 
Uncalled bet ($0.50) returned to butcheN18
butcheN18 collected $1 from pot
butcheN18: doesn't show hand 
*** SUMMARY ***
Total pot $1 | Rake $0 
Seat 1: tipner (small blind) folded before Flop
Seat 2: butcheN18 (big blind) collected ($1)
Seat 5: hammerwife folded before Flop (didn't bet)
Seat 6: Glushchenko folded before Flop (didn't bet)
Seat 8: djammusic folded before Flop (didn't bet)
Seat 9: matiko09 (button) folded before Flop (didn't bet)





PokerStars Hand #151943415527:  Hold'em No Limit ($0.50/$1.00 USD) - 2016/04/15 13:54:41 CET [2016/04/15 7:54:41 ET]
Table 'Adelgunde III' 9-max Seat #1 is the button
Seat 1: valimiu ($53.25 in chips) 
Seat 2: djammusic ($46.50 in chips) 
Seat 3: tipner ($109.12 in chips) 
Seat 4: hammerwife ($111.78 in chips) 
Seat 5: matiko09 ($129.50 in chips) 
Seat 6: Pominator92 ($157.48 in chips) 
Seat 8: aseban11 ($100.48 in chips) 
Seat 9: Kukuryzka ($107.43 in chips) 
djammusic: posts small blind $0.50
tipner: posts big blind $1
Yaaaazz: sits out 
*** HOLE CARDS ***
Dealt to matiko09 [5h Kd]
hammerwife: folds 
matiko09: folds 
Pominator92: folds 
aseban11: folds 
Kukuryzka: folds 
valimiu: calls $1
djammusic: folds 
tipner: raises $3 to $4
valimiu: calls $3
*** FLOP *** [8s Ad 6s]
tipner: bets $5
valimiu: calls $5
*** TURN *** [8s Ad 6s] [2h]
tipner: checks 
valimiu: checks 
*** RIVER *** [8s Ad 6s 2h] [Jc]
tipner: checks 
valimiu: bets $10
tipner: calls $10
*** SHOW DOWN ***
valimiu: shows [Ts 9h] (high card Ace)
tipner: shows [Ks Jh] (a pair of Jacks)
tipner collected $36.58 from pot
*** SUMMARY ***
Total pot $38.50 | Rake $1.92 
Board [8s Ad 6s 2h Jc]
Seat 1: valimiu (button) showed [Ts 9h] and lost with high card Ace
Seat 2: djammusic (small blind) folded before Flop
Seat 3: tipner (big blind) showed [Ks Jh] and won ($36.58) with a pair of Jacks
Seat 4: hammerwife folded before Flop (didn't bet)
Seat 5: matiko09 folded before Flop (didn't bet)
Seat 6: Pominator92 folded before Flop (didn't bet)
Seat 8: aseban11 folded before Flop (didn't bet)
Seat 9: Kukuryzka folded before Flop (didn't bet)





PokerStars Hand #151943418071:  Hold'em No Limit ($1/$2 USD) - 2016/04/15 13:54:46 CET [2016/04/15 7:54:46 ET]
Table 'Oceax' 9-max Seat #3 is the button
Seat 1: matiko09 ($200 in chips) 
Seat 2: Fish4trips ($324.38 in chips) 
Seat 3: Glushchenko ($200 in chips) 
Seat 4: butcheN18 ($225.42 in chips) 
Seat 6: Iggso ($258.80 in chips) 
Seat 8: Poroxide ($321.92 in chips) 
Seat 9: erfk1958 ($122.35 in chips) 
butcheN18: posts small blind $1
di0d80: is sitting out 
Iggso: posts big blind $2
ssljvr: sits out 
*** HOLE CARDS ***
Dealt to matiko09 [3h Jh]
Poroxide: folds 
erfk1958: folds 
di0d80 leaves the table
myatiy 96 joins the table at seat #5 
matiko09: folds 
myatiy 96 leaves the table
Fish4trips: folds 
Glushchenko: raises $2 to $4
butcheN18: raises $12 to $16
Iggso: folds 
Glushchenko: calls $12
*** FLOP *** [4h As 9s]
butcheN18: checks 
Glushchenko: checks 
*** TURN *** [4h As 9s] [8d]
derrocco82 joins the table at seat #5 
butcheN18: bets $16.79
Glushchenko: calls $16.79
*** RIVER *** [4h As 9s 8d] [Kc]
butcheN18: checks 
Glushchenko: checks 
*** SHOW DOWN ***
butcheN18: shows [Td Ad] (a pair of Aces)
Glushchenko: mucks hand 
butcheN18 collected $64.83 from pot
*** SUMMARY ***
Total pot $67.58 | Rake $2.75 
Board [4h As 9s 8d Kc]
Seat 1: matiko09 folded before Flop (didn't bet)
Seat 2: Fish4trips folded before Flop (didn't bet)
Seat 3: Glushchenko (button) mucked [Tc Ts]
Seat 4: butcheN18 (small blind) showed [Td Ad] and won ($64.83) with a pair of Aces
Seat 6: Iggso (big blind) folded before Flop
Seat 8: Poroxide folded before Flop (didn't bet)
Seat 9: erfk1958 folded before Flop (didn't bet)





PokerStars Hand #151943422288:  Hold'em No Limit ($1/$2 USD) - 2016/04/15 13:54:54 CET [2016/04/15 7:54:54 ET]
Table 'Adele II' 9-max Seat #5 is the button
Seat 1: RyanHuJun ($333.66 in chips) 
Seat 2: Fish4trips ($321.49 in chips) 
Seat 3: matiko09 ($313.88 in chips) 
Seat 4: Glushchenko ($200 in chips) 
Seat 5: TonnaMunz ($204.25 in chips) 
Seat 6: Kukuryzka ($228.25 in chips) 
Seat 7: Iggso ($210.84 in chips) 
Seat 9: SanychStar ($293.77 in chips) 
Kukuryzka: posts small blind $1
Iggso: posts big blind $2
butcheN18: sits out 
*** HOLE CARDS ***
Dealt to matiko09 [7d Ac]
SanychStar: folds 
RyanHuJun: calls $2
Fish4trips: raises $6 to $8
matiko09: folds 
Glushchenko: folds 
TonnaMunz: folds 
Kukuryzka: folds 
Iggso: folds 
RyanHuJun is disconnected 
RyanHuJun is connected 
RyanHuJun: calls $6
*** FLOP *** [Ad 5s Jd]
RyanHuJun: checks 
Fish4trips: bets $12.63
RyanHuJun: folds 
Uncalled bet ($12.63) returned to Fish4trips
Fish4trips collected $18.05 from pot
Fish4trips: doesn't show hand 
*** SUMMARY ***
Total pot $19 | Rake $0.95 
Board [Ad 5s Jd]
Seat 1: RyanHuJun folded on the Flop
Seat 2: Fish4trips collected ($18.05)
Seat 3: matiko09 folded before Flop (didn't bet)
Seat 4: Glushchenko folded before Flop (didn't bet)
Seat 5: TonnaMunz (button) folded before Flop (didn't bet)
Seat 6: Kukuryzka (small blind) folded before Flop
Seat 7: Iggso (big blind) folded before Flop
Seat 9: SanychStar folded before Flop (didn't bet)





PokerStars Hand #151943427427:  Hold'em No Limit ($0.50/$1.00 USD) - 2016/04/15 13:55:04 CET [2016/04/15 7:55:04 ET]
Table 'Navi' 9-max Seat #1 is the button
Seat 1: tipner ($111.83 in chips) 
Seat 2: butcheN18 ($101.50 in chips) 
Seat 3: Filojoes ($100 in chips) 
Seat 5: hammerwife ($105.82 in chips) 
Seat 6: Glushchenko ($240.08 in chips) 
Seat 8: djammusic ($45.12 in chips) 
Seat 9: matiko09 ($131.63 in chips) 
butcheN18: posts small blind $0.50
Filojoes: posts big blind $1
Pvsx.: sits out 
*** HOLE CARDS ***
Dealt to matiko09 [3h Ad]
hammerwife: folds 
Glushchenko: folds 
djammusic: folds 
matiko09: folds 
tipner: folds 
butcheN18: raises $1.44 to $2.44
Filojoes: calls $1.44
*** FLOP *** [9d Js 6c]
butcheN18: checks 
Filojoes: bets $2.78
butcheN18: folds 
Uncalled bet ($2.78) returned to Filojoes
Filojoes collected $4.64 from pot
Filojoes: doesn't show hand 
*** SUMMARY ***
Total pot $4.88 | Rake $0.24 
Board [9d Js 6c]
Seat 1: tipner (button) folded before Flop (didn't bet)
Seat 2: butcheN18 (small blind) folded on the Flop
Seat 3: Filojoes (big blind) collected ($4.64)
Seat 5: hammerwife folded before Flop (didn't bet)
Seat 6: Glushchenko folded before Flop (didn't bet)
Seat 8: djammusic folded before Flop (didn't bet)
Seat 9: matiko09 folded before Flop (didn't bet)





PokerStars Hand #151943431277:  Hold'em No Limit ($0.50/$1.00 USD) - 2016/04/15 13:55:12 CET [2016/04/15 7:55:12 ET]
Table 'Emma II' 9-max Seat #8 is the button
Seat 1: omorfadramou ($100 in chips) 
Seat 2: Filojoes ($100 in chips) 
Seat 3: Glushchenko ($226.16 in chips) 
Seat 4: matiko09 ($100 in chips) 
Seat 6: Tirka ($126.84 in chips) 
Seat 8: butcheN18 ($164.82 in chips) 
Seat 9: Foton18 ($118.06 in chips) 
Foton18: posts small blind $0.50
omorfadramou: posts big blind $1
ruslik_by: sits out 
*** HOLE CARDS ***
Dealt to matiko09 [Ks 5s]
Filojoes: folds 
Glushchenko: folds 
matiko09: folds 
Tirka: folds 
butcheN18: folds 
Foton18: raises $2 to $3
omorfadramou: folds 
Uncalled bet ($2) returned to Foton18
Foton18 collected $2 from pot
Foton18: doesn't show hand 
*** SUMMARY ***
Total pot $2 | Rake $0 
Seat 1: omorfadramou (big blind) folded before Flop
Seat 2: Filojoes folded before Flop (didn't bet)
Seat 3: Glushchenko folded before Flop (didn't bet)
Seat 4: matiko09 folded before Flop (didn't bet)
Seat 6: Tirka folded before Flop (didn't bet)
Seat 8: butcheN18 (button) folded before Flop (didn't bet)
Seat 9: Foton18 (small blind) collected ($2)





PokerStars Hand #151943432078:  Hold'em No Limit ($1/$2 USD) - 2016/04/15 13:55:13 CET [2016/04/15 7:55:13 ET]
Table 'Blaauw' 9-max Seat #8 is the button
Seat 1: myatiy 96 ($200 in chips) 
Seat 2: butcheN18 ($259.60 in chips) 
Seat 3: Glushchenko ($273.80 in chips) 
Seat 4: petro0107 ($232.89 in chips) 
Seat 5: tipner ($200 in chips) 
Seat 6: matiko09 ($229 in chips) 
Seat 7: ssljvr ($377.01 in chips) 
Seat 8: Iggso ($205.50 in chips) 
Seat 9: coinflip_si ($207.88 in chips) 
coinflip_si: posts small blind $1
myatiy 96: posts big blind $2
*** HOLE CARDS ***
Dealt to matiko09 [9c Th]
butcheN18: folds 
Glushchenko: folds 
petro0107: folds 
tipner: folds 
matiko09: folds 
ssljvr: folds 
Iggso: folds 
coinflip_si: raises $3 to $5
myatiy 96: folds 
Uncalled bet ($3) returned to coinflip_si
coinflip_si collected $4 from pot
coinflip_si: doesn't show hand 
*** SUMMARY ***
Total pot $4 | Rake $0 
Seat 1: myatiy 96 (big blind) folded before Flop
Seat 2: butcheN18 folded before Flop (didn't bet)
Seat 3: Glushchenko folded before Flop (didn't bet)
Seat 4: petro0107 folded before Flop (didn't bet)
Seat 5: tipner folded before Flop (didn't bet)
Seat 6: matiko09 folded before Flop (didn't bet)
Seat 7: ssljvr folded before Flop (didn't bet)
Seat 8: Iggso (button) folded before Flop (didn't bet)
Seat 9: coinflip_si (small blind) collected ($4)





PokerStars Hand #151943433803:  Hold'em No Limit ($1/$2 USD) - 2016/04/15 13:55:17 CET [2016/04/15 7:55:17 ET]
Table 'Irmgard II' 9-max Seat #9 is the button
Seat 2: Kukuryzka ($234.36 in chips) 
Seat 3: matiko09 ($291.17 in chips) 
Seat 4: di0d80 ($201.75 in chips) 
Seat 6: djammusic ($137.56 in chips) 
Seat 7: erfk1958 ($94.10 in chips) 
Seat 9: maximax04 ($96.46 in chips) 
GB223 will be allowed to play after the button
Kukuryzka: posts small blind $1
matiko09: posts big blind $2
*** HOLE CARDS ***
Dealt to matiko09 [Kc 2s]
di0d80: folds 
djammusic: folds 
erfk1958: folds 
maximax04: folds 
Vikulja1993 joins the table at seat #8 
Kukuryzka: raises $3 to $5
matiko09: folds 
Uncalled bet ($3) returned to Kukuryzka
Kukuryzka collected $4 from pot
Kukuryzka: doesn't show hand 
*** SUMMARY ***
Total pot $4 | Rake $0 
Seat 2: Kukuryzka (small blind) collected ($4)
Seat 3: matiko09 (big blind) folded before Flop
Seat 4: di0d80 folded before Flop (didn't bet)
Seat 6: djammusic folded before Flop (didn't bet)
Seat 7: erfk1958 folded before Flop (didn't bet)
Seat 9: maximax04 (button) folded before Flop (didn't bet)





PokerStars Hand #151943442354:  Hold'em No Limit ($0.50/$1.00 USD) - 2016/04/15 13:55:36 CET [2016/04/15 7:55:36 ET]
Table 'Parvulesco II' 9-max Seat #3 is the button
Seat 1: bilukm ($112.10 in chips) 
Seat 2: Filojoes ($107.06 in chips) 
Seat 3: matiko09 ($114.95 in chips) 
Seat 4: butcheN18 ($100 in chips) 
Seat 5: maxxmeister ($100 in chips) 
Seat 6: ruslik_by ($106 in chips) 
Seat 7: Kukuryzka ($117.58 in chips) 
Seat 8: Jimy Tiltman ($112.20 in chips) 
Seat 9: hammerwife ($191.97 in chips) 
butcheN18: posts small blind $0.50
maxxmeister: posts big blind $1
*** HOLE CARDS ***
Dealt to matiko09 [2c 6s]
ruslik_by: folds 
Kukuryzka: folds 
Jimy Tiltman: folds 
hammerwife: folds 
bilukm: folds 
Filojoes: raises $1.50 to $2.50
matiko09: folds 
butcheN18: folds 
maxxmeister: folds 
Uncalled bet ($1.50) returned to Filojoes
Filojoes collected $2.50 from pot
Filojoes: doesn't show hand 
*** SUMMARY ***
Total pot $2.50 | Rake $0 
Seat 1: bilukm folded before Flop (didn't bet)
Seat 2: Filojoes collected ($2.50)
Seat 3: matiko09 (button) folded before Flop (didn't bet)
Seat 4: butcheN18 (small blind) folded before Flop
Seat 5: maxxmeister (big blind) folded before Flop
Seat 6: ruslik_by folded before Flop (didn't bet)
Seat 7: Kukuryzka folded before Flop (didn't bet)
Seat 8: Jimy Tiltman folded before Flop (didn't bet)
Seat 9: hammerwife folded before Flop (didn't bet)





PokerStars Hand #151943442540:  Hold'em No Limit ($1/$2 USD) - 2016/04/15 13:55:37 CET [2016/04/15 7:55:37 ET]
Table 'Irmgard II' 9-max Seat #2 is the button
Seat 2: Kukuryzka ($236.36 in chips) 
Seat 3: matiko09 ($289.17 in chips) 
Seat 4: di0d80 ($201.75 in chips) 
Seat 6: djammusic ($137.56 in chips) 
Seat 7: erfk1958 ($94.10 in chips) 
Seat 9: maximax04 ($96.46 in chips) 
matiko09: posts small blind $1
di0d80: posts big blind $2
Vikulja1993: sits out 
GB223: sits out 
*** HOLE CARDS ***
Dealt to matiko09 [Jh Qc]
djammusic: folds 
erfk1958: folds 
maximax04: folds 
Kukuryzka: folds 
matiko09: raises $3 to $5
di0d80: folds 
Uncalled bet ($3) returned to matiko09
matiko09 collected $4 from pot
matiko09: doesn't show hand 
*** SUMMARY ***
Total pot $4 | Rake $0 
Seat 2: Kukuryzka (button) folded before Flop (didn't bet)
Seat 3: matiko09 (small blind) collected ($4)
Seat 4: di0d80 (big blind) folded before Flop
Seat 6: djammusic folded before Flop (didn't bet)
Seat 7: erfk1958 folded before Flop (didn't bet)
Seat 9: maximax04 folded before Flop (didn't bet)





PokerStars Hand #151943448322:  Hold'em No Limit ($0.50/$1.00 USD) - 2016/04/15 13:55:50 CET [2016/04/15 7:55:50 ET]
Table 'Adelgunde III' 9-max Seat #2 is the button
Seat 1: valimiu ($34.25 in chips) 
Seat 2: djammusic ($46 in chips) 
Seat 3: tipner ($126.70 in chips) 
Seat 4: hammerwife ($111.78 in chips) 
Seat 5: matiko09 ($129.50 in chips) 
Seat 6: Pominator92 ($157.48 in chips) 
Seat 8: aseban11 ($100.48 in chips) 
Seat 9: Kukuryzka ($107.43 in chips) 
tipner: posts small blind $0.50
hammerwife: posts big blind $1
Yaaaazz: sits out 
*** HOLE CARDS ***
Dealt to matiko09 [Ad Js]
matiko09: folds 
Pominator92: folds 
aseban11: folds 
Kukuryzka: folds 
valimiu: folds 
djammusic: raises $1.02 to $2.02
tipner: folds 
hammerwife: folds 
Uncalled bet ($1.02) returned to djammusic
djammusic collected $2.50 from pot
djammusic: doesn't show hand 
*** SUMMARY ***
Total pot $2.50 | Rake $0 
Seat 1: valimiu folded before Flop (didn't bet)
Seat 2: djammusic (button) collected ($2.50)
Seat 3: tipner (small blind) folded before Flop
Seat 4: hammerwife (big blind) folded before Flop
Seat 5: matiko09 folded before Flop (didn't bet)
Seat 6: Pominator92 folded before Flop (didn't bet)
Seat 8: aseban11 folded before Flop (didn't bet)
Seat 9: Kukuryzka folded before Flop (didn't bet)





PokerStars Hand #151943449993:  Hold'em No Limit ($0.50/$1.00 USD) - 2016/04/15 13:55:53 CET [2016/04/15 7:55:53 ET]
Table 'Navi' 9-max Seat #2 is the button
Seat 1: tipner ($111.83 in chips) 
Seat 2: butcheN18 ($100 in chips) 
Seat 3: Filojoes ($102.20 in chips) 
Seat 4: Pvsx. ($100 in chips) 
Seat 5: hammerwife ($105.82 in chips) 
Seat 6: Glushchenko ($240.08 in chips) 
Seat 8: djammusic ($45.12 in chips) 
Seat 9: matiko09 ($131.63 in chips) 
Filojoes: posts small blind $0.50
Pvsx.: posts big blind $1
*** HOLE CARDS ***
Dealt to matiko09 [6h 4d]
hammerwife: folds 
Glushchenko: raises $2 to $3
djammusic: folds 
matiko09: folds 
tipner: folds 
butcheN18: folds 
Filojoes: folds 
Pvsx.: folds 
Uncalled bet ($2) returned to Glushchenko
Glushchenko collected $2.50 from pot
*** SUMMARY ***
Total pot $2.50 | Rake $0 
Seat 1: tipner folded before Flop (didn't bet)
Seat 2: butcheN18 (button) folded before Flop (didn't bet)
Seat 3: Filojoes (small blind) folded before Flop
Seat 4: Pvsx. (big blind) folded before Flop
Seat 5: hammerwife folded before Flop (didn't bet)
Seat 6: Glushchenko collected ($2.50)
Seat 8: djammusic folded before Flop (didn't bet)
Seat 9: matiko09 folded before Flop (didn't bet)





PokerStars Hand #151943450220:  Hold'em No Limit ($0.50/$1.00 USD) - 2016/04/15 13:55:54 CET [2016/04/15 7:55:54 ET]
Table 'Emma II' 9-max Seat #9 is the button
Seat 1: omorfadramou ($100 in chips) 
Seat 2: Filojoes ($100 in chips) 
Seat 3: Glushchenko ($226.16 in chips) 
Seat 4: matiko09 ($100 in chips) 
Seat 6: Tirka ($126.84 in chips) 
Seat 8: butcheN18 ($164.82 in chips) 
Seat 9: Foton18 ($119.06 in chips) 
omorfadramou: posts small blind $0.50
Filojoes: posts big blind $1
ruslik_by: sits out 
*** HOLE CARDS ***
Dealt to matiko09 [8h 9h]
Glushchenko: folds 
matiko09: raises $2 to $3
Tirka: calls $3
butcheN18: raises $9 to $12
Foton18: folds 
omorfadramou: folds 
Filojoes: folds 
matiko09: folds 
Tirka: folds 
Uncalled bet ($9) returned to butcheN18
butcheN18 collected $10.50 from pot
butcheN18: doesn't show hand 
*** SUMMARY ***
Total pot $10.50 | Rake $0 
Seat 1: omorfadramou (small blind) folded before Flop
Seat 2: Filojoes (big blind) folded before Flop
Seat 3: Glushchenko folded before Flop (didn't bet)
Seat 4: matiko09 folded before Flop
Seat 6: Tirka folded before Flop
Seat 8: butcheN18 collected ($10.50)
Seat 9: Foton18 (button) folded before Flop (didn't bet)





PokerStars Hand #151943451172:  Hold'em No Limit ($1/$2 USD) - 2016/04/15 13:55:56 CET [2016/04/15 7:55:56 ET]
Table 'Irmgard II' 9-max Seat #3 is the button
Seat 2: Kukuryzka ($236.36 in chips) 
Seat 3: matiko09 ($291.17 in chips) 
Seat 4: di0d80 ($200 in chips) 
Seat 7: erfk1958 ($94.10 in chips) 
Seat 9: maximax04 ($96.46 in chips) 
di0d80: posts small blind $1
djammusic: is sitting out 
erfk1958: posts big blind $2
Vikulja1993: sits out 
GB223: sits out 
*** HOLE CARDS ***
Dealt to matiko09 [Th As]
maximax04: raises $2 to $4
Kukuryzka: folds 
matiko09: calls $4
di0d80: folds 
erfk1958: folds 
*** FLOP *** [9h Kc Qc]
maximax04: bets $6
matiko09: folds 
Uncalled bet ($6) returned to maximax04
maximax04 collected $10.45 from pot
maximax04: doesn't show hand 
*** SUMMARY ***
Total pot $11 | Rake $0.55 
Board [9h Kc Qc]
Seat 2: Kukuryzka folded before Flop (didn't bet)
Seat 3: matiko09 (button) folded on the Flop
Seat 4: di0d80 (small blind) folded before Flop
Seat 7: erfk1958 (big blind) folded before Flop
Seat 9: maximax04 collected ($10.45)





PokerStars Hand #151943452084:  Hold'em No Limit ($1/$2 USD) - 2016/04/15 13:55:58 CET [2016/04/15 7:55:58 ET]
Table 'Oceax' 9-max Seat #4 is the button
Seat 1: matiko09 ($200 in chips) 
Seat 2: Fish4trips ($324.38 in chips) 
Seat 3: Glushchenko ($200 in chips) 
Seat 4: butcheN18 ($257.46 in chips) 
Seat 6: Iggso ($256.80 in chips) 
Seat 7: ssljvr ($203 in chips) 
Seat 8: Poroxide ($321.92 in chips) 
Seat 9: erfk1958 ($122.35 in chips) 
derrocco82 will be allowed to play after the button
Iggso: posts small blind $1
ssljvr: posts big blind $2
*** HOLE CARDS ***
Dealt to matiko09 [Js 4d]
Poroxide: folds 
erfk1958: folds 
matiko09: folds 
Fish4trips: raises $3 to $5
Glushchenko: folds 
butcheN18: folds 
Iggso: folds 
ssljvr: folds 
Uncalled bet ($3) returned to Fish4trips
Fish4trips collected $5 from pot
Fish4trips: doesn't show hand 
*** SUMMARY ***
Total pot $5 | Rake $0 
Seat 1: matiko09 folded before Flop (didn't bet)
Seat 2: Fish4trips collected ($5)
Seat 3: Glushchenko folded before Flop (didn't bet)
Seat 4: butcheN18 (button) folded before Flop (didn't bet)
Seat 6: Iggso (small blind) folded before Flop
Seat 7: ssljvr (big blind) folded before Flop
Seat 8: Poroxide folded before Flop (didn't bet)
Seat 9: erfk1958 folded before Flop (didn't bet)





PokerStars Hand #151943455541:  Hold'em No Limit ($0.50/$1.00 USD) - 2016/04/15 13:56:06 CET [2016/04/15 7:56:06 ET]
Table 'Adelgunde III' 9-max Seat #3 is the button
Seat 1: valimiu ($34.25 in chips) 
Seat 2: djammusic ($47.50 in chips) 
Seat 3: tipner ($126.20 in chips) 
Seat 4: hammerwife ($110.78 in chips) 
Seat 5: matiko09 ($129.50 in chips) 
Seat 6: Pominator92 ($157.48 in chips) 
Seat 8: aseban11 ($100.48 in chips) 
Seat 9: Kukuryzka ($107.43 in chips) 
hammerwife: posts small blind $0.50
matiko09: posts big blind $1
Yaaaazz: sits out 
*** HOLE CARDS ***
Dealt to matiko09 [2d Td]
Pominator92: raises $2 to $3
aseban11: folds 
Kukuryzka: folds 
valimiu: calls $3
djammusic: folds 
tipner: folds 
hammerwife: folds 
matiko09: folds 
*** FLOP *** [Ah 2c 5d]
Pominator92: bets $4
valimiu: folds 
Uncalled bet ($4) returned to Pominator92
Pominator92 collected $7.12 from pot
Pominator92: doesn't show hand 
*** SUMMARY ***
Total pot $7.50 | Rake $0.38 
Board [Ah 2c 5d]
Seat 1: valimiu folded on the Flop
Seat 2: djammusic folded before Flop (didn't bet)
Seat 3: tipner (button) folded before Flop (didn't bet)
Seat 4: hammerwife (small blind) folded before Flop
Seat 5: matiko09 (big blind) folded before Flop
Seat 6: Pominator92 collected ($7.12)
Seat 8: aseban11 folded before Flop (didn't bet)
Seat 9: Kukuryzka folded before Flop (didn't bet)





PokerStars Hand #151943456151:  Hold'em No Limit ($1/$2 USD) - 2016/04/15 13:56:07 CET [2016/04/15 7:56:07 ET]
Table 'Blaauw' 9-max Seat #9 is the button
Seat 1: myatiy 96 ($200 in chips) 
Seat 2: butcheN18 ($259.60 in chips) 
Seat 3: Glushchenko ($273.80 in chips) 
Seat 4: petro0107 ($232.89 in chips) 
Seat 5: tipner ($200 in chips) 
Seat 6: matiko09 ($229 in chips) 
Seat 7: ssljvr ($377.01 in chips) 
Seat 8: Iggso ($205.50 in chips) 
Seat 9: coinflip_si ($209.88 in chips) 
myatiy 96: posts small blind $1
butcheN18: posts big blind $2
*** HOLE CARDS ***
Dealt to matiko09 [7h 3h]
Glushchenko: folds 
petro0107: folds 
tipner: folds 
matiko09: folds 
ssljvr: folds 
Iggso: raises $2 to $4
coinflip_si: folds 
myatiy 96: folds 
butcheN18: folds 
Uncalled bet ($2) returned to Iggso
Iggso collected $5 from pot
Iggso: doesn't show hand 
*** SUMMARY ***
Total pot $5 | Rake $0 
Seat 1: myatiy 96 (small blind) folded before Flop
Seat 2: butcheN18 (big blind) folded before Flop
Seat 3: Glushchenko folded before Flop (didn't bet)
Seat 4: petro0107 folded before Flop (didn't bet)
Seat 5: tipner folded before Flop (didn't bet)
Seat 6: matiko09 folded before Flop (didn't bet)
Seat 7: ssljvr folded before Flop (didn't bet)
Seat 8: Iggso collected ($5)
Seat 9: coinflip_si (button) folded before Flop (didn't bet)





PokerStars Hand #151943460482:  Hold'em No Limit ($1/$2 USD) - 2016/04/15 13:56:18 CET [2016/04/15 7:56:18 ET]
Table 'Irmgard II' 9-max Seat #4 is the button
Seat 2: Kukuryzka ($236.36 in chips) 
Seat 3: matiko09 ($287.17 in chips) 
Seat 4: di0d80 ($200 in chips) 
Seat 7: erfk1958 ($92.10 in chips) 
Seat 8: Vikulja1993 ($200 in chips) 
Seat 9: maximax04 ($102.91 in chips) 
erfk1958: posts small blind $1
Vikulja1993: posts big blind $2
GB223: sits out 
*** HOLE CARDS ***
Dealt to matiko09 [4h Td]
maximax04: calls $2
Kukuryzka: folds 
matiko09: folds 
di0d80: raises $6 to $8
erfk1958: folds 
Vikulja1993: folds 
djammusic leaves the table
maximax04: calls $6
*** FLOP *** [Ts Jh 6c]
maximax04: checks 
butcheN18 joins the table at seat #6 
di0d80: bets $12
maximax04: calls $12
*** TURN *** [Ts Jh 6c] [3d]
maximax04: checks 
di0d80: bets $22
maximax04: calls $22
*** RIVER *** [Ts Jh 6c 3d] [3s]
maximax04: bets $12
di0d80: calls $12
*** SHOW DOWN ***
maximax04: shows [7h Tc] (two pair, Tens and Threes)
di0d80: shows [Qs Js] (two pair, Jacks and Threes)
di0d80 collected $108.25 from pot
*** SUMMARY ***
Total pot $111 | Rake $2.75 
Board [Ts Jh 6c 3d 3s]
Seat 2: Kukuryzka folded before Flop (didn't bet)
Seat 3: matiko09 folded before Flop (didn't bet)
Seat 4: di0d80 (button) showed [Qs Js] and won ($108.25) with two pair, Jacks and Threes
Seat 7: erfk1958 (small blind) folded before Flop
Seat 8: Vikulja1993 (big blind) folded before Flop
Seat 9: maximax04 showed [7h Tc] and lost with two pair, Tens and Threes





PokerStars Hand #151943461108:  Hold'em No Limit ($1/$2 USD) - 2016/04/15 13:56:19 CET [2016/04/15 7:56:19 ET]
Table 'Oceax' 9-max Seat #6 is the button
Seat 1: matiko09 ($200 in chips) 
Seat 2: Fish4trips ($327.38 in chips) 
Seat 3: Glushchenko ($200 in chips) 
Seat 4: butcheN18 ($257.46 in chips) 
Seat 6: Iggso ($255.80 in chips) 
Seat 7: ssljvr ($201 in chips) 
Seat 8: Poroxide ($321.92 in chips) 
Seat 9: erfk1958 ($122.35 in chips) 
ssljvr: posts small blind $1
Poroxide: posts big blind $2
derrocco82: sits out 
*** HOLE CARDS ***
Dealt to matiko09 [Ad 9d]
erfk1958: folds 
matiko09: folds 
Fish4trips: folds 
Glushchenko: folds 
butcheN18: folds 
Iggso: raises $4 to $6
ssljvr: folds 
Poroxide: folds 
Uncalled bet ($4) returned to Iggso
Iggso collected $5 from pot
Iggso: doesn't show hand 
*** SUMMARY ***
Total pot $5 | Rake $0 
Seat 1: matiko09 folded before Flop (didn't bet)
Seat 2: Fish4trips folded before Flop (didn't bet)
Seat 3: Glushchenko folded before Flop (didn't bet)
Seat 4: butcheN18 folded before Flop (didn't bet)
Seat 6: Iggso (button) collected ($5)
Seat 7: ssljvr (small blind) folded before Flop
Seat 8: Poroxide (big blind) folded before Flop
Seat 9: erfk1958 folded before Flop (didn't bet)





PokerStars Hand #151943463302:  Hold'em No Limit ($0.50/$1.00 USD) - 2016/04/15 13:56:24 CET [2016/04/15 7:56:24 ET]
Table 'Navi' 9-max Seat #3 is the button
Seat 1: tipner ($111.83 in chips) 
Seat 2: butcheN18 ($100 in chips) 
Seat 3: Filojoes ($101.70 in chips) 
Seat 4: Pvsx. ($100 in chips) 
Seat 5: hammerwife ($105.82 in chips) 
Seat 6: Glushchenko ($241.58 in chips) 
Seat 8: djammusic ($45.12 in chips) 
Seat 9: matiko09 ($131.63 in chips) 
Pvsx.: posts small blind $0.50
hammerwife: posts big blind $1
*** HOLE CARDS ***
Dealt to matiko09 [9d Th]
Glushchenko: folds 
djammusic: folds 
matiko09: folds 
tipner: folds 
butcheN18: folds 
Filojoes: folds 
Pvsx.: folds 
Uncalled bet ($0.50) returned to hammerwife
hammerwife collected $1 from pot
hammerwife: doesn't show hand 
*** SUMMARY ***
Total pot $1 | Rake $0 
Seat 1: tipner folded before Flop (didn't bet)
Seat 2: butcheN18 folded before Flop (didn't bet)
Seat 3: Filojoes (button) folded before Flop (didn't bet)
Seat 4: Pvsx. (small blind) folded before Flop
Seat 5: hammerwife (big blind) collected ($1)
Seat 6: Glushchenko folded before Flop (didn't bet)
Seat 8: djammusic folded before Flop (didn't bet)
Seat 9: matiko09 folded before Flop (didn't bet)





PokerStars Hand #151943465508:  Hold'em No Limit ($0.50/$1.00 USD) - 2016/04/15 13:56:29 CET [2016/04/15 7:56:29 ET]
Table 'Chiny II' 9-max Seat #5 is the button
Seat 1: aseban11 ($100 in chips) 
Seat 2: Westpants ($126.81 in chips) 
Seat 3: Foton18 ($61.22 in chips) 
Seat 4: matiko09 ($175.90 in chips) 
Seat 5: omorfadramou ($166.50 in chips) 
Seat 6: choupai ($16.53 in chips) 
Seat 7: ruslik_by ($100 in chips) 
Seat 8: Filojoes ($146.74 in chips) 
Seat 9: butcheN18 ($101.50 in chips) 
choupai: posts small blind $0.50
ruslik_by: posts big blind $1
*** HOLE CARDS ***
Dealt to matiko09 [Js 7s]
Filojoes: raises $2 to $3
butcheN18: folds 
aseban11: folds 
Westpants: folds 
Foton18: folds 
matiko09: folds 
omorfadramou: folds 
choupai: folds 
ruslik_by: folds 
Uncalled bet ($2) returned to Filojoes
Filojoes collected $2.50 from pot
Filojoes: doesn't show hand 
*** SUMMARY ***
Total pot $2.50 | Rake $0 
Seat 1: aseban11 folded before Flop (didn't bet)
Seat 2: Westpants folded before Flop (didn't bet)
Seat 3: Foton18 folded before Flop (didn't bet)
Seat 4: matiko09 folded before Flop (didn't bet)
Seat 5: omorfadramou (button) folded before Flop (didn't bet)
Seat 6: choupai (small blind) folded before Flop
Seat 7: ruslik_by (big blind) folded before Flop
Seat 8: Filojoes collected ($2.50)
Seat 9: butcheN18 folded before Flop (didn't bet)





PokerStars Hand #151943468576:  Hold'em No Limit ($0.50/$1.00 USD) - 2016/04/15 13:56:36 CET [2016/04/15 7:56:36 ET]
Table 'Adelgunde III' 9-max Seat #4 is the button
Seat 1: valimiu ($31.25 in chips) 
Seat 2: djammusic ($47.50 in chips) 
Seat 3: tipner ($126.20 in chips) 
Seat 4: hammerwife ($110.28 in chips) 
Seat 5: matiko09 ($128.50 in chips) 
Seat 6: Pominator92 ($161.60 in chips) 
Seat 8: aseban11 ($100.48 in chips) 
Seat 9: Kukuryzka ($107.43 in chips) 
matiko09: posts small blind $0.50
Pominator92: posts big blind $1
Yaaaazz: sits out 
*** HOLE CARDS ***
Dealt to matiko09 [9c Qs]
aseban11: folds 
Kukuryzka: folds 
valimiu: calls $1
djammusic: folds 
tipner: folds 
hammerwife: folds 
matiko09: calls $0.50
Pominator92: checks 
*** FLOP *** [4c Tc Kh]
matiko09: checks 
Pominator92: bets $2
valimiu: calls $2
matiko09: folds 
*** TURN *** [4c Tc Kh] [5s]
Pominator92: checks 
valimiu: bets $8
Pominator92: folds 
Uncalled bet ($8) returned to valimiu
valimiu collected $6.65 from pot
valimiu: doesn't show hand 
*** SUMMARY ***
Total pot $7 | Rake $0.35 
Board [4c Tc Kh 5s]
Seat 1: valimiu collected ($6.65)
Seat 2: djammusic folded before Flop (didn't bet)
Seat 3: tipner folded before Flop (didn't bet)
Seat 4: hammerwife (button) folded before Flop (didn't bet)
Seat 5: matiko09 (small blind) folded on the Flop
Seat 6: Pominator92 (big blind) folded on the Turn
Seat 8: aseban11 folded before Flop (didn't bet)
Seat 9: Kukuryzka folded before Flop (didn't bet)





PokerStars Hand #151943468434:  Hold'em No Limit ($1/$2 USD) - 2016/04/15 13:56:36 CET [2016/04/15 7:56:36 ET]
Table 'Adele II' 9-max Seat #6 is the button
Seat 1: RyanHuJun ($325.66 in chips) 
Seat 2: Fish4trips ($331.54 in chips) 
Seat 3: matiko09 ($313.88 in chips) 
Seat 4: Glushchenko ($200 in chips) 
Seat 5: TonnaMunz ($204.25 in chips) 
Seat 6: Kukuryzka ($227.25 in chips) 
Seat 7: Iggso ($208.84 in chips) 
Seat 8: butcheN18 ($200 in chips) 
Seat 9: SanychStar ($293.77 in chips) 
Iggso: posts small blind $1
butcheN18: posts big blind $2
*** HOLE CARDS ***
Dealt to matiko09 [Kd 2d]
SanychStar: folds 
RyanHuJun: folds 
Fish4trips: raises $3 to $5
matiko09: folds 
Glushchenko: folds 
TonnaMunz: folds 
Kukuryzka: folds 
Iggso: folds 
butcheN18: folds 
Uncalled bet ($3) returned to Fish4trips
Fish4trips collected $5 from pot
Fish4trips: doesn't show hand 
*** SUMMARY ***
Total pot $5 | Rake $0 
Seat 1: RyanHuJun folded before Flop (didn't bet)
Seat 2: Fish4trips collected ($5)
Seat 3: matiko09 folded before Flop (didn't bet)
Seat 4: Glushchenko folded before Flop (didn't bet)
Seat 5: TonnaMunz folded before Flop (didn't bet)
Seat 6: Kukuryzka (button) folded before Flop (didn't bet)
Seat 7: Iggso (small blind) folded before Flop
Seat 8: butcheN18 (big blind) folded before Flop
Seat 9: SanychStar folded before Flop (didn't bet)





PokerStars Hand #151943468848:  Hold'em No Limit ($0.50/$1.00 USD) - 2016/04/15 13:56:37 CET [2016/04/15 7:56:37 ET]
Table 'Parvulesco II' 9-max Seat #4 is the button
Seat 1: bilukm ($112.10 in chips) 
Seat 2: Filojoes ($108.56 in chips) 
Seat 3: matiko09 ($114.95 in chips) 
Seat 4: butcheN18 ($100 in chips) 
Seat 5: maxxmeister ($100 in chips) 
Seat 6: ruslik_by ($106 in chips) 
Seat 7: Kukuryzka ($117.58 in chips) 
Seat 8: Jimy Tiltman ($112.20 in chips) 
Seat 9: hammerwife ($191.97 in chips) 
maxxmeister: posts small blind $0.50
ruslik_by: posts big blind $1
*** HOLE CARDS ***
Dealt to matiko09 [Qd 5s]
Kukuryzka: raises $2 to $3
Jimy Tiltman: folds 
hammerwife: folds 
bilukm: calls $3
Filojoes: calls $3
matiko09: folds 
butcheN18: folds 
maxxmeister: folds 
ruslik_by: folds 
*** FLOP *** [6d 7s 5d]
Kukuryzka: bets $7.50
bilukm: calls $7.50
Filojoes: folds 
*** TURN *** [6d 7s 5d] [8h]
Kukuryzka: checks 
bilukm: checks 
*** RIVER *** [6d 7s 5d 8h] [Ah]
Kukuryzka: checks 
bilukm: checks 
*** SHOW DOWN ***
Kukuryzka: shows [8d 8s] (three of a kind, Eights)
bilukm: mucks hand 
Kukuryzka collected $24.22 from pot
*** SUMMARY ***
Total pot $25.50 | Rake $1.28 
Board [6d 7s 5d 8h Ah]
Seat 1: bilukm mucked [Ac 3s]
Seat 2: Filojoes folded on the Flop
Seat 3: matiko09 folded before Flop (didn't bet)
Seat 4: butcheN18 (button) folded before Flop (didn't bet)
Seat 5: maxxmeister (small blind) folded before Flop
Seat 6: ruslik_by (big blind) folded before Flop
Seat 7: Kukuryzka showed [8d 8s] and won ($24.22) with three of a kind, Eights
Seat 8: Jimy Tiltman folded before Flop (didn't bet)
Seat 9: hammerwife folded before Flop (didn't bet)





PokerStars Hand #151943471616:  Hold'em No Limit ($0.50/$1.00 USD) - 2016/04/15 13:56:43 CET [2016/04/15 7:56:43 ET]
Table 'Emma II' 9-max Seat #1 is the button
Seat 1: omorfadramou ($100 in chips) 
Seat 2: Filojoes ($100 in chips) 
Seat 3: Glushchenko ($226.16 in chips) 
Seat 4: matiko09 ($100 in chips) 
Seat 6: Tirka ($123.84 in chips) 
Seat 8: butcheN18 ($172.32 in chips) 
Seat 9: Foton18 ($119.06 in chips) 
Filojoes: posts small blind $0.50
Glushchenko: posts big blind $1
ruslik_by: sits out 
*** HOLE CARDS ***
Dealt to matiko09 [Kd Qd]
matiko09: raises $2 to $3
Tirka: folds 
butcheN18: folds 
Foton18: raises $7.50 to $10.50
omorfadramou: folds 
Filojoes: folds 
Glushchenko: folds 
matiko09: calls $7.50
*** FLOP *** [Ts 5s Qs]
matiko09: checks 
Foton18: bets $11
matiko09: calls $11
*** TURN *** [Ts 5s Qs] [9d]
matiko09: checks 
Foton18: checks 
*** RIVER *** [Ts 5s Qs 9d] [Td]
matiko09: checks 
Foton18: checks 
*** SHOW DOWN ***
matiko09: shows [Kd Qd] (two pair, Queens and Tens)
Foton18: shows [Ks Kc] (two pair, Kings and Tens)
Foton18 collected $42.28 from pot
*** SUMMARY ***
Total pot $44.50 | Rake $2.22 
Board [Ts 5s Qs 9d Td]
Seat 1: omorfadramou (button) folded before Flop (didn't bet)
Seat 2: Filojoes (small blind) folded before Flop
Seat 3: Glushchenko (big blind) folded before Flop
Seat 4: matiko09 showed [Kd Qd] and lost with two pair, Queens and Tens
Seat 6: Tirka folded before Flop (didn't bet)
Seat 8: butcheN18 folded before Flop (didn't bet)
Seat 9: Foton18 showed [Ks Kc] and won ($42.28) with two pair, Kings and Tens





PokerStars Hand #151943472025:  Hold'em No Limit ($1/$2 USD) - 2016/04/15 13:56:44 CET [2016/04/15 7:56:44 ET]
Table 'Blaauw' 9-max Seat #1 is the button
Seat 1: myatiy 96 ($200 in chips) 
Seat 2: butcheN18 ($257.60 in chips) 
Seat 3: Glushchenko ($273.80 in chips) 
Seat 4: petro0107 ($232.89 in chips) 
Seat 5: tipner ($200 in chips) 
Seat 6: matiko09 ($229 in chips) 
Seat 7: ssljvr ($377.01 in chips) 
Seat 8: Iggso ($208.50 in chips) 
Seat 9: coinflip_si ($209.88 in chips) 
butcheN18: posts small blind $1
Glushchenko: posts big blind $2
*** HOLE CARDS ***
Dealt to matiko09 [Tc Ac]
petro0107: folds 
tipner: folds 
matiko09: raises $3 to $5
ssljvr: folds 
Iggso: folds 
coinflip_si: folds 
myatiy 96: folds 
butcheN18: folds 
Glushchenko: folds 
Uncalled bet ($3) returned to matiko09
matiko09 collected $5 from pot
matiko09: doesn't show hand 
*** SUMMARY ***
Total pot $5 | Rake $0 
Seat 1: myatiy 96 (button) folded before Flop (didn't bet)
Seat 2: butcheN18 (small blind) folded before Flop
Seat 3: Glushchenko (big blind) folded before Flop
Seat 4: petro0107 folded before Flop (didn't bet)
Seat 5: tipner folded before Flop (didn't bet)
Seat 6: matiko09 collected ($5)
Seat 7: ssljvr folded before Flop (didn't bet)
Seat 8: Iggso folded before Flop (didn't bet)
Seat 9: coinflip_si folded before Flop (didn't bet)





PokerStars Hand #151943475450:  Hold'em No Limit ($1/$2 USD) - 2016/04/15 13:56:51 CET [2016/04/15 7:56:51 ET]
Table 'Oceax' 9-max Seat #7 is the button
Seat 1: matiko09 ($200 in chips) 
Seat 2: Fish4trips ($327.38 in chips) 
Seat 3: Glushchenko ($200 in chips) 
Seat 4: butcheN18 ($257.46 in chips) 
Seat 6: Iggso ($258.80 in chips) 
Seat 7: ssljvr ($200 in chips) 
Seat 8: Poroxide ($319.92 in chips) 
Seat 9: erfk1958 ($122.35 in chips) 
Poroxide: posts small blind $1
erfk1958: posts big blind $2
derrocco82: sits out 
*** HOLE CARDS ***
Dealt to matiko09 [8h 9d]
matiko09: folds 
Fish4trips: raises $3 to $5
Glushchenko: folds 
butcheN18: folds 
Iggso: folds 
ssljvr: folds 
Poroxide: folds 
erfk1958: folds 
Uncalled bet ($3) returned to Fish4trips
Fish4trips collected $5 from pot
Fish4trips: doesn't show hand 
*** SUMMARY ***
Total pot $5 | Rake $0 
Seat 1: matiko09 folded before Flop (didn't bet)
Seat 2: Fish4trips collected ($5)
Seat 3: Glushchenko folded before Flop (didn't bet)
Seat 4: butcheN18 folded before Flop (didn't bet)
Seat 6: Iggso folded before Flop (didn't bet)
Seat 7: ssljvr (button) folded before Flop (didn't bet)
Seat 8: Poroxide (small blind) folded before Flop
Seat 9: erfk1958 (big blind) folded before Flop





PokerStars Hand #151943478657:  Hold'em No Limit ($0.50/$1.00 USD) - 2016/04/15 13:56:59 CET [2016/04/15 7:56:59 ET]
Table 'Navi' 9-max Seat #4 is the button
Seat 1: tipner ($111.83 in chips) 
Seat 2: butcheN18 ($100 in chips) 
Seat 3: Filojoes ($101.70 in chips) 
Seat 4: Pvsx. ($100 in chips) 
Seat 5: hammerwife ($106.32 in chips) 
Seat 6: Glushchenko ($241.58 in chips) 
Seat 8: djammusic ($45.12 in chips) 
Seat 9: matiko09 ($131.63 in chips) 
hammerwife: posts small blind $0.50
Glushchenko: posts big blind $1
*** HOLE CARDS ***
Dealt to matiko09 [5s Ad]
djammusic: folds 
matiko09: folds 
tipner: folds 
butcheN18: folds 
Filojoes: folds 
Pvsx.: raises $1.50 to $2.50
hammerwife: folds 
Glushchenko: folds 
Uncalled bet ($1.50) returned to Pvsx.
Pvsx. collected $2.50 from pot
Pvsx.: doesn't show hand 
*** SUMMARY ***
Total pot $2.50 | Rake $0 
Seat 1: tipner folded before Flop (didn't bet)
Seat 2: butcheN18 folded before Flop (didn't bet)
Seat 3: Filojoes folded before Flop (didn't bet)
Seat 4: Pvsx. (button) collected ($2.50)
Seat 5: hammerwife (small blind) folded before Flop
Seat 6: Glushchenko (big blind) folded before Flop
Seat 8: djammusic folded before Flop (didn't bet)
Seat 9: matiko09 folded before Flop (didn't bet)





PokerStars Hand #151943482328:  Hold'em No Limit ($1/$2 USD) - 2016/04/15 13:57:07 CET [2016/04/15 7:57:07 ET]
Table 'Blaauw' 9-max Seat #2 is the button
Seat 1: myatiy 96 ($200 in chips) 
Seat 2: butcheN18 ($256.60 in chips) 
Seat 3: Glushchenko ($271.80 in chips) 
Seat 4: petro0107 ($232.89 in chips) 
Seat 5: tipner ($200 in chips) 
Seat 6: matiko09 ($232 in chips) 
Seat 7: ssljvr ($377.01 in chips) 
Seat 8: Iggso ($208.50 in chips) 
Seat 9: coinflip_si ($209.88 in chips) 
Glushchenko: posts small blind $1
petro0107: posts big blind $2
*** HOLE CARDS ***
Dealt to matiko09 [Th 6c]
tipner: folds 
matiko09: folds 
ssljvr: raises $4 to $6
Iggso: folds 
coinflip_si: folds 
myatiy 96: folds 
butcheN18: folds 
Glushchenko: folds 
petro0107: folds 
Uncalled bet ($4) returned to ssljvr
ssljvr collected $5 from pot
ssljvr: doesn't show hand 
*** SUMMARY ***
Total pot $5 | Rake $0 
Seat 1: myatiy 96 folded before Flop (didn't bet)
Seat 2: butcheN18 (button) folded before Flop (didn't bet)
Seat 3: Glushchenko (small blind) folded before Flop
Seat 4: petro0107 (big blind) folded before Flop
Seat 5: tipner folded before Flop (didn't bet)
Seat 6: matiko09 folded before Flop (didn't bet)
Seat 7: ssljvr collected ($5)
Seat 8: Iggso folded before Flop (didn't bet)
Seat 9: coinflip_si folded before Flop (didn't bet)





PokerStars Hand #151943482792:  Hold'em No Limit ($1/$2 USD) - 2016/04/15 13:57:08 CET [2016/04/15 7:57:08 ET]
Table 'Adele II' 9-max Seat #7 is the button
Seat 1: RyanHuJun ($325.66 in chips) 
Seat 2: Fish4trips ($334.54 in chips) 
Seat 3: matiko09 ($313.88 in chips) 
Seat 4: Glushchenko ($200 in chips) 
Seat 5: TonnaMunz ($204.25 in chips) 
Seat 6: Kukuryzka ($227.25 in chips) 
Seat 7: Iggso ($207.84 in chips) 
Seat 8: butcheN18 ($200 in chips) 
Seat 9: SanychStar ($293.77 in chips) 
butcheN18: posts small blind $1
SanychStar: posts big blind $2
*** HOLE CARDS ***
Dealt to matiko09 [Kc As]
RyanHuJun: folds 
Fish4trips: raises $3 to $5
matiko09: calls $5
Glushchenko: folds 
TonnaMunz: folds 
Kukuryzka: folds 
Iggso: calls $5
butcheN18: folds 
SanychStar: calls $3
*** FLOP *** [Qc 9s 2h]
SanychStar: checks 
Fish4trips: checks 
matiko09: checks 
Iggso: checks 
*** TURN *** [Qc 9s 2h] [Tc]
SanychStar: checks 
Fish4trips: checks 
matiko09: checks 
Iggso: checks 
*** RIVER *** [Qc 9s 2h Tc] [2s]
SanychStar: checks 
Fish4trips: checks 
matiko09: checks 
Iggso: bets $11.17
SanychStar: calls $11.17
Fish4trips: folds 
matiko09: folds 
*** SHOW DOWN ***
Iggso: shows [Qd Ac] (two pair, Queens and Deuces)
SanychStar: mucks hand 
Iggso collected $41.17 from pot
*** SUMMARY ***
Total pot $43.34 | Rake $2.17 
Board [Qc 9s 2h Tc 2s]
Seat 1: RyanHuJun folded before Flop (didn't bet)
Seat 2: Fish4trips folded on the River
Seat 3: matiko09 folded on the River
Seat 4: Glushchenko folded before Flop (didn't bet)
Seat 5: TonnaMunz folded before Flop (didn't bet)
Seat 6: Kukuryzka folded before Flop (didn't bet)
Seat 7: Iggso (button) showed [Qd Ac] and won ($41.17) with two pair, Queens and Deuces
Seat 8: butcheN18 (small blind) folded before Flop
Seat 9: SanychStar (big blind) mucked [9h Ah]





PokerStars Hand #151943483756:  Hold'em No Limit ($1/$2 USD) - 2016/04/15 13:57:10 CET [2016/04/15 7:57:10 ET]
Table 'Oceax' 9-max Seat #8 is the button
Seat 1: matiko09 ($200 in chips) 
Seat 2: Fish4trips ($330.38 in chips) 
Seat 3: Glushchenko ($200 in chips) 
Seat 4: butcheN18 ($257.46 in chips) 
Seat 6: Iggso ($258.80 in chips) 
Seat 7: ssljvr ($200 in chips) 
Seat 8: Poroxide ($318.92 in chips) 
Seat 9: erfk1958 ($120.35 in chips) 
erfk1958: posts small blind $1
matiko09: posts big blind $2
derrocco82: sits out 
*** HOLE CARDS ***
Dealt to matiko09 [As 5d]
Fish4trips: folds 
Glushchenko: folds 
butcheN18: folds 
Iggso: folds 
ssljvr: folds 
Poroxide: folds 
erfk1958: folds 
Uncalled bet ($1) returned to matiko09
matiko09 collected $2 from pot
matiko09: doesn't show hand 
*** SUMMARY ***
Total pot $2 | Rake $0 
Seat 1: matiko09 (big blind) collected ($2)
Seat 2: Fish4trips folded before Flop (didn't bet)
Seat 3: Glushchenko folded before Flop (didn't bet)
Seat 4: butcheN18 folded before Flop (didn't bet)
Seat 6: Iggso folded before Flop (didn't bet)
Seat 7: ssljvr folded before Flop (didn't bet)
Seat 8: Poroxide (button) folded before Flop (didn't bet)
Seat 9: erfk1958 (small blind) folded before Flop





PokerStars Hand #151943484061:  Hold'em No Limit ($0.50/$1.00 USD) - 2016/04/15 13:57:11 CET [2016/04/15 7:57:11 ET]
Table 'Chiny II' 9-max Seat #6 is the button
Seat 1: aseban11 ($100 in chips) 
Seat 2: Westpants ($126.81 in chips) 
Seat 3: Foton18 ($61.22 in chips) 
Seat 4: matiko09 ($175.90 in chips) 
Seat 5: omorfadramou ($166.50 in chips) 
Seat 6: choupai ($16.03 in chips) 
Seat 7: ruslik_by ($100 in chips) 
Seat 8: Filojoes ($148.24 in chips) 
Seat 9: butcheN18 ($101.50 in chips) 
ruslik_by: posts small blind $0.50
Filojoes: posts big blind $1
*** HOLE CARDS ***
Dealt to matiko09 [4c 6h]
butcheN18: folds 
aseban11: folds 
Westpants: folds 
Foton18: folds 
matiko09: folds 
omorfadramou: folds 
choupai: folds 
ruslik_by: raises $2 to $3
Filojoes: calls $2
*** FLOP *** [6s Qd 3s]
ruslik_by: bets $3.50
Filojoes: folds 
Uncalled bet ($3.50) returned to ruslik_by
ruslik_by collected $5.70 from pot
ruslik_by: doesn't show hand 
*** SUMMARY ***
Total pot $6 | Rake $0.30 
Board [6s Qd 3s]
Seat 1: aseban11 folded before Flop (didn't bet)
Seat 2: Westpants folded before Flop (didn't bet)
Seat 3: Foton18 folded before Flop (didn't bet)
Seat 4: matiko09 folded before Flop (didn't bet)
Seat 5: omorfadramou folded before Flop (didn't bet)
Seat 6: choupai (button) folded before Flop (didn't bet)
Seat 7: ruslik_by (small blind) collected ($5.70)
Seat 8: Filojoes (big blind) folded on the Flop
Seat 9: butcheN18 folded before Flop (didn't bet)





PokerStars Hand #151943484616:  Hold'em No Limit ($1/$2 USD) - 2016/04/15 13:57:12 CET [2016/04/15 7:57:12 ET]
Table 'Irmgard II' 9-max Seat #7 is the button
Seat 2: Kukuryzka ($236.36 in chips) 
Seat 3: matiko09 ($287.17 in chips) 
Seat 4: di0d80 ($254.25 in chips) 
Seat 7: erfk1958 ($91.10 in chips) 
Seat 8: Vikulja1993 ($200 in chips) 
Seat 9: maximax04 ($48.91 in chips) 
Vikulja1993: posts small blind $1
maximax04: posts big blind $2
GB223: sits out 
butcheN18: sits out 
*** HOLE CARDS ***
Dealt to matiko09 [8h Qs]
Kukuryzka: folds 
matiko09: folds 
di0d80: folds 
erfk1958: folds 
Vikulja1993: folds 
Uncalled bet ($1) returned to maximax04
maximax04 collected $2 from pot
maximax04: doesn't show hand 
*** SUMMARY ***
Total pot $2 | Rake $0 
Seat 2: Kukuryzka folded before Flop (didn't bet)
Seat 3: matiko09 folded before Flop (didn't bet)
Seat 4: di0d80 folded before Flop (didn't bet)
Seat 7: erfk1958 (button) folded before Flop (didn't bet)
Seat 8: Vikulja1993 (small blind) folded before Flop
Seat 9: maximax04 (big blind) collected ($2)





PokerStars Hand #151943490622:  Hold'em No Limit ($1/$2 USD) - 2016/04/15 13:57:26 CET [2016/04/15 7:57:26 ET]
Table 'Oceax' 9-max Seat #9 is the button
Seat 1: matiko09 ($201 in chips) 
Seat 2: Fish4trips ($330.38 in chips) 
Seat 3: Glushchenko ($200 in chips) 
Seat 4: butcheN18 ($257.46 in chips) 
Seat 6: Iggso ($258.80 in chips) 
Seat 7: ssljvr ($200 in chips) 
Seat 8: Poroxide ($318.92 in chips) 
Seat 9: erfk1958 ($119.35 in chips) 
matiko09: posts small blind $1
Fish4trips: posts big blind $2
derrocco82: sits out 
*** HOLE CARDS ***
Dealt to matiko09 [Jh 7h]
Glushchenko: raises $4 to $6
butcheN18: folds 
Iggso: folds 
ssljvr: folds 
Poroxide: folds 
erfk1958: folds 
matiko09: folds 
Fish4trips: folds 
Uncalled bet ($4) returned to Glushchenko
Glushchenko collected $5 from pot
*** SUMMARY ***
Total pot $5 | Rake $0 
Seat 1: matiko09 (small blind) folded before Flop
Seat 2: Fish4trips (big blind) folded before Flop
Seat 3: Glushchenko collected ($5)
Seat 4: butcheN18 folded before Flop (didn't bet)
Seat 6: Iggso folded before Flop (didn't bet)
Seat 7: ssljvr folded before Flop (didn't bet)
Seat 8: Poroxide folded before Flop (didn't bet)
Seat 9: erfk1958 (button) folded before Flop (didn't bet)





PokerStars Hand #151943492249:  Hold'em No Limit ($1/$2 USD) - 2016/04/15 13:57:30 CET [2016/04/15 7:57:30 ET]
Table 'Blaauw' 9-max Seat #3 is the button
Seat 1: myatiy 96 ($200 in chips) 
Seat 2: butcheN18 ($256.60 in chips) 
Seat 3: Glushchenko ($270.80 in chips) 
Seat 4: petro0107 ($230.89 in chips) 
Seat 5: tipner ($200 in chips) 
Seat 6: matiko09 ($232 in chips) 
Seat 7: ssljvr ($380.01 in chips) 
Seat 8: Iggso ($208.50 in chips) 
Seat 9: coinflip_si ($209.88 in chips) 
petro0107: posts small blind $1
tipner: posts big blind $2
*** HOLE CARDS ***
Dealt to matiko09 [5c Ac]
matiko09: folds 
ssljvr: folds 
Iggso: folds 
coinflip_si: folds 
myatiy 96: folds 
butcheN18: folds 
Glushchenko: folds 
petro0107: calls $1
tipner: raises $6 to $8
petro0107: calls $6
*** FLOP *** [7c Ah 6d]
petro0107: checks 
tipner: bets $8
petro0107: calls $8
*** TURN *** [7c Ah 6d] [2d]
petro0107: checks 
tipner: bets $16
petro0107: folds 
Uncalled bet ($16) returned to tipner
tipner collected $30.40 from pot
tipner: doesn't show hand 
*** SUMMARY ***
Total pot $32 | Rake $1.60 
Board [7c Ah 6d 2d]
Seat 1: myatiy 96 folded before Flop (didn't bet)
Seat 2: butcheN18 folded before Flop (didn't bet)
Seat 3: Glushchenko (button) folded before Flop (didn't bet)
Seat 4: petro0107 (small blind) folded on the Turn
Seat 5: tipner (big blind) collected ($30.40)
Seat 6: matiko09 folded before Flop (didn't bet)
Seat 7: ssljvr folded before Flop (didn't bet)
Seat 8: Iggso folded before Flop (didn't bet)
Seat 9: coinflip_si folded before Flop (didn't bet)





PokerStars Hand #151943492355:  Hold'em No Limit ($0.50/$1.00 USD) - 2016/04/15 13:57:30 CET [2016/04/15 7:57:30 ET]
Table 'Emma II' 9-max Seat #2 is the button
Seat 1: omorfadramou ($100 in chips) 
Seat 2: Filojoes ($100 in chips) 
Seat 3: Glushchenko ($225.16 in chips) 
Seat 4: matiko09 ($100 in chips) 
Seat 6: Tirka ($123.84 in chips) 
Seat 8: butcheN18 ($172.32 in chips) 
Seat 9: Foton18 ($139.84 in chips) 
Glushchenko: posts small blind $0.50
matiko09: posts big blind $1
ruslik_by: sits out 
*** HOLE CARDS ***
Dealt to matiko09 [7h 2s]
Tirka: raises $2 to $3
butcheN18: folds 
Foton18: folds 
omorfadramou: folds 
Filojoes: folds 
Glushchenko: calls $2.50
matiko09: folds 
*** FLOP *** [Jh 4d Qs]
Glushchenko: checks 
Tirka: bets $3.32
Glushchenko: raises $7.31 to $10.63
Tirka: calls $7.31
*** TURN *** [Jh 4d Qs] [Th]
Glushchenko: checks 
Tirka: bets $19
Glushchenko: calls $19
*** RIVER *** [Jh 4d Qs Th] [Js]
Glushchenko: checks 
Tirka: checks 
*** SHOW DOWN ***
Glushchenko: shows [4h 4s] (a full house, Fours full of Jacks)
Tirka: mucks hand 
Glushchenko collected $63.76 from pot
*** SUMMARY ***
Total pot $66.26 | Rake $2.50 
Board [Jh 4d Qs Th Js]
Seat 1: omorfadramou folded before Flop (didn't bet)
Seat 2: Filojoes (button) folded before Flop (didn't bet)
Seat 3: Glushchenko (small blind) showed [4h 4s] and won ($63.76) with a full house, Fours full of Jacks
Seat 4: matiko09 (big blind) folded before Flop
Seat 6: Tirka mucked [Kc Ac]
Seat 8: butcheN18 folded before Flop (didn't bet)
Seat 9: Foton18 folded before Flop (didn't bet)





PokerStars Hand #151943496523:  Hold'em No Limit ($0.50/$1.00 USD) - 2016/04/15 13:57:39 CET [2016/04/15 7:57:39 ET]
Table 'Adelgunde III' 9-max Seat #5 is the button
Seat 1: valimiu ($34.90 in chips) 
Seat 2: djammusic ($47.50 in chips) 
Seat 3: tipner ($126.20 in chips) 
Seat 4: hammerwife ($110.28 in chips) 
Seat 5: matiko09 ($127.50 in chips) 
Seat 6: Pominator92 ($158.60 in chips) 
Seat 7: Yaaaazz ($100 in chips) 
Seat 8: aseban11 ($100.48 in chips) 
Seat 9: Kukuryzka ($107.43 in chips) 
Pominator92: posts small blind $0.50
Yaaaazz: posts big blind $1
*** HOLE CARDS ***
Dealt to matiko09 [Jd 3c]
aseban11: folds 
aseban11 leaves the table
Kukuryzka: folds 
valimiu: calls $1
djammusic: folds 
tipner: folds 
hammerwife: folds 
matiko09: folds 
Pominator92: calls $0.50
Yaaaazz: checks 
*** FLOP *** [4s Qs Ks]
Pominator92: bets $2
SanychStar joins the table at seat #8 
Yaaaazz: folds 
valimiu: calls $2
*** TURN *** [4s Qs Ks] [Ah]
Pominator92: bets $5
valimiu: folds 
Uncalled bet ($5) returned to Pominator92
Pominator92 collected $6.65 from pot
Pominator92: doesn't show hand 
*** SUMMARY ***
Total pot $7 | Rake $0.35 
Board [4s Qs Ks Ah]
Seat 1: valimiu folded on the Turn
Seat 2: djammusic folded before Flop (didn't bet)
Seat 3: tipner folded before Flop (didn't bet)
Seat 4: hammerwife folded before Flop (didn't bet)
Seat 5: matiko09 (button) folded before Flop (didn't bet)
Seat 6: Pominator92 (small blind) collected ($6.65)
Seat 7: Yaaaazz (big blind) folded on the Flop
Seat 8: aseban11 folded before Flop (didn't bet)
Seat 9: Kukuryzka folded before Flop (didn't bet)





PokerStars Hand #151943496250:  Hold'em No Limit ($1/$2 USD) - 2016/04/15 13:57:39 CET [2016/04/15 7:57:39 ET]
Table 'Irmgard II' 9-max Seat #8 is the button
Seat 1: GB223 ($200 in chips) 
Seat 2: Kukuryzka ($236.36 in chips) 
Seat 3: matiko09 ($287.17 in chips) 
Seat 4: di0d80 ($254.25 in chips) 
Seat 7: erfk1958 ($91.10 in chips) 
Seat 8: Vikulja1993 ($200 in chips) 
Seat 9: maximax04 ($49.91 in chips) 
maximax04: posts small blind $1
GB223: posts big blind $2
butcheN18: sits out 
*** HOLE CARDS ***
Dealt to matiko09 [3h 2s]
Kukuryzka: folds 
matiko09: folds 
di0d80: folds 
erfk1958: folds 
Vikulja1993: raises $2 to $4
maximax04: calls $3
GB223: folds 
*** FLOP *** [6h 8s Qc]
maximax04: checks 
vezunchik79 was removed from the table for failing to post
TideHan joins the table at seat #5 
Vikulja1993: bets $5
maximax04: folds 
Uncalled bet ($5) returned to Vikulja1993
Vikulja1993 collected $9.50 from pot
Vikulja1993: doesn't show hand 
*** SUMMARY ***
Total pot $10 | Rake $0.50 
Board [6h 8s Qc]
Seat 1: GB223 (big blind) folded before Flop
Seat 2: Kukuryzka folded before Flop (didn't bet)
Seat 3: matiko09 folded before Flop (didn't bet)
Seat 4: di0d80 folded before Flop (didn't bet)
Seat 7: erfk1958 folded before Flop (didn't bet)
Seat 8: Vikulja1993 (button) collected ($9.50)
Seat 9: maximax04 (small blind) folded on the Flop





PokerStars Hand #151943497378:  Hold'em No Limit ($1/$2 USD) - 2016/04/15 13:57:41 CET [2016/04/15 7:57:41 ET]
Table 'Oceax' 9-max Seat #1 is the button
Seat 1: matiko09 ($200 in chips) 
Seat 2: Fish4trips ($328.38 in chips) 
Seat 3: Glushchenko ($203 in chips) 
Seat 4: butcheN18 ($257.46 in chips) 
Seat 6: Iggso ($258.80 in chips) 
Seat 7: ssljvr ($200 in chips) 
Seat 8: Poroxide ($318.92 in chips) 
Seat 9: erfk1958 ($119.35 in chips) 
Fish4trips: posts small blind $1
Glushchenko: posts big blind $2
derrocco82: sits out 
*** HOLE CARDS ***
Dealt to matiko09 [7h Jc]
butcheN18: folds 
Iggso: raises $4 to $6
ssljvr: folds 
Poroxide: folds 
erfk1958: folds 
matiko09: folds 
Fish4trips: folds 
Glushchenko: folds 
Uncalled bet ($4) returned to Iggso
Iggso collected $5 from pot
Iggso: doesn't show hand 
*** SUMMARY ***
Total pot $5 | Rake $0 
Seat 1: matiko09 (button) folded before Flop (didn't bet)
Seat 2: Fish4trips (small blind) folded before Flop
Seat 3: Glushchenko (big blind) folded before Flop
Seat 4: butcheN18 folded before Flop (didn't bet)
Seat 6: Iggso collected ($5)
Seat 7: ssljvr folded before Flop (didn't bet)
Seat 8: Poroxide folded before Flop (didn't bet)
Seat 9: erfk1958 folded before Flop (didn't bet)





PokerStars Hand #151943500449:  Hold'em No Limit ($0.50/$1.00 USD) - 2016/04/15 13:57:48 CET [2016/04/15 7:57:48 ET]
Table 'Navi' 9-max Seat #5 is the button
Seat 1: tipner ($111.83 in chips) 
Seat 2: butcheN18 ($100 in chips) 
Seat 3: Filojoes ($101.70 in chips) 
Seat 4: Pvsx. ($101.50 in chips) 
Seat 5: hammerwife ($105.82 in chips) 
Seat 6: Glushchenko ($240.58 in chips) 
Seat 9: matiko09 ($131.63 in chips) 
Glushchenko: posts small blind $0.50
djammusic: is sitting out 
matiko09: posts big blind $1
*** HOLE CARDS ***
Dealt to matiko09 [9d 4c]
djammusic leaves the table
tipner: raises $2 to $3
Kukuryzka joins the table at seat #8 
butcheN18: folds 
Kukuryzka leaves the table
Filojoes: folds 
Pvsx.: folds 
hammerwife: folds 
Glushchenko: folds 
matiko09: folds 
Uncalled bet ($2) returned to tipner
tipner collected $2.50 from pot
tipner: doesn't show hand 
*** SUMMARY ***
Total pot $2.50 | Rake $0 
Seat 1: tipner collected ($2.50)
Seat 2: butcheN18 folded before Flop (didn't bet)
Seat 3: Filojoes folded before Flop (didn't bet)
Seat 4: Pvsx. folded before Flop (didn't bet)
Seat 5: hammerwife (button) folded before Flop (didn't bet)
Seat 6: Glushchenko (small blind) folded before Flop
Seat 9: matiko09 (big blind) folded before Flop





PokerStars Hand #151943504323:  Hold'em No Limit ($0.50/$1.00 USD) - 2016/04/15 13:57:57 CET [2016/04/15 7:57:57 ET]
Table 'Parvulesco II' 9-max Seat #5 is the button
Seat 1: bilukm ($101.60 in chips) 
Seat 2: Filojoes ($105.56 in chips) 
Seat 3: matiko09 ($114.95 in chips) 
Seat 4: butcheN18 ($100 in chips) 
Seat 5: maxxmeister ($100 in chips) 
Seat 6: ruslik_by ($105 in chips) 
Seat 7: Kukuryzka ($131.30 in chips) 
Seat 8: Jimy Tiltman ($112.20 in chips) 
Seat 9: hammerwife ($191.97 in chips) 
ruslik_by: posts small blind $0.50
Kukuryzka: posts big blind $1
*** HOLE CARDS ***
Dealt to matiko09 [4d Ah]
Jimy Tiltman: folds 
hammerwife: folds 
bilukm: folds 
Filojoes: folds 
matiko09: folds 
butcheN18: folds 
maxxmeister: raises $2 to $3
ruslik_by: folds 
Kukuryzka: folds 
Uncalled bet ($2) returned to maxxmeister
maxxmeister collected $2.50 from pot
maxxmeister: doesn't show hand 
*** SUMMARY ***
Total pot $2.50 | Rake $0 
Seat 1: bilukm folded before Flop (didn't bet)
Seat 2: Filojoes folded before Flop (didn't bet)
Seat 3: matiko09 folded before Flop (didn't bet)
Seat 4: butcheN18 folded before Flop (didn't bet)
Seat 5: maxxmeister (button) collected ($2.50)
Seat 6: ruslik_by (small blind) folded before Flop
Seat 7: Kukuryzka (big blind) folded before Flop
Seat 8: Jimy Tiltman folded before Flop (didn't bet)
Seat 9: hammerwife folded before Flop (didn't bet)





PokerStars Hand #151943514938:  Hold'em No Limit ($1/$2 USD) - 2016/04/15 13:58:21 CET [2016/04/15 7:58:21 ET]
Table 'Oceax' 9-max Seat #2 is the button
Seat 1: matiko09 ($200 in chips) 
Seat 2: Fish4trips ($327.38 in chips) 
Seat 3: Glushchenko ($201 in chips) 
Seat 4: butcheN18 ($257.46 in chips) 
Seat 6: Iggso ($261.80 in chips) 
Seat 7: ssljvr ($200 in chips) 
Seat 8: Poroxide ($318.92 in chips) 
Seat 9: erfk1958 ($119.35 in chips) 
Glushchenko: posts small blind $1
butcheN18: posts big blind $2
derrocco82: sits out 
*** HOLE CARDS ***
Dealt to matiko09 [As 9s]
Iggso: folds 
ssljvr: folds 
Poroxide: folds 
erfk1958: folds 
matiko09: raises $3 to $5
Fish4trips: raises $10 to $15
Glushchenko: folds 
butcheN18: folds 
matiko09: folds 
Uncalled bet ($10) returned to Fish4trips
Fish4trips collected $13 from pot
Fish4trips: doesn't show hand 
*** SUMMARY ***
Total pot $13 | Rake $0 
Seat 1: matiko09 folded before Flop
Seat 2: Fish4trips (button) collected ($13)
Seat 3: Glushchenko (small blind) folded before Flop
Seat 4: butcheN18 (big blind) folded before Flop
Seat 6: Iggso folded before Flop (didn't bet)
Seat 7: ssljvr folded before Flop (didn't bet)
Seat 8: Poroxide folded before Flop (didn't bet)
Seat 9: erfk1958 folded before Flop (didn't bet)





PokerStars Hand #151943515670:  Hold'em No Limit ($0.50/$1.00 USD) - 2016/04/15 13:58:22 CET [2016/04/15 7:58:22 ET]
Table 'Chiny II' 9-max Seat #7 is the button
Seat 1: aseban11 ($100 in chips) 
Seat 2: Westpants ($126.81 in chips) 
Seat 3: Foton18 ($61.22 in chips) 
Seat 4: matiko09 ($175.90 in chips) 
Seat 5: omorfadramou ($166.50 in chips) 
Seat 6: choupai ($16.03 in chips) 
Seat 7: ruslik_by ($102.70 in chips) 
Seat 8: Filojoes ($145.24 in chips) 
Seat 9: butcheN18 ($101.50 in chips) 
Filojoes: posts small blind $0.50
butcheN18: posts big blind $1
*** HOLE CARDS ***
Dealt to matiko09 [Kc 9c]
aseban11: folds 
Westpants: folds 
Foton18: folds 
aseban11 leaves the table
myatiy 96 joins the table at seat #1 
myatiy 96 leaves the table
Vikulja1993 joins the table at seat #1 
Vikulja1993 leaves the table
vrnMike joins the table at seat #1 
matiko09 has timed out
matiko09: folds 
omorfadramou: raises $2 to $3
choupai: folds 
ruslik_by: folds 
Filojoes: folds 
butcheN18: folds 
Uncalled bet ($2) returned to omorfadramou
omorfadramou collected $2.50 from pot
omorfadramou: doesn't show hand 
*** SUMMARY ***
Total pot $2.50 | Rake $0 
Seat 1: aseban11 folded before Flop (didn't bet)
Seat 2: Westpants folded before Flop (didn't bet)
Seat 3: Foton18 folded before Flop (didn't bet)
Seat 4: matiko09 folded before Flop (didn't bet)
Seat 5: omorfadramou collected ($2.50)
Seat 6: choupai folded before Flop (didn't bet)
Seat 7: ruslik_by (button) folded before Flop (didn't bet)
Seat 8: Filojoes (small blind) folded before Flop
Seat 9: butcheN18 (big blind) folded before Flop





PokerStars Hand #151943519279:  Hold'em No Limit ($1/$2 USD) - 2016/04/15 13:58:30 CET [2016/04/15 7:58:30 ET]
Table 'Irmgard II' 9-max Seat #9 is the button
Seat 1: GB223 ($200 in chips) 
Seat 2: Kukuryzka ($236.36 in chips) 
Seat 3: matiko09 ($287.17 in chips) 
Seat 4: di0d80 ($254.25 in chips) 
Seat 7: erfk1958 ($91.10 in chips) 
Seat 8: Vikulja1993 ($205.50 in chips) 
Seat 9: maximax04 ($45.91 in chips) 
GB223: posts small blind $1
Kukuryzka: posts big blind $2
TideHan: sits out 
butcheN18: sits out 
*** HOLE CARDS ***
Dealt to matiko09 [6s 4h]
matiko09: folds 
di0d80: folds 
erfk1958: folds 
Vikulja1993: folds 
maximax04: raises $6 to $8
GB223: folds 
Kukuryzka: folds 
Uncalled bet ($6) returned to maximax04
maximax04 collected $5 from pot
maximax04: doesn't show hand 
*** SUMMARY ***
Total pot $5 | Rake $0 
Seat 1: GB223 (small blind) folded before Flop
Seat 2: Kukuryzka (big blind) folded before Flop
Seat 3: matiko09 folded before Flop (didn't bet)
Seat 4: di0d80 folded before Flop (didn't bet)
Seat 7: erfk1958 folded before Flop (didn't bet)
Seat 8: Vikulja1993 folded before Flop (didn't bet)
Seat 9: maximax04 (button) collected ($5)





PokerStars Hand #151943519441:  Hold'em No Limit ($1/$2 USD) - 2016/04/15 13:58:31 CET [2016/04/15 7:58:31 ET]
Table 'Blaauw' 9-max Seat #4 is the button
Seat 1: myatiy 96 ($200 in chips) 
Seat 2: butcheN18 ($256.60 in chips) 
Seat 3: Glushchenko ($270.80 in chips) 
Seat 4: petro0107 ($214.89 in chips) 
Seat 5: tipner ($214.40 in chips) 
Seat 6: matiko09 ($232 in chips) 
Seat 7: ssljvr ($380.01 in chips) 
Seat 8: Iggso ($208.50 in chips) 
Seat 9: coinflip_si ($209.88 in chips) 
tipner: posts small blind $1
matiko09: posts big blind $2
*** HOLE CARDS ***
Dealt to matiko09 [Tc 4h]
ssljvr: folds 
Iggso: folds 
coinflip_si: folds 
myatiy 96: folds 
butcheN18: folds 
Glushchenko: folds 
petro0107: calls $2
tipner: folds 
matiko09: checks 
*** FLOP *** [7d Jd 3d]
matiko09: checks 
petro0107: bets $2.37
matiko09: folds 
Uncalled bet ($2.37) returned to petro0107
petro0107 collected $4.75 from pot
petro0107: doesn't show hand 
*** SUMMARY ***
Total pot $5 | Rake $0.25 
Board [7d Jd 3d]
Seat 1: myatiy 96 folded before Flop (didn't bet)
Seat 2: butcheN18 folded before Flop (didn't bet)
Seat 3: Glushchenko folded before Flop (didn't bet)
Seat 4: petro0107 (button) collected ($4.75)
Seat 5: tipner (small blind) folded before Flop
Seat 6: matiko09 (big blind) folded on the Flop
Seat 7: ssljvr folded before Flop (didn't bet)
Seat 8: Iggso folded before Flop (didn't bet)
Seat 9: coinflip_si folded before Flop (didn't bet)





PokerStars Hand #151943527835:  Hold'em No Limit ($0.50/$1.00 USD) - 2016/04/15 13:58:50 CET [2016/04/15 7:58:50 ET]
Table 'Adelgunde III' 9-max Seat #6 is the button
Seat 1: valimiu ($31.90 in chips) 
Seat 2: djammusic ($47.50 in chips) 
Seat 3: tipner ($126.20 in chips) 
Seat 4: hammerwife ($110.28 in chips) 
Seat 5: matiko09 ($127.50 in chips) 
Seat 6: Pominator92 ($162.25 in chips) 
Seat 7: Yaaaazz ($100 in chips) 
Seat 8: SanychStar ($100 in chips) 
Seat 9: Kukuryzka ($107.43 in chips) 
Yaaaazz: posts small blind $0.50
SanychStar: posts big blind $1
*** HOLE CARDS ***
Dealt to matiko09 [6d 9h]
Kukuryzka: folds 
valimiu: folds 
djammusic: raises $1.25 to $2.25
tipner: folds 
hammerwife has timed out
hammerwife: folds 
matiko09: folds 
Pominator92: folds 
Yaaaazz: folds 
SanychStar: folds 
Uncalled bet ($1.25) returned to djammusic
djammusic collected $2.50 from pot
djammusic: doesn't show hand 
*** SUMMARY ***
Total pot $2.50 | Rake $0 
Seat 1: valimiu folded before Flop (didn't bet)
Seat 2: djammusic collected ($2.50)
Seat 3: tipner folded before Flop (didn't bet)
Seat 4: hammerwife folded before Flop (didn't bet)
Seat 5: matiko09 folded before Flop (didn't bet)
Seat 6: Pominator92 (button) folded before Flop (didn't bet)
Seat 7: Yaaaazz (small blind) folded before Flop
Seat 8: SanychStar (big blind) folded before Flop
Seat 9: Kukuryzka folded before Flop (didn't bet)





PokerStars Hand #151943531883:  Hold'em No Limit ($0.50/$1.00 USD) - 2016/04/15 13:58:59 CET [2016/04/15 7:58:59 ET]
Table 'Navi' 9-max Seat #6 is the button
Seat 1: tipner ($113.33 in chips) 
Seat 2: butcheN18 ($100 in chips) 
Seat 3: Filojoes ($101.70 in chips) 
Seat 4: Pvsx. ($101.50 in chips) 
Seat 5: hammerwife ($105.82 in chips) 
Seat 6: Glushchenko ($240.08 in chips) 
Seat 9: matiko09 ($130.63 in chips) 
matiko09: posts small blind $0.50
tipner: posts big blind $1
*** HOLE CARDS ***
Dealt to matiko09 [Kh 8h]
ruslik_by joins the table at seat #8 
butcheN18: raises $2 to $3
Filojoes: folds 
Pvsx.: folds 
hammerwife: folds 
Glushchenko: folds 
matiko09: folds 
tipner: folds 
Uncalled bet ($2) returned to butcheN18
butcheN18 collected $2.50 from pot
butcheN18: doesn't show hand 
*** SUMMARY ***
Total pot $2.50 | Rake $0 
Seat 1: tipner (big blind) folded before Flop
Seat 2: butcheN18 collected ($2.50)
Seat 3: Filojoes folded before Flop (didn't bet)
Seat 4: Pvsx. folded before Flop (didn't bet)
Seat 5: hammerwife folded before Flop (didn't bet)
Seat 6: Glushchenko (button) folded before Flop (didn't bet)
Seat 9: matiko09 (small blind) folded before Flop





PokerStars Hand #151943535988:  Hold'em No Limit ($1/$2 USD) - 2016/04/15 13:59:08 CET [2016/04/15 7:59:08 ET]
Table 'Irmgard II' 9-max Seat #1 is the button
Seat 1: GB223 ($200 in chips) 
Seat 2: Kukuryzka ($234.36 in chips) 
Seat 3: matiko09 ($287.17 in chips) 
Seat 4: di0d80 ($254.25 in chips) 
Seat 7: erfk1958 ($91.10 in chips) 
Seat 8: Vikulja1993 ($205.50 in chips) 
Seat 9: maximax04 ($48.91 in chips) 
Kukuryzka: posts small blind $1
matiko09: posts big blind $2
TideHan: sits out 
butcheN18: sits out 
*** HOLE CARDS ***
Dealt to matiko09 [2h 3s]
di0d80: folds 
erfk1958: folds 
Vikulja1993: raises $4 to $6
maximax04: calls $6
GB223: raises $18 to $24
Kukuryzka: folds 
matiko09: folds 
Vikulja1993: calls $18
maximax04: calls $18
*** FLOP *** [5d 3c 6c]
Vikulja1993: checks 
maximax04: bets $24.91 and is all-in
GB223: calls $24.91
Vikulja1993: raises $31.09 to $56
GB223: raises $120 to $176 and is all-in
Vikulja1993: calls $120
*** TURN *** [5d 3c 6c] [8c]
*** RIVER *** [5d 3c 6c 8c] [3d]
*** SHOW DOWN ***
Vikulja1993: shows [Ac Kc] (a flush, Ace high)
GB223: shows [Tc Ts] (two pair, Tens and Threes)
Vikulja1993 collected $302.18 from side pot
maximax04: shows [7h 6h] (two pair, Sixes and Threes)
Vikulja1993 collected $146.98 from main pot
*** SUMMARY ***
Total pot $451.91 Main pot $146.98. Side pot $302.18. | Rake $2.75 
Board [5d 3c 6c 8c 3d]
Seat 1: GB223 (button) showed [Tc Ts] and lost with two pair, Tens and Threes
Seat 2: Kukuryzka (small blind) folded before Flop
Seat 3: matiko09 (big blind) folded before Flop
Seat 4: di0d80 folded before Flop (didn't bet)
Seat 7: erfk1958 folded before Flop (didn't bet)
Seat 8: Vikulja1993 showed [Ac Kc] and won ($449.16) with a flush, Ace high
Seat 9: maximax04 showed [7h 6h] and lost with two pair, Sixes and Threes





PokerStars Hand #151943535926:  Hold'em No Limit ($1/$2 USD) - 2016/04/15 13:59:08 CET [2016/04/15 7:59:08 ET]
Table 'Oceax' 9-max Seat #3 is the button
Seat 1: matiko09 ($200 in chips) 
Seat 2: Fish4trips ($335.38 in chips) 
Seat 3: Glushchenko ($200 in chips) 
Seat 4: butcheN18 ($255.46 in chips) 
Seat 5: derrocco82 ($200 in chips) 
Seat 6: Iggso ($261.80 in chips) 
Seat 7: ssljvr ($200 in chips) 
Seat 8: Poroxide ($318.92 in chips) 
Seat 9: erfk1958 ($119.35 in chips) 
butcheN18: posts small blind $1
derrocco82: posts big blind $2
*** HOLE CARDS ***
Dealt to matiko09 [Td 8h]
Iggso: folds 
ssljvr: folds 
Poroxide: folds 
erfk1958: raises $2 to $4
matiko09: folds 
Fish4trips: folds 
Glushchenko: raises $10 to $14
butcheN18: folds 
derrocco82: folds 
erfk1958: calls $10
*** FLOP *** [Tc Jh 4c]
erfk1958: checks 
Glushchenko: checks 
*** TURN *** [Tc Jh 4c] [6s]
erfk1958: checks 
Glushchenko: checks 
*** RIVER *** [Tc Jh 4c 6s] [6c]
erfk1958: checks 
Glushchenko: checks 
*** SHOW DOWN ***
erfk1958: shows [Ad Jd] (two pair, Jacks and Sixes)
Glushchenko: shows [Jc Ah] (two pair, Jacks and Sixes)
erfk1958 collected $14.73 from pot
Glushchenko collected $14.72 from pot
*** SUMMARY ***
Total pot $31 | Rake $1.55 
Board [Tc Jh 4c 6s 6c]
Seat 1: matiko09 folded before Flop (didn't bet)
Seat 2: Fish4trips folded before Flop (didn't bet)
Seat 3: Glushchenko (button) showed [Jc Ah] and won ($14.72) with two pair, Jacks and Sixes
Seat 4: butcheN18 (small blind) folded before Flop
Seat 5: derrocco82 (big blind) folded before Flop
Seat 6: Iggso folded before Flop (didn't bet)
Seat 7: ssljvr folded before Flop (didn't bet)
Seat 8: Poroxide folded before Flop (didn't bet)
Seat 9: erfk1958 showed [Ad Jd] and won ($14.73) with two pair, Jacks and Sixes





PokerStars Hand #151943536242:  Hold'em No Limit ($0.50/$1.00 USD) - 2016/04/15 13:59:09 CET [2016/04/15 7:59:09 ET]
Table 'Emma II' 9-max Seat #3 is the button
Seat 1: omorfadramou ($100 in chips) 
Seat 2: Filojoes ($100 in chips) 
Seat 3: Glushchenko ($256.29 in chips) 
Seat 4: matiko09 ($100 in chips) 
Seat 6: Tirka ($91.21 in chips) 
Seat 8: butcheN18 ($172.32 in chips) 
Seat 9: Foton18 ($139.84 in chips) 
matiko09: posts small blind $0.50
Zuckinio1909 was removed from the table for failing to post
Tirka: posts big blind $1
ruslik_by: sits out 
*** HOLE CARDS ***
Dealt to matiko09 [4c Tc]
myatiy 96 joins the table at seat #5 
myatiy 96 leaves the table
butcheN18: raises $2 to $3
Vikulja1993 joins the table at seat #5 
Foton18: folds 
omorfadramou: folds 
Tirka said, "sjuure thing"
Filojoes: folds 
Glushchenko: folds 
Vikulja1993 leaves the table
vrnMike joins the table at seat #5 
matiko09: folds 
Tirka: calls $2
*** FLOP *** [Kd 2s 9h]
Tirka: checks 
vrnMike leaves the table
butcheN18: bets $4
Tirka: folds 
Uncalled bet ($4) returned to butcheN18
butcheN18 collected $6.18 from pot
butcheN18: doesn't show hand 
*** SUMMARY ***
Total pot $6.50 | Rake $0.32 
Board [Kd 2s 9h]
Seat 1: omorfadramou folded before Flop (didn't bet)
Seat 2: Filojoes folded before Flop (didn't bet)
Seat 3: Glushchenko (button) folded before Flop (didn't bet)
Seat 4: matiko09 (small blind) folded before Flop
Seat 6: Tirka (big blind) folded on the Flop
Seat 8: butcheN18 collected ($6.18)
Seat 9: Foton18 folded before Flop (didn't bet)





PokerStars Hand #151943538257:  Hold'em No Limit ($1/$2 USD) - 2016/04/15 13:59:14 CET [2016/04/15 7:59:14 ET]
Table 'Blaauw' 9-max Seat #5 is the button
Seat 1: myatiy 96 ($200 in chips) 
Seat 2: butcheN18 ($256.60 in chips) 
Seat 3: Glushchenko ($270.80 in chips) 
Seat 4: petro0107 ($217.64 in chips) 
Seat 5: tipner ($213.40 in chips) 
Seat 6: matiko09 ($230 in chips) 
Seat 7: ssljvr ($380.01 in chips) 
Seat 8: Iggso ($208.50 in chips) 
Seat 9: coinflip_si ($209.88 in chips) 
matiko09: posts small blind $1
ssljvr: posts big blind $2
*** HOLE CARDS ***
Dealt to matiko09 [As 5d]
Iggso: folds 
coinflip_si: raises $3 to $5
myatiy 96: folds 
butcheN18: folds 
Glushchenko: folds 
petro0107: folds 
tipner: folds 
matiko09: folds 
ssljvr: calls $3
*** FLOP *** [2s Ad 6d]
ssljvr: checks 
coinflip_si: bets $3.44
ssljvr: folds 
Uncalled bet ($3.44) returned to coinflip_si
coinflip_si collected $10.45 from pot
coinflip_si: doesn't show hand 
*** SUMMARY ***
Total pot $11 | Rake $0.55 
Board [2s Ad 6d]
Seat 1: myatiy 96 folded before Flop (didn't bet)
Seat 2: butcheN18 folded before Flop (didn't bet)
Seat 3: Glushchenko folded before Flop (didn't bet)
Seat 4: petro0107 folded before Flop (didn't bet)
Seat 5: tipner (button) folded before Flop (didn't bet)
Seat 6: matiko09 (small blind) folded before Flop
Seat 7: ssljvr (big blind) folded on the Flop
Seat 8: Iggso folded before Flop (didn't bet)
Seat 9: coinflip_si collected ($10.45)





PokerStars Hand #151943541087:  Hold'em No Limit ($0.50/$1.00 USD) - 2016/04/15 13:59:20 CET [2016/04/15 7:59:20 ET]
Table 'Parvulesco II' 9-max Seat #6 is the button
Seat 1: bilukm ($101.60 in chips) 
Seat 2: Filojoes ($105.56 in chips) 
Seat 3: matiko09 ($114.95 in chips) 
Seat 4: butcheN18 ($100 in chips) 
Seat 5: maxxmeister ($101.50 in chips) 
Seat 6: ruslik_by ($104.50 in chips) 
Seat 7: Kukuryzka ($130.30 in chips) 
Seat 8: Jimy Tiltman ($112.20 in chips) 
Seat 9: hammerwife ($191.97 in chips) 
Kukuryzka: posts small blind $0.50
Jimy Tiltman: posts big blind $1
*** HOLE CARDS ***
Dealt to matiko09 [7d Ac]
hammerwife: folds 
bilukm: calls $1
Filojoes: folds 
matiko09: folds 
butcheN18: folds 
maxxmeister: folds 
ruslik_by: folds 
Kukuryzka: folds 
Jimy Tiltman: checks 
*** FLOP *** [3h 5s 5h]
Jimy Tiltman: checks 
bilukm: checks 
*** TURN *** [3h 5s 5h] [7c]
Jimy Tiltman: bets $1.78
bilukm: calls $1.78
*** RIVER *** [3h 5s 5h 7c] [6c]
Jimy Tiltman: checks 
bilukm: bets $5.76
Jimy Tiltman: folds 
Uncalled bet ($5.76) returned to bilukm
bilukm collected $5.76 from pot
bilukm: doesn't show hand 
*** SUMMARY ***
Total pot $6.06 | Rake $0.30 
Board [3h 5s 5h 7c 6c]
Seat 1: bilukm collected ($5.76)
Seat 2: Filojoes folded before Flop (didn't bet)
Seat 3: matiko09 folded before Flop (didn't bet)
Seat 4: butcheN18 folded before Flop (didn't bet)
Seat 5: maxxmeister folded before Flop (didn't bet)
Seat 6: ruslik_by (button) folded before Flop (didn't bet)
Seat 7: Kukuryzka (small blind) folded before Flop
Seat 8: Jimy Tiltman (big blind) folded on the River
Seat 9: hammerwife folded before Flop (didn't bet)





PokerStars Hand #151943541676:  Hold'em No Limit ($0.50/$1.00 USD) - 2016/04/15 13:59:21 CET [2016/04/15 7:59:21 ET]
Table 'Chiny II' 9-max Seat #8 is the button
Seat 1: vrnMike ($162.06 in chips) 
Seat 2: Westpants ($126.81 in chips) 
Seat 3: Foton18 ($61.22 in chips) 
Seat 4: matiko09 ($175.90 in chips) 
Seat 5: omorfadramou ($168 in chips) 
Seat 6: choupai ($16.03 in chips) 
Seat 7: ruslik_by ($102.70 in chips) 
Seat 8: Filojoes ($144.74 in chips) 
Seat 9: butcheN18 ($100.50 in chips) 
butcheN18: posts small blind $0.50
vrnMike: posts big blind $1
*** HOLE CARDS ***
Dealt to matiko09 [Qh 6s]
Westpants: raises $2 to $3
Foton18: folds 
matiko09: folds 
omorfadramou: folds 
choupai: folds 
ruslik_by: folds 
Filojoes: folds 
butcheN18: folds 
vrnMike: folds 
Uncalled bet ($2) returned to Westpants
Westpants collected $2.50 from pot
*** SUMMARY ***
Total pot $2.50 | Rake $0 
Seat 1: vrnMike (big blind) folded before Flop
Seat 2: Westpants collected ($2.50)
Seat 3: Foton18 folded before Flop (didn't bet)
Seat 4: matiko09 folded before Flop (didn't bet)
Seat 5: omorfadramou folded before Flop (didn't bet)
Seat 6: choupai folded before Flop (didn't bet)
Seat 7: ruslik_by folded before Flop (didn't bet)
Seat 8: Filojoes (button) folded before Flop (didn't bet)
Seat 9: butcheN18 (small blind) folded before Flop





PokerStars Hand #151943548149:  Hold'em No Limit ($0.50/$1.00 USD) - 2016/04/15 13:59:36 CET [2016/04/15 7:59:36 ET]
Table 'Adelgunde III' 9-max Seat #7 is the button
Seat 1: valimiu ($31.90 in chips) 
Seat 2: djammusic ($49 in chips) 
Seat 3: tipner ($126.20 in chips) 
Seat 4: hammerwife ($110.28 in chips) 
Seat 5: matiko09 ($127.50 in chips) 
Seat 6: Pominator92 ($162.25 in chips) 
Seat 7: Yaaaazz ($100 in chips) 
Seat 8: SanychStar ($100 in chips) 
Seat 9: Kukuryzka ($107.43 in chips) 
SanychStar: posts small blind $0.50
Kukuryzka: posts big blind $1
*** HOLE CARDS ***
Dealt to matiko09 [Js Qs]
valimiu: folds 
djammusic: folds 
tipner: folds 
hammerwife: raises $1.50 to $2.50
matiko09: calls $2.50
Pominator92: calls $2.50
Yaaaazz: folds 
SanychStar: folds 
Kukuryzka: folds 
*** FLOP *** [Jh 3h 4s]
hammerwife: bets $3
matiko09: calls $3
Pominator92: folds 
*** TURN *** [Jh 3h 4s] [6d]
hammerwife: checks 
matiko09: bets $7
hammerwife: folds 
Uncalled bet ($7) returned to matiko09
matiko09 collected $14.25 from pot
matiko09: doesn't show hand 
*** SUMMARY ***
Total pot $15 | Rake $0.75 
Board [Jh 3h 4s 6d]
Seat 1: valimiu folded before Flop (didn't bet)
Seat 2: djammusic folded before Flop (didn't bet)
Seat 3: tipner folded before Flop (didn't bet)
Seat 4: hammerwife folded on the Turn
Seat 5: matiko09 collected ($14.25)
Seat 6: Pominator92 folded on the Flop
Seat 7: Yaaaazz (button) folded before Flop (didn't bet)
Seat 8: SanychStar (small blind) folded before Flop
Seat 9: Kukuryzka (big blind) folded before Flop





PokerStars Hand #151943551064:  Hold'em No Limit ($0.50/$1.00 USD) - 2016/04/15 13:59:42 CET [2016/04/15 7:59:42 ET]
Table 'Navi' 9-max Seat #9 is the button
Seat 1: tipner ($112.33 in chips) 
Seat 3: Filojoes ($101.70 in chips) 
Seat 4: Pvsx. ($101.50 in chips) 
Seat 5: hammerwife ($105.82 in chips) 
Seat 6: Glushchenko ($240.08 in chips) 
Seat 9: matiko09 ($130.13 in chips) 
tipner: posts small blind $0.50
butcheN18: is sitting out 
Filojoes: posts big blind $1
butcheN18 leaves the table
ruslik_by: sits out 
*** HOLE CARDS ***
Dealt to matiko09 [Ts 2h]
myatiy 96 joins the table at seat #2 
Pvsx.: folds 
hammerwife: folds 
Glushchenko: folds 
matiko09: folds 
tipner: raises $2 to $3
Filojoes: raises $6 to $9
tipner: folds 
Uncalled bet ($6) returned to Filojoes
Filojoes collected $6 from pot
Filojoes: doesn't show hand 
*** SUMMARY ***
Total pot $6 | Rake $0 
Seat 1: tipner (small blind) folded before Flop
Seat 3: Filojoes (big blind) collected ($6)
Seat 4: Pvsx. folded before Flop (didn't bet)
Seat 5: hammerwife folded before Flop (didn't bet)
Seat 6: Glushchenko folded before Flop (didn't bet)
Seat 9: matiko09 (button) folded before Flop (didn't bet)





PokerStars Hand #151943552861:  Hold'em No Limit ($0.50/$1.00 USD) - 2016/04/15 13:59:46 CET [2016/04/15 7:59:46 ET]
Table 'Emma II' 9-max Seat #4 is the button
Seat 1: omorfadramou ($100 in chips) 
Seat 2: Filojoes ($100 in chips) 
Seat 3: Glushchenko ($256.29 in chips) 
Seat 4: matiko09 ($100 in chips) 
Seat 6: Tirka ($88.21 in chips) 
Seat 7: ruslik_by ($100 in chips) 
Seat 8: butcheN18 ($175.50 in chips) 
Seat 9: Foton18 ($139.84 in chips) 
Tirka: posts small blind $0.50
ruslik_by: posts big blind $1
*** HOLE CARDS ***
Dealt to matiko09 [2h 3s]
butcheN18: folds 
Foton18: folds 
omorfadramou: folds 
Filojoes: folds 
Glushchenko: raises $1.50 to $2.50
matiko09: folds 
Tirka: folds 
ruslik_by: folds 
Uncalled bet ($1.50) returned to Glushchenko
Glushchenko collected $2.50 from pot
*** SUMMARY ***
Total pot $2.50 | Rake $0 
Seat 1: omorfadramou folded before Flop (didn't bet)
Seat 2: Filojoes folded before Flop (didn't bet)
Seat 3: Glushchenko collected ($2.50)
Seat 4: matiko09 (button) folded before Flop (didn't bet)
Seat 6: Tirka (small blind) folded before Flop
Seat 7: ruslik_by (big blind) folded before Flop
Seat 8: butcheN18 folded before Flop (didn't bet)
Seat 9: Foton18 folded before Flop (didn't bet)





PokerStars Hand #151943554802:  Hold'em No Limit ($1/$2 USD) - 2016/04/15 13:59:51 CET [2016/04/15 7:59:51 ET]
Table 'Blaauw' 9-max Seat #6 is the button
Seat 1: myatiy 96 ($200 in chips) 
Seat 2: butcheN18 ($256.60 in chips) 
Seat 3: Glushchenko ($270.80 in chips) 
Seat 4: petro0107 ($217.64 in chips) 
Seat 5: tipner ($213.40 in chips) 
Seat 6: matiko09 ($229 in chips) 
Seat 7: ssljvr ($375.01 in chips) 
Seat 8: Iggso ($208.50 in chips) 
Seat 9: coinflip_si ($215.33 in chips) 
ssljvr: posts small blind $1
Iggso: posts big blind $2
*** HOLE CARDS ***
Dealt to matiko09 [2h 2s]
coinflip_si: folds 
myatiy 96: folds 
butcheN18: folds 
Glushchenko: folds 
petro0107: calls $2
tipner: folds 
matiko09: raises $4 to $6
ssljvr: folds 
Iggso: folds 
petro0107: calls $4
*** FLOP *** [Qc 5h 7s]
petro0107: checks 
matiko09: checks 
*** TURN *** [Qc 5h 7s] [5d]
petro0107: bets $6
matiko09: calls $6
*** RIVER *** [Qc 5h 7s 5d] [3d]
petro0107: checks 
matiko09: checks 
*** SHOW DOWN ***
petro0107: shows [Ac 9c] (a pair of Fives)
matiko09: shows [2h 2s] (two pair, Fives and Deuces)
matiko09 collected $25.65 from pot
*** SUMMARY ***
Total pot $27 | Rake $1.35 
Board [Qc 5h 7s 5d 3d]
Seat 1: myatiy 96 folded before Flop (didn't bet)
Seat 2: butcheN18 folded before Flop (didn't bet)
Seat 3: Glushchenko folded before Flop (didn't bet)
Seat 4: petro0107 showed [Ac 9c] and lost with a pair of Fives
Seat 5: tipner folded before Flop (didn't bet)
Seat 6: matiko09 (button) showed [2h 2s] and won ($25.65) with two pair, Fives and Deuces
Seat 7: ssljvr (small blind) folded before Flop
Seat 8: Iggso (big blind) folded before Flop
Seat 9: coinflip_si folded before Flop (didn't bet)





PokerStars Hand #151943558575:  Hold'em No Limit ($0.50/$1.00 USD) - 2016/04/15 14:00:00 CET [2016/04/15 8:00:00 ET]
Table 'Chiny II' 9-max Seat #9 is the button
Seat 1: vrnMike ($161.06 in chips) 
Seat 2: Westpants ($128.31 in chips) 
Seat 3: Foton18 ($61.22 in chips) 
Seat 4: matiko09 ($175.90 in chips) 
Seat 5: omorfadramou ($168 in chips) 
Seat 6: choupai ($16.03 in chips) 
Seat 7: ruslik_by ($102.70 in chips) 
Seat 8: Filojoes ($144.74 in chips) 
Seat 9: butcheN18 ($100 in chips) 
vrnMike: posts small blind $0.50
Westpants: posts big blind $1
*** HOLE CARDS ***
Dealt to matiko09 [8h 6c]
Foton18: folds 
matiko09: folds 
omorfadramou: folds 
choupai: folds 
ruslik_by: raises $2 to $3
Filojoes: folds 
butcheN18: folds 
vrnMike: folds 
Westpants: folds 
Uncalled bet ($2) returned to ruslik_by
ruslik_by collected $2.50 from pot
ruslik_by: doesn't show hand 
*** SUMMARY ***
Total pot $2.50 | Rake $0 
Seat 1: vrnMike (small blind) folded before Flop
Seat 2: Westpants (big blind) folded before Flop
Seat 3: Foton18 folded before Flop (didn't bet)
Seat 4: matiko09 folded before Flop (didn't bet)
Seat 5: omorfadramou folded before Flop (didn't bet)
Seat 6: choupai folded before Flop (didn't bet)
Seat 7: ruslik_by collected ($2.50)
Seat 8: Filojoes folded before Flop (didn't bet)
Seat 9: butcheN18 (button) folded before Flop (didn't bet)





PokerStars Hand #151943561512:  Hold'em No Limit ($1/$2 USD) - 2016/04/15 14:00:06 CET [2016/04/15 8:00:06 ET]
Table 'Oceax' 9-max Seat #4 is the button
Seat 1: matiko09 ($200 in chips) 
Seat 2: Fish4trips ($335.38 in chips) 
Seat 3: Glushchenko ($200.72 in chips) 
Seat 4: butcheN18 ($254.46 in chips) 
Seat 5: derrocco82 ($198 in chips) 
Seat 6: Iggso ($261.80 in chips) 
Seat 7: ssljvr ($200 in chips) 
Seat 8: Poroxide ($318.92 in chips) 
Seat 9: erfk1958 ($120.08 in chips) 
derrocco82: posts small blind $1
Iggso: posts big blind $2
*** HOLE CARDS ***
Dealt to matiko09 [9h 3d]
ssljvr: folds 
Poroxide: folds 
erfk1958: folds 
matiko09: folds 
Fish4trips: folds 
Glushchenko: raises $3 to $5
butcheN18: folds 
derrocco82: folds 
Iggso: calls $3
*** FLOP *** [Ad 4s 4d]
Iggso: checks 
Glushchenko: checks 
*** TURN *** [Ad 4s 4d] [2h]
Iggso: checks 
Glushchenko: checks 
*** RIVER *** [Ad 4s 4d 2h] [As]
Iggso: bets $5.85
Glushchenko: folds 
Uncalled bet ($5.85) returned to Iggso
Iggso collected $10.45 from pot
Iggso: doesn't show hand 
*** SUMMARY ***
Total pot $11 | Rake $0.55 
Board [Ad 4s 4d 2h As]
Seat 1: matiko09 folded before Flop (didn't bet)
Seat 2: Fish4trips folded before Flop (didn't bet)
Seat 3: Glushchenko folded on the River
Seat 4: butcheN18 (button) folded before Flop (didn't bet)
Seat 5: derrocco82 (small blind) folded before Flop
Seat 6: Iggso (big blind) collected ($10.45)
Seat 7: ssljvr folded before Flop (didn't bet)
Seat 8: Poroxide folded before Flop (didn't bet)
Seat 9: erfk1958 folded before Flop (didn't bet)





PokerStars Hand #151943568529:  Hold'em No Limit ($1/$2 USD) - 2016/04/15 14:00:21 CET [2016/04/15 8:00:21 ET]
Table 'Adele II' 9-max Seat #8 is the button
Seat 1: RyanHuJun ($325.66 in chips) 
Seat 2: Fish4trips ($329.54 in chips) 
Seat 3: matiko09 ($308.88 in chips) 
Seat 4: Glushchenko ($200 in chips) 
Seat 5: TonnaMunz ($204.25 in chips) 
Seat 6: Kukuryzka ($227.25 in chips) 
Seat 7: Iggso ($232.84 in chips) 
Seat 8: butcheN18 ($200 in chips) 
Seat 9: SanychStar ($277.60 in chips) 
SanychStar: posts small blind $1
RyanHuJun: posts big blind $2
*** HOLE CARDS ***
Dealt to matiko09 [3s 8c]
Fish4trips: folds 
matiko09: folds 
Glushchenko: folds 
TonnaMunz: raises $2.96 to $4.96
Kukuryzka: folds 
Iggso: folds 
butcheN18: folds 
SanychStar: folds 
RyanHuJun: calls $2.96
*** FLOP *** [Tc 5d Kh]
RyanHuJun: checks 
TonnaMunz: bets $7
RyanHuJun: calls $7
*** TURN *** [Tc 5d Kh] [2c]
RyanHuJun: checks 
TonnaMunz: checks 
*** RIVER *** [Tc 5d Kh 2c] [8h]
RyanHuJun: checks 
TonnaMunz: bets $12
RyanHuJun: calls $12
*** SHOW DOWN ***
TonnaMunz: shows [Qs Qd] (a pair of Queens)
RyanHuJun: shows [3d Kc] (a pair of Kings)
RyanHuJun collected $46.47 from pot
*** SUMMARY ***
Total pot $48.92 | Rake $2.45 
Board [Tc 5d Kh 2c 8h]
Seat 1: RyanHuJun (big blind) showed [3d Kc] and won ($46.47) with a pair of Kings
Seat 2: Fish4trips folded before Flop (didn't bet)
Seat 3: matiko09 folded before Flop (didn't bet)
Seat 4: Glushchenko folded before Flop (didn't bet)
Seat 5: TonnaMunz showed [Qs Qd] and lost with a pair of Queens
Seat 6: Kukuryzka folded before Flop (didn't bet)
Seat 7: Iggso folded before Flop (didn't bet)
Seat 8: butcheN18 (button) folded before Flop (didn't bet)
Seat 9: SanychStar (small blind) folded before Flop





PokerStars Hand #151943571325:  Hold'em No Limit ($0.50/$1.00 USD) - 2016/04/15 14:00:27 CET [2016/04/15 8:00:27 ET]
Table 'Navi' 9-max Seat #1 is the button
Seat 1: tipner ($109.33 in chips) 
Seat 3: Filojoes ($104.70 in chips) 
Seat 4: Pvsx. ($101.50 in chips) 
Seat 5: hammerwife ($105.82 in chips) 
Seat 6: Glushchenko ($240.08 in chips) 
Seat 9: matiko09 ($130.13 in chips) 
myatiy 96 will be allowed to play after the button
Filojoes: posts small blind $0.50
Pvsx.: posts big blind $1
ruslik_by: sits out 
*** HOLE CARDS ***
Dealt to matiko09 [4h 8h]
hammerwife: folds 
Glushchenko: raises $2 to $3
matiko09: folds 
tipner: folds 
Filojoes: folds 
Pvsx.: folds 
Uncalled bet ($2) returned to Glushchenko
Glushchenko collected $2.50 from pot
*** SUMMARY ***
Total pot $2.50 | Rake $0 
Seat 1: tipner (button) folded before Flop (didn't bet)
Seat 3: Filojoes (small blind) folded before Flop
Seat 4: Pvsx. (big blind) folded before Flop
Seat 5: hammerwife folded before Flop (didn't bet)
Seat 6: Glushchenko collected ($2.50)
Seat 9: matiko09 folded before Flop (didn't bet)





PokerStars Hand #151943573471:  Hold'em No Limit ($0.50/$1.00 USD) - 2016/04/15 14:00:32 CET [2016/04/15 8:00:32 ET]
Table 'Chiny II' 9-max Seat #1 is the button
Seat 1: vrnMike ($160.56 in chips) 
Seat 2: Westpants ($127.31 in chips) 
Seat 3: Foton18 ($61.22 in chips) 
Seat 4: matiko09 ($175.90 in chips) 
Seat 5: omorfadramou ($168 in chips) 
Seat 6: choupai ($16.03 in chips) 
Seat 7: ruslik_by ($104.20 in chips) 
Seat 8: Filojoes ($144.74 in chips) 
Seat 9: butcheN18 ($100 in chips) 
Westpants: posts small blind $0.50
Foton18: posts big blind $1
*** HOLE CARDS ***
Dealt to matiko09 [5c Ks]
matiko09: folds 
omorfadramou: folds 
choupai: folds 
ruslik_by: folds 
Filojoes: folds 
butcheN18: folds 
vrnMike: folds 
Westpants: calls $0.50
Foton18: raises $2 to $3
Westpants: calls $2
*** FLOP *** [7h 2h 5h]
Westpants: checks 
Foton18: bets $3
Westpants: folds 
Uncalled bet ($3) returned to Foton18
Foton18 collected $5.70 from pot
Foton18: doesn't show hand 
*** SUMMARY ***
Total pot $6 | Rake $0.30 
Board [7h 2h 5h]
Seat 1: vrnMike (button) folded before Flop (didn't bet)
Seat 2: Westpants (small blind) folded on the Flop
Seat 3: Foton18 (big blind) collected ($5.70)
Seat 4: matiko09 folded before Flop (didn't bet)
Seat 5: omorfadramou folded before Flop (didn't bet)
Seat 6: choupai folded before Flop (didn't bet)
Seat 7: ruslik_by folded before Flop (didn't bet)
Seat 8: Filojoes folded before Flop (didn't bet)
Seat 9: butcheN18 folded before Flop (didn't bet)





PokerStars Hand #151943575808:  Hold'em No Limit ($0.50/$1.00 USD) - 2016/04/15 14:00:37 CET [2016/04/15 8:00:37 ET]
Table 'Emma II' 9-max Seat #6 is the button
Seat 1: omorfadramou ($100 in chips) 
Seat 2: Filojoes ($100 in chips) 
Seat 3: Glushchenko ($257.79 in chips) 
Seat 4: matiko09 ($100 in chips) 
Seat 6: Tirka ($87.71 in chips) 
Seat 7: ruslik_by ($100 in chips) 
Seat 9: Foton18 ($139.84 in chips) 
ruslik_by: posts small blind $0.50
butcheN18: is sitting out 
Foton18: posts big blind $1
*** HOLE CARDS ***
Dealt to matiko09 [Tc 7c]
butcheN18 leaves the table
Prettyspitz joins the table at seat #5 
omorfadramou: folds 
Filojoes: folds 
Glushchenko: folds 
matiko09: folds 
Tirka: folds 
ruslik_by: folds 
Uncalled bet ($0.50) returned to Foton18
Foton18 collected $1 from pot
Foton18: doesn't show hand 
*** SUMMARY ***
Total pot $1 | Rake $0 
Seat 1: omorfadramou folded before Flop (didn't bet)
Seat 2: Filojoes folded before Flop (didn't bet)
Seat 3: Glushchenko folded before Flop (didn't bet)
Seat 4: matiko09 folded before Flop (didn't bet)
Seat 6: Tirka (button) folded before Flop (didn't bet)
Seat 7: ruslik_by (small blind) folded before Flop
Seat 9: Foton18 (big blind) collected ($1)





PokerStars Hand #151943578919:  Hold'em No Limit ($1/$2 USD) - 2016/04/15 14:00:43 CET [2016/04/15 8:00:43 ET]
Table 'Blaauw' 9-max Seat #7 is the button
Seat 1: myatiy 96 ($200 in chips) 
Seat 2: butcheN18 ($256.60 in chips) 
Seat 3: Glushchenko ($270.80 in chips) 
Seat 4: petro0107 ($205.64 in chips) 
Seat 5: tipner ($213.40 in chips) 
Seat 6: matiko09 ($242.65 in chips) 
Seat 7: ssljvr ($374.01 in chips) 
Seat 8: Iggso ($206.50 in chips) 
Seat 9: coinflip_si ($215.33 in chips) 
Iggso: posts small blind $1
coinflip_si: posts big blind $2
*** HOLE CARDS ***
Dealt to matiko09 [Kd 5s]
myatiy 96: folds 
butcheN18: folds 
Glushchenko: raises $4 to $6
petro0107: folds 
tipner: folds 
matiko09: folds 
ssljvr: raises $12 to $18
Iggso: folds 
coinflip_si: folds 
Glushchenko: calls $12
*** FLOP *** [2s 3d 8h]
Glushchenko: checks 
ssljvr: checks 
*** TURN *** [2s 3d 8h] [Qs]
Glushchenko: bets $24.69
ssljvr: calls $24.69
*** RIVER *** [2s 3d 8h Qs] [4d]
Glushchenko: checks 
ssljvr: checks 
*** SHOW DOWN ***
Glushchenko: shows [Ks As] (high card Ace)
ssljvr: shows [Jc Js] (a pair of Jacks)
ssljvr collected $85.63 from pot
*** SUMMARY ***
Total pot $88.38 | Rake $2.75 
Board [2s 3d 8h Qs 4d]
Seat 1: myatiy 96 folded before Flop (didn't bet)
Seat 2: butcheN18 folded before Flop (didn't bet)
Seat 3: Glushchenko showed [Ks As] and lost with high card Ace
Seat 4: petro0107 folded before Flop (didn't bet)
Seat 5: tipner folded before Flop (didn't bet)
Seat 6: matiko09 folded before Flop (didn't bet)
Seat 7: ssljvr (button) showed [Jc Js] and won ($85.63) with a pair of Jacks
Seat 8: Iggso (small blind) folded before Flop
Seat 9: coinflip_si (big blind) folded before Flop





PokerStars Hand #151943583455:  Hold'em No Limit ($0.50/$1.00 USD) - 2016/04/15 14:00:53 CET [2016/04/15 8:00:53 ET]
Table 'Parvulesco II' 9-max Seat #7 is the button
Seat 1: bilukm ($104.58 in chips) 
Seat 2: Filojoes ($105.56 in chips) 
Seat 3: matiko09 ($114.95 in chips) 
Seat 4: butcheN18 ($100 in chips) 
Seat 5: maxxmeister ($101.50 in chips) 
Seat 6: ruslik_by ($104.50 in chips) 
Seat 7: Kukuryzka ($129.80 in chips) 
Seat 8: Jimy Tiltman ($109.42 in chips) 
Seat 9: hammerwife ($191.97 in chips) 
Jimy Tiltman: posts small blind $0.50
hammerwife: posts big blind $1
*** HOLE CARDS ***
Dealt to matiko09 [2c As]
bilukm: calls $1
Filojoes: raises $3 to $4
matiko09: folds 
butcheN18: raises $8 to $12
maxxmeister: folds 
ruslik_by: calls $12
Kukuryzka: folds 
Jimy Tiltman: folds 
hammerwife: folds 
bilukm: folds 
Filojoes: folds 
*** FLOP *** [7h 8d 8h]
butcheN18: checks 
ruslik_by: bets $13
butcheN18: folds 
Uncalled bet ($13) returned to ruslik_by
ruslik_by collected $28.98 from pot
ruslik_by: doesn't show hand 
*** SUMMARY ***
Total pot $30.50 | Rake $1.52 
Board [7h 8d 8h]
Seat 1: bilukm folded before Flop
Seat 2: Filojoes folded before Flop
Seat 3: matiko09 folded before Flop (didn't bet)
Seat 4: butcheN18 folded on the Flop
Seat 5: maxxmeister folded before Flop (didn't bet)
Seat 6: ruslik_by collected ($28.98)
Seat 7: Kukuryzka (button) folded before Flop (didn't bet)
Seat 8: Jimy Tiltman (small blind) folded before Flop
Seat 9: hammerwife (big blind) folded before Flop





PokerStars Hand #151943585744:  Hold'em No Limit ($1/$2 USD) - 2016/04/15 14:00:58 CET [2016/04/15 8:00:58 ET]
Table 'Oceax' 9-max Seat #5 is the button
Seat 1: matiko09 ($200 in chips) 
Seat 2: Fish4trips ($335.38 in chips) 
Seat 3: Glushchenko ($200 in chips) 
Seat 4: butcheN18 ($254.46 in chips) 
Seat 5: derrocco82 ($197 in chips) 
Seat 6: Iggso ($267.25 in chips) 
Seat 7: ssljvr ($200 in chips) 
Seat 8: Poroxide ($318.92 in chips) 
Seat 9: erfk1958 ($120.08 in chips) 
Iggso: posts small blind $1
ssljvr: posts big blind $2
*** HOLE CARDS ***
Dealt to matiko09 [3s 6c]
Poroxide: folds 
erfk1958: folds 
matiko09: folds 
Fish4trips: folds 
Glushchenko: folds 
butcheN18: folds 
derrocco82: folds 
Iggso: calls $1
ssljvr: raises $6 to $8
Iggso: calls $6
*** FLOP *** [Qh 7h 2d]
Iggso: checks 
ssljvr: bets $9.42
Iggso: raises $19.58 to $29
ssljvr: folds 
Uncalled bet ($19.58) returned to Iggso
Iggso collected $33.10 from pot
Iggso: doesn't show hand 
*** SUMMARY ***
Total pot $34.84 | Rake $1.74 
Board [Qh 7h 2d]
Seat 1: matiko09 folded before Flop (didn't bet)
Seat 2: Fish4trips folded before Flop (didn't bet)
Seat 3: Glushchenko folded before Flop (didn't bet)
Seat 4: butcheN18 folded before Flop (didn't bet)
Seat 5: derrocco82 (button) folded before Flop (didn't bet)
Seat 6: Iggso (small blind) collected ($33.10)
Seat 7: ssljvr (big blind) folded on the Flop
Seat 8: Poroxide folded before Flop (didn't bet)
Seat 9: erfk1958 folded before Flop (didn't bet)





PokerStars Hand #151943586239:  Hold'em No Limit ($0.50/$1.00 USD) - 2016/04/15 14:00:59 CET [2016/04/15 8:00:59 ET]
Table 'Adelgunde III' 9-max Seat #8 is the button
Seat 1: valimiu ($31.90 in chips) 
Seat 2: djammusic ($49 in chips) 
Seat 3: tipner ($126.20 in chips) 
Seat 4: hammerwife ($104.78 in chips) 
Seat 5: matiko09 ($136.25 in chips) 
Seat 6: Pominator92 ($159.75 in chips) 
Seat 7: Yaaaazz ($100 in chips) 
Seat 8: SanychStar ($100 in chips) 
Seat 9: Kukuryzka ($106.43 in chips) 
Kukuryzka: posts small blind $0.50
valimiu: posts big blind $1
*** HOLE CARDS ***
Dealt to matiko09 [Jd Tc]
djammusic: folds 
tipner: folds 
hammerwife: folds 
matiko09: folds 
Pominator92: raises $2 to $3
Yaaaazz: folds 
SanychStar: calls $3
Kukuryzka: folds 
valimiu: folds 
*** FLOP *** [Qs 3s 8c]
Pominator92: bets $3.56
SanychStar: calls $3.56
*** TURN *** [Qs 3s 8c] [5d]
Pominator92: bets $8
SanychStar: calls $8
*** RIVER *** [Qs 3s 8c 5d] [Jh]
Pominator92: bets $15
SanychStar: calls $15
*** SHOW DOWN ***
Pominator92: shows [Kc 6d] (high card King)
SanychStar: shows [Qh Ks] (a pair of Queens)
SanychStar collected $58.12 from pot
*** SUMMARY ***
Total pot $60.62 | Rake $2.50 
Board [Qs 3s 8c 5d Jh]
Seat 1: valimiu (big blind) folded before Flop
Seat 2: djammusic folded before Flop (didn't bet)
Seat 3: tipner folded before Flop (didn't bet)
Seat 4: hammerwife folded before Flop (didn't bet)
Seat 5: matiko09 folded before Flop (didn't bet)
Seat 6: Pominator92 showed [Kc 6d] and lost with high card King
Seat 7: Yaaaazz folded before Flop (didn't bet)
Seat 8: SanychStar (button) showed [Qh Ks] and won ($58.12) with a pair of Queens
Seat 9: Kukuryzka (small blind) folded before Flop





PokerStars Hand #151943587556:  Hold'em No Limit ($0.50/$1.00 USD) - 2016/04/15 14:01:01 CET [2016/04/15 8:01:01 ET]
Table 'Navi' 9-max Seat #3 is the button
Seat 1: tipner ($109.33 in chips) 
Seat 3: Filojoes ($104.20 in chips) 
Seat 4: Pvsx. ($100.50 in chips) 
Seat 5: hammerwife ($105.82 in chips) 
Seat 6: Glushchenko ($241.58 in chips) 
Seat 9: matiko09 ($130.13 in chips) 
Pvsx.: posts small blind $0.50
hammerwife: posts big blind $1
ruslik_by: sits out 
myatiy 96: sits out 
*** HOLE CARDS ***
Dealt to matiko09 [2c 3s]
Glushchenko: folds 
matiko09: folds 
tipner: folds 
Filojoes: raises $1 to $2
Pvsx.: folds 
hammerwife: folds 
Uncalled bet ($1) returned to Filojoes
Filojoes collected $2.50 from pot
Filojoes: doesn't show hand 
*** SUMMARY ***
Total pot $2.50 | Rake $0 
Seat 1: tipner folded before Flop (didn't bet)
Seat 3: Filojoes (button) collected ($2.50)
Seat 4: Pvsx. (small blind) folded before Flop
Seat 5: hammerwife (big blind) folded before Flop
Seat 6: Glushchenko folded before Flop (didn't bet)
Seat 9: matiko09 folded before Flop (didn't bet)





PokerStars Hand #151943588044:  Hold'em No Limit ($1/$2 USD) - 2016/04/15 14:01:02 CET [2016/04/15 8:01:02 ET]
Table 'Irmgard II' 9-max Seat #2 is the button
Seat 1: GB223 ($200 in chips) 
Seat 2: Kukuryzka ($233.36 in chips) 
Seat 3: matiko09 ($285.17 in chips) 
Seat 4: di0d80 ($254.25 in chips) 
Seat 7: erfk1958 ($91.10 in chips) 
Seat 8: Vikulja1993 ($454.66 in chips) 
matiko09: posts small blind $1
di0d80: posts big blind $2
TideHan: sits out 
butcheN18: sits out 
*** HOLE CARDS ***
Dealt to matiko09 [4d 8h]
erfk1958: raises $2 to $4
Vikulja1993: folds 
maximax04 leaves the table
myatiy 96 joins the table at seat #9 
GB223: folds 
myatiy 96 leaves the table
ssljvr joins the table at seat #9 
Kukuryzka: calls $4
matiko09: folds 
ssljvr leaves the table
di0d80: folds 
*** FLOP *** [6c Qh 8d]
erfk1958: bets $4
Kukuryzka: calls $4
*** TURN *** [6c Qh 8d] [5s]
erfk1958: bets $8
Kukuryzka: folds 
Uncalled bet ($8) returned to erfk1958
erfk1958 collected $18.05 from pot
erfk1958: doesn't show hand 
*** SUMMARY ***
Total pot $19 | Rake $0.95 
Board [6c Qh 8d 5s]
Seat 1: GB223 folded before Flop (didn't bet)
Seat 2: Kukuryzka (button) folded on the Turn
Seat 3: matiko09 (small blind) folded before Flop
Seat 4: di0d80 (big blind) folded before Flop
Seat 7: erfk1958 collected ($18.05)
Seat 8: Vikulja1993 folded before Flop (didn't bet)





PokerStars Hand #151943593987:  Hold'em No Limit ($0.50/$1.00 USD) - 2016/04/15 14:01:15 CET [2016/04/15 8:01:15 ET]
Table 'Chiny II' 9-max Seat #2 is the button
Seat 1: vrnMike ($160.56 in chips) 
Seat 2: Westpants ($124.31 in chips) 
Seat 3: Foton18 ($63.92 in chips) 
Seat 4: matiko09 ($175.90 in chips) 
Seat 5: omorfadramou ($168 in chips) 
Seat 6: choupai ($16.03 in chips) 
Seat 7: ruslik_by ($104.20 in chips) 
Seat 8: Filojoes ($144.74 in chips) 
Seat 9: butcheN18 ($100 in chips) 
Foton18: posts small blind $0.50
matiko09: posts big blind $1
*** HOLE CARDS ***
Dealt to matiko09 [Jc 6h]
omorfadramou: folds 
choupai: folds 
ruslik_by: folds 
Filojoes: raises $2 to $3
butcheN18: folds 
vrnMike: folds 
Westpants: raises $4 to $7
Foton18: folds 
matiko09: folds 
Filojoes: calls $4
*** FLOP *** [8d 6c 3d]
Filojoes: checks 
Westpants: bets $9.25
Filojoes: folds 
Uncalled bet ($9.25) returned to Westpants
Westpants collected $14.72 from pot
*** SUMMARY ***
Total pot $15.50 | Rake $0.78 
Board [8d 6c 3d]
Seat 1: vrnMike folded before Flop (didn't bet)
Seat 2: Westpants (button) collected ($14.72)
Seat 3: Foton18 (small blind) folded before Flop
Seat 4: matiko09 (big blind) folded before Flop
Seat 5: omorfadramou folded before Flop (didn't bet)
Seat 6: choupai folded before Flop (didn't bet)
Seat 7: ruslik_by folded before Flop (didn't bet)
Seat 8: Filojoes folded on the Flop
Seat 9: butcheN18 folded before Flop (didn't bet)





PokerStars Hand #151943600106:  Hold'em No Limit ($0.50/$1.00 USD) - 2016/04/15 14:01:27 CET [2016/04/15 8:01:27 ET]
Table 'Emma II' 9-max Seat #7 is the button
Seat 1: omorfadramou ($100 in chips) 
Seat 2: Filojoes ($100 in chips) 
Seat 3: Glushchenko ($257.79 in chips) 
Seat 4: matiko09 ($100 in chips) 
Seat 6: Tirka ($87.71 in chips) 
Seat 7: ruslik_by ($100 in chips) 
Seat 9: Foton18 ($140.34 in chips) 
Foton18: posts small blind $0.50
omorfadramou: posts big blind $1
Prettyspitz: sits out 
*** HOLE CARDS ***
Dealt to matiko09 [Ac Ah]
Filojoes: folds 
Glushchenko: folds 
matiko09: raises $2 to $3
Tirka: folds 
ruslik_by: folds 
Foton18: folds 
omorfadramou: folds 
Uncalled bet ($2) returned to matiko09
matiko09 collected $2.50 from pot
matiko09: doesn't show hand 
*** SUMMARY ***
Total pot $2.50 | Rake $0 
Seat 1: omorfadramou (big blind) folded before Flop
Seat 2: Filojoes folded before Flop (didn't bet)
Seat 3: Glushchenko folded before Flop (didn't bet)
Seat 4: matiko09 collected ($2.50)
Seat 6: Tirka folded before Flop (didn't bet)
Seat 7: ruslik_by (button) folded before Flop (didn't bet)
Seat 9: Foton18 (small blind) folded before Flop





PokerStars Hand #151943604250:  Hold'em No Limit ($0.50/$1.00 USD) - 2016/04/15 14:01:36 CET [2016/04/15 8:01:36 ET]
Table 'Navi' 9-max Seat #4 is the button
Seat 1: tipner ($109.33 in chips) 
Seat 3: Filojoes ($105.70 in chips) 
Seat 4: Pvsx. ($100 in chips) 
Seat 5: hammerwife ($104.82 in chips) 
Seat 8: ruslik_by ($100 in chips) 
Seat 9: matiko09 ($130.13 in chips) 
hammerwife: posts small blind $0.50
Glushchenko: is sitting out 
Glushchenko leaves the table
ruslik_by: posts big blind $1
myatiy 96: sits out 
*** HOLE CARDS ***
Dealt to matiko09 [5h 8h]
Vikulja1993 joins the table at seat #6 
matiko09: folds 
tipner: folds 
Filojoes: raises $1.50 to $2.50
Pvsx.: folds 
hammerwife: folds 
ruslik_by: folds 
Uncalled bet ($1.50) returned to Filojoes
Filojoes collected $2.50 from pot
Filojoes: doesn't show hand 
*** SUMMARY ***
Total pot $2.50 | Rake $0 
Seat 1: tipner folded before Flop (didn't bet)
Seat 3: Filojoes collected ($2.50)
Seat 4: Pvsx. (button) folded before Flop (didn't bet)
Seat 5: hammerwife (small blind) folded before Flop
Seat 8: ruslik_by (big blind) folded before Flop
Seat 9: matiko09 folded before Flop (didn't bet)





PokerStars Hand #151943610121:  Hold'em No Limit ($0.50/$1.00 USD) - 2016/04/15 14:01:48 CET [2016/04/15 8:01:48 ET]
Table 'Emma II' 9-max Seat #9 is the button
Seat 1: omorfadramou ($100 in chips) 
Seat 2: Filojoes ($100 in chips) 
Seat 3: Glushchenko ($257.79 in chips) 
Seat 4: matiko09 ($101.50 in chips) 
Seat 6: Tirka ($87.71 in chips) 
Seat 7: ruslik_by ($100 in chips) 
Seat 9: Foton18 ($139.84 in chips) 
omorfadramou: posts small blind $0.50
Filojoes: posts big blind $1
Prettyspitz: sits out 
*** HOLE CARDS ***
Dealt to matiko09 [Kd 7s]
Glushchenko: folds 
matiko09: folds 
Tirka: folds 
ruslik_by: folds 
Foton18: raises $2 to $3
omorfadramou: folds 
Filojoes: folds 
Uncalled bet ($2) returned to Foton18
Foton18 collected $2.50 from pot
Foton18: doesn't show hand 
Pamboui joins the table at seat #8 
*** SUMMARY ***
Total pot $2.50 | Rake $0 
Seat 1: omorfadramou (small blind) folded before Flop
Seat 2: Filojoes (big blind) folded before Flop
Seat 3: Glushchenko folded before Flop (didn't bet)
Seat 4: matiko09 folded before Flop (didn't bet)
Seat 6: Tirka folded before Flop (didn't bet)
Seat 7: ruslik_by folded before Flop (didn't bet)
Seat 9: Foton18 (button) collected ($2.50)





PokerStars Hand #151943616551:  Hold'em No Limit ($1/$2 USD) - 2016/04/15 14:02:00 CET [2016/04/15 8:02:00 ET]
Table 'Oceax' 9-max Seat #6 is the button
Seat 1: matiko09 ($200 in chips) 
Seat 2: Fish4trips ($335.38 in chips) 
Seat 3: Glushchenko ($200 in chips) 
Seat 4: butcheN18 ($254.46 in chips) 
Seat 5: derrocco82 ($197 in chips) 
Seat 6: Iggso ($282.93 in chips) 
Seat 7: ssljvr ($200 in chips) 
Seat 8: Poroxide ($318.92 in chips) 
Seat 9: erfk1958 ($120.08 in chips) 
ssljvr: posts small blind $1
Poroxide: posts big blind $2
*** HOLE CARDS ***
Dealt to matiko09 [8d 7s]
erfk1958: folds 
matiko09: folds 
Fish4trips: folds 
Glushchenko: raises $4 to $6
butcheN18: folds 
derrocco82: folds 
Iggso: calls $6
ssljvr: folds 
Poroxide: calls $4
*** FLOP *** [Jc 8s 6d]
Poroxide: checks 
Glushchenko: checks 
Iggso: checks 
*** TURN *** [Jc 8s 6d] [5c]
Poroxide: checks 
Glushchenko: checks 
Iggso: checks 
*** RIVER *** [Jc 8s 6d 5c] [Jd]
Poroxide: bets $10
Glushchenko: folds 
Iggso: folds 
Uncalled bet ($10) returned to Poroxide
Poroxide collected $18.05 from pot
Poroxide: doesn't show hand 
*** SUMMARY ***
Total pot $19 | Rake $0.95 
Board [Jc 8s 6d 5c Jd]
Seat 1: matiko09 folded before Flop (didn't bet)
Seat 2: Fish4trips folded before Flop (didn't bet)
Seat 3: Glushchenko folded on the River
Seat 4: butcheN18 folded before Flop (didn't bet)
Seat 5: derrocco82 folded before Flop (didn't bet)
Seat 6: Iggso (button) folded on the River
Seat 7: ssljvr (small blind) folded before Flop
Seat 8: Poroxide (big blind) collected ($18.05)
Seat 9: erfk1958 folded before Flop (didn't bet)





PokerStars Hand #151943621218:  Hold'em No Limit ($1/$2 USD) - 2016/04/15 14:02:09 CET [2016/04/15 8:02:09 ET]
Table 'Blaauw' 9-max Seat #8 is the button
Seat 1: myatiy 96 ($200 in chips) 
Seat 2: butcheN18 ($256.60 in chips) 
Seat 3: Glushchenko ($228.11 in chips) 
Seat 4: petro0107 ($205.64 in chips) 
Seat 5: tipner ($213.40 in chips) 
Seat 6: matiko09 ($242.65 in chips) 
Seat 7: ssljvr ($416.95 in chips) 
Seat 8: Iggso ($205.50 in chips) 
Seat 9: coinflip_si ($213.33 in chips) 
coinflip_si: posts small blind $1
myatiy 96: posts big blind $2
*** HOLE CARDS ***
Dealt to matiko09 [Ts 4d]
butcheN18: folds 
Glushchenko: folds 
petro0107: folds 
tipner: folds 
matiko09: folds 
ssljvr: folds 
Iggso: raises $2 to $4
coinflip_si: folds 
myatiy 96: raises $12 to $16
Iggso: folds 
Uncalled bet ($12) returned to myatiy 96
myatiy 96 collected $9 from pot
myatiy 96: doesn't show hand 
*** SUMMARY ***
Total pot $9 | Rake $0 
Seat 1: myatiy 96 (big blind) collected ($9)
Seat 2: butcheN18 folded before Flop (didn't bet)
Seat 3: Glushchenko folded before Flop (didn't bet)
Seat 4: petro0107 folded before Flop (didn't bet)
Seat 5: tipner folded before Flop (didn't bet)
Seat 6: matiko09 folded before Flop (didn't bet)
Seat 7: ssljvr folded before Flop (didn't bet)
Seat 8: Iggso (button) folded before Flop
Seat 9: coinflip_si (small blind) folded before Flop





PokerStars Hand #151943621589:  Hold'em No Limit ($0.50/$1.00 USD) - 2016/04/15 14:02:10 CET [2016/04/15 8:02:10 ET]
Table 'Emma II' 9-max Seat #1 is the button
Seat 1: omorfadramou ($100 in chips) 
Seat 2: Filojoes ($100 in chips) 
Seat 3: Glushchenko ($257.79 in chips) 
Seat 4: matiko09 ($101.50 in chips) 
Seat 6: Tirka ($87.71 in chips) 
Seat 7: ruslik_by ($100 in chips) 
Seat 9: Foton18 ($141.34 in chips) 
Filojoes: posts small blind $0.50
Glushchenko: posts big blind $1
Prettyspitz: sits out 
Pamboui: sits out 
*** HOLE CARDS ***
Dealt to matiko09 [Td Js]
matiko09: folds 
Tirka: folds 
ruslik_by: raises $2 to $3
Foton18: folds 
omorfadramou: raises $6 to $9
Filojoes: folds 
Glushchenko: folds 
ruslik_by: folds 
Uncalled bet ($6) returned to omorfadramou
omorfadramou collected $7.50 from pot
omorfadramou: doesn't show hand 
*** SUMMARY ***
Total pot $7.50 | Rake $0 
Seat 1: omorfadramou (button) collected ($7.50)
Seat 2: Filojoes (small blind) folded before Flop
Seat 3: Glushchenko (big blind) folded before Flop
Seat 4: matiko09 folded before Flop (didn't bet)
Seat 6: Tirka folded before Flop (didn't bet)
Seat 7: ruslik_by folded before Flop
Seat 9: Foton18 folded before Flop (didn't bet)





PokerStars Hand #151943622638:  Hold'em No Limit ($0.50/$1.00 USD) - 2016/04/15 14:02:12 CET [2016/04/15 8:02:12 ET]
Table 'Adelgunde III' 9-max Seat #9 is the button
Seat 1: valimiu ($30.90 in chips) 
Seat 3: tipner ($126.20 in chips) 
Seat 4: hammerwife ($104.78 in chips) 
Seat 5: matiko09 ($136.25 in chips) 
Seat 6: Pominator92 ($130.19 in chips) 
Seat 7: Yaaaazz ($100 in chips) 
Seat 8: SanychStar ($128.56 in chips) 
Seat 9: Kukuryzka ($105.93 in chips) 
valimiu: posts small blind $0.50
djammusic: is sitting out 
tipner: posts big blind $1
*** HOLE CARDS ***
Dealt to matiko09 [2d 9s]
djammusic leaves the table
hammerwife: folds 
Vikulja1993 joins the table at seat #2 
matiko09: folds 
Pominator92: raises $2 to $3
Yaaaazz: raises $7 to $10
SanychStar: folds 
Kukuryzka: folds 
valimiu: calls $9.50
tipner: folds 
Pominator92: calls $7
*** FLOP *** [8s 4h Td]
valimiu: checks 
Pominator92: checks 
Yaaaazz: checks 
*** TURN *** [8s 4h Td] [5c]
valimiu: checks 
Pominator92: bets $20
Yaaaazz: folds 
valimiu: folds 
Uncalled bet ($20) returned to Pominator92
Pominator92 collected $29.45 from pot
Pominator92: doesn't show hand 
*** SUMMARY ***
Total pot $31 | Rake $1.55 
Board [8s 4h Td 5c]
Seat 1: valimiu (small blind) folded on the Turn
Seat 3: tipner (big blind) folded before Flop
Seat 4: hammerwife folded before Flop (didn't bet)
Seat 5: matiko09 folded before Flop (didn't bet)
Seat 6: Pominator92 collected ($29.45)
Seat 7: Yaaaazz folded on the Turn
Seat 8: SanychStar folded before Flop (didn't bet)
Seat 9: Kukuryzka (button) folded before Flop (didn't bet)





PokerStars Hand #151943624210:  Hold'em No Limit ($0.50/$1.00 USD) - 2016/04/15 14:02:16 CET [2016/04/15 8:02:16 ET]
Table 'Chiny II' 9-max Seat #3 is the button
Seat 1: vrnMike ($160.56 in chips) 
Seat 2: Westpants ($132.03 in chips) 
Seat 3: Foton18 ($63.42 in chips) 
Seat 4: matiko09 ($174.90 in chips) 
Seat 5: omorfadramou ($168 in chips) 
Seat 6: choupai ($16.03 in chips) 
Seat 7: ruslik_by ($104.20 in chips) 
Seat 8: Filojoes ($137.74 in chips) 
Seat 9: butcheN18 ($100 in chips) 
matiko09: posts small blind $0.50
omorfadramou: posts big blind $1
*** HOLE CARDS ***
Dealt to matiko09 [4h 9s]
choupai: folds 
ruslik_by: folds 
Filojoes: folds 
butcheN18: folds 
vrnMike: folds 
Westpants: raises $2 to $3
Foton18: folds 
matiko09: folds 
omorfadramou: folds 
Uncalled bet ($2) returned to Westpants
Westpants collected $2.50 from pot
*** SUMMARY ***
Total pot $2.50 | Rake $0 
Seat 1: vrnMike folded before Flop (didn't bet)
Seat 2: Westpants collected ($2.50)
Seat 3: Foton18 (button) folded before Flop (didn't bet)
Seat 4: matiko09 (small blind) folded before Flop
Seat 5: omorfadramou (big blind) folded before Flop
Seat 6: choupai folded before Flop (didn't bet)
Seat 7: ruslik_by folded before Flop (didn't bet)
Seat 8: Filojoes folded before Flop (didn't bet)
Seat 9: butcheN18 folded before Flop (didn't bet)





PokerStars Hand #151943624821:  Hold'em No Limit ($0.50/$1.00 USD) - 2016/04/15 14:02:17 CET [2016/04/15 8:02:17 ET]
Table 'Navi' 9-max Seat #5 is the button
Seat 1: tipner ($109.33 in chips) 
Seat 3: Filojoes ($107.20 in chips) 
Seat 4: Pvsx. ($100 in chips) 
Seat 5: hammerwife ($104.32 in chips) 
Seat 8: ruslik_by ($100 in chips) 
Seat 9: matiko09 ($130.13 in chips) 
Vikulja1993 will be allowed to play after the button
ruslik_by: posts small blind $0.50
matiko09: posts big blind $1
myatiy 96: sits out 
*** HOLE CARDS ***
Dealt to matiko09 [As 8c]
tipner: raises $2 to $3
Filojoes: folds 
Pvsx.: folds 
hammerwife: folds 
ruslik_by: folds 
matiko09: folds 
Uncalled bet ($2) returned to tipner
tipner collected $2.50 from pot
tipner: doesn't show hand 
*** SUMMARY ***
Total pot $2.50 | Rake $0 
Seat 1: tipner collected ($2.50)
Seat 3: Filojoes folded before Flop (didn't bet)
Seat 4: Pvsx. folded before Flop (didn't bet)
Seat 5: hammerwife (button) folded before Flop (didn't bet)
Seat 8: ruslik_by (small blind) folded before Flop
Seat 9: matiko09 (big blind) folded before Flop





PokerStars Hand #151943627179:  Hold'em No Limit ($0.50/$1.00 USD) - 2016/04/15 14:02:22 CET [2016/04/15 8:02:22 ET]
Table 'Parvulesco II' 9-max Seat #8 is the button
Seat 1: bilukm ($103.58 in chips) 
Seat 2: Filojoes ($101.56 in chips) 
Seat 3: matiko09 ($114.95 in chips) 
Seat 4: butcheN18 ($100 in chips) 
Seat 5: maxxmeister ($101.50 in chips) 
Seat 6: ruslik_by ($121.48 in chips) 
Seat 7: Kukuryzka ($129.80 in chips) 
Seat 8: Jimy Tiltman ($108.92 in chips) 
Seat 9: hammerwife ($190.97 in chips) 
hammerwife: posts small blind $0.50
bilukm: posts big blind $1
*** HOLE CARDS ***
Dealt to matiko09 [5s 2d]
Filojoes: folds 
matiko09: folds 
butcheN18: folds 
maxxmeister: folds 
ruslik_by: raises $2 to $3
Kukuryzka: folds 
Jimy Tiltman: folds 
hammerwife: folds 
bilukm: folds 
Uncalled bet ($2) returned to ruslik_by
ruslik_by collected $2.50 from pot
ruslik_by: doesn't show hand 
*** SUMMARY ***
Total pot $2.50 | Rake $0 
Seat 1: bilukm (big blind) folded before Flop
Seat 2: Filojoes folded before Flop (didn't bet)
Seat 3: matiko09 folded before Flop (didn't bet)
Seat 4: butcheN18 folded before Flop (didn't bet)
Seat 5: maxxmeister folded before Flop (didn't bet)
Seat 6: ruslik_by collected ($2.50)
Seat 7: Kukuryzka folded before Flop (didn't bet)
Seat 8: Jimy Tiltman (button) folded before Flop (didn't bet)
Seat 9: hammerwife (small blind) folded before Flop





PokerStars Hand #151943630412:  Hold'em No Limit ($1/$2 USD) - 2016/04/15 14:02:28 CET [2016/04/15 8:02:28 ET]
Table 'Adele II' 9-max Seat #9 is the button
Seat 1: RyanHuJun ($348.17 in chips) 
Seat 2: Fish4trips ($329.54 in chips) 
Seat 3: matiko09 ($308.88 in chips) 
Seat 4: Glushchenko ($200 in chips) 
Seat 5: TonnaMunz ($200 in chips) 
Seat 6: Kukuryzka ($227.25 in chips) 
Seat 7: Iggso ($232.84 in chips) 
Seat 8: butcheN18 ($200 in chips) 
Seat 9: SanychStar ($276.60 in chips) 
RyanHuJun: posts small blind $1
Fish4trips: posts big blind $2
*** HOLE CARDS ***
Dealt to matiko09 [3s Kh]
matiko09: folds 
Glushchenko: folds 
TonnaMunz: folds 
Kukuryzka: folds 
Iggso: folds 
butcheN18: folds 
SanychStar: folds 
RyanHuJun: raises $4 to $6
Fish4trips: folds 
Uncalled bet ($4) returned to RyanHuJun
RyanHuJun collected $4 from pot
RyanHuJun: doesn't show hand 
*** SUMMARY ***
Total pot $4 | Rake $0 
Seat 1: RyanHuJun (small blind) collected ($4)
Seat 2: Fish4trips (big blind) folded before Flop
Seat 3: matiko09 folded before Flop (didn't bet)
Seat 4: Glushchenko folded before Flop (didn't bet)
Seat 5: TonnaMunz folded before Flop (didn't bet)
Seat 6: Kukuryzka folded before Flop (didn't bet)
Seat 7: Iggso folded before Flop (didn't bet)
Seat 8: butcheN18 folded before Flop (didn't bet)
Seat 9: SanychStar (button) folded before Flop (didn't bet)





PokerStars Hand #151943632506:  Hold'em No Limit ($1/$2 USD) - 2016/04/15 14:02:32 CET [2016/04/15 8:02:32 ET]
Table 'Irmgard II' 9-max Seat #3 is the button
Seat 1: GB223 ($200 in chips) 
Seat 2: Kukuryzka ($225.36 in chips) 
Seat 3: matiko09 ($284.17 in chips) 
Seat 4: di0d80 ($252.25 in chips) 
Seat 5: TideHan ($200 in chips) 
Seat 7: erfk1958 ($101.15 in chips) 
Seat 8: Vikulja1993 ($454.66 in chips) 
di0d80: posts small blind $1
TideHan: posts big blind $2
butcheN18: sits out 
*** HOLE CARDS ***
Dealt to matiko09 [Td Qd]
erfk1958: folds 
Vikulja1993: folds 
GB223: folds 
Kukuryzka: folds 
matiko09: raises $2.54 to $4.54
di0d80: raises $10.46 to $15
TideHan: folds 
matiko09: calls $10.46
*** FLOP *** [Kd 7c 6d]
di0d80: bets $18
matiko09: calls $18
*** TURN *** [Kd 7c 6d] [8s]
derrocco82 joins the table at seat #9 
di0d80: checks 
matiko09: checks 
*** RIVER *** [Kd 7c 6d 8s] [Ts]
di0d80: checks 
matiko09: checks 
*** SHOW DOWN ***
di0d80: shows [Jc Ac] (high card Ace)
matiko09: shows [Td Qd] (a pair of Tens)
matiko09 collected $65.25 from pot
*** SUMMARY ***
Total pot $68 | Rake $2.75 
Board [Kd 7c 6d 8s Ts]
Seat 1: GB223 folded before Flop (didn't bet)
Seat 2: Kukuryzka folded before Flop (didn't bet)
Seat 3: matiko09 (button) showed [Td Qd] and won ($65.25) with a pair of Tens
Seat 4: di0d80 (small blind) showed [Jc Ac] and lost with high card Ace
Seat 5: TideHan (big blind) folded before Flop
Seat 7: erfk1958 folded before Flop (didn't bet)
Seat 8: Vikulja1993 folded before Flop (didn't bet)





PokerStars Hand #151943642060:  Hold'em No Limit ($0.50/$1.00 USD) - 2016/04/15 14:02:51 CET [2016/04/15 8:02:51 ET]
Table 'Navi' 9-max Seat #8 is the button
Seat 1: tipner ($110.83 in chips) 
Seat 3: Filojoes ($107.20 in chips) 
Seat 4: Pvsx. ($100 in chips) 
Seat 5: hammerwife ($104.32 in chips) 
Seat 8: ruslik_by ($100 in chips) 
Seat 9: matiko09 ($129.13 in chips) 
matiko09: posts small blind $0.50
tipner: posts big blind $1
myatiy 96: sits out 
Vikulja1993: sits out 
*** HOLE CARDS ***
Dealt to matiko09 [8d Jc]
Filojoes: folds 
Pvsx.: folds 
hammerwife: folds 
ruslik_by: raises $1.50 to $2.50
matiko09: folds 
tipner: raises $6.50 to $9
ruslik_by: folds 
Uncalled bet ($6.50) returned to tipner
tipner collected $5.50 from pot
tipner: doesn't show hand 
*** SUMMARY ***
Total pot $5.50 | Rake $0 
Seat 1: tipner (big blind) collected ($5.50)
Seat 3: Filojoes folded before Flop (didn't bet)
Seat 4: Pvsx. folded before Flop (didn't bet)
Seat 5: hammerwife folded before Flop (didn't bet)
Seat 8: ruslik_by (button) folded before Flop
Seat 9: matiko09 (small blind) folded before Flop





PokerStars Hand #151943643084:  Hold'em No Limit ($1/$2 USD) - 2016/04/15 14:02:53 CET [2016/04/15 8:02:53 ET]
Table 'Blaauw' 9-max Seat #9 is the button
Seat 1: myatiy 96 ($205 in chips) 
Seat 2: butcheN18 ($256.60 in chips) 
Seat 3: Glushchenko ($228.11 in chips) 
Seat 4: petro0107 ($205.64 in chips) 
Seat 5: tipner ($213.40 in chips) 
Seat 6: matiko09 ($242.65 in chips) 
Seat 7: ssljvr ($416.95 in chips) 
Seat 8: Iggso ($201.50 in chips) 
Seat 9: coinflip_si ($212.33 in chips) 
myatiy 96: posts small blind $1
butcheN18: posts big blind $2
*** HOLE CARDS ***
Dealt to matiko09 [3d 5h]
Glushchenko: folds 
petro0107: calls $2
tipner: folds 
matiko09: folds 
ssljvr: folds 
Iggso: folds 
coinflip_si: folds 
myatiy 96: folds 
butcheN18: raises $6.36 to $8.36
petro0107: folds 
Uncalled bet ($6.36) returned to butcheN18
butcheN18 collected $5 from pot
butcheN18: doesn't show hand 
*** SUMMARY ***
Total pot $5 | Rake $0 
Seat 1: myatiy 96 (small blind) folded before Flop
Seat 2: butcheN18 (big blind) collected ($5)
Seat 3: Glushchenko folded before Flop (didn't bet)
Seat 4: petro0107 folded before Flop
Seat 5: tipner folded before Flop (didn't bet)
Seat 6: matiko09 folded before Flop (didn't bet)
Seat 7: ssljvr folded before Flop (didn't bet)
Seat 8: Iggso folded before Flop (didn't bet)
Seat 9: coinflip_si (button) folded before Flop (didn't bet)





PokerStars Hand #151943643492:  Hold'em No Limit ($0.50/$1.00 USD) - 2016/04/15 14:02:54 CET [2016/04/15 8:02:54 ET]
Table 'Chiny II' 9-max Seat #4 is the button
Seat 1: vrnMike ($160.56 in chips) 
Seat 2: Westpants ($133.53 in chips) 
Seat 3: Foton18 ($63.42 in chips) 
Seat 4: matiko09 ($174.40 in chips) 
Seat 5: omorfadramou ($167 in chips) 
Seat 6: choupai ($16.03 in chips) 
Seat 7: ruslik_by ($104.20 in chips) 
Seat 8: Filojoes ($137.74 in chips) 
Seat 9: butcheN18 ($100 in chips) 
omorfadramou: posts small blind $0.50
choupai: posts big blind $1
*** HOLE CARDS ***
Dealt to matiko09 [7h Jh]
ruslik_by: folds 
Filojoes: folds 
butcheN18: folds 
vrnMike: folds 
Westpants: raises $2 to $3
Foton18: folds 
matiko09: folds 
omorfadramou: folds 
choupai: folds 
Uncalled bet ($2) returned to Westpants
Westpants collected $2.50 from pot
*** SUMMARY ***
Total pot $2.50 | Rake $0 
Seat 1: vrnMike folded before Flop (didn't bet)
Seat 2: Westpants collected ($2.50)
Seat 3: Foton18 folded before Flop (didn't bet)
Seat 4: matiko09 (button) folded before Flop (didn't bet)
Seat 5: omorfadramou (small blind) folded before Flop
Seat 6: choupai (big blind) folded before Flop
Seat 7: ruslik_by folded before Flop (didn't bet)
Seat 8: Filojoes folded before Flop (didn't bet)
Seat 9: butcheN18 folded before Flop (didn't bet)





PokerStars Hand #151943644564:  Hold'em No Limit ($0.50/$1.00 USD) - 2016/04/15 14:02:56 CET [2016/04/15 8:02:56 ET]
Table 'Parvulesco II' 9-max Seat #9 is the button
Seat 1: bilukm ($102.58 in chips) 
Seat 2: Filojoes ($101.56 in chips) 
Seat 3: matiko09 ($114.95 in chips) 
Seat 4: butcheN18 ($100 in chips) 
Seat 5: maxxmeister ($101.50 in chips) 
Seat 6: ruslik_by ($122.98 in chips) 
Seat 7: Kukuryzka ($129.80 in chips) 
Seat 8: Jimy Tiltman ($108.92 in chips) 
Seat 9: hammerwife ($190.47 in chips) 
bilukm: posts small blind $0.50
Filojoes: posts big blind $1
*** HOLE CARDS ***
Dealt to matiko09 [Qc 3d]
matiko09: folds 
butcheN18: folds 
maxxmeister: folds 
ruslik_by: folds 
Kukuryzka: raises $2 to $3
Jimy Tiltman: folds 
hammerwife: folds 
bilukm: calls $2.50
Filojoes: folds 
*** FLOP *** [Ad 7d Kc]
bilukm: checks 
Kukuryzka: bets $4.99
bilukm: calls $4.99
*** TURN *** [Ad 7d Kc] [Kh]
bilukm: checks 
Kukuryzka: checks 
*** RIVER *** [Ad 7d Kc Kh] [Ac]
bilukm: checks 
Kukuryzka: bets $4
bilukm: folds 
Uncalled bet ($4) returned to Kukuryzka
Kukuryzka collected $16.13 from pot
Kukuryzka: doesn't show hand 
*** SUMMARY ***
Total pot $16.98 | Rake $0.85 
Board [Ad 7d Kc Kh Ac]
Seat 1: bilukm (small blind) folded on the River
Seat 2: Filojoes (big blind) folded before Flop
Seat 3: matiko09 folded before Flop (didn't bet)
Seat 4: butcheN18 folded before Flop (didn't bet)
Seat 5: maxxmeister folded before Flop (didn't bet)
Seat 6: ruslik_by folded before Flop (didn't bet)
Seat 7: Kukuryzka collected ($16.13)
Seat 8: Jimy Tiltman folded before Flop (didn't bet)
Seat 9: hammerwife (button) folded before Flop (didn't bet)





PokerStars Hand #151943646830:  Hold'em No Limit ($0.50/$1.00 USD) - 2016/04/15 14:03:01 CET [2016/04/15 8:03:01 ET]
Table 'Emma II' 9-max Seat #2 is the button
Seat 1: omorfadramou ($104.50 in chips) 
Seat 2: Filojoes ($100 in chips) 
Seat 3: Glushchenko ($256.79 in chips) 
Seat 4: matiko09 ($101.50 in chips) 
Seat 6: Tirka ($87.71 in chips) 
Seat 7: ruslik_by ($100 in chips) 
Seat 9: Foton18 ($141.34 in chips) 
Glushchenko: posts small blind $0.50
matiko09: posts big blind $1
Prettyspitz: sits out 
Pamboui: sits out 
*** HOLE CARDS ***
Dealt to matiko09 [4s 7d]
Tirka: folds 
ruslik_by: raises $2 to $3
Foton18: folds 
omorfadramou: folds 
Filojoes: calls $3
Glushchenko: raises $10 to $13
matiko09: folds 
ruslik_by: calls $10
Filojoes: folds 
*** FLOP *** [Th 6c 5s]
Glushchenko: bets $14.25
ruslik_by: folds 
Uncalled bet ($14.25) returned to Glushchenko
Glushchenko collected $28.50 from pot
*** SUMMARY ***
Total pot $30 | Rake $1.50 
Board [Th 6c 5s]
Seat 1: omorfadramou folded before Flop (didn't bet)
Seat 2: Filojoes (button) folded before Flop
Seat 3: Glushchenko (small blind) collected ($28.50)
Seat 4: matiko09 (big blind) folded before Flop
Seat 6: Tirka folded before Flop (didn't bet)
Seat 7: ruslik_by folded on the Flop
Seat 9: Foton18 folded before Flop (didn't bet)





PokerStars Hand #151943650045:  Hold'em No Limit ($1/$2 USD) - 2016/04/15 14:03:07 CET [2016/04/15 8:03:07 ET]
Table 'Adele II' 9-max Seat #1 is the button
Seat 1: RyanHuJun ($350.17 in chips) 
Seat 2: Fish4trips ($327.54 in chips) 
Seat 3: matiko09 ($308.88 in chips) 
Seat 4: Glushchenko ($200 in chips) 
Seat 5: TonnaMunz ($200 in chips) 
Seat 6: Kukuryzka ($227.25 in chips) 
Seat 7: Iggso ($232.84 in chips) 
Seat 8: butcheN18 ($200 in chips) 
Seat 9: SanychStar ($276.60 in chips) 
Fish4trips: posts small blind $1
matiko09: posts big blind $2
*** HOLE CARDS ***
Dealt to matiko09 [7s Kh]
Glushchenko: folds 
TonnaMunz: folds 
Kukuryzka: folds 
Iggso: folds 
butcheN18: folds 
SanychStar: folds 
RyanHuJun: raises $4 to $6
Fish4trips: folds 
matiko09: folds 
Uncalled bet ($4) returned to RyanHuJun
RyanHuJun collected $5 from pot
RyanHuJun: doesn't show hand 
*** SUMMARY ***
Total pot $5 | Rake $0 
Seat 1: RyanHuJun (button) collected ($5)
Seat 2: Fish4trips (small blind) folded before Flop
Seat 3: matiko09 (big blind) folded before Flop
Seat 4: Glushchenko folded before Flop (didn't bet)
Seat 5: TonnaMunz folded before Flop (didn't bet)
Seat 6: Kukuryzka folded before Flop (didn't bet)
Seat 7: Iggso folded before Flop (didn't bet)
Seat 8: butcheN18 folded before Flop (didn't bet)
Seat 9: SanychStar folded before Flop (didn't bet)





PokerStars Hand #151943651791:  Hold'em No Limit ($1/$2 USD) - 2016/04/15 14:03:11 CET [2016/04/15 8:03:11 ET]
Table 'Oceax' 9-max Seat #7 is the button
Seat 1: matiko09 ($200 in chips) 
Seat 2: Fish4trips ($335.38 in chips) 
Seat 3: Glushchenko ($200 in chips) 
Seat 4: butcheN18 ($254.46 in chips) 
Seat 5: derrocco82 ($197 in chips) 
Seat 6: Iggso ($276.93 in chips) 
Seat 7: ssljvr ($200 in chips) 
Seat 8: Poroxide ($330.97 in chips) 
Seat 9: erfk1958 ($120.08 in chips) 
Poroxide: posts small blind $1
erfk1958: posts big blind $2
*** HOLE CARDS ***
Dealt to matiko09 [6h 5h]
matiko09: folds 
Fish4trips: folds 
Glushchenko: raises $4 to $6
butcheN18: folds 
derrocco82: folds 
Iggso: folds 
ssljvr: raises $12 to $18
Poroxide: folds 
erfk1958: folds 
Glushchenko: calls $12
*** FLOP *** [Th 9s Tc]
Glushchenko: checks 
ssljvr: bets $19
Glushchenko: calls $19
*** TURN *** [Th 9s Tc] [6s]
Glushchenko: checks 
ssljvr: bets $44
Glushchenko: folds 
Uncalled bet ($44) returned to ssljvr
ssljvr collected $74.25 from pot
ssljvr: doesn't show hand 
*** SUMMARY ***
Total pot $77 | Rake $2.75 
Board [Th 9s Tc 6s]
Seat 1: matiko09 folded before Flop (didn't bet)
Seat 2: Fish4trips folded before Flop (didn't bet)
Seat 3: Glushchenko folded on the Turn
Seat 4: butcheN18 folded before Flop (didn't bet)
Seat 5: derrocco82 folded before Flop (didn't bet)
Seat 6: Iggso folded before Flop (didn't bet)
Seat 7: ssljvr (button) collected ($74.25)
Seat 8: Poroxide (small blind) folded before Flop
Seat 9: erfk1958 (big blind) folded before Flop





PokerStars Hand #151943654542:  Hold'em No Limit ($0.50/$1.00 USD) - 2016/04/15 14:03:16 CET [2016/04/15 8:03:16 ET]
Table 'Chiny II' 9-max Seat #5 is the button
Seat 1: vrnMike ($160.56 in chips) 
Seat 2: Westpants ($135.03 in chips) 
Seat 3: Foton18 ($63.42 in chips) 
Seat 4: matiko09 ($174.40 in chips) 
Seat 5: omorfadramou ($166.50 in chips) 
Seat 6: choupai ($15.03 in chips) 
Seat 7: ruslik_by ($104.20 in chips) 
Seat 8: Filojoes ($137.74 in chips) 
Seat 9: butcheN18 ($100 in chips) 
choupai: posts small blind $0.50
ruslik_by: posts big blind $1
*** HOLE CARDS ***
Dealt to matiko09 [4s 5d]
Filojoes: folds 
butcheN18: folds 
vrnMike: folds 
Westpants: raises $2 to $3
Foton18: folds 
matiko09: folds 
omorfadramou: folds 
choupai: folds 
ruslik_by: folds 
Uncalled bet ($2) returned to Westpants
Westpants collected $2.50 from pot
*** SUMMARY ***
Total pot $2.50 | Rake $0 
Seat 1: vrnMike folded before Flop (didn't bet)
Seat 2: Westpants collected ($2.50)
Seat 3: Foton18 folded before Flop (didn't bet)
Seat 4: matiko09 folded before Flop (didn't bet)
Seat 5: omorfadramou (button) folded before Flop (didn't bet)
Seat 6: choupai (small blind) folded before Flop
Seat 7: ruslik_by (big blind) folded before Flop
Seat 8: Filojoes folded before Flop (didn't bet)
Seat 9: butcheN18 folded before Flop (didn't bet)





PokerStars Hand #151943658973:  Hold'em No Limit ($1/$2 USD) - 2016/04/15 14:03:25 CET [2016/04/15 8:03:25 ET]
Table 'Blaauw' 9-max Seat #1 is the button
Seat 1: myatiy 96 ($204 in chips) 
Seat 2: butcheN18 ($259.60 in chips) 
Seat 3: Glushchenko ($228.11 in chips) 
Seat 4: petro0107 ($203.64 in chips) 
Seat 5: tipner ($213.40 in chips) 
Seat 6: matiko09 ($242.65 in chips) 
Seat 7: ssljvr ($416.95 in chips) 
Seat 8: Iggso ($201.50 in chips) 
Seat 9: coinflip_si ($212.33 in chips) 
butcheN18: posts small blind $1
Glushchenko: posts big blind $2
*** HOLE CARDS ***
Dealt to matiko09 [7c 2s]
petro0107: folds 
tipner: folds 
matiko09: folds 
ssljvr: folds 
Iggso: raises $2 to $4
coinflip_si: folds 
myatiy 96: folds 
butcheN18: folds 
Glushchenko: folds 
Uncalled bet ($2) returned to Iggso
Iggso collected $5 from pot
Iggso: doesn't show hand 
*** SUMMARY ***
Total pot $5 | Rake $0 
Seat 1: myatiy 96 (button) folded before Flop (didn't bet)
Seat 2: butcheN18 (small blind) folded before Flop
Seat 3: Glushchenko (big blind) folded before Flop
Seat 4: petro0107 folded before Flop (didn't bet)
Seat 5: tipner folded before Flop (didn't bet)
Seat 6: matiko09 folded before Flop (didn't bet)
Seat 7: ssljvr folded before Flop (didn't bet)
Seat 8: Iggso collected ($5)
Seat 9: coinflip_si folded before Flop (didn't bet)





PokerStars Hand #151943659687:  Hold'em No Limit ($0.50/$1.00 USD) - 2016/04/15 14:03:26 CET [2016/04/15 8:03:26 ET]
Table 'Navi' 9-max Seat #9 is the button
Seat 1: tipner ($113.83 in chips) 
Seat 2: myatiy 96 ($100 in chips) 
Seat 3: Filojoes ($107.20 in chips) 
Seat 4: Pvsx. ($100 in chips) 
Seat 5: hammerwife ($104.32 in chips) 
Seat 8: ruslik_by ($100 in chips) 
Seat 9: matiko09 ($128.63 in chips) 
tipner: posts small blind $0.50
myatiy 96: posts big blind $1
Vikulja1993: sits out 
*** HOLE CARDS ***
Dealt to matiko09 [7d 2h]
Filojoes: folds 
Pvsx.: raises $1.50 to $2.50
hammerwife: folds 
ruslik_by: folds 
matiko09: folds 
tipner: folds 
myatiy 96: folds 
Uncalled bet ($1.50) returned to Pvsx.
Pvsx. collected $2.50 from pot
Pvsx.: doesn't show hand 
*** SUMMARY ***
Total pot $2.50 | Rake $0 
Seat 1: tipner (small blind) folded before Flop
Seat 2: myatiy 96 (big blind) folded before Flop
Seat 3: Filojoes folded before Flop (didn't bet)
Seat 4: Pvsx. collected ($2.50)
Seat 5: hammerwife folded before Flop (didn't bet)
Seat 8: ruslik_by folded before Flop (didn't bet)
Seat 9: matiko09 (button) folded before Flop (didn't bet)





PokerStars Hand #151943666428:  Hold'em No Limit ($0.50/$1.00 USD) - 2016/04/15 14:03:39 CET [2016/04/15 8:03:39 ET]
Table 'Adelgunde III' 9-max Seat #1 is the button
Seat 1: valimiu ($20.90 in chips) 
Seat 3: tipner ($125.20 in chips) 
Seat 4: hammerwife ($104.78 in chips) 
Seat 5: matiko09 ($136.25 in chips) 
Seat 6: Pominator92 ($149.64 in chips) 
Seat 7: Yaaaazz ($100 in chips) 
Seat 8: SanychStar ($128.56 in chips) 
Seat 9: Kukuryzka ($105.93 in chips) 
Vikulja1993 will be allowed to play after the button
tipner: posts small blind $0.50
hammerwife: posts big blind $1
*** HOLE CARDS ***
Dealt to matiko09 [2d 7s]
matiko09: folds 
Pominator92: calls $1
Yaaaazz: folds 
SanychStar: folds 
Kukuryzka: raises $3 to $4
valimiu: calls $4
tipner: folds 
hammerwife: calls $3
Pominator92: calls $3
*** FLOP *** [5c 8c 2h]
hammerwife: bets $8
Pominator92: calls $8
Kukuryzka: folds 
valimiu: folds 
*** TURN *** [5c 8c 2h] [4c]
hammerwife: checks 
Pominator92: checks 
*** RIVER *** [5c 8c 2h 4c] [5d]
hammerwife: checks 
Pominator92: bets $27
hammerwife: folds 
Uncalled bet ($27) returned to Pominator92
Pominator92 collected $30.88 from pot
Pominator92: doesn't show hand 
*** SUMMARY ***
Total pot $32.50 | Rake $1.62 
Board [5c 8c 2h 4c 5d]
Seat 1: valimiu (button) folded on the Flop
Seat 3: tipner (small blind) folded before Flop
Seat 4: hammerwife (big blind) folded on the River
Seat 5: matiko09 folded before Flop (didn't bet)
Seat 6: Pominator92 collected ($30.88)
Seat 7: Yaaaazz folded before Flop (didn't bet)
Seat 8: SanychStar folded before Flop (didn't bet)
Seat 9: Kukuryzka folded on the Flop





PokerStars Hand #151943669237:  Hold'em No Limit ($1/$2 USD) - 2016/04/15 14:03:45 CET [2016/04/15 8:03:45 ET]
Table 'Marmara II' 9-max Seat #4 is the button
Seat 1: ssljvr ($491.98 in chips) 
Seat 3: Glushchenko ($224.31 in chips) 
Seat 4: Fish4trips ($252.96 in chips) 
Seat 5: docmarc777 ($200 in chips) 
Seat 7: matiko09 ($200 in chips) 
Seat 9: erfk1958 ($111.15 in chips) 
docmarc777: posts small blind $1
matiko09: posts big blind $2
Dachish: sits out 
Iggso: sits out 
*** HOLE CARDS ***
Dealt to matiko09 [2c 5d]
erfk1958: folds 
ssljvr: folds 
Glushchenko: raises $3 to $5
Fish4trips: folds 
docmarc777: raises $11 to $16
matiko09: folds 
azzad2007 joins the table at seat #6 
Glushchenko: calls $11
*** FLOP *** [9c 8d Qd]
docmarc777: bets $20
Glushchenko: folds 
Uncalled bet ($20) returned to docmarc777
docmarc777 collected $32.30 from pot
docmarc777: doesn't show hand 
*** SUMMARY ***
Total pot $34 | Rake $1.70 
Board [9c 8d Qd]
Seat 1: ssljvr folded before Flop (didn't bet)
Seat 3: Glushchenko folded on the Flop
Seat 4: Fish4trips (button) folded before Flop (didn't bet)
Seat 5: docmarc777 (small blind) collected ($32.30)
Seat 7: matiko09 (big blind) folded before Flop
Seat 9: erfk1958 folded before Flop (didn't bet)





PokerStars Hand #151943672239:  Hold'em No Limit ($1/$2 USD) - 2016/04/15 14:03:51 CET [2016/04/15 8:03:51 ET]
Table 'Adele II' 9-max Seat #2 is the button
Seat 1: RyanHuJun ($353.17 in chips) 
Seat 2: Fish4trips ($326.54 in chips) 
Seat 3: matiko09 ($306.88 in chips) 
Seat 4: Glushchenko ($200 in chips) 
Seat 5: TonnaMunz ($200 in chips) 
Seat 6: Kukuryzka ($227.25 in chips) 
Seat 7: Iggso ($232.84 in chips) 
Seat 8: butcheN18 ($200 in chips) 
Seat 9: SanychStar ($276.60 in chips) 
matiko09: posts small blind $1
Glushchenko: posts big blind $2
*** HOLE CARDS ***
Dealt to matiko09 [Qd 2s]
TonnaMunz: raises $2.96 to $4.96
Kukuryzka: folds 
Iggso: folds 
butcheN18: folds 
SanychStar: folds 
RyanHuJun: folds 
Fish4trips: folds 
matiko09: folds 
Glushchenko: folds 
Uncalled bet ($2.96) returned to TonnaMunz
TonnaMunz collected $5 from pot
TonnaMunz: doesn't show hand 
*** SUMMARY ***
Total pot $5 | Rake $0 
Seat 1: RyanHuJun folded before Flop (didn't bet)
Seat 2: Fish4trips (button) folded before Flop (didn't bet)
Seat 3: matiko09 (small blind) folded before Flop
Seat 4: Glushchenko (big blind) folded before Flop
Seat 5: TonnaMunz collected ($5)
Seat 6: Kukuryzka folded before Flop (didn't bet)
Seat 7: Iggso folded before Flop (didn't bet)
Seat 8: butcheN18 folded before Flop (didn't bet)
Seat 9: SanychStar folded before Flop (didn't bet)





PokerStars Hand #151943674193:  Hold'em No Limit ($1/$2 USD) - 2016/04/15 14:03:54 CET [2016/04/15 8:03:54 ET]
Table 'Irmgard II' 9-max Seat #4 is the button
Seat 1: GB223 ($200 in chips) 
Seat 2: Kukuryzka ($225.36 in chips) 
Seat 3: matiko09 ($316.42 in chips) 
Seat 4: di0d80 ($219.25 in chips) 
Seat 5: TideHan ($200 in chips) 
Seat 6: butcheN18 ($200 in chips) 
Seat 7: erfk1958 ($101.15 in chips) 
Seat 8: Vikulja1993 ($454.66 in chips) 
TideHan: posts small blind $1
butcheN18: posts big blind $2
derrocco82: sits out 
*** HOLE CARDS ***
Dealt to matiko09 [Tc Kh]
erfk1958: folds 
Vikulja1993: folds 
GB223: folds 
Kukuryzka: folds 
matiko09: raises $3 to $5
di0d80: folds 
TideHan: folds 
butcheN18: folds 
Uncalled bet ($3) returned to matiko09
matiko09 collected $5 from pot
matiko09: doesn't show hand 
*** SUMMARY ***
Total pot $5 | Rake $0 
Seat 1: GB223 folded before Flop (didn't bet)
Seat 2: Kukuryzka folded before Flop (didn't bet)
Seat 3: matiko09 collected ($5)
Seat 4: di0d80 (button) folded before Flop (didn't bet)
Seat 5: TideHan (small blind) folded before Flop
Seat 6: butcheN18 (big blind) folded before Flop
Seat 7: erfk1958 folded before Flop (didn't bet)
Seat 8: Vikulja1993 folded before Flop (didn't bet)





PokerStars Hand #151943674576:  Hold'em No Limit ($0.50/$1.00 USD) - 2016/04/15 14:03:55 CET [2016/04/15 8:03:55 ET]
Table 'Chiny II' 9-max Seat #6 is the button
Seat 1: vrnMike ($160.56 in chips) 
Seat 2: Westpants ($136.53 in chips) 
Seat 3: Foton18 ($63.42 in chips) 
Seat 4: matiko09 ($174.40 in chips) 
Seat 5: omorfadramou ($166.50 in chips) 
Seat 6: choupai ($14.53 in chips) 
Seat 7: ruslik_by ($103.20 in chips) 
Seat 8: Filojoes ($137.74 in chips) 
Seat 9: butcheN18 ($100 in chips) 
ruslik_by: posts small blind $0.50
Filojoes: posts big blind $1
*** HOLE CARDS ***
Dealt to matiko09 [3d 6s]
butcheN18: folds 
vrnMike: folds 
Westpants: raises $2 to $3
Foton18: folds 
matiko09: folds 
omorfadramou: folds 
choupai: folds 
ruslik_by: calls $2.50
Filojoes: folds 
*** FLOP *** [2c 6d Tc]
ruslik_by: checks 
Westpants: bets $4.12
ruslik_by: calls $4.12
*** TURN *** [2c 6d Tc] [9d]
ruslik_by: checks 
Westpants: checks 
*** RIVER *** [2c 6d Tc 9d] [3h]
ruslik_by: bets $7
Westpants: calls $7
*** SHOW DOWN ***
ruslik_by: shows [Jh Ad] (high card Ace)
Westpants: shows [Qs Ts] (a pair of Tens)
Westpants collected $27.78 from pot
*** SUMMARY ***
Total pot $29.24 | Rake $1.46 
Board [2c 6d Tc 9d 3h]
Seat 1: vrnMike folded before Flop (didn't bet)
Seat 2: Westpants showed [Qs Ts] and won ($27.78) with a pair of Tens
Seat 3: Foton18 folded before Flop (didn't bet)
Seat 4: matiko09 folded before Flop (didn't bet)
Seat 5: omorfadramou folded before Flop (didn't bet)
Seat 6: choupai (button) folded before Flop (didn't bet)
Seat 7: ruslik_by (small blind) showed [Jh Ad] and lost with high card Ace
Seat 8: Filojoes (big blind) folded before Flop
Seat 9: butcheN18 folded before Flop (didn't bet)





PokerStars Hand #151943674275:  Hold'em No Limit ($0.50/$1.00 USD) - 2016/04/15 14:03:55 CET [2016/04/15 8:03:55 ET]
Table 'Navi' 9-max Seat #1 is the button
Seat 1: tipner ($113.33 in chips) 
Seat 2: myatiy 96 ($100 in chips) 
Seat 4: Pvsx. ($101.50 in chips) 
Seat 5: hammerwife ($104.32 in chips) 
Seat 8: ruslik_by ($100 in chips) 
Seat 9: matiko09 ($128.63 in chips) 
myatiy 96: posts small blind $0.50
Filojoes: is sitting out 
Filojoes leaves the table
Pvsx.: posts big blind $1
Vikulja1993: sits out 
*** HOLE CARDS ***
Dealt to matiko09 [3h Ad]
vrnMike joins the table at seat #3 
hammerwife: folds 
ruslik_by: folds 
matiko09: folds 
tipner: raises $1.50 to $2.50
myatiy 96: folds 
Pvsx.: folds 
Uncalled bet ($1.50) returned to tipner
tipner collected $2.50 from pot
tipner: doesn't show hand 
*** SUMMARY ***
Total pot $2.50 | Rake $0 
Seat 1: tipner (button) collected ($2.50)
Seat 2: myatiy 96 (small blind) folded before Flop
Seat 4: Pvsx. (big blind) folded before Flop
Seat 5: hammerwife folded before Flop (didn't bet)
Seat 8: ruslik_by folded before Flop (didn't bet)
Seat 9: matiko09 folded before Flop (didn't bet)





PokerStars Hand #151943678474:  Hold'em No Limit ($0.50/$1.00 USD) - 2016/04/15 14:04:03 CET [2016/04/15 8:04:03 ET]
Table 'Emma II' 9-max Seat #3 is the button
Seat 1: omorfadramou ($104.50 in chips) 
Seat 2: Filojoes ($100 in chips) 
Seat 3: Glushchenko ($272.29 in chips) 
Seat 4: matiko09 ($100.50 in chips) 
Seat 5: Prettyspitz ($100 in chips) 
Seat 6: Tirka ($87.71 in chips) 
Seat 7: ruslik_by ($100 in chips) 
Seat 9: Foton18 ($141.34 in chips) 
matiko09: posts small blind $0.50
Prettyspitz: posts big blind $1
Pamboui: sits out 
*** HOLE CARDS ***
Dealt to matiko09 [7d 8s]
Tirka: folds 
ruslik_by: folds 
Foton18: raises $2 to $3
omorfadramou: folds 
Filojoes: folds 
Glushchenko: folds 
matiko09: folds 
Prettyspitz: folds 
Uncalled bet ($2) returned to Foton18
Foton18 collected $2.50 from pot
Foton18: doesn't show hand 
*** SUMMARY ***
Total pot $2.50 | Rake $0 
Seat 1: omorfadramou folded before Flop (didn't bet)
Seat 2: Filojoes folded before Flop (didn't bet)
Seat 3: Glushchenko (button) folded before Flop (didn't bet)
Seat 4: matiko09 (small blind) folded before Flop
Seat 5: Prettyspitz (big blind) folded before Flop
Seat 6: Tirka folded before Flop (didn't bet)
Seat 7: ruslik_by folded before Flop (didn't bet)
Seat 9: Foton18 collected ($2.50)





PokerStars Hand #151943680815:  Hold'em No Limit ($0.50/$1.00 USD) - 2016/04/15 14:04:07 CET [2016/04/15 8:04:07 ET]
Table 'Parvulesco II' 9-max Seat #1 is the button
Seat 1: bilukm ($94.59 in chips) 
Seat 2: Filojoes ($100.56 in chips) 
Seat 3: matiko09 ($114.95 in chips) 
Seat 4: butcheN18 ($100 in chips) 
Seat 5: maxxmeister ($101.50 in chips) 
Seat 6: ruslik_by ($122.98 in chips) 
Seat 7: Kukuryzka ($137.94 in chips) 
Seat 8: Jimy Tiltman ($108.92 in chips) 
Seat 9: hammerwife ($190.47 in chips) 
Filojoes: posts small blind $0.50
matiko09: posts big blind $1
*** HOLE CARDS ***
Dealt to matiko09 [6s 8c]
butcheN18: raises $2 to $3
maxxmeister: folds 
ruslik_by: folds 
Kukuryzka: folds 
Jimy Tiltman: raises $3 to $6
hammerwife: folds 
bilukm: folds 
Filojoes: folds 
matiko09: folds 
butcheN18: folds 
Uncalled bet ($3) returned to Jimy Tiltman
Jimy Tiltman collected $7.50 from pot
Jimy Tiltman: doesn't show hand 
*** SUMMARY ***
Total pot $7.50 | Rake $0 
Seat 1: bilukm (button) folded before Flop (didn't bet)
Seat 2: Filojoes (small blind) folded before Flop
Seat 3: matiko09 (big blind) folded before Flop
Seat 4: butcheN18 folded before Flop
Seat 5: maxxmeister folded before Flop (didn't bet)
Seat 6: ruslik_by folded before Flop (didn't bet)
Seat 7: Kukuryzka folded before Flop (didn't bet)
Seat 8: Jimy Tiltman collected ($7.50)
Seat 9: hammerwife folded before Flop (didn't bet)





PokerStars Hand #151943685916:  Hold'em No Limit ($1/$2 USD) - 2016/04/15 14:04:17 CET [2016/04/15 8:04:17 ET]
Table 'Adele II' 9-max Seat #3 is the button
Seat 1: RyanHuJun ($353.17 in chips) 
Seat 2: Fish4trips ($326.54 in chips) 
Seat 3: matiko09 ($305.88 in chips) 
Seat 4: Glushchenko ($200 in chips) 
Seat 5: TonnaMunz ($203 in chips) 
Seat 6: Kukuryzka ($227.25 in chips) 
Seat 7: Iggso ($232.84 in chips) 
Seat 8: butcheN18 ($200 in chips) 
Seat 9: SanychStar ($276.60 in chips) 
Glushchenko: posts small blind $1
TonnaMunz: posts big blind $2
*** HOLE CARDS ***
Dealt to matiko09 [3s 6h]
Kukuryzka: folds 
Iggso: folds 
butcheN18: folds 
SanychStar: folds 
RyanHuJun: folds 
Fish4trips: folds 
matiko09: folds 
Glushchenko: folds 
Uncalled bet ($1) returned to TonnaMunz
TonnaMunz collected $2 from pot
TonnaMunz: doesn't show hand 
*** SUMMARY ***
Total pot $2 | Rake $0 
Seat 1: RyanHuJun folded before Flop (didn't bet)
Seat 2: Fish4trips folded before Flop (didn't bet)
Seat 3: matiko09 (button) folded before Flop (didn't bet)
Seat 4: Glushchenko (small blind) folded before Flop
Seat 5: TonnaMunz (big blind) collected ($2)
Seat 6: Kukuryzka folded before Flop (didn't bet)
Seat 7: Iggso folded before Flop (didn't bet)
Seat 8: butcheN18 folded before Flop (didn't bet)
Seat 9: SanychStar folded before Flop (didn't bet)





PokerStars Hand #151943686354:  Hold'em No Limit ($1/$2 USD) - 2016/04/15 14:04:18 CET [2016/04/15 8:04:18 ET]
Table 'Blaauw' 9-max Seat #2 is the button
Seat 1: myatiy 96 ($204 in chips) 
Seat 2: butcheN18 ($258.60 in chips) 
Seat 3: Glushchenko ($226.11 in chips) 
Seat 4: petro0107 ($203.64 in chips) 
Seat 5: tipner ($213.40 in chips) 
Seat 6: matiko09 ($242.65 in chips) 
Seat 7: ssljvr ($416.95 in chips) 
Seat 8: Iggso ($204.50 in chips) 
Seat 9: coinflip_si ($212.33 in chips) 
Glushchenko: posts small blind $1
petro0107: posts big blind $2
*** HOLE CARDS ***
Dealt to matiko09 [Tc 5d]
tipner: folds 
matiko09: folds 
ssljvr: folds 
Iggso: folds 
coinflip_si: raises $3 to $5
myatiy 96: folds 
butcheN18: folds 
Glushchenko: folds 
petro0107: calls $3
*** FLOP *** [Js Th Td]
petro0107: checks 
coinflip_si: checks 
*** TURN *** [Js Th Td] [As]
petro0107: checks 
coinflip_si: bets $3.44
petro0107: calls $3.44
*** RIVER *** [Js Th Td As] [9s]
petro0107: checks 
coinflip_si: checks 
*** SHOW DOWN ***
petro0107: shows [Qc 8h] (a straight, Eight to Queen)
coinflip_si: mucks hand 
petro0107 collected $16.99 from pot
*** SUMMARY ***
Total pot $17.88 | Rake $0.89 
Board [Js Th Td As 9s]
Seat 1: myatiy 96 folded before Flop (didn't bet)
Seat 2: butcheN18 (button) folded before Flop (didn't bet)
Seat 3: Glushchenko (small blind) folded before Flop
Seat 4: petro0107 (big blind) showed [Qc 8h] and won ($16.99) with a straight, Eight to Queen
Seat 5: tipner folded before Flop (didn't bet)
Seat 6: matiko09 folded before Flop (didn't bet)
Seat 7: ssljvr folded before Flop (didn't bet)
Seat 8: Iggso folded before Flop (didn't bet)
Seat 9: coinflip_si mucked [6d 8d]





PokerStars Hand #151943688419:  Hold'em No Limit ($1/$2 USD) - 2016/04/15 14:04:22 CET [2016/04/15 8:04:22 ET]
Table 'Irmgard II' 9-max Seat #5 is the button
Seat 1: GB223 ($200 in chips) 
Seat 2: Kukuryzka ($225.36 in chips) 
Seat 3: matiko09 ($319.42 in chips) 
Seat 4: di0d80 ($219.25 in chips) 
Seat 5: TideHan ($200 in chips) 
Seat 6: butcheN18 ($200 in chips) 
Seat 7: erfk1958 ($101.15 in chips) 
Seat 8: Vikulja1993 ($454.66 in chips) 
butcheN18: posts small blind $1
erfk1958: posts big blind $2
derrocco82: sits out 
*** HOLE CARDS ***
Dealt to matiko09 [6h 2d]
Vikulja1993: folds 
Vikulja1993 leaves the table
myatiy 96 joins the table at seat #8 
myatiy 96 leaves the table
GB223: folds 
Kukuryzka: folds 
matiko09: folds 
di0d80: folds 
TideHan: folds 
butcheN18: folds 
Uncalled bet ($1) returned to erfk1958
erfk1958 collected $2 from pot
erfk1958: doesn't show hand 
*** SUMMARY ***
Total pot $2 | Rake $0 
Seat 1: GB223 folded before Flop (didn't bet)
Seat 2: Kukuryzka folded before Flop (didn't bet)
Seat 3: matiko09 folded before Flop (didn't bet)
Seat 4: di0d80 folded before Flop (didn't bet)
Seat 5: TideHan (button) folded before Flop (didn't bet)
Seat 6: butcheN18 (small blind) folded before Flop
Seat 7: erfk1958 (big blind) collected ($2)
Seat 8: Vikulja1993 folded before Flop (didn't bet)





PokerStars Hand #151943691753:  Hold'em No Limit ($1/$2 USD) - 2016/04/15 14:04:29 CET [2016/04/15 8:04:29 ET]
Table 'Marmara II' 9-max Seat #5 is the button
Seat 1: ssljvr ($491.98 in chips) 
Seat 3: Glushchenko ($208.31 in chips) 
Seat 4: Fish4trips ($252.96 in chips) 
Seat 5: docmarc777 ($216.30 in chips) 
Seat 7: matiko09 ($200 in chips) 
Seat 8: Dachish ($160 in chips) 
Seat 9: erfk1958 ($111.15 in chips) 
azzad2007 will be allowed to play after the button
matiko09: posts small blind $1
Dachish: posts big blind $2
Iggso: sits out 
*** HOLE CARDS ***
Dealt to matiko09 [As 2h]
erfk1958: raises $2 to $4
ssljvr: folds 
Glushchenko: folds 
Fish4trips: folds 
docmarc777: folds 
matiko09: folds 
Dachish: folds 
Uncalled bet ($2) returned to erfk1958
erfk1958 collected $5 from pot
erfk1958: doesn't show hand 
*** SUMMARY ***
Total pot $5 | Rake $0 
Seat 1: ssljvr folded before Flop (didn't bet)
Seat 3: Glushchenko folded before Flop (didn't bet)
Seat 4: Fish4trips folded before Flop (didn't bet)
Seat 5: docmarc777 (button) folded before Flop (didn't bet)
Seat 7: matiko09 (small blind) folded before Flop
Seat 8: Dachish (big blind) folded before Flop
Seat 9: erfk1958 collected ($5)





PokerStars Hand #151943696753:  Hold'em No Limit ($0.50/$1.00 USD) - 2016/04/15 14:04:39 CET [2016/04/15 8:04:39 ET]
Table 'Navi' 9-max Seat #2 is the button
Seat 1: tipner ($114.83 in chips) 
Seat 2: myatiy 96 ($100 in chips) 
Seat 4: Pvsx. ($100.50 in chips) 
Seat 5: hammerwife ($104.32 in chips) 
Seat 8: ruslik_by ($100 in chips) 
Seat 9: matiko09 ($128.63 in chips) 
vrnMike will be allowed to play after the button
Pvsx.: posts small blind $0.50
hammerwife: posts big blind $1
Vikulja1993: sits out 
*** HOLE CARDS ***
Dealt to matiko09 [8d 7d]
ruslik_by: folds 
matiko09: raises $2 to $3
tipner: folds 
myatiy 96: folds 
Pvsx.: folds 
hammerwife: raises $6 to $9
matiko09: folds 
Uncalled bet ($6) returned to hammerwife
hammerwife collected $6.50 from pot
hammerwife: doesn't show hand 
*** SUMMARY ***
Total pot $6.50 | Rake $0 
Seat 1: tipner folded before Flop (didn't bet)
Seat 2: myatiy 96 (button) folded before Flop (didn't bet)
Seat 4: Pvsx. (small blind) folded before Flop
Seat 5: hammerwife (big blind) collected ($6.50)
Seat 8: ruslik_by folded before Flop (didn't bet)
Seat 9: matiko09 folded before Flop





PokerStars Hand #151943699016:  Hold'em No Limit ($1/$2 USD) - 2016/04/15 14:04:43 CET [2016/04/15 8:04:43 ET]
Table 'Irmgard II' 9-max Seat #6 is the button
Seat 1: GB223 ($200 in chips) 
Seat 2: Kukuryzka ($225.36 in chips) 
Seat 3: matiko09 ($319.42 in chips) 
Seat 4: di0d80 ($219.25 in chips) 
Seat 5: TideHan ($200 in chips) 
Seat 6: butcheN18 ($200 in chips) 
Seat 7: erfk1958 ($102.15 in chips) 
Seat 9: derrocco82 ($200 in chips) 
erfk1958: posts small blind $1
derrocco82: posts big blind $2
*** HOLE CARDS ***
Dealt to matiko09 [2s 8s]
GB223: folds 
Kukuryzka: folds 
matiko09: folds 
di0d80: folds 
TideHan: raises $4 to $6
myatiy 96 joins the table at seat #8 
myatiy 96 leaves the table
butcheN18: folds 
erfk1958: folds 
derrocco82: folds 
Uncalled bet ($4) returned to TideHan
TideHan collected $5 from pot
TideHan: doesn't show hand 
*** SUMMARY ***
Total pot $5 | Rake $0 
Seat 1: GB223 folded before Flop (didn't bet)
Seat 2: Kukuryzka folded before Flop (didn't bet)
Seat 3: matiko09 folded before Flop (didn't bet)
Seat 4: di0d80 folded before Flop (didn't bet)
Seat 5: TideHan collected ($5)
Seat 6: butcheN18 (button) folded before Flop (didn't bet)
Seat 7: erfk1958 (small blind) folded before Flop
Seat 9: derrocco82 (big blind) folded before Flop





PokerStars Hand #151943699021:  Hold'em No Limit ($1/$2 USD) - 2016/04/15 14:04:43 CET [2016/04/15 8:04:43 ET]
Table 'Adele II' 9-max Seat #4 is the button
Seat 1: RyanHuJun ($353.17 in chips) 
Seat 2: Fish4trips ($326.54 in chips) 
Seat 3: matiko09 ($305.88 in chips) 
Seat 4: Glushchenko ($200 in chips) 
Seat 5: TonnaMunz ($204 in chips) 
Seat 6: Kukuryzka ($227.25 in chips) 
Seat 7: Iggso ($232.84 in chips) 
Seat 8: butcheN18 ($200 in chips) 
Seat 9: SanychStar ($276.60 in chips) 
TonnaMunz: posts small blind $1
Kukuryzka: posts big blind $2
*** HOLE CARDS ***
Dealt to matiko09 [Ts 5h]
Iggso: folds 
butcheN18: folds 
SanychStar: raises $3 to $5
RyanHuJun: folds 
Fish4trips: folds 
matiko09: folds 
Glushchenko: folds 
TonnaMunz: folds 
Kukuryzka: folds 
Uncalled bet ($3) returned to SanychStar
SanychStar collected $5 from pot
*** SUMMARY ***
Total pot $5 | Rake $0 
Seat 1: RyanHuJun folded before Flop (didn't bet)
Seat 2: Fish4trips folded before Flop (didn't bet)
Seat 3: matiko09 folded before Flop (didn't bet)
Seat 4: Glushchenko (button) folded before Flop (didn't bet)
Seat 5: TonnaMunz (small blind) folded before Flop
Seat 6: Kukuryzka (big blind) folded before Flop
Seat 7: Iggso folded before Flop (didn't bet)
Seat 8: butcheN18 folded before Flop (didn't bet)
Seat 9: SanychStar collected ($5)





PokerStars Hand #151943699941:  Hold'em No Limit ($1/$2 USD) - 2016/04/15 14:04:45 CET [2016/04/15 8:04:45 ET]
Table 'Oceax' 9-max Seat #8 is the button
Seat 1: matiko09 ($200 in chips) 
Seat 2: Fish4trips ($335.38 in chips) 
Seat 3: Glushchenko ($200 in chips) 
Seat 4: butcheN18 ($254.46 in chips) 
Seat 5: derrocco82 ($197 in chips) 
Seat 6: Iggso ($276.93 in chips) 
Seat 7: ssljvr ($237.25 in chips) 
Seat 8: Poroxide ($329.97 in chips) 
Seat 9: erfk1958 ($118.08 in chips) 
erfk1958: posts small blind $1
matiko09: posts big blind $2
*** HOLE CARDS ***
Dealt to matiko09 [7s 9c]
Fish4trips: folds 
Glushchenko: folds 
butcheN18: folds 
derrocco82: calls $2
Iggso: folds 
ssljvr: raises $8 to $10
Poroxide: folds 
erfk1958: folds 
matiko09: folds 
derrocco82: folds 
Uncalled bet ($8) returned to ssljvr
ssljvr collected $7 from pot
ssljvr: doesn't show hand 
*** SUMMARY ***
Total pot $7 | Rake $0 
Seat 1: matiko09 (big blind) folded before Flop
Seat 2: Fish4trips folded before Flop (didn't bet)
Seat 3: Glushchenko folded before Flop (didn't bet)
Seat 4: butcheN18 folded before Flop (didn't bet)
Seat 5: derrocco82 folded before Flop
Seat 6: Iggso folded before Flop (didn't bet)
Seat 7: ssljvr collected ($7)
Seat 8: Poroxide (button) folded before Flop (didn't bet)
Seat 9: erfk1958 (small blind) folded before Flop





PokerStars Hand #151943701957:  Hold'em No Limit ($0.50/$1.00 USD) - 2016/04/15 14:04:49 CET [2016/04/15 8:04:49 ET]
Table 'Emma II' 9-max Seat #4 is the button
Seat 1: omorfadramou ($104.50 in chips) 
Seat 2: Filojoes ($100 in chips) 
Seat 3: Glushchenko ($272.29 in chips) 
Seat 4: matiko09 ($100 in chips) 
Seat 5: Prettyspitz ($100 in chips) 
Seat 6: Tirka ($87.71 in chips) 
Seat 7: ruslik_by ($100 in chips) 
Seat 9: Foton18 ($142.84 in chips) 
Prettyspitz: posts small blind $0.50
Tirka: posts big blind $1
Pamboui: sits out 
*** HOLE CARDS ***
Dealt to matiko09 [Qs 6h]
ruslik_by: folds 
Foton18: folds 
omorfadramou: folds 
Filojoes: folds 
Glushchenko: folds 
matiko09: folds 
Prettyspitz: folds 
Uncalled bet ($0.50) returned to Tirka
Tirka collected $1 from pot
Tirka: doesn't show hand 
*** SUMMARY ***
Total pot $1 | Rake $0 
Seat 1: omorfadramou folded before Flop (didn't bet)
Seat 2: Filojoes folded before Flop (didn't bet)
Seat 3: Glushchenko folded before Flop (didn't bet)
Seat 4: matiko09 (button) folded before Flop (didn't bet)
Seat 5: Prettyspitz (small blind) folded before Flop
Seat 6: Tirka (big blind) collected ($1)
Seat 7: ruslik_by folded before Flop (didn't bet)
Seat 9: Foton18 folded before Flop (didn't bet)





PokerStars Hand #151943703040:  Hold'em No Limit ($1/$2 USD) - 2016/04/15 14:04:51 CET [2016/04/15 8:04:51 ET]
Table 'Marmara II' 9-max Seat #7 is the button
Seat 1: ssljvr ($491.98 in chips) 
Seat 3: Glushchenko ($208.31 in chips) 
Seat 4: Fish4trips ($252.96 in chips) 
Seat 5: docmarc777 ($216.30 in chips) 
Seat 6: azzad2007 ($200 in chips) 
Seat 7: matiko09 ($200 in chips) 
Seat 8: Dachish ($158 in chips) 
Seat 9: erfk1958 ($114.15 in chips) 
Dachish: posts small blind $1
erfk1958: posts big blind $2
Iggso: sits out 
azzad2007: posts big blind $2
*** HOLE CARDS ***
Dealt to matiko09 [Qc 9c]
ssljvr: folds 
Glushchenko: folds 
Fish4trips: folds 
docmarc777: folds 
azzad2007: checks 
matiko09: raises $6 to $8
Dachish: folds 
erfk1958: folds 
azzad2007: folds 
Uncalled bet ($6) returned to matiko09
matiko09 collected $7 from pot
matiko09: doesn't show hand 
*** SUMMARY ***
Total pot $7 | Rake $0 
Seat 1: ssljvr folded before Flop (didn't bet)
Seat 3: Glushchenko folded before Flop (didn't bet)
Seat 4: Fish4trips folded before Flop (didn't bet)
Seat 5: docmarc777 folded before Flop (didn't bet)
Seat 6: azzad2007 folded before Flop
Seat 7: matiko09 (button) collected ($7)
Seat 8: Dachish (small blind) folded before Flop
Seat 9: erfk1958 (big blind) folded before Flop





PokerStars Hand #151943705307:  Hold'em No Limit ($0.50/$1.00 USD) - 2016/04/15 14:04:56 CET [2016/04/15 8:04:56 ET]
Table 'Adelgunde III' 9-max Seat #3 is the button
Seat 1: valimiu ($16.90 in chips) 
Seat 3: tipner ($124.70 in chips) 
Seat 4: hammerwife ($100 in chips) 
Seat 5: matiko09 ($136.25 in chips) 
Seat 6: Pominator92 ($168.52 in chips) 
Seat 7: Yaaaazz ($100 in chips) 
Seat 8: SanychStar ($128.56 in chips) 
Seat 9: Kukuryzka ($101.93 in chips) 
hammerwife: posts small blind $0.50
matiko09: posts big blind $1
Vikulja1993: sits out 
*** HOLE CARDS ***
Dealt to matiko09 [Kc 6d]
Pominator92: folds 
Yaaaazz: folds 
SanychStar: folds 
Kukuryzka: folds 
valimiu: calls $1
tipner: folds 
hammerwife: folds 
matiko09: checks 
*** FLOP *** [8h Js 2s]
matiko09: checks 
valimiu: checks 
*** TURN *** [8h Js 2s] [Td]
matiko09: checks 
valimiu: bets $3
matiko09: folds 
Uncalled bet ($3) returned to valimiu
valimiu collected $2.38 from pot
valimiu: doesn't show hand 
*** SUMMARY ***
Total pot $2.50 | Rake $0.12 
Board [8h Js 2s Td]
Seat 1: valimiu collected ($2.38)
Seat 3: tipner (button) folded before Flop (didn't bet)
Seat 4: hammerwife (small blind) folded before Flop
Seat 5: matiko09 (big blind) folded on the Turn
Seat 6: Pominator92 folded before Flop (didn't bet)
Seat 7: Yaaaazz folded before Flop (didn't bet)
Seat 8: SanychStar folded before Flop (didn't bet)
Seat 9: Kukuryzka folded before Flop (didn't bet)





PokerStars Hand #151943707051:  Hold'em No Limit ($0.50/$1.00 USD) - 2016/04/15 14:04:59 CET [2016/04/15 8:04:59 ET]
Table 'Navi' 9-max Seat #4 is the button
Seat 1: tipner ($114.83 in chips) 
Seat 2: myatiy 96 ($100 in chips) 
Seat 4: Pvsx. ($100 in chips) 
Seat 5: hammerwife ($107.82 in chips) 
Seat 6: Vikulja1993 ($100 in chips) 
Seat 8: ruslik_by ($100 in chips) 
Seat 9: matiko09 ($125.63 in chips) 
hammerwife: posts small blind $0.50
Vikulja1993: posts big blind $1
vrnMike: sits out 
*** HOLE CARDS ***
Dealt to matiko09 [Ks 8d]
ruslik_by: folds 
matiko09: folds 
tipner: folds 
myatiy 96: folds 
Pvsx.: folds 
hammerwife: raises $1.60 to $2.60
Vikulja1993: raises $5.40 to $8
hammerwife: calls $5.40
*** FLOP *** [5c Jh Js]
hammerwife: checks 
Vikulja1993: bets $5
hammerwife: calls $5
*** TURN *** [5c Jh Js] [2h]
hammerwife: checks 
Vikulja1993: bets $19
hammerwife: folds 
Uncalled bet ($19) returned to Vikulja1993
Vikulja1993 collected $24.70 from pot
Vikulja1993: doesn't show hand 
*** SUMMARY ***
Total pot $26 | Rake $1.30 
Board [5c Jh Js 2h]
Seat 1: tipner folded before Flop (didn't bet)
Seat 2: myatiy 96 folded before Flop (didn't bet)
Seat 4: Pvsx. (button) folded before Flop (didn't bet)
Seat 5: hammerwife (small blind) folded on the Turn
Seat 6: Vikulja1993 (big blind) collected ($24.70)
Seat 8: ruslik_by folded before Flop (didn't bet)
Seat 9: matiko09 folded before Flop (didn't bet)





PokerStars Hand #151943708734:  Hold'em No Limit ($0.50/$1.00 USD) - 2016/04/15 14:05:02 CET [2016/04/15 8:05:02 ET]
Table 'Parvulesco II' 9-max Seat #2 is the button
Seat 1: bilukm ($94.59 in chips) 
Seat 2: Filojoes ($100.06 in chips) 
Seat 3: matiko09 ($113.95 in chips) 
Seat 4: butcheN18 ($100 in chips) 
Seat 5: maxxmeister ($101.50 in chips) 
Seat 6: ruslik_by ($122.98 in chips) 
Seat 7: Kukuryzka ($137.94 in chips) 
Seat 8: Jimy Tiltman ($113.42 in chips) 
Seat 9: hammerwife ($190.47 in chips) 
matiko09: posts small blind $0.50
butcheN18: posts big blind $1
*** HOLE CARDS ***
Dealt to matiko09 [Ad 3s]
maxxmeister: folds 
ruslik_by: folds 
Kukuryzka: raises $2 to $3
Jimy Tiltman: folds 
hammerwife: folds 
bilukm: calls $3
Filojoes: calls $3
matiko09: folds 
butcheN18: folds 
*** FLOP *** [2d 5d 9d]
Kukuryzka: checks 
bilukm: checks 
Filojoes: bets $6.50
Kukuryzka: folds 
bilukm: folds 
Uncalled bet ($6.50) returned to Filojoes
Filojoes collected $9.98 from pot
Filojoes: doesn't show hand 
*** SUMMARY ***
Total pot $10.50 | Rake $0.52 
Board [2d 5d 9d]
Seat 1: bilukm folded on the Flop
Seat 2: Filojoes (button) collected ($9.98)
Seat 3: matiko09 (small blind) folded before Flop
Seat 4: butcheN18 (big blind) folded before Flop
Seat 5: maxxmeister folded before Flop (didn't bet)
Seat 6: ruslik_by folded before Flop (didn't bet)
Seat 7: Kukuryzka folded on the Flop
Seat 8: Jimy Tiltman folded before Flop (didn't bet)
Seat 9: hammerwife folded before Flop (didn't bet)





PokerStars Hand #151943711234:  Hold'em No Limit ($0.50/$1.00 USD) - 2016/04/15 14:05:07 CET [2016/04/15 8:05:07 ET]
Table 'Chiny II' 9-max Seat #7 is the button
Seat 1: vrnMike ($160.56 in chips) 
Seat 2: Westpants ($150.19 in chips) 
Seat 3: Foton18 ($63.42 in chips) 
Seat 4: matiko09 ($174.40 in chips) 
Seat 5: omorfadramou ($166.50 in chips) 
Seat 6: choupai ($14.53 in chips) 
Seat 7: ruslik_by ($100 in chips) 
Seat 8: Filojoes ($136.74 in chips) 
Seat 9: butcheN18 ($100 in chips) 
Filojoes: posts small blind $0.50
butcheN18: posts big blind $1
*** HOLE CARDS ***
Dealt to matiko09 [9s 7h]
vrnMike: folds 
Westpants: folds 
Foton18: folds 
matiko09: folds 
omorfadramou: folds 
choupai: raises $2 to $3
ruslik_by: folds 
Filojoes: folds 
butcheN18: folds 
Uncalled bet ($2) returned to choupai
choupai collected $2.50 from pot
choupai: doesn't show hand 
*** SUMMARY ***
Total pot $2.50 | Rake $0 
Seat 1: vrnMike folded before Flop (didn't bet)
Seat 2: Westpants folded before Flop (didn't bet)
Seat 3: Foton18 folded before Flop (didn't bet)
Seat 4: matiko09 folded before Flop (didn't bet)
Seat 5: omorfadramou folded before Flop (didn't bet)
Seat 6: choupai collected ($2.50)
Seat 7: ruslik_by (button) folded before Flop (didn't bet)
Seat 8: Filojoes (small blind) folded before Flop
Seat 9: butcheN18 (big blind) folded before Flop





PokerStars Hand #151943711994:  Hold'em No Limit ($0.50/$1.00 USD) - 2016/04/15 14:05:09 CET [2016/04/15 8:05:09 ET]
Table 'Emma II' 9-max Seat #5 is the button
Seat 1: omorfadramou ($104.50 in chips) 
Seat 2: Filojoes ($100 in chips) 
Seat 3: Glushchenko ($272.29 in chips) 
Seat 4: matiko09 ($100 in chips) 
Seat 5: Prettyspitz ($100 in chips) 
Seat 6: Tirka ($88.21 in chips) 
Seat 7: ruslik_by ($100 in chips) 
Seat 9: Foton18 ($142.84 in chips) 
Tirka: posts small blind $0.50
ruslik_by: posts big blind $1
Pamboui: sits out 
*** HOLE CARDS ***
Dealt to matiko09 [5s Ad]
Foton18: calls $1
omorfadramou: folds 
Filojoes: raises $3 to $4
Glushchenko: folds 
matiko09: folds 
Prettyspitz: folds 
Tirka: folds 
ruslik_by: raises $8 to $12
Foton18: folds 
Filojoes: folds 
Uncalled bet ($8) returned to ruslik_by
ruslik_by collected $9.50 from pot
ruslik_by: doesn't show hand 
*** SUMMARY ***
Total pot $9.50 | Rake $0 
Seat 1: omorfadramou folded before Flop (didn't bet)
Seat 2: Filojoes folded before Flop
Seat 3: Glushchenko folded before Flop (didn't bet)
Seat 4: matiko09 folded before Flop (didn't bet)
Seat 5: Prettyspitz (button) folded before Flop (didn't bet)
Seat 6: Tirka (small blind) folded before Flop
Seat 7: ruslik_by (big blind) collected ($9.50)
Seat 9: Foton18 folded before Flop





PokerStars Hand #151943712765:  Hold'em No Limit ($1/$2 USD) - 2016/04/15 14:05:10 CET [2016/04/15 8:05:10 ET]
Table 'Marmara II' 9-max Seat #8 is the button
Seat 1: ssljvr ($491.98 in chips) 
Seat 3: Glushchenko ($208.31 in chips) 
Seat 4: Fish4trips ($252.96 in chips) 
Seat 5: docmarc777 ($216.30 in chips) 
Seat 6: azzad2007 ($200 in chips) 
Seat 7: matiko09 ($205 in chips) 
Seat 8: Dachish ($157 in chips) 
Seat 9: erfk1958 ($112.15 in chips) 
erfk1958: posts small blind $1
ssljvr: posts big blind $2
Iggso: sits out 
*** HOLE CARDS ***
Dealt to matiko09 [6d Qd]
Glushchenko: folds 
Fish4trips: folds 
docmarc777: folds 
azzad2007: folds 
matiko09: folds 
Dachish: raises $2 to $4
erfk1958: calls $3
ssljvr: folds 
*** FLOP *** [2c 7h 9s]
erfk1958: checks 
Dachish: bets $6
erfk1958: calls $6
*** TURN *** [2c 7h 9s] [3c]
erfk1958: checks 
Dachish: checks 
*** RIVER *** [2c 7h 9s 3c] [Th]
erfk1958: bets $8
Dachish: calls $8
*** SHOW DOWN ***
erfk1958: shows [9d 7d] (two pair, Nines and Sevens)
Dachish: mucks hand 
erfk1958 collected $36.10 from pot
*** SUMMARY ***
Total pot $38 | Rake $1.90 
Board [2c 7h 9s 3c Th]
Seat 1: ssljvr (big blind) folded before Flop
Seat 3: Glushchenko folded before Flop (didn't bet)
Seat 4: Fish4trips folded before Flop (didn't bet)
Seat 5: docmarc777 folded before Flop (didn't bet)
Seat 6: azzad2007 folded before Flop (didn't bet)
Seat 7: matiko09 folded before Flop (didn't bet)
Seat 8: Dachish (button) mucked [8s 7c]
Seat 9: erfk1958 (small blind) showed [9d 7d] and won ($36.10) with two pair, Nines and Sevens





PokerStars Hand #151943714427:  Hold'em No Limit ($1/$2 USD) - 2016/04/15 14:05:13 CET [2016/04/15 8:05:13 ET]
Table 'Oceax' 9-max Seat #9 is the button
Seat 1: matiko09 ($200 in chips) 
Seat 2: Fish4trips ($335.38 in chips) 
Seat 3: Glushchenko ($200 in chips) 
Seat 4: butcheN18 ($254.46 in chips) 
Seat 5: derrocco82 ($195 in chips) 
Seat 6: Iggso ($276.93 in chips) 
Seat 7: ssljvr ($242.25 in chips) 
Seat 8: Poroxide ($329.97 in chips) 
Seat 9: erfk1958 ($117.08 in chips) 
matiko09: posts small blind $1
Fish4trips: posts big blind $2
*** HOLE CARDS ***
Dealt to matiko09 [7h 6s]
Glushchenko: folds 
butcheN18: folds 
derrocco82: folds 
Iggso: folds 
ssljvr: folds 
Poroxide: folds 
erfk1958: raises $2 to $4
matiko09: folds 
Fish4trips: folds 
Uncalled bet ($2) returned to erfk1958
erfk1958 collected $5 from pot
erfk1958: doesn't show hand 
*** SUMMARY ***
Total pot $5 | Rake $0 
Seat 1: matiko09 (small blind) folded before Flop
Seat 2: Fish4trips (big blind) folded before Flop
Seat 3: Glushchenko folded before Flop (didn't bet)
Seat 4: butcheN18 folded before Flop (didn't bet)
Seat 5: derrocco82 folded before Flop (didn't bet)
Seat 6: Iggso folded before Flop (didn't bet)
Seat 7: ssljvr folded before Flop (didn't bet)
Seat 8: Poroxide folded before Flop (didn't bet)
Seat 9: erfk1958 (button) collected ($5)





PokerStars Hand #151943717540:  Hold'em No Limit ($1/$2 USD) - 2016/04/15 14:05:20 CET [2016/04/15 8:05:20 ET]
Table 'Adele II' 9-max Seat #5 is the button
Seat 1: RyanHuJun ($353.17 in chips) 
Seat 2: Fish4trips ($326.54 in chips) 
Seat 3: matiko09 ($305.88 in chips) 
Seat 4: Glushchenko ($200 in chips) 
Seat 5: TonnaMunz ($203 in chips) 
Seat 6: Kukuryzka ($225.25 in chips) 
Seat 7: Iggso ($232.84 in chips) 
Seat 8: butcheN18 ($200 in chips) 
Seat 9: SanychStar ($279.60 in chips) 
Kukuryzka: posts small blind $1
Iggso: posts big blind $2
*** HOLE CARDS ***
Dealt to matiko09 [8s Qc]
butcheN18: folds 
SanychStar: folds 
RyanHuJun: calls $2
Fish4trips: folds 
matiko09: folds 
Glushchenko: raises $6 to $8
TonnaMunz: folds 
Kukuryzka: folds 
Iggso: folds 
RyanHuJun: calls $6
*** FLOP *** [6c 9h 4s]
RyanHuJun: checks 
Glushchenko: bets $12.03
RyanHuJun: folds 
Uncalled bet ($12.03) returned to Glushchenko
Glushchenko collected $18.05 from pot
*** SUMMARY ***
Total pot $19 | Rake $0.95 
Board [6c 9h 4s]
Seat 1: RyanHuJun folded on the Flop
Seat 2: Fish4trips folded before Flop (didn't bet)
Seat 3: matiko09 folded before Flop (didn't bet)
Seat 4: Glushchenko collected ($18.05)
Seat 5: TonnaMunz (button) folded before Flop (didn't bet)
Seat 6: Kukuryzka (small blind) folded before Flop
Seat 7: Iggso (big blind) folded before Flop
Seat 8: butcheN18 folded before Flop (didn't bet)
Seat 9: SanychStar folded before Flop (didn't bet)





PokerStars Hand #151943719120:  Hold'em No Limit ($0.50/$1.00 USD) - 2016/04/15 14:05:23 CET [2016/04/15 8:05:23 ET]
Table 'Adelgunde III' 9-max Seat #4 is the button
Seat 1: valimiu ($18.28 in chips) 
Seat 3: tipner ($124.70 in chips) 
Seat 4: hammerwife ($100 in chips) 
Seat 5: matiko09 ($135.25 in chips) 
Seat 6: Pominator92 ($168.52 in chips) 
Seat 7: Yaaaazz ($100 in chips) 
Seat 8: SanychStar ($128.56 in chips) 
Seat 9: Kukuryzka ($101.93 in chips) 
matiko09: posts small blind $0.50
Pominator92: posts big blind $1
Vikulja1993: sits out 
*** HOLE CARDS ***
Dealt to matiko09 [9d Kh]
Yaaaazz: folds 
SanychStar: folds 
Kukuryzka: folds 
valimiu: calls $1
tipner: folds 
hammerwife: raises $3 to $4
matiko09: folds 
Pominator92: calls $3
valimiu: calls $3
*** FLOP *** [5s 7c Jd]
Pominator92: checks 
valimiu: bets $5
hammerwife: calls $5
Pominator92: folds 
*** TURN *** [5s 7c Jd] [Ac]
valimiu: bets $9.28 and is all-in
hammerwife: calls $9.28
*** RIVER *** [5s 7c Jd Ac] [Td]
*** SHOW DOWN ***
valimiu: shows [8c Jc] (a pair of Jacks)
hammerwife: shows [As Ts] (two pair, Aces and Tens)
hammerwife collected $39.01 from pot
*** SUMMARY ***
Total pot $41.06 | Rake $2.05 
Board [5s 7c Jd Ac Td]
Seat 1: valimiu showed [8c Jc] and lost with a pair of Jacks
Seat 3: tipner folded before Flop (didn't bet)
Seat 4: hammerwife (button) showed [As Ts] and won ($39.01) with two pair, Aces and Tens
Seat 5: matiko09 (small blind) folded before Flop
Seat 6: Pominator92 (big blind) folded on the Flop
Seat 7: Yaaaazz folded before Flop (didn't bet)
Seat 8: SanychStar folded before Flop (didn't bet)
Seat 9: Kukuryzka folded before Flop (didn't bet)





PokerStars Hand #151943727179:  Hold'em No Limit ($0.50/$1.00 USD) - 2016/04/15 14:05:39 CET [2016/04/15 8:05:39 ET]
Table 'Chiny II' 9-max Seat #8 is the button
Seat 1: vrnMike ($160.56 in chips) 
Seat 2: Westpants ($150.19 in chips) 
Seat 3: Foton18 ($63.42 in chips) 
Seat 4: matiko09 ($174.40 in chips) 
Seat 5: omorfadramou ($166.50 in chips) 
Seat 6: choupai ($16.03 in chips) 
Seat 7: ruslik_by ($100 in chips) 
Seat 8: Filojoes ($136.24 in chips) 
Seat 9: butcheN18 ($100 in chips) 
butcheN18: posts small blind $0.50
vrnMike: posts big blind $1
*** HOLE CARDS ***
Dealt to matiko09 [Td 8c]
Westpants: folds 
Foton18: folds 
matiko09: folds 
omorfadramou: folds 
choupai: raises $2 to $3
ruslik_by: folds 
Filojoes: folds 
butcheN18: folds 
vrnMike: folds 
Uncalled bet ($2) returned to choupai
choupai collected $2.50 from pot
choupai: doesn't show hand 
*** SUMMARY ***
Total pot $2.50 | Rake $0 
Seat 1: vrnMike (big blind) folded before Flop
Seat 2: Westpants folded before Flop (didn't bet)
Seat 3: Foton18 folded before Flop (didn't bet)
Seat 4: matiko09 folded before Flop (didn't bet)
Seat 5: omorfadramou folded before Flop (didn't bet)
Seat 6: choupai collected ($2.50)
Seat 7: ruslik_by folded before Flop (didn't bet)
Seat 8: Filojoes (button) folded before Flop (didn't bet)
Seat 9: butcheN18 (small blind) folded before Flop





PokerStars Hand #151943730871:  Hold'em No Limit ($1/$2 USD) - 2016/04/15 14:05:46 CET [2016/04/15 8:05:46 ET]
Table 'Oceax' 9-max Seat #1 is the button
Seat 1: matiko09 ($200 in chips) 
Seat 2: Fish4trips ($333.38 in chips) 
Seat 3: Glushchenko ($200 in chips) 
Seat 4: butcheN18 ($254.46 in chips) 
Seat 5: derrocco82 ($195 in chips) 
Seat 6: Iggso ($276.93 in chips) 
Seat 7: ssljvr ($242.25 in chips) 
Seat 8: Poroxide ($329.97 in chips) 
Seat 9: erfk1958 ($120.08 in chips) 
Fish4trips: posts small blind $1
Glushchenko: posts big blind $2
*** HOLE CARDS ***
Dealt to matiko09 [3d 8h]
butcheN18: folds 
derrocco82: folds 
Iggso: folds 
ssljvr: folds 
Poroxide: folds 
erfk1958: folds 
matiko09: folds 
Fish4trips: raises $3 to $5
Glushchenko: calls $3
*** FLOP *** [Jh Ts Ah]
Fish4trips: checks 
Glushchenko: checks 
*** TURN *** [Jh Ts Ah] [Qc]
Fish4trips: checks 
Glushchenko: bets $6.33
Fish4trips: calls $6.33
*** RIVER *** [Jh Ts Ah Qc] [Jc]
Fish4trips: checks 
Glushchenko: checks 
*** SHOW DOWN ***
Fish4trips: shows [As 3s] (two pair, Aces and Jacks)
Glushchenko: shows [Th Kd] (a straight, Ten to Ace)
Glushchenko collected $21.53 from pot
*** SUMMARY ***
Total pot $22.66 | Rake $1.13 
Board [Jh Ts Ah Qc Jc]
Seat 1: matiko09 (button) folded before Flop (didn't bet)
Seat 2: Fish4trips (small blind) showed [As 3s] and lost with two pair, Aces and Jacks
Seat 3: Glushchenko (big blind) showed [Th Kd] and won ($21.53) with a straight, Ten to Ace
Seat 4: butcheN18 folded before Flop (didn't bet)
Seat 5: derrocco82 folded before Flop (didn't bet)
Seat 6: Iggso folded before Flop (didn't bet)
Seat 7: ssljvr folded before Flop (didn't bet)
Seat 8: Poroxide folded before Flop (didn't bet)
Seat 9: erfk1958 folded before Flop (didn't bet)





PokerStars Hand #151943730961:  Hold'em No Limit ($1/$2 USD) - 2016/04/15 14:05:46 CET [2016/04/15 8:05:46 ET]
Table 'Blaauw' 9-max Seat #3 is the button
Seat 1: myatiy 96 ($204 in chips) 
Seat 2: butcheN18 ($258.60 in chips) 
Seat 3: Glushchenko ($225.11 in chips) 
Seat 4: petro0107 ($212.19 in chips) 
Seat 5: tipner ($213.40 in chips) 
Seat 6: matiko09 ($242.65 in chips) 
Seat 7: ssljvr ($416.95 in chips) 
Seat 8: Iggso ($204.50 in chips) 
Seat 9: coinflip_si ($203.89 in chips) 
petro0107: posts small blind $1
tipner: posts big blind $2
*** HOLE CARDS ***
Dealt to matiko09 [9c Kd]
matiko09: folds 
ssljvr: folds 
Iggso: folds 
coinflip_si: folds 
myatiy 96: folds 
butcheN18: folds 
Glushchenko: folds 
petro0107: calls $1
tipner: checks 
*** FLOP *** [Jc 4d 3c]
petro0107: checks 
tipner: checks 
*** TURN *** [Jc 4d 3c] [Kh]
petro0107: bets $2
tipner: folds 
Uncalled bet ($2) returned to petro0107
petro0107 collected $3.80 from pot
petro0107: doesn't show hand 
*** SUMMARY ***
Total pot $4 | Rake $0.20 
Board [Jc 4d 3c Kh]
Seat 1: myatiy 96 folded before Flop (didn't bet)
Seat 2: butcheN18 folded before Flop (didn't bet)
Seat 3: Glushchenko (button) folded before Flop (didn't bet)
Seat 4: petro0107 (small blind) collected ($3.80)
Seat 5: tipner (big blind) folded on the Turn
Seat 6: matiko09 folded before Flop (didn't bet)
Seat 7: ssljvr folded before Flop (didn't bet)
Seat 8: Iggso folded before Flop (didn't bet)
Seat 9: coinflip_si folded before Flop (didn't bet)





PokerStars Hand #151943731509:  Hold'em No Limit ($0.50/$1.00 USD) - 2016/04/15 14:05:47 CET [2016/04/15 8:05:47 ET]
Table 'Emma II' 9-max Seat #6 is the button
Seat 1: omorfadramou ($104.50 in chips) 
Seat 2: Filojoes ($100 in chips) 
Seat 3: Glushchenko ($272.29 in chips) 
Seat 4: matiko09 ($100 in chips) 
Seat 5: Prettyspitz ($100 in chips) 
Seat 6: Tirka ($87.71 in chips) 
Seat 7: ruslik_by ($105.50 in chips) 
Seat 8: Pamboui ($40 in chips) 
Seat 9: Foton18 ($141.84 in chips) 
ruslik_by: posts small blind $0.50
Pamboui: posts big blind $1
*** HOLE CARDS ***
Dealt to matiko09 [9s Kh]
Foton18: raises $2 to $3
omorfadramou: folds 
Filojoes: calls $3
Glushchenko: calls $3
matiko09: folds 
Prettyspitz: folds 
Tirka: folds 
ruslik_by: calls $2.50
Pamboui: calls $2
*** FLOP *** [4d Jh Ac]
ruslik_by: checks 
Pamboui: bets $37 and is all-in
Foton18: folds 
Filojoes: calls $37
Glushchenko: folds 
ruslik_by: folds 
*** TURN *** [4d Jh Ac] [2s]
*** RIVER *** [4d Jh Ac 2s] [8s]
*** SHOW DOWN ***
Pamboui: shows [As 7d] (a pair of Aces)
Filojoes: shows [Kc Ah] (a pair of Aces - King kicker)
Filojoes collected $86.50 from pot
*** SUMMARY ***
Total pot $89 | Rake $2.50 
Board [4d Jh Ac 2s 8s]
Seat 1: omorfadramou folded before Flop (didn't bet)
Seat 2: Filojoes showed [Kc Ah] and won ($86.50) with a pair of Aces
Seat 3: Glushchenko folded on the Flop
Seat 4: matiko09 folded before Flop (didn't bet)
Seat 5: Prettyspitz folded before Flop (didn't bet)
Seat 6: Tirka (button) folded before Flop (didn't bet)
Seat 7: ruslik_by (small blind) folded on the Flop
Seat 8: Pamboui (big blind) showed [As 7d] and lost with a pair of Aces
Seat 9: Foton18 folded on the Flop





PokerStars Hand #151943753085:  Hold'em No Limit ($1/$2 USD) - 2016/04/15 14:06:30 CET [2016/04/15 8:06:30 ET]
Table 'Blaauw' 9-max Seat #4 is the button
Seat 1: myatiy 96 ($204 in chips) 
Seat 2: butcheN18 ($258.60 in chips) 
Seat 3: Glushchenko ($225.11 in chips) 
Seat 4: petro0107 ($213.99 in chips) 
Seat 5: tipner ($211.40 in chips) 
Seat 6: matiko09 ($242.65 in chips) 
Seat 7: ssljvr ($416.95 in chips) 
Seat 8: Iggso ($204.50 in chips) 
Seat 9: coinflip_si ($203.89 in chips) 
tipner: posts small blind $1
matiko09: posts big blind $2
*** HOLE CARDS ***
Dealt to matiko09 [Tc 7h]
ssljvr: folds 
Iggso: folds 
coinflip_si: folds 
myatiy 96: folds 
butcheN18: raises $4 to $6
Glushchenko: folds 
petro0107: calls $6
tipner: folds 
matiko09: folds 
*** FLOP *** [As 4c 4d]
butcheN18: bets $8.41
petro0107: calls $8.41
*** TURN *** [As 4c 4d] [8s]
butcheN18: checks 
petro0107: bets $10
butcheN18: folds 
Uncalled bet ($10) returned to petro0107
petro0107 collected $30.23 from pot
petro0107: doesn't show hand 
*** SUMMARY ***
Total pot $31.82 | Rake $1.59 
Board [As 4c 4d 8s]
Seat 1: myatiy 96 folded before Flop (didn't bet)
Seat 2: butcheN18 folded on the Turn
Seat 3: Glushchenko folded before Flop (didn't bet)
Seat 4: petro0107 (button) collected ($30.23)
Seat 5: tipner (small blind) folded before Flop
Seat 6: matiko09 (big blind) folded before Flop
Seat 7: ssljvr folded before Flop (didn't bet)
Seat 8: Iggso folded before Flop (didn't bet)
Seat 9: coinflip_si folded before Flop (didn't bet)





PokerStars Hand #151943754273:  Hold'em No Limit ($0.50/$1.00 USD) - 2016/04/15 14:06:32 CET [2016/04/15 8:06:32 ET]
Table 'Adelgunde III' 9-max Seat #5 is the button
Seat 3: tipner ($124.70 in chips) 
Seat 4: hammerwife ($120.73 in chips) 
Seat 5: matiko09 ($134.75 in chips) 
Seat 6: Pominator92 ($164.52 in chips) 
Seat 7: Yaaaazz ($100 in chips) 
Seat 8: SanychStar ($128.56 in chips) 
Seat 9: Kukuryzka ($101.93 in chips) 
Pominator92: posts small blind $0.50
Yaaaazz: posts big blind $1
Vikulja1993: sits out 
*** HOLE CARDS ***
Dealt to matiko09 [9c Td]
SanychStar: folds 
Kukuryzka: raises $2 to $3
tipner: folds 
hammerwife: folds 
matiko09: folds 
Pominator92: folds 
Yaaaazz: folds 
Uncalled bet ($2) returned to Kukuryzka
Kukuryzka collected $2.50 from pot
Kukuryzka: doesn't show hand 
*** SUMMARY ***
Total pot $2.50 | Rake $0 
Seat 3: tipner folded before Flop (didn't bet)
Seat 4: hammerwife folded before Flop (didn't bet)
Seat 5: matiko09 (button) folded before Flop (didn't bet)
Seat 6: Pominator92 (small blind) folded before Flop
Seat 7: Yaaaazz (big blind) folded before Flop
Seat 8: SanychStar folded before Flop (didn't bet)
Seat 9: Kukuryzka collected ($2.50)





PokerStars Hand #151943755195:  Hold'em No Limit ($1/$2 USD) - 2016/04/15 14:06:34 CET [2016/04/15 8:06:34 ET]
Table 'Adele II' 9-max Seat #6 is the button
Seat 1: RyanHuJun ($345.17 in chips) 
Seat 2: Fish4trips ($326.54 in chips) 
Seat 3: matiko09 ($305.88 in chips) 
Seat 4: Glushchenko ($210.05 in chips) 
Seat 5: TonnaMunz ($203 in chips) 
Seat 6: Kukuryzka ($224.25 in chips) 
Seat 7: Iggso ($230.84 in chips) 
Seat 8: butcheN18 ($200 in chips) 
Seat 9: SanychStar ($279.60 in chips) 
Iggso: posts small blind $1
butcheN18: posts big blind $2
*** HOLE CARDS ***
Dealt to matiko09 [6d 4d]
SanychStar: folds 
RyanHuJun: folds 
Fish4trips: folds 
matiko09: folds 
Glushchenko: folds 
TonnaMunz: folds 
Kukuryzka: raises $2 to $4
Iggso: folds 
butcheN18: calls $2
*** FLOP *** [8d Kc Js]
butcheN18: checks 
Kukuryzka: checks 
*** TURN *** [8d Kc Js] [Jc]
butcheN18: checks 
Kukuryzka: bets $4
butcheN18: calls $4
*** RIVER *** [8d Kc Js Jc] [Kd]
butcheN18: checks 
Kukuryzka: bets $5
butcheN18: calls $5
*** SHOW DOWN ***
Kukuryzka: shows [7s 7d] (two pair, Kings and Jacks)
butcheN18: shows [6s As] (two pair, Kings and Jacks - Ace kicker)
butcheN18 collected $25.65 from pot
*** SUMMARY ***
Total pot $27 | Rake $1.35 
Board [8d Kc Js Jc Kd]
Seat 1: RyanHuJun folded before Flop (didn't bet)
Seat 2: Fish4trips folded before Flop (didn't bet)
Seat 3: matiko09 folded before Flop (didn't bet)
Seat 4: Glushchenko folded before Flop (didn't bet)
Seat 5: TonnaMunz folded before Flop (didn't bet)
Seat 6: Kukuryzka (button) showed [7s 7d] and lost with two pair, Kings and Jacks
Seat 7: Iggso (small blind) folded before Flop
Seat 8: butcheN18 (big blind) showed [6s As] and won ($25.65) with two pair, Kings and Jacks
Seat 9: SanychStar folded before Flop (didn't bet)





PokerStars Hand #151943756853:  Hold'em No Limit ($1/$2 USD) - 2016/04/15 14:06:37 CET [2016/04/15 8:06:37 ET]
Table 'Marmara II' 9-max Seat #9 is the button
Seat 1: ssljvr ($489.98 in chips) 
Seat 2: Iggso ($205 in chips) 
Seat 3: Glushchenko ($208.31 in chips) 
Seat 4: Fish4trips ($252.96 in chips) 
Seat 5: docmarc777 ($216.30 in chips) 
Seat 6: azzad2007 ($200 in chips) 
Seat 7: matiko09 ($205 in chips) 
Seat 8: Dachish ($139 in chips) 
Seat 9: erfk1958 ($130.25 in chips) 
ssljvr: posts small blind $1
Iggso: posts big blind $2
*** HOLE CARDS ***
Dealt to matiko09 [Td 7h]
Glushchenko: folds 
Fish4trips: raises $3 to $5
docmarc777: calls $5
azzad2007: folds 
matiko09: folds 
Dachish: folds 
erfk1958: folds 
ssljvr: folds 
Iggso: raises $19 to $24
Fish4trips: folds 
docmarc777: calls $19
*** FLOP *** [Tc 8d Ts]
Iggso: bets $22
docmarc777: raises $22 to $44
Iggso: calls $22
*** TURN *** [Tc 8d Ts] [6s]
Iggso: checks 
docmarc777: bets $70
Iggso: raises $67 to $137 and is all-in
docmarc777: calls $67
*** RIVER *** [Tc 8d Ts 6s] [5s]
*** SHOW DOWN ***
Iggso: shows [Kd Kc] (two pair, Kings and Tens)
docmarc777: shows [8s 8c] (a full house, Eights full of Tens)
docmarc777 collected $413.25 from pot
*** SUMMARY ***
Total pot $416 | Rake $2.75 
Board [Tc 8d Ts 6s 5s]
Seat 1: ssljvr (small blind) folded before Flop
Seat 2: Iggso (big blind) showed [Kd Kc] and lost with two pair, Kings and Tens
Seat 3: Glushchenko folded before Flop (didn't bet)
Seat 4: Fish4trips folded before Flop
Seat 5: docmarc777 showed [8s 8c] and won ($413.25) with a full house, Eights full of Tens
Seat 6: azzad2007 folded before Flop (didn't bet)
Seat 7: matiko09 folded before Flop (didn't bet)
Seat 8: Dachish folded before Flop (didn't bet)
Seat 9: erfk1958 (button) folded before Flop (didn't bet)





PokerStars Hand #151943760148:  Hold'em No Limit ($0.50/$1.00 USD) - 2016/04/15 14:06:43 CET [2016/04/15 8:06:43 ET]
Table 'Chiny II' 9-max Seat #9 is the button
Seat 1: vrnMike ($159.56 in chips) 
Seat 2: Westpants ($150.19 in chips) 
Seat 3: Foton18 ($63.42 in chips) 
Seat 4: matiko09 ($174.40 in chips) 
Seat 5: omorfadramou ($166.50 in chips) 
Seat 6: choupai ($17.53 in chips) 
Seat 7: ruslik_by ($100 in chips) 
Seat 8: Filojoes ($136.24 in chips) 
Seat 9: butcheN18 ($100 in chips) 
vrnMike: posts small blind $0.50
Westpants: posts big blind $1
*** HOLE CARDS ***
Dealt to matiko09 [7c 6d]
Foton18: raises $2 to $3
matiko09: folds 
omorfadramou: folds 
choupai: folds 
ruslik_by: folds 
Filojoes: folds 
butcheN18: calls $3
vrnMike: folds 
Westpants: folds 
*** FLOP *** [2h 9s 4d]
Foton18: bets $4
butcheN18: calls $4
*** TURN *** [2h 9s 4d] [Ac]
Foton18: bets $10
butcheN18: folds 
Uncalled bet ($10) returned to Foton18
Foton18 collected $14.72 from pot
Foton18: doesn't show hand 
*** SUMMARY ***
Total pot $15.50 | Rake $0.78 
Board [2h 9s 4d Ac]
Seat 1: vrnMike (small blind) folded before Flop
Seat 2: Westpants (big blind) folded before Flop
Seat 3: Foton18 collected ($14.72)
Seat 4: matiko09 folded before Flop (didn't bet)
Seat 5: omorfadramou folded before Flop (didn't bet)
Seat 6: choupai folded before Flop (didn't bet)
Seat 7: ruslik_by folded before Flop (didn't bet)
Seat 8: Filojoes folded before Flop (didn't bet)
Seat 9: butcheN18 (button) folded on the Turn





PokerStars Hand #151943760796:  Hold'em No Limit ($0.50/$1.00 USD) - 2016/04/15 14:06:45 CET [2016/04/15 8:06:45 ET]
Table 'Navi' 9-max Seat #5 is the button
Seat 1: tipner ($114.83 in chips) 
Seat 2: myatiy 96 ($100 in chips) 
Seat 4: Pvsx. ($100 in chips) 
Seat 5: hammerwife ($100 in chips) 
Seat 6: Vikulja1993 ($111.70 in chips) 
Seat 8: ruslik_by ($100 in chips) 
Seat 9: matiko09 ($125.63 in chips) 
Vikulja1993: posts small blind $0.50
ruslik_by: posts big blind $1
vrnMike: sits out 
*** HOLE CARDS ***
Dealt to matiko09 [Ks Tc]
matiko09: folds 
tipner: folds 
myatiy 96: folds 
Pvsx.: folds 
hammerwife: folds 
Vikulja1993: raises $1.50 to $2.50
ruslik_by: calls $1.50
*** FLOP *** [4c Th 8s]
Vikulja1993: checks 
ruslik_by: bets $2
Vikulja1993: calls $2
*** TURN *** [4c Th 8s] [7c]
Vikulja1993: checks 
ruslik_by: bets $4
Vikulja1993: calls $4
*** RIVER *** [4c Th 8s 7c] [7s]
Vikulja1993: checks 
ruslik_by: checks 
*** SHOW DOWN ***
Vikulja1993: shows [Qh Qd] (two pair, Queens and Sevens)
ruslik_by: mucks hand 
Vikulja1993 collected $16.15 from pot
*** SUMMARY ***
Total pot $17 | Rake $0.85 
Board [4c Th 8s 7c 7s]
Seat 1: tipner folded before Flop (didn't bet)
Seat 2: myatiy 96 folded before Flop (didn't bet)
Seat 4: Pvsx. folded before Flop (didn't bet)
Seat 5: hammerwife (button) folded before Flop (didn't bet)
Seat 6: Vikulja1993 (small blind) showed [Qh Qd] and won ($16.15) with two pair, Queens and Sevens
Seat 8: ruslik_by (big blind) mucked [As 6s]
Seat 9: matiko09 folded before Flop (didn't bet)





PokerStars Hand #151943764319:  Hold'em No Limit ($1/$2 USD) - 2016/04/15 14:06:52 CET [2016/04/15 8:06:52 ET]
Table 'Oceax' 9-max Seat #2 is the button
Seat 1: matiko09 ($200 in chips) 
Seat 2: Fish4trips ($322.05 in chips) 
Seat 3: Glushchenko ($210.20 in chips) 
Seat 4: butcheN18 ($254.46 in chips) 
Seat 5: derrocco82 ($195 in chips) 
Seat 6: Iggso ($276.93 in chips) 
Seat 7: ssljvr ($242.25 in chips) 
Seat 8: Poroxide ($329.97 in chips) 
Seat 9: erfk1958 ($120.08 in chips) 
Glushchenko: posts small blind $1
butcheN18: posts big blind $2
*** HOLE CARDS ***
Dealt to matiko09 [8d 2h]
derrocco82: folds 
Iggso: folds 
ssljvr: folds 
Poroxide: folds 
erfk1958: folds 
matiko09: folds 
Fish4trips: raises $2 to $4
Glushchenko: folds 
butcheN18: folds 
Uncalled bet ($2) returned to Fish4trips
Fish4trips collected $5 from pot
Fish4trips: doesn't show hand 
*** SUMMARY ***
Total pot $5 | Rake $0 
Seat 1: matiko09 folded before Flop (didn't bet)
Seat 2: Fish4trips (button) collected ($5)
Seat 3: Glushchenko (small blind) folded before Flop
Seat 4: butcheN18 (big blind) folded before Flop
Seat 5: derrocco82 folded before Flop (didn't bet)
Seat 6: Iggso folded before Flop (didn't bet)
Seat 7: ssljvr folded before Flop (didn't bet)
Seat 8: Poroxide folded before Flop (didn't bet)
Seat 9: erfk1958 folded before Flop (didn't bet)





PokerStars Hand #151943768754:  Hold'em No Limit ($0.50/$1.00 USD) - 2016/04/15 14:07:00 CET [2016/04/15 8:07:00 ET]
Table 'Parvulesco II' 9-max Seat #3 is the button
Seat 1: bilukm ($91.59 in chips) 
Seat 2: Filojoes ($107.04 in chips) 
Seat 3: matiko09 ($113.45 in chips) 
Seat 4: butcheN18 ($100 in chips) 
Seat 5: maxxmeister ($101.50 in chips) 
Seat 6: ruslik_by ($122.98 in chips) 
Seat 7: Kukuryzka ($134.94 in chips) 
Seat 8: Jimy Tiltman ($113.42 in chips) 
Seat 9: hammerwife ($190.47 in chips) 
butcheN18: posts small blind $0.50
maxxmeister: posts big blind $1
*** HOLE CARDS ***
Dealt to matiko09 [Qs 2d]
ruslik_by: folds 
Kukuryzka: folds 
Jimy Tiltman: folds 
hammerwife: raises $1.50 to $2.50
bilukm: calls $2.50
Filojoes: folds 
matiko09: folds 
butcheN18: folds 
maxxmeister: calls $1.50
*** FLOP *** [6d 6c 2h]
maxxmeister: bets $5.51
hammerwife: folds 
bilukm: folds 
Uncalled bet ($5.51) returned to maxxmeister
maxxmeister collected $7.60 from pot
maxxmeister: doesn't show hand 
*** SUMMARY ***
Total pot $8 | Rake $0.40 
Board [6d 6c 2h]
Seat 1: bilukm folded on the Flop
Seat 2: Filojoes folded before Flop (didn't bet)
Seat 3: matiko09 (button) folded before Flop (didn't bet)
Seat 4: butcheN18 (small blind) folded before Flop
Seat 5: maxxmeister (big blind) collected ($7.60)
Seat 6: ruslik_by folded before Flop (didn't bet)
Seat 7: Kukuryzka folded before Flop (didn't bet)
Seat 8: Jimy Tiltman folded before Flop (didn't bet)
Seat 9: hammerwife folded on the Flop





PokerStars Hand #151943769523:  Hold'em No Limit ($0.50/$1.00 USD) - 2016/04/15 14:07:02 CET [2016/04/15 8:07:02 ET]
Table 'Adelgunde III' 9-max Seat #6 is the button
Seat 3: tipner ($124.70 in chips) 
Seat 4: hammerwife ($120.73 in chips) 
Seat 5: matiko09 ($134.75 in chips) 
Seat 6: Pominator92 ($164.02 in chips) 
Seat 7: Yaaaazz ($100 in chips) 
Seat 8: SanychStar ($128.56 in chips) 
Seat 9: Kukuryzka ($103.43 in chips) 
Yaaaazz: posts small blind $0.50
SanychStar: posts big blind $1
Vikulja1993: sits out 
*** HOLE CARDS ***
Dealt to matiko09 [Qd Th]
Kukuryzka: folds 
tipner: folds 
hammerwife: folds 
matiko09: raises $1.50 to $2.50
Pominator92: folds 
Yaaaazz: folds 
SanychStar: folds 
Uncalled bet ($1.50) returned to matiko09
matiko09 collected $2.50 from pot
matiko09: doesn't show hand 
*** SUMMARY ***
Total pot $2.50 | Rake $0 
Seat 3: tipner folded before Flop (didn't bet)
Seat 4: hammerwife folded before Flop (didn't bet)
Seat 5: matiko09 collected ($2.50)
Seat 6: Pominator92 (button) folded before Flop (didn't bet)
Seat 7: Yaaaazz (small blind) folded before Flop
Seat 8: SanychStar (big blind) folded before Flop
Seat 9: Kukuryzka folded before Flop (didn't bet)





PokerStars Hand #151943770190:  Hold'em No Limit ($0.50/$1.00 USD) - 2016/04/15 14:07:03 CET [2016/04/15 8:07:03 ET]
Table 'Emma II' 9-max Seat #7 is the button
Seat 1: omorfadramou ($104.50 in chips) 
Seat 2: Filojoes ($146.50 in chips) 
Seat 3: Glushchenko ($269.29 in chips) 
Seat 4: matiko09 ($100 in chips) 
Seat 5: Prettyspitz ($100 in chips) 
Seat 6: Tirka ($87.71 in chips) 
Seat 7: ruslik_by ($102.50 in chips) 
Seat 9: Foton18 ($138.84 in chips) 
Foton18: posts small blind $0.50
omorfadramou: posts big blind $1
*** HOLE CARDS ***
Dealt to matiko09 [7c 3s]
Pamboui leaves the table
Filojoes: folds 
Glushchenko: folds 
matiko09: folds 
Prettyspitz: folds 
Tirka: raises $2 to $3
ruslik_by: folds 
Foton18: folds 
omorfadramou: folds 
Uncalled bet ($2) returned to Tirka
Tirka collected $2.50 from pot
Tirka: doesn't show hand 
*** SUMMARY ***
Total pot $2.50 | Rake $0 
Seat 1: omorfadramou (big blind) folded before Flop
Seat 2: Filojoes folded before Flop (didn't bet)
Seat 3: Glushchenko folded before Flop (didn't bet)
Seat 4: matiko09 folded before Flop (didn't bet)
Seat 5: Prettyspitz folded before Flop (didn't bet)
Seat 6: Tirka collected ($2.50)
Seat 7: ruslik_by (button) folded before Flop (didn't bet)
Seat 9: Foton18 (small blind) folded before Flop





PokerStars Hand #151943779206:  Hold'em No Limit ($1/$2 USD) - 2016/04/15 14:07:21 CET [2016/04/15 8:07:21 ET]
Table 'Oceax' 9-max Seat #3 is the button
Seat 1: matiko09 ($200 in chips) 
Seat 2: Fish4trips ($325.05 in chips) 
Seat 3: Glushchenko ($209.20 in chips) 
Seat 4: butcheN18 ($252.46 in chips) 
Seat 5: derrocco82 ($195 in chips) 
Seat 6: Iggso ($276.93 in chips) 
Seat 7: ssljvr ($242.25 in chips) 
Seat 8: Poroxide ($329.97 in chips) 
Seat 9: erfk1958 ($120.08 in chips) 
butcheN18: posts small blind $1
derrocco82: posts big blind $2
*** HOLE CARDS ***
Dealt to matiko09 [Th 8c]
Iggso: folds 
ssljvr: folds 
Poroxide: folds 
erfk1958: folds 
matiko09: folds 
Fish4trips: raises $3 to $5
Glushchenko: folds 
butcheN18: folds 
derrocco82: folds 
Uncalled bet ($3) returned to Fish4trips
Fish4trips collected $5 from pot
Fish4trips: doesn't show hand 
*** SUMMARY ***
Total pot $5 | Rake $0 
Seat 1: matiko09 folded before Flop (didn't bet)
Seat 2: Fish4trips collected ($5)
Seat 3: Glushchenko (button) folded before Flop (didn't bet)
Seat 4: butcheN18 (small blind) folded before Flop
Seat 5: derrocco82 (big blind) folded before Flop
Seat 6: Iggso folded before Flop (didn't bet)
Seat 7: ssljvr folded before Flop (didn't bet)
Seat 8: Poroxide folded before Flop (didn't bet)
Seat 9: erfk1958 folded before Flop (didn't bet)





PokerStars Hand #151943785648:  Hold'em No Limit ($0.50/$1.00 USD) - 2016/04/15 14:07:34 CET [2016/04/15 8:07:34 ET]
Table 'Adelgunde III' 9-max Seat #7 is the button
Seat 3: tipner ($124.70 in chips) 
Seat 4: hammerwife ($120.73 in chips) 
Seat 5: matiko09 ($136.25 in chips) 
Seat 6: Pominator92 ($164.02 in chips) 
Seat 7: Yaaaazz ($100 in chips) 
Seat 8: SanychStar ($127.56 in chips) 
Seat 9: Kukuryzka ($103.43 in chips) 
SanychStar: posts small blind $0.50
Kukuryzka: posts big blind $1
Vikulja1993: sits out 
*** HOLE CARDS ***
Dealt to matiko09 [5h Qc]
tipner: folds 
hammerwife: raises $1.50 to $2.50
matiko09: folds 
Pominator92: folds 
Yaaaazz: folds 
SanychStar: folds 
Kukuryzka: folds 
Uncalled bet ($1.50) returned to hammerwife
hammerwife collected $2.50 from pot
hammerwife: doesn't show hand 
*** SUMMARY ***
Total pot $2.50 | Rake $0 
Seat 3: tipner folded before Flop (didn't bet)
Seat 4: hammerwife collected ($2.50)
Seat 5: matiko09 folded before Flop (didn't bet)
Seat 6: Pominator92 folded before Flop (didn't bet)
Seat 7: Yaaaazz (button) folded before Flop (didn't bet)
Seat 8: SanychStar (small blind) folded before Flop
Seat 9: Kukuryzka (big blind) folded before Flop





PokerStars Hand #151943787837:  Hold'em No Limit ($1/$2 USD) - 2016/04/15 14:07:38 CET [2016/04/15 8:07:38 ET]
Table 'Blaauw' 9-max Seat #5 is the button
Seat 1: myatiy 96 ($204 in chips) 
Seat 2: butcheN18 ($244.19 in chips) 
Seat 3: Glushchenko ($225.11 in chips) 
Seat 4: petro0107 ($229.81 in chips) 
Seat 5: tipner ($210.40 in chips) 
Seat 6: matiko09 ($240.65 in chips) 
Seat 7: ssljvr ($416.95 in chips) 
Seat 8: Iggso ($204.50 in chips) 
Seat 9: coinflip_si ($203.89 in chips) 
matiko09: posts small blind $1
ssljvr: posts big blind $2
*** HOLE CARDS ***
Dealt to matiko09 [Td 8c]
Iggso: folds 
coinflip_si: raises $3 to $5
myatiy 96: folds 
butcheN18: folds 
Glushchenko: folds 
petro0107: calls $5
tipner: folds 
matiko09: folds 
ssljvr: folds 
*** FLOP *** [Jc 4d Ks]
coinflip_si: bets $7.66
petro0107: calls $7.66
*** TURN *** [Jc 4d Ks] [Js]
coinflip_si: checks 
petro0107: bets $10
coinflip_si: calls $10
*** RIVER *** [Jc 4d Ks Js] [Jd]
coinflip_si: checks 
petro0107: bets $20
coinflip_si: calls $20
*** SHOW DOWN ***
petro0107: shows [6c Kc] (a full house, Jacks full of Kings)
coinflip_si: mucks hand 
petro0107 collected $85.57 from pot
*** SUMMARY ***
Total pot $88.32 | Rake $2.75 
Board [Jc 4d Ks Js Jd]
Seat 1: myatiy 96 folded before Flop (didn't bet)
Seat 2: butcheN18 folded before Flop (didn't bet)
Seat 3: Glushchenko folded before Flop (didn't bet)
Seat 4: petro0107 showed [6c Kc] and won ($85.57) with a full house, Jacks full of Kings
Seat 5: tipner (button) folded before Flop (didn't bet)
Seat 6: matiko09 (small blind) folded before Flop
Seat 7: ssljvr (big blind) folded before Flop
Seat 8: Iggso folded before Flop (didn't bet)
Seat 9: coinflip_si mucked [As Qc]





PokerStars Hand #151943789706:  Hold'em No Limit ($0.50/$1.00 USD) - 2016/04/15 14:07:42 CET [2016/04/15 8:07:42 ET]
Table 'Navi' 9-max Seat #6 is the button
Seat 1: tipner ($114.83 in chips) 
Seat 2: myatiy 96 ($100 in chips) 
Seat 4: Pvsx. ($100 in chips) 
Seat 5: hammerwife ($100 in chips) 
Seat 6: Vikulja1993 ($119.35 in chips) 
Seat 8: ruslik_by ($100 in chips) 
Seat 9: matiko09 ($125.63 in chips) 
ruslik_by: posts small blind $0.50
matiko09: posts big blind $1
vrnMike: sits out 
*** HOLE CARDS ***
Dealt to matiko09 [8d 6s]
tipner: folds 
myatiy 96: folds 
Pvsx.: raises $1.50 to $2.50
hammerwife: folds 
Vikulja1993: folds 
ruslik_by: folds 
matiko09: folds 
Uncalled bet ($1.50) returned to Pvsx.
Pvsx. collected $2.50 from pot
Pvsx.: doesn't show hand 
*** SUMMARY ***
Total pot $2.50 | Rake $0 
Seat 1: tipner folded before Flop (didn't bet)
Seat 2: myatiy 96 folded before Flop (didn't bet)
Seat 4: Pvsx. collected ($2.50)
Seat 5: hammerwife folded before Flop (didn't bet)
Seat 6: Vikulja1993 (button) folded before Flop (didn't bet)
Seat 8: ruslik_by (small blind) folded before Flop
Seat 9: matiko09 (big blind) folded before Flop





PokerStars Hand #151943795620:  Hold'em No Limit ($0.50/$1.00 USD) - 2016/04/15 14:07:53 CET [2016/04/15 8:07:53 ET]
Table 'Chiny II' 9-max Seat #1 is the button
Seat 1: vrnMike ($159.06 in chips) 
Seat 2: Westpants ($149.19 in chips) 
Seat 3: Foton18 ($71.14 in chips) 
Seat 4: matiko09 ($174.40 in chips) 
Seat 5: omorfadramou ($166.50 in chips) 
Seat 6: choupai ($17.53 in chips) 
Seat 7: ruslik_by ($100 in chips) 
Seat 8: Filojoes ($136.24 in chips) 
Seat 9: butcheN18 ($100 in chips) 
Westpants: posts small blind $0.50
Foton18: posts big blind $1
*** HOLE CARDS ***
Dealt to matiko09 [6h 2c]
matiko09: folds 
omorfadramou: folds 
choupai: raises $2 to $3
ruslik_by: folds 
Filojoes: folds 
butcheN18: folds 
vrnMike: folds 
Westpants: folds 
Foton18: calls $2
*** FLOP *** [Jh 2s Kc]
Foton18: bets $2
choupai: calls $2
*** TURN *** [Jh 2s Kc] [Ad]
Foton18: bets $10
choupai: folds 
Uncalled bet ($10) returned to Foton18
Foton18 collected $9.98 from pot
Foton18: doesn't show hand 
*** SUMMARY ***
Total pot $10.50 | Rake $0.52 
Board [Jh 2s Kc Ad]
Seat 1: vrnMike (button) folded before Flop (didn't bet)
Seat 2: Westpants (small blind) folded before Flop
Seat 3: Foton18 (big blind) collected ($9.98)
Seat 4: matiko09 folded before Flop (didn't bet)
Seat 5: omorfadramou folded before Flop (didn't bet)
Seat 6: choupai folded on the Turn
Seat 7: ruslik_by folded before Flop (didn't bet)
Seat 8: Filojoes folded before Flop (didn't bet)
Seat 9: butcheN18 folded before Flop (didn't bet)





PokerStars Hand #151943796208:  Hold'em No Limit ($0.50/$1.00 USD) - 2016/04/15 14:07:54 CET [2016/04/15 8:07:54 ET]
Table 'Emma II' 9-max Seat #9 is the button
Seat 1: omorfadramou ($103.50 in chips) 
Seat 2: Filojoes ($146.50 in chips) 
Seat 3: Glushchenko ($269.29 in chips) 
Seat 4: matiko09 ($100 in chips) 
Seat 5: Prettyspitz ($100 in chips) 
Seat 6: Tirka ($89.21 in chips) 
Seat 7: ruslik_by ($102.50 in chips) 
Seat 9: Foton18 ($138.34 in chips) 
omorfadramou: posts small blind $0.50
Filojoes: posts big blind $1
*** HOLE CARDS ***
Dealt to matiko09 [4s 2c]
Glushchenko: raises $2 to $3
matiko09: folds 
Prettyspitz: folds 
Tirka: folds 
ruslik_by: folds 
Foton18: folds 
omorfadramou: folds 
Vikulja1993 joins the table at seat #8 
Filojoes: folds 
Uncalled bet ($2) returned to Glushchenko
Glushchenko collected $2.50 from pot
Vikulja1993 leaves the table
*** SUMMARY ***
Total pot $2.50 | Rake $0 
Seat 1: omorfadramou (small blind) folded before Flop
Seat 2: Filojoes (big blind) folded before Flop
Seat 3: Glushchenko collected ($2.50)
Seat 4: matiko09 folded before Flop (didn't bet)
Seat 5: Prettyspitz folded before Flop (didn't bet)
Seat 6: Tirka folded before Flop (didn't bet)
Seat 7: ruslik_by folded before Flop (didn't bet)
Seat 9: Foton18 (button) folded before Flop (didn't bet)





PokerStars Hand #151943799268:  Hold'em No Limit ($1/$2 USD) - 2016/04/15 14:08:00 CET [2016/04/15 8:08:00 ET]
Table 'Oceax' 9-max Seat #4 is the button
Seat 1: matiko09 ($200 in chips) 
Seat 2: Fish4trips ($328.05 in chips) 
Seat 3: Glushchenko ($209.20 in chips) 
Seat 4: butcheN18 ($251.46 in chips) 
Seat 5: derrocco82 ($193 in chips) 
Seat 6: Iggso ($276.93 in chips) 
Seat 7: ssljvr ($242.25 in chips) 
Seat 8: Poroxide ($329.97 in chips) 
Seat 9: erfk1958 ($120.08 in chips) 
derrocco82: posts small blind $1
Iggso: posts big blind $2
*** HOLE CARDS ***
Dealt to matiko09 [3h 4s]
ssljvr: folds 
Poroxide: folds 
erfk1958: folds 
matiko09: folds 
Fish4trips: folds 
Glushchenko: folds 
butcheN18: folds 
derrocco82: folds 
Uncalled bet ($1) returned to Iggso
Iggso collected $2 from pot
Iggso: doesn't show hand 
*** SUMMARY ***
Total pot $2 | Rake $0 
Seat 1: matiko09 folded before Flop (didn't bet)
Seat 2: Fish4trips folded before Flop (didn't bet)
Seat 3: Glushchenko folded before Flop (didn't bet)
Seat 4: butcheN18 (button) folded before Flop (didn't bet)
Seat 5: derrocco82 (small blind) folded before Flop
Seat 6: Iggso (big blind) collected ($2)
Seat 7: ssljvr folded before Flop (didn't bet)
Seat 8: Poroxide folded before Flop (didn't bet)
Seat 9: erfk1958 folded before Flop (didn't bet)





PokerStars Hand #151943802140:  Hold'em No Limit ($1/$2 USD) - 2016/04/15 14:08:06 CET [2016/04/15 8:08:06 ET]
Table 'Marmara II' 9-max Seat #1 is the button
Seat 1: ssljvr ($488.98 in chips) 
Seat 2: Iggso ($200 in chips) 
Seat 3: Glushchenko ($208.31 in chips) 
Seat 4: Fish4trips ($247.96 in chips) 
Seat 5: docmarc777 ($424.55 in chips) 
Seat 6: azzad2007 ($200 in chips) 
Seat 7: matiko09 ($205 in chips) 
Seat 8: Dachish ($139 in chips) 
Seat 9: erfk1958 ($130.25 in chips) 
Iggso: posts small blind $1
Glushchenko: posts big blind $2
*** HOLE CARDS ***
Dealt to matiko09 [6h 7d]
Fish4trips: folds 
docmarc777: folds 
azzad2007: raises $4 to $6
matiko09: folds 
Dachish: folds 
erfk1958: folds 
ssljvr: folds 
Iggso: folds 
Glushchenko: raises $14 to $20
azzad2007: calls $14
*** FLOP *** [6s Ts 4d]
Glushchenko: bets $22
azzad2007: calls $22
*** TURN *** [6s Ts 4d] [Th]
Glushchenko: bets $47
azzad2007: raises $111 to $158 and is all-in
Glushchenko: calls $111
*** FIRST RIVER *** [6s Ts 4d Th] [Td]
*** SECOND RIVER *** [6s Ts 4d Th] [7c]
*** FIRST SHOW DOWN ***
Glushchenko: shows [Ac As] (a full house, Tens full of Aces)
azzad2007: shows [Ah Ad] (a full house, Tens full of Aces)
Glushchenko collected $99.57 from pot
azzad2007 collected $99.56 from pot
*** SECOND SHOW DOWN ***
Glushchenko: shows [Ac As] (two pair, Aces and Tens)
azzad2007: shows [Ah Ad] (two pair, Aces and Tens)
Glushchenko collected $99.56 from pot
azzad2007 collected $99.56 from pot
*** SUMMARY ***
Total pot $401 | Rake $2.75 
Hand was run twice
FIRST Board [6s Ts 4d Th Td]
SECOND Board [6s Ts 4d Th 7c]
Seat 1: ssljvr (button) folded before Flop (didn't bet)
Seat 2: Iggso (small blind) folded before Flop
Seat 3: Glushchenko (big blind) showed [Ac As] and won ($99.57) with a full house, Tens full of Aces, and won ($99.56) with two pair, Aces and Tens
Seat 4: Fish4trips folded before Flop (didn't bet)
Seat 5: docmarc777 folded before Flop (didn't bet)
Seat 6: azzad2007 showed [Ah Ad] and won ($99.56) with a full house, Tens full of Aces, and won ($99.56) with two pair, Aces and Tens
Seat 7: matiko09 folded before Flop (didn't bet)
Seat 8: Dachish folded before Flop (didn't bet)
Seat 9: erfk1958 folded before Flop (didn't bet)





PokerStars Hand #151943803058:  Hold'em No Limit ($1/$2 USD) - 2016/04/15 14:08:08 CET [2016/04/15 8:08:08 ET]
Table 'Adele II' 9-max Seat #7 is the button
Seat 1: RyanHuJun ($345.17 in chips) 
Seat 2: Fish4trips ($326.54 in chips) 
Seat 3: matiko09 ($305.88 in chips) 
Seat 4: Glushchenko ($210.05 in chips) 
Seat 5: TonnaMunz ($203 in chips) 
Seat 6: Kukuryzka ($211.25 in chips) 
Seat 7: Iggso ($229.84 in chips) 
Seat 8: butcheN18 ($212.65 in chips) 
Seat 9: SanychStar ($279.60 in chips) 
butcheN18: posts small blind $1
SanychStar: posts big blind $2
*** HOLE CARDS ***
Dealt to matiko09 [5s 3s]
RyanHuJun: folds 
Fish4trips: folds 
matiko09: folds 
Glushchenko: folds 
TonnaMunz: folds 
Kukuryzka: folds 
Iggso: folds 
butcheN18: folds 
Uncalled bet ($1) returned to SanychStar
SanychStar collected $2 from pot
*** SUMMARY ***
Total pot $2 | Rake $0 
Seat 1: RyanHuJun folded before Flop (didn't bet)
Seat 2: Fish4trips folded before Flop (didn't bet)
Seat 3: matiko09 folded before Flop (didn't bet)
Seat 4: Glushchenko folded before Flop (didn't bet)
Seat 5: TonnaMunz folded before Flop (didn't bet)
Seat 6: Kukuryzka folded before Flop (didn't bet)
Seat 7: Iggso (button) folded before Flop (didn't bet)
Seat 8: butcheN18 (small blind) folded before Flop
Seat 9: SanychStar (big blind) collected ($2)





PokerStars Hand #151943808229:  Hold'em No Limit ($0.50/$1.00 USD) - 2016/04/15 14:08:18 CET [2016/04/15 8:08:18 ET]
Table 'Parvulesco II' 9-max Seat #4 is the button
Seat 1: bilukm ($89.09 in chips) 
Seat 2: Filojoes ($107.04 in chips) 
Seat 3: matiko09 ($113.45 in chips) 
Seat 4: butcheN18 ($100 in chips) 
Seat 5: maxxmeister ($106.60 in chips) 
Seat 6: ruslik_by ($122.98 in chips) 
Seat 7: Kukuryzka ($134.94 in chips) 
Seat 8: Jimy Tiltman ($113.42 in chips) 
Seat 9: hammerwife ($187.97 in chips) 
maxxmeister: posts small blind $0.50
ruslik_by: posts big blind $1
*** HOLE CARDS ***
Dealt to matiko09 [Td 4s]
Kukuryzka: folds 
Jimy Tiltman: folds 
hammerwife: folds 
bilukm: calls $1
Filojoes: folds 
matiko09: folds 
butcheN18: folds 
maxxmeister: calls $0.50
ruslik_by: checks 
*** FLOP *** [Ah Ks 2h]
maxxmeister: checks 
ruslik_by: checks 
bilukm: checks 
*** TURN *** [Ah Ks 2h] [3s]
maxxmeister: checks 
ruslik_by: checks 
bilukm: bets $1
maxxmeister: folds 
ruslik_by: calls $1
*** RIVER *** [Ah Ks 2h 3s] [2s]
ruslik_by: checks 
bilukm: checks 
*** SHOW DOWN ***
ruslik_by: shows [Tc Qd] (a pair of Deuces)
bilukm: mucks hand 
ruslik_by collected $4.75 from pot
*** SUMMARY ***
Total pot $5 | Rake $0.25 
Board [Ah Ks 2h 3s 2s]
Seat 1: bilukm mucked [Jd 4d]
Seat 2: Filojoes folded before Flop (didn't bet)
Seat 3: matiko09 folded before Flop (didn't bet)
Seat 4: butcheN18 (button) folded before Flop (didn't bet)
Seat 5: maxxmeister (small blind) folded on the Turn
Seat 6: ruslik_by (big blind) showed [Tc Qd] and won ($4.75) with a pair of Deuces
Seat 7: Kukuryzka folded before Flop (didn't bet)
Seat 8: Jimy Tiltman folded before Flop (didn't bet)
Seat 9: hammerwife folded before Flop (didn't bet)





PokerStars Hand #151943809115:  Hold'em No Limit ($0.50/$1.00 USD) - 2016/04/15 14:08:19 CET [2016/04/15 8:08:19 ET]
Table 'Navi' 9-max Seat #8 is the button
Seat 1: tipner ($114.83 in chips) 
Seat 2: myatiy 96 ($100 in chips) 
Seat 4: Pvsx. ($101.50 in chips) 
Seat 5: hammerwife ($100 in chips) 
Seat 6: Vikulja1993 ($119.35 in chips) 
Seat 8: ruslik_by ($100 in chips) 
Seat 9: matiko09 ($124.63 in chips) 
matiko09: posts small blind $0.50
tipner: posts big blind $1
vrnMike: sits out 
*** HOLE CARDS ***
Dealt to matiko09 [Tc Ac]
myatiy 96: folds 
Pvsx.: folds 
hammerwife: folds 
Vikulja1993: folds 
ruslik_by: raises $1.50 to $2.50
matiko09: raises $6.50 to $9
tipner: folds 
ruslik_by: folds 
Uncalled bet ($6.50) returned to matiko09
matiko09 collected $6 from pot
matiko09: doesn't show hand 
*** SUMMARY ***
Total pot $6 | Rake $0 
Seat 1: tipner (big blind) folded before Flop
Seat 2: myatiy 96 folded before Flop (didn't bet)
Seat 4: Pvsx. folded before Flop (didn't bet)
Seat 5: hammerwife folded before Flop (didn't bet)
Seat 6: Vikulja1993 folded before Flop (didn't bet)
Seat 8: ruslik_by (button) folded before Flop
Seat 9: matiko09 (small blind) collected ($6)





PokerStars Hand #151943810165:  Hold'em No Limit ($0.50/$1.00 USD) - 2016/04/15 14:08:22 CET [2016/04/15 8:08:22 ET]
Table 'Adelgunde III' 9-max Seat #8 is the button
Seat 2: Vikulja1993 ($100 in chips) 
Seat 3: tipner ($124.70 in chips) 
Seat 4: hammerwife ($122.23 in chips) 
Seat 5: matiko09 ($136.25 in chips) 
Seat 6: Pominator92 ($164.02 in chips) 
Seat 7: Yaaaazz ($100 in chips) 
Seat 8: SanychStar ($127.06 in chips) 
Seat 9: Kukuryzka ($102.43 in chips) 
Kukuryzka: posts small blind $0.50
Vikulja1993: posts big blind $1
*** HOLE CARDS ***
Dealt to matiko09 [8h 8s]
tipner: folds 
hammerwife: folds 
matiko09: raises $2 to $3
Pominator92: folds 
Yaaaazz: folds 
SanychStar: folds 
Kukuryzka: folds 
Vikulja1993: calls $2
*** FLOP *** [Qc 8c 8d]
Vikulja1993: checks 
matiko09: bets $3.21
Vikulja1993: folds 
Uncalled bet ($3.21) returned to matiko09
matiko09 collected $6.18 from pot
matiko09: doesn't show hand 
*** SUMMARY ***
Total pot $6.50 | Rake $0.32 
Board [Qc 8c 8d]
Seat 2: Vikulja1993 (big blind) folded on the Flop
Seat 3: tipner folded before Flop (didn't bet)
Seat 4: hammerwife folded before Flop (didn't bet)
Seat 5: matiko09 collected ($6.18)
Seat 6: Pominator92 folded before Flop (didn't bet)
Seat 7: Yaaaazz folded before Flop (didn't bet)
Seat 8: SanychStar (button) folded before Flop (didn't bet)
Seat 9: Kukuryzka (small blind) folded before Flop





PokerStars Hand #151943812747:  Hold'em No Limit ($1/$2 USD) - 2016/04/15 14:08:26 CET [2016/04/15 8:08:26 ET]
Table 'Oceax' 9-max Seat #5 is the button
Seat 1: matiko09 ($200 in chips) 
Seat 2: Fish4trips ($328.05 in chips) 
Seat 3: Glushchenko ($209.20 in chips) 
Seat 4: butcheN18 ($251.46 in chips) 
Seat 5: derrocco82 ($192 in chips) 
Seat 6: Iggso ($277.93 in chips) 
Seat 7: ssljvr ($242.25 in chips) 
Seat 8: Poroxide ($329.97 in chips) 
Seat 9: erfk1958 ($120.08 in chips) 
Iggso: posts small blind $1
ssljvr: posts big blind $2
*** HOLE CARDS ***
Dealt to matiko09 [Ts Ac]
Poroxide: folds 
erfk1958: folds 
matiko09: folds 
Fish4trips: folds 
Glushchenko: raises $4 to $6
butcheN18: folds 
derrocco82: folds 
Iggso: folds 
ssljvr: calls $4
*** FLOP *** [6s 8d 3s]
ssljvr: checks 
Glushchenko: checks 
*** TURN *** [6s 8d 3s] [Td]
ssljvr: checks 
Glushchenko: checks 
*** RIVER *** [6s 8d 3s Td] [Kd]
ssljvr: bets $8.23
Glushchenko: folds 
Uncalled bet ($8.23) returned to ssljvr
ssljvr collected $12.35 from pot
ssljvr: doesn't show hand 
*** SUMMARY ***
Total pot $13 | Rake $0.65 
Board [6s 8d 3s Td Kd]
Seat 1: matiko09 folded before Flop (didn't bet)
Seat 2: Fish4trips folded before Flop (didn't bet)
Seat 3: Glushchenko folded on the River
Seat 4: butcheN18 folded before Flop (didn't bet)
Seat 5: derrocco82 (button) folded before Flop (didn't bet)
Seat 6: Iggso (small blind) folded before Flop
Seat 7: ssljvr (big blind) collected ($12.35)
Seat 8: Poroxide folded before Flop (didn't bet)
Seat 9: erfk1958 folded before Flop (didn't bet)





PokerStars Hand #151943815662:  Hold'em No Limit ($1/$2 USD) - 2016/04/15 14:08:32 CET [2016/04/15 8:08:32 ET]
Table 'Adele II' 9-max Seat #8 is the button
Seat 1: RyanHuJun ($345.17 in chips) 
Seat 2: Fish4trips ($326.54 in chips) 
Seat 3: matiko09 ($305.88 in chips) 
Seat 4: Glushchenko ($210.05 in chips) 
Seat 5: TonnaMunz ($203 in chips) 
Seat 6: Kukuryzka ($211.25 in chips) 
Seat 7: Iggso ($229.84 in chips) 
Seat 8: butcheN18 ($211.65 in chips) 
Seat 9: SanychStar ($280.60 in chips) 
SanychStar: posts small blind $1
RyanHuJun: posts big blind $2
*** HOLE CARDS ***
Dealt to matiko09 [Js Kh]
Fish4trips: folds 
matiko09: raises $3 to $5
Glushchenko: folds 
TonnaMunz: folds 
Kukuryzka: folds 
Iggso: folds 
butcheN18: folds 
SanychStar: folds 
RyanHuJun: calls $3
*** FLOP *** [7h Jh 6s]
RyanHuJun: checks 
matiko09: bets $6.79
RyanHuJun: folds 
Uncalled bet ($6.79) returned to matiko09
matiko09 collected $10.45 from pot
matiko09: doesn't show hand 
*** SUMMARY ***
Total pot $11 | Rake $0.55 
Board [7h Jh 6s]
Seat 1: RyanHuJun (big blind) folded on the Flop
Seat 2: Fish4trips folded before Flop (didn't bet)
Seat 3: matiko09 collected ($10.45)
Seat 4: Glushchenko folded before Flop (didn't bet)
Seat 5: TonnaMunz folded before Flop (didn't bet)
Seat 6: Kukuryzka folded before Flop (didn't bet)
Seat 7: Iggso folded before Flop (didn't bet)
Seat 8: butcheN18 (button) folded before Flop (didn't bet)
Seat 9: SanychStar (small blind) folded before Flop





PokerStars Hand #151943820249:  Hold'em No Limit ($0.50/$1.00 USD) - 2016/04/15 14:08:41 CET [2016/04/15 8:08:41 ET]
Table 'Emma II' 9-max Seat #1 is the button
Seat 1: omorfadramou ($103 in chips) 
Seat 2: Filojoes ($145.50 in chips) 
Seat 3: Glushchenko ($270.79 in chips) 
Seat 4: matiko09 ($100 in chips) 
Seat 5: Prettyspitz ($100 in chips) 
Seat 6: Tirka ($89.21 in chips) 
Seat 7: ruslik_by ($102.50 in chips) 
Seat 9: Foton18 ($138.34 in chips) 
Filojoes: posts small blind $0.50
Glushchenko: posts big blind $1
*** HOLE CARDS ***
Dealt to matiko09 [9c Ah]
matiko09: folds 
Prettyspitz: raises $2 to $3
Tirka: folds 
ruslik_by: folds 
Foton18: folds 
omorfadramou: folds 
Filojoes: calls $2.50
Glushchenko: folds 
*** FLOP *** [2d 3c 5s]
Filojoes: checks 
Prettyspitz: bets $5.18
Filojoes: folds 
Uncalled bet ($5.18) returned to Prettyspitz
Prettyspitz collected $6.65 from pot
Prettyspitz: doesn't show hand 
*** SUMMARY ***
Total pot $7 | Rake $0.35 
Board [2d 3c 5s]
Seat 1: omorfadramou (button) folded before Flop (didn't bet)
Seat 2: Filojoes (small blind) folded on the Flop
Seat 3: Glushchenko (big blind) folded before Flop
Seat 4: matiko09 folded before Flop (didn't bet)
Seat 5: Prettyspitz collected ($6.65)
Seat 6: Tirka folded before Flop (didn't bet)
Seat 7: ruslik_by folded before Flop (didn't bet)
Seat 9: Foton18 folded before Flop (didn't bet)





PokerStars Hand #151943826858:  Hold'em No Limit ($0.50/$1.00 USD) - 2016/04/15 14:08:54 CET [2016/04/15 8:08:54 ET]
Table 'Adelgunde III' 9-max Seat #9 is the button
Seat 2: Vikulja1993 ($100 in chips) 
Seat 3: tipner ($124.70 in chips) 
Seat 4: hammerwife ($122.23 in chips) 
Seat 5: matiko09 ($139.43 in chips) 
Seat 6: Pominator92 ($164.02 in chips) 
Seat 7: Yaaaazz ($100 in chips) 
Seat 8: SanychStar ($127.06 in chips) 
Seat 9: Kukuryzka ($101.93 in chips) 
Vikulja1993: posts small blind $0.50
tipner: posts big blind $1
*** HOLE CARDS ***
Dealt to matiko09 [7c 3s]
hammerwife: folds 
matiko09: folds 
Pominator92: calls $1
Yaaaazz: folds 
SanychStar: folds 
Kukuryzka: raises $3 to $4
Vikulja1993: folds 
tipner: folds 
Pominator92: calls $3
*** FLOP *** [5h 6c 4h]
Pominator92: checks 
Kukuryzka: bets $4.51
Pominator92: calls $4.51
*** TURN *** [5h 6c 4h] [2s]
Pominator92: checks 
Kukuryzka: checks 
*** RIVER *** [5h 6c 4h 2s] [8s]
Pominator92: bets $15
Kukuryzka: raises $22.50 to $37.50
Pominator92: folds 
Uncalled bet ($22.50) returned to Kukuryzka
Kukuryzka collected $46.09 from pot
Kukuryzka: doesn't show hand 
*** SUMMARY ***
Total pot $48.52 | Rake $2.43 
Board [5h 6c 4h 2s 8s]
Seat 2: Vikulja1993 (small blind) folded before Flop
Seat 3: tipner (big blind) folded before Flop
Seat 4: hammerwife folded before Flop (didn't bet)
Seat 5: matiko09 folded before Flop (didn't bet)
Seat 6: Pominator92 folded on the River
Seat 7: Yaaaazz folded before Flop (didn't bet)
Seat 8: SanychStar folded before Flop (didn't bet)
Seat 9: Kukuryzka (button) collected ($46.09)





PokerStars Hand #151943827754:  Hold'em No Limit ($1/$2 USD) - 2016/04/15 14:08:56 CET [2016/04/15 8:08:56 ET]
Table 'Blaauw' 9-max Seat #6 is the button
Seat 1: myatiy 96 ($204 in chips) 
Seat 2: butcheN18 ($244.19 in chips) 
Seat 3: Glushchenko ($225.11 in chips) 
Seat 4: petro0107 ($272.72 in chips) 
Seat 5: tipner ($210.40 in chips) 
Seat 6: matiko09 ($239.65 in chips) 
Seat 7: ssljvr ($414.95 in chips) 
Seat 8: Iggso ($204.50 in chips) 
Seat 9: coinflip_si ($200 in chips) 
ssljvr: posts small blind $1
Iggso: posts big blind $2
*** HOLE CARDS ***
Dealt to matiko09 [Ts 7s]
coinflip_si: folds 
myatiy 96: folds 
butcheN18: folds 
Glushchenko: folds 
petro0107: calls $2
tipner: folds 
matiko09: raises $6 to $8
ssljvr: folds 
Iggso: folds 
petro0107: calls $6
*** FLOP *** [6c Qs 9s]
petro0107: checks 
matiko09: bets $11
petro0107: calls $11
*** TURN *** [6c Qs 9s] [Jh]
petro0107: checks 
matiko09: checks 
*** RIVER *** [6c Qs 9s Jh] [Kd]
petro0107: bets $12
matiko09: raises $20 to $32
petro0107: calls $20
*** SHOW DOWN ***
matiko09: shows [Ts 7s] (a straight, Nine to King)
petro0107: mucks hand 
matiko09 collected $102.25 from pot
*** SUMMARY ***
Total pot $105 | Rake $2.75 
Board [6c Qs 9s Jh Kd]
Seat 1: myatiy 96 folded before Flop (didn't bet)
Seat 2: butcheN18 folded before Flop (didn't bet)
Seat 3: Glushchenko folded before Flop (didn't bet)
Seat 4: petro0107 mucked [9h 6s]
Seat 5: tipner folded before Flop (didn't bet)
Seat 6: matiko09 (button) showed [Ts 7s] and won ($102.25) with a straight, Nine to King
Seat 7: ssljvr (small blind) folded before Flop
Seat 8: Iggso (big blind) folded before Flop
Seat 9: coinflip_si folded before Flop (didn't bet)





PokerStars Hand #151943834203:  Hold'em No Limit ($0.50/$1.00 USD) - 2016/04/15 14:09:08 CET [2016/04/15 8:09:08 ET]
Table 'Chiny II' 9-max Seat #2 is the button
Seat 1: vrnMike ($159.06 in chips) 
Seat 2: Westpants ($148.69 in chips) 
Seat 3: Foton18 ($76.12 in chips) 
Seat 4: matiko09 ($174.40 in chips) 
Seat 5: omorfadramou ($166.50 in chips) 
Seat 6: choupai ($12.53 in chips) 
Seat 7: ruslik_by ($100 in chips) 
Seat 8: Filojoes ($136.24 in chips) 
Seat 9: butcheN18 ($100 in chips) 
Foton18: posts small blind $0.50
matiko09: posts big blind $1
*** HOLE CARDS ***
Dealt to matiko09 [Tc 4d]
omorfadramou: folds 
choupai: folds 
ruslik_by: folds 
Filojoes: folds 
butcheN18: raises $2 to $3
vrnMike: folds 
Westpants: raises $4 to $7
Foton18: folds 
matiko09: folds 
butcheN18: folds 
Uncalled bet ($4) returned to Westpants
Westpants collected $7.50 from pot
*** SUMMARY ***
Total pot $7.50 | Rake $0 
Seat 1: vrnMike folded before Flop (didn't bet)
Seat 2: Westpants (button) collected ($7.50)
Seat 3: Foton18 (small blind) folded before Flop
Seat 4: matiko09 (big blind) folded before Flop
Seat 5: omorfadramou folded before Flop (didn't bet)
Seat 6: choupai folded before Flop (didn't bet)
Seat 7: ruslik_by folded before Flop (didn't bet)
Seat 8: Filojoes folded before Flop (didn't bet)
Seat 9: butcheN18 folded before Flop





PokerStars Hand #151943835411:  Hold'em No Limit ($0.50/$1.00 USD) - 2016/04/15 14:09:10 CET [2016/04/15 8:09:10 ET]
Table 'Navi' 9-max Seat #9 is the button
Seat 1: tipner ($113.83 in chips) 
Seat 2: myatiy 96 ($100 in chips) 
Seat 4: Pvsx. ($101.50 in chips) 
Seat 5: hammerwife ($100 in chips) 
Seat 6: Vikulja1993 ($119.35 in chips) 
Seat 8: ruslik_by ($100 in chips) 
Seat 9: matiko09 ($128.13 in chips) 
tipner: posts small blind $0.50
myatiy 96: posts big blind $1
vrnMike: sits out 
*** HOLE CARDS ***
Dealt to matiko09 [Qs 3d]
Pvsx.: folds 
hammerwife: folds 
Vikulja1993: folds 
ruslik_by: folds 
matiko09: folds 
tipner: folds 
Uncalled bet ($0.50) returned to myatiy 96
myatiy 96 collected $1 from pot
myatiy 96: doesn't show hand 
*** SUMMARY ***
Total pot $1 | Rake $0 
Seat 1: tipner (small blind) folded before Flop
Seat 2: myatiy 96 (big blind) collected ($1)
Seat 4: Pvsx. folded before Flop (didn't bet)
Seat 5: hammerwife folded before Flop (didn't bet)
Seat 6: Vikulja1993 folded before Flop (didn't bet)
Seat 8: ruslik_by folded before Flop (didn't bet)
Seat 9: matiko09 (button) folded before Flop (didn't bet)





PokerStars Hand #151943836983:  Hold'em No Limit ($1/$2 USD) - 2016/04/15 14:09:13 CET [2016/04/15 8:09:13 ET]
Table 'Adele II' 9-max Seat #9 is the button
Seat 1: RyanHuJun ($340.17 in chips) 
Seat 2: Fish4trips ($326.54 in chips) 
Seat 3: matiko09 ($311.33 in chips) 
Seat 4: Glushchenko ($210.05 in chips) 
Seat 5: TonnaMunz ($203 in chips) 
Seat 6: Kukuryzka ($211.25 in chips) 
Seat 7: Iggso ($229.84 in chips) 
Seat 8: butcheN18 ($211.65 in chips) 
Seat 9: SanychStar ($279.60 in chips) 
RyanHuJun: posts small blind $1
Fish4trips: posts big blind $2
*** HOLE CARDS ***
Dealt to matiko09 [4c Js]
matiko09: folds 
Glushchenko: folds 
TonnaMunz: folds 
Kukuryzka: folds 
Iggso: folds 
butcheN18: folds 
SanychStar: folds 
RyanHuJun: raises $6 to $8
Fish4trips: folds 
Uncalled bet ($6) returned to RyanHuJun
RyanHuJun collected $4 from pot
RyanHuJun: doesn't show hand 
*** SUMMARY ***
Total pot $4 | Rake $0 
Seat 1: RyanHuJun (small blind) collected ($4)
Seat 2: Fish4trips (big blind) folded before Flop
Seat 3: matiko09 folded before Flop (didn't bet)
Seat 4: Glushchenko folded before Flop (didn't bet)
Seat 5: TonnaMunz folded before Flop (didn't bet)
Seat 6: Kukuryzka folded before Flop (didn't bet)
Seat 7: Iggso folded before Flop (didn't bet)
Seat 8: butcheN18 folded before Flop (didn't bet)
Seat 9: SanychStar (button) folded before Flop (didn't bet)





PokerStars Hand #151943845605:  Hold'em No Limit ($0.50/$1.00 USD) - 2016/04/15 14:09:30 CET [2016/04/15 8:09:30 ET]
Table 'Navi' 9-max Seat #1 is the button
Seat 1: tipner ($113.33 in chips) 
Seat 2: myatiy 96 ($100.50 in chips) 
Seat 3: vrnMike ($141.85 in chips) 
Seat 4: Pvsx. ($101.50 in chips) 
Seat 5: hammerwife ($100 in chips) 
Seat 6: Vikulja1993 ($119.35 in chips) 
Seat 8: ruslik_by ($100 in chips) 
Seat 9: matiko09 ($128.13 in chips) 
myatiy 96: posts small blind $0.50
vrnMike: posts big blind $1
*** HOLE CARDS ***
Dealt to matiko09 [2s 3c]
Pvsx.: raises $1.50 to $2.50
hammerwife: folds 
Vikulja1993: folds 
ruslik_by: folds 
matiko09: folds 
tipner: folds 
myatiy 96: folds 
vrnMike: folds 
Uncalled bet ($1.50) returned to Pvsx.
Pvsx. collected $2.50 from pot
Pvsx.: doesn't show hand 
*** SUMMARY ***
Total pot $2.50 | Rake $0 
Seat 1: tipner (button) folded before Flop (didn't bet)
Seat 2: myatiy 96 (small blind) folded before Flop
Seat 3: vrnMike (big blind) folded before Flop
Seat 4: Pvsx. collected ($2.50)
Seat 5: hammerwife folded before Flop (didn't bet)
Seat 6: Vikulja1993 folded before Flop (didn't bet)
Seat 8: ruslik_by folded before Flop (didn't bet)
Seat 9: matiko09 folded before Flop (didn't bet)





PokerStars Hand #151943852630:  Hold'em No Limit ($1/$2 USD) - 2016/04/15 14:09:43 CET [2016/04/15 8:09:43 ET]
Table 'Oceax' 9-max Seat #6 is the button
Seat 1: matiko09 ($200 in chips) 
Seat 2: Fish4trips ($328.05 in chips) 
Seat 3: Glushchenko ($203.20 in chips) 
Seat 4: butcheN18 ($251.46 in chips) 
Seat 5: derrocco82 ($192 in chips) 
Seat 6: Iggso ($276.93 in chips) 
Seat 7: ssljvr ($248.60 in chips) 
Seat 8: Poroxide ($329.97 in chips) 
Seat 9: erfk1958 ($120.08 in chips) 
ssljvr: posts small blind $1
Poroxide: posts big blind $2
*** HOLE CARDS ***
Dealt to matiko09 [6h Td]
erfk1958: folds 
matiko09: folds 
Fish4trips: folds 
Glushchenko: raises $4 to $6
butcheN18: raises $12 to $18
derrocco82: folds 
Iggso: folds 
ssljvr: folds 
Poroxide: folds 
Glushchenko: raises $24 to $42
butcheN18: raises $209.46 to $251.46 and is all-in
Glushchenko: folds 
Uncalled bet ($209.46) returned to butcheN18
butcheN18 collected $87 from pot
butcheN18: doesn't show hand 
*** SUMMARY ***
Total pot $87 | Rake $0 
Seat 1: matiko09 folded before Flop (didn't bet)
Seat 2: Fish4trips folded before Flop (didn't bet)
Seat 3: Glushchenko folded before Flop
Seat 4: butcheN18 collected ($87)
Seat 5: derrocco82 folded before Flop (didn't bet)
Seat 6: Iggso (button) folded before Flop (didn't bet)
Seat 7: ssljvr (small blind) folded before Flop
Seat 8: Poroxide (big blind) folded before Flop
Seat 9: erfk1958 folded before Flop (didn't bet)





PokerStars Hand #151943854174:  Hold'em No Limit ($1/$2 USD) - 2016/04/15 14:09:46 CET [2016/04/15 8:09:46 ET]
Table 'Adele II' 9-max Seat #1 is the button
Seat 1: RyanHuJun ($342.17 in chips) 
Seat 2: Fish4trips ($324.54 in chips) 
Seat 3: matiko09 ($311.33 in chips) 
Seat 4: Glushchenko ($210.05 in chips) 
Seat 5: TonnaMunz ($203 in chips) 
Seat 6: Kukuryzka ($211.25 in chips) 
Seat 7: Iggso ($229.84 in chips) 
Seat 8: butcheN18 ($211.65 in chips) 
Seat 9: SanychStar ($279.60 in chips) 
Fish4trips: posts small blind $1
matiko09: posts big blind $2
*** HOLE CARDS ***
Dealt to matiko09 [Qc Ah]
Glushchenko: folds 
TonnaMunz: folds 
Kukuryzka: folds 
Iggso: folds 
butcheN18: folds 
SanychStar: folds 
RyanHuJun: folds 
Fish4trips: folds 
Uncalled bet ($1) returned to matiko09
matiko09 collected $2 from pot
matiko09: doesn't show hand 
*** SUMMARY ***
Total pot $2 | Rake $0 
Seat 1: RyanHuJun (button) folded before Flop (didn't bet)
Seat 2: Fish4trips (small blind) folded before Flop
Seat 3: matiko09 (big blind) collected ($2)
Seat 4: Glushchenko folded before Flop (didn't bet)
Seat 5: TonnaMunz folded before Flop (didn't bet)
Seat 6: Kukuryzka folded before Flop (didn't bet)
Seat 7: Iggso folded before Flop (didn't bet)
Seat 8: butcheN18 folded before Flop (didn't bet)
Seat 9: SanychStar folded before Flop (didn't bet)





PokerStars Hand #151943854454:  Hold'em No Limit ($0.50/$1.00 USD) - 2016/04/15 14:09:47 CET [2016/04/15 8:09:47 ET]
Table 'Emma II' 9-max Seat #2 is the button
Seat 1: omorfadramou ($103 in chips) 
Seat 2: Filojoes ($142.50 in chips) 
Seat 3: Glushchenko ($269.79 in chips) 
Seat 4: matiko09 ($100 in chips) 
Seat 5: Prettyspitz ($103.65 in chips) 
Seat 6: Tirka ($89.21 in chips) 
Seat 7: ruslik_by ($102.50 in chips) 
Seat 9: Foton18 ($138.34 in chips) 
Glushchenko: posts small blind $0.50
matiko09: posts big blind $1
*** HOLE CARDS ***
Dealt to matiko09 [9h 5h]
Prettyspitz: folds 
Tirka: folds 
ruslik_by: raises $2 to $3
Foton18: folds 
omorfadramou: folds 
Filojoes: folds 
Glushchenko: folds 
matiko09: folds 
Uncalled bet ($2) returned to ruslik_by
ruslik_by collected $2.50 from pot
ruslik_by: doesn't show hand 
*** SUMMARY ***
Total pot $2.50 | Rake $0 
Seat 1: omorfadramou folded before Flop (didn't bet)
Seat 2: Filojoes (button) folded before Flop (didn't bet)
Seat 3: Glushchenko (small blind) folded before Flop
Seat 4: matiko09 (big blind) folded before Flop
Seat 5: Prettyspitz folded before Flop (didn't bet)
Seat 6: Tirka folded before Flop (didn't bet)
Seat 7: ruslik_by collected ($2.50)
Seat 9: Foton18 folded before Flop (didn't bet)





PokerStars Hand #151943856027:  Hold'em No Limit ($0.50/$1.00 USD) - 2016/04/15 14:09:50 CET [2016/04/15 8:09:50 ET]
Table 'Adelgunde III' 9-max Seat #2 is the button
Seat 1: valimiu ($50.15 in chips) 
Seat 2: Vikulja1993 ($100 in chips) 
Seat 3: tipner ($123.70 in chips) 
Seat 4: hammerwife ($122.23 in chips) 
Seat 5: matiko09 ($139.43 in chips) 
Seat 6: Pominator92 ($140.51 in chips) 
Seat 7: Yaaaazz ($100 in chips) 
Seat 8: SanychStar ($127.06 in chips) 
Seat 9: Kukuryzka ($124.51 in chips) 
tipner: posts small blind $0.50
hammerwife: posts big blind $1
valimiu: posts small & big blinds $1.50
*** HOLE CARDS ***
Dealt to matiko09 [8c Ah]
matiko09: folds 
Pominator92: raises $2 to $3
Yaaaazz: folds 
SanychStar: raises $9 to $12
Kukuryzka: folds 
valimiu: folds 
Vikulja1993: folds 
tipner: folds 
hammerwife: folds 
Pominator92: folds 
Uncalled bet ($9) returned to SanychStar
SanychStar collected $9 from pot
*** SUMMARY ***
Total pot $9 | Rake $0 
Seat 1: valimiu folded before Flop
Seat 2: Vikulja1993 (button) folded before Flop (didn't bet)
Seat 3: tipner (small blind) folded before Flop
Seat 4: hammerwife (big blind) folded before Flop
Seat 5: matiko09 folded before Flop (didn't bet)
Seat 6: Pominator92 folded before Flop
Seat 7: Yaaaazz folded before Flop (didn't bet)
Seat 8: SanychStar collected ($9)
Seat 9: Kukuryzka folded before Flop (didn't bet)





PokerStars Hand #151943859309:  Hold'em No Limit ($0.50/$1.00 USD) - 2016/04/15 14:09:56 CET [2016/04/15 8:09:56 ET]
Table 'Chiny II' 9-max Seat #3 is the button
Seat 1: vrnMike ($159.06 in chips) 
Seat 2: Westpants ($153.19 in chips) 
Seat 3: Foton18 ($75.62 in chips) 
Seat 4: matiko09 ($173.40 in chips) 
Seat 5: omorfadramou ($166.50 in chips) 
Seat 6: choupai ($12.53 in chips) 
Seat 7: ruslik_by ($100 in chips) 
Seat 8: Filojoes ($136.24 in chips) 
Seat 9: butcheN18 ($100 in chips) 
matiko09: posts small blind $0.50
omorfadramou: posts big blind $1
*** HOLE CARDS ***
Dealt to matiko09 [4h Qd]
choupai: folds 
ruslik_by: folds 
Filojoes: folds 
butcheN18: folds 
vrnMike: folds 
Westpants: folds 
Foton18: raises $2 to $3
matiko09: folds 
omorfadramou: folds 
Uncalled bet ($2) returned to Foton18
Foton18 collected $2.50 from pot
Foton18: doesn't show hand 
*** SUMMARY ***
Total pot $2.50 | Rake $0 
Seat 1: vrnMike folded before Flop (didn't bet)
Seat 2: Westpants folded before Flop (didn't bet)
Seat 3: Foton18 (button) collected ($2.50)
Seat 4: matiko09 (small blind) folded before Flop
Seat 5: omorfadramou (big blind) folded before Flop
Seat 6: choupai folded before Flop (didn't bet)
Seat 7: ruslik_by folded before Flop (didn't bet)
Seat 8: Filojoes folded before Flop (didn't bet)
Seat 9: butcheN18 folded before Flop (didn't bet)





PokerStars Hand #151943860467:  Hold'em No Limit ($1/$2 USD) - 2016/04/15 14:09:58 CET [2016/04/15 8:09:58 ET]
Table 'Marmara II' 9-max Seat #2 is the button
Seat 1: ssljvr ($488.98 in chips) 
Seat 2: Iggso ($200 in chips) 
Seat 3: Glushchenko ($207.44 in chips) 
Seat 4: Fish4trips ($247.96 in chips) 
Seat 5: docmarc777 ($424.55 in chips) 
Seat 6: azzad2007 ($200 in chips) 
Seat 7: matiko09 ($205 in chips) 
Seat 8: Dachish ($139 in chips) 
Seat 9: erfk1958 ($130.25 in chips) 
Glushchenko: posts small blind $1
Fish4trips: posts big blind $2
*** HOLE CARDS ***
Dealt to matiko09 [6s 5h]
docmarc777: folds 
azzad2007: folds 
matiko09: folds 
Dachish: folds 
erfk1958: folds 
ssljvr: raises $2 to $4
Iggso: folds 
Glushchenko: folds 
Fish4trips: folds 
Uncalled bet ($2) returned to ssljvr
ssljvr collected $5 from pot
ssljvr: doesn't show hand 
*** SUMMARY ***
Total pot $5 | Rake $0 
Seat 1: ssljvr collected ($5)
Seat 2: Iggso (button) folded before Flop (didn't bet)
Seat 3: Glushchenko (small blind) folded before Flop
Seat 4: Fish4trips (big blind) folded before Flop
Seat 5: docmarc777 folded before Flop (didn't bet)
Seat 6: azzad2007 folded before Flop (didn't bet)
Seat 7: matiko09 folded before Flop (didn't bet)
Seat 8: Dachish folded before Flop (didn't bet)
Seat 9: erfk1958 folded before Flop (didn't bet)





PokerStars Hand #151943860511:  Hold'em No Limit ($0.50/$1.00 USD) - 2016/04/15 14:09:58 CET [2016/04/15 8:09:58 ET]
Table 'Parvulesco II' 9-max Seat #5 is the button
Seat 1: bilukm ($87.09 in chips) 
Seat 2: Filojoes ($107.04 in chips) 
Seat 3: matiko09 ($113.45 in chips) 
Seat 4: butcheN18 ($100 in chips) 
Seat 5: maxxmeister ($105.60 in chips) 
Seat 6: ruslik_by ($125.73 in chips) 
Seat 7: Kukuryzka ($134.94 in chips) 
Seat 8: Jimy Tiltman ($113.42 in chips) 
Seat 9: hammerwife ($187.97 in chips) 
ruslik_by: posts small blind $0.50
Kukuryzka: posts big blind $1
*** HOLE CARDS ***
Dealt to matiko09 [Qc Kd]
Jimy Tiltman: folds 
hammerwife: folds 
bilukm: calls $1
Filojoes: folds 
matiko09: raises $3 to $4
butcheN18: calls $4
maxxmeister: folds 
ruslik_by: folds 
Kukuryzka: folds 
bilukm: folds 
*** FLOP *** [Td Jd Ks]
matiko09: checks 
butcheN18: bets $6.38
matiko09: calls $6.38
*** TURN *** [Td Jd Ks] [Js]
matiko09: checks 
butcheN18: checks 
*** RIVER *** [Td Jd Ks Js] [5s]
matiko09: checks 
butcheN18: checks 
*** SHOW DOWN ***
matiko09: shows [Qc Kd] (two pair, Kings and Jacks)
butcheN18: mucks hand 
matiko09 collected $22.10 from pot
*** SUMMARY ***
Total pot $23.26 | Rake $1.16 
Board [Td Jd Ks Js 5s]
Seat 1: bilukm folded before Flop
Seat 2: Filojoes folded before Flop (didn't bet)
Seat 3: matiko09 showed [Qc Kd] and won ($22.10) with two pair, Kings and Jacks
Seat 4: butcheN18 mucked [Th 8h]
Seat 5: maxxmeister (button) folded before Flop (didn't bet)
Seat 6: ruslik_by (small blind) folded before Flop
Seat 7: Kukuryzka (big blind) folded before Flop
Seat 8: Jimy Tiltman folded before Flop (didn't bet)
Seat 9: hammerwife folded before Flop (didn't bet)





PokerStars Hand #151943861575:  Hold'em No Limit ($0.50/$1.00 USD) - 2016/04/15 14:10:01 CET [2016/04/15 8:10:01 ET]
Table 'Navi' 9-max Seat #2 is the button
Seat 1: tipner ($113.33 in chips) 
Seat 2: myatiy 96 ($100 in chips) 
Seat 3: vrnMike ($140.85 in chips) 
Seat 4: Pvsx. ($103 in chips) 
Seat 5: hammerwife ($100 in chips) 
Seat 6: Vikulja1993 ($119.35 in chips) 
Seat 8: ruslik_by ($100 in chips) 
Seat 9: matiko09 ($128.13 in chips) 
vrnMike: posts small blind $0.50
Pvsx.: posts big blind $1
*** HOLE CARDS ***
Dealt to matiko09 [8h Th]
hammerwife: folds 
Vikulja1993: raises $2 to $3
ruslik_by: folds 
matiko09: folds 
tipner: folds 
myatiy 96: folds 
vrnMike: folds 
Pvsx.: folds 
Uncalled bet ($2) returned to Vikulja1993
Vikulja1993 collected $2.50 from pot
Vikulja1993: doesn't show hand 
*** SUMMARY ***
Total pot $2.50 | Rake $0 
Seat 1: tipner folded before Flop (didn't bet)
Seat 2: myatiy 96 (button) folded before Flop (didn't bet)
Seat 3: vrnMike (small blind) folded before Flop
Seat 4: Pvsx. (big blind) folded before Flop
Seat 5: hammerwife folded before Flop (didn't bet)
Seat 6: Vikulja1993 collected ($2.50)
Seat 8: ruslik_by folded before Flop (didn't bet)
Seat 9: matiko09 folded before Flop (didn't bet)





PokerStars Hand #151943867566:  Hold'em No Limit ($0.50/$1.00 USD) - 2016/04/15 14:10:12 CET [2016/04/15 8:10:12 ET]
Table 'Adelgunde III' 9-max Seat #3 is the button
Seat 1: valimiu ($48.65 in chips) 
Seat 2: Vikulja1993 ($100 in chips) 
Seat 3: tipner ($123.20 in chips) 
Seat 4: hammerwife ($121.23 in chips) 
Seat 5: matiko09 ($139.43 in chips) 
Seat 6: Pominator92 ($137.51 in chips) 
Seat 7: Yaaaazz ($100 in chips) 
Seat 8: SanychStar ($133.06 in chips) 
Seat 9: Kukuryzka ($124.51 in chips) 
hammerwife: posts small blind $0.50
matiko09: posts big blind $1
*** HOLE CARDS ***
Dealt to matiko09 [Tc 3d]
Pominator92: raises $2 to $3
Yaaaazz: folds 
SanychStar: folds 
Kukuryzka: folds 
valimiu: calls $3
Vikulja1993: calls $3
tipner: folds 
hammerwife: raises $13 to $16
matiko09: folds 
Pominator92: folds 
valimiu: folds 
Vikulja1993: folds 
Uncalled bet ($13) returned to hammerwife
hammerwife collected $13 from pot
hammerwife: doesn't show hand 
*** SUMMARY ***
Total pot $13 | Rake $0 
Seat 1: valimiu folded before Flop
Seat 2: Vikulja1993 folded before Flop
Seat 3: tipner (button) folded before Flop (didn't bet)
Seat 4: hammerwife (small blind) collected ($13)
Seat 5: matiko09 (big blind) folded before Flop
Seat 6: Pominator92 folded before Flop
Seat 7: Yaaaazz folded before Flop (didn't bet)
Seat 8: SanychStar folded before Flop (didn't bet)
Seat 9: Kukuryzka folded before Flop (didn't bet)





PokerStars Hand #151943868840:  Hold'em No Limit ($1/$2 USD) - 2016/04/15 14:10:15 CET [2016/04/15 8:10:15 ET]
Table 'Adele II' 9-max Seat #2 is the button
Seat 1: RyanHuJun ($342.17 in chips) 
Seat 2: Fish4trips ($323.54 in chips) 
Seat 3: matiko09 ($312.33 in chips) 
Seat 4: Glushchenko ($210.05 in chips) 
Seat 5: TonnaMunz ($203 in chips) 
Seat 6: Kukuryzka ($211.25 in chips) 
Seat 7: Iggso ($229.84 in chips) 
Seat 8: butcheN18 ($211.65 in chips) 
Seat 9: SanychStar ($279.60 in chips) 
matiko09: posts small blind $1
Glushchenko: posts big blind $2
*** HOLE CARDS ***
Dealt to matiko09 [5c 4h]
TonnaMunz: folds 
Kukuryzka: folds 
Iggso: folds 
butcheN18: folds 
SanychStar: folds 
RyanHuJun: raises $4 to $6
Fish4trips: folds 
matiko09: folds 
Glushchenko: folds 
Uncalled bet ($4) returned to RyanHuJun
RyanHuJun collected $5 from pot
*** SUMMARY ***
Total pot $5 | Rake $0 
Seat 1: RyanHuJun collected ($5)
Seat 2: Fish4trips (button) folded before Flop (didn't bet)
Seat 3: matiko09 (small blind) folded before Flop
Seat 4: Glushchenko (big blind) folded before Flop
Seat 5: TonnaMunz folded before Flop (didn't bet)
Seat 6: Kukuryzka folded before Flop (didn't bet)
Seat 7: Iggso folded before Flop (didn't bet)
Seat 8: butcheN18 folded before Flop (didn't bet)
Seat 9: SanychStar folded before Flop (didn't bet)





PokerStars Hand #151943875171:  Hold'em No Limit ($0.50/$1.00 USD) - 2016/04/15 14:10:27 CET [2016/04/15 8:10:27 ET]
Table 'Navi' 9-max Seat #3 is the button
Seat 1: tipner ($113.33 in chips) 
Seat 2: myatiy 96 ($100 in chips) 
Seat 3: vrnMike ($140.35 in chips) 
Seat 4: Pvsx. ($102 in chips) 
Seat 6: Vikulja1993 ($120.85 in chips) 
Seat 8: ruslik_by ($100 in chips) 
Seat 9: matiko09 ($128.13 in chips) 
Pvsx.: posts small blind $0.50
hammerwife: is sitting out 
Vikulja1993: posts big blind $1
*** HOLE CARDS ***
Dealt to matiko09 [8c 7s]
ruslik_by: folds 
hammerwife leaves the table
matiko09: folds 
tipner: folds 
myatiy 96: raises $1.50 to $2.50
vrnMike: folds 
Pvsx.: raises $6 to $8.50
Vikulja1993: folds 
myatiy 96: calls $6
*** FLOP *** [7c 2s 6s]
Pvsx.: bets $11
myatiy 96: folds 
Uncalled bet ($11) returned to Pvsx.
Pvsx. collected $17.10 from pot
Pvsx.: doesn't show hand 
*** SUMMARY ***
Total pot $18 | Rake $0.90 
Board [7c 2s 6s]
Seat 1: tipner folded before Flop (didn't bet)
Seat 2: myatiy 96 folded on the Flop
Seat 3: vrnMike (button) folded before Flop (didn't bet)
Seat 4: Pvsx. (small blind) collected ($17.10)
Seat 6: Vikulja1993 (big blind) folded before Flop
Seat 8: ruslik_by folded before Flop (didn't bet)
Seat 9: matiko09 folded before Flop (didn't bet)





PokerStars Hand #151943878625:  Hold'em No Limit ($1/$2 USD) - 2016/04/15 14:10:34 CET [2016/04/15 8:10:34 ET]
Table 'Marmara II' 9-max Seat #3 is the button
Seat 1: ssljvr ($491.98 in chips) 
Seat 2: Iggso ($200 in chips) 
Seat 3: Glushchenko ($206.44 in chips) 
Seat 4: Fish4trips ($245.96 in chips) 
Seat 5: docmarc777 ($424.55 in chips) 
Seat 6: azzad2007 ($200 in chips) 
Seat 7: matiko09 ($205 in chips) 
Seat 8: Dachish ($139 in chips) 
Seat 9: erfk1958 ($130.25 in chips) 
Fish4trips: posts small blind $1
docmarc777: posts big blind $2
*** HOLE CARDS ***
Dealt to matiko09 [5c 3c]
azzad2007: folds 
matiko09: folds 
Dachish: folds 
erfk1958: folds 
ssljvr: folds 
Iggso: folds 
Glushchenko: raises $2 to $4
Fish4trips: folds 
docmarc777: folds 
Uncalled bet ($2) returned to Glushchenko
Glushchenko collected $5 from pot
*** SUMMARY ***
Total pot $5 | Rake $0 
Seat 1: ssljvr folded before Flop (didn't bet)
Seat 2: Iggso folded before Flop (didn't bet)
Seat 3: Glushchenko (button) collected ($5)
Seat 4: Fish4trips (small blind) folded before Flop
Seat 5: docmarc777 (big blind) folded before Flop
Seat 6: azzad2007 folded before Flop (didn't bet)
Seat 7: matiko09 folded before Flop (didn't bet)
Seat 8: Dachish folded before Flop (didn't bet)
Seat 9: erfk1958 folded before Flop (didn't bet)





PokerStars Hand #151943878533:  Hold'em No Limit ($0.50/$1.00 USD) - 2016/04/15 14:10:34 CET [2016/04/15 8:10:34 ET]
Table 'Emma II' 9-max Seat #3 is the button
Seat 1: omorfadramou ($103 in chips) 
Seat 2: Filojoes ($142.50 in chips) 
Seat 3: Glushchenko ($269.29 in chips) 
Seat 4: matiko09 ($100 in chips) 
Seat 5: Prettyspitz ($103.65 in chips) 
Seat 6: Tirka ($89.21 in chips) 
Seat 7: ruslik_by ($104 in chips) 
Seat 9: Foton18 ($138.34 in chips) 
matiko09: posts small blind $0.50
Prettyspitz: posts big blind $1
*** HOLE CARDS ***
Dealt to matiko09 [8h Jc]
Tirka: raises $2 to $3
ruslik_by: folds 
Foton18: folds 
omorfadramou: calls $3
Filojoes: folds 
Glushchenko: folds 
matiko09: folds 
Vikulja1993 joins the table at seat #8 
Vikulja1993 leaves the table
Prettyspitz: folds 
*** FLOP *** [8d 2d 8s]
Tirka: bets $4.74
omorfadramou: calls $4.74
*** TURN *** [8d 2d 8s] [5h]
di0d80 joins the table at seat #8 
di0d80 leaves the table
Tirka: checks 
omorfadramou: checks 
*** RIVER *** [8d 2d 8s 5h] [4h]
Tirka: bets $8.06
myatiy 96 joins the table at seat #8 
myatiy 96 leaves the table
Vikulja1993 joins the table at seat #8 
omorfadramou: folds 
Uncalled bet ($8.06) returned to Tirka
Tirka collected $16.13 from pot
Tirka: doesn't show hand 
*** SUMMARY ***
Total pot $16.98 | Rake $0.85 
Board [8d 2d 8s 5h 4h]
Seat 1: omorfadramou folded on the River
Seat 2: Filojoes folded before Flop (didn't bet)
Seat 3: Glushchenko (button) folded before Flop (didn't bet)
Seat 4: matiko09 (small blind) folded before Flop
Seat 5: Prettyspitz (big blind) folded before Flop
Seat 6: Tirka collected ($16.13)
Seat 7: ruslik_by folded before Flop (didn't bet)
Seat 9: Foton18 folded before Flop (didn't bet)





PokerStars Hand #151943880701:  Hold'em No Limit ($1/$2 USD) - 2016/04/15 14:10:38 CET [2016/04/15 8:10:38 ET]
Table 'Blaauw' 9-max Seat #7 is the button
Seat 1: myatiy 96 ($204 in chips) 
Seat 2: butcheN18 ($244.19 in chips) 
Seat 3: Glushchenko ($225.11 in chips) 
Seat 4: petro0107 ($221.72 in chips) 
Seat 5: tipner ($210.40 in chips) 
Seat 6: matiko09 ($290.90 in chips) 
Seat 7: ssljvr ($413.95 in chips) 
Seat 8: Iggso ($202.50 in chips) 
Seat 9: coinflip_si ($200 in chips) 
Iggso: posts small blind $1
coinflip_si: posts big blind $2
*** HOLE CARDS ***
Dealt to matiko09 [6d Ac]
myatiy 96: folds 
butcheN18: folds 
Glushchenko: folds 
petro0107: calls $2
tipner: raises $6 to $8
matiko09: folds 
ssljvr: folds 
Iggso: folds 
coinflip_si: folds 
petro0107: folds 
Uncalled bet ($6) returned to tipner
tipner collected $7 from pot
tipner: doesn't show hand 
*** SUMMARY ***
Total pot $7 | Rake $0 
Seat 1: myatiy 96 folded before Flop (didn't bet)
Seat 2: butcheN18 folded before Flop (didn't bet)
Seat 3: Glushchenko folded before Flop (didn't bet)
Seat 4: petro0107 folded before Flop
Seat 5: tipner collected ($7)
Seat 6: matiko09 folded before Flop (didn't bet)
Seat 7: ssljvr (button) folded before Flop (didn't bet)
Seat 8: Iggso (small blind) folded before Flop
Seat 9: coinflip_si (big blind) folded before Flop





PokerStars Hand #151943881880:  Hold'em No Limit ($0.50/$1.00 USD) - 2016/04/15 14:10:40 CET [2016/04/15 8:10:40 ET]
Table 'Chiny II' 9-max Seat #4 is the button
Seat 1: vrnMike ($159.06 in chips) 
Seat 2: Westpants ($153.19 in chips) 
Seat 3: Foton18 ($77.12 in chips) 
Seat 4: matiko09 ($172.90 in chips) 
Seat 5: omorfadramou ($165.50 in chips) 
Seat 6: choupai ($12.53 in chips) 
Seat 7: ruslik_by ($100 in chips) 
Seat 8: Filojoes ($136.24 in chips) 
Seat 9: butcheN18 ($100 in chips) 
omorfadramou: posts small blind $0.50
choupai: posts big blind $1
*** HOLE CARDS ***
Dealt to matiko09 [9d Ts]
ruslik_by: raises $2 to $3
Filojoes: folds 
butcheN18: folds 
vrnMike: calls $3
Westpants: folds 
Foton18: folds 
matiko09: folds 
omorfadramou: folds 
choupai: folds 
*** FLOP *** [5d 7d 5c]
ruslik_by: bets $4.50
vrnMike: folds 
Uncalled bet ($4.50) returned to ruslik_by
ruslik_by collected $7.12 from pot
ruslik_by: doesn't show hand 
*** SUMMARY ***
Total pot $7.50 | Rake $0.38 
Board [5d 7d 5c]
Seat 1: vrnMike folded on the Flop
Seat 2: Westpants folded before Flop (didn't bet)
Seat 3: Foton18 folded before Flop (didn't bet)
Seat 4: matiko09 (button) folded before Flop (didn't bet)
Seat 5: omorfadramou (small blind) folded before Flop
Seat 6: choupai (big blind) folded before Flop
Seat 7: ruslik_by collected ($7.12)
Seat 8: Filojoes folded before Flop (didn't bet)
Seat 9: butcheN18 folded before Flop (didn't bet)





PokerStars Hand #151943883403:  Hold'em No Limit ($1/$2 USD) - 2016/04/15 14:10:43 CET [2016/04/15 8:10:43 ET]
Table 'Oceax' 9-max Seat #7 is the button
Seat 1: matiko09 ($200 in chips) 
Seat 2: Fish4trips ($328.05 in chips) 
Seat 3: Glushchenko ($200 in chips) 
Seat 4: butcheN18 ($296.46 in chips) 
Seat 5: derrocco82 ($192 in chips) 
Seat 6: Iggso ($276.93 in chips) 
Seat 7: ssljvr ($247.60 in chips) 
Seat 8: Poroxide ($327.97 in chips) 
Seat 9: erfk1958 ($120.08 in chips) 
Poroxide: posts small blind $1
erfk1958: posts big blind $2
*** HOLE CARDS ***
Dealt to matiko09 [Qh 9d]
matiko09: folds 
Fish4trips: folds 
Glushchenko: folds 
butcheN18: folds 
derrocco82: folds 
Iggso: folds 
ssljvr: raises $4 to $6
Poroxide: folds 
erfk1958: folds 
Uncalled bet ($4) returned to ssljvr
ssljvr collected $5 from pot
ssljvr: doesn't show hand 
*** SUMMARY ***
Total pot $5 | Rake $0 
Seat 1: matiko09 folded before Flop (didn't bet)
Seat 2: Fish4trips folded before Flop (didn't bet)
Seat 3: Glushchenko folded before Flop (didn't bet)
Seat 4: butcheN18 folded before Flop (didn't bet)
Seat 5: derrocco82 folded before Flop (didn't bet)
Seat 6: Iggso folded before Flop (didn't bet)
Seat 7: ssljvr (button) collected ($5)
Seat 8: Poroxide (small blind) folded before Flop
Seat 9: erfk1958 (big blind) folded before Flop





PokerStars Hand #151943887252:  Hold'em No Limit ($1/$2 USD) - 2016/04/15 14:10:50 CET [2016/04/15 8:10:50 ET]
Table 'Adele II' 9-max Seat #3 is the button
Seat 1: RyanHuJun ($345.17 in chips) 
Seat 2: Fish4trips ($323.54 in chips) 
Seat 3: matiko09 ($311.33 in chips) 
Seat 4: Glushchenko ($208.05 in chips) 
Seat 5: TonnaMunz ($203 in chips) 
Seat 6: Kukuryzka ($211.25 in chips) 
Seat 7: Iggso ($229.84 in chips) 
Seat 8: butcheN18 ($211.65 in chips) 
Seat 9: SanychStar ($279.60 in chips) 
Glushchenko: posts small blind $1
TonnaMunz: posts big blind $2
*** HOLE CARDS ***
Dealt to matiko09 [Js Kh]
Kukuryzka: folds 
Iggso: raises $4 to $6
butcheN18: calls $6
SanychStar: folds 
RyanHuJun: folds 
Fish4trips: folds 
matiko09: folds 
Glushchenko: folds 
TonnaMunz: folds 
*** FLOP *** [4s 3h 9h]
Iggso: checks 
butcheN18: bets $9.12
Iggso: raises $21.65 to $30.77
butcheN18: calls $21.65
*** TURN *** [4s 3h 9h] [4d]
Iggso: checks 
butcheN18: checks 
*** RIVER *** [4s 3h 9h 4d] [6h]
Iggso: checks 
butcheN18: checks 
*** SHOW DOWN ***
Iggso: shows [Qh Td] (a pair of Fours)
butcheN18: shows [Ac Ah] (two pair, Aces and Fours)
butcheN18 collected $73.79 from pot
*** SUMMARY ***
Total pot $76.54 | Rake $2.75 
Board [4s 3h 9h 4d 6h]
Seat 1: RyanHuJun folded before Flop (didn't bet)
Seat 2: Fish4trips folded before Flop (didn't bet)
Seat 3: matiko09 (button) folded before Flop (didn't bet)
Seat 4: Glushchenko (small blind) folded before Flop
Seat 5: TonnaMunz (big blind) folded before Flop
Seat 6: Kukuryzka folded before Flop (didn't bet)
Seat 7: Iggso showed [Qh Td] and lost with a pair of Fours
Seat 8: butcheN18 showed [Ac Ah] and won ($73.79) with two pair, Aces and Fours
Seat 9: SanychStar folded before Flop (didn't bet)





PokerStars Hand #151943888622:  Hold'em No Limit ($0.50/$1.00 USD) - 2016/04/15 14:10:53 CET [2016/04/15 8:10:53 ET]
Table 'Adelgunde III' 9-max Seat #4 is the button
Seat 1: valimiu ($45.65 in chips) 
Seat 2: Vikulja1993 ($100 in chips) 
Seat 3: tipner ($123.20 in chips) 
Seat 4: hammerwife ($131.23 in chips) 
Seat 5: matiko09 ($138.43 in chips) 
Seat 6: Pominator92 ($134.51 in chips) 
Seat 7: Yaaaazz ($100 in chips) 
Seat 8: SanychStar ($133.06 in chips) 
Seat 9: Kukuryzka ($124.51 in chips) 
matiko09: posts small blind $0.50
Pominator92: posts big blind $1
*** HOLE CARDS ***
Dealt to matiko09 [Tc 5c]
Yaaaazz: folds 
SanychStar: folds 
Kukuryzka: folds 
valimiu: calls $1
Vikulja1993: raises $3 to $4
tipner: folds 
hammerwife: folds 
matiko09: folds 
Pominator92: calls $3
valimiu: calls $3
*** FLOP *** [9c 7c 9s]
Pominator92: checks 
valimiu: checks 
Vikulja1993: bets $5
Pominator92: raises $9 to $14
valimiu: calls $14
Vikulja1993: calls $9
*** TURN *** [9c 7c 9s] [2d]
Pominator92: bets $26
valimiu: calls $26
Vikulja1993: calls $26
*** RIVER *** [9c 7c 9s 2d] [7h]
Pominator92: bets $90.51 and is all-in
valimiu: calls $1.65 and is all-in
Vikulja1993: folds 
Uncalled bet ($88.86) returned to Pominator92
*** SHOW DOWN ***
Pominator92: shows [Td 7d] (a full house, Sevens full of Nines)
valimiu: shows [9d Jc] (a full house, Nines full of Sevens)
valimiu collected $133.30 from pot
*** SUMMARY ***
Total pot $135.80 | Rake $2.50 
Board [9c 7c 9s 2d 7h]
Seat 1: valimiu showed [9d Jc] and won ($133.30) with a full house, Nines full of Sevens
Seat 2: Vikulja1993 folded on the River
Seat 3: tipner folded before Flop (didn't bet)
Seat 4: hammerwife (button) folded before Flop (didn't bet)
Seat 5: matiko09 (small blind) folded before Flop
Seat 6: Pominator92 (big blind) showed [Td 7d] and lost with a full house, Sevens full of Nines
Seat 7: Yaaaazz folded before Flop (didn't bet)
Seat 8: SanychStar folded before Flop (didn't bet)
Seat 9: Kukuryzka folded before Flop (didn't bet)





PokerStars Hand #151943894640:  Hold'em No Limit ($0.50/$1.00 USD) - 2016/04/15 14:11:04 CET [2016/04/15 8:11:04 ET]
Table 'Navi' 9-max Seat #4 is the button
Seat 1: tipner ($113.33 in chips) 
Seat 2: myatiy 96 ($100 in chips) 
Seat 3: vrnMike ($140.35 in chips) 
Seat 4: Pvsx. ($110.60 in chips) 
Seat 6: Vikulja1993 ($119.85 in chips) 
Seat 8: ruslik_by ($100 in chips) 
Seat 9: matiko09 ($128.13 in chips) 
Vikulja1993: posts small blind $0.50
ruslik_by: posts big blind $1
*** HOLE CARDS ***
Dealt to matiko09 [8s 4c]
Prettyspitz joins the table at seat #5 
matiko09: folds 
tipner: folds 
myatiy 96: folds 
vrnMike: folds 
Pvsx.: folds 
Vikulja1993: raises $1.50 to $2.50
ruslik_by: calls $1.50
*** FLOP *** [Ts Jh Ac]
Vikulja1993: checks 
ruslik_by: bets $2
Vikulja1993: calls $2
*** TURN *** [Ts Jh Ac] [3d]
Vikulja1993: checks 
ruslik_by: checks 
*** RIVER *** [Ts Jh Ac 3d] [2d]
Vikulja1993: checks 
ruslik_by: checks 
*** SHOW DOWN ***
Vikulja1993: shows [9h Kh] (high card Ace)
ruslik_by: mucks hand 
Vikulja1993 collected $8.55 from pot
*** SUMMARY ***
Total pot $9 | Rake $0.45 
Board [Ts Jh Ac 3d 2d]
Seat 1: tipner folded before Flop (didn't bet)
Seat 2: myatiy 96 folded before Flop (didn't bet)
Seat 3: vrnMike folded before Flop (didn't bet)
Seat 4: Pvsx. (button) folded before Flop (didn't bet)
Seat 6: Vikulja1993 (small blind) showed [9h Kh] and won ($8.55) with high card Ace
Seat 8: ruslik_by (big blind) mucked [5s Qs]
Seat 9: matiko09 folded before Flop (didn't bet)





PokerStars Hand #151943894632:  Hold'em No Limit ($1/$2 USD) - 2016/04/15 14:11:04 CET [2016/04/15 8:11:04 ET]
Table 'Marmara II' 9-max Seat #4 is the button
Seat 1: ssljvr ($491.98 in chips) 
Seat 2: Iggso ($200 in chips) 
Seat 3: Glushchenko ($209.44 in chips) 
Seat 4: Fish4trips ($244.96 in chips) 
Seat 5: docmarc777 ($422.55 in chips) 
Seat 6: azzad2007 ($200 in chips) 
Seat 7: matiko09 ($205 in chips) 
Seat 8: Dachish ($139 in chips) 
Seat 9: erfk1958 ($130.25 in chips) 
docmarc777: posts small blind $1
azzad2007: posts big blind $2
*** HOLE CARDS ***
Dealt to matiko09 [7c 5d]
matiko09: folds 
Dachish: folds 
erfk1958: raises $2 to $4
ssljvr: folds 
Iggso: folds 
Glushchenko: folds 
Fish4trips: folds 
docmarc777: folds 
azzad2007: folds 
Uncalled bet ($2) returned to erfk1958
erfk1958 collected $5 from pot
erfk1958: doesn't show hand 
*** SUMMARY ***
Total pot $5 | Rake $0 
Seat 1: ssljvr folded before Flop (didn't bet)
Seat 2: Iggso folded before Flop (didn't bet)
Seat 3: Glushchenko folded before Flop (didn't bet)
Seat 4: Fish4trips (button) folded before Flop (didn't bet)
Seat 5: docmarc777 (small blind) folded before Flop
Seat 6: azzad2007 (big blind) folded before Flop
Seat 7: matiko09 folded before Flop (didn't bet)
Seat 8: Dachish folded before Flop (didn't bet)
Seat 9: erfk1958 collected ($5)





PokerStars Hand #151943899180:  Hold'em No Limit ($0.50/$1.00 USD) - 2016/04/15 14:11:13 CET [2016/04/15 8:11:13 ET]
Table 'Parvulesco II' 9-max Seat #6 is the button
Seat 1: bilukm ($86.09 in chips) 
Seat 2: Filojoes ($107.04 in chips) 
Seat 3: matiko09 ($125.17 in chips) 
Seat 4: butcheN18 ($100 in chips) 
Seat 5: maxxmeister ($105.60 in chips) 
Seat 6: ruslik_by ($125.23 in chips) 
Seat 7: Kukuryzka ($133.94 in chips) 
Seat 8: Jimy Tiltman ($113.42 in chips) 
Seat 9: hammerwife ($187.97 in chips) 
Kukuryzka: posts small blind $0.50
Jimy Tiltman: posts big blind $1
*** HOLE CARDS ***
Dealt to matiko09 [Js 9s]
hammerwife: folds 
bilukm: calls $1
Filojoes: folds 
matiko09: raises $4 to $5
butcheN18: folds 
maxxmeister: folds 
ruslik_by: folds 
Kukuryzka: folds 
Jimy Tiltman: folds 
bilukm: calls $4
*** FLOP *** [Kd 8d 7h]
bilukm: checks 
matiko09: bets $6
bilukm: calls $6
*** TURN *** [Kd 8d 7h] [Qs]
bilukm: checks 
matiko09: checks 
*** RIVER *** [Kd 8d 7h Qs] [2h]
bilukm: checks 
matiko09: checks 
*** SHOW DOWN ***
bilukm: shows [2d 3d] (a pair of Deuces)
matiko09: mucks hand 
bilukm collected $22.32 from pot
*** SUMMARY ***
Total pot $23.50 | Rake $1.18 
Board [Kd 8d 7h Qs 2h]
Seat 1: bilukm showed [2d 3d] and won ($22.32) with a pair of Deuces
Seat 2: Filojoes folded before Flop (didn't bet)
Seat 3: matiko09 mucked [Js 9s]
Seat 4: butcheN18 folded before Flop (didn't bet)
Seat 5: maxxmeister folded before Flop (didn't bet)
Seat 6: ruslik_by (button) folded before Flop (didn't bet)
Seat 7: Kukuryzka (small blind) folded before Flop
Seat 8: Jimy Tiltman (big blind) folded before Flop
Seat 9: hammerwife folded before Flop (didn't bet)





PokerStars Hand #151943903933:  Hold'em No Limit ($1/$2 USD) - 2016/04/15 14:11:22 CET [2016/04/15 8:11:22 ET]
Table 'Blaauw' 9-max Seat #8 is the button
Seat 1: myatiy 96 ($204 in chips) 
Seat 2: butcheN18 ($244.19 in chips) 
Seat 3: Glushchenko ($225.11 in chips) 
Seat 4: petro0107 ($219.72 in chips) 
Seat 5: tipner ($215.40 in chips) 
Seat 6: matiko09 ($290.90 in chips) 
Seat 7: ssljvr ($413.95 in chips) 
Seat 8: Iggso ($201.50 in chips) 
Seat 9: coinflip_si ($200 in chips) 
coinflip_si: posts small blind $1
myatiy 96: posts big blind $2
*** HOLE CARDS ***
Dealt to matiko09 [9s 7s]
butcheN18: raises $4 to $6
Glushchenko: folds 
petro0107: folds 
tipner: raises $12 to $18
matiko09: folds 
ssljvr: folds 
Iggso: folds 
coinflip_si: folds 
myatiy 96: folds 
butcheN18: folds 
Uncalled bet ($12) returned to tipner
tipner collected $15 from pot
tipner: doesn't show hand 
*** SUMMARY ***
Total pot $15 | Rake $0 
Seat 1: myatiy 96 (big blind) folded before Flop
Seat 2: butcheN18 folded before Flop
Seat 3: Glushchenko folded before Flop (didn't bet)
Seat 4: petro0107 folded before Flop (didn't bet)
Seat 5: tipner collected ($15)
Seat 6: matiko09 folded before Flop (didn't bet)
Seat 7: ssljvr folded before Flop (didn't bet)
Seat 8: Iggso (button) folded before Flop (didn't bet)
Seat 9: coinflip_si (small blind) folded before Flop





PokerStars Hand #151943903775:  Hold'em No Limit ($1/$2 USD) - 2016/04/15 14:11:22 CET [2016/04/15 8:11:22 ET]
Table 'Marmara II' 9-max Seat #5 is the button
Seat 1: ssljvr ($491.98 in chips) 
Seat 2: Iggso ($200 in chips) 
Seat 3: Glushchenko ($209.44 in chips) 
Seat 4: Fish4trips ($244.96 in chips) 
Seat 5: docmarc777 ($421.55 in chips) 
Seat 6: azzad2007 ($200 in chips) 
Seat 7: matiko09 ($205 in chips) 
Seat 8: Dachish ($139 in chips) 
Seat 9: erfk1958 ($133.25 in chips) 
azzad2007: posts small blind $1
matiko09: posts big blind $2
*** HOLE CARDS ***
Dealt to matiko09 [Qc Js]
Dachish: folds 
erfk1958: folds 
ssljvr: folds 
Iggso: folds 
Glushchenko: folds 
Fish4trips: folds 
docmarc777: folds 
azzad2007: raises $2.80 to $4.80
matiko09: calls $2.80
*** FLOP *** [Th 9s 2c]
azzad2007: bets $2.55
matiko09: calls $2.55
*** TURN *** [Th 9s 2c] [3c]
azzad2007: checks 
matiko09: bets $9.07
azzad2007: folds 
Uncalled bet ($9.07) returned to matiko09
matiko09 collected $13.96 from pot
matiko09: doesn't show hand 
*** SUMMARY ***
Total pot $14.70 | Rake $0.74 
Board [Th 9s 2c 3c]
Seat 1: ssljvr folded before Flop (didn't bet)
Seat 2: Iggso folded before Flop (didn't bet)
Seat 3: Glushchenko folded before Flop (didn't bet)
Seat 4: Fish4trips folded before Flop (didn't bet)
Seat 5: docmarc777 (button) folded before Flop (didn't bet)
Seat 6: azzad2007 (small blind) folded on the Turn
Seat 7: matiko09 (big blind) collected ($13.96)
Seat 8: Dachish folded before Flop (didn't bet)
Seat 9: erfk1958 folded before Flop (didn't bet)





PokerStars Hand #151943906208:  Hold'em No Limit ($1/$2 USD) - 2016/04/15 14:11:27 CET [2016/04/15 8:11:27 ET]
Table 'Oceax' 9-max Seat #8 is the button
Seat 1: matiko09 ($200 in chips) 
Seat 2: Fish4trips ($328.05 in chips) 
Seat 3: Glushchenko ($200 in chips) 
Seat 4: butcheN18 ($296.46 in chips) 
Seat 5: derrocco82 ($192 in chips) 
Seat 6: Iggso ($276.93 in chips) 
Seat 7: ssljvr ($250.60 in chips) 
Seat 8: Poroxide ($326.97 in chips) 
Seat 9: erfk1958 ($118.08 in chips) 
erfk1958: posts small blind $1
matiko09: posts big blind $2
*** HOLE CARDS ***
Dealt to matiko09 [Jh 9d]
Fish4trips: folds 
Glushchenko: folds 
butcheN18: folds 
derrocco82: folds 
Iggso: folds 
ssljvr: folds 
Poroxide: folds 
erfk1958: raises $2 to $4
matiko09: calls $2
*** FLOP *** [9c Kd 3c]
erfk1958: bets $6
matiko09: calls $6
*** TURN *** [9c Kd 3c] [5s]
erfk1958: bets $16
matiko09: calls $16
*** RIVER *** [9c Kd 3c 5s] [Jd]
erfk1958: checks 
matiko09: bets $32
erfk1958: calls $32
*** SHOW DOWN ***
matiko09: shows [Jh 9d] (two pair, Jacks and Nines)
erfk1958: shows [Ks Kh] (three of a kind, Kings)
erfk1958 collected $113.25 from pot
*** SUMMARY ***
Total pot $116 | Rake $2.75 
Board [9c Kd 3c 5s Jd]
Seat 1: matiko09 (big blind) showed [Jh 9d] and lost with two pair, Jacks and Nines
Seat 2: Fish4trips folded before Flop (didn't bet)
Seat 3: Glushchenko folded before Flop (didn't bet)
Seat 4: butcheN18 folded before Flop (didn't bet)
Seat 5: derrocco82 folded before Flop (didn't bet)
Seat 6: Iggso folded before Flop (didn't bet)
Seat 7: ssljvr folded before Flop (didn't bet)
Seat 8: Poroxide (button) folded before Flop (didn't bet)
Seat 9: erfk1958 (small blind) showed [Ks Kh] and won ($113.25) with three of a kind, Kings





PokerStars Hand #151943909580:  Hold'em No Limit ($0.50/$1.00 USD) - 2016/04/15 14:11:33 CET [2016/04/15 8:11:33 ET]
Table 'Chiny II' 9-max Seat #5 is the button
Seat 1: vrnMike ($156.06 in chips) 
Seat 2: Westpants ($153.19 in chips) 
Seat 3: Foton18 ($77.12 in chips) 
Seat 4: matiko09 ($172.90 in chips) 
Seat 5: omorfadramou ($165 in chips) 
Seat 6: choupai ($11.53 in chips) 
Seat 7: ruslik_by ($104.12 in chips) 
Seat 8: Filojoes ($136.24 in chips) 
Seat 9: butcheN18 ($100 in chips) 
choupai: posts small blind $0.50
ruslik_by: posts big blind $1
*** HOLE CARDS ***
Dealt to matiko09 [Qd 6h]
Filojoes: folds 
butcheN18: folds 
vrnMike: folds 
Westpants: folds 
Foton18: folds 
matiko09: folds 
omorfadramou: raises $1 to $2
choupai: raises $5 to $7
ruslik_by: folds 
omorfadramou: folds 
Uncalled bet ($5) returned to choupai
choupai collected $5 from pot
choupai: doesn't show hand 
*** SUMMARY ***
Total pot $5 | Rake $0 
Seat 1: vrnMike folded before Flop (didn't bet)
Seat 2: Westpants folded before Flop (didn't bet)
Seat 3: Foton18 folded before Flop (didn't bet)
Seat 4: matiko09 folded before Flop (didn't bet)
Seat 5: omorfadramou (button) folded before Flop
Seat 6: choupai (small blind) collected ($5)
Seat 7: ruslik_by (big blind) folded before Flop
Seat 8: Filojoes folded before Flop (didn't bet)
Seat 9: butcheN18 folded before Flop (didn't bet)





PokerStars Hand #151943916844:  Hold'em No Limit ($0.50/$1.00 USD) - 2016/04/15 14:11:47 CET [2016/04/15 8:11:47 ET]
Table 'Emma II' 9-max Seat #4 is the button
Seat 1: omorfadramou ($100 in chips) 
Seat 2: Filojoes ($142.50 in chips) 
Seat 3: Glushchenko ($269.29 in chips) 
Seat 4: matiko09 ($100 in chips) 
Seat 5: Prettyspitz ($102.65 in chips) 
Seat 6: Tirka ($97.60 in chips) 
Seat 7: ruslik_by ($104 in chips) 
Seat 9: Foton18 ($138.34 in chips) 
Prettyspitz: posts small blind $0.50
Tirka: posts big blind $1
Vikulja1993: sits out 
*** HOLE CARDS ***
Dealt to matiko09 [8s 9c]
ruslik_by: folds 
Foton18: folds 
omorfadramou: folds 
Filojoes: raises $2 to $3
Glushchenko: folds 
matiko09: folds 
Prettyspitz: folds 
Tirka: folds 
Uncalled bet ($2) returned to Filojoes
Filojoes collected $2.50 from pot
Filojoes: doesn't show hand 
*** SUMMARY ***
Total pot $2.50 | Rake $0 
Seat 1: omorfadramou folded before Flop (didn't bet)
Seat 2: Filojoes collected ($2.50)
Seat 3: Glushchenko folded before Flop (didn't bet)
Seat 4: matiko09 (button) folded before Flop (didn't bet)
Seat 5: Prettyspitz (small blind) folded before Flop
Seat 6: Tirka (big blind) folded before Flop
Seat 7: ruslik_by folded before Flop (didn't bet)
Seat 9: Foton18 folded before Flop (didn't bet)





PokerStars Hand #151943922095:  Hold'em No Limit ($0.50/$1.00 USD) - 2016/04/15 14:11:57 CET [2016/04/15 8:11:57 ET]
Table 'Adelgunde III' 9-max Seat #5 is the button
Seat 1: valimiu ($133.30 in chips) 
Seat 2: Vikulja1993 ($100 in chips) 
Seat 3: tipner ($123.20 in chips) 
Seat 4: hammerwife ($131.23 in chips) 
Seat 5: matiko09 ($137.93 in chips) 
Seat 6: Pominator92 ($88.86 in chips) 
Seat 7: Yaaaazz ($100 in chips) 
Seat 8: SanychStar ($133.06 in chips) 
Seat 9: Kukuryzka ($124.51 in chips) 
Pominator92: posts small blind $0.50
Yaaaazz: posts big blind $1
*** HOLE CARDS ***
Dealt to matiko09 [Jc Qh]
SanychStar: folds 
Kukuryzka: folds 
valimiu: calls $1
Vikulja1993: folds 
tipner: folds 
hammerwife has timed out
hammerwife: folds 
matiko09: raises $3 to $4
Pominator92: calls $3.50
Yaaaazz: folds 
valimiu: folds 
*** FLOP *** [Ad Qs Th]
Pominator92: checks 
matiko09: checks 
*** TURN *** [Ad Qs Th] [Kc]
Pominator92: checks 
matiko09: bets $6.18
Pominator92: folds 
Uncalled bet ($6.18) returned to matiko09
matiko09 collected $9.50 from pot
matiko09: doesn't show hand 
*** SUMMARY ***
Total pot $10 | Rake $0.50 
Board [Ad Qs Th Kc]
Seat 1: valimiu folded before Flop
Seat 2: Vikulja1993 folded before Flop (didn't bet)
Seat 3: tipner folded before Flop (didn't bet)
Seat 4: hammerwife folded before Flop (didn't bet)
Seat 5: matiko09 (button) collected ($9.50)
Seat 6: Pominator92 (small blind) folded on the Turn
Seat 7: Yaaaazz (big blind) folded before Flop
Seat 8: SanychStar folded before Flop (didn't bet)
Seat 9: Kukuryzka folded before Flop (didn't bet)





PokerStars Hand #151943926221:  Hold'em No Limit ($0.50/$1.00 USD) - 2016/04/15 14:12:05 CET [2016/04/15 8:12:05 ET]
Table 'Chiny II' 9-max Seat #6 is the button
Seat 1: vrnMike ($156.06 in chips) 
Seat 2: Westpants ($153.19 in chips) 
Seat 3: Foton18 ($77.12 in chips) 
Seat 4: matiko09 ($172.90 in chips) 
Seat 5: omorfadramou ($163 in chips) 
Seat 6: choupai ($14.53 in chips) 
Seat 7: ruslik_by ($103.12 in chips) 
Seat 8: Filojoes ($136.24 in chips) 
Seat 9: butcheN18 ($100 in chips) 
ruslik_by: posts small blind $0.50
Filojoes: posts big blind $1
*** HOLE CARDS ***
Dealt to matiko09 [4c 7c]
butcheN18: folds 
vrnMike: folds 
Westpants: raises $2 to $3
Foton18: folds 
matiko09: folds 
omorfadramou: folds 
choupai: folds 
ruslik_by: folds 
Filojoes: folds 
Uncalled bet ($2) returned to Westpants
Westpants collected $2.50 from pot
*** SUMMARY ***
Total pot $2.50 | Rake $0 
Seat 1: vrnMike folded before Flop (didn't bet)
Seat 2: Westpants collected ($2.50)
Seat 3: Foton18 folded before Flop (didn't bet)
Seat 4: matiko09 folded before Flop (didn't bet)
Seat 5: omorfadramou folded before Flop (didn't bet)
Seat 6: choupai (button) folded before Flop (didn't bet)
Seat 7: ruslik_by (small blind) folded before Flop
Seat 8: Filojoes (big blind) folded before Flop
Seat 9: butcheN18 folded before Flop (didn't bet)





PokerStars Hand #151943932713:  Hold'em No Limit ($0.50/$1.00 USD) - 2016/04/15 14:12:18 CET [2016/04/15 8:12:18 ET]
Table 'Navi' 9-max Seat #6 is the button
Seat 1: tipner ($113.33 in chips) 
Seat 2: myatiy 96 ($100 in chips) 
Seat 3: vrnMike ($140.35 in chips) 
Seat 4: Pvsx. ($110.60 in chips) 
Seat 6: Vikulja1993 ($123.90 in chips) 
Seat 8: ruslik_by ($100 in chips) 
Seat 9: matiko09 ($128.13 in chips) 
ruslik_by: posts small blind $0.50
matiko09: posts big blind $1
Prettyspitz: sits out 
*** HOLE CARDS ***
Dealt to matiko09 [7d 3d]
tipner: folds 
myatiy 96: folds 
vrnMike: folds 
Pvsx.: raises $1.50 to $2.50
Vikulja1993: folds 
ruslik_by: folds 
matiko09: folds 
Uncalled bet ($1.50) returned to Pvsx.
Pvsx. collected $2.50 from pot
Pvsx.: doesn't show hand 
*** SUMMARY ***
Total pot $2.50 | Rake $0 
Seat 1: tipner folded before Flop (didn't bet)
Seat 2: myatiy 96 folded before Flop (didn't bet)
Seat 3: vrnMike folded before Flop (didn't bet)
Seat 4: Pvsx. collected ($2.50)
Seat 6: Vikulja1993 (button) folded before Flop (didn't bet)
Seat 8: ruslik_by (small blind) folded before Flop
Seat 9: matiko09 (big blind) folded before Flop





PokerStars Hand #151943935390:  Hold'em No Limit ($1/$2 USD) - 2016/04/15 14:12:23 CET [2016/04/15 8:12:23 ET]
Table 'Blaauw' 9-max Seat #9 is the button
Seat 1: myatiy 96 ($202 in chips) 
Seat 2: butcheN18 ($238.19 in chips) 
Seat 3: Glushchenko ($225.11 in chips) 
Seat 4: petro0107 ($219.72 in chips) 
Seat 5: tipner ($224.40 in chips) 
Seat 6: matiko09 ($290.90 in chips) 
Seat 7: ssljvr ($413.95 in chips) 
Seat 8: Iggso ($201.50 in chips) 
Seat 9: coinflip_si ($200 in chips) 
myatiy 96: posts small blind $1
butcheN18: posts big blind $2
*** HOLE CARDS ***
Dealt to matiko09 [9s Kc]
Glushchenko: folds 
Glushchenko leaves the table
petro0107: folds 
erfk1958 joins the table at seat #3 
tipner: folds 
matiko09: folds 
ssljvr: folds 
Iggso: folds 
coinflip_si: folds 
myatiy 96: folds 
Uncalled bet ($1) returned to butcheN18
butcheN18 collected $2 from pot
butcheN18: doesn't show hand 
*** SUMMARY ***
Total pot $2 | Rake $0 
Seat 1: myatiy 96 (small blind) folded before Flop
Seat 2: butcheN18 (big blind) collected ($2)
Seat 3: Glushchenko folded before Flop (didn't bet)
Seat 4: petro0107 folded before Flop (didn't bet)
Seat 5: tipner folded before Flop (didn't bet)
Seat 6: matiko09 folded before Flop (didn't bet)
Seat 7: ssljvr folded before Flop (didn't bet)
Seat 8: Iggso folded before Flop (didn't bet)
Seat 9: coinflip_si (button) folded before Flop (didn't bet)





PokerStars Hand #151943938776:  Hold'em No Limit ($0.50/$1.00 USD) - 2016/04/15 14:12:30 CET [2016/04/15 8:12:30 ET]
Table 'Chiny II' 9-max Seat #7 is the button
Seat 1: vrnMike ($156.06 in chips) 
Seat 2: Westpants ($154.69 in chips) 
Seat 3: Foton18 ($77.12 in chips) 
Seat 4: matiko09 ($172.90 in chips) 
Seat 5: omorfadramou ($163 in chips) 
Seat 6: choupai ($14.53 in chips) 
Seat 7: ruslik_by ($102.62 in chips) 
Seat 8: Filojoes ($135.24 in chips) 
Seat 9: butcheN18 ($100 in chips) 
Filojoes: posts small blind $0.50
butcheN18: posts big blind $1
*** HOLE CARDS ***
Dealt to matiko09 [4d 3c]
vrnMike: folds 
Westpants: folds 
Foton18: folds 
matiko09: folds 
omorfadramou: folds 
choupai: folds 
ruslik_by: raises $1.50 to $2.50
Filojoes: calls $2
butcheN18: folds 
*** FLOP *** [6h 2h 4h]
Filojoes: checks 
ruslik_by: bets $3
Filojoes: raises $6 to $9
ruslik_by: folds 
Uncalled bet ($6) returned to Filojoes
Filojoes collected $11.40 from pot
Filojoes: doesn't show hand 
*** SUMMARY ***
Total pot $12 | Rake $0.60 
Board [6h 2h 4h]
Seat 1: vrnMike folded before Flop (didn't bet)
Seat 2: Westpants folded before Flop (didn't bet)
Seat 3: Foton18 folded before Flop (didn't bet)
Seat 4: matiko09 folded before Flop (didn't bet)
Seat 5: omorfadramou folded before Flop (didn't bet)
Seat 6: choupai folded before Flop (didn't bet)
Seat 7: ruslik_by (button) folded on the Flop
Seat 8: Filojoes (small blind) collected ($11.40)
Seat 9: butcheN18 (big blind) folded before Flop





PokerStars Hand #151943940657:  Hold'em No Limit ($0.50/$1.00 USD) - 2016/04/15 14:12:33 CET [2016/04/15 8:12:33 ET]
Table 'Emma II' 9-max Seat #5 is the button
Seat 1: omorfadramou ($100 in chips) 
Seat 2: Filojoes ($144 in chips) 
Seat 3: Glushchenko ($269.29 in chips) 
Seat 4: matiko09 ($100 in chips) 
Seat 5: Prettyspitz ($102.15 in chips) 
Seat 6: Tirka ($96.60 in chips) 
Seat 7: ruslik_by ($104 in chips) 
Seat 9: Foton18 ($138.34 in chips) 
Tirka: posts small blind $0.50
ruslik_by: posts big blind $1
Vikulja1993: sits out 
*** HOLE CARDS ***
Dealt to matiko09 [Ts Kd]
Foton18: raises $2 to $3
omorfadramou: folds 
Filojoes: folds 
Glushchenko: folds 
Vikulja1993 leaves the table
matiko09: folds 
geiranger011 joins the table at seat #8 
Prettyspitz: folds 
Tirka: calls $2.50
ruslik_by: folds 
*** FLOP *** [7h 9d As]
Tirka: checks 
Foton18: bets $3
Tirka: calls $3
*** TURN *** [7h 9d As] [4h]
Tirka: checks 
Foton18: checks 
*** RIVER *** [7h 9d As 4h] [2h]
Tirka: checks 
Foton18: bets $6
Tirka: calls $6
*** SHOW DOWN ***
Foton18: shows [6s 3s] (high card Ace)
Tirka: shows [Qh Qs] (a pair of Queens)
Tirka collected $23.75 from pot
*** SUMMARY ***
Total pot $25 | Rake $1.25 
Board [7h 9d As 4h 2h]
Seat 1: omorfadramou folded before Flop (didn't bet)
Seat 2: Filojoes folded before Flop (didn't bet)
Seat 3: Glushchenko folded before Flop (didn't bet)
Seat 4: matiko09 folded before Flop (didn't bet)
Seat 5: Prettyspitz (button) folded before Flop (didn't bet)
Seat 6: Tirka (small blind) showed [Qh Qs] and won ($23.75) with a pair of Queens
Seat 7: ruslik_by (big blind) folded before Flop
Seat 9: Foton18 showed [6s 3s] and lost with high card Ace





PokerStars Hand #151943941288:  Hold'em No Limit ($1/$2 USD) - 2016/04/15 14:12:34 CET [2016/04/15 8:12:34 ET]
Table 'Oceax' 9-max Seat #9 is the button
Seat 1: matiko09 ($200 in chips) 
Seat 2: Fish4trips ($328.05 in chips) 
Seat 3: Glushchenko ($200 in chips) 
Seat 4: butcheN18 ($296.46 in chips) 
Seat 5: derrocco82 ($192 in chips) 
Seat 6: Iggso ($276.93 in chips) 
Seat 7: ssljvr ($250.60 in chips) 
Seat 8: Poroxide ($326.97 in chips) 
Seat 9: erfk1958 ($173.33 in chips) 
matiko09: posts small blind $1
Fish4trips: posts big blind $2
*** HOLE CARDS ***
Dealt to matiko09 [Ks Ts]
Glushchenko: raises $4 to $6
butcheN18: folds 
derrocco82: folds 
Iggso: folds 
ssljvr: folds 
Poroxide: folds 
erfk1958: folds 
matiko09: folds 
matiko09 said, ":D"
Fish4trips: raises $14 to $20
Glushchenko: calls $14
*** FLOP *** [5c 4h Ah]
Fish4trips: checks 
Glushchenko: bets $20
Fish4trips: calls $20
*** TURN *** [5c 4h Ah] [4c]
Fish4trips: checks 
Glushchenko: bets $44
Fish4trips: folds 
Uncalled bet ($44) returned to Glushchenko
Glushchenko collected $78.25 from pot
*** SUMMARY ***
Total pot $81 | Rake $2.75 
Board [5c 4h Ah 4c]
Seat 1: matiko09 (small blind) folded before Flop
Seat 2: Fish4trips (big blind) folded on the Turn
Seat 3: Glushchenko collected ($78.25)
Seat 4: butcheN18 folded before Flop (didn't bet)
Seat 5: derrocco82 folded before Flop (didn't bet)
Seat 6: Iggso folded before Flop (didn't bet)
Seat 7: ssljvr folded before Flop (didn't bet)
Seat 8: Poroxide folded before Flop (didn't bet)
Seat 9: erfk1958 (button) folded before Flop (didn't bet)





PokerStars Hand #151943944463:  Hold'em No Limit ($1/$2 USD) - 2016/04/15 14:12:41 CET [2016/04/15 8:12:41 ET]
Table 'Adele II' 9-max Seat #4 is the button
Seat 1: RyanHuJun ($345.17 in chips) 
Seat 2: Fish4trips ($323.54 in chips) 
Seat 3: matiko09 ($311.33 in chips) 
Seat 4: Glushchenko ($207.05 in chips) 
Seat 5: TonnaMunz ($201 in chips) 
Seat 6: Kukuryzka ($211.25 in chips) 
Seat 7: Iggso ($200 in chips) 
Seat 8: butcheN18 ($248.67 in chips) 
Seat 9: SanychStar ($279.60 in chips) 
TonnaMunz: posts small blind $1
Kukuryzka: posts big blind $2
*** HOLE CARDS ***
Dealt to matiko09 [3d 2s]
Iggso: raises $4 to $6
butcheN18: folds 
SanychStar: folds 
RyanHuJun: calls $6
Fish4trips: folds 
matiko09: folds 
Glushchenko: folds 
TonnaMunz: calls $5
Kukuryzka: raises $22 to $28
Iggso: folds 
RyanHuJun: folds 
TonnaMunz: folds 
Uncalled bet ($22) returned to Kukuryzka
Kukuryzka collected $24 from pot
Kukuryzka: doesn't show hand 
*** SUMMARY ***
Total pot $24 | Rake $0 
Seat 1: RyanHuJun folded before Flop
Seat 2: Fish4trips folded before Flop (didn't bet)
Seat 3: matiko09 folded before Flop (didn't bet)
Seat 4: Glushchenko (button) folded before Flop (didn't bet)
Seat 5: TonnaMunz (small blind) folded before Flop
Seat 6: Kukuryzka (big blind) collected ($24)
Seat 7: Iggso folded before Flop
Seat 8: butcheN18 folded before Flop (didn't bet)
Seat 9: SanychStar folded before Flop (didn't bet)





PokerStars Hand #151943945236:  Hold'em No Limit ($0.50/$1.00 USD) - 2016/04/15 14:12:42 CET [2016/04/15 8:12:42 ET]
Table 'Navi' 9-max Seat #8 is the button
Seat 1: tipner ($113.33 in chips) 
Seat 2: myatiy 96 ($100 in chips) 
Seat 3: vrnMike ($140.35 in chips) 
Seat 4: Pvsx. ($112.10 in chips) 
Seat 6: Vikulja1993 ($123.90 in chips) 
Seat 8: ruslik_by ($100 in chips) 
Seat 9: matiko09 ($127.13 in chips) 
matiko09: posts small blind $0.50
tipner: posts big blind $1
Prettyspitz: sits out 
*** HOLE CARDS ***
Dealt to matiko09 [Ac 3d]
myatiy 96: folds 
vrnMike: folds 
Pvsx.: raises $1.50 to $2.50
Vikulja1993: folds 
ruslik_by: raises $6 to $8.50
matiko09: folds 
tipner: folds 
Pvsx.: folds 
Uncalled bet ($6) returned to ruslik_by
ruslik_by collected $6.50 from pot
ruslik_by: doesn't show hand 
*** SUMMARY ***
Total pot $6.50 | Rake $0 
Seat 1: tipner (big blind) folded before Flop
Seat 2: myatiy 96 folded before Flop (didn't bet)
Seat 3: vrnMike folded before Flop (didn't bet)
Seat 4: Pvsx. folded before Flop
Seat 6: Vikulja1993 folded before Flop (didn't bet)
Seat 8: ruslik_by (button) collected ($6.50)
Seat 9: matiko09 (small blind) folded before Flop





PokerStars Hand #151943947957:  Hold'em No Limit ($0.50/$1.00 USD) - 2016/04/15 14:12:47 CET [2016/04/15 8:12:47 ET]
Table 'Parvulesco II' 9-max Seat #7 is the button
Seat 1: bilukm ($97.41 in chips) 
Seat 2: Filojoes ($107.04 in chips) 
Seat 3: matiko09 ($114.17 in chips) 
Seat 4: butcheN18 ($100 in chips) 
Seat 5: maxxmeister ($105.60 in chips) 
Seat 6: ruslik_by ($125.23 in chips) 
Seat 7: Kukuryzka ($133.44 in chips) 
Seat 8: Jimy Tiltman ($112.42 in chips) 
Seat 9: hammerwife ($187.97 in chips) 
Jimy Tiltman: posts small blind $0.50
hammerwife: posts big blind $1
*** HOLE CARDS ***
Dealt to matiko09 [Qh Qd]
bilukm: calls $1
Filojoes: folds 
matiko09: raises $4 to $5
butcheN18: folds 
maxxmeister: folds 
ruslik_by: folds 
Kukuryzka: folds 
Jimy Tiltman: folds 
hammerwife: folds 
bilukm: calls $4
*** FLOP *** [9c As 6s]
bilukm: checks 
matiko09: checks 
*** TURN *** [9c As 6s] [7d]
bilukm: bets $5.46
matiko09: calls $5.46
*** RIVER *** [9c As 6s 7d] [Qs]
bilukm: checks 
matiko09: bets $12
bilukm: folds 
Uncalled bet ($12) returned to matiko09
matiko09 collected $21.30 from pot
matiko09: doesn't show hand 
*** SUMMARY ***
Total pot $22.42 | Rake $1.12 
Board [9c As 6s 7d Qs]
Seat 1: bilukm folded on the River
Seat 2: Filojoes folded before Flop (didn't bet)
Seat 3: matiko09 collected ($21.30)
Seat 4: butcheN18 folded before Flop (didn't bet)
Seat 5: maxxmeister folded before Flop (didn't bet)
Seat 6: ruslik_by folded before Flop (didn't bet)
Seat 7: Kukuryzka (button) folded before Flop (didn't bet)
Seat 8: Jimy Tiltman (small blind) folded before Flop
Seat 9: hammerwife (big blind) folded before Flop





PokerStars Hand #151943951054:  Hold'em No Limit ($1/$2 USD) - 2016/04/15 14:12:53 CET [2016/04/15 8:12:53 ET]
Table 'Blaauw' 9-max Seat #1 is the button
Seat 1: myatiy 96 ($201 in chips) 
Seat 2: butcheN18 ($239.19 in chips) 
Seat 3: erfk1958 ($122 in chips) 
Seat 4: petro0107 ($219.72 in chips) 
Seat 5: tipner ($224.40 in chips) 
Seat 6: matiko09 ($290.90 in chips) 
Seat 7: ssljvr ($413.95 in chips) 
Seat 8: Iggso ($201.50 in chips) 
Seat 9: coinflip_si ($200 in chips) 
butcheN18: posts small blind $1
erfk1958: posts big blind $2
*** HOLE CARDS ***
Dealt to matiko09 [3s 7s]
petro0107: calls $2
tipner: folds 
matiko09: folds 
ssljvr: folds 
Iggso: raises $4 to $6
coinflip_si: folds 
myatiy 96: calls $6
butcheN18: folds 
erfk1958: folds 
petro0107: calls $4
*** FLOP *** [8d 9s Tc]
petro0107: checks 
Iggso: checks 
myatiy 96: bets $9.97
petro0107: calls $9.97
Iggso: calls $9.97
*** TURN *** [8d 9s Tc] [Ad]
petro0107: checks 
Iggso: checks 
myatiy 96: checks 
*** RIVER *** [8d 9s Tc Ad] [Ac]
petro0107: checks 
Iggso: checks 
myatiy 96: checks 
*** SHOW DOWN ***
petro0107: shows [7c 8s] (two pair, Aces and Eights)
Iggso: shows [Jc 9c] (two pair, Aces and Nines)
myatiy 96: shows [Ks Ts] (two pair, Aces and Tens)
myatiy 96 collected $48.36 from pot
*** SUMMARY ***
Total pot $50.91 | Rake $2.55 
Board [8d 9s Tc Ad Ac]
Seat 1: myatiy 96 (button) showed [Ks Ts] and won ($48.36) with two pair, Aces and Tens
Seat 2: butcheN18 (small blind) folded before Flop
Seat 3: erfk1958 (big blind) folded before Flop
Seat 4: petro0107 showed [7c 8s] and lost with two pair, Aces and Eights
Seat 5: tipner folded before Flop (didn't bet)
Seat 6: matiko09 folded before Flop (didn't bet)
Seat 7: ssljvr folded before Flop (didn't bet)
Seat 8: Iggso showed [Jc 9c] and lost with two pair, Aces and Nines
Seat 9: coinflip_si folded before Flop (didn't bet)





PokerStars Hand #151943957137:  Hold'em No Limit ($0.50/$1.00 USD) - 2016/04/15 14:13:05 CET [2016/04/15 8:13:05 ET]
Table 'Navi' 9-max Seat #9 is the button
Seat 1: tipner ($112.33 in chips) 
Seat 2: myatiy 96 ($100 in chips) 
Seat 3: vrnMike ($140.35 in chips) 
Seat 4: Pvsx. ($109.60 in chips) 
Seat 6: Vikulja1993 ($123.90 in chips) 
Seat 8: ruslik_by ($104 in chips) 
Seat 9: matiko09 ($126.63 in chips) 
tipner: posts small blind $0.50
myatiy 96: posts big blind $1
Prettyspitz: sits out 
*** HOLE CARDS ***
Dealt to matiko09 [Qh 2c]
vrnMike: folds 
Pvsx.: folds 
Vikulja1993: folds 
ruslik_by: raises $1.50 to $2.50
matiko09: folds 
tipner: folds 
myatiy 96: folds 
Uncalled bet ($1.50) returned to ruslik_by
ruslik_by collected $2.50 from pot
ruslik_by: doesn't show hand 
*** SUMMARY ***
Total pot $2.50 | Rake $0 
Seat 1: tipner (small blind) folded before Flop
Seat 2: myatiy 96 (big blind) folded before Flop
Seat 3: vrnMike folded before Flop (didn't bet)
Seat 4: Pvsx. folded before Flop (didn't bet)
Seat 6: Vikulja1993 folded before Flop (didn't bet)
Seat 8: ruslik_by collected ($2.50)
Seat 9: matiko09 (button) folded before Flop (didn't bet)





PokerStars Hand #151943962508:  Hold'em No Limit ($0.50/$1.00 USD) - 2016/04/15 14:13:15 CET [2016/04/15 8:13:15 ET]
Table 'Adelgunde III' 9-max Seat #6 is the button
Seat 1: valimiu ($132.30 in chips) 
Seat 2: Vikulja1993 ($100 in chips) 
Seat 3: tipner ($123.20 in chips) 
Seat 4: hammerwife ($131.23 in chips) 
Seat 5: matiko09 ($143.43 in chips) 
Seat 6: Pominator92 ($84.86 in chips) 
Seat 7: Yaaaazz ($100 in chips) 
Seat 8: SanychStar ($133.06 in chips) 
Seat 9: Kukuryzka ($124.51 in chips) 
Yaaaazz: posts small blind $0.50
SanychStar: posts big blind $1
*** HOLE CARDS ***
Dealt to matiko09 [5d Qs]
Kukuryzka: folds 
valimiu has timed out
valimiu: folds 
Vikulja1993: raises $2 to $3
tipner: folds 
hammerwife: folds 
matiko09: folds 
Pominator92: folds 
Yaaaazz: folds 
SanychStar: folds 
Uncalled bet ($2) returned to Vikulja1993
Vikulja1993 collected $2.50 from pot
Vikulja1993: doesn't show hand 
*** SUMMARY ***
Total pot $2.50 | Rake $0 
Seat 1: valimiu folded before Flop (didn't bet)
Seat 2: Vikulja1993 collected ($2.50)
Seat 3: tipner folded before Flop (didn't bet)
Seat 4: hammerwife folded before Flop (didn't bet)
Seat 5: matiko09 folded before Flop (didn't bet)
Seat 6: Pominator92 (button) folded before Flop (didn't bet)
Seat 7: Yaaaazz (small blind) folded before Flop
Seat 8: SanychStar (big blind) folded before Flop
Seat 9: Kukuryzka folded before Flop (didn't bet)





PokerStars Hand #151943964323:  Hold'em No Limit ($1/$2 USD) - 2016/04/15 14:13:19 CET [2016/04/15 8:13:19 ET]
Table 'Marmara II' 9-max Seat #6 is the button
Seat 1: ssljvr ($491.98 in chips) 
Seat 2: Iggso ($200 in chips) 
Seat 3: Glushchenko ($209.44 in chips) 
Seat 4: Fish4trips ($244.96 in chips) 
Seat 5: docmarc777 ($421.55 in chips) 
Seat 6: azzad2007 ($200 in chips) 
Seat 7: matiko09 ($211.61 in chips) 
Seat 8: Dachish ($139 in chips) 
Seat 9: erfk1958 ($133.25 in chips) 
matiko09: posts small blind $1
Dachish: posts big blind $2
*** HOLE CARDS ***
Dealt to matiko09 [5d 3h]
erfk1958: folds 
ssljvr: folds 
Iggso: folds 
Glushchenko: folds 
Fish4trips: folds 
docmarc777: folds 
azzad2007: folds 
matiko09: folds 
Uncalled bet ($1) returned to Dachish
Dachish collected $2 from pot
Dachish: doesn't show hand 
*** SUMMARY ***
Total pot $2 | Rake $0 
Seat 1: ssljvr folded before Flop (didn't bet)
Seat 2: Iggso folded before Flop (didn't bet)
Seat 3: Glushchenko folded before Flop (didn't bet)
Seat 4: Fish4trips folded before Flop (didn't bet)
Seat 5: docmarc777 folded before Flop (didn't bet)
Seat 6: azzad2007 (button) folded before Flop (didn't bet)
Seat 7: matiko09 (small blind) folded before Flop
Seat 8: Dachish (big blind) collected ($2)
Seat 9: erfk1958 folded before Flop (didn't bet)





PokerStars Hand #151943968411:  Hold'em No Limit ($0.50/$1.00 USD) - 2016/04/15 14:13:27 CET [2016/04/15 8:13:27 ET]
Table 'Emma II' 9-max Seat #6 is the button
Seat 1: omorfadramou ($100 in chips) 
Seat 2: Filojoes ($144 in chips) 
Seat 3: Glushchenko ($269.29 in chips) 
Seat 4: matiko09 ($100 in chips) 
Seat 5: Prettyspitz ($102.15 in chips) 
Seat 6: Tirka ($108.35 in chips) 
Seat 7: ruslik_by ($103 in chips) 
Seat 8: geiranger011 ($100 in chips) 
Seat 9: Foton18 ($126.34 in chips) 
ruslik_by: posts small blind $0.50
geiranger011: posts big blind $1
*** HOLE CARDS ***
Dealt to matiko09 [7h 8h]
Foton18: folds 
omorfadramou: folds 
Filojoes: folds 
Glushchenko: folds 
matiko09: raises $2 to $3
Prettyspitz: folds 
Tirka: folds 
ruslik_by: folds 
geiranger011: folds 
Uncalled bet ($2) returned to matiko09
matiko09 collected $2.50 from pot
matiko09: doesn't show hand 
*** SUMMARY ***
Total pot $2.50 | Rake $0 
Seat 1: omorfadramou folded before Flop (didn't bet)
Seat 2: Filojoes folded before Flop (didn't bet)
Seat 3: Glushchenko folded before Flop (didn't bet)
Seat 4: matiko09 collected ($2.50)
Seat 5: Prettyspitz folded before Flop (didn't bet)
Seat 6: Tirka (button) folded before Flop (didn't bet)
Seat 7: ruslik_by (small blind) folded before Flop
Seat 8: geiranger011 (big blind) folded before Flop
Seat 9: Foton18 folded before Flop (didn't bet)





PokerStars Hand #151943975657:  Hold'em No Limit ($1/$2 USD) - 2016/04/15 14:13:41 CET [2016/04/15 8:13:41 ET]
Table 'Marmara II' 9-max Seat #7 is the button
Seat 1: ssljvr ($491.98 in chips) 
Seat 2: Iggso ($200 in chips) 
Seat 3: Glushchenko ($209.44 in chips) 
Seat 4: Fish4trips ($244.96 in chips) 
Seat 5: docmarc777 ($421.55 in chips) 
Seat 6: azzad2007 ($200 in chips) 
Seat 7: matiko09 ($210.61 in chips) 
Seat 8: Dachish ($140 in chips) 
Seat 9: erfk1958 ($133.25 in chips) 
Dachish: posts small blind $1
erfk1958: posts big blind $2
*** HOLE CARDS ***
Dealt to matiko09 [Qd Kd]
ssljvr: folds 
Iggso: folds 
Glushchenko: folds 
Fish4trips: folds 
docmarc777: folds 
azzad2007: folds 
matiko09: raises $2.54 to $4.54
Dachish: calls $3.54
erfk1958: calls $2.54
*** FLOP *** [2d 3s 5h]
Dachish: checks 
erfk1958: bets $6
matiko09: calls $6
Dachish: raises $18 to $24
erfk1958: raises $104.71 to $128.71 and is all-in
matiko09: folds 
Dachish: folds 
Uncalled bet ($104.71) returned to erfk1958
erfk1958 collected $64.87 from pot
erfk1958: doesn't show hand 
*** SUMMARY ***
Total pot $67.62 | Rake $2.75 
Board [2d 3s 5h]
Seat 1: ssljvr folded before Flop (didn't bet)
Seat 2: Iggso folded before Flop (didn't bet)
Seat 3: Glushchenko folded before Flop (didn't bet)
Seat 4: Fish4trips folded before Flop (didn't bet)
Seat 5: docmarc777 folded before Flop (didn't bet)
Seat 6: azzad2007 folded before Flop (didn't bet)
Seat 7: matiko09 (button) folded on the Flop
Seat 8: Dachish (small blind) folded on the Flop
Seat 9: erfk1958 (big blind) collected ($64.87)





PokerStars Hand #151943978963:  Hold'em No Limit ($0.50/$1.00 USD) - 2016/04/15 14:13:48 CET [2016/04/15 8:13:48 ET]
Table 'Navi' 9-max Seat #1 is the button
Seat 1: tipner ($111.83 in chips) 
Seat 2: myatiy 96 ($100 in chips) 
Seat 3: vrnMike ($140.35 in chips) 
Seat 4: Pvsx. ($109.60 in chips) 
Seat 6: Vikulja1993 ($123.90 in chips) 
Seat 8: ruslik_by ($105.50 in chips) 
Seat 9: matiko09 ($126.63 in chips) 
myatiy 96: posts small blind $0.50
vrnMike: posts big blind $1
Prettyspitz: sits out 
*** HOLE CARDS ***
Dealt to matiko09 [4s Qc]
Pvsx.: raises $1.50 to $2.50
Vikulja1993: folds 
ruslik_by: raises $6 to $8.50
matiko09: folds 
tipner: folds 
myatiy 96: folds 
vrnMike: folds 
Pvsx.: calls $6
*** FLOP *** [7c Kd 2d]
Pvsx.: checks 
ruslik_by: bets $9
Pvsx.: raises $15 to $24
ruslik_by: calls $15
*** TURN *** [7c Kd 2d] [Qs]
Pvsx.: checks 
ruslik_by: checks 
*** RIVER *** [7c Kd 2d Qs] [4d]
Pvsx.: bets $32
ruslik_by: raises $41 to $73 and is all-in
Pvsx.: folds 
Uncalled bet ($41) returned to ruslik_by
ruslik_by collected $128 from pot
ruslik_by: doesn't show hand 
*** SUMMARY ***
Total pot $130.50 | Rake $2.50 
Board [7c Kd 2d Qs 4d]
Seat 1: tipner (button) folded before Flop (didn't bet)
Seat 2: myatiy 96 (small blind) folded before Flop
Seat 3: vrnMike (big blind) folded before Flop
Seat 4: Pvsx. folded on the River
Seat 6: Vikulja1993 folded before Flop (didn't bet)
Seat 8: ruslik_by collected ($128)
Seat 9: matiko09 folded before Flop (didn't bet)





PokerStars Hand #151943982280:  Hold'em No Limit ($1/$2 USD) - 2016/04/15 14:13:54 CET [2016/04/15 8:13:54 ET]
Table 'Adele II' 9-max Seat #5 is the button
Seat 1: RyanHuJun ($339.17 in chips) 
Seat 2: Fish4trips ($323.54 in chips) 
Seat 3: matiko09 ($311.33 in chips) 
Seat 4: Glushchenko ($207.05 in chips) 
Seat 5: TonnaMunz ($200 in chips) 
Seat 6: Kukuryzka ($229.25 in chips) 
Seat 7: Iggso ($200 in chips) 
Seat 8: butcheN18 ($248.67 in chips) 
Seat 9: SanychStar ($279.60 in chips) 
Kukuryzka: posts small blind $1
Iggso: posts big blind $2
*** HOLE CARDS ***
Dealt to matiko09 [6c Jc]
butcheN18: folds 
SanychStar: folds 
RyanHuJun: folds 
Fish4trips: folds 
matiko09: folds 
Glushchenko: folds 
TonnaMunz: raises $2.96 to $4.96
Kukuryzka: raises $11.04 to $16
Iggso: folds 
TonnaMunz: folds 
Uncalled bet ($11.04) returned to Kukuryzka
Kukuryzka collected $11.92 from pot
Kukuryzka: doesn't show hand 
*** SUMMARY ***
Total pot $11.92 | Rake $0 
Seat 1: RyanHuJun folded before Flop (didn't bet)
Seat 2: Fish4trips folded before Flop (didn't bet)
Seat 3: matiko09 folded before Flop (didn't bet)
Seat 4: Glushchenko folded before Flop (didn't bet)
Seat 5: TonnaMunz (button) folded before Flop
Seat 6: Kukuryzka (small blind) collected ($11.92)
Seat 7: Iggso (big blind) folded before Flop
Seat 8: butcheN18 folded before Flop (didn't bet)
Seat 9: SanychStar folded before Flop (didn't bet)





PokerStars Hand #151943982835:  Hold'em No Limit ($0.50/$1.00 USD) - 2016/04/15 14:13:55 CET [2016/04/15 8:13:55 ET]
Table 'Chiny II' 9-max Seat #8 is the button
Seat 1: vrnMike ($156.06 in chips) 
Seat 2: Westpants ($154.69 in chips) 
Seat 3: Foton18 ($77.12 in chips) 
Seat 4: matiko09 ($172.90 in chips) 
Seat 5: omorfadramou ($163 in chips) 
Seat 6: choupai ($14.53 in chips) 
Seat 7: ruslik_by ($100 in chips) 
Seat 8: Filojoes ($141.14 in chips) 
Seat 9: butcheN18 ($100 in chips) 
butcheN18: posts small blind $0.50
vrnMike: posts big blind $1
*** HOLE CARDS ***
Dealt to matiko09 [6d 3h]
Westpants: folds 
Foton18: folds 
matiko09: folds 
omorfadramou: folds 
choupai: raises $2 to $3
ruslik_by: folds 
Filojoes: folds 
butcheN18: folds 
vrnMike: folds 
Uncalled bet ($2) returned to choupai
choupai collected $2.50 from pot
choupai: doesn't show hand 
*** SUMMARY ***
Total pot $2.50 | Rake $0 
Seat 1: vrnMike (big blind) folded before Flop
Seat 2: Westpants folded before Flop (didn't bet)
Seat 3: Foton18 folded before Flop (didn't bet)
Seat 4: matiko09 folded before Flop (didn't bet)
Seat 5: omorfadramou folded before Flop (didn't bet)
Seat 6: choupai collected ($2.50)
Seat 7: ruslik_by folded before Flop (didn't bet)
Seat 8: Filojoes (button) folded before Flop (didn't bet)
Seat 9: butcheN18 (small blind) folded before Flop





PokerStars Hand #151943984768:  Hold'em No Limit ($0.50/$1.00 USD) - 2016/04/15 14:13:59 CET [2016/04/15 8:13:59 ET]
Table 'Adelgunde III' 9-max Seat #7 is the button
Seat 1: valimiu ($132.30 in chips) 
Seat 2: Vikulja1993 ($101.50 in chips) 
Seat 3: tipner ($123.20 in chips) 
Seat 4: hammerwife ($131.23 in chips) 
Seat 5: matiko09 ($143.43 in chips) 
Seat 6: Pominator92 ($84.86 in chips) 
Seat 7: Yaaaazz ($100 in chips) 
Seat 8: SanychStar ($132.06 in chips) 
Seat 9: Kukuryzka ($124.51 in chips) 
SanychStar: posts small blind $0.50
Kukuryzka: posts big blind $1
*** HOLE CARDS ***
Dealt to matiko09 [9d Ah]
valimiu: calls $1
Vikulja1993: folds 
tipner: folds 
hammerwife: folds 
matiko09: raises $4 to $5
Pominator92: calls $5
Yaaaazz: folds 
SanychStar: folds 
Kukuryzka: folds 
valimiu: folds 
*** FLOP *** [2s Th 9h]
matiko09: checks 
Pominator92: bets $5.94
matiko09: calls $5.94
*** TURN *** [2s Th 9h] [3d]
matiko09: checks 
Pominator92: bets $11.58
matiko09: calls $11.58
*** RIVER *** [2s Th 9h 3d] [Jc]
matiko09: checks 
Pominator92: checks 
*** SHOW DOWN ***
matiko09: shows [9d Ah] (a pair of Nines)
Pominator92: shows [7d Td] (a pair of Tens)
Pominator92 collected $45.16 from pot
*** SUMMARY ***
Total pot $47.54 | Rake $2.38 
Board [2s Th 9h 3d Jc]
Seat 1: valimiu folded before Flop
Seat 2: Vikulja1993 folded before Flop (didn't bet)
Seat 3: tipner folded before Flop (didn't bet)
Seat 4: hammerwife folded before Flop (didn't bet)
Seat 5: matiko09 showed [9d Ah] and lost with a pair of Nines
Seat 6: Pominator92 showed [7d Td] and won ($45.16) with a pair of Tens
Seat 7: Yaaaazz (button) folded before Flop (didn't bet)
Seat 8: SanychStar (small blind) folded before Flop
Seat 9: Kukuryzka (big blind) folded before Flop





PokerStars Hand #151943989048:  Hold'em No Limit ($0.50/$1.00 USD) - 2016/04/15 14:14:07 CET [2016/04/15 8:14:07 ET]
Table 'Parvulesco II' 9-max Seat #8 is the button
Seat 1: bilukm ($86.95 in chips) 
Seat 2: Filojoes ($107.04 in chips) 
Seat 3: matiko09 ($125.01 in chips) 
Seat 4: butcheN18 ($100 in chips) 
Seat 5: maxxmeister ($105.60 in chips) 
Seat 6: ruslik_by ($125.23 in chips) 
Seat 7: Kukuryzka ($133.44 in chips) 
Seat 8: Jimy Tiltman ($111.92 in chips) 
Seat 9: hammerwife ($186.97 in chips) 
hammerwife: posts small blind $0.50
bilukm: posts big blind $1
*** HOLE CARDS ***
Dealt to matiko09 [Qs 7h]
Filojoes: folds 
matiko09: folds 
butcheN18: folds 
maxxmeister: folds 
ruslik_by: raises $2 to $3
Kukuryzka: folds 
Jimy Tiltman: folds 
hammerwife: folds 
bilukm: calls $2
*** FLOP *** [Kh 6h 8s]
bilukm: checks 
ruslik_by: bets $3.50
bilukm: calls $3.50
*** TURN *** [Kh 6h 8s] [4s]
bilukm: checks 
ruslik_by: checks 
*** RIVER *** [Kh 6h 8s 4s] [8h]
bilukm: checks 
ruslik_by: checks 
*** SHOW DOWN ***
bilukm: shows [Jc Tc] (a pair of Eights)
ruslik_by: shows [Qh As] (a pair of Eights - Ace kicker)
ruslik_by collected $12.82 from pot
*** SUMMARY ***
Total pot $13.50 | Rake $0.68 
Board [Kh 6h 8s 4s 8h]
Seat 1: bilukm (big blind) showed [Jc Tc] and lost with a pair of Eights
Seat 2: Filojoes folded before Flop (didn't bet)
Seat 3: matiko09 folded before Flop (didn't bet)
Seat 4: butcheN18 folded before Flop (didn't bet)
Seat 5: maxxmeister folded before Flop (didn't bet)
Seat 6: ruslik_by showed [Qh As] and won ($12.82) with a pair of Eights
Seat 7: Kukuryzka folded before Flop (didn't bet)
Seat 8: Jimy Tiltman (button) folded before Flop (didn't bet)
Seat 9: hammerwife (small blind) folded before Flop





PokerStars Hand #151943993914:  Hold'em No Limit ($0.50/$1.00 USD) - 2016/04/15 14:14:17 CET [2016/04/15 8:14:17 ET]
Table 'Emma II' 9-max Seat #7 is the button
Seat 1: omorfadramou ($100 in chips) 
Seat 2: Filojoes ($144 in chips) 
Seat 3: Glushchenko ($269.29 in chips) 
Seat 4: matiko09 ($101.50 in chips) 
Seat 5: Prettyspitz ($102.15 in chips) 
Seat 6: Tirka ($108.35 in chips) 
Seat 7: ruslik_by ($102.50 in chips) 
Seat 8: geiranger011 ($99 in chips) 
Seat 9: Foton18 ($126.34 in chips) 
geiranger011: posts small blind $0.50
Foton18: posts big blind $1
*** HOLE CARDS ***
Dealt to matiko09 [Qs 9s]
omorfadramou: folds 
Filojoes: folds 
Glushchenko: folds 
matiko09: folds 
Prettyspitz: folds 
Tirka: raises $2 to $3
ruslik_by: folds 
geiranger011: folds 
Foton18: calls $2
*** FLOP *** [5c 8c Tc]
Foton18: checks 
Tirka: bets $3.09
Foton18: folds 
Uncalled bet ($3.09) returned to Tirka
Tirka collected $6.18 from pot
Tirka: doesn't show hand 
*** SUMMARY ***
Total pot $6.50 | Rake $0.32 
Board [5c 8c Tc]
Seat 1: omorfadramou folded before Flop (didn't bet)
Seat 2: Filojoes folded before Flop (didn't bet)
Seat 3: Glushchenko folded before Flop (didn't bet)
Seat 4: matiko09 folded before Flop (didn't bet)
Seat 5: Prettyspitz folded before Flop (didn't bet)
Seat 6: Tirka collected ($6.18)
Seat 7: ruslik_by (button) folded before Flop (didn't bet)
Seat 8: geiranger011 (small blind) folded before Flop
Seat 9: Foton18 (big blind) folded on the Flop





PokerStars Hand #151943995055:  Hold'em No Limit ($1/$2 USD) - 2016/04/15 14:14:19 CET [2016/04/15 8:14:19 ET]
Table 'Adele II' 9-max Seat #6 is the button
Seat 1: RyanHuJun ($339.17 in chips) 
Seat 2: Fish4trips ($323.54 in chips) 
Seat 3: matiko09 ($311.33 in chips) 
Seat 4: Glushchenko ($207.05 in chips) 
Seat 5: TonnaMunz ($200 in chips) 
Seat 6: Kukuryzka ($236.21 in chips) 
Seat 7: Iggso ($200 in chips) 
Seat 8: butcheN18 ($248.67 in chips) 
Seat 9: SanychStar ($279.60 in chips) 
Iggso: posts small blind $1
butcheN18: posts big blind $2
*** HOLE CARDS ***
Dealt to matiko09 [8d Jc]
SanychStar: folds 
RyanHuJun: calls $2
Fish4trips: folds 
matiko09: folds 
Glushchenko: folds 
TonnaMunz: folds 
Kukuryzka: folds 
Iggso: calls $1
butcheN18: checks 
*** FLOP *** [Ks 3d 8c]
Iggso: checks 
butcheN18: checks 
RyanHuJun: bets $4
Iggso: folds 
butcheN18: folds 
Uncalled bet ($4) returned to RyanHuJun
RyanHuJun collected $5.70 from pot
RyanHuJun: doesn't show hand 
*** SUMMARY ***
Total pot $6 | Rake $0.30 
Board [Ks 3d 8c]
Seat 1: RyanHuJun collected ($5.70)
Seat 2: Fish4trips folded before Flop (didn't bet)
Seat 3: matiko09 folded before Flop (didn't bet)
Seat 4: Glushchenko folded before Flop (didn't bet)
Seat 5: TonnaMunz folded before Flop (didn't bet)
Seat 6: Kukuryzka (button) folded before Flop (didn't bet)
Seat 7: Iggso (small blind) folded on the Flop
Seat 8: butcheN18 (big blind) folded on the Flop
Seat 9: SanychStar folded before Flop (didn't bet)





PokerStars Hand #151943998315:  Hold'em No Limit ($1/$2 USD) - 2016/04/15 14:14:25 CET [2016/04/15 8:14:25 ET]
Table 'Blaauw' 9-max Seat #2 is the button
Seat 1: myatiy 96 ($233.39 in chips) 
Seat 2: butcheN18 ($238.19 in chips) 
Seat 3: erfk1958 ($120 in chips) 
Seat 4: petro0107 ($203.75 in chips) 
Seat 5: tipner ($224.40 in chips) 
Seat 6: matiko09 ($290.90 in chips) 
Seat 7: ssljvr ($413.95 in chips) 
Seat 8: Iggso ($200 in chips) 
Seat 9: coinflip_si ($200 in chips) 
erfk1958: posts small blind $1
petro0107: posts big blind $2
*** HOLE CARDS ***
Dealt to matiko09 [3d 2d]
tipner: folds 
matiko09: folds 
ssljvr: folds 
Iggso: folds 
coinflip_si: folds 
myatiy 96: raises $3 to $5
butcheN18: folds 
erfk1958: folds 
petro0107: calls $3
*** FLOP *** [7c 6h 6d]
petro0107: checks 
myatiy 96: bets $3.44
petro0107: calls $3.44
*** TURN *** [7c 6h 6d] [3h]
petro0107: checks 
myatiy 96: bets $8.49
petro0107: calls $8.49
*** RIVER *** [7c 6h 6d 3h] [7h]
petro0107: bets $22
myatiy 96: folds 
Uncalled bet ($22) returned to petro0107
petro0107 collected $33.12 from pot
petro0107: doesn't show hand 
*** SUMMARY ***
Total pot $34.86 | Rake $1.74 
Board [7c 6h 6d 3h 7h]
Seat 1: myatiy 96 folded on the River
Seat 2: butcheN18 (button) folded before Flop (didn't bet)
Seat 3: erfk1958 (small blind) folded before Flop
Seat 4: petro0107 (big blind) collected ($33.12)
Seat 5: tipner folded before Flop (didn't bet)
Seat 6: matiko09 folded before Flop (didn't bet)
Seat 7: ssljvr folded before Flop (didn't bet)
Seat 8: Iggso folded before Flop (didn't bet)
Seat 9: coinflip_si folded before Flop (didn't bet)





PokerStars Hand #151943998943:  Hold'em No Limit ($1/$2 USD) - 2016/04/15 14:14:26 CET [2016/04/15 8:14:26 ET]
Table 'Oceax' 9-max Seat #1 is the button
Seat 1: matiko09 ($200 in chips) 
Seat 2: Fish4trips ($288.05 in chips) 
Seat 4: butcheN18 ($296.46 in chips) 
Seat 5: derrocco82 ($192 in chips) 
Seat 6: Iggso ($276.93 in chips) 
Seat 7: ssljvr ($250.60 in chips) 
Seat 8: Poroxide ($326.97 in chips) 
Seat 9: erfk1958 ($173.33 in chips) 
Fish4trips: posts small blind $1
Glushchenko: is sitting out 
butcheN18: posts big blind $2
Glushchenko leaves the table
*** HOLE CARDS ***
Dealt to matiko09 [Jd 2s]
Vikulja1993 joins the table at seat #3 
derrocco82: raises $4 to $6
Iggso: folds 
ssljvr: folds 
Poroxide: folds 
erfk1958: folds 
matiko09: folds 
Fish4trips: calls $5
butcheN18: folds 
*** FLOP *** [6c 6s 5h]
Fish4trips: checks 
derrocco82: checks 
*** TURN *** [6c 6s 5h] [Ah]
Fish4trips: bets $8.37
derrocco82: calls $8.37
*** RIVER *** [6c 6s 5h Ah] [7s]
Fish4trips: checks 
derrocco82: bets $12
Fish4trips: folds 
Uncalled bet ($12) returned to derrocco82
derrocco82 collected $29.20 from pot
derrocco82: doesn't show hand 
*** SUMMARY ***
Total pot $30.74 | Rake $1.54 
Board [6c 6s 5h Ah 7s]
Seat 1: matiko09 (button) folded before Flop (didn't bet)
Seat 2: Fish4trips (small blind) folded on the River
Seat 4: butcheN18 (big blind) folded before Flop
Seat 5: derrocco82 collected ($29.20)
Seat 6: Iggso folded before Flop (didn't bet)
Seat 7: ssljvr folded before Flop (didn't bet)
Seat 8: Poroxide folded before Flop (didn't bet)
Seat 9: erfk1958 folded before Flop (didn't bet)





PokerStars Hand #151944003247:  Hold'em No Limit ($0.50/$1.00 USD) - 2016/04/15 14:14:35 CET [2016/04/15 8:14:35 ET]
Table 'Chiny II' 9-max Seat #9 is the button
Seat 1: vrnMike ($155.06 in chips) 
Seat 2: Westpants ($154.69 in chips) 
Seat 3: Foton18 ($77.12 in chips) 
Seat 4: matiko09 ($172.90 in chips) 
Seat 5: omorfadramou ($163 in chips) 
Seat 6: choupai ($16.03 in chips) 
Seat 7: ruslik_by ($100 in chips) 
Seat 8: Filojoes ($141.14 in chips) 
Seat 9: butcheN18 ($100 in chips) 
vrnMike: posts small blind $0.50
Westpants: posts big blind $1
*** HOLE CARDS ***
Dealt to matiko09 [8c 9c]
Foton18: folds 
matiko09: raises $2 to $3
omorfadramou: folds 
choupai: folds 
ruslik_by: folds 
Filojoes: folds 
butcheN18: folds 
vrnMike: folds 
Westpants: folds 
Uncalled bet ($2) returned to matiko09
matiko09 collected $2.50 from pot
matiko09: doesn't show hand 
*** SUMMARY ***
Total pot $2.50 | Rake $0 
Seat 1: vrnMike (small blind) folded before Flop
Seat 2: Westpants (big blind) folded before Flop
Seat 3: Foton18 folded before Flop (didn't bet)
Seat 4: matiko09 collected ($2.50)
Seat 5: omorfadramou folded before Flop (didn't bet)
Seat 6: choupai folded before Flop (didn't bet)
Seat 7: ruslik_by folded before Flop (didn't bet)
Seat 8: Filojoes folded before Flop (didn't bet)
Seat 9: butcheN18 (button) folded before Flop (didn't bet)





PokerStars Hand #151944010637:  Hold'em No Limit ($0.50/$1.00 USD) - 2016/04/15 14:14:49 CET [2016/04/15 8:14:49 ET]
Table 'Emma II' 9-max Seat #8 is the button
Seat 1: omorfadramou ($100 in chips) 
Seat 2: Filojoes ($144 in chips) 
Seat 3: Glushchenko ($269.29 in chips) 
Seat 4: matiko09 ($101.50 in chips) 
Seat 5: Prettyspitz ($102.15 in chips) 
Seat 6: Tirka ($111.53 in chips) 
Seat 7: ruslik_by ($102.50 in chips) 
Seat 8: geiranger011 ($98.50 in chips) 
Seat 9: Foton18 ($123.34 in chips) 
Foton18: posts small blind $0.50
omorfadramou: posts big blind $1
*** HOLE CARDS ***
Dealt to matiko09 [5s 9h]
Filojoes: folds 
Glushchenko: folds 
matiko09: folds 
Prettyspitz: folds 
Tirka: raises $2 to $3
ruslik_by: folds 
geiranger011: folds 
Foton18: calls $2.50
omorfadramou: folds 
*** FLOP *** [Jh Qd Kh]
Foton18: checks 
Tirka: checks 
*** TURN *** [Jh Qd Kh] [3c]
Foton18: bets $4
Tirka: calls $4
*** RIVER *** [Jh Qd Kh 3c] [6d]
Foton18: bets $14
Tirka: folds 
Uncalled bet ($14) returned to Foton18
Foton18 collected $14.25 from pot
Foton18: doesn't show hand 
*** SUMMARY ***
Total pot $15 | Rake $0.75 
Board [Jh Qd Kh 3c 6d]
Seat 1: omorfadramou (big blind) folded before Flop
Seat 2: Filojoes folded before Flop (didn't bet)
Seat 3: Glushchenko folded before Flop (didn't bet)
Seat 4: matiko09 folded before Flop (didn't bet)
Seat 5: Prettyspitz folded before Flop (didn't bet)
Seat 6: Tirka folded on the River
Seat 7: ruslik_by folded before Flop (didn't bet)
Seat 8: geiranger011 (button) folded before Flop (didn't bet)
Seat 9: Foton18 (small blind) collected ($14.25)





PokerStars Hand #151944011399:  Hold'em No Limit ($1/$2 USD) - 2016/04/15 14:14:51 CET [2016/04/15 8:14:51 ET]
Table 'Marmara II' 9-max Seat #8 is the button
Seat 1: ssljvr ($491.98 in chips) 
Seat 2: Iggso ($200 in chips) 
Seat 3: Glushchenko ($209.44 in chips) 
Seat 4: Fish4trips ($244.96 in chips) 
Seat 5: docmarc777 ($421.55 in chips) 
Seat 6: azzad2007 ($200 in chips) 
Seat 7: matiko09 ($200.07 in chips) 
Seat 8: Dachish ($111.46 in chips) 
Seat 9: erfk1958 ($169.58 in chips) 
erfk1958: posts small blind $1
ssljvr: posts big blind $2
*** HOLE CARDS ***
Dealt to matiko09 [Td Th]
Iggso: folds 
Glushchenko: folds 
Fish4trips: folds 
docmarc777: raises $3.55 to $5.55
azzad2007: folds 
matiko09: raises $10.45 to $16
Dachish: folds 
erfk1958: folds 
ssljvr: folds 
docmarc777: calls $10.45
*** FLOP *** [6s Jc 7s]
docmarc777: checks 
matiko09: checks 
*** TURN *** [6s Jc 7s] [3c]
docmarc777: bets $18
matiko09: calls $18
*** RIVER *** [6s Jc 7s 3c] [Qd]
docmarc777: checks 
matiko09: checks 
*** SHOW DOWN ***
docmarc777: shows [8d 8h] (a pair of Eights)
matiko09: shows [Td Th] (a pair of Tens)
matiko09 collected $68.25 from pot
*** SUMMARY ***
Total pot $71 | Rake $2.75 
Board [6s Jc 7s 3c Qd]
Seat 1: ssljvr (big blind) folded before Flop
Seat 2: Iggso folded before Flop (didn't bet)
Seat 3: Glushchenko folded before Flop (didn't bet)
Seat 4: Fish4trips folded before Flop (didn't bet)
Seat 5: docmarc777 showed [8d 8h] and lost with a pair of Eights
Seat 6: azzad2007 folded before Flop (didn't bet)
Seat 7: matiko09 showed [Td Th] and won ($68.25) with a pair of Tens
Seat 8: Dachish (button) folded before Flop (didn't bet)
Seat 9: erfk1958 (small blind) folded before Flop





PokerStars Hand #151944016270:  Hold'em No Limit ($0.50/$1.00 USD) - 2016/04/15 14:15:00 CET [2016/04/15 8:15:00 ET]
Table 'Chiny II' 9-max Seat #1 is the button
Seat 1: vrnMike ($154.56 in chips) 
Seat 2: Westpants ($153.69 in chips) 
Seat 3: Foton18 ($77.12 in chips) 
Seat 4: matiko09 ($174.40 in chips) 
Seat 5: omorfadramou ($163 in chips) 
Seat 6: choupai ($16.03 in chips) 
Seat 7: ruslik_by ($100 in chips) 
Seat 8: Filojoes ($141.14 in chips) 
Seat 9: butcheN18 ($100 in chips) 
Westpants: posts small blind $0.50
Foton18: posts big blind $1
*** HOLE CARDS ***
Dealt to matiko09 [6c 3s]
matiko09: folds 
omorfadramou: folds 
choupai: calls $1
ruslik_by: folds 
Filojoes: raises $2 to $3
butcheN18: folds 
vrnMike: folds 
Westpants: folds 
Foton18: calls $2
choupai: calls $2
*** FLOP *** [6h Qd 4s]
Foton18: checks 
choupai: checks 
Filojoes: bets $4
Foton18: folds 
choupai: calls $4
*** TURN *** [6h Qd 4s] [7c]
choupai: checks 
Filojoes: bets $9.97
choupai: folds 
Uncalled bet ($9.97) returned to Filojoes
Filojoes collected $16.62 from pot
Filojoes: doesn't show hand 
*** SUMMARY ***
Total pot $17.50 | Rake $0.88 
Board [6h Qd 4s 7c]
Seat 1: vrnMike (button) folded before Flop (didn't bet)
Seat 2: Westpants (small blind) folded before Flop
Seat 3: Foton18 (big blind) folded on the Flop
Seat 4: matiko09 folded before Flop (didn't bet)
Seat 5: omorfadramou folded before Flop (didn't bet)
Seat 6: choupai folded on the Turn
Seat 7: ruslik_by folded before Flop (didn't bet)
Seat 8: Filojoes collected ($16.62)
Seat 9: butcheN18 folded before Flop (didn't bet)





PokerStars Hand #151944016952:  Hold'em No Limit ($0.50/$1.00 USD) - 2016/04/15 14:15:01 CET [2016/04/15 8:15:01 ET]
Table 'Adelgunde III' 9-max Seat #8 is the button
Seat 1: valimiu ($131.30 in chips) 
Seat 2: Vikulja1993 ($101.50 in chips) 
Seat 3: tipner ($123.20 in chips) 
Seat 4: hammerwife ($131.23 in chips) 
Seat 5: matiko09 ($120.91 in chips) 
Seat 6: Pominator92 ($107.50 in chips) 
Seat 7: Yaaaazz ($100 in chips) 
Seat 8: SanychStar ($131.56 in chips) 
Seat 9: Kukuryzka ($123.51 in chips) 
Kukuryzka: posts small blind $0.50
valimiu: posts big blind $1
*** HOLE CARDS ***
Dealt to matiko09 [Kd 6s]
Vikulja1993: folds 
tipner: raises $2 to $3
hammerwife: folds 
matiko09: folds 
Pominator92: folds 
Yaaaazz: folds 
SanychStar: folds 
Kukuryzka: folds 
valimiu: folds 
Uncalled bet ($2) returned to tipner
tipner collected $2.50 from pot
tipner: doesn't show hand 
*** SUMMARY ***
Total pot $2.50 | Rake $0 
Seat 1: valimiu (big blind) folded before Flop
Seat 2: Vikulja1993 folded before Flop (didn't bet)
Seat 3: tipner collected ($2.50)
Seat 4: hammerwife folded before Flop (didn't bet)
Seat 5: matiko09 folded before Flop (didn't bet)
Seat 6: Pominator92 folded before Flop (didn't bet)
Seat 7: Yaaaazz folded before Flop (didn't bet)
Seat 8: SanychStar (button) folded before Flop (didn't bet)
Seat 9: Kukuryzka (small blind) folded before Flop





PokerStars Hand #151944017199:  Hold'em No Limit ($1/$2 USD) - 2016/04/15 14:15:02 CET [2016/04/15 8:15:02 ET]
Table 'Adele II' 9-max Seat #7 is the button
Seat 1: RyanHuJun ($342.87 in chips) 
Seat 2: Fish4trips ($323.54 in chips) 
Seat 3: matiko09 ($311.33 in chips) 
Seat 4: Glushchenko ($207.05 in chips) 
Seat 5: TonnaMunz ($200 in chips) 
Seat 6: Kukuryzka ($236.21 in chips) 
Seat 7: Iggso ($200 in chips) 
Seat 8: butcheN18 ($246.67 in chips) 
Seat 9: SanychStar ($279.60 in chips) 
butcheN18: posts small blind $1
SanychStar: posts big blind $2
*** HOLE CARDS ***
Dealt to matiko09 [9h 2c]
RyanHuJun: folds 
Fish4trips: folds 
matiko09: folds 
Glushchenko: folds 
TonnaMunz: folds 
Kukuryzka: raises $3 to $5
Iggso: calls $5
butcheN18: folds 
SanychStar: folds 
*** FLOP *** [5s 6h 5c]
Kukuryzka: bets $9.26
Iggso: folds 
Uncalled bet ($9.26) returned to Kukuryzka
Kukuryzka collected $12.35 from pot
Kukuryzka: doesn't show hand 
*** SUMMARY ***
Total pot $13 | Rake $0.65 
Board [5s 6h 5c]
Seat 1: RyanHuJun folded before Flop (didn't bet)
Seat 2: Fish4trips folded before Flop (didn't bet)
Seat 3: matiko09 folded before Flop (didn't bet)
Seat 4: Glushchenko folded before Flop (didn't bet)
Seat 5: TonnaMunz folded before Flop (didn't bet)
Seat 6: Kukuryzka collected ($12.35)
Seat 7: Iggso (button) folded on the Flop
Seat 8: butcheN18 (small blind) folded before Flop
Seat 9: SanychStar (big blind) folded before Flop





PokerStars Hand #151944024595:  Hold'em No Limit ($0.50/$1.00 USD) - 2016/04/15 14:15:16 CET [2016/04/15 8:15:16 ET]
Table 'Parvulesco II' 9-max Seat #9 is the button
Seat 1: bilukm ($100 in chips) 
Seat 2: Filojoes ($107.04 in chips) 
Seat 3: matiko09 ($125.01 in chips) 
Seat 4: butcheN18 ($100 in chips) 
Seat 5: maxxmeister ($105.60 in chips) 
Seat 6: ruslik_by ($131.55 in chips) 
Seat 7: Kukuryzka ($133.44 in chips) 
Seat 8: Jimy Tiltman ($111.92 in chips) 
Seat 9: hammerwife ($186.47 in chips) 
bilukm: posts small blind $0.50
Filojoes: posts big blind $1
*** HOLE CARDS ***
Dealt to matiko09 [4c 7c]
matiko09: folds 
butcheN18: folds 
maxxmeister: folds 
ruslik_by: folds 
Kukuryzka: folds 
Jimy Tiltman: folds 
hammerwife: raises $1.01 to $2.01
bilukm: calls $1.51
Filojoes: folds 
*** FLOP *** [5s Jh As]
bilukm: bets $2.38
hammerwife: raises $6.12 to $8.50
bilukm: calls $6.12
*** TURN *** [5s Jh As] [Ah]
bilukm: checks 
hammerwife: bets $13.50
bilukm: calls $13.50
*** RIVER *** [5s Jh As Ah] [Td]
bilukm: checks 
hammerwife: bets $162.46 and is all-in
bilukm: folds 
Uncalled bet ($162.46) returned to hammerwife
hammerwife collected $46.57 from pot
hammerwife: doesn't show hand 
*** SUMMARY ***
Total pot $49.02 | Rake $2.45 
Board [5s Jh As Ah Td]
Seat 1: bilukm (small blind) folded on the River
Seat 2: Filojoes (big blind) folded before Flop
Seat 3: matiko09 folded before Flop (didn't bet)
Seat 4: butcheN18 folded before Flop (didn't bet)
Seat 5: maxxmeister folded before Flop (didn't bet)
Seat 6: ruslik_by folded before Flop (didn't bet)
Seat 7: Kukuryzka folded before Flop (didn't bet)
Seat 8: Jimy Tiltman folded before Flop (didn't bet)
Seat 9: hammerwife (button) collected ($46.57)





PokerStars Hand #151944028132:  Hold'em No Limit ($1/$2 USD) - 2016/04/15 14:15:23 CET [2016/04/15 8:15:23 ET]
Table 'Oceax' 9-max Seat #2 is the button
Seat 1: matiko09 ($200 in chips) 
Seat 2: Fish4trips ($273.68 in chips) 
Seat 4: butcheN18 ($294.46 in chips) 
Seat 5: derrocco82 ($206.83 in chips) 
Seat 6: Iggso ($276.93 in chips) 
Seat 7: ssljvr ($250.60 in chips) 
Seat 8: Poroxide ($326.97 in chips) 
Seat 9: erfk1958 ($173.33 in chips) 
Vikulja1993 will be allowed to play after the button
butcheN18: posts small blind $1
derrocco82: posts big blind $2
*** HOLE CARDS ***
Dealt to matiko09 [4d Th]
Iggso: folds 
ssljvr: folds 
Poroxide: folds 
erfk1958: raises $2 to $4
matiko09: folds 
Fish4trips: folds 
butcheN18: folds 
derrocco82: folds 
Uncalled bet ($2) returned to erfk1958
erfk1958 collected $5 from pot
erfk1958: doesn't show hand 
*** SUMMARY ***
Total pot $5 | Rake $0 
Seat 1: matiko09 folded before Flop (didn't bet)
Seat 2: Fish4trips (button) folded before Flop (didn't bet)
Seat 4: butcheN18 (small blind) folded before Flop
Seat 5: derrocco82 (big blind) folded before Flop
Seat 6: Iggso folded before Flop (didn't bet)
Seat 7: ssljvr folded before Flop (didn't bet)
Seat 8: Poroxide folded before Flop (didn't bet)
Seat 9: erfk1958 collected ($5)





PokerStars Hand #151944031438:  Hold'em No Limit ($0.50/$1.00 USD) - 2016/04/15 14:15:29 CET [2016/04/15 8:15:29 ET]
Table 'Desagneauxa II' 9-max Seat #1 is the button
Seat 1: Rocky6434 ($77.18 in chips) 
Seat 2: Filojoes ($100 in chips) 
Seat 3: matiko09 ($100 in chips) 
Seat 5: Carlo22222 ($35.20 in chips) 
Seat 6: DIMAN_324 ($113.35 in chips) 
Seat 7: TideHan ($100 in chips) 
Seat 8: di0d80 ($100 in chips) 
Filojoes: posts small blind $0.50
matiko09: posts big blind $1
Prettyspitz: sits out 
ruslik_by: sits out 
*** HOLE CARDS ***
Dealt to matiko09 [Ad 6c]
Carlo22222: folds 
DIMAN_324: folds 
TideHan: raises $2 to $3
di0d80: folds 
Rocky6434: calls $3
Filojoes: folds 
matiko09: folds 
*** FLOP *** [Js Qc Ac]
TideHan: bets $4.69
Rocky6434: calls $4.69
*** TURN *** [Js Qc Ac] [As]
TideHan: checks 
Rocky6434: checks 
*** RIVER *** [Js Qc Ac As] [Th]
TideHan: bets $13
Rocky6434: raises $13 to $26
TideHan: calls $13
*** SHOW DOWN ***
Rocky6434: shows [Jh Jd] (a full house, Jacks full of Aces)
TideHan: mucks hand 
Rocky6434 collected $66.38 from pot
*** SUMMARY ***
Total pot $68.88 | Rake $2.50 
Board [Js Qc Ac As Th]
Seat 1: Rocky6434 (button) showed [Jh Jd] and won ($66.38) with a full house, Jacks full of Aces
Seat 2: Filojoes (small blind) folded before Flop
Seat 3: matiko09 (big blind) folded before Flop
Seat 5: Carlo22222 folded before Flop (didn't bet)
Seat 6: DIMAN_324 folded before Flop (didn't bet)
Seat 7: TideHan mucked [Kc 3c]
Seat 8: di0d80 folded before Flop (didn't bet)





PokerStars Hand #151944037786:  Hold'em No Limit ($1/$2 USD) - 2016/04/15 14:15:41 CET [2016/04/15 8:15:41 ET]
Table 'Adele II' 9-max Seat #8 is the button
Seat 1: RyanHuJun ($342.87 in chips) 
Seat 2: Fish4trips ($323.54 in chips) 
Seat 3: matiko09 ($311.33 in chips) 
Seat 4: Glushchenko ($207.05 in chips) 
Seat 5: TonnaMunz ($200 in chips) 
Seat 6: Kukuryzka ($243.56 in chips) 
Seat 7: Iggso ($200 in chips) 
Seat 8: butcheN18 ($245.67 in chips) 
Seat 9: SanychStar ($277.60 in chips) 
SanychStar: posts small blind $1
RyanHuJun: posts big blind $2
*** HOLE CARDS ***
Dealt to matiko09 [Ah 8h]
Fish4trips: folds 
matiko09: folds 
Glushchenko: raises $4 to $6
TonnaMunz: folds 
Kukuryzka: folds 
Iggso: folds 
butcheN18: folds 
SanychStar: folds 
RyanHuJun: calls $4
*** FLOP *** [Kc 2d Ac]
RyanHuJun: checks 
Glushchenko: checks 
*** TURN *** [Kc 2d Ac] [Qd]
RyanHuJun: checks 
Glushchenko: bets $8.23
RyanHuJun: calls $8.23
*** RIVER *** [Kc 2d Ac Qd] [4d]
RyanHuJun: checks 
Glushchenko: checks 
*** SHOW DOWN ***
RyanHuJun: shows [Kh 8c] (a pair of Kings)
Glushchenko: shows [Ks Qc] (two pair, Kings and Queens)
Glushchenko collected $27.99 from pot
*** SUMMARY ***
Total pot $29.46 | Rake $1.47 
Board [Kc 2d Ac Qd 4d]
Seat 1: RyanHuJun (big blind) showed [Kh 8c] and lost with a pair of Kings
Seat 2: Fish4trips folded before Flop (didn't bet)
Seat 3: matiko09 folded before Flop (didn't bet)
Seat 4: Glushchenko showed [Ks Qc] and won ($27.99) with two pair, Kings and Queens
Seat 5: TonnaMunz folded before Flop (didn't bet)
Seat 6: Kukuryzka folded before Flop (didn't bet)
Seat 7: Iggso folded before Flop (didn't bet)
Seat 8: butcheN18 (button) folded before Flop (didn't bet)
Seat 9: SanychStar (small blind) folded before Flop





PokerStars Hand #151944039932:  Hold'em No Limit ($1/$2 USD) - 2016/04/15 14:15:46 CET [2016/04/15 8:15:46 ET]
Table 'Blaauw' 9-max Seat #3 is the button
Seat 1: myatiy 96 ($216.46 in chips) 
Seat 2: butcheN18 ($238.19 in chips) 
Seat 3: erfk1958 ($119 in chips) 
Seat 4: petro0107 ($219.94 in chips) 
Seat 5: tipner ($224.40 in chips) 
Seat 6: matiko09 ($290.90 in chips) 
Seat 7: ssljvr ($413.95 in chips) 
Seat 8: Iggso ($200 in chips) 
Seat 9: coinflip_si ($200 in chips) 
petro0107: posts small blind $1
tipner: posts big blind $2
*** HOLE CARDS ***
Dealt to matiko09 [Th 2c]
matiko09: folds 
ssljvr: folds 
Iggso: folds 
coinflip_si: folds 
myatiy 96: folds 
butcheN18: folds 
erfk1958: raises $2 to $4
petro0107: calls $3
tipner: folds 
*** FLOP *** [Ah 3d 7c]
petro0107: checks 
erfk1958: checks 
*** TURN *** [Ah 3d 7c] [8h]
petro0107: checks 
erfk1958: bets $8
petro0107: raises $8 to $16
erfk1958: calls $8
*** RIVER *** [Ah 3d 7c 8h] [4s]
petro0107: checks 
erfk1958: checks 
*** SHOW DOWN ***
petro0107: shows [Ks 6h] (high card Ace)
erfk1958: shows [8c 7d] (two pair, Eights and Sevens)
erfk1958 collected $39.90 from pot
*** SUMMARY ***
Total pot $42 | Rake $2.10 
Board [Ah 3d 7c 8h 4s]
Seat 1: myatiy 96 folded before Flop (didn't bet)
Seat 2: butcheN18 folded before Flop (didn't bet)
Seat 3: erfk1958 (button) showed [8c 7d] and won ($39.90) with two pair, Eights and Sevens
Seat 4: petro0107 (small blind) showed [Ks 6h] and lost with high card Ace
Seat 5: tipner (big blind) folded before Flop
Seat 6: matiko09 folded before Flop (didn't bet)
Seat 7: ssljvr folded before Flop (didn't bet)
Seat 8: Iggso folded before Flop (didn't bet)
Seat 9: coinflip_si folded before Flop (didn't bet)





PokerStars Hand #151944042844:  Hold'em No Limit ($1/$2 USD) - 2016/04/15 14:15:51 CET [2016/04/15 8:15:51 ET]
Table 'Marmara II' 9-max Seat #9 is the button
Seat 1: ssljvr ($489.98 in chips) 
Seat 2: Iggso ($200 in chips) 
Seat 3: Glushchenko ($209.44 in chips) 
Seat 4: Fish4trips ($244.96 in chips) 
Seat 5: docmarc777 ($387.55 in chips) 
Seat 6: azzad2007 ($200 in chips) 
Seat 7: matiko09 ($234.32 in chips) 
Seat 8: Dachish ($161.46 in chips) 
Seat 9: erfk1958 ($168.58 in chips) 
ssljvr: posts small blind $1
Iggso: posts big blind $2
*** HOLE CARDS ***
Dealt to matiko09 [Ac Jc]
Glushchenko: folds 
Fish4trips: folds 
docmarc777: raises $3.55 to $5.55
azzad2007: folds 
matiko09: calls $5.55
Dachish: folds 
erfk1958: folds 
ssljvr: folds 
Iggso: folds 
*** FLOP *** [Jh Th Kh]
docmarc777: bets $14
matiko09: folds 
Uncalled bet ($14) returned to docmarc777
docmarc777 collected $13.40 from pot
*** SUMMARY ***
Total pot $14.10 | Rake $0.70 
Board [Jh Th Kh]
Seat 1: ssljvr (small blind) folded before Flop
Seat 2: Iggso (big blind) folded before Flop
Seat 3: Glushchenko folded before Flop (didn't bet)
Seat 4: Fish4trips folded before Flop (didn't bet)
Seat 5: docmarc777 collected ($13.40)
Seat 6: azzad2007 folded before Flop (didn't bet)
Seat 7: matiko09 folded on the Flop
Seat 8: Dachish folded before Flop (didn't bet)
Seat 9: erfk1958 (button) folded before Flop (didn't bet)





PokerStars Hand #151944043165:  Hold'em No Limit ($1/$2 USD) - 2016/04/15 14:15:52 CET [2016/04/15 8:15:52 ET]
Table 'Oceax' 9-max Seat #4 is the button
Seat 1: matiko09 ($200 in chips) 
Seat 2: Fish4trips ($273.68 in chips) 
Seat 4: butcheN18 ($293.46 in chips) 
Seat 5: derrocco82 ($204.83 in chips) 
Seat 6: Iggso ($276.93 in chips) 
Seat 7: ssljvr ($250.60 in chips) 
Seat 8: Poroxide ($326.97 in chips) 
Seat 9: erfk1958 ($176.33 in chips) 
derrocco82: posts small blind $1
Iggso: posts big blind $2
Vikulja1993: sits out 
*** HOLE CARDS ***
Dealt to matiko09 [3d 3c]
ssljvr: folds 
Poroxide: folds 
erfk1958: folds 
matiko09: raises $3 to $5
Fish4trips: folds 
butcheN18: folds 
derrocco82: folds 
Iggso: folds 
Uncalled bet ($3) returned to matiko09
matiko09 collected $5 from pot
matiko09: doesn't show hand 
*** SUMMARY ***
Total pot $5 | Rake $0 
Seat 1: matiko09 collected ($5)
Seat 2: Fish4trips folded before Flop (didn't bet)
Seat 4: butcheN18 (button) folded before Flop (didn't bet)
Seat 5: derrocco82 (small blind) folded before Flop
Seat 6: Iggso (big blind) folded before Flop
Seat 7: ssljvr folded before Flop (didn't bet)
Seat 8: Poroxide folded before Flop (didn't bet)
Seat 9: erfk1958 folded before Flop (didn't bet)





PokerStars Hand #151944044064:  Hold'em No Limit ($0.50/$1.00 USD) - 2016/04/15 14:15:54 CET [2016/04/15 8:15:54 ET]
Table 'Emma II' 9-max Seat #9 is the button
Seat 1: omorfadramou ($100 in chips) 
Seat 2: Filojoes ($144 in chips) 
Seat 3: Glushchenko ($269.29 in chips) 
Seat 4: matiko09 ($101.50 in chips) 
Seat 5: Prettyspitz ($102.15 in chips) 
Seat 6: Tirka ($104.53 in chips) 
Seat 7: ruslik_by ($102.50 in chips) 
Seat 8: geiranger011 ($98.50 in chips) 
Seat 9: Foton18 ($130.59 in chips) 
omorfadramou: posts small blind $0.50
Filojoes: posts big blind $1
*** HOLE CARDS ***
Dealt to matiko09 [9s Ks]
Glushchenko: folds 
matiko09: folds 
Prettyspitz: raises $2 to $3
Tirka: folds 
ruslik_by: folds 
geiranger011: folds 
Foton18: folds 
omorfadramou: folds 
Filojoes: folds 
Uncalled bet ($2) returned to Prettyspitz
Prettyspitz collected $2.50 from pot
Prettyspitz: doesn't show hand 
*** SUMMARY ***
Total pot $2.50 | Rake $0 
Seat 1: omorfadramou (small blind) folded before Flop
Seat 2: Filojoes (big blind) folded before Flop
Seat 3: Glushchenko folded before Flop (didn't bet)
Seat 4: matiko09 folded before Flop (didn't bet)
Seat 5: Prettyspitz collected ($2.50)
Seat 6: Tirka folded before Flop (didn't bet)
Seat 7: ruslik_by folded before Flop (didn't bet)
Seat 8: geiranger011 folded before Flop (didn't bet)
Seat 9: Foton18 (button) folded before Flop (didn't bet)





PokerStars Hand #151944049558:  Hold'em No Limit ($0.50/$1.00 USD) - 2016/04/15 14:16:04 CET [2016/04/15 8:16:04 ET]
Table 'Adelgunde III' 9-max Seat #9 is the button
Seat 1: valimiu ($130.30 in chips) 
Seat 2: Vikulja1993 ($101.50 in chips) 
Seat 3: tipner ($124.70 in chips) 
Seat 4: hammerwife ($131.23 in chips) 
Seat 5: matiko09 ($120.91 in chips) 
Seat 6: Pominator92 ($107.50 in chips) 
Seat 7: Yaaaazz ($100 in chips) 
Seat 8: SanychStar ($131.56 in chips) 
Seat 9: Kukuryzka ($123.01 in chips) 
valimiu: posts small blind $0.50
Vikulja1993: posts big blind $1
*** HOLE CARDS ***
Dealt to matiko09 [5h Qs]
tipner: folds 
hammerwife: folds 
matiko09: folds 
Pominator92: calls $1
Yaaaazz: folds 
SanychStar: raises $2.50 to $3.50
Kukuryzka: folds 
valimiu: folds 
Vikulja1993: folds 
Pominator92: calls $2.50
*** FLOP *** [Jd 6s 3d]
Pominator92: checks 
SanychStar: checks 
*** TURN *** [Jd 6s 3d] [5s]
Pominator92: checks 
SanychStar: checks 
*** RIVER *** [Jd 6s 3d 5s] [Kd]
Pominator92: bets $4
SanychStar: folds 
Uncalled bet ($4) returned to Pominator92
Pominator92 collected $8.08 from pot
Pominator92: doesn't show hand 
*** SUMMARY ***
Total pot $8.50 | Rake $0.42 
Board [Jd 6s 3d 5s Kd]
Seat 1: valimiu (small blind) folded before Flop
Seat 2: Vikulja1993 (big blind) folded before Flop
Seat 3: tipner folded before Flop (didn't bet)
Seat 4: hammerwife folded before Flop (didn't bet)
Seat 5: matiko09 folded before Flop (didn't bet)
Seat 6: Pominator92 collected ($8.08)
Seat 7: Yaaaazz folded before Flop (didn't bet)
Seat 8: SanychStar folded on the River
Seat 9: Kukuryzka (button) folded before Flop (didn't bet)





PokerStars Hand #151944052004:  Hold'em No Limit ($0.50/$1.00 USD) - 2016/04/15 14:16:09 CET [2016/04/15 8:16:09 ET]
Table 'Navi' 9-max Seat #2 is the button
Seat 1: tipner ($111.83 in chips) 
Seat 2: myatiy 96 ($100 in chips) 
Seat 3: vrnMike ($139.35 in chips) 
Seat 4: Pvsx. ($100 in chips) 
Seat 6: Vikulja1993 ($123.90 in chips) 
Seat 8: ruslik_by ($169 in chips) 
Seat 9: matiko09 ($126.63 in chips) 
vrnMike: posts small blind $0.50
Pvsx.: posts big blind $1
Prettyspitz: sits out 
*** HOLE CARDS ***
Dealt to matiko09 [3c 9c]
Vikulja1993: folds 
ruslik_by: folds 
matiko09: folds 
tipner: folds 
myatiy 96: folds 
vrnMike: folds 
Uncalled bet ($0.50) returned to Pvsx.
Pvsx. collected $1 from pot
Pvsx.: doesn't show hand 
*** SUMMARY ***
Total pot $1 | Rake $0 
Seat 1: tipner folded before Flop (didn't bet)
Seat 2: myatiy 96 (button) folded before Flop (didn't bet)
Seat 3: vrnMike (small blind) folded before Flop
Seat 4: Pvsx. (big blind) collected ($1)
Seat 6: Vikulja1993 folded before Flop (didn't bet)
Seat 8: ruslik_by folded before Flop (didn't bet)
Seat 9: matiko09 folded before Flop (didn't bet)





PokerStars Hand #151944052174:  Hold'em No Limit ($1/$2 USD) - 2016/04/15 14:16:09 CET [2016/04/15 8:16:09 ET]
Table 'Oceax' 9-max Seat #5 is the button
Seat 1: matiko09 ($203 in chips) 
Seat 2: Fish4trips ($273.68 in chips) 
Seat 4: butcheN18 ($293.46 in chips) 
Seat 5: derrocco82 ($203.83 in chips) 
Seat 6: Iggso ($274.93 in chips) 
Seat 7: ssljvr ($250.60 in chips) 
Seat 8: Poroxide ($326.97 in chips) 
Seat 9: erfk1958 ($176.33 in chips) 
Iggso: posts small blind $1
ssljvr: posts big blind $2
Vikulja1993: sits out 
*** HOLE CARDS ***
Dealt to matiko09 [Kh 8d]
Poroxide: folds 
erfk1958: folds 
matiko09: folds 
Fish4trips: folds 
butcheN18: folds 
derrocco82: folds 
Iggso: calls $1
ssljvr: raises $6 to $8
Iggso: folds 
Uncalled bet ($6) returned to ssljvr
ssljvr collected $4 from pot
ssljvr: doesn't show hand 
*** SUMMARY ***
Total pot $4 | Rake $0 
Seat 1: matiko09 folded before Flop (didn't bet)
Seat 2: Fish4trips folded before Flop (didn't bet)
Seat 4: butcheN18 folded before Flop (didn't bet)
Seat 5: derrocco82 (button) folded before Flop (didn't bet)
Seat 6: Iggso (small blind) folded before Flop
Seat 7: ssljvr (big blind) collected ($4)
Seat 8: Poroxide folded before Flop (didn't bet)
Seat 9: erfk1958 folded before Flop (didn't bet)





PokerStars Hand #151944058199:  Hold'em No Limit ($1/$2 USD) - 2016/04/15 14:16:21 CET [2016/04/15 8:16:21 ET]
Table 'Marmara II' 9-max Seat #1 is the button
Seat 1: ssljvr ($488.98 in chips) 
Seat 2: Iggso ($200 in chips) 
Seat 3: Glushchenko ($209.44 in chips) 
Seat 4: Fish4trips ($244.96 in chips) 
Seat 5: docmarc777 ($395.40 in chips) 
Seat 6: azzad2007 ($200 in chips) 
Seat 7: matiko09 ($228.77 in chips) 
Seat 8: Dachish ($161.46 in chips) 
Seat 9: erfk1958 ($168.58 in chips) 
Iggso: posts small blind $1
Glushchenko: posts big blind $2
*** HOLE CARDS ***
Dealt to matiko09 [Jh 2h]
Fish4trips: folds 
docmarc777: folds 
azzad2007: folds 
matiko09: folds 
Dachish: raises $3 to $5
erfk1958: folds 
ssljvr: folds 
Iggso: folds 
Glushchenko: folds 
Uncalled bet ($3) returned to Dachish
Dachish collected $5 from pot
Dachish: doesn't show hand 
*** SUMMARY ***
Total pot $5 | Rake $0 
Seat 1: ssljvr (button) folded before Flop (didn't bet)
Seat 2: Iggso (small blind) folded before Flop
Seat 3: Glushchenko (big blind) folded before Flop
Seat 4: Fish4trips folded before Flop (didn't bet)
Seat 5: docmarc777 folded before Flop (didn't bet)
Seat 6: azzad2007 folded before Flop (didn't bet)
Seat 7: matiko09 folded before Flop (didn't bet)
Seat 8: Dachish collected ($5)
Seat 9: erfk1958 folded before Flop (didn't bet)





PokerStars Hand #151944063293:  Hold'em No Limit ($0.50/$1.00 USD) - 2016/04/15 14:16:31 CET [2016/04/15 8:16:31 ET]
Table 'Emma II' 9-max Seat #1 is the button
Seat 1: omorfadramou ($100 in chips) 
Seat 2: Filojoes ($143 in chips) 
Seat 3: Glushchenko ($269.29 in chips) 
Seat 4: matiko09 ($101.50 in chips) 
Seat 5: Prettyspitz ($103.65 in chips) 
Seat 6: Tirka ($104.53 in chips) 
Seat 7: ruslik_by ($102.50 in chips) 
Seat 8: geiranger011 ($98.50 in chips) 
Seat 9: Foton18 ($130.59 in chips) 
Filojoes: posts small blind $0.50
Glushchenko: posts big blind $1
*** HOLE CARDS ***
Dealt to matiko09 [7d 6s]
matiko09: folds 
Prettyspitz: folds 
Tirka: folds 
ruslik_by: folds 
geiranger011: raises $1.50 to $2.50
Foton18: folds 
omorfadramou: calls $2.50
Filojoes: calls $2
Glushchenko: folds 
*** FLOP *** [Qd Th 6c]
Filojoes: checks 
geiranger011: checks 
omorfadramou: checks 
*** TURN *** [Qd Th 6c] [5s]
Filojoes: checks 
geiranger011: checks 
omorfadramou: checks 
*** RIVER *** [Qd Th 6c 5s] [2s]
Filojoes: checks 
geiranger011: checks 
omorfadramou: bets $4.28
Filojoes: folds 
geiranger011: raises $4.28 to $8.56
omorfadramou: calls $4.28
*** SHOW DOWN ***
geiranger011: shows [Ad 2h] (a pair of Deuces)
omorfadramou: shows [Ts 9s] (a pair of Tens)
omorfadramou collected $24.34 from pot
*** SUMMARY ***
Total pot $25.62 | Rake $1.28 
Board [Qd Th 6c 5s 2s]
Seat 1: omorfadramou (button) showed [Ts 9s] and won ($24.34) with a pair of Tens
Seat 2: Filojoes (small blind) folded on the River
Seat 3: Glushchenko (big blind) folded before Flop
Seat 4: matiko09 folded before Flop (didn't bet)
Seat 5: Prettyspitz folded before Flop (didn't bet)
Seat 6: Tirka folded before Flop (didn't bet)
Seat 7: ruslik_by folded before Flop (didn't bet)
Seat 8: geiranger011 showed [Ad 2h] and lost with a pair of Deuces
Seat 9: Foton18 folded before Flop (didn't bet)





PokerStars Hand #151944064659:  Hold'em No Limit ($0.50/$1.00 USD) - 2016/04/15 14:16:33 CET [2016/04/15 8:16:33 ET]
Table 'Chiny II' 9-max Seat #2 is the button
Seat 1: vrnMike ($154.56 in chips) 
Seat 2: Westpants ($153.19 in chips) 
Seat 3: Foton18 ($74.12 in chips) 
Seat 4: matiko09 ($174.40 in chips) 
Seat 5: omorfadramou ($163 in chips) 
Seat 6: choupai ($9.03 in chips) 
Seat 7: ruslik_by ($100 in chips) 
Seat 8: Filojoes ($150.76 in chips) 
Seat 9: butcheN18 ($100 in chips) 
Foton18: posts small blind $0.50
matiko09: posts big blind $1
*** HOLE CARDS ***
Dealt to matiko09 [9s Qd]
omorfadramou: folds 
choupai: folds 
ruslik_by: folds 
Filojoes: folds 
butcheN18: folds 
vrnMike: folds 
Westpants: raises $1.46 to $2.46
Foton18: folds 
matiko09: calls $1.46
*** FLOP *** [2c Kd Ks]
matiko09: checks 
Westpants: bets $3.65
matiko09: folds 
Uncalled bet ($3.65) returned to Westpants
Westpants collected $5.15 from pot
*** SUMMARY ***
Total pot $5.42 | Rake $0.27 
Board [2c Kd Ks]
Seat 1: vrnMike folded before Flop (didn't bet)
Seat 2: Westpants (button) collected ($5.15)
Seat 3: Foton18 (small blind) folded before Flop
Seat 4: matiko09 (big blind) folded on the Flop
Seat 5: omorfadramou folded before Flop (didn't bet)
Seat 6: choupai folded before Flop (didn't bet)
Seat 7: ruslik_by folded before Flop (didn't bet)
Seat 8: Filojoes folded before Flop (didn't bet)
Seat 9: butcheN18 folded before Flop (didn't bet)





PokerStars Hand #151944067936:  Hold'em No Limit ($1/$2 USD) - 2016/04/15 14:16:40 CET [2016/04/15 8:16:40 ET]
Table 'Oceax' 9-max Seat #6 is the button
Seat 1: matiko09 ($203 in chips) 
Seat 2: Fish4trips ($273.68 in chips) 
Seat 4: butcheN18 ($293.46 in chips) 
Seat 5: derrocco82 ($203.83 in chips) 
Seat 6: Iggso ($272.93 in chips) 
Seat 7: ssljvr ($252.60 in chips) 
Seat 8: Poroxide ($326.97 in chips) 
Seat 9: erfk1958 ($176.33 in chips) 
ssljvr: posts small blind $1
Poroxide: posts big blind $2
Vikulja1993: sits out 
*** HOLE CARDS ***
Dealt to matiko09 [8s 5c]
erfk1958: folds 
matiko09: folds 
Fish4trips: folds 
butcheN18: raises $4 to $6
derrocco82: folds 
Iggso: folds 
ssljvr: calls $5
Poroxide: folds 
*** FLOP *** [Ts Jc 8d]
ssljvr: checks 
butcheN18: bets $8.51
ssljvr: raises $20.49 to $29
butcheN18: calls $20.49
*** TURN *** [Ts Jc 8d] [6d]
ssljvr: checks 
butcheN18: bets $44
ssljvr: folds 
Uncalled bet ($44) returned to butcheN18
butcheN18 collected $69.25 from pot
butcheN18: doesn't show hand 
*** SUMMARY ***
Total pot $72 | Rake $2.75 
Board [Ts Jc 8d 6d]
Seat 1: matiko09 folded before Flop (didn't bet)
Seat 2: Fish4trips folded before Flop (didn't bet)
Seat 4: butcheN18 collected ($69.25)
Seat 5: derrocco82 folded before Flop (didn't bet)
Seat 6: Iggso (button) folded before Flop (didn't bet)
Seat 7: ssljvr (small blind) folded on the Turn
Seat 8: Poroxide (big blind) folded before Flop
Seat 9: erfk1958 folded before Flop (didn't bet)





PokerStars Hand #151944068604:  Hold'em No Limit ($0.50/$1.00 USD) - 2016/04/15 14:16:41 CET [2016/04/15 8:16:41 ET]
Table 'Navi' 9-max Seat #3 is the button
Seat 1: tipner ($111.83 in chips) 
Seat 2: myatiy 96 ($100 in chips) 
Seat 3: vrnMike ($138.85 in chips) 
Seat 4: Pvsx. ($100.50 in chips) 
Seat 5: Prettyspitz ($100 in chips) 
Seat 6: Vikulja1993 ($123.90 in chips) 
Seat 8: ruslik_by ($169 in chips) 
Seat 9: matiko09 ($126.63 in chips) 
Pvsx.: posts small blind $0.50
Prettyspitz: posts big blind $1
*** HOLE CARDS ***
Dealt to matiko09 [Qs Ah]
Vikulja1993: raises $2 to $3
ruslik_by: folds 
matiko09: calls $3
tipner: folds 
myatiy 96: folds 
vrnMike: folds 
Pvsx.: folds 
Prettyspitz: folds 
*** FLOP *** [7s Ad 6s]
Vikulja1993: checks 
matiko09: bets $4.63
Vikulja1993: folds 
Uncalled bet ($4.63) returned to matiko09
matiko09 collected $7.12 from pot
matiko09: doesn't show hand 
*** SUMMARY ***
Total pot $7.50 | Rake $0.38 
Board [7s Ad 6s]
Seat 1: tipner folded before Flop (didn't bet)
Seat 2: myatiy 96 folded before Flop (didn't bet)
Seat 3: vrnMike (button) folded before Flop (didn't bet)
Seat 4: Pvsx. (small blind) folded before Flop
Seat 5: Prettyspitz (big blind) folded before Flop
Seat 6: Vikulja1993 folded on the Flop
Seat 8: ruslik_by folded before Flop (didn't bet)
Seat 9: matiko09 collected ($7.12)





PokerStars Hand #151944071642:  Hold'em No Limit ($1/$2 USD) - 2016/04/15 14:16:47 CET [2016/04/15 8:16:47 ET]
Table 'Adele II' 9-max Seat #9 is the button
Seat 1: RyanHuJun ($328.64 in chips) 
Seat 2: Fish4trips ($323.54 in chips) 
Seat 3: matiko09 ($311.33 in chips) 
Seat 4: Glushchenko ($220.81 in chips) 
Seat 5: TonnaMunz ($200 in chips) 
Seat 6: Kukuryzka ($243.56 in chips) 
Seat 7: Iggso ($200 in chips) 
Seat 8: butcheN18 ($245.67 in chips) 
Seat 9: SanychStar ($276.60 in chips) 
RyanHuJun: posts small blind $1
Fish4trips: posts big blind $2
*** HOLE CARDS ***
Dealt to matiko09 [4h 4s]
matiko09: raises $3 to $5
Glushchenko: calls $5
TonnaMunz: folds 
Kukuryzka: folds 
Iggso: folds 
butcheN18: folds 
SanychStar: folds 
RyanHuJun: folds 
Fish4trips: folds 
*** FLOP *** [7d Qd Qc]
matiko09: checks 
Glushchenko: bets $8.23
matiko09: folds 
Uncalled bet ($8.23) returned to Glushchenko
Glushchenko collected $12.35 from pot
*** SUMMARY ***
Total pot $13 | Rake $0.65 
Board [7d Qd Qc]
Seat 1: RyanHuJun (small blind) folded before Flop
Seat 2: Fish4trips (big blind) folded before Flop
Seat 3: matiko09 folded on the Flop
Seat 4: Glushchenko collected ($12.35)
Seat 5: TonnaMunz folded before Flop (didn't bet)
Seat 6: Kukuryzka folded before Flop (didn't bet)
Seat 7: Iggso folded before Flop (didn't bet)
Seat 8: butcheN18 folded before Flop (didn't bet)
Seat 9: SanychStar (button) folded before Flop (didn't bet)





PokerStars Hand #151944072362:  Hold'em No Limit ($1/$2 USD) - 2016/04/15 14:16:48 CET [2016/04/15 8:16:48 ET]
Table 'Blaauw' 9-max Seat #4 is the button
Seat 1: myatiy 96 ($216.46 in chips) 
Seat 2: butcheN18 ($238.19 in chips) 
Seat 3: erfk1958 ($138.90 in chips) 
Seat 4: petro0107 ($199.94 in chips) 
Seat 5: tipner ($222.40 in chips) 
Seat 6: matiko09 ($290.90 in chips) 
Seat 7: ssljvr ($413.95 in chips) 
Seat 8: Iggso ($200 in chips) 
Seat 9: coinflip_si ($200 in chips) 
tipner: posts small blind $1
matiko09: posts big blind $2
*** HOLE CARDS ***
Dealt to matiko09 [7s Ts]
ssljvr: folds 
Iggso: raises $4 to $6
coinflip_si: folds 
myatiy 96: raises $12 to $18
butcheN18: folds 
erfk1958: folds 
petro0107: folds 
tipner: folds 
matiko09: folds 
Iggso: folds 
Uncalled bet ($12) returned to myatiy 96
myatiy 96 collected $15 from pot
myatiy 96: doesn't show hand 
*** SUMMARY ***
Total pot $15 | Rake $0 
Seat 1: myatiy 96 collected ($15)
Seat 2: butcheN18 folded before Flop (didn't bet)
Seat 3: erfk1958 folded before Flop (didn't bet)
Seat 4: petro0107 (button) folded before Flop (didn't bet)
Seat 5: tipner (small blind) folded before Flop
Seat 6: matiko09 (big blind) folded before Flop
Seat 7: ssljvr folded before Flop (didn't bet)
Seat 8: Iggso folded before Flop
Seat 9: coinflip_si folded before Flop (didn't bet)





PokerStars Hand #151944073134:  Hold'em No Limit ($0.50/$1.00 USD) - 2016/04/15 14:16:50 CET [2016/04/15 8:16:50 ET]
Table 'Desagneauxa II' 9-max Seat #2 is the button
Seat 1: Rocky6434 ($109.87 in chips) 
Seat 2: Filojoes ($100 in chips) 
Seat 3: matiko09 ($100 in chips) 
Seat 4: Prettyspitz ($100 in chips) 
Seat 5: Carlo22222 ($35.20 in chips) 
Seat 6: DIMAN_324 ($113.35 in chips) 
Seat 7: TideHan ($100 in chips) 
Seat 8: di0d80 ($100 in chips) 
matiko09: posts small blind $0.50
Prettyspitz: posts big blind $1
ruslik_by: sits out 
*** HOLE CARDS ***
Dealt to matiko09 [4c 3s]
Carlo22222: folds 
DIMAN_324: folds 
TideHan: folds 
di0d80: folds 
Rocky6434: folds 
Filojoes: raises $1 to $2
Rocky6434 leaves the table
matiko09: folds 
Prettyspitz: folds 
Uncalled bet ($1) returned to Filojoes
Filojoes collected $2.50 from pot
Filojoes: doesn't show hand 
*** SUMMARY ***
Total pot $2.50 | Rake $0 
Seat 1: Rocky6434 folded before Flop (didn't bet)
Seat 2: Filojoes (button) collected ($2.50)
Seat 3: matiko09 (small blind) folded before Flop
Seat 4: Prettyspitz (big blind) folded before Flop
Seat 5: Carlo22222 folded before Flop (didn't bet)
Seat 6: DIMAN_324 folded before Flop (didn't bet)
Seat 7: TideHan folded before Flop (didn't bet)
Seat 8: di0d80 folded before Flop (didn't bet)





PokerStars Hand #151944082533:  Hold'em No Limit ($1/$2 USD) - 2016/04/15 14:17:08 CET [2016/04/15 8:17:08 ET]
Table 'Marmara II' 9-max Seat #2 is the button
Seat 1: ssljvr ($488.98 in chips) 
Seat 2: Iggso ($200 in chips) 
Seat 3: Glushchenko ($207.44 in chips) 
Seat 4: Fish4trips ($244.96 in chips) 
Seat 5: docmarc777 ($395.40 in chips) 
Seat 6: azzad2007 ($200 in chips) 
Seat 7: matiko09 ($228.77 in chips) 
Seat 8: Dachish ($164.46 in chips) 
Seat 9: erfk1958 ($168.58 in chips) 
Glushchenko: posts small blind $1
Fish4trips: posts big blind $2
*** HOLE CARDS ***
Dealt to matiko09 [3h 4h]
docmarc777: folds 
azzad2007: folds 
matiko09: folds 
Dachish: raises $3 to $5
erfk1958: folds 
ssljvr: folds 
Iggso: calls $5
Glushchenko: calls $4
Fish4trips: folds 
*** FLOP *** [5d Jh 5h]
Glushchenko: checks 
Dachish: bets $8
Iggso: folds 
Glushchenko: folds 
Uncalled bet ($8) returned to Dachish
Dachish collected $16.15 from pot
Dachish: doesn't show hand 
*** SUMMARY ***
Total pot $17 | Rake $0.85 
Board [5d Jh 5h]
Seat 1: ssljvr folded before Flop (didn't bet)
Seat 2: Iggso (button) folded on the Flop
Seat 3: Glushchenko (small blind) folded on the Flop
Seat 4: Fish4trips (big blind) folded before Flop
Seat 5: docmarc777 folded before Flop (didn't bet)
Seat 6: azzad2007 folded before Flop (didn't bet)
Seat 7: matiko09 folded before Flop (didn't bet)
Seat 8: Dachish collected ($16.15)
Seat 9: erfk1958 folded before Flop (didn't bet)





PokerStars Hand #151944085216:  Hold'em No Limit ($1/$2 USD) - 2016/04/15 14:17:13 CET [2016/04/15 8:17:13 ET]
Table 'Blaauw' 9-max Seat #5 is the button
Seat 1: myatiy 96 ($225.46 in chips) 
Seat 2: butcheN18 ($238.19 in chips) 
Seat 3: erfk1958 ($138.90 in chips) 
Seat 4: petro0107 ($199.94 in chips) 
Seat 5: tipner ($221.40 in chips) 
Seat 6: matiko09 ($288.90 in chips) 
Seat 7: ssljvr ($413.95 in chips) 
Seat 8: Iggso ($200 in chips) 
Seat 9: coinflip_si ($200 in chips) 
matiko09: posts small blind $1
ssljvr: posts big blind $2
*** HOLE CARDS ***
Dealt to matiko09 [Jh 9d]
Iggso: folds 
coinflip_si: folds 
myatiy 96: folds 
butcheN18: raises $4 to $6
erfk1958: folds 
petro0107: folds 
tipner: folds 
matiko09: folds 
ssljvr: folds 
Uncalled bet ($4) returned to butcheN18
butcheN18 collected $5 from pot
butcheN18: doesn't show hand 
*** SUMMARY ***
Total pot $5 | Rake $0 
Seat 1: myatiy 96 folded before Flop (didn't bet)
Seat 2: butcheN18 collected ($5)
Seat 3: erfk1958 folded before Flop (didn't bet)
Seat 4: petro0107 folded before Flop (didn't bet)
Seat 5: tipner (button) folded before Flop (didn't bet)
Seat 6: matiko09 (small blind) folded before Flop
Seat 7: ssljvr (big blind) folded before Flop
Seat 8: Iggso folded before Flop (didn't bet)
Seat 9: coinflip_si folded before Flop (didn't bet)





PokerStars Hand #151944090041:  Hold'em No Limit ($0.50/$1.00 USD) - 2016/04/15 14:17:22 CET [2016/04/15 8:17:22 ET]
Table 'Chiny II' 9-max Seat #3 is the button
Seat 1: vrnMike ($154.56 in chips) 
Seat 2: Westpants ($155.88 in chips) 
Seat 3: Foton18 ($73.62 in chips) 
Seat 4: matiko09 ($171.94 in chips) 
Seat 5: omorfadramou ($163 in chips) 
Seat 6: choupai ($9.03 in chips) 
Seat 7: ruslik_by ($100 in chips) 
Seat 8: Filojoes ($150.76 in chips) 
Seat 9: butcheN18 ($100 in chips) 
matiko09: posts small blind $0.50
omorfadramou: posts big blind $1
*** HOLE CARDS ***
Dealt to matiko09 [Qh 5h]
choupai: folds 
ruslik_by: folds 
Filojoes: raises $2 to $3
butcheN18: folds 
vrnMike: folds 
Westpants: folds 
Foton18: folds 
matiko09: folds 
omorfadramou: folds 
Uncalled bet ($2) returned to Filojoes
Filojoes collected $2.50 from pot
Filojoes: doesn't show hand 
*** SUMMARY ***
Total pot $2.50 | Rake $0 
Seat 1: vrnMike folded before Flop (didn't bet)
Seat 2: Westpants folded before Flop (didn't bet)
Seat 3: Foton18 (button) folded before Flop (didn't bet)
Seat 4: matiko09 (small blind) folded before Flop
Seat 5: omorfadramou (big blind) folded before Flop
Seat 6: choupai folded before Flop (didn't bet)
Seat 7: ruslik_by folded before Flop (didn't bet)
Seat 8: Filojoes collected ($2.50)
Seat 9: butcheN18 folded before Flop (didn't bet)





PokerStars Hand #151944090447:  Hold'em No Limit ($0.50/$1.00 USD) - 2016/04/15 14:17:23 CET [2016/04/15 8:17:23 ET]
Table 'Adelgunde III' 9-max Seat #1 is the button
Seat 1: valimiu ($129.80 in chips) 
Seat 2: Vikulja1993 ($100.50 in chips) 
Seat 3: tipner ($124.70 in chips) 
Seat 4: hammerwife ($131.23 in chips) 
Seat 5: matiko09 ($120.91 in chips) 
Seat 6: Pominator92 ($112.08 in chips) 
Seat 7: Yaaaazz ($100 in chips) 
Seat 8: SanychStar ($128.06 in chips) 
Seat 9: Kukuryzka ($123.01 in chips) 
Vikulja1993: posts small blind $0.50
tipner: posts big blind $1
*** HOLE CARDS ***
Dealt to matiko09 [Js 6c]
hammerwife: folds 
matiko09: folds 
Pominator92: folds 
Yaaaazz: folds 
SanychStar: folds 
Kukuryzka: folds 
valimiu: calls $1
Vikulja1993: folds 
tipner: checks 
*** FLOP *** [Kd Ks 9s]
tipner: bets $2
valimiu: folds 
Uncalled bet ($2) returned to tipner
tipner collected $2.38 from pot
tipner: doesn't show hand 
*** SUMMARY ***
Total pot $2.50 | Rake $0.12 
Board [Kd Ks 9s]
Seat 1: valimiu (button) folded on the Flop
Seat 2: Vikulja1993 (small blind) folded before Flop
Seat 3: tipner (big blind) collected ($2.38)
Seat 4: hammerwife folded before Flop (didn't bet)
Seat 5: matiko09 folded before Flop (didn't bet)
Seat 6: Pominator92 folded before Flop (didn't bet)
Seat 7: Yaaaazz folded before Flop (didn't bet)
Seat 8: SanychStar folded before Flop (didn't bet)
Seat 9: Kukuryzka folded before Flop (didn't bet)





PokerStars Hand #151944094321:  Hold'em No Limit ($0.50/$1.00 USD) - 2016/04/15 14:17:30 CET [2016/04/15 8:17:30 ET]
Table 'Parvulesco II' 9-max Seat #1 is the button
Seat 1: bilukm ($75.99 in chips) 
Seat 2: Filojoes ($106.04 in chips) 
Seat 3: matiko09 ($125.01 in chips) 
Seat 4: butcheN18 ($100 in chips) 
Seat 5: maxxmeister ($105.60 in chips) 
Seat 6: ruslik_by ($131.55 in chips) 
Seat 7: Kukuryzka ($133.44 in chips) 
Seat 8: Jimy Tiltman ($111.92 in chips) 
Seat 9: hammerwife ($209.03 in chips) 
Filojoes: posts small blind $0.50
matiko09: posts big blind $1
*** HOLE CARDS ***
Dealt to matiko09 [6c Jc]
butcheN18: raises $2 to $3
maxxmeister: calls $3
ruslik_by: folds 
Kukuryzka: folds 
Jimy Tiltman: folds 
hammerwife: folds 
bilukm: calls $3
Filojoes: folds 
matiko09: folds 
*** FLOP *** [3s Qd 6d]
butcheN18: checks 
maxxmeister: checks 
bilukm: checks 
*** TURN *** [3s Qd 6d] [7c]
butcheN18: checks 
maxxmeister: checks 
bilukm: checks 
*** RIVER *** [3s Qd 6d 7c] [8s]
butcheN18: checks 
maxxmeister: bets $7.68
bilukm: folds 
butcheN18: folds 
Uncalled bet ($7.68) returned to maxxmeister
maxxmeister collected $9.98 from pot
maxxmeister: doesn't show hand 
*** SUMMARY ***
Total pot $10.50 | Rake $0.52 
Board [3s Qd 6d 7c 8s]
Seat 1: bilukm (button) folded on the River
Seat 2: Filojoes (small blind) folded before Flop
Seat 3: matiko09 (big blind) folded before Flop
Seat 4: butcheN18 folded on the River
Seat 5: maxxmeister collected ($9.98)
Seat 6: ruslik_by folded before Flop (didn't bet)
Seat 7: Kukuryzka folded before Flop (didn't bet)
Seat 8: Jimy Tiltman folded before Flop (didn't bet)
Seat 9: hammerwife folded before Flop (didn't bet)





PokerStars Hand #151944095146:  Hold'em No Limit ($0.50/$1.00 USD) - 2016/04/15 14:17:32 CET [2016/04/15 8:17:32 ET]
Table 'Desagneauxa II' 9-max Seat #3 is the button
Seat 2: Filojoes ($101.50 in chips) 
Seat 3: matiko09 ($100 in chips) 
Seat 4: Prettyspitz ($100 in chips) 
Seat 5: Carlo22222 ($47.44 in chips) 
Seat 6: DIMAN_324 ($113.35 in chips) 
Seat 7: TideHan ($100 in chips) 
Seat 8: di0d80 ($100 in chips) 
Prettyspitz: posts small blind $0.50
Carlo22222: posts big blind $1
ruslik_by: sits out 
*** HOLE CARDS ***
Dealt to matiko09 [8h Td]
DIMAN_324: raises $2 to $3
TideHan: folds 
di0d80: folds 
Filojoes: folds 
matiko09: folds 
Prettyspitz: folds 
Carlo22222: calls $2
*** FLOP *** [8s Ks Qh]
Carlo22222: checks 
DIMAN_324: bets $4
Carlo22222: calls $4
*** TURN *** [8s Ks Qh] [Ad]
Vikulja1993 joins the table at seat #1 
Carlo22222: checks 
DIMAN_324: checks 
*** RIVER *** [8s Ks Qh Ad] [6h]
Carlo22222: bets $8
DIMAN_324: folds 
Uncalled bet ($8) returned to Carlo22222
Carlo22222 collected $13.78 from pot
Carlo22222: doesn't show hand 
*** SUMMARY ***
Total pot $14.50 | Rake $0.72 
Board [8s Ks Qh Ad 6h]
Seat 2: Filojoes folded before Flop (didn't bet)
Seat 3: matiko09 (button) folded before Flop (didn't bet)
Seat 4: Prettyspitz (small blind) folded before Flop
Seat 5: Carlo22222 (big blind) collected ($13.78)
Seat 6: DIMAN_324 folded on the River
Seat 7: TideHan folded before Flop (didn't bet)
Seat 8: di0d80 folded before Flop (didn't bet)





PokerStars Hand #151944095137:  Hold'em No Limit ($1/$2 USD) - 2016/04/15 14:17:32 CET [2016/04/15 8:17:32 ET]
Table 'Adele II' 9-max Seat #1 is the button
Seat 1: RyanHuJun ($327.64 in chips) 
Seat 2: Fish4trips ($321.54 in chips) 
Seat 3: matiko09 ($306.33 in chips) 
Seat 4: Glushchenko ($228.16 in chips) 
Seat 5: TonnaMunz ($200 in chips) 
Seat 6: Kukuryzka ($243.56 in chips) 
Seat 7: Iggso ($200 in chips) 
Seat 8: butcheN18 ($245.67 in chips) 
Seat 9: SanychStar ($276.60 in chips) 
Fish4trips: posts small blind $1
matiko09: posts big blind $2
*** HOLE CARDS ***
Dealt to matiko09 [Kh 9h]
Glushchenko: folds 
TonnaMunz: folds 
Kukuryzka: folds 
Iggso: folds 
butcheN18: folds 
SanychStar: folds 
RyanHuJun: folds 
Fish4trips: folds 
Uncalled bet ($1) returned to matiko09
matiko09 collected $2 from pot
matiko09: doesn't show hand 
*** SUMMARY ***
Total pot $2 | Rake $0 
Seat 1: RyanHuJun (button) folded before Flop (didn't bet)
Seat 2: Fish4trips (small blind) folded before Flop
Seat 3: matiko09 (big blind) collected ($2)
Seat 4: Glushchenko folded before Flop (didn't bet)
Seat 5: TonnaMunz folded before Flop (didn't bet)
Seat 6: Kukuryzka folded before Flop (didn't bet)
Seat 7: Iggso folded before Flop (didn't bet)
Seat 8: butcheN18 folded before Flop (didn't bet)
Seat 9: SanychStar folded before Flop (didn't bet)





PokerStars Hand #151944100584:  Hold'em No Limit ($0.50/$1.00 USD) - 2016/04/15 14:17:42 CET [2016/04/15 8:17:42 ET]
Table 'Navi' 9-max Seat #4 is the button
Seat 1: tipner ($111.83 in chips) 
Seat 2: myatiy 96 ($100 in chips) 
Seat 3: vrnMike ($138.85 in chips) 
Seat 4: Pvsx. ($100 in chips) 
Seat 5: Prettyspitz ($100 in chips) 
Seat 6: Vikulja1993 ($120.90 in chips) 
Seat 8: ruslik_by ($169 in chips) 
Seat 9: matiko09 ($130.75 in chips) 
Prettyspitz: posts small blind $0.50
Vikulja1993: posts big blind $1
*** HOLE CARDS ***
Dealt to matiko09 [Kd Ks]
ruslik_by: folds 
matiko09: raises $2 to $3
tipner: folds 
myatiy 96: folds 
vrnMike: folds 
Pvsx.: folds 
Prettyspitz: folds 
Vikulja1993: folds 
Uncalled bet ($2) returned to matiko09
matiko09 collected $2.50 from pot
matiko09: doesn't show hand 
*** SUMMARY ***
Total pot $2.50 | Rake $0 
Seat 1: tipner folded before Flop (didn't bet)
Seat 2: myatiy 96 folded before Flop (didn't bet)
Seat 3: vrnMike folded before Flop (didn't bet)
Seat 4: Pvsx. (button) folded before Flop (didn't bet)
Seat 5: Prettyspitz (small blind) folded before Flop
Seat 6: Vikulja1993 (big blind) folded before Flop
Seat 8: ruslik_by folded before Flop (didn't bet)
Seat 9: matiko09 collected ($2.50)





PokerStars Hand #151944105737:  Hold'em No Limit ($1/$2 USD) - 2016/04/15 14:17:52 CET [2016/04/15 8:17:52 ET]
Table 'Blaauw' 9-max Seat #6 is the button
Seat 1: myatiy 96 ($225.46 in chips) 
Seat 2: butcheN18 ($241.19 in chips) 
Seat 3: erfk1958 ($138.90 in chips) 
Seat 4: petro0107 ($199.94 in chips) 
Seat 5: tipner ($221.40 in chips) 
Seat 6: matiko09 ($287.90 in chips) 
Seat 7: ssljvr ($411.95 in chips) 
Seat 8: Iggso ($200 in chips) 
Seat 9: coinflip_si ($200 in chips) 
ssljvr: posts small blind $1
Iggso: posts big blind $2
*** HOLE CARDS ***
Dealt to matiko09 [Qs 6h]
coinflip_si: folds 
myatiy 96: folds 
butcheN18: folds 
erfk1958: raises $2 to $4
petro0107: calls $4
tipner: folds 
matiko09: folds 
ssljvr: folds 
Iggso: folds 
*** FLOP *** [3s Jh Jd]
erfk1958: bets $4
petro0107: calls $4
*** TURN *** [3s Jh Jd] [2h]
erfk1958: bets $6
petro0107: calls $6
*** RIVER *** [3s Jh Jd 2h] [5c]
erfk1958: checks 
petro0107: bets $22
erfk1958: folds 
Uncalled bet ($22) returned to petro0107
petro0107 collected $29.45 from pot
petro0107: doesn't show hand 
*** SUMMARY ***
Total pot $31 | Rake $1.55 
Board [3s Jh Jd 2h 5c]
Seat 1: myatiy 96 folded before Flop (didn't bet)
Seat 2: butcheN18 folded before Flop (didn't bet)
Seat 3: erfk1958 folded on the River
Seat 4: petro0107 collected ($29.45)
Seat 5: tipner folded before Flop (didn't bet)
Seat 6: matiko09 (button) folded before Flop (didn't bet)
Seat 7: ssljvr (small blind) folded before Flop
Seat 8: Iggso (big blind) folded before Flop
Seat 9: coinflip_si folded before Flop (didn't bet)





PokerStars Hand #151944110271:  Hold'em No Limit ($0.50/$1.00 USD) - 2016/04/15 14:18:00 CET [2016/04/15 8:18:00 ET]
Table 'Chiny II' 9-max Seat #4 is the button
Seat 1: vrnMike ($154.56 in chips) 
Seat 2: Westpants ($155.88 in chips) 
Seat 3: Foton18 ($73.62 in chips) 
Seat 4: matiko09 ($171.44 in chips) 
Seat 5: omorfadramou ($162 in chips) 
Seat 6: choupai ($9.03 in chips) 
Seat 7: ruslik_by ($100 in chips) 
Seat 8: Filojoes ($152.26 in chips) 
Seat 9: butcheN18 ($100 in chips) 
omorfadramou: posts small blind $0.50
choupai: posts big blind $1
*** HOLE CARDS ***
Dealt to matiko09 [Tc 7d]
ruslik_by: folds 
Filojoes: folds 
butcheN18: folds 
vrnMike: folds 
Westpants: folds 
Foton18: raises $2 to $3
matiko09: folds 
omorfadramou: folds 
choupai: folds 
Uncalled bet ($2) returned to Foton18
Foton18 collected $2.50 from pot
Foton18: doesn't show hand 
*** SUMMARY ***
Total pot $2.50 | Rake $0 
Seat 1: vrnMike folded before Flop (didn't bet)
Seat 2: Westpants folded before Flop (didn't bet)
Seat 3: Foton18 collected ($2.50)
Seat 4: matiko09 (button) folded before Flop (didn't bet)
Seat 5: omorfadramou (small blind) folded before Flop
Seat 6: choupai (big blind) folded before Flop
Seat 7: ruslik_by folded before Flop (didn't bet)
Seat 8: Filojoes folded before Flop (didn't bet)
Seat 9: butcheN18 folded before Flop (didn't bet)





PokerStars Hand #151944109843:  Hold'em No Limit ($0.50/$1.00 USD) - 2016/04/15 14:18:00 CET [2016/04/15 8:18:00 ET]
Table 'Emma II' 9-max Seat #2 is the button
Seat 1: omorfadramou ($113.28 in chips) 
Seat 2: Filojoes ($140.50 in chips) 
Seat 3: Glushchenko ($268.29 in chips) 
Seat 4: matiko09 ($101.50 in chips) 
Seat 5: Prettyspitz ($103.65 in chips) 
Seat 6: Tirka ($104.53 in chips) 
Seat 7: ruslik_by ($102.50 in chips) 
Seat 8: geiranger011 ($87.44 in chips) 
Seat 9: Foton18 ($130.59 in chips) 
Glushchenko: posts small blind $0.50
matiko09: posts big blind $1
*** HOLE CARDS ***
Dealt to matiko09 [3d 9d]
Prettyspitz: raises $2 to $3
Tirka: calls $3
ruslik_by: calls $3
geiranger011: folds 
Foton18: raises $2 to $5
omorfadramou: folds 
Filojoes: folds 
Glushchenko: folds 
matiko09: folds 
Prettyspitz: calls $2
Tirka: calls $2
ruslik_by: raises $10 to $15
Foton18: calls $10
Prettyspitz: calls $10
Tirka: calls $10
*** FLOP *** [2s Ah 5s]
Prettyspitz: checks 
Tirka: checks 
ruslik_by: checks 
Foton18: checks 
*** TURN *** [2s Ah 5s] [7d]
Prettyspitz: bets $24
Tirka: calls $24
ruslik_by: folds 
Foton18: folds 
*** RIVER *** [2s Ah 5s 7d] [5d]
Prettyspitz: checks 
Tirka: checks 
*** SHOW DOWN ***
Prettyspitz: shows [9s 8s] (a pair of Fives)
Tirka: shows [Jd As] (two pair, Aces and Fives)
Tirka collected $107 from pot
*** SUMMARY ***
Total pot $109.50 | Rake $2.50 
Board [2s Ah 5s 7d 5d]
Seat 1: omorfadramou folded before Flop (didn't bet)
Seat 2: Filojoes (button) folded before Flop (didn't bet)
Seat 3: Glushchenko (small blind) folded before Flop
Seat 4: matiko09 (big blind) folded before Flop
Seat 5: Prettyspitz showed [9s 8s] and lost with a pair of Fives
Seat 6: Tirka showed [Jd As] and won ($107) with two pair, Aces and Fives
Seat 7: ruslik_by folded on the Turn
Seat 8: geiranger011 folded before Flop (didn't bet)
Seat 9: Foton18 folded on the Turn





PokerStars Hand #151944111566:  Hold'em No Limit ($1/$2 USD) - 2016/04/15 14:18:03 CET [2016/04/15 8:18:03 ET]
Table 'Adele II' 9-max Seat #2 is the button
Seat 1: RyanHuJun ($327.64 in chips) 
Seat 2: Fish4trips ($320.54 in chips) 
Seat 3: matiko09 ($307.33 in chips) 
Seat 4: Glushchenko ($228.16 in chips) 
Seat 5: TonnaMunz ($200 in chips) 
Seat 6: Kukuryzka ($243.56 in chips) 
Seat 7: Iggso ($200 in chips) 
Seat 8: butcheN18 ($245.67 in chips) 
Seat 9: SanychStar ($276.60 in chips) 
matiko09: posts small blind $1
Glushchenko: posts big blind $2
*** HOLE CARDS ***
Dealt to matiko09 [As 7d]
TonnaMunz: folds 
Kukuryzka: raises $4 to $6
Iggso: folds 
butcheN18: folds 
SanychStar: folds 
RyanHuJun: calls $6
Fish4trips: folds 
matiko09: folds 
Glushchenko: folds 
*** FLOP *** [Ts Ac 8h]
Kukuryzka: bets $10.69
RyanHuJun: calls $10.69
*** TURN *** [Ts Ac 8h] [4h]
Kukuryzka: bets $24
RyanHuJun: folds 
Uncalled bet ($24) returned to Kukuryzka
Kukuryzka collected $34.56 from pot
Kukuryzka: doesn't show hand 
*** SUMMARY ***
Total pot $36.38 | Rake $1.82 
Board [Ts Ac 8h 4h]
Seat 1: RyanHuJun folded on the Turn
Seat 2: Fish4trips (button) folded before Flop (didn't bet)
Seat 3: matiko09 (small blind) folded before Flop
Seat 4: Glushchenko (big blind) folded before Flop
Seat 5: TonnaMunz folded before Flop (didn't bet)
Seat 6: Kukuryzka collected ($34.56)
Seat 7: Iggso folded before Flop (didn't bet)
Seat 8: butcheN18 folded before Flop (didn't bet)
Seat 9: SanychStar folded before Flop (didn't bet)





PokerStars Hand #151944114071:  Hold'em No Limit ($0.50/$1.00 USD) - 2016/04/15 14:18:08 CET [2016/04/15 8:18:08 ET]
Table 'Navi' 9-max Seat #5 is the button
Seat 1: tipner ($111.83 in chips) 
Seat 2: myatiy 96 ($100 in chips) 
Seat 3: vrnMike ($138.85 in chips) 
Seat 4: Pvsx. ($100 in chips) 
Seat 5: Prettyspitz ($100 in chips) 
Seat 6: Vikulja1993 ($119.90 in chips) 
Seat 8: ruslik_by ($169 in chips) 
Seat 9: matiko09 ($132.25 in chips) 
Vikulja1993: posts small blind $0.50
yoshidao was removed from the table for failing to post
ruslik_by: posts big blind $1
*** HOLE CARDS ***
Dealt to matiko09 [4c 5s]
Kukuryzka joins the table at seat #7 
matiko09: folds 
Kukuryzka leaves the table
tipner: folds 
myatiy 96: folds 
vrnMike: folds 
Pvsx.: folds 
Prettyspitz: raises $1.04 to $2.04
Vikulja1993: folds 
ruslik_by: folds 
Uncalled bet ($1.04) returned to Prettyspitz
Prettyspitz collected $2.50 from pot
Prettyspitz: doesn't show hand 
*** SUMMARY ***
Total pot $2.50 | Rake $0 
Seat 1: tipner folded before Flop (didn't bet)
Seat 2: myatiy 96 folded before Flop (didn't bet)
Seat 3: vrnMike folded before Flop (didn't bet)
Seat 4: Pvsx. folded before Flop (didn't bet)
Seat 5: Prettyspitz (button) collected ($2.50)
Seat 6: Vikulja1993 (small blind) folded before Flop
Seat 8: ruslik_by (big blind) folded before Flop
Seat 9: matiko09 folded before Flop (didn't bet)





PokerStars Hand #151944116702:  Hold'em No Limit ($0.50/$1.00 USD) - 2016/04/15 14:18:13 CET [2016/04/15 8:18:13 ET]
Table 'Adelgunde III' 9-max Seat #2 is the button
Seat 1: valimiu ($128.80 in chips) 
Seat 2: Vikulja1993 ($100 in chips) 
Seat 3: tipner ($126.08 in chips) 
Seat 4: hammerwife ($131.23 in chips) 
Seat 5: matiko09 ($120.91 in chips) 
Seat 6: Pominator92 ($112.08 in chips) 
Seat 7: Yaaaazz ($100 in chips) 
Seat 8: SanychStar ($128.06 in chips) 
Seat 9: Kukuryzka ($123.01 in chips) 
tipner: posts small blind $0.50
hammerwife: posts big blind $1
*** HOLE CARDS ***
Dealt to matiko09 [Js 8c]
matiko09: folds 
Pominator92: calls $1
Yaaaazz: folds 
SanychStar: folds 
Kukuryzka: folds 
valimiu: calls $1
Vikulja1993: folds 
tipner: folds 
hammerwife: checks 
*** FLOP *** [6c 9h 7c]
hammerwife: checks 
Pominator92: bets $2
valimiu: calls $2
hammerwife: calls $2
*** TURN *** [6c 9h 7c] [Th]
hammerwife: checks 
Pominator92: checks 
valimiu: checks 
*** RIVER *** [6c 9h 7c Th] [4h]
hammerwife: bets $3.60
Pominator92: calls $3.60
valimiu: folds 
*** SHOW DOWN ***
hammerwife: shows [7h Td] (two pair, Tens and Sevens)
Pominator92: shows [Ts 9d] (two pair, Tens and Nines)
Pominator92 collected $15.86 from pot
*** SUMMARY ***
Total pot $16.70 | Rake $0.84 
Board [6c 9h 7c Th 4h]
Seat 1: valimiu folded on the River
Seat 2: Vikulja1993 (button) folded before Flop (didn't bet)
Seat 3: tipner (small blind) folded before Flop
Seat 4: hammerwife (big blind) showed [7h Td] and lost with two pair, Tens and Sevens
Seat 5: matiko09 folded before Flop (didn't bet)
Seat 6: Pominator92 showed [Ts 9d] and won ($15.86) with two pair, Tens and Nines
Seat 7: Yaaaazz folded before Flop (didn't bet)
Seat 8: SanychStar folded before Flop (didn't bet)
Seat 9: Kukuryzka folded before Flop (didn't bet)





PokerStars Hand #151944125641:  Hold'em No Limit ($1/$2 USD) - 2016/04/15 14:18:30 CET [2016/04/15 8:18:30 ET]
Table 'Marmara II' 9-max Seat #3 is the button
Seat 1: ssljvr ($488.98 in chips) 
Seat 2: Iggso ($200 in chips) 
Seat 3: Glushchenko ($202.44 in chips) 
Seat 4: Fish4trips ($242.96 in chips) 
Seat 5: docmarc777 ($395.40 in chips) 
Seat 6: azzad2007 ($200 in chips) 
Seat 7: matiko09 ($228.77 in chips) 
Seat 8: Dachish ($175.61 in chips) 
Seat 9: erfk1958 ($168.58 in chips) 
Fish4trips: posts small blind $1
docmarc777: posts big blind $2
*** HOLE CARDS ***
Dealt to matiko09 [3s 7c]
azzad2007: folds 
matiko09: folds 
Dachish: folds 
erfk1958: folds 
ssljvr: folds 
Iggso: folds 
Glushchenko: raises $2 to $4
Fish4trips: folds 
docmarc777: raises $9 to $13
Glushchenko: calls $9
*** FLOP *** [Ah Kd Qc]
docmarc777: bets $12
Glushchenko: calls $12
*** TURN *** [Ah Kd Qc] [Qs]
docmarc777: checks 
Glushchenko: checks 
*** RIVER *** [Ah Kd Qc Qs] [3h]
docmarc777: bets $28
Glushchenko: folds 
Uncalled bet ($28) returned to docmarc777
docmarc777 collected $48.45 from pot
*** SUMMARY ***
Total pot $51 | Rake $2.55 
Board [Ah Kd Qc Qs 3h]
Seat 1: ssljvr folded before Flop (didn't bet)
Seat 2: Iggso folded before Flop (didn't bet)
Seat 3: Glushchenko (button) folded on the River
Seat 4: Fish4trips (small blind) folded before Flop
Seat 5: docmarc777 (big blind) collected ($48.45)
Seat 6: azzad2007 folded before Flop (didn't bet)
Seat 7: matiko09 folded before Flop (didn't bet)
Seat 8: Dachish folded before Flop (didn't bet)
Seat 9: erfk1958 folded before Flop (didn't bet)





PokerStars Hand #151944128324:  Hold'em No Limit ($0.50/$1.00 USD) - 2016/04/15 14:18:35 CET [2016/04/15 8:18:35 ET]
Table 'Desagneauxa II' 9-max Seat #4 is the button
Seat 2: Filojoes ($101.50 in chips) 
Seat 3: matiko09 ($100 in chips) 
Seat 4: Prettyspitz ($100 in chips) 
Seat 5: Carlo22222 ($54.22 in chips) 
Seat 6: DIMAN_324 ($106.35 in chips) 
Seat 7: TideHan ($100 in chips) 
Seat 8: di0d80 ($100 in chips) 
Carlo22222: posts small blind $0.50
DIMAN_324: posts big blind $1
ruslik_by: sits out 
Vikulja1993: sits out 
*** HOLE CARDS ***
Dealt to matiko09 [3h 6h]
TideHan: folds 
di0d80: folds 
Filojoes: folds 
matiko09: folds 
Prettyspitz: folds 
Carlo22222: raises $1 to $2
Vikulja1993 leaves the table
DIMAN_324: folds 
Uncalled bet ($1) returned to Carlo22222
Carlo22222 collected $2 from pot
Carlo22222: doesn't show hand 
*** SUMMARY ***
Total pot $2 | Rake $0 
Seat 2: Filojoes folded before Flop (didn't bet)
Seat 3: matiko09 folded before Flop (didn't bet)
Seat 4: Prettyspitz (button) folded before Flop (didn't bet)
Seat 5: Carlo22222 (small blind) collected ($2)
Seat 6: DIMAN_324 (big blind) folded before Flop
Seat 7: TideHan folded before Flop (didn't bet)
Seat 8: di0d80 folded before Flop (didn't bet)





PokerStars Hand #151944128948:  Hold'em No Limit ($1/$2 USD) - 2016/04/15 14:18:36 CET [2016/04/15 8:18:36 ET]
Table 'Oceax' 9-max Seat #7 is the button
Seat 1: matiko09 ($203 in chips) 
Seat 2: Fish4trips ($273.68 in chips) 
Seat 4: butcheN18 ($327.71 in chips) 
Seat 5: derrocco82 ($203.83 in chips) 
Seat 6: Iggso ($272.93 in chips) 
Seat 7: ssljvr ($217.60 in chips) 
Seat 8: Poroxide ($324.97 in chips) 
Poroxide: posts small blind $1
erfk1958: is sitting out 
erfk1958 leaves the table
matiko09: posts big blind $2
Vikulja1993: sits out 
*** HOLE CARDS ***
Dealt to matiko09 [3s 8c]
myatiy 96 joins the table at seat #9 
Fish4trips: folds 
Fish4trips leaves the table
myatiy 96 leaves the table
butcheN18: raises $4 to $6
derrocco82: folds 
Iggso: folds 
tipner joins the table at seat #9 
di0d80 joins the table at seat #2 
ssljvr: folds 
di0d80 leaves the table
Poroxide: folds 
matiko09: folds 
Uncalled bet ($4) returned to butcheN18
butcheN18 collected $5 from pot
butcheN18: doesn't show hand 
*** SUMMARY ***
Total pot $5 | Rake $0 
Seat 1: matiko09 (big blind) folded before Flop
Seat 2: Fish4trips folded before Flop (didn't bet)
Seat 4: butcheN18 collected ($5)
Seat 5: derrocco82 folded before Flop (didn't bet)
Seat 6: Iggso folded before Flop (didn't bet)
Seat 7: ssljvr (button) folded before Flop (didn't bet)
Seat 8: Poroxide (small blind) folded before Flop





PokerStars Hand #151944129321:  Hold'em No Limit ($0.50/$1.00 USD) - 2016/04/15 14:18:37 CET [2016/04/15 8:18:37 ET]
Table 'Chiny II' 9-max Seat #5 is the button
Seat 1: vrnMike ($154.56 in chips) 
Seat 2: Westpants ($155.88 in chips) 
Seat 3: Foton18 ($75.12 in chips) 
Seat 4: matiko09 ($171.44 in chips) 
Seat 5: omorfadramou ($161.50 in chips) 
Seat 6: choupai ($8.03 in chips) 
Seat 7: ruslik_by ($100 in chips) 
Seat 8: Filojoes ($152.26 in chips) 
Seat 9: butcheN18 ($100 in chips) 
choupai: posts small blind $0.50
ruslik_by: posts big blind $1
*** HOLE CARDS ***
Dealt to matiko09 [Kh Qd]
Filojoes: raises $2 to $3
butcheN18: folds 
vrnMike: folds 
Westpants: calls $3
Foton18: folds 
matiko09: folds 
omorfadramou: folds 
choupai: folds 
ruslik_by: folds 
*** FLOP *** [7d 4c 2c]
Filojoes: bets $3.27
Westpants: calls $3.27
*** TURN *** [7d 4c 2c] [2h]
Filojoes: bets $8
Westpants: calls $8
*** RIVER *** [7d 4c 2c 2h] [4h]
Filojoes: bets $17.12
Westpants: calls $17.12
*** SHOW DOWN ***
Filojoes: shows [Js Jc] (two pair, Jacks and Fours)
Westpants: mucks hand 
Filojoes collected $61.78 from pot
*** SUMMARY ***
Total pot $64.28 | Rake $2.50 
Board [7d 4c 2c 2h 4h]
Seat 1: vrnMike folded before Flop (didn't bet)
Seat 2: Westpants mucked [7h 8h]
Seat 3: Foton18 folded before Flop (didn't bet)
Seat 4: matiko09 folded before Flop (didn't bet)
Seat 5: omorfadramou (button) folded before Flop (didn't bet)
Seat 6: choupai (small blind) folded before Flop
Seat 7: ruslik_by (big blind) folded before Flop
Seat 8: Filojoes showed [Js Jc] and won ($61.78) with two pair, Jacks and Fours
Seat 9: butcheN18 folded before Flop (didn't bet)





PokerStars Hand #151944129743:  Hold'em No Limit ($0.50/$1.00 USD) - 2016/04/15 14:18:38 CET [2016/04/15 8:18:38 ET]
Table 'Parvulesco II' 9-max Seat #2 is the button
Seat 1: bilukm ($72.99 in chips) 
Seat 2: Filojoes ($105.54 in chips) 
Seat 3: matiko09 ($124.01 in chips) 
Seat 4: butcheN18 ($100 in chips) 
Seat 5: maxxmeister ($112.58 in chips) 
Seat 6: ruslik_by ($131.55 in chips) 
Seat 7: Kukuryzka ($133.44 in chips) 
Seat 8: Jimy Tiltman ($111.92 in chips) 
Seat 9: hammerwife ($209.03 in chips) 
matiko09: posts small blind $0.50
butcheN18: posts big blind $1
*** HOLE CARDS ***
Dealt to matiko09 [2h 9c]
maxxmeister: folds 
ruslik_by: raises $2 to $3
Kukuryzka: folds 
Jimy Tiltman: folds 
hammerwife: folds 
bilukm: calls $3
Filojoes: calls $3
matiko09: folds 
butcheN18: calls $2
*** FLOP *** [7h 9s Kh]
butcheN18: checks 
ruslik_by: bets $6.50
bilukm: folds 
Filojoes: folds 
butcheN18: folds 
Uncalled bet ($6.50) returned to ruslik_by
ruslik_by collected $11.88 from pot
ruslik_by: doesn't show hand 
*** SUMMARY ***
Total pot $12.50 | Rake $0.62 
Board [7h 9s Kh]
Seat 1: bilukm folded on the Flop
Seat 2: Filojoes (button) folded on the Flop
Seat 3: matiko09 (small blind) folded before Flop
Seat 4: butcheN18 (big blind) folded on the Flop
Seat 5: maxxmeister folded before Flop (didn't bet)
Seat 6: ruslik_by collected ($11.88)
Seat 7: Kukuryzka folded before Flop (didn't bet)
Seat 8: Jimy Tiltman folded before Flop (didn't bet)
Seat 9: hammerwife folded before Flop (didn't bet)





PokerStars Hand #151944138940:  Hold'em No Limit ($0.50/$1.00 USD) - 2016/04/15 14:18:55 CET [2016/04/15 8:18:55 ET]
Table 'Navi' 9-max Seat #6 is the button
Seat 1: tipner ($111.83 in chips) 
Seat 2: myatiy 96 ($100 in chips) 
Seat 3: vrnMike ($138.85 in chips) 
Seat 4: Pvsx. ($100 in chips) 
Seat 5: Prettyspitz ($101.50 in chips) 
Seat 6: Vikulja1993 ($119.40 in chips) 
Seat 8: ruslik_by ($168 in chips) 
Seat 9: matiko09 ($132.25 in chips) 
ruslik_by: posts small blind $0.50
matiko09: posts big blind $1
*** HOLE CARDS ***
Dealt to matiko09 [8c 4d]
tipner: folds 
myatiy 96: folds 
di0d80 joins the table at seat #7 
di0d80 leaves the table
vrnMike: raises $1 to $2
Pvsx.: folds 
Prettyspitz: folds 
Vikulja1993: folds 
ruslik_by: folds 
matiko09: folds 
Uncalled bet ($1) returned to vrnMike
vrnMike collected $2.50 from pot
*** SUMMARY ***
Total pot $2.50 | Rake $0 
Seat 1: tipner folded before Flop (didn't bet)
Seat 2: myatiy 96 folded before Flop (didn't bet)
Seat 3: vrnMike collected ($2.50)
Seat 4: Pvsx. folded before Flop (didn't bet)
Seat 5: Prettyspitz folded before Flop (didn't bet)
Seat 6: Vikulja1993 (button) folded before Flop (didn't bet)
Seat 8: ruslik_by (small blind) folded before Flop
Seat 9: matiko09 (big blind) folded before Flop





PokerStars Hand #151944139468:  Hold'em No Limit ($1/$2 USD) - 2016/04/15 14:18:56 CET [2016/04/15 8:18:56 ET]
Table 'Blaauw' 9-max Seat #7 is the button
Seat 1: myatiy 96 ($225.46 in chips) 
Seat 2: butcheN18 ($241.19 in chips) 
Seat 3: erfk1958 ($124.90 in chips) 
Seat 4: petro0107 ($215.39 in chips) 
Seat 5: tipner ($221.40 in chips) 
Seat 6: matiko09 ($287.90 in chips) 
Seat 7: ssljvr ($410.95 in chips) 
Seat 8: Iggso ($200 in chips) 
Seat 9: coinflip_si ($200 in chips) 
Iggso: posts small blind $1
coinflip_si: posts big blind $2
*** HOLE CARDS ***
Dealt to matiko09 [Qd 8s]
myatiy 96: folds 
butcheN18: folds 
erfk1958: raises $2 to $4
petro0107: folds 
tipner: folds 
matiko09: folds 
ssljvr: folds 
Iggso: folds 
coinflip_si: folds 
Uncalled bet ($2) returned to erfk1958
erfk1958 collected $5 from pot
erfk1958: doesn't show hand 
*** SUMMARY ***
Total pot $5 | Rake $0 
Seat 1: myatiy 96 folded before Flop (didn't bet)
Seat 2: butcheN18 folded before Flop (didn't bet)
Seat 3: erfk1958 collected ($5)
Seat 4: petro0107 folded before Flop (didn't bet)
Seat 5: tipner folded before Flop (didn't bet)
Seat 6: matiko09 folded before Flop (didn't bet)
Seat 7: ssljvr (button) folded before Flop (didn't bet)
Seat 8: Iggso (small blind) folded before Flop
Seat 9: coinflip_si (big blind) folded before Flop





PokerStars Hand #151944140869:  Hold'em No Limit ($1/$2 USD) - 2016/04/15 14:18:58 CET [2016/04/15 8:18:58 ET]
Table 'Adele II' 9-max Seat #3 is the button
Seat 1: RyanHuJun ($310.95 in chips) 
Seat 2: Fish4trips ($320.54 in chips) 
Seat 3: matiko09 ($306.33 in chips) 
Seat 4: Glushchenko ($226.16 in chips) 
Seat 5: TonnaMunz ($200 in chips) 
Seat 6: Kukuryzka ($261.43 in chips) 
Seat 7: Iggso ($200 in chips) 
Seat 8: butcheN18 ($245.67 in chips) 
Seat 9: SanychStar ($276.60 in chips) 
Glushchenko: posts small blind $1
TonnaMunz: posts big blind $2
*** HOLE CARDS ***
Dealt to matiko09 [5h 9h]
Kukuryzka: folds 
Iggso: folds 
butcheN18: folds 
SanychStar: raises $3 to $5
RyanHuJun: calls $5
Fish4trips: calls $5
matiko09: folds 
Glushchenko: folds 
TonnaMunz: folds 
*** FLOP *** [Ts 5d As]
SanychStar: checks 
RyanHuJun: checks 
Fish4trips: bets $10.23
SanychStar: folds 
RyanHuJun: calls $10.23
*** TURN *** [Ts 5d As] [6s]
RyanHuJun: checks 
Fish4trips: bets $24
RyanHuJun: folds 
Uncalled bet ($24) returned to Fish4trips
Fish4trips collected $36.54 from pot
Fish4trips: doesn't show hand 
*** SUMMARY ***
Total pot $38.46 | Rake $1.92 
Board [Ts 5d As 6s]
Seat 1: RyanHuJun folded on the Turn
Seat 2: Fish4trips collected ($36.54)
Seat 3: matiko09 (button) folded before Flop (didn't bet)
Seat 4: Glushchenko (small blind) folded before Flop
Seat 5: TonnaMunz (big blind) folded before Flop
Seat 6: Kukuryzka folded before Flop (didn't bet)
Seat 7: Iggso folded before Flop (didn't bet)
Seat 8: butcheN18 folded before Flop (didn't bet)
Seat 9: SanychStar folded on the Flop





PokerStars Hand #151944141967:  Hold'em No Limit ($0.50/$1.00 USD) - 2016/04/15 14:19:01 CET [2016/04/15 8:19:01 ET]
Table 'Desagneauxa II' 9-max Seat #5 is the button
Seat 2: Filojoes ($101.50 in chips) 
Seat 3: matiko09 ($100 in chips) 
Seat 4: Prettyspitz ($100 in chips) 
Seat 5: Carlo22222 ($55.22 in chips) 
Seat 6: DIMAN_324 ($105.35 in chips) 
Seat 8: di0d80 ($100 in chips) 
DIMAN_324: posts small blind $0.50
TideHan: is sitting out 
di0d80: posts big blind $1
TideHan leaves the table
ruslik_by: sits out 
*** HOLE CARDS ***
Dealt to matiko09 [2h 3h]
Filojoes: folds 
matiko09: folds 
Prettyspitz: folds 
Carlo22222: folds 
DIMAN_324: raises $1.40 to $2.40
magzi777 joins the table at seat #1 
di0d80: calls $1.40
*** FLOP *** [3d 8h 7h]
DIMAN_324: bets $3.42
di0d80: folds 
Uncalled bet ($3.42) returned to DIMAN_324
DIMAN_324 collected $4.56 from pot
DIMAN_324: doesn't show hand 
*** SUMMARY ***
Total pot $4.80 | Rake $0.24 
Board [3d 8h 7h]
Seat 2: Filojoes folded before Flop (didn't bet)
Seat 3: matiko09 folded before Flop (didn't bet)
Seat 4: Prettyspitz folded before Flop (didn't bet)
Seat 5: Carlo22222 (button) folded before Flop (didn't bet)
Seat 6: DIMAN_324 (small blind) collected ($4.56)
Seat 8: di0d80 (big blind) folded on the Flop





PokerStars Hand #151944145619:  Hold'em No Limit ($1/$2 USD) - 2016/04/15 14:19:08 CET [2016/04/15 8:19:08 ET]
Table 'Oceax' 9-max Seat #8 is the button
Seat 1: matiko09 ($201 in chips) 
Seat 3: Vikulja1993 ($200 in chips) 
Seat 4: butcheN18 ($330.71 in chips) 
Seat 5: derrocco82 ($203.83 in chips) 
Seat 6: Iggso ($272.93 in chips) 
Seat 7: ssljvr ($217.60 in chips) 
Seat 8: Poroxide ($323.97 in chips) 
tipner will be allowed to play after the button
TonnaMunz joins the table at seat #2 
matiko09: posts small blind $1
Vikulja1993: posts big blind $2
*** HOLE CARDS ***
Dealt to matiko09 [5h 9d]
butcheN18: folds 
derrocco82: folds 
Iggso: raises $4 to $6
ssljvr: folds 
Poroxide: folds 
matiko09: folds 
Vikulja1993: folds 
Uncalled bet ($4) returned to Iggso
Iggso collected $5 from pot
Iggso: doesn't show hand 
*** SUMMARY ***
Total pot $5 | Rake $0 
Seat 1: matiko09 (small blind) folded before Flop
Seat 3: Vikulja1993 (big blind) folded before Flop
Seat 4: butcheN18 folded before Flop (didn't bet)
Seat 5: derrocco82 folded before Flop (didn't bet)
Seat 6: Iggso collected ($5)
Seat 7: ssljvr folded before Flop (didn't bet)
Seat 8: Poroxide (button) folded before Flop (didn't bet)





PokerStars Hand #151944148533:  Hold'em No Limit ($0.50/$1.00 USD) - 2016/04/15 14:19:13 CET [2016/04/15 8:19:13 ET]
Table 'Adelgunde III' 9-max Seat #3 is the button
Seat 1: valimiu ($125.80 in chips) 
Seat 2: Vikulja1993 ($100 in chips) 
Seat 3: tipner ($125.58 in chips) 
Seat 4: hammerwife ($124.63 in chips) 
Seat 5: matiko09 ($120.91 in chips) 
Seat 6: Pominator92 ($121.34 in chips) 
Seat 7: Yaaaazz ($100 in chips) 
Seat 8: SanychStar ($128.06 in chips) 
Seat 9: Kukuryzka ($123.01 in chips) 
hammerwife: posts small blind $0.50
matiko09: posts big blind $1
*** HOLE CARDS ***
Dealt to matiko09 [5c 2d]
Pominator92: folds 
Yaaaazz: raises $2 to $3
SanychStar: folds 
Kukuryzka: folds 
valimiu: folds 
Vikulja1993: raises $6 to $9
tipner: calls $9
hammerwife: raises $15 to $24
matiko09: folds 
Yaaaazz: raises $76 to $100 and is all-in
Vikulja1993: folds 
tipner: folds 
hammerwife: folds 
Uncalled bet ($76) returned to Yaaaazz
Yaaaazz collected $67 from pot
*** SUMMARY ***
Total pot $67 | Rake $0 
Seat 1: valimiu folded before Flop (didn't bet)
Seat 2: Vikulja1993 folded before Flop
Seat 3: tipner (button) folded before Flop
Seat 4: hammerwife (small blind) folded before Flop
Seat 5: matiko09 (big blind) folded before Flop
Seat 6: Pominator92 folded before Flop (didn't bet)
Seat 7: Yaaaazz collected ($67)
Seat 8: SanychStar folded before Flop (didn't bet)
Seat 9: Kukuryzka folded before Flop (didn't bet)





PokerStars Hand #151944152854:  Hold'em No Limit ($1/$2 USD) - 2016/04/15 14:19:22 CET [2016/04/15 8:19:22 ET]
Table 'Blaauw' 9-max Seat #8 is the button
Seat 1: myatiy 96 ($225.46 in chips) 
Seat 2: butcheN18 ($241.19 in chips) 
Seat 3: erfk1958 ($127.90 in chips) 
Seat 4: petro0107 ($215.39 in chips) 
Seat 5: tipner ($221.40 in chips) 
Seat 6: matiko09 ($287.90 in chips) 
Seat 7: ssljvr ($410.95 in chips) 
Seat 8: Iggso ($200 in chips) 
Seat 9: coinflip_si ($200 in chips) 
coinflip_si: posts small blind $1
myatiy 96: posts big blind $2
*** HOLE CARDS ***
Dealt to matiko09 [7c 5s]
butcheN18: folds 
erfk1958: folds 
petro0107: calls $2
tipner: raises $6 to $8
matiko09: folds 
ssljvr: folds 
Iggso: raises $12 to $20
coinflip_si: folds 
myatiy 96: folds 
petro0107: folds 
tipner: raises $26 to $46
Iggso: folds 
Uncalled bet ($26) returned to tipner
tipner collected $45 from pot
*** SUMMARY ***
Total pot $45 | Rake $0 
Seat 1: myatiy 96 (big blind) folded before Flop
Seat 2: butcheN18 folded before Flop (didn't bet)
Seat 3: erfk1958 folded before Flop (didn't bet)
Seat 4: petro0107 folded before Flop
Seat 5: tipner collected ($45)
Seat 6: matiko09 folded before Flop (didn't bet)
Seat 7: ssljvr folded before Flop (didn't bet)
Seat 8: Iggso (button) folded before Flop
Seat 9: coinflip_si (small blind) folded before Flop





PokerStars Hand #151944155535:  Hold'em No Limit ($1/$2 USD) - 2016/04/15 14:19:27 CET [2016/04/15 8:19:27 ET]
Table 'Oceax' 9-max Seat #1 is the button
Seat 1: matiko09 ($200 in chips) 
Seat 3: Vikulja1993 ($200 in chips) 
Seat 4: butcheN18 ($330.71 in chips) 
Seat 5: derrocco82 ($203.83 in chips) 
Seat 6: Iggso ($275.93 in chips) 
Seat 7: ssljvr ($217.60 in chips) 
Seat 8: Poroxide ($323.97 in chips) 
TonnaMunz will be allowed to play after the button
Vikulja1993: posts small blind $1
butcheN18: posts big blind $2
tipner: sits out 
*** HOLE CARDS ***
Dealt to matiko09 [7h Ts]
derrocco82: folds 
Iggso: raises $4 to $6
ssljvr: folds 
Poroxide: folds 
matiko09: folds 
Vikulja1993: folds 
butcheN18: folds 
Uncalled bet ($4) returned to Iggso
Iggso collected $5 from pot
Iggso: doesn't show hand 
*** SUMMARY ***
Total pot $5 | Rake $0 
Seat 1: matiko09 (button) folded before Flop (didn't bet)
Seat 3: Vikulja1993 (small blind) folded before Flop
Seat 4: butcheN18 (big blind) folded before Flop
Seat 5: derrocco82 folded before Flop (didn't bet)
Seat 6: Iggso collected ($5)
Seat 7: ssljvr folded before Flop (didn't bet)
Seat 8: Poroxide folded before Flop (didn't bet)





PokerStars Hand #151944157953:  Hold'em No Limit ($0.50/$1.00 USD) - 2016/04/15 14:19:32 CET [2016/04/15 8:19:32 ET]
Table 'Chiny II' 9-max Seat #6 is the button
Seat 1: vrnMike ($154.56 in chips) 
Seat 2: Westpants ($124.49 in chips) 
Seat 3: Foton18 ($75.12 in chips) 
Seat 4: matiko09 ($171.44 in chips) 
Seat 5: omorfadramou ($161.50 in chips) 
Seat 6: choupai ($7.53 in chips) 
Seat 7: ruslik_by ($100 in chips) 
Seat 8: Filojoes ($182.65 in chips) 
Seat 9: butcheN18 ($100 in chips) 
ruslik_by: posts small blind $0.50
Filojoes: posts big blind $1
*** HOLE CARDS ***
Dealt to matiko09 [Jd 9d]
butcheN18: folds 
vrnMike: raises $1 to $2
Westpants: folds 
Foton18: folds 
matiko09: folds 
omorfadramou: raises $6 to $8
choupai: folds 
ruslik_by: folds 
Filojoes: folds 
vrnMike: calls $6
*** FLOP *** [Jc 4h 8h]
vrnMike: checks 
omorfadramou: bets $8.80
vrnMike: folds 
Uncalled bet ($8.80) returned to omorfadramou
omorfadramou collected $16.62 from pot
omorfadramou: doesn't show hand 
*** SUMMARY ***
Total pot $17.50 | Rake $0.88 
Board [Jc 4h 8h]
Seat 1: vrnMike folded on the Flop
Seat 2: Westpants folded before Flop (didn't bet)
Seat 3: Foton18 folded before Flop (didn't bet)
Seat 4: matiko09 folded before Flop (didn't bet)
Seat 5: omorfadramou collected ($16.62)
Seat 6: choupai (button) folded before Flop (didn't bet)
Seat 7: ruslik_by (small blind) folded before Flop
Seat 8: Filojoes (big blind) folded before Flop
Seat 9: butcheN18 folded before Flop (didn't bet)





PokerStars Hand #151944159713:  Hold'em No Limit ($0.50/$1.00 USD) - 2016/04/15 14:19:35 CET [2016/04/15 8:19:35 ET]
Table 'Navi' 9-max Seat #8 is the button
Seat 3: vrnMike ($140.35 in chips) 
Seat 4: Pvsx. ($100 in chips) 
Seat 5: Prettyspitz ($101.50 in chips) 
Seat 6: Vikulja1993 ($119.40 in chips) 
Seat 8: ruslik_by ($167.50 in chips) 
Seat 9: matiko09 ($131.25 in chips) 
matiko09: posts small blind $0.50
tipner: is sitting out 
myatiy 96: is sitting out 
vrnMike: posts big blind $1
*** HOLE CARDS ***
Dealt to matiko09 [5h Tc]
tipner leaves the table
Pvsx.: folds 
IdiotFromNE joins the table at seat #7 
myatiy 96 leaves the table
Prettyspitz: folds 
Vikulja1993: folds 
ruslik_by: raises $1.50 to $2.50
masaytoo joins the table at seat #1 
matiko09: folds 
vrnMike: calls $1.50
*** FLOP *** [Ks Th 6d]
vrnMike: checks 
Xx7-Zeus-7xX joins the table at seat #2 
ruslik_by: bets $3
vrnMike: calls $3
*** TURN *** [Ks Th 6d] [2d]
vrnMike: checks 
ruslik_by: checks 
*** RIVER *** [Ks Th 6d 2d] [Kd]
vrnMike: bets $6
ruslik_by: folds 
Uncalled bet ($6) returned to vrnMike
vrnMike collected $10.92 from pot
*** SUMMARY ***
Total pot $11.50 | Rake $0.58 
Board [Ks Th 6d 2d Kd]
Seat 3: vrnMike (big blind) collected ($10.92)
Seat 4: Pvsx. folded before Flop (didn't bet)
Seat 5: Prettyspitz folded before Flop (didn't bet)
Seat 6: Vikulja1993 folded before Flop (didn't bet)
Seat 8: ruslik_by (button) folded on the River
Seat 9: matiko09 (small blind) folded before Flop





PokerStars Hand #151944164567:  Hold'em No Limit ($1/$2 USD) - 2016/04/15 14:19:45 CET [2016/04/15 8:19:45 ET]
Table 'Marmara II' 9-max Seat #4 is the button
Seat 1: ssljvr ($488.98 in chips) 
Seat 2: Iggso ($200 in chips) 
Seat 3: Glushchenko ($200 in chips) 
Seat 4: Fish4trips ($241.96 in chips) 
Seat 5: docmarc777 ($418.85 in chips) 
Seat 6: azzad2007 ($200 in chips) 
Seat 7: matiko09 ($228.77 in chips) 
Seat 8: Dachish ($175.61 in chips) 
Seat 9: erfk1958 ($168.58 in chips) 
docmarc777: posts small blind $1
azzad2007: posts big blind $2
*** HOLE CARDS ***
Dealt to matiko09 [7c 7d]
matiko09: raises $3 to $5
Dachish: folds 
erfk1958: folds 
ssljvr: folds 
Iggso: folds 
Glushchenko: folds 
Fish4trips: folds 
docmarc777: folds 
azzad2007: folds 
Uncalled bet ($3) returned to matiko09
matiko09 collected $5 from pot
matiko09: doesn't show hand 
*** SUMMARY ***
Total pot $5 | Rake $0 
Seat 1: ssljvr folded before Flop (didn't bet)
Seat 2: Iggso folded before Flop (didn't bet)
Seat 3: Glushchenko folded before Flop (didn't bet)
Seat 4: Fish4trips (button) folded before Flop (didn't bet)
Seat 5: docmarc777 (small blind) folded before Flop
Seat 6: azzad2007 (big blind) folded before Flop
Seat 7: matiko09 collected ($5)
Seat 8: Dachish folded before Flop (didn't bet)
Seat 9: erfk1958 folded before Flop (didn't bet)





PokerStars Hand #151944164550:  Hold'em No Limit ($0.50/$1.00 USD) - 2016/04/15 14:19:45 CET [2016/04/15 8:19:45 ET]
Table 'Desagneauxa II' 9-max Seat #6 is the button
Seat 2: Filojoes ($101.50 in chips) 
Seat 3: matiko09 ($100 in chips) 
Seat 4: Prettyspitz ($100 in chips) 
Seat 5: Carlo22222 ($55.22 in chips) 
Seat 6: DIMAN_324 ($107.51 in chips) 
Seat 8: di0d80 ($100 in chips) 
Seat 9: ruslik_by ($100 in chips) 
di0d80: posts small blind $0.50
ruslik_by: posts big blind $1
magzi777: sits out 
*** HOLE CARDS ***
Dealt to matiko09 [9s Ad]
Filojoes: folds 
matiko09: folds 
Prettyspitz: folds 
Carlo22222: raises $1 to $2
IdiotFromNE joins the table at seat #7 
DIMAN_324: folds 
di0d80: folds 
ruslik_by: folds 
Uncalled bet ($1) returned to Carlo22222
Carlo22222 collected $2.50 from pot
Carlo22222: doesn't show hand 
*** SUMMARY ***
Total pot $2.50 | Rake $0 
Seat 2: Filojoes folded before Flop (didn't bet)
Seat 3: matiko09 folded before Flop (didn't bet)
Seat 4: Prettyspitz folded before Flop (didn't bet)
Seat 5: Carlo22222 collected ($2.50)
Seat 6: DIMAN_324 (button) folded before Flop (didn't bet)
Seat 8: di0d80 (small blind) folded before Flop
Seat 9: ruslik_by (big blind) folded before Flop





PokerStars Hand #151944173007:  Hold'em No Limit ($1/$2 USD) - 2016/04/15 14:20:01 CET [2016/04/15 8:20:01 ET]
Table 'Oceax' 9-max Seat #3 is the button
Seat 1: matiko09 ($200 in chips) 
Seat 3: Vikulja1993 ($200 in chips) 
Seat 4: butcheN18 ($328.71 in chips) 
Seat 5: derrocco82 ($203.83 in chips) 
Seat 6: Iggso ($278.93 in chips) 
Seat 7: ssljvr ($217.60 in chips) 
Seat 8: Poroxide ($323.97 in chips) 
butcheN18: posts small blind $1
derrocco82: posts big blind $2
tipner: sits out 
TonnaMunz: sits out 
*** HOLE CARDS ***
Dealt to matiko09 [Qd 9h]
Iggso: raises $4 to $6
ssljvr: folds 
Poroxide: folds 
matiko09: folds 
Vikulja1993: folds 
butcheN18: folds 
derrocco82: folds 
Uncalled bet ($4) returned to Iggso
Iggso collected $5 from pot
Iggso: doesn't show hand 
*** SUMMARY ***
Total pot $5 | Rake $0 
Seat 1: matiko09 folded before Flop (didn't bet)
Seat 3: Vikulja1993 (button) folded before Flop (didn't bet)
Seat 4: butcheN18 (small blind) folded before Flop
Seat 5: derrocco82 (big blind) folded before Flop
Seat 6: Iggso collected ($5)
Seat 7: ssljvr folded before Flop (didn't bet)
Seat 8: Poroxide folded before Flop (didn't bet)





PokerStars Hand #151944173882:  Hold'em No Limit ($1/$2 USD) - 2016/04/15 14:20:03 CET [2016/04/15 8:20:03 ET]
Table 'Blaauw' 9-max Seat #9 is the button
Seat 1: myatiy 96 ($223.46 in chips) 
Seat 2: butcheN18 ($241.19 in chips) 
Seat 3: erfk1958 ($127.90 in chips) 
Seat 4: petro0107 ($213.39 in chips) 
Seat 5: tipner ($246.40 in chips) 
Seat 6: matiko09 ($287.90 in chips) 
Seat 7: ssljvr ($410.95 in chips) 
Seat 8: Iggso ($200 in chips) 
Seat 9: coinflip_si ($200 in chips) 
myatiy 96: posts small blind $1
butcheN18: posts big blind $2
*** HOLE CARDS ***
Dealt to matiko09 [3c 3h]
erfk1958: folds 
petro0107: folds 
tipner: folds 
matiko09: raises $3 to $5
ssljvr: folds 
Iggso: folds 
coinflip_si: folds 
myatiy 96: folds 
butcheN18: folds 
Uncalled bet ($3) returned to matiko09
matiko09 collected $5 from pot
matiko09: doesn't show hand 
*** SUMMARY ***
Total pot $5 | Rake $0 
Seat 1: myatiy 96 (small blind) folded before Flop
Seat 2: butcheN18 (big blind) folded before Flop
Seat 3: erfk1958 folded before Flop (didn't bet)
Seat 4: petro0107 folded before Flop (didn't bet)
Seat 5: tipner folded before Flop (didn't bet)
Seat 6: matiko09 collected ($5)
Seat 7: ssljvr folded before Flop (didn't bet)
Seat 8: Iggso folded before Flop (didn't bet)
Seat 9: coinflip_si (button) folded before Flop (didn't bet)





PokerStars Hand #151944174694:  Hold'em No Limit ($0.50/$1.00 USD) - 2016/04/15 14:20:04 CET [2016/04/15 8:20:04 ET]
Table 'Parvulesco II' 9-max Seat #3 is the button
Seat 1: bilukm ($69.99 in chips) 
Seat 2: Filojoes ($102.54 in chips) 
Seat 3: matiko09 ($123.51 in chips) 
Seat 4: butcheN18 ($100 in chips) 
Seat 5: maxxmeister ($112.58 in chips) 
Seat 6: ruslik_by ($140.43 in chips) 
Seat 7: Kukuryzka ($133.44 in chips) 
Seat 8: Jimy Tiltman ($111.92 in chips) 
Seat 9: hammerwife ($209.03 in chips) 
butcheN18: posts small blind $0.50
maxxmeister: posts big blind $1
*** HOLE CARDS ***
Dealt to matiko09 [4c 6s]
ruslik_by: folds 
Kukuryzka: folds 
Jimy Tiltman: folds 
hammerwife: folds 
bilukm: folds 
Filojoes: raises $1.50 to $2.50
matiko09: folds 
butcheN18: folds 
maxxmeister: folds 
Uncalled bet ($1.50) returned to Filojoes
Filojoes collected $2.50 from pot
Filojoes: doesn't show hand 
*** SUMMARY ***
Total pot $2.50 | Rake $0 
Seat 1: bilukm folded before Flop (didn't bet)
Seat 2: Filojoes collected ($2.50)
Seat 3: matiko09 (button) folded before Flop (didn't bet)
Seat 4: butcheN18 (small blind) folded before Flop
Seat 5: maxxmeister (big blind) folded before Flop
Seat 6: ruslik_by folded before Flop (didn't bet)
Seat 7: Kukuryzka folded before Flop (didn't bet)
Seat 8: Jimy Tiltman folded before Flop (didn't bet)
Seat 9: hammerwife folded before Flop (didn't bet)





PokerStars Hand #151944174813:  Hold'em No Limit ($1/$2 USD) - 2016/04/15 14:20:04 CET [2016/04/15 8:20:04 ET]
Table 'Marmara II' 9-max Seat #5 is the button
Seat 1: ssljvr ($488.98 in chips) 
Seat 2: Iggso ($200 in chips) 
Seat 3: Glushchenko ($200 in chips) 
Seat 4: Fish4trips ($241.96 in chips) 
Seat 5: docmarc777 ($417.85 in chips) 
Seat 6: azzad2007 ($200 in chips) 
Seat 7: matiko09 ($231.77 in chips) 
Seat 8: Dachish ($175.61 in chips) 
Seat 9: erfk1958 ($168.58 in chips) 
azzad2007: posts small blind $1
matiko09: posts big blind $2
*** HOLE CARDS ***
Dealt to matiko09 [7c 5c]
Dachish: folds 
erfk1958: folds 
ssljvr: folds 
Iggso: folds 
Glushchenko: folds 
Fish4trips: folds 
docmarc777 has timed out
docmarc777: folds 
azzad2007: folds 
Uncalled bet ($1) returned to matiko09
matiko09 collected $2 from pot
matiko09: doesn't show hand 
*** SUMMARY ***
Total pot $2 | Rake $0 
Seat 1: ssljvr folded before Flop (didn't bet)
Seat 2: Iggso folded before Flop (didn't bet)
Seat 3: Glushchenko folded before Flop (didn't bet)
Seat 4: Fish4trips folded before Flop (didn't bet)
Seat 5: docmarc777 (button) folded before Flop (didn't bet)
Seat 6: azzad2007 (small blind) folded before Flop
Seat 7: matiko09 (big blind) collected ($2)
Seat 8: Dachish folded before Flop (didn't bet)
Seat 9: erfk1958 folded before Flop (didn't bet)





PokerStars Hand #151944177028:  Hold'em No Limit ($0.50/$1.00 USD) - 2016/04/15 14:20:08 CET [2016/04/15 8:20:08 ET]
Table 'Adelgunde III' 9-max Seat #4 is the button
Seat 1: valimiu ($125.80 in chips) 
Seat 2: Vikulja1993 ($100 in chips) 
Seat 3: tipner ($116.58 in chips) 
Seat 4: hammerwife ($100.63 in chips) 
Seat 5: matiko09 ($119.91 in chips) 
Seat 6: Pominator92 ($121.34 in chips) 
Seat 7: Yaaaazz ($143 in chips) 
Seat 8: SanychStar ($128.06 in chips) 
Seat 9: Kukuryzka ($123.01 in chips) 
matiko09: posts small blind $0.50
Pominator92: posts big blind $1
*** HOLE CARDS ***
Dealt to matiko09 [Ah 5s]
Yaaaazz: folds 
SanychStar: folds 
Kukuryzka: folds 
valimiu: calls $1
Vikulja1993: folds 
tipner: folds 
hammerwife: raises $4 to $5
matiko09: folds 
Pominator92: folds 
valimiu: calls $4
*** FLOP *** [6h Jd 8h]
valimiu: bets $5
hammerwife: raises $10 to $15
valimiu: calls $10
*** TURN *** [6h Jd 8h] [4d]
valimiu: checks 
hammerwife: bets $27.50
valimiu: calls $27.50
*** RIVER *** [6h Jd 8h 4d] [2h]
valimiu: checks 
hammerwife: checks 
*** SHOW DOWN ***
valimiu: shows [3h 9h] (a flush, Nine high)
hammerwife: mucks hand 
valimiu collected $94 from pot
*** SUMMARY ***
Total pot $96.50 | Rake $2.50 
Board [6h Jd 8h 4d 2h]
Seat 1: valimiu showed [3h 9h] and won ($94) with a flush, Nine high
Seat 2: Vikulja1993 folded before Flop (didn't bet)
Seat 3: tipner folded before Flop (didn't bet)
Seat 4: hammerwife (button) mucked [Jh As]
Seat 5: matiko09 (small blind) folded before Flop
Seat 6: Pominator92 (big blind) folded before Flop
Seat 7: Yaaaazz folded before Flop (didn't bet)
Seat 8: SanychStar folded before Flop (didn't bet)
Seat 9: Kukuryzka folded before Flop (didn't bet)





PokerStars Hand #151944181955:  Hold'em No Limit ($1/$2 USD) - 2016/04/15 14:20:18 CET [2016/04/15 8:20:18 ET]
Table 'Oceax' 9-max Seat #4 is the button
Seat 1: matiko09 ($200 in chips) 
Seat 3: Vikulja1993 ($200 in chips) 
Seat 4: butcheN18 ($327.71 in chips) 
Seat 5: derrocco82 ($201.83 in chips) 
Seat 6: Iggso ($281.93 in chips) 
Seat 7: ssljvr ($217.60 in chips) 
Seat 8: Poroxide ($323.97 in chips) 
derrocco82: posts small blind $1
Iggso: posts big blind $2
tipner: sits out 
TonnaMunz: sits out 
*** HOLE CARDS ***
Dealt to matiko09 [Qc 9d]
ssljvr: raises $4 to $6
Poroxide: folds 
matiko09: folds 
Vikulja1993: folds 
butcheN18: folds 
derrocco82: folds 
Iggso: calls $4
*** FLOP *** [2c Ah 4d]
Iggso: checks 
ssljvr: checks 
*** TURN *** [2c Ah 4d] [8s]
Iggso: checks 
ssljvr: bets $6.54
Iggso: raises $18.46 to $25
ssljvr: folds 
Uncalled bet ($18.46) returned to Iggso
Iggso collected $24.78 from pot
Iggso: doesn't show hand 
*** SUMMARY ***
Total pot $26.08 | Rake $1.30 
Board [2c Ah 4d 8s]
Seat 1: matiko09 folded before Flop (didn't bet)
Seat 3: Vikulja1993 folded before Flop (didn't bet)
Seat 4: butcheN18 (button) folded before Flop (didn't bet)
Seat 5: derrocco82 (small blind) folded before Flop
Seat 6: Iggso (big blind) collected ($24.78)
Seat 7: ssljvr folded on the Turn
Seat 8: Poroxide folded before Flop (didn't bet)





PokerStars Hand #151944185513:  Hold'em No Limit ($0.50/$1.00 USD) - 2016/04/15 14:20:25 CET [2016/04/15 8:20:25 ET]
Table 'Parvulesco II' 9-max Seat #4 is the button
Seat 1: bilukm ($69.99 in chips) 
Seat 2: Filojoes ($104.04 in chips) 
Seat 3: matiko09 ($123.51 in chips) 
Seat 4: butcheN18 ($100 in chips) 
Seat 5: maxxmeister ($111.58 in chips) 
Seat 6: ruslik_by ($140.43 in chips) 
Seat 7: Kukuryzka ($133.44 in chips) 
Seat 8: Jimy Tiltman ($111.92 in chips) 
Seat 9: hammerwife ($209.03 in chips) 
maxxmeister: posts small blind $0.50
ruslik_by: posts big blind $1
*** HOLE CARDS ***
Dealt to matiko09 [Kc 7h]
Kukuryzka: raises $2 to $3
Jimy Tiltman: folds 
hammerwife: folds 
bilukm: raises $2 to $5
Filojoes: folds 
matiko09: folds 
butcheN18: folds 
maxxmeister: folds 
ruslik_by: folds 
Kukuryzka: calls $2
*** FLOP *** [Jc 2s 6c]
Kukuryzka: checks 
bilukm: bets $5.46
Kukuryzka: calls $5.46
*** TURN *** [Jc 2s 6c] [3c]
Kukuryzka: checks 
bilukm: checks 
*** RIVER *** [Jc 2s 6c 3c] [3d]
Kukuryzka: checks 
bilukm: checks 
*** SHOW DOWN ***
Kukuryzka: shows [Qs Js] (two pair, Jacks and Threes)
bilukm: mucks hand 
Kukuryzka collected $21.30 from pot
*** SUMMARY ***
Total pot $22.42 | Rake $1.12 
Board [Jc 2s 6c 3c 3d]
Seat 1: bilukm mucked [9c 9h]
Seat 2: Filojoes folded before Flop (didn't bet)
Seat 3: matiko09 folded before Flop (didn't bet)
Seat 4: butcheN18 (button) folded before Flop (didn't bet)
Seat 5: maxxmeister (small blind) folded before Flop
Seat 6: ruslik_by (big blind) folded before Flop
Seat 7: Kukuryzka showed [Qs Js] and won ($21.30) with two pair, Jacks and Threes
Seat 8: Jimy Tiltman folded before Flop (didn't bet)
Seat 9: hammerwife folded before Flop (didn't bet)





PokerStars Hand #151944186454:  Hold'em No Limit ($1/$2 USD) - 2016/04/15 14:20:27 CET [2016/04/15 8:20:27 ET]
Table 'Adele II' 9-max Seat #4 is the button
Seat 1: RyanHuJun ($295.72 in chips) 
Seat 2: Fish4trips ($341.85 in chips) 
Seat 3: matiko09 ($306.33 in chips) 
Seat 4: Glushchenko ($225.16 in chips) 
Seat 5: TonnaMunz ($200 in chips) 
Seat 6: Kukuryzka ($261.43 in chips) 
Seat 7: Iggso ($200 in chips) 
Seat 8: butcheN18 ($245.67 in chips) 
Seat 9: SanychStar ($271.60 in chips) 
TonnaMunz: posts small blind $1
Kukuryzka: posts big blind $2
*** HOLE CARDS ***
Dealt to matiko09 [Ac 4h]
Iggso: folds 
butcheN18: folds 
SanychStar: folds 
RyanHuJun: raises $4 to $6
Fish4trips: folds 
matiko09: folds 
Glushchenko: calls $6
TonnaMunz: folds 
Kukuryzka: folds 
*** FLOP *** [5d Td 8d]
RyanHuJun: bets $6
Glushchenko: folds 
Uncalled bet ($6) returned to RyanHuJun
RyanHuJun collected $14.25 from pot
RyanHuJun: doesn't show hand 
*** SUMMARY ***
Total pot $15 | Rake $0.75 
Board [5d Td 8d]
Seat 1: RyanHuJun collected ($14.25)
Seat 2: Fish4trips folded before Flop (didn't bet)
Seat 3: matiko09 folded before Flop (didn't bet)
Seat 4: Glushchenko (button) folded on the Flop
Seat 5: TonnaMunz (small blind) folded before Flop
Seat 6: Kukuryzka (big blind) folded before Flop
Seat 7: Iggso folded before Flop (didn't bet)
Seat 8: butcheN18 folded before Flop (didn't bet)
Seat 9: SanychStar folded before Flop (didn't bet)





PokerStars Hand #151944186520:  Hold'em No Limit ($0.50/$1.00 USD) - 2016/04/15 14:20:27 CET [2016/04/15 8:20:27 ET]
Table 'Desagneauxa II' 9-max Seat #8 is the button
Seat 1: magzi777 ($100 in chips) 
Seat 2: Filojoes ($101.50 in chips) 
Seat 3: matiko09 ($100 in chips) 
Seat 4: Prettyspitz ($100 in chips) 
Seat 5: Carlo22222 ($56.72 in chips) 
Seat 6: DIMAN_324 ($107.51 in chips) 
Seat 8: di0d80 ($100 in chips) 
Seat 9: ruslik_by ($100 in chips) 
ruslik_by: posts small blind $0.50
magzi777: posts big blind $1
IdiotFromNE: sits out 
*** HOLE CARDS ***
Dealt to matiko09 [Qs 2d]
Filojoes: folds 
Filojoes leaves the table
matiko09: folds 
myatiy 96 joins the table at seat #2 
myatiy 96 leaves the table
Prettyspitz: folds 
Carlo22222: raises $1 to $2
DIMAN_324: folds 
di0d80: folds 
ruslik_by: folds 
magzi777: folds 
Uncalled bet ($1) returned to Carlo22222
Carlo22222 collected $2.50 from pot
Carlo22222: doesn't show hand 
*** SUMMARY ***
Total pot $2.50 | Rake $0 
Seat 1: magzi777 (big blind) folded before Flop
Seat 2: Filojoes folded before Flop (didn't bet)
Seat 3: matiko09 folded before Flop (didn't bet)
Seat 4: Prettyspitz folded before Flop (didn't bet)
Seat 5: Carlo22222 collected ($2.50)
Seat 6: DIMAN_324 folded before Flop (didn't bet)
Seat 8: di0d80 (button) folded before Flop (didn't bet)
Seat 9: ruslik_by (small blind) folded before Flop





PokerStars Hand #151944187215:  Hold'em No Limit ($1/$2 USD) - 2016/04/15 14:20:28 CET [2016/04/15 8:20:28 ET]
Table 'Blaauw' 9-max Seat #1 is the button
Seat 1: myatiy 96 ($222.46 in chips) 
Seat 2: butcheN18 ($239.19 in chips) 
Seat 4: petro0107 ($213.39 in chips) 
Seat 5: tipner ($246.40 in chips) 
Seat 6: matiko09 ($290.90 in chips) 
Seat 7: ssljvr ($410.95 in chips) 
Seat 8: Iggso ($200 in chips) 
Seat 9: coinflip_si ($200 in chips) 
butcheN18: posts small blind $1
erfk1958: is sitting out 
erfk1958 leaves the table
petro0107: posts big blind $2
*** HOLE CARDS ***
Dealt to matiko09 [Jh 5d]
Vikulja1993 joins the table at seat #3 
tipner: folds 
matiko09: folds 
ssljvr: folds 
Iggso: folds 
coinflip_si: folds 
myatiy 96: raises $2.50 to $4.50
butcheN18: folds 
petro0107: raises $2.50 to $7
myatiy 96: calls $2.50
*** FLOP *** [Qh Tc 6h]
petro0107: bets $8
myatiy 96: calls $8
*** TURN *** [Qh Tc 6h] [2s]
petro0107: checks 
myatiy 96: checks 
*** RIVER *** [Qh Tc 6h 2s] [6d]
petro0107: bets $16
myatiy 96: folds 
Uncalled bet ($16) returned to petro0107
petro0107 collected $29.45 from pot
petro0107: doesn't show hand 
*** SUMMARY ***
Total pot $31 | Rake $1.55 
Board [Qh Tc 6h 2s 6d]
Seat 1: myatiy 96 (button) folded on the River
Seat 2: butcheN18 (small blind) folded before Flop
Seat 4: petro0107 (big blind) collected ($29.45)
Seat 5: tipner folded before Flop (didn't bet)
Seat 6: matiko09 folded before Flop (didn't bet)
Seat 7: ssljvr folded before Flop (didn't bet)
Seat 8: Iggso folded before Flop (didn't bet)
Seat 9: coinflip_si folded before Flop (didn't bet)





PokerStars Hand #151944192305:  Hold'em No Limit ($1/$2 USD) - 2016/04/15 14:20:38 CET [2016/04/15 8:20:38 ET]
Table 'Marmara II' 9-max Seat #6 is the button
Seat 1: ssljvr ($488.98 in chips) 
Seat 2: Iggso ($200 in chips) 
Seat 3: Glushchenko ($200 in chips) 
Seat 4: Fish4trips ($241.96 in chips) 
Seat 5: docmarc777 ($417.85 in chips) 
Seat 6: azzad2007 ($200 in chips) 
Seat 7: matiko09 ($232.77 in chips) 
Seat 8: Dachish ($175.61 in chips) 
Seat 9: erfk1958 ($168.58 in chips) 
matiko09: posts small blind $1
Dachish: posts big blind $2
*** HOLE CARDS ***
Dealt to matiko09 [Jh As]
erfk1958: folds 
ssljvr: folds 
Iggso: folds 
Glushchenko: folds 
Fish4trips: folds 
erfk1958 leaves the table
di0d80 joins the table at seat #9 
docmarc777 has timed out
docmarc777: folds 
azzad2007: raises $2.80 to $4.80
matiko09: raises $13.20 to $18
Dachish: folds 
azzad2007: calls $13.20
*** FLOP *** [2c 4c 8s]
matiko09: checks 
azzad2007: bets $10.10
matiko09: folds 
Uncalled bet ($10.10) returned to azzad2007
azzad2007 collected $36.10 from pot
azzad2007: doesn't show hand 
*** SUMMARY ***
Total pot $38 | Rake $1.90 
Board [2c 4c 8s]
Seat 1: ssljvr folded before Flop (didn't bet)
Seat 2: Iggso folded before Flop (didn't bet)
Seat 3: Glushchenko folded before Flop (didn't bet)
Seat 4: Fish4trips folded before Flop (didn't bet)
Seat 5: docmarc777 folded before Flop (didn't bet)
Seat 6: azzad2007 (button) collected ($36.10)
Seat 7: matiko09 (small blind) folded on the Flop
Seat 8: Dachish (big blind) folded before Flop
Seat 9: erfk1958 folded before Flop (didn't bet)





PokerStars Hand #151944194579:  Hold'em No Limit ($0.50/$1.00 USD) - 2016/04/15 14:20:42 CET [2016/04/15 8:20:42 ET]
Table 'Navi' 9-max Seat #9 is the button
Seat 3: vrnMike ($145.77 in chips) 
Seat 4: Pvsx. ($100 in chips) 
Seat 5: Prettyspitz ($101.50 in chips) 
Seat 6: Vikulja1993 ($119.40 in chips) 
Seat 8: ruslik_by ($162 in chips) 
Seat 9: matiko09 ($130.75 in chips) 
masaytoo will be allowed to play after the button
Xx7-Zeus-7xX will be allowed to play after the button
vrnMike: posts small blind $0.50
Pvsx.: posts big blind $1
IdiotFromNE: sits out 
*** HOLE CARDS ***
Dealt to matiko09 [7s 6s]
Prettyspitz: folds 
Vikulja1993: folds 
ruslik_by: raises $1.50 to $2.50
matiko09: calls $2.50
vrnMike: folds 
Pvsx.: folds 
*** FLOP *** [5s 3d Ac]
ruslik_by: checks 
matiko09: bets $4.02
ruslik_by: calls $4.02
*** TURN *** [5s 3d Ac] [9h]
ruslik_by: checks 
matiko09: bets $7.18
ruslik_by: calls $7.18
*** RIVER *** [5s 3d Ac 9h] [As]
ruslik_by: checks 
matiko09: checks 
*** SHOW DOWN ***
ruslik_by: shows [Ad Jd] (three of a kind, Aces)
matiko09: mucks hand 
ruslik_by collected $27.46 from pot
*** SUMMARY ***
Total pot $28.90 | Rake $1.44 
Board [5s 3d Ac 9h As]
Seat 3: vrnMike (small blind) folded before Flop
Seat 4: Pvsx. (big blind) folded before Flop
Seat 5: Prettyspitz folded before Flop (didn't bet)
Seat 6: Vikulja1993 folded before Flop (didn't bet)
Seat 8: ruslik_by showed [Ad Jd] and won ($27.46) with three of a kind, Aces
Seat 9: matiko09 (button) mucked [7s 6s]





PokerStars Hand #151944194840:  Hold'em No Limit ($0.50/$1.00 USD) - 2016/04/15 14:20:42 CET [2016/04/15 8:20:42 ET]
Table 'Emma II' 9-max Seat #4 is the button
Seat 1: omorfadramou ($113.28 in chips) 
Seat 2: Filojoes ($140.50 in chips) 
Seat 4: matiko09 ($100.50 in chips) 
Seat 5: Prettyspitz ($100 in chips) 
Seat 6: Tirka ($172.53 in chips) 
Seat 7: ruslik_by ($100 in chips) 
Seat 8: geiranger011 ($100 in chips) 
Seat 9: Foton18 ($115.59 in chips) 
Prettyspitz: posts small blind $0.50
Tirka: posts big blind $1
*** HOLE CARDS ***
Dealt to matiko09 [Td 6c]
ruslik_by: folds 
geiranger011: folds 
Foton18: folds 
omorfadramou: folds 
Filojoes: folds 
matiko09: folds 
Prettyspitz: raises $2 to $3
Tirka: calls $2
*** FLOP *** [2d 9h 3h]
Prettyspitz: checks 
Tirka: checks 
*** TURN *** [2d 9h 3h] [8h]
Prettyspitz: checks 
Tirka: checks 
*** RIVER *** [2d 9h 3h 8h] [Th]
Prettyspitz: checks 
Tirka: bets $3.79
Prettyspitz: folds 
Uncalled bet ($3.79) returned to Tirka
Tirka collected $5.70 from pot
Tirka: doesn't show hand 
*** SUMMARY ***
Total pot $6 | Rake $0.30 
Board [2d 9h 3h 8h Th]
Seat 1: omorfadramou folded before Flop (didn't bet)
Seat 2: Filojoes folded before Flop (didn't bet)
Seat 4: matiko09 (button) folded before Flop (didn't bet)
Seat 5: Prettyspitz (small blind) folded on the River
Seat 6: Tirka (big blind) collected ($5.70)
Seat 7: ruslik_by folded before Flop (didn't bet)
Seat 8: geiranger011 folded before Flop (didn't bet)
Seat 9: Foton18 folded before Flop (didn't bet)





PokerStars Hand #151944195618:  Hold'em No Limit ($0.50/$1.00 USD) - 2016/04/15 14:20:44 CET [2016/04/15 8:20:44 ET]
Table 'Chiny II' 9-max Seat #7 is the button
Seat 1: vrnMike ($146.56 in chips) 
Seat 2: Westpants ($124.49 in chips) 
Seat 3: Foton18 ($75.12 in chips) 
Seat 4: matiko09 ($171.44 in chips) 
Seat 5: omorfadramou ($170.12 in chips) 
Seat 6: choupai ($7.53 in chips) 
Seat 7: ruslik_by ($100 in chips) 
Seat 8: Filojoes ($181.65 in chips) 
Seat 9: butcheN18 ($100 in chips) 
Filojoes: posts small blind $0.50
butcheN18: posts big blind $1
*** HOLE CARDS ***
Dealt to matiko09 [Jd 3d]
vrnMike: raises $1 to $2
Westpants: folds 
Foton18: folds 
matiko09: folds 
omorfadramou: folds 
choupai: folds 
ruslik_by: folds 
Filojoes: folds 
butcheN18: raises $6 to $8
vrnMike: folds 
Uncalled bet ($6) returned to butcheN18
butcheN18 collected $4.50 from pot
butcheN18: doesn't show hand 
*** SUMMARY ***
Total pot $4.50 | Rake $0 
Seat 1: vrnMike folded before Flop
Seat 2: Westpants folded before Flop (didn't bet)
Seat 3: Foton18 folded before Flop (didn't bet)
Seat 4: matiko09 folded before Flop (didn't bet)
Seat 5: omorfadramou folded before Flop (didn't bet)
Seat 6: choupai folded before Flop (didn't bet)
Seat 7: ruslik_by (button) folded before Flop (didn't bet)
Seat 8: Filojoes (small blind) folded before Flop
Seat 9: butcheN18 (big blind) collected ($4.50)





PokerStars Hand #151944213410:  Hold'em No Limit ($1/$2 USD) - 2016/04/15 14:21:18 CET [2016/04/15 8:21:18 ET]
Table 'Oceax' 9-max Seat #5 is the button
Seat 1: matiko09 ($200 in chips) 
Seat 3: Vikulja1993 ($200 in chips) 
Seat 4: butcheN18 ($327.71 in chips) 
Seat 5: derrocco82 ($200.83 in chips) 
Seat 6: Iggso ($294.17 in chips) 
Seat 7: ssljvr ($205.06 in chips) 
Seat 8: Poroxide ($323.97 in chips) 
Iggso: posts small blind $1
ssljvr: posts big blind $2
tipner: sits out 
TonnaMunz: sits out 
*** HOLE CARDS ***
Dealt to matiko09 [2h Kd]
Poroxide: folds 
matiko09: folds 
Vikulja1993: folds 
butcheN18: folds 
derrocco82: folds 
Iggso: calls $1
ssljvr: raises $6 to $8
Iggso: calls $6
*** FLOP *** [Th 5h 7c]
Iggso: checks 
ssljvr: bets $6.08
Iggso: folds 
Uncalled bet ($6.08) returned to ssljvr
ssljvr collected $15.20 from pot
ssljvr: doesn't show hand 
*** SUMMARY ***
Total pot $16 | Rake $0.80 
Board [Th 5h 7c]
Seat 1: matiko09 folded before Flop (didn't bet)
Seat 3: Vikulja1993 folded before Flop (didn't bet)
Seat 4: butcheN18 folded before Flop (didn't bet)
Seat 5: derrocco82 (button) folded before Flop (didn't bet)
Seat 6: Iggso (small blind) folded on the Flop
Seat 7: ssljvr (big blind) collected ($15.20)
Seat 8: Poroxide folded before Flop (didn't bet)





PokerStars Hand #151944217392:  Hold'em No Limit ($0.50/$1.00 USD) - 2016/04/15 14:21:26 CET [2016/04/15 8:21:26 ET]
Table 'Adelgunde III' 9-max Seat #5 is the button
Seat 1: valimiu ($172.30 in chips) 
Seat 2: Vikulja1993 ($100 in chips) 
Seat 3: tipner ($116.58 in chips) 
Seat 4: hammerwife ($100 in chips) 
Seat 5: matiko09 ($119.41 in chips) 
Seat 6: Pominator92 ($120.34 in chips) 
Seat 8: SanychStar ($128.06 in chips) 
Seat 9: Kukuryzka ($123.01 in chips) 
Pominator92: posts small blind $0.50
Yaaaazz: is sitting out 
SanychStar: posts big blind $1
*** HOLE CARDS ***
Dealt to matiko09 [Jc Ad]
Kukuryzka: folds 
valimiu: folds 
Yaaaazz leaves the table
Filojoes joins the table at seat #7 
Vikulja1993: folds 
tipner has timed out
tipner: folds 
hammerwife: folds 
matiko09: raises $1.50 to $2.50
Pominator92: calls $2
SanychStar: folds 
*** FLOP *** [Qh 2c As]
Pominator92: checks 
matiko09: checks 
*** TURN *** [Qh 2c As] [9s]
Pominator92: bets $2.85
matiko09: calls $2.85
*** RIVER *** [Qh 2c As 9s] [9h]
Pominator92: checks 
matiko09: bets $4
Pominator92: calls $4
*** SHOW DOWN ***
matiko09: shows [Jc Ad] (two pair, Aces and Nines)
Pominator92: mucks hand 
matiko09 collected $18.72 from pot
*** SUMMARY ***
Total pot $19.70 | Rake $0.98 
Board [Qh 2c As 9s 9h]
Seat 1: valimiu folded before Flop (didn't bet)
Seat 2: Vikulja1993 folded before Flop (didn't bet)
Seat 3: tipner folded before Flop (didn't bet)
Seat 4: hammerwife folded before Flop (didn't bet)
Seat 5: matiko09 (button) showed [Jc Ad] and won ($18.72) with two pair, Aces and Nines
Seat 6: Pominator92 (small blind) mucked [Qc 2s]
Seat 8: SanychStar (big blind) folded before Flop
Seat 9: Kukuryzka folded before Flop (didn't bet)





PokerStars Hand #151944219844:  Hold'em No Limit ($1/$2 USD) - 2016/04/15 14:21:31 CET [2016/04/15 8:21:31 ET]
Table 'Blaauw' 9-max Seat #2 is the button
Seat 1: myatiy 96 ($207.46 in chips) 
Seat 2: butcheN18 ($238.19 in chips) 
Seat 4: petro0107 ($227.84 in chips) 
Seat 5: tipner ($246.40 in chips) 
Seat 6: matiko09 ($290.90 in chips) 
Seat 7: ssljvr ($410.95 in chips) 
Seat 8: Iggso ($200 in chips) 
Seat 9: coinflip_si ($200 in chips) 
Vikulja1993 will be allowed to play after the button
petro0107: posts small blind $1
tipner: posts big blind $2
*** HOLE CARDS ***
Dealt to matiko09 [9c 6c]
matiko09: folds 
ssljvr: folds 
Iggso: folds 
coinflip_si: raises $3 to $5
myatiy 96: folds 
butcheN18: folds 
petro0107: calls $4
tipner: calls $3
*** FLOP *** [5c Jh Jc]
petro0107: checks 
tipner: checks 
coinflip_si: bets $8
petro0107: calls $8
tipner: folds 
*** TURN *** [5c Jh Jc] [3h]
petro0107: checks 
coinflip_si: checks 
*** RIVER *** [5c Jh Jc 3h] [8c]
petro0107: bets $16
coinflip_si: folds 
Uncalled bet ($16) returned to petro0107
petro0107 collected $29.45 from pot
petro0107: doesn't show hand 
*** SUMMARY ***
Total pot $31 | Rake $1.55 
Board [5c Jh Jc 3h 8c]
Seat 1: myatiy 96 folded before Flop (didn't bet)
Seat 2: butcheN18 (button) folded before Flop (didn't bet)
Seat 4: petro0107 (small blind) collected ($29.45)
Seat 5: tipner (big blind) folded on the Flop
Seat 6: matiko09 folded before Flop (didn't bet)
Seat 7: ssljvr folded before Flop (didn't bet)
Seat 8: Iggso folded before Flop (didn't bet)
Seat 9: coinflip_si folded on the River





PokerStars Hand #151944220579:  Hold'em No Limit ($0.50/$1.00 USD) - 2016/04/15 14:21:32 CET [2016/04/15 8:21:32 ET]
Table 'Parvulesco II' 9-max Seat #5 is the button
Seat 1: bilukm ($59.53 in chips) 
Seat 2: Filojoes ($104.04 in chips) 
Seat 3: matiko09 ($123.51 in chips) 
Seat 4: butcheN18 ($100 in chips) 
Seat 5: maxxmeister ($111.08 in chips) 
Seat 6: ruslik_by ($139.43 in chips) 
Seat 7: Kukuryzka ($144.28 in chips) 
Seat 8: Jimy Tiltman ($111.92 in chips) 
Seat 9: hammerwife ($209.03 in chips) 
ruslik_by: posts small blind $0.50
Kukuryzka: posts big blind $1
*** HOLE CARDS ***
Dealt to matiko09 [Ad 5d]
Jimy Tiltman: folds 
hammerwife: folds 
bilukm: folds 
Filojoes: folds 
matiko09: raises $2 to $3
butcheN18: folds 
maxxmeister: folds 
ruslik_by: folds 
Kukuryzka: folds 
Uncalled bet ($2) returned to matiko09
matiko09 collected $2.50 from pot
matiko09: doesn't show hand 
*** SUMMARY ***
Total pot $2.50 | Rake $0 
Seat 1: bilukm folded before Flop (didn't bet)
Seat 2: Filojoes folded before Flop (didn't bet)
Seat 3: matiko09 collected ($2.50)
Seat 4: butcheN18 folded before Flop (didn't bet)
Seat 5: maxxmeister (button) folded before Flop (didn't bet)
Seat 6: ruslik_by (small blind) folded before Flop
Seat 7: Kukuryzka (big blind) folded before Flop
Seat 8: Jimy Tiltman folded before Flop (didn't bet)
Seat 9: hammerwife folded before Flop (didn't bet)





PokerStars Hand #151944221821:  Hold'em No Limit ($1/$2 USD) - 2016/04/15 14:21:34 CET [2016/04/15 8:21:34 ET]
Table 'Adele II' 9-max Seat #5 is the button
Seat 1: RyanHuJun ($303.97 in chips) 
Seat 2: Fish4trips ($341.85 in chips) 
Seat 3: matiko09 ($306.33 in chips) 
Seat 4: Glushchenko ($219.16 in chips) 
Seat 5: TonnaMunz ($200 in chips) 
Seat 6: Kukuryzka ($259.43 in chips) 
Seat 7: Iggso ($200 in chips) 
Seat 8: butcheN18 ($245.67 in chips) 
Seat 9: SanychStar ($271.60 in chips) 
Kukuryzka: posts small blind $1
Iggso: posts big blind $2
*** HOLE CARDS ***
Dealt to matiko09 [Kd 7d]
butcheN18: folds 
SanychStar: folds 
RyanHuJun: raises $4 to $6
Fish4trips: calls $6
matiko09: folds 
Glushchenko: folds 
TonnaMunz: folds 
Kukuryzka: calls $5
Iggso: calls $4
*** FLOP *** [4c Qd 7h]
Kukuryzka: checks 
Iggso: checks 
RyanHuJun: checks 
Fish4trips: checks 
*** TURN *** [4c Qd 7h] [7c]
Kukuryzka: checks 
Iggso: checks 
RyanHuJun: checks 
Fish4trips: checks 
*** RIVER *** [4c Qd 7h 7c] [6c]
Kukuryzka: checks 
Iggso: checks 
RyanHuJun: checks 
Fish4trips: checks 
*** SHOW DOWN ***
Kukuryzka: shows [Jh Ah] (a pair of Sevens)
Iggso: shows [4h 6h] (two pair, Sevens and Sixes)
RyanHuJun: shows [Kc Qs] (two pair, Queens and Sevens)
Fish4trips: mucks hand 
RyanHuJun collected $22.80 from pot
*** SUMMARY ***
Total pot $24 | Rake $1.20 
Board [4c Qd 7h 7c 6c]
Seat 1: RyanHuJun showed [Kc Qs] and won ($22.80) with two pair, Queens and Sevens
Seat 2: Fish4trips mucked [5d 5c]
Seat 3: matiko09 folded before Flop (didn't bet)
Seat 4: Glushchenko folded before Flop (didn't bet)
Seat 5: TonnaMunz (button) folded before Flop (didn't bet)
Seat 6: Kukuryzka (small blind) showed [Jh Ah] and lost with a pair of Sevens
Seat 7: Iggso (big blind) showed [4h 6h] and lost with two pair, Sevens and Sixes
Seat 8: butcheN18 folded before Flop (didn't bet)
Seat 9: SanychStar folded before Flop (didn't bet)





PokerStars Hand #151944225148:  Hold'em No Limit ($0.50/$1.00 USD) - 2016/04/15 14:21:41 CET [2016/04/15 8:21:41 ET]
Table 'Chiny II' 9-max Seat #8 is the button
Seat 1: vrnMike ($144.56 in chips) 
Seat 2: Westpants ($124.49 in chips) 
Seat 3: Foton18 ($75.12 in chips) 
Seat 4: matiko09 ($171.44 in chips) 
Seat 5: omorfadramou ($170.12 in chips) 
Seat 6: choupai ($7.53 in chips) 
Seat 7: ruslik_by ($100 in chips) 
Seat 8: Filojoes ($181.15 in chips) 
Seat 9: butcheN18 ($102.50 in chips) 
butcheN18: posts small blind $0.50
vrnMike: posts big blind $1
*** HOLE CARDS ***
Dealt to matiko09 [3h Jd]
Westpants: folds 
Foton18: folds 
matiko09: folds 
omorfadramou: folds 
choupai: folds 
ruslik_by: folds 
Filojoes: raises $1 to $2
butcheN18: raises $6 to $8
vrnMike: folds 
Filojoes: folds 
Uncalled bet ($6) returned to butcheN18
butcheN18 collected $5 from pot
butcheN18: doesn't show hand 
*** SUMMARY ***
Total pot $5 | Rake $0 
Seat 1: vrnMike (big blind) folded before Flop
Seat 2: Westpants folded before Flop (didn't bet)
Seat 3: Foton18 folded before Flop (didn't bet)
Seat 4: matiko09 folded before Flop (didn't bet)
Seat 5: omorfadramou folded before Flop (didn't bet)
Seat 6: choupai folded before Flop (didn't bet)
Seat 7: ruslik_by folded before Flop (didn't bet)
Seat 8: Filojoes (button) folded before Flop
Seat 9: butcheN18 (small blind) collected ($5)





PokerStars Hand #151944241715:  Hold'em No Limit ($0.50/$1.00 USD) - 2016/04/15 14:22:12 CET [2016/04/15 8:22:12 ET]
Table 'Parvulesco II' 9-max Seat #6 is the button
Seat 1: bilukm ($59.53 in chips) 
Seat 2: Filojoes ($104.04 in chips) 
Seat 3: matiko09 ($125.01 in chips) 
Seat 4: butcheN18 ($100 in chips) 
Seat 5: maxxmeister ($111.08 in chips) 
Seat 6: ruslik_by ($138.93 in chips) 
Seat 7: Kukuryzka ($143.28 in chips) 
Seat 8: Jimy Tiltman ($111.92 in chips) 
Seat 9: hammerwife ($209.03 in chips) 
Kukuryzka: posts small blind $0.50
Jimy Tiltman: posts big blind $1
*** HOLE CARDS ***
Dealt to matiko09 [Jc 2h]
hammerwife: folds 
bilukm: folds 
Filojoes: raises $2 to $3
matiko09: folds 
butcheN18: folds 
maxxmeister: folds 
ruslik_by: folds 
Kukuryzka: folds 
Jimy Tiltman: calls $2
*** FLOP *** [2s Jd 9d]
Jimy Tiltman: checks 
Filojoes: bets $3.71
Jimy Tiltman: folds 
Uncalled bet ($3.71) returned to Filojoes
Filojoes collected $6.18 from pot
Filojoes: doesn't show hand 
*** SUMMARY ***
Total pot $6.50 | Rake $0.32 
Board [2s Jd 9d]
Seat 1: bilukm folded before Flop (didn't bet)
Seat 2: Filojoes collected ($6.18)
Seat 3: matiko09 folded before Flop (didn't bet)
Seat 4: butcheN18 folded before Flop (didn't bet)
Seat 5: maxxmeister folded before Flop (didn't bet)
Seat 6: ruslik_by (button) folded before Flop (didn't bet)
Seat 7: Kukuryzka (small blind) folded before Flop
Seat 8: Jimy Tiltman (big blind) folded on the Flop
Seat 9: hammerwife folded before Flop (didn't bet)





PokerStars Hand #151944241534:  Hold'em No Limit ($1/$2 USD) - 2016/04/15 14:22:12 CET [2016/04/15 8:22:12 ET]
Table 'Oceax' 9-max Seat #6 is the button
Seat 1: matiko09 ($200 in chips) 
Seat 3: Vikulja1993 ($200 in chips) 
Seat 4: butcheN18 ($327.71 in chips) 
Seat 5: derrocco82 ($200.83 in chips) 
Seat 6: Iggso ($286.17 in chips) 
Seat 7: ssljvr ($212.26 in chips) 
Seat 8: Poroxide ($323.97 in chips) 
ssljvr: posts small blind $1
Poroxide: posts big blind $2
tipner: sits out 
TonnaMunz: sits out 
*** HOLE CARDS ***
Dealt to matiko09 [Jh 7s]
matiko09: folds 
Vikulja1993: folds 
butcheN18: folds 
derrocco82: folds 
Iggso: folds 
ssljvr: raises $4 to $6
Poroxide: calls $4
*** FLOP *** [9d 3d 8d]
ssljvr: bets $8.55
Poroxide: raises $9.45 to $18
ssljvr: calls $9.45
*** TURN *** [9d 3d 8d] [9h]
ssljvr: checks 
Poroxide: bets $28
ssljvr: folds 
Uncalled bet ($28) returned to Poroxide
Poroxide collected $45.60 from pot
Poroxide: doesn't show hand 
*** SUMMARY ***
Total pot $48 | Rake $2.40 
Board [9d 3d 8d 9h]
Seat 1: matiko09 folded before Flop (didn't bet)
Seat 3: Vikulja1993 folded before Flop (didn't bet)
Seat 4: butcheN18 folded before Flop (didn't bet)
Seat 5: derrocco82 folded before Flop (didn't bet)
Seat 6: Iggso (button) folded before Flop (didn't bet)
Seat 7: ssljvr (small blind) folded on the Turn
Seat 8: Poroxide (big blind) collected ($45.60)





PokerStars Hand #151944242632:  Hold'em No Limit ($0.50/$1.00 USD) - 2016/04/15 14:22:14 CET [2016/04/15 8:22:14 ET]
Table 'Navi' 9-max Seat #3 is the button
Seat 3: vrnMike ($145.27 in chips) 
Seat 4: Pvsx. ($100 in chips) 
Seat 5: Prettyspitz ($101.50 in chips) 
Seat 6: Vikulja1993 ($119.40 in chips) 
Seat 8: ruslik_by ($175.76 in chips) 
Seat 9: matiko09 ($117.05 in chips) 
Pvsx.: posts small blind $0.50
Prettyspitz: posts big blind $1
IdiotFromNE: sits out 
masaytoo: sits out 
Xx7-Zeus-7xX: sits out 
*** HOLE CARDS ***
Dealt to matiko09 [Td 3c]
Vikulja1993: folds 
Vikulja1993 leaves the table
ruslik_by: folds 
matiko09: folds 
vrnMike: raises $2 to $3
Pvsx.: calls $2.50
Prettyspitz: folds 
*** FLOP *** [5d 7h 5c]
Pvsx.: checks 
vrnMike: checks 
*** TURN *** [5d 7h 5c] [7c]
Pvsx.: bets $3.32
vrnMike: folds 
Uncalled bet ($3.32) returned to Pvsx.
Pvsx. collected $6.65 from pot
Pvsx.: doesn't show hand 
*** SUMMARY ***
Total pot $7 | Rake $0.35 
Board [5d 7h 5c 7c]
Seat 3: vrnMike (button) folded on the Turn
Seat 4: Pvsx. (small blind) collected ($6.65)
Seat 5: Prettyspitz (big blind) folded before Flop
Seat 6: Vikulja1993 folded before Flop (didn't bet)
Seat 8: ruslik_by folded before Flop (didn't bet)
Seat 9: matiko09 folded before Flop (didn't bet)





PokerStars Hand #151944243495:  Hold'em No Limit ($0.50/$1.00 USD) - 2016/04/15 14:22:15 CET [2016/04/15 8:22:15 ET]
Table 'Emma II' 9-max Seat #5 is the button
Seat 1: omorfadramou ($113.28 in chips) 
Seat 2: Filojoes ($140.50 in chips) 
Seat 4: matiko09 ($100.50 in chips) 
Seat 5: Prettyspitz ($100 in chips) 
Seat 6: Tirka ($175.23 in chips) 
Seat 7: ruslik_by ($100 in chips) 
Seat 8: geiranger011 ($100 in chips) 
Seat 9: Foton18 ($115.59 in chips) 
Tirka: posts small blind $0.50
ruslik_by: posts big blind $1
*** HOLE CARDS ***
Dealt to matiko09 [6h 5d]
geiranger011: folds 
Foton18: folds 
omorfadramou: folds 
Filojoes: folds 
matiko09: folds 
Prettyspitz: raises $1.04 to $2.04
Tirka: folds 
ruslik_by: folds 
Uncalled bet ($1.04) returned to Prettyspitz
Prettyspitz collected $2.50 from pot
Prettyspitz: doesn't show hand 
*** SUMMARY ***
Total pot $2.50 | Rake $0 
Seat 1: omorfadramou folded before Flop (didn't bet)
Seat 2: Filojoes folded before Flop (didn't bet)
Seat 4: matiko09 folded before Flop (didn't bet)
Seat 5: Prettyspitz (button) collected ($2.50)
Seat 6: Tirka (small blind) folded before Flop
Seat 7: ruslik_by (big blind) folded before Flop
Seat 8: geiranger011 folded before Flop (didn't bet)
Seat 9: Foton18 folded before Flop (didn't bet)





PokerStars Hand #151944248802:  Hold'em No Limit ($0.50/$1.00 USD) - 2016/04/15 14:22:25 CET [2016/04/15 8:22:25 ET]
Table 'Chiny II' 9-max Seat #9 is the button
Seat 1: vrnMike ($143.56 in chips) 
Seat 2: Westpants ($124.49 in chips) 
Seat 3: Foton18 ($75.12 in chips) 
Seat 4: matiko09 ($171.44 in chips) 
Seat 5: omorfadramou ($170.12 in chips) 
Seat 6: choupai ($7.53 in chips) 
Seat 7: ruslik_by ($100 in chips) 
Seat 8: Filojoes ($179.15 in chips) 
Seat 9: butcheN18 ($105.50 in chips) 
vrnMike: posts small blind $0.50
Westpants: posts big blind $1
*** HOLE CARDS ***
Dealt to matiko09 [Qd Th]
Foton18: folds 
matiko09: folds 
omorfadramou: raises $2 to $3
choupai: folds 
ruslik_by: folds 
Filojoes: folds 
butcheN18: folds 
vrnMike: folds 
Westpants: folds 
Uncalled bet ($2) returned to omorfadramou
omorfadramou collected $2.50 from pot
omorfadramou: doesn't show hand 
*** SUMMARY ***
Total pot $2.50 | Rake $0 
Seat 1: vrnMike (small blind) folded before Flop
Seat 2: Westpants (big blind) folded before Flop
Seat 3: Foton18 folded before Flop (didn't bet)
Seat 4: matiko09 folded before Flop (didn't bet)
Seat 5: omorfadramou collected ($2.50)
Seat 6: choupai folded before Flop (didn't bet)
Seat 7: ruslik_by folded before Flop (didn't bet)
Seat 8: Filojoes folded before Flop (didn't bet)
Seat 9: butcheN18 (button) folded before Flop (didn't bet)





PokerStars Hand #151944255675:  Hold'em No Limit ($0.50/$1.00 USD) - 2016/04/15 14:22:39 CET [2016/04/15 8:22:39 ET]
Table 'Adelgunde III' 9-max Seat #6 is the button
Seat 1: valimiu ($172.30 in chips) 
Seat 2: Vikulja1993 ($100 in chips) 
Seat 3: tipner ($116.58 in chips) 
Seat 4: hammerwife ($100 in chips) 
Seat 5: matiko09 ($128.78 in chips) 
Seat 6: Pominator92 ($110.99 in chips) 
Seat 8: SanychStar ($127.06 in chips) 
Seat 9: Kukuryzka ($123.01 in chips) 
Filojoes will be allowed to play after the button
SanychStar: posts small blind $0.50
Kukuryzka: posts big blind $1
*** HOLE CARDS ***
Dealt to matiko09 [Qc 4c]
valimiu: calls $1
Vikulja1993: folds 
tipner: folds 
hammerwife: folds 
matiko09: folds 
Pominator92: raises $3 to $4
SanychStar: folds 
Kukuryzka: folds 
valimiu: calls $3
*** FLOP *** [4h 9s 3c]
valimiu: checks 
Pominator92: bets $6
valimiu: folds 
Uncalled bet ($6) returned to Pominator92
Pominator92 collected $9.02 from pot
Pominator92: doesn't show hand 
*** SUMMARY ***
Total pot $9.50 | Rake $0.48 
Board [4h 9s 3c]
Seat 1: valimiu folded on the Flop
Seat 2: Vikulja1993 folded before Flop (didn't bet)
Seat 3: tipner folded before Flop (didn't bet)
Seat 4: hammerwife folded before Flop (didn't bet)
Seat 5: matiko09 folded before Flop (didn't bet)
Seat 6: Pominator92 (button) collected ($9.02)
Seat 8: SanychStar (small blind) folded before Flop
Seat 9: Kukuryzka (big blind) folded before Flop





PokerStars Hand #151944258955:  Hold'em No Limit ($1/$2 USD) - 2016/04/15 14:22:45 CET [2016/04/15 8:22:45 ET]
Table 'Marmara II' 9-max Seat #7 is the button
Seat 1: ssljvr ($488.98 in chips) 
Seat 2: Iggso ($200 in chips) 
Seat 3: Glushchenko ($200 in chips) 
Seat 4: Fish4trips ($241.96 in chips) 
Seat 5: docmarc777 ($417.85 in chips) 
Seat 6: azzad2007 ($218.10 in chips) 
Seat 7: matiko09 ($214.77 in chips) 
Seat 8: Dachish ($173.61 in chips) 
Seat 9: di0d80 ($200 in chips) 
Dachish: posts small blind $1
di0d80: posts big blind $2
*** HOLE CARDS ***
Dealt to matiko09 [3c 2c]
ssljvr: folds 
Iggso: folds 
Glushchenko: raises $4 to $6
Fish4trips: folds 
docmarc777: folds 
azzad2007: folds 
matiko09: folds 
Dachish: folds 
di0d80: raises $12 to $18
Glushchenko: calls $12
*** FLOP *** [Kc 2h Tc]
di0d80: checks 
Glushchenko: checks 
*** TURN *** [Kc 2h Tc] [6h]
di0d80: checks 
Glushchenko: checks 
*** RIVER *** [Kc 2h Tc 6h] [Kd]
di0d80: bets $20
Glushchenko: folds 
Uncalled bet ($20) returned to di0d80
di0d80 collected $35.15 from pot
di0d80: doesn't show hand 
*** SUMMARY ***
Total pot $37 | Rake $1.85 
Board [Kc 2h Tc 6h Kd]
Seat 1: ssljvr folded before Flop (didn't bet)
Seat 2: Iggso folded before Flop (didn't bet)
Seat 3: Glushchenko folded on the River
Seat 4: Fish4trips folded before Flop (didn't bet)
Seat 5: docmarc777 folded before Flop (didn't bet)
Seat 6: azzad2007 folded before Flop (didn't bet)
Seat 7: matiko09 (button) folded before Flop (didn't bet)
Seat 8: Dachish (small blind) folded before Flop
Seat 9: di0d80 (big blind) collected ($35.15)





PokerStars Hand #151944262121:  Hold'em No Limit ($0.50/$1.00 USD) - 2016/04/15 14:22:51 CET [2016/04/15 8:22:51 ET]
Table 'Chiny II' 9-max Seat #1 is the button
Seat 1: vrnMike ($143.06 in chips) 
Seat 2: Westpants ($123.49 in chips) 
Seat 3: Foton18 ($75.12 in chips) 
Seat 4: matiko09 ($171.44 in chips) 
Seat 5: omorfadramou ($171.62 in chips) 
Seat 6: choupai ($7.53 in chips) 
Seat 7: ruslik_by ($100 in chips) 
Seat 8: Filojoes ($179.15 in chips) 
Seat 9: butcheN18 ($105.50 in chips) 
Westpants: posts small blind $0.50
Foton18: posts big blind $1
*** HOLE CARDS ***
Dealt to matiko09 [5s Jh]
matiko09: folds 
omorfadramou: folds 
choupai: folds 
ruslik_by: folds 
Filojoes: raises $2 to $3
butcheN18: folds 
vrnMike: folds 
Westpants: folds 
Foton18: calls $2
*** FLOP *** [8h Kc 3c]
Foton18: checks 
Filojoes: checks 
*** TURN *** [8h Kc 3c] [5c]
Foton18: bets $4
Filojoes: folds 
Uncalled bet ($4) returned to Foton18
Foton18 collected $6.18 from pot
Foton18: doesn't show hand 
*** SUMMARY ***
Total pot $6.50 | Rake $0.32 
Board [8h Kc 3c 5c]
Seat 1: vrnMike (button) folded before Flop (didn't bet)
Seat 2: Westpants (small blind) folded before Flop
Seat 3: Foton18 (big blind) collected ($6.18)
Seat 4: matiko09 folded before Flop (didn't bet)
Seat 5: omorfadramou folded before Flop (didn't bet)
Seat 6: choupai folded before Flop (didn't bet)
Seat 7: ruslik_by folded before Flop (didn't bet)
Seat 8: Filojoes folded on the Turn
Seat 9: butcheN18 folded before Flop (didn't bet)





PokerStars Hand #151944267262:  Hold'em No Limit ($1/$2 USD) - 2016/04/15 14:23:00 CET [2016/04/15 8:23:00 ET]
Table 'Oceax' 9-max Seat #7 is the button
Seat 1: matiko09 ($200 in chips) 
Seat 3: Vikulja1993 ($200 in chips) 
Seat 4: butcheN18 ($327.71 in chips) 
Seat 5: derrocco82 ($200.83 in chips) 
Seat 6: Iggso ($286.17 in chips) 
Seat 7: ssljvr ($200 in chips) 
Seat 8: Poroxide ($345.57 in chips) 
Seat 9: tipner ($200 in chips) 
Poroxide: posts small blind $1
tipner: posts big blind $2
TonnaMunz: sits out 
*** HOLE CARDS ***
Dealt to matiko09 [7h Jh]
matiko09: folds 
Vikulja1993: folds 
butcheN18: folds 
derrocco82: folds 
Iggso: folds 
ssljvr: raises $4 to $6
Poroxide: folds 
tipner: calls $4
*** FLOP *** [As Jc 9d]
tipner: checks 
ssljvr: bets $4.94
tipner: calls $4.94
*** TURN *** [As Jc 9d] [8s]
tipner: checks 
ssljvr: checks 
*** RIVER *** [As Jc 9d 8s] [Js]
tipner: checks 
ssljvr: bets $13.47
tipner: calls $13.47
*** SHOW DOWN ***
ssljvr: shows [Ad Qh] (two pair, Aces and Jacks)
tipner: mucks hand 
ssljvr collected $47.33 from pot
*** SUMMARY ***
Total pot $49.82 | Rake $2.49 
Board [As Jc 9d 8s Js]
Seat 1: matiko09 folded before Flop (didn't bet)
Seat 3: Vikulja1993 folded before Flop (didn't bet)
Seat 4: butcheN18 folded before Flop (didn't bet)
Seat 5: derrocco82 folded before Flop (didn't bet)
Seat 6: Iggso folded before Flop (didn't bet)
Seat 7: ssljvr (button) showed [Ad Qh] and won ($47.33) with two pair, Aces and Jacks
Seat 8: Poroxide (small blind) folded before Flop
Seat 9: tipner (big blind) mucked [5d Ac]





PokerStars Hand #151944267054:  Hold'em No Limit ($0.50/$1.00 USD) - 2016/04/15 14:23:00 CET [2016/04/15 8:23:00 ET]
Table 'Emma II' 9-max Seat #6 is the button
Seat 1: omorfadramou ($113.28 in chips) 
Seat 2: Filojoes ($140.50 in chips) 
Seat 4: matiko09 ($100.50 in chips) 
Seat 5: Prettyspitz ($101.50 in chips) 
Seat 6: Tirka ($174.73 in chips) 
Seat 7: ruslik_by ($100 in chips) 
Seat 8: geiranger011 ($100 in chips) 
Seat 9: Foton18 ($115.59 in chips) 
ruslik_by: posts small blind $0.50
geiranger011: posts big blind $1
*** HOLE CARDS ***
Dealt to matiko09 [Ah Ts]
Foton18: folds 
omorfadramou: raises $2 to $3
Filojoes: folds 
matiko09: folds 
Prettyspitz: folds 
Tirka: folds 
ruslik_by: folds 
geiranger011: folds 
Uncalled bet ($2) returned to omorfadramou
omorfadramou collected $2.50 from pot
omorfadramou: doesn't show hand 
*** SUMMARY ***
Total pot $2.50 | Rake $0 
Seat 1: omorfadramou collected ($2.50)
Seat 2: Filojoes folded before Flop (didn't bet)
Seat 4: matiko09 folded before Flop (didn't bet)
Seat 5: Prettyspitz folded before Flop (didn't bet)
Seat 6: Tirka (button) folded before Flop (didn't bet)
Seat 7: ruslik_by (small blind) folded before Flop
Seat 8: geiranger011 (big blind) folded before Flop
Seat 9: Foton18 folded before Flop (didn't bet)





PokerStars Hand #151944267885:  Hold'em No Limit ($0.50/$1.00 USD) - 2016/04/15 14:23:02 CET [2016/04/15 8:23:02 ET]
Table 'Parvulesco II' 9-max Seat #7 is the button
Seat 1: bilukm ($59.53 in chips) 
Seat 2: Filojoes ($107.22 in chips) 
Seat 3: matiko09 ($125.01 in chips) 
Seat 4: butcheN18 ($100 in chips) 
Seat 5: maxxmeister ($111.08 in chips) 
Seat 6: ruslik_by ($138.93 in chips) 
Seat 7: Kukuryzka ($142.78 in chips) 
Seat 8: Jimy Tiltman ($108.92 in chips) 
Seat 9: hammerwife ($209.03 in chips) 
Jimy Tiltman: posts small blind $0.50
hammerwife: posts big blind $1
*** HOLE CARDS ***
Dealt to matiko09 [9d 5h]
bilukm: raises $1 to $2
Filojoes: folds 
matiko09: folds 
butcheN18: folds 
maxxmeister: folds 
ruslik_by: raises $5 to $7
Kukuryzka: folds 
Jimy Tiltman: folds 
hammerwife: folds 
bilukm: folds 
Uncalled bet ($5) returned to ruslik_by
ruslik_by collected $5.50 from pot
ruslik_by: doesn't show hand 
*** SUMMARY ***
Total pot $5.50 | Rake $0 
Seat 1: bilukm folded before Flop
Seat 2: Filojoes folded before Flop (didn't bet)
Seat 3: matiko09 folded before Flop (didn't bet)
Seat 4: butcheN18 folded before Flop (didn't bet)
Seat 5: maxxmeister folded before Flop (didn't bet)
Seat 6: ruslik_by collected ($5.50)
Seat 7: Kukuryzka (button) folded before Flop (didn't bet)
Seat 8: Jimy Tiltman (small blind) folded before Flop
Seat 9: hammerwife (big blind) folded before Flop





PokerStars Hand #151944268872:  Hold'em No Limit ($1/$2 USD) - 2016/04/15 14:23:04 CET [2016/04/15 8:23:04 ET]
Table 'Adele II' 9-max Seat #6 is the button
Seat 1: RyanHuJun ($320.77 in chips) 
Seat 2: Fish4trips ($335.85 in chips) 
Seat 3: matiko09 ($306.33 in chips) 
Seat 4: Glushchenko ($219.16 in chips) 
Seat 5: TonnaMunz ($200 in chips) 
Seat 6: Kukuryzka ($253.43 in chips) 
Seat 7: Iggso ($200 in chips) 
Seat 8: butcheN18 ($245.67 in chips) 
Seat 9: SanychStar ($271.60 in chips) 
Iggso: posts small blind $1
butcheN18: posts big blind $2
*** HOLE CARDS ***
Dealt to matiko09 [6c Ks]
SanychStar: folds 
RyanHuJun: calls $2
Fish4trips: folds 
matiko09: folds 
Glushchenko: folds 
TonnaMunz: folds 
Kukuryzka: folds 
Iggso: folds 
butcheN18: checks 
*** FLOP *** [8d 5c 9d]
butcheN18: bets $3.04
RyanHuJun: calls $3.04
*** TURN *** [8d 5c 9d] [Ad]
butcheN18: checks 
RyanHuJun: checks 
*** RIVER *** [8d 5c 9d Ad] [6s]
butcheN18: checks 
RyanHuJun: checks 
*** SHOW DOWN ***
butcheN18: shows [Ts 9c] (a pair of Nines)
RyanHuJun: shows [Kd As] (a pair of Aces)
RyanHuJun collected $10.53 from pot
*** SUMMARY ***
Total pot $11.08 | Rake $0.55 
Board [8d 5c 9d Ad 6s]
Seat 1: RyanHuJun showed [Kd As] and won ($10.53) with a pair of Aces
Seat 2: Fish4trips folded before Flop (didn't bet)
Seat 3: matiko09 folded before Flop (didn't bet)
Seat 4: Glushchenko folded before Flop (didn't bet)
Seat 5: TonnaMunz folded before Flop (didn't bet)
Seat 6: Kukuryzka (button) folded before Flop (didn't bet)
Seat 7: Iggso (small blind) folded before Flop
Seat 8: butcheN18 (big blind) showed [Ts 9c] and lost with a pair of Nines
Seat 9: SanychStar folded before Flop (didn't bet)





PokerStars Hand #151944272658:  Hold'em No Limit ($0.50/$1.00 USD) - 2016/04/15 14:23:11 CET [2016/04/15 8:23:11 ET]
Table 'Navi' 9-max Seat #4 is the button
Seat 3: vrnMike ($142.27 in chips) 
Seat 4: Pvsx. ($103.65 in chips) 
Seat 5: Prettyspitz ($100.50 in chips) 
Seat 7: IdiotFromNE ($100 in chips) 
Seat 8: ruslik_by ($175.76 in chips) 
Seat 9: matiko09 ($117.05 in chips) 
Prettyspitz: posts small blind $0.50
IdiotFromNE: posts big blind $1
masaytoo: sits out 
Xx7-Zeus-7xX: sits out 
*** HOLE CARDS ***
Dealt to matiko09 [Jh 7c]
ruslik_by: folds 
matiko09: folds 
vrnMike: folds 
Pvsx.: folds 
Prettyspitz: folds 
Uncalled bet ($0.50) returned to IdiotFromNE
IdiotFromNE collected $1 from pot
IdiotFromNE: doesn't show hand 
*** SUMMARY ***
Total pot $1 | Rake $0 
Seat 3: vrnMike folded before Flop (didn't bet)
Seat 4: Pvsx. (button) folded before Flop (didn't bet)
Seat 5: Prettyspitz (small blind) folded before Flop
Seat 7: IdiotFromNE (big blind) collected ($1)
Seat 8: ruslik_by folded before Flop (didn't bet)
Seat 9: matiko09 folded before Flop (didn't bet)





PokerStars Hand #151944272842:  Hold'em No Limit ($1/$2 USD) - 2016/04/15 14:23:11 CET [2016/04/15 8:23:11 ET]
Table 'Blaauw' 9-max Seat #4 is the button
Seat 1: myatiy 96 ($207.46 in chips) 
Seat 2: butcheN18 ($238.19 in chips) 
Seat 4: petro0107 ($244.29 in chips) 
Seat 5: tipner ($241.40 in chips) 
Seat 6: matiko09 ($290.90 in chips) 
Seat 7: ssljvr ($410.95 in chips) 
Seat 8: Iggso ($200 in chips) 
Seat 9: coinflip_si ($200 in chips) 
tipner: posts small blind $1
matiko09: posts big blind $2
Vikulja1993: sits out 
*** HOLE CARDS ***
Dealt to matiko09 [6h 7d]
ssljvr: folds 
Iggso: raises $4 to $6
coinflip_si: folds 
myatiy 96: folds 
butcheN18: folds 
petro0107: folds 
tipner: folds 
matiko09: folds 
Uncalled bet ($4) returned to Iggso
Iggso collected $5 from pot
Iggso: doesn't show hand 
*** SUMMARY ***
Total pot $5 | Rake $0 
Seat 1: myatiy 96 folded before Flop (didn't bet)
Seat 2: butcheN18 folded before Flop (didn't bet)
Seat 4: petro0107 (button) folded before Flop (didn't bet)
Seat 5: tipner (small blind) folded before Flop
Seat 6: matiko09 (big blind) folded before Flop
Seat 7: ssljvr folded before Flop (didn't bet)
Seat 8: Iggso collected ($5)
Seat 9: coinflip_si folded before Flop (didn't bet)





PokerStars Hand #151944279600:  Hold'em No Limit ($0.50/$1.00 USD) - 2016/04/15 14:23:24 CET [2016/04/15 8:23:24 ET]
Table 'Emma II' 9-max Seat #7 is the button
Seat 1: omorfadramou ($114.78 in chips) 
Seat 2: Filojoes ($140.50 in chips) 
Seat 4: matiko09 ($100.50 in chips) 
Seat 5: Prettyspitz ($101.50 in chips) 
Seat 6: Tirka ($174.73 in chips) 
Seat 7: ruslik_by ($100 in chips) 
Seat 8: geiranger011 ($99 in chips) 
Seat 9: Foton18 ($115.59 in chips) 
geiranger011: posts small blind $0.50
Foton18: posts big blind $1
*** HOLE CARDS ***
Dealt to matiko09 [Ah 2c]
omorfadramou: folds 
Filojoes: folds 
matiko09: folds 
Prettyspitz: raises $2 to $3
Tirka: folds 
ruslik_by: folds 
geiranger011: folds 
Foton18: calls $2
*** FLOP *** [2s 8s 5c]
Foton18: checks 
Prettyspitz: bets $4.82
Foton18: calls $4.82
*** TURN *** [2s 8s 5c] [Qh]
Foton18: checks 
Prettyspitz: bets $12
Foton18: calls $12
*** RIVER *** [2s 8s 5c Qh] [6s]
Foton18: checks 
Prettyspitz: checks 
*** SHOW DOWN ***
Foton18: shows [Ks Js] (a flush, King high)
Prettyspitz: mucks hand 
Foton18 collected $38.13 from pot
*** SUMMARY ***
Total pot $40.14 | Rake $2.01 
Board [2s 8s 5c Qh 6s]
Seat 1: omorfadramou folded before Flop (didn't bet)
Seat 2: Filojoes folded before Flop (didn't bet)
Seat 4: matiko09 folded before Flop (didn't bet)
Seat 5: Prettyspitz mucked [Kc Kh]
Seat 6: Tirka folded before Flop (didn't bet)
Seat 7: ruslik_by (button) folded before Flop (didn't bet)
Seat 8: geiranger011 (small blind) folded before Flop
Seat 9: Foton18 (big blind) showed [Ks Js] and won ($38.13) with a flush, King high





PokerStars Hand #151944280292:  Hold'em No Limit ($0.50/$1.00 USD) - 2016/04/15 14:23:25 CET [2016/04/15 8:23:25 ET]
Table 'Adelgunde III' 9-max Seat #8 is the button
Seat 1: valimiu ($168.30 in chips) 
Seat 2: Vikulja1993 ($100 in chips) 
Seat 3: tipner ($116.58 in chips) 
Seat 4: hammerwife ($100 in chips) 
Seat 5: matiko09 ($128.78 in chips) 
Seat 6: Pominator92 ($116.01 in chips) 
Seat 8: SanychStar ($126.56 in chips) 
Seat 9: Kukuryzka ($122.01 in chips) 
Kukuryzka: posts small blind $0.50
valimiu: posts big blind $1
Filojoes: sits out 
*** HOLE CARDS ***
Dealt to matiko09 [As 7s]
Vikulja1993: folds 
tipner: folds 
hammerwife: raises $1.50 to $2.50
matiko09: folds 
Pominator92: folds 
SanychStar: folds 
Kukuryzka: folds 
valimiu: folds 
Uncalled bet ($1.50) returned to hammerwife
hammerwife collected $2.50 from pot
hammerwife: doesn't show hand 
*** SUMMARY ***
Total pot $2.50 | Rake $0 
Seat 1: valimiu (big blind) folded before Flop
Seat 2: Vikulja1993 folded before Flop (didn't bet)
Seat 3: tipner folded before Flop (didn't bet)
Seat 4: hammerwife collected ($2.50)
Seat 5: matiko09 folded before Flop (didn't bet)
Seat 6: Pominator92 folded before Flop (didn't bet)
Seat 8: SanychStar (button) folded before Flop (didn't bet)
Seat 9: Kukuryzka (small blind) folded before Flop





PokerStars Hand #151944287368:  Hold'em No Limit ($1/$2 USD) - 2016/04/15 14:23:38 CET [2016/04/15 8:23:38 ET]
Table 'Blaauw' 9-max Seat #5 is the button
Seat 1: myatiy 96 ($207.46 in chips) 
Seat 2: butcheN18 ($238.19 in chips) 
Seat 4: petro0107 ($244.29 in chips) 
Seat 5: tipner ($240.40 in chips) 
Seat 6: matiko09 ($288.90 in chips) 
Seat 7: ssljvr ($410.95 in chips) 
Seat 8: Iggso ($203 in chips) 
Seat 9: coinflip_si ($200 in chips) 
matiko09: posts small blind $1
ssljvr: posts big blind $2
Vikulja1993: sits out 
*** HOLE CARDS ***
Dealt to matiko09 [Jh 6h]
Iggso: folds 
coinflip_si: folds 
myatiy 96 is disconnected 
myatiy 96 has timed out while disconnected
myatiy 96: folds 
butcheN18: folds 
petro0107: calls $2
tipner: raises $6 to $8
matiko09: folds 
ssljvr: folds 
petro0107: calls $6
*** FLOP *** [5d 5s 7s]
petro0107: checks 
tipner: checks 
*** TURN *** [5d 5s 7s] [As]
petro0107: checks 
tipner: checks 
*** RIVER *** [5d 5s 7s As] [2s]
petro0107: bets $9.02
tipner: folds 
Uncalled bet ($9.02) returned to petro0107
petro0107 collected $18.05 from pot
petro0107: doesn't show hand 
*** SUMMARY ***
Total pot $19 | Rake $0.95 
Board [5d 5s 7s As 2s]
Seat 1: myatiy 96 folded before Flop (didn't bet)
Seat 2: butcheN18 folded before Flop (didn't bet)
Seat 4: petro0107 collected ($18.05)
Seat 5: tipner (button) folded on the River
Seat 6: matiko09 (small blind) folded before Flop
Seat 7: ssljvr (big blind) folded before Flop
Seat 8: Iggso folded before Flop (didn't bet)
Seat 9: coinflip_si folded before Flop (didn't bet)





PokerStars Hand #151944289065:  Hold'em No Limit ($0.50/$1.00 USD) - 2016/04/15 14:23:42 CET [2016/04/15 8:23:42 ET]
Table 'Chiny II' 9-max Seat #2 is the button
Seat 1: vrnMike ($143.06 in chips) 
Seat 2: Westpants ($122.99 in chips) 
Seat 3: Foton18 ($78.30 in chips) 
Seat 4: matiko09 ($171.44 in chips) 
Seat 5: omorfadramou ($171.62 in chips) 
Seat 6: choupai ($7.53 in chips) 
Seat 7: ruslik_by ($100 in chips) 
Seat 8: Filojoes ($176.15 in chips) 
Seat 9: butcheN18 ($105.50 in chips) 
Foton18: posts small blind $0.50
matiko09: posts big blind $1
*** HOLE CARDS ***
Dealt to matiko09 [Jc Ac]
omorfadramou: folds 
choupai: folds 
ruslik_by: folds 
Filojoes: folds 
butcheN18: raises $2 to $3
vrnMike: folds 
Westpants: folds 
Foton18: folds 
matiko09: calls $2
*** FLOP *** [Tc 3d 8h]
matiko09: checks 
butcheN18: bets $4
matiko09: calls $4
*** TURN *** [Tc 3d 8h] [6c]
matiko09: checks 
butcheN18: checks 
*** RIVER *** [Tc 3d 8h 6c] [Kd]
matiko09: checks 
butcheN18: bets $8.81
matiko09: raises $16.19 to $25
butcheN18: folds 
Uncalled bet ($16.19) returned to matiko09
matiko09 collected $30.51 from pot
matiko09: doesn't show hand 
*** SUMMARY ***
Total pot $32.12 | Rake $1.61 
Board [Tc 3d 8h 6c Kd]
Seat 1: vrnMike folded before Flop (didn't bet)
Seat 2: Westpants (button) folded before Flop (didn't bet)
Seat 3: Foton18 (small blind) folded before Flop
Seat 4: matiko09 (big blind) collected ($30.51)
Seat 5: omorfadramou folded before Flop (didn't bet)
Seat 6: choupai folded before Flop (didn't bet)
Seat 7: ruslik_by folded before Flop (didn't bet)
Seat 8: Filojoes folded before Flop (didn't bet)
Seat 9: butcheN18 folded on the River





PokerStars Hand #151944292607:  Hold'em No Limit ($0.50/$1.00 USD) - 2016/04/15 14:23:48 CET [2016/04/15 8:23:48 ET]
Table 'Parvulesco II' 9-max Seat #8 is the button
Seat 1: bilukm ($100 in chips) 
Seat 2: Filojoes ($107.22 in chips) 
Seat 3: matiko09 ($125.01 in chips) 
Seat 4: butcheN18 ($100 in chips) 
Seat 5: maxxmeister ($111.08 in chips) 
Seat 6: ruslik_by ($142.43 in chips) 
Seat 7: Kukuryzka ($142.78 in chips) 
Seat 8: Jimy Tiltman ($108.42 in chips) 
Seat 9: hammerwife ($208.03 in chips) 
hammerwife: posts small blind $0.50
bilukm: posts big blind $1
*** HOLE CARDS ***
Dealt to matiko09 [Qc 8c]
Filojoes: folds 
matiko09: folds 
butcheN18: folds 
maxxmeister: folds 
ruslik_by: folds 
Kukuryzka: raises $1.50 to $2.50
Jimy Tiltman: folds 
hammerwife: folds 
bilukm: calls $1.50
*** FLOP *** [8s As 3h]
bilukm: bets $2.61
Kukuryzka: folds 
Uncalled bet ($2.61) returned to bilukm
bilukm collected $5.22 from pot
bilukm: doesn't show hand 
*** SUMMARY ***
Total pot $5.50 | Rake $0.28 
Board [8s As 3h]
Seat 1: bilukm (big blind) collected ($5.22)
Seat 2: Filojoes folded before Flop (didn't bet)
Seat 3: matiko09 folded before Flop (didn't bet)
Seat 4: butcheN18 folded before Flop (didn't bet)
Seat 5: maxxmeister folded before Flop (didn't bet)
Seat 6: ruslik_by folded before Flop (didn't bet)
Seat 7: Kukuryzka folded on the Flop
Seat 8: Jimy Tiltman (button) folded before Flop (didn't bet)
Seat 9: hammerwife (small blind) folded before Flop





PokerStars Hand #151944294333:  Hold'em No Limit ($0.50/$1.00 USD) - 2016/04/15 14:23:52 CET [2016/04/15 8:23:52 ET]
Table 'Adelgunde III' 9-max Seat #9 is the button
Seat 1: valimiu ($167.30 in chips) 
Seat 2: Vikulja1993 ($100 in chips) 
Seat 3: tipner ($116.58 in chips) 
Seat 4: hammerwife ($101.50 in chips) 
Seat 5: matiko09 ($128.78 in chips) 
Seat 6: Pominator92 ($116.01 in chips) 
Seat 8: SanychStar ($126.56 in chips) 
Seat 9: Kukuryzka ($121.51 in chips) 
valimiu: posts small blind $0.50
Vikulja1993: posts big blind $1
Filojoes: sits out 
*** HOLE CARDS ***
Dealt to matiko09 [Qh 5c]
tipner: raises $2 to $3
hammerwife: folds 
matiko09: folds 
Pominator92: folds 
SanychStar: folds 
Kukuryzka: folds 
valimiu: folds 
Vikulja1993: folds 
Uncalled bet ($2) returned to tipner
tipner collected $2.50 from pot
tipner: doesn't show hand 
*** SUMMARY ***
Total pot $2.50 | Rake $0 
Seat 1: valimiu (small blind) folded before Flop
Seat 2: Vikulja1993 (big blind) folded before Flop
Seat 3: tipner collected ($2.50)
Seat 4: hammerwife folded before Flop (didn't bet)
Seat 5: matiko09 folded before Flop (didn't bet)
Seat 6: Pominator92 folded before Flop (didn't bet)
Seat 8: SanychStar folded before Flop (didn't bet)
Seat 9: Kukuryzka (button) folded before Flop (didn't bet)





PokerStars Hand #151944300690:  Hold'em No Limit ($1/$2 USD) - 2016/04/15 14:24:04 CET [2016/04/15 8:24:04 ET]
Table 'Marmara II' 9-max Seat #8 is the button
Seat 1: ssljvr ($488.98 in chips) 
Seat 2: Iggso ($200 in chips) 
Seat 3: Glushchenko ($200 in chips) 
Seat 4: Fish4trips ($241.96 in chips) 
Seat 5: docmarc777 ($417.85 in chips) 
Seat 6: azzad2007 ($218.10 in chips) 
Seat 7: matiko09 ($214.77 in chips) 
Seat 8: Dachish ($172.61 in chips) 
Seat 9: di0d80 ($217.15 in chips) 
di0d80: posts small blind $1
ssljvr: posts big blind $2
*** HOLE CARDS ***
Dealt to matiko09 [Th Qh]
Iggso: folds 
Glushchenko: folds 
Fish4trips: folds 
docmarc777: folds 
azzad2007: folds 
matiko09: raises $3 to $5
Dachish: raises $11 to $16
di0d80: folds 
ssljvr: folds 
matiko09: folds 
Uncalled bet ($11) returned to Dachish
Dachish collected $13 from pot
Dachish: doesn't show hand 
*** SUMMARY ***
Total pot $13 | Rake $0 
Seat 1: ssljvr (big blind) folded before Flop
Seat 2: Iggso folded before Flop (didn't bet)
Seat 3: Glushchenko folded before Flop (didn't bet)
Seat 4: Fish4trips folded before Flop (didn't bet)
Seat 5: docmarc777 folded before Flop (didn't bet)
Seat 6: azzad2007 folded before Flop (didn't bet)
Seat 7: matiko09 folded before Flop
Seat 8: Dachish (button) collected ($13)
Seat 9: di0d80 (small blind) folded before Flop





PokerStars Hand #151944305553:  Hold'em No Limit ($1/$2 USD) - 2016/04/15 14:24:13 CET [2016/04/15 8:24:13 ET]
Table 'Adele II' 9-max Seat #7 is the button
Seat 1: RyanHuJun ($326.26 in chips) 
Seat 2: Fish4trips ($335.85 in chips) 
Seat 3: matiko09 ($306.33 in chips) 
Seat 4: Glushchenko ($219.16 in chips) 
Seat 5: TonnaMunz ($200 in chips) 
Seat 6: Kukuryzka ($253.43 in chips) 
Seat 7: Iggso ($200 in chips) 
Seat 8: butcheN18 ($240.63 in chips) 
Seat 9: SanychStar ($271.60 in chips) 
butcheN18: posts small blind $1
SanychStar: posts big blind $2
*** HOLE CARDS ***
Dealt to matiko09 [6c Jh]
RyanHuJun: calls $2
Fish4trips: folds 
matiko09: folds 
Glushchenko: folds 
TonnaMunz: folds 
Kukuryzka: folds 
Iggso: folds 
butcheN18: raises $6.36 to $8.36
SanychStar: folds 
RyanHuJun: calls $6.36
*** FLOP *** [8d 8s As]
butcheN18: checks 
RyanHuJun: bets $8
butcheN18: calls $8
*** TURN *** [8d 8s As] [8h]
butcheN18: checks 
RyanHuJun: bets $10
butcheN18: folds 
Uncalled bet ($10) returned to RyanHuJun
RyanHuJun collected $32.98 from pot
RyanHuJun: doesn't show hand 
*** SUMMARY ***
Total pot $34.72 | Rake $1.74 
Board [8d 8s As 8h]
Seat 1: RyanHuJun collected ($32.98)
Seat 2: Fish4trips folded before Flop (didn't bet)
Seat 3: matiko09 folded before Flop (didn't bet)
Seat 4: Glushchenko folded before Flop (didn't bet)
Seat 5: TonnaMunz folded before Flop (didn't bet)
Seat 6: Kukuryzka folded before Flop (didn't bet)
Seat 7: Iggso (button) folded before Flop (didn't bet)
Seat 8: butcheN18 (small blind) folded on the Turn
Seat 9: SanychStar (big blind) folded before Flop





PokerStars Hand #151944307102:  Hold'em No Limit ($1/$2 USD) - 2016/04/15 14:24:16 CET [2016/04/15 8:24:16 ET]
Table 'Oceax' 9-max Seat #8 is the button
Seat 1: matiko09 ($200 in chips) 
Seat 3: Vikulja1993 ($200 in chips) 
Seat 4: butcheN18 ($327.71 in chips) 
Seat 5: derrocco82 ($200.83 in chips) 
Seat 6: Iggso ($286.17 in chips) 
Seat 7: ssljvr ($222.92 in chips) 
Seat 8: Poroxide ($344.57 in chips) 
Seat 9: tipner ($200 in chips) 
tipner: posts small blind $1
matiko09: posts big blind $2
TonnaMunz: sits out 
*** HOLE CARDS ***
Dealt to matiko09 [4h Jh]
Vikulja1993: folds 
butcheN18: folds 
derrocco82: folds 
Iggso: folds 
ssljvr: raises $4 to $6
Poroxide: folds 
tipner: raises $14 to $20
matiko09: folds 
ssljvr: calls $14
*** FLOP *** [7h Qd Js]
tipner: checks 
ssljvr: bets $20
tipner: folds 
Uncalled bet ($20) returned to ssljvr
ssljvr collected $39.90 from pot
ssljvr: doesn't show hand 
*** SUMMARY ***
Total pot $42 | Rake $2.10 
Board [7h Qd Js]
Seat 1: matiko09 (big blind) folded before Flop
Seat 3: Vikulja1993 folded before Flop (didn't bet)
Seat 4: butcheN18 folded before Flop (didn't bet)
Seat 5: derrocco82 folded before Flop (didn't bet)
Seat 6: Iggso folded before Flop (didn't bet)
Seat 7: ssljvr collected ($39.90)
Seat 8: Poroxide (button) folded before Flop (didn't bet)
Seat 9: tipner (small blind) folded on the Flop





PokerStars Hand #151944317036:  Hold'em No Limit ($0.50/$1.00 USD) - 2016/04/15 14:24:35 CET [2016/04/15 8:24:35 ET]
Table 'Emma II' 9-max Seat #8 is the button
Seat 1: omorfadramou ($114.78 in chips) 
Seat 2: Filojoes ($140.50 in chips) 
Seat 4: matiko09 ($100.50 in chips) 
Seat 5: Prettyspitz ($100 in chips) 
Seat 6: Tirka ($174.73 in chips) 
Seat 7: ruslik_by ($100 in chips) 
Seat 8: geiranger011 ($98.50 in chips) 
Seat 9: Foton18 ($133.90 in chips) 
Foton18: posts small blind $0.50
omorfadramou: posts big blind $1
*** HOLE CARDS ***
Dealt to matiko09 [Jh 5c]
Filojoes: folds 
matiko09: folds 
Prettyspitz: folds 
Tirka: folds 
ruslik_by: folds 
geiranger011: folds 
Foton18: raises $1 to $2
omorfadramou: folds 
Uncalled bet ($1) returned to Foton18
Foton18 collected $2 from pot
Foton18: doesn't show hand 
*** SUMMARY ***
Total pot $2 | Rake $0 
Seat 1: omorfadramou (big blind) folded before Flop
Seat 2: Filojoes folded before Flop (didn't bet)
Seat 4: matiko09 folded before Flop (didn't bet)
Seat 5: Prettyspitz folded before Flop (didn't bet)
Seat 6: Tirka folded before Flop (didn't bet)
Seat 7: ruslik_by folded before Flop (didn't bet)
Seat 8: geiranger011 (button) folded before Flop (didn't bet)
Seat 9: Foton18 (small blind) collected ($2)





PokerStars Hand #151944319202:  Hold'em No Limit ($0.50/$1.00 USD) - 2016/04/15 14:24:39 CET [2016/04/15 8:24:39 ET]
Table 'Parvulesco II' 9-max Seat #9 is the button
Seat 1: bilukm ($102.72 in chips) 
Seat 2: Filojoes ($107.22 in chips) 
Seat 3: matiko09 ($125.01 in chips) 
Seat 4: butcheN18 ($100 in chips) 
Seat 5: maxxmeister ($111.08 in chips) 
Seat 6: ruslik_by ($142.43 in chips) 
Seat 7: Kukuryzka ($140.28 in chips) 
Seat 8: Jimy Tiltman ($108.42 in chips) 
Seat 9: hammerwife ($207.53 in chips) 
bilukm: posts small blind $0.50
Filojoes: posts big blind $1
*** HOLE CARDS ***
Dealt to matiko09 [4d 5d]
matiko09: folds 
butcheN18: folds 
maxxmeister: folds 
ruslik_by: folds 
Kukuryzka: raises $2 to $3
Jimy Tiltman: calls $3
hammerwife: folds 
bilukm: folds 
Filojoes: raises $11 to $14
Kukuryzka: folds 
Jimy Tiltman: calls $11
*** FLOP *** [9c 2s Kc]
Filojoes: checks 
Jimy Tiltman: bets $14.96
Filojoes: raises $22.04 to $37
Jimy Tiltman: calls $22.04
*** TURN *** [9c 2s Kc] [3s]
Filojoes: bets $56.22 and is all-in
Jimy Tiltman: calls $56.22
*** FIRST RIVER *** [9c 2s Kc 3s] [3d]
*** SECOND RIVER *** [9c 2s Kc 3s] [6c]
*** FIRST SHOW DOWN ***
Filojoes: shows [Ks Kd] (a full house, Kings full of Threes)
Jimy Tiltman: shows [Kh Ac] (two pair, Kings and Threes)
Filojoes collected $107.72 from pot
*** SECOND SHOW DOWN ***
Filojoes: shows [Ks Kd] (three of a kind, Kings)
Jimy Tiltman: shows [Kh Ac] (a pair of Kings)
Filojoes collected $107.72 from pot
*** SUMMARY ***
Total pot $217.94 | Rake $2.50 
Hand was run twice
FIRST Board [9c 2s Kc 3s 3d]
SECOND Board [9c 2s Kc 3s 6c]
Seat 1: bilukm (small blind) folded before Flop
Seat 2: Filojoes (big blind) showed [Ks Kd] and won ($107.72) with a full house, Kings full of Threes, and won ($107.72) with three of a kind, Kings
Seat 3: matiko09 folded before Flop (didn't bet)
Seat 4: butcheN18 folded before Flop (didn't bet)
Seat 5: maxxmeister folded before Flop (didn't bet)
Seat 6: ruslik_by folded before Flop (didn't bet)
Seat 7: Kukuryzka folded before Flop
Seat 8: Jimy Tiltman showed [Kh Ac] and lost with two pair, Kings and Threes, and lost with a pair of Kings
Seat 9: hammerwife (button) folded before Flop (didn't bet)





PokerStars Hand #151944324306:  Hold'em No Limit ($0.50/$1.00 USD) - 2016/04/15 14:24:49 CET [2016/04/15 8:24:49 ET]
Table 'Adelgunde III' 9-max Seat #1 is the button
Seat 1: valimiu ($166.80 in chips) 
Seat 2: Vikulja1993 ($100 in chips) 
Seat 3: tipner ($118.08 in chips) 
Seat 4: hammerwife ($101.50 in chips) 
Seat 5: matiko09 ($128.78 in chips) 
Seat 6: Pominator92 ($116.01 in chips) 
Seat 8: SanychStar ($126.56 in chips) 
Seat 9: Kukuryzka ($121.51 in chips) 
Vikulja1993: posts small blind $0.50
tipner: posts big blind $1
Filojoes: sits out 
*** HOLE CARDS ***
Dealt to matiko09 [Tc Js]
hammerwife: folds 
matiko09: folds 
Pominator92: raises $1 to $2
SanychStar: folds 
Kukuryzka: folds 
valimiu: folds 
Vikulja1993: raises $5 to $7
tipner: folds 
Pominator92: raises $10 to $17
Vikulja1993: calls $10
*** FLOP *** [Qc Jd 8d]
Vikulja1993: checks 
Pominator92: bets $19
Vikulja1993: raises $19 to $38
Pominator92: raises $61.01 to $99.01 and is all-in
Vikulja1993: calls $45 and is all-in
Uncalled bet ($16.01) returned to Pominator92
*** TURN *** [Qc Jd 8d] [Qs]
*** RIVER *** [Qc Jd 8d Qs] [9h]
*** SHOW DOWN ***
Vikulja1993: shows [8s 8c] (a full house, Eights full of Queens)
Pominator92: shows [As Ac] (two pair, Aces and Queens)
Vikulja1993 collected $198.50 from pot
*** SUMMARY ***
Total pot $201 | Rake $2.50 
Board [Qc Jd 8d Qs 9h]
Seat 1: valimiu (button) folded before Flop (didn't bet)
Seat 2: Vikulja1993 (small blind) showed [8s 8c] and won ($198.50) with a full house, Eights full of Queens
Seat 3: tipner (big blind) folded before Flop
Seat 4: hammerwife folded before Flop (didn't bet)
Seat 5: matiko09 folded before Flop (didn't bet)
Seat 6: Pominator92 showed [As Ac] and lost with two pair, Aces and Queens
Seat 8: SanychStar folded before Flop (didn't bet)
Seat 9: Kukuryzka folded before Flop (didn't bet)





PokerStars Hand #151944328291:  Hold'em No Limit ($0.50/$1.00 USD) - 2016/04/15 14:24:56 CET [2016/04/15 8:24:56 ET]
Table 'Emma II' 9-max Seat #9 is the button
Seat 1: omorfadramou ($113.78 in chips) 
Seat 2: Filojoes ($140.50 in chips) 
Seat 4: matiko09 ($100.50 in chips) 
Seat 5: Prettyspitz ($100 in chips) 
Seat 6: Tirka ($174.73 in chips) 
Seat 7: ruslik_by ($100 in chips) 
Seat 8: geiranger011 ($98.50 in chips) 
Seat 9: Foton18 ($134.90 in chips) 
omorfadramou: posts small blind $0.50
Filojoes: posts big blind $1
*** HOLE CARDS ***
Dealt to matiko09 [Kh 5c]
matiko09: folds 
Prettyspitz: folds 
Tirka: folds 
ruslik_by: folds 
geiranger011: folds 
Foton18: raises $2 to $3
omorfadramou: folds 
Filojoes: folds 
Uncalled bet ($2) returned to Foton18
Foton18 collected $2.50 from pot
Foton18: doesn't show hand 
*** SUMMARY ***
Total pot $2.50 | Rake $0 
Seat 1: omorfadramou (small blind) folded before Flop
Seat 2: Filojoes (big blind) folded before Flop
Seat 4: matiko09 folded before Flop (didn't bet)
Seat 5: Prettyspitz folded before Flop (didn't bet)
Seat 6: Tirka folded before Flop (didn't bet)
Seat 7: ruslik_by folded before Flop (didn't bet)
Seat 8: geiranger011 folded before Flop (didn't bet)
Seat 9: Foton18 (button) collected ($2.50)





PokerStars Hand #151944331377:  Hold'em No Limit ($1/$2 USD) - 2016/04/15 14:25:02 CET [2016/04/15 8:25:02 ET]
Table 'Marmara II' 9-max Seat #9 is the button
Seat 1: ssljvr ($486.98 in chips) 
Seat 2: Iggso ($200 in chips) 
Seat 3: Glushchenko ($200 in chips) 
Seat 4: Fish4trips ($241.96 in chips) 
Seat 5: docmarc777 ($417.85 in chips) 
Seat 6: azzad2007 ($218.10 in chips) 
Seat 7: matiko09 ($209.77 in chips) 
Seat 8: Dachish ($180.61 in chips) 
Seat 9: di0d80 ($216.15 in chips) 
ssljvr: posts small blind $1
Iggso: posts big blind $2
*** HOLE CARDS ***
Dealt to matiko09 [9c Qd]
Glushchenko: folds 
Fish4trips: folds 
docmarc777: folds 
azzad2007: folds 
matiko09: folds 
Dachish: raises $2 to $4
di0d80: folds 
ssljvr: folds 
Iggso: calls $2
*** FLOP *** [Td 2c 8d]
Iggso: checks 
Dachish: checks 
*** TURN *** [Td 2c 8d] [As]
Iggso: checks 
Dachish: bets $6
Iggso: folds 
Uncalled bet ($6) returned to Dachish
Dachish collected $8.55 from pot
Dachish: doesn't show hand 
*** SUMMARY ***
Total pot $9 | Rake $0.45 
Board [Td 2c 8d As]
Seat 1: ssljvr (small blind) folded before Flop
Seat 2: Iggso (big blind) folded on the Turn
Seat 3: Glushchenko folded before Flop (didn't bet)
Seat 4: Fish4trips folded before Flop (didn't bet)
Seat 5: docmarc777 folded before Flop (didn't bet)
Seat 6: azzad2007 folded before Flop (didn't bet)
Seat 7: matiko09 folded before Flop (didn't bet)
Seat 8: Dachish collected ($8.55)
Seat 9: di0d80 (button) folded before Flop (didn't bet)





PokerStars Hand #151944337600:  Hold'em No Limit ($1/$2 USD) - 2016/04/15 14:25:14 CET [2016/04/15 8:25:14 ET]
Table 'Oceax' 9-max Seat #9 is the button
Seat 1: matiko09 ($200 in chips) 
Seat 2: TonnaMunz ($200 in chips) 
Seat 3: Vikulja1993 ($200 in chips) 
Seat 4: butcheN18 ($327.71 in chips) 
Seat 5: derrocco82 ($200.83 in chips) 
Seat 6: Iggso ($286.17 in chips) 
Seat 7: ssljvr ($242.82 in chips) 
Seat 8: Poroxide ($344.57 in chips) 
Seat 9: tipner ($200 in chips) 
matiko09: posts small blind $1
TonnaMunz: posts big blind $2
*** HOLE CARDS ***
Dealt to matiko09 [6s 4c]
Vikulja1993: folds 
butcheN18: raises $4 to $6
derrocco82: folds 
Iggso: folds 
ssljvr: folds 
Poroxide: folds 
tipner: folds 
matiko09: folds 
TonnaMunz: folds 
Uncalled bet ($4) returned to butcheN18
butcheN18 collected $5 from pot
butcheN18: doesn't show hand 
*** SUMMARY ***
Total pot $5 | Rake $0 
Seat 1: matiko09 (small blind) folded before Flop
Seat 2: TonnaMunz (big blind) folded before Flop
Seat 3: Vikulja1993 folded before Flop (didn't bet)
Seat 4: butcheN18 collected ($5)
Seat 5: derrocco82 folded before Flop (didn't bet)
Seat 6: Iggso folded before Flop (didn't bet)
Seat 7: ssljvr folded before Flop (didn't bet)
Seat 8: Poroxide folded before Flop (didn't bet)
Seat 9: tipner (button) folded before Flop (didn't bet)





PokerStars Hand #151944342677:  Hold'em No Limit ($1/$2 USD) - 2016/04/15 14:25:24 CET [2016/04/15 8:25:24 ET]
Table 'Blaauw' 9-max Seat #6 is the button
Seat 2: butcheN18 ($238.19 in chips) 
Seat 4: petro0107 ($254.34 in chips) 
Seat 5: tipner ($232.40 in chips) 
Seat 6: matiko09 ($287.90 in chips) 
Seat 7: ssljvr ($408.95 in chips) 
Seat 8: Iggso ($203 in chips) 
Seat 9: coinflip_si ($200 in chips) 
ssljvr: posts small blind $1
Iggso: posts big blind $2
Vikulja1993: sits out 
*** HOLE CARDS ***
Dealt to matiko09 [Kd 3c]
coinflip_si: folds 
butcheN18: raises $4 to $6
petro0107: folds 
tipner: folds 
matiko09: folds 
ssljvr: folds 
Iggso: folds 
Uncalled bet ($4) returned to butcheN18
butcheN18 collected $5 from pot
butcheN18: doesn't show hand 
*** SUMMARY ***
Total pot $5 | Rake $0 
Seat 2: butcheN18 collected ($5)
Seat 4: petro0107 folded before Flop (didn't bet)
Seat 5: tipner folded before Flop (didn't bet)
Seat 6: matiko09 (button) folded before Flop (didn't bet)
Seat 7: ssljvr (small blind) folded before Flop
Seat 8: Iggso (big blind) folded before Flop
Seat 9: coinflip_si folded before Flop (didn't bet)





PokerStars Hand #151944342721:  Hold'em No Limit ($0.50/$1.00 USD) - 2016/04/15 14:25:24 CET [2016/04/15 8:25:24 ET]
Table 'Emma II' 9-max Seat #1 is the button
Seat 1: omorfadramou ($113.28 in chips) 
Seat 2: Filojoes ($139.50 in chips) 
Seat 4: matiko09 ($100.50 in chips) 
Seat 5: Prettyspitz ($100 in chips) 
Seat 6: Tirka ($174.73 in chips) 
Seat 7: ruslik_by ($100 in chips) 
Seat 8: geiranger011 ($98.50 in chips) 
Seat 9: Foton18 ($136.40 in chips) 
Filojoes: posts small blind $0.50
matiko09: posts big blind $1
*** HOLE CARDS ***
Dealt to matiko09 [9s 5c]
Prettyspitz: folds 
Tirka: folds 
ruslik_by: folds 
geiranger011: folds 
Foton18: raises $1 to $2
omorfadramou: folds 
Filojoes: calls $1.50
matiko09: folds 
*** FLOP *** [Kd Kc Jc]
Filojoes: checks 
Foton18: bets $2
Filojoes: calls $2
*** TURN *** [Kd Kc Jc] [Td]
Filojoes: checks 
Foton18: checks 
*** RIVER *** [Kd Kc Jc Td] [As]
Filojoes: bets $5.13
Foton18: folds 
Uncalled bet ($5.13) returned to Filojoes
Filojoes collected $8.55 from pot
Filojoes: doesn't show hand 
*** SUMMARY ***
Total pot $9 | Rake $0.45 
Board [Kd Kc Jc Td As]
Seat 1: omorfadramou (button) folded before Flop (didn't bet)
Seat 2: Filojoes (small blind) collected ($8.55)
Seat 4: matiko09 (big blind) folded before Flop
Seat 5: Prettyspitz folded before Flop (didn't bet)
Seat 6: Tirka folded before Flop (didn't bet)
Seat 7: ruslik_by folded before Flop (didn't bet)
Seat 8: geiranger011 folded before Flop (didn't bet)
Seat 9: Foton18 folded on the River





PokerStars Hand #151944347036:  Hold'em No Limit ($1/$2 USD) - 2016/04/15 14:25:32 CET [2016/04/15 8:25:32 ET]
Table 'Adele II' 9-max Seat #8 is the button
Seat 1: RyanHuJun ($342.88 in chips) 
Seat 2: Fish4trips ($335.85 in chips) 
Seat 3: matiko09 ($306.33 in chips) 
Seat 5: TonnaMunz ($200 in chips) 
Seat 6: Kukuryzka ($253.43 in chips) 
Seat 7: Iggso ($200 in chips) 
Seat 8: butcheN18 ($224.27 in chips) 
Seat 9: SanychStar ($269.60 in chips) 
SanychStar: posts small blind $1
RyanHuJun: posts big blind $2
*** HOLE CARDS ***
Dealt to matiko09 [Td Qc]
Fish4trips: folds 
matiko09: folds 
TonnaMunz: raises $2.96 to $4.96
Kukuryzka: calls $4.96
Iggso: folds 
butcheN18: folds 
SanychStar: folds 
RyanHuJun: calls $2.96
*** FLOP *** [2h Js 9c]
Fish4trips leaves the table
RyanHuJun: checks 
TonnaMunz: bets $10
Kukuryzka: folds 
Durnichka joins the table at seat #2 
RyanHuJun: calls $10
*** TURN *** [2h Js 9c] [Qd]
RyanHuJun: checks 
TonnaMunz: checks 
*** RIVER *** [2h Js 9c Qd] [2c]
RyanHuJun: bets $20
TonnaMunz: folds 
Uncalled bet ($20) returned to RyanHuJun
RyanHuJun collected $34.09 from pot
RyanHuJun: doesn't show hand 
*** SUMMARY ***
Total pot $35.88 | Rake $1.79 
Board [2h Js 9c Qd 2c]
Seat 1: RyanHuJun (big blind) collected ($34.09)
Seat 2: Fish4trips folded before Flop (didn't bet)
Seat 3: matiko09 folded before Flop (didn't bet)
Seat 5: TonnaMunz folded on the River
Seat 6: Kukuryzka folded on the Flop
Seat 7: Iggso folded before Flop (didn't bet)
Seat 8: butcheN18 (button) folded before Flop (didn't bet)
Seat 9: SanychStar (small blind) folded before Flop





PokerStars Hand #151944347984:  Hold'em No Limit ($1/$2 USD) - 2016/04/15 14:25:33 CET [2016/04/15 8:25:33 ET]
Table 'Oceax' 9-max Seat #1 is the button
Seat 1: matiko09 ($200 in chips) 
Seat 2: TonnaMunz ($200 in chips) 
Seat 3: Vikulja1993 ($200 in chips) 
Seat 4: butcheN18 ($330.71 in chips) 
Seat 5: derrocco82 ($200.83 in chips) 
Seat 6: Iggso ($286.17 in chips) 
Seat 7: ssljvr ($242.82 in chips) 
Seat 8: Poroxide ($344.57 in chips) 
Seat 9: tipner ($200 in chips) 
TonnaMunz: posts small blind $1
Vikulja1993: posts big blind $2
*** HOLE CARDS ***
Dealt to matiko09 [Qd 4h]
butcheN18: folds 
derrocco82: folds 
Iggso: folds 
ssljvr: folds 
Poroxide: folds 
tipner: folds 
matiko09: folds 
TonnaMunz: raises $3.88 to $5.88
Vikulja1993: folds 
Uncalled bet ($3.88) returned to TonnaMunz
TonnaMunz collected $4 from pot
TonnaMunz: doesn't show hand 
*** SUMMARY ***
Total pot $4 | Rake $0 
Seat 1: matiko09 (button) folded before Flop (didn't bet)
Seat 2: TonnaMunz (small blind) collected ($4)
Seat 3: Vikulja1993 (big blind) folded before Flop
Seat 4: butcheN18 folded before Flop (didn't bet)
Seat 5: derrocco82 folded before Flop (didn't bet)
Seat 6: Iggso folded before Flop (didn't bet)
Seat 7: ssljvr folded before Flop (didn't bet)
Seat 8: Poroxide folded before Flop (didn't bet)
Seat 9: tipner folded before Flop (didn't bet)





PokerStars Hand #151944349298:  Hold'em No Limit ($0.50/$1.00 USD) - 2016/04/15 14:25:36 CET [2016/04/15 8:25:36 ET]
Table 'Chiny II' 9-max Seat #3 is the button
Seat 1: vrnMike ($143.06 in chips) 
Seat 2: Westpants ($122.99 in chips) 
Seat 3: Foton18 ($77.80 in chips) 
Seat 4: matiko09 ($186.14 in chips) 
Seat 5: omorfadramou ($171.62 in chips) 
Seat 6: choupai ($7.53 in chips) 
Seat 7: ruslik_by ($100 in chips) 
Seat 8: Filojoes ($176.15 in chips) 
Seat 9: butcheN18 ($100 in chips) 
matiko09: posts small blind $0.50
omorfadramou: posts big blind $1
*** HOLE CARDS ***
Dealt to matiko09 [9s Qc]
choupai has timed out
choupai: folds 
ruslik_by: folds 
Filojoes: folds 
butcheN18: raises $2 to $3
vrnMike: folds 
Westpants: folds 
Foton18: folds 
matiko09: folds 
omorfadramou: folds 
Uncalled bet ($2) returned to butcheN18
butcheN18 collected $2.50 from pot
butcheN18: doesn't show hand 
*** SUMMARY ***
Total pot $2.50 | Rake $0 
Seat 1: vrnMike folded before Flop (didn't bet)
Seat 2: Westpants folded before Flop (didn't bet)
Seat 3: Foton18 (button) folded before Flop (didn't bet)
Seat 4: matiko09 (small blind) folded before Flop
Seat 5: omorfadramou (big blind) folded before Flop
Seat 6: choupai folded before Flop (didn't bet)
Seat 7: ruslik_by folded before Flop (didn't bet)
Seat 8: Filojoes folded before Flop (didn't bet)
Seat 9: butcheN18 collected ($2.50)





PokerStars Hand #151944352092:  Hold'em No Limit ($1/$2 USD) - 2016/04/15 14:25:41 CET [2016/04/15 8:25:41 ET]
Table 'Blaauw' 9-max Seat #7 is the button
Seat 2: butcheN18 ($241.19 in chips) 
Seat 4: petro0107 ($254.34 in chips) 
Seat 5: tipner ($232.40 in chips) 
Seat 6: matiko09 ($287.90 in chips) 
Seat 7: ssljvr ($407.95 in chips) 
Seat 8: Iggso ($201 in chips) 
Seat 9: coinflip_si ($200 in chips) 
Iggso: posts small blind $1
coinflip_si: posts big blind $2
Vikulja1993: sits out 
*** HOLE CARDS ***
Dealt to matiko09 [3h Qs]
butcheN18: folds 
petro0107: calls $2
tipner: folds 
matiko09: folds 
ssljvr: folds 
Iggso: raises $7 to $9
coinflip_si: folds 
petro0107: calls $7
*** FLOP *** [Tc 7s 6h]
Iggso: bets $14.25
petro0107: folds 
Uncalled bet ($14.25) returned to Iggso
Iggso collected $19 from pot
Iggso: doesn't show hand 
*** SUMMARY ***
Total pot $20 | Rake $1 
Board [Tc 7s 6h]
Seat 2: butcheN18 folded before Flop (didn't bet)
Seat 4: petro0107 folded on the Flop
Seat 5: tipner folded before Flop (didn't bet)
Seat 6: matiko09 folded before Flop (didn't bet)
Seat 7: ssljvr (button) folded before Flop (didn't bet)
Seat 8: Iggso (small blind) collected ($19)
Seat 9: coinflip_si (big blind) folded before Flop





PokerStars Hand #151944355768:  Hold'em No Limit ($1/$2 USD) - 2016/04/15 14:25:48 CET [2016/04/15 8:25:48 ET]
Table 'Marmara II' 9-max Seat #1 is the button
Seat 1: ssljvr ($485.98 in chips) 
Seat 2: Iggso ($200 in chips) 
Seat 4: Fish4trips ($241.96 in chips) 
Seat 5: docmarc777 ($417.85 in chips) 
Seat 6: azzad2007 ($218.10 in chips) 
Seat 7: matiko09 ($209.77 in chips) 
Seat 8: Dachish ($185.16 in chips) 
Seat 9: di0d80 ($216.15 in chips) 
Iggso: posts small blind $1
Fish4trips: posts big blind $2
*** HOLE CARDS ***
Dealt to matiko09 [7s 8c]
docmarc777: raises $2 to $4
azzad2007: folds 
matiko09: folds 
Dachish: folds 
di0d80: folds 
ssljvr: folds 
Iggso: calls $3
Fish4trips: folds 
*** FLOP *** [8d Td 5d]
Fish4trips leaves the table
derrocco82 joins the table at seat #4 
Iggso: checks 
docmarc777: bets $6
Iggso: folds 
Uncalled bet ($6) returned to docmarc777
docmarc777 collected $9.50 from pot
*** SUMMARY ***
Total pot $10 | Rake $0.50 
Board [8d Td 5d]
Seat 1: ssljvr (button) folded before Flop (didn't bet)
Seat 2: Iggso (small blind) folded on the Flop
Seat 4: Fish4trips (big blind) folded before Flop
Seat 5: docmarc777 collected ($9.50)
Seat 6: azzad2007 folded before Flop (didn't bet)
Seat 7: matiko09 folded before Flop (didn't bet)
Seat 8: Dachish folded before Flop (didn't bet)
Seat 9: di0d80 folded before Flop (didn't bet)





PokerStars Hand #151944359527:  Hold'em No Limit ($0.50/$1.00 USD) - 2016/04/15 14:25:55 CET [2016/04/15 8:25:55 ET]
Table 'Adelgunde III' 9-max Seat #2 is the button
Seat 1: valimiu ($166.80 in chips) 
Seat 2: Vikulja1993 ($198.50 in chips) 
Seat 3: tipner ($117.08 in chips) 
Seat 4: hammerwife ($101.50 in chips) 
Seat 5: matiko09 ($128.78 in chips) 
Seat 6: Pominator92 ($16.01 in chips) 
Seat 8: SanychStar ($126.56 in chips) 
Seat 9: Kukuryzka ($121.51 in chips) 
tipner: posts small blind $0.50
hammerwife: posts big blind $1
Filojoes: sits out 
*** HOLE CARDS ***
Dealt to matiko09 [7d 7s]
matiko09: raises $2 to $3
Pominator92 said, "sick"
Pominator92: raises $13.01 to $16.01 and is all-in
Vikulja1993 said, "ty"
SanychStar: folds 
Kukuryzka: folds 
valimiu: folds 
Vikulja1993: folds 
tipner: folds 
hammerwife: calls $15.01
matiko09: calls $13.01
*** FLOP *** [3c 4h 4c]
hammerwife: bets $15
matiko09: calls $15
*** TURN *** [3c 4h 4c] [8c]
hammerwife: checks 
matiko09: checks 
*** RIVER *** [3c 4h 4c 8c] [Jd]
hammerwife: checks 
matiko09: bets $41
hammerwife: folds 
Uncalled bet ($41) returned to matiko09
*** SHOW DOWN ***
matiko09: shows [7d 7s] (two pair, Sevens and Fours)
matiko09 collected $29.93 from side pot
Pominator92: mucks hand 
matiko09 collected $46.10 from main pot
*** SUMMARY ***
Total pot $78.53 Main pot $46.10. Side pot $29.93. | Rake $2.50 
Board [3c 4h 4c 8c Jd]
Seat 1: valimiu folded before Flop (didn't bet)
Seat 2: Vikulja1993 (button) folded before Flop (didn't bet)
Seat 3: tipner (small blind) folded before Flop
Seat 4: hammerwife (big blind) folded on the River
Seat 5: matiko09 showed [7d 7s] and won ($76.03) with two pair, Sevens and Fours
Seat 6: Pominator92 mucked [3h 6c]
Seat 8: SanychStar folded before Flop (didn't bet)
Seat 9: Kukuryzka folded before Flop (didn't bet)





PokerStars Hand #151944360283:  Hold'em No Limit ($1/$2 USD) - 2016/04/15 14:25:57 CET [2016/04/15 8:25:57 ET]
Table 'Oceax' 9-max Seat #2 is the button
Seat 1: matiko09 ($200 in chips) 
Seat 2: TonnaMunz ($202 in chips) 
Seat 3: Vikulja1993 ($200 in chips) 
Seat 5: derrocco82 ($200.83 in chips) 
Seat 6: Iggso ($286.17 in chips) 
Seat 7: ssljvr ($242.82 in chips) 
Seat 8: Poroxide ($344.57 in chips) 
Seat 9: tipner ($200 in chips) 
Vikulja1993: posts small blind $1
butcheN18: is sitting out 
derrocco82: posts big blind $2
*** HOLE CARDS ***
Dealt to matiko09 [Th Ts]
butcheN18 leaves the table
Iggso: folds 
ssljvr: folds 
Poroxide: folds 
tipner: folds 
matiko09: raises $3 to $5
13Ghosts joins the table at seat #4 
TonnaMunz: calls $5
Vikulja1993: folds 
derrocco82: calls $3
*** FLOP *** [Kd Jh 6s]
derrocco82: checks 
matiko09: checks 
TonnaMunz: checks 
*** TURN *** [Kd Jh 6s] [Ah]
derrocco82: checks 
matiko09: checks 
TonnaMunz: checks 
*** RIVER *** [Kd Jh 6s Ah] [6c]
derrocco82: bets $8
matiko09: folds 
TonnaMunz: folds 
Uncalled bet ($8) returned to derrocco82
derrocco82 collected $15.20 from pot
derrocco82: doesn't show hand 
*** SUMMARY ***
Total pot $16 | Rake $0.80 
Board [Kd Jh 6s Ah 6c]
Seat 1: matiko09 folded on the River
Seat 2: TonnaMunz (button) folded on the River
Seat 3: Vikulja1993 (small blind) folded before Flop
Seat 5: derrocco82 (big blind) collected ($15.20)
Seat 6: Iggso folded before Flop (didn't bet)
Seat 7: ssljvr folded before Flop (didn't bet)
Seat 8: Poroxide folded before Flop (didn't bet)
Seat 9: tipner folded before Flop (didn't bet)





PokerStars Hand #151944376174:  Hold'em No Limit ($0.50/$1.00 USD) - 2016/04/15 14:26:27 CET [2016/04/15 8:26:27 ET]
Table 'Chiny II' 9-max Seat #4 is the button
Seat 1: vrnMike ($143.06 in chips) 
Seat 2: Westpants ($122.99 in chips) 
Seat 3: Foton18 ($77.80 in chips) 
Seat 4: matiko09 ($185.64 in chips) 
Seat 5: omorfadramou ($170.62 in chips) 
Seat 7: ruslik_by ($100 in chips) 
Seat 8: Filojoes ($176.15 in chips) 
Seat 9: butcheN18 ($101.50 in chips) 
omorfadramou: posts small blind $0.50
ruslik_by: posts big blind $1
*** HOLE CARDS ***
Dealt to matiko09 [6d 4c]
Filojoes: folds 
butcheN18: folds 
vrnMike: folds 
Westpants: folds 
Foton18: folds 
matiko09: folds 
omorfadramou: folds 
Uncalled bet ($0.50) returned to ruslik_by
ruslik_by collected $1 from pot
ruslik_by: doesn't show hand 
*** SUMMARY ***
Total pot $1 | Rake $0 
Seat 1: vrnMike folded before Flop (didn't bet)
Seat 2: Westpants folded before Flop (didn't bet)
Seat 3: Foton18 folded before Flop (didn't bet)
Seat 4: matiko09 (button) folded before Flop (didn't bet)
Seat 5: omorfadramou (small blind) folded before Flop
Seat 7: ruslik_by (big blind) collected ($1)
Seat 8: Filojoes folded before Flop (didn't bet)
Seat 9: butcheN18 folded before Flop (didn't bet)





PokerStars Hand #151944378374:  Hold'em No Limit ($1/$2 USD) - 2016/04/15 14:26:31 CET [2016/04/15 8:26:31 ET]
Table 'Blaauw' 9-max Seat #8 is the button
Seat 2: butcheN18 ($241.19 in chips) 
Seat 4: petro0107 ($245.34 in chips) 
Seat 5: tipner ($232.40 in chips) 
Seat 6: matiko09 ($287.90 in chips) 
Seat 7: ssljvr ($407.95 in chips) 
Seat 8: Iggso ($211 in chips) 
Seat 9: coinflip_si ($200 in chips) 
coinflip_si: posts small blind $1
butcheN18: posts big blind $2
Vikulja1993: sits out 
*** HOLE CARDS ***
Dealt to matiko09 [Ks Qc]
petro0107: folds 
tipner: folds 
matiko09: raises $3 to $5
ssljvr: folds 
Iggso: raises $13.26 to $18.26
coinflip_si: folds 
butcheN18: folds 
matiko09: folds 
Uncalled bet ($13.26) returned to Iggso
Iggso collected $13 from pot
Iggso: doesn't show hand 
*** SUMMARY ***
Total pot $13 | Rake $0 
Seat 2: butcheN18 (big blind) folded before Flop
Seat 4: petro0107 folded before Flop (didn't bet)
Seat 5: tipner folded before Flop (didn't bet)
Seat 6: matiko09 folded before Flop
Seat 7: ssljvr folded before Flop (didn't bet)
Seat 8: Iggso (button) collected ($13)
Seat 9: coinflip_si (small blind) folded before Flop





PokerStars Hand #151944380305:  Hold'em No Limit ($0.50/$1.00 USD) - 2016/04/15 14:26:34 CET [2016/04/15 8:26:34 ET]
Table 'Emma II' 9-max Seat #2 is the button
Seat 1: omorfadramou ($113.28 in chips) 
Seat 2: Filojoes ($144.05 in chips) 
Seat 4: matiko09 ($100 in chips) 
Seat 5: Prettyspitz ($100 in chips) 
Seat 6: Tirka ($174.73 in chips) 
Seat 7: ruslik_by ($100 in chips) 
Seat 8: geiranger011 ($98.50 in chips) 
Seat 9: Foton18 ($132.40 in chips) 
matiko09: posts small blind $0.50
Prettyspitz: posts big blind $1
*** HOLE CARDS ***
Dealt to matiko09 [9d 3h]
Tirka: folds 
ruslik_by: folds 
geiranger011: calls $1
Foton18: calls $1
omorfadramou: folds 
Filojoes: folds 
matiko09: folds 
Prettyspitz: checks 
*** FLOP *** [Js 2s As]
Prettyspitz: checks 
geiranger011: bets $1.66
Foton18: raises $3.34 to $5
Prettyspitz: folds 
geiranger011: calls $3.34
*** TURN *** [Js 2s As] [3c]
geiranger011: checks 
Foton18: bets $11
geiranger011: calls $11
*** RIVER *** [Js 2s As 3c] [Kh]
geiranger011: checks 
Foton18: bets $34
geiranger011: calls $34
*** SHOW DOWN ***
Foton18: shows [9s 7s] (a flush, Ace high)
geiranger011: mucks hand 
Foton18 collected $101 from pot
*** SUMMARY ***
Total pot $103.50 | Rake $2.50 
Board [Js 2s As 3c Kh]
Seat 1: omorfadramou folded before Flop (didn't bet)
Seat 2: Filojoes (button) folded before Flop (didn't bet)
Seat 4: matiko09 (small blind) folded before Flop
Seat 5: Prettyspitz (big blind) folded on the Flop
Seat 6: Tirka folded before Flop (didn't bet)
Seat 7: ruslik_by folded before Flop (didn't bet)
Seat 8: geiranger011 mucked [Ks Jd]
Seat 9: Foton18 showed [9s 7s] and won ($101) with a flush, Ace high





PokerStars Hand #151944382325:  Hold'em No Limit ($1/$2 USD) - 2016/04/15 14:26:38 CET [2016/04/15 8:26:38 ET]
Table 'Marmara II' 9-max Seat #2 is the button
Seat 1: ssljvr ($485.98 in chips) 
Seat 2: Iggso ($200 in chips) 
Seat 5: docmarc777 ($423.35 in chips) 
Seat 6: azzad2007 ($218.10 in chips) 
Seat 7: matiko09 ($209.77 in chips) 
Seat 8: Dachish ($185.16 in chips) 
Seat 9: di0d80 ($216.15 in chips) 
derrocco82 will be allowed to play after the button
docmarc777: posts small blind $1
azzad2007: posts big blind $2
*** HOLE CARDS ***
Dealt to matiko09 [Jc Ad]
matiko09: raises $3 to $5
Dachish: folds 
di0d80: folds 
ssljvr: folds 
Iggso: folds 
docmarc777: calls $4
azzad2007: folds 
*** FLOP *** [Js As Qd]
docmarc777: checks 
matiko09: bets $8
docmarc777: raises $8 to $16
matiko09: calls $8
*** TURN *** [Js As Qd] [2h]
docmarc777: bets $26
azzad2007 leaves the table
matiko09: calls $26
*** RIVER *** [Js As Qd 2h] [3h]
docmarc777: bets $46
matiko09: calls $46
*** SHOW DOWN ***
docmarc777: shows [Ts Ks] (a straight, Ten to Ace)
matiko09: mucks hand 
docmarc777 collected $185.25 from pot
*** SUMMARY ***
Total pot $188 | Rake $2.75 
Board [Js As Qd 2h 3h]
Seat 1: ssljvr folded before Flop (didn't bet)
Seat 2: Iggso (button) folded before Flop (didn't bet)
Seat 5: docmarc777 (small blind) showed [Ts Ks] and won ($185.25) with a straight, Ten to Ace
Seat 6: azzad2007 (big blind) folded before Flop
Seat 7: matiko09 mucked [Jc Ad]
Seat 8: Dachish folded before Flop (didn't bet)
Seat 9: di0d80 folded before Flop (didn't bet)





