PokerStars Hand #151164582163:  Hold'em No Limit ($1/$2 USD) - 2016/03/30 16:18:49 CET [2016/03/30 10:18:49 ET]
Table 'Jole' 9-max Seat #4 is the button
Seat 1: matiko09 ($200 in chips) 
Seat 2: RamiroAgujis ($286.91 in chips) 
Seat 3: chenconhaste ($215.65 in chips) 
Seat 4: volwebni4ek ($87.66 in chips) 
Seat 5: dunga119 ($219.02 in chips) 
Seat 6: King_ZéManel ($234.34 in chips) 
Seat 7: ilaviiitech ($223.05 in chips) 
Seat 9: Ravnica11 ($80 in chips) 
dunga119: posts small blind $1
King_ZéManel: posts big blind $2
*** HOLE CARDS ***
Dealt to matiko09 [Jh 9d]
ilaviiitech: folds 
Ravnica11: folds 
matiko09: folds 
RamiroAgujis: folds 
chenconhaste: folds 
volwebni4ek: raises $2 to $4
dunga119: folds 
King_ZéManel: folds 
Uncalled bet ($2) returned to volwebni4ek
volwebni4ek collected $5 from pot
volwebni4ek: doesn't show hand 
*** SUMMARY ***
Total pot $5 | Rake $0 
Seat 1: matiko09 folded before Flop (didn't bet)
Seat 2: RamiroAgujis folded before Flop (didn't bet)
Seat 3: chenconhaste folded before Flop (didn't bet)
Seat 4: volwebni4ek (button) collected ($5)
Seat 5: dunga119 (small blind) folded before Flop
Seat 6: King_ZéManel (big blind) folded before Flop
Seat 7: ilaviiitech folded before Flop (didn't bet)
Seat 9: Ravnica11 folded before Flop (didn't bet)





PokerStars Hand #151164590411:  Hold'em No Limit ($0.50/$1.00 USD) - 2016/03/30 16:19:02 CET [2016/03/30 10:19:02 ET]
Table 'Amata II' 9-max Seat #5 is the button
Seat 2: ilaviiitech ($100 in chips) 
Seat 3: matiko09 ($185.23 in chips) 
Seat 4: lumen21 ($106.06 in chips) 
Seat 5: Spid1 ($100 in chips) 
Seat 6: RamiroAgujis ($118.53 in chips) 
Seat 7: Pvsx. ($196.51 in chips) 
Seat 8: chenconhaste ($181.99 in chips) 
Seat 9: kaya.ertugrul88 ($136.70 in chips) 
RamiroAgujis: posts small blind $0.50
Pvsx.: posts big blind $1
*** HOLE CARDS ***
Dealt to matiko09 [7h 2d]
chenconhaste: folds 
kaya.ertugrul88: raises $1 to $2
ilaviiitech: folds 
matiko09: folds 
lumen21: folds 
Spid1: folds 
RamiroAgujis: folds 
Pvsx.: folds 
Uncalled bet ($1) returned to kaya.ertugrul88
kaya.ertugrul88 collected $2.50 from pot
kaya.ertugrul88: doesn't show hand 
*** SUMMARY ***
Total pot $2.50 | Rake $0 
Seat 2: ilaviiitech folded before Flop (didn't bet)
Seat 3: matiko09 folded before Flop (didn't bet)
Seat 4: lumen21 folded before Flop (didn't bet)
Seat 5: Spid1 (button) folded before Flop (didn't bet)
Seat 6: RamiroAgujis (small blind) folded before Flop
Seat 7: Pvsx. (big blind) folded before Flop
Seat 8: chenconhaste folded before Flop (didn't bet)
Seat 9: kaya.ertugrul88 collected ($2.50)





PokerStars Hand #151164594631:  Hold'em No Limit ($1/$2 USD) - 2016/03/30 16:19:08 CET [2016/03/30 10:19:08 ET]
Table 'Philoctetes II' 9-max Seat #8 is the button
Seat 1: vezunchik79 ($129.93 in chips) 
Seat 2: prominente ($200 in chips) 
Seat 5: zhaimeng ($362.36 in chips) 
Seat 7: matiko09 ($200 in chips) 
Seat 8: suddend3ath ($200 in chips) 
Seat 9: RamiroAgujis ($228.25 in chips) 
RamiroAgujis: posts small blind $1
vezunchik79: posts big blind $2
tepi_guy: sits out 
*** HOLE CARDS ***
Dealt to matiko09 [7s 5c]
prominente: folds 
zhaimeng: calls $2
matiko09: folds 
suddend3ath: folds 
RamiroAgujis: folds 
vezunchik79: checks 
*** FLOP *** [5s 6c 6h]
vezunchik79: checks 
zhaimeng: checks 
*** TURN *** [5s 6c 6h] [Qh]
vezunchik79: checks 
zhaimeng: checks 
*** RIVER *** [5s 6c 6h Qh] [8s]
vezunchik79: checks 
mentalpshyco joins the table at seat #3 
zhaimeng: bets $4.75
vezunchik79: folds 
Uncalled bet ($4.75) returned to zhaimeng
zhaimeng collected $4.75 from pot
*** SUMMARY ***
Total pot $5 | Rake $0.25 
Board [5s 6c 6h Qh 8s]
Seat 1: vezunchik79 (big blind) folded on the River
Seat 2: prominente folded before Flop (didn't bet)
Seat 5: zhaimeng collected ($4.75)
Seat 7: matiko09 folded before Flop (didn't bet)
Seat 8: suddend3ath (button) folded before Flop (didn't bet)
Seat 9: RamiroAgujis (small blind) folded before Flop





PokerStars Hand #151164603414:  Hold'em No Limit ($1/$2 USD) - 2016/03/30 16:19:21 CET [2016/03/30 10:19:21 ET]
Table 'Jole' 9-max Seat #5 is the button
Seat 1: matiko09 ($200 in chips) 
Seat 2: RamiroAgujis ($286.91 in chips) 
Seat 3: chenconhaste ($215.65 in chips) 
Seat 4: volwebni4ek ($90.66 in chips) 
Seat 5: dunga119 ($218.02 in chips) 
Seat 6: King_ZéManel ($232.34 in chips) 
Seat 7: ilaviiitech ($223.05 in chips) 
Seat 9: Ravnica11 ($80 in chips) 
King_ZéManel: posts small blind $1
ilaviiitech: posts big blind $2
*** HOLE CARDS ***
Dealt to matiko09 [Ks Th]
Ravnica11: folds 
matiko09: folds 
RamiroAgujis: folds 
chenconhaste: folds 
volwebni4ek: folds 
dunga119: calls $2
King_ZéManel: raises $6 to $8
ilaviiitech: folds 
dunga119: raises $8 to $16
King_ZéManel: calls $8
*** FLOP *** [5c Ad 6h]
King_ZéManel: checks 
dunga119: checks 
*** TURN *** [5c Ad 6h] [4h]
King_ZéManel: checks 
dunga119: checks 
*** RIVER *** [5c Ad 6h 4h] [7h]
King_ZéManel: bets $24.22
dunga119: calls $24.22
*** SHOW DOWN ***
King_ZéManel: shows [7c 7d] (three of a kind, Sevens)
dunga119: shows [8c 8h] (a straight, Four to Eight)
dunga119 collected $79.69 from pot
*** SUMMARY ***
Total pot $82.44 | Rake $2.75 
Board [5c Ad 6h 4h 7h]
Seat 1: matiko09 folded before Flop (didn't bet)
Seat 2: RamiroAgujis folded before Flop (didn't bet)
Seat 3: chenconhaste folded before Flop (didn't bet)
Seat 4: volwebni4ek folded before Flop (didn't bet)
Seat 5: dunga119 (button) showed [8c 8h] and won ($79.69) with a straight, Four to Eight
Seat 6: King_ZéManel (small blind) showed [7c 7d] and lost with three of a kind, Sevens
Seat 7: ilaviiitech (big blind) folded before Flop
Seat 9: Ravnica11 folded before Flop (didn't bet)





PokerStars Hand #151164606158:  Hold'em No Limit ($1/$2 USD) - 2016/03/30 16:19:25 CET [2016/03/30 10:19:25 ET]
Table 'Hektor III' 9-max Seat #2 is the button
Seat 1: matiko09 ($200 in chips) 
Seat 2: RamiroAgujis ($306.45 in chips) 
Seat 3: T0ny Adams ($81.64 in chips) 
Seat 4: volwebni4ek ($99.75 in chips) 
Seat 5: prominente ($269.75 in chips) 
Seat 7: InsomniaRU ($226.04 in chips) 
Seat 8: ki11u ($244.15 in chips) 
Seat 9: fonng ($335.49 in chips) 
T0ny Adams: posts small blind $1
volwebni4ek: posts big blind $2
*** HOLE CARDS ***
Dealt to matiko09 [Qs 7d]
prominente: raises $3 to $5
InsomniaRU: folds 
ki11u: folds 
fonng: folds 
matiko09: folds 
RamiroAgujis: folds 
T0ny Adams: folds 
volwebni4ek: folds 
Uncalled bet ($3) returned to prominente
prominente collected $5 from pot
prominente: doesn't show hand 
*** SUMMARY ***
Total pot $5 | Rake $0 
Seat 1: matiko09 folded before Flop (didn't bet)
Seat 2: RamiroAgujis (button) folded before Flop (didn't bet)
Seat 3: T0ny Adams (small blind) folded before Flop
Seat 4: volwebni4ek (big blind) folded before Flop
Seat 5: prominente collected ($5)
Seat 7: InsomniaRU folded before Flop (didn't bet)
Seat 8: ki11u folded before Flop (didn't bet)
Seat 9: fonng folded before Flop (didn't bet)





PokerStars Hand #151164606344:  Hold'em No Limit ($1/$2 USD) - 2016/03/30 16:19:26 CET [2016/03/30 10:19:26 ET]
Table 'Tabit III' 9-max Seat #5 is the button
Seat 1: RamiroAgujis ($206.40 in chips) 
Seat 3: prominente ($212.20 in chips) 
Seat 4: matiko09 ($226.54 in chips) 
Seat 5: itaik1 ($91.06 in chips) 
Seat 6: King_ZéManel ($200 in chips) 
Seat 7: ilaviiitech ($202 in chips) 
Seat 8: ki11u ($218.07 in chips) 
Seat 9: suddend3ath ($200 in chips) 
King_ZéManel: posts small blind $1
ilaviiitech: posts big blind $2
tepi_guy: sits out 
*** HOLE CARDS ***
Dealt to matiko09 [2c 8s]
ki11u: folds 
suddend3ath: folds 
RamiroAgujis: folds 
prominente: raises $3 to $5
matiko09: folds 
itaik1: folds 
King_ZéManel: folds 
ilaviiitech: folds 
Uncalled bet ($3) returned to prominente
prominente collected $5 from pot
prominente: doesn't show hand 
*** SUMMARY ***
Total pot $5 | Rake $0 
Seat 1: RamiroAgujis folded before Flop (didn't bet)
Seat 3: prominente collected ($5)
Seat 4: matiko09 folded before Flop (didn't bet)
Seat 5: itaik1 (button) folded before Flop (didn't bet)
Seat 6: King_ZéManel (small blind) folded before Flop
Seat 7: ilaviiitech (big blind) folded before Flop
Seat 8: ki11u folded before Flop (didn't bet)
Seat 9: suddend3ath folded before Flop (didn't bet)





PokerStars Hand #151164607063:  Hold'em No Limit ($0.50/$1.00 USD) - 2016/03/30 16:19:27 CET [2016/03/30 10:19:27 ET]
Table 'Amata II' 9-max Seat #6 is the button
Seat 2: ilaviiitech ($100 in chips) 
Seat 3: matiko09 ($185.23 in chips) 
Seat 4: lumen21 ($106.06 in chips) 
Seat 5: Spid1 ($100 in chips) 
Seat 6: RamiroAgujis ($118.03 in chips) 
Seat 7: Pvsx. ($195.51 in chips) 
Seat 9: kaya.ertugrul88 ($138.20 in chips) 
Pvsx.: posts small blind $0.50
chenconhaste: is sitting out 
kaya.ertugrul88: posts big blind $1
*** HOLE CARDS ***
Dealt to matiko09 [Ad Qc]
chenconhaste leaves the table
ilaviiitech: raises $2 to $3
matiko09: calls $3
lumen21: folds 
Spid1: folds 
RamiroAgujis: folds 
Pvsx.: folds 
kaya.ertugrul88: calls $2
*** FLOP *** [4d Qd Kc]
kaya.ertugrul88: checks 
ilaviiitech: checks 
matiko09: checks 
*** TURN *** [4d Qd Kc] [Qh]
kaya.ertugrul88: checks 
ilaviiitech: checks 
matiko09: bets $7
kaya.ertugrul88: folds 
ilaviiitech: folds 
Uncalled bet ($7) returned to matiko09
matiko09 collected $9.02 from pot
matiko09: doesn't show hand 
*** SUMMARY ***
Total pot $9.50 | Rake $0.48 
Board [4d Qd Kc Qh]
Seat 2: ilaviiitech folded on the Turn
Seat 3: matiko09 collected ($9.02)
Seat 4: lumen21 folded before Flop (didn't bet)
Seat 5: Spid1 folded before Flop (didn't bet)
Seat 6: RamiroAgujis (button) folded before Flop (didn't bet)
Seat 7: Pvsx. (small blind) folded before Flop
Seat 9: kaya.ertugrul88 (big blind) folded on the Turn





PokerStars Hand #151164608020:  Hold'em No Limit ($1/$2 USD) - 2016/03/30 16:19:28 CET [2016/03/30 10:19:28 ET]
Table 'Aesculapia II' 9-max Seat #4 is the button
Seat 1: buthmen ($343.78 in chips) 
Seat 2: suddend3ath ($200 in chips) 
Seat 3: matiko09 ($293.49 in chips) 
Seat 4: ki11u ($434.29 in chips) 
Seat 5: prominente ($211.42 in chips) 
Seat 7: Rumboni66 ($117.49 in chips) 
Seat 9: InsomniaRU ($208 in chips) 
prominente: posts small blind $1
CapnDobro: is sitting out 
Rumboni66: posts big blind $2
*** HOLE CARDS ***
Dealt to matiko09 [5h 2c]
InsomniaRU: folds 
buthmen: folds 
suddend3ath: folds 
matiko09: folds 
ki11u: folds 
CapnDobro leaves the table
prominente: raises $3 to $5
Rumboni66: raises $5 to $10
prominente: folds 
Uncalled bet ($5) returned to Rumboni66
Rumboni66 collected $10 from pot
Rumboni66: doesn't show hand 
*** SUMMARY ***
Total pot $10 | Rake $0 
Seat 1: buthmen folded before Flop (didn't bet)
Seat 2: suddend3ath folded before Flop (didn't bet)
Seat 3: matiko09 folded before Flop (didn't bet)
Seat 4: ki11u (button) folded before Flop (didn't bet)
Seat 5: prominente (small blind) folded before Flop
Seat 7: Rumboni66 (big blind) collected ($10)
Seat 9: InsomniaRU folded before Flop (didn't bet)





PokerStars Hand #151164611360:  Hold'em No Limit ($1/$2 USD) - 2016/03/30 16:19:33 CET [2016/03/30 10:19:33 ET]
Table 'Tydeus III' 9-max Seat #6 is the button
Seat 1: InsomniaRU ($226.25 in chips) 
Seat 2: RamiroAgujis ($209.55 in chips) 
Seat 4: T0ny Adams ($83.40 in chips) 
Seat 5: suddend3ath ($227.45 in chips) 
Seat 6: prominente ($200 in chips) 
Seat 7: matiko09 ($200 in chips) 
Seat 9: velourleder ($125.25 in chips) 
matiko09: posts small blind $1
velourleder: posts big blind $2
*** HOLE CARDS ***
Dealt to matiko09 [7h 9h]
InsomniaRU: folds 
RamiroAgujis: folds 
T0ny Adams: folds 
suddend3ath: folds 
prominente: raises $2 to $4
matiko09: folds 
velourleder: raises $6 to $10
prominente: folds 
Uncalled bet ($6) returned to velourleder
velourleder collected $9 from pot
*** SUMMARY ***
Total pot $9 | Rake $0 
Seat 1: InsomniaRU folded before Flop (didn't bet)
Seat 2: RamiroAgujis folded before Flop (didn't bet)
Seat 4: T0ny Adams folded before Flop (didn't bet)
Seat 5: suddend3ath folded before Flop (didn't bet)
Seat 6: prominente (button) folded before Flop
Seat 7: matiko09 (small blind) folded before Flop
Seat 9: velourleder (big blind) collected ($9)





PokerStars Hand #151164614328:  Hold'em No Limit ($0.50/$1.00 USD) - 2016/03/30 16:19:38 CET [2016/03/30 10:19:38 ET]
Table 'Figneria III' 9-max Seat #9 is the button
Seat 1: matiko09 ($100 in chips) 
Seat 2: sanpidk ($100 in chips) 
Seat 3: lumen21 ($117.45 in chips) 
Seat 4: CI58 ($100 in chips) 
Seat 5: chenconhaste ($111.14 in chips) 
Seat 7: holloway85 ($156.44 in chips) 
Seat 8: Dachish ($70 in chips) 
Seat 9: p.snow89 ($81.05 in chips) 
matiko09: posts small blind $0.50
sanpidk: posts big blind $1
*** HOLE CARDS ***
Dealt to matiko09 [6s 8h]
lumen21: folds 
CI58: folds 
chenconhaste: folds 
holloway85: folds 
Dachish: folds 
p.snow89: raises $3 to $4
matiko09: folds 
sanpidk: folds 
Uncalled bet ($3) returned to p.snow89
p.snow89 collected $2.50 from pot
*** SUMMARY ***
Total pot $2.50 | Rake $0 
Seat 1: matiko09 (small blind) folded before Flop
Seat 2: sanpidk (big blind) folded before Flop
Seat 3: lumen21 folded before Flop (didn't bet)
Seat 4: CI58 folded before Flop (didn't bet)
Seat 5: chenconhaste folded before Flop (didn't bet)
Seat 7: holloway85 folded before Flop (didn't bet)
Seat 8: Dachish folded before Flop (didn't bet)
Seat 9: p.snow89 (button) collected ($2.50)





PokerStars Hand #151164623736:  Hold'em No Limit ($0.50/$1.00 USD) - 2016/03/30 16:19:51 CET [2016/03/30 10:19:51 ET]
Table 'Pannonia II' 9-max Seat #9 is the button
Seat 1: CI58 ($100 in chips) 
Seat 2: matiko09 ($103.26 in chips) 
Seat 3: MGL_Sky99 ($106.50 in chips) 
Seat 5: Spid1 ($126.87 in chips) 
Seat 6: lumen21 ($113 in chips) 
Seat 7: volwebni4ek ($42.75 in chips) 
Seat 8: stonymalony ($44.92 in chips) 
Seat 9: b_____a__242 ($88.89 in chips) 
CI58: posts small blind $0.50
matiko09: posts big blind $1
*** HOLE CARDS ***
Dealt to matiko09 [7h 3d]
MGL_Sky99: folds 
Spid1: folds 
lumen21: folds 
volwebni4ek: folds 
stonymalony: raises $1 to $2
b_____a__242: folds 
CI58: folds 
matiko09: folds 
Uncalled bet ($1) returned to stonymalony
stonymalony collected $2.50 from pot
stonymalony: doesn't show hand 
*** SUMMARY ***
Total pot $2.50 | Rake $0 
Seat 1: CI58 (small blind) folded before Flop
Seat 2: matiko09 (big blind) folded before Flop
Seat 3: MGL_Sky99 folded before Flop (didn't bet)
Seat 5: Spid1 folded before Flop (didn't bet)
Seat 6: lumen21 folded before Flop (didn't bet)
Seat 7: volwebni4ek folded before Flop (didn't bet)
Seat 8: stonymalony collected ($2.50)
Seat 9: b_____a__242 (button) folded before Flop (didn't bet)





PokerStars Hand #151164624028:  Hold'em No Limit ($1/$2 USD) - 2016/03/30 16:19:52 CET [2016/03/30 10:19:52 ET]
Table 'Aesculapia II' 9-max Seat #5 is the button
Seat 1: buthmen ($343.78 in chips) 
Seat 2: suddend3ath ($200 in chips) 
Seat 3: matiko09 ($293.49 in chips) 
Seat 4: ki11u ($434.29 in chips) 
Seat 5: prominente ($206.42 in chips) 
Seat 7: Rumboni66 ($122.49 in chips) 
Seat 9: InsomniaRU ($208 in chips) 
Rumboni66: posts small blind $1
InsomniaRU: posts big blind $2
*** HOLE CARDS ***
Dealt to matiko09 [9d Jd]
buthmen: folds 
suddend3ath: folds 
matiko09: raises $3 to $5
ki11u: folds 
prominente: folds 
Rumboni66: folds 
InsomniaRU: calls $3
*** FLOP *** [5c 8h 2h]
InsomniaRU: checks 
matiko09: checks 
*** TURN *** [5c 8h 2h] [Th]
volwebni4ek joins the table at seat #6 
InsomniaRU: bets $7
matiko09: calls $7
*** RIVER *** [5c 8h 2h Th] [8d]
InsomniaRU: bets $15.91
matiko09: folds 
Uncalled bet ($15.91) returned to InsomniaRU
InsomniaRU collected $23.75 from pot
InsomniaRU: doesn't show hand 
*** SUMMARY ***
Total pot $25 | Rake $1.25 
Board [5c 8h 2h Th 8d]
Seat 1: buthmen folded before Flop (didn't bet)
Seat 2: suddend3ath folded before Flop (didn't bet)
Seat 3: matiko09 folded on the River
Seat 4: ki11u folded before Flop (didn't bet)
Seat 5: prominente (button) folded before Flop (didn't bet)
Seat 7: Rumboni66 (small blind) folded before Flop
Seat 9: InsomniaRU (big blind) collected ($23.75)





PokerStars Hand #151164625151:  Hold'em No Limit ($1/$2 USD) - 2016/03/30 16:19:53 CET [2016/03/30 10:19:53 ET]
Table 'Tabit III' 9-max Seat #6 is the button
Seat 1: RamiroAgujis ($206.40 in chips) 
Seat 3: prominente ($215.20 in chips) 
Seat 4: matiko09 ($226.54 in chips) 
Seat 5: itaik1 ($91.06 in chips) 
Seat 6: King_ZéManel ($200 in chips) 
Seat 7: ilaviiitech ($200 in chips) 
Seat 9: suddend3ath ($200 in chips) 
ilaviiitech: posts small blind $1
ki11u: is sitting out 
suddend3ath: posts big blind $2
tepi_guy: sits out 
*** HOLE CARDS ***
Dealt to matiko09 [6d Ts]
ki11u leaves the table
RamiroAgujis: folds 
prominente: folds 
matiko09: folds 
itaik1: folds 
King_ZéManel: folds 
ilaviiitech: raises $4 to $6
suddend3ath: folds 
Uncalled bet ($4) returned to ilaviiitech
ilaviiitech collected $4 from pot
ilaviiitech: doesn't show hand 
*** SUMMARY ***
Total pot $4 | Rake $0 
Seat 1: RamiroAgujis folded before Flop (didn't bet)
Seat 3: prominente folded before Flop (didn't bet)
Seat 4: matiko09 folded before Flop (didn't bet)
Seat 5: itaik1 folded before Flop (didn't bet)
Seat 6: King_ZéManel (button) folded before Flop (didn't bet)
Seat 7: ilaviiitech (small blind) collected ($4)
Seat 9: suddend3ath (big blind) folded before Flop





PokerStars Hand #151164625386:  Hold'em No Limit ($1/$2 USD) - 2016/03/30 16:19:54 CET [2016/03/30 10:19:54 ET]
Table 'Hektor III' 9-max Seat #3 is the button
Seat 1: matiko09 ($200 in chips) 
Seat 2: RamiroAgujis ($306.45 in chips) 
Seat 3: T0ny Adams ($80.64 in chips) 
Seat 4: volwebni4ek ($97.75 in chips) 
Seat 5: prominente ($272.75 in chips) 
Seat 7: InsomniaRU ($226.04 in chips) 
Seat 8: ki11u ($244.15 in chips) 
Seat 9: fonng ($335.49 in chips) 
volwebni4ek: posts small blind $1
prominente: posts big blind $2
*** HOLE CARDS ***
Dealt to matiko09 [5c 2s]
InsomniaRU: folds 
ki11u: folds 
fonng: raises $2 to $4
matiko09: folds 
RamiroAgujis: folds 
T0ny Adams: folds 
volwebni4ek: folds 
prominente: folds 
Uncalled bet ($2) returned to fonng
fonng collected $5 from pot
fonng: doesn't show hand 
*** SUMMARY ***
Total pot $5 | Rake $0 
Seat 1: matiko09 folded before Flop (didn't bet)
Seat 2: RamiroAgujis folded before Flop (didn't bet)
Seat 3: T0ny Adams (button) folded before Flop (didn't bet)
Seat 4: volwebni4ek (small blind) folded before Flop
Seat 5: prominente (big blind) folded before Flop
Seat 7: InsomniaRU folded before Flop (didn't bet)
Seat 8: ki11u folded before Flop (didn't bet)
Seat 9: fonng collected ($5)





PokerStars Hand #151164627508:  Hold'em No Limit ($1/$2 USD) - 2016/03/30 16:19:57 CET [2016/03/30 10:19:57 ET]
Table 'Philoctetes II' 9-max Seat #9 is the button
Seat 1: vezunchik79 ($127.93 in chips) 
Seat 2: prominente ($200 in chips) 
Seat 5: zhaimeng ($365.11 in chips) 
Seat 7: matiko09 ($200 in chips) 
Seat 8: suddend3ath ($200 in chips) 
Seat 9: RamiroAgujis ($227.25 in chips) 
vezunchik79: posts small blind $1
prominente: posts big blind $2
mentalpshyco: sits out 
tepi_guy: sits out 
*** HOLE CARDS ***
Dealt to matiko09 [9h 3d]
zhaimeng: calls $2
matiko09: folds 
suddend3ath: folds 
RamiroAgujis: raises $6 to $8
vezunchik79: folds 
prominente: folds 
zhaimeng: calls $6
*** FLOP *** [Qc 2h Jd]
zhaimeng: checks 
RamiroAgujis: bets $12
zhaimeng: folds 
Uncalled bet ($12) returned to RamiroAgujis
RamiroAgujis collected $18.05 from pot
RamiroAgujis: doesn't show hand 
*** SUMMARY ***
Total pot $19 | Rake $0.95 
Board [Qc 2h Jd]
Seat 1: vezunchik79 (small blind) folded before Flop
Seat 2: prominente (big blind) folded before Flop
Seat 5: zhaimeng folded on the Flop
Seat 7: matiko09 folded before Flop (didn't bet)
Seat 8: suddend3ath folded before Flop (didn't bet)
Seat 9: RamiroAgujis (button) collected ($18.05)





PokerStars Hand #151164628089:  Hold'em No Limit ($1/$2 USD) - 2016/03/30 16:19:58 CET [2016/03/30 10:19:58 ET]
Table 'Tydeus III' 9-max Seat #7 is the button
Seat 1: InsomniaRU ($226.25 in chips) 
Seat 2: RamiroAgujis ($209.55 in chips) 
Seat 4: T0ny Adams ($83.40 in chips) 
Seat 5: suddend3ath ($227.45 in chips) 
Seat 6: prominente ($200 in chips) 
Seat 7: matiko09 ($200 in chips) 
Seat 9: velourleder ($130.25 in chips) 
velourleder: posts small blind $1
InsomniaRU: posts big blind $2
*** HOLE CARDS ***
Dealt to matiko09 [8h 7c]
RamiroAgujis: folds 
T0ny Adams: raises $3 to $5
suddend3ath: folds 
prominente: folds 
matiko09: folds 
velourleder: folds 
InsomniaRU: folds 
Uncalled bet ($3) returned to T0ny Adams
tepi_guy joins the table at seat #8 
T0ny Adams collected $5 from pot
T0ny Adams: doesn't show hand 
*** SUMMARY ***
Total pot $5 | Rake $0 
Seat 1: InsomniaRU (big blind) folded before Flop
Seat 2: RamiroAgujis folded before Flop (didn't bet)
Seat 4: T0ny Adams collected ($5)
Seat 5: suddend3ath folded before Flop (didn't bet)
Seat 6: prominente folded before Flop (didn't bet)
Seat 7: matiko09 (button) folded before Flop (didn't bet)
Seat 9: velourleder (small blind) folded before Flop





PokerStars Hand #151164636859:  Hold'em No Limit ($0.50/$1.00 USD) - 2016/03/30 16:20:11 CET [2016/03/30 10:20:11 ET]
Table 'Alcor II' 9-max Seat #9 is the button
Seat 1: Red4erT ($116.12 in chips) 
Seat 2: holloway85 ($87.28 in chips) 
Seat 3: mitchymitch3 ($98.41 in chips) 
Seat 5: elbiber2000 ($104.12 in chips) 
Seat 6: godfrey004 ($141.15 in chips) 
Seat 7: sanpidk ($105.21 in chips) 
Seat 8: cdv1984 ($100 in chips) 
Seat 9: matiko09 ($197.24 in chips) 
Red4erT: posts small blind $0.50
holloway85: posts big blind $1
*** HOLE CARDS ***
Dealt to matiko09 [Qh Js]
mitchymitch3: folds 
elbiber2000: folds 
godfrey004: folds 
sanpidk: folds 
cdv1984: folds 
matiko09: raises $1.27 to $2.27
Red4erT: folds 
holloway85: calls $1.27
*** FLOP *** [As 2d Jd]
holloway85: bets $2.39
matiko09: calls $2.39
*** TURN *** [As 2d Jd] [Ad]
holloway85: checks 
matiko09: checks 
*** RIVER *** [As 2d Jd Ad] [6s]
holloway85: bets $4.66
matiko09: calls $4.66
*** SHOW DOWN ***
holloway85: shows [9d 5s] (a pair of Aces)
matiko09: shows [Qh Js] (two pair, Aces and Jacks)
matiko09 collected $18.18 from pot
*** SUMMARY ***
Total pot $19.14 | Rake $0.96 
Board [As 2d Jd Ad 6s]
Seat 1: Red4erT (small blind) folded before Flop
Seat 2: holloway85 (big blind) showed [9d 5s] and lost with a pair of Aces
Seat 3: mitchymitch3 folded before Flop (didn't bet)
Seat 5: elbiber2000 folded before Flop (didn't bet)
Seat 6: godfrey004 folded before Flop (didn't bet)
Seat 7: sanpidk folded before Flop (didn't bet)
Seat 8: cdv1984 folded before Flop (didn't bet)
Seat 9: matiko09 (button) showed [Qh Js] and won ($18.18) with two pair, Aces and Jacks





PokerStars Hand #151164641093:  Hold'em No Limit ($1/$2 USD) - 2016/03/30 16:20:18 CET [2016/03/30 10:20:18 ET]
Table 'Jole' 9-max Seat #6 is the button
Seat 1: matiko09 ($200 in chips) 
Seat 2: RamiroAgujis ($286.91 in chips) 
Seat 3: chenconhaste ($215.65 in chips) 
Seat 4: volwebni4ek ($90.66 in chips) 
Seat 5: dunga119 ($257.49 in chips) 
Seat 6: King_ZéManel ($200 in chips) 
Seat 7: ilaviiitech ($221.05 in chips) 
Seat 9: Ravnica11 ($80 in chips) 
ilaviiitech: posts small blind $1
Ravnica11: posts big blind $2
*** HOLE CARDS ***
Dealt to matiko09 [Kc 9h]
matiko09: folds 
RamiroAgujis: raises $5 to $7
chenconhaste: folds 
volwebni4ek: folds 
dunga119: calls $7
King_ZéManel: folds 
ilaviiitech: folds 
Ravnica11: folds 
*** FLOP *** [2d 3d Td]
RamiroAgujis: bets $13
dunga119: calls $13
*** TURN *** [2d 3d Td] [6c]
RamiroAgujis: bets $38
dunga119: folds 
Uncalled bet ($38) returned to RamiroAgujis
RamiroAgujis collected $40.85 from pot
RamiroAgujis: doesn't show hand 
*** SUMMARY ***
Total pot $43 | Rake $2.15 
Board [2d 3d Td 6c]
Seat 1: matiko09 folded before Flop (didn't bet)
Seat 2: RamiroAgujis collected ($40.85)
Seat 3: chenconhaste folded before Flop (didn't bet)
Seat 4: volwebni4ek folded before Flop (didn't bet)
Seat 5: dunga119 folded on the Turn
Seat 6: King_ZéManel (button) folded before Flop (didn't bet)
Seat 7: ilaviiitech (small blind) folded before Flop
Seat 9: Ravnica11 (big blind) folded before Flop





PokerStars Hand #151164644396:  Hold'em No Limit ($1/$2 USD) - 2016/03/30 16:20:22 CET [2016/03/30 10:20:22 ET]
Table 'Tabit III' 9-max Seat #7 is the button
Seat 1: RamiroAgujis ($206.40 in chips) 
Seat 3: prominente ($215.20 in chips) 
Seat 4: matiko09 ($226.54 in chips) 
Seat 5: itaik1 ($91.06 in chips) 
Seat 6: King_ZéManel ($200 in chips) 
Seat 7: ilaviiitech ($202 in chips) 
Seat 9: suddend3ath ($200 in chips) 
suddend3ath: posts small blind $1
RamiroAgujis: posts big blind $2
tepi_guy: sits out 
*** HOLE CARDS ***
Dealt to matiko09 [8h 8c]
prominente: folds 
matiko09: raises $3 to $5
itaik1: folds 
King_ZéManel: folds 
ilaviiitech: folds 
suddend3ath: folds 
RamiroAgujis: folds 
Uncalled bet ($3) returned to matiko09
matiko09 collected $5 from pot
matiko09: doesn't show hand 
*** SUMMARY ***
Total pot $5 | Rake $0 
Seat 1: RamiroAgujis (big blind) folded before Flop
Seat 3: prominente folded before Flop (didn't bet)
Seat 4: matiko09 collected ($5)
Seat 5: itaik1 folded before Flop (didn't bet)
Seat 6: King_ZéManel folded before Flop (didn't bet)
Seat 7: ilaviiitech (button) folded before Flop (didn't bet)
Seat 9: suddend3ath (small blind) folded before Flop





PokerStars Hand #151164647105:  Hold'em No Limit ($0.50/$1.00 USD) - 2016/03/30 16:20:26 CET [2016/03/30 10:20:26 ET]
Table 'Figneria III' 9-max Seat #1 is the button
Seat 1: matiko09 ($100 in chips) 
Seat 2: sanpidk ($100 in chips) 
Seat 4: CI58 ($100 in chips) 
Seat 5: chenconhaste ($111.14 in chips) 
Seat 7: holloway85 ($156.44 in chips) 
Seat 8: Dachish ($70 in chips) 
Seat 9: p.snow89 ($82.55 in chips) 
sanpidk: posts small blind $0.50
lumen21: is sitting out 
CI58: posts big blind $1
*** HOLE CARDS ***
Dealt to matiko09 [8h Qd]
chenconhaste: folds 
holloway85: folds 
Dachish: folds 
p.snow89: raises $3 to $4
matiko09: folds 
sanpidk: folds 
CI58: folds 
Uncalled bet ($3) returned to p.snow89
p.snow89 collected $2.50 from pot
p.snow89: doesn't show hand 
*** SUMMARY ***
Total pot $2.50 | Rake $0 
Seat 1: matiko09 (button) folded before Flop (didn't bet)
Seat 2: sanpidk (small blind) folded before Flop
Seat 4: CI58 (big blind) folded before Flop
Seat 5: chenconhaste folded before Flop (didn't bet)
Seat 7: holloway85 folded before Flop (didn't bet)
Seat 8: Dachish folded before Flop (didn't bet)
Seat 9: p.snow89 collected ($2.50)





PokerStars Hand #151164649249:  Hold'em No Limit ($1/$2 USD) - 2016/03/30 16:20:30 CET [2016/03/30 10:20:30 ET]
Table 'Tydeus III' 9-max Seat #9 is the button
Seat 1: InsomniaRU ($224.25 in chips) 
Seat 2: RamiroAgujis ($209.55 in chips) 
Seat 4: T0ny Adams ($86.40 in chips) 
Seat 5: suddend3ath ($227.45 in chips) 
Seat 6: prominente ($200 in chips) 
Seat 7: matiko09 ($200 in chips) 
Seat 9: velourleder ($129.25 in chips) 
InsomniaRU: posts small blind $1
RamiroAgujis: posts big blind $2
tepi_guy: sits out 
*** HOLE CARDS ***
Dealt to matiko09 [2h 5c]
T0ny Adams: raises $3 to $5
suddend3ath: calls $5
prominente: folds 
matiko09: folds 
velourleder: folds 
InsomniaRU: folds 
RamiroAgujis: folds 
*** FLOP *** [7d 8d 4s]
T0ny Adams: bets $4.19
suddend3ath: calls $4.19
*** TURN *** [7d 8d 4s] [6d]
T0ny Adams: bets $14
suddend3ath: calls $14
*** RIVER *** [7d 8d 4s 6d] [Qd]
T0ny Adams: checks 
suddend3ath: checks 
*** SHOW DOWN ***
T0ny Adams: shows [6h 6s] (three of a kind, Sixes)
suddend3ath: shows [9d 9h] (a flush, Queen high)
suddend3ath collected $46.91 from pot
*** SUMMARY ***
Total pot $49.38 | Rake $2.47 
Board [7d 8d 4s 6d Qd]
Seat 1: InsomniaRU (small blind) folded before Flop
Seat 2: RamiroAgujis (big blind) folded before Flop
Seat 4: T0ny Adams showed [6h 6s] and lost with three of a kind, Sixes
Seat 5: suddend3ath showed [9d 9h] and won ($46.91) with a flush, Queen high
Seat 6: prominente folded before Flop (didn't bet)
Seat 7: matiko09 folded before Flop (didn't bet)
Seat 9: velourleder (button) folded before Flop (didn't bet)





PokerStars Hand #151164652070:  Hold'em No Limit ($0.50/$1.00 USD) - 2016/03/30 16:20:34 CET [2016/03/30 10:20:34 ET]
Table 'Amata II' 9-max Seat #7 is the button
Seat 2: ilaviiitech ($100 in chips) 
Seat 3: matiko09 ($191.25 in chips) 
Seat 4: lumen21 ($106.06 in chips) 
Seat 5: Spid1 ($100 in chips) 
Seat 6: RamiroAgujis ($118.03 in chips) 
Seat 7: Pvsx. ($195.01 in chips) 
Seat 9: kaya.ertugrul88 ($135.20 in chips) 
kaya.ertugrul88: posts small blind $0.50
ilaviiitech: posts big blind $1
*** HOLE CARDS ***
Dealt to matiko09 [Th Ac]
matiko09: raises $2 to $3
lumen21: folds 
Spid1: folds 
sanpidk joins the table at seat #8 
RamiroAgujis: folds 
Pvsx.: folds 
sanpidk leaves the table
ka100pka527 joins the table at seat #8 
kaya.ertugrul88: calls $2.50
ilaviiitech: raises $11 to $14
matiko09: folds 
kaya.ertugrul88: calls $11
*** FLOP *** [9d 6c 2c]
kaya.ertugrul88: checks 
ilaviiitech: bets $16.50
kaya.ertugrul88: folds 
Uncalled bet ($16.50) returned to ilaviiitech
ilaviiitech collected $29.45 from pot
ilaviiitech: doesn't show hand 
*** SUMMARY ***
Total pot $31 | Rake $1.55 
Board [9d 6c 2c]
Seat 2: ilaviiitech (big blind) collected ($29.45)
Seat 3: matiko09 folded before Flop
Seat 4: lumen21 folded before Flop (didn't bet)
Seat 5: Spid1 folded before Flop (didn't bet)
Seat 6: RamiroAgujis folded before Flop (didn't bet)
Seat 7: Pvsx. (button) folded before Flop (didn't bet)
Seat 9: kaya.ertugrul88 (small blind) folded on the Flop





PokerStars Hand #151164658863:  Hold'em No Limit ($0.50/$1.00 USD) - 2016/03/30 16:20:44 CET [2016/03/30 10:20:44 ET]
Table 'Pannonia II' 9-max Seat #1 is the button
Seat 1: CI58 ($100 in chips) 
Seat 2: matiko09 ($102.26 in chips) 
Seat 3: MGL_Sky99 ($106.50 in chips) 
Seat 5: Spid1 ($126.87 in chips) 
Seat 6: lumen21 ($113 in chips) 
Seat 7: volwebni4ek ($42.75 in chips) 
Seat 8: stonymalony ($46.42 in chips) 
Seat 9: b_____a__242 ($88.89 in chips) 
matiko09: posts small blind $0.50
MGL_Sky99: posts big blind $1
*** HOLE CARDS ***
Dealt to matiko09 [7s Td]
Spid1: folds 
lumen21: folds 
volwebni4ek: folds 
stonymalony: raises $2 to $3
b_____a__242: folds 
CI58: folds 
matiko09: folds 
MGL_Sky99: folds 
Uncalled bet ($2) returned to stonymalony
stonymalony collected $2.50 from pot
stonymalony: doesn't show hand 
*** SUMMARY ***
Total pot $2.50 | Rake $0 
Seat 1: CI58 (button) folded before Flop (didn't bet)
Seat 2: matiko09 (small blind) folded before Flop
Seat 3: MGL_Sky99 (big blind) folded before Flop
Seat 5: Spid1 folded before Flop (didn't bet)
Seat 6: lumen21 folded before Flop (didn't bet)
Seat 7: volwebni4ek folded before Flop (didn't bet)
Seat 8: stonymalony collected ($2.50)
Seat 9: b_____a__242 folded before Flop (didn't bet)





PokerStars Hand #151164665024:  Hold'em No Limit ($1/$2 USD) - 2016/03/30 16:20:54 CET [2016/03/30 10:20:54 ET]
Table 'Tabit III' 9-max Seat #9 is the button
Seat 1: RamiroAgujis ($204.40 in chips) 
Seat 2: tepi_guy ($200 in chips) 
Seat 3: prominente ($215.20 in chips) 
Seat 4: matiko09 ($229.54 in chips) 
Seat 5: itaik1 ($91.06 in chips) 
Seat 6: King_ZéManel ($200 in chips) 
Seat 7: ilaviiitech ($202 in chips) 
Seat 9: suddend3ath ($200 in chips) 
RamiroAgujis: posts small blind $1
tepi_guy: posts big blind $2
*** HOLE CARDS ***
Dealt to matiko09 [Ts 3d]
prominente: folds 
matiko09: folds 
itaik1: raises $4 to $6
King_ZéManel: folds 
ilaviiitech: folds 
mentalpshyco joins the table at seat #8 
suddend3ath: folds 
RamiroAgujis: folds 
tepi_guy: folds 
Uncalled bet ($4) returned to itaik1
itaik1 collected $5 from pot
itaik1: doesn't show hand 
*** SUMMARY ***
Total pot $5 | Rake $0 
Seat 1: RamiroAgujis (small blind) folded before Flop
Seat 2: tepi_guy (big blind) folded before Flop
Seat 3: prominente folded before Flop (didn't bet)
Seat 4: matiko09 folded before Flop (didn't bet)
Seat 5: itaik1 collected ($5)
Seat 6: King_ZéManel folded before Flop (didn't bet)
Seat 7: ilaviiitech folded before Flop (didn't bet)
Seat 9: suddend3ath (button) folded before Flop (didn't bet)





PokerStars Hand #151164667638:  Hold'em No Limit ($1/$2 USD) - 2016/03/30 16:20:57 CET [2016/03/30 10:20:57 ET]
Table 'Hektor III' 9-max Seat #4 is the button
Seat 1: matiko09 ($200 in chips) 
Seat 2: RamiroAgujis ($306.45 in chips) 
Seat 3: T0ny Adams ($80.64 in chips) 
Seat 4: volwebni4ek ($96.75 in chips) 
Seat 5: prominente ($270.75 in chips) 
Seat 7: InsomniaRU ($226.04 in chips) 
Seat 8: ki11u ($244.15 in chips) 
Seat 9: fonng ($338.49 in chips) 
prominente: posts small blind $1
InsomniaRU: posts big blind $2
*** HOLE CARDS ***
Dealt to matiko09 [4h 5c]
ki11u: folds 
fonng: folds 
matiko09: folds 
RamiroAgujis: folds 
T0ny Adams: folds 
volwebni4ek: raises $2 to $4
prominente: raises $10 to $14
InsomniaRU: folds 
volwebni4ek: folds 
Uncalled bet ($10) returned to prominente
prominente collected $10 from pot
*** SUMMARY ***
Total pot $10 | Rake $0 
Seat 1: matiko09 folded before Flop (didn't bet)
Seat 2: RamiroAgujis folded before Flop (didn't bet)
Seat 3: T0ny Adams folded before Flop (didn't bet)
Seat 4: volwebni4ek (button) folded before Flop
Seat 5: prominente (small blind) collected ($10)
Seat 7: InsomniaRU (big blind) folded before Flop
Seat 8: ki11u folded before Flop (didn't bet)
Seat 9: fonng folded before Flop (didn't bet)





PokerStars Hand #151164670049:  Hold'em No Limit ($1/$2 USD) - 2016/03/30 16:21:01 CET [2016/03/30 10:21:01 ET]
Table 'Philoctetes II' 9-max Seat #1 is the button
Seat 1: vezunchik79 ($126.93 in chips) 
Seat 2: prominente ($200 in chips) 
Seat 3: mentalpshyco ($200 in chips) 
Seat 5: zhaimeng ($357.11 in chips) 
Seat 7: matiko09 ($200 in chips) 
Seat 8: suddend3ath ($200 in chips) 
Seat 9: RamiroAgujis ($237.30 in chips) 
prominente: posts small blind $1
mentalpshyco: posts big blind $2
tepi_guy: sits out 
*** HOLE CARDS ***
Dealt to matiko09 [6h Kh]
zhaimeng: folds 
matiko09: folds 
suddend3ath: folds 
RamiroAgujis: raises $4 to $6
vezunchik79: folds 
prominente: folds 
mentalpshyco: folds 
Uncalled bet ($4) returned to RamiroAgujis
RamiroAgujis collected $5 from pot
RamiroAgujis: doesn't show hand 
*** SUMMARY ***
Total pot $5 | Rake $0 
Seat 1: vezunchik79 (button) folded before Flop (didn't bet)
Seat 2: prominente (small blind) folded before Flop
Seat 3: mentalpshyco (big blind) folded before Flop
Seat 5: zhaimeng folded before Flop (didn't bet)
Seat 7: matiko09 folded before Flop (didn't bet)
Seat 8: suddend3ath folded before Flop (didn't bet)
Seat 9: RamiroAgujis collected ($5)





PokerStars Hand #151164674489:  Hold'em No Limit ($0.50/$1.00 USD) - 2016/03/30 16:21:08 CET [2016/03/30 10:21:08 ET]
Table 'Figneria III' 9-max Seat #2 is the button
Seat 1: matiko09 ($100 in chips) 
Seat 2: sanpidk ($100 in chips) 
Seat 4: CI58 ($100 in chips) 
Seat 7: holloway85 ($156.44 in chips) 
Seat 8: Dachish ($70 in chips) 
Seat 9: p.snow89 ($84.05 in chips) 
CI58: posts small blind $0.50
chenconhaste: is sitting out 
holloway85: posts big blind $1
*** HOLE CARDS ***
Dealt to matiko09 [3c Tc]
chenconhaste leaves the table
volwebni4ek joins the table at seat #5 
Dachish: raises $1.50 to $2.50
p.snow89: calls $2.50
matiko09: folds 
sanpidk: folds 
CI58: folds 
holloway85: calls $1.50
*** FLOP *** [7c 7s 2s]
holloway85: checks 
Dachish: checks 
p.snow89: bets $3.80
holloway85: folds 
Dachish: folds 
Uncalled bet ($3.80) returned to p.snow89
p.snow89 collected $7.60 from pot
p.snow89: doesn't show hand 
*** SUMMARY ***
Total pot $8 | Rake $0.40 
Board [7c 7s 2s]
Seat 1: matiko09 folded before Flop (didn't bet)
Seat 2: sanpidk (button) folded before Flop (didn't bet)
Seat 4: CI58 (small blind) folded before Flop
Seat 7: holloway85 (big blind) folded on the Flop
Seat 8: Dachish folded on the Flop
Seat 9: p.snow89 collected ($7.60)





PokerStars Hand #151164676740:  Hold'em No Limit ($0.50/$1.00 USD) - 2016/03/30 16:21:11 CET [2016/03/30 10:21:11 ET]
Table 'Pannonia II' 9-max Seat #2 is the button
Seat 1: CI58 ($100 in chips) 
Seat 2: matiko09 ($101.76 in chips) 
Seat 3: MGL_Sky99 ($105.50 in chips) 
Seat 5: Spid1 ($126.87 in chips) 
Seat 6: lumen21 ($113 in chips) 
Seat 7: volwebni4ek ($42.75 in chips) 
Seat 8: stonymalony ($47.92 in chips) 
Seat 9: b_____a__242 ($88.89 in chips) 
MGL_Sky99: posts small blind $0.50
Spid1: posts big blind $1
*** HOLE CARDS ***
Dealt to matiko09 [9s 9h]
lumen21: folds 
volwebni4ek: raises $2 to $3
stonymalony: calls $3
b_____a__242: calls $3
CI58: folds 
matiko09: calls $3
MGL_Sky99: calls $2.50
Spid1: folds 
*** FLOP *** [4d Js Kh]
MGL_Sky99: checks 
volwebni4ek: checks 
stonymalony: checks 
b_____a__242: checks 
matiko09: checks 
*** TURN *** [4d Js Kh] [4s]
MGL_Sky99: checks 
volwebni4ek: checks 
stonymalony: checks 
b_____a__242: checks 
matiko09: checks 
*** RIVER *** [4d Js Kh 4s] [5s]
MGL_Sky99: checks 
volwebni4ek: checks 
stonymalony: bets $10
b_____a__242: folds 
matiko09: folds 
MGL_Sky99: folds 
volwebni4ek: folds 
Uncalled bet ($10) returned to stonymalony
stonymalony collected $15.20 from pot
stonymalony: doesn't show hand 
*** SUMMARY ***
Total pot $16 | Rake $0.80 
Board [4d Js Kh 4s 5s]
Seat 1: CI58 folded before Flop (didn't bet)
Seat 2: matiko09 (button) folded on the River
Seat 3: MGL_Sky99 (small blind) folded on the River
Seat 5: Spid1 (big blind) folded before Flop
Seat 6: lumen21 folded before Flop (didn't bet)
Seat 7: volwebni4ek folded on the River
Seat 8: stonymalony collected ($15.20)
Seat 9: b_____a__242 folded on the River





PokerStars Hand #151164678427:  Hold'em No Limit ($0.50/$1.00 USD) - 2016/03/30 16:21:13 CET [2016/03/30 10:21:13 ET]
Table 'Alcor II' 9-max Seat #1 is the button
Seat 1: Red4erT ($115.62 in chips) 
Seat 2: holloway85 ($77.96 in chips) 
Seat 3: mitchymitch3 ($98.41 in chips) 
Seat 5: elbiber2000 ($104.12 in chips) 
Seat 6: godfrey004 ($141.15 in chips) 
Seat 7: sanpidk ($105.21 in chips) 
Seat 8: cdv1984 ($100 in chips) 
Seat 9: matiko09 ($206.10 in chips) 
holloway85: posts small blind $0.50
mitchymitch3: posts big blind $1
*** HOLE CARDS ***
Dealt to matiko09 [Jh 4c]
elbiber2000: folds 
godfrey004: folds 
sanpidk: folds 
cdv1984: raises $2 to $3
matiko09: folds 
Red4erT: folds 
holloway85: folds 
mitchymitch3: folds 
Uncalled bet ($2) returned to cdv1984
cdv1984 collected $2.50 from pot
cdv1984: doesn't show hand 
*** SUMMARY ***
Total pot $2.50 | Rake $0 
Seat 1: Red4erT (button) folded before Flop (didn't bet)
Seat 2: holloway85 (small blind) folded before Flop
Seat 3: mitchymitch3 (big blind) folded before Flop
Seat 5: elbiber2000 folded before Flop (didn't bet)
Seat 6: godfrey004 folded before Flop (didn't bet)
Seat 7: sanpidk folded before Flop (didn't bet)
Seat 8: cdv1984 collected ($2.50)
Seat 9: matiko09 folded before Flop (didn't bet)





PokerStars Hand #151164682168:  Hold'em No Limit ($1/$2 USD) - 2016/03/30 16:21:19 CET [2016/03/30 10:21:19 ET]
Table 'Jole' 9-max Seat #7 is the button
Seat 1: matiko09 ($200 in chips) 
Seat 2: RamiroAgujis ($307.76 in chips) 
Seat 3: chenconhaste ($215.65 in chips) 
Seat 4: volwebni4ek ($90.66 in chips) 
Seat 5: dunga119 ($237.49 in chips) 
Seat 6: King_ZéManel ($200 in chips) 
Seat 7: ilaviiitech ($220.05 in chips) 
Seat 9: Ravnica11 ($78 in chips) 
Ravnica11: posts small blind $1
matiko09: posts big blind $2
*** HOLE CARDS ***
Dealt to matiko09 [6s Ah]
RamiroAgujis: folds 
chenconhaste: folds 
volwebni4ek: folds 
dunga119: calls $2
King_ZéManel: folds 
ilaviiitech: raises $6 to $8
Ravnica11: folds 
matiko09: folds 
dunga119: raises $8 to $16
ilaviiitech: calls $8
*** FLOP *** [Qs 9c Jc]
dunga119: checks 
ilaviiitech: bets $29.92
dunga119: folds 
Uncalled bet ($29.92) returned to ilaviiitech
ilaviiitech collected $33.25 from pot
ilaviiitech: doesn't show hand 
*** SUMMARY ***
Total pot $35 | Rake $1.75 
Board [Qs 9c Jc]
Seat 1: matiko09 (big blind) folded before Flop
Seat 2: RamiroAgujis folded before Flop (didn't bet)
Seat 3: chenconhaste folded before Flop (didn't bet)
Seat 4: volwebni4ek folded before Flop (didn't bet)
Seat 5: dunga119 folded on the Flop
Seat 6: King_ZéManel folded before Flop (didn't bet)
Seat 7: ilaviiitech (button) collected ($33.25)
Seat 9: Ravnica11 (small blind) folded before Flop





PokerStars Hand #151164687979:  Hold'em No Limit ($1/$2 USD) - 2016/03/30 16:21:28 CET [2016/03/30 10:21:28 ET]
Table 'Aesculapia II' 9-max Seat #7 is the button
Seat 1: buthmen ($343.78 in chips) 
Seat 2: suddend3ath ($200 in chips) 
Seat 3: matiko09 ($281.49 in chips) 
Seat 4: ki11u ($434.29 in chips) 
Seat 5: prominente ($206.42 in chips) 
Seat 7: Rumboni66 ($121.49 in chips) 
Seat 9: InsomniaRU ($219.75 in chips) 
InsomniaRU: posts small blind $1
buthmen: posts big blind $2
volwebni4ek: sits out 
*** HOLE CARDS ***
Dealt to matiko09 [2c Jd]
suddend3ath: folds 
matiko09: folds 
ki11u: folds 
prominente: raises $3 to $5
Rumboni66: folds 
InsomniaRU: folds 
buthmen: calls $3
*** FLOP *** [5s 9d 7s]
buthmen: checks 
prominente: checks 
*** TURN *** [5s 9d 7s] [2d]
buthmen: bets $4
prominente: calls $4
*** RIVER *** [5s 9d 7s 2d] [3h]
buthmen: bets $4
prominente: folds 
Uncalled bet ($4) returned to buthmen
buthmen collected $18.05 from pot
buthmen: doesn't show hand 
*** SUMMARY ***
Total pot $19 | Rake $0.95 
Board [5s 9d 7s 2d 3h]
Seat 1: buthmen (big blind) collected ($18.05)
Seat 2: suddend3ath folded before Flop (didn't bet)
Seat 3: matiko09 folded before Flop (didn't bet)
Seat 4: ki11u folded before Flop (didn't bet)
Seat 5: prominente folded on the River
Seat 7: Rumboni66 (button) folded before Flop (didn't bet)
Seat 9: InsomniaRU (small blind) folded before Flop





PokerStars Hand #151164689386:  Hold'em No Limit ($1/$2 USD) - 2016/03/30 16:21:30 CET [2016/03/30 10:21:30 ET]
Table 'Philoctetes II' 9-max Seat #2 is the button
Seat 1: vezunchik79 ($126.93 in chips) 
Seat 2: prominente ($200 in chips) 
Seat 3: mentalpshyco ($200 in chips) 
Seat 4: tepi_guy ($200 in chips) 
Seat 5: zhaimeng ($357.11 in chips) 
Seat 7: matiko09 ($200 in chips) 
Seat 8: suddend3ath ($200 in chips) 
Seat 9: RamiroAgujis ($240.30 in chips) 
mentalpshyco: posts small blind $1
tepi_guy: posts big blind $2
*** HOLE CARDS ***
Dealt to matiko09 [4c Tc]
zhaimeng: folds 
matiko09: folds 
suddend3ath: folds 
RamiroAgujis: folds 
vezunchik79: folds 
prominente: raises $2 to $4
mentalpshyco: folds 
tepi_guy: calls $2
*** FLOP *** [8d 6h Jh]
tepi_guy: checks 
prominente: checks 
*** TURN *** [8d 6h Jh] [Th]
tepi_guy: bets $8.55
prominente: folds 
Uncalled bet ($8.55) returned to tepi_guy
tepi_guy collected $8.55 from pot
tepi_guy: doesn't show hand 
*** SUMMARY ***
Total pot $9 | Rake $0.45 
Board [8d 6h Jh Th]
Seat 1: vezunchik79 folded before Flop (didn't bet)
Seat 2: prominente (button) folded on the Turn
Seat 3: mentalpshyco (small blind) folded before Flop
Seat 4: tepi_guy (big blind) collected ($8.55)
Seat 5: zhaimeng folded before Flop (didn't bet)
Seat 7: matiko09 folded before Flop (didn't bet)
Seat 8: suddend3ath folded before Flop (didn't bet)
Seat 9: RamiroAgujis folded before Flop (didn't bet)





PokerStars Hand #151164689514:  Hold'em No Limit ($1/$2 USD) - 2016/03/30 16:21:30 CET [2016/03/30 10:21:30 ET]
Table 'Tydeus III' 9-max Seat #1 is the button
Seat 1: InsomniaRU ($223.25 in chips) 
Seat 2: RamiroAgujis ($207.55 in chips) 
Seat 4: T0ny Adams ($63.21 in chips) 
Seat 5: suddend3ath ($251.17 in chips) 
Seat 6: prominente ($200 in chips) 
Seat 7: matiko09 ($200 in chips) 
Seat 9: velourleder ($129.25 in chips) 
RamiroAgujis: posts small blind $1
T0ny Adams: posts big blind $2
tepi_guy: sits out 
*** HOLE CARDS ***
Dealt to matiko09 [2c 6c]
suddend3ath: folds 
prominente: folds 
matiko09: folds 
velourleder: folds 
InsomniaRU: folds 
RamiroAgujis: folds 
Uncalled bet ($1) returned to T0ny Adams
T0ny Adams collected $2 from pot
T0ny Adams: doesn't show hand 
*** SUMMARY ***
Total pot $2 | Rake $0 
Seat 1: InsomniaRU (button) folded before Flop (didn't bet)
Seat 2: RamiroAgujis (small blind) folded before Flop
Seat 4: T0ny Adams (big blind) collected ($2)
Seat 5: suddend3ath folded before Flop (didn't bet)
Seat 6: prominente folded before Flop (didn't bet)
Seat 7: matiko09 folded before Flop (didn't bet)
Seat 9: velourleder folded before Flop (didn't bet)





PokerStars Hand #151164696566:  Hold'em No Limit ($0.50/$1.00 USD) - 2016/03/30 16:21:40 CET [2016/03/30 10:21:40 ET]
Table 'Amata II' 9-max Seat #9 is the button
Seat 2: ilaviiitech ($115.45 in chips) 
Seat 3: matiko09 ($188.25 in chips) 
Seat 4: lumen21 ($106.06 in chips) 
Seat 5: Spid1 ($100 in chips) 
Seat 6: RamiroAgujis ($118.03 in chips) 
Seat 7: Pvsx. ($195.01 in chips) 
Seat 9: kaya.ertugrul88 ($121.20 in chips) 
ilaviiitech: posts small blind $0.50
matiko09: posts big blind $1
ka100pka527: sits out 
*** HOLE CARDS ***
Dealt to matiko09 [4h Qh]
lumen21: raises $2 to $3
Spid1: folds 
RamiroAgujis: folds 
Pvsx.: folds 
kaya.ertugrul88: calls $3
ilaviiitech: folds 
matiko09: folds 
*** FLOP *** [Ad Tc As]
lumen21: checks 
kaya.ertugrul88: checks 
*** TURN *** [Ad Tc As] [Qd]
lumen21: checks 
kaya.ertugrul88: checks 
*** RIVER *** [Ad Tc As Qd] [9s]
lumen21: checks 
kaya.ertugrul88: checks 
*** SHOW DOWN ***
lumen21: shows [5h 5d] (two pair, Aces and Fives)
kaya.ertugrul88: mucks hand 
lumen21 collected $7.12 from pot
*** SUMMARY ***
Total pot $7.50 | Rake $0.38 
Board [Ad Tc As Qd 9s]
Seat 2: ilaviiitech (small blind) folded before Flop
Seat 3: matiko09 (big blind) folded before Flop
Seat 4: lumen21 showed [5h 5d] and won ($7.12) with two pair, Aces and Fives
Seat 5: Spid1 folded before Flop (didn't bet)
Seat 6: RamiroAgujis folded before Flop (didn't bet)
Seat 7: Pvsx. folded before Flop (didn't bet)
Seat 9: kaya.ertugrul88 (button) mucked [7h 8h]





PokerStars Hand #151164701576:  Hold'em No Limit ($1/$2 USD) - 2016/03/30 16:21:48 CET [2016/03/30 10:21:48 ET]
Table 'Hektor III' 9-max Seat #5 is the button
Seat 1: matiko09 ($200 in chips) 
Seat 2: RamiroAgujis ($306.45 in chips) 
Seat 3: T0ny Adams ($80.64 in chips) 
Seat 4: volwebni4ek ($92.75 in chips) 
Seat 5: prominente ($276.75 in chips) 
Seat 7: InsomniaRU ($224.04 in chips) 
Seat 9: fonng ($338.49 in chips) 
InsomniaRU: posts small blind $1
ki11u: is sitting out 
fonng: posts big blind $2
*** HOLE CARDS ***
Dealt to matiko09 [Jc Qd]
matiko09: folds 
RamiroAgujis: folds 
ki11u leaves the table
T0ny Adams: raises $3 to $5
volwebni4ek: folds 
prominente: folds 
InsomniaRU: folds 
fonng: calls $3
*** FLOP *** [Ad Jh Qc]
fonng: checks 
T0ny Adams: checks 
*** TURN *** [Ad Jh Qc] [8s]
tepi_guy joins the table at seat #8 
fonng: checks 
T0ny Adams: checks 
*** RIVER *** [Ad Jh Qc 8s] [As]
fonng: checks 
T0ny Adams: checks 
*** SHOW DOWN ***
fonng: shows [2h 2c] (two pair, Aces and Deuces)
T0ny Adams: shows [9c 9h] (two pair, Aces and Nines)
T0ny Adams collected $10.45 from pot
*** SUMMARY ***
Total pot $11 | Rake $0.55 
Board [Ad Jh Qc 8s As]
Seat 1: matiko09 folded before Flop (didn't bet)
Seat 2: RamiroAgujis folded before Flop (didn't bet)
Seat 3: T0ny Adams showed [9c 9h] and won ($10.45) with two pair, Aces and Nines
Seat 4: volwebni4ek folded before Flop (didn't bet)
Seat 5: prominente (button) folded before Flop (didn't bet)
Seat 7: InsomniaRU (small blind) folded before Flop
Seat 9: fonng (big blind) showed [2h 2c] and lost with two pair, Aces and Deuces





PokerStars Hand #151164705264:  Hold'em No Limit ($1/$2 USD) - 2016/03/30 16:21:54 CET [2016/03/30 10:21:54 ET]
Table 'Tydeus III' 9-max Seat #2 is the button
Seat 1: InsomniaRU ($223.25 in chips) 
Seat 2: RamiroAgujis ($206.55 in chips) 
Seat 4: T0ny Adams ($64.21 in chips) 
Seat 5: suddend3ath ($251.17 in chips) 
Seat 6: prominente ($200 in chips) 
Seat 7: matiko09 ($200 in chips) 
Seat 9: velourleder ($129.25 in chips) 
T0ny Adams: posts small blind $1
suddend3ath: posts big blind $2
tepi_guy: sits out 
*** HOLE CARDS ***
Dealt to matiko09 [Jd 5h]
prominente: folds 
matiko09: folds 
velourleder: folds 
InsomniaRU: folds 
RamiroAgujis: raises $3 to $5
T0ny Adams: folds 
suddend3ath: calls $3
*** FLOP *** [3c Th 2s]
suddend3ath: checks 
RamiroAgujis: bets $6
suddend3ath: folds 
Uncalled bet ($6) returned to RamiroAgujis
RamiroAgujis collected $10.45 from pot
RamiroAgujis: doesn't show hand 
*** SUMMARY ***
Total pot $11 | Rake $0.55 
Board [3c Th 2s]
Seat 1: InsomniaRU folded before Flop (didn't bet)
Seat 2: RamiroAgujis (button) collected ($10.45)
Seat 4: T0ny Adams (small blind) folded before Flop
Seat 5: suddend3ath (big blind) folded on the Flop
Seat 6: prominente folded before Flop (didn't bet)
Seat 7: matiko09 folded before Flop (didn't bet)
Seat 9: velourleder folded before Flop (didn't bet)





PokerStars Hand #151164706627:  Hold'em No Limit ($0.50/$1.00 USD) - 2016/03/30 16:21:56 CET [2016/03/30 10:21:56 ET]
Table 'Alcor II' 9-max Seat #2 is the button
Seat 1: Red4erT ($115.62 in chips) 
Seat 2: holloway85 ($77.46 in chips) 
Seat 3: mitchymitch3 ($97.41 in chips) 
Seat 5: elbiber2000 ($104.12 in chips) 
Seat 6: godfrey004 ($141.15 in chips) 
Seat 7: sanpidk ($105.21 in chips) 
Seat 8: cdv1984 ($101.50 in chips) 
Seat 9: matiko09 ($206.10 in chips) 
mitchymitch3: posts small blind $0.50
elbiber2000: posts big blind $1
*** HOLE CARDS ***
Dealt to matiko09 [5c As]
godfrey004: calls $1
sanpidk: folds 
cdv1984: folds 
matiko09: folds 
Red4erT: folds 
holloway85: folds 
mitchymitch3: raises $2 to $3
elbiber2000: folds 
godfrey004: calls $2
*** FLOP *** [8s Qs 8c]
mitchymitch3: bets $4
godfrey004: calls $4
*** TURN *** [8s Qs 8c] [7h]
mitchymitch3: bets $8
godfrey004: calls $8
*** RIVER *** [8s Qs 8c 7h] [4s]
mitchymitch3: checks 
godfrey004: bets $16
mitchymitch3: folds 
Uncalled bet ($16) returned to godfrey004
godfrey004 collected $29.45 from pot
*** SUMMARY ***
Total pot $31 | Rake $1.55 
Board [8s Qs 8c 7h 4s]
Seat 1: Red4erT folded before Flop (didn't bet)
Seat 2: holloway85 (button) folded before Flop (didn't bet)
Seat 3: mitchymitch3 (small blind) folded on the River
Seat 5: elbiber2000 (big blind) folded before Flop
Seat 6: godfrey004 collected ($29.45)
Seat 7: sanpidk folded before Flop (didn't bet)
Seat 8: cdv1984 folded before Flop (didn't bet)
Seat 9: matiko09 folded before Flop (didn't bet)





PokerStars Hand #151164715986:  Hold'em No Limit ($1/$2 USD) - 2016/03/30 16:22:09 CET [2016/03/30 10:22:09 ET]
Table 'Jole' 9-max Seat #9 is the button
Seat 1: matiko09 ($200 in chips) 
Seat 2: RamiroAgujis ($307.76 in chips) 
Seat 3: chenconhaste ($215.65 in chips) 
Seat 4: volwebni4ek ($90.66 in chips) 
Seat 5: dunga119 ($221.49 in chips) 
Seat 6: King_ZéManel ($200 in chips) 
Seat 7: ilaviiitech ($237.30 in chips) 
Seat 9: Ravnica11 ($77 in chips) 
matiko09: posts small blind $1
RamiroAgujis: posts big blind $2
*** HOLE CARDS ***
Dealt to matiko09 [Jd 7h]
chenconhaste: folds 
volwebni4ek: folds 
dunga119: calls $2
King_ZéManel: raises $6 to $8
ilaviiitech: folds 
Ravnica11: folds 
matiko09: folds 
RamiroAgujis: folds 
dunga119: calls $6
*** FLOP *** [Td Jh 3h]
dunga119: checks 
King_ZéManel: bets $14
dunga119: folds 
Uncalled bet ($14) returned to King_ZéManel
King_ZéManel collected $18.05 from pot
King_ZéManel: doesn't show hand 
*** SUMMARY ***
Total pot $19 | Rake $0.95 
Board [Td Jh 3h]
Seat 1: matiko09 (small blind) folded before Flop
Seat 2: RamiroAgujis (big blind) folded before Flop
Seat 3: chenconhaste folded before Flop (didn't bet)
Seat 4: volwebni4ek folded before Flop (didn't bet)
Seat 5: dunga119 folded on the Flop
Seat 6: King_ZéManel collected ($18.05)
Seat 7: ilaviiitech folded before Flop (didn't bet)
Seat 9: Ravnica11 (button) folded before Flop (didn't bet)





PokerStars Hand #151164716381:  Hold'em No Limit ($0.50/$1.00 USD) - 2016/03/30 16:22:10 CET [2016/03/30 10:22:10 ET]
Table 'Figneria III' 9-max Seat #4 is the button
Seat 1: matiko09 ($100 in chips) 
Seat 2: sanpidk ($100 in chips) 
Seat 4: CI58 ($100 in chips) 
Seat 7: holloway85 ($153.94 in chips) 
Seat 8: Dachish ($67.50 in chips) 
Seat 9: p.snow89 ($89.15 in chips) 
volwebni4ek will be allowed to play after the button
holloway85: posts small blind $0.50
Dachish: posts big blind $1
*** HOLE CARDS ***
Dealt to matiko09 [8d Qc]
p.snow89: calls $1
matiko09: folds 
sanpidk: folds 
CI58: folds 
holloway85: calls $0.50
Dachish: checks 
*** FLOP *** [8c 3c Qh]
holloway85: checks 
Dachish: checks 
p.snow89: checks 
*** TURN *** [8c 3c Qh] [Ac]
holloway85: checks 
Dachish: checks 
p.snow89: checks 
*** RIVER *** [8c 3c Qh Ac] [9h]
holloway85: bets $1.42
Dachish: folds 
p.snow89: folds 
Uncalled bet ($1.42) returned to holloway85
holloway85 collected $2.85 from pot
holloway85: doesn't show hand 
*** SUMMARY ***
Total pot $3 | Rake $0.15 
Board [8c 3c Qh Ac 9h]
Seat 1: matiko09 folded before Flop (didn't bet)
Seat 2: sanpidk folded before Flop (didn't bet)
Seat 4: CI58 (button) folded before Flop (didn't bet)
Seat 7: holloway85 (small blind) collected ($2.85)
Seat 8: Dachish (big blind) folded on the River
Seat 9: p.snow89 folded on the River





PokerStars Hand #151164723343:  Hold'em No Limit ($1/$2 USD) - 2016/03/30 16:22:20 CET [2016/03/30 10:22:20 ET]
Table 'Aesculapia II' 9-max Seat #9 is the button
Seat 1: buthmen ($352.83 in chips) 
Seat 2: suddend3ath ($200 in chips) 
Seat 3: matiko09 ($281.49 in chips) 
Seat 4: ki11u ($434.29 in chips) 
Seat 5: prominente ($200 in chips) 
Seat 7: Rumboni66 ($121.49 in chips) 
Seat 9: InsomniaRU ($218.75 in chips) 
buthmen: posts small blind $1
suddend3ath: posts big blind $2
volwebni4ek: sits out 
*** HOLE CARDS ***
Dealt to matiko09 [5h Ac]
matiko09: folds 
ki11u: folds 
prominente: folds 
Rumboni66: folds 
InsomniaRU: folds 
buthmen: raises $4 to $6
suddend3ath: calls $4
*** FLOP *** [5c 9h 8c]
buthmen: bets $4
suddend3ath: calls $4
*** TURN *** [5c 9h 8c] [Qh]
buthmen: bets $8
suddend3ath: calls $8
*** RIVER *** [5c 9h 8c Qh] [Qd]
buthmen: bets $17.10
suddend3ath: folds 
Uncalled bet ($17.10) returned to buthmen
buthmen collected $34.20 from pot
buthmen: doesn't show hand 
*** SUMMARY ***
Total pot $36 | Rake $1.80 
Board [5c 9h 8c Qh Qd]
Seat 1: buthmen (small blind) collected ($34.20)
Seat 2: suddend3ath (big blind) folded on the River
Seat 3: matiko09 folded before Flop (didn't bet)
Seat 4: ki11u folded before Flop (didn't bet)
Seat 5: prominente folded before Flop (didn't bet)
Seat 7: Rumboni66 folded before Flop (didn't bet)
Seat 9: InsomniaRU (button) folded before Flop (didn't bet)





PokerStars Hand #151164729337:  Hold'em No Limit ($0.50/$1.00 USD) - 2016/03/30 16:22:29 CET [2016/03/30 10:22:29 ET]
Table 'Amata II' 9-max Seat #2 is the button
Seat 2: ilaviiitech ($114.95 in chips) 
Seat 3: matiko09 ($187.25 in chips) 
Seat 5: Spid1 ($100 in chips) 
Seat 6: RamiroAgujis ($118.03 in chips) 
Seat 7: Pvsx. ($195.01 in chips) 
Seat 9: kaya.ertugrul88 ($118.20 in chips) 
matiko09: posts small blind $0.50
lumen21: is sitting out 
Spid1: posts big blind $1
ka100pka527: sits out 
*** HOLE CARDS ***
Dealt to matiko09 [6d 5h]
RamiroAgujis: folds 
Pvsx.: folds 
kaya.ertugrul88: folds 
ilaviiitech: folds 
matiko09: folds 
Uncalled bet ($0.50) returned to Spid1
Spid1 collected $1 from pot
Spid1: doesn't show hand 
*** SUMMARY ***
Total pot $1 | Rake $0 
Seat 2: ilaviiitech (button) folded before Flop (didn't bet)
Seat 3: matiko09 (small blind) folded before Flop
Seat 5: Spid1 (big blind) collected ($1)
Seat 6: RamiroAgujis folded before Flop (didn't bet)
Seat 7: Pvsx. folded before Flop (didn't bet)
Seat 9: kaya.ertugrul88 folded before Flop (didn't bet)





PokerStars Hand #151164731422:  Hold'em No Limit ($1/$2 USD) - 2016/03/30 16:22:32 CET [2016/03/30 10:22:32 ET]
Table 'Philoctetes II' 9-max Seat #3 is the button
Seat 1: vezunchik79 ($126.93 in chips) 
Seat 2: prominente ($200 in chips) 
Seat 3: mentalpshyco ($200 in chips) 
Seat 4: tepi_guy ($204.55 in chips) 
Seat 5: zhaimeng ($357.11 in chips) 
Seat 7: matiko09 ($200 in chips) 
Seat 8: suddend3ath ($200 in chips) 
Seat 9: RamiroAgujis ($240.30 in chips) 
tepi_guy: posts small blind $1
zhaimeng: posts big blind $2
*** HOLE CARDS ***
Dealt to matiko09 [Jh 9d]
matiko09: folds 
suddend3ath: folds 
RamiroAgujis: folds 
vezunchik79: raises $4 to $6
prominente: folds 
mentalpshyco: folds 
tepi_guy: folds 
zhaimeng: calls $4
*** FLOP *** [8d Ks 9s]
zhaimeng: checks 
vezunchik79: bets $14
zhaimeng: folds 
Uncalled bet ($14) returned to vezunchik79
vezunchik79 collected $12.35 from pot
vezunchik79: doesn't show hand 
*** SUMMARY ***
Total pot $13 | Rake $0.65 
Board [8d Ks 9s]
Seat 1: vezunchik79 collected ($12.35)
Seat 2: prominente folded before Flop (didn't bet)
Seat 3: mentalpshyco (button) folded before Flop (didn't bet)
Seat 4: tepi_guy (small blind) folded before Flop
Seat 5: zhaimeng (big blind) folded on the Flop
Seat 7: matiko09 folded before Flop (didn't bet)
Seat 8: suddend3ath folded before Flop (didn't bet)
Seat 9: RamiroAgujis folded before Flop (didn't bet)





PokerStars Hand #151164738382:  Hold'em No Limit ($0.50/$1.00 USD) - 2016/03/30 16:22:43 CET [2016/03/30 10:22:43 ET]
Table 'Amata II' 9-max Seat #3 is the button
Seat 2: ilaviiitech ($114.95 in chips) 
Seat 3: matiko09 ($186.75 in chips) 
Seat 5: Spid1 ($100.50 in chips) 
Seat 6: RamiroAgujis ($118.03 in chips) 
Seat 7: Pvsx. ($195.01 in chips) 
Seat 9: kaya.ertugrul88 ($118.20 in chips) 
Spid1: posts small blind $0.50
RamiroAgujis: posts big blind $1
ka100pka527: sits out 
*** HOLE CARDS ***
Dealt to matiko09 [3s 6c]
Pvsx.: raises $1.50 to $2.50
kaya.ertugrul88: calls $2.50
ilaviiitech: folds 
matiko09: folds 
Spid1: folds 
RamiroAgujis: folds 
*** FLOP *** [Js Ks 4c]
Pvsx.: checks 
kaya.ertugrul88: checks 
*** TURN *** [Js Ks 4c] [9d]
Pvsx.: checks 
kaya.ertugrul88: checks 
*** RIVER *** [Js Ks 4c 9d] [4d]
Pvsx.: checks 
kaya.ertugrul88: bets $3
Pvsx.: folds 
Uncalled bet ($3) returned to kaya.ertugrul88
kaya.ertugrul88 collected $6.18 from pot
kaya.ertugrul88: doesn't show hand 
*** SUMMARY ***
Total pot $6.50 | Rake $0.32 
Board [Js Ks 4c 9d 4d]
Seat 2: ilaviiitech folded before Flop (didn't bet)
Seat 3: matiko09 (button) folded before Flop (didn't bet)
Seat 5: Spid1 (small blind) folded before Flop
Seat 6: RamiroAgujis (big blind) folded before Flop
Seat 7: Pvsx. folded on the River
Seat 9: kaya.ertugrul88 collected ($6.18)





PokerStars Hand #151164745361:  Hold'em No Limit ($1/$2 USD) - 2016/03/30 16:22:53 CET [2016/03/30 10:22:53 ET]
Table 'Jole' 9-max Seat #1 is the button
Seat 1: matiko09 ($200 in chips) 
Seat 2: RamiroAgujis ($305.76 in chips) 
Seat 4: volwebni4ek ($90.66 in chips) 
Seat 5: dunga119 ($213.49 in chips) 
Seat 6: King_ZéManel ($210.05 in chips) 
Seat 7: ilaviiitech ($237.30 in chips) 
Seat 9: Ravnica11 ($77 in chips) 
RamiroAgujis: posts small blind $1
chenconhaste: is sitting out 
volwebni4ek: posts big blind $2
*** HOLE CARDS ***
Dealt to matiko09 [2c 8h]
chenconhaste leaves the table
dunga119: calls $2
King_ZéManel: folds 
ilaviiitech: raises $6 to $8
Ravnica11: folds 
matiko09: folds 
RamiroAgujis: folds 
volwebni4ek: folds 
dunga119: calls $6
*** FLOP *** [8s Qh 5h]
dunga119: bets $9.02
ilaviiitech: calls $9.02
*** TURN *** [8s Qh 5h] [9c]
dunga119: bets $17.59
ilaviiitech: raises $68.41 to $86
dunga119: folds 
Uncalled bet ($68.41) returned to ilaviiitech
ilaviiitech collected $69.47 from pot
ilaviiitech: doesn't show hand 
*** SUMMARY ***
Total pot $72.22 | Rake $2.75 
Board [8s Qh 5h 9c]
Seat 1: matiko09 (button) folded before Flop (didn't bet)
Seat 2: RamiroAgujis (small blind) folded before Flop
Seat 4: volwebni4ek (big blind) folded before Flop
Seat 5: dunga119 folded on the Turn
Seat 6: King_ZéManel folded before Flop (didn't bet)
Seat 7: ilaviiitech collected ($69.47)
Seat 9: Ravnica11 folded before Flop (didn't bet)





PokerStars Hand #151164745245:  Hold'em No Limit ($1/$2 USD) - 2016/03/30 16:22:53 CET [2016/03/30 10:22:53 ET]
Table 'Hektor III' 9-max Seat #7 is the button
Seat 1: matiko09 ($200 in chips) 
Seat 2: RamiroAgujis ($306.45 in chips) 
Seat 3: T0ny Adams ($86.09 in chips) 
Seat 4: volwebni4ek ($92.75 in chips) 
Seat 5: prominente ($276.75 in chips) 
Seat 7: InsomniaRU ($223.04 in chips) 
Seat 9: fonng ($333.49 in chips) 
tepi_guy will be allowed to play after the button
fonng: posts small blind $1
matiko09: posts big blind $2
*** HOLE CARDS ***
Dealt to matiko09 [4h 8s]
RamiroAgujis: folds 
T0ny Adams: raises $3 to $5
volwebni4ek: folds 
prominente: folds 
InsomniaRU: folds 
fonng: folds 
matiko09: folds 
Uncalled bet ($3) returned to T0ny Adams
T0ny Adams collected $5 from pot
T0ny Adams: doesn't show hand 
*** SUMMARY ***
Total pot $5 | Rake $0 
Seat 1: matiko09 (big blind) folded before Flop
Seat 2: RamiroAgujis folded before Flop (didn't bet)
Seat 3: T0ny Adams collected ($5)
Seat 4: volwebni4ek folded before Flop (didn't bet)
Seat 5: prominente folded before Flop (didn't bet)
Seat 7: InsomniaRU (button) folded before Flop (didn't bet)
Seat 9: fonng (small blind) folded before Flop





PokerStars Hand #151164754555:  Hold'em No Limit ($0.50/$1.00 USD) - 2016/03/30 16:23:07 CET [2016/03/30 10:23:07 ET]
Table 'Alcor II' 9-max Seat #3 is the button
Seat 1: Red4erT ($115.62 in chips) 
Seat 2: holloway85 ($77.46 in chips) 
Seat 3: mitchymitch3 ($82.41 in chips) 
Seat 5: elbiber2000 ($103.12 in chips) 
Seat 6: godfrey004 ($155.60 in chips) 
Seat 7: sanpidk ($105.21 in chips) 
Seat 8: cdv1984 ($101.50 in chips) 
Seat 9: matiko09 ($206.10 in chips) 
elbiber2000: posts small blind $0.50
godfrey004: posts big blind $1
*** HOLE CARDS ***
Dealt to matiko09 [As 3d]
sanpidk: folds 
cdv1984: folds 
matiko09: folds 
Red4erT: raises $2 to $3
holloway85: folds 
mitchymitch3: folds 
elbiber2000: folds 
godfrey004: calls $2
*** FLOP *** [4d Ah 8c]
godfrey004: checks 
Red4erT: checks 
*** TURN *** [4d Ah 8c] [9s]
godfrey004: bets $5
Red4erT: folds 
Uncalled bet ($5) returned to godfrey004
godfrey004 collected $6.18 from pot
godfrey004: doesn't show hand 
*** SUMMARY ***
Total pot $6.50 | Rake $0.32 
Board [4d Ah 8c 9s]
Seat 1: Red4erT folded on the Turn
Seat 2: holloway85 folded before Flop (didn't bet)
Seat 3: mitchymitch3 (button) folded before Flop (didn't bet)
Seat 5: elbiber2000 (small blind) folded before Flop
Seat 6: godfrey004 (big blind) collected ($6.18)
Seat 7: sanpidk folded before Flop (didn't bet)
Seat 8: cdv1984 folded before Flop (didn't bet)
Seat 9: matiko09 folded before Flop (didn't bet)





PokerStars Hand #151164760963:  Hold'em No Limit ($0.50/$1.00 USD) - 2016/03/30 16:23:16 CET [2016/03/30 10:23:16 ET]
Table 'Amata II' 9-max Seat #5 is the button
Seat 2: ilaviiitech ($114.95 in chips) 
Seat 3: matiko09 ($186.75 in chips) 
Seat 5: Spid1 ($100 in chips) 
Seat 6: RamiroAgujis ($117.03 in chips) 
Seat 7: Pvsx. ($192.51 in chips) 
Seat 9: kaya.ertugrul88 ($121.88 in chips) 
RamiroAgujis: posts small blind $0.50
Pvsx.: posts big blind $1
ka100pka527: sits out 
*** HOLE CARDS ***
Dealt to matiko09 [6s 9s]
kaya.ertugrul88: folds 
ilaviiitech: folds 
matiko09: folds 
Spid1: raises $1.50 to $2.50
RamiroAgujis: raises $6.50 to $9
Pvsx.: folds 
Spid1: folds 
Uncalled bet ($6.50) returned to RamiroAgujis
RamiroAgujis collected $6 from pot
RamiroAgujis: doesn't show hand 
*** SUMMARY ***
Total pot $6 | Rake $0 
Seat 2: ilaviiitech folded before Flop (didn't bet)
Seat 3: matiko09 folded before Flop (didn't bet)
Seat 5: Spid1 (button) folded before Flop
Seat 6: RamiroAgujis (small blind) collected ($6)
Seat 7: Pvsx. (big blind) folded before Flop
Seat 9: kaya.ertugrul88 folded before Flop (didn't bet)





PokerStars Hand #151164765173:  Hold'em No Limit ($1/$2 USD) - 2016/03/30 16:23:23 CET [2016/03/30 10:23:23 ET]
Table 'Aesculapia II' 9-max Seat #1 is the button
Seat 1: buthmen ($369.03 in chips) 
Seat 2: suddend3ath ($200 in chips) 
Seat 3: matiko09 ($281.49 in chips) 
Seat 4: ki11u ($434.29 in chips) 
Seat 5: prominente ($200 in chips) 
Seat 7: Rumboni66 ($121.49 in chips) 
Seat 9: InsomniaRU ($218.75 in chips) 
suddend3ath: posts small blind $1
matiko09: posts big blind $2
volwebni4ek: sits out 
*** HOLE CARDS ***
Dealt to matiko09 [4d 7c]
ki11u: folds 
prominente: folds 
Rumboni66: folds 
InsomniaRU: raises $3 to $5
buthmen: folds 
suddend3ath: folds 
matiko09: folds 
Uncalled bet ($3) returned to InsomniaRU
InsomniaRU collected $5 from pot
InsomniaRU: doesn't show hand 
*** SUMMARY ***
Total pot $5 | Rake $0 
Seat 1: buthmen (button) folded before Flop (didn't bet)
Seat 2: suddend3ath (small blind) folded before Flop
Seat 3: matiko09 (big blind) folded before Flop
Seat 4: ki11u folded before Flop (didn't bet)
Seat 5: prominente folded before Flop (didn't bet)
Seat 7: Rumboni66 folded before Flop (didn't bet)
Seat 9: InsomniaRU collected ($5)





PokerStars Hand #151164765817:  Hold'em No Limit ($1/$2 USD) - 2016/03/30 16:23:24 CET [2016/03/30 10:23:24 ET]
Table 'Hektor III' 9-max Seat #9 is the button
Seat 1: matiko09 ($200 in chips) 
Seat 2: RamiroAgujis ($306.45 in chips) 
Seat 3: T0ny Adams ($89.09 in chips) 
Seat 4: volwebni4ek ($92.75 in chips) 
Seat 5: prominente ($276.75 in chips) 
Seat 7: InsomniaRU ($223.04 in chips) 
Seat 9: fonng ($332.49 in chips) 
matiko09: posts small blind $1
RamiroAgujis: posts big blind $2
tepi_guy: sits out 
*** HOLE CARDS ***
Dealt to matiko09 [7h 6c]
T0ny Adams: folds 
volwebni4ek: raises $4 to $6
prominente: calls $6
InsomniaRU: calls $6
fonng: calls $6
matiko09: folds 
RamiroAgujis: folds 
*** FLOP *** [7d Ks Ad]
volwebni4ek: bets $15
prominente: folds 
InsomniaRU: folds 
fonng: folds 
Uncalled bet ($15) returned to volwebni4ek
volwebni4ek collected $25.65 from pot
volwebni4ek: doesn't show hand 
*** SUMMARY ***
Total pot $27 | Rake $1.35 
Board [7d Ks Ad]
Seat 1: matiko09 (small blind) folded before Flop
Seat 2: RamiroAgujis (big blind) folded before Flop
Seat 3: T0ny Adams folded before Flop (didn't bet)
Seat 4: volwebni4ek collected ($25.65)
Seat 5: prominente folded on the Flop
Seat 7: InsomniaRU folded on the Flop
Seat 9: fonng (button) folded on the Flop





PokerStars Hand #151164769290:  Hold'em No Limit ($0.50/$1.00 USD) - 2016/03/30 16:23:29 CET [2016/03/30 10:23:29 ET]
Table 'Figneria III' 9-max Seat #7 is the button
Seat 1: matiko09 ($100 in chips) 
Seat 2: sanpidk ($100 in chips) 
Seat 4: CI58 ($100 in chips) 
Seat 7: holloway85 ($155.79 in chips) 
Seat 8: Dachish ($66.50 in chips) 
Seat 9: p.snow89 ($88.15 in chips) 
Dachish: posts small blind $0.50
p.snow89: posts big blind $1
volwebni4ek: sits out 
*** HOLE CARDS ***
Dealt to matiko09 [3s Jh]
matiko09: folds 
sanpidk: folds 
CI58: folds 
holloway85: folds 
Dachish: folds 
Uncalled bet ($0.50) returned to p.snow89
p.snow89 collected $1 from pot
p.snow89: doesn't show hand 
*** SUMMARY ***
Total pot $1 | Rake $0 
Seat 1: matiko09 folded before Flop (didn't bet)
Seat 2: sanpidk folded before Flop (didn't bet)
Seat 4: CI58 folded before Flop (didn't bet)
Seat 7: holloway85 (button) folded before Flop (didn't bet)
Seat 8: Dachish (small blind) folded before Flop
Seat 9: p.snow89 (big blind) collected ($1)





PokerStars Hand #151164774218:  Hold'em No Limit ($0.50/$1.00 USD) - 2016/03/30 16:23:36 CET [2016/03/30 10:23:36 ET]
Table 'Pannonia II' 9-max Seat #3 is the button
Seat 1: CI58 ($100 in chips) 
Seat 2: matiko09 ($100 in chips) 
Seat 3: MGL_Sky99 ($102.50 in chips) 
Seat 5: Spid1 ($125.87 in chips) 
Seat 7: volwebni4ek ($40 in chips) 
Seat 8: stonymalony ($60.12 in chips) 
Seat 9: b_____a__242 ($85.89 in chips) 
Spid1: posts small blind $0.50
volwebni4ek: posts big blind $1
*** HOLE CARDS ***
Dealt to matiko09 [7d Ts]
stonymalony: folds 
b_____a__242: folds 
CI58: raises $2 to $3
matiko09: folds 
MGL_Sky99: calls $3
Spid1: folds 
volwebni4ek: folds 
*** FLOP *** [5s 9s 3d]
CI58: checks 
MGL_Sky99: checks 
*** TURN *** [5s 9s 3d] [Th]
CI58: checks 
MGL_Sky99: bets $4.56
CI58: folds 
Uncalled bet ($4.56) returned to MGL_Sky99
MGL_Sky99 collected $7.12 from pot
MGL_Sky99: doesn't show hand 
*** SUMMARY ***
Total pot $7.50 | Rake $0.38 
Board [5s 9s 3d Th]
Seat 1: CI58 folded on the Turn
Seat 2: matiko09 folded before Flop (didn't bet)
Seat 3: MGL_Sky99 (button) collected ($7.12)
Seat 5: Spid1 (small blind) folded before Flop
Seat 7: volwebni4ek (big blind) folded before Flop
Seat 8: stonymalony folded before Flop (didn't bet)
Seat 9: b_____a__242 folded before Flop (didn't bet)





PokerStars Hand #151164775497:  Hold'em No Limit ($1/$2 USD) - 2016/03/30 16:23:38 CET [2016/03/30 10:23:38 ET]
Table 'Philoctetes II' 9-max Seat #4 is the button
Seat 1: vezunchik79 ($133.28 in chips) 
Seat 2: prominente ($200 in chips) 
Seat 3: mentalpshyco ($200 in chips) 
Seat 4: tepi_guy ($203.55 in chips) 
Seat 5: zhaimeng ($351.11 in chips) 
Seat 7: matiko09 ($200 in chips) 
Seat 8: suddend3ath ($200 in chips) 
Seat 9: RamiroAgujis ($240.30 in chips) 
zhaimeng: posts small blind $1
matiko09: posts big blind $2
*** HOLE CARDS ***
Dealt to matiko09 [4h Ks]
suddend3ath: raises $3 to $5
RamiroAgujis: folds 
vezunchik79: folds 
prominente: folds 
mentalpshyco: folds 
tepi_guy: folds 
zhaimeng: folds 
matiko09: folds 
Uncalled bet ($3) returned to suddend3ath
suddend3ath collected $5 from pot
suddend3ath: doesn't show hand 
*** SUMMARY ***
Total pot $5 | Rake $0 
Seat 1: vezunchik79 folded before Flop (didn't bet)
Seat 2: prominente folded before Flop (didn't bet)
Seat 3: mentalpshyco folded before Flop (didn't bet)
Seat 4: tepi_guy (button) folded before Flop (didn't bet)
Seat 5: zhaimeng (small blind) folded before Flop
Seat 7: matiko09 (big blind) folded before Flop
Seat 8: suddend3ath collected ($5)
Seat 9: RamiroAgujis folded before Flop (didn't bet)





PokerStars Hand #151164786514:  Hold'em No Limit ($0.50/$1.00 USD) - 2016/03/30 16:23:55 CET [2016/03/30 10:23:55 ET]
Table 'Amata II' 9-max Seat #6 is the button
Seat 2: ilaviiitech ($114.95 in chips) 
Seat 3: matiko09 ($186.75 in chips) 
Seat 5: Spid1 ($100 in chips) 
Seat 6: RamiroAgujis ($120.53 in chips) 
Seat 7: Pvsx. ($191.51 in chips) 
Seat 8: ka100pka527 ($56.22 in chips) 
Pvsx.: posts small blind $0.50
ka100pka527: posts big blind $1
*** HOLE CARDS ***
Dealt to matiko09 [Qh Ad]
ilaviiitech: folds 
matiko09: raises $2 to $3
Spid1: folds 
RamiroAgujis: folds 
Pvsx.: folds 
ka100pka527: folds 
Uncalled bet ($2) returned to matiko09
matiko09 collected $2.50 from pot
matiko09: doesn't show hand 
*** SUMMARY ***
Total pot $2.50 | Rake $0 
Seat 2: ilaviiitech folded before Flop (didn't bet)
Seat 3: matiko09 collected ($2.50)
Seat 5: Spid1 folded before Flop (didn't bet)
Seat 6: RamiroAgujis (button) folded before Flop (didn't bet)
Seat 7: Pvsx. (small blind) folded before Flop
Seat 8: ka100pka527 (big blind) folded before Flop





PokerStars Hand #151164786933:  Hold'em No Limit ($0.50/$1.00 USD) - 2016/03/30 16:23:55 CET [2016/03/30 10:23:55 ET]
Table 'Figneria III' 9-max Seat #8 is the button
Seat 1: matiko09 ($100 in chips) 
Seat 2: sanpidk ($100 in chips) 
Seat 4: CI58 ($100 in chips) 
Seat 7: holloway85 ($155.79 in chips) 
Seat 8: Dachish ($66 in chips) 
Seat 9: p.snow89 ($88.65 in chips) 
p.snow89: posts small blind $0.50
matiko09: posts big blind $1
volwebni4ek: sits out 
*** HOLE CARDS ***
Dealt to matiko09 [3s Kh]
sanpidk: folds 
CI58: folds 
holloway85: calls $1
Dachish: raises $3.50 to $4.50
p.snow89: calls $4
matiko09: folds 
holloway85: raises $6.50 to $11
Dachish: calls $6.50
p.snow89: calls $6.50
*** FLOP *** [8s 6s 6h]
p.snow89: checks 
holloway85: checks 
Dachish: checks 
*** TURN *** [8s 6s 6h] [5c]
p.snow89: bets $11
holloway85: calls $11
Dachish: calls $11
*** RIVER *** [8s 6s 6h 5c] [5s]
p.snow89: bets $20
holloway85: calls $20
Dachish: folds 
*** SHOW DOWN ***
p.snow89: shows [Ac 9h] (two pair, Sixes and Fives)
holloway85: shows [Ah Ad] (two pair, Aces and Sixes)
holloway85 collected $104.50 from pot
*** SUMMARY ***
Total pot $107 | Rake $2.50 
Board [8s 6s 6h 5c 5s]
Seat 1: matiko09 (big blind) folded before Flop
Seat 2: sanpidk folded before Flop (didn't bet)
Seat 4: CI58 folded before Flop (didn't bet)
Seat 7: holloway85 showed [Ah Ad] and won ($104.50) with two pair, Aces and Sixes
Seat 8: Dachish (button) folded on the River
Seat 9: p.snow89 (small blind) showed [Ac 9h] and lost with two pair, Sixes and Fives





PokerStars Hand #151164789384:  Hold'em No Limit ($1/$2 USD) - 2016/03/30 16:23:59 CET [2016/03/30 10:23:59 ET]
Table 'Aesculapia II' 9-max Seat #2 is the button
Seat 1: buthmen ($369.03 in chips) 
Seat 2: suddend3ath ($200 in chips) 
Seat 3: matiko09 ($279.49 in chips) 
Seat 5: prominente ($200 in chips) 
Seat 7: Rumboni66 ($121.49 in chips) 
Seat 9: InsomniaRU ($221.75 in chips) 
matiko09: posts small blind $1
ki11u: is sitting out 
ki11u leaves the table
prominente: posts big blind $2
volwebni4ek: sits out 
*** HOLE CARDS ***
Dealt to matiko09 [Jc 9c]
Rumboni66: folds 
InsomniaRU: folds 
buthmen: folds 
suddend3ath: raises $3 to $5
matiko09: raises $13 to $18
prominente: folds 
suddend3ath: calls $13
*** FLOP *** [3c 4c 5s]
matiko09: bets $20
suddend3ath: raises $32 to $52
matiko09: calls $32
*** TURN *** [3c 4c 5s] [Kc]
matiko09: checks 
suddend3ath: bets $130 and is all-in
matiko09: calls $130
*** RIVER *** [3c 4c 5s Kc] [2c]
*** SHOW DOWN ***
matiko09: shows [Jc 9c] (a flush, King high)
suddend3ath: mucks hand 
matiko09 collected $399.25 from pot
*** SUMMARY ***
Total pot $402 | Rake $2.75 
Board [3c 4c 5s Kc 2c]
Seat 1: buthmen folded before Flop (didn't bet)
Seat 2: suddend3ath (button) mucked [3h 3d]
Seat 3: matiko09 (small blind) showed [Jc 9c] and won ($399.25) with a flush, King high
Seat 5: prominente (big blind) folded before Flop
Seat 7: Rumboni66 folded before Flop (didn't bet)
Seat 9: InsomniaRU folded before Flop (didn't bet)





PokerStars Hand #151164795333:  Hold'em No Limit ($1/$2 USD) - 2016/03/30 16:24:08 CET [2016/03/30 10:24:08 ET]
Table 'Philoctetes II' 9-max Seat #5 is the button
Seat 1: vezunchik79 ($133.28 in chips) 
Seat 2: prominente ($200 in chips) 
Seat 3: mentalpshyco ($200 in chips) 
Seat 4: tepi_guy ($203.55 in chips) 
Seat 5: zhaimeng ($350.11 in chips) 
Seat 7: matiko09 ($200 in chips) 
Seat 8: suddend3ath ($203 in chips) 
Seat 9: RamiroAgujis ($240.30 in chips) 
matiko09: posts small blind $1
suddend3ath: posts big blind $2
*** HOLE CARDS ***
Dealt to matiko09 [9c 8s]
RamiroAgujis: folds 
vezunchik79: folds 
prominente: folds 
mentalpshyco: folds 
tepi_guy: folds 
zhaimeng: raises $5 to $7
matiko09: folds 
suddend3ath: folds 
Uncalled bet ($5) returned to zhaimeng
zhaimeng collected $5 from pot
zhaimeng: doesn't show hand 
*** SUMMARY ***
Total pot $5 | Rake $0 
Seat 1: vezunchik79 folded before Flop (didn't bet)
Seat 2: prominente folded before Flop (didn't bet)
Seat 3: mentalpshyco folded before Flop (didn't bet)
Seat 4: tepi_guy folded before Flop (didn't bet)
Seat 5: zhaimeng (button) collected ($5)
Seat 7: matiko09 (small blind) folded before Flop
Seat 8: suddend3ath (big blind) folded before Flop
Seat 9: RamiroAgujis folded before Flop (didn't bet)





PokerStars Hand #151164797845:  Hold'em No Limit ($0.50/$1.00 USD) - 2016/03/30 16:24:11 CET [2016/03/30 10:24:11 ET]
Table 'Amata II' 9-max Seat #7 is the button
Seat 2: ilaviiitech ($114.95 in chips) 
Seat 3: matiko09 ($188.25 in chips) 
Seat 5: Spid1 ($100 in chips) 
Seat 6: RamiroAgujis ($120.53 in chips) 
Seat 7: Pvsx. ($191.01 in chips) 
Seat 8: ka100pka527 ($55.22 in chips) 
ka100pka527: posts small blind $0.50
e306 was removed from the table for failing to post
ilaviiitech: posts big blind $1
*** HOLE CARDS ***
Dealt to matiko09 [Tc Kc]
IdiotFromNE joins the table at seat #1 
matiko09: raises $2 to $3
Spid1: folds 
RamiroAgujis: folds 
Pvsx.: folds 
ka100pka527: folds 
ilaviiitech: folds 
Uncalled bet ($2) returned to matiko09
matiko09 collected $2.50 from pot
matiko09: doesn't show hand 
*** SUMMARY ***
Total pot $2.50 | Rake $0 
Seat 2: ilaviiitech (big blind) folded before Flop
Seat 3: matiko09 collected ($2.50)
Seat 5: Spid1 folded before Flop (didn't bet)
Seat 6: RamiroAgujis folded before Flop (didn't bet)
Seat 7: Pvsx. (button) folded before Flop (didn't bet)
Seat 8: ka100pka527 (small blind) folded before Flop





PokerStars Hand #151164804034:  Hold'em No Limit ($0.50/$1.00 USD) - 2016/03/30 16:24:21 CET [2016/03/30 10:24:21 ET]
Table 'Alcor II' 9-max Seat #5 is the button
Seat 1: Red4erT ($112.62 in chips) 
Seat 2: holloway85 ($77.46 in chips) 
Seat 3: mitchymitch3 ($100 in chips) 
Seat 5: elbiber2000 ($102.62 in chips) 
Seat 6: godfrey004 ($158.78 in chips) 
Seat 7: sanpidk ($105.21 in chips) 
Seat 8: cdv1984 ($101.50 in chips) 
Seat 9: matiko09 ($206.10 in chips) 
godfrey004: posts small blind $0.50
sanpidk: posts big blind $1
*** HOLE CARDS ***
Dealt to matiko09 [Qh Ts]
cdv1984: folds 
matiko09: folds 
Red4erT: folds 
holloway85: folds 
mitchymitch3: folds 
elbiber2000: raises $2 to $3
godfrey004: calls $2.50
sanpidk: folds 
*** FLOP *** [3h 8c 2c]
godfrey004: checks 
elbiber2000: checks 
*** TURN *** [3h 8c 2c] [3d]
godfrey004: checks 
elbiber2000: bets $3
godfrey004: calls $3
*** RIVER *** [3h 8c 2c 3d] [Ks]
godfrey004: checks 
elbiber2000: checks 
*** SHOW DOWN ***
godfrey004: shows [Ac Jh] (a pair of Threes)
elbiber2000: mucks hand 
godfrey004 collected $12.35 from pot
*** SUMMARY ***
Total pot $13 | Rake $0.65 
Board [3h 8c 2c 3d Ks]
Seat 1: Red4erT folded before Flop (didn't bet)
Seat 2: holloway85 folded before Flop (didn't bet)
Seat 3: mitchymitch3 folded before Flop (didn't bet)
Seat 5: elbiber2000 (button) mucked [As Th]
Seat 6: godfrey004 (small blind) showed [Ac Jh] and won ($12.35) with a pair of Threes
Seat 7: sanpidk (big blind) folded before Flop
Seat 8: cdv1984 folded before Flop (didn't bet)
Seat 9: matiko09 folded before Flop (didn't bet)





PokerStars Hand #151164810260:  Hold'em No Limit ($1/$2 USD) - 2016/03/30 16:24:30 CET [2016/03/30 10:24:30 ET]
Table 'Jole' 9-max Seat #2 is the button
Seat 1: matiko09 ($200 in chips) 
Seat 2: RamiroAgujis ($304.76 in chips) 
Seat 4: volwebni4ek ($88.66 in chips) 
Seat 5: dunga119 ($178.88 in chips) 
Seat 6: King_ZéManel ($210.05 in chips) 
Seat 7: ilaviiitech ($272.16 in chips) 
Seat 9: Ravnica11 ($77 in chips) 
volwebni4ek: posts small blind $1
dunga119: posts big blind $2
*** HOLE CARDS ***
Dealt to matiko09 [6d 2s]
King_ZéManel: folds 
ilaviiitech: folds 
Ravnica11: folds 
matiko09: folds 
RamiroAgujis: raises $3 to $5
volwebni4ek: folds 
dunga119: folds 
Uncalled bet ($3) returned to RamiroAgujis
RamiroAgujis collected $5 from pot
RamiroAgujis: doesn't show hand 
*** SUMMARY ***
Total pot $5 | Rake $0 
Seat 1: matiko09 folded before Flop (didn't bet)
Seat 2: RamiroAgujis (button) collected ($5)
Seat 4: volwebni4ek (small blind) folded before Flop
Seat 5: dunga119 (big blind) folded before Flop
Seat 6: King_ZéManel folded before Flop (didn't bet)
Seat 7: ilaviiitech folded before Flop (didn't bet)
Seat 9: Ravnica11 folded before Flop (didn't bet)





PokerStars Hand #151164810841:  Hold'em No Limit ($0.50/$1.00 USD) - 2016/03/30 16:24:31 CET [2016/03/30 10:24:31 ET]
Table 'Amata II' 9-max Seat #8 is the button
Seat 2: ilaviiitech ($113.95 in chips) 
Seat 3: matiko09 ($189.75 in chips) 
Seat 5: Spid1 ($100 in chips) 
Seat 6: RamiroAgujis ($120.53 in chips) 
Seat 7: Pvsx. ($191.01 in chips) 
Seat 8: ka100pka527 ($54.72 in chips) 
IdiotFromNE will be allowed to play after the button
ilaviiitech: posts small blind $0.50
matiko09: posts big blind $1
*** HOLE CARDS ***
Dealt to matiko09 [9s 7d]
Spid1: folds 
RamiroAgujis: folds 
Pvsx.: folds 
ka100pka527: folds 
ilaviiitech: folds 
Uncalled bet ($0.50) returned to matiko09
matiko09 collected $1 from pot
matiko09: doesn't show hand 
*** SUMMARY ***
Total pot $1 | Rake $0 
Seat 2: ilaviiitech (small blind) folded before Flop
Seat 3: matiko09 (big blind) collected ($1)
Seat 5: Spid1 folded before Flop (didn't bet)
Seat 6: RamiroAgujis folded before Flop (didn't bet)
Seat 7: Pvsx. folded before Flop (didn't bet)
Seat 8: ka100pka527 (button) folded before Flop (didn't bet)





PokerStars Hand #151164813863:  Hold'em No Limit ($0.50/$1.00 USD) - 2016/03/30 16:24:35 CET [2016/03/30 10:24:35 ET]
Table 'Pannonia II' 9-max Seat #5 is the button
Seat 1: CI58 ($100 in chips) 
Seat 2: matiko09 ($100 in chips) 
Seat 3: MGL_Sky99 ($106.62 in chips) 
Seat 5: Spid1 ($125.37 in chips) 
Seat 7: volwebni4ek ($40 in chips) 
Seat 8: stonymalony ($60.12 in chips) 
Seat 9: b_____a__242 ($85.89 in chips) 
volwebni4ek: posts small blind $0.50
stonymalony: posts big blind $1
*** HOLE CARDS ***
Dealt to matiko09 [5h Jh]
b_____a__242: folds 
CI58: folds 
matiko09: folds 
MGL_Sky99: folds 
Spid1: raises $1.50 to $2.50
volwebni4ek: folds 
stonymalony: calls $1.50
*** FLOP *** [Jd 7c 8h]
stonymalony: checks 
Spid1: bets $3.50
stonymalony: calls $3.50
*** TURN *** [Jd 7c 8h] [6s]
stonymalony: checks 
Spid1: checks 
*** RIVER *** [Jd 7c 8h 6s] [4c]
stonymalony: checks 
Spid1: bets $8.50
stonymalony: calls $8.50
*** SHOW DOWN ***
Spid1: shows [Ad 2s] (high card Ace)
stonymalony: shows [8c As] (a pair of Eights)
stonymalony collected $28.02 from pot
*** SUMMARY ***
Total pot $29.50 | Rake $1.48 
Board [Jd 7c 8h 6s 4c]
Seat 1: CI58 folded before Flop (didn't bet)
Seat 2: matiko09 folded before Flop (didn't bet)
Seat 3: MGL_Sky99 folded before Flop (didn't bet)
Seat 5: Spid1 (button) showed [Ad 2s] and lost with high card Ace
Seat 7: volwebni4ek (small blind) folded before Flop
Seat 8: stonymalony (big blind) showed [8c As] and won ($28.02) with a pair of Eights
Seat 9: b_____a__242 folded before Flop (didn't bet)





PokerStars Hand #151164818797:  Hold'em No Limit ($1/$2 USD) - 2016/03/30 16:24:43 CET [2016/03/30 10:24:43 ET]
Table 'Hektor III' 9-max Seat #1 is the button
Seat 1: matiko09 ($200 in chips) 
Seat 2: RamiroAgujis ($304.45 in chips) 
Seat 3: T0ny Adams ($89.09 in chips) 
Seat 4: volwebni4ek ($112.40 in chips) 
Seat 5: prominente ($270.75 in chips) 
Seat 7: InsomniaRU ($217.04 in chips) 
Seat 9: fonng ($326.49 in chips) 
RamiroAgujis: posts small blind $1
T0ny Adams: posts big blind $2
tepi_guy: sits out 
*** HOLE CARDS ***
Dealt to matiko09 [3d 2d]
volwebni4ek: folds 
prominente: raises $3 to $5
InsomniaRU: folds 
fonng: calls $5
matiko09: folds 
RamiroAgujis: calls $4
T0ny Adams: calls $3
*** FLOP *** [4c 2h 8d]
RamiroAgujis: checks 
T0ny Adams: checks 
prominente: checks 
fonng: bets $10
RamiroAgujis: folds 
T0ny Adams: folds 
prominente: calls $10
*** TURN *** [4c 2h 8d] [5d]
prominente: checks 
fonng: checks 
*** RIVER *** [4c 2h 8d 5d] [Ac]
prominente: bets $27.33
fonng: folds 
Uncalled bet ($27.33) returned to prominente
prominente collected $38 from pot
prominente: doesn't show hand 
*** SUMMARY ***
Total pot $40 | Rake $2 
Board [4c 2h 8d 5d Ac]
Seat 1: matiko09 (button) folded before Flop (didn't bet)
Seat 2: RamiroAgujis (small blind) folded on the Flop
Seat 3: T0ny Adams (big blind) folded on the Flop
Seat 4: volwebni4ek folded before Flop (didn't bet)
Seat 5: prominente collected ($38)
Seat 7: InsomniaRU folded before Flop (didn't bet)
Seat 9: fonng folded on the River





PokerStars Hand #151164821132:  Hold'em No Limit ($1/$2 USD) - 2016/03/30 16:24:46 CET [2016/03/30 10:24:46 ET]
Table 'Philoctetes II' 9-max Seat #7 is the button
Seat 1: vezunchik79 ($133.28 in chips) 
Seat 2: prominente ($200 in chips) 
Seat 3: mentalpshyco ($200 in chips) 
Seat 4: tepi_guy ($203.55 in chips) 
Seat 5: zhaimeng ($353.11 in chips) 
Seat 7: matiko09 ($200 in chips) 
Seat 8: suddend3ath ($201 in chips) 
Seat 9: RamiroAgujis ($240.30 in chips) 
suddend3ath: posts small blind $1
RamiroAgujis: posts big blind $2
*** HOLE CARDS ***
Dealt to matiko09 [Js 7h]
vezunchik79: folds 
prominente: folds 
mentalpshyco: raises $3 to $5
tepi_guy: folds 
zhaimeng: calls $5
matiko09: folds 
suddend3ath: folds 
RamiroAgujis: folds 
*** FLOP *** [7c 9c Qs]
mentalpshyco: checks 
zhaimeng: bets $6.17
mentalpshyco: folds 
Uncalled bet ($6.17) returned to zhaimeng
zhaimeng collected $12.35 from pot
zhaimeng: doesn't show hand 
*** SUMMARY ***
Total pot $13 | Rake $0.65 
Board [7c 9c Qs]
Seat 1: vezunchik79 folded before Flop (didn't bet)
Seat 2: prominente folded before Flop (didn't bet)
Seat 3: mentalpshyco folded on the Flop
Seat 4: tepi_guy folded before Flop (didn't bet)
Seat 5: zhaimeng collected ($12.35)
Seat 7: matiko09 (button) folded before Flop (didn't bet)
Seat 8: suddend3ath (small blind) folded before Flop
Seat 9: RamiroAgujis (big blind) folded before Flop





PokerStars Hand #151164821384:  Hold'em No Limit ($0.50/$1.00 USD) - 2016/03/30 16:24:46 CET [2016/03/30 10:24:46 ET]
Table 'Amata II' 9-max Seat #2 is the button
Seat 2: ilaviiitech ($113.45 in chips) 
Seat 3: matiko09 ($190.25 in chips) 
Seat 5: Spid1 ($100 in chips) 
Seat 6: RamiroAgujis ($120.53 in chips) 
Seat 7: Pvsx. ($191.01 in chips) 
Seat 8: ka100pka527 ($54.72 in chips) 
matiko09: posts small blind $0.50
Spid1: posts big blind $1
IdiotFromNE: sits out 
*** HOLE CARDS ***
Dealt to matiko09 [Qc 2s]
RamiroAgujis: folds 
Pvsx.: folds 
ka100pka527: folds 
ilaviiitech: raises $2 to $3
matiko09: folds 
Spid1: folds 
Uncalled bet ($2) returned to ilaviiitech
ilaviiitech collected $2.50 from pot
ilaviiitech: doesn't show hand 
*** SUMMARY ***
Total pot $2.50 | Rake $0 
Seat 2: ilaviiitech (button) collected ($2.50)
Seat 3: matiko09 (small blind) folded before Flop
Seat 5: Spid1 (big blind) folded before Flop
Seat 6: RamiroAgujis folded before Flop (didn't bet)
Seat 7: Pvsx. folded before Flop (didn't bet)
Seat 8: ka100pka527 folded before Flop (didn't bet)





PokerStars Hand #151164821861:  Hold'em No Limit ($1/$2 USD) - 2016/03/30 16:24:47 CET [2016/03/30 10:24:47 ET]
Table 'Jole' 9-max Seat #4 is the button
Seat 1: matiko09 ($200 in chips) 
Seat 2: RamiroAgujis ($307.76 in chips) 
Seat 4: volwebni4ek ($87.66 in chips) 
Seat 5: dunga119 ($200 in chips) 
Seat 6: King_ZéManel ($210.05 in chips) 
Seat 7: ilaviiitech ($272.16 in chips) 
Seat 9: Ravnica11 ($77 in chips) 
dunga119: posts small blind $1
King_ZéManel: posts big blind $2
*** HOLE CARDS ***
Dealt to matiko09 [9d 3h]
ilaviiitech: folds 
Ravnica11: folds 
matiko09: folds 
RamiroAgujis: folds 
volwebni4ek: raises $2 to $4
dunga119: raises $10 to $14
King_ZéManel: folds 
volwebni4ek: folds 
Uncalled bet ($10) returned to dunga119
dunga119 collected $10 from pot
dunga119: doesn't show hand 
*** SUMMARY ***
Total pot $10 | Rake $0 
Seat 1: matiko09 folded before Flop (didn't bet)
Seat 2: RamiroAgujis folded before Flop (didn't bet)
Seat 4: volwebni4ek (button) folded before Flop
Seat 5: dunga119 (small blind) collected ($10)
Seat 6: King_ZéManel (big blind) folded before Flop
Seat 7: ilaviiitech folded before Flop (didn't bet)
Seat 9: Ravnica11 folded before Flop (didn't bet)





PokerStars Hand #151164832044:  Hold'em No Limit ($1/$2 USD) - 2016/03/30 16:25:02 CET [2016/03/30 10:25:02 ET]
Table 'Aesculapia II' 9-max Seat #3 is the button
Seat 1: buthmen ($369.03 in chips) 
Seat 2: suddend3ath ($200 in chips) 
Seat 3: matiko09 ($478.74 in chips) 
Seat 5: prominente ($200 in chips) 
Seat 6: volwebni4ek ($80 in chips) 
Seat 7: Rumboni66 ($121.49 in chips) 
Seat 9: InsomniaRU ($221.75 in chips) 
prominente: posts small blind $1
volwebni4ek: posts big blind $2
*** HOLE CARDS ***
Dealt to matiko09 [Jc 3s]
Rumboni66: folds 
o.miro joins the table at seat #4 
InsomniaRU: folds 
buthmen: folds 
suddend3ath: folds 
matiko09: folds 
o.miro leaves the table
tepi_guy joins the table at seat #4 
prominente: folds 
Uncalled bet ($1) returned to volwebni4ek
volwebni4ek collected $2 from pot
volwebni4ek: doesn't show hand 
*** SUMMARY ***
Total pot $2 | Rake $0 
Seat 1: buthmen folded before Flop (didn't bet)
Seat 2: suddend3ath folded before Flop (didn't bet)
Seat 3: matiko09 (button) folded before Flop (didn't bet)
Seat 5: prominente (small blind) folded before Flop
Seat 6: volwebni4ek (big blind) collected ($2)
Seat 7: Rumboni66 folded before Flop (didn't bet)
Seat 9: InsomniaRU folded before Flop (didn't bet)





PokerStars Hand #151164834965:  Hold'em No Limit ($0.50/$1.00 USD) - 2016/03/30 16:25:07 CET [2016/03/30 10:25:07 ET]
Table 'Amata II' 9-max Seat #3 is the button
Seat 2: ilaviiitech ($114.95 in chips) 
Seat 3: matiko09 ($189.75 in chips) 
Seat 5: Spid1 ($100 in chips) 
Seat 6: RamiroAgujis ($120.53 in chips) 
Seat 7: Pvsx. ($191.01 in chips) 
Seat 8: ka100pka527 ($54.72 in chips) 
Spid1: posts small blind $0.50
RamiroAgujis: posts big blind $1
IdiotFromNE: sits out 
*** HOLE CARDS ***
Dealt to matiko09 [7d Kh]
Pvsx.: folds 
ka100pka527: raises $1 to $2
ilaviiitech: folds 
matiko09: folds 
Spid1: folds 
RamiroAgujis: folds 
Uncalled bet ($1) returned to ka100pka527
ka100pka527 collected $2.50 from pot
ka100pka527: doesn't show hand 
*** SUMMARY ***
Total pot $2.50 | Rake $0 
Seat 2: ilaviiitech folded before Flop (didn't bet)
Seat 3: matiko09 (button) folded before Flop (didn't bet)
Seat 5: Spid1 (small blind) folded before Flop
Seat 6: RamiroAgujis (big blind) folded before Flop
Seat 7: Pvsx. folded before Flop (didn't bet)
Seat 8: ka100pka527 collected ($2.50)





PokerStars Hand #151164844976:  Hold'em No Limit ($1/$2 USD) - 2016/03/30 16:25:22 CET [2016/03/30 10:25:22 ET]
Table 'Jole' 9-max Seat #5 is the button
Seat 1: matiko09 ($200 in chips) 
Seat 2: RamiroAgujis ($307.76 in chips) 
Seat 4: volwebni4ek ($83.66 in chips) 
Seat 5: dunga119 ($206 in chips) 
Seat 6: King_ZéManel ($208.05 in chips) 
Seat 7: ilaviiitech ($272.16 in chips) 
Seat 9: Ravnica11 ($77 in chips) 
King_ZéManel: posts small blind $1
ilaviiitech: posts big blind $2
*** HOLE CARDS ***
Dealt to matiko09 [Js 7h]
Ravnica11: folds 
matiko09: folds 
RamiroAgujis: folds 
volwebni4ek: folds 
dunga119: folds 
King_ZéManel: raises $4 to $6
ilaviiitech: raises $12 to $18
King_ZéManel: folds 
Uncalled bet ($12) returned to ilaviiitech
ilaviiitech collected $12 from pot
ilaviiitech: doesn't show hand 
*** SUMMARY ***
Total pot $12 | Rake $0 
Seat 1: matiko09 folded before Flop (didn't bet)
Seat 2: RamiroAgujis folded before Flop (didn't bet)
Seat 4: volwebni4ek folded before Flop (didn't bet)
Seat 5: dunga119 (button) folded before Flop (didn't bet)
Seat 6: King_ZéManel (small blind) folded before Flop
Seat 7: ilaviiitech (big blind) collected ($12)
Seat 9: Ravnica11 folded before Flop (didn't bet)





PokerStars Hand #151164848673:  Hold'em No Limit ($0.50/$1.00 USD) - 2016/03/30 16:25:27 CET [2016/03/30 10:25:27 ET]
Table 'Amata II' 9-max Seat #5 is the button
Seat 2: ilaviiitech ($114.95 in chips) 
Seat 3: matiko09 ($189.75 in chips) 
Seat 5: Spid1 ($100 in chips) 
Seat 6: RamiroAgujis ($119.53 in chips) 
Seat 7: Pvsx. ($191.01 in chips) 
Seat 8: ka100pka527 ($56.22 in chips) 
RamiroAgujis: posts small blind $0.50
Pvsx.: posts big blind $1
IdiotFromNE: sits out 
*** HOLE CARDS ***
Dealt to matiko09 [4c Jc]
ka100pka527: folds 
ilaviiitech: folds 
matiko09: folds 
Spid1: raises $1.50 to $2.50
RamiroAgujis: folds 
Pvsx.: folds 
Uncalled bet ($1.50) returned to Spid1
Spid1 collected $2.50 from pot
Spid1: doesn't show hand 
*** SUMMARY ***
Total pot $2.50 | Rake $0 
Seat 2: ilaviiitech folded before Flop (didn't bet)
Seat 3: matiko09 folded before Flop (didn't bet)
Seat 5: Spid1 (button) collected ($2.50)
Seat 6: RamiroAgujis (small blind) folded before Flop
Seat 7: Pvsx. (big blind) folded before Flop
Seat 8: ka100pka527 folded before Flop (didn't bet)





PokerStars Hand #151164851325:  Hold'em No Limit ($0.50/$1.00 USD) - 2016/03/30 16:25:31 CET [2016/03/30 10:25:31 ET]
Table 'Figneria III' 9-max Seat #9 is the button
Seat 1: matiko09 ($100 in chips) 
Seat 2: sanpidk ($100 in chips) 
Seat 4: CI58 ($100 in chips) 
Seat 7: holloway85 ($218.29 in chips) 
Seat 8: Dachish ($70 in chips) 
Seat 9: p.snow89 ($46.65 in chips) 
matiko09: posts small blind $0.50
sanpidk: posts big blind $1
volwebni4ek: sits out 
*** HOLE CARDS ***
Dealt to matiko09 [Ad 3h]
CI58: folds 
holloway85: folds 
Dachish: folds 
p.snow89: calls $1
matiko09: calls $0.50
sanpidk: raises $4.50 to $5.50
p.snow89: folds 
matiko09: folds 
Uncalled bet ($4.50) returned to sanpidk
sanpidk collected $3 from pot
sanpidk: doesn't show hand 
*** SUMMARY ***
Total pot $3 | Rake $0 
Seat 1: matiko09 (small blind) folded before Flop
Seat 2: sanpidk (big blind) collected ($3)
Seat 4: CI58 folded before Flop (didn't bet)
Seat 7: holloway85 folded before Flop (didn't bet)
Seat 8: Dachish folded before Flop (didn't bet)
Seat 9: p.snow89 (button) folded before Flop





PokerStars Hand #151164853145:  Hold'em No Limit ($0.50/$1.00 USD) - 2016/03/30 16:25:34 CET [2016/03/30 10:25:34 ET]
Table 'Alcor II' 9-max Seat #6 is the button
Seat 1: Red4erT ($112.62 in chips) 
Seat 2: holloway85 ($77.46 in chips) 
Seat 3: mitchymitch3 ($100 in chips) 
Seat 5: elbiber2000 ($100 in chips) 
Seat 6: godfrey004 ($165.13 in chips) 
Seat 7: sanpidk ($104.21 in chips) 
Seat 9: matiko09 ($206.10 in chips) 
sanpidk: posts small blind $0.50
cdv1984: is sitting out 
matiko09: posts big blind $1
*** HOLE CARDS ***
Dealt to matiko09 [4s 9d]
cdv1984 leaves the table
Dachish joins the table at seat #8 
Red4erT: raises $2 to $3
Dachish leaves the table
volwebni4ek joins the table at seat #8 
volwebni4ek leaves the table
holloway85: folds 
mitchymitch3: folds 
elbiber2000: folds 
RICKA16 joins the table at seat #8 
godfrey004: calls $3
sanpidk: folds 
matiko09: folds 
*** FLOP *** [Kd 7s Tc]
RICKA16 leaves the table
Red4erT: checks 
godfrey004: checks 
*** TURN *** [Kd 7s Tc] [Jd]
Red4erT: checks 
godfrey004: bets $4
Red4erT: folds 
Uncalled bet ($4) returned to godfrey004
godfrey004 collected $7.12 from pot
godfrey004: doesn't show hand 
*** SUMMARY ***
Total pot $7.50 | Rake $0.38 
Board [Kd 7s Tc Jd]
Seat 1: Red4erT folded on the Turn
Seat 2: holloway85 folded before Flop (didn't bet)
Seat 3: mitchymitch3 folded before Flop (didn't bet)
Seat 5: elbiber2000 folded before Flop (didn't bet)
Seat 6: godfrey004 (button) collected ($7.12)
Seat 7: sanpidk (small blind) folded before Flop
Seat 9: matiko09 (big blind) folded before Flop





PokerStars Hand #151164856801:  Hold'em No Limit ($0.50/$1.00 USD) - 2016/03/30 16:25:40 CET [2016/03/30 10:25:40 ET]
Table 'Pannonia II' 9-max Seat #7 is the button
Seat 1: CI58 ($100 in chips) 
Seat 2: matiko09 ($100 in chips) 
Seat 3: MGL_Sky99 ($106.62 in chips) 
Seat 5: Spid1 ($110.87 in chips) 
Seat 7: volwebni4ek ($40 in chips) 
Seat 8: stonymalony ($73.64 in chips) 
Seat 9: b_____a__242 ($85.89 in chips) 
stonymalony: posts small blind $0.50
b_____a__242: posts big blind $1
*** HOLE CARDS ***
Dealt to matiko09 [Jd 8c]
CI58: folds 
matiko09: folds 
MGL_Sky99: raises $2 to $3
Spid1: folds 
volwebni4ek: folds 
stonymalony: folds 
b_____a__242: folds 
Uncalled bet ($2) returned to MGL_Sky99
MGL_Sky99 collected $2.50 from pot
MGL_Sky99: doesn't show hand 
*** SUMMARY ***
Total pot $2.50 | Rake $0 
Seat 1: CI58 folded before Flop (didn't bet)
Seat 2: matiko09 folded before Flop (didn't bet)
Seat 3: MGL_Sky99 collected ($2.50)
Seat 5: Spid1 folded before Flop (didn't bet)
Seat 7: volwebni4ek (button) folded before Flop (didn't bet)
Seat 8: stonymalony (small blind) folded before Flop
Seat 9: b_____a__242 (big blind) folded before Flop





PokerStars Hand #151164861559:  Hold'em No Limit ($1/$2 USD) - 2016/03/30 16:25:47 CET [2016/03/30 10:25:47 ET]
Table 'Aesculapia II' 9-max Seat #5 is the button
Seat 1: buthmen ($369.03 in chips) 
Seat 2: suddend3ath ($200 in chips) 
Seat 3: matiko09 ($478.74 in chips) 
Seat 5: prominente ($200 in chips) 
Seat 6: volwebni4ek ($81 in chips) 
Seat 7: Rumboni66 ($121.49 in chips) 
Seat 9: InsomniaRU ($221.75 in chips) 
volwebni4ek: posts small blind $1
Rumboni66: posts big blind $2
tepi_guy: sits out 
*** HOLE CARDS ***
Dealt to matiko09 [Qd 6c]
InsomniaRU: folds 
buthmen: raises $4 to $6
suddend3ath: folds 
matiko09: folds 
prominente: folds 
volwebni4ek: folds 
Rumboni66: folds 
Uncalled bet ($4) returned to buthmen
buthmen collected $5 from pot
buthmen: doesn't show hand 
*** SUMMARY ***
Total pot $5 | Rake $0 
Seat 1: buthmen collected ($5)
Seat 2: suddend3ath folded before Flop (didn't bet)
Seat 3: matiko09 folded before Flop (didn't bet)
Seat 5: prominente (button) folded before Flop (didn't bet)
Seat 6: volwebni4ek (small blind) folded before Flop
Seat 7: Rumboni66 (big blind) folded before Flop
Seat 9: InsomniaRU folded before Flop (didn't bet)





PokerStars Hand #151164861404:  Hold'em No Limit ($0.50/$1.00 USD) - 2016/03/30 16:25:47 CET [2016/03/30 10:25:47 ET]
Table 'Amata II' 9-max Seat #6 is the button
Seat 2: ilaviiitech ($114.95 in chips) 
Seat 3: matiko09 ($189.75 in chips) 
Seat 5: Spid1 ($101.50 in chips) 
Seat 6: RamiroAgujis ($119.03 in chips) 
Seat 7: Pvsx. ($190.01 in chips) 
Seat 8: ka100pka527 ($56.22 in chips) 
Pvsx.: posts small blind $0.50
ka100pka527: posts big blind $1
IdiotFromNE: sits out 
*** HOLE CARDS ***
Dealt to matiko09 [Jc Ah]
ilaviiitech: folds 
matiko09: raises $2 to $3
Spid1: folds 
RamiroAgujis: raises $6 to $9
Pvsx.: folds 
ka100pka527: folds 
matiko09: folds 
Uncalled bet ($6) returned to RamiroAgujis
RamiroAgujis collected $7.50 from pot
RamiroAgujis: doesn't show hand 
*** SUMMARY ***
Total pot $7.50 | Rake $0 
Seat 2: ilaviiitech folded before Flop (didn't bet)
Seat 3: matiko09 folded before Flop
Seat 5: Spid1 folded before Flop (didn't bet)
Seat 6: RamiroAgujis (button) collected ($7.50)
Seat 7: Pvsx. (small blind) folded before Flop
Seat 8: ka100pka527 (big blind) folded before Flop





PokerStars Hand #151164869861:  Hold'em No Limit ($0.50/$1.00 USD) - 2016/03/30 16:25:59 CET [2016/03/30 10:25:59 ET]
Table 'Pannonia II' 9-max Seat #8 is the button
Seat 1: CI58 ($100 in chips) 
Seat 2: matiko09 ($100 in chips) 
Seat 3: MGL_Sky99 ($108.12 in chips) 
Seat 5: Spid1 ($110.87 in chips) 
Seat 7: volwebni4ek ($40 in chips) 
Seat 8: stonymalony ($73.14 in chips) 
Seat 9: b_____a__242 ($84.89 in chips) 
b_____a__242: posts small blind $0.50
CI58: posts big blind $1
*** HOLE CARDS ***
Dealt to matiko09 [Qh Qd]
matiko09: raises $2 to $3
MGL_Sky99: folds 
Spid1: folds 
volwebni4ek: folds 
stonymalony: folds 
b_____a__242: folds 
CI58: folds 
Uncalled bet ($2) returned to matiko09
matiko09 collected $2.50 from pot
matiko09: doesn't show hand 
*** SUMMARY ***
Total pot $2.50 | Rake $0 
Seat 1: CI58 (big blind) folded before Flop
Seat 2: matiko09 collected ($2.50)
Seat 3: MGL_Sky99 folded before Flop (didn't bet)
Seat 5: Spid1 folded before Flop (didn't bet)
Seat 7: volwebni4ek folded before Flop (didn't bet)
Seat 8: stonymalony (button) folded before Flop (didn't bet)
Seat 9: b_____a__242 (small blind) folded before Flop





PokerStars Hand #151164871250:  Hold'em No Limit ($1/$2 USD) - 2016/03/30 16:26:01 CET [2016/03/30 10:26:01 ET]
Table 'Jole' 9-max Seat #6 is the button
Seat 1: matiko09 ($200 in chips) 
Seat 2: RamiroAgujis ($307.76 in chips) 
Seat 4: volwebni4ek ($83.66 in chips) 
Seat 5: dunga119 ($206 in chips) 
Seat 6: King_ZéManel ($202.05 in chips) 
Seat 7: ilaviiitech ($278.16 in chips) 
Seat 9: Ravnica11 ($77 in chips) 
ilaviiitech: posts small blind $1
Ravnica11: posts big blind $2
*** HOLE CARDS ***
Dealt to matiko09 [5s Ad]
prominente joins the table at seat #3 
matiko09: folds 
RamiroAgujis: folds 
volwebni4ek: folds 
dunga119: folds 
King_ZéManel: folds 
ilaviiitech: folds 
Uncalled bet ($1) returned to Ravnica11
Ravnica11 collected $2 from pot
*** SUMMARY ***
Total pot $2 | Rake $0 
Seat 1: matiko09 folded before Flop (didn't bet)
Seat 2: RamiroAgujis folded before Flop (didn't bet)
Seat 4: volwebni4ek folded before Flop (didn't bet)
Seat 5: dunga119 folded before Flop (didn't bet)
Seat 6: King_ZéManel (button) folded before Flop (didn't bet)
Seat 7: ilaviiitech (small blind) folded before Flop
Seat 9: Ravnica11 (big blind) collected ($2)





PokerStars Hand #151164880755:  Hold'em No Limit ($1/$2 USD) - 2016/03/30 16:26:16 CET [2016/03/30 10:26:16 ET]
Table 'Philoctetes II' 9-max Seat #8 is the button
Seat 1: vezunchik79 ($133.28 in chips) 
Seat 2: prominente ($200 in chips) 
Seat 3: mentalpshyco ($200 in chips) 
Seat 4: tepi_guy ($203.55 in chips) 
Seat 5: zhaimeng ($360.46 in chips) 
Seat 7: matiko09 ($200 in chips) 
Seat 8: suddend3ath ($200 in chips) 
Seat 9: RamiroAgujis ($238.30 in chips) 
RamiroAgujis: posts small blind $1
vezunchik79: posts big blind $2
*** HOLE CARDS ***
Dealt to matiko09 [Td 3s]
prominente: folds 
mentalpshyco: folds 
tepi_guy: folds 
zhaimeng: folds 
matiko09: folds 
suddend3ath: folds 
RamiroAgujis: raises $3 to $5
vezunchik79: folds 
Uncalled bet ($3) returned to RamiroAgujis
RamiroAgujis collected $4 from pot
RamiroAgujis: doesn't show hand 
*** SUMMARY ***
Total pot $4 | Rake $0 
Seat 1: vezunchik79 (big blind) folded before Flop
Seat 2: prominente folded before Flop (didn't bet)
Seat 3: mentalpshyco folded before Flop (didn't bet)
Seat 4: tepi_guy folded before Flop (didn't bet)
Seat 5: zhaimeng folded before Flop (didn't bet)
Seat 7: matiko09 folded before Flop (didn't bet)
Seat 8: suddend3ath (button) folded before Flop (didn't bet)
Seat 9: RamiroAgujis (small blind) collected ($4)





PokerStars Hand #151164883762:  Hold'em No Limit ($0.50/$1.00 USD) - 2016/03/30 16:26:20 CET [2016/03/30 10:26:20 ET]
Table 'Amata II' 9-max Seat #7 is the button
Seat 1: IdiotFromNE ($100 in chips) 
Seat 2: ilaviiitech ($114.95 in chips) 
Seat 3: matiko09 ($186.75 in chips) 
Seat 5: Spid1 ($101.50 in chips) 
Seat 6: RamiroAgujis ($123.53 in chips) 
Seat 7: Pvsx. ($189.51 in chips) 
Seat 8: ka100pka527 ($55.22 in chips) 
ka100pka527: posts small blind $0.50
IdiotFromNE: posts big blind $1
*** HOLE CARDS ***
Dealt to matiko09 [As Ad]
ilaviiitech: folds 
matiko09: raises $2 to $3
Spid1: folds 
RamiroAgujis: raises $6 to $9
Pvsx.: folds 
ka100pka527: folds 
IdiotFromNE: folds 
matiko09: raises $12 to $21
RamiroAgujis: calls $12
*** FLOP *** [5d 3d Tc]
matiko09: bets $14
RamiroAgujis: calls $14
*** TURN *** [5d 3d Tc] [4s]
matiko09: bets $25
RamiroAgujis: folds 
Uncalled bet ($25) returned to matiko09
matiko09 collected $69 from pot
matiko09: doesn't show hand 
*** SUMMARY ***
Total pot $71.50 | Rake $2.50 
Board [5d 3d Tc 4s]
Seat 1: IdiotFromNE (big blind) folded before Flop
Seat 2: ilaviiitech folded before Flop (didn't bet)
Seat 3: matiko09 collected ($69)
Seat 5: Spid1 folded before Flop (didn't bet)
Seat 6: RamiroAgujis folded on the Turn
Seat 7: Pvsx. (button) folded before Flop (didn't bet)
Seat 8: ka100pka527 (small blind) folded before Flop





PokerStars Hand #151164886704:  Hold'em No Limit ($1/$2 USD) - 2016/03/30 16:26:24 CET [2016/03/30 10:26:24 ET]
Table 'Aesculapia II' 9-max Seat #6 is the button
Seat 1: buthmen ($372.03 in chips) 
Seat 2: suddend3ath ($200 in chips) 
Seat 3: matiko09 ($478.74 in chips) 
Seat 5: prominente ($200 in chips) 
Seat 6: volwebni4ek ($80 in chips) 
Seat 7: Rumboni66 ($119.49 in chips) 
Seat 9: InsomniaRU ($221.75 in chips) 
Rumboni66: posts small blind $1
InsomniaRU: posts big blind $2
tepi_guy: sits out 
*** HOLE CARDS ***
Dealt to matiko09 [2h 5c]
buthmen: folds 
suddend3ath: raises $3 to $5
matiko09: folds 
prominente: folds 
volwebni4ek: folds 
Rumboni66: folds 
InsomniaRU: folds 
Uncalled bet ($3) returned to suddend3ath
suddend3ath collected $5 from pot
suddend3ath: doesn't show hand 
*** SUMMARY ***
Total pot $5 | Rake $0 
Seat 1: buthmen folded before Flop (didn't bet)
Seat 2: suddend3ath collected ($5)
Seat 3: matiko09 folded before Flop (didn't bet)
Seat 5: prominente folded before Flop (didn't bet)
Seat 6: volwebni4ek (button) folded before Flop (didn't bet)
Seat 7: Rumboni66 (small blind) folded before Flop
Seat 9: InsomniaRU (big blind) folded before Flop





PokerStars Hand #151164886667:  Hold'em No Limit ($0.50/$1.00 USD) - 2016/03/30 16:26:24 CET [2016/03/30 10:26:24 ET]
Table 'Figneria III' 9-max Seat #1 is the button
Seat 1: matiko09 ($100 in chips) 
Seat 2: sanpidk ($102 in chips) 
Seat 4: CI58 ($100 in chips) 
Seat 7: holloway85 ($218.29 in chips) 
Seat 8: Dachish ($70 in chips) 
Seat 9: p.snow89 ($45.65 in chips) 
sanpidk: posts small blind $0.50
CI58: posts big blind $1
volwebni4ek: sits out 
*** HOLE CARDS ***
Dealt to matiko09 [9s Th]
holloway85: folds 
Dachish: raises $2 to $3
p.snow89: calls $3
matiko09: folds 
sanpidk: folds 
CI58: folds 
*** FLOP *** [Tc 6h 3s]
Dachish: bets $4
p.snow89: calls $4
*** TURN *** [Tc 6h 3s] [5h]
Dachish: checks 
p.snow89: checks 
*** RIVER *** [Tc 6h 3s 5h] [8c]
Dachish: checks 
p.snow89: checks 
*** SHOW DOWN ***
Dachish: shows [9c 9d] (a pair of Nines)
p.snow89: mucks hand 
Dachish collected $14.72 from pot
*** SUMMARY ***
Total pot $15.50 | Rake $0.78 
Board [Tc 6h 3s 5h 8c]
Seat 1: matiko09 (button) folded before Flop (didn't bet)
Seat 2: sanpidk (small blind) folded before Flop
Seat 4: CI58 (big blind) folded before Flop
Seat 7: holloway85 folded before Flop (didn't bet)
Seat 8: Dachish showed [9c 9d] and won ($14.72) with a pair of Nines
Seat 9: p.snow89 mucked [Ac 3c]





PokerStars Hand #151164889488:  Hold'em No Limit ($0.50/$1.00 USD) - 2016/03/30 16:26:28 CET [2016/03/30 10:26:28 ET]
Table 'Pannonia II' 9-max Seat #9 is the button
Seat 1: CI58 ($100 in chips) 
Seat 2: matiko09 ($101.50 in chips) 
Seat 3: MGL_Sky99 ($108.12 in chips) 
Seat 5: Spid1 ($110.87 in chips) 
Seat 7: volwebni4ek ($40 in chips) 
Seat 8: stonymalony ($73.14 in chips) 
Seat 9: b_____a__242 ($84.39 in chips) 
CI58: posts small blind $0.50
matiko09: posts big blind $1
*** HOLE CARDS ***
Dealt to matiko09 [Td Qh]
MGL_Sky99: folds 
Spid1: folds 
volwebni4ek: folds 
stonymalony: raises $1 to $2
b_____a__242: folds 
CI58: folds 
matiko09: calls $1
*** FLOP *** [Jd 4s Jh]
matiko09: checks 
stonymalony: bets $2
matiko09: folds 
Uncalled bet ($2) returned to stonymalony
stonymalony collected $4.28 from pot
stonymalony: doesn't show hand 
*** SUMMARY ***
Total pot $4.50 | Rake $0.22 
Board [Jd 4s Jh]
Seat 1: CI58 (small blind) folded before Flop
Seat 2: matiko09 (big blind) folded on the Flop
Seat 3: MGL_Sky99 folded before Flop (didn't bet)
Seat 5: Spid1 folded before Flop (didn't bet)
Seat 7: volwebni4ek folded before Flop (didn't bet)
Seat 8: stonymalony collected ($4.28)
Seat 9: b_____a__242 (button) folded before Flop (didn't bet)





PokerStars Hand #151164890171:  Hold'em No Limit ($1/$2 USD) - 2016/03/30 16:26:29 CET [2016/03/30 10:26:29 ET]
Table 'Jole' 9-max Seat #7 is the button
Seat 1: matiko09 ($200 in chips) 
Seat 2: RamiroAgujis ($307.76 in chips) 
Seat 4: volwebni4ek ($83.66 in chips) 
Seat 5: dunga119 ($206 in chips) 
Seat 6: King_ZéManel ($202.05 in chips) 
Seat 7: ilaviiitech ($277.16 in chips) 
Seat 9: Ravnica11 ($78 in chips) 
Ravnica11: posts small blind $1
matiko09: posts big blind $2
prominente: sits out 
*** HOLE CARDS ***
Dealt to matiko09 [Jc Jd]
RamiroAgujis: folds 
volwebni4ek: folds 
dunga119: calls $2
King_ZéManel: folds 
ilaviiitech: folds 
Ravnica11: raises $7 to $9
matiko09: calls $7
dunga119: calls $7
*** FLOP *** [8h Ks Qc]
Ravnica11: bets $16
matiko09: folds 
dunga119: folds 
Uncalled bet ($16) returned to Ravnica11
Ravnica11 collected $25.65 from pot
*** SUMMARY ***
Total pot $27 | Rake $1.35 
Board [8h Ks Qc]
Seat 1: matiko09 (big blind) folded on the Flop
Seat 2: RamiroAgujis folded before Flop (didn't bet)
Seat 4: volwebni4ek folded before Flop (didn't bet)
Seat 5: dunga119 folded on the Flop
Seat 6: King_ZéManel folded before Flop (didn't bet)
Seat 7: ilaviiitech (button) folded before Flop (didn't bet)
Seat 9: Ravnica11 (small blind) collected ($25.65)





PokerStars Hand #151164889791:  Hold'em No Limit ($0.50/$1.00 USD) - 2016/03/30 16:26:29 CET [2016/03/30 10:26:29 ET]
Table 'Alcor II' 9-max Seat #7 is the button
Seat 1: Red4erT ($109.62 in chips) 
Seat 2: holloway85 ($77.46 in chips) 
Seat 3: mitchymitch3 ($100 in chips) 
Seat 5: elbiber2000 ($100 in chips) 
Seat 6: godfrey004 ($169.25 in chips) 
Seat 7: sanpidk ($103.71 in chips) 
Seat 9: matiko09 ($205.10 in chips) 
matiko09: posts small blind $0.50
Red4erT: posts big blind $1
*** HOLE CARDS ***
Dealt to matiko09 [6s Ts]
ka100pka527 joins the table at seat #8 
holloway85: folds 
mitchymitch3: folds 
elbiber2000: raises $2 to $3
godfrey004: folds 
sanpidk: folds 
matiko09: folds 
Red4erT: folds 
Uncalled bet ($2) returned to elbiber2000
elbiber2000 collected $2.50 from pot
elbiber2000: doesn't show hand 
*** SUMMARY ***
Total pot $2.50 | Rake $0 
Seat 1: Red4erT (big blind) folded before Flop
Seat 2: holloway85 folded before Flop (didn't bet)
Seat 3: mitchymitch3 folded before Flop (didn't bet)
Seat 5: elbiber2000 collected ($2.50)
Seat 6: godfrey004 folded before Flop (didn't bet)
Seat 7: sanpidk (button) folded before Flop (didn't bet)
Seat 9: matiko09 (small blind) folded before Flop





PokerStars Hand #151164904367:  Hold'em No Limit ($1/$2 USD) - 2016/03/30 16:26:51 CET [2016/03/30 10:26:51 ET]
Table 'Philoctetes II' 9-max Seat #9 is the button
Seat 1: vezunchik79 ($131.28 in chips) 
Seat 2: prominente ($200 in chips) 
Seat 3: mentalpshyco ($200 in chips) 
Seat 4: tepi_guy ($203.55 in chips) 
Seat 5: zhaimeng ($360.46 in chips) 
Seat 7: matiko09 ($200 in chips) 
Seat 8: suddend3ath ($200 in chips) 
Seat 9: RamiroAgujis ($240.30 in chips) 
vezunchik79: posts small blind $1
prominente: posts big blind $2
*** HOLE CARDS ***
Dealt to matiko09 [Ah Td]
mentalpshyco: folds 
tepi_guy: folds 
zhaimeng: calls $2
matiko09: raises $6 to $8
suddend3ath: folds 
RamiroAgujis: folds 
vezunchik79: folds 
prominente: folds 
zhaimeng: calls $6
*** FLOP *** [Kd 6s 9c]
zhaimeng: checks 
matiko09: checks 
*** TURN *** [Kd 6s 9c] [7d]
zhaimeng: bets $9.02
matiko09: folds 
Uncalled bet ($9.02) returned to zhaimeng
zhaimeng collected $18.05 from pot
zhaimeng: doesn't show hand 
*** SUMMARY ***
Total pot $19 | Rake $0.95 
Board [Kd 6s 9c 7d]
Seat 1: vezunchik79 (small blind) folded before Flop
Seat 2: prominente (big blind) folded before Flop
Seat 3: mentalpshyco folded before Flop (didn't bet)
Seat 4: tepi_guy folded before Flop (didn't bet)
Seat 5: zhaimeng collected ($18.05)
Seat 7: matiko09 folded on the Turn
Seat 8: suddend3ath folded before Flop (didn't bet)
Seat 9: RamiroAgujis (button) folded before Flop (didn't bet)





PokerStars Hand #151164915409:  Hold'em No Limit ($0.50/$1.00 USD) - 2016/03/30 16:27:07 CET [2016/03/30 10:27:07 ET]
Table 'Alcor II' 9-max Seat #9 is the button
Seat 1: Red4erT ($108.62 in chips) 
Seat 2: holloway85 ($77.46 in chips) 
Seat 3: mitchymitch3 ($100 in chips) 
Seat 5: elbiber2000 ($101.50 in chips) 
Seat 6: godfrey004 ($169.25 in chips) 
Seat 7: sanpidk ($103.71 in chips) 
Seat 9: matiko09 ($204.60 in chips) 
Red4erT: posts small blind $0.50
holloway85: posts big blind $1
ka100pka527: sits out 
*** HOLE CARDS ***
Dealt to matiko09 [6d 3s]
mitchymitch3: folds 
elbiber2000: raises $2 to $3
godfrey004: folds 
sanpidk: folds 
matiko09: folds 
Red4erT: folds 
holloway85: folds 
Uncalled bet ($2) returned to elbiber2000
elbiber2000 collected $2.50 from pot
elbiber2000: doesn't show hand 
*** SUMMARY ***
Total pot $2.50 | Rake $0 
Seat 1: Red4erT (small blind) folded before Flop
Seat 2: holloway85 (big blind) folded before Flop
Seat 3: mitchymitch3 folded before Flop (didn't bet)
Seat 5: elbiber2000 collected ($2.50)
Seat 6: godfrey004 folded before Flop (didn't bet)
Seat 7: sanpidk folded before Flop (didn't bet)
Seat 9: matiko09 (button) folded before Flop (didn't bet)





PokerStars Hand #151164915328:  Hold'em No Limit ($1/$2 USD) - 2016/03/30 16:27:07 CET [2016/03/30 10:27:07 ET]
Table 'Hektor III' 9-max Seat #2 is the button
Seat 1: matiko09 ($200 in chips) 
Seat 2: RamiroAgujis ($299.45 in chips) 
Seat 3: T0ny Adams ($84.09 in chips) 
Seat 4: volwebni4ek ($112.40 in chips) 
Seat 5: prominente ($293.75 in chips) 
Seat 7: InsomniaRU ($217.04 in chips) 
Seat 9: fonng ($311.49 in chips) 
T0ny Adams: posts small blind $1
volwebni4ek: posts big blind $2
tepi_guy: sits out 
*** HOLE CARDS ***
Dealt to matiko09 [5s 2s]
prominente: folds 
InsomniaRU: folds 
fonng: folds 
matiko09: folds 
RamiroAgujis: raises $3 to $5
T0ny Adams: folds 
volwebni4ek: folds 
Uncalled bet ($3) returned to RamiroAgujis
RamiroAgujis collected $5 from pot
RamiroAgujis: doesn't show hand 
*** SUMMARY ***
Total pot $5 | Rake $0 
Seat 1: matiko09 folded before Flop (didn't bet)
Seat 2: RamiroAgujis (button) collected ($5)
Seat 3: T0ny Adams (small blind) folded before Flop
Seat 4: volwebni4ek (big blind) folded before Flop
Seat 5: prominente folded before Flop (didn't bet)
Seat 7: InsomniaRU folded before Flop (didn't bet)
Seat 9: fonng folded before Flop (didn't bet)





PokerStars Hand #151164915025:  Hold'em No Limit ($0.50/$1.00 USD) - 2016/03/30 16:27:07 CET [2016/03/30 10:27:07 ET]
Table 'Figneria III' 9-max Seat #2 is the button
Seat 1: matiko09 ($100 in chips) 
Seat 2: sanpidk ($101.50 in chips) 
Seat 4: CI58 ($100 in chips) 
Seat 5: volwebni4ek ($40 in chips) 
Seat 7: holloway85 ($218.29 in chips) 
Seat 8: Dachish ($77.72 in chips) 
Seat 9: p.snow89 ($38.65 in chips) 
CI58: posts small blind $0.50
volwebni4ek: posts big blind $1
*** HOLE CARDS ***
Dealt to matiko09 [Ks Ac]
holloway85: folds 
Dachish: folds 
p.snow89: raises $3 to $4
matiko09: raises $8.50 to $12.50
sanpidk: folds 
CI58: folds 
volwebni4ek: folds 
p.snow89: calls $8.50
*** FLOP *** [7s 3h Js]
p.snow89: bets $26.15 and is all-in
matiko09: calls $26.15
*** TURN *** [7s 3h Js] [3d]
*** RIVER *** [7s 3h Js 3d] [8d]
*** SHOW DOWN ***
p.snow89: shows [Qh Jh] (two pair, Jacks and Threes)
matiko09: mucks hand 
p.snow89 collected $76.30 from pot
*** SUMMARY ***
Total pot $78.80 | Rake $2.50 
Board [7s 3h Js 3d 8d]
Seat 1: matiko09 mucked [Ks Ac]
Seat 2: sanpidk (button) folded before Flop (didn't bet)
Seat 4: CI58 (small blind) folded before Flop
Seat 5: volwebni4ek (big blind) folded before Flop
Seat 7: holloway85 folded before Flop (didn't bet)
Seat 8: Dachish folded before Flop (didn't bet)
Seat 9: p.snow89 showed [Qh Jh] and won ($76.30) with two pair, Jacks and Threes





PokerStars Hand #151164918300:  Hold'em No Limit ($1/$2 USD) - 2016/03/30 16:27:12 CET [2016/03/30 10:27:12 ET]
Table 'Aesculapia II' 9-max Seat #7 is the button
Seat 1: buthmen ($372.03 in chips) 
Seat 2: suddend3ath ($203 in chips) 
Seat 3: matiko09 ($478.74 in chips) 
Seat 5: prominente ($200 in chips) 
Seat 6: volwebni4ek ($80 in chips) 
Seat 7: Rumboni66 ($118.49 in chips) 
Seat 9: InsomniaRU ($219.75 in chips) 
InsomniaRU: posts small blind $1
buthmen: posts big blind $2
tepi_guy: sits out 
*** HOLE CARDS ***
Dealt to matiko09 [Js 4h]
suddend3ath: folds 
matiko09: folds 
prominente: folds 
volwebni4ek: folds 
Rumboni66: folds 
InsomniaRU: calls $1
buthmen: checks 
*** FLOP *** [3c Ac 4c]
InsomniaRU: checks 
buthmen: bets $4
InsomniaRU: folds 
Uncalled bet ($4) returned to buthmen
buthmen collected $3.80 from pot
buthmen: doesn't show hand 
*** SUMMARY ***
Total pot $4 | Rake $0.20 
Board [3c Ac 4c]
Seat 1: buthmen (big blind) collected ($3.80)
Seat 2: suddend3ath folded before Flop (didn't bet)
Seat 3: matiko09 folded before Flop (didn't bet)
Seat 5: prominente folded before Flop (didn't bet)
Seat 6: volwebni4ek folded before Flop (didn't bet)
Seat 7: Rumboni66 (button) folded before Flop (didn't bet)
Seat 9: InsomniaRU (small blind) folded on the Flop





PokerStars Hand #151164919616:  Hold'em No Limit ($0.50/$1.00 USD) - 2016/03/30 16:27:14 CET [2016/03/30 10:27:14 ET]
Table 'Pannonia II' 9-max Seat #1 is the button
Seat 1: CI58 ($100 in chips) 
Seat 2: matiko09 ($100 in chips) 
Seat 3: MGL_Sky99 ($108.12 in chips) 
Seat 5: Spid1 ($110.87 in chips) 
Seat 7: volwebni4ek ($40 in chips) 
Seat 8: stonymalony ($75.42 in chips) 
Seat 9: b_____a__242 ($84.39 in chips) 
matiko09: posts small blind $0.50
MGL_Sky99: posts big blind $1
*** HOLE CARDS ***
Dealt to matiko09 [As 3s]
Spid1: folds 
volwebni4ek: folds 
stonymalony: raises $2 to $3
b_____a__242: folds 
CI58: folds 
matiko09: folds 
MGL_Sky99: calls $2
*** FLOP *** [Kd 9s Jh]
MGL_Sky99 is disconnected 
MGL_Sky99 is connected 
MGL_Sky99: checks 
stonymalony: bets $3
MGL_Sky99: folds 
Uncalled bet ($3) returned to stonymalony
stonymalony collected $6.18 from pot
stonymalony: doesn't show hand 
*** SUMMARY ***
Total pot $6.50 | Rake $0.32 
Board [Kd 9s Jh]
Seat 1: CI58 (button) folded before Flop (didn't bet)
Seat 2: matiko09 (small blind) folded before Flop
Seat 3: MGL_Sky99 (big blind) folded on the Flop
Seat 5: Spid1 folded before Flop (didn't bet)
Seat 7: volwebni4ek folded before Flop (didn't bet)
Seat 8: stonymalony collected ($6.18)
Seat 9: b_____a__242 folded before Flop (didn't bet)





PokerStars Hand #151164934600:  Hold'em No Limit ($1/$2 USD) - 2016/03/30 16:27:36 CET [2016/03/30 10:27:36 ET]
Table 'Jole' 9-max Seat #9 is the button
Seat 1: matiko09 ($200 in chips) 
Seat 2: RamiroAgujis ($307.76 in chips) 
Seat 4: volwebni4ek ($83.66 in chips) 
Seat 5: dunga119 ($197 in chips) 
Seat 6: King_ZéManel ($202.05 in chips) 
Seat 7: ilaviiitech ($277.16 in chips) 
Seat 9: Ravnica11 ($94.65 in chips) 
matiko09: posts small blind $1
RamiroAgujis: posts big blind $2
prominente: sits out 
*** HOLE CARDS ***
Dealt to matiko09 [9c 2s]
volwebni4ek: folds 
dunga119: calls $2
King_ZéManel: folds 
ilaviiitech: folds 
Ravnica11: folds 
matiko09: folds 
RamiroAgujis: raises $6 to $8
dunga119: calls $6
*** FLOP *** [7d Kh 8h]
RamiroAgujis: checks 
dunga119: checks 
*** TURN *** [7d Kh 8h] [9h]
RamiroAgujis: checks 
dunga119: checks 
*** RIVER *** [7d Kh 8h 9h] [Js]
RamiroAgujis: checks 
dunga119: bets $16.15
RamiroAgujis: folds 
Uncalled bet ($16.15) returned to dunga119
dunga119 collected $16.15 from pot
dunga119: doesn't show hand 
*** SUMMARY ***
Total pot $17 | Rake $0.85 
Board [7d Kh 8h 9h Js]
Seat 1: matiko09 (small blind) folded before Flop
Seat 2: RamiroAgujis (big blind) folded on the River
Seat 4: volwebni4ek folded before Flop (didn't bet)
Seat 5: dunga119 collected ($16.15)
Seat 6: King_ZéManel folded before Flop (didn't bet)
Seat 7: ilaviiitech folded before Flop (didn't bet)
Seat 9: Ravnica11 (button) folded before Flop (didn't bet)





PokerStars Hand #151164942289:  Hold'em No Limit ($0.50/$1.00 USD) - 2016/03/30 16:27:48 CET [2016/03/30 10:27:48 ET]
Table 'Alcor II' 9-max Seat #1 is the button
Seat 1: Red4erT ($108.12 in chips) 
Seat 2: holloway85 ($76.46 in chips) 
Seat 3: mitchymitch3 ($100 in chips) 
Seat 5: elbiber2000 ($103 in chips) 
Seat 6: godfrey004 ($169.25 in chips) 
Seat 7: sanpidk ($103.71 in chips) 
Seat 9: matiko09 ($204.60 in chips) 
holloway85: posts small blind $0.50
mitchymitch3: posts big blind $1
ka100pka527: sits out 
*** HOLE CARDS ***
Dealt to matiko09 [2d 7c]
elbiber2000: folds 
godfrey004: folds 
sanpidk: folds 
matiko09: folds 
Red4erT: raises $1.50 to $2.50
holloway85: folds 
mitchymitch3: calls $1.50
*** FLOP *** [7h Kh 9s]
mitchymitch3: checks 
Red4erT: bets $2.71
mitchymitch3: calls $2.71
*** TURN *** [7h Kh 9s] [Kd]
mitchymitch3: checks 
Red4erT: checks 
*** RIVER *** [7h Kh 9s Kd] [Th]
mitchymitch3: checks 
Red4erT: bets $7.78
mitchymitch3: raises $17.22 to $25
Red4erT: folds 
Uncalled bet ($17.22) returned to mitchymitch3
mitchymitch3 collected $25.16 from pot
mitchymitch3: doesn't show hand 
*** SUMMARY ***
Total pot $26.48 | Rake $1.32 
Board [7h Kh 9s Kd Th]
Seat 1: Red4erT (button) folded on the River
Seat 2: holloway85 (small blind) folded before Flop
Seat 3: mitchymitch3 (big blind) collected ($25.16)
Seat 5: elbiber2000 folded before Flop (didn't bet)
Seat 6: godfrey004 folded before Flop (didn't bet)
Seat 7: sanpidk folded before Flop (didn't bet)
Seat 9: matiko09 folded before Flop (didn't bet)





PokerStars Hand #151164945874:  Hold'em No Limit ($1/$2 USD) - 2016/03/30 16:27:53 CET [2016/03/30 10:27:53 ET]
Table 'Hektor III' 9-max Seat #3 is the button
Seat 1: matiko09 ($200 in chips) 
Seat 2: RamiroAgujis ($302.45 in chips) 
Seat 3: T0ny Adams ($83.09 in chips) 
Seat 4: volwebni4ek ($110.40 in chips) 
Seat 5: prominente ($293.75 in chips) 
Seat 7: InsomniaRU ($217.04 in chips) 
Seat 9: fonng ($311.49 in chips) 
volwebni4ek: posts small blind $1
prominente: posts big blind $2
tepi_guy: sits out 
*** HOLE CARDS ***
Dealt to matiko09 [3d Qs]
InsomniaRU: folds 
fonng is disconnected 
fonng has timed out while disconnected
fonng: folds 
matiko09: folds 
RamiroAgujis: folds 
T0ny Adams: raises $2.34 to $4.34
volwebni4ek: raises $10.66 to $15
prominente: folds 
T0ny Adams: raises $57 to $72
volwebni4ek: folds 
Uncalled bet ($57) returned to T0ny Adams
T0ny Adams collected $32 from pot
T0ny Adams: doesn't show hand 
*** SUMMARY ***
Total pot $32 | Rake $0 
Seat 1: matiko09 folded before Flop (didn't bet)
Seat 2: RamiroAgujis folded before Flop (didn't bet)
Seat 3: T0ny Adams (button) collected ($32)
Seat 4: volwebni4ek (small blind) folded before Flop
Seat 5: prominente (big blind) folded before Flop
Seat 7: InsomniaRU folded before Flop (didn't bet)
Seat 9: fonng folded before Flop (didn't bet)





PokerStars Hand #151164947038:  Hold'em No Limit ($0.50/$1.00 USD) - 2016/03/30 16:27:55 CET [2016/03/30 10:27:55 ET]
Table 'Amata II' 9-max Seat #8 is the button
Seat 1: IdiotFromNE ($100 in chips) 
Seat 2: ilaviiitech ($114.95 in chips) 
Seat 3: matiko09 ($220.75 in chips) 
Seat 5: Spid1 ($101.50 in chips) 
Seat 6: RamiroAgujis ($100 in chips) 
Seat 7: Pvsx. ($189.51 in chips) 
Seat 8: ka100pka527 ($54.72 in chips) 
IdiotFromNE: posts small blind $0.50
ilaviiitech: posts big blind $1
*** HOLE CARDS ***
Dealt to matiko09 [8c 9s]
matiko09: folds 
Spid1: folds 
RamiroAgujis: folds 
Pvsx.: folds 
ka100pka527: raises $1 to $2
IdiotFromNE: folds 
ilaviiitech: folds 
Uncalled bet ($1) returned to ka100pka527
ka100pka527 collected $2.50 from pot
ka100pka527: doesn't show hand 
*** SUMMARY ***
Total pot $2.50 | Rake $0 
Seat 1: IdiotFromNE (small blind) folded before Flop
Seat 2: ilaviiitech (big blind) folded before Flop
Seat 3: matiko09 folded before Flop (didn't bet)
Seat 5: Spid1 folded before Flop (didn't bet)
Seat 6: RamiroAgujis folded before Flop (didn't bet)
Seat 7: Pvsx. folded before Flop (didn't bet)
Seat 8: ka100pka527 (button) collected ($2.50)





PokerStars Hand #151164947633:  Hold'em No Limit ($1/$2 USD) - 2016/03/30 16:27:56 CET [2016/03/30 10:27:56 ET]
Table 'Aesculapia II' 9-max Seat #9 is the button
Seat 1: buthmen ($373.83 in chips) 
Seat 2: suddend3ath ($203 in chips) 
Seat 3: matiko09 ($478.74 in chips) 
Seat 5: prominente ($200 in chips) 
Seat 6: volwebni4ek ($80 in chips) 
Seat 7: Rumboni66 ($118.49 in chips) 
Seat 9: InsomniaRU ($217.75 in chips) 
buthmen: posts small blind $1
suddend3ath: posts big blind $2
tepi_guy: sits out 
*** HOLE CARDS ***
Dealt to matiko09 [7c Td]
matiko09: folds 
prominente: raises $3 to $5
volwebni4ek: calls $5
Rumboni66: folds 
InsomniaRU: calls $5
buthmen: folds 
suddend3ath: folds 
*** FLOP *** [5h 3c 3d]
prominente: checks 
volwebni4ek: bets $11
InsomniaRU: folds 
prominente: calls $11
*** TURN *** [5h 3c 3d] [2c]
prominente: checks 
volwebni4ek: checks 
*** RIVER *** [5h 3c 3d 2c] [3s]
prominente: checks 
volwebni4ek: bets $13
prominente: folds 
Uncalled bet ($13) returned to volwebni4ek
volwebni4ek collected $38 from pot
volwebni4ek: doesn't show hand 
*** SUMMARY ***
Total pot $40 | Rake $2 
Board [5h 3c 3d 2c 3s]
Seat 1: buthmen (small blind) folded before Flop
Seat 2: suddend3ath (big blind) folded before Flop
Seat 3: matiko09 folded before Flop (didn't bet)
Seat 5: prominente folded on the River
Seat 6: volwebni4ek collected ($38)
Seat 7: Rumboni66 folded before Flop (didn't bet)
Seat 9: InsomniaRU (button) folded on the Flop





PokerStars Hand #151164950884:  Hold'em No Limit ($0.50/$1.00 USD) - 2016/03/30 16:28:00 CET [2016/03/30 10:28:00 ET]
Table 'Figneria III' 9-max Seat #4 is the button
Seat 1: matiko09 ($100 in chips) 
Seat 2: sanpidk ($101.50 in chips) 
Seat 4: CI58 ($100 in chips) 
Seat 5: volwebni4ek ($40 in chips) 
Seat 7: holloway85 ($218.29 in chips) 
Seat 8: Dachish ($77.72 in chips) 
Seat 9: p.snow89 ($76.30 in chips) 
volwebni4ek: posts small blind $0.50
holloway85: posts big blind $1
*** HOLE CARDS ***
Dealt to matiko09 [9s Qd]
Dachish: folds 
p.snow89: folds 
matiko09: folds 
sanpidk: raises $1.50 to $2.50
CI58: folds 
volwebni4ek: folds 
holloway85: calls $1.50
*** FLOP *** [2c Ad Tc]
holloway85: checks 
sanpidk: bets $3.50
holloway85: folds 
Uncalled bet ($3.50) returned to sanpidk
sanpidk collected $5.22 from pot
sanpidk: doesn't show hand 
*** SUMMARY ***
Total pot $5.50 | Rake $0.28 
Board [2c Ad Tc]
Seat 1: matiko09 folded before Flop (didn't bet)
Seat 2: sanpidk collected ($5.22)
Seat 4: CI58 (button) folded before Flop (didn't bet)
Seat 5: volwebni4ek (small blind) folded before Flop
Seat 7: holloway85 (big blind) folded on the Flop
Seat 8: Dachish folded before Flop (didn't bet)
Seat 9: p.snow89 folded before Flop (didn't bet)





PokerStars Hand #151164954090:  Hold'em No Limit ($1/$2 USD) - 2016/03/30 16:28:05 CET [2016/03/30 10:28:05 ET]
Table 'Philoctetes II' 9-max Seat #1 is the button
Seat 1: vezunchik79 ($130.28 in chips) 
Seat 2: prominente ($200 in chips) 
Seat 3: mentalpshyco ($200 in chips) 
Seat 4: tepi_guy ($203.55 in chips) 
Seat 5: zhaimeng ($370.51 in chips) 
Seat 7: matiko09 ($200 in chips) 
Seat 8: suddend3ath ($200 in chips) 
Seat 9: RamiroAgujis ($240.30 in chips) 
prominente: posts small blind $1
mentalpshyco: posts big blind $2
*** HOLE CARDS ***
Dealt to matiko09 [6c Th]
tepi_guy: folds 
zhaimeng: folds 
matiko09: folds 
suddend3ath: raises $3 to $5
RamiroAgujis: folds 
vezunchik79: folds 
prominente: folds 
mentalpshyco: folds 
Uncalled bet ($3) returned to suddend3ath
suddend3ath collected $5 from pot
suddend3ath: doesn't show hand 
*** SUMMARY ***
Total pot $5 | Rake $0 
Seat 1: vezunchik79 (button) folded before Flop (didn't bet)
Seat 2: prominente (small blind) folded before Flop
Seat 3: mentalpshyco (big blind) folded before Flop
Seat 4: tepi_guy folded before Flop (didn't bet)
Seat 5: zhaimeng folded before Flop (didn't bet)
Seat 7: matiko09 folded before Flop (didn't bet)
Seat 8: suddend3ath collected ($5)
Seat 9: RamiroAgujis folded before Flop (didn't bet)





PokerStars Hand #151164965522:  Hold'em No Limit ($0.50/$1.00 USD) - 2016/03/30 16:28:22 CET [2016/03/30 10:28:22 ET]
Table 'Amata II' 9-max Seat #1 is the button
Seat 1: IdiotFromNE ($100 in chips) 
Seat 2: ilaviiitech ($113.95 in chips) 
Seat 3: matiko09 ($220.75 in chips) 
Seat 5: Spid1 ($101.50 in chips) 
Seat 6: RamiroAgujis ($100 in chips) 
Seat 7: Pvsx. ($189.51 in chips) 
Seat 8: ka100pka527 ($56.22 in chips) 
ilaviiitech: posts small blind $0.50
matiko09: posts big blind $1
*** HOLE CARDS ***
Dealt to matiko09 [Qh 9s]
Spid1: folds 
RamiroAgujis: folds 
Pvsx.: folds 
ka100pka527: folds 
IdiotFromNE: folds 
ilaviiitech: folds 
Uncalled bet ($0.50) returned to matiko09
matiko09 collected $1 from pot
matiko09: doesn't show hand 
*** SUMMARY ***
Total pot $1 | Rake $0 
Seat 1: IdiotFromNE (button) folded before Flop (didn't bet)
Seat 2: ilaviiitech (small blind) folded before Flop
Seat 3: matiko09 (big blind) collected ($1)
Seat 5: Spid1 folded before Flop (didn't bet)
Seat 6: RamiroAgujis folded before Flop (didn't bet)
Seat 7: Pvsx. folded before Flop (didn't bet)
Seat 8: ka100pka527 folded before Flop (didn't bet)





PokerStars Hand #151164967943:  Hold'em No Limit ($0.50/$1.00 USD) - 2016/03/30 16:28:26 CET [2016/03/30 10:28:26 ET]
Table 'Pannonia II' 9-max Seat #2 is the button
Seat 1: CI58 ($100 in chips) 
Seat 2: matiko09 ($100 in chips) 
Seat 3: MGL_Sky99 ($105.12 in chips) 
Seat 5: Spid1 ($110.87 in chips) 
Seat 7: volwebni4ek ($40 in chips) 
Seat 8: stonymalony ($78.60 in chips) 
Seat 9: b_____a__242 ($84.39 in chips) 
MGL_Sky99: posts small blind $0.50
Spid1: posts big blind $1
*** HOLE CARDS ***
Dealt to matiko09 [3c Tc]
volwebni4ek: raises $2 to $3
stonymalony: folds 
b_____a__242: folds 
CI58: folds 
matiko09: folds 
MGL_Sky99: folds 
Spid1: folds 
Uncalled bet ($2) returned to volwebni4ek
volwebni4ek collected $2.50 from pot
volwebni4ek: doesn't show hand 
*** SUMMARY ***
Total pot $2.50 | Rake $0 
Seat 1: CI58 folded before Flop (didn't bet)
Seat 2: matiko09 (button) folded before Flop (didn't bet)
Seat 3: MGL_Sky99 (small blind) folded before Flop
Seat 5: Spid1 (big blind) folded before Flop
Seat 7: volwebni4ek collected ($2.50)
Seat 8: stonymalony folded before Flop (didn't bet)
Seat 9: b_____a__242 folded before Flop (didn't bet)





PokerStars Hand #151164975682:  Hold'em No Limit ($0.50/$1.00 USD) - 2016/03/30 16:28:37 CET [2016/03/30 10:28:37 ET]
Table 'Figneria III' 9-max Seat #5 is the button
Seat 1: matiko09 ($100 in chips) 
Seat 2: sanpidk ($104.22 in chips) 
Seat 4: CI58 ($100 in chips) 
Seat 5: volwebni4ek ($40 in chips) 
Seat 7: holloway85 ($215.79 in chips) 
Seat 8: Dachish ($77.72 in chips) 
Seat 9: p.snow89 ($76.30 in chips) 
holloway85: posts small blind $0.50
Dachish: posts big blind $1
*** HOLE CARDS ***
Dealt to matiko09 [Jh 2s]
p.snow89: folds 
matiko09: folds 
sanpidk: raises $2 to $3
CI58: folds 
volwebni4ek: folds 
holloway85: folds 
Dachish: folds 
Uncalled bet ($2) returned to sanpidk
sanpidk collected $2.50 from pot
sanpidk: doesn't show hand 
*** SUMMARY ***
Total pot $2.50 | Rake $0 
Seat 1: matiko09 folded before Flop (didn't bet)
Seat 2: sanpidk collected ($2.50)
Seat 4: CI58 folded before Flop (didn't bet)
Seat 5: volwebni4ek (button) folded before Flop (didn't bet)
Seat 7: holloway85 (small blind) folded before Flop
Seat 8: Dachish (big blind) folded before Flop
Seat 9: p.snow89 folded before Flop (didn't bet)





PokerStars Hand #151164976125:  Hold'em No Limit ($0.50/$1.00 USD) - 2016/03/30 16:28:38 CET [2016/03/30 10:28:38 ET]
Table 'Amata II' 9-max Seat #2 is the button
Seat 1: IdiotFromNE ($100 in chips) 
Seat 2: ilaviiitech ($113.45 in chips) 
Seat 3: matiko09 ($221.25 in chips) 
Seat 5: Spid1 ($101.50 in chips) 
Seat 6: RamiroAgujis ($100 in chips) 
Seat 7: Pvsx. ($189.51 in chips) 
Seat 8: ka100pka527 ($56.22 in chips) 
matiko09: posts small blind $0.50
Spid1: posts big blind $1
*** HOLE CARDS ***
Dealt to matiko09 [7s 3c]
RamiroAgujis: folds 
Pvsx.: folds 
ka100pka527: raises $1 to $2
IdiotFromNE: folds 
ilaviiitech: folds 
matiko09: folds 
Spid1: folds 
Uncalled bet ($1) returned to ka100pka527
ka100pka527 collected $2.50 from pot
ka100pka527: doesn't show hand 
*** SUMMARY ***
Total pot $2.50 | Rake $0 
Seat 1: IdiotFromNE folded before Flop (didn't bet)
Seat 2: ilaviiitech (button) folded before Flop (didn't bet)
Seat 3: matiko09 (small blind) folded before Flop
Seat 5: Spid1 (big blind) folded before Flop
Seat 6: RamiroAgujis folded before Flop (didn't bet)
Seat 7: Pvsx. folded before Flop (didn't bet)
Seat 8: ka100pka527 collected ($2.50)





PokerStars Hand #151164975922:  Hold'em No Limit ($1/$2 USD) - 2016/03/30 16:28:38 CET [2016/03/30 10:28:38 ET]
Table 'Philoctetes II' 9-max Seat #2 is the button
Seat 1: vezunchik79 ($130.28 in chips) 
Seat 2: prominente ($200 in chips) 
Seat 3: mentalpshyco ($200 in chips) 
Seat 4: tepi_guy ($203.55 in chips) 
Seat 5: zhaimeng ($370.51 in chips) 
Seat 7: matiko09 ($200 in chips) 
Seat 8: suddend3ath ($203 in chips) 
Seat 9: RamiroAgujis ($240.30 in chips) 
mentalpshyco: posts small blind $1
tepi_guy: posts big blind $2
*** HOLE CARDS ***
Dealt to matiko09 [Kh Ad]
zhaimeng: folds 
matiko09: raises $3 to $5
suddend3ath: calls $5
RamiroAgujis: folds 
vezunchik79: folds 
prominente: calls $5
mentalpshyco: folds 
tepi_guy: calls $3
*** FLOP *** [Qh 5h 4h]
tepi_guy: checks 
matiko09: checks 
suddend3ath: checks 
prominente: bets $13.29
tepi_guy: folds 
matiko09: calls $13.29
suddend3ath: folds 
*** TURN *** [Qh 5h 4h] [5c]
matiko09: checks 
prominente: checks 
*** RIVER *** [Qh 5h 4h 5c] [Td]
matiko09: checks 
prominente: bets $32.53
matiko09: folds 
Uncalled bet ($32.53) returned to prominente
prominente collected $45.20 from pot
prominente: doesn't show hand 
*** SUMMARY ***
Total pot $47.58 | Rake $2.38 
Board [Qh 5h 4h 5c Td]
Seat 1: vezunchik79 folded before Flop (didn't bet)
Seat 2: prominente (button) collected ($45.20)
Seat 3: mentalpshyco (small blind) folded before Flop
Seat 4: tepi_guy (big blind) folded on the Flop
Seat 5: zhaimeng folded before Flop (didn't bet)
Seat 7: matiko09 folded on the River
Seat 8: suddend3ath folded on the Flop
Seat 9: RamiroAgujis folded before Flop (didn't bet)





PokerStars Hand #151164978400:  Hold'em No Limit ($1/$2 USD) - 2016/03/30 16:28:41 CET [2016/03/30 10:28:41 ET]
Table 'Jole' 9-max Seat #1 is the button
Seat 1: matiko09 ($200 in chips) 
Seat 2: RamiroAgujis ($299.76 in chips) 
Seat 3: prominente ($200 in chips) 
Seat 4: volwebni4ek ($83.66 in chips) 
Seat 5: dunga119 ($205.15 in chips) 
Seat 6: King_ZéManel ($202.05 in chips) 
Seat 7: ilaviiitech ($277.16 in chips) 
Seat 9: Ravnica11 ($94.65 in chips) 
RamiroAgujis: posts small blind $1
prominente: posts big blind $2
*** HOLE CARDS ***
Dealt to matiko09 [Jd 7c]
volwebni4ek: folds 
dunga119: folds 
King_ZéManel: folds 
ilaviiitech: folds 
Ravnica11: folds 
matiko09: folds 
RamiroAgujis: raises $3 to $5
prominente: folds 
Uncalled bet ($3) returned to RamiroAgujis
RamiroAgujis collected $4 from pot
RamiroAgujis: doesn't show hand 
*** SUMMARY ***
Total pot $4 | Rake $0 
Seat 1: matiko09 (button) folded before Flop (didn't bet)
Seat 2: RamiroAgujis (small blind) collected ($4)
Seat 3: prominente (big blind) folded before Flop
Seat 4: volwebni4ek folded before Flop (didn't bet)
Seat 5: dunga119 folded before Flop (didn't bet)
Seat 6: King_ZéManel folded before Flop (didn't bet)
Seat 7: ilaviiitech folded before Flop (didn't bet)
Seat 9: Ravnica11 folded before Flop (didn't bet)





PokerStars Hand #151164986603:  Hold'em No Limit ($0.50/$1.00 USD) - 2016/03/30 16:28:54 CET [2016/03/30 10:28:54 ET]
Table 'Pannonia II' 9-max Seat #3 is the button
Seat 1: CI58 ($100 in chips) 
Seat 2: matiko09 ($100 in chips) 
Seat 3: MGL_Sky99 ($104.62 in chips) 
Seat 5: Spid1 ($109.87 in chips) 
Seat 8: stonymalony ($78.60 in chips) 
Seat 9: b_____a__242 ($84.39 in chips) 
Spid1: posts small blind $0.50
volwebni4ek: is sitting out 
volwebni4ek leaves the table
stonymalony: posts big blind $1
*** HOLE CARDS ***
Dealt to matiko09 [Kd 3s]
sanpidk joins the table at seat #7 
b_____a__242: folds 
sanpidk leaves the table
CI58: folds 
Dachish joins the table at seat #7 
matiko09: folds 
MGL_Sky99: raises $2 to $3
Spid1: raises $7.50 to $10.50
stonymalony: calls $9.50
MGL_Sky99: folds 
*** FLOP *** [7h Qc 5s]
Spid1: bets $10.50
stonymalony: calls $10.50
*** TURN *** [7h Qc 5s] [Ad]
Spid1: bets $27
stonymalony: folds [Jh Jc]
Uncalled bet ($27) returned to Spid1
Spid1 collected $42.75 from pot
Spid1: doesn't show hand 
*** SUMMARY ***
Total pot $45 | Rake $2.25 
Board [7h Qc 5s Ad]
Seat 1: CI58 folded before Flop (didn't bet)
Seat 2: matiko09 folded before Flop (didn't bet)
Seat 3: MGL_Sky99 (button) folded before Flop
Seat 5: Spid1 (small blind) collected ($42.75)
Seat 8: stonymalony (big blind) folded on the Turn
Seat 9: b_____a__242 folded before Flop (didn't bet)





PokerStars Hand #151164998353:  Hold'em No Limit ($0.50/$1.00 USD) - 2016/03/30 16:29:11 CET [2016/03/30 10:29:11 ET]
Table 'Figneria III' 9-max Seat #7 is the button
Seat 1: matiko09 ($100 in chips) 
Seat 2: sanpidk ($105.72 in chips) 
Seat 4: CI58 ($100 in chips) 
Seat 5: volwebni4ek ($40 in chips) 
Seat 7: holloway85 ($215.29 in chips) 
Seat 8: Dachish ($76.72 in chips) 
Seat 9: p.snow89 ($76.30 in chips) 
Dachish: posts small blind $0.50
p.snow89: posts big blind $1
*** HOLE CARDS ***
Dealt to matiko09 [Kc 8c]
matiko09: folds 
sanpidk: folds 
CI58: folds 
volwebni4ek: raises $1.20 to $2.20
holloway85: folds 
Dachish: folds 
p.snow89: calls $1.20
*** FLOP *** [4d 2d 9d]
p.snow89: checks 
volwebni4ek: checks 
*** TURN *** [4d 2d 9d] [7c]
p.snow89: checks 
volwebni4ek: checks 
*** RIVER *** [4d 2d 9d 7c] [2c]
p.snow89: bets $2.33
volwebni4ek: calls $2.33
*** SHOW DOWN ***
p.snow89: shows [5h 7s] (two pair, Sevens and Deuces)
volwebni4ek: mucks hand 
p.snow89 collected $9.08 from pot
*** SUMMARY ***
Total pot $9.56 | Rake $0.48 
Board [4d 2d 9d 7c 2c]
Seat 1: matiko09 folded before Flop (didn't bet)
Seat 2: sanpidk folded before Flop (didn't bet)
Seat 4: CI58 folded before Flop (didn't bet)
Seat 5: volwebni4ek mucked [Ac 8s]
Seat 7: holloway85 (button) folded before Flop (didn't bet)
Seat 8: Dachish (small blind) folded before Flop
Seat 9: p.snow89 (big blind) showed [5h 7s] and won ($9.08) with two pair, Sevens and Deuces





PokerStars Hand #151164997808:  Hold'em No Limit ($0.50/$1.00 USD) - 2016/03/30 16:29:11 CET [2016/03/30 10:29:11 ET]
Table 'Alcor II' 9-max Seat #2 is the button
Seat 1: Red4erT ($100 in chips) 
Seat 2: holloway85 ($75.96 in chips) 
Seat 3: mitchymitch3 ($112.17 in chips) 
Seat 5: elbiber2000 ($103 in chips) 
Seat 6: godfrey004 ($169.25 in chips) 
Seat 7: sanpidk ($103.71 in chips) 
Seat 9: matiko09 ($204.60 in chips) 
mitchymitch3: posts small blind $0.50
elbiber2000: posts big blind $1
ka100pka527: sits out 
*** HOLE CARDS ***
Dealt to matiko09 [8h 7d]
godfrey004: folds 
sanpidk: folds 
matiko09: folds 
Red4erT: folds 
holloway85: calls $1
mitchymitch3: folds 
elbiber2000: checks 
*** FLOP *** [2c 8d 9d]
elbiber2000: checks 
holloway85: checks 
*** TURN *** [2c 8d 9d] [Jc]
elbiber2000: checks 
holloway85: checks 
*** RIVER *** [2c 8d 9d Jc] [6s]
elbiber2000: checks 
holloway85: bets $1
elbiber2000: folds 
Uncalled bet ($1) returned to holloway85
holloway85 collected $2.38 from pot
holloway85: doesn't show hand 
*** SUMMARY ***
Total pot $2.50 | Rake $0.12 
Board [2c 8d 9d Jc 6s]
Seat 1: Red4erT folded before Flop (didn't bet)
Seat 2: holloway85 (button) collected ($2.38)
Seat 3: mitchymitch3 (small blind) folded before Flop
Seat 5: elbiber2000 (big blind) folded on the River
Seat 6: godfrey004 folded before Flop (didn't bet)
Seat 7: sanpidk folded before Flop (didn't bet)
Seat 9: matiko09 folded before Flop (didn't bet)





PokerStars Hand #151164998761:  Hold'em No Limit ($1/$2 USD) - 2016/03/30 16:29:12 CET [2016/03/30 10:29:12 ET]
Table 'Jole' 9-max Seat #2 is the button
Seat 1: matiko09 ($200 in chips) 
Seat 2: RamiroAgujis ($301.76 in chips) 
Seat 3: prominente ($200 in chips) 
Seat 5: dunga119 ($205.15 in chips) 
Seat 6: King_ZéManel ($202.05 in chips) 
Seat 7: ilaviiitech ($277.16 in chips) 
Seat 9: Ravnica11 ($94.65 in chips) 
prominente: posts small blind $1
volwebni4ek: is sitting out 
volwebni4ek leaves the table
dunga119: posts big blind $2
*** HOLE CARDS ***
Dealt to matiko09 [Qs Td]
King_ZéManel: folds 
ilaviiitech: folds 
Ravnica11: folds 
matiko09: raises $3 to $5
RamiroAgujis: folds 
prominente: raises $13 to $18
InsomniaRU joins the table at seat #4 
dunga119: folds 
InsomniaRU leaves the table
matiko09: folds 
Uncalled bet ($13) returned to prominente
prominente collected $12 from pot
prominente: doesn't show hand 
*** SUMMARY ***
Total pot $12 | Rake $0 
Seat 1: matiko09 folded before Flop
Seat 2: RamiroAgujis (button) folded before Flop (didn't bet)
Seat 3: prominente (small blind) collected ($12)
Seat 5: dunga119 (big blind) folded before Flop
Seat 6: King_ZéManel folded before Flop (didn't bet)
Seat 7: ilaviiitech folded before Flop (didn't bet)
Seat 9: Ravnica11 folded before Flop (didn't bet)





PokerStars Hand #151164998559:  Hold'em No Limit ($0.50/$1.00 USD) - 2016/03/30 16:29:12 CET [2016/03/30 10:29:12 ET]
Table 'Amata II' 9-max Seat #3 is the button
Seat 1: IdiotFromNE ($100 in chips) 
Seat 2: ilaviiitech ($113.45 in chips) 
Seat 3: matiko09 ($220.75 in chips) 
Seat 5: Spid1 ($100.50 in chips) 
Seat 6: RamiroAgujis ($100 in chips) 
Seat 7: Pvsx. ($189.51 in chips) 
Seat 8: ka100pka527 ($57.72 in chips) 
Spid1: posts small blind $0.50
RamiroAgujis: posts big blind $1
*** HOLE CARDS ***
Dealt to matiko09 [5c Qh]
Pvsx.: folds 
ka100pka527: folds 
IdiotFromNE: folds 
ilaviiitech: folds 
matiko09: folds 
Spid1: folds 
Uncalled bet ($0.50) returned to RamiroAgujis
RamiroAgujis collected $1 from pot
RamiroAgujis: doesn't show hand 
*** SUMMARY ***
Total pot $1 | Rake $0 
Seat 1: IdiotFromNE folded before Flop (didn't bet)
Seat 2: ilaviiitech folded before Flop (didn't bet)
Seat 3: matiko09 (button) folded before Flop (didn't bet)
Seat 5: Spid1 (small blind) folded before Flop
Seat 6: RamiroAgujis (big blind) collected ($1)
Seat 7: Pvsx. folded before Flop (didn't bet)
Seat 8: ka100pka527 folded before Flop (didn't bet)





PokerStars Hand #151165009762:  Hold'em No Limit ($0.50/$1.00 USD) - 2016/03/30 16:29:29 CET [2016/03/30 10:29:29 ET]
Table 'Amata II' 9-max Seat #5 is the button
Seat 2: ilaviiitech ($113.45 in chips) 
Seat 3: matiko09 ($220.75 in chips) 
Seat 5: Spid1 ($100 in chips) 
Seat 6: RamiroAgujis ($100.50 in chips) 
Seat 7: Pvsx. ($189.51 in chips) 
Seat 8: ka100pka527 ($57.72 in chips) 
RamiroAgujis: posts small blind $0.50
Pvsx.: posts big blind $1
*** HOLE CARDS ***
Dealt to matiko09 [Qd 9c]
ka100pka527: folds 
ilaviiitech: folds 
matiko09: folds 
Spid1: raises $1.50 to $2.50
RamiroAgujis: raises $6.50 to $9
Pvsx.: folds 
Spid1: calls $6.50
*** FLOP *** [Ts As 5c]
RamiroAgujis: checks 
Spid1: bets $10.50
RamiroAgujis: calls $10.50
*** TURN *** [Ts As 5c] [Ad]
RamiroAgujis: checks 
Spid1: bets $24
RamiroAgujis: calls $24
*** RIVER *** [Ts As 5c Ad] [Js]
RamiroAgujis: checks 
Spid1: bets $56.50 and is all-in
RamiroAgujis: folds 
Uncalled bet ($56.50) returned to Spid1
Spid1 collected $85.50 from pot
Spid1: doesn't show hand 
*** SUMMARY ***
Total pot $88 | Rake $2.50 
Board [Ts As 5c Ad Js]
Seat 2: ilaviiitech folded before Flop (didn't bet)
Seat 3: matiko09 folded before Flop (didn't bet)
Seat 5: Spid1 (button) collected ($85.50)
Seat 6: RamiroAgujis (small blind) folded on the River
Seat 7: Pvsx. (big blind) folded before Flop
Seat 8: ka100pka527 folded before Flop (didn't bet)





PokerStars Hand #151165020648:  Hold'em No Limit ($1/$2 USD) - 2016/03/30 16:29:44 CET [2016/03/30 10:29:44 ET]
Table 'Hektor III' 9-max Seat #4 is the button
Seat 1: matiko09 ($200 in chips) 
Seat 2: RamiroAgujis ($302.45 in chips) 
Seat 3: T0ny Adams ($100.09 in chips) 
Seat 4: volwebni4ek ($95.40 in chips) 
Seat 5: prominente ($291.75 in chips) 
Seat 7: InsomniaRU ($217.04 in chips) 
Seat 9: fonng ($311.49 in chips) 
prominente: posts small blind $1
InsomniaRU: posts big blind $2
tepi_guy: sits out 
*** HOLE CARDS ***
Dealt to matiko09 [5d Jc]
fonng: folds 
matiko09: folds 
RamiroAgujis has timed out
RamiroAgujis: folds 
T0ny Adams: raises $3 to $5
volwebni4ek: calls $5
prominente: folds 
InsomniaRU: folds 
*** FLOP *** [4d 7s 9h]
T0ny Adams: checks 
volwebni4ek: bets $7.66
T0ny Adams: calls $7.66
*** TURN *** [4d 7s 9h] [3h]
T0ny Adams: checks 
volwebni4ek: checks 
*** RIVER *** [4d 7s 9h 3h] [Kc]
T0ny Adams: checks 
volwebni4ek: bets $11.11
T0ny Adams: folds 
Uncalled bet ($11.11) returned to volwebni4ek
volwebni4ek collected $26.90 from pot
volwebni4ek: doesn't show hand 
*** SUMMARY ***
Total pot $28.32 | Rake $1.42 
Board [4d 7s 9h 3h Kc]
Seat 1: matiko09 folded before Flop (didn't bet)
Seat 2: RamiroAgujis folded before Flop (didn't bet)
Seat 3: T0ny Adams folded on the River
Seat 4: volwebni4ek (button) collected ($26.90)
Seat 5: prominente (small blind) folded before Flop
Seat 7: InsomniaRU (big blind) folded before Flop
Seat 9: fonng folded before Flop (didn't bet)





PokerStars Hand #151165024648:  Hold'em No Limit ($1/$2 USD) - 2016/03/30 16:29:50 CET [2016/03/30 10:29:50 ET]
Table 'Jole' 9-max Seat #3 is the button
Seat 1: matiko09 ($200 in chips) 
Seat 2: RamiroAgujis ($301.76 in chips) 
Seat 3: prominente ($207 in chips) 
Seat 5: dunga119 ($203.15 in chips) 
Seat 6: King_ZéManel ($202.05 in chips) 
Seat 7: ilaviiitech ($277.16 in chips) 
Seat 9: Ravnica11 ($94.65 in chips) 
dunga119: posts small blind $1
King_ZéManel: posts big blind $2
*** HOLE CARDS ***
Dealt to matiko09 [Kc Ks]
ilaviiitech: folds 
Ravnica11: folds 
matiko09: raises $3 to $5
RamiroAgujis: calls $5
prominente: folds 
dunga119: raises $3 to $8
King_ZéManel: folds 
matiko09: raises $18 to $26
tepi_guy joins the table at seat #4 
RamiroAgujis: calls $21
dunga119: calls $18
*** FLOP *** [Qd 2d 4d]
dunga119: bets $77.25
matiko09: raises $96.75 to $174 and is all-in
RamiroAgujis: folds 
dunga119: folds 
Uncalled bet ($96.75) returned to matiko09
matiko09 collected $231.75 from pot
matiko09: doesn't show hand 
*** SUMMARY ***
Total pot $234.50 | Rake $2.75 
Board [Qd 2d 4d]
Seat 1: matiko09 collected ($231.75)
Seat 2: RamiroAgujis folded on the Flop
Seat 3: prominente (button) folded before Flop (didn't bet)
Seat 5: dunga119 (small blind) folded on the Flop
Seat 6: King_ZéManel (big blind) folded before Flop
Seat 7: ilaviiitech folded before Flop (didn't bet)
Seat 9: Ravnica11 folded before Flop (didn't bet)





PokerStars Hand #151165026705:  Hold'em No Limit ($0.50/$1.00 USD) - 2016/03/30 16:29:54 CET [2016/03/30 10:29:54 ET]
Table 'Pannonia II' 9-max Seat #5 is the button
Seat 1: CI58 ($100 in chips) 
Seat 2: matiko09 ($100 in chips) 
Seat 3: MGL_Sky99 ($101.62 in chips) 
Seat 5: Spid1 ($131.62 in chips) 
Seat 8: stonymalony ($57.60 in chips) 
Seat 9: b_____a__242 ($84.39 in chips) 
Dachish will be allowed to play after the button
stonymalony: posts small blind $0.50
b_____a__242: posts big blind $1
*** HOLE CARDS ***
Dealt to matiko09 [Qs 5h]
CI58: folds 
matiko09: folds 
MGL_Sky99: folds 
Spid1: folds 
stonymalony: raises $1 to $2
b_____a__242: calls $1
*** FLOP *** [Jd 7h Kc]
stonymalony: checks 
b_____a__242: bets $2.50
stonymalony: folds 
Uncalled bet ($2.50) returned to b_____a__242
b_____a__242 collected $3.80 from pot
b_____a__242: doesn't show hand 
*** SUMMARY ***
Total pot $4 | Rake $0.20 
Board [Jd 7h Kc]
Seat 1: CI58 folded before Flop (didn't bet)
Seat 2: matiko09 folded before Flop (didn't bet)
Seat 3: MGL_Sky99 folded before Flop (didn't bet)
Seat 5: Spid1 (button) folded before Flop (didn't bet)
Seat 8: stonymalony (small blind) folded on the Flop
Seat 9: b_____a__242 (big blind) collected ($3.80)





PokerStars Hand #151165034262:  Hold'em No Limit ($0.50/$1.00 USD) - 2016/03/30 16:30:05 CET [2016/03/30 10:30:05 ET]
Table 'Alcor II' 9-max Seat #3 is the button
Seat 1: Red4erT ($100 in chips) 
Seat 2: holloway85 ($77.34 in chips) 
Seat 3: mitchymitch3 ($111.67 in chips) 
Seat 5: elbiber2000 ($102 in chips) 
Seat 6: godfrey004 ($169.25 in chips) 
Seat 7: sanpidk ($103.71 in chips) 
Seat 9: matiko09 ($204.60 in chips) 
elbiber2000: posts small blind $0.50
godfrey004: posts big blind $1
ka100pka527: sits out 
*** HOLE CARDS ***
Dealt to matiko09 [Qh 3h]
sanpidk: folds 
matiko09: folds 
Red4erT: folds 
holloway85: folds 
mitchymitch3: folds 
elbiber2000: raises $2 to $3
godfrey004: calls $2
*** FLOP *** [9d Kh 5d]
elbiber2000: bets $4
godfrey004: folds 
Uncalled bet ($4) returned to elbiber2000
elbiber2000 collected $5.70 from pot
elbiber2000: doesn't show hand 
*** SUMMARY ***
Total pot $6 | Rake $0.30 
Board [9d Kh 5d]
Seat 1: Red4erT folded before Flop (didn't bet)
Seat 2: holloway85 folded before Flop (didn't bet)
Seat 3: mitchymitch3 (button) folded before Flop (didn't bet)
Seat 5: elbiber2000 (small blind) collected ($5.70)
Seat 6: godfrey004 (big blind) folded on the Flop
Seat 7: sanpidk folded before Flop (didn't bet)
Seat 9: matiko09 folded before Flop (didn't bet)





PokerStars Hand #151165048805:  Hold'em No Limit ($1/$2 USD) - 2016/03/30 16:30:26 CET [2016/03/30 10:30:26 ET]
Table 'Philoctetes II' 9-max Seat #3 is the button
Seat 1: vezunchik79 ($130.28 in chips) 
Seat 2: prominente ($226.91 in chips) 
Seat 3: mentalpshyco ($200 in chips) 
Seat 4: tepi_guy ($200 in chips) 
Seat 5: zhaimeng ($370.51 in chips) 
Seat 7: matiko09 ($200 in chips) 
Seat 8: suddend3ath ($200 in chips) 
Seat 9: RamiroAgujis ($240.30 in chips) 
tepi_guy: posts small blind $1
zhaimeng: posts big blind $2
*** HOLE CARDS ***
Dealt to matiko09 [Qs Tc]
matiko09: folds 
suddend3ath: folds 
RamiroAgujis: folds 
vezunchik79: folds 
prominente: folds 
mentalpshyco: folds 
tepi_guy: folds 
Uncalled bet ($1) returned to zhaimeng
zhaimeng collected $2 from pot
zhaimeng: doesn't show hand 
*** SUMMARY ***
Total pot $2 | Rake $0 
Seat 1: vezunchik79 folded before Flop (didn't bet)
Seat 2: prominente folded before Flop (didn't bet)
Seat 3: mentalpshyco (button) folded before Flop (didn't bet)
Seat 4: tepi_guy (small blind) folded before Flop
Seat 5: zhaimeng (big blind) collected ($2)
Seat 7: matiko09 folded before Flop (didn't bet)
Seat 8: suddend3ath folded before Flop (didn't bet)
Seat 9: RamiroAgujis folded before Flop (didn't bet)





PokerStars Hand #151165049861:  Hold'em No Limit ($0.50/$1.00 USD) - 2016/03/30 16:30:28 CET [2016/03/30 10:30:28 ET]
Table 'Figneria III' 9-max Seat #8 is the button
Seat 1: matiko09 ($100 in chips) 
Seat 2: sanpidk ($105.72 in chips) 
Seat 4: CI58 ($100 in chips) 
Seat 5: volwebni4ek ($40 in chips) 
Seat 7: holloway85 ($215.29 in chips) 
Seat 8: Dachish ($76.22 in chips) 
Seat 9: p.snow89 ($80.85 in chips) 
p.snow89: posts small blind $0.50
matiko09: posts big blind $1
*** HOLE CARDS ***
Dealt to matiko09 [8s 2h]
sanpidk: folds 
CI58: folds 
volwebni4ek: folds 
holloway85: raises $2 to $3
Dachish: folds 
p.snow89: raises $2 to $5
matiko09: folds 
holloway85: calls $2
*** FLOP *** [7d 9d Qs]
p.snow89: bets $5
holloway85: folds 
Uncalled bet ($5) returned to p.snow89
p.snow89 collected $10.45 from pot
p.snow89: doesn't show hand 
*** SUMMARY ***
Total pot $11 | Rake $0.55 
Board [7d 9d Qs]
Seat 1: matiko09 (big blind) folded before Flop
Seat 2: sanpidk folded before Flop (didn't bet)
Seat 4: CI58 folded before Flop (didn't bet)
Seat 5: volwebni4ek folded before Flop (didn't bet)
Seat 7: holloway85 folded on the Flop
Seat 8: Dachish (button) folded before Flop (didn't bet)
Seat 9: p.snow89 (small blind) collected ($10.45)





PokerStars Hand #151165057383:  Hold'em No Limit ($0.50/$1.00 USD) - 2016/03/30 16:30:39 CET [2016/03/30 10:30:39 ET]
Table 'Pannonia II' 9-max Seat #8 is the button
Seat 1: CI58 ($100 in chips) 
Seat 2: matiko09 ($100 in chips) 
Seat 3: MGL_Sky99 ($101.62 in chips) 
Seat 5: Spid1 ($131.62 in chips) 
Seat 8: stonymalony ($55.60 in chips) 
Seat 9: b_____a__242 ($86.19 in chips) 
b_____a__242: posts small blind $0.50
CI58: posts big blind $1
Dachish: sits out 
*** HOLE CARDS ***
Dealt to matiko09 [7s 5c]
matiko09: folds 
MGL_Sky99: folds 
Spid1: folds 
stonymalony: raises $1 to $2
b_____a__242: folds 
CI58: folds 
Uncalled bet ($1) returned to stonymalony
stonymalony collected $2.50 from pot
stonymalony: doesn't show hand 
*** SUMMARY ***
Total pot $2.50 | Rake $0 
Seat 1: CI58 (big blind) folded before Flop
Seat 2: matiko09 folded before Flop (didn't bet)
Seat 3: MGL_Sky99 folded before Flop (didn't bet)
Seat 5: Spid1 folded before Flop (didn't bet)
Seat 8: stonymalony (button) collected ($2.50)
Seat 9: b_____a__242 (small blind) folded before Flop





PokerStars Hand #151165062015:  Hold'em No Limit ($0.50/$1.00 USD) - 2016/03/30 16:30:46 CET [2016/03/30 10:30:46 ET]
Table 'Alcor II' 9-max Seat #5 is the button
Seat 1: Red4erT ($100 in chips) 
Seat 2: holloway85 ($77.34 in chips) 
Seat 3: mitchymitch3 ($111.67 in chips) 
Seat 5: elbiber2000 ($104.70 in chips) 
Seat 6: godfrey004 ($166.25 in chips) 
Seat 7: sanpidk ($103.71 in chips) 
Seat 9: matiko09 ($204.60 in chips) 
godfrey004: posts small blind $0.50
sanpidk: posts big blind $1
ka100pka527: sits out 
*** HOLE CARDS ***
Dealt to matiko09 [8h 7s]
matiko09: folds 
Red4erT: folds 
holloway85: folds 
mitchymitch3: folds 
elbiber2000: folds 
godfrey004: calls $0.50
sanpidk: raises $3.50 to $4.50
godfrey004: calls $3.50
*** FLOP *** [4s Kd 8s]
godfrey004: checks 
sanpidk: bets $5
godfrey004: calls $5
*** TURN *** [4s Kd 8s] [4c]
godfrey004: checks 
sanpidk: checks 
*** RIVER *** [4s Kd 8s 4c] [4h]
godfrey004: checks 
sanpidk: bets $10
godfrey004: calls $10
*** SHOW DOWN ***
sanpidk: shows [Qd Td] (three of a kind, Fours)
godfrey004: shows [Kc 7c] (a full house, Fours full of Kings)
godfrey004 collected $37.05 from pot
*** SUMMARY ***
Total pot $39 | Rake $1.95 
Board [4s Kd 8s 4c 4h]
Seat 1: Red4erT folded before Flop (didn't bet)
Seat 2: holloway85 folded before Flop (didn't bet)
Seat 3: mitchymitch3 folded before Flop (didn't bet)
Seat 5: elbiber2000 (button) folded before Flop (didn't bet)
Seat 6: godfrey004 (small blind) showed [Kc 7c] and won ($37.05) with a full house, Fours full of Kings
Seat 7: sanpidk (big blind) showed [Qd Td] and lost with three of a kind, Fours
Seat 9: matiko09 folded before Flop (didn't bet)





PokerStars Hand #151165063802:  Hold'em No Limit ($0.50/$1.00 USD) - 2016/03/30 16:30:48 CET [2016/03/30 10:30:48 ET]
Table 'Amata II' 9-max Seat #6 is the button
Seat 2: ilaviiitech ($113.45 in chips) 
Seat 3: matiko09 ($220.75 in chips) 
Seat 5: Spid1 ($142 in chips) 
Seat 6: RamiroAgujis ($100 in chips) 
Seat 7: Pvsx. ($188.51 in chips) 
Seat 8: ka100pka527 ($57.72 in chips) 
Pvsx.: posts small blind $0.50
ka100pka527: posts big blind $1
*** HOLE CARDS ***
Dealt to matiko09 [Jd 4s]
ilaviiitech: folds 
matiko09: folds 
Spid1: folds 
RamiroAgujis: raises $1.50 to $2.50
Pvsx.: folds 
ka100pka527: folds 
Uncalled bet ($1.50) returned to RamiroAgujis
RamiroAgujis collected $2.50 from pot
RamiroAgujis: doesn't show hand 
*** SUMMARY ***
Total pot $2.50 | Rake $0 
Seat 2: ilaviiitech folded before Flop (didn't bet)
Seat 3: matiko09 folded before Flop (didn't bet)
Seat 5: Spid1 folded before Flop (didn't bet)
Seat 6: RamiroAgujis (button) collected ($2.50)
Seat 7: Pvsx. (small blind) folded before Flop
Seat 8: ka100pka527 (big blind) folded before Flop





PokerStars Hand #151165071312:  Hold'em No Limit ($1/$2 USD) - 2016/03/30 16:31:00 CET [2016/03/30 10:31:00 ET]
Table 'Philoctetes II' 9-max Seat #4 is the button
Seat 1: vezunchik79 ($130.28 in chips) 
Seat 2: prominente ($226.91 in chips) 
Seat 3: mentalpshyco ($200 in chips) 
Seat 4: tepi_guy ($200 in chips) 
Seat 5: zhaimeng ($371.51 in chips) 
Seat 7: matiko09 ($200 in chips) 
Seat 8: suddend3ath ($200 in chips) 
Seat 9: RamiroAgujis ($240.30 in chips) 
zhaimeng: posts small blind $1
matiko09: posts big blind $2
*** HOLE CARDS ***
Dealt to matiko09 [9c Qh]
suddend3ath: folds 
RamiroAgujis: folds 
vezunchik79: folds 
prominente: folds 
mentalpshyco: folds 
tepi_guy: folds 
zhaimeng: calls $1
matiko09: raises $6 to $8
zhaimeng: calls $6
*** FLOP *** [3d 4c 8s]
zhaimeng: checks 
matiko09: bets $9.88
zhaimeng: folds 
Uncalled bet ($9.88) returned to matiko09
matiko09 collected $15.20 from pot
matiko09: doesn't show hand 
*** SUMMARY ***
Total pot $16 | Rake $0.80 
Board [3d 4c 8s]
Seat 1: vezunchik79 folded before Flop (didn't bet)
Seat 2: prominente folded before Flop (didn't bet)
Seat 3: mentalpshyco folded before Flop (didn't bet)
Seat 4: tepi_guy (button) folded before Flop (didn't bet)
Seat 5: zhaimeng (small blind) folded on the Flop
Seat 7: matiko09 (big blind) collected ($15.20)
Seat 8: suddend3ath folded before Flop (didn't bet)
Seat 9: RamiroAgujis folded before Flop (didn't bet)





PokerStars Hand #151165075773:  Hold'em No Limit ($1/$2 USD) - 2016/03/30 16:31:06 CET [2016/03/30 10:31:06 ET]
Table 'Aesculapia II' 9-max Seat #1 is the button
Seat 1: buthmen ($372.83 in chips) 
Seat 2: suddend3ath ($201 in chips) 
Seat 3: matiko09 ($478.74 in chips) 
Seat 5: prominente ($200 in chips) 
Seat 6: volwebni4ek ($102 in chips) 
Seat 7: Rumboni66 ($118.49 in chips) 
Seat 9: InsomniaRU ($212.75 in chips) 
suddend3ath: posts small blind $1
matiko09: posts big blind $2
tepi_guy: sits out 
*** HOLE CARDS ***
Dealt to matiko09 [4s 2s]
prominente: folds 
volwebni4ek: folds 
Rumboni66: folds 
InsomniaRU: folds 
buthmen: raises $4 to $6
suddend3ath: folds 
matiko09: folds 
Uncalled bet ($4) returned to buthmen
buthmen collected $5 from pot
buthmen: doesn't show hand 
*** SUMMARY ***
Total pot $5 | Rake $0 
Seat 1: buthmen (button) collected ($5)
Seat 2: suddend3ath (small blind) folded before Flop
Seat 3: matiko09 (big blind) folded before Flop
Seat 5: prominente folded before Flop (didn't bet)
Seat 6: volwebni4ek folded before Flop (didn't bet)
Seat 7: Rumboni66 folded before Flop (didn't bet)
Seat 9: InsomniaRU folded before Flop (didn't bet)





PokerStars Hand #151165080317:  Hold'em No Limit ($0.50/$1.00 USD) - 2016/03/30 16:31:13 CET [2016/03/30 10:31:13 ET]
Table 'Amata II' 9-max Seat #7 is the button
Seat 2: ilaviiitech ($113.45 in chips) 
Seat 3: matiko09 ($220.75 in chips) 
Seat 5: Spid1 ($142 in chips) 
Seat 6: RamiroAgujis ($101.50 in chips) 
Seat 7: Pvsx. ($188.01 in chips) 
Seat 8: ka100pka527 ($56.72 in chips) 
ka100pka527: posts small blind $0.50
ilaviiitech: posts big blind $1
*** HOLE CARDS ***
Dealt to matiko09 [7h 6d]
matiko09: folds 
Spid1: folds 
RamiroAgujis: folds 
Pvsx.: folds 
ka100pka527: raises $1 to $2
ilaviiitech: calls $1
*** FLOP *** [7s 2d Th]
ka100pka527: bets $2.53
ilaviiitech: folds 
Uncalled bet ($2.53) returned to ka100pka527
ka100pka527 collected $3.80 from pot
ka100pka527: doesn't show hand 
*** SUMMARY ***
Total pot $4 | Rake $0.20 
Board [7s 2d Th]
Seat 2: ilaviiitech (big blind) folded on the Flop
Seat 3: matiko09 folded before Flop (didn't bet)
Seat 5: Spid1 folded before Flop (didn't bet)
Seat 6: RamiroAgujis folded before Flop (didn't bet)
Seat 7: Pvsx. (button) folded before Flop (didn't bet)
Seat 8: ka100pka527 (small blind) collected ($3.80)





PokerStars Hand #151165091992:  Hold'em No Limit ($1/$2 USD) - 2016/03/30 16:31:30 CET [2016/03/30 10:31:30 ET]
Table 'Aesculapia II' 9-max Seat #2 is the button
Seat 1: buthmen ($375.83 in chips) 
Seat 2: suddend3ath ($200 in chips) 
Seat 3: matiko09 ($476.74 in chips) 
Seat 4: tepi_guy ($200 in chips) 
Seat 5: prominente ($200 in chips) 
Seat 6: volwebni4ek ($102 in chips) 
Seat 7: Rumboni66 ($118.49 in chips) 
Seat 9: InsomniaRU ($212.75 in chips) 
matiko09: posts small blind $1
tepi_guy: posts big blind $2
*** HOLE CARDS ***
Dealt to matiko09 [7c 4d]
prominente: folds 
volwebni4ek: folds 
Rumboni66: folds 
InsomniaRU: folds 
buthmen: folds 
suddend3ath: folds 
matiko09: folds 
Uncalled bet ($1) returned to tepi_guy
tepi_guy collected $2 from pot
tepi_guy: doesn't show hand 
*** SUMMARY ***
Total pot $2 | Rake $0 
Seat 1: buthmen folded before Flop (didn't bet)
Seat 2: suddend3ath (button) folded before Flop (didn't bet)
Seat 3: matiko09 (small blind) folded before Flop
Seat 4: tepi_guy (big blind) collected ($2)
Seat 5: prominente folded before Flop (didn't bet)
Seat 6: volwebni4ek folded before Flop (didn't bet)
Seat 7: Rumboni66 folded before Flop (didn't bet)
Seat 9: InsomniaRU folded before Flop (didn't bet)





PokerStars Hand #151165095988:  Hold'em No Limit ($1/$2 USD) - 2016/03/30 16:31:36 CET [2016/03/30 10:31:36 ET]
Table 'Hektor III' 9-max Seat #5 is the button
Seat 1: matiko09 ($200 in chips) 
Seat 2: RamiroAgujis ($302.45 in chips) 
Seat 3: T0ny Adams ($87.43 in chips) 
Seat 4: volwebni4ek ($109.64 in chips) 
Seat 5: prominente ($290.75 in chips) 
Seat 7: InsomniaRU ($215.04 in chips) 
Seat 8: tepi_guy ($200 in chips) 
Seat 9: fonng ($311.49 in chips) 
InsomniaRU: posts small blind $1
tepi_guy: posts big blind $2
*** HOLE CARDS ***
Dealt to matiko09 [9s 8h]
fonng: calls $2
matiko09: folds 
RamiroAgujis: folds 
T0ny Adams: folds 
volwebni4ek: folds 
prominente: folds 
InsomniaRU: folds 
tepi_guy: checks 
*** FLOP *** [7s Js 7c]
tepi_guy: checks 
fonng: checks 
*** TURN *** [7s Js 7c] [Kh]
tepi_guy: checks 
fonng: checks 
*** RIVER *** [7s Js 7c Kh] [Ah]
tepi_guy: checks 
fonng: checks 
*** SHOW DOWN ***
tepi_guy: shows [2s Td] (a pair of Sevens)
fonng: shows [8s As] (two pair, Aces and Sevens)
fonng collected $4.75 from pot
*** SUMMARY ***
Total pot $5 | Rake $0.25 
Board [7s Js 7c Kh Ah]
Seat 1: matiko09 folded before Flop (didn't bet)
Seat 2: RamiroAgujis folded before Flop (didn't bet)
Seat 3: T0ny Adams folded before Flop (didn't bet)
Seat 4: volwebni4ek folded before Flop (didn't bet)
Seat 5: prominente (button) folded before Flop (didn't bet)
Seat 7: InsomniaRU (small blind) folded before Flop
Seat 8: tepi_guy (big blind) showed [2s Td] and lost with a pair of Sevens
Seat 9: fonng showed [8s As] and won ($4.75) with two pair, Aces and Sevens





PokerStars Hand #151165099780:  Hold'em No Limit ($0.50/$1.00 USD) - 2016/03/30 16:31:42 CET [2016/03/30 10:31:42 ET]
Table 'Figneria III' 9-max Seat #9 is the button
Seat 1: matiko09 ($100 in chips) 
Seat 2: sanpidk ($105.72 in chips) 
Seat 4: CI58 ($100 in chips) 
Seat 5: volwebni4ek ($40 in chips) 
Seat 7: holloway85 ($210.29 in chips) 
Seat 8: Dachish ($76.22 in chips) 
Seat 9: p.snow89 ($86.30 in chips) 
matiko09: posts small blind $0.50
sanpidk: posts big blind $1
*** HOLE CARDS ***
Dealt to matiko09 [As 4h]
CI58: folds 
volwebni4ek: raises $2 to $3
holloway85: folds 
Dachish: folds 
p.snow89: folds 
matiko09: folds 
sanpidk: folds 
Uncalled bet ($2) returned to volwebni4ek
volwebni4ek collected $2.50 from pot
volwebni4ek: doesn't show hand 
*** SUMMARY ***
Total pot $2.50 | Rake $0 
Seat 1: matiko09 (small blind) folded before Flop
Seat 2: sanpidk (big blind) folded before Flop
Seat 4: CI58 folded before Flop (didn't bet)
Seat 5: volwebni4ek collected ($2.50)
Seat 7: holloway85 folded before Flop (didn't bet)
Seat 8: Dachish folded before Flop (didn't bet)
Seat 9: p.snow89 (button) folded before Flop (didn't bet)





PokerStars Hand #151165101928:  Hold'em No Limit ($0.50/$1.00 USD) - 2016/03/30 16:31:45 CET [2016/03/30 10:31:45 ET]
Table 'Pannonia II' 9-max Seat #9 is the button
Seat 1: CI58 ($100 in chips) 
Seat 2: matiko09 ($100 in chips) 
Seat 3: MGL_Sky99 ($101.62 in chips) 
Seat 5: Spid1 ($131.62 in chips) 
Seat 8: stonymalony ($57.10 in chips) 
Seat 9: b_____a__242 ($85.69 in chips) 
CI58: posts small blind $0.50
matiko09: posts big blind $1
Dachish: sits out 
*** HOLE CARDS ***
Dealt to matiko09 [9c Ks]
MGL_Sky99: folds 
Spid1: raises $2 to $3
stonymalony: folds 
b_____a__242: folds 
CI58: folds 
matiko09: folds 
Uncalled bet ($2) returned to Spid1
Spid1 collected $2.50 from pot
Spid1: doesn't show hand 
*** SUMMARY ***
Total pot $2.50 | Rake $0 
Seat 1: CI58 (small blind) folded before Flop
Seat 2: matiko09 (big blind) folded before Flop
Seat 3: MGL_Sky99 folded before Flop (didn't bet)
Seat 5: Spid1 collected ($2.50)
Seat 8: stonymalony folded before Flop (didn't bet)
Seat 9: b_____a__242 (button) folded before Flop (didn't bet)





PokerStars Hand #151165104544:  Hold'em No Limit ($1/$2 USD) - 2016/03/30 16:31:49 CET [2016/03/30 10:31:49 ET]
Table 'Aesculapia II' 9-max Seat #3 is the button
Seat 1: buthmen ($375.83 in chips) 
Seat 2: suddend3ath ($200 in chips) 
Seat 3: matiko09 ($475.74 in chips) 
Seat 4: tepi_guy ($201 in chips) 
Seat 5: prominente ($200 in chips) 
Seat 6: volwebni4ek ($102 in chips) 
Seat 7: Rumboni66 ($118.49 in chips) 
Seat 9: InsomniaRU ($212.75 in chips) 
tepi_guy: posts small blind $1
prominente: posts big blind $2
*** HOLE CARDS ***
Dealt to matiko09 [7s 8h]
volwebni4ek: folds 
Rumboni66: folds 
InsomniaRU: folds 
buthmen: raises $4 to $6
suddend3ath: raises $12 to $18
matiko09: folds 
tepi_guy: folds 
prominente: folds 
buthmen: calls $12
*** FLOP *** [7h 9c Th]
buthmen: checks 
suddend3ath: bets $40
buthmen: calls $40
*** TURN *** [7h 9c Th] [Tc]
buthmen: checks 
suddend3ath: bets $80
buthmen: calls $80
*** RIVER *** [7h 9c Th Tc] [3c]
buthmen: checks 
suddend3ath: checks 
*** SHOW DOWN ***
buthmen: shows [7d Ac] (two pair, Tens and Sevens)
suddend3ath: shows [9h Ah] (two pair, Tens and Nines)
suddend3ath collected $276.25 from pot
*** SUMMARY ***
Total pot $279 | Rake $2.75 
Board [7h 9c Th Tc 3c]
Seat 1: buthmen showed [7d Ac] and lost with two pair, Tens and Sevens
Seat 2: suddend3ath showed [9h Ah] and won ($276.25) with two pair, Tens and Nines
Seat 3: matiko09 (button) folded before Flop (didn't bet)
Seat 4: tepi_guy (small blind) folded before Flop
Seat 5: prominente (big blind) folded before Flop
Seat 6: volwebni4ek folded before Flop (didn't bet)
Seat 7: Rumboni66 folded before Flop (didn't bet)
Seat 9: InsomniaRU folded before Flop (didn't bet)





PokerStars Hand #151165107346:  Hold'em No Limit ($0.50/$1.00 USD) - 2016/03/30 16:31:53 CET [2016/03/30 10:31:53 ET]
Table 'Amata II' 9-max Seat #8 is the button
Seat 2: ilaviiitech ($111.45 in chips) 
Seat 3: matiko09 ($220.75 in chips) 
Seat 5: Spid1 ($142 in chips) 
Seat 6: RamiroAgujis ($101.50 in chips) 
Seat 7: Pvsx. ($188.01 in chips) 
Seat 8: ka100pka527 ($58.52 in chips) 
ilaviiitech: posts small blind $0.50
matiko09: posts big blind $1
*** HOLE CARDS ***
Dealt to matiko09 [Th 8d]
Spid1: folds 
RamiroAgujis: raises $2 to $3
Pvsx.: folds 
ka100pka527: folds 
ilaviiitech: folds 
matiko09: folds 
Uncalled bet ($2) returned to RamiroAgujis
RamiroAgujis collected $2.50 from pot
*** SUMMARY ***
Total pot $2.50 | Rake $0 
Seat 2: ilaviiitech (small blind) folded before Flop
Seat 3: matiko09 (big blind) folded before Flop
Seat 5: Spid1 folded before Flop (didn't bet)
Seat 6: RamiroAgujis collected ($2.50)
Seat 7: Pvsx. folded before Flop (didn't bet)
Seat 8: ka100pka527 (button) folded before Flop (didn't bet)





PokerStars Hand #151165110515:  Hold'em No Limit ($0.50/$1.00 USD) - 2016/03/30 16:31:58 CET [2016/03/30 10:31:58 ET]
Table 'Alcor II' 9-max Seat #6 is the button
Seat 1: Red4erT ($100 in chips) 
Seat 2: holloway85 ($77.34 in chips) 
Seat 3: mitchymitch3 ($111.67 in chips) 
Seat 5: elbiber2000 ($104.70 in chips) 
Seat 6: godfrey004 ($183.80 in chips) 
Seat 7: sanpidk ($100 in chips) 
Seat 8: ka100pka527 ($66.28 in chips) 
Seat 9: matiko09 ($204.60 in chips) 
sanpidk: posts small blind $0.50
ka100pka527: posts big blind $1
*** HOLE CARDS ***
Dealt to matiko09 [6d Ah]
matiko09: folds 
Red4erT: folds 
holloway85: folds 
mitchymitch3: folds 
elbiber2000: folds 
godfrey004: calls $1
sanpidk: raises $4 to $5
ka100pka527: folds 
godfrey004: folds 
Uncalled bet ($4) returned to sanpidk
sanpidk collected $3 from pot
*** SUMMARY ***
Total pot $3 | Rake $0 
Seat 1: Red4erT folded before Flop (didn't bet)
Seat 2: holloway85 folded before Flop (didn't bet)
Seat 3: mitchymitch3 folded before Flop (didn't bet)
Seat 5: elbiber2000 folded before Flop (didn't bet)
Seat 6: godfrey004 (button) folded before Flop
Seat 7: sanpidk (small blind) collected ($3)
Seat 8: ka100pka527 (big blind) folded before Flop
Seat 9: matiko09 folded before Flop (didn't bet)





PokerStars Hand #151165117732:  Hold'em No Limit ($0.50/$1.00 USD) - 2016/03/30 16:32:09 CET [2016/03/30 10:32:09 ET]
Table 'Amata II' 9-max Seat #2 is the button
Seat 2: ilaviiitech ($110.95 in chips) 
Seat 3: matiko09 ($219.75 in chips) 
Seat 5: Spid1 ($142 in chips) 
Seat 6: RamiroAgujis ($103 in chips) 
Seat 7: Pvsx. ($188.01 in chips) 
Seat 8: ka100pka527 ($58.52 in chips) 
matiko09: posts small blind $0.50
Spid1: posts big blind $1
*** HOLE CARDS ***
Dealt to matiko09 [Tc Kh]
RamiroAgujis: folds 
Pvsx.: folds 
ka100pka527: raises $1 to $2
ilaviiitech: folds 
matiko09: folds 
Spid1: folds 
Uncalled bet ($1) returned to ka100pka527
ka100pka527 collected $2.50 from pot
ka100pka527: doesn't show hand 
*** SUMMARY ***
Total pot $2.50 | Rake $0 
Seat 2: ilaviiitech (button) folded before Flop (didn't bet)
Seat 3: matiko09 (small blind) folded before Flop
Seat 5: Spid1 (big blind) folded before Flop
Seat 6: RamiroAgujis folded before Flop (didn't bet)
Seat 7: Pvsx. folded before Flop (didn't bet)
Seat 8: ka100pka527 collected ($2.50)





PokerStars Hand #151165118949:  Hold'em No Limit ($1/$2 USD) - 2016/03/30 16:32:10 CET [2016/03/30 10:32:10 ET]
Table 'Philoctetes II' 9-max Seat #5 is the button
Seat 1: vezunchik79 ($130.28 in chips) 
Seat 2: prominente ($226.91 in chips) 
Seat 3: mentalpshyco ($200 in chips) 
Seat 4: tepi_guy ($200 in chips) 
Seat 5: zhaimeng ($363.51 in chips) 
Seat 7: matiko09 ($207.20 in chips) 
Seat 8: suddend3ath ($200 in chips) 
Seat 9: RamiroAgujis ($240.30 in chips) 
matiko09: posts small blind $1
suddend3ath: posts big blind $2
*** HOLE CARDS ***
Dealt to matiko09 [7h Ks]
RamiroAgujis: folds 
vezunchik79: raises $3 to $5
prominente: folds 
mentalpshyco: folds 
tepi_guy: calls $5
zhaimeng: calls $5
matiko09: folds 
suddend3ath: folds 
*** FLOP *** [8d 9h Jc]
vezunchik79: bets $10
tepi_guy: folds 
zhaimeng: calls $10
*** TURN *** [8d 9h Jc] [8s]
vezunchik79: bets $20
zhaimeng: folds 
Uncalled bet ($20) returned to vezunchik79
vezunchik79 collected $36.10 from pot
vezunchik79: doesn't show hand 
*** SUMMARY ***
Total pot $38 | Rake $1.90 
Board [8d 9h Jc 8s]
Seat 1: vezunchik79 collected ($36.10)
Seat 2: prominente folded before Flop (didn't bet)
Seat 3: mentalpshyco folded before Flop (didn't bet)
Seat 4: tepi_guy folded on the Flop
Seat 5: zhaimeng (button) folded on the Turn
Seat 7: matiko09 (small blind) folded before Flop
Seat 8: suddend3ath (big blind) folded before Flop
Seat 9: RamiroAgujis folded before Flop (didn't bet)





PokerStars Hand #151165118905:  Hold'em No Limit ($0.50/$1.00 USD) - 2016/03/30 16:32:10 CET [2016/03/30 10:32:10 ET]
Table 'Pannonia II' 9-max Seat #1 is the button
Seat 1: CI58 ($100 in chips) 
Seat 2: matiko09 ($100 in chips) 
Seat 3: MGL_Sky99 ($101.62 in chips) 
Seat 5: Spid1 ($133.12 in chips) 
Seat 8: stonymalony ($57.10 in chips) 
Seat 9: b_____a__242 ($85.69 in chips) 
matiko09: posts small blind $0.50
MGL_Sky99: posts big blind $1
Dachish: sits out 
*** HOLE CARDS ***
Dealt to matiko09 [3s 9d]
Spid1: folds 
stonymalony: folds 
b_____a__242: folds 
CI58: folds 
matiko09: folds 
Uncalled bet ($0.50) returned to MGL_Sky99
MGL_Sky99 collected $1 from pot
MGL_Sky99: doesn't show hand 
*** SUMMARY ***
Total pot $1 | Rake $0 
Seat 1: CI58 (button) folded before Flop (didn't bet)
Seat 2: matiko09 (small blind) folded before Flop
Seat 3: MGL_Sky99 (big blind) collected ($1)
Seat 5: Spid1 folded before Flop (didn't bet)
Seat 8: stonymalony folded before Flop (didn't bet)
Seat 9: b_____a__242 folded before Flop (didn't bet)





PokerStars Hand #151165124977:  Hold'em No Limit ($0.50/$1.00 USD) - 2016/03/30 16:32:19 CET [2016/03/30 10:32:19 ET]
Table 'Figneria III' 9-max Seat #1 is the button
Seat 1: matiko09 ($100 in chips) 
Seat 2: sanpidk ($104.72 in chips) 
Seat 4: CI58 ($100 in chips) 
Seat 5: volwebni4ek ($41.50 in chips) 
Seat 7: holloway85 ($210.29 in chips) 
Seat 8: Dachish ($76.22 in chips) 
Seat 9: p.snow89 ($86.30 in chips) 
sanpidk: posts small blind $0.50
CI58: posts big blind $1
*** HOLE CARDS ***
Dealt to matiko09 [2c Qs]
volwebni4ek: folds 
holloway85: calls $1
Dachish: raises $3.50 to $4.50
p.snow89: folds 
matiko09: folds 
sanpidk: folds 
CI58: folds 
holloway85: calls $3.50
*** FLOP *** [3s Qc Td]
holloway85: checks 
Dachish: checks 
*** TURN *** [3s Qc Td] [8s]
holloway85: checks 
Dachish: checks 
*** RIVER *** [3s Qc Td 8s] [5d]
holloway85: bets $2
Dachish: calls $2
*** SHOW DOWN ***
holloway85: shows [8d Ad] (a pair of Eights)
Dachish: mucks hand 
holloway85 collected $13.78 from pot
*** SUMMARY ***
Total pot $14.50 | Rake $0.72 
Board [3s Qc Td 8s 5d]
Seat 1: matiko09 (button) folded before Flop (didn't bet)
Seat 2: sanpidk (small blind) folded before Flop
Seat 4: CI58 (big blind) folded before Flop
Seat 5: volwebni4ek folded before Flop (didn't bet)
Seat 7: holloway85 showed [8d Ad] and won ($13.78) with a pair of Eights
Seat 8: Dachish mucked [6c 6s]
Seat 9: p.snow89 folded before Flop (didn't bet)





PokerStars Hand #151165128461:  Hold'em No Limit ($0.50/$1.00 USD) - 2016/03/30 16:32:25 CET [2016/03/30 10:32:25 ET]
Table 'Pannonia II' 9-max Seat #2 is the button
Seat 1: CI58 ($100 in chips) 
Seat 2: matiko09 ($100 in chips) 
Seat 3: MGL_Sky99 ($102.12 in chips) 
Seat 5: Spid1 ($133.12 in chips) 
Seat 8: stonymalony ($57.10 in chips) 
Seat 9: b_____a__242 ($85.69 in chips) 
MGL_Sky99: posts small blind $0.50
Spid1: posts big blind $1
Dachish: sits out 
*** HOLE CARDS ***
Dealt to matiko09 [Jc 9h]
stonymalony: raises $1 to $2
b_____a__242: folds 
CI58: folds 
matiko09: folds 
MGL_Sky99: folds 
Spid1: folds 
Uncalled bet ($1) returned to stonymalony
stonymalony collected $2.50 from pot
stonymalony: doesn't show hand 
*** SUMMARY ***
Total pot $2.50 | Rake $0 
Seat 1: CI58 folded before Flop (didn't bet)
Seat 2: matiko09 (button) folded before Flop (didn't bet)
Seat 3: MGL_Sky99 (small blind) folded before Flop
Seat 5: Spid1 (big blind) folded before Flop
Seat 8: stonymalony collected ($2.50)
Seat 9: b_____a__242 folded before Flop (didn't bet)





PokerStars Hand #151165128901:  Hold'em No Limit ($0.50/$1.00 USD) - 2016/03/30 16:32:25 CET [2016/03/30 10:32:25 ET]
Table 'Amata II' 9-max Seat #3 is the button
Seat 2: ilaviiitech ($110.95 in chips) 
Seat 3: matiko09 ($219.25 in chips) 
Seat 5: Spid1 ($141 in chips) 
Seat 6: RamiroAgujis ($103 in chips) 
Seat 7: Pvsx. ($188.01 in chips) 
Seat 8: ka100pka527 ($60.02 in chips) 
Spid1: posts small blind $0.50
RamiroAgujis: posts big blind $1
*** HOLE CARDS ***
Dealt to matiko09 [Qd Td]
Pvsx.: folds 
ka100pka527: raises $2 to $3
ilaviiitech: folds 
matiko09: folds 
Spid1: folds 
RamiroAgujis: folds 
Uncalled bet ($2) returned to ka100pka527
ka100pka527 collected $2.50 from pot
ka100pka527: doesn't show hand 
*** SUMMARY ***
Total pot $2.50 | Rake $0 
Seat 2: ilaviiitech folded before Flop (didn't bet)
Seat 3: matiko09 (button) folded before Flop (didn't bet)
Seat 5: Spid1 (small blind) folded before Flop
Seat 6: RamiroAgujis (big blind) folded before Flop
Seat 7: Pvsx. folded before Flop (didn't bet)
Seat 8: ka100pka527 collected ($2.50)





PokerStars Hand #151165130022:  Hold'em No Limit ($0.50/$1.00 USD) - 2016/03/30 16:32:27 CET [2016/03/30 10:32:27 ET]
Table 'Alcor II' 9-max Seat #7 is the button
Seat 1: Red4erT ($100 in chips) 
Seat 2: holloway85 ($77.34 in chips) 
Seat 3: mitchymitch3 ($111.67 in chips) 
Seat 5: elbiber2000 ($104.70 in chips) 
Seat 6: godfrey004 ($182.80 in chips) 
Seat 7: sanpidk ($102 in chips) 
Seat 8: ka100pka527 ($65.28 in chips) 
Seat 9: matiko09 ($204.60 in chips) 
ka100pka527: posts small blind $0.50
matiko09: posts big blind $1
*** HOLE CARDS ***
Dealt to matiko09 [4c Jh]
Red4erT: folds 
holloway85: folds 
mitchymitch3: folds 
elbiber2000: folds 
godfrey004: calls $1
sanpidk: folds 
ka100pka527: raises $4 to $5
matiko09: folds 
godfrey004: calls $4
*** FLOP *** [9c Kc 5h]
ka100pka527: checks 
godfrey004: checks 
*** TURN *** [9c Kc 5h] [Ad]
ka100pka527: checks 
godfrey004: bets $6
ka100pka527: folds 
Uncalled bet ($6) returned to godfrey004
godfrey004 collected $10.45 from pot
godfrey004: doesn't show hand 
*** SUMMARY ***
Total pot $11 | Rake $0.55 
Board [9c Kc 5h Ad]
Seat 1: Red4erT folded before Flop (didn't bet)
Seat 2: holloway85 folded before Flop (didn't bet)
Seat 3: mitchymitch3 folded before Flop (didn't bet)
Seat 5: elbiber2000 folded before Flop (didn't bet)
Seat 6: godfrey004 collected ($10.45)
Seat 7: sanpidk (button) folded before Flop (didn't bet)
Seat 8: ka100pka527 (small blind) folded on the Turn
Seat 9: matiko09 (big blind) folded before Flop





PokerStars Hand #151165131685:  Hold'em No Limit ($1/$2 USD) - 2016/03/30 16:32:29 CET [2016/03/30 10:32:29 ET]
Table 'Jole' 9-max Seat #5 is the button
Seat 1: matiko09 ($328.50 in chips) 
Seat 2: RamiroAgujis ($275.76 in chips) 
Seat 3: prominente ($207 in chips) 
Seat 5: dunga119 ($99.90 in chips) 
Seat 6: King_ZéManel ($200.05 in chips) 
Seat 7: ilaviiitech ($277.16 in chips) 
Seat 9: Ravnica11 ($94.65 in chips) 
King_ZéManel: posts small blind $1
ilaviiitech: posts big blind $2
tepi_guy: sits out 
*** HOLE CARDS ***
Dealt to matiko09 [2d 9d]
Ravnica11: folds 
matiko09: folds 
RamiroAgujis: folds 
prominente: raises $3 to $5
dunga119: raises $7 to $12
King_ZéManel: folds 
ilaviiitech: folds 
prominente: folds 
Uncalled bet ($7) returned to dunga119
dunga119 collected $13 from pot
dunga119: doesn't show hand 
*** SUMMARY ***
Total pot $13 | Rake $0 
Seat 1: matiko09 folded before Flop (didn't bet)
Seat 2: RamiroAgujis folded before Flop (didn't bet)
Seat 3: prominente folded before Flop
Seat 5: dunga119 (button) collected ($13)
Seat 6: King_ZéManel (small blind) folded before Flop
Seat 7: ilaviiitech (big blind) folded before Flop
Seat 9: Ravnica11 folded before Flop (didn't bet)





PokerStars Hand #151165134005:  Hold'em No Limit ($1/$2 USD) - 2016/03/30 16:32:33 CET [2016/03/30 10:32:33 ET]
Table 'Hektor III' 9-max Seat #7 is the button
Seat 1: matiko09 ($200 in chips) 
Seat 2: RamiroAgujis ($302.45 in chips) 
Seat 3: T0ny Adams ($87.43 in chips) 
Seat 4: volwebni4ek ($109.64 in chips) 
Seat 5: prominente ($290.75 in chips) 
Seat 7: InsomniaRU ($214.04 in chips) 
Seat 8: tepi_guy ($200 in chips) 
Seat 9: fonng ($314.24 in chips) 
tepi_guy: posts small blind $1
fonng: posts big blind $2
*** HOLE CARDS ***
Dealt to matiko09 [3s Ad]
matiko09: folds 
RamiroAgujis: folds 
T0ny Adams: folds 
volwebni4ek: raises $3 to $5
prominente: calls $5
InsomniaRU: folds 
tepi_guy: folds 
fonng: folds 
*** FLOP *** [7h Qs Ac]
volwebni4ek: checks 
prominente: bets $8.23
volwebni4ek: raises $13.99 to $22.22
prominente: calls $13.99
*** TURN *** [7h Qs Ac] [4d]
volwebni4ek: checks 
prominente: bets $25
volwebni4ek: calls $25
*** RIVER *** [7h Qs Ac 4d] [Kh]
volwebni4ek: checks 
prominente: bets $69.79
volwebni4ek: folds 
Uncalled bet ($69.79) returned to prominente
prominente collected $104.69 from pot
prominente: doesn't show hand 
*** SUMMARY ***
Total pot $107.44 | Rake $2.75 
Board [7h Qs Ac 4d Kh]
Seat 1: matiko09 folded before Flop (didn't bet)
Seat 2: RamiroAgujis folded before Flop (didn't bet)
Seat 3: T0ny Adams folded before Flop (didn't bet)
Seat 4: volwebni4ek folded on the River
Seat 5: prominente collected ($104.69)
Seat 7: InsomniaRU (button) folded before Flop (didn't bet)
Seat 8: tepi_guy (small blind) folded before Flop
Seat 9: fonng (big blind) folded before Flop





PokerStars Hand #151165139183:  Hold'em No Limit ($0.50/$1.00 USD) - 2016/03/30 16:32:41 CET [2016/03/30 10:32:41 ET]
Table 'Amata II' 9-max Seat #5 is the button
Seat 2: ilaviiitech ($110.95 in chips) 
Seat 3: matiko09 ($219.25 in chips) 
Seat 5: Spid1 ($140.50 in chips) 
Seat 6: RamiroAgujis ($102 in chips) 
Seat 7: Pvsx. ($188.01 in chips) 
Seat 8: ka100pka527 ($61.52 in chips) 
RamiroAgujis: posts small blind $0.50
Pvsx.: posts big blind $1
*** HOLE CARDS ***
Dealt to matiko09 [9s 6s]
ka100pka527: folds 
ilaviiitech: folds 
matiko09: folds 
Spid1: folds 
RamiroAgujis: raises $2 to $3
Pvsx.: folds 
Uncalled bet ($2) returned to RamiroAgujis
RamiroAgujis collected $2 from pot
RamiroAgujis: doesn't show hand 
*** SUMMARY ***
Total pot $2 | Rake $0 
Seat 2: ilaviiitech folded before Flop (didn't bet)
Seat 3: matiko09 folded before Flop (didn't bet)
Seat 5: Spid1 (button) folded before Flop (didn't bet)
Seat 6: RamiroAgujis (small blind) collected ($2)
Seat 7: Pvsx. (big blind) folded before Flop
Seat 8: ka100pka527 folded before Flop (didn't bet)





PokerStars Hand #151165142214:  Hold'em No Limit ($1/$2 USD) - 2016/03/30 16:32:45 CET [2016/03/30 10:32:45 ET]
Table 'Aesculapia II' 9-max Seat #4 is the button
Seat 1: buthmen ($237.83 in chips) 
Seat 2: suddend3ath ($338.25 in chips) 
Seat 3: matiko09 ($475.74 in chips) 
Seat 4: tepi_guy ($200 in chips) 
Seat 5: prominente ($200 in chips) 
Seat 7: Rumboni66 ($118.49 in chips) 
Seat 9: InsomniaRU ($212.75 in chips) 
prominente: posts small blind $1
volwebni4ek: is sitting out 
volwebni4ek leaves the table
Rumboni66: posts big blind $2
*** HOLE CARDS ***
Dealt to matiko09 [3s 6d]
InsomniaRU: raises $3 to $5
buthmen: calls $5
suddend3ath: folds 
mentalpshyco joins the table at seat #6 
matiko09: folds 
tepi_guy: folds 
prominente: folds 
Rumboni66: folds 
*** FLOP *** [9d 2s Qh]
InsomniaRU: checks 
buthmen: bets $4
InsomniaRU: calls $4
*** TURN *** [9d 2s Qh] [Td]
InsomniaRU: bets $13.37
buthmen: calls $13.37
*** RIVER *** [9d 2s Qh Td] [Qs]
InsomniaRU: checks 
buthmen: checks 
*** SHOW DOWN ***
InsomniaRU: shows [Tc 9c] (two pair, Queens and Tens)
buthmen: shows [Ts 6s] (two pair, Queens and Tens)
InsomniaRU collected $22.68 from pot
buthmen collected $22.67 from pot
*** SUMMARY ***
Total pot $47.74 | Rake $2.39 
Board [9d 2s Qh Td Qs]
Seat 1: buthmen showed [Ts 6s] and won ($22.67) with two pair, Queens and Tens
Seat 2: suddend3ath folded before Flop (didn't bet)
Seat 3: matiko09 folded before Flop (didn't bet)
Seat 4: tepi_guy (button) folded before Flop (didn't bet)
Seat 5: prominente (small blind) folded before Flop
Seat 7: Rumboni66 (big blind) folded before Flop
Seat 9: InsomniaRU showed [Tc 9c] and won ($22.68) with two pair, Queens and Tens





PokerStars Hand #151165152326:  Hold'em No Limit ($0.50/$1.00 USD) - 2016/03/30 16:33:00 CET [2016/03/30 10:33:00 ET]
Table 'Pannonia II' 9-max Seat #3 is the button
Seat 1: CI58 ($100 in chips) 
Seat 2: matiko09 ($100 in chips) 
Seat 3: MGL_Sky99 ($101.62 in chips) 
Seat 5: Spid1 ($132.12 in chips) 
Seat 7: Dachish ($70 in chips) 
Seat 8: stonymalony ($58.60 in chips) 
Seat 9: b_____a__242 ($85.69 in chips) 
Spid1: posts small blind $0.50
Dachish: posts big blind $1
*** HOLE CARDS ***
Dealt to matiko09 [5c Tc]
stonymalony: folds 
b_____a__242: folds 
CI58: raises $2 to $3
matiko09: folds 
MGL_Sky99: folds 
Spid1: folds 
Dachish: calls $2
*** FLOP *** [3d Qc 8s]
Dachish: checks 
CI58: checks 
*** TURN *** [3d Qc 8s] [Ah]
Dachish: checks 
CI58: bets $3.09
Dachish: raises $8.77 to $11.86
CI58: folds 
Uncalled bet ($8.77) returned to Dachish
Dachish collected $12.05 from pot
Dachish: doesn't show hand 
*** SUMMARY ***
Total pot $12.68 | Rake $0.63 
Board [3d Qc 8s Ah]
Seat 1: CI58 folded on the Turn
Seat 2: matiko09 folded before Flop (didn't bet)
Seat 3: MGL_Sky99 (button) folded before Flop (didn't bet)
Seat 5: Spid1 (small blind) folded before Flop
Seat 7: Dachish (big blind) collected ($12.05)
Seat 8: stonymalony folded before Flop (didn't bet)
Seat 9: b_____a__242 folded before Flop (didn't bet)





PokerStars Hand #151165158379:  Hold'em No Limit ($0.50/$1.00 USD) - 2016/03/30 16:33:09 CET [2016/03/30 10:33:09 ET]
Table 'Figneria III' 9-max Seat #2 is the button
Seat 1: matiko09 ($100 in chips) 
Seat 2: sanpidk ($104.22 in chips) 
Seat 4: CI58 ($100 in chips) 
Seat 7: holloway85 ($217.57 in chips) 
Seat 8: Dachish ($69.72 in chips) 
Seat 9: p.snow89 ($86.30 in chips) 
CI58: posts small blind $0.50
volwebni4ek: is sitting out 
e306 was removed from the table for failing to post
volwebni4ek leaves the table
holloway85: posts big blind $1
*** HOLE CARDS ***
Dealt to matiko09 [Js 9h]
Dachish: folds 
b_____a__242 joins the table at seat #5 
p.snow89: calls $1
matiko09: folds 
sanpidk: raises $3.50 to $4.50
CI58: folds 
holloway85: folds 
RICKA16 joins the table at seat #6 
p.snow89: calls $3.50
*** FLOP *** [7c Jd Ah]
p.snow89: checks 
sanpidk: bets $5.50
p.snow89: folds 
Uncalled bet ($5.50) returned to sanpidk
sanpidk collected $9.98 from pot
sanpidk: doesn't show hand 
*** SUMMARY ***
Total pot $10.50 | Rake $0.52 
Board [7c Jd Ah]
Seat 1: matiko09 folded before Flop (didn't bet)
Seat 2: sanpidk (button) collected ($9.98)
Seat 4: CI58 (small blind) folded before Flop
Seat 7: holloway85 (big blind) folded before Flop
Seat 8: Dachish folded before Flop (didn't bet)
Seat 9: p.snow89 folded on the Flop





PokerStars Hand #151165160997:  Hold'em No Limit ($1/$2 USD) - 2016/03/30 16:33:13 CET [2016/03/30 10:33:13 ET]
Table 'Jole' 9-max Seat #6 is the button
Seat 1: matiko09 ($328.50 in chips) 
Seat 2: RamiroAgujis ($275.76 in chips) 
Seat 3: prominente ($202 in chips) 
Seat 5: dunga119 ($107.90 in chips) 
Seat 6: King_ZéManel ($200 in chips) 
Seat 7: ilaviiitech ($275.16 in chips) 
Seat 9: Ravnica11 ($94.65 in chips) 
ilaviiitech: posts small blind $1
Ravnica11: posts big blind $2
tepi_guy: sits out 
*** HOLE CARDS ***
Dealt to matiko09 [Qh 3d]
matiko09: folds 
RamiroAgujis: folds 
prominente: raises $3 to $5
dunga119: folds 
dunga119 leaves the table
King_ZéManel: folds 
ilaviiitech: calls $4
mentalpshyco joins the table at seat #5 
Ravnica11: folds 
*** FLOP *** [As Jd 4h]
ilaviiitech: checks 
prominente: checks 
*** TURN *** [As Jd 4h] [2d]
ilaviiitech: bets $7.98
prominente: calls $7.98
*** RIVER *** [As Jd 4h 2d] [9h]
ilaviiitech: checks 
prominente: bets $15.94
ilaviiitech: folds 
Uncalled bet ($15.94) returned to prominente
prominente collected $26.56 from pot
prominente: doesn't show hand 
*** SUMMARY ***
Total pot $27.96 | Rake $1.40 
Board [As Jd 4h 2d 9h]
Seat 1: matiko09 folded before Flop (didn't bet)
Seat 2: RamiroAgujis folded before Flop (didn't bet)
Seat 3: prominente collected ($26.56)
Seat 5: dunga119 folded before Flop (didn't bet)
Seat 6: King_ZéManel (button) folded before Flop (didn't bet)
Seat 7: ilaviiitech (small blind) folded on the River
Seat 9: Ravnica11 (big blind) folded before Flop





PokerStars Hand #151165164765:  Hold'em No Limit ($0.50/$1.00 USD) - 2016/03/30 16:33:19 CET [2016/03/30 10:33:19 ET]
Table 'Amata II' 9-max Seat #6 is the button
Seat 2: ilaviiitech ($110.95 in chips) 
Seat 3: matiko09 ($219.25 in chips) 
Seat 5: Spid1 ($140.50 in chips) 
Seat 6: RamiroAgujis ($103 in chips) 
Seat 7: Pvsx. ($187.01 in chips) 
Seat 8: ka100pka527 ($61.52 in chips) 
Pvsx.: posts small blind $0.50
ka100pka527: posts big blind $1
*** HOLE CARDS ***
Dealt to matiko09 [3s Ac]
ilaviiitech: folds 
matiko09: folds 
Spid1: raises $1.50 to $2.50
RamiroAgujis: folds 
Pvsx.: folds 
ka100pka527: calls $1.50
*** FLOP *** [9h 7c Jc]
ka100pka527: checks 
Spid1: checks 
*** TURN *** [9h 7c Jc] [Qs]
ka100pka527: checks 
Spid1: bets $4
ka100pka527: folds 
Uncalled bet ($4) returned to Spid1
Spid1 collected $5.22 from pot
Spid1: doesn't show hand 
*** SUMMARY ***
Total pot $5.50 | Rake $0.28 
Board [9h 7c Jc Qs]
Seat 2: ilaviiitech folded before Flop (didn't bet)
Seat 3: matiko09 folded before Flop (didn't bet)
Seat 5: Spid1 collected ($5.22)
Seat 6: RamiroAgujis (button) folded before Flop (didn't bet)
Seat 7: Pvsx. (small blind) folded before Flop
Seat 8: ka100pka527 (big blind) folded on the Turn





PokerStars Hand #151165174103:  Hold'em No Limit ($0.50/$1.00 USD) - 2016/03/30 16:33:32 CET [2016/03/30 10:33:32 ET]
Table 'Alcor II' 9-max Seat #8 is the button
Seat 1: Red4erT ($100 in chips) 
Seat 2: holloway85 ($77.34 in chips) 
Seat 3: mitchymitch3 ($111.67 in chips) 
Seat 5: elbiber2000 ($104.70 in chips) 
Seat 6: godfrey004 ($188.25 in chips) 
Seat 7: sanpidk ($102 in chips) 
Seat 8: ka100pka527 ($60.28 in chips) 
Seat 9: matiko09 ($203.60 in chips) 
matiko09: posts small blind $0.50
Red4erT: posts big blind $1
*** HOLE CARDS ***
Dealt to matiko09 [Ts Tc]
holloway85: folds 
mitchymitch3: folds 
elbiber2000: folds 
godfrey004: calls $1
sanpidk: folds 
ka100pka527: folds 
matiko09: raises $4 to $5
Red4erT: folds 
godfrey004: calls $4
*** FLOP *** [8h 6s Th]
matiko09: bets $7
godfrey004: folds 
Uncalled bet ($7) returned to matiko09
matiko09 collected $10.45 from pot
matiko09: doesn't show hand 
*** SUMMARY ***
Total pot $11 | Rake $0.55 
Board [8h 6s Th]
Seat 1: Red4erT (big blind) folded before Flop
Seat 2: holloway85 folded before Flop (didn't bet)
Seat 3: mitchymitch3 folded before Flop (didn't bet)
Seat 5: elbiber2000 folded before Flop (didn't bet)
Seat 6: godfrey004 folded on the Flop
Seat 7: sanpidk folded before Flop (didn't bet)
Seat 8: ka100pka527 (button) folded before Flop (didn't bet)
Seat 9: matiko09 (small blind) collected ($10.45)





PokerStars Hand #151165180862:  Hold'em No Limit ($1/$2 USD) - 2016/03/30 16:33:43 CET [2016/03/30 10:33:43 ET]
Table 'Philoctetes II' 9-max Seat #7 is the button
Seat 1: vezunchik79 ($151.38 in chips) 
Seat 2: prominente ($226.91 in chips) 
Seat 3: mentalpshyco ($200 in chips) 
Seat 4: tepi_guy ($200 in chips) 
Seat 5: zhaimeng ($348.51 in chips) 
Seat 7: matiko09 ($206.20 in chips) 
Seat 8: suddend3ath ($200 in chips) 
Seat 9: RamiroAgujis ($240.30 in chips) 
suddend3ath: posts small blind $1
RamiroAgujis: posts big blind $2
*** HOLE CARDS ***
Dealt to matiko09 [9c Jc]
vezunchik79: folds 
prominente: folds 
mentalpshyco: raises $3 to $5
tepi_guy: calls $5
zhaimeng: folds 
matiko09: folds 
suddend3ath: folds 
RamiroAgujis: folds 
*** FLOP *** [Kd 7d 5s]
mentalpshyco: checks 
tepi_guy: checks 
*** TURN *** [Kd 7d 5s] [3s]
mentalpshyco: bets $8
tepi_guy: calls $8
*** RIVER *** [Kd 7d 5s 3s] [Qh]
mentalpshyco: bets $18
tepi_guy: folds 
Uncalled bet ($18) returned to mentalpshyco
mentalpshyco collected $27.55 from pot
mentalpshyco: doesn't show hand 
*** SUMMARY ***
Total pot $29 | Rake $1.45 
Board [Kd 7d 5s 3s Qh]
Seat 1: vezunchik79 folded before Flop (didn't bet)
Seat 2: prominente folded before Flop (didn't bet)
Seat 3: mentalpshyco collected ($27.55)
Seat 4: tepi_guy folded on the River
Seat 5: zhaimeng folded before Flop (didn't bet)
Seat 7: matiko09 (button) folded before Flop (didn't bet)
Seat 8: suddend3ath (small blind) folded before Flop
Seat 9: RamiroAgujis (big blind) folded before Flop





PokerStars Hand #151165194206:  Hold'em No Limit ($0.50/$1.00 USD) - 2016/03/30 16:34:02 CET [2016/03/30 10:34:02 ET]
Table 'Pannonia II' 9-max Seat #5 is the button
Seat 1: CI58 ($100 in chips) 
Seat 2: matiko09 ($100 in chips) 
Seat 3: MGL_Sky99 ($101.62 in chips) 
Seat 5: Spid1 ($131.62 in chips) 
Seat 7: Dachish ($75.96 in chips) 
Seat 8: stonymalony ($58.60 in chips) 
Seat 9: b_____a__242 ($85.69 in chips) 
Dachish: posts small blind $0.50
stonymalony: posts big blind $1
*** HOLE CARDS ***
Dealt to matiko09 [4s 8s]
b_____a__242: folds 
CI58: folds 
matiko09: folds 
MGL_Sky99: folds 
Spid1: folds 
Dachish: raises $2 to $3
stonymalony: calls $2
*** FLOP *** [Js Td 4c]
Dachish: bets $4.04
stonymalony: calls $4.04
*** TURN *** [Js Td 4c] [7d]
Dachish: checks 
stonymalony: checks 
*** RIVER *** [Js Td 4c 7d] [Qc]
Dachish: checks 
stonymalony: bets $8
Dachish: folds 
Uncalled bet ($8) returned to stonymalony
stonymalony collected $13.38 from pot
stonymalony: doesn't show hand 
*** SUMMARY ***
Total pot $14.08 | Rake $0.70 
Board [Js Td 4c 7d Qc]
Seat 1: CI58 folded before Flop (didn't bet)
Seat 2: matiko09 folded before Flop (didn't bet)
Seat 3: MGL_Sky99 folded before Flop (didn't bet)
Seat 5: Spid1 (button) folded before Flop (didn't bet)
Seat 7: Dachish (small blind) folded on the River
Seat 8: stonymalony (big blind) collected ($13.38)
Seat 9: b_____a__242 folded before Flop (didn't bet)





PokerStars Hand #151165196060:  Hold'em No Limit ($0.50/$1.00 USD) - 2016/03/30 16:34:05 CET [2016/03/30 10:34:05 ET]
Table 'Amata II' 9-max Seat #7 is the button
Seat 3: matiko09 ($219.25 in chips) 
Seat 5: Spid1 ($143.22 in chips) 
Seat 6: RamiroAgujis ($103 in chips) 
Seat 7: Pvsx. ($186.51 in chips) 
Seat 8: ka100pka527 ($59.02 in chips) 
ka100pka527: posts small blind $0.50
ilaviiitech: is sitting out 
matiko09: posts big blind $1
*** HOLE CARDS ***
Dealt to matiko09 [Jc Kd]
Spid1: folds 
ilaviiitech leaves the table
RamiroAgujis: raises $2 to $3
Pvsx.: folds 
ka100pka527: folds 
matiko09: folds 
Uncalled bet ($2) returned to RamiroAgujis
RamiroAgujis collected $2.50 from pot
*** SUMMARY ***
Total pot $2.50 | Rake $0 
Seat 3: matiko09 (big blind) folded before Flop
Seat 5: Spid1 folded before Flop (didn't bet)
Seat 6: RamiroAgujis collected ($2.50)
Seat 7: Pvsx. (button) folded before Flop (didn't bet)
Seat 8: ka100pka527 (small blind) folded before Flop





PokerStars Hand #151165198444:  Hold'em No Limit ($0.50/$1.00 USD) - 2016/03/30 16:34:08 CET [2016/03/30 10:34:08 ET]
Table 'Figneria III' 9-max Seat #4 is the button
Seat 1: matiko09 ($100 in chips) 
Seat 2: sanpidk ($109.70 in chips) 
Seat 4: CI58 ($100 in chips) 
Seat 7: holloway85 ($216.57 in chips) 
Seat 9: p.snow89 ($81.80 in chips) 
b_____a__242 will be allowed to play after the button
RICKA16 will be allowed to play after the button
holloway85: posts small blind $0.50
Dachish: is sitting out 
p.snow89: posts big blind $1
*** HOLE CARDS ***
Dealt to matiko09 [Js 7s]
matiko09: folds 
sanpidk: folds 
CI58: folds 
holloway85: calls $0.50
p.snow89: checks 
*** FLOP *** [Qs 6c 8d]
holloway85: checks 
p.snow89: bets $3
holloway85: calls $3
*** TURN *** [Qs 6c 8d] [2h]
holloway85: checks 
p.snow89: bets $4
holloway85: calls $4
*** RIVER *** [Qs 6c 8d 2h] [7h]
holloway85: checks 
p.snow89: bets $7
holloway85: folds 
Uncalled bet ($7) returned to p.snow89
p.snow89 collected $15.20 from pot
p.snow89: doesn't show hand 
*** SUMMARY ***
Total pot $16 | Rake $0.80 
Board [Qs 6c 8d 2h 7h]
Seat 1: matiko09 folded before Flop (didn't bet)
Seat 2: sanpidk folded before Flop (didn't bet)
Seat 4: CI58 (button) folded before Flop (didn't bet)
Seat 7: holloway85 (small blind) folded on the River
Seat 9: p.snow89 (big blind) collected ($15.20)





PokerStars Hand #151165204513:  Hold'em No Limit ($0.50/$1.00 USD) - 2016/03/30 16:34:17 CET [2016/03/30 10:34:17 ET]
Table 'Alcor II' 9-max Seat #9 is the button
Seat 1: Red4erT ($100 in chips) 
Seat 2: holloway85 ($77.34 in chips) 
Seat 3: mitchymitch3 ($111.67 in chips) 
Seat 5: elbiber2000 ($104.70 in chips) 
Seat 6: godfrey004 ($183.25 in chips) 
Seat 7: sanpidk ($102 in chips) 
Seat 8: ka100pka527 ($60.28 in chips) 
Seat 9: matiko09 ($209.05 in chips) 
Red4erT: posts small blind $0.50
holloway85: posts big blind $1
*** HOLE CARDS ***
Dealt to matiko09 [Jd 6c]
mitchymitch3: folds 
elbiber2000: raises $2 to $3
godfrey004: folds 
sanpidk: folds 
ka100pka527: folds 
matiko09: folds 
Red4erT: folds 
holloway85: folds 
Uncalled bet ($2) returned to elbiber2000
elbiber2000 collected $2.50 from pot
elbiber2000: doesn't show hand 
*** SUMMARY ***
Total pot $2.50 | Rake $0 
Seat 1: Red4erT (small blind) folded before Flop
Seat 2: holloway85 (big blind) folded before Flop
Seat 3: mitchymitch3 folded before Flop (didn't bet)
Seat 5: elbiber2000 collected ($2.50)
Seat 6: godfrey004 folded before Flop (didn't bet)
Seat 7: sanpidk folded before Flop (didn't bet)
Seat 8: ka100pka527 folded before Flop (didn't bet)
Seat 9: matiko09 (button) folded before Flop (didn't bet)





PokerStars Hand #151165212453:  Hold'em No Limit ($0.50/$1.00 USD) - 2016/03/30 16:34:29 CET [2016/03/30 10:34:29 ET]
Table 'Amata II' 9-max Seat #8 is the button
Seat 3: matiko09 ($218.25 in chips) 
Seat 6: RamiroAgujis ($104.50 in chips) 
Seat 7: Pvsx. ($186.51 in chips) 
Seat 8: ka100pka527 ($58.52 in chips) 
matiko09: posts small blind $0.50
lumen21 was removed from the table for failing to post
Spid1: is sitting out 
RamiroAgujis: posts big blind $1
*** HOLE CARDS ***
Dealt to matiko09 [9c Ts]
Effort92 joins the table at seat #2 
Spid1 leaves the table
Pvsx.: folds 
ka100pka527: raises $2 to $3
matiko09: folds 
RamiroAgujis: folds 
Uncalled bet ($2) returned to ka100pka527
ka100pka527 collected $2.50 from pot
ka100pka527: doesn't show hand 
*** SUMMARY ***
Total pot $2.50 | Rake $0 
Seat 3: matiko09 (small blind) folded before Flop
Seat 6: RamiroAgujis (big blind) folded before Flop
Seat 7: Pvsx. folded before Flop (didn't bet)
Seat 8: ka100pka527 (button) collected ($2.50)





PokerStars Hand #151165221710:  Hold'em No Limit ($0.50/$1.00 USD) - 2016/03/30 16:34:43 CET [2016/03/30 10:34:43 ET]
Table 'Alcor II' 9-max Seat #1 is the button
Seat 1: Red4erT ($100 in chips) 
Seat 2: holloway85 ($76.34 in chips) 
Seat 3: mitchymitch3 ($111.67 in chips) 
Seat 5: elbiber2000 ($106.20 in chips) 
Seat 6: godfrey004 ($183.25 in chips) 
Seat 7: sanpidk ($102 in chips) 
Seat 8: ka100pka527 ($60.28 in chips) 
Seat 9: matiko09 ($209.05 in chips) 
holloway85: posts small blind $0.50
mitchymitch3: posts big blind $1
*** HOLE CARDS ***
Dealt to matiko09 [Tc 5c]
elbiber2000: folds 
godfrey004: calls $1
sanpidk: folds 
ka100pka527: folds 
matiko09: folds 
Red4erT: raises $2 to $3
holloway85: folds 
mitchymitch3: calls $2
godfrey004: calls $2
*** FLOP *** [Qd 4d Kc]
mitchymitch3: checks 
godfrey004: checks 
Red4erT: bets $5.50
mitchymitch3: calls $5.50
godfrey004: calls $5.50
*** TURN *** [Qd 4d Kc] [6d]
mitchymitch3: checks 
godfrey004: checks 
Red4erT: checks 
*** RIVER *** [Qd 4d Kc 6d] [8c]
mitchymitch3: bets $6
godfrey004: raises $6 to $12
Red4erT: folds 
mitchymitch3: calls $6
*** SHOW DOWN ***
godfrey004: shows [Ad 3d] (a flush, Ace high)
mitchymitch3: mucks hand 
godfrey004 collected $47.50 from pot
*** SUMMARY ***
Total pot $50 | Rake $2.50 
Board [Qd 4d Kc 6d 8c]
Seat 1: Red4erT (button) folded on the River
Seat 2: holloway85 (small blind) folded before Flop
Seat 3: mitchymitch3 (big blind) mucked [9d Kh]
Seat 5: elbiber2000 folded before Flop (didn't bet)
Seat 6: godfrey004 showed [Ad 3d] and won ($47.50) with a flush, Ace high
Seat 7: sanpidk folded before Flop (didn't bet)
Seat 8: ka100pka527 folded before Flop (didn't bet)
Seat 9: matiko09 folded before Flop (didn't bet)





PokerStars Hand #151165222767:  Hold'em No Limit ($1/$2 USD) - 2016/03/30 16:34:44 CET [2016/03/30 10:34:44 ET]
Table 'Aesculapia II' 9-max Seat #5 is the button
Seat 1: buthmen ($238.13 in chips) 
Seat 2: suddend3ath ($338.25 in chips) 
Seat 3: matiko09 ($475.74 in chips) 
Seat 4: tepi_guy ($200 in chips) 
Seat 5: prominente ($200 in chips) 
Seat 7: Rumboni66 ($116.49 in chips) 
Seat 9: InsomniaRU ($213.06 in chips) 
mentalpshyco will be allowed to play after the button
Rumboni66: posts small blind $1
InsomniaRU: posts big blind $2
*** HOLE CARDS ***
Dealt to matiko09 [2c Qc]
buthmen: raises $4 to $6
suddend3ath: folds 
matiko09: folds 
tepi_guy: folds 
prominente: folds 
Rumboni66: folds 
InsomniaRU: folds 
Uncalled bet ($4) returned to buthmen
buthmen collected $5 from pot
buthmen: doesn't show hand 
*** SUMMARY ***
Total pot $5 | Rake $0 
Seat 1: buthmen collected ($5)
Seat 2: suddend3ath folded before Flop (didn't bet)
Seat 3: matiko09 folded before Flop (didn't bet)
Seat 4: tepi_guy folded before Flop (didn't bet)
Seat 5: prominente (button) folded before Flop (didn't bet)
Seat 7: Rumboni66 (small blind) folded before Flop
Seat 9: InsomniaRU (big blind) folded before Flop





PokerStars Hand #151165225812:  Hold'em No Limit ($0.50/$1.00 USD) - 2016/03/30 16:34:49 CET [2016/03/30 10:34:49 ET]
Table 'Amata II' 9-max Seat #3 is the button
Seat 3: matiko09 ($217.75 in chips) 
Seat 6: RamiroAgujis ($103.50 in chips) 
Seat 7: Pvsx. ($186.51 in chips) 
Seat 8: ka100pka527 ($60.02 in chips) 
RamiroAgujis: posts small blind $0.50
Pvsx.: posts big blind $1
Effort92: sits out 
*** HOLE CARDS ***
Dealt to matiko09 [Ad Ac]
ka100pka527: folds 
ka100pka527 leaves the table
di0d80 joins the table at seat #8 
matiko09: raises $1.27 to $2.27
di0d80 leaves the table
RamiroAgujis: folds 
Sloeve joins the table at seat #8 
azzad2007 joins the table at seat #4 
Pvsx.: folds 
Uncalled bet ($1.27) returned to matiko09
matiko09 collected $2.50 from pot
matiko09: doesn't show hand 
*** SUMMARY ***
Total pot $2.50 | Rake $0 
Seat 3: matiko09 (button) collected ($2.50)
Seat 6: RamiroAgujis (small blind) folded before Flop
Seat 7: Pvsx. (big blind) folded before Flop
Seat 8: ka100pka527 folded before Flop (didn't bet)





PokerStars Hand #151165230318:  Hold'em No Limit ($1/$2 USD) - 2016/03/30 16:34:56 CET [2016/03/30 10:34:56 ET]
Table 'Jole' 9-max Seat #7 is the button
Seat 1: matiko09 ($328.50 in chips) 
Seat 2: RamiroAgujis ($275.76 in chips) 
Seat 3: prominente ($215.58 in chips) 
Seat 6: King_ZéManel ($200 in chips) 
Seat 7: ilaviiitech ($262.18 in chips) 
Seat 9: Ravnica11 ($92.65 in chips) 
Ravnica11: posts small blind $1
matiko09: posts big blind $2
tepi_guy: sits out 
mentalpshyco: sits out 
*** HOLE CARDS ***
Dealt to matiko09 [7s 6s]
RamiroAgujis: folds 
prominente: folds 
King_ZéManel: raises $4 to $6
ilaviiitech: folds 
Ravnica11: folds 
matiko09: folds 
Uncalled bet ($4) returned to King_ZéManel
King_ZéManel collected $5 from pot
King_ZéManel: doesn't show hand 
*** SUMMARY ***
Total pot $5 | Rake $0 
Seat 1: matiko09 (big blind) folded before Flop
Seat 2: RamiroAgujis folded before Flop (didn't bet)
Seat 3: prominente folded before Flop (didn't bet)
Seat 6: King_ZéManel collected ($5)
Seat 7: ilaviiitech (button) folded before Flop (didn't bet)
Seat 9: Ravnica11 (small blind) folded before Flop





PokerStars Hand #151165233118:  Hold'em No Limit ($1/$2 USD) - 2016/03/30 16:35:00 CET [2016/03/30 10:35:00 ET]
Table 'Hektor III' 9-max Seat #8 is the button
Seat 1: matiko09 ($200 in chips) 
Seat 2: RamiroAgujis ($302.45 in chips) 
Seat 3: T0ny Adams ($87.43 in chips) 
Seat 4: volwebni4ek ($80 in chips) 
Seat 5: prominente ($343.22 in chips) 
Seat 7: InsomniaRU ($214.04 in chips) 
Seat 8: tepi_guy ($200 in chips) 
Seat 9: fonng ($312.24 in chips) 
fonng: posts small blind $1
matiko09: posts big blind $2
*** HOLE CARDS ***
Dealt to matiko09 [4c 9s]
RamiroAgujis: folds 
T0ny Adams: folds 
volwebni4ek: folds 
prominente: raises $3 to $5
InsomniaRU: folds 
tepi_guy: calls $5
fonng: raises $11 to $16
matiko09: folds 
prominente: raises $16 to $32
tepi_guy: folds 
fonng: calls $16
*** FLOP *** [Ad Jd Qc]
fonng: bets $68
prominente: raises $68 to $136
fonng: raises $144.24 to $280.24 and is all-in
prominente: calls $144.24
*** TURN *** [Ad Jd Qc] [4s]
*** RIVER *** [Ad Jd Qc 4s] [Kc]
*** SHOW DOWN ***
fonng: shows [As Kd] (two pair, Aces and Kings)
prominente: shows [Js Ac] (two pair, Aces and Jacks)
fonng collected $628.73 from pot
*** SUMMARY ***
Total pot $631.48 | Rake $2.75 
Board [Ad Jd Qc 4s Kc]
Seat 1: matiko09 (big blind) folded before Flop
Seat 2: RamiroAgujis folded before Flop (didn't bet)
Seat 3: T0ny Adams folded before Flop (didn't bet)
Seat 4: volwebni4ek folded before Flop (didn't bet)
Seat 5: prominente showed [Js Ac] and lost with two pair, Aces and Jacks
Seat 7: InsomniaRU folded before Flop (didn't bet)
Seat 8: tepi_guy (button) folded before Flop
Seat 9: fonng (small blind) showed [As Kd] and won ($628.73) with two pair, Aces and Kings





PokerStars Hand #151165235383:  Hold'em No Limit ($0.50/$1.00 USD) - 2016/03/30 16:35:03 CET [2016/03/30 10:35:03 ET]
Table 'Hadwiger' 9-max Seat #7 is the button
Seat 1: AKplus ($100 in chips) 
Seat 2: Sloeve ($100 in chips) 
Seat 3: sanpidk ($100 in chips) 
Seat 4: Westpants ($100 in chips) 
Seat 5: tipner ($100 in chips) 
Seat 6: Spid1 ($100 in chips) 
Seat 7: matiko09 ($100 in chips) 
Seat 8: di0d80 ($100 in chips) 
Seat 9: IdiotFromNE ($100 in chips) 
di0d80: posts small blind $0.50
IdiotFromNE: posts big blind $1
*** HOLE CARDS ***
Dealt to matiko09 [8s 7d]
AKplus: folds 
Sloeve: folds 
Sloeve leaves the table
sanpidk: raises $2 to $3
Westpants: folds 
tipner: folds 
Spid1: folds 
matiko09: folds 
di0d80: folds 
IdiotFromNE: folds 
Uncalled bet ($2) returned to sanpidk
sanpidk collected $2.50 from pot
sanpidk: doesn't show hand 
*** SUMMARY ***
Total pot $2.50 | Rake $0 
Seat 1: AKplus folded before Flop (didn't bet)
Seat 2: Sloeve folded before Flop (didn't bet)
Seat 3: sanpidk collected ($2.50)
Seat 4: Westpants folded before Flop (didn't bet)
Seat 5: tipner folded before Flop (didn't bet)
Seat 6: Spid1 folded before Flop (didn't bet)
Seat 7: matiko09 (button) folded before Flop (didn't bet)
Seat 8: di0d80 (small blind) folded before Flop
Seat 9: IdiotFromNE (big blind) folded before Flop





PokerStars Hand #151165240088:  Hold'em No Limit ($0.50/$1.00 USD) - 2016/03/30 16:35:10 CET [2016/03/30 10:35:10 ET]
Table 'Amata II' 9-max Seat #6 is the button
Seat 3: matiko09 ($219.25 in chips) 
Seat 6: RamiroAgujis ($103 in chips) 
Seat 7: Pvsx. ($185.51 in chips) 
Seat 8: Sloeve ($100 in chips) 
Pvsx.: posts small blind $0.50
Sloeve: posts big blind $1
Effort92: sits out 
azzad2007: sits out 
*** HOLE CARDS ***
Dealt to matiko09 [4h 9s]
matiko09: folds 
RamiroAgujis: raises $1.50 to $2.50
Pvsx.: raises $6.50 to $9
Sloeve: folds 
RamiroAgujis: folds 
Uncalled bet ($6.50) returned to Pvsx.
Pvsx. collected $6 from pot
Pvsx.: doesn't show hand 
*** SUMMARY ***
Total pot $6 | Rake $0 
Seat 3: matiko09 folded before Flop (didn't bet)
Seat 6: RamiroAgujis (button) folded before Flop
Seat 7: Pvsx. (small blind) collected ($6)
Seat 8: Sloeve (big blind) folded before Flop





PokerStars Hand #151165240675:  Hold'em No Limit ($0.50/$1.00 USD) - 2016/03/30 16:35:11 CET [2016/03/30 10:35:11 ET]
Table 'Pannonia II' 9-max Seat #7 is the button
Seat 1: CI58 ($100 in chips) 
Seat 2: matiko09 ($100 in chips) 
Seat 3: MGL_Sky99 ($101.62 in chips) 
Seat 5: Spid1 ($131.62 in chips) 
Seat 7: Dachish ($68.92 in chips) 
Seat 8: stonymalony ($64.94 in chips) 
Seat 9: b_____a__242 ($85.69 in chips) 
stonymalony: posts small blind $0.50
b_____a__242: posts big blind $1
*** HOLE CARDS ***
Dealt to matiko09 [Qh 7c]
CI58: raises $2 to $3
matiko09: folds 
MGL_Sky99: calls $3
Spid1: folds 
Dachish: folds 
stonymalony: folds 
b_____a__242: folds 
*** FLOP *** [Jc Tc 7d]
CI58: bets $4.27
MGL_Sky99: folds 
Uncalled bet ($4.27) returned to CI58
CI58 collected $7.12 from pot
CI58: doesn't show hand 
*** SUMMARY ***
Total pot $7.50 | Rake $0.38 
Board [Jc Tc 7d]
Seat 1: CI58 collected ($7.12)
Seat 2: matiko09 folded before Flop (didn't bet)
Seat 3: MGL_Sky99 folded on the Flop
Seat 5: Spid1 folded before Flop (didn't bet)
Seat 7: Dachish (button) folded before Flop (didn't bet)
Seat 8: stonymalony (small blind) folded before Flop
Seat 9: b_____a__242 (big blind) folded before Flop





PokerStars Hand #151165244171:  Hold'em No Limit ($0.50/$1.00 USD) - 2016/03/30 16:35:16 CET [2016/03/30 10:35:16 ET]
Table 'Figneria III' 9-max Seat #7 is the button
Seat 1: matiko09 ($100 in chips) 
Seat 2: sanpidk ($109.70 in chips) 
Seat 4: CI58 ($100 in chips) 
Seat 7: holloway85 ($208.57 in chips) 
Seat 9: p.snow89 ($89 in chips) 
p.snow89: posts small blind $0.50
matiko09: posts big blind $1
b_____a__242: sits out 
RICKA16: sits out 
*** HOLE CARDS ***
Dealt to matiko09 [9h Td]
sanpidk: folds 
CI58: raises $2 to $3
holloway85: folds 
p.snow89: calls $2.50
matiko09: folds 
*** FLOP *** [2c 4s 8d]
p.snow89: bets $4
CI58: raises $8 to $12
p.snow89: calls $8
*** TURN *** [2c 4s 8d] [Ah]
p.snow89: checks 
CI58: checks 
*** RIVER *** [2c 4s 8d Ah] [Ac]
p.snow89: checks 
CI58: bets $12
p.snow89: folds 
Uncalled bet ($12) returned to CI58
CI58 collected $29.45 from pot
CI58: doesn't show hand 
*** SUMMARY ***
Total pot $31 | Rake $1.55 
Board [2c 4s 8d Ah Ac]
Seat 1: matiko09 (big blind) folded before Flop
Seat 2: sanpidk folded before Flop (didn't bet)
Seat 4: CI58 collected ($29.45)
Seat 7: holloway85 (button) folded before Flop (didn't bet)
Seat 9: p.snow89 (small blind) folded on the River





PokerStars Hand #151165245657:  Hold'em No Limit ($1/$2 USD) - 2016/03/30 16:35:18 CET [2016/03/30 10:35:18 ET]
Table 'Jole' 9-max Seat #9 is the button
Seat 1: matiko09 ($326.50 in chips) 
Seat 2: RamiroAgujis ($275.76 in chips) 
Seat 3: prominente ($215.58 in chips) 
Seat 6: King_ZéManel ($203 in chips) 
Seat 7: ilaviiitech ($262.18 in chips) 
Seat 9: Ravnica11 ($91.65 in chips) 
matiko09: posts small blind $1
RamiroAgujis: posts big blind $2
tepi_guy: sits out 
mentalpshyco: sits out 
*** HOLE CARDS ***
Dealt to matiko09 [6d Tc]
prominente: raises $3 to $5
King_ZéManel: folds 
ilaviiitech: folds 
Ravnica11: folds 
matiko09: folds 
RamiroAgujis: folds 
Uncalled bet ($3) returned to prominente
prominente collected $5 from pot
prominente: doesn't show hand 
*** SUMMARY ***
Total pot $5 | Rake $0 
Seat 1: matiko09 (small blind) folded before Flop
Seat 2: RamiroAgujis (big blind) folded before Flop
Seat 3: prominente collected ($5)
Seat 6: King_ZéManel folded before Flop (didn't bet)
Seat 7: ilaviiitech folded before Flop (didn't bet)
Seat 9: Ravnica11 (button) folded before Flop (didn't bet)





PokerStars Hand #151165248445:  Hold'em No Limit ($1/$2 USD) - 2016/03/30 16:35:22 CET [2016/03/30 10:35:22 ET]
Table 'Philoctetes II' 9-max Seat #8 is the button
Seat 1: vezunchik79 ($151.38 in chips) 
Seat 2: prominente ($226.91 in chips) 
Seat 3: mentalpshyco ($214.55 in chips) 
Seat 4: tepi_guy ($200 in chips) 
Seat 5: zhaimeng ($348.51 in chips) 
Seat 7: matiko09 ($206.20 in chips) 
Seat 8: suddend3ath ($200 in chips) 
Seat 9: RamiroAgujis ($238.30 in chips) 
RamiroAgujis: posts small blind $1
vezunchik79: posts big blind $2
*** HOLE CARDS ***
Dealt to matiko09 [9d Js]
prominente: folds 
mentalpshyco has timed out
mentalpshyco: folds 
tepi_guy: folds 
zhaimeng: raises $2 to $4
matiko09: folds 
suddend3ath: raises $12 to $16
RamiroAgujis: folds 
vezunchik79: folds 
zhaimeng: folds 
Uncalled bet ($12) returned to suddend3ath
suddend3ath collected $11 from pot
suddend3ath: doesn't show hand 
*** SUMMARY ***
Total pot $11 | Rake $0 
Seat 1: vezunchik79 (big blind) folded before Flop
Seat 2: prominente folded before Flop (didn't bet)
Seat 3: mentalpshyco folded before Flop (didn't bet)
Seat 4: tepi_guy folded before Flop (didn't bet)
Seat 5: zhaimeng folded before Flop
Seat 7: matiko09 folded before Flop (didn't bet)
Seat 8: suddend3ath (button) collected ($11)
Seat 9: RamiroAgujis (small blind) folded before Flop





PokerStars Hand #151165255015:  Hold'em No Limit ($1/$2 USD) - 2016/03/30 16:35:32 CET [2016/03/30 10:35:32 ET]
Table 'Aesculapia II' 9-max Seat #7 is the button
Seat 1: buthmen ($241.13 in chips) 
Seat 2: suddend3ath ($338.25 in chips) 
Seat 3: matiko09 ($475.74 in chips) 
Seat 4: tepi_guy ($200 in chips) 
Seat 5: prominente ($200 in chips) 
Seat 7: Rumboni66 ($115.49 in chips) 
Seat 9: InsomniaRU ($211.06 in chips) 
InsomniaRU: posts small blind $1
buthmen: posts big blind $2
mentalpshyco: sits out 
*** HOLE CARDS ***
Dealt to matiko09 [Ts 2c]
suddend3ath: folds 
matiko09: folds 
tepi_guy: raises $3.40 to $5.40
prominente: folds 
Rumboni66: folds 
InsomniaRU: folds 
buthmen: calls $3.40
*** FLOP *** [2d 6s 6c]
buthmen: bets $2
tepi_guy: raises $9.16 to $11.16
buthmen: folds 
Uncalled bet ($9.16) returned to tepi_guy
tepi_guy collected $15.01 from pot
tepi_guy: doesn't show hand 
*** SUMMARY ***
Total pot $15.80 | Rake $0.79 
Board [2d 6s 6c]
Seat 1: buthmen (big blind) folded on the Flop
Seat 2: suddend3ath folded before Flop (didn't bet)
Seat 3: matiko09 folded before Flop (didn't bet)
Seat 4: tepi_guy collected ($15.01)
Seat 5: prominente folded before Flop (didn't bet)
Seat 7: Rumboni66 (button) folded before Flop (didn't bet)
Seat 9: InsomniaRU (small blind) folded before Flop





PokerStars Hand #151165266865:  Hold'em No Limit ($1/$2 USD) - 2016/03/30 16:35:49 CET [2016/03/30 10:35:49 ET]
Table 'Jole' 9-max Seat #1 is the button
Seat 1: matiko09 ($325.50 in chips) 
Seat 2: RamiroAgujis ($273.76 in chips) 
Seat 4: tepi_guy ($200 in chips) 
Seat 6: King_ZéManel ($203 in chips) 
Seat 7: ilaviiitech ($262.18 in chips) 
Seat 9: Ravnica11 ($91.65 in chips) 
RamiroAgujis: posts small blind $1
prominente: is sitting out 
tepi_guy: posts big blind $2
mentalpshyco: sits out 
*** HOLE CARDS ***
Dealt to matiko09 [Qs Jh]
prominente leaves the table
King_ZéManel: folds 
ilaviiitech: folds 
Dykallis joins the table at seat #3 
Ravnica11: raises $2.40 to $4.40
Dykallis leaves the table
matiko09: folds 
RamiroAgujis: folds 
tepi_guy: raises $8.80 to $13.20
Ravnica11: folds 
Uncalled bet ($8.80) returned to tepi_guy
tepi_guy collected $9.80 from pot
tepi_guy: doesn't show hand 
*** SUMMARY ***
Total pot $9.80 | Rake $0 
Seat 1: matiko09 (button) folded before Flop (didn't bet)
Seat 2: RamiroAgujis (small blind) folded before Flop
Seat 4: tepi_guy (big blind) collected ($9.80)
Seat 6: King_ZéManel folded before Flop (didn't bet)
Seat 7: ilaviiitech folded before Flop (didn't bet)
Seat 9: Ravnica11 folded before Flop





PokerStars Hand #151165268522:  Hold'em No Limit ($0.50/$1.00 USD) - 2016/03/30 16:35:52 CET [2016/03/30 10:35:52 ET]
Table 'Pannonia II' 9-max Seat #8 is the button
Seat 1: CI58 ($104.12 in chips) 
Seat 2: matiko09 ($100 in chips) 
Seat 3: MGL_Sky99 ($98.62 in chips) 
Seat 5: Spid1 ($131.62 in chips) 
Seat 7: Dachish ($68.92 in chips) 
Seat 8: stonymalony ($64.44 in chips) 
Seat 9: b_____a__242 ($84.69 in chips) 
b_____a__242: posts small blind $0.50
CI58: posts big blind $1
*** HOLE CARDS ***
Dealt to matiko09 [2h 5h]
matiko09: folds 
MGL_Sky99: folds 
Spid1: folds 
Dachish: folds 
stonymalony: raises $2 to $3
b_____a__242: folds 
CI58: folds 
Uncalled bet ($2) returned to stonymalony
stonymalony collected $2.50 from pot
stonymalony: doesn't show hand 
*** SUMMARY ***
Total pot $2.50 | Rake $0 
Seat 1: CI58 (big blind) folded before Flop
Seat 2: matiko09 folded before Flop (didn't bet)
Seat 3: MGL_Sky99 folded before Flop (didn't bet)
Seat 5: Spid1 folded before Flop (didn't bet)
Seat 7: Dachish folded before Flop (didn't bet)
Seat 8: stonymalony (button) collected ($2.50)
Seat 9: b_____a__242 (small blind) folded before Flop





PokerStars Hand #151165280765:  Hold'em No Limit ($1/$2 USD) - 2016/03/30 16:36:10 CET [2016/03/30 10:36:10 ET]
Table 'Aesculapia II' 9-max Seat #9 is the button
Seat 1: buthmen ($233.73 in chips) 
Seat 2: suddend3ath ($338.25 in chips) 
Seat 3: matiko09 ($475.74 in chips) 
Seat 4: tepi_guy ($207.61 in chips) 
Seat 5: prominente ($200 in chips) 
Seat 7: Rumboni66 ($115.49 in chips) 
Seat 9: InsomniaRU ($210.06 in chips) 
buthmen: posts small blind $1
suddend3ath: posts big blind $2
mentalpshyco: sits out 
*** HOLE CARDS ***
Dealt to matiko09 [2c Jc]
matiko09: folds 
tepi_guy: folds 
prominente: folds 
Rumboni66: folds 
InsomniaRU: raises $3 to $5
buthmen: calls $4
suddend3ath: folds 
*** FLOP *** [9d 3h 4h]
buthmen: checks 
InsomniaRU: checks 
*** TURN *** [9d 3h 4h] [4c]
buthmen: bets $5.70
InsomniaRU: folds 
Uncalled bet ($5.70) returned to buthmen
buthmen collected $11.40 from pot
buthmen: doesn't show hand 
*** SUMMARY ***
Total pot $12 | Rake $0.60 
Board [9d 3h 4h 4c]
Seat 1: buthmen (small blind) collected ($11.40)
Seat 2: suddend3ath (big blind) folded before Flop
Seat 3: matiko09 folded before Flop (didn't bet)
Seat 4: tepi_guy folded before Flop (didn't bet)
Seat 5: prominente folded before Flop (didn't bet)
Seat 7: Rumboni66 folded before Flop (didn't bet)
Seat 9: InsomniaRU (button) folded on the Turn





PokerStars Hand #151165284956:  Hold'em No Limit ($0.50/$1.00 USD) - 2016/03/30 16:36:16 CET [2016/03/30 10:36:16 ET]
Table 'Pannonia II' 9-max Seat #9 is the button
Seat 1: CI58 ($103.12 in chips) 
Seat 2: matiko09 ($100 in chips) 
Seat 3: MGL_Sky99 ($98.62 in chips) 
Seat 5: Spid1 ($131.62 in chips) 
Seat 7: Dachish ($68.92 in chips) 
Seat 8: stonymalony ($65.94 in chips) 
Seat 9: b_____a__242 ($84.19 in chips) 
CI58: posts small blind $0.50
matiko09: posts big blind $1
*** HOLE CARDS ***
Dealt to matiko09 [3s 4s]
MGL_Sky99: raises $2 to $3
Spid1: folds 
Dachish: folds 
stonymalony: folds 
b_____a__242: folds 
CI58: folds 
matiko09: folds 
Uncalled bet ($2) returned to MGL_Sky99
MGL_Sky99 collected $2.50 from pot
MGL_Sky99: doesn't show hand 
*** SUMMARY ***
Total pot $2.50 | Rake $0 
Seat 1: CI58 (small blind) folded before Flop
Seat 2: matiko09 (big blind) folded before Flop
Seat 3: MGL_Sky99 collected ($2.50)
Seat 5: Spid1 folded before Flop (didn't bet)
Seat 7: Dachish folded before Flop (didn't bet)
Seat 8: stonymalony folded before Flop (didn't bet)
Seat 9: b_____a__242 (button) folded before Flop (didn't bet)





PokerStars Hand #151165290283:  Hold'em No Limit ($0.50/$1.00 USD) - 2016/03/30 16:36:24 CET [2016/03/30 10:36:24 ET]
Table 'Figneria III' 9-max Seat #9 is the button
Seat 1: matiko09 ($100 in chips) 
Seat 2: sanpidk ($109.70 in chips) 
Seat 4: CI58 ($114.45 in chips) 
Seat 7: holloway85 ($208.57 in chips) 
Seat 9: p.snow89 ($74 in chips) 
matiko09: posts small blind $0.50
sanpidk: posts big blind $1
b_____a__242: sits out 
RICKA16: sits out 
*** HOLE CARDS ***
Dealt to matiko09 [Ts 2h]
CI58: folds 
holloway85: folds 
p.snow89: folds 
matiko09: folds 
Uncalled bet ($0.50) returned to sanpidk
sanpidk collected $1 from pot
sanpidk: doesn't show hand 
*** SUMMARY ***
Total pot $1 | Rake $0 
Seat 1: matiko09 (small blind) folded before Flop
Seat 2: sanpidk (big blind) collected ($1)
Seat 4: CI58 folded before Flop (didn't bet)
Seat 7: holloway85 folded before Flop (didn't bet)
Seat 9: p.snow89 (button) folded before Flop (didn't bet)





PokerStars Hand #151165290473:  Hold'em No Limit ($1/$2 USD) - 2016/03/30 16:36:24 CET [2016/03/30 10:36:24 ET]
Table 'Jole' 9-max Seat #2 is the button
Seat 1: matiko09 ($325.50 in chips) 
Seat 2: RamiroAgujis ($272.76 in chips) 
Seat 4: tepi_guy ($205.40 in chips) 
Seat 5: mentalpshyco ($200 in chips) 
Seat 6: King_ZéManel ($203 in chips) 
Seat 7: ilaviiitech ($262.18 in chips) 
Seat 9: Ravnica11 ($87.25 in chips) 
tepi_guy: posts small blind $1
mentalpshyco: posts big blind $2
*** HOLE CARDS ***
Dealt to matiko09 [5s 3d]
King_ZéManel: folds 
ilaviiitech: folds 
Ravnica11: raises $2.40 to $4.40
matiko09: folds 
RamiroAgujis: folds 
tepi_guy: folds 
mentalpshyco: folds 
Uncalled bet ($2.40) returned to Ravnica11
Ravnica11 collected $5 from pot
*** SUMMARY ***
Total pot $5 | Rake $0 
Seat 1: matiko09 folded before Flop (didn't bet)
Seat 2: RamiroAgujis (button) folded before Flop (didn't bet)
Seat 4: tepi_guy (small blind) folded before Flop
Seat 5: mentalpshyco (big blind) folded before Flop
Seat 6: King_ZéManel folded before Flop (didn't bet)
Seat 7: ilaviiitech folded before Flop (didn't bet)
Seat 9: Ravnica11 collected ($5)





PokerStars Hand #151165300789:  Hold'em No Limit ($1/$2 USD) - 2016/03/30 16:36:39 CET [2016/03/30 10:36:39 ET]
Table 'Hektor III' 9-max Seat #9 is the button
Seat 1: matiko09 ($200 in chips) 
Seat 2: RamiroAgujis ($302.45 in chips) 
Seat 3: T0ny Adams ($87.43 in chips) 
Seat 4: volwebni4ek ($80 in chips) 
Seat 5: prominente ($200 in chips) 
Seat 7: InsomniaRU ($214.04 in chips) 
Seat 8: tepi_guy ($200 in chips) 
Seat 9: fonng ($628.73 in chips) 
matiko09: posts small blind $1
RamiroAgujis: posts big blind $2
*** HOLE CARDS ***
Dealt to matiko09 [Tc 7s]
T0ny Adams: folds 
volwebni4ek: folds 
prominente: folds 
InsomniaRU: folds 
tepi_guy: raises $3.40 to $5.40
fonng: calls $5.40
matiko09: folds 
RamiroAgujis: folds 
*** FLOP *** [6h Qs Qh]
tepi_guy: checks 
fonng: checks 
*** TURN *** [6h Qs Qh] [Jc]
tepi_guy: checks 
fonng: checks 
*** RIVER *** [6h Qs Qh Jc] [9s]
tepi_guy: bets $13.48
fonng: folds 
Uncalled bet ($13.48) returned to tepi_guy
tepi_guy collected $13.11 from pot
tepi_guy: doesn't show hand 
*** SUMMARY ***
Total pot $13.80 | Rake $0.69 
Board [6h Qs Qh Jc 9s]
Seat 1: matiko09 (small blind) folded before Flop
Seat 2: RamiroAgujis (big blind) folded before Flop
Seat 3: T0ny Adams folded before Flop (didn't bet)
Seat 4: volwebni4ek folded before Flop (didn't bet)
Seat 5: prominente folded before Flop (didn't bet)
Seat 7: InsomniaRU folded before Flop (didn't bet)
Seat 8: tepi_guy collected ($13.11)
Seat 9: fonng (button) folded on the River





PokerStars Hand #151165301354:  Hold'em No Limit ($0.50/$1.00 USD) - 2016/03/30 16:36:40 CET [2016/03/30 10:36:40 ET]
Table 'Pannonia II' 9-max Seat #1 is the button
Seat 1: CI58 ($102.62 in chips) 
Seat 2: matiko09 ($100 in chips) 
Seat 3: MGL_Sky99 ($100.12 in chips) 
Seat 5: Spid1 ($131.62 in chips) 
Seat 8: stonymalony ($65.94 in chips) 
Seat 9: b_____a__242 ($84.19 in chips) 
matiko09: posts small blind $0.50
MGL_Sky99: posts big blind $1
*** HOLE CARDS ***
Dealt to matiko09 [3h As]
Spid1: folds 
stonymalony: raises $1 to $2
b_____a__242: folds 
CI58: folds 
matiko09: folds 
MGL_Sky99: calls $1
*** FLOP *** [2d 5h 8h]
MGL_Sky99: checks 
stonymalony: checks 
*** TURN *** [2d 5h 8h] [Th]
MGL_Sky99: bets $3.14
stonymalony: calls $3.14
*** RIVER *** [2d 5h 8h Th] [3s]
MGL_Sky99: bets $7.12
stonymalony: folds 
Uncalled bet ($7.12) returned to MGL_Sky99
MGL_Sky99 collected $10.24 from pot
MGL_Sky99: doesn't show hand 
*** SUMMARY ***
Total pot $10.78 | Rake $0.54 
Board [2d 5h 8h Th 3s]
Seat 1: CI58 (button) folded before Flop (didn't bet)
Seat 2: matiko09 (small blind) folded before Flop
Seat 3: MGL_Sky99 (big blind) collected ($10.24)
Seat 5: Spid1 folded before Flop (didn't bet)
Seat 8: stonymalony folded on the River
Seat 9: b_____a__242 folded before Flop (didn't bet)





PokerStars Hand #151165303316:  Hold'em No Limit ($0.50/$1.00 USD) - 2016/03/30 16:36:43 CET [2016/03/30 10:36:43 ET]
Table 'Figneria III' 9-max Seat #1 is the button
Seat 1: matiko09 ($100 in chips) 
Seat 2: sanpidk ($110.20 in chips) 
Seat 4: CI58 ($114.45 in chips) 
Seat 7: holloway85 ($208.57 in chips) 
Seat 9: p.snow89 ($74 in chips) 
sanpidk: posts small blind $0.50
CI58: posts big blind $1
b_____a__242: sits out 
RICKA16: sits out 
*** HOLE CARDS ***
Dealt to matiko09 [4d 3d]
holloway85: folds 
p.snow89: raises $2 to $3
matiko09: folds 
sanpidk: folds 
CI58: folds 
Uncalled bet ($2) returned to p.snow89
p.snow89 collected $2.50 from pot
p.snow89: doesn't show hand 
*** SUMMARY ***
Total pot $2.50 | Rake $0 
Seat 1: matiko09 (button) folded before Flop (didn't bet)
Seat 2: sanpidk (small blind) folded before Flop
Seat 4: CI58 (big blind) folded before Flop
Seat 7: holloway85 folded before Flop (didn't bet)
Seat 9: p.snow89 collected ($2.50)





PokerStars Hand #151165304894:  Hold'em No Limit ($0.50/$1.00 USD) - 2016/03/30 16:36:45 CET [2016/03/30 10:36:45 ET]
Table 'Hadwiger' 9-max Seat #8 is the button
Seat 1: AKplus ($100 in chips) 
Seat 3: sanpidk ($101.50 in chips) 
Seat 4: Westpants ($100 in chips) 
Seat 5: tipner ($100 in chips) 
Seat 6: Spid1 ($100 in chips) 
Seat 7: matiko09 ($100 in chips) 
Seat 8: di0d80 ($100 in chips) 
Seat 9: IdiotFromNE ($100 in chips) 
IdiotFromNE: posts small blind $0.50
AKplus: posts big blind $1
*** HOLE CARDS ***
Dealt to matiko09 [3s Qs]
sanpidk: folds 
Westpants: folds 
tipner: folds 
Spid1: folds 
matiko09: folds 
di0d80: raises $1 to $2
IdiotFromNE: folds 
AKplus: folds 
Uncalled bet ($1) returned to di0d80
di0d80 collected $2.50 from pot
di0d80: doesn't show hand 
*** SUMMARY ***
Total pot $2.50 | Rake $0 
Seat 1: AKplus (big blind) folded before Flop
Seat 3: sanpidk folded before Flop (didn't bet)
Seat 4: Westpants folded before Flop (didn't bet)
Seat 5: tipner folded before Flop (didn't bet)
Seat 6: Spid1 folded before Flop (didn't bet)
Seat 7: matiko09 folded before Flop (didn't bet)
Seat 8: di0d80 (button) collected ($2.50)
Seat 9: IdiotFromNE (small blind) folded before Flop





PokerStars Hand #151165309739:  Hold'em No Limit ($1/$2 USD) - 2016/03/30 16:36:52 CET [2016/03/30 10:36:52 ET]
Table 'Philoctetes II' 9-max Seat #9 is the button
Seat 1: vezunchik79 ($149.38 in chips) 
Seat 2: prominente ($226.91 in chips) 
Seat 3: mentalpshyco ($214.55 in chips) 
Seat 4: tepi_guy ($200 in chips) 
Seat 5: zhaimeng ($344.51 in chips) 
Seat 7: matiko09 ($206.20 in chips) 
Seat 8: suddend3ath ($207 in chips) 
Seat 9: RamiroAgujis ($237.30 in chips) 
vezunchik79: posts small blind $1
prominente: posts big blind $2
*** HOLE CARDS ***
Dealt to matiko09 [3d 3s]
mentalpshyco: folds 
tepi_guy: folds 
zhaimeng: folds 
matiko09: raises $3 to $5
suddend3ath: folds 
RamiroAgujis: folds 
vezunchik79: folds 
prominente: folds 
Uncalled bet ($3) returned to matiko09
matiko09 collected $5 from pot
matiko09: doesn't show hand 
*** SUMMARY ***
Total pot $5 | Rake $0 
Seat 1: vezunchik79 (small blind) folded before Flop
Seat 2: prominente (big blind) folded before Flop
Seat 3: mentalpshyco folded before Flop (didn't bet)
Seat 4: tepi_guy folded before Flop (didn't bet)
Seat 5: zhaimeng folded before Flop (didn't bet)
Seat 7: matiko09 collected ($5)
Seat 8: suddend3ath folded before Flop (didn't bet)
Seat 9: RamiroAgujis (button) folded before Flop (didn't bet)





PokerStars Hand #151165309443:  Hold'em No Limit ($1/$2 USD) - 2016/03/30 16:36:52 CET [2016/03/30 10:36:52 ET]
Table 'Aesculapia II' 9-max Seat #1 is the button
Seat 1: buthmen ($240.13 in chips) 
Seat 2: suddend3ath ($336.25 in chips) 
Seat 3: matiko09 ($475.74 in chips) 
Seat 4: tepi_guy ($207.61 in chips) 
Seat 5: prominente ($200 in chips) 
Seat 7: Rumboni66 ($115.49 in chips) 
Seat 9: InsomniaRU ($205.06 in chips) 
suddend3ath: posts small blind $1
matiko09: posts big blind $2
mentalpshyco: sits out 
*** HOLE CARDS ***
Dealt to matiko09 [5s 9s]
tepi_guy: folds 
prominente: raises $3 to $5
Rumboni66: folds 
InsomniaRU: folds 
buthmen: calls $5
suddend3ath: folds 
matiko09: folds 
*** FLOP *** [4c 9h 2h]
prominente: bets $9
buthmen: calls $9
*** TURN *** [4c 9h 2h] [Tc]
prominente: bets $20
buthmen: calls $20
*** RIVER *** [4c 9h 2h Tc] [Th]
prominente: checks 
buthmen: bets $34.12
prominente: calls $34.12
*** SHOW DOWN ***
buthmen: shows [4h 5h] (a flush, Ten high)
prominente: mucks hand 
buthmen collected $136.49 from pot
*** SUMMARY ***
Total pot $139.24 | Rake $2.75 
Board [4c 9h 2h Tc Th]
Seat 1: buthmen (button) showed [4h 5h] and won ($136.49) with a flush, Ten high
Seat 2: suddend3ath (small blind) folded before Flop
Seat 3: matiko09 (big blind) folded before Flop
Seat 4: tepi_guy folded before Flop (didn't bet)
Seat 5: prominente mucked [Ac Ad]
Seat 7: Rumboni66 folded before Flop (didn't bet)
Seat 9: InsomniaRU folded before Flop (didn't bet)





PokerStars Hand #151165310030:  Hold'em No Limit ($0.50/$1.00 USD) - 2016/03/30 16:36:53 CET [2016/03/30 10:36:53 ET]
Table 'Alcor II' 9-max Seat #2 is the button
Seat 1: Red4erT ($100 in chips) 
Seat 2: holloway85 ($75.84 in chips) 
Seat 3: mitchymitch3 ($91.17 in chips) 
Seat 5: elbiber2000 ($106.20 in chips) 
Seat 6: godfrey004 ($210.25 in chips) 
Seat 7: sanpidk ($102 in chips) 
Seat 8: ka100pka527 ($60.28 in chips) 
Seat 9: matiko09 ($209.05 in chips) 
mitchymitch3: posts small blind $0.50
e306 was removed from the table for failing to post
elbiber2000: posts big blind $1
*** HOLE CARDS ***
Dealt to matiko09 [Kh Qh]
godfrey004: folds 
Effort92 joins the table at seat #4 
sanpidk: folds 
ka100pka527: folds 
matiko09: raises $2 to $3
Red4erT: folds 
holloway85: folds 
mitchymitch3: raises $6 to $9
elbiber2000: folds 
matiko09: calls $6
*** FLOP *** [6s 4c Td]
mitchymitch3: bets $9
matiko09: folds 
Uncalled bet ($9) returned to mitchymitch3
mitchymitch3 collected $18.05 from pot
mitchymitch3: doesn't show hand 
*** SUMMARY ***
Total pot $19 | Rake $0.95 
Board [6s 4c Td]
Seat 1: Red4erT folded before Flop (didn't bet)
Seat 2: holloway85 (button) folded before Flop (didn't bet)
Seat 3: mitchymitch3 (small blind) collected ($18.05)
Seat 5: elbiber2000 (big blind) folded before Flop
Seat 6: godfrey004 folded before Flop (didn't bet)
Seat 7: sanpidk folded before Flop (didn't bet)
Seat 8: ka100pka527 folded before Flop (didn't bet)
Seat 9: matiko09 folded on the Flop





PokerStars Hand #151165312786:  Hold'em No Limit ($1/$2 USD) - 2016/03/30 16:36:57 CET [2016/03/30 10:36:57 ET]
Table 'Jole' 9-max Seat #4 is the button
Seat 1: matiko09 ($325.50 in chips) 
Seat 2: RamiroAgujis ($272.76 in chips) 
Seat 4: tepi_guy ($204.40 in chips) 
Seat 5: mentalpshyco ($200 in chips) 
Seat 6: King_ZéManel ($203 in chips) 
Seat 7: ilaviiitech ($262.18 in chips) 
Seat 9: Ravnica11 ($90.25 in chips) 
mentalpshyco: posts small blind $1
King_ZéManel: posts big blind $2
*** HOLE CARDS ***
Dealt to matiko09 [Qh 3h]
ilaviiitech: folds 
ilaviiitech leaves the table
Ravnica11: raises $2.40 to $4.40
matiko09: folds 
di0d80 joins the table at seat #7 
di0d80 leaves the table
RamiroAgujis: folds 
tepi_guy: folds 
mentalpshyco: folds 
CI58 joins the table at seat #7 
King_ZéManel: folds 
Uncalled bet ($2.40) returned to Ravnica11
Ravnica11 collected $5 from pot
*** SUMMARY ***
Total pot $5 | Rake $0 
Seat 1: matiko09 folded before Flop (didn't bet)
Seat 2: RamiroAgujis folded before Flop (didn't bet)
Seat 4: tepi_guy (button) folded before Flop (didn't bet)
Seat 5: mentalpshyco (small blind) folded before Flop
Seat 6: King_ZéManel (big blind) folded before Flop
Seat 7: ilaviiitech folded before Flop (didn't bet)
Seat 9: Ravnica11 collected ($5)





PokerStars Hand #151165324745:  Hold'em No Limit ($0.50/$1.00 USD) - 2016/03/30 16:37:15 CET [2016/03/30 10:37:15 ET]
Table 'Figneria III' 9-max Seat #2 is the button
Seat 1: matiko09 ($100 in chips) 
Seat 2: sanpidk ($109.70 in chips) 
Seat 4: CI58 ($113.45 in chips) 
Seat 5: b_____a__242 ($85 in chips) 
Seat 7: holloway85 ($208.57 in chips) 
Seat 9: p.snow89 ($75.50 in chips) 
CI58: posts small blind $0.50
b_____a__242: posts big blind $1
RICKA16: sits out 
*** HOLE CARDS ***
Dealt to matiko09 [6s 6d]
holloway85: folds 
p.snow89: folds 
matiko09: raises $1.50 to $2.50
sanpidk: folds 
CI58: folds 
b_____a__242: folds 
Uncalled bet ($1.50) returned to matiko09
matiko09 collected $2.50 from pot
matiko09: doesn't show hand 
*** SUMMARY ***
Total pot $2.50 | Rake $0 
Seat 1: matiko09 collected ($2.50)
Seat 2: sanpidk (button) folded before Flop (didn't bet)
Seat 4: CI58 (small blind) folded before Flop
Seat 5: b_____a__242 (big blind) folded before Flop
Seat 7: holloway85 folded before Flop (didn't bet)
Seat 9: p.snow89 folded before Flop (didn't bet)





PokerStars Hand #151165327276:  Hold'em No Limit ($1/$2 USD) - 2016/03/30 16:37:18 CET [2016/03/30 10:37:18 ET]
Table 'Philoctetes II' 9-max Seat #1 is the button
Seat 1: vezunchik79 ($148.38 in chips) 
Seat 2: prominente ($224.91 in chips) 
Seat 3: mentalpshyco ($214.55 in chips) 
Seat 4: tepi_guy ($200 in chips) 
Seat 5: zhaimeng ($344.51 in chips) 
Seat 7: matiko09 ($209.20 in chips) 
Seat 8: suddend3ath ($207 in chips) 
Seat 9: RamiroAgujis ($237.30 in chips) 
prominente: posts small blind $1
mentalpshyco: posts big blind $2
*** HOLE CARDS ***
Dealt to matiko09 [Qs 7c]
tepi_guy: folds 
zhaimeng: folds 
matiko09: folds 
suddend3ath: folds 
RamiroAgujis: folds 
vezunchik79: raises $4 to $6
prominente: folds 
mentalpshyco: folds 
Uncalled bet ($4) returned to vezunchik79
vezunchik79 collected $5 from pot
vezunchik79: doesn't show hand 
*** SUMMARY ***
Total pot $5 | Rake $0 
Seat 1: vezunchik79 (button) collected ($5)
Seat 2: prominente (small blind) folded before Flop
Seat 3: mentalpshyco (big blind) folded before Flop
Seat 4: tepi_guy folded before Flop (didn't bet)
Seat 5: zhaimeng folded before Flop (didn't bet)
Seat 7: matiko09 folded before Flop (didn't bet)
Seat 8: suddend3ath folded before Flop (didn't bet)
Seat 9: RamiroAgujis folded before Flop (didn't bet)





PokerStars Hand #151165334794:  Hold'em No Limit ($0.50/$1.00 USD) - 2016/03/30 16:37:29 CET [2016/03/30 10:37:29 ET]
Table 'Pannonia II' 9-max Seat #2 is the button
Seat 1: CI58 ($102.62 in chips) 
Seat 2: matiko09 ($100 in chips) 
Seat 3: MGL_Sky99 ($105.22 in chips) 
Seat 5: Spid1 ($131.62 in chips) 
Seat 8: stonymalony ($60.80 in chips) 
Seat 9: b_____a__242 ($84.19 in chips) 
MGL_Sky99: posts small blind $0.50
e306 was removed from the table for failing to post
Spid1: posts big blind $1
*** HOLE CARDS ***
Dealt to matiko09 [2c Jc]
ka100pka527 joins the table at seat #4 
stonymalony: raises $1 to $2
b_____a__242: folds 
CI58: folds 
matiko09: folds 
MGL_Sky99: folds 
Spid1: folds 
Uncalled bet ($1) returned to stonymalony
stonymalony collected $2.50 from pot
stonymalony: doesn't show hand 
*** SUMMARY ***
Total pot $2.50 | Rake $0 
Seat 1: CI58 folded before Flop (didn't bet)
Seat 2: matiko09 (button) folded before Flop (didn't bet)
Seat 3: MGL_Sky99 (small blind) folded before Flop
Seat 5: Spid1 (big blind) folded before Flop
Seat 8: stonymalony collected ($2.50)
Seat 9: b_____a__242 folded before Flop (didn't bet)





PokerStars Hand #151165336056:  Hold'em No Limit ($0.50/$1.00 USD) - 2016/03/30 16:37:31 CET [2016/03/30 10:37:31 ET]
Table 'Hadwiger' 9-max Seat #9 is the button
Seat 1: AKplus ($99 in chips) 
Seat 3: sanpidk ($101.50 in chips) 
Seat 4: Westpants ($100 in chips) 
Seat 5: tipner ($100 in chips) 
Seat 6: Spid1 ($100 in chips) 
Seat 7: matiko09 ($100 in chips) 
Seat 8: di0d80 ($101.50 in chips) 
Seat 9: IdiotFromNE ($100 in chips) 
AKplus: posts small blind $0.50
sanpidk: posts big blind $1
*** HOLE CARDS ***
Dealt to matiko09 [As Ac]
Westpants: folds 
tipner: folds 
Spid1: folds 
matiko09: raises $2 to $3
di0d80: folds 
IdiotFromNE: folds 
AKplus: folds 
sanpidk: folds 
Uncalled bet ($2) returned to matiko09
matiko09 collected $2.50 from pot
matiko09: doesn't show hand 
*** SUMMARY ***
Total pot $2.50 | Rake $0 
Seat 1: AKplus (small blind) folded before Flop
Seat 3: sanpidk (big blind) folded before Flop
Seat 4: Westpants folded before Flop (didn't bet)
Seat 5: tipner folded before Flop (didn't bet)
Seat 6: Spid1 folded before Flop (didn't bet)
Seat 7: matiko09 collected ($2.50)
Seat 8: di0d80 folded before Flop (didn't bet)
Seat 9: IdiotFromNE (button) folded before Flop (didn't bet)





PokerStars Hand #151165339808:  Hold'em No Limit ($1/$2 USD) - 2016/03/30 16:37:37 CET [2016/03/30 10:37:37 ET]
Table 'Jole' 9-max Seat #5 is the button
Seat 1: matiko09 ($325.50 in chips) 
Seat 2: RamiroAgujis ($272.76 in chips) 
Seat 4: tepi_guy ($204.40 in chips) 
Seat 5: mentalpshyco ($200 in chips) 
Seat 6: King_ZéManel ($201 in chips) 
Seat 7: CI58 ($200 in chips) 
Seat 9: Ravnica11 ($93.25 in chips) 
King_ZéManel: posts small blind $1
CI58: posts big blind $2
*** HOLE CARDS ***
Dealt to matiko09 [Qh Qd]
Ravnica11: folds 
matiko09: raises $3 to $5
RamiroAgujis: folds 
tepi_guy: folds 
mentalpshyco: folds 
Westpants joins the table at seat #3 
King_ZéManel: folds 
CI58: folds 
Uncalled bet ($3) returned to matiko09
matiko09 collected $5 from pot
matiko09: doesn't show hand 
*** SUMMARY ***
Total pot $5 | Rake $0 
Seat 1: matiko09 collected ($5)
Seat 2: RamiroAgujis folded before Flop (didn't bet)
Seat 4: tepi_guy folded before Flop (didn't bet)
Seat 5: mentalpshyco (button) folded before Flop (didn't bet)
Seat 6: King_ZéManel (small blind) folded before Flop
Seat 7: CI58 (big blind) folded before Flop
Seat 9: Ravnica11 folded before Flop (didn't bet)





PokerStars Hand #151165342176:  Hold'em No Limit ($0.50/$1.00 USD) - 2016/03/30 16:37:40 CET [2016/03/30 10:37:40 ET]
Table 'Figneria III' 9-max Seat #4 is the button
Seat 1: matiko09 ($101.50 in chips) 
Seat 2: sanpidk ($109.70 in chips) 
Seat 4: CI58 ($112.95 in chips) 
Seat 5: b_____a__242 ($84 in chips) 
Seat 6: RICKA16 ($100 in chips) 
Seat 7: holloway85 ($208.57 in chips) 
Seat 9: p.snow89 ($75.50 in chips) 
b_____a__242: posts small blind $0.50
RICKA16: posts big blind $1
*** HOLE CARDS ***
Dealt to matiko09 [7d 5d]
holloway85: folds 
p.snow89: raises $2 to $3
matiko09: folds 
sanpidk: folds 
CI58: folds 
b_____a__242: raises $8.50 to $11.50
RICKA16: folds 
p.snow89: raises $64 to $75.50 and is all-in
p.snow89 said, "fold dont sleep"
b_____a__242: folds 
Uncalled bet ($64) returned to p.snow89
p.snow89 collected $24 from pot
p.snow89: doesn't show hand 
*** SUMMARY ***
Total pot $24 | Rake $0 
Seat 1: matiko09 folded before Flop (didn't bet)
Seat 2: sanpidk folded before Flop (didn't bet)
Seat 4: CI58 (button) folded before Flop (didn't bet)
Seat 5: b_____a__242 (small blind) folded before Flop
Seat 6: RICKA16 (big blind) folded before Flop
Seat 7: holloway85 folded before Flop (didn't bet)
Seat 9: p.snow89 collected ($24)





PokerStars Hand #151165349199:  Hold'em No Limit ($0.50/$1.00 USD) - 2016/03/30 16:37:51 CET [2016/03/30 10:37:51 ET]
Table 'Pannonia II' 9-max Seat #3 is the button
Seat 1: CI58 ($102.62 in chips) 
Seat 2: matiko09 ($100 in chips) 
Seat 3: MGL_Sky99 ($104.72 in chips) 
Seat 5: Spid1 ($130.62 in chips) 
Seat 8: stonymalony ($62.30 in chips) 
Seat 9: b_____a__242 ($84.19 in chips) 
ka100pka527 will be allowed to play after the button
Spid1: posts small blind $0.50
stonymalony: posts big blind $1
*** HOLE CARDS ***
Dealt to matiko09 [7s Qh]
b_____a__242: raises $2 to $3
CI58: folds 
matiko09: folds 
MGL_Sky99: folds 
Spid1: folds 
stonymalony: calls $2
*** FLOP *** [8s 3h Ac]
stonymalony: checks 
b_____a__242: checks 
*** TURN *** [8s 3h Ac] [9s]
stonymalony: checks 
b_____a__242: bets $3.52
stonymalony: folds 
Uncalled bet ($3.52) returned to b_____a__242
b_____a__242 collected $6.18 from pot
b_____a__242: doesn't show hand 
*** SUMMARY ***
Total pot $6.50 | Rake $0.32 
Board [8s 3h Ac 9s]
Seat 1: CI58 folded before Flop (didn't bet)
Seat 2: matiko09 folded before Flop (didn't bet)
Seat 3: MGL_Sky99 (button) folded before Flop (didn't bet)
Seat 5: Spid1 (small blind) folded before Flop
Seat 8: stonymalony (big blind) folded on the Turn
Seat 9: b_____a__242 collected ($6.18)





PokerStars Hand #151165350268:  Hold'em No Limit ($0.50/$1.00 USD) - 2016/03/30 16:37:52 CET [2016/03/30 10:37:52 ET]
Table 'Alcor II' 9-max Seat #3 is the button
Seat 1: Red4erT ($100 in chips) 
Seat 2: holloway85 ($75.84 in chips) 
Seat 3: mitchymitch3 ($100.22 in chips) 
Seat 5: elbiber2000 ($105.20 in chips) 
Seat 6: godfrey004 ($210.25 in chips) 
Seat 7: sanpidk ($102 in chips) 
Seat 8: ka100pka527 ($60.28 in chips) 
Seat 9: matiko09 ($200.05 in chips) 
Effort92 will be allowed to play after the button
elbiber2000: posts small blind $0.50
godfrey004: posts big blind $1
*** HOLE CARDS ***
Dealt to matiko09 [Ad Ts]
sanpidk: folds 
ka100pka527: raises $2 to $3
matiko09: folds 
Red4erT: folds 
holloway85: folds 
mitchymitch3: folds 
elbiber2000: raises $5 to $8
godfrey004: folds 
ka100pka527: calls $5
*** FLOP *** [4c 2h 3s]
elbiber2000: bets $7
ka100pka527: raises $15.07 to $22.07
elbiber2000: folds 
Uncalled bet ($15.07) returned to ka100pka527
ka100pka527 collected $29.45 from pot
ka100pka527: doesn't show hand 
*** SUMMARY ***
Total pot $31 | Rake $1.55 
Board [4c 2h 3s]
Seat 1: Red4erT folded before Flop (didn't bet)
Seat 2: holloway85 folded before Flop (didn't bet)
Seat 3: mitchymitch3 (button) folded before Flop (didn't bet)
Seat 5: elbiber2000 (small blind) folded on the Flop
Seat 6: godfrey004 (big blind) folded before Flop
Seat 7: sanpidk folded before Flop (didn't bet)
Seat 8: ka100pka527 collected ($29.45)
Seat 9: matiko09 folded before Flop (didn't bet)





PokerStars Hand #151165354664:  Hold'em No Limit ($1/$2 USD) - 2016/03/30 16:37:59 CET [2016/03/30 10:37:59 ET]
Table 'Hektor III' 9-max Seat #1 is the button
Seat 1: matiko09 ($200 in chips) 
Seat 2: RamiroAgujis ($300.45 in chips) 
Seat 3: T0ny Adams ($87.43 in chips) 
Seat 4: volwebni4ek ($80 in chips) 
Seat 5: prominente ($200 in chips) 
Seat 7: InsomniaRU ($214.04 in chips) 
Seat 8: tepi_guy ($207.71 in chips) 
Seat 9: fonng ($623.33 in chips) 
RamiroAgujis: posts small blind $1
T0ny Adams: posts big blind $2
*** HOLE CARDS ***
Dealt to matiko09 [8s 9s]
volwebni4ek: folds 
prominente: folds 
InsomniaRU: folds 
tepi_guy: folds 
fonng: raises $2 to $4
matiko09: raises $8 to $12
RamiroAgujis: folds 
T0ny Adams: raises $31 to $43
fonng: folds 
matiko09: folds 
Uncalled bet ($31) returned to T0ny Adams
T0ny Adams collected $29 from pot
T0ny Adams: doesn't show hand 
*** SUMMARY ***
Total pot $29 | Rake $0 
Seat 1: matiko09 (button) folded before Flop
Seat 2: RamiroAgujis (small blind) folded before Flop
Seat 3: T0ny Adams (big blind) collected ($29)
Seat 4: volwebni4ek folded before Flop (didn't bet)
Seat 5: prominente folded before Flop (didn't bet)
Seat 7: InsomniaRU folded before Flop (didn't bet)
Seat 8: tepi_guy folded before Flop (didn't bet)
Seat 9: fonng folded before Flop





PokerStars Hand #151165355398:  Hold'em No Limit ($0.50/$1.00 USD) - 2016/03/30 16:38:00 CET [2016/03/30 10:38:00 ET]
Table 'Hadwiger' 9-max Seat #1 is the button
Seat 1: AKplus ($98.50 in chips) 
Seat 3: sanpidk ($100.50 in chips) 
Seat 4: Westpants ($100 in chips) 
Seat 5: tipner ($100 in chips) 
Seat 6: Spid1 ($100 in chips) 
Seat 7: matiko09 ($101.50 in chips) 
Seat 8: di0d80 ($101.50 in chips) 
Seat 9: IdiotFromNE ($100 in chips) 
sanpidk: posts small blind $0.50
Westpants: posts big blind $1
*** HOLE CARDS ***
Dealt to matiko09 [Ts 3s]
tipner: folds 
Spid1: folds 
matiko09: folds 
di0d80: raises $1.50 to $2.50
IdiotFromNE: folds 
AKplus: folds 
sanpidk: folds 
Westpants: folds 
Uncalled bet ($1.50) returned to di0d80
di0d80 collected $2.50 from pot
di0d80: doesn't show hand 
*** SUMMARY ***
Total pot $2.50 | Rake $0 
Seat 1: AKplus (button) folded before Flop (didn't bet)
Seat 3: sanpidk (small blind) folded before Flop
Seat 4: Westpants (big blind) folded before Flop
Seat 5: tipner folded before Flop (didn't bet)
Seat 6: Spid1 folded before Flop (didn't bet)
Seat 7: matiko09 folded before Flop (didn't bet)
Seat 8: di0d80 collected ($2.50)
Seat 9: IdiotFromNE folded before Flop (didn't bet)





PokerStars Hand #151165365316:  Hold'em No Limit ($1/$2 USD) - 2016/03/30 16:38:15 CET [2016/03/30 10:38:15 ET]
Table 'Aesculapia II' 9-max Seat #2 is the button
Seat 1: buthmen ($308.50 in chips) 
Seat 2: suddend3ath ($335.25 in chips) 
Seat 3: matiko09 ($473.74 in chips) 
Seat 4: tepi_guy ($207.61 in chips) 
Seat 5: prominente ($200 in chips) 
Seat 7: Rumboni66 ($115.49 in chips) 
Seat 9: InsomniaRU ($205.06 in chips) 
matiko09: posts small blind $1
tepi_guy: posts big blind $2
mentalpshyco: sits out 
*** HOLE CARDS ***
Dealt to matiko09 [Qs Qc]
prominente: folds 
Rumboni66: folds 
InsomniaRU: folds 
buthmen: raises $6 to $8
suddend3ath: folds 
matiko09: raises $16 to $24
tepi_guy: folds 
buthmen: calls $16
*** FLOP *** [4s 6s Jc]
matiko09: bets $32
buthmen: calls $32
*** TURN *** [4s 6s Jc] [9s]
matiko09: checks 
buthmen: bets $55.62
matiko09: calls $55.62
*** RIVER *** [4s 6s Jc 9s] [Tc]
matiko09: checks 
buthmen: bets $111.24
e306 leaves the table
matiko09: calls $111.24
*** SHOW DOWN ***
buthmen: shows [Ad Ks] (high card Ace)
matiko09: shows [Qs Qc] (a pair of Queens)
matiko09 collected $444.97 from pot
*** SUMMARY ***
Total pot $447.72 | Rake $2.75 
Board [4s 6s Jc 9s Tc]
Seat 1: buthmen showed [Ad Ks] and lost with high card Ace
Seat 2: suddend3ath (button) folded before Flop (didn't bet)
Seat 3: matiko09 (small blind) showed [Qs Qc] and won ($444.97) with a pair of Queens
Seat 4: tepi_guy (big blind) folded before Flop
Seat 5: prominente folded before Flop (didn't bet)
Seat 7: Rumboni66 folded before Flop (didn't bet)
Seat 9: InsomniaRU folded before Flop (didn't bet)





PokerStars Hand #151165372495:  Hold'em No Limit ($0.50/$1.00 USD) - 2016/03/30 16:38:25 CET [2016/03/30 10:38:25 ET]
Table 'Hadwiger' 9-max Seat #3 is the button
Seat 1: AKplus ($98.50 in chips) 
Seat 3: sanpidk ($100 in chips) 
Seat 4: Westpants ($100 in chips) 
Seat 7: matiko09 ($101.50 in chips) 
Seat 8: di0d80 ($103 in chips) 
Seat 9: IdiotFromNE ($100 in chips) 
Westpants: posts small blind $0.50
tipner: is sitting out 
Spid1: is sitting out 
matiko09: posts big blind $1
*** HOLE CARDS ***
Dealt to matiko09 [Ah Js]
Spid1 leaves the table
di0d80: folds 
IdiotFromNE: folds 
di0d80 leaves the table
AKplus: folds 
di0d80 joins the table at seat #2 
sanpidk: raises $1.24 to $2.24
Westpants: folds 
matiko09: calls $1.24
*** FLOP *** [6h Jh 9d]
matiko09: checks 
tipner leaves the table
sanpidk: checks 
*** TURN *** [6h Jh 9d] [Kd]
matiko09: checks 
sanpidk: bets $3
matiko09: calls $3
*** RIVER *** [6h Jh 9d Kd] [8d]
matiko09: checks 
sanpidk: bets $6.50
matiko09: folds 
Uncalled bet ($6.50) returned to sanpidk
sanpidk collected $10.43 from pot
sanpidk: doesn't show hand 
*** SUMMARY ***
Total pot $10.98 | Rake $0.55 
Board [6h Jh 9d Kd 8d]
Seat 1: AKplus folded before Flop (didn't bet)
Seat 3: sanpidk (button) collected ($10.43)
Seat 4: Westpants (small blind) folded before Flop
Seat 7: matiko09 (big blind) folded on the River
Seat 8: di0d80 folded before Flop (didn't bet)
Seat 9: IdiotFromNE folded before Flop (didn't bet)





PokerStars Hand #151165374938:  Hold'em No Limit ($1/$2 USD) - 2016/03/30 16:38:29 CET [2016/03/30 10:38:29 ET]
Table 'Philoctetes II' 9-max Seat #2 is the button
Seat 1: vezunchik79 ($151.38 in chips) 
Seat 2: prominente ($223.91 in chips) 
Seat 3: mentalpshyco ($212.55 in chips) 
Seat 4: tepi_guy ($200 in chips) 
Seat 5: zhaimeng ($344.51 in chips) 
Seat 7: matiko09 ($209.20 in chips) 
Seat 8: suddend3ath ($207 in chips) 
Seat 9: RamiroAgujis ($237.30 in chips) 
mentalpshyco: posts small blind $1
tepi_guy: posts big blind $2
*** HOLE CARDS ***
Dealt to matiko09 [5s 3d]
zhaimeng: folds 
matiko09: folds 
suddend3ath: raises $3 to $5
RamiroAgujis: folds 
vezunchik79: folds 
prominente: folds 
mentalpshyco: folds 
tepi_guy: folds 
Uncalled bet ($3) returned to suddend3ath
suddend3ath collected $5 from pot
suddend3ath: doesn't show hand 
*** SUMMARY ***
Total pot $5 | Rake $0 
Seat 1: vezunchik79 folded before Flop (didn't bet)
Seat 2: prominente (button) folded before Flop (didn't bet)
Seat 3: mentalpshyco (small blind) folded before Flop
Seat 4: tepi_guy (big blind) folded before Flop
Seat 5: zhaimeng folded before Flop (didn't bet)
Seat 7: matiko09 folded before Flop (didn't bet)
Seat 8: suddend3ath collected ($5)
Seat 9: RamiroAgujis folded before Flop (didn't bet)





PokerStars Hand #151165388160:  Hold'em No Limit ($1/$2 USD) - 2016/03/30 16:38:48 CET [2016/03/30 10:38:48 ET]
Table 'Hektor III' 9-max Seat #2 is the button
Seat 1: matiko09 ($200 in chips) 
Seat 2: RamiroAgujis ($299.45 in chips) 
Seat 3: T0ny Adams ($104.43 in chips) 
Seat 5: prominente ($200 in chips) 
Seat 7: InsomniaRU ($214.04 in chips) 
Seat 8: tepi_guy ($207.71 in chips) 
Seat 9: fonng ($619.33 in chips) 
T0ny Adams: posts small blind $1
volwebni4ek: is sitting out 
volwebni4ek leaves the table
prominente: posts big blind $2
*** HOLE CARDS ***
Dealt to matiko09 [8s 3c]
InsomniaRU: folds 
tepi_guy: folds 
fonng: folds 
matiko09: folds 
RamiroAgujis: raises $3 to $5
T0ny Adams: folds 
prominente: folds 
Uncalled bet ($3) returned to RamiroAgujis
RamiroAgujis collected $5 from pot
RamiroAgujis: doesn't show hand 
*** SUMMARY ***
Total pot $5 | Rake $0 
Seat 1: matiko09 folded before Flop (didn't bet)
Seat 2: RamiroAgujis (button) collected ($5)
Seat 3: T0ny Adams (small blind) folded before Flop
Seat 5: prominente (big blind) folded before Flop
Seat 7: InsomniaRU folded before Flop (didn't bet)
Seat 8: tepi_guy folded before Flop (didn't bet)
Seat 9: fonng folded before Flop (didn't bet)





PokerStars Hand #151165392603:  Hold'em No Limit ($0.50/$1.00 USD) - 2016/03/30 16:38:55 CET [2016/03/30 10:38:55 ET]
Table 'Pannonia II' 9-max Seat #5 is the button
Seat 1: CI58 ($102.62 in chips) 
Seat 2: matiko09 ($100 in chips) 
Seat 3: MGL_Sky99 ($104.72 in chips) 
Seat 5: Spid1 ($130.12 in chips) 
Seat 8: stonymalony ($59.30 in chips) 
stonymalony: posts small blind $0.50
b_____a__242: is sitting out 
CI58: posts big blind $1
ka100pka527: sits out 
*** HOLE CARDS ***
Dealt to matiko09 [Jh Ah]
matiko09: raises $2 to $3
MGL_Sky99: folds 
Spid1: folds 
b_____a__242 leaves the table
stonymalony: folds 
Effort92 joins the table at seat #9 
CI58: folds 
Uncalled bet ($2) returned to matiko09
matiko09 collected $2.50 from pot
matiko09: doesn't show hand 
*** SUMMARY ***
Total pot $2.50 | Rake $0 
Seat 1: CI58 (big blind) folded before Flop
Seat 2: matiko09 collected ($2.50)
Seat 3: MGL_Sky99 folded before Flop (didn't bet)
Seat 5: Spid1 (button) folded before Flop (didn't bet)
Seat 8: stonymalony (small blind) folded before Flop





PokerStars Hand #151165397625:  Hold'em No Limit ($1/$2 USD) - 2016/03/30 16:39:02 CET [2016/03/30 10:39:02 ET]
Table 'Philoctetes II' 9-max Seat #3 is the button
Seat 1: vezunchik79 ($151.38 in chips) 
Seat 2: prominente ($223.91 in chips) 
Seat 3: mentalpshyco ($211.55 in chips) 
Seat 4: tepi_guy ($200 in chips) 
Seat 5: zhaimeng ($344.51 in chips) 
Seat 7: matiko09 ($209.20 in chips) 
Seat 8: suddend3ath ($210 in chips) 
Seat 9: RamiroAgujis ($237.30 in chips) 
tepi_guy: posts small blind $1
zhaimeng: posts big blind $2
*** HOLE CARDS ***
Dealt to matiko09 [8c 9s]
matiko09: folds 
suddend3ath: folds 
RamiroAgujis: folds 
vezunchik79: folds 
prominente: raises $3 to $5
mentalpshyco: folds 
tepi_guy: folds 
zhaimeng: raises $11 to $16
prominente: folds 
Uncalled bet ($11) returned to zhaimeng
zhaimeng collected $11 from pot
*** SUMMARY ***
Total pot $11 | Rake $0 
Seat 1: vezunchik79 folded before Flop (didn't bet)
Seat 2: prominente folded before Flop
Seat 3: mentalpshyco (button) folded before Flop (didn't bet)
Seat 4: tepi_guy (small blind) folded before Flop
Seat 5: zhaimeng (big blind) collected ($11)
Seat 7: matiko09 folded before Flop (didn't bet)
Seat 8: suddend3ath folded before Flop (didn't bet)
Seat 9: RamiroAgujis folded before Flop (didn't bet)





PokerStars Hand #151165400073:  Hold'em No Limit ($1/$2 USD) - 2016/03/30 16:39:06 CET [2016/03/30 10:39:06 ET]
Table 'Hektor III' 9-max Seat #3 is the button
Seat 1: matiko09 ($200 in chips) 
Seat 2: RamiroAgujis ($302.45 in chips) 
Seat 3: T0ny Adams ($103.43 in chips) 
Seat 5: prominente ($200 in chips) 
Seat 7: InsomniaRU ($214.04 in chips) 
Seat 8: tepi_guy ($207.71 in chips) 
Seat 9: fonng ($619.33 in chips) 
prominente: posts small blind $1
InsomniaRU: posts big blind $2
*** HOLE CARDS ***
Dealt to matiko09 [3c 3h]
tepi_guy: folds 
fonng is disconnected 
fonng has timed out while disconnected
fonng: folds 
matiko09: raises $3 to $5
RamiroAgujis: folds 
e306 leaves the table
o.miro joins the table at seat #4 
o.miro leaves the table
T0ny Adams: folds 
prominente: folds 
di0d80 joins the table at seat #4 
InsomniaRU: calls $3
*** FLOP *** [9d Kc 2d]
fonng leaves the table
InsomniaRU: checks 
matiko09: checks 
*** TURN *** [9d Kc 2d] [5d]
InsomniaRU: checks 
matiko09: checks 
*** RIVER *** [9d Kc 2d 5d] [3d]
InsomniaRU: checks 
matiko09: checks 
*** SHOW DOWN ***
InsomniaRU: shows [Jc Kh] (a pair of Kings)
matiko09: shows [3c 3h] (three of a kind, Threes)
matiko09 collected $10.45 from pot
*** SUMMARY ***
Total pot $11 | Rake $0.55 
Board [9d Kc 2d 5d 3d]
Seat 1: matiko09 showed [3c 3h] and won ($10.45) with three of a kind, Threes
Seat 2: RamiroAgujis folded before Flop (didn't bet)
Seat 3: T0ny Adams (button) folded before Flop (didn't bet)
Seat 5: prominente (small blind) folded before Flop
Seat 7: InsomniaRU (big blind) showed [Jc Kh] and lost with a pair of Kings
Seat 8: tepi_guy folded before Flop (didn't bet)
Seat 9: fonng folded before Flop (didn't bet)





PokerStars Hand #151165404783:  Hold'em No Limit ($0.50/$1.00 USD) - 2016/03/30 16:39:13 CET [2016/03/30 10:39:13 ET]
Table 'Pannonia II' 9-max Seat #8 is the button
Seat 1: CI58 ($101.62 in chips) 
Seat 2: matiko09 ($101.50 in chips) 
Seat 3: MGL_Sky99 ($104.72 in chips) 
Seat 5: Spid1 ($130.12 in chips) 
Seat 8: stonymalony ($58.80 in chips) 
Effort92 will be allowed to play after the button
CI58: posts small blind $0.50
matiko09: posts big blind $1
ka100pka527: sits out 
*** HOLE CARDS ***
Dealt to matiko09 [6s Td]
MGL_Sky99: folds 
Spid1: folds 
stonymalony: raises $1 to $2
CI58: folds 
matiko09: folds 
Uncalled bet ($1) returned to stonymalony
stonymalony collected $2.50 from pot
stonymalony: doesn't show hand 
*** SUMMARY ***
Total pot $2.50 | Rake $0 
Seat 1: CI58 (small blind) folded before Flop
Seat 2: matiko09 (big blind) folded before Flop
Seat 3: MGL_Sky99 folded before Flop (didn't bet)
Seat 5: Spid1 folded before Flop (didn't bet)
Seat 8: stonymalony (button) collected ($2.50)





PokerStars Hand #151165411903:  Hold'em No Limit ($0.50/$1.00 USD) - 2016/03/30 16:39:23 CET [2016/03/30 10:39:23 ET]
Table 'Figneria III' 9-max Seat #5 is the button
Seat 1: matiko09 ($101.50 in chips) 
Seat 2: sanpidk ($109.70 in chips) 
Seat 4: CI58 ($112.95 in chips) 
Seat 5: b_____a__242 ($72.50 in chips) 
Seat 6: RICKA16 ($99 in chips) 
Seat 7: holloway85 ($208.57 in chips) 
Seat 9: p.snow89 ($88 in chips) 
RICKA16: posts small blind $0.50
holloway85: posts big blind $1
*** HOLE CARDS ***
Dealt to matiko09 [Td 2s]
p.snow89: folds 
matiko09: folds 
sanpidk: folds 
CI58 has timed out
CI58: folds 
b_____a__242: folds 
RICKA16: raises $2 to $3
holloway85: folds 
Uncalled bet ($2) returned to RICKA16
RICKA16 collected $2 from pot
RICKA16: doesn't show hand 
*** SUMMARY ***
Total pot $2 | Rake $0 
Seat 1: matiko09 folded before Flop (didn't bet)
Seat 2: sanpidk folded before Flop (didn't bet)
Seat 4: CI58 folded before Flop (didn't bet)
Seat 5: b_____a__242 (button) folded before Flop (didn't bet)
Seat 6: RICKA16 (small blind) collected ($2)
Seat 7: holloway85 (big blind) folded before Flop
Seat 9: p.snow89 folded before Flop (didn't bet)





PokerStars Hand #151165424013:  Hold'em No Limit ($0.50/$1.00 USD) - 2016/03/30 16:39:41 CET [2016/03/30 10:39:41 ET]
Table 'Alcor II' 9-max Seat #5 is the button
Seat 1: Red4erT ($100 in chips) 
Seat 2: holloway85 ($75.84 in chips) 
Seat 3: mitchymitch3 ($100.22 in chips) 
Seat 5: elbiber2000 ($100 in chips) 
Seat 6: godfrey004 ($209.25 in chips) 
Seat 7: sanpidk ($102 in chips) 
Seat 8: ka100pka527 ($74.73 in chips) 
Seat 9: matiko09 ($200.05 in chips) 
godfrey004: posts small blind $0.50
sanpidk: posts big blind $1
Effort92: sits out 
*** HOLE CARDS ***
Dealt to matiko09 [3c 8d]
ka100pka527: folds 
matiko09: folds 
Red4erT: folds 
holloway85: calls $1
mitchymitch3: folds 
elbiber2000: raises $3 to $4
godfrey004: calls $3.50
sanpidk: folds 
holloway85: calls $3
*** FLOP *** [Jd Td 7h]
godfrey004: checks 
holloway85: checks 
elbiber2000: bets $9
godfrey004: folds 
holloway85: folds 
Uncalled bet ($9) returned to elbiber2000
elbiber2000 collected $12.35 from pot
elbiber2000: doesn't show hand 
*** SUMMARY ***
Total pot $13 | Rake $0.65 
Board [Jd Td 7h]
Seat 1: Red4erT folded before Flop (didn't bet)
Seat 2: holloway85 folded on the Flop
Seat 3: mitchymitch3 folded before Flop (didn't bet)
Seat 5: elbiber2000 (button) collected ($12.35)
Seat 6: godfrey004 (small blind) folded on the Flop
Seat 7: sanpidk (big blind) folded before Flop
Seat 8: ka100pka527 folded before Flop (didn't bet)
Seat 9: matiko09 folded before Flop (didn't bet)





PokerStars Hand #151165429472:  Hold'em No Limit ($1/$2 USD) - 2016/03/30 16:39:49 CET [2016/03/30 10:39:49 ET]
Table 'Philoctetes II' 9-max Seat #4 is the button
Seat 1: vezunchik79 ($151.38 in chips) 
Seat 2: prominente ($218.91 in chips) 
Seat 3: mentalpshyco ($211.55 in chips) 
Seat 4: tepi_guy ($200 in chips) 
Seat 5: zhaimeng ($350.51 in chips) 
Seat 7: matiko09 ($209.20 in chips) 
Seat 8: suddend3ath ($210 in chips) 
Seat 9: RamiroAgujis ($237.30 in chips) 
zhaimeng: posts small blind $1
e306 was removed from the table for failing to post
matiko09: posts big blind $2
*** HOLE CARDS ***
Dealt to matiko09 [2d 5c]
suddend3ath: folds 
InsomniaRU joins the table at seat #6 
InsomniaRU leaves the table
RamiroAgujis: folds 
vezunchik79: raises $4 to $6
prominente: calls $6
mentalpshyco: raises $16 to $22
tepi_guy: folds 
zhaimeng: folds 
matiko09: folds 
vezunchik79: folds 
prominente: folds 
Uncalled bet ($16) returned to mentalpshyco
mentalpshyco collected $21 from pot
mentalpshyco: doesn't show hand 
*** SUMMARY ***
Total pot $21 | Rake $0 
Seat 1: vezunchik79 folded before Flop
Seat 2: prominente folded before Flop
Seat 3: mentalpshyco collected ($21)
Seat 4: tepi_guy (button) folded before Flop (didn't bet)
Seat 5: zhaimeng (small blind) folded before Flop
Seat 7: matiko09 (big blind) folded before Flop
Seat 8: suddend3ath folded before Flop (didn't bet)
Seat 9: RamiroAgujis folded before Flop (didn't bet)





PokerStars Hand #151165433242:  Hold'em No Limit ($0.50/$1.00 USD) - 2016/03/30 16:39:55 CET [2016/03/30 10:39:55 ET]
Table 'Pannonia II' 9-max Seat #1 is the button
Seat 1: CI58 ($101.12 in chips) 
Seat 2: matiko09 ($100.50 in chips) 
Seat 3: MGL_Sky99 ($104.72 in chips) 
Seat 5: Spid1 ($130.12 in chips) 
Seat 8: stonymalony ($60.30 in chips) 
matiko09: posts small blind $0.50
MGL_Sky99: posts big blind $1
ka100pka527: sits out 
Effort92: sits out 
*** HOLE CARDS ***
Dealt to matiko09 [2c 5d]
Spid1: folds 
stonymalony: raises $1 to $2
CI58 has timed out
CI58: folds 
matiko09: folds 
MGL_Sky99: calls $1
*** FLOP *** [8h 2s Ks]
MGL_Sky99: checks 
stonymalony: checks 
*** TURN *** [8h 2s Ks] [Js]
MGL_Sky99: checks 
stonymalony: bets $2
MGL_Sky99: folds 
Uncalled bet ($2) returned to stonymalony
stonymalony collected $4.28 from pot
stonymalony: doesn't show hand 
*** SUMMARY ***
Total pot $4.50 | Rake $0.22 
Board [8h 2s Ks Js]
Seat 1: CI58 (button) folded before Flop (didn't bet)
Seat 2: matiko09 (small blind) folded before Flop
Seat 3: MGL_Sky99 (big blind) folded on the Turn
Seat 5: Spid1 folded before Flop (didn't bet)
Seat 8: stonymalony collected ($4.28)





PokerStars Hand #151165443807:  Hold'em No Limit ($1/$2 USD) - 2016/03/30 16:40:10 CET [2016/03/30 10:40:10 ET]
Table 'Aesculapia II' 9-max Seat #3 is the button
Seat 1: buthmen ($85.64 in chips) 
Seat 2: suddend3ath ($335.25 in chips) 
Seat 3: matiko09 ($695.85 in chips) 
Seat 4: tepi_guy ($205.61 in chips) 
Seat 5: prominente ($200 in chips) 
Seat 7: Rumboni66 ($115.49 in chips) 
Seat 9: InsomniaRU ($205.06 in chips) 
tepi_guy: posts small blind $1
prominente: posts big blind $2
mentalpshyco: sits out 
*** HOLE CARDS ***
Dealt to matiko09 [9c Jh]
Rumboni66: folds 
InsomniaRU: folds 
buthmen: folds 
suddend3ath: raises $3 to $5
matiko09: folds 
tepi_guy: folds 
prominente: folds 
Uncalled bet ($3) returned to suddend3ath
suddend3ath collected $5 from pot
suddend3ath: doesn't show hand 
*** SUMMARY ***
Total pot $5 | Rake $0 
Seat 1: buthmen folded before Flop (didn't bet)
Seat 2: suddend3ath collected ($5)
Seat 3: matiko09 (button) folded before Flop (didn't bet)
Seat 4: tepi_guy (small blind) folded before Flop
Seat 5: prominente (big blind) folded before Flop
Seat 7: Rumboni66 folded before Flop (didn't bet)
Seat 9: InsomniaRU folded before Flop (didn't bet)





PokerStars Hand #151165445708:  Hold'em No Limit ($0.50/$1.00 USD) - 2016/03/30 16:40:13 CET [2016/03/30 10:40:13 ET]
Table 'Hadwiger' 9-max Seat #4 is the button
Seat 1: AKplus ($98.50 in chips) 
Seat 3: sanpidk ($105.19 in chips) 
Seat 4: Westpants ($100 in chips) 
Seat 7: matiko09 ($100 in chips) 
Seat 9: IdiotFromNE ($100 in chips) 
matiko09: posts small blind $0.50
IdiotFromNE: posts big blind $1
di0d80: sits out 
*** HOLE CARDS ***
Dealt to matiko09 [As 5d]
AKplus: folds 
sanpidk: folds 
Westpants: raises $1.46 to $2.46
matiko09: folds 
fonng joins the table at seat #8 
IdiotFromNE: folds 
Uncalled bet ($1.46) returned to Westpants
Spid1 joins the table at seat #5 
Westpants collected $2.50 from pot
*** SUMMARY ***
Total pot $2.50 | Rake $0 
Seat 1: AKplus folded before Flop (didn't bet)
Seat 3: sanpidk folded before Flop (didn't bet)
Seat 4: Westpants (button) collected ($2.50)
Seat 7: matiko09 (small blind) folded before Flop
Seat 9: IdiotFromNE (big blind) folded before Flop





PokerStars Hand #151165447785:  Hold'em No Limit ($0.50/$1.00 USD) - 2016/03/30 16:40:16 CET [2016/03/30 10:40:16 ET]
Table 'Figneria III' 9-max Seat #6 is the button
Seat 1: matiko09 ($101.50 in chips) 
Seat 2: sanpidk ($109.70 in chips) 
Seat 5: b_____a__242 ($72.50 in chips) 
Seat 6: RICKA16 ($100 in chips) 
Seat 7: holloway85 ($207.57 in chips) 
Seat 9: p.snow89 ($88 in chips) 
holloway85: posts small blind $0.50
p.snow89: posts big blind $1
*** HOLE CARDS ***
Dealt to matiko09 [Qd Ts]
matiko09: folds 
sanpidk: folds 
b_____a__242: folds 
RICKA16: folds 
holloway85: calls $0.50
p.snow89: checks 
*** FLOP *** [Qc Kh 9c]
holloway85: bets $1
p.snow89: calls $1
*** TURN *** [Qc Kh 9c] [Ad]
holloway85: checks 
p.snow89: checks 
*** RIVER *** [Qc Kh 9c Ad] [Th]
holloway85: bets $1
p.snow89: raises $9 to $10
holloway85: folds 
Uncalled bet ($9) returned to p.snow89
p.snow89 collected $5.70 from pot
p.snow89: doesn't show hand 
*** SUMMARY ***
Total pot $6 | Rake $0.30 
Board [Qc Kh 9c Ad Th]
Seat 1: matiko09 folded before Flop (didn't bet)
Seat 2: sanpidk folded before Flop (didn't bet)
Seat 5: b_____a__242 folded before Flop (didn't bet)
Seat 6: RICKA16 (button) folded before Flop (didn't bet)
Seat 7: holloway85 (small blind) folded on the River
Seat 9: p.snow89 (big blind) collected ($5.70)





PokerStars Hand #151165458365:  Hold'em No Limit ($0.50/$1.00 USD) - 2016/03/30 16:40:32 CET [2016/03/30 10:40:32 ET]
Table 'Hadwiger' 9-max Seat #7 is the button
Seat 1: AKplus ($98.50 in chips) 
Seat 3: sanpidk ($105.19 in chips) 
Seat 4: Westpants ($101.50 in chips) 
Seat 7: matiko09 ($100 in chips) 
Seat 9: IdiotFromNE ($100 in chips) 
fonng will be allowed to play after the button
IdiotFromNE: posts small blind $0.50
AKplus: posts big blind $1
di0d80: sits out 
Spid1: sits out 
*** HOLE CARDS ***
Dealt to matiko09 [2d Qd]
sanpidk: folds 
Westpants: folds 
matiko09: folds 
fonng leaves the table
IdiotFromNE: raises $1.50 to $2.50
19SERGE74 joins the table at seat #8 
AKplus: calls $1.50
*** FLOP *** [Jh 5d 4s]
IdiotFromNE: checks 
AKplus: checks 
*** TURN *** [Jh 5d 4s] [Kh]
IdiotFromNE: bets $3.80
AKplus: calls $3.80
*** RIVER *** [Jh 5d 4s Kh] [Kd]
IdiotFromNE: checks 
AKplus: checks 
*** SHOW DOWN ***
IdiotFromNE: shows [As Th] (a pair of Kings)
AKplus: mucks hand 
IdiotFromNE collected $11.97 from pot
*** SUMMARY ***
Total pot $12.60 | Rake $0.63 
Board [Jh 5d 4s Kh Kd]
Seat 1: AKplus (big blind) mucked [Tc Qs]
Seat 3: sanpidk folded before Flop (didn't bet)
Seat 4: Westpants folded before Flop (didn't bet)
Seat 7: matiko09 (button) folded before Flop (didn't bet)
Seat 9: IdiotFromNE (small blind) showed [As Th] and won ($11.97) with a pair of Kings





PokerStars Hand #151165464929:  Hold'em No Limit ($1/$2 USD) - 2016/03/30 16:40:42 CET [2016/03/30 10:40:42 ET]
Table 'Aesculapia II' 9-max Seat #4 is the button
Seat 1: buthmen ($85.64 in chips) 
Seat 2: suddend3ath ($338.25 in chips) 
Seat 3: matiko09 ($695.85 in chips) 
Seat 4: tepi_guy ($204.61 in chips) 
Seat 5: prominente ($200 in chips) 
Seat 6: mentalpshyco ($200 in chips) 
Seat 7: Rumboni66 ($115.49 in chips) 
Seat 9: InsomniaRU ($205.06 in chips) 
prominente: posts small blind $1
mentalpshyco: posts big blind $2
*** HOLE CARDS ***
Dealt to matiko09 [2h 5s]
Rumboni66: folds 
InsomniaRU: folds 
buthmen: raises $4 to $6
suddend3ath: folds 
matiko09: folds 
tepi_guy: folds 
prominente: folds 
tipner joins the table at seat #8 
mentalpshyco: calls $4
*** FLOP *** [Ad 6d Jc]
mentalpshyco: checks 
buthmen: bets $6
mentalpshyco: folds 
Uncalled bet ($6) returned to buthmen
buthmen collected $12.35 from pot
buthmen: doesn't show hand 
*** SUMMARY ***
Total pot $13 | Rake $0.65 
Board [Ad 6d Jc]
Seat 1: buthmen collected ($12.35)
Seat 2: suddend3ath folded before Flop (didn't bet)
Seat 3: matiko09 folded before Flop (didn't bet)
Seat 4: tepi_guy (button) folded before Flop (didn't bet)
Seat 5: prominente (small blind) folded before Flop
Seat 6: mentalpshyco (big blind) folded on the Flop
Seat 7: Rumboni66 folded before Flop (didn't bet)
Seat 9: InsomniaRU folded before Flop (didn't bet)





PokerStars Hand #151165472904:  Hold'em No Limit ($0.50/$1.00 USD) - 2016/03/30 16:40:53 CET [2016/03/30 10:40:53 ET]
Table 'Alcor II' 9-max Seat #6 is the button
Seat 1: Red4erT ($100 in chips) 
Seat 2: holloway85 ($71.84 in chips) 
Seat 3: mitchymitch3 ($100.22 in chips) 
Seat 5: elbiber2000 ($108.35 in chips) 
Seat 6: godfrey004 ($205.25 in chips) 
Seat 7: sanpidk ($101 in chips) 
Seat 8: ka100pka527 ($74.73 in chips) 
Seat 9: matiko09 ($200.05 in chips) 
sanpidk: posts small blind $0.50
ka100pka527: posts big blind $1
Effort92: sits out 
*** HOLE CARDS ***
Dealt to matiko09 [8s 5s]
matiko09: folds 
Red4erT: raises $2 to $3
holloway85: folds 
mitchymitch3: folds 
elbiber2000: calls $3
godfrey004: folds 
sanpidk: folds 
ka100pka527: folds 
*** FLOP *** [Kh 5h Ts]
Red4erT: checks 
elbiber2000: checks 
*** TURN *** [Kh 5h Ts] [9c]
Red4erT: checks 
elbiber2000: bets $5
Red4erT: folds 
Uncalled bet ($5) returned to elbiber2000
elbiber2000 collected $7.12 from pot
elbiber2000: doesn't show hand 
*** SUMMARY ***
Total pot $7.50 | Rake $0.38 
Board [Kh 5h Ts 9c]
Seat 1: Red4erT folded on the Turn
Seat 2: holloway85 folded before Flop (didn't bet)
Seat 3: mitchymitch3 folded before Flop (didn't bet)
Seat 5: elbiber2000 collected ($7.12)
Seat 6: godfrey004 (button) folded before Flop (didn't bet)
Seat 7: sanpidk (small blind) folded before Flop
Seat 8: ka100pka527 (big blind) folded before Flop
Seat 9: matiko09 folded before Flop (didn't bet)





PokerStars Hand #151165473573:  Hold'em No Limit ($0.50/$1.00 USD) - 2016/03/30 16:40:54 CET [2016/03/30 10:40:54 ET]
Table 'Pannonia II' 9-max Seat #2 is the button
Seat 1: CI58 ($101.12 in chips) 
Seat 2: matiko09 ($100 in chips) 
Seat 3: MGL_Sky99 ($102.72 in chips) 
Seat 4: ka100pka527 ($60.02 in chips) 
Seat 5: Spid1 ($130.12 in chips) 
Seat 8: stonymalony ($62.58 in chips) 
MGL_Sky99: posts small blind $0.50
ka100pka527: posts big blind $1
Effort92: sits out 
*** HOLE CARDS ***
Dealt to matiko09 [Tc 4d]
Spid1: folds 
stonymalony: folds 
CI58: folds 
matiko09: folds 
MGL_Sky99: folds 
Uncalled bet ($0.50) returned to ka100pka527
ka100pka527 collected $1 from pot
ka100pka527: doesn't show hand 
*** SUMMARY ***
Total pot $1 | Rake $0 
Seat 1: CI58 folded before Flop (didn't bet)
Seat 2: matiko09 (button) folded before Flop (didn't bet)
Seat 3: MGL_Sky99 (small blind) folded before Flop
Seat 4: ka100pka527 (big blind) collected ($1)
Seat 5: Spid1 folded before Flop (didn't bet)
Seat 8: stonymalony folded before Flop (didn't bet)





PokerStars Hand #151165479553:  Hold'em No Limit ($1/$2 USD) - 2016/03/30 16:41:03 CET [2016/03/30 10:41:03 ET]
Table 'Hektor III' 9-max Seat #5 is the button
Seat 1: matiko09 ($205.45 in chips) 
Seat 2: RamiroAgujis ($302.45 in chips) 
Seat 3: T0ny Adams ($103.43 in chips) 
Seat 5: prominente ($200 in chips) 
Seat 7: InsomniaRU ($209.04 in chips) 
Seat 8: tepi_guy ($207.71 in chips) 
InsomniaRU: posts small blind $1
tepi_guy: posts big blind $2
di0d80: sits out 
*** HOLE CARDS ***
Dealt to matiko09 [Ad 2h]
matiko09: folds 
RamiroAgujis: folds 
T0ny Adams: raises $3 to $5
prominente: folds 
InsomniaRU: raises $7 to $12
tepi_guy: folds 
T0ny Adams: folds 
Uncalled bet ($7) returned to InsomniaRU
InsomniaRU collected $12 from pot
InsomniaRU: doesn't show hand 
*** SUMMARY ***
Total pot $12 | Rake $0 
Seat 1: matiko09 folded before Flop (didn't bet)
Seat 2: RamiroAgujis folded before Flop (didn't bet)
Seat 3: T0ny Adams folded before Flop
Seat 5: prominente (button) folded before Flop (didn't bet)
Seat 7: InsomniaRU (small blind) collected ($12)
Seat 8: tepi_guy (big blind) folded before Flop





PokerStars Hand #151165484256:  Hold'em No Limit ($0.50/$1.00 USD) - 2016/03/30 16:41:10 CET [2016/03/30 10:41:10 ET]
Table 'Figneria III' 9-max Seat #7 is the button
Seat 1: matiko09 ($101.50 in chips) 
Seat 2: sanpidk ($109.70 in chips) 
Seat 4: CI58 ($112.95 in chips) 
Seat 5: b_____a__242 ($72.50 in chips) 
Seat 6: RICKA16 ($100 in chips) 
Seat 7: holloway85 ($204.57 in chips) 
Seat 9: p.snow89 ($90.70 in chips) 
p.snow89: posts small blind $0.50
matiko09: posts big blind $1
*** HOLE CARDS ***
Dealt to matiko09 [9d 7d]
sanpidk: folds 
CI58: folds 
b_____a__242: folds 
RICKA16: folds 
holloway85 has timed out
holloway85: folds 
p.snow89: calls $0.50
matiko09: raises $3 to $4
p.snow89: calls $3
*** FLOP *** [Kc 9s 5d]
p.snow89: checks 
matiko09: checks 
*** TURN *** [Kc 9s 5d] [Ts]
p.snow89: checks 
matiko09: checks 
*** RIVER *** [Kc 9s 5d Ts] [Js]
p.snow89: checks 
matiko09: checks 
*** SHOW DOWN ***
p.snow89: shows [6h 7h] (high card King)
matiko09: shows [9d 7d] (a pair of Nines)
matiko09 collected $7.60 from pot
*** SUMMARY ***
Total pot $8 | Rake $0.40 
Board [Kc 9s 5d Ts Js]
Seat 1: matiko09 (big blind) showed [9d 7d] and won ($7.60) with a pair of Nines
Seat 2: sanpidk folded before Flop (didn't bet)
Seat 4: CI58 folded before Flop (didn't bet)
Seat 5: b_____a__242 folded before Flop (didn't bet)
Seat 6: RICKA16 folded before Flop (didn't bet)
Seat 7: holloway85 (button) folded before Flop (didn't bet)
Seat 9: p.snow89 (small blind) showed [6h 7h] and lost with high card King





PokerStars Hand #151165492550:  Hold'em No Limit ($0.50/$1.00 USD) - 2016/03/30 16:41:22 CET [2016/03/30 10:41:22 ET]
Table 'Pannonia II' 9-max Seat #3 is the button
Seat 1: CI58 ($101.12 in chips) 
Seat 2: matiko09 ($100 in chips) 
Seat 3: MGL_Sky99 ($102.22 in chips) 
Seat 4: ka100pka527 ($60.52 in chips) 
Seat 5: Spid1 ($130.12 in chips) 
Seat 8: stonymalony ($62.58 in chips) 
ka100pka527: posts small blind $0.50
Spid1: posts big blind $1
Effort92: sits out 
*** HOLE CARDS ***
Dealt to matiko09 [4s 6h]
stonymalony: folds 
CI58: folds 
matiko09: folds 
MGL_Sky99: folds 
ka100pka527: raises $2 to $3
Spid1: raises $5 to $8
ka100pka527: calls $5
*** FLOP *** [Ad Jd 6s]
ka100pka527: checks 
Spid1: checks 
*** TURN *** [Ad Jd 6s] [Qh]
ka100pka527: checks 
Spid1: bets $9
ka100pka527: folds 
Uncalled bet ($9) returned to Spid1
Spid1 collected $15.20 from pot
Spid1: doesn't show hand 
*** SUMMARY ***
Total pot $16 | Rake $0.80 
Board [Ad Jd 6s Qh]
Seat 1: CI58 folded before Flop (didn't bet)
Seat 2: matiko09 folded before Flop (didn't bet)
Seat 3: MGL_Sky99 (button) folded before Flop (didn't bet)
Seat 4: ka100pka527 (small blind) folded on the Turn
Seat 5: Spid1 (big blind) collected ($15.20)
Seat 8: stonymalony folded before Flop (didn't bet)





PokerStars Hand #151165492628:  Hold'em No Limit ($1/$2 USD) - 2016/03/30 16:41:22 CET [2016/03/30 10:41:22 ET]
Table 'Philoctetes II' 9-max Seat #5 is the button
Seat 1: vezunchik79 ($145.38 in chips) 
Seat 2: prominente ($212.91 in chips) 
Seat 3: mentalpshyco ($226.55 in chips) 
Seat 4: tepi_guy ($200 in chips) 
Seat 5: zhaimeng ($349.51 in chips) 
Seat 7: matiko09 ($207.20 in chips) 
Seat 8: suddend3ath ($210 in chips) 
Seat 9: RamiroAgujis ($237.30 in chips) 
matiko09: posts small blind $1
suddend3ath: posts big blind $2
*** HOLE CARDS ***
Dealt to matiko09 [5c Qs]
RamiroAgujis: folds 
vezunchik79: folds 
prominente: folds 
mentalpshyco: folds 
tepi_guy: folds 
zhaimeng: raises $5 to $7
di0d80 joins the table at seat #6 
matiko09: folds 
suddend3ath: folds 
Uncalled bet ($5) returned to zhaimeng
zhaimeng collected $5 from pot
*** SUMMARY ***
Total pot $5 | Rake $0 
Seat 1: vezunchik79 folded before Flop (didn't bet)
Seat 2: prominente folded before Flop (didn't bet)
Seat 3: mentalpshyco folded before Flop (didn't bet)
Seat 4: tepi_guy folded before Flop (didn't bet)
Seat 5: zhaimeng (button) collected ($5)
Seat 7: matiko09 (small blind) folded before Flop
Seat 8: suddend3ath (big blind) folded before Flop
Seat 9: RamiroAgujis folded before Flop (didn't bet)





PokerStars Hand #151165503019:  Hold'em No Limit ($0.50/$1.00 USD) - 2016/03/30 16:41:27 CET [2016/03/30 10:41:27 ET]
Table 'Hadwiger' 9-max Seat #9 is the button
Seat 1: AKplus ($92.20 in chips) 
Seat 2: di0d80 ($103 in chips) 
Seat 3: sanpidk ($105.19 in chips) 
Seat 4: Westpants ($101.50 in chips) 
Seat 7: matiko09 ($100 in chips) 
Seat 9: IdiotFromNE ($105.67 in chips) 
AKplus: posts small blind $0.50
di0d80: posts big blind $1
Spid1: sits out 
19SERGE74: sits out 
*** HOLE CARDS ***
Dealt to matiko09 [7c 2h]
sanpidk: folds 
sanpidk leaves the table
Westpants: folds 
matiko09: folds 
IdiotFromNE: raises $1.50 to $2.50
AKplus: folds 
di0d80: folds 
Uncalled bet ($1.50) returned to IdiotFromNE
IdiotFromNE collected $2.50 from pot
IdiotFromNE: doesn't show hand 
*** SUMMARY ***
Total pot $2.50 | Rake $0 
Seat 1: AKplus (small blind) folded before Flop
Seat 2: di0d80 (big blind) folded before Flop
Seat 3: sanpidk folded before Flop (didn't bet)
Seat 4: Westpants folded before Flop (didn't bet)
Seat 7: matiko09 folded before Flop (didn't bet)
Seat 9: IdiotFromNE (button) collected ($2.50)





PokerStars Hand #151165508404:  Hold'em No Limit ($0.50/$1.00 USD) - 2016/03/30 16:41:35 CET [2016/03/30 10:41:35 ET]
Table 'Alcor II' 9-max Seat #7 is the button
Seat 1: Red4erT ($100 in chips) 
Seat 2: holloway85 ($71.84 in chips) 
Seat 3: mitchymitch3 ($100.22 in chips) 
Seat 5: elbiber2000 ($112.47 in chips) 
Seat 6: godfrey004 ($205.25 in chips) 
Seat 7: sanpidk ($100.50 in chips) 
Seat 8: ka100pka527 ($73.73 in chips) 
Seat 9: matiko09 ($200.05 in chips) 
ka100pka527: posts small blind $0.50
matiko09: posts big blind $1
Effort92: sits out 
*** HOLE CARDS ***
Dealt to matiko09 [6d Th]
Red4erT: raises $2 to $3
holloway85: folds 
mitchymitch3: folds 
elbiber2000: folds 
godfrey004: folds 
sanpidk: folds 
ka100pka527: folds 
matiko09: folds 
Uncalled bet ($2) returned to Red4erT
Red4erT collected $2.50 from pot
Red4erT: doesn't show hand 
*** SUMMARY ***
Total pot $2.50 | Rake $0 
Seat 1: Red4erT collected ($2.50)
Seat 2: holloway85 folded before Flop (didn't bet)
Seat 3: mitchymitch3 folded before Flop (didn't bet)
Seat 5: elbiber2000 folded before Flop (didn't bet)
Seat 6: godfrey004 folded before Flop (didn't bet)
Seat 7: sanpidk (button) folded before Flop (didn't bet)
Seat 8: ka100pka527 (small blind) folded before Flop
Seat 9: matiko09 (big blind) folded before Flop





PokerStars Hand #151165518235:  Hold'em No Limit ($0.50/$1.00 USD) - 2016/03/30 16:41:49 CET [2016/03/30 10:41:49 ET]
Table 'Hadwiger' 9-max Seat #1 is the button
Seat 1: AKplus ($91.70 in chips) 
Seat 2: di0d80 ($102 in chips) 
Seat 4: Westpants ($101.50 in chips) 
Seat 7: matiko09 ($100 in chips) 
Seat 9: IdiotFromNE ($107.17 in chips) 
di0d80: posts small blind $0.50
Westpants: posts big blind $1
Spid1: sits out 
19SERGE74: sits out 
*** HOLE CARDS ***
Dealt to matiko09 [Js Kd]
matiko09: folds 
xrisall_2 joins the table at seat #6 
IdiotFromNE: folds 
yuminyumin1 joins the table at seat #3 
AKplus: folds 
di0d80: folds 
Uncalled bet ($0.50) returned to Westpants
Spid1 leaves the table
Westpants collected $1 from pot
*** SUMMARY ***
Total pot $1 | Rake $0 
Seat 1: AKplus (button) folded before Flop (didn't bet)
Seat 2: di0d80 (small blind) folded before Flop
Seat 4: Westpants (big blind) collected ($1)
Seat 7: matiko09 folded before Flop (didn't bet)
Seat 9: IdiotFromNE folded before Flop (didn't bet)





PokerStars Hand #151165521735:  Hold'em No Limit ($1/$2 USD) - 2016/03/30 16:41:55 CET [2016/03/30 10:41:55 ET]
Table 'Aesculapia II' 9-max Seat #5 is the button
Seat 1: buthmen ($91.99 in chips) 
Seat 2: suddend3ath ($338.25 in chips) 
Seat 3: matiko09 ($695.85 in chips) 
Seat 4: tepi_guy ($204.61 in chips) 
Seat 5: prominente ($200 in chips) 
Seat 6: mentalpshyco ($200 in chips) 
Seat 7: Rumboni66 ($115.49 in chips) 
Seat 9: InsomniaRU ($205.06 in chips) 
mentalpshyco: posts small blind $1
Rumboni66: posts big blind $2
*** HOLE CARDS ***
Dealt to matiko09 [4s 6d]
tipner leaves the table
InsomniaRU: raises $3 to $5
buthmen: calls $5
suddend3ath: folds 
matiko09: folds 
tepi_guy: calls $5
prominente: folds 
mentalpshyco: folds 
Rumboni66: calls $3
*** FLOP *** [Qc 4h 9c]
Rumboni66: checks 
InsomniaRU: checks 
buthmen: checks 
tepi_guy: checks 
*** TURN *** [Qc 4h 9c] [Ah]
Rumboni66: checks 
InsomniaRU: bets $7.98
buthmen: raises $17.95 to $25.93
tepi_guy: folds 
Rumboni66: folds 
InsomniaRU: folds 
Uncalled bet ($17.95) returned to buthmen
buthmen collected $35.11 from pot
buthmen: doesn't show hand 
*** SUMMARY ***
Total pot $36.96 | Rake $1.85 
Board [Qc 4h 9c Ah]
Seat 1: buthmen collected ($35.11)
Seat 2: suddend3ath folded before Flop (didn't bet)
Seat 3: matiko09 folded before Flop (didn't bet)
Seat 4: tepi_guy folded on the Turn
Seat 5: prominente (button) folded before Flop (didn't bet)
Seat 6: mentalpshyco (small blind) folded before Flop
Seat 7: Rumboni66 (big blind) folded on the Turn
Seat 9: InsomniaRU folded on the Turn





PokerStars Hand #151165523688:  Hold'em No Limit ($0.50/$1.00 USD) - 2016/03/30 16:41:58 CET [2016/03/30 10:41:58 ET]
Table 'Alcor II' 9-max Seat #8 is the button
Seat 1: Red4erT ($101.50 in chips) 
Seat 2: holloway85 ($71.84 in chips) 
Seat 3: mitchymitch3 ($100.22 in chips) 
Seat 5: elbiber2000 ($112.47 in chips) 
Seat 6: godfrey004 ($205.25 in chips) 
Seat 7: sanpidk ($100.50 in chips) 
Seat 8: ka100pka527 ($73.23 in chips) 
Seat 9: matiko09 ($199.05 in chips) 
matiko09: posts small blind $0.50
Red4erT: posts big blind $1
Effort92: sits out 
*** HOLE CARDS ***
Dealt to matiko09 [5h Kc]
holloway85 has timed out
holloway85: folds 
mitchymitch3: folds 
elbiber2000: folds 
godfrey004: calls $1
sanpidk: folds 
ka100pka527: folds 
matiko09: folds 
Red4erT: checks 
*** FLOP *** [Ac 2c 5s]
Red4erT: checks 
godfrey004: bets $2
Red4erT: folds 
Uncalled bet ($2) returned to godfrey004
godfrey004 collected $2.38 from pot
godfrey004: doesn't show hand 
*** SUMMARY ***
Total pot $2.50 | Rake $0.12 
Board [Ac 2c 5s]
Seat 1: Red4erT (big blind) folded on the Flop
Seat 2: holloway85 folded before Flop (didn't bet)
Seat 3: mitchymitch3 folded before Flop (didn't bet)
Seat 5: elbiber2000 folded before Flop (didn't bet)
Seat 6: godfrey004 collected ($2.38)
Seat 7: sanpidk folded before Flop (didn't bet)
Seat 8: ka100pka527 (button) folded before Flop (didn't bet)
Seat 9: matiko09 (small blind) folded before Flop





PokerStars Hand #151165527900:  Hold'em No Limit ($1/$2 USD) - 2016/03/30 16:42:04 CET [2016/03/30 10:42:04 ET]
Table 'Philoctetes II' 9-max Seat #7 is the button
Seat 1: vezunchik79 ($145.38 in chips) 
Seat 2: prominente ($212.91 in chips) 
Seat 3: mentalpshyco ($226.55 in chips) 
Seat 4: tepi_guy ($200 in chips) 
Seat 5: zhaimeng ($352.51 in chips) 
Seat 7: matiko09 ($206.20 in chips) 
Seat 8: suddend3ath ($208 in chips) 
Seat 9: RamiroAgujis ($237.30 in chips) 
suddend3ath: posts small blind $1
RamiroAgujis: posts big blind $2
di0d80: sits out 
*** HOLE CARDS ***
Dealt to matiko09 [Th 8s]
vezunchik79: raises $2 to $4
prominente: folds 
mentalpshyco: folds 
tepi_guy: folds 
zhaimeng: folds 
matiko09: folds 
suddend3ath: folds 
RamiroAgujis: folds 
Uncalled bet ($2) returned to vezunchik79
vezunchik79 collected $5 from pot
vezunchik79: doesn't show hand 
*** SUMMARY ***
Total pot $5 | Rake $0 
Seat 1: vezunchik79 collected ($5)
Seat 2: prominente folded before Flop (didn't bet)
Seat 3: mentalpshyco folded before Flop (didn't bet)
Seat 4: tepi_guy folded before Flop (didn't bet)
Seat 5: zhaimeng folded before Flop (didn't bet)
Seat 7: matiko09 (button) folded before Flop (didn't bet)
Seat 8: suddend3ath (small blind) folded before Flop
Seat 9: RamiroAgujis (big blind) folded before Flop





PokerStars Hand #151165537512:  Hold'em No Limit ($0.50/$1.00 USD) - 2016/03/30 16:42:18 CET [2016/03/30 10:42:18 ET]
Table 'Hadwiger' 9-max Seat #2 is the button
Seat 1: AKplus ($91.70 in chips) 
Seat 2: di0d80 ($101.50 in chips) 
Seat 4: Westpants ($102 in chips) 
Seat 6: xrisall_2 ($80 in chips) 
Seat 7: matiko09 ($100 in chips) 
Seat 9: IdiotFromNE ($107.17 in chips) 
yuminyumin1 will be allowed to play after the button
Westpants: posts small blind $0.50
xrisall_2: posts big blind $1
19SERGE74: sits out 
*** HOLE CARDS ***
Dealt to matiko09 [Qh 6h]
matiko09: folds 
IdiotFromNE: folds 
ardo888 joins the table at seat #5 
AKplus: folds 
di0d80: raises $1 to $2
Westpants: folds 
xrisall_2: calls $1
*** FLOP *** [Kd 2c 4d]
xrisall_2: checks 
di0d80: checks 
*** TURN *** [Kd 2c 4d] [4c]
xrisall_2: checks 
di0d80: bets $3
xrisall_2: folds 
Uncalled bet ($3) returned to di0d80
di0d80 collected $4.28 from pot
di0d80: doesn't show hand 
*** SUMMARY ***
Total pot $4.50 | Rake $0.22 
Board [Kd 2c 4d 4c]
Seat 1: AKplus folded before Flop (didn't bet)
Seat 2: di0d80 (button) collected ($4.28)
Seat 4: Westpants (small blind) folded before Flop
Seat 6: xrisall_2 (big blind) folded on the Turn
Seat 7: matiko09 folded before Flop (didn't bet)
Seat 9: IdiotFromNE folded before Flop (didn't bet)





PokerStars Hand #151165542136:  Hold'em No Limit ($0.50/$1.00 USD) - 2016/03/30 16:42:25 CET [2016/03/30 10:42:25 ET]
Table 'Figneria III' 9-max Seat #9 is the button
Seat 1: matiko09 ($105.10 in chips) 
Seat 2: sanpidk ($109.70 in chips) 
Seat 4: CI58 ($112.95 in chips) 
Seat 5: b_____a__242 ($72.50 in chips) 
Seat 6: RICKA16 ($100 in chips) 
Seat 7: holloway85 ($204.57 in chips) 
Seat 9: p.snow89 ($86.70 in chips) 
matiko09: posts small blind $0.50
sanpidk: posts big blind $1
*** HOLE CARDS ***
Dealt to matiko09 [Tc 4c]
CI58: folds 
b_____a__242: folds 
RICKA16: folds 
holloway85: folds 
p.snow89: calls $1
matiko09: folds 
sanpidk: checks 
*** FLOP *** [3d Qh Ks]
sanpidk: checks 
p.snow89: bets $4
sanpidk: folds 
Uncalled bet ($4) returned to p.snow89
p.snow89 collected $2.38 from pot
p.snow89: doesn't show hand 
*** SUMMARY ***
Total pot $2.50 | Rake $0.12 
Board [3d Qh Ks]
Seat 1: matiko09 (small blind) folded before Flop
Seat 2: sanpidk (big blind) folded on the Flop
Seat 4: CI58 folded before Flop (didn't bet)
Seat 5: b_____a__242 folded before Flop (didn't bet)
Seat 6: RICKA16 folded before Flop (didn't bet)
Seat 7: holloway85 folded before Flop (didn't bet)
Seat 9: p.snow89 (button) collected ($2.38)





PokerStars Hand #151165563864:  Hold'em No Limit ($0.50/$1.00 USD) - 2016/03/30 16:42:56 CET [2016/03/30 10:42:56 ET]
Table 'Pannonia II' 9-max Seat #4 is the button
Seat 1: CI58 ($101.12 in chips) 
Seat 2: matiko09 ($100 in chips) 
Seat 3: MGL_Sky99 ($102.22 in chips) 
Seat 4: ka100pka527 ($52.52 in chips) 
Seat 5: Spid1 ($137.32 in chips) 
Seat 6: lumen21 ($113 in chips) 
Seat 8: stonymalony ($62.58 in chips) 
Spid1: posts small blind $0.50
lumen21: posts big blind $1
Effort92: sits out 
*** HOLE CARDS ***
Dealt to matiko09 [Td Ad]
stonymalony: raises $1 to $2
CI58: folds 
matiko09: calls $2
MGL_Sky99: folds 
ka100pka527: folds 
Spid1: calls $1.50
lumen21: calls $1
*** FLOP *** [5s Kc As]
Spid1: checks 
lumen21: checks 
stonymalony: bets $3
matiko09: calls $3
Spid1: folds 
lumen21: calls $3
*** TURN *** [5s Kc As] [9d]
lumen21: checks 
stonymalony: bets $10
matiko09: calls $10
lumen21: folds 
*** RIVER *** [5s Kc As 9d] [7s]
stonymalony: bets $11
matiko09: calls $11
*** SHOW DOWN ***
stonymalony: shows [Ks 9s] (a flush, Ace high)
matiko09: mucks hand 
stonymalony collected $56.50 from pot
*** SUMMARY ***
Total pot $59 | Rake $2.50 
Board [5s Kc As 9d 7s]
Seat 1: CI58 folded before Flop (didn't bet)
Seat 2: matiko09 mucked [Td Ad]
Seat 3: MGL_Sky99 folded before Flop (didn't bet)
Seat 4: ka100pka527 (button) folded before Flop (didn't bet)
Seat 5: Spid1 (small blind) folded on the Flop
Seat 6: lumen21 (big blind) folded on the Turn
Seat 8: stonymalony showed [Ks 9s] and won ($56.50) with a flush, Ace high





PokerStars Hand #151165568213:  Hold'em No Limit ($1/$2 USD) - 2016/03/30 16:43:02 CET [2016/03/30 10:43:02 ET]
Table 'Philoctetes II' 9-max Seat #8 is the button
Seat 1: vezunchik79 ($148.38 in chips) 
Seat 2: prominente ($212.91 in chips) 
Seat 3: mentalpshyco ($226.55 in chips) 
Seat 4: tepi_guy ($200 in chips) 
Seat 5: zhaimeng ($352.51 in chips) 
Seat 7: matiko09 ($206.20 in chips) 
Seat 8: suddend3ath ($207 in chips) 
Seat 9: RamiroAgujis ($235.30 in chips) 
RamiroAgujis: posts small blind $1
vezunchik79: posts big blind $2
di0d80: sits out 
*** HOLE CARDS ***
Dealt to matiko09 [4c 6h]
prominente: folds 
mentalpshyco: folds 
tepi_guy: raises $3.40 to $5.40
zhaimeng: calls $5.40
matiko09: folds 
suddend3ath: folds 
RamiroAgujis: folds 
vezunchik79: folds 
*** FLOP *** [6s 5s 4d]
tepi_guy: checks 
zhaimeng: bets $13.11
tepi_guy: folds 
Uncalled bet ($13.11) returned to zhaimeng
zhaimeng collected $13.11 from pot
zhaimeng: doesn't show hand 
*** SUMMARY ***
Total pot $13.80 | Rake $0.69 
Board [6s 5s 4d]
Seat 1: vezunchik79 (big blind) folded before Flop
Seat 2: prominente folded before Flop (didn't bet)
Seat 3: mentalpshyco folded before Flop (didn't bet)
Seat 4: tepi_guy folded on the Flop
Seat 5: zhaimeng collected ($13.11)
Seat 7: matiko09 folded before Flop (didn't bet)
Seat 8: suddend3ath (button) folded before Flop (didn't bet)
Seat 9: RamiroAgujis (small blind) folded before Flop





PokerStars Hand #151165568871:  Hold'em No Limit ($0.50/$1.00 USD) - 2016/03/30 16:43:03 CET [2016/03/30 10:43:03 ET]
Table 'Hadwiger' 9-max Seat #4 is the button
Seat 1: AKplus ($91.70 in chips) 
Seat 2: di0d80 ($103.78 in chips) 
Seat 4: Westpants ($101.50 in chips) 
Seat 6: xrisall_2 ($78 in chips) 
Seat 7: matiko09 ($100 in chips) 
Seat 9: IdiotFromNE ($107.17 in chips) 
ardo888 will be allowed to play after the button
xrisall_2: posts small blind $0.50
matiko09: posts big blind $1
19SERGE74: sits out 
yuminyumin1: sits out 
*** HOLE CARDS ***
Dealt to matiko09 [Ts As]
IdiotFromNE: folds 
AKplus: folds 
di0d80: raises $1.50 to $2.50
Westpants: calls $2.50
xrisall_2: folds 
matiko09: calls $1.50
*** FLOP *** [Tc 6d Td]
matiko09: checks 
di0d80: checks 
Westpants: bets $5.01
matiko09: raises $8.99 to $14
di0d80: folds 
Westpants: folds 
Uncalled bet ($8.99) returned to matiko09
matiko09 collected $17.12 from pot
matiko09: doesn't show hand 
*** SUMMARY ***
Total pot $18.02 | Rake $0.90 
Board [Tc 6d Td]
Seat 1: AKplus folded before Flop (didn't bet)
Seat 2: di0d80 folded on the Flop
Seat 4: Westpants (button) folded on the Flop
Seat 6: xrisall_2 (small blind) folded before Flop
Seat 7: matiko09 (big blind) collected ($17.12)
Seat 9: IdiotFromNE folded before Flop (didn't bet)





PokerStars Hand #151165575095:  Hold'em No Limit ($0.50/$1.00 USD) - 2016/03/30 16:43:13 CET [2016/03/30 10:43:13 ET]
Table 'Alcor II' 9-max Seat #9 is the button
Seat 1: Red4erT ($100.50 in chips) 
Seat 2: holloway85 ($71.84 in chips) 
Seat 3: mitchymitch3 ($100.22 in chips) 
Seat 5: elbiber2000 ($112.47 in chips) 
Seat 6: godfrey004 ($206.63 in chips) 
Seat 7: sanpidk ($100.50 in chips) 
Seat 8: ka100pka527 ($73.23 in chips) 
Seat 9: matiko09 ($198.55 in chips) 
Red4erT: posts small blind $0.50
holloway85: posts big blind $1
Effort92: sits out 
*** HOLE CARDS ***
Dealt to matiko09 [3c 8h]
mitchymitch3: folds 
elbiber2000: folds 
godfrey004: folds 
sanpidk: folds 
ka100pka527: folds 
matiko09: folds 
Red4erT: folds 
Uncalled bet ($0.50) returned to holloway85
holloway85 collected $1 from pot
holloway85: doesn't show hand 
*** SUMMARY ***
Total pot $1 | Rake $0 
Seat 1: Red4erT (small blind) folded before Flop
Seat 2: holloway85 (big blind) collected ($1)
Seat 3: mitchymitch3 folded before Flop (didn't bet)
Seat 5: elbiber2000 folded before Flop (didn't bet)
Seat 6: godfrey004 folded before Flop (didn't bet)
Seat 7: sanpidk folded before Flop (didn't bet)
Seat 8: ka100pka527 folded before Flop (didn't bet)
Seat 9: matiko09 (button) folded before Flop (didn't bet)





PokerStars Hand #151165579341:  Hold'em No Limit ($0.50/$1.00 USD) - 2016/03/30 16:43:19 CET [2016/03/30 10:43:19 ET]
Table 'Figneria III' 9-max Seat #1 is the button
Seat 1: matiko09 ($104.60 in chips) 
Seat 2: sanpidk ($108.70 in chips) 
Seat 3: lumen21 ($117.45 in chips) 
Seat 4: CI58 ($112.95 in chips) 
Seat 5: b_____a__242 ($72.50 in chips) 
Seat 6: RICKA16 ($100 in chips) 
Seat 7: holloway85 ($204.57 in chips) 
Seat 9: p.snow89 ($88.08 in chips) 
sanpidk: posts small blind $0.50
lumen21: posts big blind $1
*** HOLE CARDS ***
Dealt to matiko09 [Jh 6d]
CI58: raises $2 to $3
b_____a__242: folds 
RICKA16: folds 
holloway85: folds 
p.snow89: folds 
matiko09: folds 
sanpidk: folds 
lumen21: folds 
Uncalled bet ($2) returned to CI58
CI58 collected $2.50 from pot
CI58: doesn't show hand 
*** SUMMARY ***
Total pot $2.50 | Rake $0 
Seat 1: matiko09 (button) folded before Flop (didn't bet)
Seat 2: sanpidk (small blind) folded before Flop
Seat 3: lumen21 (big blind) folded before Flop
Seat 4: CI58 collected ($2.50)
Seat 5: b_____a__242 folded before Flop (didn't bet)
Seat 6: RICKA16 folded before Flop (didn't bet)
Seat 7: holloway85 folded before Flop (didn't bet)
Seat 9: p.snow89 folded before Flop (didn't bet)





PokerStars Hand #151165580038:  Hold'em No Limit ($1/$2 USD) - 2016/03/30 16:43:20 CET [2016/03/30 10:43:20 ET]
Table 'Aesculapia II' 9-max Seat #6 is the button
Seat 1: buthmen ($114.12 in chips) 
Seat 2: suddend3ath ($338.25 in chips) 
Seat 3: matiko09 ($695.85 in chips) 
Seat 4: tepi_guy ($200 in chips) 
Seat 5: prominente ($200 in chips) 
Seat 6: mentalpshyco ($200 in chips) 
Seat 7: Rumboni66 ($110.49 in chips) 
Seat 9: InsomniaRU ($200 in chips) 
Rumboni66: posts small blind $1
InsomniaRU: posts big blind $2
*** HOLE CARDS ***
Dealt to matiko09 [7c Ks]
buthmen: folds 
suddend3ath: raises $3 to $5
matiko09: folds 
tepi_guy: calls $5
prominente: folds 
mentalpshyco: folds 
Rumboni66: folds 
InsomniaRU: folds 
*** FLOP *** [7s 9s 2s]
suddend3ath: checks 
tepi_guy: checks 
*** TURN *** [7s 9s 2s] [Tc]
suddend3ath: checks 
tepi_guy: bets $7.90
suddend3ath: folds 
Uncalled bet ($7.90) returned to tepi_guy
tepi_guy collected $12.35 from pot
tepi_guy: doesn't show hand 
*** SUMMARY ***
Total pot $13 | Rake $0.65 
Board [7s 9s 2s Tc]
Seat 1: buthmen folded before Flop (didn't bet)
Seat 2: suddend3ath folded on the Turn
Seat 3: matiko09 folded before Flop (didn't bet)
Seat 4: tepi_guy collected ($12.35)
Seat 5: prominente folded before Flop (didn't bet)
Seat 6: mentalpshyco (button) folded before Flop (didn't bet)
Seat 7: Rumboni66 (small blind) folded before Flop
Seat 9: InsomniaRU (big blind) folded before Flop





PokerStars Hand #151165591724:  Hold'em No Limit ($0.50/$1.00 USD) - 2016/03/30 16:43:37 CET [2016/03/30 10:43:37 ET]
Table 'Alcor II' 9-max Seat #1 is the button
Seat 1: Red4erT ($100 in chips) 
Seat 2: holloway85 ($72.34 in chips) 
Seat 3: mitchymitch3 ($100.22 in chips) 
Seat 5: elbiber2000 ($112.47 in chips) 
Seat 6: godfrey004 ($206.63 in chips) 
Seat 7: sanpidk ($100.50 in chips) 
Seat 8: ka100pka527 ($73.23 in chips) 
Seat 9: matiko09 ($198.55 in chips) 
holloway85: posts small blind $0.50
mitchymitch3: posts big blind $1
Effort92: sits out 
*** HOLE CARDS ***
Dealt to matiko09 [3s Ad]
elbiber2000: folds 
godfrey004: raises $3 to $4
sanpidk: folds 
ka100pka527: folds 
matiko09: folds 
Red4erT: calls $4
holloway85: folds 
mitchymitch3: calls $3
*** FLOP *** [9h Qs 4d]
mitchymitch3: checks 
godfrey004: checks 
Red4erT: checks 
*** TURN *** [9h Qs 4d] [5s]
mitchymitch3: checks 
godfrey004: checks 
Red4erT: bets $8.91
mitchymitch3: folds 
godfrey004: folds [As Jd]
Uncalled bet ($8.91) returned to Red4erT
Red4erT collected $11.88 from pot
Red4erT: doesn't show hand 
*** SUMMARY ***
Total pot $12.50 | Rake $0.62 
Board [9h Qs 4d 5s]
Seat 1: Red4erT (button) collected ($11.88)
Seat 2: holloway85 (small blind) folded before Flop
Seat 3: mitchymitch3 (big blind) folded on the Turn
Seat 5: elbiber2000 folded before Flop (didn't bet)
Seat 6: godfrey004 folded on the Turn
Seat 7: sanpidk folded before Flop (didn't bet)
Seat 8: ka100pka527 folded before Flop (didn't bet)
Seat 9: matiko09 folded before Flop (didn't bet)





PokerStars Hand #151165613721:  Hold'em No Limit ($1/$2 USD) - 2016/03/30 16:44:09 CET [2016/03/30 10:44:09 ET]
Table 'Aesculapia II' 9-max Seat #7 is the button
Seat 1: buthmen ($114.12 in chips) 
Seat 2: suddend3ath ($333.25 in chips) 
Seat 3: matiko09 ($695.85 in chips) 
Seat 4: tepi_guy ($207.35 in chips) 
Seat 5: prominente ($200 in chips) 
Seat 6: mentalpshyco ($200 in chips) 
Seat 7: Rumboni66 ($109.49 in chips) 
Seat 9: InsomniaRU ($200 in chips) 
InsomniaRU: posts small blind $1
buthmen: posts big blind $2
*** HOLE CARDS ***
Dealt to matiko09 [7d Ac]
suddend3ath: folds 
matiko09: folds 
tepi_guy: folds 
prominente: raises $3 to $5
mentalpshyco: folds 
Rumboni66: folds 
InsomniaRU: folds 
buthmen: calls $3
*** FLOP *** [6s Jh Ad]
buthmen: checks 
prominente: checks 
*** TURN *** [6s Jh Ad] [9s]
buthmen: bets $5.22
prominente: calls $5.22
*** RIVER *** [6s Jh Ad 9s] [6d]
buthmen: bets $10.18
prominente: folds 
Uncalled bet ($10.18) returned to buthmen
buthmen collected $20.37 from pot
buthmen: doesn't show hand 
*** SUMMARY ***
Total pot $21.44 | Rake $1.07 
Board [6s Jh Ad 9s 6d]
Seat 1: buthmen (big blind) collected ($20.37)
Seat 2: suddend3ath folded before Flop (didn't bet)
Seat 3: matiko09 folded before Flop (didn't bet)
Seat 4: tepi_guy folded before Flop (didn't bet)
Seat 5: prominente folded on the River
Seat 6: mentalpshyco folded before Flop (didn't bet)
Seat 7: Rumboni66 (button) folded before Flop (didn't bet)
Seat 9: InsomniaRU (small blind) folded before Flop





PokerStars Hand #151165614847:  Hold'em No Limit ($0.50/$1.00 USD) - 2016/03/30 16:44:11 CET [2016/03/30 10:44:11 ET]
Table 'Figneria III' 9-max Seat #2 is the button
Seat 1: matiko09 ($104.60 in chips) 
Seat 2: sanpidk ($108.20 in chips) 
Seat 3: lumen21 ($116.45 in chips) 
Seat 4: CI58 ($114.45 in chips) 
Seat 5: b_____a__242 ($72.50 in chips) 
Seat 6: RICKA16 ($100 in chips) 
Seat 7: holloway85 ($204.57 in chips) 
Seat 9: p.snow89 ($88.08 in chips) 
lumen21: posts small blind $0.50
CI58: posts big blind $1
*** HOLE CARDS ***
Dealt to matiko09 [2c Ah]
b_____a__242: folds 
RICKA16: folds 
holloway85: calls $1
p.snow89: calls $1
matiko09: folds 
sanpidk: folds 
lumen21: raises $4 to $5
CI58: folds 
holloway85: calls $4
p.snow89: calls $4
*** FLOP *** [7d 5s 4d]
lumen21: checks 
holloway85: checks 
p.snow89: bets $7
lumen21: folds 
holloway85: folds 
Uncalled bet ($7) returned to p.snow89
p.snow89 collected $15.20 from pot
p.snow89: doesn't show hand 
*** SUMMARY ***
Total pot $16 | Rake $0.80 
Board [7d 5s 4d]
Seat 1: matiko09 folded before Flop (didn't bet)
Seat 2: sanpidk (button) folded before Flop (didn't bet)
Seat 3: lumen21 (small blind) folded on the Flop
Seat 4: CI58 (big blind) folded before Flop
Seat 5: b_____a__242 folded before Flop (didn't bet)
Seat 6: RICKA16 folded before Flop (didn't bet)
Seat 7: holloway85 folded on the Flop
Seat 9: p.snow89 collected ($15.20)





PokerStars Hand #151165616638:  Hold'em No Limit ($0.50/$1.00 USD) - 2016/03/30 16:44:13 CET [2016/03/30 10:44:13 ET]
Table 'Hadwiger' 9-max Seat #6 is the button
Seat 1: AKplus ($91.70 in chips) 
Seat 2: di0d80 ($101.28 in chips) 
Seat 4: Westpants ($100 in chips) 
Seat 6: xrisall_2 ($77.50 in chips) 
Seat 7: matiko09 ($109.61 in chips) 
Seat 8: 19SERGE74 ($60 in chips) 
Seat 9: IdiotFromNE ($107.17 in chips) 
matiko09: posts small blind $0.50
19SERGE74: posts big blind $1
yuminyumin1: sits out 
ardo888: sits out 
*** HOLE CARDS ***
Dealt to matiko09 [2d Ah]
IdiotFromNE: folds 
AKplus: folds 
di0d80: folds 
Westpants: folds 
xrisall_2: raises $2 to $3
matiko09: folds 
19SERGE74: folds 
Uncalled bet ($2) returned to xrisall_2
xrisall_2 collected $2.50 from pot
xrisall_2: doesn't show hand 
*** SUMMARY ***
Total pot $2.50 | Rake $0 
Seat 1: AKplus folded before Flop (didn't bet)
Seat 2: di0d80 folded before Flop (didn't bet)
Seat 4: Westpants folded before Flop (didn't bet)
Seat 6: xrisall_2 (button) collected ($2.50)
Seat 7: matiko09 (small blind) folded before Flop
Seat 8: 19SERGE74 (big blind) folded before Flop
Seat 9: IdiotFromNE folded before Flop (didn't bet)





PokerStars Hand #151165621068:  Hold'em No Limit ($0.50/$1.00 USD) - 2016/03/30 16:44:20 CET [2016/03/30 10:44:20 ET]
Table 'Pannonia II' 9-max Seat #5 is the button
Seat 1: CI58 ($101.12 in chips) 
Seat 2: matiko09 ($100 in chips) 
Seat 3: MGL_Sky99 ($102.22 in chips) 
Seat 4: ka100pka527 ($52.52 in chips) 
Seat 5: Spid1 ($135.32 in chips) 
Seat 6: lumen21 ($108 in chips) 
Seat 8: stonymalony ($93.08 in chips) 
lumen21: posts small blind $0.50
stonymalony: posts big blind $1
Effort92: sits out 
*** HOLE CARDS ***
Dealt to matiko09 [4s 4d]
CI58: folds 
matiko09: raises $2 to $3
MGL_Sky99: folds 
ka100pka527: folds 
Spid1: folds 
lumen21: folds 
stonymalony: calls $2
*** FLOP *** [Ks Qd 5h]
stonymalony: checks 
matiko09: checks 
*** TURN *** [Ks Qd 5h] [8d]
stonymalony: bets $3
matiko09: folds 
Uncalled bet ($3) returned to stonymalony
stonymalony collected $6.18 from pot
stonymalony: doesn't show hand 
*** SUMMARY ***
Total pot $6.50 | Rake $0.32 
Board [Ks Qd 5h 8d]
Seat 1: CI58 folded before Flop (didn't bet)
Seat 2: matiko09 folded on the Turn
Seat 3: MGL_Sky99 folded before Flop (didn't bet)
Seat 4: ka100pka527 folded before Flop (didn't bet)
Seat 5: Spid1 (button) folded before Flop (didn't bet)
Seat 6: lumen21 (small blind) folded before Flop
Seat 8: stonymalony (big blind) collected ($6.18)





PokerStars Hand #151165621351:  Hold'em No Limit ($1/$2 USD) - 2016/03/30 16:44:20 CET [2016/03/30 10:44:20 ET]
Table 'Philoctetes II' 9-max Seat #9 is the button
Seat 1: vezunchik79 ($146.38 in chips) 
Seat 2: prominente ($212.91 in chips) 
Seat 3: mentalpshyco ($226.55 in chips) 
Seat 4: tepi_guy ($200 in chips) 
Seat 5: zhaimeng ($360.22 in chips) 
Seat 7: matiko09 ($206.20 in chips) 
Seat 8: suddend3ath ($207 in chips) 
Seat 9: RamiroAgujis ($234.30 in chips) 
vezunchik79: posts small blind $1
prominente: posts big blind $2
di0d80: sits out 
*** HOLE CARDS ***
Dealt to matiko09 [5h 4d]
mentalpshyco: folds 
tepi_guy: folds 
zhaimeng: folds 
matiko09: folds 
suddend3ath: raises $3 to $5
RamiroAgujis: folds 
vezunchik79: folds 
prominente: raises $13 to $18
suddend3ath: folds 
Uncalled bet ($13) returned to prominente
prominente collected $11 from pot
prominente: doesn't show hand 
*** SUMMARY ***
Total pot $11 | Rake $0 
Seat 1: vezunchik79 (small blind) folded before Flop
Seat 2: prominente (big blind) collected ($11)
Seat 3: mentalpshyco folded before Flop (didn't bet)
Seat 4: tepi_guy folded before Flop (didn't bet)
Seat 5: zhaimeng folded before Flop (didn't bet)
Seat 7: matiko09 folded before Flop (didn't bet)
Seat 8: suddend3ath folded before Flop
Seat 9: RamiroAgujis (button) folded before Flop (didn't bet)





PokerStars Hand #151165639260:  Hold'em No Limit ($0.50/$1.00 USD) - 2016/03/30 16:44:47 CET [2016/03/30 10:44:47 ET]
Table 'Alcor II' 9-max Seat #2 is the button
Seat 1: Red4erT ($107.88 in chips) 
Seat 2: holloway85 ($71.84 in chips) 
Seat 3: mitchymitch3 ($96.22 in chips) 
Seat 4: Effort92 ($100 in chips) 
Seat 5: elbiber2000 ($112.47 in chips) 
Seat 6: godfrey004 ($202.63 in chips) 
Seat 7: sanpidk ($100.50 in chips) 
Seat 8: ka100pka527 ($73.23 in chips) 
Seat 9: matiko09 ($198.55 in chips) 
mitchymitch3: posts small blind $0.50
Effort92: posts big blind $1
*** HOLE CARDS ***
Dealt to matiko09 [8s Kc]
elbiber2000: folds 
godfrey004: calls $1
sanpidk: raises $3.50 to $4.50
ka100pka527: folds 
matiko09: folds 
Red4erT: folds 
holloway85: folds 
mitchymitch3: folds 
Effort92: folds 
godfrey004: calls $3.50
*** FLOP *** [4h 6c 2h]
godfrey004: checks 
sanpidk: checks 
*** TURN *** [4h 6c 2h] [Qd]
godfrey004: checks 
sanpidk: checks 
*** RIVER *** [4h 6c 2h Qd] [8c]
godfrey004: bets $4
sanpidk: folds 
Uncalled bet ($4) returned to godfrey004
godfrey004 collected $9.98 from pot
godfrey004: doesn't show hand 
*** SUMMARY ***
Total pot $10.50 | Rake $0.52 
Board [4h 6c 2h Qd 8c]
Seat 1: Red4erT folded before Flop (didn't bet)
Seat 2: holloway85 (button) folded before Flop (didn't bet)
Seat 3: mitchymitch3 (small blind) folded before Flop
Seat 4: Effort92 (big blind) folded before Flop
Seat 5: elbiber2000 folded before Flop (didn't bet)
Seat 6: godfrey004 collected ($9.98)
Seat 7: sanpidk folded on the River
Seat 8: ka100pka527 folded before Flop (didn't bet)
Seat 9: matiko09 folded before Flop (didn't bet)





PokerStars Hand #151165642177:  Hold'em No Limit ($0.50/$1.00 USD) - 2016/03/30 16:44:51 CET [2016/03/30 10:44:51 ET]
Table 'Hadwiger' 9-max Seat #7 is the button
Seat 1: AKplus ($91.70 in chips) 
Seat 2: di0d80 ($101.28 in chips) 
Seat 4: Westpants ($100 in chips) 
Seat 6: xrisall_2 ($79 in chips) 
Seat 7: matiko09 ($109.11 in chips) 
Seat 8: 19SERGE74 ($60 in chips) 
Seat 9: IdiotFromNE ($107.17 in chips) 
19SERGE74: posts small blind $0.50
IdiotFromNE: posts big blind $1
yuminyumin1: sits out 
ardo888: sits out 
*** HOLE CARDS ***
Dealt to matiko09 [3c 2h]
AKplus: folds 
di0d80: folds 
Westpants: folds 
xrisall_2: folds 
matiko09: folds 
19SERGE74: folds 
Uncalled bet ($0.50) returned to IdiotFromNE
IdiotFromNE collected $1 from pot
IdiotFromNE: doesn't show hand 
*** SUMMARY ***
Total pot $1 | Rake $0 
Seat 1: AKplus folded before Flop (didn't bet)
Seat 2: di0d80 folded before Flop (didn't bet)
Seat 4: Westpants folded before Flop (didn't bet)
Seat 6: xrisall_2 folded before Flop (didn't bet)
Seat 7: matiko09 (button) folded before Flop (didn't bet)
Seat 8: 19SERGE74 (small blind) folded before Flop
Seat 9: IdiotFromNE (big blind) collected ($1)





PokerStars Hand #151165650346:  Hold'em No Limit ($0.50/$1.00 USD) - 2016/03/30 16:45:03 CET [2016/03/30 10:45:03 ET]
Table 'Pannonia II' 9-max Seat #6 is the button
Seat 1: CI58 ($101.12 in chips) 
Seat 2: matiko09 ($100 in chips) 
Seat 3: MGL_Sky99 ($102.22 in chips) 
Seat 4: ka100pka527 ($52.52 in chips) 
Seat 5: Spid1 ($135.32 in chips) 
Seat 6: lumen21 ($107.50 in chips) 
Seat 8: stonymalony ($96.26 in chips) 
Seat 9: Effort92 ($100 in chips) 
stonymalony: posts small blind $0.50
Effort92: posts big blind $1
*** HOLE CARDS ***
Dealt to matiko09 [2s Ad]
CI58: folds 
matiko09: folds 
MGL_Sky99: folds 
ka100pka527: folds 
Spid1: folds 
lumen21: raises $2 to $3
stonymalony: calls $2.50
Effort92: raises $8 to $11
lumen21: calls $8
stonymalony: calls $8
*** FLOP *** [3c Jh Ks]
stonymalony: checks 
Effort92: checks 
lumen21: bets $17.24
stonymalony: folds 
Effort92: folds 
Uncalled bet ($17.24) returned to lumen21
lumen21 collected $31.35 from pot
lumen21: doesn't show hand 
*** SUMMARY ***
Total pot $33 | Rake $1.65 
Board [3c Jh Ks]
Seat 1: CI58 folded before Flop (didn't bet)
Seat 2: matiko09 folded before Flop (didn't bet)
Seat 3: MGL_Sky99 folded before Flop (didn't bet)
Seat 4: ka100pka527 folded before Flop (didn't bet)
Seat 5: Spid1 folded before Flop (didn't bet)
Seat 6: lumen21 (button) collected ($31.35)
Seat 8: stonymalony (small blind) folded on the Flop
Seat 9: Effort92 (big blind) folded on the Flop





PokerStars Hand #151165656004:  Hold'em No Limit ($0.50/$1.00 USD) - 2016/03/30 16:45:11 CET [2016/03/30 10:45:11 ET]
Table 'Figneria III' 9-max Seat #3 is the button
Seat 1: matiko09 ($104.60 in chips) 
Seat 2: sanpidk ($108.20 in chips) 
Seat 3: lumen21 ($111.45 in chips) 
Seat 4: CI58 ($113.45 in chips) 
Seat 5: b_____a__242 ($72.50 in chips) 
Seat 6: RICKA16 ($100 in chips) 
Seat 7: holloway85 ($199.57 in chips) 
Seat 9: p.snow89 ($98.28 in chips) 
CI58: posts small blind $0.50
b_____a__242: posts big blind $1
*** HOLE CARDS ***
Dealt to matiko09 [Td Jh]
RICKA16: folds 
holloway85: folds 
p.snow89: raises $2 to $3
matiko09: folds 
sanpidk: folds 
lumen21: folds 
CI58: folds 
b_____a__242: folds 
Uncalled bet ($2) returned to p.snow89
p.snow89 collected $2.50 from pot
p.snow89: doesn't show hand 
*** SUMMARY ***
Total pot $2.50 | Rake $0 
Seat 1: matiko09 folded before Flop (didn't bet)
Seat 2: sanpidk folded before Flop (didn't bet)
Seat 3: lumen21 (button) folded before Flop (didn't bet)
Seat 4: CI58 (small blind) folded before Flop
Seat 5: b_____a__242 (big blind) folded before Flop
Seat 6: RICKA16 folded before Flop (didn't bet)
Seat 7: holloway85 folded before Flop (didn't bet)
Seat 9: p.snow89 collected ($2.50)





PokerStars Hand #151165661424:  Hold'em No Limit ($0.50/$1.00 USD) - 2016/03/30 16:45:19 CET [2016/03/30 10:45:19 ET]
Table 'Hadwiger' 9-max Seat #8 is the button
Seat 1: AKplus ($91.70 in chips) 
Seat 2: di0d80 ($101.28 in chips) 
Seat 4: Westpants ($100 in chips) 
Seat 6: xrisall_2 ($79 in chips) 
Seat 7: matiko09 ($109.11 in chips) 
Seat 8: 19SERGE74 ($60 in chips) 
Seat 9: IdiotFromNE ($107.67 in chips) 
IdiotFromNE: posts small blind $0.50
AKplus: posts big blind $1
yuminyumin1: sits out 
ardo888: sits out 
*** HOLE CARDS ***
Dealt to matiko09 [Jh 4h]
di0d80: folds 
Westpants: folds 
xrisall_2: folds 
matiko09: folds 
19SERGE74: folds 
IdiotFromNE: raises $1.50 to $2.50
AKplus: folds 
Uncalled bet ($1.50) returned to IdiotFromNE
IdiotFromNE collected $2 from pot
IdiotFromNE: doesn't show hand 
*** SUMMARY ***
Total pot $2 | Rake $0 
Seat 1: AKplus (big blind) folded before Flop
Seat 2: di0d80 folded before Flop (didn't bet)
Seat 4: Westpants folded before Flop (didn't bet)
Seat 6: xrisall_2 folded before Flop (didn't bet)
Seat 7: matiko09 folded before Flop (didn't bet)
Seat 8: 19SERGE74 (button) folded before Flop (didn't bet)
Seat 9: IdiotFromNE (small blind) collected ($2)





PokerStars Hand #151165671376:  Hold'em No Limit ($1/$2 USD) - 2016/03/30 16:45:34 CET [2016/03/30 10:45:34 ET]
Table 'Philoctetes II' 9-max Seat #1 is the button
Seat 1: vezunchik79 ($145.38 in chips) 
Seat 2: prominente ($218.91 in chips) 
Seat 3: mentalpshyco ($226.55 in chips) 
Seat 4: tepi_guy ($200 in chips) 
Seat 5: zhaimeng ($360.22 in chips) 
Seat 7: matiko09 ($206.20 in chips) 
Seat 8: suddend3ath ($202 in chips) 
Seat 9: RamiroAgujis ($234.30 in chips) 
prominente: posts small blind $1
mentalpshyco: posts big blind $2
di0d80: sits out 
*** HOLE CARDS ***
Dealt to matiko09 [5h Ah]
tepi_guy: folds 
zhaimeng: raises $2 to $4
matiko09: folds 
suddend3ath: folds 
RamiroAgujis: folds 
vezunchik79: calls $4
prominente: folds 
mentalpshyco: calls $2
*** FLOP *** [8c 3c 3d]
mentalpshyco: checks 
zhaimeng: checks 
vezunchik79: checks 
*** TURN *** [8c 3c 3d] [4s]
mentalpshyco: checks 
zhaimeng: bets $12.35
vezunchik79: folds 
mentalpshyco: folds 
Uncalled bet ($12.35) returned to zhaimeng
zhaimeng collected $12.35 from pot
*** SUMMARY ***
Total pot $13 | Rake $0.65 
Board [8c 3c 3d 4s]
Seat 1: vezunchik79 (button) folded on the Turn
Seat 2: prominente (small blind) folded before Flop
Seat 3: mentalpshyco (big blind) folded on the Turn
Seat 4: tepi_guy folded before Flop (didn't bet)
Seat 5: zhaimeng collected ($12.35)
Seat 7: matiko09 folded before Flop (didn't bet)
Seat 8: suddend3ath folded before Flop (didn't bet)
Seat 9: RamiroAgujis folded before Flop (didn't bet)





PokerStars Hand #151165683832:  Hold'em No Limit ($0.50/$1.00 USD) - 2016/03/30 16:45:52 CET [2016/03/30 10:45:52 ET]
Table 'Figneria III' 9-max Seat #4 is the button
Seat 1: matiko09 ($104.60 in chips) 
Seat 2: sanpidk ($108.20 in chips) 
Seat 3: lumen21 ($111.45 in chips) 
Seat 4: CI58 ($112.95 in chips) 
Seat 5: b_____a__242 ($71.50 in chips) 
Seat 6: RICKA16 ($100 in chips) 
Seat 7: holloway85 ($199.57 in chips) 
Seat 9: p.snow89 ($99.78 in chips) 
b_____a__242: posts small blind $0.50
RICKA16: posts big blind $1
*** HOLE CARDS ***
Dealt to matiko09 [2s 3s]
holloway85: folds 
p.snow89 has timed out
p.snow89: folds 
matiko09: folds 
sanpidk: folds 
lumen21: raises $1.50 to $2.50
CI58: raises $5.50 to $8
b_____a__242: folds 
RICKA16: raises $12 to $20
lumen21: folds 
CI58: calls $12
*** FLOP *** [8s 5d 6d]
RICKA16: checks 
CI58: bets $20.42
RICKA16: raises $20.42 to $40.84
CI58: calls $20.42
*** TURN *** [8s 5d 6d] [Qd]
RICKA16: bets $39.16 and is all-in
CI58: calls $39.16
*** RIVER *** [8s 5d 6d Qd] [6c]
*** SHOW DOWN ***
RICKA16: shows [Kd Ks] (two pair, Kings and Sixes)
CI58: shows [Ah Ad] (two pair, Aces and Sixes)
CI58 collected $200.50 from pot
*** SUMMARY ***
Total pot $203 | Rake $2.50 
Board [8s 5d 6d Qd 6c]
Seat 1: matiko09 folded before Flop (didn't bet)
Seat 2: sanpidk folded before Flop (didn't bet)
Seat 3: lumen21 folded before Flop
Seat 4: CI58 (button) showed [Ah Ad] and won ($200.50) with two pair, Aces and Sixes
Seat 5: b_____a__242 (small blind) folded before Flop
Seat 6: RICKA16 (big blind) showed [Kd Ks] and lost with two pair, Kings and Sixes
Seat 7: holloway85 folded before Flop (didn't bet)
Seat 9: p.snow89 folded before Flop (didn't bet)





PokerStars Hand #151165685268:  Hold'em No Limit ($0.50/$1.00 USD) - 2016/03/30 16:45:54 CET [2016/03/30 10:45:54 ET]
Table 'Hadwiger' 9-max Seat #9 is the button
Seat 1: AKplus ($90.70 in chips) 
Seat 2: di0d80 ($101.28 in chips) 
Seat 4: Westpants ($100 in chips) 
Seat 6: xrisall_2 ($79 in chips) 
Seat 7: matiko09 ($109.11 in chips) 
Seat 8: 19SERGE74 ($60 in chips) 
Seat 9: IdiotFromNE ($108.67 in chips) 
AKplus: posts small blind $0.50
di0d80: posts big blind $1
yuminyumin1: sits out 
ardo888: sits out 
*** HOLE CARDS ***
Dealt to matiko09 [3s As]
Westpants: folds 
xrisall_2: folds 
matiko09: raises $2 to $3
19SERGE74: folds 
IdiotFromNE: folds 
AKplus: folds 
di0d80: folds 
Uncalled bet ($2) returned to matiko09
matiko09 collected $2.50 from pot
matiko09: doesn't show hand 
*** SUMMARY ***
Total pot $2.50 | Rake $0 
Seat 1: AKplus (small blind) folded before Flop
Seat 2: di0d80 (big blind) folded before Flop
Seat 4: Westpants folded before Flop (didn't bet)
Seat 6: xrisall_2 folded before Flop (didn't bet)
Seat 7: matiko09 collected ($2.50)
Seat 8: 19SERGE74 folded before Flop (didn't bet)
Seat 9: IdiotFromNE (button) folded before Flop (didn't bet)





PokerStars Hand #151165686322:  Hold'em No Limit ($0.50/$1.00 USD) - 2016/03/30 16:45:56 CET [2016/03/30 10:45:56 ET]
Table 'Alcor II' 9-max Seat #3 is the button
Seat 1: Red4erT ($107.88 in chips) 
Seat 2: holloway85 ($71.84 in chips) 
Seat 3: mitchymitch3 ($95.72 in chips) 
Seat 4: Effort92 ($99 in chips) 
Seat 5: elbiber2000 ($112.47 in chips) 
Seat 6: godfrey004 ($208.11 in chips) 
Seat 7: sanpidk ($100 in chips) 
Seat 8: ka100pka527 ($73.23 in chips) 
Seat 9: matiko09 ($198.55 in chips) 
Effort92: posts small blind $0.50
elbiber2000: posts big blind $1
*** HOLE CARDS ***
Dealt to matiko09 [8c 2c]
godfrey004: folds 
sanpidk: folds 
ka100pka527: folds 
matiko09: folds 
Red4erT: folds 
holloway85: raises $2 to $3
mitchymitch3: folds 
Effort92: folds 
elbiber2000: folds 
Uncalled bet ($2) returned to holloway85
holloway85 collected $2.50 from pot
holloway85: doesn't show hand 
*** SUMMARY ***
Total pot $2.50 | Rake $0 
Seat 1: Red4erT folded before Flop (didn't bet)
Seat 2: holloway85 collected ($2.50)
Seat 3: mitchymitch3 (button) folded before Flop (didn't bet)
Seat 4: Effort92 (small blind) folded before Flop
Seat 5: elbiber2000 (big blind) folded before Flop
Seat 6: godfrey004 folded before Flop (didn't bet)
Seat 7: sanpidk folded before Flop (didn't bet)
Seat 8: ka100pka527 folded before Flop (didn't bet)
Seat 9: matiko09 folded before Flop (didn't bet)





PokerStars Hand #151165688840:  Hold'em No Limit ($1/$2 USD) - 2016/03/30 16:45:59 CET [2016/03/30 10:45:59 ET]
Table 'Aesculapia II' 9-max Seat #9 is the button
Seat 1: buthmen ($124.27 in chips) 
Seat 2: suddend3ath ($333.25 in chips) 
Seat 3: matiko09 ($695.85 in chips) 
Seat 4: tepi_guy ($207.35 in chips) 
Seat 5: prominente ($200 in chips) 
Seat 6: mentalpshyco ($200 in chips) 
Seat 7: Rumboni66 ($109.49 in chips) 
Seat 9: InsomniaRU ($200 in chips) 
buthmen: posts small blind $1
suddend3ath: posts big blind $2
*** HOLE CARDS ***
Dealt to matiko09 [Qh Jc]
matiko09: folds 
tepi_guy: folds 
prominente: folds 
mentalpshyco: folds 
Rumboni66: folds 
InsomniaRU: raises $3 to $5
buthmen: calls $4
suddend3ath: folds 
*** FLOP *** [4s 3d Th]
buthmen: checks 
InsomniaRU: checks 
*** TURN *** [4s 3d Th] [5h]
buthmen: bets $5.70
InsomniaRU: folds 
Uncalled bet ($5.70) returned to buthmen
buthmen collected $11.40 from pot
buthmen: doesn't show hand 
*** SUMMARY ***
Total pot $12 | Rake $0.60 
Board [4s 3d Th 5h]
Seat 1: buthmen (small blind) collected ($11.40)
Seat 2: suddend3ath (big blind) folded before Flop
Seat 3: matiko09 folded before Flop (didn't bet)
Seat 4: tepi_guy folded before Flop (didn't bet)
Seat 5: prominente folded before Flop (didn't bet)
Seat 6: mentalpshyco folded before Flop (didn't bet)
Seat 7: Rumboni66 folded before Flop (didn't bet)
Seat 9: InsomniaRU (button) folded on the Turn





PokerStars Hand #151165708901:  Hold'em No Limit ($0.50/$1.00 USD) - 2016/03/30 16:46:29 CET [2016/03/30 10:46:29 ET]
Table 'Hadwiger' 9-max Seat #1 is the button
Seat 1: AKplus ($90.20 in chips) 
Seat 2: di0d80 ($100.28 in chips) 
Seat 3: yuminyumin1 ($100 in chips) 
Seat 4: Westpants ($100 in chips) 
Seat 6: xrisall_2 ($79 in chips) 
Seat 7: matiko09 ($110.61 in chips) 
Seat 8: 19SERGE74 ($60 in chips) 
Seat 9: IdiotFromNE ($108.67 in chips) 
di0d80: posts small blind $0.50
yuminyumin1: posts big blind $1
ardo888: sits out 
*** HOLE CARDS ***
Dealt to matiko09 [5c 9s]
Westpants: folds 
xrisall_2: folds 
matiko09: folds 
19SERGE74: folds 
IdiotFromNE: folds 
AKplus: folds 
di0d80: raises $2 to $3
yuminyumin1: folds 
Uncalled bet ($2) returned to di0d80
di0d80 collected $2 from pot
di0d80: doesn't show hand 
*** SUMMARY ***
Total pot $2 | Rake $0 
Seat 1: AKplus (button) folded before Flop (didn't bet)
Seat 2: di0d80 (small blind) collected ($2)
Seat 3: yuminyumin1 (big blind) folded before Flop
Seat 4: Westpants folded before Flop (didn't bet)
Seat 6: xrisall_2 folded before Flop (didn't bet)
Seat 7: matiko09 folded before Flop (didn't bet)
Seat 8: 19SERGE74 folded before Flop (didn't bet)
Seat 9: IdiotFromNE folded before Flop (didn't bet)





PokerStars Hand #151165709977:  Hold'em No Limit ($0.50/$1.00 USD) - 2016/03/30 16:46:31 CET [2016/03/30 10:46:31 ET]
Table 'Alcor II' 9-max Seat #4 is the button
Seat 1: Red4erT ($107.88 in chips) 
Seat 2: holloway85 ($73.34 in chips) 
Seat 3: mitchymitch3 ($95.72 in chips) 
Seat 4: Effort92 ($98.50 in chips) 
Seat 5: elbiber2000 ($111.47 in chips) 
Seat 6: godfrey004 ($208.11 in chips) 
Seat 7: sanpidk ($100 in chips) 
Seat 8: ka100pka527 ($73.23 in chips) 
Seat 9: matiko09 ($198.55 in chips) 
elbiber2000: posts small blind $0.50
godfrey004: posts big blind $1
*** HOLE CARDS ***
Dealt to matiko09 [3h Kh]
sanpidk: folds 
ka100pka527: folds 
matiko09: folds 
Red4erT: raises $2 to $3
holloway85: folds 
mitchymitch3: folds 
Effort92: folds 
elbiber2000: folds 
godfrey004: folds 
Uncalled bet ($2) returned to Red4erT
Red4erT collected $2.50 from pot
Red4erT: doesn't show hand 
*** SUMMARY ***
Total pot $2.50 | Rake $0 
Seat 1: Red4erT collected ($2.50)
Seat 2: holloway85 folded before Flop (didn't bet)
Seat 3: mitchymitch3 folded before Flop (didn't bet)
Seat 4: Effort92 (button) folded before Flop (didn't bet)
Seat 5: elbiber2000 (small blind) folded before Flop
Seat 6: godfrey004 (big blind) folded before Flop
Seat 7: sanpidk folded before Flop (didn't bet)
Seat 8: ka100pka527 folded before Flop (didn't bet)
Seat 9: matiko09 folded before Flop (didn't bet)





PokerStars Hand #151165716967:  Hold'em No Limit ($0.50/$1.00 USD) - 2016/03/30 16:46:41 CET [2016/03/30 10:46:41 ET]
Table 'Pannonia II' 9-max Seat #8 is the button
Seat 1: CI58 ($101.12 in chips) 
Seat 2: matiko09 ($100 in chips) 
Seat 3: MGL_Sky99 ($102.22 in chips) 
Seat 4: ka100pka527 ($52.52 in chips) 
Seat 5: Spid1 ($135.32 in chips) 
Seat 6: lumen21 ($127.85 in chips) 
Seat 8: stonymalony ($85.26 in chips) 
Seat 9: Effort92 ($89 in chips) 
Effort92: posts small blind $0.50
CI58: posts big blind $1
*** HOLE CARDS ***
Dealt to matiko09 [3s Js]
matiko09: folds 
MGL_Sky99: folds 
ka100pka527: folds 
Spid1: folds 
lumen21: folds 
stonymalony: folds 
Effort92: folds 
Uncalled bet ($0.50) returned to CI58
CI58 collected $1 from pot
CI58: doesn't show hand 
*** SUMMARY ***
Total pot $1 | Rake $0 
Seat 1: CI58 (big blind) collected ($1)
Seat 2: matiko09 folded before Flop (didn't bet)
Seat 3: MGL_Sky99 folded before Flop (didn't bet)
Seat 4: ka100pka527 folded before Flop (didn't bet)
Seat 5: Spid1 folded before Flop (didn't bet)
Seat 6: lumen21 folded before Flop (didn't bet)
Seat 8: stonymalony (button) folded before Flop (didn't bet)
Seat 9: Effort92 (small blind) folded before Flop





PokerStars Hand #151165726271:  Hold'em No Limit ($0.50/$1.00 USD) - 2016/03/30 16:46:54 CET [2016/03/30 10:46:54 ET]
Table 'Pannonia II' 9-max Seat #9 is the button
Seat 1: CI58 ($101.62 in chips) 
Seat 2: matiko09 ($100 in chips) 
Seat 3: MGL_Sky99 ($102.22 in chips) 
Seat 4: ka100pka527 ($52.52 in chips) 
Seat 5: Spid1 ($135.32 in chips) 
Seat 6: lumen21 ($127.85 in chips) 
Seat 8: stonymalony ($85.26 in chips) 
Seat 9: Effort92 ($88.50 in chips) 
CI58: posts small blind $0.50
matiko09: posts big blind $1
*** HOLE CARDS ***
Dealt to matiko09 [7c 8h]
MGL_Sky99: folds 
ka100pka527: folds 
Spid1: folds 
lumen21: folds 
stonymalony: raises $1 to $2
Effort92: folds 
CI58: folds 
matiko09: folds 
Uncalled bet ($1) returned to stonymalony
stonymalony collected $2.50 from pot
stonymalony: doesn't show hand 
*** SUMMARY ***
Total pot $2.50 | Rake $0 
Seat 1: CI58 (small blind) folded before Flop
Seat 2: matiko09 (big blind) folded before Flop
Seat 3: MGL_Sky99 folded before Flop (didn't bet)
Seat 4: ka100pka527 folded before Flop (didn't bet)
Seat 5: Spid1 folded before Flop (didn't bet)
Seat 6: lumen21 folded before Flop (didn't bet)
Seat 8: stonymalony collected ($2.50)
Seat 9: Effort92 (button) folded before Flop (didn't bet)





PokerStars Hand #151165727725:  Hold'em No Limit ($0.50/$1.00 USD) - 2016/03/30 16:46:56 CET [2016/03/30 10:46:56 ET]
Table 'Alcor II' 9-max Seat #5 is the button
Seat 1: Red4erT ($109.38 in chips) 
Seat 2: holloway85 ($73.34 in chips) 
Seat 3: mitchymitch3 ($95.72 in chips) 
Seat 4: Effort92 ($98.50 in chips) 
Seat 5: elbiber2000 ($110.97 in chips) 
Seat 6: godfrey004 ($207.11 in chips) 
Seat 7: sanpidk ($100 in chips) 
Seat 8: ka100pka527 ($73.23 in chips) 
Seat 9: matiko09 ($198.55 in chips) 
godfrey004: posts small blind $0.50
sanpidk: posts big blind $1
*** HOLE CARDS ***
Dealt to matiko09 [4h 2c]
ka100pka527: folds 
matiko09: folds 
Red4erT: folds 
holloway85: calls $1
mitchymitch3: folds 
Effort92: calls $1
elbiber2000: folds 
godfrey004: folds 
sanpidk: raises $4.50 to $5.50
holloway85: calls $4.50
Effort92: calls $4.50
*** FLOP *** [As Jc 6c]
sanpidk: checks 
holloway85: bets $2
Effort92: folds 
sanpidk: folds 
Uncalled bet ($2) returned to holloway85
holloway85 collected $16.15 from pot
holloway85: doesn't show hand 
*** SUMMARY ***
Total pot $17 | Rake $0.85 
Board [As Jc 6c]
Seat 1: Red4erT folded before Flop (didn't bet)
Seat 2: holloway85 collected ($16.15)
Seat 3: mitchymitch3 folded before Flop (didn't bet)
Seat 4: Effort92 folded on the Flop
Seat 5: elbiber2000 (button) folded before Flop (didn't bet)
Seat 6: godfrey004 (small blind) folded before Flop
Seat 7: sanpidk (big blind) folded on the Flop
Seat 8: ka100pka527 folded before Flop (didn't bet)
Seat 9: matiko09 folded before Flop (didn't bet)





PokerStars Hand #151165732468:  Hold'em No Limit ($1/$2 USD) - 2016/03/30 16:47:03 CET [2016/03/30 10:47:03 ET]
Table 'Aesculapia II' 9-max Seat #1 is the button
Seat 1: buthmen ($130.67 in chips) 
Seat 2: suddend3ath ($331.25 in chips) 
Seat 3: matiko09 ($695.85 in chips) 
Seat 4: tepi_guy ($207.35 in chips) 
Seat 5: prominente ($200 in chips) 
Seat 6: mentalpshyco ($200 in chips) 
Seat 7: Rumboni66 ($109.49 in chips) 
Seat 9: InsomniaRU ($200 in chips) 
suddend3ath: posts small blind $1
matiko09: posts big blind $2
*** HOLE CARDS ***
Dealt to matiko09 [Ks Ad]
tepi_guy: folds 
prominente: folds 
mentalpshyco: folds 
Rumboni66: folds 
InsomniaRU: folds 
buthmen: folds 
suddend3ath: calls $1
matiko09: raises $6 to $8
kaya.ertugrul88 joins the table at seat #8 
suddend3ath: calls $6
*** FLOP *** [Kh 4c 3d]
suddend3ath: checks 
matiko09: bets $7.90
suddend3ath: calls $7.90
*** TURN *** [Kh 4c 3d] [2d]
suddend3ath: checks 
matiko09: checks 
*** RIVER *** [Kh 4c 3d 2d] [2s]
suddend3ath: checks 
matiko09: bets $19.64
suddend3ath: folds 
Uncalled bet ($19.64) returned to matiko09
matiko09 collected $30.21 from pot
matiko09: doesn't show hand 
*** SUMMARY ***
Total pot $31.80 | Rake $1.59 
Board [Kh 4c 3d 2d 2s]
Seat 1: buthmen (button) folded before Flop (didn't bet)
Seat 2: suddend3ath (small blind) folded on the River
Seat 3: matiko09 (big blind) collected ($30.21)
Seat 4: tepi_guy folded before Flop (didn't bet)
Seat 5: prominente folded before Flop (didn't bet)
Seat 6: mentalpshyco folded before Flop (didn't bet)
Seat 7: Rumboni66 folded before Flop (didn't bet)
Seat 9: InsomniaRU folded before Flop (didn't bet)





PokerStars Hand #151165741037:  Hold'em No Limit ($0.50/$1.00 USD) - 2016/03/30 16:47:16 CET [2016/03/30 10:47:16 ET]
Table 'Hadwiger' 9-max Seat #2 is the button
Seat 1: AKplus ($90.20 in chips) 
Seat 2: di0d80 ($101.28 in chips) 
Seat 3: yuminyumin1 ($99 in chips) 
Seat 4: Westpants ($100 in chips) 
Seat 6: xrisall_2 ($79 in chips) 
Seat 7: matiko09 ($110.61 in chips) 
Seat 8: 19SERGE74 ($60 in chips) 
Seat 9: IdiotFromNE ($108.67 in chips) 
yuminyumin1: posts small blind $0.50
Westpants: posts big blind $1
ardo888: sits out 
*** HOLE CARDS ***
Dealt to matiko09 [Jd Jh]
xrisall_2: folds 
matiko09: raises $2 to $3
19SERGE74: folds 
IdiotFromNE: folds 
AKplus: folds 
di0d80: folds 
yuminyumin1: folds 
Westpants: folds 
Uncalled bet ($2) returned to matiko09
matiko09 collected $2.50 from pot
matiko09: doesn't show hand 
*** SUMMARY ***
Total pot $2.50 | Rake $0 
Seat 1: AKplus folded before Flop (didn't bet)
Seat 2: di0d80 (button) folded before Flop (didn't bet)
Seat 3: yuminyumin1 (small blind) folded before Flop
Seat 4: Westpants (big blind) folded before Flop
Seat 6: xrisall_2 folded before Flop (didn't bet)
Seat 7: matiko09 collected ($2.50)
Seat 8: 19SERGE74 folded before Flop (didn't bet)
Seat 9: IdiotFromNE folded before Flop (didn't bet)





PokerStars Hand #151165754539:  Hold'em No Limit ($0.50/$1.00 USD) - 2016/03/30 16:47:36 CET [2016/03/30 10:47:36 ET]
Table 'Pannonia II' 9-max Seat #1 is the button
Seat 1: CI58 ($101.12 in chips) 
Seat 2: matiko09 ($100 in chips) 
Seat 3: MGL_Sky99 ($102.22 in chips) 
Seat 4: ka100pka527 ($52.52 in chips) 
Seat 5: Spid1 ($135.32 in chips) 
Seat 6: lumen21 ($127.85 in chips) 
Seat 8: stonymalony ($86.76 in chips) 
Seat 9: Effort92 ($88.50 in chips) 
matiko09: posts small blind $0.50
MGL_Sky99: posts big blind $1
*** HOLE CARDS ***
Dealt to matiko09 [6s Tc]
ka100pka527: folds 
Spid1: folds 
lumen21: folds 
stonymalony: folds 
Effort92: folds 
CI58: folds 
matiko09: folds 
Uncalled bet ($0.50) returned to MGL_Sky99
MGL_Sky99 collected $1 from pot
MGL_Sky99: doesn't show hand 
*** SUMMARY ***
Total pot $1 | Rake $0 
Seat 1: CI58 (button) folded before Flop (didn't bet)
Seat 2: matiko09 (small blind) folded before Flop
Seat 3: MGL_Sky99 (big blind) collected ($1)
Seat 4: ka100pka527 folded before Flop (didn't bet)
Seat 5: Spid1 folded before Flop (didn't bet)
Seat 6: lumen21 folded before Flop (didn't bet)
Seat 8: stonymalony folded before Flop (didn't bet)
Seat 9: Effort92 folded before Flop (didn't bet)





PokerStars Hand #151165767727:  Hold'em No Limit ($0.50/$1.00 USD) - 2016/03/30 16:47:55 CET [2016/03/30 10:47:55 ET]
Table 'Figneria III' 9-max Seat #5 is the button
Seat 1: matiko09 ($104.60 in chips) 
Seat 2: sanpidk ($108.20 in chips) 
Seat 3: lumen21 ($108.95 in chips) 
Seat 4: CI58 ($213.45 in chips) 
Seat 5: b_____a__242 ($71 in chips) 
Seat 7: holloway85 ($199.57 in chips) 
Seat 9: p.snow89 ($99.78 in chips) 
holloway85: posts small blind $0.50
p.snow89: posts big blind $1
*** HOLE CARDS ***
Dealt to matiko09 [5s Qs]
matiko09: folds 
sanpidk: folds 
lumen21: folds 
CI58: folds 
b_____a__242: raises $2 to $3
holloway85: calls $2.50
p.snow89: calls $2
*** FLOP *** [3c Kd 7d]
holloway85: checks 
p.snow89: bets $4
b_____a__242: folds 
holloway85: calls $4
*** TURN *** [3c Kd 7d] [9c]
holloway85: checks 
p.snow89 is disconnected 
p.snow89 is connected 
p.snow89: bets $7
holloway85: raises $7 to $14
p.snow89: calls $7
*** RIVER *** [3c Kd 7d 9c] [6d]
holloway85: bets $15
p.snow89: calls $15
*** SHOW DOWN ***
holloway85: shows [7s 7h] (three of a kind, Sevens)
p.snow89: mucks hand 
holloway85 collected $72.50 from pot
*** SUMMARY ***
Total pot $75 | Rake $2.50 
Board [3c Kd 7d 9c 6d]
Seat 1: matiko09 folded before Flop (didn't bet)
Seat 2: sanpidk folded before Flop (didn't bet)
Seat 3: lumen21 folded before Flop (didn't bet)
Seat 4: CI58 folded before Flop (didn't bet)
Seat 5: b_____a__242 (button) folded on the Flop
Seat 7: holloway85 (small blind) showed [7s 7h] and won ($72.50) with three of a kind, Sevens
Seat 9: p.snow89 (big blind) mucked [6s Ks]





PokerStars Hand #151165770387:  Hold'em No Limit ($0.50/$1.00 USD) - 2016/03/30 16:47:59 CET [2016/03/30 10:47:59 ET]
Table 'Pannonia II' 9-max Seat #2 is the button
Seat 1: CI58 ($101.12 in chips) 
Seat 2: matiko09 ($100 in chips) 
Seat 3: MGL_Sky99 ($102.72 in chips) 
Seat 5: Spid1 ($135.32 in chips) 
Seat 6: lumen21 ($127.85 in chips) 
Seat 8: stonymalony ($86.76 in chips) 
Seat 9: Effort92 ($88.50 in chips) 
MGL_Sky99: posts small blind $0.50
ka100pka527: is sitting out 
Spid1: posts big blind $1
*** HOLE CARDS ***
Dealt to matiko09 [2s 9h]
ka100pka527 leaves the table
lumen21: folds 
SumPosad joins the table at seat #4 
stonymalony: raises $1 to $2
Effort92: folds 
CI58: folds 
matiko09: folds 
MGL_Sky99: folds 
Spid1: calls $1
*** FLOP *** [5h Kd Kh]
Spid1: checks 
stonymalony: checks 
*** TURN *** [5h Kd Kh] [7c]
Spid1: checks 
stonymalony: checks 
*** RIVER *** [5h Kd Kh 7c] [6s]
Spid1: checks 
stonymalony: checks 
*** SHOW DOWN ***
Spid1: shows [4c 5d] (two pair, Kings and Fives)
stonymalony: shows [Ad 6c] (two pair, Kings and Sixes)
stonymalony collected $4.28 from pot
*** SUMMARY ***
Total pot $4.50 | Rake $0.22 
Board [5h Kd Kh 7c 6s]
Seat 1: CI58 folded before Flop (didn't bet)
Seat 2: matiko09 (button) folded before Flop (didn't bet)
Seat 3: MGL_Sky99 (small blind) folded before Flop
Seat 5: Spid1 (big blind) showed [4c 5d] and lost with two pair, Kings and Fives
Seat 6: lumen21 folded before Flop (didn't bet)
Seat 8: stonymalony showed [Ad 6c] and won ($4.28) with two pair, Kings and Sixes
Seat 9: Effort92 folded before Flop (didn't bet)





PokerStars Hand #151165770918:  Hold'em No Limit ($1/$2 USD) - 2016/03/30 16:48:00 CET [2016/03/30 10:48:00 ET]
Table 'Aesculapia II' 9-max Seat #2 is the button
Seat 1: buthmen ($130.67 in chips) 
Seat 2: suddend3ath ($315.35 in chips) 
Seat 3: matiko09 ($710.16 in chips) 
Seat 4: tepi_guy ($207.35 in chips) 
Seat 5: prominente ($200 in chips) 
Seat 6: mentalpshyco ($200 in chips) 
Seat 7: Rumboni66 ($109.49 in chips) 
Seat 8: kaya.ertugrul88 ($120 in chips) 
Seat 9: InsomniaRU ($200 in chips) 
matiko09: posts small blind $1
tepi_guy: posts big blind $2
kaya.ertugrul88: posts big blind $2
*** HOLE CARDS ***
Dealt to matiko09 [3s 2d]
prominente: folds 
mentalpshyco: folds 
Rumboni66: folds 
kaya.ertugrul88: checks 
InsomniaRU: folds 
buthmen: raises $4 to $6
suddend3ath: calls $6
matiko09: folds 
tepi_guy: raises $18 to $24
kaya.ertugrul88: folds 
buthmen: calls $18
suddend3ath: calls $18
*** FLOP *** [Ad 4h 7c]
tepi_guy: bets $26.45
buthmen: calls $26.45
suddend3ath: folds 
*** TURN *** [Ad 4h 7c] [3d]
tepi_guy: bets $100.12
buthmen: calls $80.22 and is all-in
Uncalled bet ($19.90) returned to tepi_guy
*** RIVER *** [Ad 4h 7c 3d] [Tc]
*** SHOW DOWN ***
tepi_guy: shows [Jh As] (a pair of Aces)
buthmen: shows [7d 8h] (a pair of Sevens)
tepi_guy collected $285.59 from pot
*** SUMMARY ***
Total pot $288.34 | Rake $2.75 
Board [Ad 4h 7c 3d Tc]
Seat 1: buthmen showed [7d 8h] and lost with a pair of Sevens
Seat 2: suddend3ath (button) folded on the Flop
Seat 3: matiko09 (small blind) folded before Flop
Seat 4: tepi_guy (big blind) showed [Jh As] and won ($285.59) with a pair of Aces
Seat 5: prominente folded before Flop (didn't bet)
Seat 6: mentalpshyco folded before Flop (didn't bet)
Seat 7: Rumboni66 folded before Flop (didn't bet)
Seat 8: kaya.ertugrul88 folded before Flop
Seat 9: InsomniaRU folded before Flop (didn't bet)





PokerStars Hand #151165772143:  Hold'em No Limit ($0.50/$1.00 USD) - 2016/03/30 16:48:01 CET [2016/03/30 10:48:01 ET]
Table 'Hadwiger' 9-max Seat #3 is the button
Seat 1: AKplus ($90.20 in chips) 
Seat 2: di0d80 ($101.28 in chips) 
Seat 3: yuminyumin1 ($98.50 in chips) 
Seat 4: Westpants ($100 in chips) 
Seat 5: ardo888 ($100 in chips) 
Seat 6: xrisall_2 ($79 in chips) 
Seat 7: matiko09 ($112.11 in chips) 
Seat 8: 19SERGE74 ($60 in chips) 
Seat 9: IdiotFromNE ($108.67 in chips) 
Westpants: posts small blind $0.50
ardo888: posts big blind $1
*** HOLE CARDS ***
Dealt to matiko09 [6d 2c]
xrisall_2 is disconnected 
xrisall_2 has timed out while disconnected
xrisall_2: folds 
matiko09: folds 
19SERGE74: folds 
IdiotFromNE: folds 
AKplus: raises $1 to $2
di0d80: folds 
yuminyumin1: calls $2
Westpants: folds 
ardo888: calls $1
*** FLOP *** [7c Jc 7d]
ardo888: checks 
AKplus: bets $4
yuminyumin1: folds 
ardo888: folds 
Uncalled bet ($4) returned to AKplus
AKplus collected $6.18 from pot
AKplus: doesn't show hand 
*** SUMMARY ***
Total pot $6.50 | Rake $0.32 
Board [7c Jc 7d]
Seat 1: AKplus collected ($6.18)
Seat 2: di0d80 folded before Flop (didn't bet)
Seat 3: yuminyumin1 (button) folded on the Flop
Seat 4: Westpants (small blind) folded before Flop
Seat 5: ardo888 (big blind) folded on the Flop
Seat 6: xrisall_2 folded before Flop (didn't bet)
Seat 7: matiko09 folded before Flop (didn't bet)
Seat 8: 19SERGE74 folded before Flop (didn't bet)
Seat 9: IdiotFromNE folded before Flop (didn't bet)





PokerStars Hand #151165772296:  Hold'em No Limit ($0.50/$1.00 USD) - 2016/03/30 16:48:02 CET [2016/03/30 10:48:02 ET]
Table 'Alcor II' 9-max Seat #6 is the button
Seat 1: Red4erT ($109.38 in chips) 
Seat 2: holloway85 ($83.99 in chips) 
Seat 3: mitchymitch3 ($95.72 in chips) 
Seat 4: Effort92 ($93 in chips) 
Seat 5: elbiber2000 ($110.97 in chips) 
Seat 6: godfrey004 ($206.61 in chips) 
Seat 7: sanpidk ($100 in chips) 
Seat 9: matiko09 ($198.55 in chips) 
sanpidk: posts small blind $0.50
ka100pka527: is sitting out 
matiko09: posts big blind $1
*** HOLE CARDS ***
Dealt to matiko09 [8c 7h]
ka100pka527 leaves the table
Red4erT: folds 
Red4erT leaves the table
holloway85: folds 
mitchymitch3: raises $2 to $3
Effort92: calls $3
elbiber2000: folds 
godfrey004: folds 
sanpidk: folds 
matiko09: folds 
*** FLOP *** [5d Ks 8d]
mitchymitch3: bets $4
Effort92: folds 
Uncalled bet ($4) returned to mitchymitch3
mitchymitch3 collected $7.12 from pot
mitchymitch3: doesn't show hand 
*** SUMMARY ***
Total pot $7.50 | Rake $0.38 
Board [5d Ks 8d]
Seat 1: Red4erT folded before Flop (didn't bet)
Seat 2: holloway85 folded before Flop (didn't bet)
Seat 3: mitchymitch3 collected ($7.12)
Seat 4: Effort92 folded on the Flop
Seat 5: elbiber2000 folded before Flop (didn't bet)
Seat 6: godfrey004 (button) folded before Flop (didn't bet)
Seat 7: sanpidk (small blind) folded before Flop
Seat 9: matiko09 (big blind) folded before Flop





PokerStars Hand #151165772173:  Hold'em No Limit ($1/$2 USD) - 2016/03/30 16:48:02 CET [2016/03/30 10:48:02 ET]
Table 'Philoctetes II' 9-max Seat #2 is the button
Seat 1: vezunchik79 ($141.38 in chips) 
Seat 2: prominente ($217.91 in chips) 
Seat 3: mentalpshyco ($222.55 in chips) 
Seat 4: tepi_guy ($200 in chips) 
Seat 5: zhaimeng ($368.57 in chips) 
Seat 7: matiko09 ($206.20 in chips) 
Seat 8: suddend3ath ($202 in chips) 
Seat 9: RamiroAgujis ($234.30 in chips) 
mentalpshyco: posts small blind $1
tepi_guy: posts big blind $2
di0d80: sits out 
*** HOLE CARDS ***
Dealt to matiko09 [2d Kc]
zhaimeng: folds 
matiko09: folds 
suddend3ath: folds 
RamiroAgujis: folds 
vezunchik79: folds 
prominente: folds 
mentalpshyco: raises $3 to $5
tepi_guy has timed out
tepi_guy: folds 
Uncalled bet ($3) returned to mentalpshyco
mentalpshyco collected $4 from pot
mentalpshyco: doesn't show hand 
*** SUMMARY ***
Total pot $4 | Rake $0 
Seat 1: vezunchik79 folded before Flop (didn't bet)
Seat 2: prominente (button) folded before Flop (didn't bet)
Seat 3: mentalpshyco (small blind) collected ($4)
Seat 4: tepi_guy (big blind) folded before Flop
Seat 5: zhaimeng folded before Flop (didn't bet)
Seat 7: matiko09 folded before Flop (didn't bet)
Seat 8: suddend3ath folded before Flop (didn't bet)
Seat 9: RamiroAgujis folded before Flop (didn't bet)





PokerStars Hand #151165795803:  Hold'em No Limit ($0.50/$1.00 USD) - 2016/03/30 16:48:36 CET [2016/03/30 10:48:36 ET]
Table 'Pannonia II' 9-max Seat #3 is the button
Seat 1: CI58 ($101.12 in chips) 
Seat 2: matiko09 ($100 in chips) 
Seat 3: MGL_Sky99 ($102.22 in chips) 
Seat 5: Spid1 ($133.32 in chips) 
Seat 6: lumen21 ($127.85 in chips) 
Seat 8: stonymalony ($89.04 in chips) 
Seat 9: Effort92 ($88.50 in chips) 
SumPosad will be allowed to play after the button
Spid1: posts small blind $0.50
lumen21: posts big blind $1
*** HOLE CARDS ***
Dealt to matiko09 [7c Th]
stonymalony: raises $1 to $2
Effort92: folds 
CI58: folds 
matiko09: folds 
MGL_Sky99: raises $5 to $7
Spid1: raises $17 to $24
lumen21: folds 
stonymalony: folds 
MGL_Sky99: folds 
Uncalled bet ($17) returned to Spid1
Spid1 collected $17 from pot
Spid1: doesn't show hand 
*** SUMMARY ***
Total pot $17 | Rake $0 
Seat 1: CI58 folded before Flop (didn't bet)
Seat 2: matiko09 folded before Flop (didn't bet)
Seat 3: MGL_Sky99 (button) folded before Flop
Seat 5: Spid1 (small blind) collected ($17)
Seat 6: lumen21 (big blind) folded before Flop
Seat 8: stonymalony folded before Flop
Seat 9: Effort92 folded before Flop (didn't bet)





PokerStars Hand #151165795827:  Hold'em No Limit ($0.50/$1.00 USD) - 2016/03/30 16:48:36 CET [2016/03/30 10:48:36 ET]
Table 'Alcor II' 9-max Seat #7 is the button
Seat 2: holloway85 ($83.99 in chips) 
Seat 3: mitchymitch3 ($99.84 in chips) 
Seat 4: Effort92 ($90 in chips) 
Seat 5: elbiber2000 ($110.97 in chips) 
Seat 6: godfrey004 ($206.61 in chips) 
Seat 7: sanpidk ($100 in chips) 
Seat 9: matiko09 ($197.55 in chips) 
matiko09: posts small blind $0.50
holloway85: posts big blind $1
*** HOLE CARDS ***
Dealt to matiko09 [6s Tc]
mitchymitch3: folds 
Effort92: raises $1.50 to $2.50
RICKA16 joins the table at seat #8 
di0d80 joins the table at seat #1 
elbiber2000: folds 
godfrey004: calls $2.50
sanpidk: folds 
matiko09: folds 
holloway85: calls $1.50
*** FLOP *** [Th 9c 7s]
holloway85: checks 
Effort92: checks 
godfrey004: bets $6
holloway85: folds 
Effort92: folds 
Uncalled bet ($6) returned to godfrey004
godfrey004 collected $7.60 from pot
godfrey004: doesn't show hand 
*** SUMMARY ***
Total pot $8 | Rake $0.40 
Board [Th 9c 7s]
Seat 2: holloway85 (big blind) folded on the Flop
Seat 3: mitchymitch3 folded before Flop (didn't bet)
Seat 4: Effort92 folded on the Flop
Seat 5: elbiber2000 folded before Flop (didn't bet)
Seat 6: godfrey004 collected ($7.60)
Seat 7: sanpidk (button) folded before Flop (didn't bet)
Seat 9: matiko09 (small blind) folded before Flop





PokerStars Hand #151165824328:  Hold'em No Limit ($0.50/$1.00 USD) - 2016/03/30 16:49:18 CET [2016/03/30 10:49:18 ET]
Table 'Pannonia II' 9-max Seat #5 is the button
Seat 1: CI58 ($101.12 in chips) 
Seat 2: matiko09 ($100 in chips) 
Seat 3: MGL_Sky99 ($95.22 in chips) 
Seat 5: Spid1 ($143.32 in chips) 
Seat 6: lumen21 ($126.85 in chips) 
Seat 8: stonymalony ($87.04 in chips) 
Seat 9: Effort92 ($88.50 in chips) 
lumen21: posts small blind $0.50
stonymalony: posts big blind $1
SumPosad: sits out 
*** HOLE CARDS ***
Dealt to matiko09 [7s 2c]
Effort92: folds 
CI58: folds 
matiko09: folds 
MGL_Sky99: folds 
Spid1: folds 
lumen21: folds 
Uncalled bet ($0.50) returned to stonymalony
stonymalony collected $1 from pot
stonymalony: doesn't show hand 
*** SUMMARY ***
Total pot $1 | Rake $0 
Seat 1: CI58 folded before Flop (didn't bet)
Seat 2: matiko09 folded before Flop (didn't bet)
Seat 3: MGL_Sky99 folded before Flop (didn't bet)
Seat 5: Spid1 (button) folded before Flop (didn't bet)
Seat 6: lumen21 (small blind) folded before Flop
Seat 8: stonymalony (big blind) collected ($1)
Seat 9: Effort92 folded before Flop (didn't bet)





PokerStars Hand #151165837581:  Hold'em No Limit ($0.50/$1.00 USD) - 2016/03/30 16:49:37 CET [2016/03/30 10:49:37 ET]
Table 'Pannonia II' 9-max Seat #6 is the button
Seat 1: CI58 ($101.12 in chips) 
Seat 2: matiko09 ($100 in chips) 
Seat 3: MGL_Sky99 ($95.22 in chips) 
Seat 5: Spid1 ($143.32 in chips) 
Seat 6: lumen21 ($126.35 in chips) 
Seat 8: stonymalony ($87.54 in chips) 
Seat 9: Effort92 ($88.50 in chips) 
stonymalony: posts small blind $0.50
Effort92: posts big blind $1
SumPosad: sits out 
*** HOLE CARDS ***
Dealt to matiko09 [Td 3h]
CI58: raises $2 to $3
matiko09: folds 
MGL_Sky99: calls $3
Spid1: folds 
lumen21: folds 
stonymalony: calls $2.50
Effort92: folds 
*** FLOP *** [4h 9c 8c]
stonymalony: checks 
CI58: checks 
MGL_Sky99: checks 
*** TURN *** [4h 9c 8c] [2d]
stonymalony: checks 
CI58: checks 
MGL_Sky99: checks 
*** RIVER *** [4h 9c 8c 2d] [Jh]
stonymalony: bets $5
CI58: calls $5
MGL_Sky99: folds 
*** SHOW DOWN ***
stonymalony: shows [Kh Ad] (high card Ace)
CI58: shows [Ah Jc] (a pair of Jacks)
CI58 collected $19 from pot
*** SUMMARY ***
Total pot $20 | Rake $1 
Board [4h 9c 8c 2d Jh]
Seat 1: CI58 showed [Ah Jc] and won ($19) with a pair of Jacks
Seat 2: matiko09 folded before Flop (didn't bet)
Seat 3: MGL_Sky99 folded on the River
Seat 5: Spid1 folded before Flop (didn't bet)
Seat 6: lumen21 (button) folded before Flop (didn't bet)
Seat 8: stonymalony (small blind) showed [Kh Ad] and lost with high card Ace
Seat 9: Effort92 (big blind) folded before Flop





PokerStars Hand #151165838382:  Hold'em No Limit ($0.50/$1.00 USD) - 2016/03/30 16:49:39 CET [2016/03/30 10:49:39 ET]
Table 'Alcor II' 9-max Seat #9 is the button
Seat 2: holloway85 ($81.49 in chips) 
Seat 3: mitchymitch3 ($99.84 in chips) 
Seat 4: Effort92 ($87.50 in chips) 
Seat 5: elbiber2000 ($110.97 in chips) 
Seat 6: godfrey004 ($211.71 in chips) 
Seat 7: sanpidk ($100 in chips) 
Seat 9: matiko09 ($197.05 in chips) 
di0d80 will be allowed to play after the button
holloway85: posts small blind $0.50
mitchymitch3: posts big blind $1
RICKA16: sits out 
*** HOLE CARDS ***
Dealt to matiko09 [5h 2h]
Effort92: raises $1.50 to $2.50
elbiber2000: folds 
godfrey004: folds 
sanpidk: folds 
matiko09: folds 
holloway85: folds 
mitchymitch3: folds 
Uncalled bet ($1.50) returned to Effort92
Effort92 collected $2.50 from pot
Effort92: doesn't show hand 
*** SUMMARY ***
Total pot $2.50 | Rake $0 
Seat 2: holloway85 (small blind) folded before Flop
Seat 3: mitchymitch3 (big blind) folded before Flop
Seat 4: Effort92 collected ($2.50)
Seat 5: elbiber2000 folded before Flop (didn't bet)
Seat 6: godfrey004 folded before Flop (didn't bet)
Seat 7: sanpidk folded before Flop (didn't bet)
Seat 9: matiko09 (button) folded before Flop (didn't bet)





PokerStars Hand #151165841940:  Hold'em No Limit ($1/$2 USD) - 2016/03/30 16:49:44 CET [2016/03/30 10:49:44 ET]
Table 'Philoctetes II' 9-max Seat #3 is the button
Seat 1: vezunchik79 ($141.38 in chips) 
Seat 2: prominente ($217.91 in chips) 
Seat 3: mentalpshyco ($224.55 in chips) 
Seat 4: tepi_guy ($200 in chips) 
Seat 5: zhaimeng ($368.57 in chips) 
Seat 7: matiko09 ($206.20 in chips) 
Seat 8: suddend3ath ($202 in chips) 
Seat 9: RamiroAgujis ($234.30 in chips) 
tepi_guy: posts small blind $1
zhaimeng: posts big blind $2
di0d80: sits out 
*** HOLE CARDS ***
Dealt to matiko09 [Kh 5c]
matiko09: folds 
suddend3ath: folds 
RamiroAgujis: folds 
vezunchik79: folds 
prominente has timed out
prominente: folds 
mentalpshyco: raises $3 to $5
tepi_guy: folds 
zhaimeng: folds 
Uncalled bet ($3) returned to mentalpshyco
mentalpshyco collected $5 from pot
mentalpshyco: doesn't show hand 
*** SUMMARY ***
Total pot $5 | Rake $0 
Seat 1: vezunchik79 folded before Flop (didn't bet)
Seat 2: prominente folded before Flop (didn't bet)
Seat 3: mentalpshyco (button) collected ($5)
Seat 4: tepi_guy (small blind) folded before Flop
Seat 5: zhaimeng (big blind) folded before Flop
Seat 7: matiko09 folded before Flop (didn't bet)
Seat 8: suddend3ath folded before Flop (didn't bet)
Seat 9: RamiroAgujis folded before Flop (didn't bet)





PokerStars Hand #151165844369:  Hold'em No Limit ($0.50/$1.00 USD) - 2016/03/30 16:49:47 CET [2016/03/30 10:49:47 ET]
Table 'Hadwiger' 9-max Seat #4 is the button
Seat 1: AKplus ($94.38 in chips) 
Seat 2: di0d80 ($101.28 in chips) 
Seat 3: yuminyumin1 ($96.50 in chips) 
Seat 4: Westpants ($100 in chips) 
Seat 5: ardo888 ($100 in chips) 
Seat 6: xrisall_2 ($79 in chips) 
Seat 7: matiko09 ($112.11 in chips) 
Seat 8: 19SERGE74 ($60 in chips) 
Seat 9: IdiotFromNE ($108.67 in chips) 
ardo888: posts small blind $0.50
xrisall_2: posts big blind $1
*** HOLE CARDS ***
Dealt to matiko09 [8c 3h]
matiko09: folds 
19SERGE74: folds 
IdiotFromNE: folds 
AKplus: raises $1 to $2
di0d80: folds 
yuminyumin1: folds 
Westpants: folds 
ardo888: folds 
xrisall_2: calls $1
*** FLOP *** [Jc 2h 9s]
xrisall_2: bets $2
AKplus: folds 
Uncalled bet ($2) returned to xrisall_2
xrisall_2 collected $4.28 from pot
*** SUMMARY ***
Total pot $4.50 | Rake $0.22 
Board [Jc 2h 9s]
Seat 1: AKplus folded on the Flop
Seat 2: di0d80 folded before Flop (didn't bet)
Seat 3: yuminyumin1 folded before Flop (didn't bet)
Seat 4: Westpants (button) folded before Flop (didn't bet)
Seat 5: ardo888 (small blind) folded before Flop
Seat 6: xrisall_2 (big blind) collected ($4.28)
Seat 7: matiko09 folded before Flop (didn't bet)
Seat 8: 19SERGE74 folded before Flop (didn't bet)
Seat 9: IdiotFromNE folded before Flop (didn't bet)





PokerStars Hand #151165846208:  Hold'em No Limit ($0.50/$1.00 USD) - 2016/03/30 16:49:50 CET [2016/03/30 10:49:50 ET]
Table 'Figneria III' 9-max Seat #7 is the button
Seat 1: matiko09 ($104.60 in chips) 
Seat 2: sanpidk ($108.20 in chips) 
Seat 3: lumen21 ($108.95 in chips) 
Seat 4: CI58 ($213.45 in chips) 
Seat 5: b_____a__242 ($68 in chips) 
Seat 7: holloway85 ($236.07 in chips) 
Seat 9: p.snow89 ($63.78 in chips) 
p.snow89: posts small blind $0.50
matiko09: posts big blind $1
RICKA16: sits out 
*** HOLE CARDS ***
Dealt to matiko09 [3s 9h]
sanpidk: folds 
lumen21: folds 
CI58: folds 
b_____a__242: raises $1.51 to $2.51
holloway85: calls $2.51
p.snow89: folds 
matiko09: folds 
*** FLOP *** [6s Ac 7c]
b_____a__242: bets $4.50
holloway85: calls $4.50
*** TURN *** [6s Ac 7c] [Ah]
b_____a__242: checks 
holloway85: bets $3
b_____a__242: folds 
Uncalled bet ($3) returned to holloway85
holloway85 collected $14.74 from pot
holloway85: doesn't show hand 
*** SUMMARY ***
Total pot $15.52 | Rake $0.78 
Board [6s Ac 7c Ah]
Seat 1: matiko09 (big blind) folded before Flop
Seat 2: sanpidk folded before Flop (didn't bet)
Seat 3: lumen21 folded before Flop (didn't bet)
Seat 4: CI58 folded before Flop (didn't bet)
Seat 5: b_____a__242 folded on the Turn
Seat 7: holloway85 (button) collected ($14.74)
Seat 9: p.snow89 (small blind) folded before Flop





PokerStars Hand #151165846806:  Hold'em No Limit ($1/$2 USD) - 2016/03/30 16:49:51 CET [2016/03/30 10:49:51 ET]
Table 'Aesculapia II' 9-max Seat #3 is the button
Seat 2: suddend3ath ($291.35 in chips) 
Seat 3: matiko09 ($709.16 in chips) 
Seat 4: tepi_guy ($362.27 in chips) 
Seat 5: prominente ($200 in chips) 
Seat 6: mentalpshyco ($200 in chips) 
Seat 7: Rumboni66 ($109.49 in chips) 
Seat 8: kaya.ertugrul88 ($118 in chips) 
Seat 9: InsomniaRU ($200 in chips) 
tepi_guy: posts small blind $1
prominente: posts big blind $2
*** HOLE CARDS ***
Dealt to matiko09 [Kd Ah]
buthmen leaves the table
mentalpshyco: folds 
T0ny Adams joins the table at seat #1 
Rumboni66: calls $2
kaya.ertugrul88: calls $2
InsomniaRU: folds 
suddend3ath: raises $8 to $10
matiko09: calls $10
tepi_guy: folds 
prominente: folds 
Rumboni66: raises $10 to $20
kaya.ertugrul88: calls $18
suddend3ath: calls $10
matiko09: raises $600 to $620
Rumboni66: calls $89.49 and is all-in
kaya.ertugrul88: folds 
suddend3ath: folds 
Uncalled bet ($510.51) returned to matiko09
*** FLOP *** [As 2s Qc]
*** TURN *** [As 2s Qc] [5s]
*** RIVER *** [As 2s Qc 5s] [5d]
*** SHOW DOWN ***
Rumboni66: shows [Kc Ac] (two pair, Aces and Fives)
matiko09: shows [Kd Ah] (two pair, Aces and Fives)
Rumboni66 collected $129.62 from pot
matiko09 collected $129.61 from pot
*** SUMMARY ***
Total pot $261.98 | Rake $2.75 
Board [As 2s Qc 5s 5d]
Seat 2: suddend3ath folded before Flop
Seat 3: matiko09 (button) showed [Kd Ah] and won ($129.61) with two pair, Aces and Fives
Seat 4: tepi_guy (small blind) folded before Flop
Seat 5: prominente (big blind) folded before Flop
Seat 6: mentalpshyco folded before Flop (didn't bet)
Seat 7: Rumboni66 showed [Kc Ac] and won ($129.62) with two pair, Aces and Fives
Seat 8: kaya.ertugrul88 folded before Flop
Seat 9: InsomniaRU folded before Flop (didn't bet)





PokerStars Hand #151165855798:  Hold'em No Limit ($0.50/$1.00 USD) - 2016/03/30 16:50:04 CET [2016/03/30 10:50:04 ET]
Table 'Alcor II' 9-max Seat #2 is the button
Seat 2: holloway85 ($80.99 in chips) 
Seat 3: mitchymitch3 ($98.84 in chips) 
Seat 4: Effort92 ($89 in chips) 
Seat 5: elbiber2000 ($110.97 in chips) 
Seat 6: godfrey004 ($211.71 in chips) 
Seat 7: sanpidk ($100 in chips) 
Seat 9: matiko09 ($197.05 in chips) 
mitchymitch3: posts small blind $0.50
Effort92: posts big blind $1
RICKA16: sits out 
di0d80: sits out 
*** HOLE CARDS ***
Dealt to matiko09 [3s As]
elbiber2000: folds 
godfrey004: folds 
sanpidk: folds 
matiko09: raises $1.50 to $2.50
holloway85: folds 
mitchymitch3: folds 
Effort92: folds 
Uncalled bet ($1.50) returned to matiko09
matiko09 collected $2.50 from pot
matiko09: doesn't show hand 
*** SUMMARY ***
Total pot $2.50 | Rake $0 
Seat 2: holloway85 (button) folded before Flop (didn't bet)
Seat 3: mitchymitch3 (small blind) folded before Flop
Seat 4: Effort92 (big blind) folded before Flop
Seat 5: elbiber2000 folded before Flop (didn't bet)
Seat 6: godfrey004 folded before Flop (didn't bet)
Seat 7: sanpidk folded before Flop (didn't bet)
Seat 9: matiko09 collected ($2.50)





PokerStars Hand #151165869189:  Hold'em No Limit ($0.50/$1.00 USD) - 2016/03/30 16:50:24 CET [2016/03/30 10:50:24 ET]
Table 'Hadwiger' 9-max Seat #5 is the button
Seat 1: AKplus ($92.38 in chips) 
Seat 2: di0d80 ($101.28 in chips) 
Seat 3: yuminyumin1 ($96.50 in chips) 
Seat 4: Westpants ($100 in chips) 
Seat 5: ardo888 ($100 in chips) 
Seat 6: xrisall_2 ($81.28 in chips) 
Seat 7: matiko09 ($112.11 in chips) 
Seat 8: 19SERGE74 ($60 in chips) 
Seat 9: IdiotFromNE ($108.67 in chips) 
xrisall_2: posts small blind $0.50
matiko09: posts big blind $1
*** HOLE CARDS ***
Dealt to matiko09 [8h 3c]
19SERGE74: folds 
IdiotFromNE: folds 
AKplus: folds 
di0d80: folds 
yuminyumin1: calls $1
Westpants: folds 
ardo888: folds 
xrisall_2: calls $0.50
matiko09: checks 
*** FLOP *** [6c Jc 6s]
xrisall_2: checks 
matiko09: checks 
yuminyumin1: bets $1.50
xrisall_2: folds 
matiko09: folds 
Uncalled bet ($1.50) returned to yuminyumin1
yuminyumin1 collected $2.85 from pot
yuminyumin1: doesn't show hand 
*** SUMMARY ***
Total pot $3 | Rake $0.15 
Board [6c Jc 6s]
Seat 1: AKplus folded before Flop (didn't bet)
Seat 2: di0d80 folded before Flop (didn't bet)
Seat 3: yuminyumin1 collected ($2.85)
Seat 4: Westpants folded before Flop (didn't bet)
Seat 5: ardo888 (button) folded before Flop (didn't bet)
Seat 6: xrisall_2 (small blind) folded on the Flop
Seat 7: matiko09 (big blind) folded on the Flop
Seat 8: 19SERGE74 folded before Flop (didn't bet)
Seat 9: IdiotFromNE folded before Flop (didn't bet)





PokerStars Hand #151165876398:  Hold'em No Limit ($0.50/$1.00 USD) - 2016/03/30 16:50:35 CET [2016/03/30 10:50:35 ET]
Table 'Alcor II' 9-max Seat #3 is the button
Seat 2: holloway85 ($80.99 in chips) 
Seat 3: mitchymitch3 ($98.34 in chips) 
Seat 4: Effort92 ($88 in chips) 
Seat 5: elbiber2000 ($110.97 in chips) 
Seat 6: godfrey004 ($211.71 in chips) 
Seat 7: sanpidk ($100 in chips) 
Seat 9: matiko09 ($198.55 in chips) 
Effort92: posts small blind $0.50
elbiber2000: posts big blind $1
RICKA16: sits out 
di0d80: sits out 
*** HOLE CARDS ***
Dealt to matiko09 [7d 9d]
godfrey004: folds 
sanpidk: raises $2 to $3
matiko09: folds 
holloway85: folds 
mitchymitch3: folds 
Effort92: folds 
elbiber2000: folds 
Uncalled bet ($2) returned to sanpidk
sanpidk collected $2.50 from pot
sanpidk: doesn't show hand 
*** SUMMARY ***
Total pot $2.50 | Rake $0 
Seat 2: holloway85 folded before Flop (didn't bet)
Seat 3: mitchymitch3 (button) folded before Flop (didn't bet)
Seat 4: Effort92 (small blind) folded before Flop
Seat 5: elbiber2000 (big blind) folded before Flop
Seat 6: godfrey004 folded before Flop (didn't bet)
Seat 7: sanpidk collected ($2.50)
Seat 9: matiko09 folded before Flop (didn't bet)





PokerStars Hand #151165877189:  Hold'em No Limit ($1/$2 USD) - 2016/03/30 16:50:36 CET [2016/03/30 10:50:36 ET]
Table 'Philoctetes II' 9-max Seat #4 is the button
Seat 1: vezunchik79 ($141.38 in chips) 
Seat 2: prominente ($217.91 in chips) 
Seat 3: mentalpshyco ($227.55 in chips) 
Seat 4: tepi_guy ($200 in chips) 
Seat 5: zhaimeng ($366.57 in chips) 
Seat 6: di0d80 ($200 in chips) 
Seat 7: matiko09 ($206.20 in chips) 
Seat 8: suddend3ath ($202 in chips) 
Seat 9: RamiroAgujis ($234.30 in chips) 
zhaimeng: posts small blind $1
di0d80: posts big blind $2
*** HOLE CARDS ***
Dealt to matiko09 [5c Kc]
matiko09 has timed out
matiko09: folds 
suddend3ath: folds 
RamiroAgujis: raises $5 to $7
vezunchik79: calls $7
prominente: folds 
mentalpshyco: folds 
tepi_guy: folds 
zhaimeng: folds 
di0d80: folds 
*** FLOP *** [As Ts Ks]
RamiroAgujis: bets $10
vezunchik79: calls $10
*** TURN *** [As Ts Ks] [Td]
RamiroAgujis: checks 
vezunchik79: checks 
*** RIVER *** [As Ts Ks Td] [8d]
RamiroAgujis: checks 
vezunchik79: checks 
*** SHOW DOWN ***
RamiroAgujis: shows [Ad Qs] (two pair, Aces and Tens)
vezunchik79: mucks hand 
RamiroAgujis collected $35.15 from pot
*** SUMMARY ***
Total pot $37 | Rake $1.85 
Board [As Ts Ks Td 8d]
Seat 1: vezunchik79 mucked [Kd Qh]
Seat 2: prominente folded before Flop (didn't bet)
Seat 3: mentalpshyco folded before Flop (didn't bet)
Seat 4: tepi_guy (button) folded before Flop (didn't bet)
Seat 5: zhaimeng (small blind) folded before Flop
Seat 6: di0d80 (big blind) folded before Flop
Seat 7: matiko09 folded before Flop (didn't bet)
Seat 8: suddend3ath folded before Flop (didn't bet)
Seat 9: RamiroAgujis showed [Ad Qs] and won ($35.15) with two pair, Aces and Tens





PokerStars Hand #151165891384:  Hold'em No Limit ($0.50/$1.00 USD) - 2016/03/30 16:50:57 CET [2016/03/30 10:50:57 ET]
Table 'Pannonia II' 9-max Seat #8 is the button
Seat 1: CI58 ($112.12 in chips) 
Seat 2: matiko09 ($100 in chips) 
Seat 3: MGL_Sky99 ($92.22 in chips) 
Seat 5: Spid1 ($143.32 in chips) 
Seat 6: lumen21 ($126.35 in chips) 
Seat 8: stonymalony ($79.54 in chips) 
Seat 9: Effort92 ($87.50 in chips) 
Effort92: posts small blind $0.50
CI58: posts big blind $1
SumPosad: sits out 
*** HOLE CARDS ***
Dealt to matiko09 [7s 3h]
matiko09: folds 
MGL_Sky99: folds 
Spid1: folds 
lumen21: folds 
stonymalony: raises $1 to $2
Effort92: folds 
CI58: calls $1
*** FLOP *** [Js 5d Ah]
CI58: checks 
stonymalony: checks 
*** TURN *** [Js 5d Ah] [6h]
CI58: bets $2.14
stonymalony: calls $2.14
*** RIVER *** [Js 5d Ah 6h] [3d]
CI58: checks 
stonymalony: checks 
*** SHOW DOWN ***
CI58: shows [5c 7c] (a pair of Fives)
stonymalony: shows [Ad 9h] (a pair of Aces)
stonymalony collected $8.34 from pot
*** SUMMARY ***
Total pot $8.78 | Rake $0.44 
Board [Js 5d Ah 6h 3d]
Seat 1: CI58 (big blind) showed [5c 7c] and lost with a pair of Fives
Seat 2: matiko09 folded before Flop (didn't bet)
Seat 3: MGL_Sky99 folded before Flop (didn't bet)
Seat 5: Spid1 folded before Flop (didn't bet)
Seat 6: lumen21 folded before Flop (didn't bet)
Seat 8: stonymalony (button) showed [Ad 9h] and won ($8.34) with a pair of Aces
Seat 9: Effort92 (small blind) folded before Flop





PokerStars Hand #151165891620:  Hold'em No Limit ($0.50/$1.00 USD) - 2016/03/30 16:50:57 CET [2016/03/30 10:50:57 ET]
Table 'Figneria III' 9-max Seat #9 is the button
Seat 1: matiko09 ($103.60 in chips) 
Seat 2: sanpidk ($108.20 in chips) 
Seat 3: lumen21 ($108.95 in chips) 
Seat 4: CI58 ($213.45 in chips) 
Seat 5: b_____a__242 ($85 in chips) 
Seat 7: holloway85 ($243.80 in chips) 
Seat 9: p.snow89 ($63.28 in chips) 
matiko09: posts small blind $0.50
sanpidk: posts big blind $1
RICKA16: sits out 
*** HOLE CARDS ***
Dealt to matiko09 [Ac 2c]
lumen21: folds 
CI58: folds 
b_____a__242: raises $1.51 to $2.51
holloway85: folds 
p.snow89: calls $2.51
matiko09: folds 
sanpidk: folds 
*** FLOP *** [8d Qc 3s]
b_____a__242: bets $2.16
p.snow89 is connected 
p.snow89: folds 
Uncalled bet ($2.16) returned to b_____a__242
b_____a__242 collected $6.19 from pot
b_____a__242: doesn't show hand 
*** SUMMARY ***
Total pot $6.52 | Rake $0.33 
Board [8d Qc 3s]
Seat 1: matiko09 (small blind) folded before Flop
Seat 2: sanpidk (big blind) folded before Flop
Seat 3: lumen21 folded before Flop (didn't bet)
Seat 4: CI58 folded before Flop (didn't bet)
Seat 5: b_____a__242 collected ($6.19)
Seat 7: holloway85 folded before Flop (didn't bet)
Seat 9: p.snow89 (button) folded on the Flop





PokerStars Hand #151165900311:  Hold'em No Limit ($1/$2 USD) - 2016/03/30 16:51:10 CET [2016/03/30 10:51:10 ET]
Table 'Jole' 9-max Seat #6 is the button
Seat 1: prominente ($215.58 in chips) 
Seat 2: InsomniaRU ($208.45 in chips) 
Seat 3: tipner ($200 in chips) 
Seat 4: GS_Sydney ($177.44 in chips) 
Seat 5: mentalpshyco ($200 in chips) 
Seat 6: King_ZéManel ($205 in chips) 
Seat 7: thecurv ($211.60 in chips) 
Seat 8: matiko09 ($328.50 in chips) 
Seat 9: RamiroAgujis ($272.76 in chips) 
thecurv: posts small blind $1
matiko09: posts big blind $2
*** HOLE CARDS ***
Dealt to matiko09 [5s 9h]
RamiroAgujis: folds 
prominente: folds 
InsomniaRU: folds 
tipner: folds 
GS_Sydney: raises $4 to $6
mentalpshyco: folds 
King_ZéManel: folds 
thecurv: folds 
matiko09: folds 
Uncalled bet ($4) returned to GS_Sydney
GS_Sydney collected $5 from pot
GS_Sydney: doesn't show hand 
*** SUMMARY ***
Total pot $5 | Rake $0 
Seat 1: prominente folded before Flop (didn't bet)
Seat 2: InsomniaRU folded before Flop (didn't bet)
Seat 3: tipner folded before Flop (didn't bet)
Seat 4: GS_Sydney collected ($5)
Seat 5: mentalpshyco folded before Flop (didn't bet)
Seat 6: King_ZéManel (button) folded before Flop (didn't bet)
Seat 7: thecurv (small blind) folded before Flop
Seat 8: matiko09 (big blind) folded before Flop
Seat 9: RamiroAgujis folded before Flop (didn't bet)





PokerStars Hand #151165914499:  Hold'em No Limit ($0.50/$1.00 USD) - 2016/03/30 16:51:31 CET [2016/03/30 10:51:31 ET]
Table 'Alcor II' 9-max Seat #4 is the button
Seat 2: holloway85 ($80.99 in chips) 
Seat 3: mitchymitch3 ($98.34 in chips) 
Seat 4: Effort92 ($87.50 in chips) 
Seat 5: elbiber2000 ($109.97 in chips) 
Seat 6: godfrey004 ($211.71 in chips) 
Seat 7: sanpidk ($101.50 in chips) 
Seat 9: matiko09 ($198.55 in chips) 
elbiber2000: posts small blind $0.50
godfrey004: posts big blind $1
RICKA16: sits out 
di0d80: sits out 
*** HOLE CARDS ***
Dealt to matiko09 [Qc 5s]
sanpidk: folds 
matiko09: folds 
holloway85: folds 
mitchymitch3: raises $2 to $3
Effort92: folds 
elbiber2000: folds 
godfrey004: calls $2
*** FLOP *** [3s Kh Qd]
godfrey004: checks 
mitchymitch3: checks 
*** TURN *** [3s Kh Qd] [7s]
godfrey004: bets $5
mitchymitch3: folds 
Uncalled bet ($5) returned to godfrey004
godfrey004 collected $6.18 from pot
*** SUMMARY ***
Total pot $6.50 | Rake $0.32 
Board [3s Kh Qd 7s]
Seat 2: holloway85 folded before Flop (didn't bet)
Seat 3: mitchymitch3 folded on the Turn
Seat 4: Effort92 (button) folded before Flop (didn't bet)
Seat 5: elbiber2000 (small blind) folded before Flop
Seat 6: godfrey004 (big blind) collected ($6.18)
Seat 7: sanpidk folded before Flop (didn't bet)
Seat 9: matiko09 folded before Flop (didn't bet)





PokerStars Hand #151165914942:  Hold'em No Limit ($0.50/$1.00 USD) - 2016/03/30 16:51:31 CET [2016/03/30 10:51:31 ET]
Table 'Hadwiger' 9-max Seat #6 is the button
Seat 1: AKplus ($92.38 in chips) 
Seat 2: di0d80 ($101.28 in chips) 
Seat 3: yuminyumin1 ($98.35 in chips) 
Seat 4: Westpants ($100 in chips) 
Seat 5: ardo888 ($100 in chips) 
Seat 6: xrisall_2 ($80.28 in chips) 
Seat 7: matiko09 ($111.11 in chips) 
Seat 8: 19SERGE74 ($60 in chips) 
Seat 9: IdiotFromNE ($108.67 in chips) 
matiko09: posts small blind $0.50
19SERGE74: posts big blind $1
*** HOLE CARDS ***
Dealt to matiko09 [6c 4h]
IdiotFromNE: folds 
AKplus: folds 
di0d80: folds 
yuminyumin1: raises $1 to $2
Westpants: folds 
ardo888: raises $5.50 to $7.50
xrisall_2: folds 
matiko09: folds 
19SERGE74: folds 
yuminyumin1: folds 
Uncalled bet ($5.50) returned to ardo888
ardo888 collected $5.50 from pot
ardo888: doesn't show hand 
*** SUMMARY ***
Total pot $5.50 | Rake $0 
Seat 1: AKplus folded before Flop (didn't bet)
Seat 2: di0d80 folded before Flop (didn't bet)
Seat 3: yuminyumin1 folded before Flop
Seat 4: Westpants folded before Flop (didn't bet)
Seat 5: ardo888 collected ($5.50)
Seat 6: xrisall_2 (button) folded before Flop (didn't bet)
Seat 7: matiko09 (small blind) folded before Flop
Seat 8: 19SERGE74 (big blind) folded before Flop
Seat 9: IdiotFromNE folded before Flop (didn't bet)





PokerStars Hand #151165919565:  Hold'em No Limit ($1/$2 USD) - 2016/03/30 16:51:38 CET [2016/03/30 10:51:38 ET]
Table 'Aesculapia II' 9-max Seat #4 is the button
Seat 2: suddend3ath ($271.35 in chips) 
Seat 3: matiko09 ($729.28 in chips) 
Seat 4: tepi_guy ($361.27 in chips) 
Seat 5: prominente ($200 in chips) 
Seat 6: mentalpshyco ($200 in chips) 
Seat 7: Rumboni66 ($129.62 in chips) 
Seat 8: kaya.ertugrul88 ($98 in chips) 
Seat 9: InsomniaRU ($200 in chips) 
prominente: posts small blind $1
mentalpshyco: posts big blind $2
T0ny Adams: sits out 
*** HOLE CARDS ***
Dealt to matiko09 [3d 2d]
Rumboni66: folds 
kaya.ertugrul88: calls $2
InsomniaRU: folds 
suddend3ath: raises $6 to $8
matiko09: folds 
tepi_guy: folds 
prominente: folds 
mentalpshyco: folds 
kaya.ertugrul88: calls $6
*** FLOP *** [Qd 3c 5s]
kaya.ertugrul88: checks 
suddend3ath: checks 
*** TURN *** [Qd 3c 5s] [3h]
kaya.ertugrul88: checks 
suddend3ath: bets $12
kaya.ertugrul88: folds 
Uncalled bet ($12) returned to suddend3ath
suddend3ath collected $18.05 from pot
suddend3ath: doesn't show hand 
*** SUMMARY ***
Total pot $19 | Rake $0.95 
Board [Qd 3c 5s 3h]
Seat 2: suddend3ath collected ($18.05)
Seat 3: matiko09 folded before Flop (didn't bet)
Seat 4: tepi_guy (button) folded before Flop (didn't bet)
Seat 5: prominente (small blind) folded before Flop
Seat 6: mentalpshyco (big blind) folded before Flop
Seat 7: Rumboni66 folded before Flop (didn't bet)
Seat 8: kaya.ertugrul88 folded on the Turn
Seat 9: InsomniaRU folded before Flop (didn't bet)





PokerStars Hand #151165926899:  Hold'em No Limit ($1/$2 USD) - 2016/03/30 16:51:49 CET [2016/03/30 10:51:49 ET]
Table 'Jole' 9-max Seat #7 is the button
Seat 1: prominente ($215.58 in chips) 
Seat 2: InsomniaRU ($208.45 in chips) 
Seat 3: tipner ($200 in chips) 
Seat 4: GS_Sydney ($180.44 in chips) 
Seat 5: mentalpshyco ($200 in chips) 
Seat 6: King_ZéManel ($205 in chips) 
Seat 7: thecurv ($210.60 in chips) 
Seat 8: matiko09 ($326.50 in chips) 
Seat 9: RamiroAgujis ($272.76 in chips) 
matiko09: posts small blind $1
RamiroAgujis: posts big blind $2
*** HOLE CARDS ***
Dealt to matiko09 [7h 4d]
prominente: raises $3 to $5
InsomniaRU: folds 
tipner: calls $5
GS_Sydney: folds 
mentalpshyco: folds 
King_ZéManel: folds 
thecurv: folds 
matiko09: folds 
RamiroAgujis: folds 
*** FLOP *** [6d As 3h]
prominente: bets $7.40
tipner: folds 
Uncalled bet ($7.40) returned to prominente
prominente collected $12.35 from pot
prominente: doesn't show hand 
*** SUMMARY ***
Total pot $13 | Rake $0.65 
Board [6d As 3h]
Seat 1: prominente collected ($12.35)
Seat 2: InsomniaRU folded before Flop (didn't bet)
Seat 3: tipner folded on the Flop
Seat 4: GS_Sydney folded before Flop (didn't bet)
Seat 5: mentalpshyco folded before Flop (didn't bet)
Seat 6: King_ZéManel folded before Flop (didn't bet)
Seat 7: thecurv (button) folded before Flop (didn't bet)
Seat 8: matiko09 (small blind) folded before Flop
Seat 9: RamiroAgujis (big blind) folded before Flop





PokerStars Hand #151165929847:  Hold'em No Limit ($0.50/$1.00 USD) - 2016/03/30 16:51:53 CET [2016/03/30 10:51:53 ET]
Table 'Pannonia II' 9-max Seat #9 is the button
Seat 1: CI58 ($107.98 in chips) 
Seat 2: matiko09 ($100 in chips) 
Seat 3: MGL_Sky99 ($92.22 in chips) 
Seat 5: Spid1 ($143.32 in chips) 
Seat 6: lumen21 ($126.35 in chips) 
Seat 8: stonymalony ($83.74 in chips) 
Seat 9: Effort92 ($87 in chips) 
CI58: posts small blind $0.50
matiko09: posts big blind $1
SumPosad: sits out 
*** HOLE CARDS ***
Dealt to matiko09 [Qd Ts]
MGL_Sky99: folds 
Spid1: raises $2 to $3
lumen21: folds 
stonymalony: folds 
Effort92: folds 
CI58: folds 
matiko09: folds 
Uncalled bet ($2) returned to Spid1
Spid1 collected $2.50 from pot
Spid1: doesn't show hand 
*** SUMMARY ***
Total pot $2.50 | Rake $0 
Seat 1: CI58 (small blind) folded before Flop
Seat 2: matiko09 (big blind) folded before Flop
Seat 3: MGL_Sky99 folded before Flop (didn't bet)
Seat 5: Spid1 collected ($2.50)
Seat 6: lumen21 folded before Flop (didn't bet)
Seat 8: stonymalony folded before Flop (didn't bet)
Seat 9: Effort92 (button) folded before Flop (didn't bet)





PokerStars Hand #151165941774:  Hold'em No Limit ($0.50/$1.00 USD) - 2016/03/30 16:52:11 CET [2016/03/30 10:52:11 ET]
Table 'Alcor II' 9-max Seat #5 is the button
Seat 2: holloway85 ($80.99 in chips) 
Seat 3: mitchymitch3 ($95.34 in chips) 
Seat 4: Effort92 ($87.50 in chips) 
Seat 5: elbiber2000 ($109.47 in chips) 
Seat 6: godfrey004 ($214.89 in chips) 
Seat 7: sanpidk ($101.50 in chips) 
Seat 9: matiko09 ($198.55 in chips) 
godfrey004: posts small blind $0.50
sanpidk: posts big blind $1
RICKA16: sits out 
di0d80: sits out 
*** HOLE CARDS ***
Dealt to matiko09 [5s 2c]
matiko09: folds 
holloway85: calls $1
mitchymitch3: calls $1
Effort92: folds 
elbiber2000: raises $4 to $5
godfrey004: raises $12 to $17
sanpidk: folds 
holloway85: folds 
mitchymitch3: folds 
elbiber2000: calls $12
*** FLOP *** [Kc Js Ah]
godfrey004: bets $24
elbiber2000: calls $24
*** TURN *** [Kc Js Ah] [7d]
godfrey004: bets $82.50
elbiber2000: folds 
Uncalled bet ($82.50) returned to godfrey004
godfrey004 collected $82.50 from pot
godfrey004: doesn't show hand 
*** SUMMARY ***
Total pot $85 | Rake $2.50 
Board [Kc Js Ah 7d]
Seat 2: holloway85 folded before Flop
Seat 3: mitchymitch3 folded before Flop
Seat 4: Effort92 folded before Flop (didn't bet)
Seat 5: elbiber2000 (button) folded on the Turn
Seat 6: godfrey004 (small blind) collected ($82.50)
Seat 7: sanpidk (big blind) folded before Flop
Seat 9: matiko09 folded before Flop (didn't bet)





PokerStars Hand #151165944918:  Hold'em No Limit ($0.50/$1.00 USD) - 2016/03/30 16:52:16 CET [2016/03/30 10:52:16 ET]
Table 'Hadwiger' 9-max Seat #7 is the button
Seat 1: AKplus ($92.38 in chips) 
Seat 2: di0d80 ($101.28 in chips) 
Seat 3: yuminyumin1 ($96.35 in chips) 
Seat 4: Westpants ($100 in chips) 
Seat 5: ardo888 ($103.50 in chips) 
Seat 6: xrisall_2 ($80.28 in chips) 
Seat 7: matiko09 ($110.61 in chips) 
Seat 8: 19SERGE74 ($60 in chips) 
Seat 9: IdiotFromNE ($108.67 in chips) 
19SERGE74: posts small blind $0.50
IdiotFromNE: posts big blind $1
*** HOLE CARDS ***
Dealt to matiko09 [7h 8d]
AKplus: folds 
di0d80: folds 
yuminyumin1: folds 
Westpants: raises $2 to $3
ardo888: folds 
xrisall_2: calls $3
matiko09: folds 
19SERGE74: raises $10 to $13
IdiotFromNE: folds 
Westpants: calls $10
xrisall_2: calls $10
*** FLOP *** [5s Ts 7s]
19SERGE74: bets $25.33
Westpants: folds 
xrisall_2: raises $36.67 to $62
19SERGE74: calls $21.67 and is all-in
Uncalled bet ($15) returned to xrisall_2
*** TURN *** [5s Ts 7s] [Td]
*** RIVER *** [5s Ts 7s Td] [3h]
*** SHOW DOWN ***
19SERGE74: shows [Qc Qs] (two pair, Queens and Tens)
xrisall_2: shows [5c 5h] (a full house, Fives full of Tens)
xrisall_2 collected $131.50 from pot
*** SUMMARY ***
Total pot $134 | Rake $2.50 
Board [5s Ts 7s Td 3h]
Seat 1: AKplus folded before Flop (didn't bet)
Seat 2: di0d80 folded before Flop (didn't bet)
Seat 3: yuminyumin1 folded before Flop (didn't bet)
Seat 4: Westpants folded on the Flop
Seat 5: ardo888 folded before Flop (didn't bet)
Seat 6: xrisall_2 showed [5c 5h] and won ($131.50) with a full house, Fives full of Tens
Seat 7: matiko09 (button) folded before Flop (didn't bet)
Seat 8: 19SERGE74 (small blind) showed [Qc Qs] and lost with two pair, Queens and Tens
Seat 9: IdiotFromNE (big blind) folded before Flop





PokerStars Hand #151165945224:  Hold'em No Limit ($0.50/$1.00 USD) - 2016/03/30 16:52:16 CET [2016/03/30 10:52:16 ET]
Table 'Figneria III' 9-max Seat #1 is the button
Seat 1: matiko09 ($103.10 in chips) 
Seat 2: sanpidk ($107.20 in chips) 
Seat 3: lumen21 ($108.95 in chips) 
Seat 4: CI58 ($213.45 in chips) 
Seat 5: b_____a__242 ($88.68 in chips) 
Seat 7: holloway85 ($243.80 in chips) 
Seat 9: p.snow89 ($60.77 in chips) 
sanpidk: posts small blind $0.50
lumen21: posts big blind $1
RICKA16: sits out 
*** HOLE CARDS ***
Dealt to matiko09 [Ad 3d]
CI58: folds 
b_____a__242: folds 
holloway85: folds 
p.snow89: folds 
matiko09: raises $1.27 to $2.27
sanpidk: calls $1.77
lumen21: calls $1.27
*** FLOP *** [2h 5h As]
sanpidk: checks 
lumen21: checks 
matiko09: checks 
*** TURN *** [2h 5h As] [Tc]
sanpidk: bets $4.50
lumen21: folds 
matiko09: calls $4.50
*** RIVER *** [2h 5h As Tc] [7s]
sanpidk: checks 
matiko09: checks 
*** SHOW DOWN ***
sanpidk: shows [Jc Kh] (high card Ace)
matiko09: shows [Ad 3d] (a pair of Aces)
matiko09 collected $15.02 from pot
*** SUMMARY ***
Total pot $15.81 | Rake $0.79 
Board [2h 5h As Tc 7s]
Seat 1: matiko09 (button) showed [Ad 3d] and won ($15.02) with a pair of Aces
Seat 2: sanpidk (small blind) showed [Jc Kh] and lost with high card Ace
Seat 3: lumen21 (big blind) folded on the Turn
Seat 4: CI58 folded before Flop (didn't bet)
Seat 5: b_____a__242 folded before Flop (didn't bet)
Seat 7: holloway85 folded before Flop (didn't bet)
Seat 9: p.snow89 folded before Flop (didn't bet)





PokerStars Hand #151165947027:  Hold'em No Limit ($0.50/$1.00 USD) - 2016/03/30 16:52:19 CET [2016/03/30 10:52:19 ET]
Table 'Pannonia II' 9-max Seat #1 is the button
Seat 1: CI58 ($107.48 in chips) 
Seat 2: matiko09 ($100 in chips) 
Seat 3: MGL_Sky99 ($92.22 in chips) 
Seat 5: Spid1 ($144.82 in chips) 
Seat 6: lumen21 ($126.35 in chips) 
Seat 8: stonymalony ($83.74 in chips) 
Seat 9: Effort92 ($87 in chips) 
matiko09: posts small blind $0.50
MGL_Sky99: posts big blind $1
SumPosad: sits out 
*** HOLE CARDS ***
Dealt to matiko09 [7s 5c]
Spid1: folds 
lumen21: folds 
stonymalony: raises $1 to $2
Effort92: folds 
CI58: folds 
matiko09: folds 
MGL_Sky99: calls $1
*** FLOP *** [Kh Tc 8c]
MGL_Sky99: checks 
stonymalony: checks 
*** TURN *** [Kh Tc 8c] [8s]
MGL_Sky99: bets $2.54
stonymalony: calls $2.54
*** RIVER *** [Kh Tc 8c 8s] [7c]
MGL_Sky99: bets $7.55
stonymalony: calls $7.55
*** SHOW DOWN ***
MGL_Sky99: shows [4d 6d] (a pair of Eights)
stonymalony: shows [8d Qh] (three of a kind, Eights)
stonymalony collected $23.45 from pot
*** SUMMARY ***
Total pot $24.68 | Rake $1.23 
Board [Kh Tc 8c 8s 7c]
Seat 1: CI58 (button) folded before Flop (didn't bet)
Seat 2: matiko09 (small blind) folded before Flop
Seat 3: MGL_Sky99 (big blind) showed [4d 6d] and lost with a pair of Eights
Seat 5: Spid1 folded before Flop (didn't bet)
Seat 6: lumen21 folded before Flop (didn't bet)
Seat 8: stonymalony showed [8d Qh] and won ($23.45) with three of a kind, Eights
Seat 9: Effort92 folded before Flop (didn't bet)





PokerStars Hand #151165954939:  Hold'em No Limit ($1/$2 USD) - 2016/03/30 16:52:30 CET [2016/03/30 10:52:30 ET]
Table 'Jole' 9-max Seat #8 is the button
Seat 1: prominente ($222.93 in chips) 
Seat 2: InsomniaRU ($208.45 in chips) 
Seat 3: tipner ($200 in chips) 
Seat 4: GS_Sydney ($180.44 in chips) 
Seat 5: mentalpshyco ($200 in chips) 
Seat 6: King_ZéManel ($205 in chips) 
Seat 7: thecurv ($210.60 in chips) 
Seat 8: matiko09 ($325.50 in chips) 
Seat 9: RamiroAgujis ($270.76 in chips) 
RamiroAgujis: posts small blind $1
prominente: posts big blind $2
*** HOLE CARDS ***
Dealt to matiko09 [5h 2c]
InsomniaRU: folds 
tipner: folds 
GS_Sydney: calls $2
mentalpshyco: folds 
King_ZéManel: raises $6 to $8
thecurv: folds 
matiko09: folds 
RamiroAgujis: folds 
prominente: folds 
GS_Sydney: calls $6
*** FLOP *** [8h 4c 9h]
GS_Sydney: checks 
King_ZéManel: bets $13.53
GS_Sydney: folds 
Uncalled bet ($13.53) returned to King_ZéManel
King_ZéManel collected $18.05 from pot
King_ZéManel: doesn't show hand 
*** SUMMARY ***
Total pot $19 | Rake $0.95 
Board [8h 4c 9h]
Seat 1: prominente (big blind) folded before Flop
Seat 2: InsomniaRU folded before Flop (didn't bet)
Seat 3: tipner folded before Flop (didn't bet)
Seat 4: GS_Sydney folded on the Flop
Seat 5: mentalpshyco folded before Flop (didn't bet)
Seat 6: King_ZéManel collected ($18.05)
Seat 7: thecurv folded before Flop (didn't bet)
Seat 8: matiko09 (button) folded before Flop (didn't bet)
Seat 9: RamiroAgujis (small blind) folded before Flop





PokerStars Hand #151165962035:  Hold'em No Limit ($1/$2 USD) - 2016/03/30 16:52:41 CET [2016/03/30 10:52:41 ET]
Table 'Aesculapia II' 9-max Seat #5 is the button
Seat 2: suddend3ath ($281.40 in chips) 
Seat 3: matiko09 ($729.28 in chips) 
Seat 4: tepi_guy ($361.27 in chips) 
Seat 5: prominente ($200 in chips) 
Seat 6: mentalpshyco ($200 in chips) 
Seat 7: Rumboni66 ($129.62 in chips) 
Seat 8: kaya.ertugrul88 ($90 in chips) 
Seat 9: InsomniaRU ($200 in chips) 
mentalpshyco: posts small blind $1
Rumboni66: posts big blind $2
T0ny Adams: sits out 
*** HOLE CARDS ***
Dealt to matiko09 [Ks 3d]
kaya.ertugrul88: calls $2
InsomniaRU: folds 
suddend3ath: folds 
matiko09: folds 
tepi_guy: folds 
prominente: folds 
mentalpshyco: folds 
Rumboni66: checks 
*** FLOP *** [Td 8s Th]
Rumboni66: checks 
kaya.ertugrul88: checks 
*** TURN *** [Td 8s Th] [5d]
Rumboni66: bets $2
kaya.ertugrul88: calls $2
*** RIVER *** [Td 8s Th 5d] [6c]
Rumboni66: bets $2
kaya.ertugrul88: folds 
Uncalled bet ($2) returned to Rumboni66
Rumboni66 collected $8.55 from pot
Rumboni66: doesn't show hand 
*** SUMMARY ***
Total pot $9 | Rake $0.45 
Board [Td 8s Th 5d 6c]
Seat 2: suddend3ath folded before Flop (didn't bet)
Seat 3: matiko09 folded before Flop (didn't bet)
Seat 4: tepi_guy folded before Flop (didn't bet)
Seat 5: prominente (button) folded before Flop (didn't bet)
Seat 6: mentalpshyco (small blind) folded before Flop
Seat 7: Rumboni66 (big blind) collected ($8.55)
Seat 8: kaya.ertugrul88 folded on the River
Seat 9: InsomniaRU folded before Flop (didn't bet)





PokerStars Hand #151165964198:  Hold'em No Limit ($1/$2 USD) - 2016/03/30 16:52:44 CET [2016/03/30 10:52:44 ET]
Table 'Philoctetes II' 9-max Seat #5 is the button
Seat 1: vezunchik79 ($124.38 in chips) 
Seat 2: prominente ($217.91 in chips) 
Seat 3: mentalpshyco ($227.55 in chips) 
Seat 4: tepi_guy ($200 in chips) 
Seat 5: zhaimeng ($365.57 in chips) 
Seat 6: di0d80 ($200 in chips) 
Seat 7: matiko09 ($206.20 in chips) 
Seat 8: suddend3ath ($202 in chips) 
Seat 9: RamiroAgujis ($252.45 in chips) 
di0d80: posts small blind $1
matiko09: posts big blind $2
*** HOLE CARDS ***
Dealt to matiko09 [2s 2d]
suddend3ath: raises $3 to $5
RamiroAgujis: folds 
vezunchik79: folds 
prominente: folds 
mentalpshyco: folds 
tepi_guy: folds 
zhaimeng: folds 
di0d80: folds 
matiko09: calls $3
*** FLOP *** [6s Js Ah]
matiko09: checks 
suddend3ath: checks 
*** TURN *** [6s Js Ah] [Ks]
matiko09: checks 
suddend3ath: checks 
*** RIVER *** [6s Js Ah Ks] [3d]
matiko09: checks 
suddend3ath: checks 
*** SHOW DOWN ***
matiko09: shows [2s 2d] (a pair of Deuces)
suddend3ath: shows [8d 8c] (a pair of Eights)
suddend3ath collected $10.45 from pot
*** SUMMARY ***
Total pot $11 | Rake $0.55 
Board [6s Js Ah Ks 3d]
Seat 1: vezunchik79 folded before Flop (didn't bet)
Seat 2: prominente folded before Flop (didn't bet)
Seat 3: mentalpshyco folded before Flop (didn't bet)
Seat 4: tepi_guy folded before Flop (didn't bet)
Seat 5: zhaimeng (button) folded before Flop (didn't bet)
Seat 6: di0d80 (small blind) folded before Flop
Seat 7: matiko09 (big blind) showed [2s 2d] and lost with a pair of Deuces
Seat 8: suddend3ath showed [8d 8c] and won ($10.45) with a pair of Eights
Seat 9: RamiroAgujis folded before Flop (didn't bet)





PokerStars Hand #151165991766:  Hold'em No Limit ($1/$2 USD) - 2016/03/30 16:53:25 CET [2016/03/30 10:53:25 ET]
Table 'Aesculapia II' 9-max Seat #6 is the button
Seat 2: suddend3ath ($281.40 in chips) 
Seat 3: matiko09 ($729.28 in chips) 
Seat 4: tepi_guy ($361.27 in chips) 
Seat 5: prominente ($200 in chips) 
Seat 6: mentalpshyco ($200 in chips) 
Seat 7: Rumboni66 ($134.17 in chips) 
Seat 8: kaya.ertugrul88 ($86 in chips) 
Seat 9: InsomniaRU ($200 in chips) 
Rumboni66: posts small blind $1
kaya.ertugrul88: posts big blind $2
T0ny Adams: sits out 
*** HOLE CARDS ***
Dealt to matiko09 [Qh 6s]
InsomniaRU: folds 
suddend3ath: folds 
matiko09: folds 
tepi_guy: folds 
prominente: raises $3 to $5
mentalpshyco: folds 
Rumboni66: folds 
kaya.ertugrul88: calls $3
*** FLOP *** [Ts Jc Th]
kaya.ertugrul88: checks 
prominente: bets $5.22
kaya.ertugrul88: raises $5.22 to $10.44
prominente: folds 
Uncalled bet ($5.22) returned to kaya.ertugrul88
kaya.ertugrul88 collected $20.37 from pot
kaya.ertugrul88: doesn't show hand 
*** SUMMARY ***
Total pot $21.44 | Rake $1.07 
Board [Ts Jc Th]
Seat 2: suddend3ath folded before Flop (didn't bet)
Seat 3: matiko09 folded before Flop (didn't bet)
Seat 4: tepi_guy folded before Flop (didn't bet)
Seat 5: prominente folded on the Flop
Seat 6: mentalpshyco (button) folded before Flop (didn't bet)
Seat 7: Rumboni66 (small blind) folded before Flop
Seat 8: kaya.ertugrul88 (big blind) collected ($20.37)
Seat 9: InsomniaRU folded before Flop (didn't bet)





PokerStars Hand #151165993566:  Hold'em No Limit ($1/$2 USD) - 2016/03/30 16:53:28 CET [2016/03/30 10:53:28 ET]
Table 'Jole' 9-max Seat #9 is the button
Seat 1: prominente ($220.93 in chips) 
Seat 2: InsomniaRU ($208.45 in chips) 
Seat 3: tipner ($200 in chips) 
Seat 4: GS_Sydney ($172.44 in chips) 
Seat 5: mentalpshyco ($200 in chips) 
Seat 6: King_ZéManel ($215.05 in chips) 
Seat 7: thecurv ($210.60 in chips) 
Seat 8: matiko09 ($325.50 in chips) 
Seat 9: RamiroAgujis ($269.76 in chips) 
prominente: posts small blind $1
InsomniaRU: posts big blind $2
*** HOLE CARDS ***
Dealt to matiko09 [9h 5c]
tipner: folds 
GS_Sydney: folds 
mentalpshyco: raises $3 to $5
King_ZéManel: folds 
thecurv: folds 
matiko09: folds 
RamiroAgujis: calls $5
prominente: calls $4
InsomniaRU: folds 
*** FLOP *** [Th 7c 3s]
prominente: checks 
mentalpshyco: bets $10
RamiroAgujis: folds 
prominente: calls $10
*** TURN *** [Th 7c 3s] [Jh]
prominente: checks 
mentalpshyco: checks 
*** RIVER *** [Th 7c 3s Jh] [5d]
prominente: bets $24.43
mentalpshyco: calls $24.43
*** SHOW DOWN ***
prominente: shows [7s 7d] (three of a kind, Sevens)
mentalpshyco: mucks hand 
prominente collected $83.11 from pot
*** SUMMARY ***
Total pot $85.86 | Rake $2.75 
Board [Th 7c 3s Jh 5d]
Seat 1: prominente (small blind) showed [7s 7d] and won ($83.11) with three of a kind, Sevens
Seat 2: InsomniaRU (big blind) folded before Flop
Seat 3: tipner folded before Flop (didn't bet)
Seat 4: GS_Sydney folded before Flop (didn't bet)
Seat 5: mentalpshyco mucked [Kc Ks]
Seat 6: King_ZéManel folded before Flop (didn't bet)
Seat 7: thecurv folded before Flop (didn't bet)
Seat 8: matiko09 folded before Flop (didn't bet)
Seat 9: RamiroAgujis (button) folded on the Flop





PokerStars Hand #151165994722:  Hold'em No Limit ($0.50/$1.00 USD) - 2016/03/30 16:53:29 CET [2016/03/30 10:53:29 ET]
Table 'Figneria III' 9-max Seat #2 is the button
Seat 1: matiko09 ($111.35 in chips) 
Seat 2: sanpidk ($100.43 in chips) 
Seat 3: lumen21 ($106.68 in chips) 
Seat 4: CI58 ($213.45 in chips) 
Seat 5: b_____a__242 ($88.68 in chips) 
Seat 7: holloway85 ($243.80 in chips) 
Seat 9: p.snow89 ($60.77 in chips) 
lumen21: posts small blind $0.50
CI58: posts big blind $1
RICKA16: sits out 
*** HOLE CARDS ***
Dealt to matiko09 [Js 7d]
b_____a__242: folds 
holloway85: folds 
p.snow89: calls $1
matiko09: folds 
sanpidk: folds 
lumen21: folds 
CI58: checks 
*** FLOP *** [9h 7c 5s]
CI58: checks 
p.snow89: checks 
*** TURN *** [9h 7c 5s] [8c]
CI58: checks 
p.snow89: checks 
*** RIVER *** [9h 7c 5s 8c] [Tc]
CI58: checks 
p.snow89: checks 
*** SHOW DOWN ***
CI58: shows [4c As] (high card Ace)
p.snow89: shows [4d Ah] (high card Ace)
CI58 collected $1.19 from pot
p.snow89 collected $1.19 from pot
*** SUMMARY ***
Total pot $2.50 | Rake $0.12 
Board [9h 7c 5s 8c Tc]
Seat 1: matiko09 folded before Flop (didn't bet)
Seat 2: sanpidk (button) folded before Flop (didn't bet)
Seat 3: lumen21 (small blind) folded before Flop
Seat 4: CI58 (big blind) showed [4c As] and won ($1.19) with high card Ace
Seat 5: b_____a__242 folded before Flop (didn't bet)
Seat 7: holloway85 folded before Flop (didn't bet)
Seat 9: p.snow89 showed [4d Ah] and won ($1.19) with high card Ace





PokerStars Hand #151165999009:  Hold'em No Limit ($0.50/$1.00 USD) - 2016/03/30 16:53:36 CET [2016/03/30 10:53:36 ET]
Table 'Hadwiger' 9-max Seat #8 is the button
Seat 1: AKplus ($92.38 in chips) 
Seat 2: di0d80 ($101.28 in chips) 
Seat 3: yuminyumin1 ($96.35 in chips) 
Seat 4: Westpants ($100 in chips) 
Seat 5: ardo888 ($103.50 in chips) 
Seat 6: xrisall_2 ($151.78 in chips) 
Seat 7: matiko09 ($110.61 in chips) 
Seat 8: 19SERGE74 ($60 in chips) 
Seat 9: IdiotFromNE ($107.67 in chips) 
IdiotFromNE: posts small blind $0.50
AKplus: posts big blind $1
*** HOLE CARDS ***
Dealt to matiko09 [3d Ah]
di0d80: folds 
yuminyumin1: folds 
Westpants: folds 
ardo888: folds 
xrisall_2: raises $3 to $4
matiko09: folds 
19SERGE74: folds 
19SERGE74 leaves the table
IdiotFromNE: folds 
AKplus: folds 
Uncalled bet ($3) returned to xrisall_2
xrisall_2 collected $2.50 from pot
xrisall_2: doesn't show hand 
*** SUMMARY ***
Total pot $2.50 | Rake $0 
Seat 1: AKplus (big blind) folded before Flop
Seat 2: di0d80 folded before Flop (didn't bet)
Seat 3: yuminyumin1 folded before Flop (didn't bet)
Seat 4: Westpants folded before Flop (didn't bet)
Seat 5: ardo888 folded before Flop (didn't bet)
Seat 6: xrisall_2 collected ($2.50)
Seat 7: matiko09 folded before Flop (didn't bet)
Seat 8: 19SERGE74 (button) folded before Flop (didn't bet)
Seat 9: IdiotFromNE (small blind) folded before Flop





PokerStars Hand #151166002424:  Hold'em No Limit ($0.50/$1.00 USD) - 2016/03/30 16:53:41 CET [2016/03/30 10:53:41 ET]
Table 'Pannonia II' 9-max Seat #2 is the button
Seat 1: CI58 ($107.48 in chips) 
Seat 2: matiko09 ($100 in chips) 
Seat 3: MGL_Sky99 ($80.13 in chips) 
Seat 4: SumPosad ($42.42 in chips) 
Seat 5: Spid1 ($144.82 in chips) 
Seat 6: lumen21 ($126.35 in chips) 
Seat 8: stonymalony ($95.10 in chips) 
Seat 9: Effort92 ($100 in chips) 
MGL_Sky99: posts small blind $0.50
SumPosad: posts big blind $1
*** HOLE CARDS ***
Dealt to matiko09 [7d 3d]
Spid1: folds 
lumen21: raises $2 to $3
stonymalony: calls $3
Effort92: folds 
CI58: folds 
matiko09: folds 
MGL_Sky99: folds 
SumPosad: calls $2
*** FLOP *** [Kd 5s 7h]
SumPosad: checks 
lumen21: bets $4.96
stonymalony: folds 
SumPosad: calls $4.96
*** TURN *** [Kd 5s 7h] [3c]
SumPosad: checks 
lumen21: checks 
*** RIVER *** [Kd 5s 7h 3c] [Jd]
SumPosad: bets $10
lumen21: calls $10
*** SHOW DOWN ***
SumPosad: shows [Qs Ks] (a pair of Kings)
lumen21: mucks hand 
SumPosad collected $37.45 from pot
*** SUMMARY ***
Total pot $39.42 | Rake $1.97 
Board [Kd 5s 7h 3c Jd]
Seat 1: CI58 folded before Flop (didn't bet)
Seat 2: matiko09 (button) folded before Flop (didn't bet)
Seat 3: MGL_Sky99 (small blind) folded before Flop
Seat 4: SumPosad (big blind) showed [Qs Ks] and won ($37.45) with a pair of Kings
Seat 5: Spid1 folded before Flop (didn't bet)
Seat 6: lumen21 mucked [Kh Th]
Seat 8: stonymalony folded on the Flop
Seat 9: Effort92 folded before Flop (didn't bet)





PokerStars Hand #151166007391:  Hold'em No Limit ($1/$2 USD) - 2016/03/30 16:53:48 CET [2016/03/30 10:53:48 ET]
Table 'Philoctetes II' 9-max Seat #6 is the button
Seat 1: vezunchik79 ($124.38 in chips) 
Seat 2: prominente ($217.91 in chips) 
Seat 3: mentalpshyco ($227.55 in chips) 
Seat 4: tepi_guy ($200 in chips) 
Seat 5: zhaimeng ($365.57 in chips) 
Seat 6: di0d80 ($200 in chips) 
Seat 7: matiko09 ($201.20 in chips) 
Seat 8: suddend3ath ($207.45 in chips) 
Seat 9: RamiroAgujis ($252.45 in chips) 
matiko09: posts small blind $1
suddend3ath: posts big blind $2
*** HOLE CARDS ***
Dealt to matiko09 [5d 2d]
RamiroAgujis: raises $5 to $7
vezunchik79: folds 
prominente: folds 
mentalpshyco: folds 
tepi_guy: folds 
zhaimeng: folds 
di0d80: folds 
matiko09: folds 
suddend3ath: folds 
Uncalled bet ($5) returned to RamiroAgujis
RamiroAgujis collected $5 from pot
RamiroAgujis: doesn't show hand 
*** SUMMARY ***
Total pot $5 | Rake $0 
Seat 1: vezunchik79 folded before Flop (didn't bet)
Seat 2: prominente folded before Flop (didn't bet)
Seat 3: mentalpshyco folded before Flop (didn't bet)
Seat 4: tepi_guy folded before Flop (didn't bet)
Seat 5: zhaimeng folded before Flop (didn't bet)
Seat 6: di0d80 (button) folded before Flop (didn't bet)
Seat 7: matiko09 (small blind) folded before Flop
Seat 8: suddend3ath (big blind) folded before Flop
Seat 9: RamiroAgujis collected ($5)





PokerStars Hand #151166018983:  Hold'em No Limit ($0.50/$1.00 USD) - 2016/03/30 16:54:05 CET [2016/03/30 10:54:05 ET]
Table 'Hadwiger' 9-max Seat #9 is the button
Seat 1: AKplus ($91.38 in chips) 
Seat 2: di0d80 ($101.28 in chips) 
Seat 3: yuminyumin1 ($96.35 in chips) 
Seat 4: Westpants ($100 in chips) 
Seat 5: ardo888 ($103.50 in chips) 
Seat 6: xrisall_2 ($153.28 in chips) 
Seat 7: matiko09 ($110.61 in chips) 
Seat 9: IdiotFromNE ($107.17 in chips) 
AKplus: posts small blind $0.50
di0d80: posts big blind $1
*** HOLE CARDS ***
Dealt to matiko09 [8h 6s]
yuminyumin1: calls $1
Westpants: folds 
ardo888: folds 
xrisall_2: folds 
sanpidk joins the table at seat #8 
sanpidk leaves the table
matiko09: folds 
IdiotFromNE: folds 
AKplus: calls $0.50
di0d80: checks 
*** FLOP *** [6d 9d 3d]
AKplus: checks 
di0d80: checks 
yuminyumin1: bets $2
AKplus: folds 
di0d80: folds 
Uncalled bet ($2) returned to yuminyumin1
yuminyumin1 collected $2.85 from pot
yuminyumin1: doesn't show hand 
*** SUMMARY ***
Total pot $3 | Rake $0.15 
Board [6d 9d 3d]
Seat 1: AKplus (small blind) folded on the Flop
Seat 2: di0d80 (big blind) folded on the Flop
Seat 3: yuminyumin1 collected ($2.85)
Seat 4: Westpants folded before Flop (didn't bet)
Seat 5: ardo888 folded before Flop (didn't bet)
Seat 6: xrisall_2 folded before Flop (didn't bet)
Seat 7: matiko09 folded before Flop (didn't bet)
Seat 9: IdiotFromNE (button) folded before Flop (didn't bet)





PokerStars Hand #151166025307:  Hold'em No Limit ($0.50/$1.00 USD) - 2016/03/30 16:54:14 CET [2016/03/30 10:54:14 ET]
Table 'Alcor II' 9-max Seat #6 is the button
Seat 2: holloway85 ($79.99 in chips) 
Seat 3: mitchymitch3 ($94.34 in chips) 
Seat 4: Effort92 ($100 in chips) 
Seat 5: elbiber2000 ($100 in chips) 
Seat 6: godfrey004 ($256.39 in chips) 
Seat 7: sanpidk ($100.50 in chips) 
Seat 8: RICKA16 ($289.06 in chips) 
Seat 9: matiko09 ($198.55 in chips) 
sanpidk: posts small blind $0.50
RICKA16: posts big blind $1
di0d80: sits out 
*** HOLE CARDS ***
Dealt to matiko09 [2d Kd]
matiko09: folds 
holloway85: folds 
mitchymitch3: raises $2 to $3
Effort92: folds 
elbiber2000: folds 
godfrey004: folds 
sanpidk: folds 
RICKA16: folds 
Uncalled bet ($2) returned to mitchymitch3
mitchymitch3 collected $2.50 from pot
mitchymitch3: doesn't show hand 
*** SUMMARY ***
Total pot $2.50 | Rake $0 
Seat 2: holloway85 folded before Flop (didn't bet)
Seat 3: mitchymitch3 collected ($2.50)
Seat 4: Effort92 folded before Flop (didn't bet)
Seat 5: elbiber2000 folded before Flop (didn't bet)
Seat 6: godfrey004 (button) folded before Flop (didn't bet)
Seat 7: sanpidk (small blind) folded before Flop
Seat 8: RICKA16 (big blind) folded before Flop
Seat 9: matiko09 folded before Flop (didn't bet)





PokerStars Hand #151166026568:  Hold'em No Limit ($0.50/$1.00 USD) - 2016/03/30 16:54:16 CET [2016/03/30 10:54:16 ET]
Table 'Figneria III' 9-max Seat #3 is the button
Seat 1: matiko09 ($111.35 in chips) 
Seat 2: sanpidk ($100.43 in chips) 
Seat 3: lumen21 ($106.18 in chips) 
Seat 4: CI58 ($213.64 in chips) 
Seat 5: b_____a__242 ($88.68 in chips) 
Seat 7: holloway85 ($243.80 in chips) 
Seat 9: p.snow89 ($60.96 in chips) 
CI58: posts small blind $0.50
b_____a__242: posts big blind $1
RICKA16: sits out 
*** HOLE CARDS ***
Dealt to matiko09 [5s Th]
holloway85: folds 
p.snow89: calls $1
matiko09: folds 
sanpidk: folds 
lumen21: folds 
CI58: raises $4 to $5
p.snow89 is disconnected 
b_____a__242: folds 
p.snow89 is connected 
p.snow89: calls $4
*** FLOP *** [2s Qd Jh]
CI58: checks 
p.snow89: checks 
*** TURN *** [2s Qd Jh] [3s]
CI58: checks 
p.snow89: checks 
*** RIVER *** [2s Qd Jh 3s] [7d]
CI58: checks 
p.snow89: checks 
*** SHOW DOWN ***
CI58: shows [Tc Ah] (high card Ace)
p.snow89: mucks hand 
CI58 collected $10.45 from pot
*** SUMMARY ***
Total pot $11 | Rake $0.55 
Board [2s Qd Jh 3s 7d]
Seat 1: matiko09 folded before Flop (didn't bet)
Seat 2: sanpidk folded before Flop (didn't bet)
Seat 3: lumen21 (button) folded before Flop (didn't bet)
Seat 4: CI58 (small blind) showed [Tc Ah] and won ($10.45) with high card Ace
Seat 5: b_____a__242 (big blind) folded before Flop
Seat 7: holloway85 folded before Flop (didn't bet)
Seat 9: p.snow89 mucked [Ad 4d]





PokerStars Hand #151166028747:  Hold'em No Limit ($1/$2 USD) - 2016/03/30 16:54:19 CET [2016/03/30 10:54:19 ET]
Table 'Philoctetes II' 9-max Seat #7 is the button
Seat 1: vezunchik79 ($124.38 in chips) 
Seat 2: prominente ($217.91 in chips) 
Seat 3: mentalpshyco ($227.55 in chips) 
Seat 4: tepi_guy ($200 in chips) 
Seat 5: zhaimeng ($365.57 in chips) 
Seat 6: di0d80 ($200 in chips) 
Seat 7: matiko09 ($200.20 in chips) 
Seat 8: suddend3ath ($205.45 in chips) 
Seat 9: RamiroAgujis ($255.45 in chips) 
suddend3ath: posts small blind $1
RamiroAgujis: posts big blind $2
*** HOLE CARDS ***
Dealt to matiko09 [Qs 5h]
vezunchik79: folds 
prominente: folds 
mentalpshyco: folds 
tepi_guy: folds 
zhaimeng: raises $5 to $7
di0d80: folds 
matiko09: folds 
suddend3ath: raises $14 to $21
RamiroAgujis: folds 
zhaimeng: calls $14
*** FLOP *** [Ks 9s 8h]
suddend3ath: bets $28
zhaimeng: calls $28
*** TURN *** [Ks 9s 8h] [Ac]
suddend3ath: bets $42
zhaimeng: calls $42
*** RIVER *** [Ks 9s 8h Ac] [2c]
suddend3ath: checks 
zhaimeng: checks 
*** SHOW DOWN ***
suddend3ath: shows [Kh Qh] (a pair of Kings)
zhaimeng: shows [Js Ad] (a pair of Aces)
zhaimeng collected $181.25 from pot
*** SUMMARY ***
Total pot $184 | Rake $2.75 
Board [Ks 9s 8h Ac 2c]
Seat 1: vezunchik79 folded before Flop (didn't bet)
Seat 2: prominente folded before Flop (didn't bet)
Seat 3: mentalpshyco folded before Flop (didn't bet)
Seat 4: tepi_guy folded before Flop (didn't bet)
Seat 5: zhaimeng showed [Js Ad] and won ($181.25) with a pair of Aces
Seat 6: di0d80 folded before Flop (didn't bet)
Seat 7: matiko09 (button) folded before Flop (didn't bet)
Seat 8: suddend3ath (small blind) showed [Kh Qh] and lost with a pair of Kings
Seat 9: RamiroAgujis (big blind) folded before Flop





PokerStars Hand #151166033546:  Hold'em No Limit ($1/$2 USD) - 2016/03/30 16:54:26 CET [2016/03/30 10:54:26 ET]
Table 'Aesculapia II' 9-max Seat #7 is the button
Seat 2: suddend3ath ($281.40 in chips) 
Seat 3: matiko09 ($729.28 in chips) 
Seat 4: tepi_guy ($361.27 in chips) 
Seat 5: prominente ($200 in chips) 
Seat 6: mentalpshyco ($200 in chips) 
Seat 7: Rumboni66 ($133.17 in chips) 
Seat 8: kaya.ertugrul88 ($96.15 in chips) 
Seat 9: InsomniaRU ($200 in chips) 
kaya.ertugrul88: posts small blind $1
InsomniaRU: posts big blind $2
T0ny Adams: sits out 
*** HOLE CARDS ***
Dealt to matiko09 [8s 3d]
suddend3ath: folds 
matiko09: folds 
tepi_guy: folds 
prominente: raises $3 to $5
mentalpshyco: folds 
Rumboni66: folds 
kaya.ertugrul88: calls $4
InsomniaRU: calls $3
*** FLOP *** [Ad 9h 5c]
kaya.ertugrul88: checks 
InsomniaRU: checks 
prominente: bets $5
kaya.ertugrul88: folds 
InsomniaRU: calls $5
*** TURN *** [Ad 9h 5c] [7c]
InsomniaRU: checks 
prominente: checks 
*** RIVER *** [Ad 9h 5c 7c] [Th]
InsomniaRU: checks 
prominente: checks 
*** SHOW DOWN ***
InsomniaRU: shows [9c Qd] (a pair of Nines)
prominente: shows [6h Ah] (a pair of Aces)
prominente collected $23.75 from pot
*** SUMMARY ***
Total pot $25 | Rake $1.25 
Board [Ad 9h 5c 7c Th]
Seat 2: suddend3ath folded before Flop (didn't bet)
Seat 3: matiko09 folded before Flop (didn't bet)
Seat 4: tepi_guy folded before Flop (didn't bet)
Seat 5: prominente showed [6h Ah] and won ($23.75) with a pair of Aces
Seat 6: mentalpshyco folded before Flop (didn't bet)
Seat 7: Rumboni66 (button) folded before Flop (didn't bet)
Seat 8: kaya.ertugrul88 (small blind) folded on the Flop
Seat 9: InsomniaRU (big blind) showed [9c Qd] and lost with a pair of Nines





PokerStars Hand #151166037172:  Hold'em No Limit ($1/$2 USD) - 2016/03/30 16:54:31 CET [2016/03/30 10:54:31 ET]
Table 'Sadalbari' 9-max Seat #2 is the button
Seat 2: Rycious ($77 in chips) 
Seat 3: thecurv ($200 in chips) 
Seat 4: matiko09 ($200 in chips) 
Seat 6: King_ZéManel ($236.25 in chips) 
Seat 8: RamiroAgujis ($203 in chips) 
Seat 9: InsomniaRU ($205 in chips) 
thecurv: posts small blind $1
matiko09: posts big blind $2
prominente: sits out 
*** HOLE CARDS ***
Dealt to matiko09 [4s 6h]
King_ZéManel: folds 
RamiroAgujis: folds 
InsomniaRU: folds 
Rycious: calls $2
RamiroAgujis leaves the table
thecurv: calls $1
matiko09: checks 
*** FLOP *** [Kc Tc 9d]
thecurv: checks 
matiko09: checks 
Rycious: bets $2
thecurv: folds 
matiko09: folds 
Uncalled bet ($2) returned to Rycious
Rycious collected $5.70 from pot
Rycious: doesn't show hand 
*** SUMMARY ***
Total pot $6 | Rake $0.30 
Board [Kc Tc 9d]
Seat 2: Rycious (button) collected ($5.70)
Seat 3: thecurv (small blind) folded on the Flop
Seat 4: matiko09 (big blind) folded on the Flop
Seat 6: King_ZéManel folded before Flop (didn't bet)
Seat 8: RamiroAgujis folded before Flop (didn't bet)
Seat 9: InsomniaRU folded before Flop (didn't bet)





PokerStars Hand #151166055274:  Hold'em No Limit ($0.50/$1.00 USD) - 2016/03/30 16:54:58 CET [2016/03/30 10:54:58 ET]
Table 'Alcor II' 9-max Seat #7 is the button
Seat 2: holloway85 ($79.99 in chips) 
Seat 3: mitchymitch3 ($95.84 in chips) 
Seat 4: Effort92 ($100 in chips) 
Seat 5: elbiber2000 ($100 in chips) 
Seat 6: godfrey004 ($256.39 in chips) 
Seat 7: sanpidk ($100 in chips) 
Seat 8: RICKA16 ($288.06 in chips) 
Seat 9: matiko09 ($198.55 in chips) 
RICKA16: posts small blind $0.50
matiko09: posts big blind $1
di0d80: sits out 
*** HOLE CARDS ***
Dealt to matiko09 [5s 2d]
holloway85: folds 
mitchymitch3: folds 
Effort92: raises $1.50 to $2.50
elbiber2000: folds 
godfrey004: raises $5.50 to $8
sanpidk: folds 
RICKA16: folds 
matiko09: folds 
Effort92: raises $13 to $21
godfrey004: calls $13
*** FLOP *** [2h 5h 6s]
Effort92: checks 
godfrey004: checks 
*** TURN *** [2h 5h 6s] [2s]
Effort92: bets $21
godfrey004: calls $21
*** RIVER *** [2h 5h 6s 2s] [6h]
Effort92: bets $58 and is all-in
godfrey004: calls $58
*** SHOW DOWN ***
Effort92: shows [Ah As] (two pair, Aces and Sixes)
godfrey004: mucks hand 
Effort92 collected $199 from pot
*** SUMMARY ***
Total pot $201.50 | Rake $2.50 
Board [2h 5h 6s 2s 6h]
Seat 2: holloway85 folded before Flop (didn't bet)
Seat 3: mitchymitch3 folded before Flop (didn't bet)
Seat 4: Effort92 showed [Ah As] and won ($199) with two pair, Aces and Sixes
Seat 5: elbiber2000 folded before Flop (didn't bet)
Seat 6: godfrey004 mucked [Qh Qc]
Seat 7: sanpidk (button) folded before Flop (didn't bet)
Seat 8: RICKA16 (small blind) folded before Flop
Seat 9: matiko09 (big blind) folded before Flop





PokerStars Hand #151166056432:  Hold'em No Limit ($1/$2 USD) - 2016/03/30 16:55:00 CET [2016/03/30 10:55:00 ET]
Table 'Sadalbari' 9-max Seat #3 is the button
Seat 2: Rycious ($80.70 in chips) 
Seat 3: thecurv ($200 in chips) 
Seat 4: matiko09 ($200 in chips) 
Seat 7: prominente ($200 in chips) 
Seat 9: InsomniaRU ($205 in chips) 
matiko09: posts small blind $1
King_ZéManel: is sitting out 
prominente: posts big blind $2
*** HOLE CARDS ***
Dealt to matiko09 [Qh As]
InsomniaRU: folds 
Rycious: folds 
thecurv: calls $2
matiko09: raises $8 to $10
prominente: folds 
thecurv: folds 
Uncalled bet ($8) returned to matiko09
matiko09 collected $6 from pot
matiko09: doesn't show hand 
*** SUMMARY ***
Total pot $6 | Rake $0 
Seat 2: Rycious folded before Flop (didn't bet)
Seat 3: thecurv (button) folded before Flop
Seat 4: matiko09 (small blind) collected ($6)
Seat 7: prominente (big blind) folded before Flop
Seat 9: InsomniaRU folded before Flop (didn't bet)





PokerStars Hand #151166060003:  Hold'em No Limit ($0.50/$1.00 USD) - 2016/03/30 16:55:05 CET [2016/03/30 10:55:05 ET]
Table 'Hadwiger' 9-max Seat #1 is the button
Seat 1: AKplus ($90.38 in chips) 
Seat 2: di0d80 ($100.28 in chips) 
Seat 3: yuminyumin1 ($98.20 in chips) 
Seat 4: Westpants ($100 in chips) 
Seat 5: ardo888 ($103.50 in chips) 
Seat 6: xrisall_2 ($153.28 in chips) 
Seat 7: matiko09 ($110.61 in chips) 
Seat 9: IdiotFromNE ($107.17 in chips) 
di0d80: posts small blind $0.50
yuminyumin1: posts big blind $1
*** HOLE CARDS ***
Dealt to matiko09 [2s 7c]
Westpants: folds 
ardo888: raises $2 to $3
xrisall_2: folds 
matiko09: folds 
IdiotFromNE: folds 
AKplus: folds 
di0d80: folds 
yuminyumin1: folds 
Uncalled bet ($2) returned to ardo888
ardo888 collected $2.50 from pot
ardo888: doesn't show hand 
*** SUMMARY ***
Total pot $2.50 | Rake $0 
Seat 1: AKplus (button) folded before Flop (didn't bet)
Seat 2: di0d80 (small blind) folded before Flop
Seat 3: yuminyumin1 (big blind) folded before Flop
Seat 4: Westpants folded before Flop (didn't bet)
Seat 5: ardo888 collected ($2.50)
Seat 6: xrisall_2 folded before Flop (didn't bet)
Seat 7: matiko09 folded before Flop (didn't bet)
Seat 9: IdiotFromNE folded before Flop (didn't bet)





PokerStars Hand #151166062519:  Hold'em No Limit ($1/$2 USD) - 2016/03/30 16:55:09 CET [2016/03/30 10:55:09 ET]
Table 'Jole' 9-max Seat #1 is the button
Seat 1: prominente ($264.61 in chips) 
Seat 2: InsomniaRU ($206.45 in chips) 
Seat 3: tipner ($200 in chips) 
Seat 4: GS_Sydney ($172.44 in chips) 
Seat 5: mentalpshyco ($200 in chips) 
Seat 6: King_ZéManel ($215.05 in chips) 
Seat 7: thecurv ($210.60 in chips) 
Seat 8: matiko09 ($325.50 in chips) 
Seat 9: RamiroAgujis ($264.76 in chips) 
InsomniaRU: posts small blind $1
tipner: posts big blind $2
*** HOLE CARDS ***
Dealt to matiko09 [4c 6h]
GS_Sydney: calls $2
mentalpshyco: raises $6 to $8
King_ZéManel: calls $8
thecurv: folds 
matiko09: folds 
RamiroAgujis: calls $8
prominente: folds 
InsomniaRU: folds 
tipner: folds 
GS_Sydney: calls $6
*** FLOP *** [7d Jd Qh]
GS_Sydney: checks 
mentalpshyco: bets $18
King_ZéManel: calls $18
RamiroAgujis: folds 
GS_Sydney: calls $18
*** TURN *** [7d Jd Qh] [3s]
GS_Sydney: checks 
mentalpshyco: bets $50
King_ZéManel: calls $50
GS_Sydney: folds 
*** RIVER *** [7d Jd Qh 3s] [4h]
mentalpshyco: checks 
King_ZéManel: checks 
*** SHOW DOWN ***
mentalpshyco: shows [Ac Qs] (a pair of Queens)
King_ZéManel: shows [As Ad] (a pair of Aces)
King_ZéManel collected $186.25 from pot
*** SUMMARY ***
Total pot $189 | Rake $2.75 
Board [7d Jd Qh 3s 4h]
Seat 1: prominente (button) folded before Flop (didn't bet)
Seat 2: InsomniaRU (small blind) folded before Flop
Seat 3: tipner (big blind) folded before Flop
Seat 4: GS_Sydney folded on the Turn
Seat 5: mentalpshyco showed [Ac Qs] and lost with a pair of Queens
Seat 6: King_ZéManel showed [As Ad] and won ($186.25) with a pair of Aces
Seat 7: thecurv folded before Flop (didn't bet)
Seat 8: matiko09 folded before Flop (didn't bet)
Seat 9: RamiroAgujis folded on the Flop





PokerStars Hand #151166064406:  Hold'em No Limit ($0.50/$1.00 USD) - 2016/03/30 16:55:12 CET [2016/03/30 10:55:12 ET]
Table 'Sirona II' 9-max Seat #5 is the button
Seat 1: funXmun ($112.64 in chips) 
Seat 2: koutani7 ($138.24 in chips) 
Seat 4: RICKA16 ($87.98 in chips) 
Seat 5: bragutza ($256.27 in chips) 
Seat 6: lumen21 ($100 in chips) 
Seat 7: matiko09 ($153.91 in chips) 
Seat 8: sanpidk ($100 in chips) 
Seat 9: mycka86 ($230.60 in chips) 
lumen21: posts small blind $0.50
matiko09: posts big blind $1
*** HOLE CARDS ***
Dealt to matiko09 [9d Jd]
sanpidk: folds 
mycka86: folds 
funXmun: folds 
koutani7: folds 
RICKA16: folds 
bragutza: calls $1
claudioneamt joins the table at seat #3 
lumen21: folds 
matiko09: checks 
*** FLOP *** [5d 7s 9h]
matiko09: bets $1.55
bragutza: folds 
Uncalled bet ($1.55) returned to matiko09
matiko09 collected $2.38 from pot
matiko09: doesn't show hand 
*** SUMMARY ***
Total pot $2.50 | Rake $0.12 
Board [5d 7s 9h]
Seat 1: funXmun folded before Flop (didn't bet)
Seat 2: koutani7 folded before Flop (didn't bet)
Seat 4: RICKA16 folded before Flop (didn't bet)
Seat 5: bragutza (button) folded on the Flop
Seat 6: lumen21 (small blind) folded before Flop
Seat 7: matiko09 (big blind) collected ($2.38)
Seat 8: sanpidk folded before Flop (didn't bet)
Seat 9: mycka86 folded before Flop (didn't bet)





PokerStars Hand #151166067770:  Hold'em No Limit ($1/$2 USD) - 2016/03/30 16:55:18 CET [2016/03/30 10:55:18 ET]
Table 'Sadalbari' 9-max Seat #4 is the button
Seat 2: Rycious ($80.70 in chips) 
Seat 3: thecurv ($200 in chips) 
Seat 4: matiko09 ($204 in chips) 
Seat 7: prominente ($200 in chips) 
King_ZéManel will be allowed to play after the button
prominente: posts small blind $1
InsomniaRU: is sitting out 
InsomniaRU leaves the table
Rycious: posts big blind $2
*** HOLE CARDS ***
Dealt to matiko09 [Ad Ts]
thecurv: folds 
matiko09: raises $2.54 to $4.54
prominente: folds 
Rycious: folds 
Uncalled bet ($2.54) returned to matiko09
matiko09 collected $5 from pot
matiko09: doesn't show hand 
*** SUMMARY ***
Total pot $5 | Rake $0 
Seat 2: Rycious (big blind) folded before Flop
Seat 3: thecurv folded before Flop (didn't bet)
Seat 4: matiko09 (button) collected ($5)
Seat 7: prominente (small blind) folded before Flop





PokerStars Hand #151166070772:  Hold'em No Limit ($0.50/$1.00 USD) - 2016/03/30 16:55:23 CET [2016/03/30 10:55:23 ET]
Table 'Pannonia II' 9-max Seat #3 is the button
Seat 1: CI58 ($107.48 in chips) 
Seat 2: matiko09 ($100 in chips) 
Seat 3: MGL_Sky99 ($79.63 in chips) 
Seat 4: SumPosad ($61.91 in chips) 
Seat 5: Spid1 ($144.82 in chips) 
Seat 6: lumen21 ($108.39 in chips) 
Seat 8: stonymalony ($92.10 in chips) 
Seat 9: Effort92 ($100 in chips) 
SumPosad: posts small blind $0.50
Spid1: posts big blind $1
*** HOLE CARDS ***
Dealt to matiko09 [8d 2h]
lumen21 has timed out
lumen21: folds 
stonymalony: raises $2 to $3
Effort92: folds 
CI58: folds 
matiko09: folds 
MGL_Sky99: folds 
SumPosad: folds 
Spid1: raises $9 to $12
stonymalony: calls $9
*** FLOP *** [Ad Th 4d]
Spid1: bets $14
stonymalony: calls $14
*** TURN *** [Ad Th 4d] [5c]
Spid1: checks 
stonymalony: bets $30
Spid1: raises $88.82 to $118.82 and is all-in
stonymalony: calls $36.10 and is all-in
Uncalled bet ($52.72) returned to Spid1
*** RIVER *** [Ad Th 4d 5c] [6s]
*** SHOW DOWN ***
Spid1: shows [Ah As] (three of a kind, Aces)
stonymalony: shows [Td Ts] (three of a kind, Tens)
Spid1 collected $182.20 from pot
*** SUMMARY ***
Total pot $184.70 | Rake $2.50 
Board [Ad Th 4d 5c 6s]
Seat 1: CI58 folded before Flop (didn't bet)
Seat 2: matiko09 folded before Flop (didn't bet)
Seat 3: MGL_Sky99 (button) folded before Flop (didn't bet)
Seat 4: SumPosad (small blind) folded before Flop
Seat 5: Spid1 (big blind) showed [Ah As] and won ($182.20) with three of a kind, Aces
Seat 6: lumen21 folded before Flop (didn't bet)
Seat 8: stonymalony showed [Td Ts] and lost with three of a kind, Tens
Seat 9: Effort92 folded before Flop (didn't bet)





PokerStars Hand #151166075054:  Hold'em No Limit ($1/$2 USD) - 2016/03/30 16:55:31 CET [2016/03/30 10:55:31 ET]
Table 'Sadalbari' 9-max Seat #7 is the button
Seat 2: Rycious ($78.70 in chips) 
Seat 3: thecurv ($200 in chips) 
Seat 4: matiko09 ($207 in chips) 
Seat 7: prominente ($200 in chips) 
Rycious: posts small blind $1
thecurv: posts big blind $2
King_ZéManel: sits out 
*** HOLE CARDS ***
Dealt to matiko09 [5d 5c]
matiko09: raises $3 to $5
fonng joins the table at seat #9 
prominente: folds 
RamiroAgujis joins the table at seat #5 
Rycious: calls $4
thecurv: folds 
*** FLOP *** [7h 2s 9c]
Rycious: bets $4
matiko09: calls $4
*** TURN *** [7h 2s 9c] [Jh]
Rycious: bets $9
matiko09: folds 
Uncalled bet ($9) returned to Rycious
Rycious collected $19 from pot
Rycious: doesn't show hand 
*** SUMMARY ***
Total pot $20 | Rake $1 
Board [7h 2s 9c Jh]
Seat 2: Rycious (small blind) collected ($19)
Seat 3: thecurv (big blind) folded before Flop
Seat 4: matiko09 folded on the Turn
Seat 7: prominente (button) folded before Flop (didn't bet)





PokerStars Hand #151166082540:  Hold'em No Limit ($1/$2 USD) - 2016/03/30 16:55:44 CET [2016/03/30 10:55:44 ET]
Table 'Philoctetes II' 9-max Seat #8 is the button
Seat 1: vezunchik79 ($124.38 in chips) 
Seat 2: prominente ($217.91 in chips) 
Seat 3: mentalpshyco ($227.55 in chips) 
Seat 4: tepi_guy ($200 in chips) 
Seat 5: zhaimeng ($455.82 in chips) 
Seat 6: di0d80 ($200 in chips) 
Seat 7: matiko09 ($200.20 in chips) 
Seat 8: suddend3ath ($200 in chips) 
Seat 9: RamiroAgujis ($253.45 in chips) 
RamiroAgujis: posts small blind $1
vezunchik79: posts big blind $2
*** HOLE CARDS ***
Dealt to matiko09 [8s 9s]
prominente: raises $3 to $5
mentalpshyco: folds 
tepi_guy: folds 
zhaimeng: calls $5
tepi_guy leaves the table
di0d80: folds 
matiko09: calls $5
suddend3ath: folds 
RamiroAgujis: folds 
InsomniaRU joins the table at seat #4 
InsomniaRU leaves the table
vezunchik79: folds 
*** FLOP *** [8d 2c Jh]
prominente: checks 
zhaimeng: bets $17.10
matiko09: folds 
prominente: folds 
Uncalled bet ($17.10) returned to zhaimeng
zhaimeng collected $17.10 from pot
zhaimeng: doesn't show hand 
*** SUMMARY ***
Total pot $18 | Rake $0.90 
Board [8d 2c Jh]
Seat 1: vezunchik79 (big blind) folded before Flop
Seat 2: prominente folded on the Flop
Seat 3: mentalpshyco folded before Flop (didn't bet)
Seat 4: tepi_guy folded before Flop (didn't bet)
Seat 5: zhaimeng collected ($17.10)
Seat 6: di0d80 folded before Flop (didn't bet)
Seat 7: matiko09 folded on the Flop
Seat 8: suddend3ath (button) folded before Flop (didn't bet)
Seat 9: RamiroAgujis (small blind) folded before Flop





PokerStars Hand #151166084983:  Hold'em No Limit ($1/$2 USD) - 2016/03/30 16:55:48 CET [2016/03/30 10:55:48 ET]
Table 'Aesculapia II' 9-max Seat #8 is the button
Seat 1: T0ny Adams ($80 in chips) 
Seat 2: suddend3ath ($281.40 in chips) 
Seat 3: matiko09 ($729.28 in chips) 
Seat 4: tepi_guy ($361.27 in chips) 
Seat 5: prominente ($213.75 in chips) 
Seat 6: mentalpshyco ($200 in chips) 
Seat 7: Rumboni66 ($133.17 in chips) 
Seat 8: kaya.ertugrul88 ($91.15 in chips) 
Seat 9: InsomniaRU ($200 in chips) 
InsomniaRU: posts small blind $1
T0ny Adams: posts big blind $2
*** HOLE CARDS ***
Dealt to matiko09 [Jh 2c]
suddend3ath: raises $3 to $5
matiko09: folds 
tepi_guy: folds 
prominente: calls $5
mentalpshyco: folds 
Rumboni66: folds 
tepi_guy leaves the table
di0d80 joins the table at seat #4 
di0d80 leaves the table
kaya.ertugrul88 has timed out
kaya.ertugrul88: folds 
InsomniaRU: folds 
T0ny Adams: calls $3
*** FLOP *** [Ad 6s 6c]
T0ny Adams: checks 
suddend3ath: checks 
prominente: checks 
*** TURN *** [Ad 6s 6c] [5d]
T0ny Adams: checks 
suddend3ath: bets $10
prominente: calls $10
T0ny Adams: folds 
*** RIVER *** [Ad 6s 6c 5d] [8s]
suddend3ath: bets $22
prominente: calls $22
*** SHOW DOWN ***
suddend3ath: shows [5h 5s] (a full house, Fives full of Sixes)
prominente: mucks hand 
suddend3ath collected $77.25 from pot
*** SUMMARY ***
Total pot $80 | Rake $2.75 
Board [Ad 6s 6c 5d 8s]
Seat 1: T0ny Adams (big blind) folded on the Turn
Seat 2: suddend3ath showed [5h 5s] and won ($77.25) with a full house, Fives full of Sixes
Seat 3: matiko09 folded before Flop (didn't bet)
Seat 4: tepi_guy folded before Flop (didn't bet)
Seat 5: prominente mucked [Kd Ac]
Seat 6: mentalpshyco folded before Flop (didn't bet)
Seat 7: Rumboni66 folded before Flop (didn't bet)
Seat 8: kaya.ertugrul88 (button) folded before Flop (didn't bet)
Seat 9: InsomniaRU (small blind) folded before Flop





PokerStars Hand #151166085271:  Hold'em No Limit ($0.50/$1.00 USD) - 2016/03/30 16:55:48 CET [2016/03/30 10:55:48 ET]
Table 'Hadwiger' 9-max Seat #2 is the button
Seat 2: di0d80 ($100 in chips) 
Seat 3: yuminyumin1 ($97.20 in chips) 
Seat 4: Westpants ($100 in chips) 
Seat 5: ardo888 ($105 in chips) 
Seat 6: xrisall_2 ($153.28 in chips) 
Seat 7: matiko09 ($110.61 in chips) 
Seat 9: IdiotFromNE ($107.17 in chips) 
yuminyumin1: posts small blind $0.50
Westpants: posts big blind $1
*** HOLE CARDS ***
Dealt to matiko09 [9s Td]
ardo888: folds 
xrisall_2: folds 
matiko09: folds 
IdiotFromNE: folds 
di0d80: raises $1 to $2
yuminyumin1: folds 
Westpants: folds 
Uncalled bet ($1) returned to di0d80
di0d80 collected $2.50 from pot
di0d80: doesn't show hand 
*** SUMMARY ***
Total pot $2.50 | Rake $0 
Seat 2: di0d80 (button) collected ($2.50)
Seat 3: yuminyumin1 (small blind) folded before Flop
Seat 4: Westpants (big blind) folded before Flop
Seat 5: ardo888 folded before Flop (didn't bet)
Seat 6: xrisall_2 folded before Flop (didn't bet)
Seat 7: matiko09 folded before Flop (didn't bet)
Seat 9: IdiotFromNE folded before Flop (didn't bet)





PokerStars Hand #151166093529:  Hold'em No Limit ($0.50/$1.00 USD) - 2016/03/30 16:56:02 CET [2016/03/30 10:56:02 ET]
Table 'Figneria III' 9-max Seat #4 is the button
Seat 1: matiko09 ($111.35 in chips) 
Seat 2: sanpidk ($100.43 in chips) 
Seat 3: lumen21 ($106.18 in chips) 
Seat 4: CI58 ($219.09 in chips) 
Seat 5: b_____a__242 ($87.68 in chips) 
Seat 6: RICKA16 ($100 in chips) 
Seat 7: holloway85 ($243.80 in chips) 
Seat 9: p.snow89 ($55.96 in chips) 
b_____a__242: posts small blind $0.50
RICKA16: posts big blind $1
*** HOLE CARDS ***
Dealt to matiko09 [4c 9c]
holloway85: folds 
p.snow89: folds 
matiko09: folds 
sanpidk: folds 
lumen21: folds 
CI58: raises $1.25 to $2.25
b_____a__242: raises $6.25 to $8.50
RICKA16: folds 
CI58: folds 
Uncalled bet ($6.25) returned to b_____a__242
b_____a__242 collected $5.50 from pot
b_____a__242: doesn't show hand 
*** SUMMARY ***
Total pot $5.50 | Rake $0 
Seat 1: matiko09 folded before Flop (didn't bet)
Seat 2: sanpidk folded before Flop (didn't bet)
Seat 3: lumen21 folded before Flop (didn't bet)
Seat 4: CI58 (button) folded before Flop
Seat 5: b_____a__242 (small blind) collected ($5.50)
Seat 6: RICKA16 (big blind) folded before Flop
Seat 7: holloway85 folded before Flop (didn't bet)
Seat 9: p.snow89 folded before Flop (didn't bet)





PokerStars Hand #151166096628:  Hold'em No Limit ($1/$2 USD) - 2016/03/30 16:56:08 CET [2016/03/30 10:56:08 ET]
Table 'Sadalbari' 9-max Seat #2 is the button
Seat 2: Rycious ($88.70 in chips) 
Seat 3: thecurv ($200 in chips) 
Seat 4: matiko09 ($200 in chips) 
Seat 7: prominente ($200 in chips) 
Seat 9: fonng ($100 in chips) 
thecurv: posts small blind $1
matiko09: posts big blind $2
RamiroAgujis: sits out 
King_ZéManel: sits out 
fonng: posts big blind $2
*** HOLE CARDS ***
Dealt to matiko09 [9c 8s]
prominente: folds 
fonng: checks 
Rycious: folds 
thecurv: folds 
matiko09: checks 
*** FLOP *** [Jc Ad Tc]
matiko09: bets $3.09
fonng: folds 
Uncalled bet ($3.09) returned to matiko09
matiko09 collected $4.75 from pot
matiko09: doesn't show hand 
*** SUMMARY ***
Total pot $5 | Rake $0.25 
Board [Jc Ad Tc]
Seat 2: Rycious (button) folded before Flop (didn't bet)
Seat 3: thecurv (small blind) folded before Flop
Seat 4: matiko09 (big blind) collected ($4.75)
Seat 7: prominente folded before Flop (didn't bet)
Seat 9: fonng folded on the Flop





PokerStars Hand #151166104548:  Hold'em No Limit ($0.50/$1.00 USD) - 2016/03/30 16:56:21 CET [2016/03/30 10:56:21 ET]
Table 'Alcor II' 9-max Seat #8 is the button
Seat 1: di0d80 ($107.73 in chips) 
Seat 2: holloway85 ($79.99 in chips) 
Seat 3: mitchymitch3 ($95.84 in chips) 
Seat 4: Effort92 ($199 in chips) 
Seat 5: elbiber2000 ($100 in chips) 
Seat 6: godfrey004 ($156.39 in chips) 
Seat 7: sanpidk ($100 in chips) 
Seat 8: RICKA16 ($287.56 in chips) 
Seat 9: matiko09 ($197.55 in chips) 
matiko09: posts small blind $0.50
di0d80: posts big blind $1
*** HOLE CARDS ***
Dealt to matiko09 [Qc 3s]
holloway85 has timed out
holloway85: folds 
mitchymitch3: folds 
Effort92: folds 
elbiber2000: folds 
godfrey004: raises $3 to $4
sanpidk: folds 
RICKA16: folds 
matiko09: folds 
di0d80: folds 
Uncalled bet ($3) returned to godfrey004
godfrey004 collected $2.50 from pot
godfrey004: doesn't show hand 
*** SUMMARY ***
Total pot $2.50 | Rake $0 
Seat 1: di0d80 (big blind) folded before Flop
Seat 2: holloway85 folded before Flop (didn't bet)
Seat 3: mitchymitch3 folded before Flop (didn't bet)
Seat 4: Effort92 folded before Flop (didn't bet)
Seat 5: elbiber2000 folded before Flop (didn't bet)
Seat 6: godfrey004 collected ($2.50)
Seat 7: sanpidk folded before Flop (didn't bet)
Seat 8: RICKA16 (button) folded before Flop (didn't bet)
Seat 9: matiko09 (small blind) folded before Flop





PokerStars Hand #151166107201:  Hold'em No Limit ($0.50/$1.00 USD) - 2016/03/30 16:56:26 CET [2016/03/30 10:56:26 ET]
Table 'Sirona II' 9-max Seat #6 is the button
Seat 1: funXmun ($112.64 in chips) 
Seat 2: koutani7 ($138.24 in chips) 
Seat 3: claudioneamt ($45 in chips) 
Seat 4: RICKA16 ($100 in chips) 
Seat 5: bragutza ($255.27 in chips) 
Seat 6: lumen21 ($100 in chips) 
Seat 7: matiko09 ($155.29 in chips) 
Seat 8: sanpidk ($100 in chips) 
Seat 9: mycka86 ($230.60 in chips) 
matiko09: posts small blind $0.50
sanpidk: posts big blind $1
claudioneamt: posts big blind $1
*** HOLE CARDS ***
Dealt to matiko09 [Js 3c]
mycka86: folds 
funXmun: folds 
koutani7: folds 
claudioneamt: checks 
RICKA16: folds 
bragutza: raises $2 to $3
lumen21: folds 
matiko09: folds 
sanpidk: folds 
claudioneamt: calls $2
*** FLOP *** [4s 6h 4h]
claudioneamt: checks 
bragutza: bets $4
claudioneamt: calls $4
*** TURN *** [4s 6h 4h] [8d]
claudioneamt: checks 
bragutza: bets $7.36
claudioneamt: calls $7.36
*** RIVER *** [4s 6h 4h 8d] [6s]
claudioneamt: checks 
bragutza: checks 
*** SHOW DOWN ***
claudioneamt: shows [3h Kh] (two pair, Sixes and Fours)
bragutza: shows [9c 9h] (two pair, Nines and Sixes)
bragutza collected $28.71 from pot
*** SUMMARY ***
Total pot $30.22 | Rake $1.51 
Board [4s 6h 4h 8d 6s]
Seat 1: funXmun folded before Flop (didn't bet)
Seat 2: koutani7 folded before Flop (didn't bet)
Seat 3: claudioneamt showed [3h Kh] and lost with two pair, Sixes and Fours
Seat 4: RICKA16 folded before Flop (didn't bet)
Seat 5: bragutza showed [9c 9h] and won ($28.71) with two pair, Nines and Sixes
Seat 6: lumen21 (button) folded before Flop (didn't bet)
Seat 7: matiko09 (small blind) folded before Flop
Seat 8: sanpidk (big blind) folded before Flop
Seat 9: mycka86 folded before Flop (didn't bet)





PokerStars Hand #151166115655:  Hold'em No Limit ($1/$2 USD) - 2016/03/30 16:56:40 CET [2016/03/30 10:56:40 ET]
Table 'Sadalbari' 9-max Seat #3 is the button
Seat 2: Rycious ($88.70 in chips) 
Seat 3: thecurv ($200 in chips) 
Seat 4: matiko09 ($202.75 in chips) 
Seat 5: RamiroAgujis ($203 in chips) 
Seat 7: prominente ($200 in chips) 
Seat 9: fonng ($98 in chips) 
matiko09: posts small blind $1
RamiroAgujis: posts big blind $2
King_ZéManel: sits out 
*** HOLE CARDS ***
Dealt to matiko09 [Qh 8d]
prominente: raises $3 to $5
fonng: folds 
Rycious: folds 
thecurv: folds 
matiko09: folds 
RamiroAgujis: folds 
Uncalled bet ($3) returned to prominente
prominente collected $5 from pot
prominente: doesn't show hand 
*** SUMMARY ***
Total pot $5 | Rake $0 
Seat 2: Rycious folded before Flop (didn't bet)
Seat 3: thecurv (button) folded before Flop (didn't bet)
Seat 4: matiko09 (small blind) folded before Flop
Seat 5: RamiroAgujis (big blind) folded before Flop
Seat 7: prominente collected ($5)
Seat 9: fonng folded before Flop (didn't bet)





PokerStars Hand #151166120045:  Hold'em No Limit ($0.50/$1.00 USD) - 2016/03/30 16:56:48 CET [2016/03/30 10:56:48 ET]
Table 'Hadwiger' 9-max Seat #3 is the button
Seat 2: di0d80 ($101.50 in chips) 
Seat 3: yuminyumin1 ($96.70 in chips) 
Seat 4: Westpants ($100 in chips) 
Seat 5: ardo888 ($105 in chips) 
Seat 6: xrisall_2 ($153.28 in chips) 
Seat 7: matiko09 ($110.61 in chips) 
Seat 9: IdiotFromNE ($107.17 in chips) 
Westpants: posts small blind $0.50
ardo888: posts big blind $1
*** HOLE CARDS ***
Dealt to matiko09 [5h Qc]
xrisall_2: raises $2 to $3
matiko09: folds 
IdiotFromNE: folds 
Effort92 joins the table at seat #8 
di0d80: calls $3
yuminyumin1: folds 
Westpants: folds 
ardo888: folds 
*** FLOP *** [Kc 8h 5c]
xrisall_2: bets $3
di0d80: folds 
Uncalled bet ($3) returned to xrisall_2
xrisall_2 collected $7.12 from pot
xrisall_2: doesn't show hand 
*** SUMMARY ***
Total pot $7.50 | Rake $0.38 
Board [Kc 8h 5c]
Seat 2: di0d80 folded on the Flop
Seat 3: yuminyumin1 (button) folded before Flop (didn't bet)
Seat 4: Westpants (small blind) folded before Flop
Seat 5: ardo888 (big blind) folded before Flop
Seat 6: xrisall_2 collected ($7.12)
Seat 7: matiko09 folded before Flop (didn't bet)
Seat 9: IdiotFromNE folded before Flop (didn't bet)





PokerStars Hand #151166121874:  Hold'em No Limit ($0.50/$1.00 USD) - 2016/03/30 16:56:51 CET [2016/03/30 10:56:51 ET]
Table 'Figneria III' 9-max Seat #5 is the button
Seat 1: matiko09 ($111.35 in chips) 
Seat 2: sanpidk ($100.43 in chips) 
Seat 3: lumen21 ($106.18 in chips) 
Seat 4: CI58 ($216.84 in chips) 
Seat 5: b_____a__242 ($90.93 in chips) 
Seat 6: RICKA16 ($99 in chips) 
Seat 7: holloway85 ($243.80 in chips) 
Seat 9: p.snow89 ($55.96 in chips) 
RICKA16: posts small blind $0.50
holloway85: posts big blind $1
*** HOLE CARDS ***
Dealt to matiko09 [7h Td]
p.snow89: folds 
matiko09: folds 
sanpidk: raises $2 to $3
lumen21: folds 
CI58: folds 
b_____a__242: folds 
RICKA16: folds 
holloway85: raises $4 to $7
sanpidk: calls $4
*** FLOP *** [6d Qh 2h]
holloway85: checks 
sanpidk: checks 
*** TURN *** [6d Qh 2h] [4c]
holloway85: bets $2
sanpidk: raises $4 to $6
holloway85: calls $4
*** RIVER *** [6d Qh 2h 4c] [4s]
holloway85: checks 
sanpidk: checks 
*** SHOW DOWN ***
holloway85: shows [Ac As] (two pair, Aces and Fours)
sanpidk: mucks hand 
holloway85 collected $25.18 from pot
*** SUMMARY ***
Total pot $26.50 | Rake $1.32 
Board [6d Qh 2h 4c 4s]
Seat 1: matiko09 folded before Flop (didn't bet)
Seat 2: sanpidk mucked [3s 3h]
Seat 3: lumen21 folded before Flop (didn't bet)
Seat 4: CI58 folded before Flop (didn't bet)
Seat 5: b_____a__242 (button) folded before Flop (didn't bet)
Seat 6: RICKA16 (small blind) folded before Flop
Seat 7: holloway85 (big blind) showed [Ac As] and won ($25.18) with two pair, Aces and Fours
Seat 9: p.snow89 folded before Flop (didn't bet)





PokerStars Hand #151166128936:  Hold'em No Limit ($0.50/$1.00 USD) - 2016/03/30 16:57:03 CET [2016/03/30 10:57:03 ET]
Table 'Pannonia II' 9-max Seat #4 is the button
Seat 1: CI58 ($107.48 in chips) 
Seat 2: matiko09 ($100 in chips) 
Seat 3: MGL_Sky99 ($79.63 in chips) 
Seat 4: SumPosad ($61.41 in chips) 
Seat 5: Spid1 ($234.92 in chips) 
Seat 6: lumen21 ($108.39 in chips) 
Seat 9: Effort92 ($100 in chips) 
Spid1: posts small blind $0.50
lumen21: posts big blind $1
*** HOLE CARDS ***
Dealt to matiko09 [Kd 5c]
Effort92: folds 
CI58: folds 
matiko09: folds 
MGL_Sky99: folds 
SumPosad: raises $1.40 to $2.40
Spid1: folds 
lumen21: folds 
Uncalled bet ($1.40) returned to SumPosad
SumPosad collected $2.50 from pot
SumPosad: doesn't show hand 
*** SUMMARY ***
Total pot $2.50 | Rake $0 
Seat 1: CI58 folded before Flop (didn't bet)
Seat 2: matiko09 folded before Flop (didn't bet)
Seat 3: MGL_Sky99 folded before Flop (didn't bet)
Seat 4: SumPosad (button) collected ($2.50)
Seat 5: Spid1 (small blind) folded before Flop
Seat 6: lumen21 (big blind) folded before Flop
Seat 9: Effort92 folded before Flop (didn't bet)





PokerStars Hand #151166131069:  Hold'em No Limit ($0.50/$1.00 USD) - 2016/03/30 16:57:07 CET [2016/03/30 10:57:07 ET]
Table 'Alcor II' 9-max Seat #9 is the button
Seat 1: di0d80 ($106.73 in chips) 
Seat 3: mitchymitch3 ($95.84 in chips) 
Seat 4: Effort92 ($199 in chips) 
Seat 5: elbiber2000 ($100 in chips) 
Seat 6: godfrey004 ($157.89 in chips) 
Seat 7: sanpidk ($100 in chips) 
Seat 8: RICKA16 ($287.56 in chips) 
Seat 9: matiko09 ($197.05 in chips) 
di0d80: posts small blind $0.50
mitchymitch3: posts big blind $1
*** HOLE CARDS ***
Dealt to matiko09 [9c Qc]
Effort92: folds 
elbiber2000: folds 
godfrey004: folds 
sanpidk: folds 
RICKA16: folds 
matiko09: raises $1.27 to $2.27
di0d80: folds 
mitchymitch3: raises $5.73 to $8
matiko09: folds 
Uncalled bet ($5.73) returned to mitchymitch3
mitchymitch3 collected $5.04 from pot
mitchymitch3: doesn't show hand 
*** SUMMARY ***
Total pot $5.04 | Rake $0 
Seat 1: di0d80 (small blind) folded before Flop
Seat 3: mitchymitch3 (big blind) collected ($5.04)
Seat 4: Effort92 folded before Flop (didn't bet)
Seat 5: elbiber2000 folded before Flop (didn't bet)
Seat 6: godfrey004 folded before Flop (didn't bet)
Seat 7: sanpidk folded before Flop (didn't bet)
Seat 8: RICKA16 folded before Flop (didn't bet)
Seat 9: matiko09 (button) folded before Flop





PokerStars Hand #151166134901:  Hold'em No Limit ($1/$2 USD) - 2016/03/30 16:57:14 CET [2016/03/30 10:57:14 ET]
Table 'Sadalbari' 9-max Seat #4 is the button
Seat 2: Rycious ($88.70 in chips) 
Seat 3: thecurv ($200 in chips) 
Seat 4: matiko09 ($201.75 in chips) 
Seat 5: RamiroAgujis ($201 in chips) 
Seat 6: King_ZéManel ($236.25 in chips) 
Seat 7: prominente ($203 in chips) 
Seat 9: fonng ($98 in chips) 
RamiroAgujis: posts small blind $1
King_ZéManel: posts big blind $2
*** HOLE CARDS ***
Dealt to matiko09 [Js Th]
Igoriah joins the table at seat #1 
suddend3ath joins the table at seat #8 
prominente: folds 
fonng: folds 
Rycious: calls $2
thecurv: folds 
matiko09: raises $6 to $8
RamiroAgujis: folds 
King_ZéManel: folds 
Rycious: folds 
Uncalled bet ($6) returned to matiko09
matiko09 collected $7 from pot
matiko09: doesn't show hand 
*** SUMMARY ***
Total pot $7 | Rake $0 
Seat 2: Rycious folded before Flop
Seat 3: thecurv folded before Flop (didn't bet)
Seat 4: matiko09 (button) collected ($7)
Seat 5: RamiroAgujis (small blind) folded before Flop
Seat 6: King_ZéManel (big blind) folded before Flop
Seat 7: prominente folded before Flop (didn't bet)
Seat 9: fonng folded before Flop (didn't bet)





PokerStars Hand #151166139210:  Hold'em No Limit ($1/$2 USD) - 2016/03/30 16:57:21 CET [2016/03/30 10:57:21 ET]
Table 'Philoctetes II' 9-max Seat #9 is the button
Seat 1: vezunchik79 ($122.38 in chips) 
Seat 2: prominente ($212.91 in chips) 
Seat 3: mentalpshyco ($227.55 in chips) 
Seat 5: zhaimeng ($467.92 in chips) 
Seat 6: di0d80 ($200 in chips) 
Seat 7: matiko09 ($200 in chips) 
Seat 8: suddend3ath ($200 in chips) 
Seat 9: RamiroAgujis ($252.45 in chips) 
vezunchik79: posts small blind $1
prominente: posts big blind $2
*** HOLE CARDS ***
Dealt to matiko09 [6h 3c]
mentalpshyco: folds 
zhaimeng: folds 
di0d80: raises $3 to $5
matiko09: folds 
suddend3ath: folds 
RamiroAgujis: folds 
vezunchik79: folds 
prominente: folds 
Uncalled bet ($3) returned to di0d80
di0d80 collected $5 from pot
di0d80: doesn't show hand 
*** SUMMARY ***
Total pot $5 | Rake $0 
Seat 1: vezunchik79 (small blind) folded before Flop
Seat 2: prominente (big blind) folded before Flop
Seat 3: mentalpshyco folded before Flop (didn't bet)
Seat 5: zhaimeng folded before Flop (didn't bet)
Seat 6: di0d80 collected ($5)
Seat 7: matiko09 folded before Flop (didn't bet)
Seat 8: suddend3ath folded before Flop (didn't bet)
Seat 9: RamiroAgujis (button) folded before Flop (didn't bet)





PokerStars Hand #151166140014:  Hold'em No Limit ($1/$2 USD) - 2016/03/30 16:57:22 CET [2016/03/30 10:57:22 ET]
Table 'Tabit III' 9-max Seat #9 is the button
Seat 1: di0d80 ($237.97 in chips) 
Seat 2: matiko09 ($229.54 in chips) 
Seat 3: prominente ($200 in chips) 
Seat 4: Dykallis ($501.53 in chips) 
Seat 5: itaik1 ($97.24 in chips) 
Seat 7: jannis1951 ($122.88 in chips) 
Seat 8: mentalpshyco ($203 in chips) 
Seat 9: suddend3ath ($200 in chips) 
di0d80: posts small blind $1
matiko09: posts big blind $2
Igoriah: sits out 
*** HOLE CARDS ***
Dealt to matiko09 [Tc 6s]
prominente: folds 
Dykallis: folds 
itaik1: folds 
jannis1951: raises $2 to $4
mentalpshyco: folds 
suddend3ath: calls $4
di0d80: folds 
matiko09: folds 
*** FLOP *** [3c 5d Js]
jannis1951: bets $10.45
suddend3ath: calls $10.45
*** TURN *** [3c 5d Js] [Ad]
jannis1951: bets $30.30
suddend3ath: calls $30.30
*** RIVER *** [3c 5d Js Ad] [4s]
jannis1951: checks 
suddend3ath: checks 
*** SHOW DOWN ***
jannis1951: shows [7c Ac] (a pair of Aces)
suddend3ath: mucks hand 
jannis1951 collected $89.75 from pot
*** SUMMARY ***
Total pot $92.50 | Rake $2.75 
Board [3c 5d Js Ad 4s]
Seat 1: di0d80 (small blind) folded before Flop
Seat 2: matiko09 (big blind) folded before Flop
Seat 3: prominente folded before Flop (didn't bet)
Seat 4: Dykallis folded before Flop (didn't bet)
Seat 5: itaik1 folded before Flop (didn't bet)
Seat 7: jannis1951 showed [7c Ac] and won ($89.75) with a pair of Aces
Seat 8: mentalpshyco folded before Flop (didn't bet)
Seat 9: suddend3ath (button) mucked [Jd Qd]





PokerStars Hand #151166143474:  Hold'em No Limit ($0.50/$1.00 USD) - 2016/03/30 16:57:28 CET [2016/03/30 10:57:28 ET]
Table 'Alcor II' 9-max Seat #1 is the button
Seat 1: di0d80 ($106.23 in chips) 
Seat 3: mitchymitch3 ($98.61 in chips) 
Seat 4: Effort92 ($199 in chips) 
Seat 5: elbiber2000 ($100 in chips) 
Seat 6: godfrey004 ($157.89 in chips) 
Seat 7: sanpidk ($100 in chips) 
Seat 8: RICKA16 ($287.56 in chips) 
Seat 9: matiko09 ($194.78 in chips) 
holloway85 will be allowed to play after the button
mitchymitch3: posts small blind $0.50
Effort92: posts big blind $1
*** HOLE CARDS ***
Dealt to matiko09 [5c 2d]
elbiber2000: folds 
godfrey004: raises $3 to $4
sanpidk: folds 
RICKA16: folds 
matiko09: folds 
di0d80: folds 
mitchymitch3: folds 
Effort92: folds 
Uncalled bet ($3) returned to godfrey004
godfrey004 collected $2.50 from pot
godfrey004: doesn't show hand 
*** SUMMARY ***
Total pot $2.50 | Rake $0 
Seat 1: di0d80 (button) folded before Flop (didn't bet)
Seat 3: mitchymitch3 (small blind) folded before Flop
Seat 4: Effort92 (big blind) folded before Flop
Seat 5: elbiber2000 folded before Flop (didn't bet)
Seat 6: godfrey004 collected ($2.50)
Seat 7: sanpidk folded before Flop (didn't bet)
Seat 8: RICKA16 folded before Flop (didn't bet)
Seat 9: matiko09 folded before Flop (didn't bet)





PokerStars Hand #151166144376:  Hold'em No Limit ($1/$2 USD) - 2016/03/30 16:57:30 CET [2016/03/30 10:57:30 ET]
Table 'Aesculapia II' 9-max Seat #9 is the button
Seat 1: T0ny Adams ($75 in chips) 
Seat 2: suddend3ath ($321.65 in chips) 
Seat 3: matiko09 ($729.28 in chips) 
Seat 5: prominente ($200 in chips) 
Seat 6: mentalpshyco ($200 in chips) 
Seat 7: Rumboni66 ($133.17 in chips) 
Seat 9: InsomniaRU ($200 in chips) 
T0ny Adams: posts small blind $1
suddend3ath: posts big blind $2
*** HOLE CARDS ***
Dealt to matiko09 [Jd 6d]
matiko09: folds 
prominente: folds 
mentalpshyco: raises $3 to $5
Rumboni66: folds 
InsomniaRU: folds 
T0ny Adams: folds 
suddend3ath: folds 
Uncalled bet ($3) returned to mentalpshyco
mentalpshyco collected $5 from pot
mentalpshyco: doesn't show hand 
*** SUMMARY ***
Total pot $5 | Rake $0 
Seat 1: T0ny Adams (small blind) folded before Flop
Seat 2: suddend3ath (big blind) folded before Flop
Seat 3: matiko09 folded before Flop (didn't bet)
Seat 5: prominente folded before Flop (didn't bet)
Seat 6: mentalpshyco collected ($5)
Seat 7: Rumboni66 folded before Flop (didn't bet)
Seat 9: InsomniaRU (button) folded before Flop (didn't bet)





PokerStars Hand #151166145387:  Hold'em No Limit ($1/$2 USD) - 2016/03/30 16:57:31 CET [2016/03/30 10:57:31 ET]
Table 'Jole' 9-max Seat #2 is the button
Seat 1: prominente ($264.61 in chips) 
Seat 2: InsomniaRU ($205.45 in chips) 
Seat 3: tipner ($200 in chips) 
Seat 4: GS_Sydney ($146.44 in chips) 
Seat 5: mentalpshyco ($200 in chips) 
Seat 6: King_ZéManel ($325.30 in chips) 
Seat 7: thecurv ($210.60 in chips) 
Seat 8: matiko09 ($325.50 in chips) 
Seat 9: RamiroAgujis ($256.76 in chips) 
tipner: posts small blind $1
GS_Sydney: posts big blind $2
*** HOLE CARDS ***
Dealt to matiko09 [5c 3c]
mentalpshyco: folds 
King_ZéManel: folds 
thecurv: folds 
matiko09: folds 
RamiroAgujis: folds 
prominente: folds 
InsomniaRU: folds 
tipner: raises $4 to $6
GS_Sydney: calls $4
*** FLOP *** [7c Tc Ac]
tipner: bets $5.70
GS_Sydney: calls $5.70
*** TURN *** [7c Tc Ac] [9h]
tipner: checks 
GS_Sydney: checks 
*** RIVER *** [7c Tc Ac 9h] [Kc]
tipner: bets $12
GS_Sydney: folds 
Uncalled bet ($12) returned to tipner
tipner collected $22.23 from pot
tipner: doesn't show hand 
*** SUMMARY ***
Total pot $23.40 | Rake $1.17 
Board [7c Tc Ac 9h Kc]
Seat 1: prominente folded before Flop (didn't bet)
Seat 2: InsomniaRU (button) folded before Flop (didn't bet)
Seat 3: tipner (small blind) collected ($22.23)
Seat 4: GS_Sydney (big blind) folded on the River
Seat 5: mentalpshyco folded before Flop (didn't bet)
Seat 6: King_ZéManel folded before Flop (didn't bet)
Seat 7: thecurv folded before Flop (didn't bet)
Seat 8: matiko09 folded before Flop (didn't bet)
Seat 9: RamiroAgujis folded before Flop (didn't bet)





PokerStars Hand #151166145437:  Hold'em No Limit ($0.50/$1.00 USD) - 2016/03/30 16:57:32 CET [2016/03/30 10:57:32 ET]
Table 'Hadwiger' 9-max Seat #4 is the button
Seat 2: di0d80 ($100 in chips) 
Seat 3: yuminyumin1 ($96.70 in chips) 
Seat 4: Westpants ($100 in chips) 
Seat 5: ardo888 ($104 in chips) 
Seat 6: xrisall_2 ($157.40 in chips) 
Seat 7: matiko09 ($110.61 in chips) 
Seat 9: IdiotFromNE ($107.17 in chips) 
ardo888: posts small blind $0.50
xrisall_2: posts big blind $1
Effort92: sits out 
*** HOLE CARDS ***
Dealt to matiko09 [Kh 2d]
matiko09: folds 
IdiotFromNE: folds 
di0d80: raises $1.50 to $2.50
yuminyumin1: folds 
Westpants: folds 
ardo888: folds 
xrisall_2: folds 
Uncalled bet ($1.50) returned to di0d80
di0d80 collected $2.50 from pot
di0d80: doesn't show hand 
*** SUMMARY ***
Total pot $2.50 | Rake $0 
Seat 2: di0d80 collected ($2.50)
Seat 3: yuminyumin1 folded before Flop (didn't bet)
Seat 4: Westpants (button) folded before Flop (didn't bet)
Seat 5: ardo888 (small blind) folded before Flop
Seat 6: xrisall_2 (big blind) folded before Flop
Seat 7: matiko09 folded before Flop (didn't bet)
Seat 9: IdiotFromNE folded before Flop (didn't bet)





PokerStars Hand #151166146555:  Hold'em No Limit ($0.50/$1.00 USD) - 2016/03/30 16:57:33 CET [2016/03/30 10:57:33 ET]
Table 'Pannonia II' 9-max Seat #5 is the button
Seat 1: CI58 ($107.48 in chips) 
Seat 2: matiko09 ($100 in chips) 
Seat 3: MGL_Sky99 ($79.63 in chips) 
Seat 4: SumPosad ($62.91 in chips) 
Seat 5: Spid1 ($234.42 in chips) 
Seat 6: lumen21 ($107.39 in chips) 
Seat 7: Dachish ($68.92 in chips) 
Seat 8: stonymalony ($100 in chips) 
Seat 9: Effort92 ($100 in chips) 
lumen21: posts small blind $0.50
Dachish: posts big blind $1
*** HOLE CARDS ***
Dealt to matiko09 [8d Js]
stonymalony: folds 
Effort92: folds 
CI58: folds 
matiko09: folds 
MGL_Sky99: folds 
SumPosad: raises $1.50 to $2.50
Spid1: folds 
lumen21: folds 
Dachish: calls $1.50
*** FLOP *** [3h 2c 2h]
Dachish: checks 
SumPosad: bets $3.20
Dachish: folds 
Uncalled bet ($3.20) returned to SumPosad
SumPosad collected $5.22 from pot
SumPosad: doesn't show hand 
*** SUMMARY ***
Total pot $5.50 | Rake $0.28 
Board [3h 2c 2h]
Seat 1: CI58 folded before Flop (didn't bet)
Seat 2: matiko09 folded before Flop (didn't bet)
Seat 3: MGL_Sky99 folded before Flop (didn't bet)
Seat 4: SumPosad collected ($5.22)
Seat 5: Spid1 (button) folded before Flop (didn't bet)
Seat 6: lumen21 (small blind) folded before Flop
Seat 7: Dachish (big blind) folded on the Flop
Seat 8: stonymalony folded before Flop (didn't bet)
Seat 9: Effort92 folded before Flop (didn't bet)





PokerStars Hand #151166148650:  Hold'em No Limit ($0.50/$1.00 USD) - 2016/03/30 16:57:37 CET [2016/03/30 10:57:37 ET]
Table 'Sirona II' 9-max Seat #7 is the button
Seat 1: funXmun ($112.64 in chips) 
Seat 2: koutani7 ($138.24 in chips) 
Seat 3: claudioneamt ($30.64 in chips) 
Seat 4: RICKA16 ($100 in chips) 
Seat 5: bragutza ($269.62 in chips) 
Seat 6: lumen21 ($100 in chips) 
Seat 7: matiko09 ($154.79 in chips) 
Seat 8: sanpidk ($100 in chips) 
Seat 9: mycka86 ($230.60 in chips) 
sanpidk: posts small blind $0.50
mycka86: posts big blind $1
*** HOLE CARDS ***
Dealt to matiko09 [Kd 5c]
funXmun: raises $2 to $3
koutani7: folds 
claudioneamt: folds 
RICKA16: folds 
bragutza: folds 
lumen21: folds 
matiko09: folds 
sanpidk: folds 
mycka86: folds 
Uncalled bet ($2) returned to funXmun
funXmun collected $2.50 from pot
funXmun: doesn't show hand 
*** SUMMARY ***
Total pot $2.50 | Rake $0 
Seat 1: funXmun collected ($2.50)
Seat 2: koutani7 folded before Flop (didn't bet)
Seat 3: claudioneamt folded before Flop (didn't bet)
Seat 4: RICKA16 folded before Flop (didn't bet)
Seat 5: bragutza folded before Flop (didn't bet)
Seat 6: lumen21 folded before Flop (didn't bet)
Seat 7: matiko09 (button) folded before Flop (didn't bet)
Seat 8: sanpidk (small blind) folded before Flop
Seat 9: mycka86 (big blind) folded before Flop





PokerStars Hand #151166157920:  Hold'em No Limit ($0.50/$1.00 USD) - 2016/03/30 16:57:53 CET [2016/03/30 10:57:53 ET]
Table 'Figneria III' 9-max Seat #6 is the button
Seat 1: matiko09 ($111.35 in chips) 
Seat 2: sanpidk ($100 in chips) 
Seat 3: lumen21 ($106.18 in chips) 
Seat 4: CI58 ($216.84 in chips) 
Seat 5: b_____a__242 ($90.93 in chips) 
Seat 6: RICKA16 ($100 in chips) 
Seat 7: holloway85 ($255.98 in chips) 
Seat 9: p.snow89 ($55.96 in chips) 
holloway85: posts small blind $0.50
p.snow89: posts big blind $1
*** HOLE CARDS ***
Dealt to matiko09 [Td 2s]
matiko09: folds 
sanpidk: folds 
lumen21: folds 
CI58: folds 
b_____a__242: folds 
RICKA16: folds 
holloway85: raises $1 to $2
p.snow89: raises $1 to $3
holloway85: calls $1
*** FLOP *** [3h 4d Qd]
holloway85: checks 
p.snow89: bets $6
holloway85: calls $6
*** TURN *** [3h 4d Qd] [Ts]
holloway85: checks 
p.snow89: bets $6
holloway85: calls $6
*** RIVER *** [3h 4d Qd Ts] [Ac]
holloway85: checks 
p.snow89: checks 
*** SHOW DOWN ***
holloway85: shows [Js Qs] (a pair of Queens)
p.snow89: shows [Kh Kd] (a pair of Kings)
p.snow89 collected $28.50 from pot
*** SUMMARY ***
Total pot $30 | Rake $1.50 
Board [3h 4d Qd Ts Ac]
Seat 1: matiko09 folded before Flop (didn't bet)
Seat 2: sanpidk folded before Flop (didn't bet)
Seat 3: lumen21 folded before Flop (didn't bet)
Seat 4: CI58 folded before Flop (didn't bet)
Seat 5: b_____a__242 folded before Flop (didn't bet)
Seat 6: RICKA16 (button) folded before Flop (didn't bet)
Seat 7: holloway85 (small blind) showed [Js Qs] and lost with a pair of Queens
Seat 9: p.snow89 (big blind) showed [Kh Kd] and won ($28.50) with a pair of Kings





PokerStars Hand #151166158546:  Hold'em No Limit ($1/$2 USD) - 2016/03/30 16:57:54 CET [2016/03/30 10:57:54 ET]
Table 'Aesculapia II' 9-max Seat #1 is the button
Seat 1: T0ny Adams ($74 in chips) 
Seat 2: suddend3ath ($319.65 in chips) 
Seat 3: matiko09 ($729.28 in chips) 
Seat 5: prominente ($200 in chips) 
Seat 6: mentalpshyco ($203 in chips) 
Seat 7: Rumboni66 ($133.17 in chips) 
Seat 9: InsomniaRU ($200 in chips) 
suddend3ath: posts small blind $1
matiko09: posts big blind $2
*** HOLE CARDS ***
Dealt to matiko09 [Qc Qd]
prominente: folds 
Igoriah joins the table at seat #4 
mentalpshyco: folds 
Rumboni66: folds 
Igoriah leaves the table
InsomniaRU: folds 
T0ny Adams: raises $2.34 to $4.34
suddend3ath: folds 
matiko09: raises $9.66 to $14
T0ny Adams: raises $49 to $63
matiko09: raises $49 to $112
T0ny Adams: calls $11 and is all-in
Uncalled bet ($38) returned to matiko09
*** FLOP *** [5s 7c 9h]
*** TURN *** [5s 7c 9h] [9s]
*** RIVER *** [5s 7c 9h 9s] [Js]
*** SHOW DOWN ***
matiko09: shows [Qc Qd] (two pair, Queens and Nines)
T0ny Adams: shows [Kc Kd] (two pair, Kings and Nines)
T0ny Adams collected $146.25 from pot
*** SUMMARY ***
Total pot $149 | Rake $2.75 
Board [5s 7c 9h 9s Js]
Seat 1: T0ny Adams (button) showed [Kc Kd] and won ($146.25) with two pair, Kings and Nines
Seat 2: suddend3ath (small blind) folded before Flop
Seat 3: matiko09 (big blind) showed [Qc Qd] and lost with two pair, Queens and Nines
Seat 5: prominente folded before Flop (didn't bet)
Seat 6: mentalpshyco folded before Flop (didn't bet)
Seat 7: Rumboni66 folded before Flop (didn't bet)
Seat 9: InsomniaRU folded before Flop (didn't bet)





PokerStars Hand #151166159411:  Hold'em No Limit ($0.50/$1.00 USD) - 2016/03/30 16:57:55 CET [2016/03/30 10:57:55 ET]
Table 'Hadwiger' 9-max Seat #5 is the button
Seat 2: di0d80 ($101.50 in chips) 
Seat 3: yuminyumin1 ($96.70 in chips) 
Seat 4: Westpants ($100 in chips) 
Seat 5: ardo888 ($103.50 in chips) 
Seat 6: xrisall_2 ($156.40 in chips) 
Seat 7: matiko09 ($110.61 in chips) 
Seat 9: IdiotFromNE ($107.17 in chips) 
xrisall_2: posts small blind $0.50
matiko09: posts big blind $1
Effort92: sits out 
*** HOLE CARDS ***
Dealt to matiko09 [5h Jc]
IdiotFromNE: folds 
di0d80: folds 
yuminyumin1: folds 
Westpants: folds 
ardo888: folds 
xrisall_2: folds 
Uncalled bet ($0.50) returned to matiko09
matiko09 collected $1 from pot
matiko09: doesn't show hand 
*** SUMMARY ***
Total pot $1 | Rake $0 
Seat 2: di0d80 folded before Flop (didn't bet)
Seat 3: yuminyumin1 folded before Flop (didn't bet)
Seat 4: Westpants folded before Flop (didn't bet)
Seat 5: ardo888 (button) folded before Flop (didn't bet)
Seat 6: xrisall_2 (small blind) folded before Flop
Seat 7: matiko09 (big blind) collected ($1)
Seat 9: IdiotFromNE folded before Flop (didn't bet)





PokerStars Hand #151166160937:  Hold'em No Limit ($1/$2 USD) - 2016/03/30 16:57:58 CET [2016/03/30 10:57:58 ET]
Table 'Sadalbari' 9-max Seat #5 is the button
Seat 2: Rycious ($86.70 in chips) 
Seat 3: thecurv ($200 in chips) 
Seat 4: matiko09 ($206.75 in chips) 
Seat 5: RamiroAgujis ($200 in chips) 
Seat 6: King_ZéManel ($234.25 in chips) 
Seat 7: prominente ($203 in chips) 
Seat 9: fonng ($98 in chips) 
King_ZéManel: posts small blind $1
prominente: posts big blind $2
suddend3ath: sits out 
Igoriah: sits out 
*** HOLE CARDS ***
Dealt to matiko09 [Jc Qh]
fonng: calls $2
Rycious: folds 
thecurv: folds 
matiko09: raises $6 to $8
RamiroAgujis: folds 
King_ZéManel: folds 
prominente: folds 
fonng: folds 
Uncalled bet ($6) returned to matiko09
matiko09 collected $7 from pot
matiko09: doesn't show hand 
*** SUMMARY ***
Total pot $7 | Rake $0 
Seat 2: Rycious folded before Flop (didn't bet)
Seat 3: thecurv folded before Flop (didn't bet)
Seat 4: matiko09 collected ($7)
Seat 5: RamiroAgujis (button) folded before Flop (didn't bet)
Seat 6: King_ZéManel (small blind) folded before Flop
Seat 7: prominente (big blind) folded before Flop
Seat 9: fonng folded before Flop





PokerStars Hand #151166163616:  Hold'em No Limit ($0.50/$1.00 USD) - 2016/03/30 16:58:02 CET [2016/03/30 10:58:02 ET]
Table 'Alcor II' 9-max Seat #3 is the button
Seat 1: di0d80 ($106.23 in chips) 
Seat 3: mitchymitch3 ($98.11 in chips) 
Seat 4: Effort92 ($198 in chips) 
Seat 5: elbiber2000 ($100 in chips) 
Seat 6: godfrey004 ($159.39 in chips) 
Seat 7: sanpidk ($100 in chips) 
Seat 8: RICKA16 ($287.56 in chips) 
Seat 9: matiko09 ($194.78 in chips) 
Effort92: posts small blind $0.50
elbiber2000: posts big blind $1
holloway85: sits out 
*** HOLE CARDS ***
Dealt to matiko09 [8c Td]
godfrey004: calls $1
sanpidk: folds 
RICKA16: folds 
matiko09: folds 
di0d80: raises $3 to $4
mitchymitch3: folds 
Effort92: folds 
elbiber2000: folds 
godfrey004: calls $3
*** FLOP *** [Ts 8h Tc]
godfrey004: checks 
di0d80: bets $6
godfrey004: calls $6
*** TURN *** [Ts 8h Tc] [9s]
godfrey004: checks 
di0d80: checks 
*** RIVER *** [Ts 8h Tc 9s] [Ah]
godfrey004: checks 
di0d80: checks 
*** SHOW DOWN ***
godfrey004: shows [8d 7d] (two pair, Tens and Eights)
di0d80: shows [Kd Ks] (two pair, Kings and Tens)
di0d80 collected $20.42 from pot
*** SUMMARY ***
Total pot $21.50 | Rake $1.08 
Board [Ts 8h Tc 9s Ah]
Seat 1: di0d80 showed [Kd Ks] and won ($20.42) with two pair, Kings and Tens
Seat 3: mitchymitch3 (button) folded before Flop (didn't bet)
Seat 4: Effort92 (small blind) folded before Flop
Seat 5: elbiber2000 (big blind) folded before Flop
Seat 6: godfrey004 showed [8d 7d] and lost with two pair, Tens and Eights
Seat 7: sanpidk folded before Flop (didn't bet)
Seat 8: RICKA16 folded before Flop (didn't bet)
Seat 9: matiko09 folded before Flop (didn't bet)





PokerStars Hand #151166168086:  Hold'em No Limit ($1/$2 USD) - 2016/03/30 16:58:10 CET [2016/03/30 10:58:10 ET]
Table 'Philoctetes II' 9-max Seat #1 is the button
Seat 1: vezunchik79 ($121.38 in chips) 
Seat 2: prominente ($210.91 in chips) 
Seat 3: mentalpshyco ($227.55 in chips) 
Seat 5: zhaimeng ($467.92 in chips) 
Seat 6: di0d80 ($203 in chips) 
Seat 7: matiko09 ($200 in chips) 
Seat 8: suddend3ath ($200 in chips) 
Seat 9: RamiroAgujis ($252.45 in chips) 
prominente: posts small blind $1
mentalpshyco: posts big blind $2
*** HOLE CARDS ***
Dealt to matiko09 [Qd 9c]
zhaimeng: calls $2
di0d80: folds 
matiko09: folds 
suddend3ath: raises $6 to $8
RamiroAgujis: folds 
vezunchik79: calls $8
prominente: folds 
mentalpshyco: raises $26 to $34
zhaimeng: folds 
suddend3ath: folds 
vezunchik79: calls $26
*** FLOP *** [6h 5h 7s]
mentalpshyco: bets $193.55 and is all-in
vezunchik79: folds 
Uncalled bet ($193.55) returned to mentalpshyco
mentalpshyco collected $76.25 from pot
mentalpshyco: doesn't show hand 
*** SUMMARY ***
Total pot $79 | Rake $2.75 
Board [6h 5h 7s]
Seat 1: vezunchik79 (button) folded on the Flop
Seat 2: prominente (small blind) folded before Flop
Seat 3: mentalpshyco (big blind) collected ($76.25)
Seat 5: zhaimeng folded before Flop
Seat 6: di0d80 folded before Flop (didn't bet)
Seat 7: matiko09 folded before Flop (didn't bet)
Seat 8: suddend3ath folded before Flop
Seat 9: RamiroAgujis folded before Flop (didn't bet)





PokerStars Hand #151166173582:  Hold'em No Limit ($0.50/$1.00 USD) - 2016/03/30 16:58:19 CET [2016/03/30 10:58:19 ET]
Table 'Sirona II' 9-max Seat #8 is the button
Seat 1: funXmun ($114.14 in chips) 
Seat 2: koutani7 ($138.24 in chips) 
Seat 3: claudioneamt ($30.64 in chips) 
Seat 4: RICKA16 ($100 in chips) 
Seat 5: bragutza ($269.62 in chips) 
Seat 6: lumen21 ($100 in chips) 
Seat 7: matiko09 ($154.79 in chips) 
Seat 8: sanpidk ($100 in chips) 
Seat 9: mycka86 ($229.60 in chips) 
mycka86: posts small blind $0.50
funXmun: posts big blind $1
*** HOLE CARDS ***
Dealt to matiko09 [2s 4d]
koutani7: folds 
claudioneamt: folds 
RICKA16: folds 
bragutza: calls $1
lumen21: folds 
matiko09: folds 
sanpidk: folds 
mycka86: calls $0.50
funXmun: checks 
*** FLOP *** [Qh 8h 3h]
mycka86: checks 
funXmun: checks 
bragutza: checks 
*** TURN *** [Qh 8h 3h] [Ah]
mycka86: checks 
funXmun: checks 
bragutza: bets $2.85
mycka86: folds 
funXmun: folds 
Uncalled bet ($2.85) returned to bragutza
bragutza collected $2.85 from pot
bragutza: doesn't show hand 
*** SUMMARY ***
Total pot $3 | Rake $0.15 
Board [Qh 8h 3h Ah]
Seat 1: funXmun (big blind) folded on the Turn
Seat 2: koutani7 folded before Flop (didn't bet)
Seat 3: claudioneamt folded before Flop (didn't bet)
Seat 4: RICKA16 folded before Flop (didn't bet)
Seat 5: bragutza collected ($2.85)
Seat 6: lumen21 folded before Flop (didn't bet)
Seat 7: matiko09 folded before Flop (didn't bet)
Seat 8: sanpidk (button) folded before Flop (didn't bet)
Seat 9: mycka86 (small blind) folded on the Turn





PokerStars Hand #151166173371:  Hold'em No Limit ($0.50/$1.00 USD) - 2016/03/30 16:58:19 CET [2016/03/30 10:58:19 ET]
Table 'Pannonia II' 9-max Seat #6 is the button
Seat 1: CI58 ($107.48 in chips) 
Seat 2: matiko09 ($100 in chips) 
Seat 3: MGL_Sky99 ($79.63 in chips) 
Seat 4: SumPosad ($65.63 in chips) 
Seat 5: Spid1 ($234.42 in chips) 
Seat 6: lumen21 ($106.89 in chips) 
Seat 7: Dachish ($66.42 in chips) 
Seat 8: stonymalony ($100 in chips) 
Seat 9: Effort92 ($100 in chips) 
Dachish: posts small blind $0.50
stonymalony: posts big blind $1
*** HOLE CARDS ***
Dealt to matiko09 [Ts 9h]
Effort92: folds 
CI58: folds 
matiko09: folds 
MGL_Sky99: folds 
SumPosad: folds 
Spid1: folds 
lumen21: folds 
Dachish: raises $2 to $3
stonymalony: calls $2
*** FLOP *** [Ad 5h 7c]
Dachish: bets $3.50
stonymalony: folds 
Uncalled bet ($3.50) returned to Dachish
Dachish collected $5.70 from pot
Dachish: doesn't show hand 
*** SUMMARY ***
Total pot $6 | Rake $0.30 
Board [Ad 5h 7c]
Seat 1: CI58 folded before Flop (didn't bet)
Seat 2: matiko09 folded before Flop (didn't bet)
Seat 3: MGL_Sky99 folded before Flop (didn't bet)
Seat 4: SumPosad folded before Flop (didn't bet)
Seat 5: Spid1 folded before Flop (didn't bet)
Seat 6: lumen21 (button) folded before Flop (didn't bet)
Seat 7: Dachish (small blind) collected ($5.70)
Seat 8: stonymalony (big blind) folded on the Flop
Seat 9: Effort92 folded before Flop (didn't bet)





PokerStars Hand #151166176241:  Hold'em No Limit ($0.50/$1.00 USD) - 2016/03/30 16:58:24 CET [2016/03/30 10:58:24 ET]
Table 'Hadwiger' 9-max Seat #6 is the button
Seat 2: di0d80 ($101.50 in chips) 
Seat 3: yuminyumin1 ($96.70 in chips) 
Seat 4: Westpants ($100 in chips) 
Seat 5: ardo888 ($103.50 in chips) 
Seat 6: xrisall_2 ($155.90 in chips) 
Seat 7: matiko09 ($111.11 in chips) 
Seat 8: Effort92 ($100 in chips) 
Seat 9: IdiotFromNE ($107.17 in chips) 
matiko09: posts small blind $0.50
Effort92: posts big blind $1
*** HOLE CARDS ***
Dealt to matiko09 [8d Jh]
IdiotFromNE: folds 
di0d80: folds 
yuminyumin1: raises $2 to $3
Westpants: folds 
ardo888: folds 
xrisall_2: calls $3
matiko09: folds 
Effort92: calls $2
*** FLOP *** [5c 2d Qh]
Effort92: checks 
yuminyumin1: bets $6
xrisall_2: folds 
Effort92: folds 
Uncalled bet ($6) returned to yuminyumin1
yuminyumin1 collected $9.02 from pot
yuminyumin1: doesn't show hand 
*** SUMMARY ***
Total pot $9.50 | Rake $0.48 
Board [5c 2d Qh]
Seat 2: di0d80 folded before Flop (didn't bet)
Seat 3: yuminyumin1 collected ($9.02)
Seat 4: Westpants folded before Flop (didn't bet)
Seat 5: ardo888 folded before Flop (didn't bet)
Seat 6: xrisall_2 (button) folded on the Flop
Seat 7: matiko09 (small blind) folded before Flop
Seat 8: Effort92 (big blind) folded on the Flop
Seat 9: IdiotFromNE folded before Flop (didn't bet)





PokerStars Hand #151166177242:  Hold'em No Limit ($1/$2 USD) - 2016/03/30 16:58:25 CET [2016/03/30 10:58:25 ET]
Table 'Tabit III' 9-max Seat #1 is the button
Seat 1: di0d80 ($236.97 in chips) 
Seat 2: matiko09 ($227.54 in chips) 
Seat 3: prominente ($200 in chips) 
Seat 4: Dykallis ($501.53 in chips) 
Seat 5: itaik1 ($97.24 in chips) 
Seat 7: jannis1951 ($167.88 in chips) 
Seat 8: mentalpshyco ($203 in chips) 
Seat 9: suddend3ath ($200 in chips) 
matiko09: posts small blind $1
prominente: posts big blind $2
Igoriah: sits out 
*** HOLE CARDS ***
Dealt to matiko09 [Ac 4s]
Dykallis: folds 
itaik1: folds 
jannis1951: calls $2
mentalpshyco: raises $6 to $8
suddend3ath: folds 
di0d80: folds 
matiko09: folds 
prominente: folds 
jannis1951: calls $6
*** FLOP *** [9d 9s 9h]
jannis1951: checks 
mentalpshyco: bets $12
jannis1951: folds 
Uncalled bet ($12) returned to mentalpshyco
mentalpshyco collected $18.05 from pot
mentalpshyco: doesn't show hand 
*** SUMMARY ***
Total pot $19 | Rake $0.95 
Board [9d 9s 9h]
Seat 1: di0d80 (button) folded before Flop (didn't bet)
Seat 2: matiko09 (small blind) folded before Flop
Seat 3: prominente (big blind) folded before Flop
Seat 4: Dykallis folded before Flop (didn't bet)
Seat 5: itaik1 folded before Flop (didn't bet)
Seat 7: jannis1951 folded on the Flop
Seat 8: mentalpshyco collected ($18.05)
Seat 9: suddend3ath folded before Flop (didn't bet)





PokerStars Hand #151166184332:  Hold'em No Limit ($1/$2 USD) - 2016/03/30 16:58:37 CET [2016/03/30 10:58:37 ET]
Table 'Sadalbari' 9-max Seat #6 is the button
Seat 2: Rycious ($86.70 in chips) 
Seat 3: thecurv ($200 in chips) 
Seat 4: matiko09 ($211.75 in chips) 
Seat 5: RamiroAgujis ($200 in chips) 
Seat 6: King_ZéManel ($233.25 in chips) 
Seat 7: prominente ($201 in chips) 
Seat 8: suddend3ath ($200 in chips) 
Seat 9: fonng ($96 in chips) 
prominente: posts small blind $1
suddend3ath: posts big blind $2
Igoriah: sits out 
*** HOLE CARDS ***
Dealt to matiko09 [9h 4d]
fonng: folds 
Rycious: calls $2
thecurv: folds 
matiko09: folds 
RamiroAgujis: folds 
King_ZéManel: folds 
prominente: folds 
suddend3ath: checks 
*** FLOP *** [Qh 3d 8s]
suddend3ath: checks 
Rycious: bets $2
suddend3ath: folds 
Uncalled bet ($2) returned to Rycious
Rycious collected $4.75 from pot
Rycious: doesn't show hand 
*** SUMMARY ***
Total pot $5 | Rake $0.25 
Board [Qh 3d 8s]
Seat 2: Rycious collected ($4.75)
Seat 3: thecurv folded before Flop (didn't bet)
Seat 4: matiko09 folded before Flop (didn't bet)
Seat 5: RamiroAgujis folded before Flop (didn't bet)
Seat 6: King_ZéManel (button) folded before Flop (didn't bet)
Seat 7: prominente (small blind) folded before Flop
Seat 8: suddend3ath (big blind) folded on the Flop
Seat 9: fonng folded before Flop (didn't bet)





PokerStars Hand #151166189776:  Hold'em No Limit ($0.50/$1.00 USD) - 2016/03/30 16:58:46 CET [2016/03/30 10:58:46 ET]
Table 'Alcor II' 9-max Seat #4 is the button
Seat 1: di0d80 ($116.65 in chips) 
Seat 3: mitchymitch3 ($98.11 in chips) 
Seat 4: Effort92 ($197.50 in chips) 
Seat 5: elbiber2000 ($100 in chips) 
Seat 6: godfrey004 ($149.39 in chips) 
Seat 7: sanpidk ($100 in chips) 
Seat 8: RICKA16 ($287.56 in chips) 
Seat 9: matiko09 ($194.78 in chips) 
elbiber2000: posts small blind $0.50
godfrey004: posts big blind $1
holloway85: sits out 
*** HOLE CARDS ***
Dealt to matiko09 [9s As]
sanpidk: folds 
RICKA16: folds 
matiko09: raises $2 to $3
di0d80: folds 
mitchymitch3: calls $3
Effort92: folds 
elbiber2000: folds 
godfrey004: calls $2
*** FLOP *** [Ac Tc Kd]
godfrey004: checks 
matiko09: bets $5.86
mitchymitch3: calls $5.86
godfrey004: folds 
*** TURN *** [Ac Tc Kd] [4c]
matiko09: checks 
mitchymitch3: checks 
*** RIVER *** [Ac Tc Kd 4c] [Kc]
matiko09: checks 
mitchymitch3: bets $15
matiko09: folds 
Uncalled bet ($15) returned to mitchymitch3
mitchymitch3 collected $20.16 from pot
mitchymitch3: doesn't show hand 
*** SUMMARY ***
Total pot $21.22 | Rake $1.06 
Board [Ac Tc Kd 4c Kc]
Seat 1: di0d80 folded before Flop (didn't bet)
Seat 3: mitchymitch3 collected ($20.16)
Seat 4: Effort92 (button) folded before Flop (didn't bet)
Seat 5: elbiber2000 (small blind) folded before Flop
Seat 6: godfrey004 (big blind) folded on the Flop
Seat 7: sanpidk folded before Flop (didn't bet)
Seat 8: RICKA16 folded before Flop (didn't bet)
Seat 9: matiko09 folded on the River





PokerStars Hand #151166190960:  Hold'em No Limit ($0.50/$1.00 USD) - 2016/03/30 16:58:48 CET [2016/03/30 10:58:48 ET]
Table 'Figneria III' 9-max Seat #7 is the button
Seat 1: matiko09 ($111.35 in chips) 
Seat 2: sanpidk ($100 in chips) 
Seat 3: lumen21 ($106.18 in chips) 
Seat 4: CI58 ($216.84 in chips) 
Seat 5: b_____a__242 ($90.93 in chips) 
Seat 6: RICKA16 ($100 in chips) 
Seat 7: holloway85 ($240.98 in chips) 
Seat 9: p.snow89 ($69.46 in chips) 
p.snow89: posts small blind $0.50
matiko09: posts big blind $1
*** HOLE CARDS ***
Dealt to matiko09 [Qs 5s]
holloway85 said, "nh"
sanpidk: raises $2 to $3
lumen21: calls $3
p.snow89 said, "thx"
CI58: folds 
b_____a__242: folds 
RICKA16: folds 
holloway85: folds 
p.snow89: calls $2.50
matiko09: folds 
*** FLOP *** [5h 8s Th]
holloway85 said, "really was close to folding flop"
p.snow89: checks 
holloway85 said, "Q got me in troublr"
sanpidk: checks 
lumen21: bets $9.12
p.snow89: folds 
sanpidk: folds 
Uncalled bet ($9.12) returned to lumen21
lumen21 collected $9.50 from pot
lumen21: doesn't show hand 
*** SUMMARY ***
Total pot $10 | Rake $0.50 
Board [5h 8s Th]
Seat 1: matiko09 (big blind) folded before Flop
Seat 2: sanpidk folded on the Flop
Seat 3: lumen21 collected ($9.50)
Seat 4: CI58 folded before Flop (didn't bet)
Seat 5: b_____a__242 folded before Flop (didn't bet)
Seat 6: RICKA16 folded before Flop (didn't bet)
Seat 7: holloway85 (button) folded before Flop (didn't bet)
Seat 9: p.snow89 (small blind) folded on the Flop





PokerStars Hand #151166191637:  Hold'em No Limit ($1/$2 USD) - 2016/03/30 16:58:49 CET [2016/03/30 10:58:49 ET]
Table 'Jole' 9-max Seat #3 is the button
Seat 1: prominente ($264.61 in chips) 
Seat 2: InsomniaRU ($205.45 in chips) 
Seat 3: tipner ($210.53 in chips) 
Seat 4: GS_Sydney ($134.74 in chips) 
Seat 5: mentalpshyco ($200 in chips) 
Seat 6: King_ZéManel ($325.30 in chips) 
Seat 7: thecurv ($210.60 in chips) 
Seat 8: matiko09 ($325.50 in chips) 
Seat 9: RamiroAgujis ($256.76 in chips) 
GS_Sydney: posts small blind $1
mentalpshyco: posts big blind $2
*** HOLE CARDS ***
Dealt to matiko09 [As Kh]
King_ZéManel: folds 
thecurv: folds 
matiko09: raises $3 to $5
RamiroAgujis: folds 
prominente: folds 
InsomniaRU: folds 
tipner: folds 
GS_Sydney: calls $4
mentalpshyco: folds 
*** FLOP *** [2d 6c 4s]
GS_Sydney: checks 
matiko09: checks 
*** TURN *** [2d 6c 4s] [Jh]
GS_Sydney: checks 
matiko09: checks 
*** RIVER *** [2d 6c 4s Jh] [Tc]
GS_Sydney: checks 
matiko09: checks 
*** SHOW DOWN ***
GS_Sydney: shows [5c 5s] (a pair of Fives)
matiko09: mucks hand 
GS_Sydney collected $11.40 from pot
*** SUMMARY ***
Total pot $12 | Rake $0.60 
Board [2d 6c 4s Jh Tc]
Seat 1: prominente folded before Flop (didn't bet)
Seat 2: InsomniaRU folded before Flop (didn't bet)
Seat 3: tipner (button) folded before Flop (didn't bet)
Seat 4: GS_Sydney (small blind) showed [5c 5s] and won ($11.40) with a pair of Fives
Seat 5: mentalpshyco (big blind) folded before Flop
Seat 6: King_ZéManel folded before Flop (didn't bet)
Seat 7: thecurv folded before Flop (didn't bet)
Seat 8: matiko09 mucked [As Kh]
Seat 9: RamiroAgujis folded before Flop (didn't bet)





PokerStars Hand #151166196189:  Hold'em No Limit ($1/$2 USD) - 2016/03/30 16:58:57 CET [2016/03/30 10:58:57 ET]
Table 'Aesculapia II' 9-max Seat #2 is the button
Seat 1: T0ny Adams ($146.25 in chips) 
Seat 2: suddend3ath ($318.65 in chips) 
Seat 3: matiko09 ($655.28 in chips) 
Seat 5: prominente ($200 in chips) 
Seat 6: mentalpshyco ($203 in chips) 
Seat 7: Rumboni66 ($133.17 in chips) 
Seat 9: InsomniaRU ($200 in chips) 
matiko09: posts small blind $1
prominente: posts big blind $2
*** HOLE CARDS ***
Dealt to matiko09 [4d 6c]
mentalpshyco: folds 
di0d80 joins the table at seat #4 
Rumboni66: folds 
di0d80 leaves the table
Igoriah joins the table at seat #4 
InsomniaRU: raises $3 to $5
T0ny Adams: folds 
suddend3ath: folds 
matiko09: folds 
prominente: raises $13 to $18
InsomniaRU: calls $13
*** FLOP *** [3c 4s Js]
prominente: bets $22
InsomniaRU: calls $22
*** TURN *** [3c 4s Js] [Kh]
prominente: bets $34
InsomniaRU has timed out
InsomniaRU: folds 
Uncalled bet ($34) returned to prominente
prominente collected $78.25 from pot
prominente: doesn't show hand 
*** SUMMARY ***
Total pot $81 | Rake $2.75 
Board [3c 4s Js Kh]
Seat 1: T0ny Adams folded before Flop (didn't bet)
Seat 2: suddend3ath (button) folded before Flop (didn't bet)
Seat 3: matiko09 (small blind) folded before Flop
Seat 5: prominente (big blind) collected ($78.25)
Seat 6: mentalpshyco folded before Flop (didn't bet)
Seat 7: Rumboni66 folded before Flop (didn't bet)
Seat 9: InsomniaRU folded on the Turn





PokerStars Hand #151166201899:  Hold'em No Limit ($0.50/$1.00 USD) - 2016/03/30 16:59:07 CET [2016/03/30 10:59:07 ET]
Table 'Pannonia II' 9-max Seat #7 is the button
Seat 1: CI58 ($107.48 in chips) 
Seat 2: matiko09 ($100 in chips) 
Seat 3: MGL_Sky99 ($79.63 in chips) 
Seat 4: SumPosad ($65.63 in chips) 
Seat 5: Spid1 ($234.42 in chips) 
Seat 6: lumen21 ($106.89 in chips) 
Seat 7: Dachish ($69.12 in chips) 
Seat 8: stonymalony ($97 in chips) 
Seat 9: Effort92 ($100 in chips) 
stonymalony: posts small blind $0.50
Effort92: posts big blind $1
*** HOLE CARDS ***
Dealt to matiko09 [7h Kc]
CI58: folds 
matiko09: folds 
MGL_Sky99: folds 
SumPosad: folds 
Spid1: folds 
lumen21: raises $2 to $3
Dachish: calls $3
stonymalony: folds 
Effort92: folds 
*** FLOP *** [4d 4c 2s]
lumen21: checks 
Dachish: bets $3.48
lumen21: folds 
Uncalled bet ($3.48) returned to Dachish
Dachish collected $7.12 from pot
Dachish: doesn't show hand 
*** SUMMARY ***
Total pot $7.50 | Rake $0.38 
Board [4d 4c 2s]
Seat 1: CI58 folded before Flop (didn't bet)
Seat 2: matiko09 folded before Flop (didn't bet)
Seat 3: MGL_Sky99 folded before Flop (didn't bet)
Seat 4: SumPosad folded before Flop (didn't bet)
Seat 5: Spid1 folded before Flop (didn't bet)
Seat 6: lumen21 folded on the Flop
Seat 7: Dachish (button) collected ($7.12)
Seat 8: stonymalony (small blind) folded before Flop
Seat 9: Effort92 (big blind) folded before Flop





PokerStars Hand #151166208062:  Hold'em No Limit ($1/$2 USD) - 2016/03/30 16:59:17 CET [2016/03/30 10:59:17 ET]
Table 'Sadalbari' 9-max Seat #7 is the button
Seat 2: Rycious ($89.45 in chips) 
Seat 3: thecurv ($200 in chips) 
Seat 4: matiko09 ($211.75 in chips) 
Seat 5: RamiroAgujis ($200 in chips) 
Seat 6: King_ZéManel ($233.25 in chips) 
Seat 7: prominente ($200 in chips) 
Seat 8: suddend3ath ($200 in chips) 
Seat 9: fonng ($96 in chips) 
suddend3ath: posts small blind $1
fonng: posts big blind $2
Igoriah: sits out 
*** HOLE CARDS ***
Dealt to matiko09 [3c As]
Rycious: calls $2
thecurv: folds 
matiko09: folds 
RamiroAgujis: folds 
King_ZéManel: folds 
prominente: raises $5 to $7
suddend3ath: folds 
fonng: folds 
Rycious: calls $5
*** FLOP *** [Ad 3s 7d]
Rycious: bets $8
prominente: folds 
Uncalled bet ($8) returned to Rycious
Rycious collected $16.15 from pot
*** SUMMARY ***
Total pot $17 | Rake $0.85 
Board [Ad 3s 7d]
Seat 2: Rycious collected ($16.15)
Seat 3: thecurv folded before Flop (didn't bet)
Seat 4: matiko09 folded before Flop (didn't bet)
Seat 5: RamiroAgujis folded before Flop (didn't bet)
Seat 6: King_ZéManel folded before Flop (didn't bet)
Seat 7: prominente (button) folded on the Flop
Seat 8: suddend3ath (small blind) folded before Flop
Seat 9: fonng (big blind) folded before Flop





PokerStars Hand #151166214491:  Hold'em No Limit ($1/$2 USD) - 2016/03/30 16:59:28 CET [2016/03/30 10:59:28 ET]
Table 'Tabit III' 9-max Seat #2 is the button
Seat 1: di0d80 ($236.97 in chips) 
Seat 2: matiko09 ($226.54 in chips) 
Seat 3: prominente ($200 in chips) 
Seat 4: Dykallis ($501.53 in chips) 
Seat 5: itaik1 ($97.24 in chips) 
Seat 7: jannis1951 ($159.88 in chips) 
Seat 8: mentalpshyco ($213.05 in chips) 
Seat 9: suddend3ath ($200 in chips) 
prominente: posts small blind $1
Dykallis: posts big blind $2
Igoriah: sits out 
*** HOLE CARDS ***
Dealt to matiko09 [Kh 4d]
itaik1: folds 
jannis1951: calls $2
mentalpshyco: folds 
suddend3ath: folds 
di0d80: folds 
matiko09: folds 
prominente: folds 
Dykallis: checks 
*** FLOP *** [9h Jc 2c]
Dykallis: checks 
jannis1951: checks 
*** TURN *** [9h Jc 2c] [5h]
Dykallis: checks 
jannis1951: checks 
*** RIVER *** [9h Jc 2c 5h] [As]
Dykallis: checks 
jannis1951: checks 
*** SHOW DOWN ***
Dykallis: shows [Qh 4c] (high card Ace)
jannis1951: shows [3d Kd] (high card Ace - King kicker)
jannis1951 collected $4.75 from pot
*** SUMMARY ***
Total pot $5 | Rake $0.25 
Board [9h Jc 2c 5h As]
Seat 1: di0d80 folded before Flop (didn't bet)
Seat 2: matiko09 (button) folded before Flop (didn't bet)
Seat 3: prominente (small blind) folded before Flop
Seat 4: Dykallis (big blind) showed [Qh 4c] and lost with high card Ace
Seat 5: itaik1 folded before Flop (didn't bet)
Seat 7: jannis1951 showed [3d Kd] and won ($4.75) with high card Ace
Seat 8: mentalpshyco folded before Flop (didn't bet)
Seat 9: suddend3ath folded before Flop (didn't bet)





PokerStars Hand #151166215253:  Hold'em No Limit ($0.50/$1.00 USD) - 2016/03/30 16:59:29 CET [2016/03/30 10:59:29 ET]
Table 'Sirona II' 9-max Seat #9 is the button
Seat 1: funXmun ($113.14 in chips) 
Seat 3: claudioneamt ($30.64 in chips) 
Seat 4: RICKA16 ($100 in chips) 
Seat 5: bragutza ($271.47 in chips) 
Seat 6: lumen21 ($100 in chips) 
Seat 7: matiko09 ($154.79 in chips) 
Seat 8: sanpidk ($100 in chips) 
Seat 9: mycka86 ($228.60 in chips) 
funXmun: posts small blind $0.50
koutani7: is sitting out 
claudioneamt: posts big blind $1
*** HOLE CARDS ***
Dealt to matiko09 [Th 9h]
koutani7 leaves the table
RICKA16: folds 
bragutza: raises $1 to $2
lumen21: folds 
matiko09: raises $5 to $7
Spid1 joins the table at seat #2 
sanpidk: folds 
mycka86: folds 
funXmun: folds 
claudioneamt: folds 
bragutza: calls $5
*** FLOP *** [5c 6s 3c]
bragutza: checks 
matiko09: checks 
*** TURN *** [5c 6s 3c] [Kh]
bragutza: checks 
matiko09: bets $9
bragutza: folds 
Uncalled bet ($9) returned to matiko09
matiko09 collected $14.72 from pot
matiko09: doesn't show hand 
*** SUMMARY ***
Total pot $15.50 | Rake $0.78 
Board [5c 6s 3c Kh]
Seat 1: funXmun (small blind) folded before Flop
Seat 3: claudioneamt (big blind) folded before Flop
Seat 4: RICKA16 folded before Flop (didn't bet)
Seat 5: bragutza folded on the Turn
Seat 6: lumen21 folded before Flop (didn't bet)
Seat 7: matiko09 collected ($14.72)
Seat 8: sanpidk folded before Flop (didn't bet)
Seat 9: mycka86 (button) folded before Flop (didn't bet)





PokerStars Hand #151166225345:  Hold'em No Limit ($1/$2 USD) - 2016/03/30 16:59:46 CET [2016/03/30 10:59:46 ET]
Table 'Philoctetes II' 9-max Seat #2 is the button
Seat 1: vezunchik79 ($87.38 in chips) 
Seat 2: prominente ($209.91 in chips) 
Seat 3: mentalpshyco ($269.80 in chips) 
Seat 5: zhaimeng ($465.92 in chips) 
Seat 6: di0d80 ($203 in chips) 
Seat 7: matiko09 ($200 in chips) 
Seat 8: suddend3ath ($200 in chips) 
Seat 9: RamiroAgujis ($252.45 in chips) 
mentalpshyco: posts small blind $1
zhaimeng: posts big blind $2
*** HOLE CARDS ***
Dealt to matiko09 [Kd Kh]
di0d80: folds 
matiko09: raises $3 to $5
suddend3ath: folds 
RamiroAgujis: folds 
vezunchik79: folds 
prominente: folds 
mentalpshyco: folds 
zhaimeng: folds 
Uncalled bet ($3) returned to matiko09
matiko09 collected $5 from pot
matiko09: doesn't show hand 
*** SUMMARY ***
Total pot $5 | Rake $0 
Seat 1: vezunchik79 folded before Flop (didn't bet)
Seat 2: prominente (button) folded before Flop (didn't bet)
Seat 3: mentalpshyco (small blind) folded before Flop
Seat 5: zhaimeng (big blind) folded before Flop
Seat 6: di0d80 folded before Flop (didn't bet)
Seat 7: matiko09 collected ($5)
Seat 8: suddend3ath folded before Flop (didn't bet)
Seat 9: RamiroAgujis folded before Flop (didn't bet)





PokerStars Hand #151166227554:  Hold'em No Limit ($0.50/$1.00 USD) - 2016/03/30 16:59:50 CET [2016/03/30 10:59:50 ET]
Table 'Hadwiger' 9-max Seat #7 is the button
Seat 1: AKplus ($90.38 in chips) 
Seat 2: di0d80 ($101.50 in chips) 
Seat 3: yuminyumin1 ($102.72 in chips) 
Seat 4: Westpants ($100 in chips) 
Seat 5: ardo888 ($103.50 in chips) 
Seat 6: xrisall_2 ($152.90 in chips) 
Seat 7: matiko09 ($110.61 in chips) 
Seat 8: Effort92 ($100 in chips) 
Seat 9: IdiotFromNE ($107.17 in chips) 
Effort92: posts small blind $0.50
IdiotFromNE: posts big blind $1
*** HOLE CARDS ***
Dealt to matiko09 [9d Tc]
AKplus: raises $1 to $2
di0d80: folds 
yuminyumin1: folds 
Westpants: folds 
ardo888: folds 
xrisall_2: folds 
matiko09: folds 
Effort92: folds 
IdiotFromNE: folds 
Uncalled bet ($1) returned to AKplus
AKplus collected $2.50 from pot
AKplus: doesn't show hand 
*** SUMMARY ***
Total pot $2.50 | Rake $0 
Seat 1: AKplus collected ($2.50)
Seat 2: di0d80 folded before Flop (didn't bet)
Seat 3: yuminyumin1 folded before Flop (didn't bet)
Seat 4: Westpants folded before Flop (didn't bet)
Seat 5: ardo888 folded before Flop (didn't bet)
Seat 6: xrisall_2 folded before Flop (didn't bet)
Seat 7: matiko09 (button) folded before Flop (didn't bet)
Seat 8: Effort92 (small blind) folded before Flop
Seat 9: IdiotFromNE (big blind) folded before Flop





PokerStars Hand #151166229049:  Hold'em No Limit ($1/$2 USD) - 2016/03/30 16:59:53 CET [2016/03/30 10:59:53 ET]
Table 'Jole' 9-max Seat #4 is the button
Seat 1: prominente ($264.61 in chips) 
Seat 2: InsomniaRU ($205.45 in chips) 
Seat 3: tipner ($210.53 in chips) 
Seat 4: GS_Sydney ($141.14 in chips) 
Seat 5: mentalpshyco ($200 in chips) 
Seat 6: King_ZéManel ($325.30 in chips) 
Seat 7: thecurv ($210.60 in chips) 
Seat 8: matiko09 ($320.50 in chips) 
Seat 9: RamiroAgujis ($256.76 in chips) 
mentalpshyco: posts small blind $1
King_ZéManel: posts big blind $2
*** HOLE CARDS ***
Dealt to matiko09 [2c 5d]
thecurv: folds 
matiko09: folds 
RamiroAgujis: folds 
prominente: raises $3 to $5
InsomniaRU: folds 
tipner: folds 
GS_Sydney: calls $5
mentalpshyco: folds 
King_ZéManel: folds 
*** FLOP *** [2d 9c 5c]
prominente: checks 
GS_Sydney: checks 
*** TURN *** [2d 9c 5c] [Kd]
prominente: bets $7.53
GS_Sydney: calls $7.53
*** RIVER *** [2d 9c 5c Kd] [9h]
prominente: checks 
GS_Sydney: checks 
*** SHOW DOWN ***
prominente: shows [Jd Ad] (a pair of Nines)
GS_Sydney: mucks hand 
prominente collected $26.66 from pot
*** SUMMARY ***
Total pot $28.06 | Rake $1.40 
Board [2d 9c 5c Kd 9h]
Seat 1: prominente showed [Jd Ad] and won ($26.66) with a pair of Nines
Seat 2: InsomniaRU folded before Flop (didn't bet)
Seat 3: tipner folded before Flop (didn't bet)
Seat 4: GS_Sydney (button) mucked [Js Th]
Seat 5: mentalpshyco (small blind) folded before Flop
Seat 6: King_ZéManel (big blind) folded before Flop
Seat 7: thecurv folded before Flop (didn't bet)
Seat 8: matiko09 folded before Flop (didn't bet)
Seat 9: RamiroAgujis folded before Flop (didn't bet)





PokerStars Hand #151166230882:  Hold'em No Limit ($0.50/$1.00 USD) - 2016/03/30 16:59:56 CET [2016/03/30 10:59:56 ET]
Table 'Figneria III' 9-max Seat #9 is the button
Seat 1: matiko09 ($110.35 in chips) 
Seat 2: sanpidk ($100 in chips) 
Seat 3: lumen21 ($112.68 in chips) 
Seat 4: CI58 ($216.84 in chips) 
Seat 5: b_____a__242 ($90.93 in chips) 
Seat 6: RICKA16 ($100 in chips) 
Seat 7: holloway85 ($240.98 in chips) 
Seat 9: p.snow89 ($66.46 in chips) 
matiko09: posts small blind $0.50
sanpidk: posts big blind $1
*** HOLE CARDS ***
Dealt to matiko09 [2s 5h]
lumen21: folds 
CI58: folds 
b_____a__242: folds 
RICKA16: folds 
holloway85: folds 
p.snow89: calls $1
matiko09: folds 
sanpidk: raises $3.50 to $4.50
p.snow89: calls $3.50
*** FLOP *** [2d Ts Jh]
sanpidk: bets $5.50
p.snow89: folds 
Uncalled bet ($5.50) returned to sanpidk
sanpidk collected $9.02 from pot
sanpidk: doesn't show hand 
*** SUMMARY ***
Total pot $9.50 | Rake $0.48 
Board [2d Ts Jh]
Seat 1: matiko09 (small blind) folded before Flop
Seat 2: sanpidk (big blind) collected ($9.02)
Seat 3: lumen21 folded before Flop (didn't bet)
Seat 4: CI58 folded before Flop (didn't bet)
Seat 5: b_____a__242 folded before Flop (didn't bet)
Seat 6: RICKA16 folded before Flop (didn't bet)
Seat 7: holloway85 folded before Flop (didn't bet)
Seat 9: p.snow89 (button) folded on the Flop





PokerStars Hand #151166233064:  Hold'em No Limit ($0.50/$1.00 USD) - 2016/03/30 16:59:59 CET [2016/03/30 10:59:59 ET]
Table 'Alcor II' 9-max Seat #5 is the button
Seat 1: di0d80 ($116.65 in chips) 
Seat 3: mitchymitch3 ($109.41 in chips) 
Seat 4: Effort92 ($197.50 in chips) 
Seat 5: elbiber2000 ($100 in chips) 
Seat 6: godfrey004 ($146.39 in chips) 
Seat 7: sanpidk ($100 in chips) 
Seat 8: RICKA16 ($287.56 in chips) 
Seat 9: matiko09 ($185.92 in chips) 
godfrey004: posts small blind $0.50
sanpidk: posts big blind $1
holloway85: sits out 
*** HOLE CARDS ***
Dealt to matiko09 [6h 5h]
RICKA16: folds 
matiko09: folds 
di0d80: folds 
mitchymitch3: folds 
Effort92: folds 
elbiber2000: folds 
godfrey004: raises $3 to $4
sanpidk: calls $3
*** FLOP *** [8h Ah 4d]
godfrey004: bets $6
sanpidk: raises $11 to $17
godfrey004: folds 
Uncalled bet ($11) returned to sanpidk
sanpidk collected $19 from pot
*** SUMMARY ***
Total pot $20 | Rake $1 
Board [8h Ah 4d]
Seat 1: di0d80 folded before Flop (didn't bet)
Seat 3: mitchymitch3 folded before Flop (didn't bet)
Seat 4: Effort92 folded before Flop (didn't bet)
Seat 5: elbiber2000 (button) folded before Flop (didn't bet)
Seat 6: godfrey004 (small blind) folded on the Flop
Seat 7: sanpidk (big blind) collected ($19)
Seat 8: RICKA16 folded before Flop (didn't bet)
Seat 9: matiko09 folded before Flop (didn't bet)





PokerStars Hand #151166240475:  Hold'em No Limit ($0.50/$1.00 USD) - 2016/03/30 17:00:11 CET [2016/03/30 11:00:11 ET]
Table 'Pannonia II' 9-max Seat #8 is the button
Seat 1: CI58 ($107.48 in chips) 
Seat 2: matiko09 ($100 in chips) 
Seat 3: MGL_Sky99 ($79.63 in chips) 
Seat 4: SumPosad ($65.63 in chips) 
Seat 5: Spid1 ($234.42 in chips) 
Seat 6: lumen21 ($103.89 in chips) 
Seat 7: Dachish ($73.24 in chips) 
Seat 8: stonymalony ($96.50 in chips) 
Seat 9: Effort92 ($100 in chips) 
Effort92: posts small blind $0.50
CI58: posts big blind $1
*** HOLE CARDS ***
Dealt to matiko09 [Ad Ts]
matiko09: folds 
MGL_Sky99: raises $2 to $3
SumPosad: folds 
Spid1: folds 
lumen21: folds 
Dachish: folds 
stonymalony: calls $3
Effort92: folds 
CI58: folds 
*** FLOP *** [3d 2c Ah]
MGL_Sky99: bets $3.56
stonymalony: folds 
Uncalled bet ($3.56) returned to MGL_Sky99
MGL_Sky99 collected $7.12 from pot
MGL_Sky99: doesn't show hand 
*** SUMMARY ***
Total pot $7.50 | Rake $0.38 
Board [3d 2c Ah]
Seat 1: CI58 (big blind) folded before Flop
Seat 2: matiko09 folded before Flop (didn't bet)
Seat 3: MGL_Sky99 collected ($7.12)
Seat 4: SumPosad folded before Flop (didn't bet)
Seat 5: Spid1 folded before Flop (didn't bet)
Seat 6: lumen21 folded before Flop (didn't bet)
Seat 7: Dachish folded before Flop (didn't bet)
Seat 8: stonymalony (button) folded on the Flop
Seat 9: Effort92 (small blind) folded before Flop





PokerStars Hand #151166244983:  Hold'em No Limit ($0.50/$1.00 USD) - 2016/03/30 17:00:19 CET [2016/03/30 11:00:19 ET]
Table 'Hadwiger' 9-max Seat #8 is the button
Seat 1: AKplus ($91.88 in chips) 
Seat 2: di0d80 ($101.50 in chips) 
Seat 3: yuminyumin1 ($102.72 in chips) 
Seat 4: Westpants ($100 in chips) 
Seat 5: ardo888 ($103.50 in chips) 
Seat 6: xrisall_2 ($152.90 in chips) 
Seat 7: matiko09 ($110.61 in chips) 
Seat 8: Effort92 ($100 in chips) 
Seat 9: IdiotFromNE ($106.17 in chips) 
IdiotFromNE: posts small blind $0.50
AKplus: posts big blind $1
*** HOLE CARDS ***
Dealt to matiko09 [Qh 8s]
di0d80: folds 
yuminyumin1: folds 
Westpants: folds 
ardo888: folds 
xrisall_2: raises $2 to $3
matiko09: folds 
Effort92: folds 
IdiotFromNE: folds 
AKplus: calls $2
*** FLOP *** [3h Ad Jc]
AKplus: checks 
xrisall_2: bets $3
AKplus: calls $3
*** TURN *** [3h Ad Jc] [8c]
AKplus: checks 
xrisall_2: checks 
*** RIVER *** [3h Ad Jc 8c] [9h]
AKplus: checks 
xrisall_2: checks 
*** SHOW DOWN ***
AKplus: shows [5h 5c] (a pair of Fives)
xrisall_2: shows [Jh Qc] (a pair of Jacks)
xrisall_2 collected $11.88 from pot
*** SUMMARY ***
Total pot $12.50 | Rake $0.62 
Board [3h Ad Jc 8c 9h]
Seat 1: AKplus (big blind) showed [5h 5c] and lost with a pair of Fives
Seat 2: di0d80 folded before Flop (didn't bet)
Seat 3: yuminyumin1 folded before Flop (didn't bet)
Seat 4: Westpants folded before Flop (didn't bet)
Seat 5: ardo888 folded before Flop (didn't bet)
Seat 6: xrisall_2 showed [Jh Qc] and won ($11.88) with a pair of Jacks
Seat 7: matiko09 folded before Flop (didn't bet)
Seat 8: Effort92 (button) folded before Flop (didn't bet)
Seat 9: IdiotFromNE (small blind) folded before Flop





PokerStars Hand #151166245682:  Hold'em No Limit ($1/$2 USD) - 2016/03/30 17:00:20 CET [2016/03/30 11:00:20 ET]
Table 'Sadalbari' 9-max Seat #8 is the button
Seat 1: Igoriah ($200 in chips) 
Seat 2: Rycious ($98.60 in chips) 
Seat 3: thecurv ($200 in chips) 
Seat 4: matiko09 ($211.75 in chips) 
Seat 5: RamiroAgujis ($200 in chips) 
Seat 6: King_ZéManel ($233.25 in chips) 
Seat 7: prominente ($200 in chips) 
Seat 8: suddend3ath ($200 in chips) 
Seat 9: fonng ($94 in chips) 
fonng: posts small blind $1
Igoriah: posts big blind $2
*** HOLE CARDS ***
Dealt to matiko09 [Qh 8h]
Rycious: folds 
thecurv: folds 
matiko09: folds 
RamiroAgujis: folds 
King_ZéManel: folds 
prominente: raises $3 to $5
suddend3ath: calls $5
fonng: folds 
Igoriah: folds 
*** FLOP *** [Js 8s Jd]
prominente: checks 
suddend3ath: bets $8
prominente: calls $8
*** TURN *** [Js 8s Jd] [4c]
prominente: checks 
suddend3ath: bets $20
prominente: folds 
Uncalled bet ($20) returned to suddend3ath
suddend3ath collected $27.55 from pot
suddend3ath: doesn't show hand 
*** SUMMARY ***
Total pot $29 | Rake $1.45 
Board [Js 8s Jd 4c]
Seat 1: Igoriah (big blind) folded before Flop
Seat 2: Rycious folded before Flop (didn't bet)
Seat 3: thecurv folded before Flop (didn't bet)
Seat 4: matiko09 folded before Flop (didn't bet)
Seat 5: RamiroAgujis folded before Flop (didn't bet)
Seat 6: King_ZéManel folded before Flop (didn't bet)
Seat 7: prominente folded on the Turn
Seat 8: suddend3ath (button) collected ($27.55)
Seat 9: fonng (small blind) folded before Flop





PokerStars Hand #151166250897:  Hold'em No Limit ($1/$2 USD) - 2016/03/30 17:00:29 CET [2016/03/30 11:00:29 ET]
Table 'Philoctetes II' 9-max Seat #3 is the button
Seat 1: vezunchik79 ($87.38 in chips) 
Seat 2: prominente ($209.91 in chips) 
Seat 3: mentalpshyco ($268.80 in chips) 
Seat 5: zhaimeng ($463.92 in chips) 
Seat 6: di0d80 ($203 in chips) 
Seat 7: matiko09 ($203 in chips) 
Seat 8: suddend3ath ($200 in chips) 
Seat 9: RamiroAgujis ($252.45 in chips) 
zhaimeng: posts small blind $1
di0d80: posts big blind $2
*** HOLE CARDS ***
Dealt to matiko09 [6c Th]
matiko09: folds 
suddend3ath: folds 
RamiroAgujis: folds 
vezunchik79: folds 
prominente: folds 
mentalpshyco: raises $3 to $5
zhaimeng: calls $4
di0d80: folds 
*** FLOP *** [Jh 5s Kh]
zhaimeng: checks 
mentalpshyco: bets $7
zhaimeng: calls $7
*** TURN *** [Jh 5s Kh] [Qs]
zhaimeng: checks 
mentalpshyco: checks 
*** RIVER *** [Jh 5s Kh Qs] [2s]
zhaimeng: bets $12.35
mentalpshyco: folds 
Uncalled bet ($12.35) returned to zhaimeng
zhaimeng collected $24.70 from pot
zhaimeng: doesn't show hand 
*** SUMMARY ***
Total pot $26 | Rake $1.30 
Board [Jh 5s Kh Qs 2s]
Seat 1: vezunchik79 folded before Flop (didn't bet)
Seat 2: prominente folded before Flop (didn't bet)
Seat 3: mentalpshyco (button) folded on the River
Seat 5: zhaimeng (small blind) collected ($24.70)
Seat 6: di0d80 (big blind) folded before Flop
Seat 7: matiko09 folded before Flop (didn't bet)
Seat 8: suddend3ath folded before Flop (didn't bet)
Seat 9: RamiroAgujis folded before Flop (didn't bet)





PokerStars Hand #151166253104:  Hold'em No Limit ($1/$2 USD) - 2016/03/30 17:00:32 CET [2016/03/30 11:00:32 ET]
Table 'Tabit III' 9-max Seat #3 is the button
Seat 1: di0d80 ($236.97 in chips) 
Seat 2: matiko09 ($226.54 in chips) 
Seat 3: prominente ($200 in chips) 
Seat 4: Dykallis ($499.53 in chips) 
Seat 5: itaik1 ($97.24 in chips) 
Seat 7: jannis1951 ($162.63 in chips) 
Seat 8: mentalpshyco ($213.05 in chips) 
Seat 9: suddend3ath ($200 in chips) 
Dykallis: posts small blind $1
itaik1: posts big blind $2
Igoriah: sits out 
*** HOLE CARDS ***
Dealt to matiko09 [9s Kd]
jannis1951: folds 
mentalpshyco: folds 
suddend3ath: folds 
di0d80: folds 
matiko09: folds 
prominente: raises $2 to $4
Dykallis: folds 
itaik1: folds 
Uncalled bet ($2) returned to prominente
prominente collected $5 from pot
prominente: doesn't show hand 
*** SUMMARY ***
Total pot $5 | Rake $0 
Seat 1: di0d80 folded before Flop (didn't bet)
Seat 2: matiko09 folded before Flop (didn't bet)
Seat 3: prominente (button) collected ($5)
Seat 4: Dykallis (small blind) folded before Flop
Seat 5: itaik1 (big blind) folded before Flop
Seat 7: jannis1951 folded before Flop (didn't bet)
Seat 8: mentalpshyco folded before Flop (didn't bet)
Seat 9: suddend3ath folded before Flop (didn't bet)





PokerStars Hand #151166254726:  Hold'em No Limit ($0.50/$1.00 USD) - 2016/03/30 17:00:35 CET [2016/03/30 11:00:35 ET]
Table 'Sumiana III' 9-max Seat #5 is the button
Seat 1: Mukhin1 ($108.05 in chips) 
Seat 2: Sloeve ($119.65 in chips) 
Seat 3: IdiotFromNE ($100 in chips) 
Seat 4: Pingili ($44.97 in chips) 
Seat 5: khalsanhaji ($39.85 in chips) 
Seat 6: sanpidk ($162.04 in chips) 
Seat 7: matiko09 ($100 in chips) 
Seat 8: Effort92 ($100 in chips) 
Seat 9: lumen21 ($111.25 in chips) 
sanpidk: posts small blind $0.50
matiko09: posts big blind $1
*** HOLE CARDS ***
Dealt to matiko09 [8d Ah]
Effort92: folds 
lumen21: folds 
Mukhin1: raises $2.02 to $3.02
Sloeve: folds 
IdiotFromNE: folds 
Pingili: folds 
khalsanhaji: folds 
sanpidk: folds 
matiko09: folds 
Uncalled bet ($2.02) returned to Mukhin1
Mukhin1 collected $2.50 from pot
Mukhin1: doesn't show hand 
*** SUMMARY ***
Total pot $2.50 | Rake $0 
Seat 1: Mukhin1 collected ($2.50)
Seat 2: Sloeve folded before Flop (didn't bet)
Seat 3: IdiotFromNE folded before Flop (didn't bet)
Seat 4: Pingili folded before Flop (didn't bet)
Seat 5: khalsanhaji (button) folded before Flop (didn't bet)
Seat 6: sanpidk (small blind) folded before Flop
Seat 7: matiko09 (big blind) folded before Flop
Seat 8: Effort92 folded before Flop (didn't bet)
Seat 9: lumen21 folded before Flop (didn't bet)





PokerStars Hand #151166264190:  Hold'em No Limit ($0.50/$1.00 USD) - 2016/03/30 17:00:50 CET [2016/03/30 11:00:50 ET]
Table 'Alcor II' 9-max Seat #6 is the button
Seat 1: di0d80 ($116.65 in chips) 
Seat 3: mitchymitch3 ($109.41 in chips) 
Seat 4: Effort92 ($197.50 in chips) 
Seat 5: elbiber2000 ($100 in chips) 
Seat 6: godfrey004 ($136.39 in chips) 
Seat 7: sanpidk ($109 in chips) 
Seat 8: RICKA16 ($287.56 in chips) 
Seat 9: matiko09 ($185.92 in chips) 
sanpidk: posts small blind $0.50
RICKA16: posts big blind $1
holloway85: sits out 
*** HOLE CARDS ***
Dealt to matiko09 [Ks 6c]
matiko09: folds 
di0d80: folds 
mitchymitch3: folds 
Effort92: raises $1.50 to $2.50
elbiber2000: folds 
godfrey004: folds 
sanpidk: folds 
RICKA16: folds 
Uncalled bet ($1.50) returned to Effort92
Effort92 collected $2.50 from pot
Effort92: doesn't show hand 
*** SUMMARY ***
Total pot $2.50 | Rake $0 
Seat 1: di0d80 folded before Flop (didn't bet)
Seat 3: mitchymitch3 folded before Flop (didn't bet)
Seat 4: Effort92 collected ($2.50)
Seat 5: elbiber2000 folded before Flop (didn't bet)
Seat 6: godfrey004 (button) folded before Flop (didn't bet)
Seat 7: sanpidk (small blind) folded before Flop
Seat 8: RICKA16 (big blind) folded before Flop
Seat 9: matiko09 folded before Flop (didn't bet)





PokerStars Hand #151166267329:  Hold'em No Limit ($0.50/$1.00 USD) - 2016/03/30 17:00:55 CET [2016/03/30 11:00:55 ET]
Table 'Sirona II' 9-max Seat #1 is the button
Seat 1: funXmun ($112.64 in chips) 
Seat 3: claudioneamt ($29.64 in chips) 
Seat 4: RICKA16 ($100 in chips) 
Seat 5: bragutza ($264.47 in chips) 
Seat 6: lumen21 ($100 in chips) 
Seat 7: matiko09 ($162.51 in chips) 
Seat 8: sanpidk ($100 in chips) 
Seat 9: mycka86 ($228.60 in chips) 
Spid1 will be allowed to play after the button
claudioneamt: posts small blind $0.50
RICKA16: posts big blind $1
*** HOLE CARDS ***
Dealt to matiko09 [3s 8h]
bragutza: raises $2.50 to $3.50
lumen21: folds 
matiko09: folds 
sanpidk: folds 
mycka86: folds 
funXmun: folds 
claudioneamt: calls $3
RICKA16: folds 
*** FLOP *** [Qh 3h Qd]
claudioneamt: bets $3.80
bragutza: raises $7.60 to $11.40
claudioneamt: folds 
Uncalled bet ($7.60) returned to bragutza
bragutza collected $14.82 from pot
bragutza: doesn't show hand 
*** SUMMARY ***
Total pot $15.60 | Rake $0.78 
Board [Qh 3h Qd]
Seat 1: funXmun (button) folded before Flop (didn't bet)
Seat 3: claudioneamt (small blind) folded on the Flop
Seat 4: RICKA16 (big blind) folded before Flop
Seat 5: bragutza collected ($14.82)
Seat 6: lumen21 folded before Flop (didn't bet)
Seat 7: matiko09 folded before Flop (didn't bet)
Seat 8: sanpidk folded before Flop (didn't bet)
Seat 9: mycka86 folded before Flop (didn't bet)





PokerStars Hand #151166269569:  Hold'em No Limit ($0.50/$1.00 USD) - 2016/03/30 17:00:58 CET [2016/03/30 11:00:58 ET]
Table 'Figneria III' 9-max Seat #1 is the button
Seat 1: matiko09 ($109.85 in chips) 
Seat 2: sanpidk ($104.52 in chips) 
Seat 3: lumen21 ($112.68 in chips) 
Seat 4: CI58 ($216.84 in chips) 
Seat 5: b_____a__242 ($90.93 in chips) 
Seat 6: RICKA16 ($100 in chips) 
Seat 7: holloway85 ($240.98 in chips) 
Seat 9: p.snow89 ($61.96 in chips) 
sanpidk: posts small blind $0.50
lumen21: posts big blind $1
*** HOLE CARDS ***
Dealt to matiko09 [Jc 5h]
CI58: folds 
b_____a__242: raises $2 to $3
RICKA16: calls $3
holloway85: folds 
p.snow89: folds 
matiko09: folds 
sanpidk: folds 
lumen21: folds 
*** FLOP *** [8c 9s 6h]
b_____a__242: checks 
RICKA16: bets $5
b_____a__242: folds 
Uncalled bet ($5) returned to RICKA16
RICKA16 collected $7.12 from pot
RICKA16: doesn't show hand 
*** SUMMARY ***
Total pot $7.50 | Rake $0.38 
Board [8c 9s 6h]
Seat 1: matiko09 (button) folded before Flop (didn't bet)
Seat 2: sanpidk (small blind) folded before Flop
Seat 3: lumen21 (big blind) folded before Flop
Seat 4: CI58 folded before Flop (didn't bet)
Seat 5: b_____a__242 folded on the Flop
Seat 6: RICKA16 collected ($7.12)
Seat 7: holloway85 folded before Flop (didn't bet)
Seat 9: p.snow89 folded before Flop (didn't bet)





PokerStars Hand #151166270614:  Hold'em No Limit ($1/$2 USD) - 2016/03/30 17:01:00 CET [2016/03/30 11:01:00 ET]
Table 'Aesculapia II' 9-max Seat #3 is the button
Seat 1: T0ny Adams ($146.25 in chips) 
Seat 2: suddend3ath ($318.65 in chips) 
Seat 3: matiko09 ($654.28 in chips) 
Seat 5: prominente ($238.25 in chips) 
Seat 6: mentalpshyco ($203 in chips) 
Seat 7: Rumboni66 ($133.17 in chips) 
Seat 9: InsomniaRU ($200 in chips) 
Igoriah will be allowed to play after the button
prominente: posts small blind $1
mentalpshyco: posts big blind $2
*** HOLE CARDS ***
Dealt to matiko09 [9h Jc]
Rumboni66: calls $2
InsomniaRU: folds 
T0ny Adams: raises $6 to $8
suddend3ath: folds 
matiko09: folds 
prominente: folds 
mentalpshyco: folds 
Rumboni66: calls $6
*** FLOP *** [5c 8s Ad]
Rumboni66: checks 
T0ny Adams: bets $5
Rumboni66: calls $5
*** TURN *** [5c 8s Ad] [9c]
Rumboni66: bets $6
T0ny Adams: calls $6
*** RIVER *** [5c 8s Ad 9c] [Th]
Rumboni66: bets $14
T0ny Adams: calls $14
*** SHOW DOWN ***
Rumboni66: shows [As 7s] (a pair of Aces)
T0ny Adams: shows [Qs Ac] (a pair of Aces - Queen kicker)
T0ny Adams collected $66.25 from pot
*** SUMMARY ***
Total pot $69 | Rake $2.75 
Board [5c 8s Ad 9c Th]
Seat 1: T0ny Adams showed [Qs Ac] and won ($66.25) with a pair of Aces
Seat 2: suddend3ath folded before Flop (didn't bet)
Seat 3: matiko09 (button) folded before Flop (didn't bet)
Seat 5: prominente (small blind) folded before Flop
Seat 6: mentalpshyco (big blind) folded before Flop
Seat 7: Rumboni66 showed [As 7s] and lost with a pair of Aces
Seat 9: InsomniaRU folded before Flop (didn't bet)





PokerStars Hand #151166275143:  Hold'em No Limit ($0.50/$1.00 USD) - 2016/03/30 17:01:06 CET [2016/03/30 11:01:06 ET]
Table 'Pannonia II' 9-max Seat #9 is the button
Seat 1: CI58 ($106.48 in chips) 
Seat 2: matiko09 ($100 in chips) 
Seat 3: MGL_Sky99 ($83.75 in chips) 
Seat 4: SumPosad ($65.63 in chips) 
Seat 5: Spid1 ($234.42 in chips) 
Seat 6: lumen21 ($103.89 in chips) 
Seat 7: Dachish ($73.24 in chips) 
Seat 8: stonymalony ($93.50 in chips) 
Seat 9: Effort92 ($100 in chips) 
CI58: posts small blind $0.50
matiko09: posts big blind $1
*** HOLE CARDS ***
Dealt to matiko09 [2s 7h]
MGL_Sky99: folds 
SumPosad: raises $2 to $3
Spid1: folds 
lumen21: folds 
Dachish: calls $3
stonymalony: folds 
Effort92: folds 
CI58: folds 
matiko09: folds 
*** FLOP *** [Ac Jh Ah]
SumPosad: bets $4.80
Dachish: folds 
Uncalled bet ($4.80) returned to SumPosad
SumPosad collected $7.12 from pot
SumPosad: doesn't show hand 
*** SUMMARY ***
Total pot $7.50 | Rake $0.38 
Board [Ac Jh Ah]
Seat 1: CI58 (small blind) folded before Flop
Seat 2: matiko09 (big blind) folded before Flop
Seat 3: MGL_Sky99 folded before Flop (didn't bet)
Seat 4: SumPosad collected ($7.12)
Seat 5: Spid1 folded before Flop (didn't bet)
Seat 6: lumen21 folded before Flop (didn't bet)
Seat 7: Dachish folded on the Flop
Seat 8: stonymalony folded before Flop (didn't bet)
Seat 9: Effort92 (button) folded before Flop (didn't bet)





PokerStars Hand #151166276764:  Hold'em No Limit ($1/$2 USD) - 2016/03/30 17:01:09 CET [2016/03/30 11:01:09 ET]
Table 'Tabit III' 9-max Seat #4 is the button
Seat 1: di0d80 ($236.97 in chips) 
Seat 2: matiko09 ($226.54 in chips) 
Seat 3: prominente ($203 in chips) 
Seat 4: Dykallis ($498.53 in chips) 
Seat 5: itaik1 ($95.24 in chips) 
Seat 6: Igoriah ($200 in chips) 
Seat 7: jannis1951 ($162.63 in chips) 
Seat 8: mentalpshyco ($213.05 in chips) 
Seat 9: suddend3ath ($200 in chips) 
itaik1: posts small blind $1
Igoriah: posts big blind $2
*** HOLE CARDS ***
Dealt to matiko09 [7c 6d]
jannis1951: calls $2
mentalpshyco: folds 
suddend3ath: folds 
di0d80: folds 
matiko09: folds 
prominente: raises $5 to $7
Dykallis: folds 
itaik1: folds 
Igoriah: folds 
jannis1951: calls $5
*** FLOP *** [9c Ac 6s]
jannis1951: checks 
prominente: bets $12
jannis1951: calls $12
*** TURN *** [9c Ac 6s] [4c]
jannis1951: checks 
prominente: checks 
*** RIVER *** [9c Ac 6s 4c] [8h]
jannis1951: bets $38.95
prominente: folds 
Uncalled bet ($38.95) returned to jannis1951
jannis1951 collected $38.95 from pot
*** SUMMARY ***
Total pot $41 | Rake $2.05 
Board [9c Ac 6s 4c 8h]
Seat 1: di0d80 folded before Flop (didn't bet)
Seat 2: matiko09 folded before Flop (didn't bet)
Seat 3: prominente folded on the River
Seat 4: Dykallis (button) folded before Flop (didn't bet)
Seat 5: itaik1 (small blind) folded before Flop
Seat 6: Igoriah (big blind) folded before Flop
Seat 7: jannis1951 collected ($38.95)
Seat 8: mentalpshyco folded before Flop (didn't bet)
Seat 9: suddend3ath folded before Flop (didn't bet)





PokerStars Hand #151166277392:  Hold'em No Limit ($0.50/$1.00 USD) - 2016/03/30 17:01:10 CET [2016/03/30 11:01:10 ET]
Table 'Alcor II' 9-max Seat #7 is the button
Seat 1: di0d80 ($116.65 in chips) 
Seat 3: mitchymitch3 ($109.41 in chips) 
Seat 4: Effort92 ($199 in chips) 
Seat 5: elbiber2000 ($100 in chips) 
Seat 6: godfrey004 ($136.39 in chips) 
Seat 7: sanpidk ($108.50 in chips) 
Seat 8: RICKA16 ($286.56 in chips) 
Seat 9: matiko09 ($185.92 in chips) 
RICKA16: posts small blind $0.50
matiko09: posts big blind $1
holloway85: sits out 
*** HOLE CARDS ***
Dealt to matiko09 [2s As]
di0d80: folds 
mitchymitch3: folds 
Effort92: raises $1.50 to $2.50
elbiber2000: folds 
godfrey004: folds 
sanpidk: folds 
RICKA16: folds 
matiko09: folds 
Uncalled bet ($1.50) returned to Effort92
Effort92 collected $2.50 from pot
Effort92: doesn't show hand 
*** SUMMARY ***
Total pot $2.50 | Rake $0 
Seat 1: di0d80 folded before Flop (didn't bet)
Seat 3: mitchymitch3 folded before Flop (didn't bet)
Seat 4: Effort92 collected ($2.50)
Seat 5: elbiber2000 folded before Flop (didn't bet)
Seat 6: godfrey004 folded before Flop (didn't bet)
Seat 7: sanpidk (button) folded before Flop (didn't bet)
Seat 8: RICKA16 (small blind) folded before Flop
Seat 9: matiko09 (big blind) folded before Flop





PokerStars Hand #151166287674:  Hold'em No Limit ($0.50/$1.00 USD) - 2016/03/30 17:01:25 CET [2016/03/30 11:01:25 ET]
Table 'Sumiana III' 9-max Seat #6 is the button
Seat 1: Mukhin1 ($109.55 in chips) 
Seat 2: Sloeve ($119.65 in chips) 
Seat 3: IdiotFromNE ($100 in chips) 
Seat 4: Pingili ($44.97 in chips) 
Seat 5: khalsanhaji ($39.85 in chips) 
Seat 6: sanpidk ($161.54 in chips) 
Seat 7: matiko09 ($100 in chips) 
Seat 8: Effort92 ($100 in chips) 
Seat 9: lumen21 ($111.25 in chips) 
matiko09: posts small blind $0.50
Effort92: posts big blind $1
*** HOLE CARDS ***
Dealt to matiko09 [As Kc]
lumen21: folds 
Mukhin1: folds 
Sloeve: folds 
IdiotFromNE: folds 
Pingili: calls $1
khalsanhaji: raises $2 to $3
sanpidk: folds 
matiko09: raises $8 to $11
Effort92: folds 
Pingili: folds 
khalsanhaji: calls $8
*** FLOP *** [Td 8d 4h]
matiko09: checks 
khalsanhaji: bets $28.85 and is all-in
matiko09: calls $28.85
*** TURN *** [Td 8d 4h] [5s]
*** RIVER *** [Td 8d 4h 5s] [7s]
*** SHOW DOWN ***
matiko09: shows [As Kc] (high card Ace)
khalsanhaji: mucks hand 
matiko09 collected $79.20 from pot
*** SUMMARY ***
Total pot $81.70 | Rake $2.50 
Board [Td 8d 4h 5s 7s]
Seat 1: Mukhin1 folded before Flop (didn't bet)
Seat 2: Sloeve folded before Flop (didn't bet)
Seat 3: IdiotFromNE folded before Flop (didn't bet)
Seat 4: Pingili folded before Flop
Seat 5: khalsanhaji mucked [Jd Qc]
Seat 6: sanpidk (button) folded before Flop (didn't bet)
Seat 7: matiko09 (small blind) showed [As Kc] and won ($79.20) with high card Ace
Seat 8: Effort92 (big blind) folded before Flop
Seat 9: lumen21 folded before Flop (didn't bet)





PokerStars Hand #151166292685:  Hold'em No Limit ($0.50/$1.00 USD) - 2016/03/30 17:01:33 CET [2016/03/30 11:01:33 ET]
Table 'Alcor II' 9-max Seat #8 is the button
Seat 1: di0d80 ($116.65 in chips) 
Seat 3: mitchymitch3 ($109.41 in chips) 
Seat 4: Effort92 ($200.50 in chips) 
Seat 5: elbiber2000 ($100 in chips) 
Seat 6: godfrey004 ($136.39 in chips) 
Seat 7: sanpidk ($108.50 in chips) 
Seat 8: RICKA16 ($286.06 in chips) 
Seat 9: matiko09 ($184.92 in chips) 
matiko09: posts small blind $0.50
di0d80: posts big blind $1
holloway85: sits out 
*** HOLE CARDS ***
Dealt to matiko09 [2d 2c]
mitchymitch3: folds 
Effort92: folds 
elbiber2000: folds 
godfrey004: folds 
sanpidk: raises $1 to $2
RICKA16: folds 
matiko09: folds 
di0d80: folds 
Uncalled bet ($1) returned to sanpidk
sanpidk collected $2.50 from pot
*** SUMMARY ***
Total pot $2.50 | Rake $0 
Seat 1: di0d80 (big blind) folded before Flop
Seat 3: mitchymitch3 folded before Flop (didn't bet)
Seat 4: Effort92 folded before Flop (didn't bet)
Seat 5: elbiber2000 folded before Flop (didn't bet)
Seat 6: godfrey004 folded before Flop (didn't bet)
Seat 7: sanpidk collected ($2.50)
Seat 8: RICKA16 (button) folded before Flop (didn't bet)
Seat 9: matiko09 (small blind) folded before Flop





PokerStars Hand #151166296396:  Hold'em No Limit ($0.50/$1.00 USD) - 2016/03/30 17:01:38 CET [2016/03/30 11:01:38 ET]
Table 'Hadwiger' 9-max Seat #9 is the button
Seat 1: AKplus ($85.88 in chips) 
Seat 2: di0d80 ($101.50 in chips) 
Seat 3: yuminyumin1 ($102.72 in chips) 
Seat 4: Westpants ($100 in chips) 
Seat 5: ardo888 ($103.50 in chips) 
Seat 6: xrisall_2 ($158.78 in chips) 
Seat 7: matiko09 ($110.61 in chips) 
Seat 8: Effort92 ($100 in chips) 
Seat 9: IdiotFromNE ($105.67 in chips) 
AKplus: posts small blind $0.50
di0d80: posts big blind $1
*** HOLE CARDS ***
Dealt to matiko09 [3h Kd]
yuminyumin1: folds 
Westpants: folds 
ardo888: folds 
xrisall_2: calls $1
matiko09: folds 
Effort92: folds 
IdiotFromNE: folds 
AKplus: calls $0.50
di0d80: checks 
*** FLOP *** [Kc 3d 3c]
AKplus: checks 
di0d80: checks 
xrisall_2: checks 
*** TURN *** [Kc 3d 3c] [2d]
AKplus: checks 
di0d80: checks 
xrisall_2: checks 
*** RIVER *** [Kc 3d 3c 2d] [7d]
AKplus: checks 
di0d80: checks 
xrisall_2: checks 
*** SHOW DOWN ***
AKplus: shows [As 4s] (a pair of Threes)
di0d80: mucks hand 
xrisall_2: mucks hand 
AKplus collected $2.85 from pot
*** SUMMARY ***
Total pot $3 | Rake $0.15 
Board [Kc 3d 3c 2d 7d]
Seat 1: AKplus (small blind) showed [As 4s] and won ($2.85) with a pair of Threes
Seat 2: di0d80 (big blind) mucked [5s Ts]
Seat 3: yuminyumin1 folded before Flop (didn't bet)
Seat 4: Westpants folded before Flop (didn't bet)
Seat 5: ardo888 folded before Flop (didn't bet)
Seat 6: xrisall_2 mucked [9s Qs]
Seat 7: matiko09 folded before Flop (didn't bet)
Seat 8: Effort92 folded before Flop (didn't bet)
Seat 9: IdiotFromNE (button) folded before Flop (didn't bet)





PokerStars Hand #151166304785:  Hold'em No Limit ($1/$2 USD) - 2016/03/30 17:01:50 CET [2016/03/30 11:01:50 ET]
Table 'Jole' 9-max Seat #5 is the button
Seat 1: prominente ($278.74 in chips) 
Seat 2: InsomniaRU ($205.45 in chips) 
Seat 3: tipner ($210.53 in chips) 
Seat 4: GS_Sydney ($128.61 in chips) 
Seat 5: mentalpshyco ($200 in chips) 
Seat 6: King_ZéManel ($323.30 in chips) 
Seat 7: thecurv ($210.60 in chips) 
Seat 8: matiko09 ($320.50 in chips) 
Seat 9: RamiroAgujis ($256.76 in chips) 
King_ZéManel: posts small blind $1
thecurv: posts big blind $2
*** HOLE CARDS ***
Dealt to matiko09 [Qd Kc]
matiko09: raises $3 to $5
RamiroAgujis: folds 
prominente: folds 
InsomniaRU: folds 
tipner: folds 
GS_Sydney: folds 
mentalpshyco: folds 
King_ZéManel: folds 
thecurv: folds 
Uncalled bet ($3) returned to matiko09
matiko09 collected $5 from pot
matiko09: doesn't show hand 
*** SUMMARY ***
Total pot $5 | Rake $0 
Seat 1: prominente folded before Flop (didn't bet)
Seat 2: InsomniaRU folded before Flop (didn't bet)
Seat 3: tipner folded before Flop (didn't bet)
Seat 4: GS_Sydney folded before Flop (didn't bet)
Seat 5: mentalpshyco (button) folded before Flop (didn't bet)
Seat 6: King_ZéManel (small blind) folded before Flop
Seat 7: thecurv (big blind) folded before Flop
Seat 8: matiko09 collected ($5)
Seat 9: RamiroAgujis folded before Flop (didn't bet)





PokerStars Hand #151166305812:  Hold'em No Limit ($1/$2 USD) - 2016/03/30 17:01:52 CET [2016/03/30 11:01:52 ET]
Table 'Sadalbari' 9-max Seat #9 is the button
Seat 1: Igoriah ($200 in chips) 
Seat 2: Rycious ($98.60 in chips) 
Seat 3: thecurv ($200 in chips) 
Seat 4: matiko09 ($211.75 in chips) 
Seat 5: RamiroAgujis ($200 in chips) 
Seat 6: King_ZéManel ($233.25 in chips) 
Seat 7: prominente ($200 in chips) 
Seat 8: suddend3ath ($214.55 in chips) 
Seat 9: fonng ($93 in chips) 
Igoriah: posts small blind $1
Rycious: posts big blind $2
*** HOLE CARDS ***
Dealt to matiko09 [9h 9c]
thecurv: calls $2
matiko09: calls $2
RamiroAgujis: calls $2
King_ZéManel: folds 
prominente: folds 
suddend3ath: folds 
fonng: folds 
Igoriah: calls $1
Rycious: checks 
*** FLOP *** [5h Tc 9s]
Igoriah: checks 
Rycious: checks 
thecurv: checks 
matiko09: checks 
RamiroAgujis: checks 
*** TURN *** [5h Tc 9s] [7c]
Igoriah: checks 
Rycious: bets $4
thecurv: folds 
matiko09: raises $12 to $16
RamiroAgujis: calls $16
Igoriah: folds 
Rycious: folds 
*** RIVER *** [5h Tc 9s 7c] [As]
matiko09: bets $36
RamiroAgujis: folds 
Uncalled bet ($36) returned to matiko09
matiko09 collected $43.70 from pot
matiko09: doesn't show hand 
*** SUMMARY ***
Total pot $46 | Rake $2.30 
Board [5h Tc 9s 7c As]
Seat 1: Igoriah (small blind) folded on the Turn
Seat 2: Rycious (big blind) folded on the Turn
Seat 3: thecurv folded on the Turn
Seat 4: matiko09 collected ($43.70)
Seat 5: RamiroAgujis folded on the River
Seat 6: King_ZéManel folded before Flop (didn't bet)
Seat 7: prominente folded before Flop (didn't bet)
Seat 8: suddend3ath folded before Flop (didn't bet)
Seat 9: fonng (button) folded before Flop (didn't bet)





PokerStars Hand #151166306241:  Hold'em No Limit ($1/$2 USD) - 2016/03/30 17:01:53 CET [2016/03/30 11:01:53 ET]
Table 'Philoctetes II' 9-max Seat #5 is the button
Seat 1: vezunchik79 ($87.38 in chips) 
Seat 2: prominente ($209.91 in chips) 
Seat 3: mentalpshyco ($256.80 in chips) 
Seat 5: zhaimeng ($476.62 in chips) 
Seat 6: di0d80 ($201 in chips) 
Seat 7: matiko09 ($203 in chips) 
Seat 8: suddend3ath ($200 in chips) 
Seat 9: RamiroAgujis ($252.45 in chips) 
di0d80: posts small blind $1
matiko09: posts big blind $2
*** HOLE CARDS ***
Dealt to matiko09 [4d 2d]
suddend3ath: folds 
RamiroAgujis: folds 
vezunchik79: folds 
prominente: folds 
mentalpshyco: raises $3 to $5
zhaimeng: raises $3 to $8
di0d80: folds 
matiko09: folds 
mentalpshyco: raises $19 to $27
zhaimeng: calls $19
*** FLOP *** [Ts 8d 5s]
mentalpshyco: bets $36
zhaimeng: calls $36
*** TURN *** [Ts 8d 5s] [8h]
mentalpshyco: checks 
zhaimeng: checks 
*** RIVER *** [Ts 8d 5s 8h] [Ah]
mentalpshyco: bets $82
zhaimeng: calls $82
*** SHOW DOWN ***
mentalpshyco: shows [Ks Ac] (two pair, Aces and Eights)
zhaimeng: mucks hand 
mentalpshyco collected $290.25 from pot
*** SUMMARY ***
Total pot $293 | Rake $2.75 
Board [Ts 8d 5s 8h Ah]
Seat 1: vezunchik79 folded before Flop (didn't bet)
Seat 2: prominente folded before Flop (didn't bet)
Seat 3: mentalpshyco showed [Ks Ac] and won ($290.25) with two pair, Aces and Eights
Seat 5: zhaimeng (button) mucked [As Jd]
Seat 6: di0d80 (small blind) folded before Flop
Seat 7: matiko09 (big blind) folded before Flop
Seat 8: suddend3ath folded before Flop (didn't bet)
Seat 9: RamiroAgujis folded before Flop (didn't bet)





PokerStars Hand #151166319275:  Hold'em No Limit ($0.50/$1.00 USD) - 2016/03/30 17:02:11 CET [2016/03/30 11:02:11 ET]
Table 'Pannonia II' 9-max Seat #1 is the button
Seat 1: CI58 ($105.98 in chips) 
Seat 2: matiko09 ($100 in chips) 
Seat 3: MGL_Sky99 ($83.75 in chips) 
Seat 4: SumPosad ($69.75 in chips) 
Seat 5: Spid1 ($234.42 in chips) 
Seat 6: lumen21 ($103.89 in chips) 
Seat 7: Dachish ($70.24 in chips) 
Seat 8: stonymalony ($93.50 in chips) 
Seat 9: Effort92 ($100 in chips) 
matiko09: posts small blind $0.50
MGL_Sky99: posts big blind $1
*** HOLE CARDS ***
Dealt to matiko09 [9s 2c]
SumPosad: folds 
Spid1: folds 
lumen21: raises $2 to $3
Dachish: folds 
stonymalony: calls $3
Effort92: folds 
CI58: folds 
matiko09: folds 
MGL_Sky99: folds 
*** FLOP *** [Ts Qs Ad]
lumen21: checks 
stonymalony: checks 
*** TURN *** [Ts Qs Ad] [Qc]
lumen21: bets $5.69
stonymalony: calls $5.69
*** RIVER *** [Ts Qs Ad Qc] [9d]
lumen21: bets $13.50
stonymalony: folds 
Uncalled bet ($13.50) returned to lumen21
lumen21 collected $17.94 from pot
lumen21: doesn't show hand 
*** SUMMARY ***
Total pot $18.88 | Rake $0.94 
Board [Ts Qs Ad Qc 9d]
Seat 1: CI58 (button) folded before Flop (didn't bet)
Seat 2: matiko09 (small blind) folded before Flop
Seat 3: MGL_Sky99 (big blind) folded before Flop
Seat 4: SumPosad folded before Flop (didn't bet)
Seat 5: Spid1 folded before Flop (didn't bet)
Seat 6: lumen21 collected ($17.94)
Seat 7: Dachish folded before Flop (didn't bet)
Seat 8: stonymalony folded on the River
Seat 9: Effort92 folded before Flop (didn't bet)





PokerStars Hand #151166320800:  Hold'em No Limit ($0.50/$1.00 USD) - 2016/03/30 17:02:14 CET [2016/03/30 11:02:14 ET]
Table 'Alcor II' 9-max Seat #9 is the button
Seat 1: di0d80 ($115.65 in chips) 
Seat 2: holloway85 ($79.99 in chips) 
Seat 3: mitchymitch3 ($109.41 in chips) 
Seat 4: Effort92 ($200.50 in chips) 
Seat 5: elbiber2000 ($100 in chips) 
Seat 6: godfrey004 ($136.39 in chips) 
Seat 7: sanpidk ($110 in chips) 
Seat 8: RICKA16 ($286.06 in chips) 
Seat 9: matiko09 ($184.42 in chips) 
di0d80: posts small blind $0.50
holloway85: posts big blind $1
*** HOLE CARDS ***
Dealt to matiko09 [6s 9c]
mitchymitch3: folds 
Effort92: folds 
elbiber2000: folds 
godfrey004: raises $3 to $4
sanpidk: folds 
RICKA16: folds 
matiko09: folds 
di0d80: folds 
holloway85: folds 
Uncalled bet ($3) returned to godfrey004
godfrey004 collected $2.50 from pot
godfrey004: doesn't show hand 
*** SUMMARY ***
Total pot $2.50 | Rake $0 
Seat 1: di0d80 (small blind) folded before Flop
Seat 2: holloway85 (big blind) folded before Flop
Seat 3: mitchymitch3 folded before Flop (didn't bet)
Seat 4: Effort92 folded before Flop (didn't bet)
Seat 5: elbiber2000 folded before Flop (didn't bet)
Seat 6: godfrey004 collected ($2.50)
Seat 7: sanpidk folded before Flop (didn't bet)
Seat 8: RICKA16 folded before Flop (didn't bet)
Seat 9: matiko09 (button) folded before Flop (didn't bet)





PokerStars Hand #151166322664:  Hold'em No Limit ($0.50/$1.00 USD) - 2016/03/30 17:02:16 CET [2016/03/30 11:02:16 ET]
Table 'Figneria III' 9-max Seat #2 is the button
Seat 1: matiko09 ($109.85 in chips) 
Seat 2: sanpidk ($104.02 in chips) 
Seat 3: lumen21 ($111.68 in chips) 
Seat 4: CI58 ($216.84 in chips) 
Seat 5: b_____a__242 ($87.93 in chips) 
Seat 6: RICKA16 ($104.12 in chips) 
Seat 7: holloway85 ($240.98 in chips) 
Seat 9: p.snow89 ($61.96 in chips) 
lumen21: posts small blind $0.50
CI58: posts big blind $1
*** HOLE CARDS ***
Dealt to matiko09 [9h 3s]
b_____a__242: folds 
RICKA16: folds 
holloway85: folds 
p.snow89: folds 
matiko09: folds 
sanpidk: raises $1.24 to $2.24
lumen21: folds 
CI58: folds 
Uncalled bet ($1.24) returned to sanpidk
sanpidk collected $2.50 from pot
sanpidk: doesn't show hand 
*** SUMMARY ***
Total pot $2.50 | Rake $0 
Seat 1: matiko09 folded before Flop (didn't bet)
Seat 2: sanpidk (button) collected ($2.50)
Seat 3: lumen21 (small blind) folded before Flop
Seat 4: CI58 (big blind) folded before Flop
Seat 5: b_____a__242 folded before Flop (didn't bet)
Seat 6: RICKA16 folded before Flop (didn't bet)
Seat 7: holloway85 folded before Flop (didn't bet)
Seat 9: p.snow89 folded before Flop (didn't bet)





PokerStars Hand #151166322068:  Hold'em No Limit ($0.50/$1.00 USD) - 2016/03/30 17:02:16 CET [2016/03/30 11:02:16 ET]
Table 'Sirona II' 9-max Seat #3 is the button
Seat 1: funXmun ($112.64 in chips) 
Seat 3: claudioneamt ($22.34 in chips) 
Seat 4: RICKA16 ($99 in chips) 
Seat 5: bragutza ($271.99 in chips) 
Seat 6: lumen21 ($100 in chips) 
Seat 7: matiko09 ($162.51 in chips) 
Seat 8: sanpidk ($100 in chips) 
Seat 9: mycka86 ($228.60 in chips) 
RICKA16: posts small blind $0.50
bragutza: posts big blind $1
Spid1: sits out 
*** HOLE CARDS ***
Dealt to matiko09 [8h 7d]
lumen21: folds 
matiko09: folds 
sanpidk: folds 
mycka86: folds 
funXmun: folds 
claudioneamt: calls $1
RICKA16: raises $4 to $5
bragutza: folds 
claudioneamt: folds 
Uncalled bet ($4) returned to RICKA16
RICKA16 collected $3 from pot
RICKA16: doesn't show hand 
*** SUMMARY ***
Total pot $3 | Rake $0 
Seat 1: funXmun folded before Flop (didn't bet)
Seat 3: claudioneamt (button) folded before Flop
Seat 4: RICKA16 (small blind) collected ($3)
Seat 5: bragutza (big blind) folded before Flop
Seat 6: lumen21 folded before Flop (didn't bet)
Seat 7: matiko09 folded before Flop (didn't bet)
Seat 8: sanpidk folded before Flop (didn't bet)
Seat 9: mycka86 folded before Flop (didn't bet)





PokerStars Hand #151166327636:  Hold'em No Limit ($1/$2 USD) - 2016/03/30 17:02:23 CET [2016/03/30 11:02:23 ET]
Table 'Aesculapia II' 9-max Seat #5 is the button
Seat 1: T0ny Adams ($179.50 in chips) 
Seat 2: suddend3ath ($318.65 in chips) 
Seat 3: matiko09 ($654.28 in chips) 
Seat 5: prominente ($237.25 in chips) 
Seat 6: mentalpshyco ($201 in chips) 
Seat 7: Rumboni66 ($100.17 in chips) 
Seat 9: InsomniaRU ($200 in chips) 
mentalpshyco: posts small blind $1
Rumboni66: posts big blind $2
Igoriah: sits out 
*** HOLE CARDS ***
Dealt to matiko09 [8h 3s]
InsomniaRU: folds 
T0ny Adams: folds 
suddend3ath: raises $3 to $5
matiko09: folds 
prominente: calls $5
mentalpshyco: folds 
Rumboni66: calls $3
*** FLOP *** [Qd 8d 4h]
Rumboni66: checks 
suddend3ath: checks 
prominente: checks 
*** TURN *** [Qd 8d 4h] [6s]
Rumboni66: checks 
suddend3ath: checks 
prominente: bets $11.25
Rumboni66: folds 
suddend3ath: folds 
Uncalled bet ($11.25) returned to prominente
prominente collected $15.20 from pot
prominente: doesn't show hand 
*** SUMMARY ***
Total pot $16 | Rake $0.80 
Board [Qd 8d 4h 6s]
Seat 1: T0ny Adams folded before Flop (didn't bet)
Seat 2: suddend3ath folded on the Turn
Seat 3: matiko09 folded before Flop (didn't bet)
Seat 5: prominente (button) collected ($15.20)
Seat 6: mentalpshyco (small blind) folded before Flop
Seat 7: Rumboni66 (big blind) folded on the Turn
Seat 9: InsomniaRU folded before Flop (didn't bet)





PokerStars Hand #151166328006:  Hold'em No Limit ($1/$2 USD) - 2016/03/30 17:02:24 CET [2016/03/30 11:02:24 ET]
Table 'Jole' 9-max Seat #6 is the button
Seat 1: prominente ($278.74 in chips) 
Seat 2: InsomniaRU ($205.45 in chips) 
Seat 3: tipner ($210.53 in chips) 
Seat 4: GS_Sydney ($128.61 in chips) 
Seat 5: mentalpshyco ($200 in chips) 
Seat 6: King_ZéManel ($322.30 in chips) 
Seat 7: thecurv ($208.60 in chips) 
Seat 8: matiko09 ($323.50 in chips) 
Seat 9: RamiroAgujis ($256.76 in chips) 
thecurv: posts small blind $1
matiko09: posts big blind $2
*** HOLE CARDS ***
Dealt to matiko09 [3d 9c]
RamiroAgujis: folds 
prominente: folds 
InsomniaRU: folds 
tipner: folds 
GS_Sydney: folds 
mentalpshyco: folds 
King_ZéManel: folds 
thecurv: raises $2.10 to $4.10
matiko09: folds 
Uncalled bet ($2.10) returned to thecurv
thecurv collected $4 from pot
thecurv: doesn't show hand 
*** SUMMARY ***
Total pot $4 | Rake $0 
Seat 1: prominente folded before Flop (didn't bet)
Seat 2: InsomniaRU folded before Flop (didn't bet)
Seat 3: tipner folded before Flop (didn't bet)
Seat 4: GS_Sydney folded before Flop (didn't bet)
Seat 5: mentalpshyco folded before Flop (didn't bet)
Seat 6: King_ZéManel (button) folded before Flop (didn't bet)
Seat 7: thecurv (small blind) collected ($4)
Seat 8: matiko09 (big blind) folded before Flop
Seat 9: RamiroAgujis folded before Flop (didn't bet)





PokerStars Hand #151166332939:  Hold'em No Limit ($0.50/$1.00 USD) - 2016/03/30 17:02:31 CET [2016/03/30 11:02:31 ET]
Table 'Sumiana III' 9-max Seat #7 is the button
Seat 2: Sloeve ($119.65 in chips) 
Seat 3: IdiotFromNE ($100 in chips) 
Seat 4: Pingili ($43.97 in chips) 
Seat 6: sanpidk ($161.54 in chips) 
Seat 7: matiko09 ($139.35 in chips) 
Seat 8: Effort92 ($100 in chips) 
Effort92: posts small blind $0.50
lumen21: is sitting out 
Mukhin1: is sitting out 
Sloeve: posts big blind $1
*** HOLE CARDS ***
Dealt to matiko09 [Th Kh]
lumen21 leaves the table
Filojoes joins the table at seat #9 
IdiotFromNE: folds 
Mukhin1 leaves the table
Pingili: calls $1
sanpidk: folds 
matiko09: raises $3 to $4
Effort92: folds 
khalsanhaji leaves the table
Sloeve: folds 
Pingili: calls $3
*** FLOP *** [Td Ks Qh]
Pingili: checks 
matiko09: bets $5.86
Pingili: calls $5.86
*** TURN *** [Td Ks Qh] [3d]
Pingili: checks 
chelseanin joins the table at seat #1 
matiko09: bets $14
Pingili: calls $14
*** RIVER *** [Td Ks Qh 3d] [4c]
ardo888 joins the table at seat #5 
Pingili: bets $20.11 and is all-in
matiko09: calls $20.11
*** SHOW DOWN ***
Pingili: shows [Ac Qc] (a pair of Queens)
matiko09: shows [Th Kh] (two pair, Kings and Tens)
matiko09 collected $86.94 from pot
*** SUMMARY ***
Total pot $89.44 | Rake $2.50 
Board [Td Ks Qh 3d 4c]
Seat 2: Sloeve (big blind) folded before Flop
Seat 3: IdiotFromNE folded before Flop (didn't bet)
Seat 4: Pingili showed [Ac Qc] and lost with a pair of Queens
Seat 6: sanpidk folded before Flop (didn't bet)
Seat 7: matiko09 (button) showed [Th Kh] and won ($86.94) with two pair, Kings and Tens
Seat 8: Effort92 (small blind) folded before Flop





PokerStars Hand #151166343403:  Hold'em No Limit ($0.50/$1.00 USD) - 2016/03/30 17:02:47 CET [2016/03/30 11:02:47 ET]
Table 'Alcor II' 9-max Seat #1 is the button
Seat 1: di0d80 ($115.15 in chips) 
Seat 2: holloway85 ($78.99 in chips) 
Seat 3: mitchymitch3 ($109.41 in chips) 
Seat 4: Effort92 ($200.50 in chips) 
Seat 5: elbiber2000 ($100 in chips) 
Seat 6: godfrey004 ($137.89 in chips) 
Seat 7: sanpidk ($110 in chips) 
Seat 8: RICKA16 ($286.06 in chips) 
Seat 9: matiko09 ($184.42 in chips) 
holloway85: posts small blind $0.50
mitchymitch3: posts big blind $1
*** HOLE CARDS ***
Dealt to matiko09 [7d Ah]
Effort92: folds 
elbiber2000: folds 
godfrey004: raises $3 to $4
sanpidk: folds 
RICKA16: folds 
matiko09: folds 
di0d80: folds 
holloway85: folds 
mitchymitch3: folds 
Uncalled bet ($3) returned to godfrey004
godfrey004 collected $2.50 from pot
godfrey004: doesn't show hand 
*** SUMMARY ***
Total pot $2.50 | Rake $0 
Seat 1: di0d80 (button) folded before Flop (didn't bet)
Seat 2: holloway85 (small blind) folded before Flop
Seat 3: mitchymitch3 (big blind) folded before Flop
Seat 4: Effort92 folded before Flop (didn't bet)
Seat 5: elbiber2000 folded before Flop (didn't bet)
Seat 6: godfrey004 collected ($2.50)
Seat 7: sanpidk folded before Flop (didn't bet)
Seat 8: RICKA16 folded before Flop (didn't bet)
Seat 9: matiko09 folded before Flop (didn't bet)





PokerStars Hand #151166349912:  Hold'em No Limit ($0.50/$1.00 USD) - 2016/03/30 17:02:56 CET [2016/03/30 11:02:56 ET]
Table 'Sirona II' 9-max Seat #4 is the button
Seat 1: funXmun ($112.64 in chips) 
Seat 3: claudioneamt ($21.34 in chips) 
Seat 4: RICKA16 ($101 in chips) 
Seat 5: bragutza ($270.99 in chips) 
Seat 6: lumen21 ($100 in chips) 
Seat 7: matiko09 ($162.51 in chips) 
Seat 8: sanpidk ($100 in chips) 
Seat 9: mycka86 ($228.60 in chips) 
bragutza: posts small blind $0.50
lumen21: posts big blind $1
Spid1: sits out 
*** HOLE CARDS ***
Dealt to matiko09 [2c 3c]
matiko09: folds 
sanpidk: folds 
mycka86: folds 
funXmun: raises $2 to $3
claudioneamt: folds 
RICKA16: folds 
bragutza: calls $2.50
lumen21: folds 
*** FLOP *** [Th Kh As]
bragutza: checks 
funXmun: checks 
*** TURN *** [Th Kh As] [6h]
bragutza: checks 
funXmun: checks 
*** RIVER *** [Th Kh As 6h] [Jh]
bragutza: checks 
funXmun: checks 
*** SHOW DOWN ***
bragutza: shows [5h 9h] (a flush, King high)
funXmun: mucks hand 
bragutza collected $6.65 from pot
*** SUMMARY ***
Total pot $7 | Rake $0.35 
Board [Th Kh As 6h Jh]
Seat 1: funXmun mucked [Kc Qs]
Seat 3: claudioneamt folded before Flop (didn't bet)
Seat 4: RICKA16 (button) folded before Flop (didn't bet)
Seat 5: bragutza (small blind) showed [5h 9h] and won ($6.65) with a flush, King high
Seat 6: lumen21 (big blind) folded before Flop
Seat 7: matiko09 folded before Flop (didn't bet)
Seat 8: sanpidk folded before Flop (didn't bet)
Seat 9: mycka86 folded before Flop (didn't bet)





PokerStars Hand #151166350915:  Hold'em No Limit ($1/$2 USD) - 2016/03/30 17:02:57 CET [2016/03/30 11:02:57 ET]
Table 'Jole' 9-max Seat #7 is the button
Seat 1: prominente ($278.74 in chips) 
Seat 2: InsomniaRU ($205.45 in chips) 
Seat 3: tipner ($210.53 in chips) 
Seat 4: GS_Sydney ($128.61 in chips) 
Seat 5: mentalpshyco ($200 in chips) 
Seat 6: King_ZéManel ($322.30 in chips) 
Seat 7: thecurv ($210.60 in chips) 
Seat 8: matiko09 ($321.50 in chips) 
Seat 9: RamiroAgujis ($256.76 in chips) 
matiko09: posts small blind $1
RamiroAgujis: posts big blind $2
*** HOLE CARDS ***
Dealt to matiko09 [7h 4s]
prominente: folds 
InsomniaRU: folds 
tipner: folds 
GS_Sydney: folds 
mentalpshyco: raises $3 to $5
King_ZéManel: folds 
thecurv: folds 
matiko09: folds 
RamiroAgujis: calls $3
*** FLOP *** [5d Kh 5c]
RamiroAgujis: checks 
mentalpshyco: bets $7
RamiroAgujis: calls $7
*** TURN *** [5d Kh 5c] [6h]
RamiroAgujis: checks 
mentalpshyco: bets $16
RamiroAgujis: folds 
Uncalled bet ($16) returned to mentalpshyco
mentalpshyco collected $23.75 from pot
mentalpshyco: doesn't show hand 
*** SUMMARY ***
Total pot $25 | Rake $1.25 
Board [5d Kh 5c 6h]
Seat 1: prominente folded before Flop (didn't bet)
Seat 2: InsomniaRU folded before Flop (didn't bet)
Seat 3: tipner folded before Flop (didn't bet)
Seat 4: GS_Sydney folded before Flop (didn't bet)
Seat 5: mentalpshyco collected ($23.75)
Seat 6: King_ZéManel folded before Flop (didn't bet)
Seat 7: thecurv (button) folded before Flop (didn't bet)
Seat 8: matiko09 (small blind) folded before Flop
Seat 9: RamiroAgujis (big blind) folded on the Turn





PokerStars Hand #151166350998:  Hold'em No Limit ($1/$2 USD) - 2016/03/30 17:02:58 CET [2016/03/30 11:02:58 ET]
Table 'Tabit III' 9-max Seat #5 is the button
Seat 1: di0d80 ($236.97 in chips) 
Seat 2: matiko09 ($226.54 in chips) 
Seat 3: prominente ($200 in chips) 
Seat 4: Dykallis ($498.53 in chips) 
Seat 5: itaik1 ($94.24 in chips) 
Seat 6: Igoriah ($200 in chips) 
Seat 7: jannis1951 ($182.58 in chips) 
Seat 8: mentalpshyco ($213.05 in chips) 
Seat 9: suddend3ath ($200 in chips) 
Igoriah: posts small blind $1
jannis1951: posts big blind $2
*** HOLE CARDS ***
Dealt to matiko09 [9h Kc]
mentalpshyco: folds 
suddend3ath: folds 
di0d80: folds 
matiko09: folds 
prominente: folds 
Dykallis: folds 
itaik1: raises $4 to $6
Igoriah: folds 
jannis1951: calls $4
*** FLOP *** [2s Ad 8h]
jannis1951: checks 
itaik1: checks 
*** TURN *** [2s Ad 8h] [4c]
jannis1951: bets $6.17
itaik1: folds 
Uncalled bet ($6.17) returned to jannis1951
jannis1951 collected $12.35 from pot
*** SUMMARY ***
Total pot $13 | Rake $0.65 
Board [2s Ad 8h 4c]
Seat 1: di0d80 folded before Flop (didn't bet)
Seat 2: matiko09 folded before Flop (didn't bet)
Seat 3: prominente folded before Flop (didn't bet)
Seat 4: Dykallis folded before Flop (didn't bet)
Seat 5: itaik1 (button) folded on the Turn
Seat 6: Igoriah (small blind) folded before Flop
Seat 7: jannis1951 (big blind) collected ($12.35)
Seat 8: mentalpshyco folded before Flop (didn't bet)
Seat 9: suddend3ath folded before Flop (didn't bet)





PokerStars Hand #151166354419:  Hold'em No Limit ($0.50/$1.00 USD) - 2016/03/30 17:03:02 CET [2016/03/30 11:03:02 ET]
Table 'Hadwiger' 9-max Seat #1 is the button
Seat 1: AKplus ($87.73 in chips) 
Seat 2: di0d80 ($100.50 in chips) 
Seat 3: yuminyumin1 ($102.72 in chips) 
Seat 4: Westpants ($100 in chips) 
Seat 5: ardo888 ($103.50 in chips) 
Seat 6: xrisall_2 ($157.78 in chips) 
Seat 7: matiko09 ($110.61 in chips) 
Seat 8: Effort92 ($100 in chips) 
Seat 9: IdiotFromNE ($105.67 in chips) 
di0d80: posts small blind $0.50
yuminyumin1: posts big blind $1
*** HOLE CARDS ***
Dealt to matiko09 [3h 3d]
Westpants: folds 
ardo888: folds 
xrisall_2: folds 
matiko09: raises $2 to $3
Effort92: folds 
IdiotFromNE: folds 
AKplus: calls $3
di0d80: folds 
yuminyumin1: calls $2
*** FLOP *** [4d 5c Js]
yuminyumin1: checks 
matiko09: checks 
AKplus: bets $6
yuminyumin1: calls $6
matiko09: folds 
*** TURN *** [4d 5c Js] [Qs]
yuminyumin1: checks 
AKplus: checks 
*** RIVER *** [4d 5c Js Qs] [4h]
yuminyumin1: bets $15
AKplus: folds 
Uncalled bet ($15) returned to yuminyumin1
yuminyumin1 collected $20.42 from pot
yuminyumin1: doesn't show hand 
*** SUMMARY ***
Total pot $21.50 | Rake $1.08 
Board [4d 5c Js Qs 4h]
Seat 1: AKplus (button) folded on the River
Seat 2: di0d80 (small blind) folded before Flop
Seat 3: yuminyumin1 (big blind) collected ($20.42)
Seat 4: Westpants folded before Flop (didn't bet)
Seat 5: ardo888 folded before Flop (didn't bet)
Seat 6: xrisall_2 folded before Flop (didn't bet)
Seat 7: matiko09 folded on the Flop
Seat 8: Effort92 folded before Flop (didn't bet)
Seat 9: IdiotFromNE folded before Flop (didn't bet)





PokerStars Hand #151166357261:  Hold'em No Limit ($0.50/$1.00 USD) - 2016/03/30 17:03:07 CET [2016/03/30 11:03:07 ET]
Table 'Figneria III' 9-max Seat #3 is the button
Seat 1: matiko09 ($109.85 in chips) 
Seat 2: sanpidk ($105.52 in chips) 
Seat 3: lumen21 ($111.18 in chips) 
Seat 4: CI58 ($215.84 in chips) 
Seat 5: b_____a__242 ($87.93 in chips) 
Seat 6: RICKA16 ($104.12 in chips) 
Seat 7: holloway85 ($240.98 in chips) 
Seat 9: p.snow89 ($61.96 in chips) 
CI58: posts small blind $0.50
b_____a__242: posts big blind $1
*** HOLE CARDS ***
Dealt to matiko09 [Ts 4s]
RICKA16: folds 
holloway85: folds 
p.snow89: raises $2 to $3
matiko09: folds 
sanpidk: folds 
lumen21: folds 
CI58: folds 
b_____a__242: calls $2
*** FLOP *** [Tc Jh 4d]
b_____a__242: checks 
p.snow89: checks 
*** TURN *** [Tc Jh 4d] [Th]
b_____a__242: checks 
p.snow89: checks 
*** RIVER *** [Tc Jh 4d Th] [9c]
b_____a__242: checks 
p.snow89: checks 
*** SHOW DOWN ***
b_____a__242: shows [Qd Td] (three of a kind, Tens)
p.snow89: mucks hand 
b_____a__242 collected $6.18 from pot
*** SUMMARY ***
Total pot $6.50 | Rake $0.32 
Board [Tc Jh 4d Th 9c]
Seat 1: matiko09 folded before Flop (didn't bet)
Seat 2: sanpidk folded before Flop (didn't bet)
Seat 3: lumen21 (button) folded before Flop (didn't bet)
Seat 4: CI58 (small blind) folded before Flop
Seat 5: b_____a__242 (big blind) showed [Qd Td] and won ($6.18) with three of a kind, Tens
Seat 6: RICKA16 folded before Flop (didn't bet)
Seat 7: holloway85 folded before Flop (didn't bet)
Seat 9: p.snow89 mucked [5c Ac]





PokerStars Hand #151166360217:  Hold'em No Limit ($0.50/$1.00 USD) - 2016/03/30 17:03:11 CET [2016/03/30 11:03:11 ET]
Table 'Pannonia II' 9-max Seat #2 is the button
Seat 1: CI58 ($105.98 in chips) 
Seat 2: matiko09 ($100 in chips) 
Seat 3: MGL_Sky99 ($82.75 in chips) 
Seat 5: Spid1 ($234.42 in chips) 
Seat 6: lumen21 ($113.14 in chips) 
Seat 7: Dachish ($70.24 in chips) 
Seat 8: stonymalony ($84.81 in chips) 
Seat 9: Effort92 ($100 in chips) 
MGL_Sky99: posts small blind $0.50
SumPosad: is sitting out 
Spid1: posts big blind $1
*** HOLE CARDS ***
Dealt to matiko09 [7c 8h]
lumen21: folds 
Dachish: folds 
stonymalony: folds 
SumPosad leaves the table
stonymalony leaves the table
mycka86 joins the table at seat #4 
Effort92: raises $1.50 to $2.50
CI58: calls $2.50
matiko09: folds 
MGL_Sky99: calls $2
Spid1: folds 
*** FLOP *** [Kd 6d Ks]
MGL_Sky99: checks 
Effort92: bets $5
di0d80 joins the table at seat #8 
di0d80 leaves the table
CI58: calls $5
MGL_Sky99: folds 
*** TURN *** [Kd 6d Ks] [5d]
Effort92: checks 
sanpidk joins the table at seat #8 
CI58: bets $11
Effort92: calls $11
*** RIVER *** [Kd 6d Ks 5d] [As]
Effort92: checks 
CI58: checks 
*** SHOW DOWN ***
Effort92: shows [Qh Qc] (two pair, Kings and Queens)
CI58: shows [8d Td] (a flush, King high)
CI58 collected $38.48 from pot
*** SUMMARY ***
Total pot $40.50 | Rake $2.02 
Board [Kd 6d Ks 5d As]
Seat 1: CI58 showed [8d Td] and won ($38.48) with a flush, King high
Seat 2: matiko09 (button) folded before Flop (didn't bet)
Seat 3: MGL_Sky99 (small blind) folded on the Flop
Seat 5: Spid1 (big blind) folded before Flop
Seat 6: lumen21 folded before Flop (didn't bet)
Seat 7: Dachish folded before Flop (didn't bet)
Seat 8: stonymalony folded before Flop (didn't bet)
Seat 9: Effort92 showed [Qh Qc] and lost with two pair, Kings and Queens





PokerStars Hand #151166370895:  Hold'em No Limit ($0.50/$1.00 USD) - 2016/03/30 17:03:26 CET [2016/03/30 11:03:26 ET]
Table 'Alcor II' 9-max Seat #2 is the button
Seat 1: di0d80 ($115.15 in chips) 
Seat 2: holloway85 ($78.49 in chips) 
Seat 3: mitchymitch3 ($108.41 in chips) 
Seat 4: Effort92 ($200.50 in chips) 
Seat 5: elbiber2000 ($100 in chips) 
Seat 6: godfrey004 ($139.39 in chips) 
Seat 7: sanpidk ($110 in chips) 
Seat 8: RICKA16 ($286.06 in chips) 
Seat 9: matiko09 ($184.42 in chips) 
mitchymitch3: posts small blind $0.50
Effort92: posts big blind $1
*** HOLE CARDS ***
Dealt to matiko09 [Jd Ac]
elbiber2000: raises $2 to $3
godfrey004: folds 
sanpidk: folds 
RICKA16: folds 
matiko09: folds 
di0d80: folds 
holloway85: calls $3
mitchymitch3: folds 
Effort92: folds 
*** FLOP *** [Kh 2h 2c]
elbiber2000: checks 
holloway85: bets $3.56
elbiber2000: calls $3.56
*** TURN *** [Kh 2h 2c] [Qc]
elbiber2000: checks 
holloway85: checks 
*** RIVER *** [Kh 2h 2c Qc] [8h]
elbiber2000: checks 
holloway85: bets $6.94
elbiber2000: calls $6.94
*** SHOW DOWN ***
holloway85: shows [Ad 6d] (a pair of Deuces)
elbiber2000: shows [9c 9s] (two pair, Nines and Deuces)
elbiber2000 collected $27.08 from pot
*** SUMMARY ***
Total pot $28.50 | Rake $1.42 
Board [Kh 2h 2c Qc 8h]
Seat 1: di0d80 folded before Flop (didn't bet)
Seat 2: holloway85 (button) showed [Ad 6d] and lost with a pair of Deuces
Seat 3: mitchymitch3 (small blind) folded before Flop
Seat 4: Effort92 (big blind) folded before Flop
Seat 5: elbiber2000 showed [9c 9s] and won ($27.08) with two pair, Nines and Deuces
Seat 6: godfrey004 folded before Flop (didn't bet)
Seat 7: sanpidk folded before Flop (didn't bet)
Seat 8: RICKA16 folded before Flop (didn't bet)
Seat 9: matiko09 folded before Flop (didn't bet)





PokerStars Hand #151166373326:  Hold'em No Limit ($1/$2 USD) - 2016/03/30 17:03:29 CET [2016/03/30 11:03:29 ET]
Table 'Philoctetes II' 9-max Seat #6 is the button
Seat 1: vezunchik79 ($87.38 in chips) 
Seat 2: prominente ($209.91 in chips) 
Seat 3: mentalpshyco ($402.05 in chips) 
Seat 5: zhaimeng ($331.62 in chips) 
Seat 6: di0d80 ($200 in chips) 
Seat 7: matiko09 ($201 in chips) 
Seat 8: suddend3ath ($200 in chips) 
Seat 9: RamiroAgujis ($252.45 in chips) 
matiko09: posts small blind $1
suddend3ath: posts big blind $2
*** HOLE CARDS ***
Dealt to matiko09 [7h 2s]
RamiroAgujis: raises $5 to $7
vezunchik79: folds 
prominente: folds 
mentalpshyco: folds 
zhaimeng: folds 
di0d80: folds 
matiko09: folds 
suddend3ath: folds 
Uncalled bet ($5) returned to RamiroAgujis
RamiroAgujis collected $5 from pot
RamiroAgujis: doesn't show hand 
*** SUMMARY ***
Total pot $5 | Rake $0 
Seat 1: vezunchik79 folded before Flop (didn't bet)
Seat 2: prominente folded before Flop (didn't bet)
Seat 3: mentalpshyco folded before Flop (didn't bet)
Seat 5: zhaimeng folded before Flop (didn't bet)
Seat 6: di0d80 (button) folded before Flop (didn't bet)
Seat 7: matiko09 (small blind) folded before Flop
Seat 8: suddend3ath (big blind) folded before Flop
Seat 9: RamiroAgujis collected ($5)





PokerStars Hand #151166373102:  Hold'em No Limit ($0.50/$1.00 USD) - 2016/03/30 17:03:29 CET [2016/03/30 11:03:29 ET]
Table 'Sumiana III' 9-max Seat #8 is the button
Seat 2: Sloeve ($118.65 in chips) 
Seat 3: IdiotFromNE ($100 in chips) 
Seat 6: sanpidk ($161.54 in chips) 
Seat 7: matiko09 ($182.32 in chips) 
Seat 8: Effort92 ($100 in chips) 
Filojoes will be allowed to play after the button
chelseanin will be allowed to play after the button
Sloeve: posts small blind $0.50
IdiotFromNE: posts big blind $1
ardo888: sits out 
*** HOLE CARDS ***
Dealt to matiko09 [Jc Ac]
sanpidk: folds 
matiko09: raises $1.50 to $2.50
Effort92: raises $5 to $7.50
Sloeve: folds 
IdiotFromNE: folds 
matiko09: calls $5
*** FLOP *** [Kd Ad Kc]
matiko09: checks 
Effort92: bets $8
matiko09: calls $8
*** TURN *** [Kd Ad Kc] [9s]
matiko09: checks 
Effort92: bets $14
matiko09: folds 
Uncalled bet ($14) returned to Effort92
Effort92 collected $30.88 from pot
Effort92: doesn't show hand 
*** SUMMARY ***
Total pot $32.50 | Rake $1.62 
Board [Kd Ad Kc 9s]
Seat 2: Sloeve (small blind) folded before Flop
Seat 3: IdiotFromNE (big blind) folded before Flop
Seat 6: sanpidk folded before Flop (didn't bet)
Seat 7: matiko09 folded on the Turn
Seat 8: Effort92 (button) collected ($30.88)





PokerStars Hand #151166381267:  Hold'em No Limit (€0.50/€1.00 EUR) - 2016/03/30 17:03:41 CET [2016/03/30 11:03:41 ET]
Table 'Patricia' 9-max Seat #8 is the button
Seat 1: matiko09 (€100 in chips) 
Seat 5: otterlake00 (€54.67 in chips) 
Seat 6: King_ZéManel (€100 in chips) 
Seat 7: Spid1 (€100 in chips) 
Seat 8: Painkiller72 (€100 in chips) 
Seat 9: tipner (€100 in chips) 
tipner: posts small blind €0.50
matiko09: posts big blind €1
ardo888: sits out 
Dachish: sits out 
*** HOLE CARDS ***
Dealt to matiko09 [7s 7h]
otterlake00: calls €1
King_ZéManel: folds 
Spid1: folds 
Painkiller72: folds 
tipner: raises €3 to €4
matiko09: calls €3
otterlake00: calls €3
*** FLOP *** [Qh Ad 4d]
tipner: bets €6
matiko09: folds 
otterlake00: folds 
Uncalled bet (€6) returned to tipner
tipner collected €11.40 from pot
tipner: doesn't show hand 
*** SUMMARY ***
Total pot €12 | Rake €0.60 
Board [Qh Ad 4d]
Seat 1: matiko09 (big blind) folded on the Flop
Seat 5: otterlake00 folded on the Flop
Seat 6: King_ZéManel folded before Flop (didn't bet)
Seat 7: Spid1 folded before Flop (didn't bet)
Seat 8: Painkiller72 (button) folded before Flop (didn't bet)
Seat 9: tipner (small blind) collected (€11.40)





PokerStars Hand #151166397172:  Hold'em No Limit ($1/$2 USD) - 2016/03/30 17:04:04 CET [2016/03/30 11:04:04 ET]
Table 'Tabit III' 9-max Seat #6 is the button
Seat 1: di0d80 ($236.97 in chips) 
Seat 2: matiko09 ($226.54 in chips) 
Seat 3: prominente ($200 in chips) 
Seat 4: Dykallis ($498.53 in chips) 
Seat 5: itaik1 ($88.24 in chips) 
Seat 6: Igoriah ($200 in chips) 
Seat 7: jannis1951 ($188.93 in chips) 
Seat 8: mentalpshyco ($213.05 in chips) 
Seat 9: suddend3ath ($200 in chips) 
jannis1951: posts small blind $1
mentalpshyco: posts big blind $2
*** HOLE CARDS ***
Dealt to matiko09 [4h 8d]
suddend3ath: folds 
di0d80: folds 
matiko09: folds 
prominente: folds 
Dykallis: folds 
itaik1: folds 
Igoriah: folds 
jannis1951: raises $4 to $6
mentalpshyco: folds 
Uncalled bet ($4) returned to jannis1951
jannis1951 collected $4 from pot
*** SUMMARY ***
Total pot $4 | Rake $0 
Seat 1: di0d80 folded before Flop (didn't bet)
Seat 2: matiko09 folded before Flop (didn't bet)
Seat 3: prominente folded before Flop (didn't bet)
Seat 4: Dykallis folded before Flop (didn't bet)
Seat 5: itaik1 folded before Flop (didn't bet)
Seat 6: Igoriah (button) folded before Flop (didn't bet)
Seat 7: jannis1951 (small blind) collected ($4)
Seat 8: mentalpshyco (big blind) folded before Flop
Seat 9: suddend3ath folded before Flop (didn't bet)





PokerStars Hand #151166399715:  Hold'em No Limit ($1/$2 USD) - 2016/03/30 17:04:07 CET [2016/03/30 11:04:07 ET]
Table 'Philoctetes II' 9-max Seat #7 is the button
Seat 1: vezunchik79 ($87.38 in chips) 
Seat 2: prominente ($209.91 in chips) 
Seat 3: mentalpshyco ($402.05 in chips) 
Seat 5: zhaimeng ($331.62 in chips) 
Seat 6: di0d80 ($200 in chips) 
Seat 7: matiko09 ($200 in chips) 
Seat 8: suddend3ath ($200 in chips) 
Seat 9: RamiroAgujis ($255.45 in chips) 
suddend3ath: posts small blind $1
RamiroAgujis: posts big blind $2
*** HOLE CARDS ***
Dealt to matiko09 [6c 7s]
vezunchik79: raises $2 to $4
prominente: folds 
mentalpshyco: folds 
zhaimeng: calls $4
di0d80: folds 
matiko09 has timed out
matiko09: folds 
suddend3ath: raises $17 to $21
RamiroAgujis: folds 
vezunchik79: folds 
zhaimeng: calls $17
*** FLOP *** [As 2c 5s]
suddend3ath: bets $28
zhaimeng: folds 
Uncalled bet ($28) returned to suddend3ath
suddend3ath collected $45.60 from pot
suddend3ath: doesn't show hand 
*** SUMMARY ***
Total pot $48 | Rake $2.40 
Board [As 2c 5s]
Seat 1: vezunchik79 folded before Flop
Seat 2: prominente folded before Flop (didn't bet)
Seat 3: mentalpshyco folded before Flop (didn't bet)
Seat 5: zhaimeng folded on the Flop
Seat 6: di0d80 folded before Flop (didn't bet)
Seat 7: matiko09 (button) folded before Flop (didn't bet)
Seat 8: suddend3ath (small blind) collected ($45.60)
Seat 9: RamiroAgujis (big blind) folded before Flop





PokerStars Hand #151166403560:  Hold'em No Limit ($0.50/$1.00 USD) - 2016/03/30 17:04:13 CET [2016/03/30 11:04:13 ET]
Table 'Sirona II' 9-max Seat #5 is the button
Seat 1: funXmun ($109.64 in chips) 
Seat 3: claudioneamt ($21.34 in chips) 
Seat 4: RICKA16 ($101 in chips) 
Seat 5: bragutza ($274.64 in chips) 
Seat 6: lumen21 ($100 in chips) 
Seat 7: matiko09 ($162.51 in chips) 
Seat 8: sanpidk ($100 in chips) 
Seat 9: mycka86 ($228.60 in chips) 
lumen21: posts small blind $0.50
matiko09: posts big blind $1
Spid1: sits out 
*** HOLE CARDS ***
Dealt to matiko09 [Ah 2s]
sanpidk: folds 
mycka86: folds 
funXmun: folds 
claudioneamt: calls $1
RICKA16: raises $3 to $4
bragutza: calls $4
lumen21: folds 
matiko09: folds 
claudioneamt: calls $3
*** FLOP *** [4c 6c 8d]
claudioneamt: checks 
RICKA16: bets $8
bragutza: folds 
claudioneamt: folds 
Uncalled bet ($8) returned to RICKA16
RICKA16 collected $12.82 from pot
RICKA16: doesn't show hand 
*** SUMMARY ***
Total pot $13.50 | Rake $0.68 
Board [4c 6c 8d]
Seat 1: funXmun folded before Flop (didn't bet)
Seat 3: claudioneamt folded on the Flop
Seat 4: RICKA16 collected ($12.82)
Seat 5: bragutza (button) folded on the Flop
Seat 6: lumen21 (small blind) folded before Flop
Seat 7: matiko09 (big blind) folded before Flop
Seat 8: sanpidk folded before Flop (didn't bet)
Seat 9: mycka86 folded before Flop (didn't bet)





PokerStars Hand #151166404801:  Hold'em No Limit ($1/$2 USD) - 2016/03/30 17:04:15 CET [2016/03/30 11:04:15 ET]
Table 'Jole' 9-max Seat #8 is the button
Seat 1: prominente ($278.74 in chips) 
Seat 2: InsomniaRU ($205.45 in chips) 
Seat 3: tipner ($210.53 in chips) 
Seat 4: GS_Sydney ($128.61 in chips) 
Seat 5: mentalpshyco ($211.75 in chips) 
Seat 6: King_ZéManel ($322.30 in chips) 
Seat 7: thecurv ($210.60 in chips) 
Seat 8: matiko09 ($320.50 in chips) 
Seat 9: RamiroAgujis ($244.76 in chips) 
RamiroAgujis: posts small blind $1
prominente: posts big blind $2
*** HOLE CARDS ***
Dealt to matiko09 [5h Kd]
InsomniaRU: raises $3 to $5
tipner: folds 
GS_Sydney: folds 
mentalpshyco: folds 
King_ZéManel: folds 
thecurv: folds 
matiko09: folds 
RamiroAgujis: folds 
prominente: folds 
Uncalled bet ($3) returned to InsomniaRU
InsomniaRU collected $5 from pot
InsomniaRU: doesn't show hand 
*** SUMMARY ***
Total pot $5 | Rake $0 
Seat 1: prominente (big blind) folded before Flop
Seat 2: InsomniaRU collected ($5)
Seat 3: tipner folded before Flop (didn't bet)
Seat 4: GS_Sydney folded before Flop (didn't bet)
Seat 5: mentalpshyco folded before Flop (didn't bet)
Seat 6: King_ZéManel folded before Flop (didn't bet)
Seat 7: thecurv folded before Flop (didn't bet)
Seat 8: matiko09 (button) folded before Flop (didn't bet)
Seat 9: RamiroAgujis (small blind) folded before Flop





PokerStars Hand #151166416002:  Hold'em No Limit ($0.50/$1.00 USD) - 2016/03/30 17:04:31 CET [2016/03/30 11:04:31 ET]
Table 'Figneria III' 9-max Seat #4 is the button
Seat 1: matiko09 ($109.85 in chips) 
Seat 2: sanpidk ($105.52 in chips) 
Seat 3: lumen21 ($111.18 in chips) 
Seat 4: CI58 ($215.34 in chips) 
Seat 5: b_____a__242 ($91.11 in chips) 
Seat 6: RICKA16 ($104.12 in chips) 
Seat 7: holloway85 ($240.98 in chips) 
Seat 9: p.snow89 ($58.96 in chips) 
b_____a__242: posts small blind $0.50
RICKA16: posts big blind $1
*** HOLE CARDS ***
Dealt to matiko09 [Kc Qh]
holloway85: folds 
p.snow89: calls $1
matiko09: raises $3 to $4
sanpidk: folds 
lumen21: folds 
CI58: folds 
b_____a__242: folds 
RICKA16: folds 
p.snow89: calls $3
*** FLOP *** [Kd 5s Qd]
p.snow89: checks 
matiko09: bets $6
p.snow89: folds 
Uncalled bet ($6) returned to matiko09
matiko09 collected $9.02 from pot
matiko09: doesn't show hand 
*** SUMMARY ***
Total pot $9.50 | Rake $0.48 
Board [Kd 5s Qd]
Seat 1: matiko09 collected ($9.02)
Seat 2: sanpidk folded before Flop (didn't bet)
Seat 3: lumen21 folded before Flop (didn't bet)
Seat 4: CI58 (button) folded before Flop (didn't bet)
Seat 5: b_____a__242 (small blind) folded before Flop
Seat 6: RICKA16 (big blind) folded before Flop
Seat 7: holloway85 folded before Flop (didn't bet)
Seat 9: p.snow89 folded on the Flop





PokerStars Hand #151166420141:  Hold'em No Limit ($0.50/$1.00 USD) - 2016/03/30 17:04:37 CET [2016/03/30 11:04:37 ET]
Table 'Alcor II' 9-max Seat #3 is the button
Seat 1: di0d80 ($115.15 in chips) 
Seat 2: holloway85 ($64.99 in chips) 
Seat 3: mitchymitch3 ($107.91 in chips) 
Seat 4: Effort92 ($199.50 in chips) 
Seat 5: elbiber2000 ($113.58 in chips) 
Seat 6: godfrey004 ($139.39 in chips) 
Seat 7: sanpidk ($110 in chips) 
Seat 8: RICKA16 ($286.06 in chips) 
Seat 9: matiko09 ($184.42 in chips) 
Effort92: posts small blind $0.50
elbiber2000: posts big blind $1
*** HOLE CARDS ***
Dealt to matiko09 [5h 6c]
godfrey004: folds 
sanpidk: raises $2 to $3
RICKA16: folds 
matiko09: folds 
di0d80: folds 
holloway85: folds 
mitchymitch3: folds 
Effort92: folds 
elbiber2000: folds 
Uncalled bet ($2) returned to sanpidk
sanpidk collected $2.50 from pot
sanpidk: doesn't show hand 
*** SUMMARY ***
Total pot $2.50 | Rake $0 
Seat 1: di0d80 folded before Flop (didn't bet)
Seat 2: holloway85 folded before Flop (didn't bet)
Seat 3: mitchymitch3 (button) folded before Flop (didn't bet)
Seat 4: Effort92 (small blind) folded before Flop
Seat 5: elbiber2000 (big blind) folded before Flop
Seat 6: godfrey004 folded before Flop (didn't bet)
Seat 7: sanpidk collected ($2.50)
Seat 8: RICKA16 folded before Flop (didn't bet)
Seat 9: matiko09 folded before Flop (didn't bet)





PokerStars Hand #151166425182:  Hold'em No Limit (€0.50/€1.00 EUR) - 2016/03/30 17:04:44 CET [2016/03/30 11:04:44 ET]
Table 'Patricia' 9-max Seat #9 is the button
Seat 1: matiko09 (€100 in chips) 
Seat 2: ardo888 (€100 in chips) 
Seat 5: otterlake00 (€50.67 in chips) 
Seat 6: King_ZéManel (€100 in chips) 
Seat 7: Spid1 (€100 in chips) 
Seat 8: Painkiller72 (€100 in chips) 
Seat 9: tipner (€107.40 in chips) 
matiko09: posts small blind €0.50
ardo888: posts big blind €1
Dachish: sits out 
*** HOLE CARDS ***
Dealt to matiko09 [Qh 8d]
otterlake00: folds 
stonymalony joins the table at seat #4 
King_ZéManel: folds 
Spid1: folds 
Painkiller72: folds 
tipner: folds 
matiko09: raises €1.50 to €2.50
ardo888: folds 
Uncalled bet (€1.50) returned to matiko09
matiko09 collected €2 from pot
matiko09: doesn't show hand 
*** SUMMARY ***
Total pot €2 | Rake €0 
Seat 1: matiko09 (small blind) collected (€2)
Seat 2: ardo888 (big blind) folded before Flop
Seat 5: otterlake00 folded before Flop (didn't bet)
Seat 6: King_ZéManel folded before Flop (didn't bet)
Seat 7: Spid1 folded before Flop (didn't bet)
Seat 8: Painkiller72 folded before Flop (didn't bet)
Seat 9: tipner (button) folded before Flop (didn't bet)





PokerStars Hand #151166432418:  Hold'em No Limit ($1/$2 USD) - 2016/03/30 17:04:55 CET [2016/03/30 11:04:55 ET]
Table 'Sadalbari' 9-max Seat #1 is the button
Seat 1: Igoriah ($200 in chips) 
Seat 2: Rycious ($92.60 in chips) 
Seat 3: thecurv ($200 in chips) 
Seat 4: matiko09 ($237.45 in chips) 
Seat 5: RamiroAgujis ($200 in chips) 
Seat 6: King_ZéManel ($233.25 in chips) 
Seat 7: prominente ($200 in chips) 
Seat 8: suddend3ath ($214.55 in chips) 
Seat 9: fonng ($93 in chips) 
Rycious: posts small blind $1
thecurv: posts big blind $2
*** HOLE CARDS ***
Dealt to matiko09 [Kc 9h]
matiko09: folds 
RamiroAgujis: folds 
King_ZéManel: folds 
prominente: folds 
suddend3ath: folds 
fonng: calls $2
Igoriah: raises $7 to $9
Rycious: folds 
thecurv: folds 
fonng: folds 
Uncalled bet ($7) returned to Igoriah
Igoriah collected $7 from pot
Igoriah: doesn't show hand 
*** SUMMARY ***
Total pot $7 | Rake $0 
Seat 1: Igoriah (button) collected ($7)
Seat 2: Rycious (small blind) folded before Flop
Seat 3: thecurv (big blind) folded before Flop
Seat 4: matiko09 folded before Flop (didn't bet)
Seat 5: RamiroAgujis folded before Flop (didn't bet)
Seat 6: King_ZéManel folded before Flop (didn't bet)
Seat 7: prominente folded before Flop (didn't bet)
Seat 8: suddend3ath folded before Flop (didn't bet)
Seat 9: fonng folded before Flop





PokerStars Hand #151166435474:  Hold'em No Limit ($0.50/$1.00 USD) - 2016/03/30 17:04:59 CET [2016/03/30 11:04:59 ET]
Table 'Pannonia II' 9-max Seat #3 is the button
Seat 1: CI58 ($125.96 in chips) 
Seat 2: matiko09 ($100 in chips) 
Seat 3: MGL_Sky99 ($80.25 in chips) 
Seat 5: Spid1 ($233.42 in chips) 
Seat 6: lumen21 ($113.14 in chips) 
Seat 7: Dachish ($70.24 in chips) 
Seat 9: Effort92 ($99.24 in chips) 
mycka86 will be allowed to play after the button
Spid1: posts small blind $0.50
lumen21: posts big blind $1
sanpidk: sits out 
*** HOLE CARDS ***
Dealt to matiko09 [4c 3c]
sanpidk leaves the table
Dachish: folds 
Effort92: folds 
CI58: raises $2 to $3
matiko09: folds 
MGL_Sky99: folds 
Spid1: folds 
Dachish leaves the table
lumen21: folds 
Uncalled bet ($2) returned to CI58
CI58 collected $2.50 from pot
CI58: doesn't show hand 
*** SUMMARY ***
Total pot $2.50 | Rake $0 
Seat 1: CI58 collected ($2.50)
Seat 2: matiko09 folded before Flop (didn't bet)
Seat 3: MGL_Sky99 (button) folded before Flop (didn't bet)
Seat 5: Spid1 (small blind) folded before Flop
Seat 6: lumen21 (big blind) folded before Flop
Seat 7: Dachish folded before Flop (didn't bet)
Seat 9: Effort92 folded before Flop (didn't bet)





PokerStars Hand #151166439488:  Hold'em No Limit ($1/$2 USD) - 2016/03/30 17:05:05 CET [2016/03/30 11:05:05 ET]
Table 'Jole' 9-max Seat #9 is the button
Seat 1: prominente ($276.74 in chips) 
Seat 2: InsomniaRU ($208.45 in chips) 
Seat 3: tipner ($210.53 in chips) 
Seat 4: GS_Sydney ($128.61 in chips) 
Seat 5: mentalpshyco ($211.75 in chips) 
Seat 6: King_ZéManel ($322.30 in chips) 
Seat 7: thecurv ($210.60 in chips) 
Seat 8: matiko09 ($320.50 in chips) 
Seat 9: RamiroAgujis ($243.76 in chips) 
prominente: posts small blind $1
InsomniaRU: posts big blind $2
*** HOLE CARDS ***
Dealt to matiko09 [5s Th]
tipner: folds 
GS_Sydney: calls $2
mentalpshyco: raises $6 to $8
King_ZéManel: folds 
thecurv: folds 
matiko09: folds 
RamiroAgujis: folds 
prominente: folds 
InsomniaRU: folds 
GS_Sydney: calls $6
*** FLOP *** [6c 4s 8h]
GS_Sydney: checks 
mentalpshyco: checks 
*** TURN *** [6c 4s 8h] [7h]
GS_Sydney: checks 
mentalpshyco: checks 
*** RIVER *** [6c 4s 8h 7h] [Ad]
GS_Sydney: checks 
mentalpshyco: checks 
*** SHOW DOWN ***
GS_Sydney: shows [Ts Ks] (high card Ace)
mentalpshyco: shows [Td Kd] (high card Ace)
GS_Sydney collected $9.03 from pot
mentalpshyco collected $9.02 from pot
*** SUMMARY ***
Total pot $19 | Rake $0.95 
Board [6c 4s 8h 7h Ad]
Seat 1: prominente (small blind) folded before Flop
Seat 2: InsomniaRU (big blind) folded before Flop
Seat 3: tipner folded before Flop (didn't bet)
Seat 4: GS_Sydney showed [Ts Ks] and won ($9.03) with high card Ace
Seat 5: mentalpshyco showed [Td Kd] and won ($9.02) with high card Ace
Seat 6: King_ZéManel folded before Flop (didn't bet)
Seat 7: thecurv folded before Flop (didn't bet)
Seat 8: matiko09 folded before Flop (didn't bet)
Seat 9: RamiroAgujis (button) folded before Flop (didn't bet)





PokerStars Hand #151166443303:  Hold'em No Limit ($0.50/$1.00 USD) - 2016/03/30 17:05:10 CET [2016/03/30 11:05:10 ET]
Table 'Sumiana III' 9-max Seat #2 is the button
Seat 2: Sloeve ($118.15 in chips) 
Seat 3: IdiotFromNE ($100 in chips) 
Seat 4: Pingili ($40 in chips) 
Seat 6: sanpidk ($161.54 in chips) 
Seat 7: matiko09 ($166.82 in chips) 
Seat 8: Effort92 ($115.38 in chips) 
IdiotFromNE: posts small blind $0.50
Pingili: posts big blind $1
ardo888: sits out 
Filojoes: sits out 
chelseanin: sits out 
*** HOLE CARDS ***
Dealt to matiko09 [6s 9d]
sanpidk: folds 
matiko09: folds 
Effort92: raises $1.50 to $2.50
Sloeve: folds 
IdiotFromNE: folds 
Pingili: folds 
Uncalled bet ($1.50) returned to Effort92
Effort92 collected $2.50 from pot
Effort92: doesn't show hand 
*** SUMMARY ***
Total pot $2.50 | Rake $0 
Seat 2: Sloeve (button) folded before Flop (didn't bet)
Seat 3: IdiotFromNE (small blind) folded before Flop
Seat 4: Pingili (big blind) folded before Flop
Seat 6: sanpidk folded before Flop (didn't bet)
Seat 7: matiko09 folded before Flop (didn't bet)
Seat 8: Effort92 collected ($2.50)





PokerStars Hand #151166449085:  Hold'em No Limit ($1/$2 USD) - 2016/03/30 17:05:18 CET [2016/03/30 11:05:18 ET]
Table 'Philoctetes II' 9-max Seat #8 is the button
Seat 1: vezunchik79 ($83.38 in chips) 
Seat 2: prominente ($209.91 in chips) 
Seat 3: mentalpshyco ($402.05 in chips) 
Seat 5: zhaimeng ($310.62 in chips) 
Seat 6: di0d80 ($200 in chips) 
Seat 7: matiko09 ($200 in chips) 
Seat 8: suddend3ath ($224.60 in chips) 
Seat 9: RamiroAgujis ($253.45 in chips) 
RamiroAgujis: posts small blind $1
vezunchik79: posts big blind $2
*** HOLE CARDS ***
Dealt to matiko09 [Js 5h]
prominente: raises $3 to $5
mentalpshyco: folds 
zhaimeng: calls $5
di0d80: folds 
matiko09: folds 
suddend3ath: folds 
RamiroAgujis: folds 
vezunchik79: folds 
*** FLOP *** [Ts Ks 2h]
prominente: checks 
zhaimeng: checks 
*** TURN *** [Ts Ks 2h] [Ad]
prominente: bets $7.53
zhaimeng: calls $7.53
*** RIVER *** [Ts Ks 2h Ad] [3s]
prominente: checks 
curlwillis joins the table at seat #4 
zhaimeng: checks 
*** SHOW DOWN ***
prominente: shows [6d 6c] (a pair of Sixes)
zhaimeng: shows [9s Kc] (a pair of Kings)
zhaimeng collected $26.66 from pot
*** SUMMARY ***
Total pot $28.06 | Rake $1.40 
Board [Ts Ks 2h Ad 3s]
Seat 1: vezunchik79 (big blind) folded before Flop
Seat 2: prominente showed [6d 6c] and lost with a pair of Sixes
Seat 3: mentalpshyco folded before Flop (didn't bet)
Seat 5: zhaimeng showed [9s Kc] and won ($26.66) with a pair of Kings
Seat 6: di0d80 folded before Flop (didn't bet)
Seat 7: matiko09 folded before Flop (didn't bet)
Seat 8: suddend3ath (button) folded before Flop (didn't bet)
Seat 9: RamiroAgujis (small blind) folded before Flop





PokerStars Hand #151166448521:  Hold'em No Limit ($0.50/$1.00 USD) - 2016/03/30 17:05:18 CET [2016/03/30 11:05:18 ET]
Table 'Hadwiger' 9-max Seat #2 is the button
Seat 1: AKplus ($78.73 in chips) 
Seat 2: di0d80 ($100 in chips) 
Seat 3: yuminyumin1 ($114.14 in chips) 
Seat 4: Westpants ($100 in chips) 
Seat 5: ardo888 ($103.50 in chips) 
Seat 6: xrisall_2 ($157.78 in chips) 
Seat 7: matiko09 ($107.61 in chips) 
Seat 8: Effort92 ($100 in chips) 
Seat 9: IdiotFromNE ($105.67 in chips) 
yuminyumin1: posts small blind $0.50
Westpants: posts big blind $1
*** HOLE CARDS ***
Dealt to matiko09 [4d 2d]
ardo888: folds 
xrisall_2: folds 
matiko09: folds 
Effort92: folds 
IdiotFromNE: folds 
AKplus: folds 
di0d80: raises $1 to $2
yuminyumin1: folds 
Westpants: calls $1
*** FLOP *** [Jd 9d Ac]
Westpants: checks 
di0d80: checks 
*** TURN *** [Jd 9d Ac] [6c]
Westpants: bets $2.82
di0d80: calls $2.82
*** RIVER *** [Jd 9d Ac 6c] [8h]
Westpants: checks 
di0d80: checks 
*** SHOW DOWN ***
Westpants: shows [2s Ah] (a pair of Aces)
di0d80: mucks hand 
Westpants collected $9.63 from pot
*** SUMMARY ***
Total pot $10.14 | Rake $0.51 
Board [Jd 9d Ac 6c 8h]
Seat 1: AKplus folded before Flop (didn't bet)
Seat 2: di0d80 (button) mucked [Jh Th]
Seat 3: yuminyumin1 (small blind) folded before Flop
Seat 4: Westpants (big blind) showed [2s Ah] and won ($9.63) with a pair of Aces
Seat 5: ardo888 folded before Flop (didn't bet)
Seat 6: xrisall_2 folded before Flop (didn't bet)
Seat 7: matiko09 folded before Flop (didn't bet)
Seat 8: Effort92 folded before Flop (didn't bet)
Seat 9: IdiotFromNE folded before Flop (didn't bet)





PokerStars Hand #151166451567:  Hold'em No Limit (€0.50/€1.00 EUR) - 2016/03/30 17:05:22 CET [2016/03/30 11:05:22 ET]
Table 'Patricia' 9-max Seat #1 is the button
Seat 1: matiko09 (€101 in chips) 
Seat 2: ardo888 (€100 in chips) 
Seat 3: Dachish (€70 in chips) 
Seat 4: stonymalony (€44 in chips) 
Seat 5: otterlake00 (€50.67 in chips) 
Seat 6: King_ZéManel (€100 in chips) 
Seat 7: Spid1 (€100 in chips) 
Seat 8: Painkiller72 (€100 in chips) 
Seat 9: tipner (€107.40 in chips) 
ardo888: posts small blind €0.50
Dachish: posts big blind €1
stonymalony: posts big blind €1
*** HOLE CARDS ***
Dealt to matiko09 [Qs 8h]
stonymalony: checks 
otterlake00: folds 
King_ZéManel: folds 
Spid1: folds 
Painkiller72: folds 
tipner: folds 
matiko09: raises €3 to €4
ardo888: folds 
Dachish: folds 
stonymalony: folds 
Uncalled bet (€3) returned to matiko09
matiko09 collected €3.50 from pot
matiko09: doesn't show hand 
*** SUMMARY ***
Total pot €3.50 | Rake €0 
Seat 1: matiko09 (button) collected (€3.50)
Seat 2: ardo888 (small blind) folded before Flop
Seat 3: Dachish (big blind) folded before Flop
Seat 4: stonymalony folded before Flop
Seat 5: otterlake00 folded before Flop (didn't bet)
Seat 6: King_ZéManel folded before Flop (didn't bet)
Seat 7: Spid1 folded before Flop (didn't bet)
Seat 8: Painkiller72 folded before Flop (didn't bet)
Seat 9: tipner folded before Flop (didn't bet)





PokerStars Hand #151166452397:  Hold'em No Limit ($0.50/$1.00 USD) - 2016/03/30 17:05:23 CET [2016/03/30 11:05:23 ET]
Table 'Pannonia II' 9-max Seat #5 is the button
Seat 1: CI58 ($127.46 in chips) 
Seat 2: matiko09 ($100 in chips) 
Seat 3: MGL_Sky99 ($80.25 in chips) 
Seat 5: Spid1 ($232.92 in chips) 
Seat 6: lumen21 ($112.14 in chips) 
Seat 9: Effort92 ($99.24 in chips) 
lumen21: posts small blind $0.50
Effort92: posts big blind $1
mycka86: sits out 
*** HOLE CARDS ***
Dealt to matiko09 [Kd 9h]
CI58: folds 
matiko09: folds 
MGL_Sky99: folds 
Spid1: raises $1.50 to $2.50
lumen21: folds 
Effort92: calls $1.50
*** FLOP *** [9c 7s 4c]
Effort92: checks 
Spid1: bets $3.50
power4e14 joins the table at seat #7 
Effort92: raises $6.90 to $10.40
Spid1: folds 
Uncalled bet ($6.90) returned to Effort92
Effort92 collected $11.88 from pot
Effort92: doesn't show hand 
*** SUMMARY ***
Total pot $12.50 | Rake $0.62 
Board [9c 7s 4c]
Seat 1: CI58 folded before Flop (didn't bet)
Seat 2: matiko09 folded before Flop (didn't bet)
Seat 3: MGL_Sky99 folded before Flop (didn't bet)
Seat 5: Spid1 (button) folded on the Flop
Seat 6: lumen21 (small blind) folded before Flop
Seat 9: Effort92 (big blind) collected ($11.88)





PokerStars Hand #151166452851:  Hold'em No Limit ($1/$2 USD) - 2016/03/30 17:05:24 CET [2016/03/30 11:05:24 ET]
Table 'Tabit III' 9-max Seat #7 is the button
Seat 1: di0d80 ($236.97 in chips) 
Seat 2: matiko09 ($226.54 in chips) 
Seat 3: prominente ($200 in chips) 
Seat 4: Dykallis ($498.53 in chips) 
Seat 5: itaik1 ($88.24 in chips) 
Seat 6: Igoriah ($200 in chips) 
Seat 7: jannis1951 ($190.93 in chips) 
Seat 8: mentalpshyco ($211.05 in chips) 
Seat 9: suddend3ath ($200 in chips) 
mentalpshyco: posts small blind $1
suddend3ath: posts big blind $2
*** HOLE CARDS ***
Dealt to matiko09 [6c 3c]
di0d80: folds 
matiko09: folds 
prominente: folds 
Dykallis: folds 
itaik1: folds 
Igoriah: folds 
jannis1951: raises $2 to $4
mentalpshyco: folds 
suddend3ath: calls $2
*** FLOP *** [7s Kd 3s]
suddend3ath: checks 
jannis1951: bets $8.55
suddend3ath: calls $8.55
*** TURN *** [7s Kd 3s] [4d]
suddend3ath: checks 
jannis1951: checks 
*** RIVER *** [7s Kd 3s 4d] [6d]
suddend3ath: checks 
jannis1951: bets $12.40
suddend3ath: folds 
Uncalled bet ($12.40) returned to jannis1951
jannis1951 collected $24.80 from pot
*** SUMMARY ***
Total pot $26.10 | Rake $1.30 
Board [7s Kd 3s 4d 6d]
Seat 1: di0d80 folded before Flop (didn't bet)
Seat 2: matiko09 folded before Flop (didn't bet)
Seat 3: prominente folded before Flop (didn't bet)
Seat 4: Dykallis folded before Flop (didn't bet)
Seat 5: itaik1 folded before Flop (didn't bet)
Seat 6: Igoriah folded before Flop (didn't bet)
Seat 7: jannis1951 (button) collected ($24.80)
Seat 8: mentalpshyco (small blind) folded before Flop
Seat 9: suddend3ath (big blind) folded on the River





PokerStars Hand #151166456165:  Hold'em No Limit ($0.50/$1.00 USD) - 2016/03/30 17:05:28 CET [2016/03/30 11:05:28 ET]
Table 'Figneria III' 9-max Seat #5 is the button
Seat 1: matiko09 ($114.87 in chips) 
Seat 2: sanpidk ($105.52 in chips) 
Seat 3: lumen21 ($111.18 in chips) 
Seat 4: CI58 ($215.34 in chips) 
Seat 5: b_____a__242 ($90.61 in chips) 
Seat 6: RICKA16 ($103.12 in chips) 
Seat 7: holloway85 ($240.98 in chips) 
Seat 9: p.snow89 ($54.96 in chips) 
RICKA16: posts small blind $0.50
holloway85: posts big blind $1
*** HOLE CARDS ***
Dealt to matiko09 [Js Ts]
p.snow89: folds 
matiko09: raises $2 to $3
sanpidk: folds 
lumen21: folds 
CI58: folds 
b_____a__242: folds 
RICKA16: folds 
holloway85: folds 
Uncalled bet ($2) returned to matiko09
matiko09 collected $2.50 from pot
matiko09: doesn't show hand 
*** SUMMARY ***
Total pot $2.50 | Rake $0 
Seat 1: matiko09 collected ($2.50)
Seat 2: sanpidk folded before Flop (didn't bet)
Seat 3: lumen21 folded before Flop (didn't bet)
Seat 4: CI58 folded before Flop (didn't bet)
Seat 5: b_____a__242 (button) folded before Flop (didn't bet)
Seat 6: RICKA16 (small blind) folded before Flop
Seat 7: holloway85 (big blind) folded before Flop
Seat 9: p.snow89 folded before Flop (didn't bet)





PokerStars Hand #151166462014:  Hold'em No Limit ($0.50/$1.00 USD) - 2016/03/30 17:05:37 CET [2016/03/30 11:05:37 ET]
Table 'Alcor II' 9-max Seat #4 is the button
Seat 1: di0d80 ($115.15 in chips) 
Seat 2: holloway85 ($64.99 in chips) 
Seat 3: mitchymitch3 ($107.91 in chips) 
Seat 4: Effort92 ($199 in chips) 
Seat 5: elbiber2000 ($112.58 in chips) 
Seat 6: godfrey004 ($139.39 in chips) 
Seat 7: sanpidk ($111.50 in chips) 
Seat 8: RICKA16 ($286.06 in chips) 
Seat 9: matiko09 ($184.42 in chips) 
elbiber2000: posts small blind $0.50
godfrey004: posts big blind $1
*** HOLE CARDS ***
Dealt to matiko09 [6h 2c]
sanpidk: folds 
RICKA16: raises $2 to $3
matiko09: folds 
di0d80: folds 
holloway85: folds 
mitchymitch3: folds 
Effort92: folds 
elbiber2000: folds 
godfrey004: calls $2
*** FLOP *** [4h 9s 5d]
godfrey004: checks 
RICKA16: checks 
*** TURN *** [4h 9s 5d] [3d]
godfrey004: bets $5
RICKA16: folds 
Uncalled bet ($5) returned to godfrey004
godfrey004 collected $6.18 from pot
godfrey004: doesn't show hand 
*** SUMMARY ***
Total pot $6.50 | Rake $0.32 
Board [4h 9s 5d 3d]
Seat 1: di0d80 folded before Flop (didn't bet)
Seat 2: holloway85 folded before Flop (didn't bet)
Seat 3: mitchymitch3 folded before Flop (didn't bet)
Seat 4: Effort92 (button) folded before Flop (didn't bet)
Seat 5: elbiber2000 (small blind) folded before Flop
Seat 6: godfrey004 (big blind) collected ($6.18)
Seat 7: sanpidk folded before Flop (didn't bet)
Seat 8: RICKA16 folded on the Turn
Seat 9: matiko09 folded before Flop (didn't bet)





PokerStars Hand #151166466035:  Hold'em No Limit ($0.50/$1.00 USD) - 2016/03/30 17:05:43 CET [2016/03/30 11:05:43 ET]
Table 'Sumiana III' 9-max Seat #3 is the button
Seat 2: Sloeve ($118.15 in chips) 
Seat 3: IdiotFromNE ($100 in chips) 
Seat 4: Pingili ($39 in chips) 
Seat 5: ardo888 ($100 in chips) 
Seat 6: sanpidk ($161.54 in chips) 
Seat 7: matiko09 ($166.82 in chips) 
Seat 8: Effort92 ($116.88 in chips) 
Pingili: posts small blind $0.50
ardo888: posts big blind $1
Filojoes: sits out 
chelseanin: sits out 
*** HOLE CARDS ***
Dealt to matiko09 [7s Qh]
sanpidk: folds 
matiko09: folds 
Effort92: folds 
Sloeve: folds 
IdiotFromNE: raises $1.50 to $2.50
Pingili: folds 
ardo888: folds 
Uncalled bet ($1.50) returned to IdiotFromNE
IdiotFromNE collected $2.50 from pot
IdiotFromNE: doesn't show hand 
*** SUMMARY ***
Total pot $2.50 | Rake $0 
Seat 2: Sloeve folded before Flop (didn't bet)
Seat 3: IdiotFromNE (button) collected ($2.50)
Seat 4: Pingili (small blind) folded before Flop
Seat 5: ardo888 (big blind) folded before Flop
Seat 6: sanpidk folded before Flop (didn't bet)
Seat 7: matiko09 folded before Flop (didn't bet)
Seat 8: Effort92 folded before Flop (didn't bet)





PokerStars Hand #151166471531:  Hold'em No Limit ($0.50/$1.00 USD) - 2016/03/30 17:05:51 CET [2016/03/30 11:05:51 ET]
Table 'Sirona II' 9-max Seat #6 is the button
Seat 1: funXmun ($109.64 in chips) 
Seat 3: claudioneamt ($17.34 in chips) 
Seat 4: RICKA16 ($109.82 in chips) 
Seat 5: bragutza ($270.64 in chips) 
Seat 6: lumen21 ($100 in chips) 
Seat 7: matiko09 ($161.51 in chips) 
Seat 8: sanpidk ($100 in chips) 
Seat 9: mycka86 ($228.60 in chips) 
matiko09: posts small blind $0.50
sanpidk: posts big blind $1
Spid1: sits out 
*** HOLE CARDS ***
Dealt to matiko09 [3s 8s]
mycka86: folds 
funXmun: folds 
claudioneamt: folds 
RICKA16: folds 
bragutza: raises $1 to $2
lumen21: folds 
matiko09: folds 
sanpidk: folds 
Uncalled bet ($1) returned to bragutza
bragutza collected $2.50 from pot
bragutza: doesn't show hand 
*** SUMMARY ***
Total pot $2.50 | Rake $0 
Seat 1: funXmun folded before Flop (didn't bet)
Seat 3: claudioneamt folded before Flop (didn't bet)
Seat 4: RICKA16 folded before Flop (didn't bet)
Seat 5: bragutza collected ($2.50)
Seat 6: lumen21 (button) folded before Flop (didn't bet)
Seat 7: matiko09 (small blind) folded before Flop
Seat 8: sanpidk (big blind) folded before Flop
Seat 9: mycka86 folded before Flop (didn't bet)





PokerStars Hand #151166479406:  Hold'em No Limit ($0.50/$1.00 USD) - 2016/03/30 17:06:02 CET [2016/03/30 11:06:02 ET]
Table 'Hadwiger' 9-max Seat #3 is the button
Seat 1: AKplus ($78.73 in chips) 
Seat 2: di0d80 ($100 in chips) 
Seat 3: yuminyumin1 ($113.64 in chips) 
Seat 4: Westpants ($104.81 in chips) 
Seat 5: ardo888 ($103.50 in chips) 
Seat 6: xrisall_2 ($157.78 in chips) 
Seat 7: matiko09 ($107.61 in chips) 
Seat 8: Effort92 ($100 in chips) 
Seat 9: IdiotFromNE ($105.67 in chips) 
Westpants: posts small blind $0.50
ardo888: posts big blind $1
*** HOLE CARDS ***
Dealt to matiko09 [4h 5d]
xrisall_2: folds 
matiko09: folds 
Effort92: raises $1.50 to $2.50
IdiotFromNE: folds 
AKplus: folds 
di0d80: folds 
yuminyumin1: calls $2.50
Westpants: folds 
ardo888: calls $1.50
*** FLOP *** [Qc 3s 9s]
ardo888: checks 
Effort92: checks 
yuminyumin1: bets $4
ardo888: raises $8.26 to $12.26
Effort92: folds 
yuminyumin1: calls $8.26
*** TURN *** [Qc 3s 9s] [8d]
ardo888: checks 
yuminyumin1: checks 
*** RIVER *** [Qc 3s 9s 8d] [7c]
ardo888: checks 
yuminyumin1: bets $20
ardo888: folds 
Uncalled bet ($20) returned to yuminyumin1
yuminyumin1 collected $30.89 from pot
yuminyumin1: doesn't show hand 
*** SUMMARY ***
Total pot $32.52 | Rake $1.63 
Board [Qc 3s 9s 8d 7c]
Seat 1: AKplus folded before Flop (didn't bet)
Seat 2: di0d80 folded before Flop (didn't bet)
Seat 3: yuminyumin1 (button) collected ($30.89)
Seat 4: Westpants (small blind) folded before Flop
Seat 5: ardo888 (big blind) folded on the River
Seat 6: xrisall_2 folded before Flop (didn't bet)
Seat 7: matiko09 folded before Flop (didn't bet)
Seat 8: Effort92 folded on the Flop
Seat 9: IdiotFromNE folded before Flop (didn't bet)





PokerStars Hand #151166483012:  Hold'em No Limit ($0.50/$1.00 USD) - 2016/03/30 17:06:07 CET [2016/03/30 11:06:07 ET]
Table 'Sumiana III' 9-max Seat #4 is the button
Seat 2: Sloeve ($118.15 in chips) 
Seat 3: IdiotFromNE ($101.50 in chips) 
Seat 4: Pingili ($38.50 in chips) 
Seat 5: ardo888 ($100 in chips) 
Seat 6: sanpidk ($161.54 in chips) 
Seat 7: matiko09 ($166.82 in chips) 
Seat 8: Effort92 ($116.88 in chips) 
ardo888: posts small blind $0.50
sanpidk: posts big blind $1
Filojoes: sits out 
chelseanin: sits out 
*** HOLE CARDS ***
Dealt to matiko09 [5h Kd]
matiko09: folds 
Effort92: folds 
Sloeve: folds 
IdiotFromNE: raises $1.50 to $2.50
Pingili: folds 
ardo888: folds 
sanpidk: folds 
Uncalled bet ($1.50) returned to IdiotFromNE
IdiotFromNE collected $2.50 from pot
IdiotFromNE: doesn't show hand 
*** SUMMARY ***
Total pot $2.50 | Rake $0 
Seat 2: Sloeve folded before Flop (didn't bet)
Seat 3: IdiotFromNE collected ($2.50)
Seat 4: Pingili (button) folded before Flop (didn't bet)
Seat 5: ardo888 (small blind) folded before Flop
Seat 6: sanpidk (big blind) folded before Flop
Seat 7: matiko09 folded before Flop (didn't bet)
Seat 8: Effort92 folded before Flop (didn't bet)





PokerStars Hand #151166484361:  Hold'em No Limit ($1/$2 USD) - 2016/03/30 17:06:09 CET [2016/03/30 11:06:09 ET]
Table 'Jole' 9-max Seat #1 is the button
Seat 1: prominente ($275.74 in chips) 
Seat 2: InsomniaRU ($206.45 in chips) 
Seat 3: tipner ($210.53 in chips) 
Seat 4: GS_Sydney ($129.64 in chips) 
Seat 5: mentalpshyco ($212.77 in chips) 
Seat 6: King_ZéManel ($322.30 in chips) 
Seat 7: thecurv ($210.60 in chips) 
Seat 8: matiko09 ($320.50 in chips) 
Seat 9: RamiroAgujis ($243.76 in chips) 
InsomniaRU: posts small blind $1
tipner: posts big blind $2
*** HOLE CARDS ***
Dealt to matiko09 [Qh Qc]
GS_Sydney: folds 
mentalpshyco: folds 
King_ZéManel: folds 
thecurv: folds 
matiko09: raises $3 to $5
RamiroAgujis: folds 
prominente: folds 
InsomniaRU: folds 
tipner: folds 
Uncalled bet ($3) returned to matiko09
matiko09 collected $5 from pot
matiko09: doesn't show hand 
*** SUMMARY ***
Total pot $5 | Rake $0 
Seat 1: prominente (button) folded before Flop (didn't bet)
Seat 2: InsomniaRU (small blind) folded before Flop
Seat 3: tipner (big blind) folded before Flop
Seat 4: GS_Sydney folded before Flop (didn't bet)
Seat 5: mentalpshyco folded before Flop (didn't bet)
Seat 6: King_ZéManel folded before Flop (didn't bet)
Seat 7: thecurv folded before Flop (didn't bet)
Seat 8: matiko09 collected ($5)
Seat 9: RamiroAgujis folded before Flop (didn't bet)





PokerStars Hand #151166486425:  Hold'em No Limit (€0.50/€1.00 EUR) - 2016/03/30 17:06:12 CET [2016/03/30 11:06:12 ET]
Table 'Patricia' 9-max Seat #2 is the button
Seat 1: matiko09 (€103.50 in chips) 
Seat 2: ardo888 (€100 in chips) 
Seat 3: Dachish (€69 in chips) 
Seat 4: stonymalony (€43 in chips) 
Seat 5: otterlake00 (€50.67 in chips) 
Seat 6: King_ZéManel (€100 in chips) 
Seat 7: Spid1 (€100 in chips) 
Seat 8: Painkiller72 (€100 in chips) 
Seat 9: tipner (€107.40 in chips) 
Dachish: posts small blind €0.50
stonymalony: posts big blind €1
*** HOLE CARDS ***
Dealt to matiko09 [Ks Qh]
otterlake00: calls €1
King_ZéManel: folds 
Spid1: folds 
Painkiller72: folds 
tipner: raises €3 to €4
matiko09: calls €4
ardo888: folds 
Dachish: folds 
stonymalony: calls €3
otterlake00: calls €3
*** FLOP *** [Jd 4h 3c]
stonymalony: checks 
otterlake00: checks 
tipner: bets €8
matiko09: folds 
stonymalony: calls €8
otterlake00: folds 
*** TURN *** [Jd 4h 3c] [8c]
stonymalony: checks 
tipner: bets €19
stonymalony: raises €12 to €31 and is all-in
tipner: calls €12
*** RIVER *** [Jd 4h 3c 8c] [2s]
*** SHOW DOWN ***
stonymalony: shows [3h 3d] (three of a kind, Threes)
tipner: shows [Js Qs] (a pair of Jacks)
stonymalony collected €92.25 from pot
*** SUMMARY ***
Total pot €94.50 | Rake €2.25 
Board [Jd 4h 3c 8c 2s]
Seat 1: matiko09 folded on the Flop
Seat 2: ardo888 (button) folded before Flop (didn't bet)
Seat 3: Dachish (small blind) folded before Flop
Seat 4: stonymalony (big blind) showed [3h 3d] and won (€92.25) with three of a kind, Threes
Seat 5: otterlake00 folded on the Flop
Seat 6: King_ZéManel folded before Flop (didn't bet)
Seat 7: Spid1 folded before Flop (didn't bet)
Seat 8: Painkiller72 folded before Flop (didn't bet)
Seat 9: tipner showed [Js Qs] and lost with a pair of Jacks





PokerStars Hand #151166491185:  Hold'em No Limit ($0.50/$1.00 USD) - 2016/03/30 17:06:19 CET [2016/03/30 11:06:19 ET]
Table 'Sirona II' 9-max Seat #7 is the button
Seat 1: funXmun ($109.64 in chips) 
Seat 3: claudioneamt ($17.34 in chips) 
Seat 4: RICKA16 ($109.82 in chips) 
Seat 5: bragutza ($272.14 in chips) 
Seat 6: lumen21 ($100 in chips) 
Seat 7: matiko09 ($161.01 in chips) 
Seat 8: sanpidk ($100 in chips) 
Seat 9: mycka86 ($228.60 in chips) 
sanpidk: posts small blind $0.50
mycka86: posts big blind $1
Spid1: sits out 
*** HOLE CARDS ***
Dealt to matiko09 [9d Jh]
funXmun: folds 
claudioneamt: folds 
RICKA16: folds 
bragutza: raises $2 to $3
lumen21: raises $6 to $9
matiko09: folds 
sanpidk: folds 
mycka86: folds 
bragutza: calls $6
*** FLOP *** [4d 8s 3d]
bragutza: checks 
lumen21: checks 
*** TURN *** [4d 8s 3d] [Tc]
bragutza: bets $9.26
lumen21: folds 
Uncalled bet ($9.26) returned to bragutza
bragutza collected $18.52 from pot
bragutza: doesn't show hand 
*** SUMMARY ***
Total pot $19.50 | Rake $0.98 
Board [4d 8s 3d Tc]
Seat 1: funXmun folded before Flop (didn't bet)
Seat 3: claudioneamt folded before Flop (didn't bet)
Seat 4: RICKA16 folded before Flop (didn't bet)
Seat 5: bragutza collected ($18.52)
Seat 6: lumen21 folded on the Turn
Seat 7: matiko09 (button) folded before Flop (didn't bet)
Seat 8: sanpidk (small blind) folded before Flop
Seat 9: mycka86 (big blind) folded before Flop





PokerStars Hand #151166492417:  Hold'em No Limit ($0.50/$1.00 USD) - 2016/03/30 17:06:20 CET [2016/03/30 11:06:20 ET]
Table 'Figneria III' 9-max Seat #6 is the button
Seat 1: matiko09 ($116.37 in chips) 
Seat 2: sanpidk ($105.52 in chips) 
Seat 3: lumen21 ($111.18 in chips) 
Seat 4: CI58 ($215.34 in chips) 
Seat 5: b_____a__242 ($90.61 in chips) 
Seat 6: RICKA16 ($102.62 in chips) 
Seat 7: holloway85 ($239.98 in chips) 
Seat 9: p.snow89 ($54.96 in chips) 
holloway85: posts small blind $0.50
Dachish was removed from the table for failing to post
p.snow89: posts big blind $1
*** HOLE CARDS ***
Dealt to matiko09 [4s 6s]
matiko09: folds 
di0d80 joins the table at seat #8 
di0d80 leaves the table
sanpidk: folds 
lumen21: folds 
CI58: folds 
b_____a__242: folds 
RICKA16: raises $2 to $3
holloway85: folds 
p.snow89: calls $2
*** FLOP *** [Ah Jh 3c]
p.snow89: bets $3
RICKA16: calls $3
*** TURN *** [Ah Jh 3c] [Ts]
p.snow89: checks 
RICKA16: bets $7
Dachish joins the table at seat #8 
p.snow89: folds 
Uncalled bet ($7) returned to RICKA16
RICKA16 collected $11.88 from pot
RICKA16: doesn't show hand 
*** SUMMARY ***
Total pot $12.50 | Rake $0.62 
Board [Ah Jh 3c Ts]
Seat 1: matiko09 folded before Flop (didn't bet)
Seat 2: sanpidk folded before Flop (didn't bet)
Seat 3: lumen21 folded before Flop (didn't bet)
Seat 4: CI58 folded before Flop (didn't bet)
Seat 5: b_____a__242 folded before Flop (didn't bet)
Seat 6: RICKA16 (button) collected ($11.88)
Seat 7: holloway85 (small blind) folded before Flop
Seat 9: p.snow89 (big blind) folded on the Turn





PokerStars Hand #151166498149:  Hold'em No Limit ($0.50/$1.00 USD) - 2016/03/30 17:06:28 CET [2016/03/30 11:06:28 ET]
Table 'Alcor II' 9-max Seat #5 is the button
Seat 1: di0d80 ($115.15 in chips) 
Seat 2: holloway85 ($64.99 in chips) 
Seat 3: mitchymitch3 ($107.91 in chips) 
Seat 4: Effort92 ($199 in chips) 
Seat 5: elbiber2000 ($112.08 in chips) 
Seat 6: godfrey004 ($142.57 in chips) 
Seat 7: sanpidk ($111.50 in chips) 
Seat 8: RICKA16 ($283.06 in chips) 
Seat 9: matiko09 ($184.42 in chips) 
godfrey004: posts small blind $0.50
sanpidk: posts big blind $1
*** HOLE CARDS ***
Dealt to matiko09 [Jd 8h]
RICKA16: folds 
matiko09: folds 
di0d80: folds 
holloway85: raises $1.50 to $2.50
mitchymitch3: folds 
Effort92: calls $2.50
elbiber2000: folds 
godfrey004: calls $2
sanpidk: folds 
*** FLOP *** [Js Tc 5c]
godfrey004: checks 
holloway85: bets $2
Effort92: folds 
godfrey004: folds 
Uncalled bet ($2) returned to holloway85
holloway85 collected $8.08 from pot
holloway85: doesn't show hand 
*** SUMMARY ***
Total pot $8.50 | Rake $0.42 
Board [Js Tc 5c]
Seat 1: di0d80 folded before Flop (didn't bet)
Seat 2: holloway85 collected ($8.08)
Seat 3: mitchymitch3 folded before Flop (didn't bet)
Seat 4: Effort92 folded on the Flop
Seat 5: elbiber2000 (button) folded before Flop (didn't bet)
Seat 6: godfrey004 (small blind) folded on the Flop
Seat 7: sanpidk (big blind) folded before Flop
Seat 8: RICKA16 folded before Flop (didn't bet)
Seat 9: matiko09 folded before Flop (didn't bet)





PokerStars Hand #151166499532:  Hold'em No Limit ($1/$2 USD) - 2016/03/30 17:06:30 CET [2016/03/30 11:06:30 ET]
Table 'Jole' 9-max Seat #2 is the button
Seat 1: prominente ($275.74 in chips) 
Seat 2: InsomniaRU ($205.45 in chips) 
Seat 3: tipner ($208.53 in chips) 
Seat 4: GS_Sydney ($129.64 in chips) 
Seat 5: mentalpshyco ($212.77 in chips) 
Seat 6: King_ZéManel ($322.30 in chips) 
Seat 7: thecurv ($210.60 in chips) 
Seat 8: matiko09 ($323.50 in chips) 
Seat 9: RamiroAgujis ($243.76 in chips) 
tipner: posts small blind $1
GS_Sydney: posts big blind $2
*** HOLE CARDS ***
Dealt to matiko09 [9d Th]
mentalpshyco: folds 
King_ZéManel: folds 
thecurv: folds 
matiko09: folds 
RamiroAgujis: folds 
prominente: raises $3 to $5
InsomniaRU: raises $11 to $16
tipner: folds 
GS_Sydney: folds 
prominente: calls $11
*** FLOP *** [6h 6d Td]
prominente: checks 
InsomniaRU: bets $19.28
prominente: calls $19.28
*** TURN *** [6h 6d Td] [Jh]
prominente: checks 
InsomniaRU: bets $41.07
prominente: folds 
Uncalled bet ($41.07) returned to InsomniaRU
InsomniaRU collected $70.81 from pot
InsomniaRU: doesn't show hand 
*** SUMMARY ***
Total pot $73.56 | Rake $2.75 
Board [6h 6d Td Jh]
Seat 1: prominente folded on the Turn
Seat 2: InsomniaRU (button) collected ($70.81)
Seat 3: tipner (small blind) folded before Flop
Seat 4: GS_Sydney (big blind) folded before Flop
Seat 5: mentalpshyco folded before Flop (didn't bet)
Seat 6: King_ZéManel folded before Flop (didn't bet)
Seat 7: thecurv folded before Flop (didn't bet)
Seat 8: matiko09 folded before Flop (didn't bet)
Seat 9: RamiroAgujis folded before Flop (didn't bet)





PokerStars Hand #151166504870:  Hold'em No Limit ($1/$2 USD) - 2016/03/30 17:06:38 CET [2016/03/30 11:06:38 ET]
Table 'Tabit III' 9-max Seat #8 is the button
Seat 1: di0d80 ($236.97 in chips) 
Seat 2: matiko09 ($226.54 in chips) 
Seat 3: prominente ($200 in chips) 
Seat 4: Dykallis ($498.53 in chips) 
Seat 5: itaik1 ($88.24 in chips) 
Seat 6: Igoriah ($200 in chips) 
Seat 7: jannis1951 ($203.18 in chips) 
Seat 8: mentalpshyco ($210.05 in chips) 
Seat 9: suddend3ath ($200 in chips) 
suddend3ath: posts small blind $1
di0d80: posts big blind $2
*** HOLE CARDS ***
Dealt to matiko09 [Kd Qh]
matiko09: raises $3 to $5
prominente: folds 
Dykallis: folds 
itaik1: folds 
Igoriah: folds 
jannis1951: raises $3 to $8
mentalpshyco: folds 
suddend3ath: folds 
di0d80: folds 
matiko09: calls $3
*** FLOP *** [7h Qs 8c]
matiko09: checks 
jannis1951: bets $18.05
matiko09: calls $18.05
*** TURN *** [7h Qs 8c] [Kc]
matiko09: checks 
jannis1951: checks 
*** RIVER *** [7h Qs 8c Kc] [As]
matiko09: bets $36
jannis1951: folds 
Uncalled bet ($36) returned to matiko09
matiko09 collected $52.35 from pot
matiko09: doesn't show hand 
*** SUMMARY ***
Total pot $55.10 | Rake $2.75 
Board [7h Qs 8c Kc As]
Seat 1: di0d80 (big blind) folded before Flop
Seat 2: matiko09 collected ($52.35)
Seat 3: prominente folded before Flop (didn't bet)
Seat 4: Dykallis folded before Flop (didn't bet)
Seat 5: itaik1 folded before Flop (didn't bet)
Seat 6: Igoriah folded before Flop (didn't bet)
Seat 7: jannis1951 folded on the River
Seat 8: mentalpshyco (button) folded before Flop (didn't bet)
Seat 9: suddend3ath (small blind) folded before Flop





PokerStars Hand #151166512468:  Hold'em No Limit ($1/$2 USD) - 2016/03/30 17:06:49 CET [2016/03/30 11:06:49 ET]
Table 'Philoctetes II' 9-max Seat #9 is the button
Seat 1: vezunchik79 ($81.38 in chips) 
Seat 2: prominente ($200 in chips) 
Seat 3: mentalpshyco ($402.05 in chips) 
Seat 5: zhaimeng ($324.75 in chips) 
Seat 6: di0d80 ($200 in chips) 
Seat 7: matiko09 ($200 in chips) 
Seat 8: suddend3ath ($224.60 in chips) 
Seat 9: RamiroAgujis ($252.45 in chips) 
vezunchik79: posts small blind $1
prominente: posts big blind $2
curlwillis: sits out 
*** HOLE CARDS ***
Dealt to matiko09 [9h 6s]
mentalpshyco: folds 
zhaimeng: folds 
di0d80: folds 
matiko09: folds 
suddend3ath: folds 
RamiroAgujis: raises $3 to $5
vezunchik79: folds 
prominente: folds 
Uncalled bet ($3) returned to RamiroAgujis
RamiroAgujis collected $5 from pot
RamiroAgujis: doesn't show hand 
*** SUMMARY ***
Total pot $5 | Rake $0 
Seat 1: vezunchik79 (small blind) folded before Flop
Seat 2: prominente (big blind) folded before Flop
Seat 3: mentalpshyco folded before Flop (didn't bet)
Seat 5: zhaimeng folded before Flop (didn't bet)
Seat 6: di0d80 folded before Flop (didn't bet)
Seat 7: matiko09 folded before Flop (didn't bet)
Seat 8: suddend3ath folded before Flop (didn't bet)
Seat 9: RamiroAgujis (button) collected ($5)





PokerStars Hand #151166529512:  Hold'em No Limit ($0.50/$1.00 USD) - 2016/03/30 17:07:13 CET [2016/03/30 11:07:13 ET]
Table 'Sirona II' 9-max Seat #8 is the button
Seat 1: funXmun ($109.64 in chips) 
Seat 3: claudioneamt ($17.34 in chips) 
Seat 4: RICKA16 ($109.82 in chips) 
Seat 5: bragutza ($281.66 in chips) 
Seat 6: lumen21 ($100 in chips) 
Seat 7: matiko09 ($161.01 in chips) 
Seat 8: sanpidk ($100 in chips) 
Seat 9: mycka86 ($227.60 in chips) 
mycka86: posts small blind $0.50
funXmun: posts big blind $1
Spid1: sits out 
*** HOLE CARDS ***
Dealt to matiko09 [Js Qc]
claudioneamt: folds 
RICKA16: folds 
bragutza: raises $1 to $2
lumen21: folds 
matiko09: folds 
sanpidk: raises $5 to $7
mycka86: folds 
funXmun: folds 
bragutza: calls $5
*** FLOP *** [Kh As Th]
bragutza: checks 
sanpidk: checks 
*** TURN *** [Kh As Th] [8d]
bragutza: bets $7.36
sanpidk: calls $7.36
*** RIVER *** [Kh As Th 8d] [Kc]
bragutza: bets $14.35
sanpidk: calls $14.35
*** SHOW DOWN ***
bragutza: shows [Ks Jh] (three of a kind, Kings)
sanpidk: mucks hand 
bragutza collected $56.42 from pot
*** SUMMARY ***
Total pot $58.92 | Rake $2.50 
Board [Kh As Th 8d Kc]
Seat 1: funXmun (big blind) folded before Flop
Seat 3: claudioneamt folded before Flop (didn't bet)
Seat 4: RICKA16 folded before Flop (didn't bet)
Seat 5: bragutza showed [Ks Jh] and won ($56.42) with three of a kind, Kings
Seat 6: lumen21 folded before Flop (didn't bet)
Seat 7: matiko09 folded before Flop (didn't bet)
Seat 8: sanpidk (button) mucked [7c Ac]
Seat 9: mycka86 (small blind) folded before Flop





PokerStars Hand #151166533583:  Hold'em No Limit ($1/$2 USD) - 2016/03/30 17:07:19 CET [2016/03/30 11:07:19 ET]
Table 'Philoctetes II' 9-max Seat #1 is the button
Seat 1: vezunchik79 ($80.38 in chips) 
Seat 2: prominente ($200 in chips) 
Seat 3: mentalpshyco ($402.05 in chips) 
Seat 5: zhaimeng ($324.75 in chips) 
Seat 6: di0d80 ($200 in chips) 
Seat 7: matiko09 ($200 in chips) 
Seat 8: suddend3ath ($224.60 in chips) 
Seat 9: RamiroAgujis ($255.45 in chips) 
prominente: posts small blind $1
mentalpshyco: posts big blind $2
curlwillis: sits out 
*** HOLE CARDS ***
Dealt to matiko09 [Qd 5d]
zhaimeng: folds 
di0d80: folds 
matiko09: folds 
suddend3ath: folds 
RamiroAgujis: folds 
vezunchik79: raises $2 to $4
prominente: folds 
mentalpshyco: folds 
Uncalled bet ($2) returned to vezunchik79
vezunchik79 collected $5 from pot
vezunchik79: doesn't show hand 
*** SUMMARY ***
Total pot $5 | Rake $0 
Seat 1: vezunchik79 (button) collected ($5)
Seat 2: prominente (small blind) folded before Flop
Seat 3: mentalpshyco (big blind) folded before Flop
Seat 5: zhaimeng folded before Flop (didn't bet)
Seat 6: di0d80 folded before Flop (didn't bet)
Seat 7: matiko09 folded before Flop (didn't bet)
Seat 8: suddend3ath folded before Flop (didn't bet)
Seat 9: RamiroAgujis folded before Flop (didn't bet)





PokerStars Hand #151166547783:  Hold'em No Limit ($0.50/$1.00 USD) - 2016/03/30 17:07:39 CET [2016/03/30 11:07:39 ET]
Table 'Alcor II' 9-max Seat #6 is the button
Seat 1: di0d80 ($115.15 in chips) 
Seat 2: holloway85 ($70.57 in chips) 
Seat 3: mitchymitch3 ($107.91 in chips) 
Seat 4: Effort92 ($196.50 in chips) 
Seat 5: elbiber2000 ($112.08 in chips) 
Seat 6: godfrey004 ($140.07 in chips) 
Seat 7: sanpidk ($110.50 in chips) 
Seat 8: RICKA16 ($283.06 in chips) 
Seat 9: matiko09 ($184.42 in chips) 
sanpidk: posts small blind $0.50
RICKA16: posts big blind $1
*** HOLE CARDS ***
Dealt to matiko09 [9s 8s]
matiko09: raises $2 to $3
di0d80: folds 
holloway85: folds 
mitchymitch3: folds 
Effort92: folds 
elbiber2000: folds 
godfrey004: calls $3
sanpidk: calls $2.50
RICKA16: folds 
*** FLOP *** [3d Jh Jd]
sanpidk: checks 
matiko09: checks 
godfrey004: bets $5
sanpidk: calls $5
matiko09: folds 
*** TURN *** [3d Jh Jd] [8h]
sanpidk: checks 
godfrey004: checks 
*** RIVER *** [3d Jh Jd 8h] [4s]
sanpidk: checks 
godfrey004: bets $6
sanpidk: folds 
Uncalled bet ($6) returned to godfrey004
godfrey004 collected $19 from pot
*** SUMMARY ***
Total pot $20 | Rake $1 
Board [3d Jh Jd 8h 4s]
Seat 1: di0d80 folded before Flop (didn't bet)
Seat 2: holloway85 folded before Flop (didn't bet)
Seat 3: mitchymitch3 folded before Flop (didn't bet)
Seat 4: Effort92 folded before Flop (didn't bet)
Seat 5: elbiber2000 folded before Flop (didn't bet)
Seat 6: godfrey004 (button) collected ($19)
Seat 7: sanpidk (small blind) folded on the River
Seat 8: RICKA16 (big blind) folded before Flop
Seat 9: matiko09 folded on the Flop





PokerStars Hand #151166560296:  Hold'em No Limit ($1/$2 USD) - 2016/03/30 17:07:57 CET [2016/03/30 11:07:57 ET]
Table 'Philoctetes II' 9-max Seat #2 is the button
Seat 1: vezunchik79 ($83.38 in chips) 
Seat 2: prominente ($200 in chips) 
Seat 3: mentalpshyco ($400.05 in chips) 
Seat 4: curlwillis ($89.34 in chips) 
Seat 5: zhaimeng ($324.75 in chips) 
Seat 6: di0d80 ($200 in chips) 
Seat 7: matiko09 ($200 in chips) 
Seat 8: suddend3ath ($224.60 in chips) 
Seat 9: RamiroAgujis ($255.45 in chips) 
mentalpshyco: posts small blind $1
curlwillis: posts big blind $2
*** HOLE CARDS ***
Dealt to matiko09 [Th Ad]
zhaimeng: folds 
di0d80: folds 
matiko09: raises $3 to $5
suddend3ath: folds 
RamiroAgujis: folds 
vezunchik79: calls $5
prominente: folds 
mentalpshyco: folds 
curlwillis: calls $3
*** FLOP *** [4c Qc 6h]
curlwillis: checks 
matiko09: checks 
vezunchik79: bets $15.20
curlwillis: folds 
matiko09: folds 
Uncalled bet ($15.20) returned to vezunchik79
vezunchik79 collected $15.20 from pot
vezunchik79: doesn't show hand 
*** SUMMARY ***
Total pot $16 | Rake $0.80 
Board [4c Qc 6h]
Seat 1: vezunchik79 collected ($15.20)
Seat 2: prominente (button) folded before Flop (didn't bet)
Seat 3: mentalpshyco (small blind) folded before Flop
Seat 4: curlwillis (big blind) folded on the Flop
Seat 5: zhaimeng folded before Flop (didn't bet)
Seat 6: di0d80 folded before Flop (didn't bet)
Seat 7: matiko09 folded on the Flop
Seat 8: suddend3ath folded before Flop (didn't bet)
Seat 9: RamiroAgujis folded before Flop (didn't bet)





PokerStars Hand #151166565848:  Hold'em No Limit ($0.50/$1.00 USD) - 2016/03/30 17:08:05 CET [2016/03/30 11:08:05 ET]
Table 'Hadwiger' 9-max Seat #4 is the button
Seat 1: AKplus ($78.73 in chips) 
Seat 2: di0d80 ($100 in chips) 
Seat 3: yuminyumin1 ($129.77 in chips) 
Seat 4: Westpants ($104.31 in chips) 
Seat 5: ardo888 ($100 in chips) 
Seat 6: xrisall_2 ($157.78 in chips) 
Seat 7: matiko09 ($107.61 in chips) 
Seat 8: Effort92 ($97.50 in chips) 
Seat 9: IdiotFromNE ($105.67 in chips) 
ardo888: posts small blind $0.50
xrisall_2: posts big blind $1
*** HOLE CARDS ***
Dealt to matiko09 [Qh Jc]
matiko09: folds 
Effort92: folds 
IdiotFromNE: folds 
AKplus: folds 
di0d80: folds 
yuminyumin1: calls $1
Westpants: folds 
ardo888: folds 
xrisall_2: checks 
*** FLOP *** [Ad 6d 7c]
xrisall_2: checks 
yuminyumin1: bets $1.50
xrisall_2: calls $1.50
*** TURN *** [Ad 6d 7c] [6s]
xrisall_2: checks 
yuminyumin1: checks 
*** RIVER *** [Ad 6d 7c 6s] [2h]
xrisall_2: bets $7
yuminyumin1: calls $7
*** SHOW DOWN ***
xrisall_2: shows [6c 4c] (three of a kind, Sixes)
yuminyumin1: mucks hand 
xrisall_2 collected $18.52 from pot
*** SUMMARY ***
Total pot $19.50 | Rake $0.98 
Board [Ad 6d 7c 6s 2h]
Seat 1: AKplus folded before Flop (didn't bet)
Seat 2: di0d80 folded before Flop (didn't bet)
Seat 3: yuminyumin1 mucked [9h As]
Seat 4: Westpants (button) folded before Flop (didn't bet)
Seat 5: ardo888 (small blind) folded before Flop
Seat 6: xrisall_2 (big blind) showed [6c 4c] and won ($18.52) with three of a kind, Sixes
Seat 7: matiko09 folded before Flop (didn't bet)
Seat 8: Effort92 folded before Flop (didn't bet)
Seat 9: IdiotFromNE folded before Flop (didn't bet)





PokerStars Hand #151166571438:  Hold'em No Limit (€0.50/€1.00 EUR) - 2016/03/30 17:08:13 CET [2016/03/30 11:08:13 ET]
Table 'Patricia' 9-max Seat #3 is the button
Seat 1: matiko09 (€100 in chips) 
Seat 2: ardo888 (€100 in chips) 
Seat 3: Dachish (€68.50 in chips) 
Seat 4: stonymalony (€92.25 in chips) 
Seat 5: otterlake00 (€46.67 in chips) 
Seat 6: King_ZéManel (€100 in chips) 
Seat 7: Spid1 (€100 in chips) 
Seat 8: Painkiller72 (€100 in chips) 
Seat 9: tipner (€100 in chips) 
stonymalony: posts small blind €0.50
otterlake00: posts big blind €1
*** HOLE CARDS ***
Dealt to matiko09 [8s 8c]
King_ZéManel: raises €2 to €3
Spid1: folds 
Painkiller72: folds 
tipner: folds 
matiko09: calls €3
ardo888: calls €3
Dachish: folds 
stonymalony: calls €2.50
otterlake00: calls €2
*** FLOP *** [2d 9h Kc]
stonymalony: checks 
otterlake00: bets €4
King_ZéManel: folds 
matiko09: folds 
ardo888: folds 
stonymalony: folds 
Uncalled bet (€4) returned to otterlake00
otterlake00 collected €14.25 from pot
otterlake00: doesn't show hand 
*** SUMMARY ***
Total pot €15 | Rake €0.75 
Board [2d 9h Kc]
Seat 1: matiko09 folded on the Flop
Seat 2: ardo888 folded on the Flop
Seat 3: Dachish (button) folded before Flop (didn't bet)
Seat 4: stonymalony (small blind) folded on the Flop
Seat 5: otterlake00 (big blind) collected (€14.25)
Seat 6: King_ZéManel folded on the Flop
Seat 7: Spid1 folded before Flop (didn't bet)
Seat 8: Painkiller72 folded before Flop (didn't bet)
Seat 9: tipner folded before Flop (didn't bet)





PokerStars Hand #151166586492:  Hold'em No Limit ($1/$2 USD) - 2016/03/30 17:08:34 CET [2016/03/30 11:08:34 ET]
Table 'Jole' 9-max Seat #3 is the button
Seat 1: prominente ($240.46 in chips) 
Seat 2: InsomniaRU ($240.98 in chips) 
Seat 3: tipner ($207.53 in chips) 
Seat 4: GS_Sydney ($127.64 in chips) 
Seat 5: mentalpshyco ($212.77 in chips) 
Seat 6: King_ZéManel ($322.30 in chips) 
Seat 7: thecurv ($210.60 in chips) 
Seat 8: matiko09 ($323.50 in chips) 
Seat 9: RamiroAgujis ($243.76 in chips) 
GS_Sydney: posts small blind $1
mentalpshyco: posts big blind $2
*** HOLE CARDS ***
Dealt to matiko09 [4d Qs]
King_ZéManel: folds 
thecurv: calls $2
matiko09: folds 
RamiroAgujis: folds 
prominente: folds 
InsomniaRU: folds 
tipner: folds 
GS_Sydney: calls $1
mentalpshyco: checks 
*** FLOP *** [2s Qc 8d]
GS_Sydney: checks 
mentalpshyco: checks 
thecurv: checks 
*** TURN *** [2s Qc 8d] [Tc]
GS_Sydney: checks 
mentalpshyco: checks 
thecurv: bets $4
GS_Sydney: calls $4
mentalpshyco: folds 
*** RIVER *** [2s Qc 8d Tc] [8s]
GS_Sydney: checks 
thecurv: checks 
*** SHOW DOWN ***
GS_Sydney: shows [8c 9c] (three of a kind, Eights)
thecurv: mucks hand 
GS_Sydney collected $13.30 from pot
*** SUMMARY ***
Total pot $14 | Rake $0.70 
Board [2s Qc 8d Tc 8s]
Seat 1: prominente folded before Flop (didn't bet)
Seat 2: InsomniaRU folded before Flop (didn't bet)
Seat 3: tipner (button) folded before Flop (didn't bet)
Seat 4: GS_Sydney (small blind) showed [8c 9c] and won ($13.30) with three of a kind, Eights
Seat 5: mentalpshyco (big blind) folded on the Turn
Seat 6: King_ZéManel folded before Flop (didn't bet)
Seat 7: thecurv mucked [7c 7h]
Seat 8: matiko09 folded before Flop (didn't bet)
Seat 9: RamiroAgujis folded before Flop (didn't bet)





PokerStars Hand #151166607493:  Hold'em No Limit ($0.50/$1.00 USD) - 2016/03/30 17:09:04 CET [2016/03/30 11:09:04 ET]
Table 'Sirona II' 9-max Seat #9 is the button
Seat 1: funXmun ($108.64 in chips) 
Seat 2: Spid1 ($100 in chips) 
Seat 3: claudioneamt ($17.34 in chips) 
Seat 4: RICKA16 ($109.82 in chips) 
Seat 5: bragutza ($309.37 in chips) 
Seat 6: lumen21 ($100 in chips) 
Seat 7: matiko09 ($161.01 in chips) 
Seat 8: sanpidk ($100 in chips) 
Seat 9: mycka86 ($227.10 in chips) 
funXmun: posts small blind $0.50
Spid1: posts big blind $1
*** HOLE CARDS ***
Dealt to matiko09 [2s 5s]
claudioneamt: folds 
RICKA16: folds 
bragutza: raises $2 to $3
lumen21: folds 
matiko09: folds 
sanpidk: calls $3
mycka86: folds 
funXmun: folds 
Spid1: folds 
*** FLOP *** [As 8c 2h]
bragutza: checks 
sanpidk: checks 
*** TURN *** [As 8c 2h] [8s]
bragutza: bets $3.56
sanpidk: folds 
Uncalled bet ($3.56) returned to bragutza
bragutza collected $7.12 from pot
bragutza: doesn't show hand 
*** SUMMARY ***
Total pot $7.50 | Rake $0.38 
Board [As 8c 2h 8s]
Seat 1: funXmun (small blind) folded before Flop
Seat 2: Spid1 (big blind) folded before Flop
Seat 3: claudioneamt folded before Flop (didn't bet)
Seat 4: RICKA16 folded before Flop (didn't bet)
Seat 5: bragutza collected ($7.12)
Seat 6: lumen21 folded before Flop (didn't bet)
Seat 7: matiko09 folded before Flop (didn't bet)
Seat 8: sanpidk folded on the Turn
Seat 9: mycka86 (button) folded before Flop (didn't bet)





PokerStars Hand #151166608367:  Hold'em No Limit ($1/$2 USD) - 2016/03/30 17:09:05 CET [2016/03/30 11:09:05 ET]
Table 'Philoctetes II' 9-max Seat #3 is the button
Seat 1: vezunchik79 ($93.58 in chips) 
Seat 2: prominente ($200 in chips) 
Seat 3: mentalpshyco ($399.05 in chips) 
Seat 4: curlwillis ($84.34 in chips) 
Seat 6: di0d80 ($200 in chips) 
Seat 7: matiko09 ($200 in chips) 
Seat 8: suddend3ath ($224.60 in chips) 
Seat 9: RamiroAgujis ($255.45 in chips) 
curlwillis: posts small blind $1
di0d80: posts big blind $2
*** HOLE CARDS ***
Dealt to matiko09 [5c 6h]
matiko09: folds 
suddend3ath: folds 
RamiroAgujis: folds 
vezunchik79: folds 
prominente: raises $3 to $5
mentalpshyco: raises $12 to $17
curlwillis: folds 
di0d80: folds 
prominente: calls $12
*** FLOP *** [Ts 9s 7d]
prominente: checks 
mentalpshyco: checks 
*** TURN *** [Ts 9s 7d] [Qs]
prominente: bets $18
mentalpshyco: folds 
Uncalled bet ($18) returned to prominente
prominente collected $35.15 from pot
prominente: doesn't show hand 
*** SUMMARY ***
Total pot $37 | Rake $1.85 
Board [Ts 9s 7d Qs]
Seat 1: vezunchik79 folded before Flop (didn't bet)
Seat 2: prominente collected ($35.15)
Seat 3: mentalpshyco (button) folded on the Turn
Seat 4: curlwillis (small blind) folded before Flop
Seat 6: di0d80 (big blind) folded before Flop
Seat 7: matiko09 folded before Flop (didn't bet)
Seat 8: suddend3ath folded before Flop (didn't bet)
Seat 9: RamiroAgujis folded before Flop (didn't bet)





PokerStars Hand #151166615336:  Hold'em No Limit (€0.50/€1.00 EUR) - 2016/03/30 17:09:15 CET [2016/03/30 11:09:15 ET]
Table 'Patricia' 9-max Seat #4 is the button
Seat 1: matiko09 (€100 in chips) 
Seat 2: ardo888 (€100 in chips) 
Seat 3: Dachish (€68.50 in chips) 
Seat 4: stonymalony (€89.25 in chips) 
Seat 5: otterlake00 (€57.92 in chips) 
Seat 6: King_ZéManel (€100 in chips) 
Seat 7: Spid1 (€100 in chips) 
Seat 8: Painkiller72 (€100 in chips) 
Seat 9: tipner (€100 in chips) 
otterlake00: posts small blind €0.50
King_ZéManel: posts big blind €1
*** HOLE CARDS ***
Dealt to matiko09 [3s 6d]
Spid1: raises €2 to €3
Painkiller72: folds 
tipner: folds 
matiko09: folds 
ardo888: folds 
Dachish: calls €3
stonymalony: folds 
otterlake00: folds 
King_ZéManel: folds 
*** FLOP *** [Ks Js 4d]
Spid1: bets €4.50
Dachish: folds 
Uncalled bet (€4.50) returned to Spid1
Spid1 collected €7.12 from pot
Spid1: doesn't show hand 
*** SUMMARY ***
Total pot €7.50 | Rake €0.38 
Board [Ks Js 4d]
Seat 1: matiko09 folded before Flop (didn't bet)
Seat 2: ardo888 folded before Flop (didn't bet)
Seat 3: Dachish folded on the Flop
Seat 4: stonymalony (button) folded before Flop (didn't bet)
Seat 5: otterlake00 (small blind) folded before Flop
Seat 6: King_ZéManel (big blind) folded before Flop
Seat 7: Spid1 collected (€7.12)
Seat 8: Painkiller72 folded before Flop (didn't bet)
Seat 9: tipner folded before Flop (didn't bet)





PokerStars Hand #151166641931:  Hold'em No Limit ($1/$2 USD) - 2016/03/30 17:09:53 CET [2016/03/30 11:09:53 ET]
Table 'Jole' 9-max Seat #4 is the button
Seat 1: prominente ($240.46 in chips) 
Seat 2: InsomniaRU ($240.98 in chips) 
Seat 3: tipner ($207.53 in chips) 
Seat 4: GS_Sydney ($134.94 in chips) 
Seat 5: mentalpshyco ($210.77 in chips) 
Seat 6: King_ZéManel ($322.30 in chips) 
Seat 7: thecurv ($204.60 in chips) 
Seat 8: matiko09 ($323.50 in chips) 
Seat 9: RamiroAgujis ($243.76 in chips) 
mentalpshyco: posts small blind $1
King_ZéManel: posts big blind $2
*** HOLE CARDS ***
Dealt to matiko09 [7c 3d]
thecurv: folds 
matiko09: folds 
RamiroAgujis: folds 
prominente: folds 
InsomniaRU: folds 
tipner: raises $2 to $4
GS_Sydney: folds 
mentalpshyco: folds 
King_ZéManel: folds 
Uncalled bet ($2) returned to tipner
tipner collected $5 from pot
tipner: doesn't show hand 
*** SUMMARY ***
Total pot $5 | Rake $0 
Seat 1: prominente folded before Flop (didn't bet)
Seat 2: InsomniaRU folded before Flop (didn't bet)
Seat 3: tipner collected ($5)
Seat 4: GS_Sydney (button) folded before Flop (didn't bet)
Seat 5: mentalpshyco (small blind) folded before Flop
Seat 6: King_ZéManel (big blind) folded before Flop
Seat 7: thecurv folded before Flop (didn't bet)
Seat 8: matiko09 folded before Flop (didn't bet)
Seat 9: RamiroAgujis folded before Flop (didn't bet)





PokerStars Hand #151166644866:  Hold'em No Limit (€0.50/€1.00 EUR) - 2016/03/30 17:09:57 CET [2016/03/30 11:09:57 ET]
Table 'Patricia' 9-max Seat #5 is the button
Seat 1: matiko09 (€100 in chips) 
Seat 2: ardo888 (€100 in chips) 
Seat 3: Dachish (€65.50 in chips) 
Seat 4: stonymalony (€89.25 in chips) 
Seat 5: otterlake00 (€57.42 in chips) 
Seat 6: King_ZéManel (€100 in chips) 
Seat 7: Spid1 (€104.12 in chips) 
Seat 8: Painkiller72 (€100 in chips) 
Seat 9: tipner (€100 in chips) 
King_ZéManel: posts small blind €0.50
Spid1: posts big blind €1
*** HOLE CARDS ***
Dealt to matiko09 [3c Kc]
Painkiller72: folds 
tipner: folds 
matiko09: folds 
ardo888: raises €2 to €3
Dachish: folds 
stonymalony: folds 
otterlake00: raises €3 to €6
King_ZéManel: folds 
Spid1: folds 
ardo888: calls €3
*** FLOP *** [9h Qs 9c]
ardo888: checks 
otterlake00: bets €2
ardo888: folds 
Uncalled bet (€2) returned to otterlake00
otterlake00 collected €12.82 from pot
otterlake00: doesn't show hand 
*** SUMMARY ***
Total pot €13.50 | Rake €0.68 
Board [9h Qs 9c]
Seat 1: matiko09 folded before Flop (didn't bet)
Seat 2: ardo888 folded on the Flop
Seat 3: Dachish folded before Flop (didn't bet)
Seat 4: stonymalony folded before Flop (didn't bet)
Seat 5: otterlake00 (button) collected (€12.82)
Seat 6: King_ZéManel (small blind) folded before Flop
Seat 7: Spid1 (big blind) folded before Flop
Seat 8: Painkiller72 folded before Flop (didn't bet)
Seat 9: tipner folded before Flop (didn't bet)





PokerStars Hand #151166661172:  Hold'em No Limit ($0.50/$1.00 USD) - 2016/03/30 17:10:21 CET [2016/03/30 11:10:21 ET]
Table 'Sirona II' 9-max Seat #1 is the button
Seat 1: funXmun ($108.14 in chips) 
Seat 2: Spid1 ($100 in chips) 
Seat 3: claudioneamt ($17.34 in chips) 
Seat 4: RICKA16 ($109.82 in chips) 
Seat 5: bragutza ($313.49 in chips) 
Seat 6: lumen21 ($100 in chips) 
Seat 7: matiko09 ($161.01 in chips) 
Seat 8: sanpidk ($100 in chips) 
Seat 9: mycka86 ($227.10 in chips) 
Spid1: posts small blind $0.50
claudioneamt: posts big blind $1
*** HOLE CARDS ***
Dealt to matiko09 [Td 4d]
RICKA16: folds 
bragutza: folds 
lumen21: raises $2 to $3
matiko09: folds 
sanpidk: folds 
mycka86: calls $3
funXmun: folds 
Spid1: folds 
claudioneamt: folds 
*** FLOP *** [Kd 5c Jd]
lumen21: checks 
mycka86: checks 
*** TURN *** [Kd 5c Jd] [Ac]
lumen21: checks 
mycka86: checks 
*** RIVER *** [Kd 5c Jd Ac] [Ks]
lumen21: checks 
mycka86: checks 
*** SHOW DOWN ***
lumen21: shows [8h 8d] (two pair, Kings and Eights)
mycka86: shows [Jc Qc] (two pair, Kings and Jacks)
mycka86 collected $7.12 from pot
*** SUMMARY ***
Total pot $7.50 | Rake $0.38 
Board [Kd 5c Jd Ac Ks]
Seat 1: funXmun (button) folded before Flop (didn't bet)
Seat 2: Spid1 (small blind) folded before Flop
Seat 3: claudioneamt (big blind) folded before Flop
Seat 4: RICKA16 folded before Flop (didn't bet)
Seat 5: bragutza folded before Flop (didn't bet)
Seat 6: lumen21 showed [8h 8d] and lost with two pair, Kings and Eights
Seat 7: matiko09 folded before Flop (didn't bet)
Seat 8: sanpidk folded before Flop (didn't bet)
Seat 9: mycka86 showed [Jc Qc] and won ($7.12) with two pair, Kings and Jacks





PokerStars Hand #151166667934:  Hold'em No Limit ($1/$2 USD) - 2016/03/30 17:10:30 CET [2016/03/30 11:10:30 ET]
Table 'Jole' 9-max Seat #5 is the button
Seat 1: prominente ($240.46 in chips) 
Seat 2: InsomniaRU ($240.98 in chips) 
Seat 3: tipner ($210.53 in chips) 
Seat 4: GS_Sydney ($134.94 in chips) 
Seat 5: mentalpshyco ($209.77 in chips) 
Seat 6: King_ZéManel ($320.30 in chips) 
Seat 7: thecurv ($204.60 in chips) 
Seat 8: matiko09 ($323.50 in chips) 
Seat 9: RamiroAgujis ($243.76 in chips) 
King_ZéManel: posts small blind $1
thecurv: posts big blind $2
*** HOLE CARDS ***
Dealt to matiko09 [9d Ac]
matiko09: folds 
RamiroAgujis: folds 
prominente: folds 
InsomniaRU: folds 
tipner: folds 
GS_Sydney: calls $2
mentalpshyco: folds 
King_ZéManel: raises $6 to $8
thecurv: folds 
GS_Sydney: calls $6
*** FLOP *** [As 8d Jc]
King_ZéManel: bets $11.39
GS_Sydney: folds 
Uncalled bet ($11.39) returned to King_ZéManel
King_ZéManel collected $17.10 from pot
King_ZéManel: doesn't show hand 
*** SUMMARY ***
Total pot $18 | Rake $0.90 
Board [As 8d Jc]
Seat 1: prominente folded before Flop (didn't bet)
Seat 2: InsomniaRU folded before Flop (didn't bet)
Seat 3: tipner folded before Flop (didn't bet)
Seat 4: GS_Sydney folded on the Flop
Seat 5: mentalpshyco (button) folded before Flop (didn't bet)
Seat 6: King_ZéManel (small blind) collected ($17.10)
Seat 7: thecurv (big blind) folded before Flop
Seat 8: matiko09 folded before Flop (didn't bet)
Seat 9: RamiroAgujis folded before Flop (didn't bet)





PokerStars Hand #151166690449:  Hold'em No Limit (€0.50/€1.00 EUR) - 2016/03/30 17:11:02 CET [2016/03/30 11:11:02 ET]
Table 'Patricia' 9-max Seat #6 is the button
Seat 1: matiko09 (€100 in chips) 
Seat 2: ardo888 (€100 in chips) 
Seat 3: Dachish (€65.50 in chips) 
Seat 4: stonymalony (€89.25 in chips) 
Seat 5: otterlake00 (€64.24 in chips) 
Seat 6: King_ZéManel (€100 in chips) 
Seat 7: Spid1 (€103.12 in chips) 
Seat 8: Painkiller72 (€100 in chips) 
Seat 9: tipner (€100 in chips) 
Spid1: posts small blind €0.50
Painkiller72: posts big blind €1
*** HOLE CARDS ***
Dealt to matiko09 [Ac 5s]
tipner: folds 
matiko09: folds 
ardo888: folds 
Dachish: folds 
stonymalony: raises €2 to €3
otterlake00: raises €2 to €5
King_ZéManel: folds 
Spid1: calls €4.50
Painkiller72: folds 
stonymalony: calls €2
*** FLOP *** [Jd 4s 8c]
Spid1: checks 
stonymalony: checks 
otterlake00: bets €7.60
Spid1: calls €7.60
stonymalony: calls €7.60
*** TURN *** [Jd 4s 8c] [7c]
Spid1: checks 
stonymalony: checks 
otterlake00: checks 
*** RIVER *** [Jd 4s 8c 7c] [7h]
Spid1: bets €27
stonymalony: calls €27
otterlake00: folds 
*** SHOW DOWN ***
Spid1: shows [Jh Jc] (a full house, Jacks full of Sevens)
stonymalony: mucks hand 
Spid1 collected €90.55 from pot
*** SUMMARY ***
Total pot €92.80 | Rake €2.25 
Board [Jd 4s 8c 7c 7h]
Seat 1: matiko09 folded before Flop (didn't bet)
Seat 2: ardo888 folded before Flop (didn't bet)
Seat 3: Dachish folded before Flop (didn't bet)
Seat 4: stonymalony mucked [Js Qs]
Seat 5: otterlake00 folded on the River
Seat 6: King_ZéManel (button) folded before Flop (didn't bet)
Seat 7: Spid1 (small blind) showed [Jh Jc] and won (€90.55) with a full house, Jacks full of Sevens
Seat 8: Painkiller72 (big blind) folded before Flop
Seat 9: tipner folded before Flop (didn't bet)





PokerStars Hand #151166718008:  Hold'em No Limit ($0.50/$1.00 USD) - 2016/03/30 17:11:41 CET [2016/03/30 11:11:41 ET]
Table 'Sirona II' 9-max Seat #2 is the button
Seat 1: funXmun ($108.14 in chips) 
Seat 2: Spid1 ($100 in chips) 
Seat 3: claudioneamt ($16.34 in chips) 
Seat 4: RICKA16 ($109.82 in chips) 
Seat 5: bragutza ($313.49 in chips) 
Seat 6: lumen21 ($100 in chips) 
Seat 7: matiko09 ($161.01 in chips) 
Seat 8: sanpidk ($100 in chips) 
Seat 9: mycka86 ($231.22 in chips) 
claudioneamt: posts small blind $0.50
RICKA16: posts big blind $1
*** HOLE CARDS ***
Dealt to matiko09 [Ad 6h]
bragutza: raises $1 to $2
lumen21: folds 
matiko09: folds 
sanpidk: folds 
mycka86: folds 
funXmun: folds 
Spid1: folds 
claudioneamt: calls $1.50
RICKA16: calls $1
*** FLOP *** [9s 6c Jc]
claudioneamt: checks 
RICKA16: bets $4
bragutza: calls $4
claudioneamt: raises $4 to $8
RICKA16: raises $12 to $20
bragutza: calls $16
claudioneamt: calls $6.34 and is all-in
*** TURN *** [9s 6c Jc] [6s]
RICKA16: bets $25
bragutza: calls $25
*** RIVER *** [9s 6c Jc 6s] [7s]
RICKA16: bets $21
bragutza: raises $74.92 to $95.92
RICKA16: folds 
Uncalled bet ($74.92) returned to bragutza
*** SHOW DOWN ***
bragutza: shows [Tc 8c] (a straight, Seven to Jack)
bragutza collected $103.27 from side pot
claudioneamt: shows [9d 6d] (a full house, Sixes full of Nines)
claudioneamt collected $46.57 from main pot
*** SUMMARY ***
Total pot $152.34 Main pot $46.57. Side pot $103.27. | Rake $2.50 
Board [9s 6c Jc 6s 7s]
Seat 1: funXmun folded before Flop (didn't bet)
Seat 2: Spid1 (button) folded before Flop (didn't bet)
Seat 3: claudioneamt (small blind) showed [9d 6d] and won ($46.57) with a full house, Sixes full of Nines
Seat 4: RICKA16 (big blind) folded on the River
Seat 5: bragutza showed [Tc 8c] and won ($103.27) with a straight, Seven to Jack
Seat 6: lumen21 folded before Flop (didn't bet)
Seat 7: matiko09 folded before Flop (didn't bet)
Seat 8: sanpidk folded before Flop (didn't bet)
Seat 9: mycka86 folded before Flop (didn't bet)





PokerStars Hand #151206651134:  Hold'em No Limit ($0.50/$1.00 USD) - 2016/03/31 11:58:09 CET [2016/03/31 5:58:09 ET]
Table 'Herge II' 9-max Seat #7 is the button
Seat 1: Chiapel ($80 in chips) 
Seat 2: Megaman101 ($100 in chips) 
Seat 3: matiko09 ($100 in chips) 
Seat 4: vrnMike ($100 in chips) 
Seat 5: RICKA16 ($100 in chips) 
Seat 6: masaytoo ($100 in chips) 
Seat 7: Zeeshka ($100 in chips) 
Seat 8: IdiotFromNE ($100 in chips) 
Seat 9: fatstacks122 ($100 in chips) 
IdiotFromNE: posts small blind $0.50
fatstacks122: posts big blind $1
*** HOLE CARDS ***
Dealt to matiko09 [Qh Kh]
Chiapel: folds 
Megaman101: folds 
matiko09: raises $2 to $3
vrnMike: raises $6.50 to $9.50
RICKA16: folds 
masaytoo: folds 
Zeeshka: folds 
IdiotFromNE: folds 
fatstacks122: folds 
matiko09: calls $6.50
*** FLOP *** [6d 3s 4d]
matiko09: checks 
vrnMike: bets $8.50
matiko09: folds 
Uncalled bet ($8.50) returned to vrnMike
vrnMike collected $19.48 from pot
*** SUMMARY ***
Total pot $20.50 | Rake $1.02 
Board [6d 3s 4d]
Seat 1: Chiapel folded before Flop (didn't bet)
Seat 2: Megaman101 folded before Flop (didn't bet)
Seat 3: matiko09 folded on the Flop
Seat 4: vrnMike collected ($19.48)
Seat 5: RICKA16 folded before Flop (didn't bet)
Seat 6: masaytoo folded before Flop (didn't bet)
Seat 7: Zeeshka (button) folded before Flop (didn't bet)
Seat 8: IdiotFromNE (small blind) folded before Flop
Seat 9: fatstacks122 (big blind) folded before Flop





PokerStars Hand #151206691032:  Hold'em No Limit ($0.50/$1.00 USD) - 2016/03/31 11:59:52 CET [2016/03/31 5:59:52 ET]
Table 'Herge II' 9-max Seat #8 is the button
Seat 1: Chiapel ($80 in chips) 
Seat 2: Megaman101 ($100 in chips) 
Seat 3: matiko09 ($100 in chips) 
Seat 4: vrnMike ($109.98 in chips) 
Seat 5: RICKA16 ($100 in chips) 
Seat 6: masaytoo ($100 in chips) 
Seat 7: Zeeshka ($100 in chips) 
Seat 8: IdiotFromNE ($100 in chips) 
Seat 9: fatstacks122 ($99 in chips) 
fatstacks122: posts small blind $0.50
Chiapel: posts big blind $1
*** HOLE CARDS ***
Dealt to matiko09 [2d Kh]
Megaman101: folds 
matiko09: folds 
vrnMike: folds 
RICKA16: folds 
masaytoo: folds 
Zeeshka: folds 
IdiotFromNE: folds 
fatstacks122: folds 
Uncalled bet ($0.50) returned to Chiapel
Chiapel collected $1 from pot
Chiapel: doesn't show hand 
*** SUMMARY ***
Total pot $1 | Rake $0 
Seat 1: Chiapel (big blind) collected ($1)
Seat 2: Megaman101 folded before Flop (didn't bet)
Seat 3: matiko09 folded before Flop (didn't bet)
Seat 4: vrnMike folded before Flop (didn't bet)
Seat 5: RICKA16 folded before Flop (didn't bet)
Seat 6: masaytoo folded before Flop (didn't bet)
Seat 7: Zeeshka folded before Flop (didn't bet)
Seat 8: IdiotFromNE (button) folded before Flop (didn't bet)
Seat 9: fatstacks122 (small blind) folded before Flop





PokerStars Hand #151206691706:  Hold'em No Limit ($1/$2 USD) - 2016/03/31 11:59:54 CET [2016/03/31 5:59:54 ET]
Table 'Desiderata' 9-max Seat #2 is the button
Seat 1: GALWACONT ($84.80 in chips) 
Seat 2: ilaviiitech ($200 in chips) 
Seat 3: InsomniaRU ($318.87 in chips) 
Seat 4: matiko09 ($200 in chips) 
Seat 5: Kreuznagel ($337.24 in chips) 
Seat 7: pulykakakas ($178.04 in chips) 
InsomniaRU: posts small blind $1
matiko09: posts big blind $2
rmanjkeee: sits out 
DUkalisUA: sits out 
Painkiller72: sits out 
*** HOLE CARDS ***
Dealt to matiko09 [Jh 5c]
Kreuznagel: folds 
pulykakakas: folds 
GALWACONT: raises $5 to $7
ilaviiitech: folds 
InsomniaRU: folds 
matiko09: folds 
Uncalled bet ($5) returned to GALWACONT
GALWACONT collected $5 from pot
GALWACONT: doesn't show hand 
*** SUMMARY ***
Total pot $5 | Rake $0 
Seat 1: GALWACONT collected ($5)
Seat 2: ilaviiitech (button) folded before Flop (didn't bet)
Seat 3: InsomniaRU (small blind) folded before Flop
Seat 4: matiko09 (big blind) folded before Flop
Seat 5: Kreuznagel folded before Flop (didn't bet)
Seat 7: pulykakakas folded before Flop (didn't bet)





PokerStars Hand #151206700635:  Hold'em No Limit ($0.50/$1.00 USD) - 2016/03/31 12:00:15 CET [2016/03/31 6:00:15 ET]
Table 'Herge II' 9-max Seat #9 is the button
Seat 1: Chiapel ($80.50 in chips) 
Seat 2: Megaman101 ($100 in chips) 
Seat 3: matiko09 ($100 in chips) 
Seat 4: vrnMike ($109.98 in chips) 
Seat 5: RICKA16 ($100 in chips) 
Seat 6: masaytoo ($100 in chips) 
Seat 7: Zeeshka ($100 in chips) 
Seat 8: IdiotFromNE ($100 in chips) 
Seat 9: fatstacks122 ($98.50 in chips) 
Chiapel: posts small blind $0.50
Megaman101: posts big blind $1
*** HOLE CARDS ***
Dealt to matiko09 [Td Kd]
matiko09: raises $2 to $3
vrnMike: folds 
RICKA16: folds 
masaytoo: calls $3
Zeeshka: folds 
IdiotFromNE: folds 
fatstacks122: calls $3
Chiapel: calls $2.50
Megaman101: calls $2
*** FLOP *** [7s Qc 7h]
Chiapel: checks 
Megaman101: checks 
matiko09: checks 
masaytoo: checks 
fatstacks122: checks 
*** TURN *** [7s Qc 7h] [5d]
Chiapel: checks 
Megaman101: checks 
matiko09: checks 
masaytoo: bets $7.77
fatstacks122: folds 
Chiapel: folds 
Megaman101: folds 
matiko09: folds 
Uncalled bet ($7.77) returned to masaytoo
masaytoo collected $14.25 from pot
masaytoo: doesn't show hand 
*** SUMMARY ***
Total pot $15 | Rake $0.75 
Board [7s Qc 7h 5d]
Seat 1: Chiapel (small blind) folded on the Turn
Seat 2: Megaman101 (big blind) folded on the Turn
Seat 3: matiko09 folded on the Turn
Seat 4: vrnMike folded before Flop (didn't bet)
Seat 5: RICKA16 folded before Flop (didn't bet)
Seat 6: masaytoo collected ($14.25)
Seat 7: Zeeshka folded before Flop (didn't bet)
Seat 8: IdiotFromNE folded before Flop (didn't bet)
Seat 9: fatstacks122 (button) folded on the Turn





PokerStars Hand #151206704951:  Hold'em No Limit ($1/$2 USD) - 2016/03/31 12:00:26 CET [2016/03/31 6:00:26 ET]
Table 'Desiderata' 9-max Seat #3 is the button
Seat 1: GALWACONT ($87.80 in chips) 
Seat 2: ilaviiitech ($200 in chips) 
Seat 3: InsomniaRU ($317.87 in chips) 
Seat 4: matiko09 ($200 in chips) 
Seat 5: Kreuznagel ($337.24 in chips) 
Seat 7: pulykakakas ($178.04 in chips) 
matiko09: posts small blind $1
Kreuznagel: posts big blind $2
rmanjkeee: sits out 
DUkalisUA: sits out 
Painkiller72: sits out 
*** HOLE CARDS ***
Dealt to matiko09 [5h Th]
pulykakakas: folds 
GALWACONT: raises $5 to $7
ilaviiitech: folds 
InsomniaRU: folds 
matiko09: folds 
Kreuznagel: folds 
Uncalled bet ($5) returned to GALWACONT
GALWACONT collected $5 from pot
GALWACONT: doesn't show hand 
*** SUMMARY ***
Total pot $5 | Rake $0 
Seat 1: GALWACONT collected ($5)
Seat 2: ilaviiitech folded before Flop (didn't bet)
Seat 3: InsomniaRU (button) folded before Flop (didn't bet)
Seat 4: matiko09 (small blind) folded before Flop
Seat 5: Kreuznagel (big blind) folded before Flop
Seat 7: pulykakakas folded before Flop (didn't bet)





PokerStars Hand #151206705280:  Hold'em No Limit (€0.50/€1.00 EUR) - 2016/03/31 12:00:27 CET [2016/03/31 6:00:27 ET]
Table 'Pioneer II' 9-max Seat #4 is the button
Seat 1: Kreuznagel (€108.72 in chips) 
Seat 3: vrnMike (€102.39 in chips) 
Seat 4: Zeeshka (€100 in chips) 
Seat 5: MickChick24 (€126.44 in chips) 
Seat 6: matiko09 (€100 in chips) 
Seat 7: AlKatrone (€121.17 in chips) 
Seat 8: Painkiller72 (€132.08 in chips) 
Seat 9: ardo888 (€114.03 in chips) 
MickChick24: posts small blind €0.50
matiko09: posts big blind €1
IdiotFromNE: sits out 
*** HOLE CARDS ***
Dealt to matiko09 [Ad 3s]
AlKatrone has timed out
AlKatrone: folds 
Painkiller72: folds 
ardo888: folds 
Kreuznagel: folds 
vrnMike: folds 
Zeeshka: folds 
MickChick24: folds 
Uncalled bet (€0.50) returned to matiko09
matiko09 collected €1 from pot
matiko09: doesn't show hand 
*** SUMMARY ***
Total pot €1 | Rake €0 
Seat 1: Kreuznagel folded before Flop (didn't bet)
Seat 3: vrnMike folded before Flop (didn't bet)
Seat 4: Zeeshka (button) folded before Flop (didn't bet)
Seat 5: MickChick24 (small blind) folded before Flop
Seat 6: matiko09 (big blind) collected (€1)
Seat 7: AlKatrone folded before Flop (didn't bet)
Seat 8: Painkiller72 folded before Flop (didn't bet)
Seat 9: ardo888 folded before Flop (didn't bet)





PokerStars Hand #151206715460:  Hold'em No Limit ($1/$2 USD) - 2016/03/31 12:00:51 CET [2016/03/31 6:00:51 ET]
Table 'Desiderata' 9-max Seat #4 is the button
Seat 1: GALWACONT ($90.80 in chips) 
Seat 2: ilaviiitech ($200 in chips) 
Seat 3: InsomniaRU ($317.87 in chips) 
Seat 4: matiko09 ($200 in chips) 
Seat 5: Kreuznagel ($335.24 in chips) 
Seat 6: rmanjkeee ($105.75 in chips) 
Seat 7: pulykakakas ($178.04 in chips) 
Kreuznagel: posts small blind $1
rmanjkeee: posts big blind $2
DUkalisUA: sits out 
Painkiller72: sits out 
*** HOLE CARDS ***
Dealt to matiko09 [Ks 5d]
pulykakakas: folds 
GALWACONT: folds 
ilaviiitech: folds 
InsomniaRU: folds 
matiko09: folds 
Kreuznagel: folds 
Uncalled bet ($1) returned to rmanjkeee
rmanjkeee collected $2 from pot
rmanjkeee: doesn't show hand 
*** SUMMARY ***
Total pot $2 | Rake $0 
Seat 1: GALWACONT folded before Flop (didn't bet)
Seat 2: ilaviiitech folded before Flop (didn't bet)
Seat 3: InsomniaRU folded before Flop (didn't bet)
Seat 4: matiko09 (button) folded before Flop (didn't bet)
Seat 5: Kreuznagel (small blind) folded before Flop
Seat 6: rmanjkeee (big blind) collected ($2)
Seat 7: pulykakakas folded before Flop (didn't bet)





PokerStars Hand #151206729683:  Hold'em No Limit (€0.50/€1.00 EUR) - 2016/03/31 12:01:24 CET [2016/03/31 6:01:24 ET]
Table 'Pioneer II' 9-max Seat #5 is the button
Seat 1: Kreuznagel (€108.72 in chips) 
Seat 3: vrnMike (€102.39 in chips) 
Seat 4: Zeeshka (€100 in chips) 
Seat 5: MickChick24 (€125.94 in chips) 
Seat 6: matiko09 (€100.50 in chips) 
Seat 8: Painkiller72 (€132.08 in chips) 
Seat 9: ardo888 (€114.03 in chips) 
matiko09: posts small blind €0.50
Painkiller72: posts big blind €1
IdiotFromNE: sits out 
*** HOLE CARDS ***
Dealt to matiko09 [Ks 6h]
ardo888: folds 
Kreuznagel: folds 
vrnMike: raises €1 to €2
Zeeshka: folds 
MickChick24: folds 
matiko09: folds 
Painkiller72: folds 
Uncalled bet (€1) returned to vrnMike
vrnMike collected €2.50 from pot
*** SUMMARY ***
Total pot €2.50 | Rake €0 
Seat 1: Kreuznagel folded before Flop (didn't bet)
Seat 3: vrnMike collected (€2.50)
Seat 4: Zeeshka folded before Flop (didn't bet)
Seat 5: MickChick24 (button) folded before Flop (didn't bet)
Seat 6: matiko09 (small blind) folded before Flop
Seat 8: Painkiller72 (big blind) folded before Flop
Seat 9: ardo888 folded before Flop (didn't bet)





PokerStars Hand #151206729690:  Hold'em No Limit ($1/$2 USD) - 2016/03/31 12:01:24 CET [2016/03/31 6:01:24 ET]
Table 'Desiderata' 9-max Seat #5 is the button
Seat 1: GALWACONT ($90.80 in chips) 
Seat 2: ilaviiitech ($200 in chips) 
Seat 3: InsomniaRU ($317.87 in chips) 
Seat 4: matiko09 ($200 in chips) 
Seat 5: Kreuznagel ($334.24 in chips) 
Seat 6: rmanjkeee ($106.75 in chips) 
Seat 7: pulykakakas ($178.04 in chips) 
rmanjkeee: posts small blind $1
pulykakakas: posts big blind $2
DUkalisUA: sits out 
Painkiller72: sits out 
*** HOLE CARDS ***
Dealt to matiko09 [5c 2h]
GALWACONT: calls $2
ilaviiitech: folds 
InsomniaRU: folds 
matiko09: folds 
Kreuznagel: calls $2
rmanjkeee: folds 
pulykakakas: checks 
*** FLOP *** [4d 6c Kd]
pulykakakas: checks 
GALWACONT: bets $6.65
Kreuznagel: folds 
pulykakakas: folds 
Uncalled bet ($6.65) returned to GALWACONT
GALWACONT collected $6.65 from pot
GALWACONT: doesn't show hand 
*** SUMMARY ***
Total pot $7 | Rake $0.35 
Board [4d 6c Kd]
Seat 1: GALWACONT collected ($6.65)
Seat 2: ilaviiitech folded before Flop (didn't bet)
Seat 3: InsomniaRU folded before Flop (didn't bet)
Seat 4: matiko09 folded before Flop (didn't bet)
Seat 5: Kreuznagel (button) folded on the Flop
Seat 6: rmanjkeee (small blind) folded before Flop
Seat 7: pulykakakas (big blind) folded on the Flop





PokerStars Hand #151206735934:  Hold'em No Limit (€0.50/€1.00 EUR) - 2016/03/31 12:01:39 CET [2016/03/31 6:01:39 ET]
Table 'Pioneer II' 9-max Seat #6 is the button
Seat 1: Kreuznagel (€108.72 in chips) 
Seat 3: vrnMike (€103.89 in chips) 
Seat 4: Zeeshka (€100 in chips) 
Seat 5: MickChick24 (€125.94 in chips) 
Seat 6: matiko09 (€100 in chips) 
Seat 8: Painkiller72 (€131.08 in chips) 
Seat 9: ardo888 (€114.03 in chips) 
Painkiller72: posts small blind €0.50
ardo888: posts big blind €1
IdiotFromNE: sits out 
*** HOLE CARDS ***
Dealt to matiko09 [Js Td]
Kreuznagel: raises €1.39 to €2.39
vrnMike: folds 
Zeeshka: folds 
MickChick24: folds 
matiko09: folds 
Painkiller72: folds 
ardo888: folds 
Uncalled bet (€1.39) returned to Kreuznagel
Kreuznagel collected €2.50 from pot
Kreuznagel: doesn't show hand 
*** SUMMARY ***
Total pot €2.50 | Rake €0 
Seat 1: Kreuznagel collected (€2.50)
Seat 3: vrnMike folded before Flop (didn't bet)
Seat 4: Zeeshka folded before Flop (didn't bet)
Seat 5: MickChick24 folded before Flop (didn't bet)
Seat 6: matiko09 (button) folded before Flop (didn't bet)
Seat 8: Painkiller72 (small blind) folded before Flop
Seat 9: ardo888 (big blind) folded before Flop





PokerStars Hand #151206737823:  Hold'em No Limit ($0.50/$1.00 USD) - 2016/03/31 12:01:43 CET [2016/03/31 6:01:43 ET]
Table 'Herge II' 9-max Seat #1 is the button
Seat 1: Chiapel ($77.50 in chips) 
Seat 2: Megaman101 ($97 in chips) 
Seat 3: matiko09 ($100 in chips) 
Seat 4: vrnMike ($109.98 in chips) 
Seat 5: RICKA16 ($100 in chips) 
Seat 6: masaytoo ($111.25 in chips) 
Seat 7: Zeeshka ($100 in chips) 
Seat 8: IdiotFromNE ($100 in chips) 
Megaman101: posts small blind $0.50
matiko09: posts big blind $1
*** HOLE CARDS ***
Dealt to matiko09 [2h 6h]
vrnMike: folds 
RICKA16: folds 
masaytoo: folds 
Zeeshka: raises $2 to $3
IdiotFromNE: folds 
Chiapel: folds 
Megaman101: calls $2.50
matiko09: folds 
*** FLOP *** [7s 9d Ac]
Megaman101: checks 
Zeeshka: checks 
*** TURN *** [7s 9d Ac] [Kc]
Megaman101: bets $3.32
Zeeshka: calls $3.32
*** RIVER *** [7s 9d Ac Kc] [Qh]
Megaman101: checks 
Zeeshka: bets $8.68
Megaman101: folds 
Uncalled bet ($8.68) returned to Zeeshka
Zeeshka collected $12.96 from pot
Zeeshka: doesn't show hand 
*** SUMMARY ***
Total pot $13.64 | Rake $0.68 
Board [7s 9d Ac Kc Qh]
Seat 1: Chiapel (button) folded before Flop (didn't bet)
Seat 2: Megaman101 (small blind) folded on the River
Seat 3: matiko09 (big blind) folded before Flop
Seat 4: vrnMike folded before Flop (didn't bet)
Seat 5: RICKA16 folded before Flop (didn't bet)
Seat 6: masaytoo folded before Flop (didn't bet)
Seat 7: Zeeshka collected ($12.96)
Seat 8: IdiotFromNE folded before Flop (didn't bet)





PokerStars Hand #151206748510:  Hold'em No Limit ($1/$2 USD) - 2016/03/31 12:02:08 CET [2016/03/31 6:02:08 ET]
Table 'Desiderata' 9-max Seat #6 is the button
Seat 1: GALWACONT ($95.45 in chips) 
Seat 2: ilaviiitech ($200 in chips) 
Seat 3: InsomniaRU ($317.87 in chips) 
Seat 4: matiko09 ($200 in chips) 
Seat 5: Kreuznagel ($332.24 in chips) 
Seat 6: rmanjkeee ($105.75 in chips) 
Seat 7: pulykakakas ($176.04 in chips) 
Seat 8: DUkalisUA ($200 in chips) 
pulykakakas: posts small blind $1
DUkalisUA: posts big blind $2
Painkiller72: sits out 
*** HOLE CARDS ***
Dealt to matiko09 [Qs Td]
GALWACONT: calls $2
ilaviiitech: folds 
InsomniaRU: folds 
matiko09: raises $6 to $8
Kreuznagel: folds 
rmanjkeee: folds 
pulykakakas: folds 
DUkalisUA: folds 
GALWACONT: calls $6
*** FLOP *** [7h 8h Ah]
GALWACONT: checks 
matiko09: checks 
*** TURN *** [7h 8h Ah] [Jc]
GALWACONT: checks 
matiko09: checks 
*** RIVER *** [7h 8h Ah Jc] [3d]
GALWACONT: bets $18.05
matiko09: folds 
Uncalled bet ($18.05) returned to GALWACONT
GALWACONT collected $18.05 from pot
GALWACONT: doesn't show hand 
*** SUMMARY ***
Total pot $19 | Rake $0.95 
Board [7h 8h Ah Jc 3d]
Seat 1: GALWACONT collected ($18.05)
Seat 2: ilaviiitech folded before Flop (didn't bet)
Seat 3: InsomniaRU folded before Flop (didn't bet)
Seat 4: matiko09 folded on the River
Seat 5: Kreuznagel folded before Flop (didn't bet)
Seat 6: rmanjkeee (button) folded before Flop (didn't bet)
Seat 7: pulykakakas (small blind) folded before Flop
Seat 8: DUkalisUA (big blind) folded before Flop





PokerStars Hand #151206751912:  Hold'em No Limit (€0.50/€1.00 EUR) - 2016/03/31 12:02:15 CET [2016/03/31 6:02:15 ET]
Table 'Pioneer II' 9-max Seat #8 is the button
Seat 1: Kreuznagel (€110.22 in chips) 
Seat 3: vrnMike (€103.89 in chips) 
Seat 4: Zeeshka (€100 in chips) 
Seat 5: MickChick24 (€125.94 in chips) 
Seat 6: matiko09 (€100 in chips) 
Seat 8: Painkiller72 (€130.58 in chips) 
Seat 9: ardo888 (€113.03 in chips) 
ardo888: posts small blind €0.50
Kreuznagel: posts big blind €1
IdiotFromNE: sits out 
*** HOLE CARDS ***
Dealt to matiko09 [4h Jc]
vrnMike: folds 
Zeeshka: folds 
MickChick24: folds 
matiko09: folds 
Painkiller72: raises €1 to €2
ardo888: folds 
Kreuznagel: calls €1
*** FLOP *** [Qc 5h 4c]
Kreuznagel: checks 
Painkiller72: bets €2.99
Kreuznagel: calls €2.99
*** TURN *** [Qc 5h 4c] [Js]
Kreuznagel: checks 
Painkiller72: checks 
*** RIVER *** [Qc 5h 4c Js] [3c]
Kreuznagel: checks 
Painkiller72: checks 
*** SHOW DOWN ***
Kreuznagel: shows [7h 5s] (a pair of Fives)
Painkiller72: shows [8h Jh] (a pair of Jacks)
Painkiller72 collected €9.96 from pot
*** SUMMARY ***
Total pot €10.48 | Rake €0.52 
Board [Qc 5h 4c Js 3c]
Seat 1: Kreuznagel (big blind) showed [7h 5s] and lost with a pair of Fives
Seat 3: vrnMike folded before Flop (didn't bet)
Seat 4: Zeeshka folded before Flop (didn't bet)
Seat 5: MickChick24 folded before Flop (didn't bet)
Seat 6: matiko09 folded before Flop (didn't bet)
Seat 8: Painkiller72 (button) showed [8h Jh] and won (€9.96) with a pair of Jacks
Seat 9: ardo888 (small blind) folded before Flop





PokerStars Hand #151206757870:  Hold'em No Limit ($0.50/$1.00 USD) - 2016/03/31 12:02:29 CET [2016/03/31 6:02:29 ET]
Table 'Herge II' 9-max Seat #2 is the button
Seat 1: Chiapel ($77.50 in chips) 
Seat 2: Megaman101 ($90.68 in chips) 
Seat 3: matiko09 ($100 in chips) 
Seat 4: vrnMike ($109.98 in chips) 
Seat 5: RICKA16 ($100 in chips) 
Seat 6: masaytoo ($111.25 in chips) 
Seat 7: Zeeshka ($106.64 in chips) 
Seat 8: IdiotFromNE ($100 in chips) 
matiko09: posts small blind $0.50
vrnMike: posts big blind $1
*** HOLE CARDS ***
Dealt to matiko09 [Qc 2d]
RICKA16: folds 
masaytoo: folds 
RICKA16 leaves the table
Zeeshka: folds 
IdiotFromNE: folds 
Chiapel: folds 
Megaman101: folds 
matiko09: folds 
Uncalled bet ($0.50) returned to vrnMike
vrnMike collected $1 from pot
*** SUMMARY ***
Total pot $1 | Rake $0 
Seat 1: Chiapel folded before Flop (didn't bet)
Seat 2: Megaman101 (button) folded before Flop (didn't bet)
Seat 3: matiko09 (small blind) folded before Flop
Seat 4: vrnMike (big blind) collected ($1)
Seat 5: RICKA16 folded before Flop (didn't bet)
Seat 6: masaytoo folded before Flop (didn't bet)
Seat 7: Zeeshka folded before Flop (didn't bet)
Seat 8: IdiotFromNE folded before Flop (didn't bet)





PokerStars Hand #151206763076:  Hold'em No Limit ($1/$2 USD) - 2016/03/31 12:02:41 CET [2016/03/31 6:02:41 ET]
Table 'Desiderata' 9-max Seat #7 is the button
Seat 1: GALWACONT ($105.50 in chips) 
Seat 2: ilaviiitech ($200 in chips) 
Seat 3: InsomniaRU ($317.87 in chips) 
Seat 4: matiko09 ($200 in chips) 
Seat 5: Kreuznagel ($332.24 in chips) 
Seat 6: rmanjkeee ($105.75 in chips) 
Seat 7: pulykakakas ($175.04 in chips) 
Seat 8: DUkalisUA ($200 in chips) 
Seat 9: Painkiller72 ($200 in chips) 
DUkalisUA: posts small blind $1
Painkiller72: posts big blind $2
*** HOLE CARDS ***
Dealt to matiko09 [Kd Ad]
GALWACONT: folds 
ilaviiitech: folds 
InsomniaRU: folds 
matiko09: raises $3 to $5
Kreuznagel: folds 
rmanjkeee: folds 
pulykakakas: folds 
DUkalisUA: folds 
Painkiller72: folds 
Uncalled bet ($3) returned to matiko09
matiko09 collected $5 from pot
matiko09: doesn't show hand 
*** SUMMARY ***
Total pot $5 | Rake $0 
Seat 1: GALWACONT folded before Flop (didn't bet)
Seat 2: ilaviiitech folded before Flop (didn't bet)
Seat 3: InsomniaRU folded before Flop (didn't bet)
Seat 4: matiko09 collected ($5)
Seat 5: Kreuznagel folded before Flop (didn't bet)
Seat 6: rmanjkeee folded before Flop (didn't bet)
Seat 7: pulykakakas (button) folded before Flop (didn't bet)
Seat 8: DUkalisUA (small blind) folded before Flop
Seat 9: Painkiller72 (big blind) folded before Flop





PokerStars Hand #151206767288:  Hold'em No Limit ($0.50/$1.00 USD) - 2016/03/31 12:02:51 CET [2016/03/31 6:02:51 ET]
Table 'Herge II' 9-max Seat #3 is the button
Seat 1: Chiapel ($77.50 in chips) 
Seat 2: Megaman101 ($90.68 in chips) 
Seat 3: matiko09 ($100 in chips) 
Seat 4: vrnMike ($110.48 in chips) 
Seat 6: masaytoo ($111.25 in chips) 
Seat 7: Zeeshka ($106.64 in chips) 
Seat 8: IdiotFromNE ($100 in chips) 
vrnMike: posts small blind $0.50
masaytoo: posts big blind $1
*** HOLE CARDS ***
Dealt to matiko09 [7c 8s]
Zeeshka: folds 
IdiotFromNE: folds 
Chiapel: folds 
Megaman101: folds 
matiko09: folds 
I The King I joins the table at seat #5 
vrnMike: raises $2 to $3
masaytoo: folds 
Uncalled bet ($2) returned to vrnMike
vrnMike collected $2 from pot
*** SUMMARY ***
Total pot $2 | Rake $0 
Seat 1: Chiapel folded before Flop (didn't bet)
Seat 2: Megaman101 folded before Flop (didn't bet)
Seat 3: matiko09 (button) folded before Flop (didn't bet)
Seat 4: vrnMike (small blind) collected ($2)
Seat 6: masaytoo (big blind) folded before Flop
Seat 7: Zeeshka folded before Flop (didn't bet)
Seat 8: IdiotFromNE folded before Flop (didn't bet)





PokerStars Hand #151206773303:  Hold'em No Limit ($1/$2 USD) - 2016/03/31 12:03:04 CET [2016/03/31 6:03:04 ET]
Table 'Desiderata' 9-max Seat #8 is the button
Seat 1: GALWACONT ($105.50 in chips) 
Seat 2: ilaviiitech ($200 in chips) 
Seat 3: InsomniaRU ($317.87 in chips) 
Seat 4: matiko09 ($203 in chips) 
Seat 5: Kreuznagel ($332.24 in chips) 
Seat 6: rmanjkeee ($105.75 in chips) 
Seat 7: pulykakakas ($175.04 in chips) 
Seat 8: DUkalisUA ($200 in chips) 
Seat 9: Painkiller72 ($200 in chips) 
Painkiller72: posts small blind $1
GALWACONT: posts big blind $2
*** HOLE CARDS ***
Dealt to matiko09 [As 9d]
ilaviiitech: folds 
InsomniaRU: folds 
matiko09: folds 
Kreuznagel: folds 
rmanjkeee: folds 
pulykakakas: folds 
DUkalisUA: raises $2 to $4
Painkiller72: folds 
GALWACONT: calls $2
*** FLOP *** [Qs 5s Jd]
GALWACONT: checks 
DUkalisUA: bets $5
GALWACONT: folds 
Uncalled bet ($5) returned to DUkalisUA
DUkalisUA collected $8.55 from pot
DUkalisUA: doesn't show hand 
*** SUMMARY ***
Total pot $9 | Rake $0.45 
Board [Qs 5s Jd]
Seat 1: GALWACONT (big blind) folded on the Flop
Seat 2: ilaviiitech folded before Flop (didn't bet)
Seat 3: InsomniaRU folded before Flop (didn't bet)
Seat 4: matiko09 folded before Flop (didn't bet)
Seat 5: Kreuznagel folded before Flop (didn't bet)
Seat 6: rmanjkeee folded before Flop (didn't bet)
Seat 7: pulykakakas folded before Flop (didn't bet)
Seat 8: DUkalisUA (button) collected ($8.55)
Seat 9: Painkiller72 (small blind) folded before Flop





PokerStars Hand #151206781319:  Hold'em No Limit ($0.50/$1.00 USD) - 2016/03/31 12:03:23 CET [2016/03/31 6:03:23 ET]
Table 'Herge II' 9-max Seat #4 is the button
Seat 1: Chiapel ($77.50 in chips) 
Seat 2: Megaman101 ($90.68 in chips) 
Seat 3: matiko09 ($100 in chips) 
Seat 4: vrnMike ($111.48 in chips) 
Seat 6: masaytoo ($110.25 in chips) 
Seat 7: Zeeshka ($106.64 in chips) 
Seat 8: IdiotFromNE ($100 in chips) 
I The King I will be allowed to play after the button
masaytoo: posts small blind $0.50
Zeeshka: posts big blind $1
*** HOLE CARDS ***
Dealt to matiko09 [Ah 7h]
IdiotFromNE: folds 
Chiapel: folds 
Megaman101: folds 
matiko09: raises $1.50 to $2.50
vrnMike: folds 
masaytoo: folds 
Zeeshka: folds 
Uncalled bet ($1.50) returned to matiko09
matiko09 collected $2.50 from pot
matiko09: doesn't show hand 
*** SUMMARY ***
Total pot $2.50 | Rake $0 
Seat 1: Chiapel folded before Flop (didn't bet)
Seat 2: Megaman101 folded before Flop (didn't bet)
Seat 3: matiko09 collected ($2.50)
Seat 4: vrnMike (button) folded before Flop (didn't bet)
Seat 6: masaytoo (small blind) folded before Flop
Seat 7: Zeeshka (big blind) folded before Flop
Seat 8: IdiotFromNE folded before Flop (didn't bet)





PokerStars Hand #151206787090:  Hold'em No Limit (€0.50/€1.00 EUR) - 2016/03/31 12:03:36 CET [2016/03/31 6:03:36 ET]
Table 'Pioneer II' 9-max Seat #9 is the button
Seat 1: Kreuznagel (€105.23 in chips) 
Seat 2: IdiotFromNE (€100 in chips) 
Seat 3: vrnMike (€103.89 in chips) 
Seat 4: Zeeshka (€100 in chips) 
Seat 5: MickChick24 (€125.94 in chips) 
Seat 6: matiko09 (€100 in chips) 
Seat 8: Painkiller72 (€135.55 in chips) 
Seat 9: ardo888 (€112.53 in chips) 
Kreuznagel: posts small blind €0.50
IdiotFromNE: posts big blind €1
AlKatrone: sits out 
*** HOLE CARDS ***
Dealt to matiko09 [Qd 7s]
vrnMike: folds 
Zeeshka: folds 
MickChick24: folds 
matiko09: folds 
Painkiller72: folds 
ardo888: raises €1.50 to €2.50
Kreuznagel: folds 
IdiotFromNE: folds 
Uncalled bet (€1.50) returned to ardo888
ardo888 collected €2.50 from pot
ardo888: doesn't show hand 
*** SUMMARY ***
Total pot €2.50 | Rake €0 
Seat 1: Kreuznagel (small blind) folded before Flop
Seat 2: IdiotFromNE (big blind) folded before Flop
Seat 3: vrnMike folded before Flop (didn't bet)
Seat 4: Zeeshka folded before Flop (didn't bet)
Seat 5: MickChick24 folded before Flop (didn't bet)
Seat 6: matiko09 folded before Flop (didn't bet)
Seat 8: Painkiller72 folded before Flop (didn't bet)
Seat 9: ardo888 (button) collected (€2.50)





PokerStars Hand #151206791792:  Hold'em No Limit ($0.50/$1.00 USD) - 2016/03/31 12:03:46 CET [2016/03/31 6:03:46 ET]
Table 'Herge II' 9-max Seat #6 is the button
Seat 1: Chiapel ($77.50 in chips) 
Seat 2: Megaman101 ($90.68 in chips) 
Seat 3: matiko09 ($101.50 in chips) 
Seat 4: vrnMike ($111.48 in chips) 
Seat 6: masaytoo ($109.75 in chips) 
Seat 7: Zeeshka ($105.64 in chips) 
Seat 8: IdiotFromNE ($100 in chips) 
Zeeshka: posts small blind $0.50
IdiotFromNE: posts big blind $1
I The King I: sits out 
*** HOLE CARDS ***
Dealt to matiko09 [Ts Ad]
Chiapel: folds 
Megaman101: folds 
matiko09: raises $2 to $3
vrnMike: folds 
masaytoo: folds 
Zeeshka: folds 
IdiotFromNE: folds 
Uncalled bet ($2) returned to matiko09
matiko09 collected $2.50 from pot
matiko09: doesn't show hand 
*** SUMMARY ***
Total pot $2.50 | Rake $0 
Seat 1: Chiapel folded before Flop (didn't bet)
Seat 2: Megaman101 folded before Flop (didn't bet)
Seat 3: matiko09 collected ($2.50)
Seat 4: vrnMike folded before Flop (didn't bet)
Seat 6: masaytoo (button) folded before Flop (didn't bet)
Seat 7: Zeeshka (small blind) folded before Flop
Seat 8: IdiotFromNE (big blind) folded before Flop





PokerStars Hand #151206795419:  Hold'em No Limit ($1/$2 USD) - 2016/03/31 12:03:54 CET [2016/03/31 6:03:54 ET]
Table 'Desiderata' 9-max Seat #9 is the button
Seat 1: GALWACONT ($101.50 in chips) 
Seat 2: ilaviiitech ($200 in chips) 
Seat 3: InsomniaRU ($317.87 in chips) 
Seat 4: matiko09 ($203 in chips) 
Seat 5: Kreuznagel ($332.24 in chips) 
Seat 6: rmanjkeee ($105.75 in chips) 
Seat 7: pulykakakas ($175.04 in chips) 
Seat 8: DUkalisUA ($204.55 in chips) 
Seat 9: Painkiller72 ($200 in chips) 
GALWACONT: posts small blind $1
ilaviiitech: posts big blind $2
*** HOLE CARDS ***
Dealt to matiko09 [Tc As]
InsomniaRU: folds 
matiko09: folds 
Kreuznagel: raises $2.78 to $4.78
rmanjkeee: folds 
pulykakakas: folds 
DUkalisUA: folds 
Painkiller72: folds 
GALWACONT: folds 
ilaviiitech: folds 
Uncalled bet ($2.78) returned to Kreuznagel
Kreuznagel collected $5 from pot
Kreuznagel: doesn't show hand 
*** SUMMARY ***
Total pot $5 | Rake $0 
Seat 1: GALWACONT (small blind) folded before Flop
Seat 2: ilaviiitech (big blind) folded before Flop
Seat 3: InsomniaRU folded before Flop (didn't bet)
Seat 4: matiko09 folded before Flop (didn't bet)
Seat 5: Kreuznagel collected ($5)
Seat 6: rmanjkeee folded before Flop (didn't bet)
Seat 7: pulykakakas folded before Flop (didn't bet)
Seat 8: DUkalisUA folded before Flop (didn't bet)
Seat 9: Painkiller72 (button) folded before Flop (didn't bet)





PokerStars Hand #151206803802:  Hold'em No Limit (€0.50/€1.00 EUR) - 2016/03/31 12:04:13 CET [2016/03/31 6:04:13 ET]
Table 'Pioneer II' 9-max Seat #1 is the button
Seat 1: Kreuznagel (€104.73 in chips) 
Seat 2: IdiotFromNE (€100 in chips) 
Seat 3: vrnMike (€103.89 in chips) 
Seat 4: Zeeshka (€100 in chips) 
Seat 5: MickChick24 (€125.94 in chips) 
Seat 6: matiko09 (€100 in chips) 
Seat 8: Painkiller72 (€135.55 in chips) 
Seat 9: ardo888 (€114.03 in chips) 
IdiotFromNE: posts small blind €0.50
vrnMike: posts big blind €1
AlKatrone: sits out 
*** HOLE CARDS ***
Dealt to matiko09 [Kd Tc]
Zeeshka: folds 
MickChick24: calls €1
matiko09: raises €4 to €5
Painkiller72: folds 
ardo888: raises €12 to €17
Kreuznagel: folds 
IdiotFromNE: folds 
vrnMike: folds 
MickChick24: folds 
matiko09: folds 
Uncalled bet (€12) returned to ardo888
ardo888 collected €12.50 from pot
ardo888: doesn't show hand 
*** SUMMARY ***
Total pot €12.50 | Rake €0 
Seat 1: Kreuznagel (button) folded before Flop (didn't bet)
Seat 2: IdiotFromNE (small blind) folded before Flop
Seat 3: vrnMike (big blind) folded before Flop
Seat 4: Zeeshka folded before Flop (didn't bet)
Seat 5: MickChick24 folded before Flop
Seat 6: matiko09 folded before Flop
Seat 8: Painkiller72 folded before Flop (didn't bet)
Seat 9: ardo888 collected (€12.50)





PokerStars Hand #151206805884:  Hold'em No Limit ($0.50/$1.00 USD) - 2016/03/31 12:04:18 CET [2016/03/31 6:04:18 ET]
Table 'Herge II' 9-max Seat #7 is the button
Seat 1: Chiapel ($77.50 in chips) 
Seat 2: Megaman101 ($90.68 in chips) 
Seat 3: matiko09 ($103 in chips) 
Seat 4: vrnMike ($111.48 in chips) 
Seat 6: masaytoo ($109.75 in chips) 
Seat 7: Zeeshka ($105.14 in chips) 
Seat 8: IdiotFromNE ($100 in chips) 
IdiotFromNE: posts small blind $0.50
Chiapel: posts big blind $1
I The King I: sits out 
*** HOLE CARDS ***
Dealt to matiko09 [3h Tc]
Megaman101: folds 
matiko09: folds 
vrnMike: raises $1 to $2
masaytoo: folds 
Zeeshka: folds 
IdiotFromNE: folds 
Chiapel: calls $1
*** FLOP *** [Js Td 7h]
Chiapel: checks 
vrnMike: bets $1.50
Chiapel: calls $1.50
*** TURN *** [Js Td 7h] [6d]
Chiapel: checks 
vrnMike: checks 
*** RIVER *** [Js Td 7h 6d] [Ah]
Chiapel: bets $7.12
vrnMike: calls $7.12
*** SHOW DOWN ***
Chiapel: shows [4d 9d] (high card Ace)
vrnMike: shows [Ad Ks] (a pair of Aces)
vrnMike collected $20.65 from pot
*** SUMMARY ***
Total pot $21.74 | Rake $1.09 
Board [Js Td 7h 6d Ah]
Seat 1: Chiapel (big blind) showed [4d 9d] and lost with high card Ace
Seat 2: Megaman101 folded before Flop (didn't bet)
Seat 3: matiko09 folded before Flop (didn't bet)
Seat 4: vrnMike showed [Ad Ks] and won ($20.65) with a pair of Aces
Seat 6: masaytoo folded before Flop (didn't bet)
Seat 7: Zeeshka (button) folded before Flop (didn't bet)
Seat 8: IdiotFromNE (small blind) folded before Flop





PokerStars Hand #151206810978:  Hold'em No Limit ($1/$2 USD) - 2016/03/31 12:04:30 CET [2016/03/31 6:04:30 ET]
Table 'Desiderata' 9-max Seat #1 is the button
Seat 1: GALWACONT ($100.50 in chips) 
Seat 2: ilaviiitech ($200 in chips) 
Seat 3: InsomniaRU ($317.87 in chips) 
Seat 4: matiko09 ($203 in chips) 
Seat 5: Kreuznagel ($335.24 in chips) 
Seat 6: rmanjkeee ($105.75 in chips) 
Seat 7: pulykakakas ($175.04 in chips) 
Seat 8: DUkalisUA ($204.55 in chips) 
Seat 9: Painkiller72 ($200 in chips) 
ilaviiitech: posts small blind $1
InsomniaRU: posts big blind $2
*** HOLE CARDS ***
Dealt to matiko09 [6s 2c]
matiko09: folds 
Kreuznagel: folds 
rmanjkeee: folds 
pulykakakas: raises $4 to $6
DUkalisUA: folds 
Painkiller72: calls $6
GALWACONT: folds 
ilaviiitech: folds 
InsomniaRU: folds 
*** FLOP *** [Kc Ad Jc]
pulykakakas: bets $8
Painkiller72: folds 
Uncalled bet ($8) returned to pulykakakas
pulykakakas collected $14.25 from pot
pulykakakas: doesn't show hand 
*** SUMMARY ***
Total pot $15 | Rake $0.75 
Board [Kc Ad Jc]
Seat 1: GALWACONT (button) folded before Flop (didn't bet)
Seat 2: ilaviiitech (small blind) folded before Flop
Seat 3: InsomniaRU (big blind) folded before Flop
Seat 4: matiko09 folded before Flop (didn't bet)
Seat 5: Kreuznagel folded before Flop (didn't bet)
Seat 6: rmanjkeee folded before Flop (didn't bet)
Seat 7: pulykakakas collected ($14.25)
Seat 8: DUkalisUA folded before Flop (didn't bet)
Seat 9: Painkiller72 folded on the Flop





PokerStars Hand #151206827931:  Hold'em No Limit ($0.50/$1.00 USD) - 2016/03/31 12:05:08 CET [2016/03/31 6:05:08 ET]
Table 'Herge II' 9-max Seat #8 is the button
Seat 1: Chiapel ($90.38 in chips) 
Seat 2: Megaman101 ($90.68 in chips) 
Seat 3: matiko09 ($103 in chips) 
Seat 4: vrnMike ($121.51 in chips) 
Seat 6: masaytoo ($109.75 in chips) 
Seat 7: Zeeshka ($105.14 in chips) 
Seat 8: IdiotFromNE ($100 in chips) 
Chiapel: posts small blind $0.50
Megaman101: posts big blind $1
I The King I: sits out 
*** HOLE CARDS ***
Dealt to matiko09 [Kh Td]
matiko09: folds 
vrnMike: folds 
masaytoo: folds 
Zeeshka: folds 
IdiotFromNE: folds 
Chiapel: raises $1 to $2
Megaman101: calls $1
*** FLOP *** [7d Ac As]
Chiapel: bets $3.80
Megaman101: folds 
Uncalled bet ($3.80) returned to Chiapel
Chiapel collected $3.80 from pot
Chiapel: doesn't show hand 
*** SUMMARY ***
Total pot $4 | Rake $0.20 
Board [7d Ac As]
Seat 1: Chiapel (small blind) collected ($3.80)
Seat 2: Megaman101 (big blind) folded on the Flop
Seat 3: matiko09 folded before Flop (didn't bet)
Seat 4: vrnMike folded before Flop (didn't bet)
Seat 6: masaytoo folded before Flop (didn't bet)
Seat 7: Zeeshka folded before Flop (didn't bet)
Seat 8: IdiotFromNE (button) folded before Flop (didn't bet)





PokerStars Hand #151206828377:  Hold'em No Limit (€0.50/€1.00 EUR) - 2016/03/31 12:05:09 CET [2016/03/31 6:05:09 ET]
Table 'Pioneer II' 9-max Seat #2 is the button
Seat 1: Kreuznagel (€104.73 in chips) 
Seat 2: IdiotFromNE (€100 in chips) 
Seat 3: vrnMike (€102.89 in chips) 
Seat 4: Zeeshka (€100 in chips) 
Seat 5: MickChick24 (€124.94 in chips) 
Seat 6: matiko09 (€100 in chips) 
Seat 8: Painkiller72 (€135.55 in chips) 
Seat 9: ardo888 (€121.53 in chips) 
vrnMike: posts small blind €0.50
Zeeshka: posts big blind €1
AlKatrone: sits out 
*** HOLE CARDS ***
Dealt to matiko09 [7c 6h]
MickChick24: folds 
matiko09: folds 
Painkiller72: folds 
ardo888: folds 
Kreuznagel: folds 
IdiotFromNE: raises €1.50 to €2.50
vrnMike: calls €2
Zeeshka: calls €1.50
*** FLOP *** [6s Kd 8c]
vrnMike: checks 
Zeeshka: checks 
IdiotFromNE: checks 
*** TURN *** [6s Kd 8c] [5d]
vrnMike: checks 
Zeeshka: checks 
IdiotFromNE: bets €5.69
vrnMike: folds 
Zeeshka: folds 
Uncalled bet (€5.69) returned to IdiotFromNE
IdiotFromNE collected €7.12 from pot
IdiotFromNE: doesn't show hand 
*** SUMMARY ***
Total pot €7.50 | Rake €0.38 
Board [6s Kd 8c 5d]
Seat 1: Kreuznagel folded before Flop (didn't bet)
Seat 2: IdiotFromNE (button) collected (€7.12)
Seat 3: vrnMike (small blind) folded on the Turn
Seat 4: Zeeshka (big blind) folded on the Turn
Seat 5: MickChick24 folded before Flop (didn't bet)
Seat 6: matiko09 folded before Flop (didn't bet)
Seat 8: Painkiller72 folded before Flop (didn't bet)
Seat 9: ardo888 folded before Flop (didn't bet)





PokerStars Hand #151206839132:  Hold'em No Limit ($0.50/$1.00 USD) - 2016/03/31 12:05:33 CET [2016/03/31 6:05:33 ET]
Table 'Herge II' 9-max Seat #1 is the button
Seat 1: Chiapel ($92.18 in chips) 
Seat 2: Megaman101 ($88.68 in chips) 
Seat 3: matiko09 ($103 in chips) 
Seat 4: vrnMike ($121.51 in chips) 
Seat 6: masaytoo ($109.75 in chips) 
Seat 7: Zeeshka ($105.14 in chips) 
Seat 8: IdiotFromNE ($100 in chips) 
Megaman101: posts small blind $0.50
matiko09: posts big blind $1
I The King I: sits out 
*** HOLE CARDS ***
Dealt to matiko09 [6d Jc]
vrnMike: folds 
masaytoo: raises $2 to $3
Zeeshka: folds 
IdiotFromNE: folds 
Chiapel: folds 
Megaman101: folds 
matiko09: folds 
Uncalled bet ($2) returned to masaytoo
masaytoo collected $2.50 from pot
masaytoo: doesn't show hand 
*** SUMMARY ***
Total pot $2.50 | Rake $0 
Seat 1: Chiapel (button) folded before Flop (didn't bet)
Seat 2: Megaman101 (small blind) folded before Flop
Seat 3: matiko09 (big blind) folded before Flop
Seat 4: vrnMike folded before Flop (didn't bet)
Seat 6: masaytoo collected ($2.50)
Seat 7: Zeeshka folded before Flop (didn't bet)
Seat 8: IdiotFromNE folded before Flop (didn't bet)





PokerStars Hand #151206846341:  Hold'em No Limit ($1/$2 USD) - 2016/03/31 12:05:50 CET [2016/03/31 6:05:50 ET]
Table 'Desiderata' 9-max Seat #2 is the button
Seat 1: GALWACONT ($100.50 in chips) 
Seat 2: ilaviiitech ($200 in chips) 
Seat 3: InsomniaRU ($315.87 in chips) 
Seat 4: matiko09 ($203 in chips) 
Seat 5: Kreuznagel ($335.24 in chips) 
Seat 6: rmanjkeee ($105.75 in chips) 
Seat 7: pulykakakas ($183.29 in chips) 
Seat 8: DUkalisUA ($204.55 in chips) 
Seat 9: Painkiller72 ($200 in chips) 
InsomniaRU: posts small blind $1
matiko09: posts big blind $2
*** HOLE CARDS ***
Dealt to matiko09 [3c 2c]
Kreuznagel: folds 
rmanjkeee: folds 
pulykakakas: raises $4 to $6
DUkalisUA: folds 
Painkiller72: folds 
GALWACONT: calls $6
ilaviiitech: calls $6
InsomniaRU: folds 
matiko09: folds 
*** FLOP *** [2s 5d 3d]
pulykakakas: checks 
GALWACONT: checks 
ilaviiitech: checks 
*** TURN *** [2s 5d 3d] [As]
pulykakakas: bets $6
GALWACONT: folds 
ilaviiitech: calls $6
*** RIVER *** [2s 5d 3d As] [Kc]
pulykakakas: checks 
ilaviiitech: bets $18.81
pulykakakas: folds 
Uncalled bet ($18.81) returned to ilaviiitech
ilaviiitech collected $31.35 from pot
ilaviiitech: doesn't show hand 
*** SUMMARY ***
Total pot $33 | Rake $1.65 
Board [2s 5d 3d As Kc]
Seat 1: GALWACONT folded on the Turn
Seat 2: ilaviiitech (button) collected ($31.35)
Seat 3: InsomniaRU (small blind) folded before Flop
Seat 4: matiko09 (big blind) folded before Flop
Seat 5: Kreuznagel folded before Flop (didn't bet)
Seat 6: rmanjkeee folded before Flop (didn't bet)
Seat 7: pulykakakas folded on the River
Seat 8: DUkalisUA folded before Flop (didn't bet)
Seat 9: Painkiller72 folded before Flop (didn't bet)





PokerStars Hand #151206847529:  Hold'em No Limit ($0.50/$1.00 USD) - 2016/03/31 12:05:52 CET [2016/03/31 6:05:52 ET]
Table 'Herge II' 9-max Seat #2 is the button
Seat 1: Chiapel ($92.18 in chips) 
Seat 2: Megaman101 ($88.18 in chips) 
Seat 3: matiko09 ($102 in chips) 
Seat 4: vrnMike ($121.51 in chips) 
Seat 6: masaytoo ($111.25 in chips) 
Seat 7: Zeeshka ($105.14 in chips) 
Seat 8: IdiotFromNE ($100 in chips) 
matiko09: posts small blind $0.50
vrnMike: posts big blind $1
I The King I: sits out 
*** HOLE CARDS ***
Dealt to matiko09 [9h 2h]
masaytoo: folds 
Zeeshka: folds 
IdiotFromNE: folds 
Chiapel: raises $1 to $2
Megaman101: folds 
Megaman101 leaves the table
matiko09: folds 
DUkalisUA joins the table at seat #2 
vrnMike: calls $1
*** FLOP *** [4c Jc Kd]
vrnMike: checks 
Chiapel: bets $4.28
vrnMike: calls $4.28
*** TURN *** [4c Jc Kd] [9c]
vrnMike: checks 
Chiapel: bets $12.41
vrnMike: folds 
Uncalled bet ($12.41) returned to Chiapel
Chiapel collected $12.41 from pot
Chiapel: doesn't show hand 
*** SUMMARY ***
Total pot $13.06 | Rake $0.65 
Board [4c Jc Kd 9c]
Seat 1: Chiapel collected ($12.41)
Seat 2: Megaman101 (button) folded before Flop (didn't bet)
Seat 3: matiko09 (small blind) folded before Flop
Seat 4: vrnMike (big blind) folded on the Turn
Seat 6: masaytoo folded before Flop (didn't bet)
Seat 7: Zeeshka folded before Flop (didn't bet)
Seat 8: IdiotFromNE folded before Flop (didn't bet)





PokerStars Hand #151206848451:  Hold'em No Limit ($0.50/$1.00 USD) - 2016/03/31 12:05:54 CET [2016/03/31 6:05:54 ET]
Table 'Leonid II' 9-max Seat #8 is the button
Seat 1: matiko09 ($100 in chips) 
Seat 2: ilaviiitech ($100 in chips) 
Seat 3: Painkiller72 ($103.50 in chips) 
Seat 4: vrnMike ($106 in chips) 
Seat 5: Zeeshka ($100.40 in chips) 
Seat 6: I The King I ($110.50 in chips) 
Seat 7: IdiotFromNE ($100 in chips) 
Seat 8: DUkalisUA ($100 in chips) 
Seat 9: bakus416 ($102.03 in chips) 
bakus416: posts small blind $0.50
matiko09: posts big blind $1
*** HOLE CARDS ***
Dealt to matiko09 [7d Qc]
ilaviiitech: folds 
Painkiller72: folds 
vrnMike: folds 
Zeeshka: folds 
I The King I: folds 
IdiotFromNE: folds 
DUkalisUA: folds 
bakus416: raises $2 to $3
matiko09: folds 
Uncalled bet ($2) returned to bakus416
bakus416 collected $2 from pot
bakus416: doesn't show hand 
*** SUMMARY ***
Total pot $2 | Rake $0 
Seat 1: matiko09 (big blind) folded before Flop
Seat 2: ilaviiitech folded before Flop (didn't bet)
Seat 3: Painkiller72 folded before Flop (didn't bet)
Seat 4: vrnMike folded before Flop (didn't bet)
Seat 5: Zeeshka folded before Flop (didn't bet)
Seat 6: I The King I folded before Flop (didn't bet)
Seat 7: IdiotFromNE folded before Flop (didn't bet)
Seat 8: DUkalisUA (button) folded before Flop (didn't bet)
Seat 9: bakus416 (small blind) collected ($2)





PokerStars Hand #151206858357:  Hold'em No Limit (€0.50/€1.00 EUR) - 2016/03/31 12:06:16 CET [2016/03/31 6:06:16 ET]
Table 'Pioneer II' 9-max Seat #3 is the button
Seat 1: Kreuznagel (€104.73 in chips) 
Seat 2: IdiotFromNE (€104.62 in chips) 
Seat 3: vrnMike (€100.39 in chips) 
Seat 4: Zeeshka (€100 in chips) 
Seat 5: MickChick24 (€124.94 in chips) 
Seat 6: matiko09 (€100 in chips) 
Seat 8: Painkiller72 (€135.55 in chips) 
Seat 9: ardo888 (€121.53 in chips) 
Zeeshka: posts small blind €0.50
MickChick24: posts big blind €1
AlKatrone: sits out 
*** HOLE CARDS ***
Dealt to matiko09 [4d 2c]
matiko09: folds 
Painkiller72: folds 
ardo888: raises €2 to €3
Kreuznagel: folds 
IdiotFromNE: folds 
vrnMike: folds 
Zeeshka: folds 
MickChick24: raises €3 to €6
ardo888: calls €3
*** FLOP *** [9c 8h 7d]
MickChick24: bets €4
ardo888: calls €4
*** TURN *** [9c 8h 7d] [4s]
MickChick24: checks 
ardo888: checks 
*** RIVER *** [9c 8h 7d 4s] [5s]
MickChick24: checks 
ardo888: bets €14.22
MickChick24: folds 
Uncalled bet (€14.22) returned to ardo888
ardo888 collected €19.48 from pot
ardo888: doesn't show hand 
*** SUMMARY ***
Total pot €20.50 | Rake €1.02 
Board [9c 8h 7d 4s 5s]
Seat 1: Kreuznagel folded before Flop (didn't bet)
Seat 2: IdiotFromNE folded before Flop (didn't bet)
Seat 3: vrnMike (button) folded before Flop (didn't bet)
Seat 4: Zeeshka (small blind) folded before Flop
Seat 5: MickChick24 (big blind) folded on the River
Seat 6: matiko09 folded before Flop (didn't bet)
Seat 8: Painkiller72 folded before Flop (didn't bet)
Seat 9: ardo888 collected (€19.48)





PokerStars Hand #151206863269:  Hold'em No Limit ($0.50/$1.00 USD) - 2016/03/31 12:06:27 CET [2016/03/31 6:06:27 ET]
Table 'Leonid II' 9-max Seat #9 is the button
Seat 1: matiko09 ($100 in chips) 
Seat 2: ilaviiitech ($100 in chips) 
Seat 3: Painkiller72 ($103.50 in chips) 
Seat 4: vrnMike ($106 in chips) 
Seat 5: Zeeshka ($100.40 in chips) 
Seat 6: I The King I ($110.50 in chips) 
Seat 7: IdiotFromNE ($100 in chips) 
Seat 8: DUkalisUA ($100 in chips) 
Seat 9: bakus416 ($103.03 in chips) 
matiko09: posts small blind $0.50
ilaviiitech: posts big blind $1
*** HOLE CARDS ***
Dealt to matiko09 [4s Jc]
Painkiller72: folds 
vrnMike: folds 
Zeeshka: folds 
I The King I: raises $2 to $3
IdiotFromNE: folds 
DUkalisUA: folds 
bakus416: calls $3
matiko09: folds 
ilaviiitech: folds 
*** FLOP *** [Jd 9s Ts]
I The King I: bets $5
bakus416: folds 
Uncalled bet ($5) returned to I The King I
I The King I collected $7.12 from pot
I The King I: doesn't show hand 
*** SUMMARY ***
Total pot $7.50 | Rake $0.38 
Board [Jd 9s Ts]
Seat 1: matiko09 (small blind) folded before Flop
Seat 2: ilaviiitech (big blind) folded before Flop
Seat 3: Painkiller72 folded before Flop (didn't bet)
Seat 4: vrnMike folded before Flop (didn't bet)
Seat 5: Zeeshka folded before Flop (didn't bet)
Seat 6: I The King I collected ($7.12)
Seat 7: IdiotFromNE folded before Flop (didn't bet)
Seat 8: DUkalisUA folded before Flop (didn't bet)
Seat 9: bakus416 (button) folded on the Flop





PokerStars Hand #151206872411:  Hold'em No Limit ($0.50/$1.00 USD) - 2016/03/31 12:06:48 CET [2016/03/31 6:06:48 ET]
Table 'Herge II' 9-max Seat #3 is the button
Seat 1: Chiapel ($98.31 in chips) 
Seat 3: matiko09 ($101.50 in chips) 
Seat 4: vrnMike ($115.23 in chips) 
Seat 5: I The King I ($100 in chips) 
Seat 6: masaytoo ($111.25 in chips) 
Seat 7: Zeeshka ($105.14 in chips) 
Seat 8: IdiotFromNE ($100 in chips) 
vrnMike: posts small blind $0.50
I The King I: posts big blind $1
fatstacks122: sits out 
DUkalisUA: sits out 
*** HOLE CARDS ***
Dealt to matiko09 [9c Qd]
masaytoo: calls $1
Zeeshka: folds 
IdiotFromNE: raises $1.50 to $2.50
Chiapel: folds 
matiko09: folds 
vrnMike: folds 
I The King I: folds 
masaytoo: calls $1.50
*** FLOP *** [4h Jh 9h]
masaytoo: checks 
IdiotFromNE: checks 
*** TURN *** [4h Jh 9h] [Qh]
masaytoo: bets $3.30
IdiotFromNE: calls $3.30
*** RIVER *** [4h Jh 9h Qh] [Jd]
masaytoo: bets $8.88
IdiotFromNE: folds 
Uncalled bet ($8.88) returned to masaytoo
masaytoo collected $12.44 from pot
masaytoo: doesn't show hand 
*** SUMMARY ***
Total pot $13.10 | Rake $0.66 
Board [4h Jh 9h Qh Jd]
Seat 1: Chiapel folded before Flop (didn't bet)
Seat 3: matiko09 (button) folded before Flop (didn't bet)
Seat 4: vrnMike (small blind) folded before Flop
Seat 5: I The King I (big blind) folded before Flop
Seat 6: masaytoo collected ($12.44)
Seat 7: Zeeshka folded before Flop (didn't bet)
Seat 8: IdiotFromNE folded on the River





PokerStars Hand #151206876533:  Hold'em No Limit ($1/$2 USD) - 2016/03/31 12:06:57 CET [2016/03/31 6:06:57 ET]
Table 'Cheruskia II' 9-max Seat #2 is the button
Seat 1: thecurv ($200 in chips) 
Seat 2: rmanjkeee ($203.15 in chips) 
Seat 4: riverfish786 ($385.11 in chips) 
Seat 5: matiko09 ($200 in chips) 
Seat 6: RAISYDA1SY ($87.94 in chips) 
Seat 7: BOAYARSKIY ($106.08 in chips) 
Seat 8: apfush ($203 in chips) 
Seat 9: Kreuznagel ($335.64 in chips) 
DUkalisUA will be allowed to play after the button
riverfish786: posts small blind $1
matiko09: posts big blind $2
*** HOLE CARDS ***
Dealt to matiko09 [5d 3d]
RAISYDA1SY: folds 
BOAYARSKIY: folds 
apfush: folds 
Kreuznagel: folds 
thecurv: folds 
rmanjkeee: folds 
riverfish786: raises $2.22 to $4.22
matiko09: folds 
Uncalled bet ($2.22) returned to riverfish786
riverfish786 collected $4 from pot
riverfish786: doesn't show hand 
*** SUMMARY ***
Total pot $4 | Rake $0 
Seat 1: thecurv folded before Flop (didn't bet)
Seat 2: rmanjkeee (button) folded before Flop (didn't bet)
Seat 4: riverfish786 (small blind) collected ($4)
Seat 5: matiko09 (big blind) folded before Flop
Seat 6: RAISYDA1SY folded before Flop (didn't bet)
Seat 7: BOAYARSKIY folded before Flop (didn't bet)
Seat 8: apfush folded before Flop (didn't bet)
Seat 9: Kreuznagel folded before Flop (didn't bet)





PokerStars Hand #151206884017:  Hold'em No Limit ($1/$2 USD) - 2016/03/31 12:07:14 CET [2016/03/31 6:07:14 ET]
Table 'Desiderata' 9-max Seat #3 is the button
Seat 1: GALWACONT ($94.50 in chips) 
Seat 2: ilaviiitech ($219.35 in chips) 
Seat 3: InsomniaRU ($314.87 in chips) 
Seat 4: matiko09 ($201 in chips) 
Seat 5: Kreuznagel ($335.24 in chips) 
Seat 6: rmanjkeee ($105.75 in chips) 
Seat 7: pulykakakas ($171.29 in chips) 
Seat 8: DUkalisUA ($204.55 in chips) 
Seat 9: Painkiller72 ($200 in chips) 
matiko09: posts small blind $1
Kreuznagel: posts big blind $2
*** HOLE CARDS ***
Dealt to matiko09 [Ts 8s]
rmanjkeee: folds 
pulykakakas: folds 
DUkalisUA: folds 
Painkiller72: folds 
GALWACONT: folds 
ilaviiitech: folds 
InsomniaRU: folds 
matiko09: raises $3 to $5
Kreuznagel: calls $3
*** FLOP *** [5c 9h Kh]
matiko09: checks 
Kreuznagel: bets $5.70
matiko09: folds 
Uncalled bet ($5.70) returned to Kreuznagel
Kreuznagel collected $9.50 from pot
Kreuznagel: doesn't show hand 
*** SUMMARY ***
Total pot $10 | Rake $0.50 
Board [5c 9h Kh]
Seat 1: GALWACONT folded before Flop (didn't bet)
Seat 2: ilaviiitech folded before Flop (didn't bet)
Seat 3: InsomniaRU (button) folded before Flop (didn't bet)
Seat 4: matiko09 (small blind) folded on the Flop
Seat 5: Kreuznagel (big blind) collected ($9.50)
Seat 6: rmanjkeee folded before Flop (didn't bet)
Seat 7: pulykakakas folded before Flop (didn't bet)
Seat 8: DUkalisUA folded before Flop (didn't bet)
Seat 9: Painkiller72 folded before Flop (didn't bet)





PokerStars Hand #151206889822:  Hold'em No Limit (€0.50/€1.00 EUR) - 2016/03/31 12:07:27 CET [2016/03/31 6:07:27 ET]
Table 'Pioneer II' 9-max Seat #4 is the button
Seat 1: Kreuznagel (€104.73 in chips) 
Seat 2: IdiotFromNE (€104.62 in chips) 
Seat 3: vrnMike (€100.39 in chips) 
Seat 4: Zeeshka (€100 in chips) 
Seat 5: MickChick24 (€114.94 in chips) 
Seat 6: matiko09 (€100 in chips) 
Seat 8: Painkiller72 (€135.55 in chips) 
Seat 9: ardo888 (€131.01 in chips) 
MickChick24: posts small blind €0.50
matiko09: posts big blind €1
AlKatrone: sits out 
*** HOLE CARDS ***
Dealt to matiko09 [2h 3d]
Painkiller72: raises €1.50 to €2.50
ardo888: folds 
Kreuznagel: folds 
IdiotFromNE: calls €2.50
vrnMike: folds 
Zeeshka: folds 
MickChick24: folds 
matiko09: folds 
*** FLOP *** [Qd Jc 7s]
Painkiller72: bets €4.32
IdiotFromNE: folds 
Uncalled bet (€4.32) returned to Painkiller72
Painkiller72 collected €6.18 from pot
Painkiller72: doesn't show hand 
*** SUMMARY ***
Total pot €6.50 | Rake €0.32 
Board [Qd Jc 7s]
Seat 1: Kreuznagel folded before Flop (didn't bet)
Seat 2: IdiotFromNE folded on the Flop
Seat 3: vrnMike folded before Flop (didn't bet)
Seat 4: Zeeshka (button) folded before Flop (didn't bet)
Seat 5: MickChick24 (small blind) folded before Flop
Seat 6: matiko09 (big blind) folded before Flop
Seat 8: Painkiller72 collected (€6.18)
Seat 9: ardo888 folded before Flop (didn't bet)





PokerStars Hand #151206891833:  Hold'em No Limit ($1/$2 USD) - 2016/03/31 12:07:32 CET [2016/03/31 6:07:32 ET]
Table 'Cheruskia II' 9-max Seat #4 is the button
Seat 1: thecurv ($200 in chips) 
Seat 2: rmanjkeee ($203.15 in chips) 
Seat 4: riverfish786 ($387.11 in chips) 
Seat 5: matiko09 ($200 in chips) 
Seat 6: RAISYDA1SY ($87.94 in chips) 
Seat 7: BOAYARSKIY ($106.08 in chips) 
Seat 8: apfush ($203 in chips) 
Seat 9: Kreuznagel ($335.64 in chips) 
matiko09: posts small blind $1
RAISYDA1SY: posts big blind $2
DUkalisUA: sits out 
*** HOLE CARDS ***
Dealt to matiko09 [6c 4s]
BOAYARSKIY: folds 
apfush: folds 
Kreuznagel: folds 
thecurv has timed out
thecurv: folds 
rmanjkeee: folds 
riverfish786: folds 
matiko09: folds 
Uncalled bet ($1) returned to RAISYDA1SY
RAISYDA1SY collected $2 from pot
*** SUMMARY ***
Total pot $2 | Rake $0 
Seat 1: thecurv folded before Flop (didn't bet)
Seat 2: rmanjkeee folded before Flop (didn't bet)
Seat 4: riverfish786 (button) folded before Flop (didn't bet)
Seat 5: matiko09 (small blind) folded before Flop
Seat 6: RAISYDA1SY (big blind) collected ($2)
Seat 7: BOAYARSKIY folded before Flop (didn't bet)
Seat 8: apfush folded before Flop (didn't bet)
Seat 9: Kreuznagel folded before Flop (didn't bet)





PokerStars Hand #151206898004:  Hold'em No Limit ($0.50/$1.00 USD) - 2016/03/31 12:07:46 CET [2016/03/31 6:07:46 ET]
Table 'Leonid II' 9-max Seat #1 is the button
Seat 1: matiko09 ($100 in chips) 
Seat 2: ilaviiitech ($100 in chips) 
Seat 3: Painkiller72 ($103.50 in chips) 
Seat 4: vrnMike ($106 in chips) 
Seat 5: Zeeshka ($100.40 in chips) 
Seat 6: I The King I ($114.62 in chips) 
Seat 7: IdiotFromNE ($100 in chips) 
Seat 8: DUkalisUA ($100 in chips) 
Seat 9: bakus416 ($100.03 in chips) 
ilaviiitech: posts small blind $0.50
Painkiller72: posts big blind $1
*** HOLE CARDS ***
Dealt to matiko09 [Kh Kc]
vrnMike: folds 
Zeeshka: folds 
I The King I: raises $2 to $3
IdiotFromNE: folds 
DUkalisUA: folds 
bakus416 is disconnected 
bakus416 has timed out while disconnected
bakus416: folds 
matiko09: raises $7 to $10
ilaviiitech: folds 
Painkiller72: folds 
I The King I: calls $7
*** FLOP *** [9d 5s 9s]
I The King I: checks 
matiko09: bets $12
I The King I: folds 
Uncalled bet ($12) returned to matiko09
matiko09 collected $20.42 from pot
matiko09: doesn't show hand 
*** SUMMARY ***
Total pot $21.50 | Rake $1.08 
Board [9d 5s 9s]
Seat 1: matiko09 (button) collected ($20.42)
Seat 2: ilaviiitech (small blind) folded before Flop
Seat 3: Painkiller72 (big blind) folded before Flop
Seat 4: vrnMike folded before Flop (didn't bet)
Seat 5: Zeeshka folded before Flop (didn't bet)
Seat 6: I The King I folded on the Flop
Seat 7: IdiotFromNE folded before Flop (didn't bet)
Seat 8: DUkalisUA folded before Flop (didn't bet)
Seat 9: bakus416 folded before Flop (didn't bet)





PokerStars Hand #151206904368:  Hold'em No Limit (€0.50/€1.00 EUR) - 2016/03/31 12:08:00 CET [2016/03/31 6:08:00 ET]
Table 'Pioneer II' 9-max Seat #5 is the button
Seat 1: Kreuznagel (€104.73 in chips) 
Seat 2: IdiotFromNE (€102.12 in chips) 
Seat 3: vrnMike (€100.39 in chips) 
Seat 4: Zeeshka (€100 in chips) 
Seat 5: MickChick24 (€114.44 in chips) 
Seat 6: matiko09 (€100 in chips) 
Seat 7: AlKatrone (€121.17 in chips) 
Seat 8: Painkiller72 (€139.23 in chips) 
Seat 9: ardo888 (€131.01 in chips) 
matiko09: posts small blind €0.50
AlKatrone: posts big blind €1
*** HOLE CARDS ***
Dealt to matiko09 [3s 4s]
Painkiller72: folds 
ardo888: folds 
Kreuznagel: raises €1.39 to €2.39
IdiotFromNE: folds 
vrnMike: folds 
Zeeshka: folds 
MickChick24: folds 
matiko09: folds 
AlKatrone: folds 
Uncalled bet (€1.39) returned to Kreuznagel
Kreuznagel collected €2.50 from pot
Kreuznagel: doesn't show hand 
*** SUMMARY ***
Total pot €2.50 | Rake €0 
Seat 1: Kreuznagel collected (€2.50)
Seat 2: IdiotFromNE folded before Flop (didn't bet)
Seat 3: vrnMike folded before Flop (didn't bet)
Seat 4: Zeeshka folded before Flop (didn't bet)
Seat 5: MickChick24 (button) folded before Flop (didn't bet)
Seat 6: matiko09 (small blind) folded before Flop
Seat 7: AlKatrone (big blind) folded before Flop
Seat 8: Painkiller72 folded before Flop (didn't bet)
Seat 9: ardo888 folded before Flop (didn't bet)





PokerStars Hand #151206909166:  Hold'em No Limit ($1/$2 USD) - 2016/03/31 12:08:11 CET [2016/03/31 6:08:11 ET]
Table 'Desiderata' 9-max Seat #4 is the button
Seat 1: GALWACONT ($94.50 in chips) 
Seat 2: ilaviiitech ($219.35 in chips) 
Seat 3: InsomniaRU ($314.87 in chips) 
Seat 4: matiko09 ($200 in chips) 
Seat 5: Kreuznagel ($339.74 in chips) 
Seat 7: pulykakakas ($171.29 in chips) 
Seat 8: DUkalisUA ($204.55 in chips) 
Seat 9: Painkiller72 ($200 in chips) 
Kreuznagel: posts small blind $1
rmanjkeee: is sitting out 
pulykakakas: posts big blind $2
*** HOLE CARDS ***
Dealt to matiko09 [7h 9c]
DUkalisUA: folds 
Painkiller72: folds 
GALWACONT: folds 
ilaviiitech: folds 
InsomniaRU: folds 
matiko09: folds 
Kreuznagel: folds 
Uncalled bet ($1) returned to pulykakakas
pulykakakas collected $2 from pot
pulykakakas: doesn't show hand 
*** SUMMARY ***
Total pot $2 | Rake $0 
Seat 1: GALWACONT folded before Flop (didn't bet)
Seat 2: ilaviiitech folded before Flop (didn't bet)
Seat 3: InsomniaRU folded before Flop (didn't bet)
Seat 4: matiko09 (button) folded before Flop (didn't bet)
Seat 5: Kreuznagel (small blind) folded before Flop
Seat 7: pulykakakas (big blind) collected ($2)
Seat 8: DUkalisUA folded before Flop (didn't bet)
Seat 9: Painkiller72 folded before Flop (didn't bet)





PokerStars Hand #151206916688:  Hold'em No Limit ($1/$2 USD) - 2016/03/31 12:08:28 CET [2016/03/31 6:08:28 ET]
Table 'Cheruskia II' 9-max Seat #5 is the button
Seat 2: rmanjkeee ($203.15 in chips) 
Seat 4: riverfish786 ($387.11 in chips) 
Seat 5: matiko09 ($200 in chips) 
Seat 6: RAISYDA1SY ($88.94 in chips) 
Seat 7: BOAYARSKIY ($106.08 in chips) 
Seat 8: apfush ($203 in chips) 
Seat 9: Kreuznagel ($335.64 in chips) 
RAISYDA1SY: posts small blind $1
BOAYARSKIY: posts big blind $2
DUkalisUA: sits out 
*** HOLE CARDS ***
Dealt to matiko09 [2d Td]
apfush: folds 
Kreuznagel: folds 
rmanjkeee: folds 
riverfish786: folds 
thecurv leaves the table
matiko09: folds 
RAISYDA1SY: calls $1
BOAYARSKIY: raises $6 to $8
RAISYDA1SY: calls $6
*** FLOP *** [5d 9s 9h]
InsomniaRU joins the table at seat #1 
RAISYDA1SY: checks 
InsomniaRU leaves the table
BOAYARSKIY: checks 
*** TURN *** [5d 9s 9h] [3h]
RAISYDA1SY: checks 
BOAYARSKIY: bets $9
PacPacBum joins the table at seat #1 
RAISYDA1SY: folds 
Uncalled bet ($9) returned to BOAYARSKIY
BOAYARSKIY collected $15.20 from pot
BOAYARSKIY: doesn't show hand 
*** SUMMARY ***
Total pot $16 | Rake $0.80 
Board [5d 9s 9h 3h]
Seat 2: rmanjkeee folded before Flop (didn't bet)
Seat 4: riverfish786 folded before Flop (didn't bet)
Seat 5: matiko09 (button) folded before Flop (didn't bet)
Seat 6: RAISYDA1SY (small blind) folded on the Turn
Seat 7: BOAYARSKIY (big blind) collected ($15.20)
Seat 8: apfush folded before Flop (didn't bet)
Seat 9: Kreuznagel folded before Flop (didn't bet)





PokerStars Hand #151206917445:  Hold'em No Limit (€0.50/€1.00 EUR) - 2016/03/31 12:08:30 CET [2016/03/31 6:08:30 ET]
Table 'Pioneer II' 9-max Seat #6 is the button
Seat 1: Kreuznagel (€106.23 in chips) 
Seat 2: IdiotFromNE (€102.12 in chips) 
Seat 3: vrnMike (€100.39 in chips) 
Seat 4: Zeeshka (€100 in chips) 
Seat 5: MickChick24 (€114.44 in chips) 
Seat 6: matiko09 (€100 in chips) 
Seat 7: AlKatrone (€120.17 in chips) 
Seat 8: Painkiller72 (€139.23 in chips) 
Seat 9: ardo888 (€131.01 in chips) 
AlKatrone: posts small blind €0.50
Painkiller72: posts big blind €1
*** HOLE CARDS ***
Dealt to matiko09 [7h 2c]
ardo888: folds 
Kreuznagel: folds 
IdiotFromNE: folds 
vrnMike: folds 
Zeeshka: folds 
MickChick24: folds 
matiko09: folds 
AlKatrone: raises €2 to €3
Painkiller72: folds 
Uncalled bet (€2) returned to AlKatrone
AlKatrone collected €2 from pot
AlKatrone: doesn't show hand 
*** SUMMARY ***
Total pot €2 | Rake €0 
Seat 1: Kreuznagel folded before Flop (didn't bet)
Seat 2: IdiotFromNE folded before Flop (didn't bet)
Seat 3: vrnMike folded before Flop (didn't bet)
Seat 4: Zeeshka folded before Flop (didn't bet)
Seat 5: MickChick24 folded before Flop (didn't bet)
Seat 6: matiko09 (button) folded before Flop (didn't bet)
Seat 7: AlKatrone (small blind) collected (€2)
Seat 8: Painkiller72 (big blind) folded before Flop
Seat 9: ardo888 folded before Flop (didn't bet)





PokerStars Hand #151206924012:  Hold'em No Limit ($0.50/$1.00 USD) - 2016/03/31 12:08:45 CET [2016/03/31 6:08:45 ET]
Table 'Herge II' 9-max Seat #4 is the button
Seat 1: Chiapel ($98.31 in chips) 
Seat 3: matiko09 ($101.50 in chips) 
Seat 4: vrnMike ($114.73 in chips) 
Seat 5: I The King I ($100 in chips) 
Seat 6: masaytoo ($117.89 in chips) 
Seat 7: Zeeshka ($105.14 in chips) 
Seat 8: IdiotFromNE ($100 in chips) 
Seat 9: fatstacks122 ($95.50 in chips) 
I The King I: posts small blind $0.50
masaytoo: posts big blind $1
fatstacks122: posts small & big blinds $1.50
DUkalisUA: sits out 
*** HOLE CARDS ***
Dealt to matiko09 [Kc 4s]
Zeeshka: folds 
IdiotFromNE: folds 
fatstacks122: checks 
Chiapel: folds 
matiko09: folds 
vrnMike: raises $3 to $4
I The King I: folds 
masaytoo: folds 
fatstacks122: folds 
Uncalled bet ($3) returned to vrnMike
vrnMike collected $4 from pot
*** SUMMARY ***
Total pot $4 | Rake $0 
Seat 1: Chiapel folded before Flop (didn't bet)
Seat 3: matiko09 folded before Flop (didn't bet)
Seat 4: vrnMike (button) collected ($4)
Seat 5: I The King I (small blind) folded before Flop
Seat 6: masaytoo (big blind) folded before Flop
Seat 7: Zeeshka folded before Flop (didn't bet)
Seat 8: IdiotFromNE folded before Flop (didn't bet)
Seat 9: fatstacks122 folded before Flop





PokerStars Hand #151206925124:  Hold'em No Limit ($1/$2 USD) - 2016/03/31 12:08:47 CET [2016/03/31 6:08:47 ET]
Table 'Desiderata' 9-max Seat #5 is the button
Seat 1: GALWACONT ($94.50 in chips) 
Seat 2: ilaviiitech ($219.35 in chips) 
Seat 3: InsomniaRU ($314.87 in chips) 
Seat 4: matiko09 ($200 in chips) 
Seat 5: Kreuznagel ($338.74 in chips) 
Seat 7: pulykakakas ($172.29 in chips) 
Seat 8: DUkalisUA ($204.55 in chips) 
Seat 9: Painkiller72 ($200 in chips) 
pulykakakas: posts small blind $1
DUkalisUA: posts big blind $2
*** HOLE CARDS ***
Dealt to matiko09 [3h 5c]
Painkiller72: folds 
GALWACONT: folds 
ilaviiitech: folds 
InsomniaRU: raises $3 to $5
matiko09: folds 
Kreuznagel: folds 
pulykakakas: raises $11 to $16
DUkalisUA: folds 
InsomniaRU: calls $11
*** FLOP *** [9s As 4c]
pulykakakas: bets $16.15
InsomniaRU: folds 
Uncalled bet ($16.15) returned to pulykakakas
pulykakakas collected $32.30 from pot
pulykakakas: doesn't show hand 
*** SUMMARY ***
Total pot $34 | Rake $1.70 
Board [9s As 4c]
Seat 1: GALWACONT folded before Flop (didn't bet)
Seat 2: ilaviiitech folded before Flop (didn't bet)
Seat 3: InsomniaRU folded on the Flop
Seat 4: matiko09 folded before Flop (didn't bet)
Seat 5: Kreuznagel (button) folded before Flop (didn't bet)
Seat 7: pulykakakas (small blind) collected ($32.30)
Seat 8: DUkalisUA (big blind) folded before Flop
Seat 9: Painkiller72 folded before Flop (didn't bet)





PokerStars Hand #151206930857:  Hold'em No Limit ($0.50/$1.00 USD) - 2016/03/31 12:09:00 CET [2016/03/31 6:09:00 ET]
Table 'Leonid II' 9-max Seat #2 is the button
Seat 1: matiko09 ($110.42 in chips) 
Seat 2: ilaviiitech ($100 in chips) 
Seat 3: Painkiller72 ($102.50 in chips) 
Seat 4: vrnMike ($106 in chips) 
Seat 5: Zeeshka ($100.40 in chips) 
Seat 6: I The King I ($104.62 in chips) 
Seat 7: IdiotFromNE ($100 in chips) 
Seat 8: DUkalisUA ($100 in chips) 
Painkiller72: posts small blind $0.50
vrnMike: posts big blind $1
*** HOLE CARDS ***
Dealt to matiko09 [2d 7h]
Zeeshka: folds 
I The King I: folds 
IdiotFromNE: folds 
DUkalisUA: raises $2 to $3
matiko09: folds 
ilaviiitech: folds 
Painkiller72: folds 
vrnMike: folds 
Uncalled bet ($2) returned to DUkalisUA
DUkalisUA collected $2.50 from pot
DUkalisUA: doesn't show hand 
*** SUMMARY ***
Total pot $2.50 | Rake $0 
Seat 1: matiko09 folded before Flop (didn't bet)
Seat 2: ilaviiitech (button) folded before Flop (didn't bet)
Seat 3: Painkiller72 (small blind) folded before Flop
Seat 4: vrnMike (big blind) folded before Flop
Seat 5: Zeeshka folded before Flop (didn't bet)
Seat 6: I The King I folded before Flop (didn't bet)
Seat 7: IdiotFromNE folded before Flop (didn't bet)
Seat 8: DUkalisUA collected ($2.50)





PokerStars Hand #151206937520:  Hold'em No Limit (€0.50/€1.00 EUR) - 2016/03/31 12:09:15 CET [2016/03/31 6:09:15 ET]
Table 'Pioneer II' 9-max Seat #7 is the button
Seat 1: Kreuznagel (€106.23 in chips) 
Seat 2: IdiotFromNE (€102.12 in chips) 
Seat 3: vrnMike (€100.39 in chips) 
Seat 4: Zeeshka (€100 in chips) 
Seat 5: MickChick24 (€114.44 in chips) 
Seat 6: matiko09 (€100 in chips) 
Seat 7: AlKatrone (€121.17 in chips) 
Seat 8: Painkiller72 (€138.23 in chips) 
Painkiller72: posts small blind €0.50
ardo888: is sitting out 
Kreuznagel: posts big blind €1
*** HOLE CARDS ***
Dealt to matiko09 [3c Ts]
ardo888 leaves the table
DUkalisUA joins the table at seat #9 
IdiotFromNE: folds 
vrnMike: folds 
Zeeshka: folds 
MickChick24: folds 
matiko09: folds 
AlKatrone: raises €1.25 to €2.25
Painkiller72: folds 
Kreuznagel: calls €1.25
*** FLOP *** [6h Tc 7h]
Kreuznagel: checks 
AlKatrone: checks 
*** TURN *** [6h Tc 7h] [3s]
Kreuznagel: bets €3.51
AlKatrone: folds 
Uncalled bet (€3.51) returned to Kreuznagel
Kreuznagel collected €4.75 from pot
Kreuznagel: doesn't show hand 
*** SUMMARY ***
Total pot €5 | Rake €0.25 
Board [6h Tc 7h 3s]
Seat 1: Kreuznagel (big blind) collected (€4.75)
Seat 2: IdiotFromNE folded before Flop (didn't bet)
Seat 3: vrnMike folded before Flop (didn't bet)
Seat 4: Zeeshka folded before Flop (didn't bet)
Seat 5: MickChick24 folded before Flop (didn't bet)
Seat 6: matiko09 folded before Flop (didn't bet)
Seat 7: AlKatrone (button) folded on the Turn
Seat 8: Painkiller72 (small blind) folded before Flop





PokerStars Hand #151206940772:  Hold'em No Limit ($0.50/$1.00 USD) - 2016/03/31 12:09:22 CET [2016/03/31 6:09:22 ET]
Table 'Leonid II' 9-max Seat #3 is the button
Seat 1: matiko09 ($110.42 in chips) 
Seat 2: ilaviiitech ($100 in chips) 
Seat 3: Painkiller72 ($102 in chips) 
Seat 4: vrnMike ($105 in chips) 
Seat 5: Zeeshka ($100.40 in chips) 
Seat 6: I The King I ($104.62 in chips) 
Seat 7: IdiotFromNE ($100 in chips) 
Seat 8: DUkalisUA ($101.50 in chips) 
vrnMike: posts small blind $0.50
Zeeshka: posts big blind $1
*** HOLE CARDS ***
Dealt to matiko09 [Th 7s]
I The King I: folds 
IdiotFromNE: folds 
DUkalisUA: folds 
matiko09: folds 
ilaviiitech: folds 
Painkiller72: folds 
vrnMike: folds 
Uncalled bet ($0.50) returned to Zeeshka
Zeeshka collected $1 from pot
Zeeshka: doesn't show hand 
*** SUMMARY ***
Total pot $1 | Rake $0 
Seat 1: matiko09 folded before Flop (didn't bet)
Seat 2: ilaviiitech folded before Flop (didn't bet)
Seat 3: Painkiller72 (button) folded before Flop (didn't bet)
Seat 4: vrnMike (small blind) folded before Flop
Seat 5: Zeeshka (big blind) collected ($1)
Seat 6: I The King I folded before Flop (didn't bet)
Seat 7: IdiotFromNE folded before Flop (didn't bet)
Seat 8: DUkalisUA folded before Flop (didn't bet)





PokerStars Hand #151206946241:  Hold'em No Limit ($0.50/$1.00 USD) - 2016/03/31 12:09:35 CET [2016/03/31 6:09:35 ET]
Table 'Herge II' 9-max Seat #5 is the button
Seat 3: matiko09 ($101.50 in chips) 
Seat 4: vrnMike ($117.73 in chips) 
Seat 5: I The King I ($100 in chips) 
Seat 6: masaytoo ($116.89 in chips) 
Seat 7: Zeeshka ($105.14 in chips) 
Seat 8: IdiotFromNE ($100 in chips) 
Seat 9: fatstacks122 ($94 in chips) 
masaytoo: posts small blind $0.50
Zeeshka: posts big blind $1
DUkalisUA: sits out 
*** HOLE CARDS ***
Dealt to matiko09 [2c 4d]
IdiotFromNE: raises $1.50 to $2.50
fatstacks122: folds 
matiko09: folds 
vrnMike: folds 
I The King I: folds 
masaytoo: folds 
Zeeshka: folds 
Uncalled bet ($1.50) returned to IdiotFromNE
IdiotFromNE collected $2.50 from pot
IdiotFromNE: doesn't show hand 
*** SUMMARY ***
Total pot $2.50 | Rake $0 
Seat 3: matiko09 folded before Flop (didn't bet)
Seat 4: vrnMike folded before Flop (didn't bet)
Seat 5: I The King I (button) folded before Flop (didn't bet)
Seat 6: masaytoo (small blind) folded before Flop
Seat 7: Zeeshka (big blind) folded before Flop
Seat 8: IdiotFromNE collected ($2.50)
Seat 9: fatstacks122 folded before Flop (didn't bet)





PokerStars Hand #151206947915:  Hold'em No Limit ($1/$2 USD) - 2016/03/31 12:09:38 CET [2016/03/31 6:09:38 ET]
Table 'Cheruskia II' 9-max Seat #6 is the button
Seat 2: rmanjkeee ($203.15 in chips) 
Seat 4: riverfish786 ($387.11 in chips) 
Seat 5: matiko09 ($200 in chips) 
Seat 6: RAISYDA1SY ($80.94 in chips) 
Seat 7: BOAYARSKIY ($113.28 in chips) 
Seat 8: apfush ($203 in chips) 
Seat 9: Kreuznagel ($335.64 in chips) 
BOAYARSKIY: posts small blind $1
apfush: posts big blind $2
PacPacBum: sits out 
DUkalisUA: sits out 
*** HOLE CARDS ***
Dealt to matiko09 [3c 6c]
Kreuznagel: folds 
rmanjkeee: folds 
riverfish786: folds 
matiko09: folds 
RAISYDA1SY: raises $4 to $6
BOAYARSKIY: folds 
apfush: folds 
Uncalled bet ($4) returned to RAISYDA1SY
RAISYDA1SY collected $5 from pot
*** SUMMARY ***
Total pot $5 | Rake $0 
Seat 2: rmanjkeee folded before Flop (didn't bet)
Seat 4: riverfish786 folded before Flop (didn't bet)
Seat 5: matiko09 folded before Flop (didn't bet)
Seat 6: RAISYDA1SY (button) collected ($5)
Seat 7: BOAYARSKIY (small blind) folded before Flop
Seat 8: apfush (big blind) folded before Flop
Seat 9: Kreuznagel folded before Flop (didn't bet)





PokerStars Hand #151206949043:  Hold'em No Limit ($1/$2 USD) - 2016/03/31 12:09:41 CET [2016/03/31 6:09:41 ET]
Table 'Desiderata' 9-max Seat #7 is the button
Seat 1: GALWACONT ($94.50 in chips) 
Seat 2: ilaviiitech ($219.35 in chips) 
Seat 3: InsomniaRU ($298.87 in chips) 
Seat 4: matiko09 ($200 in chips) 
Seat 5: Kreuznagel ($338.74 in chips) 
Seat 7: pulykakakas ($188.59 in chips) 
Seat 8: DUkalisUA ($202.55 in chips) 
Seat 9: Painkiller72 ($200 in chips) 
DUkalisUA: posts small blind $1
Painkiller72: posts big blind $2
*** HOLE CARDS ***
Dealt to matiko09 [2c Tc]
GALWACONT: calls $2
ilaviiitech: folds 
InsomniaRU: folds 
matiko09: folds 
Kreuznagel: raises $3 to $5
pulykakakas: folds 
DUkalisUA: folds 
Painkiller72: folds 
GALWACONT: calls $3
*** FLOP *** [9c Qh 6h]
GALWACONT: checks 
Kreuznagel: checks 
*** TURN *** [9c Qh 6h] [5d]
GALWACONT: bets $12.35
Kreuznagel: folds 
Uncalled bet ($12.35) returned to GALWACONT
GALWACONT collected $12.35 from pot
GALWACONT: doesn't show hand 
*** SUMMARY ***
Total pot $13 | Rake $0.65 
Board [9c Qh 6h 5d]
Seat 1: GALWACONT collected ($12.35)
Seat 2: ilaviiitech folded before Flop (didn't bet)
Seat 3: InsomniaRU folded before Flop (didn't bet)
Seat 4: matiko09 folded before Flop (didn't bet)
Seat 5: Kreuznagel folded on the Turn
Seat 7: pulykakakas (button) folded before Flop (didn't bet)
Seat 8: DUkalisUA (small blind) folded before Flop
Seat 9: Painkiller72 (big blind) folded before Flop





PokerStars Hand #151206956303:  Hold'em No Limit ($0.50/$1.00 USD) - 2016/03/31 12:09:57 CET [2016/03/31 6:09:57 ET]
Table 'Leonid II' 9-max Seat #4 is the button
Seat 1: matiko09 ($110.42 in chips) 
Seat 2: ilaviiitech ($100 in chips) 
Seat 3: Painkiller72 ($102 in chips) 
Seat 4: vrnMike ($104.50 in chips) 
Seat 5: Zeeshka ($100.90 in chips) 
Seat 6: I The King I ($104.62 in chips) 
Seat 7: IdiotFromNE ($100 in chips) 
Seat 8: DUkalisUA ($101.50 in chips) 
Zeeshka: posts small blind $0.50
I The King I: posts big blind $1
*** HOLE CARDS ***
Dealt to matiko09 [9c 8d]
IdiotFromNE: folds 
DUkalisUA: raises $2 to $3
matiko09: folds 
ilaviiitech: folds 
Painkiller72: folds 
vrnMike: folds 
Zeeshka: folds 
I The King I: folds 
Uncalled bet ($2) returned to DUkalisUA
DUkalisUA collected $2.50 from pot
DUkalisUA: doesn't show hand 
*** SUMMARY ***
Total pot $2.50 | Rake $0 
Seat 1: matiko09 folded before Flop (didn't bet)
Seat 2: ilaviiitech folded before Flop (didn't bet)
Seat 3: Painkiller72 folded before Flop (didn't bet)
Seat 4: vrnMike (button) folded before Flop (didn't bet)
Seat 5: Zeeshka (small blind) folded before Flop
Seat 6: I The King I (big blind) folded before Flop
Seat 7: IdiotFromNE folded before Flop (didn't bet)
Seat 8: DUkalisUA collected ($2.50)





PokerStars Hand #151206957748:  Hold'em No Limit ($1/$2 USD) - 2016/03/31 12:10:01 CET [2016/03/31 6:10:01 ET]
Table 'Cheruskia II' 9-max Seat #7 is the button
Seat 2: rmanjkeee ($203.15 in chips) 
Seat 4: riverfish786 ($387.11 in chips) 
Seat 5: matiko09 ($200 in chips) 
Seat 6: RAISYDA1SY ($83.94 in chips) 
Seat 7: BOAYARSKIY ($112.28 in chips) 
Seat 8: apfush ($201 in chips) 
Seat 9: Kreuznagel ($335.64 in chips) 
apfush: posts small blind $1
Kreuznagel: posts big blind $2
PacPacBum: sits out 
DUkalisUA: sits out 
*** HOLE CARDS ***
Dealt to matiko09 [3c As]
rmanjkeee: raises $3 to $5
riverfish786: calls $5
matiko09: folds 
RAISYDA1SY: folds 
BOAYARSKIY: calls $5
apfush: folds 
Kreuznagel: folds 
*** FLOP *** [5c 4h 5h]
rmanjkeee: checks 
riverfish786: bets $7.67
BOAYARSKIY: folds 
rmanjkeee: calls $7.67
*** TURN *** [5c 4h 5h] [7c]
rmanjkeee: checks 
riverfish786: checks 
*** RIVER *** [5c 4h 5h 7c] [2s]
rmanjkeee: bets $22
riverfish786: folds 
Uncalled bet ($22) returned to rmanjkeee
rmanjkeee collected $31.67 from pot
rmanjkeee: doesn't show hand 
*** SUMMARY ***
Total pot $33.34 | Rake $1.67 
Board [5c 4h 5h 7c 2s]
Seat 2: rmanjkeee collected ($31.67)
Seat 4: riverfish786 folded on the River
Seat 5: matiko09 folded before Flop (didn't bet)
Seat 6: RAISYDA1SY folded before Flop (didn't bet)
Seat 7: BOAYARSKIY (button) folded on the Flop
Seat 8: apfush (small blind) folded before Flop
Seat 9: Kreuznagel (big blind) folded before Flop





PokerStars Hand #151206972417:  Hold'em No Limit ($0.50/$1.00 USD) - 2016/03/31 12:10:34 CET [2016/03/31 6:10:34 ET]
Table 'Herge II' 9-max Seat #6 is the button
Seat 3: matiko09 ($101.50 in chips) 
Seat 4: vrnMike ($117.73 in chips) 
Seat 5: I The King I ($100 in chips) 
Seat 6: masaytoo ($116.39 in chips) 
Seat 7: Zeeshka ($104.14 in chips) 
Seat 8: IdiotFromNE ($101.50 in chips) 
Seat 9: fatstacks122 ($94 in chips) 
Zeeshka: posts small blind $0.50
IdiotFromNE: posts big blind $1
DUkalisUA: sits out 
*** HOLE CARDS ***
Dealt to matiko09 [5s Qd]
fatstacks122: folds 
matiko09: folds 
vrnMike: folds 
I The King I: raises $1.50 to $2.50
masaytoo: folds 
Zeeshka: folds 
IdiotFromNE: folds 
Uncalled bet ($1.50) returned to I The King I
I The King I collected $2.50 from pot
I The King I: doesn't show hand 
*** SUMMARY ***
Total pot $2.50 | Rake $0 
Seat 3: matiko09 folded before Flop (didn't bet)
Seat 4: vrnMike folded before Flop (didn't bet)
Seat 5: I The King I collected ($2.50)
Seat 6: masaytoo (button) folded before Flop (didn't bet)
Seat 7: Zeeshka (small blind) folded before Flop
Seat 8: IdiotFromNE (big blind) folded before Flop
Seat 9: fatstacks122 folded before Flop (didn't bet)





PokerStars Hand #151206972619:  Hold'em No Limit (€0.50/€1.00 EUR) - 2016/03/31 12:10:34 CET [2016/03/31 6:10:34 ET]
Table 'Pioneer II' 9-max Seat #8 is the button
Seat 1: Kreuznagel (€108.73 in chips) 
Seat 2: IdiotFromNE (€102.12 in chips) 
Seat 3: vrnMike (€100.39 in chips) 
Seat 4: Zeeshka (€100 in chips) 
Seat 5: MickChick24 (€114.44 in chips) 
Seat 6: matiko09 (€100 in chips) 
Seat 7: AlKatrone (€118.92 in chips) 
Seat 8: Painkiller72 (€137.73 in chips) 
DUkalisUA will be allowed to play after the button
Kreuznagel: posts small blind €0.50
IdiotFromNE: posts big blind €1
*** HOLE CARDS ***
Dealt to matiko09 [2h Kh]
vrnMike: folds 
Zeeshka: folds 
MickChick24: calls €1
matiko09: folds 
AlKatrone: raises €3 to €4
Painkiller72: folds 
Kreuznagel: folds 
IdiotFromNE: calls €3
MickChick24: calls €3
*** FLOP *** [5c Tc 4h]
IdiotFromNE: bets €9.50
MickChick24: folds 
AlKatrone: folds 
Uncalled bet (€9.50) returned to IdiotFromNE
IdiotFromNE collected €11.88 from pot
IdiotFromNE: doesn't show hand 
*** SUMMARY ***
Total pot €12.50 | Rake €0.62 
Board [5c Tc 4h]
Seat 1: Kreuznagel (small blind) folded before Flop
Seat 2: IdiotFromNE (big blind) collected (€11.88)
Seat 3: vrnMike folded before Flop (didn't bet)
Seat 4: Zeeshka folded before Flop (didn't bet)
Seat 5: MickChick24 folded on the Flop
Seat 6: matiko09 folded before Flop (didn't bet)
Seat 7: AlKatrone folded on the Flop
Seat 8: Painkiller72 (button) folded before Flop (didn't bet)





PokerStars Hand #151206972931:  Hold'em No Limit ($0.50/$1.00 USD) - 2016/03/31 12:10:35 CET [2016/03/31 6:10:35 ET]
Table 'Leonid II' 9-max Seat #5 is the button
Seat 1: matiko09 ($110.42 in chips) 
Seat 2: ilaviiitech ($100 in chips) 
Seat 3: Painkiller72 ($102 in chips) 
Seat 4: vrnMike ($104.50 in chips) 
Seat 5: Zeeshka ($100.40 in chips) 
Seat 6: I The King I ($103.62 in chips) 
Seat 7: IdiotFromNE ($100 in chips) 
Seat 8: DUkalisUA ($103 in chips) 
I The King I: posts small blind $0.50
IdiotFromNE: posts big blind $1
*** HOLE CARDS ***
Dealt to matiko09 [6d 9d]
DUkalisUA: folds 
matiko09: folds 
ilaviiitech: folds 
Painkiller72: folds 
vrnMike: folds 
Zeeshka: raises $1.50 to $2.50
I The King I: folds 
IdiotFromNE: folds 
Uncalled bet ($1.50) returned to Zeeshka
Zeeshka collected $2.50 from pot
Zeeshka: doesn't show hand 
*** SUMMARY ***
Total pot $2.50 | Rake $0 
Seat 1: matiko09 folded before Flop (didn't bet)
Seat 2: ilaviiitech folded before Flop (didn't bet)
Seat 3: Painkiller72 folded before Flop (didn't bet)
Seat 4: vrnMike folded before Flop (didn't bet)
Seat 5: Zeeshka (button) collected ($2.50)
Seat 6: I The King I (small blind) folded before Flop
Seat 7: IdiotFromNE (big blind) folded before Flop
Seat 8: DUkalisUA folded before Flop (didn't bet)





PokerStars Hand #151206976559:  Hold'em No Limit ($1/$2 USD) - 2016/03/31 12:10:43 CET [2016/03/31 6:10:43 ET]
Table 'Desiderata' 9-max Seat #8 is the button
Seat 1: GALWACONT ($101.85 in chips) 
Seat 2: ilaviiitech ($219.35 in chips) 
Seat 3: InsomniaRU ($298.87 in chips) 
Seat 4: matiko09 ($200 in chips) 
Seat 5: Kreuznagel ($333.74 in chips) 
Seat 7: pulykakakas ($188.59 in chips) 
Seat 8: DUkalisUA ($201.55 in chips) 
Seat 9: Painkiller72 ($200 in chips) 
Painkiller72: posts small blind $1
GALWACONT: posts big blind $2
*** HOLE CARDS ***
Dealt to matiko09 [7s 2d]
ilaviiitech: folds 
InsomniaRU: folds 
matiko09: folds 
Kreuznagel: raises $2.78 to $4.78
pulykakakas: calls $4.78
DUkalisUA: folds 
Painkiller72: folds 
GALWACONT: calls $2.78
*** FLOP *** [6h 3h 4s]
GALWACONT: checks 
Kreuznagel: checks 
pulykakakas: checks 
*** TURN *** [6h 3h 4s] [7h]
GALWACONT: bets $14.57
Kreuznagel: folds 
pulykakakas: folds 
Uncalled bet ($14.57) returned to GALWACONT
GALWACONT collected $14.57 from pot
GALWACONT: doesn't show hand 
*** SUMMARY ***
Total pot $15.34 | Rake $0.77 
Board [6h 3h 4s 7h]
Seat 1: GALWACONT (big blind) collected ($14.57)
Seat 2: ilaviiitech folded before Flop (didn't bet)
Seat 3: InsomniaRU folded before Flop (didn't bet)
Seat 4: matiko09 folded before Flop (didn't bet)
Seat 5: Kreuznagel folded on the Turn
Seat 7: pulykakakas folded on the Turn
Seat 8: DUkalisUA (button) folded before Flop (didn't bet)
Seat 9: Painkiller72 (small blind) folded before Flop





PokerStars Hand #151206987354:  Hold'em No Limit ($0.50/$1.00 USD) - 2016/03/31 12:11:07 CET [2016/03/31 6:11:07 ET]
Table 'Leonid II' 9-max Seat #6 is the button
Seat 1: matiko09 ($110.42 in chips) 
Seat 2: ilaviiitech ($100 in chips) 
Seat 3: Painkiller72 ($102 in chips) 
Seat 4: vrnMike ($104.50 in chips) 
Seat 5: Zeeshka ($101.90 in chips) 
Seat 6: I The King I ($103.12 in chips) 
Seat 7: IdiotFromNE ($100 in chips) 
Seat 8: DUkalisUA ($103 in chips) 
IdiotFromNE: posts small blind $0.50
DUkalisUA: posts big blind $1
*** HOLE CARDS ***
Dealt to matiko09 [Ac 4d]
matiko09: folds 
ilaviiitech: folds 
Painkiller72: raises $1.50 to $2.50
vrnMike: folds 
Zeeshka: calls $2.50
bakus416 leaves the table
I The King I: folds 
IdiotFromNE: folds 
DUkalisUA: calls $1.50
*** FLOP *** [5c 5s 2s]
DUkalisUA: checks 
Painkiller72: checks 
Zeeshka: bets $4.18
DUkalisUA: calls $4.18
Painkiller72: folds 
*** TURN *** [5c 5s 2s] [Qd]
DUkalisUA: checks 
Zeeshka: checks 
*** RIVER *** [5c 5s 2s Qd] [Jc]
DUkalisUA: checks 
Zeeshka: checks 
*** SHOW DOWN ***
DUkalisUA: shows [9d 9c] (two pair, Nines and Fives)
Zeeshka: mucks hand 
DUkalisUA collected $15.54 from pot
*** SUMMARY ***
Total pot $16.36 | Rake $0.82 
Board [5c 5s 2s Qd Jc]
Seat 1: matiko09 folded before Flop (didn't bet)
Seat 2: ilaviiitech folded before Flop (didn't bet)
Seat 3: Painkiller72 folded on the Flop
Seat 4: vrnMike folded before Flop (didn't bet)
Seat 5: Zeeshka mucked [6c 6d]
Seat 6: I The King I (button) folded before Flop (didn't bet)
Seat 7: IdiotFromNE (small blind) folded before Flop
Seat 8: DUkalisUA (big blind) showed [9d 9c] and won ($15.54) with two pair, Nines and Fives





PokerStars Hand #151206989449:  Hold'em No Limit ($0.50/$1.00 USD) - 2016/03/31 12:11:12 CET [2016/03/31 6:11:12 ET]
Table 'Herge II' 9-max Seat #7 is the button
Seat 3: matiko09 ($101.50 in chips) 
Seat 4: vrnMike ($117.73 in chips) 
Seat 5: I The King I ($101.50 in chips) 
Seat 6: masaytoo ($116.39 in chips) 
Seat 7: Zeeshka ($103.64 in chips) 
Seat 8: IdiotFromNE ($100.50 in chips) 
Seat 9: fatstacks122 ($94 in chips) 
IdiotFromNE: posts small blind $0.50
fatstacks122: posts big blind $1
DUkalisUA: sits out 
*** HOLE CARDS ***
Dealt to matiko09 [2s 6c]
matiko09: folds 
vrnMike: folds 
I The King I: folds 
masaytoo: raises $2 to $3
Zeeshka: folds 
IdiotFromNE: folds 
fatstacks122: raises $6 to $9
masaytoo: calls $6
*** FLOP *** [Jc 3h Kc]
fatstacks122: bets $6
masaytoo: folds 
Uncalled bet ($6) returned to fatstacks122
fatstacks122 collected $17.58 from pot
fatstacks122: doesn't show hand 
*** SUMMARY ***
Total pot $18.50 | Rake $0.92 
Board [Jc 3h Kc]
Seat 3: matiko09 folded before Flop (didn't bet)
Seat 4: vrnMike folded before Flop (didn't bet)
Seat 5: I The King I folded before Flop (didn't bet)
Seat 6: masaytoo folded on the Flop
Seat 7: Zeeshka (button) folded before Flop (didn't bet)
Seat 8: IdiotFromNE (small blind) folded before Flop
Seat 9: fatstacks122 (big blind) collected ($17.58)





PokerStars Hand #151207003853:  Hold'em No Limit ($0.50/$1.00 USD) - 2016/03/31 12:11:44 CET [2016/03/31 6:11:44 ET]
Table 'Celestia II' 9-max Seat #8 is the button
Seat 1: matiko09 ($100 in chips) 
Seat 2: ValentinChit ($73.38 in chips) 
Seat 3: ilaviiitech ($116.32 in chips) 
Seat 4: I The King I ($154.55 in chips) 
Seat 5: i am owsome ($148.11 in chips) 
Seat 6: IdiotFromNE ($100 in chips) 
Seat 8: DUkalisUA ($101.35 in chips) 
Seat 9: Chin41178 ($99 in chips) 
Chin41178: posts small blind $0.50
matiko09: posts big blind $1
Avtovo: sits out 
*** HOLE CARDS ***
Dealt to matiko09 [Qs Qc]
ValentinChit: calls $1
ilaviiitech: folds 
I The King I: folds 
i am owsome: folds 
IdiotFromNE: folds 
DUkalisUA: folds 
Chin41178: calls $0.50
matiko09: raises $5 to $6
ValentinChit: calls $5
Chin41178: folds 
*** FLOP *** [9s 3s 2h]
matiko09: bets $8.50
ValentinChit: calls $8.50
*** TURN *** [9s 3s 2h] [Th]
matiko09: bets $19
ValentinChit: calls $19
*** RIVER *** [9s 3s 2h Th] [2c]
matiko09: bets $40
ValentinChit: folds 
Uncalled bet ($40) returned to matiko09
matiko09 collected $65.50 from pot
matiko09: doesn't show hand 
*** SUMMARY ***
Total pot $68 | Rake $2.50 
Board [9s 3s 2h Th 2c]
Seat 1: matiko09 (big blind) collected ($65.50)
Seat 2: ValentinChit folded on the River
Seat 3: ilaviiitech folded before Flop (didn't bet)
Seat 4: I The King I folded before Flop (didn't bet)
Seat 5: i am owsome folded before Flop (didn't bet)
Seat 6: IdiotFromNE folded before Flop (didn't bet)
Seat 8: DUkalisUA (button) folded before Flop (didn't bet)
Seat 9: Chin41178 (small blind) folded before Flop





PokerStars Hand #151207004621:  Hold'em No Limit ($0.50/$1.00 USD) - 2016/03/31 12:11:46 CET [2016/03/31 6:11:46 ET]
Table 'Yazhi' 9-max Seat #8 is the button
Seat 1: matiko09 ($100 in chips) 
Seat 3: Painkiller72 ($102.18 in chips) 
Seat 4: apfush ($162.62 in chips) 
Seat 5: Kreuznagel ($105.18 in chips) 
Seat 6: Reven9er ($193.58 in chips) 
Seat 7: vrnMike ($100 in chips) 
Seat 8: pk4DW ($17.43 in chips) 
Seat 9: oscarleon ($203.32 in chips) 
oscarleon: posts small blind $0.50
matiko09: posts big blind $1
xHourglass: sits out 
*** HOLE CARDS ***
Dealt to matiko09 [Js 2s]
Painkiller72: raises $1.50 to $2.50
apfush: folds 
Kreuznagel: folds 
Reven9er: folds 
vrnMike: folds 
pk4DW: calls $2.50
oscarleon: folds 
matiko09: folds 
*** FLOP *** [Td Kd 8h]
Painkiller72: checks 
pk4DW: bets $3.09
Painkiller72: folds 
Uncalled bet ($3.09) returned to pk4DW
pk4DW collected $6.18 from pot
pk4DW: doesn't show hand 
*** SUMMARY ***
Total pot $6.50 | Rake $0.32 
Board [Td Kd 8h]
Seat 1: matiko09 (big blind) folded before Flop
Seat 3: Painkiller72 folded on the Flop
Seat 4: apfush folded before Flop (didn't bet)
Seat 5: Kreuznagel folded before Flop (didn't bet)
Seat 6: Reven9er folded before Flop (didn't bet)
Seat 7: vrnMike folded before Flop (didn't bet)
Seat 8: pk4DW (button) collected ($6.18)
Seat 9: oscarleon (small blind) folded before Flop





PokerStars Hand #151207009243:  Hold'em No Limit ($1/$2 USD) - 2016/03/31 12:11:56 CET [2016/03/31 6:11:56 ET]
Table 'Desiderata' 9-max Seat #9 is the button
Seat 1: GALWACONT ($111.64 in chips) 
Seat 2: ilaviiitech ($219.35 in chips) 
Seat 3: InsomniaRU ($298.87 in chips) 
Seat 4: matiko09 ($200 in chips) 
Seat 5: Kreuznagel ($328.96 in chips) 
Seat 7: pulykakakas ($183.81 in chips) 
Seat 8: DUkalisUA ($201.55 in chips) 
Seat 9: Painkiller72 ($200 in chips) 
GALWACONT: posts small blind $1
ilaviiitech: posts big blind $2
*** HOLE CARDS ***
Dealt to matiko09 [5c 3d]
InsomniaRU: folds 
matiko09: folds 
Kreuznagel: folds 
pulykakakas: folds 
DUkalisUA: folds 
Painkiller72: folds 
GALWACONT: calls $1
ilaviiitech: checks 
*** FLOP *** [8h 9c 2d]
GALWACONT: checks 
ilaviiitech: bets $3.04
GALWACONT: calls $3.04
*** TURN *** [8h 9c 2d] [6d]
GALWACONT: checks 
ilaviiitech: bets $8
GALWACONT: folds 
Uncalled bet ($8) returned to ilaviiitech
ilaviiitech collected $9.58 from pot
ilaviiitech: doesn't show hand 
*** SUMMARY ***
Total pot $10.08 | Rake $0.50 
Board [8h 9c 2d 6d]
Seat 1: GALWACONT (small blind) folded on the Turn
Seat 2: ilaviiitech (big blind) collected ($9.58)
Seat 3: InsomniaRU folded before Flop (didn't bet)
Seat 4: matiko09 folded before Flop (didn't bet)
Seat 5: Kreuznagel folded before Flop (didn't bet)
Seat 7: pulykakakas folded before Flop (didn't bet)
Seat 8: DUkalisUA folded before Flop (didn't bet)
Seat 9: Painkiller72 (button) folded before Flop (didn't bet)





PokerStars Hand #151207010145:  Hold'em No Limit ($1/$2 USD) - 2016/03/31 12:11:58 CET [2016/03/31 6:11:58 ET]
Table 'Cheruskia II' 9-max Seat #8 is the button
Seat 1: PacPacBum ($200 in chips) 
Seat 2: rmanjkeee ($222.15 in chips) 
Seat 4: riverfish786 ($374.44 in chips) 
Seat 5: matiko09 ($200 in chips) 
Seat 6: RAISYDA1SY ($83.94 in chips) 
Seat 7: BOAYARSKIY ($107.28 in chips) 
Seat 8: apfush ($200 in chips) 
Seat 9: Kreuznagel ($333.64 in chips) 
Kreuznagel: posts small blind $1
PacPacBum: posts big blind $2
DUkalisUA: sits out 
*** HOLE CARDS ***
Dealt to matiko09 [Ac Qd]
rmanjkeee: folds 
riverfish786: folds 
matiko09: raises $3 to $5
RAISYDA1SY: calls $5
BOAYARSKIY: calls $5
apfush: folds 
Kreuznagel: folds 
PacPacBum: folds 
*** FLOP *** [Kd Jc 5c]
matiko09: checks 
RAISYDA1SY: checks 
BOAYARSKIY: checks 
*** TURN *** [Kd Jc 5c] [5s]
matiko09: checks 
RAISYDA1SY: checks 
BOAYARSKIY: bets $11
matiko09: folds 
RAISYDA1SY: calls $11
*** RIVER *** [Kd Jc 5c 5s] [7d]
RAISYDA1SY: checks 
BOAYARSKIY: checks 
*** SHOW DOWN ***
RAISYDA1SY: shows [Td Ts] (two pair, Tens and Fives)
BOAYARSKIY: mucks hand 
RAISYDA1SY collected $38 from pot
*** SUMMARY ***
Total pot $40 | Rake $2 
Board [Kd Jc 5c 5s 7d]
Seat 1: PacPacBum (big blind) folded before Flop
Seat 2: rmanjkeee folded before Flop (didn't bet)
Seat 4: riverfish786 folded before Flop (didn't bet)
Seat 5: matiko09 folded on the Turn
Seat 6: RAISYDA1SY showed [Td Ts] and won ($38) with two pair, Tens and Fives
Seat 7: BOAYARSKIY mucked [Ah Th]
Seat 8: apfush (button) folded before Flop (didn't bet)
Seat 9: Kreuznagel (small blind) folded before Flop





PokerStars Hand #151207014116:  Hold'em No Limit (€0.50/€1.00 EUR) - 2016/03/31 12:12:07 CET [2016/03/31 6:12:07 ET]
Table 'Pioneer II' 9-max Seat #1 is the button
Seat 1: Kreuznagel (€108.23 in chips) 
Seat 2: IdiotFromNE (€110 in chips) 
Seat 3: vrnMike (€100.39 in chips) 
Seat 4: Zeeshka (€100 in chips) 
Seat 5: MickChick24 (€110.44 in chips) 
Seat 6: matiko09 (€100 in chips) 
Seat 7: AlKatrone (€114.92 in chips) 
Seat 8: Painkiller72 (€137.73 in chips) 
IdiotFromNE: posts small blind €0.50
vrnMike: posts big blind €1
DUkalisUA: sits out 
*** HOLE CARDS ***
Dealt to matiko09 [3h 6d]
Zeeshka: folds 
MickChick24: folds 
matiko09: folds 
AlKatrone: folds 
Painkiller72: folds 
Kreuznagel: folds 
IdiotFromNE: folds 
Uncalled bet (€0.50) returned to vrnMike
vrnMike collected €1 from pot
*** SUMMARY ***
Total pot €1 | Rake €0 
Seat 1: Kreuznagel (button) folded before Flop (didn't bet)
Seat 2: IdiotFromNE (small blind) folded before Flop
Seat 3: vrnMike (big blind) collected (€1)
Seat 4: Zeeshka folded before Flop (didn't bet)
Seat 5: MickChick24 folded before Flop (didn't bet)
Seat 6: matiko09 folded before Flop (didn't bet)
Seat 7: AlKatrone folded before Flop (didn't bet)
Seat 8: Painkiller72 folded before Flop (didn't bet)





PokerStars Hand #151207016201:  Hold'em No Limit ($0.50/$1.00 USD) - 2016/03/31 12:12:12 CET [2016/03/31 6:12:12 ET]
Table 'Dione III' 9-max Seat #8 is the button
Seat 1: matiko09 ($100 in chips) 
Seat 2: o.miro ($100 in chips) 
Seat 3: ilaviiitech ($154.10 in chips) 
Seat 4: Painkiller72 ($100 in chips) 
Seat 5: SnowKings ($40 in chips) 
Seat 7: Zeeshka ($100 in chips) 
Seat 8: DUkalisUA ($100 in chips) 
Seat 9: djammusic ($43 in chips) 
djammusic: posts small blind $0.50
matiko09: posts big blind $1
*** HOLE CARDS ***
Dealt to matiko09 [8s Kd]
o.miro: folds 
o.miro leaves the table
ilaviiitech: folds 
Painkiller72: folds 
SnowKings: folds 
Zeeshka: folds 
DUkalisUA: raises $1 to $2
djammusic: folds 
matiko09: calls $1
*** FLOP *** [7c Qd As]
matiko09: checks 
DUkalisUA: bets $3
vrnMike joins the table at seat #2 
matiko09: folds 
Uncalled bet ($3) returned to DUkalisUA
DUkalisUA collected $4.28 from pot
DUkalisUA: doesn't show hand 
*** SUMMARY ***
Total pot $4.50 | Rake $0.22 
Board [7c Qd As]
Seat 1: matiko09 (big blind) folded on the Flop
Seat 2: o.miro folded before Flop (didn't bet)
Seat 3: ilaviiitech folded before Flop (didn't bet)
Seat 4: Painkiller72 folded before Flop (didn't bet)
Seat 5: SnowKings folded before Flop (didn't bet)
Seat 7: Zeeshka folded before Flop (didn't bet)
Seat 8: DUkalisUA (button) collected ($4.28)
Seat 9: djammusic (small blind) folded before Flop





PokerStars Hand #151207025257:  Hold'em No Limit (€0.50/€1.00 EUR) - 2016/03/31 12:12:32 CET [2016/03/31 6:12:32 ET]
Table 'Pioneer II' 9-max Seat #2 is the button
Seat 1: Kreuznagel (€108.23 in chips) 
Seat 2: IdiotFromNE (€109.50 in chips) 
Seat 3: vrnMike (€100.89 in chips) 
Seat 4: Zeeshka (€100 in chips) 
Seat 5: MickChick24 (€110.44 in chips) 
Seat 6: matiko09 (€100 in chips) 
Seat 7: AlKatrone (€114.92 in chips) 
Seat 8: Painkiller72 (€137.73 in chips) 
vrnMike: posts small blind €0.50
Zeeshka: posts big blind €1
DUkalisUA: sits out 
*** HOLE CARDS ***
Dealt to matiko09 [7s 5d]
MickChick24: folds 
matiko09: folds 
AlKatrone: raises €2 to €3
Painkiller72: folds 
Kreuznagel: folds 
IdiotFromNE: folds 
vrnMike: folds 
Zeeshka: folds 
Uncalled bet (€2) returned to AlKatrone
AlKatrone collected €2.50 from pot
AlKatrone: doesn't show hand 
*** SUMMARY ***
Total pot €2.50 | Rake €0 
Seat 1: Kreuznagel folded before Flop (didn't bet)
Seat 2: IdiotFromNE (button) folded before Flop (didn't bet)
Seat 3: vrnMike (small blind) folded before Flop
Seat 4: Zeeshka (big blind) folded before Flop
Seat 5: MickChick24 folded before Flop (didn't bet)
Seat 6: matiko09 folded before Flop (didn't bet)
Seat 7: AlKatrone collected (€2.50)
Seat 8: Painkiller72 folded before Flop (didn't bet)





PokerStars Hand #151207024911:  Hold'em No Limit ($1/$2 USD) - 2016/03/31 12:12:32 CET [2016/03/31 6:12:32 ET]
Table 'Desiderata' 9-max Seat #1 is the button
Seat 1: GALWACONT ($106.60 in chips) 
Seat 2: ilaviiitech ($223.89 in chips) 
Seat 3: InsomniaRU ($298.87 in chips) 
Seat 4: matiko09 ($200 in chips) 
Seat 5: Kreuznagel ($328.96 in chips) 
Seat 7: pulykakakas ($183.81 in chips) 
Seat 8: DUkalisUA ($201.55 in chips) 
Seat 9: Painkiller72 ($200 in chips) 
ilaviiitech: posts small blind $1
InsomniaRU: posts big blind $2
*** HOLE CARDS ***
Dealt to matiko09 [9h Jd]
matiko09: folds 
Kreuznagel: folds 
pulykakakas: raises $4 to $6
DUkalisUA: folds 
Painkiller72: folds 
GALWACONT: calls $6
ilaviiitech: folds 
InsomniaRU: folds 
*** FLOP *** [5h 3d 2c]
pulykakakas: checks 
GALWACONT: checks 
*** TURN *** [5h 3d 2c] [As]
pulykakakas: bets $7.12
GALWACONT: folds 
Uncalled bet ($7.12) returned to pulykakakas
pulykakakas collected $14.25 from pot
pulykakakas: doesn't show hand 
*** SUMMARY ***
Total pot $15 | Rake $0.75 
Board [5h 3d 2c As]
Seat 1: GALWACONT (button) folded on the Turn
Seat 2: ilaviiitech (small blind) folded before Flop
Seat 3: InsomniaRU (big blind) folded before Flop
Seat 4: matiko09 folded before Flop (didn't bet)
Seat 5: Kreuznagel folded before Flop (didn't bet)
Seat 7: pulykakakas collected ($14.25)
Seat 8: DUkalisUA folded before Flop (didn't bet)
Seat 9: Painkiller72 folded before Flop (didn't bet)





PokerStars Hand #151207026828:  Hold'em No Limit ($0.50/$1.00 USD) - 2016/03/31 12:12:36 CET [2016/03/31 6:12:36 ET]
Table 'Yazhi' 9-max Seat #9 is the button
Seat 1: matiko09 ($100 in chips) 
Seat 2: xHourglass ($100 in chips) 
Seat 3: Painkiller72 ($100 in chips) 
Seat 4: apfush ($162.62 in chips) 
Seat 5: Kreuznagel ($105.18 in chips) 
Seat 6: Reven9er ($193.58 in chips) 
Seat 7: vrnMike ($100 in chips) 
Seat 8: pk4DW ($21.11 in chips) 
Seat 9: oscarleon ($202.82 in chips) 
matiko09: posts small blind $0.50
xHourglass: posts big blind $1
*** HOLE CARDS ***
Dealt to matiko09 [3d Kh]
Painkiller72: folds 
apfush: folds 
Kreuznagel: raises $1.39 to $2.39
Reven9er: calls $2.39
vrnMike: folds 
pk4DW: folds 
oscarleon: folds 
matiko09: folds 
xHourglass: folds 
*** FLOP *** [Qd 4h Js]
Kreuznagel: bets $4.15
Reven9er: folds 
Uncalled bet ($4.15) returned to Kreuznagel
Kreuznagel collected $5.97 from pot
Kreuznagel: doesn't show hand 
*** SUMMARY ***
Total pot $6.28 | Rake $0.31 
Board [Qd 4h Js]
Seat 1: matiko09 (small blind) folded before Flop
Seat 2: xHourglass (big blind) folded before Flop
Seat 3: Painkiller72 folded before Flop (didn't bet)
Seat 4: apfush folded before Flop (didn't bet)
Seat 5: Kreuznagel collected ($5.97)
Seat 6: Reven9er folded on the Flop
Seat 7: vrnMike folded before Flop (didn't bet)
Seat 8: pk4DW folded before Flop (didn't bet)
Seat 9: oscarleon (button) folded before Flop (didn't bet)





PokerStars Hand #151207029179:  Hold'em No Limit ($0.50/$1.00 USD) - 2016/03/31 12:12:41 CET [2016/03/31 6:12:41 ET]
Table 'Leonid II' 9-max Seat #7 is the button
Seat 1: matiko09 ($110.42 in chips) 
Seat 2: ilaviiitech ($100 in chips) 
Seat 3: Painkiller72 ($100 in chips) 
Seat 4: vrnMike ($104.50 in chips) 
Seat 5: Zeeshka ($100 in chips) 
Seat 6: I The King I ($103.12 in chips) 
Seat 7: IdiotFromNE ($100 in chips) 
Seat 8: DUkalisUA ($111.86 in chips) 
DUkalisUA: posts small blind $0.50
matiko09: posts big blind $1
*** HOLE CARDS ***
Dealt to matiko09 [Kc 3c]
ilaviiitech: folds 
Painkiller72: raises $1.50 to $2.50
Chin41178 joins the table at seat #9 
vrnMike: folds 
Zeeshka: folds 
I The King I: folds 
IdiotFromNE: folds 
DUkalisUA: folds 
matiko09: folds 
Uncalled bet ($1.50) returned to Painkiller72
Painkiller72 collected $2.50 from pot
Painkiller72: doesn't show hand 
*** SUMMARY ***
Total pot $2.50 | Rake $0 
Seat 1: matiko09 (big blind) folded before Flop
Seat 2: ilaviiitech folded before Flop (didn't bet)
Seat 3: Painkiller72 collected ($2.50)
Seat 4: vrnMike folded before Flop (didn't bet)
Seat 5: Zeeshka folded before Flop (didn't bet)
Seat 6: I The King I folded before Flop (didn't bet)
Seat 7: IdiotFromNE (button) folded before Flop (didn't bet)
Seat 8: DUkalisUA (small blind) folded before Flop





PokerStars Hand #151207038109:  Hold'em No Limit ($0.50/$1.00 USD) - 2016/03/31 12:13:01 CET [2016/03/31 6:13:01 ET]
Table 'Dione III' 9-max Seat #9 is the button
Seat 1: matiko09 ($100 in chips) 
Seat 2: vrnMike ($100 in chips) 
Seat 3: ilaviiitech ($154.10 in chips) 
Seat 4: Painkiller72 ($100 in chips) 
Seat 5: SnowKings ($40 in chips) 
Seat 7: Zeeshka ($100 in chips) 
Seat 8: DUkalisUA ($102.28 in chips) 
Seat 9: djammusic ($42.50 in chips) 
matiko09: posts small blind $0.50
vrnMike: posts big blind $1
*** HOLE CARDS ***
Dealt to matiko09 [4s Ks]
ilaviiitech: folds 
Painkiller72: raises $1.50 to $2.50
SnowKings: folds 
Zeeshka: folds 
DUkalisUA: folds 
djammusic: folds 
matiko09: folds 
vrnMike: folds 
Uncalled bet ($1.50) returned to Painkiller72
Painkiller72 collected $2.50 from pot
Painkiller72: doesn't show hand 
*** SUMMARY ***
Total pot $2.50 | Rake $0 
Seat 1: matiko09 (small blind) folded before Flop
Seat 2: vrnMike (big blind) folded before Flop
Seat 3: ilaviiitech folded before Flop (didn't bet)
Seat 4: Painkiller72 collected ($2.50)
Seat 5: SnowKings folded before Flop (didn't bet)
Seat 7: Zeeshka folded before Flop (didn't bet)
Seat 8: DUkalisUA folded before Flop (didn't bet)
Seat 9: djammusic (button) folded before Flop (didn't bet)





PokerStars Hand #151207044457:  Hold'em No Limit (€0.50/€1.00 EUR) - 2016/03/31 12:13:15 CET [2016/03/31 6:13:15 ET]
Table 'Pioneer II' 9-max Seat #3 is the button
Seat 1: Kreuznagel (€108.23 in chips) 
Seat 2: IdiotFromNE (€109.50 in chips) 
Seat 3: vrnMike (€100.39 in chips) 
Seat 4: Zeeshka (€100 in chips) 
Seat 5: MickChick24 (€110.44 in chips) 
Seat 6: matiko09 (€100 in chips) 
Seat 7: AlKatrone (€116.42 in chips) 
Seat 8: Painkiller72 (€137.73 in chips) 
Zeeshka: posts small blind €0.50
MickChick24: posts big blind €1
DUkalisUA: sits out 
*** HOLE CARDS ***
Dealt to matiko09 [Qc Kc]
matiko09: raises €2 to €3
AlKatrone: folds 
Painkiller72: folds 
Kreuznagel: folds 
IdiotFromNE: folds 
vrnMike: folds 
Zeeshka: folds 
MickChick24: folds 
Uncalled bet (€2) returned to matiko09
matiko09 collected €2.50 from pot
matiko09: doesn't show hand 
*** SUMMARY ***
Total pot €2.50 | Rake €0 
Seat 1: Kreuznagel folded before Flop (didn't bet)
Seat 2: IdiotFromNE folded before Flop (didn't bet)
Seat 3: vrnMike (button) folded before Flop (didn't bet)
Seat 4: Zeeshka (small blind) folded before Flop
Seat 5: MickChick24 (big blind) folded before Flop
Seat 6: matiko09 collected (€2.50)
Seat 7: AlKatrone folded before Flop (didn't bet)
Seat 8: Painkiller72 folded before Flop (didn't bet)





PokerStars Hand #151207045591:  Hold'em No Limit ($0.50/$1.00 USD) - 2016/03/31 12:13:17 CET [2016/03/31 6:13:17 ET]
Table 'Leonid II' 9-max Seat #8 is the button
Seat 1: matiko09 ($109.42 in chips) 
Seat 4: vrnMike ($104.50 in chips) 
Seat 5: Zeeshka ($100 in chips) 
Seat 6: I The King I ($103.12 in chips) 
Seat 7: IdiotFromNE ($100 in chips) 
Seat 8: DUkalisUA ($111.36 in chips) 
Chin41178 will be allowed to play after the button
matiko09: posts small blind $0.50
ilaviiitech: is sitting out 
Painkiller72: is sitting out 
vrnMike: posts big blind $1
*** HOLE CARDS ***
Dealt to matiko09 [7s 6d]
Painkiller72 leaves the table
Zeeshka: folds 
Avtovo joins the table at seat #3 
I The King I: folds 
Avtovo leaves the table
ilaviiitech leaves the table
IdiotFromNE: folds 
DUkalisUA: folds 
matiko09: folds 
Uncalled bet ($0.50) returned to vrnMike
vrnMike collected $1 from pot
PacPacBum joins the table at seat #2 
*** SUMMARY ***
Total pot $1 | Rake $0 
Seat 1: matiko09 (small blind) folded before Flop
Seat 4: vrnMike (big blind) collected ($1)
Seat 5: Zeeshka folded before Flop (didn't bet)
Seat 6: I The King I folded before Flop (didn't bet)
Seat 7: IdiotFromNE folded before Flop (didn't bet)
Seat 8: DUkalisUA (button) folded before Flop (didn't bet)





PokerStars Hand #151207050208:  Hold'em No Limit ($1/$2 USD) - 2016/03/31 12:13:28 CET [2016/03/31 6:13:28 ET]
Table 'Cheruskia II' 9-max Seat #9 is the button
Seat 1: PacPacBum ($200 in chips) 
Seat 3: DUkalisUA ($200 in chips) 
Seat 4: riverfish786 ($374.44 in chips) 
Seat 5: matiko09 ($200 in chips) 
Seat 6: RAISYDA1SY ($105.94 in chips) 
Seat 7: BOAYARSKIY ($91.28 in chips) 
Seat 8: apfush ($200 in chips) 
Seat 9: Kreuznagel ($332.64 in chips) 
PacPacBum: posts small blind $1
rmanjkeee: is sitting out 
DUkalisUA: posts big blind $2
*** HOLE CARDS ***
Dealt to matiko09 [Qs 6c]
riverfish786: folds 
matiko09: folds 
RAISYDA1SY: folds 
BOAYARSKIY: raises $2.26 to $4.26
apfush: folds 
Kreuznagel: folds 
PacPacBum: folds 
DUkalisUA: folds 
Uncalled bet ($2.26) returned to BOAYARSKIY
BOAYARSKIY collected $5 from pot
BOAYARSKIY: doesn't show hand 
*** SUMMARY ***
Total pot $5 | Rake $0 
Seat 1: PacPacBum (small blind) folded before Flop
Seat 3: DUkalisUA (big blind) folded before Flop
Seat 4: riverfish786 folded before Flop (didn't bet)
Seat 5: matiko09 folded before Flop (didn't bet)
Seat 6: RAISYDA1SY folded before Flop (didn't bet)
Seat 7: BOAYARSKIY collected ($5)
Seat 8: apfush folded before Flop (didn't bet)
Seat 9: Kreuznagel (button) folded before Flop (didn't bet)





PokerStars Hand #151207050147:  Hold'em No Limit ($1/$2 USD) - 2016/03/31 12:13:28 CET [2016/03/31 6:13:28 ET]
Table 'Desiderata' 9-max Seat #2 is the button
Seat 1: GALWACONT ($100.60 in chips) 
Seat 2: ilaviiitech ($222.89 in chips) 
Seat 3: InsomniaRU ($296.87 in chips) 
Seat 4: matiko09 ($200 in chips) 
Seat 5: Kreuznagel ($328.96 in chips) 
Seat 7: pulykakakas ($192.06 in chips) 
Seat 8: DUkalisUA ($201.55 in chips) 
Seat 9: Painkiller72 ($200 in chips) 
InsomniaRU: posts small blind $1
matiko09: posts big blind $2
*** HOLE CARDS ***
Dealt to matiko09 [3c 2h]
Kreuznagel: folds 
pulykakakas: folds 
DUkalisUA: folds 
Painkiller72: raises $3 to $5
GALWACONT: calls $5
ilaviiitech: folds 
InsomniaRU: calls $4
matiko09: folds 
*** FLOP *** [Kh 6c Jc]
InsomniaRU: checks 
Painkiller72: checks 
GALWACONT: checks 
*** TURN *** [Kh 6c Jc] [7h]
InsomniaRU: checks 
Painkiller72: checks 
GALWACONT: bets $16.15
InsomniaRU: folds 
Painkiller72: folds 
Uncalled bet ($16.15) returned to GALWACONT
GALWACONT collected $16.15 from pot
GALWACONT: doesn't show hand 
*** SUMMARY ***
Total pot $17 | Rake $0.85 
Board [Kh 6c Jc 7h]
Seat 1: GALWACONT collected ($16.15)
Seat 2: ilaviiitech (button) folded before Flop (didn't bet)
Seat 3: InsomniaRU (small blind) folded on the Turn
Seat 4: matiko09 (big blind) folded before Flop
Seat 5: Kreuznagel folded before Flop (didn't bet)
Seat 7: pulykakakas folded before Flop (didn't bet)
Seat 8: DUkalisUA folded before Flop (didn't bet)
Seat 9: Painkiller72 folded on the Turn





PokerStars Hand #151207051706:  Hold'em No Limit ($0.50/$1.00 USD) - 2016/03/31 12:13:31 CET [2016/03/31 6:13:31 ET]
Table 'Celestia II' 9-max Seat #9 is the button
Seat 1: matiko09 ($132 in chips) 
Seat 2: ValentinChit ($39.88 in chips) 
Seat 3: ilaviiitech ($116.32 in chips) 
Seat 4: I The King I ($154.55 in chips) 
Seat 5: i am owsome ($148.11 in chips) 
Seat 6: IdiotFromNE ($100 in chips) 
Seat 8: DUkalisUA ($101.35 in chips) 
Seat 9: Chin41178 ($98 in chips) 
matiko09: posts small blind $0.50
ValentinChit: posts big blind $1
Avtovo: sits out 
*** HOLE CARDS ***
Dealt to matiko09 [2s Ac]
ilaviiitech: folds 
I The King I: folds 
i am owsome: folds 
IdiotFromNE: folds 
DUkalisUA: raises $1.50 to $2.50
Chin41178: folds 
matiko09: folds 
ValentinChit: calls $1.50
*** FLOP *** [Kc Th Qs]
ValentinChit: checks 
DUkalisUA: checks 
*** TURN *** [Kc Th Qs] [9c]
ValentinChit: checks 
DUkalisUA: checks 
*** RIVER *** [Kc Th Qs 9c] [3c]
ValentinChit: checks 
DUkalisUA: checks 
*** SHOW DOWN ***
ValentinChit: shows [Qc 7s] (a pair of Queens)
DUkalisUA: mucks hand 
ValentinChit collected $5.22 from pot
*** SUMMARY ***
Total pot $5.50 | Rake $0.28 
Board [Kc Th Qs 9c 3c]
Seat 1: matiko09 (small blind) folded before Flop
Seat 2: ValentinChit (big blind) showed [Qc 7s] and won ($5.22) with a pair of Queens
Seat 3: ilaviiitech folded before Flop (didn't bet)
Seat 4: I The King I folded before Flop (didn't bet)
Seat 5: i am owsome folded before Flop (didn't bet)
Seat 6: IdiotFromNE folded before Flop (didn't bet)
Seat 8: DUkalisUA mucked [Ad 6s]
Seat 9: Chin41178 (button) folded before Flop (didn't bet)





PokerStars Hand #151207051754:  Hold'em No Limit ($0.50/$1.00 USD) - 2016/03/31 12:13:31 CET [2016/03/31 6:13:31 ET]
Table 'Yazhi' 9-max Seat #1 is the button
Seat 1: matiko09 ($100 in chips) 
Seat 2: xHourglass ($100 in chips) 
Seat 3: Painkiller72 ($100 in chips) 
Seat 4: apfush ($162.62 in chips) 
Seat 5: Kreuznagel ($108.76 in chips) 
Seat 6: Reven9er ($191.19 in chips) 
Seat 7: vrnMike ($100 in chips) 
Seat 8: pk4DW ($21.11 in chips) 
Seat 9: oscarleon ($202.82 in chips) 
xHourglass: posts small blind $0.50
Painkiller72: posts big blind $1
*** HOLE CARDS ***
Dealt to matiko09 [Qd 6s]
apfush: folds 
Kreuznagel: raises $1.39 to $2.39
Reven9er: folds 
vrnMike: folds 
pk4DW: folds 
oscarleon: folds 
matiko09: folds 
xHourglass: folds 
Painkiller72: folds 
Uncalled bet ($1.39) returned to Kreuznagel
Kreuznagel collected $2.50 from pot
Kreuznagel: doesn't show hand 
*** SUMMARY ***
Total pot $2.50 | Rake $0 
Seat 1: matiko09 (button) folded before Flop (didn't bet)
Seat 2: xHourglass (small blind) folded before Flop
Seat 3: Painkiller72 (big blind) folded before Flop
Seat 4: apfush folded before Flop (didn't bet)
Seat 5: Kreuznagel collected ($2.50)
Seat 6: Reven9er folded before Flop (didn't bet)
Seat 7: vrnMike folded before Flop (didn't bet)
Seat 8: pk4DW folded before Flop (didn't bet)
Seat 9: oscarleon folded before Flop (didn't bet)





PokerStars Hand #151207052434:  Hold'em No Limit ($0.50/$1.00 USD) - 2016/03/31 12:13:33 CET [2016/03/31 6:13:33 ET]
Table 'Leonid II' 9-max Seat #1 is the button
Seat 1: matiko09 ($108.92 in chips) 
Seat 4: vrnMike ($105 in chips) 
Seat 5: Zeeshka ($100 in chips) 
Seat 6: I The King I ($103.12 in chips) 
Seat 7: IdiotFromNE ($100 in chips) 
Seat 8: DUkalisUA ($111.36 in chips) 
PacPacBum will be allowed to play after the button
ka100pka527 joins the table at seat #3 
vrnMike: posts small blind $0.50
Zeeshka: posts big blind $1
Chin41178: sits out 
*** HOLE CARDS ***
Dealt to matiko09 [Ts 7c]
PacPacBum leaves the table
I The King I: folds 
IdiotFromNE: folds 
DUkalisUA: folds 
matiko09: folds 
vrnMike: raises $2 to $3
Zeeshka: raises $6 to $9
iamkingan joins the table at seat #2 
vrnMike: calls $6
*** FLOP *** [5h 7s Qc]
vrnMike: checks 
Zeeshka: bets $9.40
vrnMike: calls $9.40
*** TURN *** [5h 7s Qc] [5d]
vrnMike: checks 
Zeeshka: bets $18
vrnMike: calls $18
*** RIVER *** [5h 7s Qc 5d] [5c]
vrnMike: checks 
Zeeshka: bets $63.60 and is all-in
vrnMike: calls $63.60
*** SHOW DOWN ***
Zeeshka: shows [Qh As] (a full house, Fives full of Queens)
vrnMike: shows [Qs Kc] (a full house, Fives full of Queens)
vrnMike collected $98.75 from pot
Zeeshka collected $98.75 from pot
*** SUMMARY ***
Total pot $200 | Rake $2.50 
Board [5h 7s Qc 5d 5c]
Seat 1: matiko09 (button) folded before Flop (didn't bet)
Seat 4: vrnMike (small blind) showed [Qs Kc] and won ($98.75) with a full house, Fives full of Queens
Seat 5: Zeeshka (big blind) showed [Qh As] and won ($98.75) with a full house, Fives full of Queens
Seat 6: I The King I folded before Flop (didn't bet)
Seat 7: IdiotFromNE folded before Flop (didn't bet)
Seat 8: DUkalisUA folded before Flop (didn't bet)





PokerStars Hand #151207054399:  Hold'em No Limit ($0.50/$1.00 USD) - 2016/03/31 12:13:37 CET [2016/03/31 6:13:37 ET]
Table 'Herge II' 9-max Seat #8 is the button
Seat 1: Chiapel ($98.31 in chips) 
Seat 3: matiko09 ($101.50 in chips) 
Seat 4: vrnMike ($117.73 in chips) 
Seat 5: I The King I ($101.50 in chips) 
Seat 6: masaytoo ($107.39 in chips) 
Seat 7: Zeeshka ($103.64 in chips) 
Seat 8: IdiotFromNE ($100 in chips) 
Seat 9: fatstacks122 ($102.58 in chips) 
fatstacks122: posts small blind $0.50
Chiapel: posts big blind $1
DUkalisUA: sits out 
*** HOLE CARDS ***
Dealt to matiko09 [Th Tc]
matiko09: raises $2 to $3
vrnMike: folds 
I The King I: folds 
masaytoo: folds 
Zeeshka: calls $3
IdiotFromNE: folds 
fatstacks122: folds 
Chiapel: folds 
*** FLOP *** [2h Ts 6s]
matiko09: checks 
Zeeshka: bets $4.77
matiko09: calls $4.77
*** TURN *** [2h Ts 6s] [7d]
matiko09: checks 
Zeeshka: bets $10.84
matiko09: calls $10.84
*** RIVER *** [2h Ts 6s 7d] [Jd]
matiko09: checks 
Zeeshka: bets $24.64
matiko09: raises $58.25 to $82.89 and is all-in
Zeeshka: calls $58.25
*** SHOW DOWN ***
matiko09: shows [Th Tc] (three of a kind, Tens)
Zeeshka: mucks hand 
matiko09 collected $202 from pot
*** SUMMARY ***
Total pot $204.50 | Rake $2.50 
Board [2h Ts 6s 7d Jd]
Seat 1: Chiapel (big blind) folded before Flop
Seat 3: matiko09 showed [Th Tc] and won ($202) with three of a kind, Tens
Seat 4: vrnMike folded before Flop (didn't bet)
Seat 5: I The King I folded before Flop (didn't bet)
Seat 6: masaytoo folded before Flop (didn't bet)
Seat 7: Zeeshka mucked [7s 7h]
Seat 8: IdiotFromNE (button) folded before Flop (didn't bet)
Seat 9: fatstacks122 (small blind) folded before Flop





PokerStars Hand #151207056889:  Hold'em No Limit ($0.50/$1.00 USD) - 2016/03/31 12:13:43 CET [2016/03/31 6:13:43 ET]
Table 'Dione III' 9-max Seat #1 is the button
Seat 1: matiko09 ($100 in chips) 
Seat 2: vrnMike ($100 in chips) 
Seat 4: Painkiller72 ($101.50 in chips) 
Seat 5: SnowKings ($40 in chips) 
Seat 7: Zeeshka ($100 in chips) 
Seat 8: DUkalisUA ($102.28 in chips) 
Seat 9: djammusic ($42.50 in chips) 
vrnMike: posts small blind $0.50
ilaviiitech: is sitting out 
Painkiller72: posts big blind $1
*** HOLE CARDS ***
Dealt to matiko09 [Ac 2s]
ilaviiitech leaves the table
SnowKings: folds 
Avtovo joins the table at seat #3 
Zeeshka: raises $2 to $3
Avtovo leaves the table
DUkalisUA: folds 
djammusic: folds 
matiko09: folds 
vrnMike: folds 
Painkiller72: folds 
Uncalled bet ($2) returned to Zeeshka
Zeeshka collected $2.50 from pot
Zeeshka: doesn't show hand 
*** SUMMARY ***
Total pot $2.50 | Rake $0 
Seat 1: matiko09 (button) folded before Flop (didn't bet)
Seat 2: vrnMike (small blind) folded before Flop
Seat 4: Painkiller72 (big blind) folded before Flop
Seat 5: SnowKings folded before Flop (didn't bet)
Seat 7: Zeeshka collected ($2.50)
Seat 8: DUkalisUA folded before Flop (didn't bet)
Seat 9: djammusic folded before Flop (didn't bet)





PokerStars Hand #151207061506:  Hold'em No Limit (€0.50/€1.00 EUR) - 2016/03/31 12:13:53 CET [2016/03/31 6:13:53 ET]
Table 'Pioneer II' 9-max Seat #4 is the button
Seat 1: Kreuznagel (€108.23 in chips) 
Seat 2: IdiotFromNE (€109.50 in chips) 
Seat 3: vrnMike (€100.39 in chips) 
Seat 4: Zeeshka (€100 in chips) 
Seat 5: MickChick24 (€109.44 in chips) 
Seat 6: matiko09 (€101.50 in chips) 
Seat 7: AlKatrone (€116.42 in chips) 
Seat 8: Painkiller72 (€137.73 in chips) 
MickChick24: posts small blind €0.50
matiko09: posts big blind €1
DUkalisUA: sits out 
*** HOLE CARDS ***
Dealt to matiko09 [Ah 6d]
AlKatrone: folds 
Painkiller72: folds 
Kreuznagel: raises €1.39 to €2.39
IdiotFromNE: folds 
vrnMike: raises €5.11 to €7.50
Zeeshka: raises €10.50 to €18
MickChick24: folds 
matiko09: folds 
Kreuznagel: folds 
vrnMike: folds 
Uncalled bet (€10.50) returned to Zeeshka
Zeeshka collected €18.89 from pot
Zeeshka: doesn't show hand 
*** SUMMARY ***
Total pot €18.89 | Rake €0 
Seat 1: Kreuznagel folded before Flop
Seat 2: IdiotFromNE folded before Flop (didn't bet)
Seat 3: vrnMike folded before Flop
Seat 4: Zeeshka (button) collected (€18.89)
Seat 5: MickChick24 (small blind) folded before Flop
Seat 6: matiko09 (big blind) folded before Flop
Seat 7: AlKatrone folded before Flop (didn't bet)
Seat 8: Painkiller72 folded before Flop (didn't bet)





PokerStars Hand #151207068775:  Hold'em No Limit ($0.50/$1.00 USD) - 2016/03/31 12:14:09 CET [2016/03/31 6:14:09 ET]
Table 'Yazhi' 9-max Seat #2 is the button
Seat 1: matiko09 ($100 in chips) 
Seat 2: xHourglass ($100 in chips) 
Seat 3: Painkiller72 ($100 in chips) 
Seat 4: apfush ($162.62 in chips) 
Seat 5: Kreuznagel ($110.26 in chips) 
Seat 6: Reven9er ($191.19 in chips) 
Seat 7: vrnMike ($100 in chips) 
Seat 8: pk4DW ($21.11 in chips) 
Seat 9: oscarleon ($202.82 in chips) 
Painkiller72: posts small blind $0.50
apfush: posts big blind $1
*** HOLE CARDS ***
Dealt to matiko09 [Kc 9s]
Kreuznagel: folds 
Reven9er: folds 
vrnMike: raises $1 to $2
pk4DW: calls $2
Kreuznagel leaves the table
IdiotFromNE joins the table at seat #5 
oscarleon: folds 
matiko09: folds 
xHourglass: folds 
Painkiller72: folds 
apfush: folds 
*** FLOP *** [Tc 4c 4s]
vrnMike: bets $8
pk4DW: calls $8
*** TURN *** [Tc 4c 4s] [6d]
vrnMike: bets $14.50
pk4DW: calls $11.11 and is all-in
Uncalled bet ($3.39) returned to vrnMike
*** RIVER *** [Tc 4c 4s 6d] [6s]
*** SHOW DOWN ***
vrnMike: shows [Qs Ts] (two pair, Tens and Sixes)
pk4DW: shows [Ah Ad] (two pair, Aces and Sixes)
pk4DW collected $41.53 from pot
*** SUMMARY ***
Total pot $43.72 | Rake $2.19 
Board [Tc 4c 4s 6d 6s]
Seat 1: matiko09 folded before Flop (didn't bet)
Seat 2: xHourglass (button) folded before Flop (didn't bet)
Seat 3: Painkiller72 (small blind) folded before Flop
Seat 4: apfush (big blind) folded before Flop
Seat 5: Kreuznagel folded before Flop (didn't bet)
Seat 6: Reven9er folded before Flop (didn't bet)
Seat 7: vrnMike showed [Qs Ts] and lost with two pair, Tens and Sixes
Seat 8: pk4DW showed [Ah Ad] and won ($41.53) with two pair, Aces and Sixes
Seat 9: oscarleon folded before Flop (didn't bet)





PokerStars Hand #151207071230:  Hold'em No Limit ($0.50/$1.00 USD) - 2016/03/31 12:14:14 CET [2016/03/31 6:14:14 ET]
Table 'Dione III' 9-max Seat #2 is the button
Seat 1: matiko09 ($100 in chips) 
Seat 2: vrnMike ($100 in chips) 
Seat 4: Painkiller72 ($100.50 in chips) 
Seat 5: SnowKings ($40 in chips) 
Seat 7: Zeeshka ($101.50 in chips) 
Seat 8: DUkalisUA ($102.28 in chips) 
Seat 9: djammusic ($42.50 in chips) 
Painkiller72: posts small blind $0.50
SnowKings: posts big blind $1
*** HOLE CARDS ***
Dealt to matiko09 [Ts Js]
Zeeshka: folds 
DUkalisUA: folds 
djammusic: raises $1.15 to $2.15
matiko09: calls $2.15
vrnMike: folds 
Painkiller72: folds 
SnowKings: calls $1.15
*** FLOP *** [6c Ad Ah]
SnowKings: checks 
ka100pka527 joins the table at seat #3 
djammusic: checks 
matiko09: checks 
*** TURN *** [6c Ad Ah] [3d]
SnowKings: checks 
djammusic: checks 
matiko09: checks 
*** RIVER *** [6c Ad Ah 3d] [Jc]
SnowKings: checks 
djammusic: checks 
matiko09: checks 
*** SHOW DOWN ***
SnowKings: shows [Td 9h] (a pair of Aces)
djammusic: shows [Qs Kd] (a pair of Aces - King kicker)
matiko09: shows [Ts Js] (two pair, Aces and Jacks)
matiko09 collected $6.60 from pot
*** SUMMARY ***
Total pot $6.95 | Rake $0.35 
Board [6c Ad Ah 3d Jc]
Seat 1: matiko09 showed [Ts Js] and won ($6.60) with two pair, Aces and Jacks
Seat 2: vrnMike (button) folded before Flop (didn't bet)
Seat 4: Painkiller72 (small blind) folded before Flop
Seat 5: SnowKings (big blind) showed [Td 9h] and lost with a pair of Aces
Seat 7: Zeeshka folded before Flop (didn't bet)
Seat 8: DUkalisUA folded before Flop (didn't bet)
Seat 9: djammusic showed [Qs Kd] and lost with a pair of Aces





PokerStars Hand #151207078305:  Hold'em No Limit ($1/$2 USD) - 2016/03/31 12:14:30 CET [2016/03/31 6:14:30 ET]
Table 'Desiderata' 9-max Seat #3 is the button
Seat 1: GALWACONT ($111.75 in chips) 
Seat 2: ilaviiitech ($222.89 in chips) 
Seat 3: InsomniaRU ($291.87 in chips) 
Seat 4: matiko09 ($200 in chips) 
Seat 5: Kreuznagel ($328.96 in chips) 
Seat 7: pulykakakas ($192.06 in chips) 
Seat 8: DUkalisUA ($201.55 in chips) 
Seat 9: Painkiller72 ($200 in chips) 
matiko09: posts small blind $1
Kreuznagel: posts big blind $2
*** HOLE CARDS ***
Dealt to matiko09 [5h Kc]
pulykakakas: folds 
DUkalisUA: folds 
Painkiller72: raises $3 to $5
GALWACONT: folds 
ilaviiitech: folds 
InsomniaRU: folds 
matiko09: folds 
Kreuznagel: folds 
Uncalled bet ($3) returned to Painkiller72
Painkiller72 collected $5 from pot
Painkiller72: doesn't show hand 
*** SUMMARY ***
Total pot $5 | Rake $0 
Seat 1: GALWACONT folded before Flop (didn't bet)
Seat 2: ilaviiitech folded before Flop (didn't bet)
Seat 3: InsomniaRU (button) folded before Flop (didn't bet)
Seat 4: matiko09 (small blind) folded before Flop
Seat 5: Kreuznagel (big blind) folded before Flop
Seat 7: pulykakakas folded before Flop (didn't bet)
Seat 8: DUkalisUA folded before Flop (didn't bet)
Seat 9: Painkiller72 collected ($5)





PokerStars Hand #151207079148:  Hold'em No Limit ($0.50/$1.00 USD) - 2016/03/31 12:14:32 CET [2016/03/31 6:14:32 ET]
Table 'Celestia II' 9-max Seat #1 is the button
Seat 1: matiko09 ($131.50 in chips) 
Seat 2: ValentinChit ($42.60 in chips) 
Seat 3: ilaviiitech ($116.32 in chips) 
Seat 4: I The King I ($154.55 in chips) 
Seat 5: i am owsome ($148.11 in chips) 
Seat 6: IdiotFromNE ($100 in chips) 
Seat 8: DUkalisUA ($100 in chips) 
Seat 9: Chin41178 ($98 in chips) 
ValentinChit: posts small blind $0.50
ilaviiitech: posts big blind $1
Avtovo: sits out 
*** HOLE CARDS ***
Dealt to matiko09 [4s 6h]
I The King I: folds 
i am owsome: raises $1.50 to $2.50
IdiotFromNE: folds 
DUkalisUA: folds 
Chin41178: folds 
matiko09: folds 
ValentinChit: calls $2
ilaviiitech: folds 
*** FLOP *** [3s Th 9s]
ValentinChit: checks 
i am owsome: checks 
*** TURN *** [3s Th 9s] [9h]
ValentinChit: checks 
i am owsome: checks 
*** RIVER *** [3s Th 9s 9h] [2d]
ValentinChit: bets $5
i am owsome: raises $34.10 to $39.10
ValentinChit: calls $34.10
*** SHOW DOWN ***
i am owsome: shows [2c 2h] (a full house, Deuces full of Nines)
ValentinChit: mucks hand 
i am owsome collected $81.70 from pot
*** SUMMARY ***
Total pot $84.20 | Rake $2.50 
Board [3s Th 9s 9h 2d]
Seat 1: matiko09 (button) folded before Flop (didn't bet)
Seat 2: ValentinChit (small blind) mucked [9c Qc]
Seat 3: ilaviiitech (big blind) folded before Flop
Seat 4: I The King I folded before Flop (didn't bet)
Seat 5: i am owsome showed [2c 2h] and won ($81.70) with a full house, Deuces full of Nines
Seat 6: IdiotFromNE folded before Flop (didn't bet)
Seat 8: DUkalisUA folded before Flop (didn't bet)
Seat 9: Chin41178 folded before Flop (didn't bet)





PokerStars Hand #151207090755:  Hold'em No Limit ($1/$2 USD) - 2016/03/31 12:14:58 CET [2016/03/31 6:14:58 ET]
Table 'Desiderata' 9-max Seat #4 is the button
Seat 1: GALWACONT ($111.75 in chips) 
Seat 2: ilaviiitech ($222.89 in chips) 
Seat 3: InsomniaRU ($291.87 in chips) 
Seat 4: matiko09 ($200 in chips) 
Seat 5: Kreuznagel ($326.96 in chips) 
Seat 7: pulykakakas ($192.06 in chips) 
Seat 8: DUkalisUA ($201.55 in chips) 
Seat 9: Painkiller72 ($203 in chips) 
Kreuznagel: posts small blind $1
pulykakakas: posts big blind $2
*** HOLE CARDS ***
Dealt to matiko09 [Qh 4d]
DUkalisUA: folds 
Painkiller72: raises $3 to $5
GALWACONT: folds 
ilaviiitech: folds 
InsomniaRU: folds 
matiko09: folds 
Kreuznagel: folds 
pulykakakas: folds 
Uncalled bet ($3) returned to Painkiller72
Painkiller72 collected $5 from pot
Painkiller72: doesn't show hand 
*** SUMMARY ***
Total pot $5 | Rake $0 
Seat 1: GALWACONT folded before Flop (didn't bet)
Seat 2: ilaviiitech folded before Flop (didn't bet)
Seat 3: InsomniaRU folded before Flop (didn't bet)
Seat 4: matiko09 (button) folded before Flop (didn't bet)
Seat 5: Kreuznagel (small blind) folded before Flop
Seat 7: pulykakakas (big blind) folded before Flop
Seat 8: DUkalisUA folded before Flop (didn't bet)
Seat 9: Painkiller72 collected ($5)





PokerStars Hand #151207092873:  Hold'em No Limit (€0.50/€1.00 EUR) - 2016/03/31 12:15:03 CET [2016/03/31 6:15:03 ET]
Table 'Pioneer II' 9-max Seat #5 is the button
Seat 1: Kreuznagel (€105.84 in chips) 
Seat 2: IdiotFromNE (€109.50 in chips) 
Seat 3: vrnMike (€100 in chips) 
Seat 4: Zeeshka (€111.39 in chips) 
Seat 5: MickChick24 (€108.94 in chips) 
Seat 6: matiko09 (€100.50 in chips) 
Seat 7: AlKatrone (€116.42 in chips) 
Seat 8: Painkiller72 (€137.73 in chips) 
matiko09: posts small blind €0.50
AlKatrone: posts big blind €1
DUkalisUA: sits out 
*** HOLE CARDS ***
Dealt to matiko09 [6c 9s]
Painkiller72: folds 
Kreuznagel: folds 
IdiotFromNE: folds 
vrnMike: raises €1 to €2
Zeeshka: folds 
MickChick24: calls €2
matiko09: folds 
AlKatrone: calls €1
*** FLOP *** [7d 5h 7c]
AlKatrone: checks 
vrnMike: checks 
MickChick24: checks 
*** TURN *** [7d 5h 7c] [3h]
AlKatrone: checks 
vrnMike: checks 
MickChick24: checks 
*** RIVER *** [7d 5h 7c 3h] [Jd]
AlKatrone: checks 
vrnMike: bets €8
MickChick24: folds 
AlKatrone: folds 
Uncalled bet (€8) returned to vrnMike
vrnMike collected €6.18 from pot
*** SUMMARY ***
Total pot €6.50 | Rake €0.32 
Board [7d 5h 7c 3h Jd]
Seat 1: Kreuznagel folded before Flop (didn't bet)
Seat 2: IdiotFromNE folded before Flop (didn't bet)
Seat 3: vrnMike collected (€6.18)
Seat 4: Zeeshka folded before Flop (didn't bet)
Seat 5: MickChick24 (button) folded on the River
Seat 6: matiko09 (small blind) folded before Flop
Seat 7: AlKatrone (big blind) folded on the River
Seat 8: Painkiller72 folded before Flop (didn't bet)





PokerStars Hand #151207094733:  Hold'em No Limit ($0.50/$1.00 USD) - 2016/03/31 12:15:07 CET [2016/03/31 6:15:07 ET]
Table 'Yazhi' 9-max Seat #3 is the button
Seat 1: matiko09 ($100 in chips) 
Seat 2: xHourglass ($100 in chips) 
Seat 3: Painkiller72 ($100 in chips) 
Seat 4: apfush ($161.62 in chips) 
Seat 5: IdiotFromNE ($100 in chips) 
Seat 6: Reven9er ($191.19 in chips) 
Seat 7: vrnMike ($100 in chips) 
Seat 8: pk4DW ($41.53 in chips) 
Seat 9: oscarleon ($202.82 in chips) 
apfush: posts small blind $0.50
IdiotFromNE: posts big blind $1
*** HOLE CARDS ***
Dealt to matiko09 [6c 7s]
Reven9er: folds 
vrnMike: folds 
pk4DW: raises $1 to $2
oscarleon: folds 
matiko09: folds 
xHourglass: folds 
Painkiller72: folds 
apfush: folds 
IdiotFromNE: calls $1
*** FLOP *** [2h 4h Tc]
IdiotFromNE: checks 
pk4DW: bets $2.14
IdiotFromNE: folds 
Uncalled bet ($2.14) returned to pk4DW
pk4DW collected $4.28 from pot
pk4DW: doesn't show hand 
*** SUMMARY ***
Total pot $4.50 | Rake $0.22 
Board [2h 4h Tc]
Seat 1: matiko09 folded before Flop (didn't bet)
Seat 2: xHourglass folded before Flop (didn't bet)
Seat 3: Painkiller72 (button) folded before Flop (didn't bet)
Seat 4: apfush (small blind) folded before Flop
Seat 5: IdiotFromNE (big blind) folded on the Flop
Seat 6: Reven9er folded before Flop (didn't bet)
Seat 7: vrnMike folded before Flop (didn't bet)
Seat 8: pk4DW collected ($4.28)
Seat 9: oscarleon folded before Flop (didn't bet)





PokerStars Hand #151207099183:  Hold'em No Limit ($0.50/$1.00 USD) - 2016/03/31 12:15:16 CET [2016/03/31 6:15:16 ET]
Table 'Leonid II' 9-max Seat #4 is the button
Seat 1: matiko09 ($108.92 in chips) 
Seat 4: vrnMike ($103.75 in chips) 
Seat 5: Zeeshka ($100 in chips) 
Seat 6: I The King I ($103.12 in chips) 
Seat 7: IdiotFromNE ($100 in chips) 
Seat 8: DUkalisUA ($111.36 in chips) 
Zeeshka: posts small blind $0.50
I The King I: posts big blind $1
Chin41178: sits out 
iamkingan: sits out 
ka100pka527: sits out 
*** HOLE CARDS ***
Dealt to matiko09 [8c 2c]
IdiotFromNE: raises $1.50 to $2.50
DUkalisUA: folds 
matiko09: folds 
vrnMike: calls $2.50
Zeeshka: folds 
I The King I: folds 
*** FLOP *** [6s Qh 3c]
IdiotFromNE: bets $3.09
vrnMike: calls $3.09
*** TURN *** [6s Qh 3c] [2h]
IdiotFromNE: bets $9.64
vrnMike: calls $9.64
*** RIVER *** [6s Qh 3c 2h] [7s]
IdiotFromNE: checks 
vrnMike: bets $40
IdiotFromNE: folds 
Uncalled bet ($40) returned to vrnMike
vrnMike collected $30.36 from pot
*** SUMMARY ***
Total pot $31.96 | Rake $1.60 
Board [6s Qh 3c 2h 7s]
Seat 1: matiko09 folded before Flop (didn't bet)
Seat 4: vrnMike (button) collected ($30.36)
Seat 5: Zeeshka (small blind) folded before Flop
Seat 6: I The King I (big blind) folded before Flop
Seat 7: IdiotFromNE folded on the River
Seat 8: DUkalisUA folded before Flop (didn't bet)





PokerStars Hand #151207101713:  Hold'em No Limit ($1/$2 USD) - 2016/03/31 12:15:22 CET [2016/03/31 6:15:22 ET]
Table 'Desiderata' 9-max Seat #5 is the button
Seat 1: GALWACONT ($111.75 in chips) 
Seat 2: ilaviiitech ($222.89 in chips) 
Seat 3: InsomniaRU ($291.87 in chips) 
Seat 4: matiko09 ($200 in chips) 
Seat 5: Kreuznagel ($325.96 in chips) 
Seat 7: pulykakakas ($190.06 in chips) 
Seat 8: DUkalisUA ($201.55 in chips) 
Seat 9: Painkiller72 ($206 in chips) 
pulykakakas: posts small blind $1
DUkalisUA: posts big blind $2
*** HOLE CARDS ***
Dealt to matiko09 [Jh Ad]
Painkiller72: folds 
GALWACONT: folds 
ilaviiitech: folds 
InsomniaRU: folds 
matiko09: raises $3 to $5
Kreuznagel: folds 
pulykakakas: calls $4
DUkalisUA: folds 
*** FLOP *** [Jd 7s Ts]
pulykakakas: checks 
matiko09: bets $8
pulykakakas: calls $8
*** TURN *** [Jd 7s Ts] [Ks]
pulykakakas: checks 
matiko09: checks 
*** RIVER *** [Jd 7s Ts Ks] [Qd]
pulykakakas: checks 
matiko09: bets $13.83
pulykakakas: folds 
Uncalled bet ($13.83) returned to matiko09
matiko09 collected $26.60 from pot
matiko09: doesn't show hand 
*** SUMMARY ***
Total pot $28 | Rake $1.40 
Board [Jd 7s Ts Ks Qd]
Seat 1: GALWACONT folded before Flop (didn't bet)
Seat 2: ilaviiitech folded before Flop (didn't bet)
Seat 3: InsomniaRU folded before Flop (didn't bet)
Seat 4: matiko09 collected ($26.60)
Seat 5: Kreuznagel (button) folded before Flop (didn't bet)
Seat 7: pulykakakas (small blind) folded on the River
Seat 8: DUkalisUA (big blind) folded before Flop
Seat 9: Painkiller72 folded before Flop (didn't bet)





PokerStars Hand #151207105955:  Hold'em No Limit ($0.50/$1.00 USD) - 2016/03/31 12:15:31 CET [2016/03/31 6:15:31 ET]
Table 'Eugenisis III' 9-max Seat #6 is the button
Seat 1: PacPacBum ($100 in chips) 
Seat 3: Avtovo ($100 in chips) 
Seat 4: alejo22366 ($78.50 in chips) 
Seat 5: Painkiller72 ($119.36 in chips) 
Seat 6: kauff95 ($49 in chips) 
Seat 7: djammusic ($39 in chips) 
Seat 8: matiko09 ($100 in chips) 
Seat 9: choupai ($33.50 in chips) 
djammusic: posts small blind $0.50
matiko09: posts big blind $1
IdiotFromNE: sits out 
*** HOLE CARDS ***
Dealt to matiko09 [5s 2d]
choupai: folds 
PacPacBum: raises $1.04 to $2.04
Avtovo: folds 
alejo22366: folds 
Painkiller72: folds 
kauff95: folds 
djammusic: folds 
matiko09: folds 
Uncalled bet ($1.04) returned to PacPacBum
PacPacBum collected $2.50 from pot
PacPacBum: doesn't show hand 
*** SUMMARY ***
Total pot $2.50 | Rake $0 
Seat 1: PacPacBum collected ($2.50)
Seat 3: Avtovo folded before Flop (didn't bet)
Seat 4: alejo22366 folded before Flop (didn't bet)
Seat 5: Painkiller72 folded before Flop (didn't bet)
Seat 6: kauff95 (button) folded before Flop (didn't bet)
Seat 7: djammusic (small blind) folded before Flop
Seat 8: matiko09 (big blind) folded before Flop
Seat 9: choupai folded before Flop (didn't bet)





PokerStars Hand #151207112362:  Hold'em No Limit ($0.50/$1.00 USD) - 2016/03/31 12:15:45 CET [2016/03/31 6:15:45 ET]
Table 'Dione III' 9-max Seat #4 is the button
Seat 1: matiko09 ($104.45 in chips) 
Seat 2: vrnMike ($100 in chips) 
Seat 4: Painkiller72 ($100 in chips) 
Seat 5: SnowKings ($37.85 in chips) 
Seat 7: Zeeshka ($101.50 in chips) 
Seat 8: DUkalisUA ($102.28 in chips) 
Seat 9: djammusic ($40.35 in chips) 
SnowKings: posts small blind $0.50
Zeeshka: posts big blind $1
*** HOLE CARDS ***
Dealt to matiko09 [9c 3s]
DUkalisUA: folds 
djammusic: folds 
matiko09: folds 
vrnMike: raises $1 to $2
Painkiller72: folds 
SnowKings: folds 
Zeeshka: folds 
Uncalled bet ($1) returned to vrnMike
vrnMike collected $2.50 from pot
*** SUMMARY ***
Total pot $2.50 | Rake $0 
Seat 1: matiko09 folded before Flop (didn't bet)
Seat 2: vrnMike collected ($2.50)
Seat 4: Painkiller72 (button) folded before Flop (didn't bet)
Seat 5: SnowKings (small blind) folded before Flop
Seat 7: Zeeshka (big blind) folded before Flop
Seat 8: DUkalisUA folded before Flop (didn't bet)
Seat 9: djammusic folded before Flop (didn't bet)





PokerStars Hand #151207118373:  Hold'em No Limit ($0.50/$1.00 USD) - 2016/03/31 12:15:58 CET [2016/03/31 6:15:58 ET]
Table 'Eugenisis III' 9-max Seat #7 is the button
Seat 1: PacPacBum ($101.50 in chips) 
Seat 3: Avtovo ($100 in chips) 
Seat 4: alejo22366 ($78.50 in chips) 
Seat 5: Painkiller72 ($119.36 in chips) 
Seat 6: kauff95 ($49 in chips) 
Seat 7: djammusic ($38.50 in chips) 
Seat 8: matiko09 ($100 in chips) 
Seat 9: choupai ($33.50 in chips) 
matiko09: posts small blind $0.50
choupai: posts big blind $1
IdiotFromNE: sits out 
*** HOLE CARDS ***
Dealt to matiko09 [Ks Jc]
PacPacBum: raises $1.04 to $2.04
Avtovo: folds 
alejo22366: folds 
Painkiller72: folds 
kauff95: folds 
djammusic: folds 
matiko09: folds 
choupai: folds 
Uncalled bet ($1.04) returned to PacPacBum
PacPacBum collected $2.50 from pot
PacPacBum: doesn't show hand 
*** SUMMARY ***
Total pot $2.50 | Rake $0 
Seat 1: PacPacBum collected ($2.50)
Seat 3: Avtovo folded before Flop (didn't bet)
Seat 4: alejo22366 folded before Flop (didn't bet)
Seat 5: Painkiller72 folded before Flop (didn't bet)
Seat 6: kauff95 folded before Flop (didn't bet)
Seat 7: djammusic (button) folded before Flop (didn't bet)
Seat 8: matiko09 (small blind) folded before Flop
Seat 9: choupai (big blind) folded before Flop





PokerStars Hand #151207122508:  Hold'em No Limit ($0.50/$1.00 USD) - 2016/03/31 12:16:08 CET [2016/03/31 6:16:08 ET]
Table 'Yazhi' 9-max Seat #4 is the button
Seat 1: matiko09 ($100 in chips) 
Seat 2: xHourglass ($100 in chips) 
Seat 3: Painkiller72 ($100 in chips) 
Seat 4: apfush ($161.12 in chips) 
Seat 5: IdiotFromNE ($100 in chips) 
Seat 6: Reven9er ($191.19 in chips) 
Seat 7: vrnMike ($100 in chips) 
Seat 8: pk4DW ($43.81 in chips) 
Seat 9: oscarleon ($202.82 in chips) 
IdiotFromNE: posts small blind $0.50
Reven9er: posts big blind $1
*** HOLE CARDS ***
Dealt to matiko09 [9c Ah]
vrnMike: raises $1 to $2
pk4DW: folds 
oscarleon: folds 
matiko09: folds 
xHourglass: folds 
Painkiller72: folds 
apfush: folds 
IdiotFromNE: folds 
Reven9er: folds 
Uncalled bet ($1) returned to vrnMike
vrnMike collected $2.50 from pot
*** SUMMARY ***
Total pot $2.50 | Rake $0 
Seat 1: matiko09 folded before Flop (didn't bet)
Seat 2: xHourglass folded before Flop (didn't bet)
Seat 3: Painkiller72 folded before Flop (didn't bet)
Seat 4: apfush (button) folded before Flop (didn't bet)
Seat 5: IdiotFromNE (small blind) folded before Flop
Seat 6: Reven9er (big blind) folded before Flop
Seat 7: vrnMike collected ($2.50)
Seat 8: pk4DW folded before Flop (didn't bet)
Seat 9: oscarleon folded before Flop (didn't bet)





PokerStars Hand #151207124067:  Hold'em No Limit ($0.50/$1.00 USD) - 2016/03/31 12:16:11 CET [2016/03/31 6:16:11 ET]
Table 'Dione III' 9-max Seat #5 is the button
Seat 1: matiko09 ($104.45 in chips) 
Seat 2: vrnMike ($101.50 in chips) 
Seat 4: Painkiller72 ($100 in chips) 
Seat 5: SnowKings ($37.35 in chips) 
Seat 7: Zeeshka ($100.50 in chips) 
Seat 8: DUkalisUA ($102.28 in chips) 
Seat 9: djammusic ($40.35 in chips) 
Zeeshka: posts small blind $0.50
DUkalisUA: posts big blind $1
*** HOLE CARDS ***
Dealt to matiko09 [As Ah]
djammusic: folds 
matiko09: raises $2 to $3
vrnMike: folds 
Painkiller72: calls $3
SnowKings: folds 
Zeeshka: folds 
DUkalisUA: folds 
*** FLOP *** [6h 3d Kh]
matiko09: bets $4.63
Painkiller72: folds 
Uncalled bet ($4.63) returned to matiko09
matiko09 collected $7.12 from pot
matiko09: doesn't show hand 
*** SUMMARY ***
Total pot $7.50 | Rake $0.38 
Board [6h 3d Kh]
Seat 1: matiko09 collected ($7.12)
Seat 2: vrnMike folded before Flop (didn't bet)
Seat 4: Painkiller72 folded on the Flop
Seat 5: SnowKings (button) folded before Flop (didn't bet)
Seat 7: Zeeshka (small blind) folded before Flop
Seat 8: DUkalisUA (big blind) folded before Flop
Seat 9: djammusic folded before Flop (didn't bet)





PokerStars Hand #151207124203:  Hold'em No Limit ($0.50/$1.00 USD) - 2016/03/31 12:16:11 CET [2016/03/31 6:16:11 ET]
Table 'Herge II' 9-max Seat #9 is the button
Seat 1: Chiapel ($97.31 in chips) 
Seat 2: DUkalisUA ($100 in chips) 
Seat 3: matiko09 ($202 in chips) 
Seat 4: vrnMike ($117.73 in chips) 
Seat 5: I The King I ($101.50 in chips) 
Seat 6: masaytoo ($107.39 in chips) 
Seat 7: Zeeshka ($100 in chips) 
Seat 8: IdiotFromNE ($100 in chips) 
Seat 9: fatstacks122 ($102.08 in chips) 
Chiapel: posts small blind $0.50
DUkalisUA: posts big blind $1
*** HOLE CARDS ***
Dealt to matiko09 [Td Qc]
matiko09: folds 
vrnMike: folds 
I The King I: folds 
masaytoo: folds 
Zeeshka: folds 
IdiotFromNE: folds 
fatstacks122: raises $2 to $3
Chiapel: calls $2.50
DUkalisUA: calls $2
*** FLOP *** [9h 9d 5h]
Chiapel: checks 
DUkalisUA: checks 
fatstacks122: bets $3
Chiapel: calls $3
DUkalisUA: folds 
*** TURN *** [9h 9d 5h] [6s]
Chiapel: checks 
fatstacks122: bets $6.75
Chiapel: calls $6.75
*** RIVER *** [9h 9d 5h 6s] [Kc]
Chiapel: checks 
fatstacks122: bets $8.75
Chiapel: folds 
Uncalled bet ($8.75) returned to fatstacks122
fatstacks122 collected $27.08 from pot
fatstacks122: doesn't show hand 
*** SUMMARY ***
Total pot $28.50 | Rake $1.42 
Board [9h 9d 5h 6s Kc]
Seat 1: Chiapel (small blind) folded on the River
Seat 2: DUkalisUA (big blind) folded on the Flop
Seat 3: matiko09 folded before Flop (didn't bet)
Seat 4: vrnMike folded before Flop (didn't bet)
Seat 5: I The King I folded before Flop (didn't bet)
Seat 6: masaytoo folded before Flop (didn't bet)
Seat 7: Zeeshka folded before Flop (didn't bet)
Seat 8: IdiotFromNE folded before Flop (didn't bet)
Seat 9: fatstacks122 (button) collected ($27.08)





PokerStars Hand #151207125818:  Hold'em No Limit ($0.50/$1.00 USD) - 2016/03/31 12:16:15 CET [2016/03/31 6:16:15 ET]
Table 'Celestia II' 9-max Seat #2 is the button
Seat 1: matiko09 ($131.50 in chips) 
Seat 2: ValentinChit ($1 in chips) 
Seat 3: ilaviiitech ($115.32 in chips) 
Seat 4: I The King I ($154.55 in chips) 
Seat 5: i am owsome ($188.21 in chips) 
Seat 6: IdiotFromNE ($100 in chips) 
Seat 8: DUkalisUA ($100 in chips) 
Seat 9: Chin41178 ($98 in chips) 
ilaviiitech: posts small blind $0.50
I The King I: posts big blind $1
Avtovo: sits out 
*** HOLE CARDS ***
Dealt to matiko09 [4c 2s]
i am owsome: folds 
IdiotFromNE: folds 
DUkalisUA: raises $2 to $3
Chin41178: folds 
matiko09: folds 
ValentinChit: calls $1 and is all-in
ilaviiitech: calls $2.50
I The King I: folds 
*** FLOP *** [2d Td Kh]
ilaviiitech: bets $5
DUkalisUA: calls $5
*** TURN *** [2d Td Kh] [Ad]
ilaviiitech: checks 
DUkalisUA: checks 
*** RIVER *** [2d Td Kh Ad] [3d]
ilaviiitech: checks 
DUkalisUA: bets $9.40
ilaviiitech: calls $9.40
*** SHOW DOWN ***
DUkalisUA: shows [Js Kd] (a flush, Ace high)
ilaviiitech: mucks hand 
DUkalisUA collected $31.16 from side pot
ValentinChit: mucks hand 
DUkalisUA collected $3.80 from main pot
*** SUMMARY ***
Total pot $36.80 Main pot $3.80. Side pot $31.16. | Rake $1.84 
Board [2d Td Kh Ad 3d]
Seat 1: matiko09 folded before Flop (didn't bet)
Seat 2: ValentinChit (button) mucked [6s 3c]
Seat 3: ilaviiitech (small blind) mucked [8c 8d]
Seat 4: I The King I (big blind) folded before Flop
Seat 5: i am owsome folded before Flop (didn't bet)
Seat 6: IdiotFromNE folded before Flop (didn't bet)
Seat 8: DUkalisUA showed [Js Kd] and won ($34.96) with a flush, Ace high
Seat 9: Chin41178 folded before Flop (didn't bet)





PokerStars Hand #151207127325:  Hold'em No Limit ($0.50/$1.00 USD) - 2016/03/31 12:16:18 CET [2016/03/31 6:16:18 ET]
Table 'Icarus III' 9-max Seat #6 is the button
Seat 2: Painkiller72 ($100 in chips) 
Seat 4: dizzyryano79 ($29.97 in chips) 
Seat 5: I The King I ($105.60 in chips) 
Seat 6: gudridornot ($105.78 in chips) 
Seat 7: oscarleon ($154.63 in chips) 
Seat 8: matiko09 ($100 in chips) 
Seat 9: apfush ($126.76 in chips) 
oscarleon: posts small blind $0.50
matiko09: posts big blind $1
IdiotFromNE: sits out 
RICKA16: sits out 
*** HOLE CARDS ***
Dealt to matiko09 [9d Ac]
apfush: folds 
Painkiller72: raises $1.50 to $2.50
dizzyryano79: folds 
I The King I: folds 
gudridornot: folds 
oscarleon: folds 
matiko09: folds 
Uncalled bet ($1.50) returned to Painkiller72
Painkiller72 collected $2.50 from pot
Painkiller72: doesn't show hand 
*** SUMMARY ***
Total pot $2.50 | Rake $0 
Seat 2: Painkiller72 collected ($2.50)
Seat 4: dizzyryano79 folded before Flop (didn't bet)
Seat 5: I The King I folded before Flop (didn't bet)
Seat 6: gudridornot (button) folded before Flop (didn't bet)
Seat 7: oscarleon (small blind) folded before Flop
Seat 8: matiko09 (big blind) folded before Flop
Seat 9: apfush folded before Flop (didn't bet)





PokerStars Hand #151207128067:  Hold'em No Limit ($0.50/$1.00 USD) - 2016/03/31 12:16:20 CET [2016/03/31 6:16:20 ET]
Table 'Eugenisis III' 9-max Seat #8 is the button
Seat 1: PacPacBum ($103 in chips) 
Seat 3: Avtovo ($100 in chips) 
Seat 4: alejo22366 ($78.50 in chips) 
Seat 5: Painkiller72 ($119.36 in chips) 
Seat 6: kauff95 ($49 in chips) 
Seat 7: djammusic ($38.50 in chips) 
Seat 8: matiko09 ($100 in chips) 
Seat 9: choupai ($32.50 in chips) 
choupai: posts small blind $0.50
PacPacBum: posts big blind $1
IdiotFromNE: sits out 
*** HOLE CARDS ***
Dealt to matiko09 [2d 6s]
Avtovo: folds 
alejo22366: folds 
Painkiller72: raises $1.50 to $2.50
kauff95: folds 
djammusic: folds 
matiko09: folds 
choupai: folds 
PacPacBum: folds 
Uncalled bet ($1.50) returned to Painkiller72
Painkiller72 collected $2.50 from pot
Painkiller72: doesn't show hand 
*** SUMMARY ***
Total pot $2.50 | Rake $0 
Seat 1: PacPacBum (big blind) folded before Flop
Seat 3: Avtovo folded before Flop (didn't bet)
Seat 4: alejo22366 folded before Flop (didn't bet)
Seat 5: Painkiller72 collected ($2.50)
Seat 6: kauff95 folded before Flop (didn't bet)
Seat 7: djammusic folded before Flop (didn't bet)
Seat 8: matiko09 (button) folded before Flop (didn't bet)
Seat 9: choupai (small blind) folded before Flop





PokerStars Hand #151207137365:  Hold'em No Limit ($1/$2 USD) - 2016/03/31 12:16:40 CET [2016/03/31 6:16:40 ET]
Table 'Polaris IV' 9-max Seat #5 is the button
Seat 1: BOAYARSKIY ($105.79 in chips) 
Seat 3: Kreuznagel ($337.02 in chips) 
Seat 4: coinflip_si ($200 in chips) 
Seat 5: riverfish786 ($200 in chips) 
Seat 6: Mausert0811 ($298.52 in chips) 
Seat 7: matiko09 ($200 in chips) 
Seat 8: Painkiller72 ($220 in chips) 
Seat 9: K&K2 ($327.09 in chips) 
Mausert0811: posts small blind $1
matiko09: posts big blind $2
*** HOLE CARDS ***
Dealt to matiko09 [Qh 5h]
Painkiller72: folds 
K&K2: folds 
BOAYARSKIY: folds 
Kreuznagel: raises $2.78 to $4.78
coinflip_si: raises $13.22 to $18
riverfish786: folds 
Mausert0811: folds 
matiko09: folds 
Kreuznagel: raises $24 to $42
coinflip_si: folds 
Uncalled bet ($24) returned to Kreuznagel
Kreuznagel collected $39 from pot
Kreuznagel: doesn't show hand 
*** SUMMARY ***
Total pot $39 | Rake $0 
Seat 1: BOAYARSKIY folded before Flop (didn't bet)
Seat 3: Kreuznagel collected ($39)
Seat 4: coinflip_si folded before Flop
Seat 5: riverfish786 (button) folded before Flop (didn't bet)
Seat 6: Mausert0811 (small blind) folded before Flop
Seat 7: matiko09 (big blind) folded before Flop
Seat 8: Painkiller72 folded before Flop (didn't bet)
Seat 9: K&K2 folded before Flop (didn't bet)





PokerStars Hand #151207138805:  Hold'em No Limit ($0.50/$1.00 USD) - 2016/03/31 12:16:43 CET [2016/03/31 6:16:43 ET]
Table 'Leonid II' 9-max Seat #5 is the button
Seat 1: matiko09 ($108.92 in chips) 
Seat 4: vrnMike ($118.88 in chips) 
Seat 5: Zeeshka ($100 in chips) 
Seat 6: I The King I ($102.12 in chips) 
Seat 7: IdiotFromNE ($100 in chips) 
Seat 8: DUkalisUA ($111.36 in chips) 
I The King I: posts small blind $0.50
IdiotFromNE: posts big blind $1
Chin41178: sits out 
iamkingan: sits out 
*** HOLE CARDS ***
Dealt to matiko09 [Ts Td]
DUkalisUA: folds 
matiko09: raises $2 to $3
vrnMike: folds 
Zeeshka: folds 
I The King I: folds 
IdiotFromNE: folds 
Uncalled bet ($2) returned to matiko09
matiko09 collected $2.50 from pot
matiko09: doesn't show hand 
*** SUMMARY ***
Total pot $2.50 | Rake $0 
Seat 1: matiko09 collected ($2.50)
Seat 4: vrnMike folded before Flop (didn't bet)
Seat 5: Zeeshka (button) folded before Flop (didn't bet)
Seat 6: I The King I (small blind) folded before Flop
Seat 7: IdiotFromNE (big blind) folded before Flop
Seat 8: DUkalisUA folded before Flop (didn't bet)





PokerStars Hand #151207138857:  Hold'em No Limit ($0.50/$1.00 USD) - 2016/03/31 12:16:43 CET [2016/03/31 6:16:43 ET]
Table 'Yazhi' 9-max Seat #5 is the button
Seat 1: matiko09 ($100 in chips) 
Seat 2: xHourglass ($100 in chips) 
Seat 3: Painkiller72 ($100 in chips) 
Seat 4: apfush ($161.12 in chips) 
Seat 5: IdiotFromNE ($100 in chips) 
Seat 6: Reven9er ($190.19 in chips) 
Seat 7: vrnMike ($101.50 in chips) 
Seat 8: pk4DW ($43.81 in chips) 
Seat 9: oscarleon ($202.82 in chips) 
Reven9er: posts small blind $0.50
vrnMike: posts big blind $1
*** HOLE CARDS ***
Dealt to matiko09 [Qh Qs]
pk4DW: folds 
oscarleon: folds 
matiko09: raises $2 to $3
xHourglass: folds 
Painkiller72: folds 
apfush: raises $6 to $9
IdiotFromNE: folds 
Reven9er: folds 
vrnMike: folds 
matiko09: calls $6
*** FLOP *** [7s 2c 8c]
matiko09: checks 
apfush: bets $11.50
matiko09: calls $11.50
*** TURN *** [7s 2c 8c] [As]
matiko09: checks 
apfush: checks 
*** RIVER *** [7s 2c 8c As] [5s]
matiko09: checks 
apfush: checks 
*** SHOW DOWN ***
matiko09: shows [Qh Qs] (a pair of Queens)
apfush: shows [Ac 3c] (a pair of Aces)
apfush collected $40.38 from pot
*** SUMMARY ***
Total pot $42.50 | Rake $2.12 
Board [7s 2c 8c As 5s]
Seat 1: matiko09 showed [Qh Qs] and lost with a pair of Queens
Seat 2: xHourglass folded before Flop (didn't bet)
Seat 3: Painkiller72 folded before Flop (didn't bet)
Seat 4: apfush showed [Ac 3c] and won ($40.38) with a pair of Aces
Seat 5: IdiotFromNE (button) folded before Flop (didn't bet)
Seat 6: Reven9er (small blind) folded before Flop
Seat 7: vrnMike (big blind) folded before Flop
Seat 8: pk4DW folded before Flop (didn't bet)
Seat 9: oscarleon folded before Flop (didn't bet)





PokerStars Hand #151207139213:  Hold'em No Limit ($0.50/$1.00 USD) - 2016/03/31 12:16:44 CET [2016/03/31 6:16:44 ET]
Table 'Eugenisis III' 9-max Seat #9 is the button
Seat 1: PacPacBum ($102 in chips) 
Seat 2: IdiotFromNE ($100 in chips) 
Seat 3: Avtovo ($100 in chips) 
Seat 4: alejo22366 ($78.50 in chips) 
Seat 5: Painkiller72 ($120.86 in chips) 
Seat 6: kauff95 ($49 in chips) 
Seat 7: djammusic ($38.50 in chips) 
Seat 8: matiko09 ($100 in chips) 
Seat 9: choupai ($32 in chips) 
PacPacBum: posts small blind $0.50
IdiotFromNE: posts big blind $1
*** HOLE CARDS ***
Dealt to matiko09 [7d Ah]
Avtovo: raises $1.50 to $2.50
alejo22366: folds 
Painkiller72: folds 
kauff95: calls $2.50
djammusic: folds 
matiko09: folds 
choupai: folds 
PacPacBum: folds 
IdiotFromNE: folds 
*** FLOP *** [Jc 2h 6d]
Avtovo: checks 
kauff95: bets $3.09
Avtovo: folds 
Uncalled bet ($3.09) returned to kauff95
kauff95 collected $6.18 from pot
*** SUMMARY ***
Total pot $6.50 | Rake $0.32 
Board [Jc 2h 6d]
Seat 1: PacPacBum (small blind) folded before Flop
Seat 2: IdiotFromNE (big blind) folded before Flop
Seat 3: Avtovo folded on the Flop
Seat 4: alejo22366 folded before Flop (didn't bet)
Seat 5: Painkiller72 folded before Flop (didn't bet)
Seat 6: kauff95 collected ($6.18)
Seat 7: djammusic folded before Flop (didn't bet)
Seat 8: matiko09 folded before Flop (didn't bet)
Seat 9: choupai (button) folded before Flop (didn't bet)





PokerStars Hand #151207140237:  Hold'em No Limit ($1/$2 USD) - 2016/03/31 12:16:46 CET [2016/03/31 6:16:46 ET]
Table 'Desiderata' 9-max Seat #7 is the button
Seat 1: GALWACONT ($111.75 in chips) 
Seat 2: ilaviiitech ($222.89 in chips) 
Seat 3: InsomniaRU ($291.87 in chips) 
Seat 4: matiko09 ($213.60 in chips) 
Seat 5: Kreuznagel ($325.96 in chips) 
Seat 7: pulykakakas ($177.06 in chips) 
Seat 8: DUkalisUA ($200 in chips) 
Seat 9: Painkiller72 ($206 in chips) 
DUkalisUA: posts small blind $1
Painkiller72: posts big blind $2
*** HOLE CARDS ***
Dealt to matiko09 [3s Qs]
GALWACONT: calls $2
ilaviiitech: folds 
InsomniaRU: folds 
matiko09: folds 
Kreuznagel: folds 
pulykakakas: raises $4 to $6
DUkalisUA: folds 
Painkiller72: folds 
GALWACONT: calls $4
*** FLOP *** [7s 3h Ts]
GALWACONT: checks 
pulykakakas: checks 
*** TURN *** [7s 3h Ts] [2d]
GALWACONT: bets $14.25
pulykakakas: folds 
Uncalled bet ($14.25) returned to GALWACONT
GALWACONT collected $14.25 from pot
GALWACONT: doesn't show hand 
*** SUMMARY ***
Total pot $15 | Rake $0.75 
Board [7s 3h Ts 2d]
Seat 1: GALWACONT collected ($14.25)
Seat 2: ilaviiitech folded before Flop (didn't bet)
Seat 3: InsomniaRU folded before Flop (didn't bet)
Seat 4: matiko09 folded before Flop (didn't bet)
Seat 5: Kreuznagel folded before Flop (didn't bet)
Seat 7: pulykakakas (button) folded on the Turn
Seat 8: DUkalisUA (small blind) folded before Flop
Seat 9: Painkiller72 (big blind) folded before Flop





PokerStars Hand #151207141876:  Hold'em No Limit ($0.50/$1.00 USD) - 2016/03/31 12:16:50 CET [2016/03/31 6:16:50 ET]
Table 'Dione III' 9-max Seat #7 is the button
Seat 1: matiko09 ($108.57 in chips) 
Seat 2: vrnMike ($101.50 in chips) 
Seat 4: Painkiller72 ($100 in chips) 
Seat 5: SnowKings ($37.35 in chips) 
Seat 7: Zeeshka ($100 in chips) 
Seat 8: DUkalisUA ($101.28 in chips) 
Seat 9: djammusic ($40.35 in chips) 
DUkalisUA: posts small blind $0.50
djammusic: posts big blind $1
*** HOLE CARDS ***
Dealt to matiko09 [7h 3c]
matiko09: folds 
vrnMike: raises $1 to $2
Painkiller72: folds 
SnowKings: folds 
Zeeshka: folds 
DUkalisUA: folds 
djammusic: folds 
Uncalled bet ($1) returned to vrnMike
vrnMike collected $2.50 from pot
*** SUMMARY ***
Total pot $2.50 | Rake $0 
Seat 1: matiko09 folded before Flop (didn't bet)
Seat 2: vrnMike collected ($2.50)
Seat 4: Painkiller72 folded before Flop (didn't bet)
Seat 5: SnowKings folded before Flop (didn't bet)
Seat 7: Zeeshka (button) folded before Flop (didn't bet)
Seat 8: DUkalisUA (small blind) folded before Flop
Seat 9: djammusic (big blind) folded before Flop





PokerStars Hand #151207143289:  Hold'em No Limit (€0.50/€1.00 EUR) - 2016/03/31 12:16:53 CET [2016/03/31 6:16:53 ET]
Table 'Pioneer II' 9-max Seat #6 is the button
Seat 1: Kreuznagel (€105.84 in chips) 
Seat 2: IdiotFromNE (€109.50 in chips) 
Seat 3: vrnMike (€104.18 in chips) 
Seat 4: Zeeshka (€111.39 in chips) 
Seat 5: MickChick24 (€106.94 in chips) 
Seat 6: matiko09 (€100 in chips) 
Seat 7: AlKatrone (€114.42 in chips) 
Seat 8: Painkiller72 (€137.73 in chips) 
AlKatrone: posts small blind €0.50
Painkiller72: posts big blind €1
DUkalisUA: sits out 
*** HOLE CARDS ***
Dealt to matiko09 [3d 3c]
Kreuznagel: folds 
IdiotFromNE: folds 
vrnMike: raises €1 to €2
Zeeshka: folds 
MickChick24: folds 
matiko09: calls €2
AlKatrone: folds 
Painkiller72: folds 
*** FLOP *** [8h 7c 2h]
vrnMike: checks 
matiko09: checks 
*** TURN *** [8h 7c 2h] [5c]
vrnMike: checks 
matiko09: checks 
*** RIVER *** [8h 7c 2h 5c] [Ah]
vrnMike: checks 
matiko09: checks 
*** SHOW DOWN ***
vrnMike: shows [Ad Ts] (a pair of Aces)
matiko09: mucks hand 
vrnMike collected €5.22 from pot
*** SUMMARY ***
Total pot €5.50 | Rake €0.28 
Board [8h 7c 2h 5c Ah]
Seat 1: Kreuznagel folded before Flop (didn't bet)
Seat 2: IdiotFromNE folded before Flop (didn't bet)
Seat 3: vrnMike showed [Ad Ts] and won (€5.22) with a pair of Aces
Seat 4: Zeeshka folded before Flop (didn't bet)
Seat 5: MickChick24 folded before Flop (didn't bet)
Seat 6: matiko09 (button) mucked [3d 3c]
Seat 7: AlKatrone (small blind) folded before Flop
Seat 8: Painkiller72 (big blind) folded before Flop





PokerStars Hand #151207144042:  Hold'em No Limit ($0.50/$1.00 USD) - 2016/03/31 12:16:54 CET [2016/03/31 6:16:54 ET]
Table 'Icarus III' 9-max Seat #7 is the button
Seat 2: Painkiller72 ($101.50 in chips) 
Seat 4: dizzyryano79 ($29.97 in chips) 
Seat 5: I The King I ($105.60 in chips) 
Seat 6: gudridornot ($105.78 in chips) 
Seat 7: oscarleon ($154.13 in chips) 
Seat 8: matiko09 ($100 in chips) 
Seat 9: apfush ($126.76 in chips) 
matiko09: posts small blind $0.50
apfush: posts big blind $1
IdiotFromNE: sits out 
RICKA16: sits out 
*** HOLE CARDS ***
Dealt to matiko09 [6h Qs]
Painkiller72: raises $1.50 to $2.50
dizzyryano79 is disconnected 
dizzyryano79 has timed out while disconnected
dizzyryano79: folds 
I The King I: folds 
gudridornot: calls $2.50
oscarleon: folds 
matiko09: folds 
apfush: calls $1.50
*** FLOP *** [4c 6d Jd]
apfush: checks 
Painkiller72: bets $5.32
gudridornot: raises $5.32 to $10.64
apfush: folds 
Painkiller72: calls $5.32
*** TURN *** [4c 6d Jd] [9s]
Painkiller72: checks 
gudridornot: bets $18
Painkiller72: folds 
Uncalled bet ($18) returned to gudridornot
gudridornot collected $27.82 from pot
gudridornot: doesn't show hand 
*** SUMMARY ***
Total pot $29.28 | Rake $1.46 
Board [4c 6d Jd 9s]
Seat 2: Painkiller72 folded on the Turn
Seat 4: dizzyryano79 folded before Flop (didn't bet)
Seat 5: I The King I folded before Flop (didn't bet)
Seat 6: gudridornot collected ($27.82)
Seat 7: oscarleon (button) folded before Flop (didn't bet)
Seat 8: matiko09 (small blind) folded before Flop
Seat 9: apfush (big blind) folded on the Flop





PokerStars Hand #151207157833:  Hold'em No Limit ($1/$2 USD) - 2016/03/31 12:17:25 CET [2016/03/31 6:17:25 ET]
Table 'Desiderata' 9-max Seat #8 is the button
Seat 1: GALWACONT ($120 in chips) 
Seat 2: ilaviiitech ($222.89 in chips) 
Seat 3: InsomniaRU ($291.87 in chips) 
Seat 4: matiko09 ($213.60 in chips) 
Seat 5: Kreuznagel ($325.96 in chips) 
Seat 7: pulykakakas ($171.06 in chips) 
Seat 8: DUkalisUA ($200 in chips) 
Seat 9: Painkiller72 ($204 in chips) 
Painkiller72: posts small blind $1
GALWACONT: posts big blind $2
*** HOLE CARDS ***
Dealt to matiko09 [2d 3s]
ilaviiitech: folds 
InsomniaRU: folds 
matiko09: folds 
Kreuznagel: folds 
pulykakakas: folds 
DUkalisUA: raises $2 to $4
Painkiller72: folds 
GALWACONT: calls $2
*** FLOP *** [7h 6h Kd]
GALWACONT: checks 
DUkalisUA: checks 
*** TURN *** [7h 6h Kd] [Js]
GALWACONT: checks 
DUkalisUA: checks 
*** RIVER *** [7h 6h Kd Js] [7s]
GALWACONT: bets $8.55
DUkalisUA: folds 
Uncalled bet ($8.55) returned to GALWACONT
GALWACONT collected $8.55 from pot
GALWACONT: doesn't show hand 
*** SUMMARY ***
Total pot $9 | Rake $0.45 
Board [7h 6h Kd Js 7s]
Seat 1: GALWACONT (big blind) collected ($8.55)
Seat 2: ilaviiitech folded before Flop (didn't bet)
Seat 3: InsomniaRU folded before Flop (didn't bet)
Seat 4: matiko09 folded before Flop (didn't bet)
Seat 5: Kreuznagel folded before Flop (didn't bet)
Seat 7: pulykakakas folded before Flop (didn't bet)
Seat 8: DUkalisUA (button) folded on the River
Seat 9: Painkiller72 (small blind) folded before Flop





PokerStars Hand #151207158880:  Hold'em No Limit ($1/$2 USD) - 2016/03/31 12:17:27 CET [2016/03/31 6:17:27 ET]
Table 'Polaris IV' 9-max Seat #6 is the button
Seat 1: BOAYARSKIY ($105.79 in chips) 
Seat 3: Kreuznagel ($358.02 in chips) 
Seat 4: coinflip_si ($200 in chips) 
Seat 5: riverfish786 ($200 in chips) 
Seat 6: Mausert0811 ($297.52 in chips) 
Seat 7: matiko09 ($200 in chips) 
Seat 8: Painkiller72 ($220 in chips) 
Seat 9: K&K2 ($327.09 in chips) 
matiko09: posts small blind $1
Painkiller72: posts big blind $2
*** HOLE CARDS ***
Dealt to matiko09 [As 9h]
K&K2: folds 
BOAYARSKIY: folds 
Kreuznagel: folds 
coinflip_si: folds 
riverfish786: folds 
Mausert0811: folds 
matiko09: raises $3 to $5
Painkiller72: calls $3
*** FLOP *** [Jh 5c Qs]
matiko09: checks 
Painkiller72: checks 
*** TURN *** [Jh 5c Qs] [Qh]
matiko09: checks 
Painkiller72: checks 
*** RIVER *** [Jh 5c Qs Qh] [Qd]
matiko09: checks 
Painkiller72: checks 
*** SHOW DOWN ***
matiko09: shows [As 9h] (three of a kind, Queens)
Painkiller72: mucks hand 
matiko09 collected $9.50 from pot
*** SUMMARY ***
Total pot $10 | Rake $0.50 
Board [Jh 5c Qs Qh Qd]
Seat 1: BOAYARSKIY folded before Flop (didn't bet)
Seat 3: Kreuznagel folded before Flop (didn't bet)
Seat 4: coinflip_si folded before Flop (didn't bet)
Seat 5: riverfish786 folded before Flop (didn't bet)
Seat 6: Mausert0811 (button) folded before Flop (didn't bet)
Seat 7: matiko09 (small blind) showed [As 9h] and won ($9.50) with three of a kind, Queens
Seat 8: Painkiller72 (big blind) mucked [6d 9d]
Seat 9: K&K2 folded before Flop (didn't bet)





PokerStars Hand #151207159240:  Hold'em No Limit ($0.50/$1.00 USD) - 2016/03/31 12:17:28 CET [2016/03/31 6:17:28 ET]
Table 'Leonid II' 9-max Seat #6 is the button
Seat 1: matiko09 ($110.42 in chips) 
Seat 4: vrnMike ($118.88 in chips) 
Seat 5: Zeeshka ($100 in chips) 
Seat 6: I The King I ($101.62 in chips) 
Seat 7: IdiotFromNE ($100 in chips) 
Seat 8: DUkalisUA ($111.36 in chips) 
IdiotFromNE: posts small blind $0.50
DUkalisUA: posts big blind $1
Chin41178: sits out 
iamkingan: sits out 
*** HOLE CARDS ***
Dealt to matiko09 [4d Td]
matiko09: folds 
vrnMike: folds 
Zeeshka: raises $2 to $3
I The King I: folds 
IdiotFromNE: folds 
DUkalisUA: folds 
Uncalled bet ($2) returned to Zeeshka
Zeeshka collected $2.50 from pot
Zeeshka: doesn't show hand 
*** SUMMARY ***
Total pot $2.50 | Rake $0 
Seat 1: matiko09 folded before Flop (didn't bet)
Seat 4: vrnMike folded before Flop (didn't bet)
Seat 5: Zeeshka collected ($2.50)
Seat 6: I The King I (button) folded before Flop (didn't bet)
Seat 7: IdiotFromNE (small blind) folded before Flop
Seat 8: DUkalisUA (big blind) folded before Flop





PokerStars Hand #151207160539:  Hold'em No Limit ($0.50/$1.00 USD) - 2016/03/31 12:17:31 CET [2016/03/31 6:17:31 ET]
Table 'Eugenisis III' 9-max Seat #1 is the button
Seat 1: PacPacBum ($101.50 in chips) 
Seat 2: IdiotFromNE ($100 in chips) 
Seat 3: Avtovo ($100 in chips) 
Seat 4: alejo22366 ($78.50 in chips) 
Seat 5: Painkiller72 ($120.86 in chips) 
Seat 6: kauff95 ($52.68 in chips) 
Seat 7: djammusic ($38.50 in chips) 
Seat 8: matiko09 ($100 in chips) 
Seat 9: choupai ($32 in chips) 
IdiotFromNE: posts small blind $0.50
Avtovo: posts big blind $1
*** HOLE CARDS ***
Dealt to matiko09 [Qd 6h]
alejo22366: folds 
Painkiller72: folds 
kauff95: folds 
djammusic: folds 
matiko09: folds 
choupai: raises $2 to $3
PacPacBum: folds 
IdiotFromNE: raises $6.50 to $9.50
Avtovo: folds 
choupai: folds 
Uncalled bet ($6.50) returned to IdiotFromNE
IdiotFromNE collected $7 from pot
IdiotFromNE: doesn't show hand 
*** SUMMARY ***
Total pot $7 | Rake $0 
Seat 1: PacPacBum (button) folded before Flop (didn't bet)
Seat 2: IdiotFromNE (small blind) collected ($7)
Seat 3: Avtovo (big blind) folded before Flop
Seat 4: alejo22366 folded before Flop (didn't bet)
Seat 5: Painkiller72 folded before Flop (didn't bet)
Seat 6: kauff95 folded before Flop (didn't bet)
Seat 7: djammusic folded before Flop (didn't bet)
Seat 8: matiko09 folded before Flop (didn't bet)
Seat 9: choupai folded before Flop





PokerStars Hand #151207167767:  Hold'em No Limit (€0.50/€1.00 EUR) - 2016/03/31 12:17:47 CET [2016/03/31 6:17:47 ET]
Table 'Pioneer II' 9-max Seat #7 is the button
Seat 1: Kreuznagel (€105.84 in chips) 
Seat 2: IdiotFromNE (€109.50 in chips) 
Seat 3: vrnMike (€107.40 in chips) 
Seat 4: Zeeshka (€111.39 in chips) 
Seat 5: MickChick24 (€106.94 in chips) 
Seat 6: matiko09 (€100 in chips) 
Seat 7: AlKatrone (€113.92 in chips) 
Seat 8: Painkiller72 (€136.73 in chips) 
Seat 9: DUkalisUA (€100 in chips) 
Painkiller72: posts small blind €0.50
DUkalisUA: posts big blind €1
*** HOLE CARDS ***
Dealt to matiko09 [9d 4h]
Kreuznagel: folds 
IdiotFromNE: folds 
vrnMike: folds 
Zeeshka: folds 
MickChick24: folds 
matiko09: folds 
AlKatrone: raises €1.25 to €2.25
Painkiller72: folds 
DUkalisUA: folds 
Uncalled bet (€1.25) returned to AlKatrone
AlKatrone collected €2.50 from pot
AlKatrone: doesn't show hand 
*** SUMMARY ***
Total pot €2.50 | Rake €0 
Seat 1: Kreuznagel folded before Flop (didn't bet)
Seat 2: IdiotFromNE folded before Flop (didn't bet)
Seat 3: vrnMike folded before Flop (didn't bet)
Seat 4: Zeeshka folded before Flop (didn't bet)
Seat 5: MickChick24 folded before Flop (didn't bet)
Seat 6: matiko09 folded before Flop (didn't bet)
Seat 7: AlKatrone (button) collected (€2.50)
Seat 8: Painkiller72 (small blind) folded before Flop
Seat 9: DUkalisUA (big blind) folded before Flop





PokerStars Hand #151207168940:  Hold'em No Limit ($0.50/$1.00 USD) - 2016/03/31 12:17:49 CET [2016/03/31 6:17:49 ET]
Table 'Herge II' 9-max Seat #1 is the button
Seat 1: Chiapel ($84.56 in chips) 
Seat 2: DUkalisUA ($100 in chips) 
Seat 3: matiko09 ($202 in chips) 
Seat 4: vrnMike ($117.73 in chips) 
Seat 5: I The King I ($101.50 in chips) 
Seat 6: masaytoo ($107.39 in chips) 
Seat 7: Zeeshka ($100 in chips) 
Seat 8: IdiotFromNE ($100 in chips) 
Seat 9: fatstacks122 ($116.41 in chips) 
DUkalisUA: posts small blind $0.50
matiko09: posts big blind $1
*** HOLE CARDS ***
Dealt to matiko09 [2d 7h]
vrnMike: folds 
I The King I: raises $2 to $3
masaytoo: folds 
Zeeshka: folds 
IdiotFromNE: folds 
fatstacks122: calls $3
Chiapel: calls $3
DUkalisUA: folds 
matiko09: folds 
*** FLOP *** [8h Jd 4d]
I The King I: checks 
fatstacks122: checks 
Chiapel: bets $4.99
I The King I: folds 
fatstacks122: calls $4.99
*** TURN *** [8h Jd 4d] [Tc]
fatstacks122: checks 
Chiapel: bets $9.73
fatstacks122: calls $9.73
*** RIVER *** [8h Jd 4d Tc] [As]
fatstacks122: bets $8.75
Chiapel: folds 
Uncalled bet ($8.75) returned to fatstacks122
fatstacks122 collected $37.94 from pot
fatstacks122: doesn't show hand 
*** SUMMARY ***
Total pot $39.94 | Rake $2 
Board [8h Jd 4d Tc As]
Seat 1: Chiapel (button) folded on the River
Seat 2: DUkalisUA (small blind) folded before Flop
Seat 3: matiko09 (big blind) folded before Flop
Seat 4: vrnMike folded before Flop (didn't bet)
Seat 5: I The King I folded on the Flop
Seat 6: masaytoo folded before Flop (didn't bet)
Seat 7: Zeeshka folded before Flop (didn't bet)
Seat 8: IdiotFromNE folded before Flop (didn't bet)
Seat 9: fatstacks122 collected ($37.94)





PokerStars Hand #151207170826:  Hold'em No Limit ($0.50/$1.00 USD) - 2016/03/31 12:17:53 CET [2016/03/31 6:17:53 ET]
Table 'Leonid II' 9-max Seat #7 is the button
Seat 1: matiko09 ($110.42 in chips) 
Seat 4: vrnMike ($118.88 in chips) 
Seat 5: Zeeshka ($101.50 in chips) 
Seat 6: I The King I ($101.62 in chips) 
Seat 7: IdiotFromNE ($100 in chips) 
Seat 8: DUkalisUA ($110.36 in chips) 
Seat 9: Chin41178 ($100 in chips) 
DUkalisUA: posts small blind $0.50
Chin41178: posts big blind $1
iamkingan: sits out 
*** HOLE CARDS ***
Dealt to matiko09 [4d 2s]
matiko09: folds 
vrnMike: folds 
Zeeshka: folds 
I The King I: folds 
IdiotFromNE: folds 
DUkalisUA: raises $1.50 to $2.50
Chin41178: raises $4.50 to $7
DUkalisUA: calls $4.50
*** FLOP *** [9h 8c Ts]
DUkalisUA: checks 
Chin41178: bets $6.65
DUkalisUA: raises $14.85 to $21.50
Chin41178: calls $14.85
*** TURN *** [9h 8c Ts] [Td]
DUkalisUA: bets $33
Chin41178: raises $38.50 to $71.50 and is all-in
DUkalisUA: calls $38.50
*** FIRST RIVER *** [9h 8c Ts Td] [4s]
*** SECOND RIVER *** [9h 8c Ts Td] [Jh]
*** FIRST SHOW DOWN ***
DUkalisUA: shows [Jc Qd] (a straight, Eight to Queen)
Chin41178: shows [Th Qs] (three of a kind, Tens)
DUkalisUA collected $98.75 from pot
*** SECOND SHOW DOWN ***
DUkalisUA: shows [Jc Qd] (a straight, Eight to Queen)
Chin41178: shows [Th Qs] (a straight, Eight to Queen)
DUkalisUA collected $49.38 from pot
Chin41178 collected $49.37 from pot
*** SUMMARY ***
Total pot $200 | Rake $2.50 
Hand was run twice
FIRST Board [9h 8c Ts Td 4s]
SECOND Board [9h 8c Ts Td Jh]
Seat 1: matiko09 folded before Flop (didn't bet)
Seat 4: vrnMike folded before Flop (didn't bet)
Seat 5: Zeeshka folded before Flop (didn't bet)
Seat 6: I The King I folded before Flop (didn't bet)
Seat 7: IdiotFromNE (button) folded before Flop (didn't bet)
Seat 8: DUkalisUA (small blind) showed [Jc Qd] and won ($98.75) with a straight, Eight to Queen, and won ($49.38) with a straight, Eight to Queen
Seat 9: Chin41178 (big blind) showed [Th Qs] and lost with three of a kind, Tens, and won ($49.37) with a straight, Eight to Queen





PokerStars Hand #151207173257:  Hold'em No Limit ($0.50/$1.00 USD) - 2016/03/31 12:17:59 CET [2016/03/31 6:17:59 ET]
Table 'Celestia II' 9-max Seat #3 is the button
Seat 1: matiko09 ($131.50 in chips) 
Seat 3: ilaviiitech ($100 in chips) 
Seat 4: I The King I ($153.55 in chips) 
Seat 5: i am owsome ($188.21 in chips) 
Seat 6: IdiotFromNE ($100 in chips) 
Seat 8: DUkalisUA ($117.56 in chips) 
Seat 9: Chin41178 ($98 in chips) 
I The King I: posts small blind $0.50
i am owsome: posts big blind $1
Avtovo: sits out 
*** HOLE CARDS ***
Dealt to matiko09 [4s 9h]
IdiotFromNE: folds 
DUkalisUA: raises $2 to $3
Chin41178: raises $6 to $9
matiko09: folds 
ilaviiitech: folds 
I The King I: folds 
i am owsome: folds 
DUkalisUA: folds 
Uncalled bet ($6) returned to Chin41178
Chin41178 collected $7.50 from pot
Chin41178: doesn't show hand 
*** SUMMARY ***
Total pot $7.50 | Rake $0 
Seat 1: matiko09 folded before Flop (didn't bet)
Seat 3: ilaviiitech (button) folded before Flop (didn't bet)
Seat 4: I The King I (small blind) folded before Flop
Seat 5: i am owsome (big blind) folded before Flop
Seat 6: IdiotFromNE folded before Flop (didn't bet)
Seat 8: DUkalisUA folded before Flop
Seat 9: Chin41178 collected ($7.50)





PokerStars Hand #151207180052:  Hold'em No Limit ($0.50/$1.00 USD) - 2016/03/31 12:18:13 CET [2016/03/31 6:18:13 ET]
Table 'Eugenisis III' 9-max Seat #2 is the button
Seat 1: PacPacBum ($101.50 in chips) 
Seat 2: IdiotFromNE ($104 in chips) 
Seat 3: Avtovo ($100 in chips) 
Seat 4: alejo22366 ($78.50 in chips) 
Seat 5: Painkiller72 ($120.86 in chips) 
Seat 6: kauff95 ($52.68 in chips) 
Seat 7: djammusic ($38.50 in chips) 
Seat 8: matiko09 ($100 in chips) 
Seat 9: choupai ($29 in chips) 
Avtovo: posts small blind $0.50
alejo22366: posts big blind $1
*** HOLE CARDS ***
Dealt to matiko09 [Ts 7h]
Painkiller72: folds 
kauff95: folds 
djammusic: folds 
matiko09: folds 
choupai: folds 
PacPacBum: folds 
IdiotFromNE: raises $1.50 to $2.50
Avtovo: folds 
alejo22366: calls $1.50
*** FLOP *** [9d 8c 8d]
alejo22366: checks 
IdiotFromNE: checks 
*** TURN *** [9d 8c 8d] [Kc]
alejo22366: bets $3
IdiotFromNE: folds 
Uncalled bet ($3) returned to alejo22366
alejo22366 collected $5.22 from pot
*** SUMMARY ***
Total pot $5.50 | Rake $0.28 
Board [9d 8c 8d Kc]
Seat 1: PacPacBum folded before Flop (didn't bet)
Seat 2: IdiotFromNE (button) folded on the Turn
Seat 3: Avtovo (small blind) folded before Flop
Seat 4: alejo22366 (big blind) collected ($5.22)
Seat 5: Painkiller72 folded before Flop (didn't bet)
Seat 6: kauff95 folded before Flop (didn't bet)
Seat 7: djammusic folded before Flop (didn't bet)
Seat 8: matiko09 folded before Flop (didn't bet)
Seat 9: choupai folded before Flop (didn't bet)





PokerStars Hand #151207180702:  Hold'em No Limit ($1/$2 USD) - 2016/03/31 12:18:15 CET [2016/03/31 6:18:15 ET]
Table 'Coelestina II' 9-max Seat #3 is the button
Seat 1: PacPacBum ($200 in chips) 
Seat 2: Kreuznagel ($200 in chips) 
Seat 3: ilaviiitech ($200 in chips) 
Seat 4: matiko09 ($200 in chips) 
Seat 6: InsomniaRU ($200 in chips) 
Seat 8: DUkalisUA ($200 in chips) 
Seat 9: fonng ($100 in chips) 
matiko09: posts small blind $1
InsomniaRU: posts big blind $2
*** HOLE CARDS ***
Dealt to matiko09 [Jc 7c]
scherazard joins the table at seat #5 
DUkalisUA: folds 
fonng: calls $2
PacPacBum: folds 
le_marc08 joins the table at seat #7 
Kreuznagel: folds 
ilaviiitech: folds 
matiko09: calls $1
InsomniaRU: checks 
*** FLOP *** [3c 4c 2c]
matiko09: bets $4
InsomniaRU: calls $4
fonng: folds 
*** TURN *** [3c 4c 2c] [3s]
scherazard leaves the table
matiko09: bets $10
InsomniaRU: calls $10
*** RIVER *** [3c 4c 2c 3s] [9s]
Painkiller72 joins the table at seat #5 
matiko09: bets $24
InsomniaRU: calls $24
*** SHOW DOWN ***
matiko09: shows [Jc 7c] (a flush, Jack high)
InsomniaRU: mucks hand 
matiko09 collected $79.25 from pot
*** SUMMARY ***
Total pot $82 | Rake $2.75 
Board [3c 4c 2c 3s 9s]
Seat 1: PacPacBum folded before Flop (didn't bet)
Seat 2: Kreuznagel folded before Flop (didn't bet)
Seat 3: ilaviiitech (button) folded before Flop (didn't bet)
Seat 4: matiko09 (small blind) showed [Jc 7c] and won ($79.25) with a flush, Jack high
Seat 6: InsomniaRU (big blind) mucked [4s 8c]
Seat 8: DUkalisUA folded before Flop (didn't bet)
Seat 9: fonng folded on the Flop





PokerStars Hand #151207181377:  Hold'em No Limit ($1/$2 USD) - 2016/03/31 12:18:16 CET [2016/03/31 6:18:16 ET]
Table 'Desiderata' 9-max Seat #9 is the button
Seat 1: GALWACONT ($124.55 in chips) 
Seat 2: ilaviiitech ($222.89 in chips) 
Seat 3: InsomniaRU ($291.87 in chips) 
Seat 4: matiko09 ($213.60 in chips) 
Seat 5: Kreuznagel ($325.96 in chips) 
Seat 7: pulykakakas ($171.06 in chips) 
Seat 8: DUkalisUA ($200 in chips) 
Seat 9: Painkiller72 ($203 in chips) 
GALWACONT: posts small blind $1
ilaviiitech: posts big blind $2
*** HOLE CARDS ***
Dealt to matiko09 [5d 6s]
InsomniaRU: folds 
matiko09: folds 
Kreuznagel: folds 
pulykakakas: raises $4 to $6
DUkalisUA: folds 
Painkiller72: folds 
GALWACONT: folds 
ilaviiitech: folds 
Uncalled bet ($4) returned to pulykakakas
pulykakakas collected $5 from pot
pulykakakas: doesn't show hand 
*** SUMMARY ***
Total pot $5 | Rake $0 
Seat 1: GALWACONT (small blind) folded before Flop
Seat 2: ilaviiitech (big blind) folded before Flop
Seat 3: InsomniaRU folded before Flop (didn't bet)
Seat 4: matiko09 folded before Flop (didn't bet)
Seat 5: Kreuznagel folded before Flop (didn't bet)
Seat 7: pulykakakas collected ($5)
Seat 8: DUkalisUA folded before Flop (didn't bet)
Seat 9: Painkiller72 (button) folded before Flop (didn't bet)





PokerStars Hand #151207187569:  Hold'em No Limit ($1/$2 USD) - 2016/03/31 12:18:30 CET [2016/03/31 6:18:30 ET]
Table 'Polaris IV' 9-max Seat #7 is the button
Seat 1: BOAYARSKIY ($105.79 in chips) 
Seat 3: Kreuznagel ($358.02 in chips) 
Seat 4: coinflip_si ($200 in chips) 
Seat 5: riverfish786 ($200 in chips) 
Seat 6: Mausert0811 ($297.52 in chips) 
Seat 7: matiko09 ($204.50 in chips) 
Seat 8: Painkiller72 ($215 in chips) 
Seat 9: K&K2 ($327.09 in chips) 
Painkiller72: posts small blind $1
K&K2: posts big blind $2
*** HOLE CARDS ***
Dealt to matiko09 [Qc 5s]
BOAYARSKIY: folds 
Kreuznagel: folds 
coinflip_si: folds 
riverfish786: folds 
Mausert0811: raises $4 to $6
matiko09: folds 
Painkiller72: folds 
K&K2: calls $4
*** FLOP *** [Th Ah Jd]
K&K2: bets $10
Mausert0811: calls $10
*** TURN *** [Th Ah Jd] [8s]
K&K2: bets $4
Mausert0811: calls $4
*** RIVER *** [Th Ah Jd 8s] [7d]
K&K2: checks 
Mausert0811: checks 
*** SHOW DOWN ***
K&K2: shows [4d 6h] (high card Ace)
Mausert0811: shows [Ad Tc] (two pair, Aces and Tens)
Mausert0811 collected $38.95 from pot
*** SUMMARY ***
Total pot $41 | Rake $2.05 
Board [Th Ah Jd 8s 7d]
Seat 1: BOAYARSKIY folded before Flop (didn't bet)
Seat 3: Kreuznagel folded before Flop (didn't bet)
Seat 4: coinflip_si folded before Flop (didn't bet)
Seat 5: riverfish786 folded before Flop (didn't bet)
Seat 6: Mausert0811 showed [Ad Tc] and won ($38.95) with two pair, Aces and Tens
Seat 7: matiko09 (button) folded before Flop (didn't bet)
Seat 8: Painkiller72 (small blind) folded before Flop
Seat 9: K&K2 (big blind) showed [4d 6h] and lost with high card Ace





PokerStars Hand #151207188926:  Hold'em No Limit (€0.50/€1.00 EUR) - 2016/03/31 12:18:33 CET [2016/03/31 6:18:33 ET]
Table 'Pioneer II' 9-max Seat #8 is the button
Seat 1: Kreuznagel (€105.84 in chips) 
Seat 2: IdiotFromNE (€109.50 in chips) 
Seat 3: vrnMike (€107.40 in chips) 
Seat 4: Zeeshka (€111.39 in chips) 
Seat 5: MickChick24 (€106.94 in chips) 
Seat 6: matiko09 (€100 in chips) 
Seat 7: AlKatrone (€115.42 in chips) 
Seat 8: Painkiller72 (€136.23 in chips) 
Seat 9: DUkalisUA (€100 in chips) 
DUkalisUA: posts small blind €0.50
Kreuznagel: posts big blind €1
*** HOLE CARDS ***
Dealt to matiko09 [Jc 6d]
IdiotFromNE: folds 
vrnMike: folds 
Zeeshka: raises €2 to €3
MickChick24: folds 
matiko09: folds 
AlKatrone: calls €3
Painkiller72: folds 
DUkalisUA: folds 
Kreuznagel: calls €2
*** FLOP *** [4h 9d 2c]
Kreuznagel: checks 
Zeeshka: bets €4.96
AlKatrone: calls €4.96
Kreuznagel: folds 
*** TURN *** [4h 9d 2c] [Td]
Zeeshka: checks 
AlKatrone: bets €14.76
Zeeshka: folds 
Uncalled bet (€14.76) returned to AlKatrone
AlKatrone collected €18.45 from pot
AlKatrone: doesn't show hand 
*** SUMMARY ***
Total pot €19.42 | Rake €0.97 
Board [4h 9d 2c Td]
Seat 1: Kreuznagel (big blind) folded on the Flop
Seat 2: IdiotFromNE folded before Flop (didn't bet)
Seat 3: vrnMike folded before Flop (didn't bet)
Seat 4: Zeeshka folded on the Turn
Seat 5: MickChick24 folded before Flop (didn't bet)
Seat 6: matiko09 folded before Flop (didn't bet)
Seat 7: AlKatrone collected (€18.45)
Seat 8: Painkiller72 (button) folded before Flop (didn't bet)
Seat 9: DUkalisUA (small blind) folded before Flop





PokerStars Hand #151207192734:  Hold'em No Limit ($0.50/$1.00 USD) - 2016/03/31 12:18:41 CET [2016/03/31 6:18:41 ET]
Table 'Icarus III' 9-max Seat #8 is the button
Seat 1: IdiotFromNE ($100 in chips) 
Seat 2: Painkiller72 ($100 in chips) 
Seat 4: dizzyryano79 ($29.97 in chips) 
Seat 5: I The King I ($105.60 in chips) 
Seat 6: gudridornot ($120.46 in chips) 
Seat 7: oscarleon ($154.13 in chips) 
Seat 8: matiko09 ($100 in chips) 
Seat 9: apfush ($124.26 in chips) 
apfush: posts small blind $0.50
IdiotFromNE: posts big blind $1
RICKA16: sits out 
*** HOLE CARDS ***
Dealt to matiko09 [8h 2d]
Painkiller72: raises $1.50 to $2.50
dizzyryano79: calls $2.50
I The King I: folds 
gudridornot: folds 
oscarleon: folds 
matiko09: folds 
apfush: folds 
IdiotFromNE: folds 
*** FLOP *** [5h 8s 7d]
Painkiller72: checks 
dizzyryano79: bets $5
Painkiller72: calls $5
*** TURN *** [5h 8s 7d] [Th]
Painkiller72: checks 
dizzyryano79: bets $4
Painkiller72: calls $4
*** RIVER *** [5h 8s 7d Th] [Ac]
Painkiller72: checks 
dizzyryano79: checks 
*** SHOW DOWN ***
Painkiller72: shows [7c 6c] (a pair of Sevens)
dizzyryano79: shows [6s 7s] (a pair of Sevens)
Painkiller72 collected $11.64 from pot
dizzyryano79 collected $11.64 from pot
*** SUMMARY ***
Total pot $24.50 | Rake $1.22 
Board [5h 8s 7d Th Ac]
Seat 1: IdiotFromNE (big blind) folded before Flop
Seat 2: Painkiller72 showed [7c 6c] and won ($11.64) with a pair of Sevens
Seat 4: dizzyryano79 showed [6s 7s] and won ($11.64) with a pair of Sevens
Seat 5: I The King I folded before Flop (didn't bet)
Seat 6: gudridornot folded before Flop (didn't bet)
Seat 7: oscarleon folded before Flop (didn't bet)
Seat 8: matiko09 (button) folded before Flop (didn't bet)
Seat 9: apfush (small blind) folded before Flop





PokerStars Hand #151207194087:  Hold'em No Limit ($1/$2 USD) - 2016/03/31 12:18:44 CET [2016/03/31 6:18:44 ET]
Table 'Desiderata' 9-max Seat #1 is the button
Seat 1: GALWACONT ($123.55 in chips) 
Seat 2: ilaviiitech ($220.89 in chips) 
Seat 3: InsomniaRU ($291.87 in chips) 
Seat 4: matiko09 ($213.60 in chips) 
Seat 5: Kreuznagel ($325.96 in chips) 
Seat 7: pulykakakas ($174.06 in chips) 
Seat 8: DUkalisUA ($200 in chips) 
Seat 9: Painkiller72 ($203 in chips) 
ilaviiitech: posts small blind $1
InsomniaRU: posts big blind $2
*** HOLE CARDS ***
Dealt to matiko09 [8d 5h]
matiko09: folds 
Kreuznagel: folds 
pulykakakas: folds 
DUkalisUA: folds 
Painkiller72: raises $3 to $5
GALWACONT: folds 
ilaviiitech: folds 
InsomniaRU: folds 
Uncalled bet ($3) returned to Painkiller72
Painkiller72 collected $5 from pot
Painkiller72: doesn't show hand 
*** SUMMARY ***
Total pot $5 | Rake $0 
Seat 1: GALWACONT (button) folded before Flop (didn't bet)
Seat 2: ilaviiitech (small blind) folded before Flop
Seat 3: InsomniaRU (big blind) folded before Flop
Seat 4: matiko09 folded before Flop (didn't bet)
Seat 5: Kreuznagel folded before Flop (didn't bet)
Seat 7: pulykakakas folded before Flop (didn't bet)
Seat 8: DUkalisUA folded before Flop (didn't bet)
Seat 9: Painkiller72 collected ($5)





PokerStars Hand #151207200972:  Hold'em No Limit ($0.50/$1.00 USD) - 2016/03/31 12:18:59 CET [2016/03/31 6:18:59 ET]
Table 'Celestia II' 9-max Seat #4 is the button
Seat 1: matiko09 ($131.50 in chips) 
Seat 2: ValentinChit ($40 in chips) 
Seat 3: ilaviiitech ($100 in chips) 
Seat 4: I The King I ($153.05 in chips) 
Seat 5: i am owsome ($187.21 in chips) 
Seat 6: IdiotFromNE ($100 in chips) 
Seat 8: DUkalisUA ($114.56 in chips) 
Seat 9: Chin41178 ($102.50 in chips) 
i am owsome: posts small blind $0.50
IdiotFromNE: posts big blind $1
Avtovo: sits out 
*** HOLE CARDS ***
Dealt to matiko09 [Ts Kh]
DUkalisUA: folds 
Chin41178: folds 
matiko09: folds 
ValentinChit: folds 
ilaviiitech: raises $2 to $3
I The King I: folds 
i am owsome: folds 
IdiotFromNE: folds 
Uncalled bet ($2) returned to ilaviiitech
ilaviiitech collected $2.50 from pot
ilaviiitech: doesn't show hand 
*** SUMMARY ***
Total pot $2.50 | Rake $0 
Seat 1: matiko09 folded before Flop (didn't bet)
Seat 2: ValentinChit folded before Flop (didn't bet)
Seat 3: ilaviiitech collected ($2.50)
Seat 4: I The King I (button) folded before Flop (didn't bet)
Seat 5: i am owsome (small blind) folded before Flop
Seat 6: IdiotFromNE (big blind) folded before Flop
Seat 8: DUkalisUA folded before Flop (didn't bet)
Seat 9: Chin41178 folded before Flop (didn't bet)





PokerStars Hand #151207202848:  Hold'em No Limit ($0.50/$1.00 USD) - 2016/03/31 12:19:03 CET [2016/03/31 6:19:03 ET]
Table 'Eugenisis III' 9-max Seat #3 is the button
Seat 1: PacPacBum ($101.50 in chips) 
Seat 2: IdiotFromNE ($101.50 in chips) 
Seat 3: Avtovo ($100 in chips) 
Seat 4: alejo22366 ($81.22 in chips) 
Seat 5: Painkiller72 ($120.86 in chips) 
Seat 6: kauff95 ($52.68 in chips) 
Seat 7: djammusic ($38.50 in chips) 
Seat 8: matiko09 ($100 in chips) 
Seat 9: choupai ($29 in chips) 
alejo22366: posts small blind $0.50
Painkiller72: posts big blind $1
*** HOLE CARDS ***
Dealt to matiko09 [8s 4c]
kauff95: folds 
djammusic: folds 
matiko09: folds 
choupai: folds 
PacPacBum: folds 
IdiotFromNE: folds 
Avtovo: raises $1.50 to $2.50
alejo22366: folds 
Painkiller72: folds 
Uncalled bet ($1.50) returned to Avtovo
Avtovo collected $2.50 from pot
Avtovo: doesn't show hand 
*** SUMMARY ***
Total pot $2.50 | Rake $0 
Seat 1: PacPacBum folded before Flop (didn't bet)
Seat 2: IdiotFromNE folded before Flop (didn't bet)
Seat 3: Avtovo (button) collected ($2.50)
Seat 4: alejo22366 (small blind) folded before Flop
Seat 5: Painkiller72 (big blind) folded before Flop
Seat 6: kauff95 folded before Flop (didn't bet)
Seat 7: djammusic folded before Flop (didn't bet)
Seat 8: matiko09 folded before Flop (didn't bet)
Seat 9: choupai folded before Flop (didn't bet)





PokerStars Hand #151207204508:  Hold'em No Limit ($0.50/$1.00 USD) - 2016/03/31 12:19:06 CET [2016/03/31 6:19:06 ET]
Table 'Yazhi' 9-max Seat #6 is the button
Seat 1: matiko09 ($100 in chips) 
Seat 2: xHourglass ($100 in chips) 
Seat 3: Painkiller72 ($100 in chips) 
Seat 4: apfush ($181 in chips) 
Seat 5: IdiotFromNE ($100 in chips) 
Seat 6: Reven9er ($189.69 in chips) 
Seat 7: vrnMike ($100.50 in chips) 
Seat 8: pk4DW ($43.81 in chips) 
Seat 9: oscarleon ($202.82 in chips) 
vrnMike: posts small blind $0.50
pk4DW: posts big blind $1
*** HOLE CARDS ***
Dealt to matiko09 [2c Qc]
oscarleon: folds 
matiko09: folds 
xHourglass: folds 
Painkiller72: folds 
apfush: folds 
IdiotFromNE: folds 
Reven9er: folds 
vrnMike: folds 
Uncalled bet ($0.50) returned to pk4DW
pk4DW collected $1 from pot
pk4DW: doesn't show hand 
*** SUMMARY ***
Total pot $1 | Rake $0 
Seat 1: matiko09 folded before Flop (didn't bet)
Seat 2: xHourglass folded before Flop (didn't bet)
Seat 3: Painkiller72 folded before Flop (didn't bet)
Seat 4: apfush folded before Flop (didn't bet)
Seat 5: IdiotFromNE folded before Flop (didn't bet)
Seat 6: Reven9er (button) folded before Flop (didn't bet)
Seat 7: vrnMike (small blind) folded before Flop
Seat 8: pk4DW (big blind) collected ($1)
Seat 9: oscarleon folded before Flop (didn't bet)





PokerStars Hand #151207210258:  Hold'em No Limit ($1/$2 USD) - 2016/03/31 12:19:19 CET [2016/03/31 6:19:19 ET]
Table 'Desiderata' 9-max Seat #2 is the button
Seat 1: GALWACONT ($123.55 in chips) 
Seat 2: ilaviiitech ($219.89 in chips) 
Seat 3: InsomniaRU ($289.87 in chips) 
Seat 4: matiko09 ($213.60 in chips) 
Seat 5: Kreuznagel ($325.96 in chips) 
Seat 7: pulykakakas ($174.06 in chips) 
Seat 8: DUkalisUA ($200 in chips) 
Seat 9: Painkiller72 ($206 in chips) 
InsomniaRU: posts small blind $1
matiko09: posts big blind $2
*** HOLE CARDS ***
Dealt to matiko09 [2h 5d]
Kreuznagel: folds 
pulykakakas: folds 
DUkalisUA: folds 
Painkiller72: folds 
GALWACONT: folds 
ilaviiitech: folds 
InsomniaRU: folds 
Uncalled bet ($1) returned to matiko09
matiko09 collected $2 from pot
matiko09: doesn't show hand 
*** SUMMARY ***
Total pot $2 | Rake $0 
Seat 1: GALWACONT folded before Flop (didn't bet)
Seat 2: ilaviiitech (button) folded before Flop (didn't bet)
Seat 3: InsomniaRU (small blind) folded before Flop
Seat 4: matiko09 (big blind) collected ($2)
Seat 5: Kreuznagel folded before Flop (didn't bet)
Seat 7: pulykakakas folded before Flop (didn't bet)
Seat 8: DUkalisUA folded before Flop (didn't bet)
Seat 9: Painkiller72 folded before Flop (didn't bet)





PokerStars Hand #151207212692:  Hold'em No Limit ($0.50/$1.00 USD) - 2016/03/31 12:19:24 CET [2016/03/31 6:19:24 ET]
Table 'Eugenisis III' 9-max Seat #4 is the button
Seat 1: PacPacBum ($101.50 in chips) 
Seat 2: IdiotFromNE ($101.50 in chips) 
Seat 3: Avtovo ($101.50 in chips) 
Seat 4: alejo22366 ($80.72 in chips) 
Seat 5: Painkiller72 ($119.86 in chips) 
Seat 6: kauff95 ($52.68 in chips) 
Seat 7: djammusic ($38.50 in chips) 
Seat 8: matiko09 ($100 in chips) 
Seat 9: choupai ($29 in chips) 
Painkiller72: posts small blind $0.50
kauff95: posts big blind $1
*** HOLE CARDS ***
Dealt to matiko09 [3c 8s]
djammusic: folds 
matiko09: folds 
choupai: folds 
PacPacBum: folds 
IdiotFromNE: folds 
Avtovo: folds 
alejo22366: raises $2 to $3
Painkiller72: folds 
kauff95: calls $2
*** FLOP *** [Td 9h 3s]
kauff95: checks 
alejo22366: bets $3
kauff95: raises $3 to $6
alejo22366: folds 
Uncalled bet ($3) returned to kauff95
kauff95 collected $11.88 from pot
*** SUMMARY ***
Total pot $12.50 | Rake $0.62 
Board [Td 9h 3s]
Seat 1: PacPacBum folded before Flop (didn't bet)
Seat 2: IdiotFromNE folded before Flop (didn't bet)
Seat 3: Avtovo folded before Flop (didn't bet)
Seat 4: alejo22366 (button) folded on the Flop
Seat 5: Painkiller72 (small blind) folded before Flop
Seat 6: kauff95 (big blind) collected ($11.88)
Seat 7: djammusic folded before Flop (didn't bet)
Seat 8: matiko09 folded before Flop (didn't bet)
Seat 9: choupai folded before Flop (didn't bet)





PokerStars Hand #151207212657:  Hold'em No Limit ($0.50/$1.00 USD) - 2016/03/31 12:19:24 CET [2016/03/31 6:19:24 ET]
Table 'Celestia II' 9-max Seat #5 is the button
Seat 1: matiko09 ($131.50 in chips) 
Seat 2: ValentinChit ($40 in chips) 
Seat 3: ilaviiitech ($101.50 in chips) 
Seat 4: I The King I ($153.05 in chips) 
Seat 5: i am owsome ($186.71 in chips) 
Seat 6: IdiotFromNE ($100 in chips) 
Seat 7: Avtovo ($100 in chips) 
Seat 8: DUkalisUA ($114.56 in chips) 
Seat 9: Chin41178 ($102.50 in chips) 
IdiotFromNE: posts small blind $0.50
Avtovo: posts big blind $1
*** HOLE CARDS ***
Dealt to matiko09 [Th 5s]
DUkalisUA: folds 
Chin41178: folds 
matiko09: folds 
ValentinChit: folds 
ilaviiitech: folds 
I The King I: folds 
i am owsome: raises $1.50 to $2.50
IdiotFromNE: calls $2
Avtovo: folds 
*** FLOP *** [As 7h Qd]
IdiotFromNE: checks 
i am owsome: checks 
*** TURN *** [As 7h Qd] [4s]
IdiotFromNE: checks 
i am owsome: bets $3.50
IdiotFromNE: calls $3.50
*** RIVER *** [As 7h Qd 4s] [3c]
IdiotFromNE: checks 
i am owsome: bets $7
IdiotFromNE: folds 
Uncalled bet ($7) returned to i am owsome
i am owsome collected $12.35 from pot
i am owsome: doesn't show hand 
*** SUMMARY ***
Total pot $13 | Rake $0.65 
Board [As 7h Qd 4s 3c]
Seat 1: matiko09 folded before Flop (didn't bet)
Seat 2: ValentinChit folded before Flop (didn't bet)
Seat 3: ilaviiitech folded before Flop (didn't bet)
Seat 4: I The King I folded before Flop (didn't bet)
Seat 5: i am owsome (button) collected ($12.35)
Seat 6: IdiotFromNE (small blind) folded on the River
Seat 7: Avtovo (big blind) folded before Flop
Seat 8: DUkalisUA folded before Flop (didn't bet)
Seat 9: Chin41178 folded before Flop (didn't bet)





PokerStars Hand #151207215487:  Hold'em No Limit ($0.50/$1.00 USD) - 2016/03/31 12:19:30 CET [2016/03/31 6:19:30 ET]
Table 'Yazhi' 9-max Seat #7 is the button
Seat 1: matiko09 ($100 in chips) 
Seat 2: xHourglass ($100 in chips) 
Seat 3: Painkiller72 ($100 in chips) 
Seat 4: apfush ($181 in chips) 
Seat 5: IdiotFromNE ($100 in chips) 
Seat 6: Reven9er ($189.69 in chips) 
Seat 7: vrnMike ($100 in chips) 
Seat 8: pk4DW ($44.31 in chips) 
Seat 9: oscarleon ($202.82 in chips) 
pk4DW: posts small blind $0.50
oscarleon: posts big blind $1
*** HOLE CARDS ***
Dealt to matiko09 [4c Qd]
matiko09: folds 
xHourglass: folds 
Painkiller72: raises $1.50 to $2.50
apfush: calls $2.50
IdiotFromNE: raises $7.50 to $10
Reven9er: folds 
vrnMike: folds 
pk4DW: folds 
oscarleon: folds 
Painkiller72: folds 
apfush: folds 
Uncalled bet ($7.50) returned to IdiotFromNE
IdiotFromNE collected $9 from pot
IdiotFromNE: doesn't show hand 
*** SUMMARY ***
Total pot $9 | Rake $0 
Seat 1: matiko09 folded before Flop (didn't bet)
Seat 2: xHourglass folded before Flop (didn't bet)
Seat 3: Painkiller72 folded before Flop
Seat 4: apfush folded before Flop
Seat 5: IdiotFromNE collected ($9)
Seat 6: Reven9er folded before Flop (didn't bet)
Seat 7: vrnMike (button) folded before Flop (didn't bet)
Seat 8: pk4DW (small blind) folded before Flop
Seat 9: oscarleon (big blind) folded before Flop





PokerStars Hand #151207218940:  Hold'em No Limit ($1/$2 USD) - 2016/03/31 12:19:38 CET [2016/03/31 6:19:38 ET]
Table 'Desiderata' 9-max Seat #3 is the button
Seat 1: GALWACONT ($123.55 in chips) 
Seat 2: ilaviiitech ($219.89 in chips) 
Seat 3: InsomniaRU ($288.87 in chips) 
Seat 4: matiko09 ($214.60 in chips) 
Seat 5: Kreuznagel ($325.96 in chips) 
Seat 7: pulykakakas ($174.06 in chips) 
Seat 8: DUkalisUA ($200 in chips) 
Seat 9: Painkiller72 ($206 in chips) 
matiko09: posts small blind $1
Kreuznagel: posts big blind $2
*** HOLE CARDS ***
Dealt to matiko09 [4d 8h]
pulykakakas: folds 
DUkalisUA: folds 
Painkiller72 has timed out
Painkiller72: folds 
GALWACONT: calls $2
ilaviiitech: folds 
InsomniaRU: raises $5 to $7
matiko09: folds 
Kreuznagel: calls $5
GALWACONT: calls $5
*** FLOP *** [4c 3h 7d]
Kreuznagel: checks 
GALWACONT: checks 
InsomniaRU: checks 
*** TURN *** [4c 3h 7d] [6d]
pulykakakas leaves the table
Kreuznagel: checks 
GALWACONT: bets $20.90
apfush joins the table at seat #7 
InsomniaRU: folds 
Kreuznagel: folds 
Uncalled bet ($20.90) returned to GALWACONT
GALWACONT collected $20.90 from pot
GALWACONT: doesn't show hand 
*** SUMMARY ***
Total pot $22 | Rake $1.10 
Board [4c 3h 7d 6d]
Seat 1: GALWACONT collected ($20.90)
Seat 2: ilaviiitech folded before Flop (didn't bet)
Seat 3: InsomniaRU (button) folded on the Turn
Seat 4: matiko09 (small blind) folded before Flop
Seat 5: Kreuznagel (big blind) folded on the Turn
Seat 7: pulykakakas folded before Flop (didn't bet)
Seat 8: DUkalisUA folded before Flop (didn't bet)
Seat 9: Painkiller72 folded before Flop (didn't bet)





PokerStars Hand #151207226214:  Hold'em No Limit ($1/$2 USD) - 2016/03/31 12:19:54 CET [2016/03/31 6:19:54 ET]
Table 'Coelestina II' 9-max Seat #4 is the button
Seat 1: PacPacBum ($200 in chips) 
Seat 2: Kreuznagel ($200 in chips) 
Seat 3: ilaviiitech ($200 in chips) 
Seat 4: matiko09 ($239.25 in chips) 
Seat 6: InsomniaRU ($200 in chips) 
Seat 7: le_marc08 ($200 in chips) 
Seat 8: DUkalisUA ($200 in chips) 
Seat 9: fonng ($98 in chips) 
Painkiller72 will be allowed to play after the button
InsomniaRU: posts small blind $1
le_marc08: posts big blind $2
*** HOLE CARDS ***
Dealt to matiko09 [Jd 5s]
DUkalisUA: folds 
fonng: calls $2
PacPacBum: folds 
Kreuznagel: folds 
ilaviiitech: folds 
matiko09: folds 
InsomniaRU: folds 
le_marc08: checks 
*** FLOP *** [6s 4h Qh]
le_marc08: checks 
fonng: checks 
*** TURN *** [6s 4h Qh] [9d]
le_marc08: checks 
fonng: checks 
*** RIVER *** [6s 4h Qh 9d] [Jc]
le_marc08: bets $2
fonng: folds 
Uncalled bet ($2) returned to le_marc08
le_marc08 collected $4.75 from pot
le_marc08: doesn't show hand 
*** SUMMARY ***
Total pot $5 | Rake $0.25 
Board [6s 4h Qh 9d Jc]
Seat 1: PacPacBum folded before Flop (didn't bet)
Seat 2: Kreuznagel folded before Flop (didn't bet)
Seat 3: ilaviiitech folded before Flop (didn't bet)
Seat 4: matiko09 (button) folded before Flop (didn't bet)
Seat 6: InsomniaRU (small blind) folded before Flop
Seat 7: le_marc08 (big blind) collected ($4.75)
Seat 8: DUkalisUA folded before Flop (didn't bet)
Seat 9: fonng folded on the River





PokerStars Hand #151207227220:  Hold'em No Limit ($0.50/$1.00 USD) - 2016/03/31 12:19:56 CET [2016/03/31 6:19:56 ET]
Table 'Herge II' 9-max Seat #2 is the button
Seat 1: Chiapel ($66.84 in chips) 
Seat 2: DUkalisUA ($100 in chips) 
Seat 3: matiko09 ($201 in chips) 
Seat 4: vrnMike ($117.73 in chips) 
Seat 5: I The King I ($100 in chips) 
Seat 6: masaytoo ($107.39 in chips) 
Seat 7: Zeeshka ($100 in chips) 
Seat 8: IdiotFromNE ($100 in chips) 
Seat 9: fatstacks122 ($136.63 in chips) 
matiko09: posts small blind $0.50
vrnMike: posts big blind $1
*** HOLE CARDS ***
Dealt to matiko09 [6d 4h]
I The King I: folds 
masaytoo: folds 
Zeeshka: folds 
IdiotFromNE: folds 
fatstacks122: folds 
Chiapel: folds 
DUkalisUA: folds 
matiko09: folds 
Uncalled bet ($0.50) returned to vrnMike
vrnMike collected $1 from pot
*** SUMMARY ***
Total pot $1 | Rake $0 
Seat 1: Chiapel folded before Flop (didn't bet)
Seat 2: DUkalisUA (button) folded before Flop (didn't bet)
Seat 3: matiko09 (small blind) folded before Flop
Seat 4: vrnMike (big blind) collected ($1)
Seat 5: I The King I folded before Flop (didn't bet)
Seat 6: masaytoo folded before Flop (didn't bet)
Seat 7: Zeeshka folded before Flop (didn't bet)
Seat 8: IdiotFromNE folded before Flop (didn't bet)
Seat 9: fatstacks122 folded before Flop (didn't bet)





PokerStars Hand #151207234857:  Hold'em No Limit ($1/$2 USD) - 2016/03/31 12:20:13 CET [2016/03/31 6:20:13 ET]
Table 'Polaris IV' 9-max Seat #8 is the button
Seat 1: BOAYARSKIY ($105.79 in chips) 
Seat 3: Kreuznagel ($358.02 in chips) 
Seat 4: coinflip_si ($200 in chips) 
Seat 5: riverfish786 ($200 in chips) 
Seat 6: Mausert0811 ($316.47 in chips) 
Seat 7: matiko09 ($204.50 in chips) 
Seat 8: Painkiller72 ($214 in chips) 
Seat 9: K&K2 ($307.09 in chips) 
K&K2: posts small blind $1
BOAYARSKIY: posts big blind $2
*** HOLE CARDS ***
Dealt to matiko09 [Js Kc]
Kreuznagel: folds 
coinflip_si: folds 
riverfish786: raises $2 to $4
Mausert0811: folds 
matiko09: folds 
Painkiller72: folds 
K&K2: calls $3
BOAYARSKIY: raises $14 to $18
riverfish786: folds 
K&K2: calls $14
*** FLOP *** [Qh 5h Kh]
K&K2: checks 
BOAYARSKIY: bets $29
K&K2: raises $29 to $58
BOAYARSKIY: raises $29.79 to $87.79 and is all-in
K&K2: calls $29.79
*** TURN *** [Qh 5h Kh] [Jc]
*** RIVER *** [Qh 5h Kh Jc] [9s]
*** SHOW DOWN ***
K&K2: shows [Jh 7h] (a flush, King high)
BOAYARSKIY: shows [Ad Ac] (a pair of Aces)
K&K2 collected $212.83 from pot
*** SUMMARY ***
Total pot $215.58 | Rake $2.75 
Board [Qh 5h Kh Jc 9s]
Seat 1: BOAYARSKIY (big blind) showed [Ad Ac] and lost with a pair of Aces
Seat 3: Kreuznagel folded before Flop (didn't bet)
Seat 4: coinflip_si folded before Flop (didn't bet)
Seat 5: riverfish786 folded before Flop
Seat 6: Mausert0811 folded before Flop (didn't bet)
Seat 7: matiko09 folded before Flop (didn't bet)
Seat 8: Painkiller72 (button) folded before Flop (didn't bet)
Seat 9: K&K2 (small blind) showed [Jh 7h] and won ($212.83) with a flush, King high





PokerStars Hand #151207238762:  Hold'em No Limit ($0.50/$1.00 USD) - 2016/03/31 12:20:21 CET [2016/03/31 6:20:21 ET]
Table 'Yazhi' 9-max Seat #8 is the button
Seat 1: matiko09 ($100 in chips) 
Seat 2: xHourglass ($100 in chips) 
Seat 3: Painkiller72 ($100 in chips) 
Seat 4: apfush ($178.50 in chips) 
Seat 5: IdiotFromNE ($106.50 in chips) 
Seat 6: Reven9er ($189.69 in chips) 
Seat 7: vrnMike ($100 in chips) 
Seat 8: pk4DW ($43.81 in chips) 
Seat 9: oscarleon ($201.82 in chips) 
oscarleon: posts small blind $0.50
matiko09: posts big blind $1
*** HOLE CARDS ***
Dealt to matiko09 [3c 7s]
xHourglass: folds 
Painkiller72: folds 
apfush: folds 
IdiotFromNE: folds 
Reven9er: folds 
vrnMike: raises $1 to $2
pk4DW: folds 
oscarleon: folds 
matiko09: folds 
Uncalled bet ($1) returned to vrnMike
vrnMike collected $2.50 from pot
*** SUMMARY ***
Total pot $2.50 | Rake $0 
Seat 1: matiko09 (big blind) folded before Flop
Seat 2: xHourglass folded before Flop (didn't bet)
Seat 3: Painkiller72 folded before Flop (didn't bet)
Seat 4: apfush folded before Flop (didn't bet)
Seat 5: IdiotFromNE folded before Flop (didn't bet)
Seat 6: Reven9er folded before Flop (didn't bet)
Seat 7: vrnMike collected ($2.50)
Seat 8: pk4DW (button) folded before Flop (didn't bet)
Seat 9: oscarleon (small blind) folded before Flop





PokerStars Hand #151207240496:  Hold'em No Limit ($0.50/$1.00 USD) - 2016/03/31 12:20:25 CET [2016/03/31 6:20:25 ET]
Table 'Herge II' 9-max Seat #3 is the button
Seat 1: Chiapel ($66.84 in chips) 
Seat 2: DUkalisUA ($100 in chips) 
Seat 3: matiko09 ($200.50 in chips) 
Seat 4: vrnMike ($118.23 in chips) 
Seat 5: I The King I ($100 in chips) 
Seat 6: masaytoo ($107.39 in chips) 
Seat 7: Zeeshka ($100 in chips) 
Seat 8: IdiotFromNE ($100 in chips) 
Seat 9: fatstacks122 ($136.63 in chips) 
vrnMike: posts small blind $0.50
I The King I: posts big blind $1
*** HOLE CARDS ***
Dealt to matiko09 [Qd 4s]
masaytoo: raises $2 to $3
Zeeshka: folds 
IdiotFromNE: folds 
fatstacks122: folds 
Chiapel: folds 
DUkalisUA: folds 
matiko09: folds 
vrnMike: calls $2.50
I The King I: folds 
*** FLOP *** [3h 9h 5d]
fatstacks122 said, "where in aus you fom chiapel"
vrnMike: bets $5.50
masaytoo: folds 
Uncalled bet ($5.50) returned to vrnMike
vrnMike collected $6.65 from pot
*** SUMMARY ***
Total pot $7 | Rake $0.35 
Board [3h 9h 5d]
Seat 1: Chiapel folded before Flop (didn't bet)
Seat 2: DUkalisUA folded before Flop (didn't bet)
Seat 3: matiko09 (button) folded before Flop (didn't bet)
Seat 4: vrnMike (small blind) collected ($6.65)
Seat 5: I The King I (big blind) folded before Flop
Seat 6: masaytoo folded on the Flop
Seat 7: Zeeshka folded before Flop (didn't bet)
Seat 8: IdiotFromNE folded before Flop (didn't bet)
Seat 9: fatstacks122 folded before Flop (didn't bet)





PokerStars Hand #151207242809:  Hold'em No Limit (€0.50/€1.00 EUR) - 2016/03/31 12:20:30 CET [2016/03/31 6:20:30 ET]
Table 'Pioneer II' 9-max Seat #9 is the button
Seat 1: Kreuznagel (€102.84 in chips) 
Seat 2: IdiotFromNE (€109.50 in chips) 
Seat 3: vrnMike (€107.40 in chips) 
Seat 4: Zeeshka (€103.43 in chips) 
Seat 5: MickChick24 (€106.94 in chips) 
Seat 6: matiko09 (€100 in chips) 
Seat 8: Painkiller72 (€136.23 in chips) 
Seat 9: DUkalisUA (€100 in chips) 
Kreuznagel: posts small blind €0.50
IdiotFromNE: posts big blind €1
*** HOLE CARDS ***
Dealt to matiko09 [3h 5s]
vrnMike: folds 
Zeeshka: folds 
MickChick24: folds 
matiko09: folds 
Painkiller72: folds 
DUkalisUA: folds 
Kreuznagel: folds 
Uncalled bet (€0.50) returned to IdiotFromNE
IdiotFromNE collected €1 from pot
IdiotFromNE: doesn't show hand 
*** SUMMARY ***
Total pot €1 | Rake €0 
Seat 1: Kreuznagel (small blind) folded before Flop
Seat 2: IdiotFromNE (big blind) collected (€1)
Seat 3: vrnMike folded before Flop (didn't bet)
Seat 4: Zeeshka folded before Flop (didn't bet)
Seat 5: MickChick24 folded before Flop (didn't bet)
Seat 6: matiko09 folded before Flop (didn't bet)
Seat 8: Painkiller72 folded before Flop (didn't bet)
Seat 9: DUkalisUA (button) folded before Flop (didn't bet)





PokerStars Hand #151207246097:  Hold'em No Limit ($0.50/$1.00 USD) - 2016/03/31 12:20:37 CET [2016/03/31 6:20:37 ET]
Table 'Eugenisis III' 9-max Seat #5 is the button
Seat 1: PacPacBum ($101.50 in chips) 
Seat 2: IdiotFromNE ($101.50 in chips) 
Seat 3: Avtovo ($101.50 in chips) 
Seat 4: alejo22366 ($74.72 in chips) 
Seat 5: Painkiller72 ($119.36 in chips) 
Seat 6: kauff95 ($58.56 in chips) 
Seat 7: djammusic ($38.50 in chips) 
Seat 8: matiko09 ($100 in chips) 
Seat 9: choupai ($29 in chips) 
kauff95: posts small blind $0.50
djammusic: posts big blind $1
*** HOLE CARDS ***
Dealt to matiko09 [7d 4d]
matiko09: folds 
choupai: calls $1
PacPacBum: folds 
IdiotFromNE: folds 
Avtovo: folds 
alejo22366: folds 
Painkiller72: folds 
kauff95: folds 
djammusic: checks 
*** FLOP *** [9d 9h Tc]
djammusic: checks 
choupai: checks 
*** TURN *** [9d 9h Tc] [Ts]
djammusic: bets $1.23
choupai: calls $1.23
*** RIVER *** [9d 9h Tc Ts] [2c]
djammusic: bets $3.10
choupai: calls $3.10
*** SHOW DOWN ***
djammusic: shows [Td Kc] (a full house, Tens full of Nines)
choupai: mucks hand 
djammusic collected $10.60 from pot
*** SUMMARY ***
Total pot $11.16 | Rake $0.56 
Board [9d 9h Tc Ts 2c]
Seat 1: PacPacBum folded before Flop (didn't bet)
Seat 2: IdiotFromNE folded before Flop (didn't bet)
Seat 3: Avtovo folded before Flop (didn't bet)
Seat 4: alejo22366 folded before Flop (didn't bet)
Seat 5: Painkiller72 (button) folded before Flop (didn't bet)
Seat 6: kauff95 (small blind) folded before Flop
Seat 7: djammusic (big blind) showed [Td Kc] and won ($10.60) with a full house, Tens full of Nines
Seat 8: matiko09 folded before Flop (didn't bet)
Seat 9: choupai mucked [As 2s]





PokerStars Hand #151207250278:  Hold'em No Limit ($1/$2 USD) - 2016/03/31 12:20:47 CET [2016/03/31 6:20:47 ET]
Table 'Coelestina II' 9-max Seat #6 is the button
Seat 1: PacPacBum ($200 in chips) 
Seat 2: Kreuznagel ($200 in chips) 
Seat 3: ilaviiitech ($200 in chips) 
Seat 4: matiko09 ($239.25 in chips) 
Seat 5: Painkiller72 ($200 in chips) 
Seat 6: InsomniaRU ($200 in chips) 
Seat 7: le_marc08 ($202.75 in chips) 
Seat 8: DUkalisUA ($200 in chips) 
Seat 9: fonng ($96 in chips) 
le_marc08: posts small blind $1
DUkalisUA: posts big blind $2
Painkiller72: posts big blind $2
*** HOLE CARDS ***
Dealt to matiko09 [Tc Kc]
fonng: folds 
PacPacBum: folds 
Kreuznagel: folds 
ilaviiitech: folds 
matiko09: raises $5 to $7
Painkiller72: folds 
InsomniaRU: folds 
le_marc08: folds 
DUkalisUA: folds 
Uncalled bet ($5) returned to matiko09
matiko09 collected $7 from pot
matiko09: doesn't show hand 
*** SUMMARY ***
Total pot $7 | Rake $0 
Seat 1: PacPacBum folded before Flop (didn't bet)
Seat 2: Kreuznagel folded before Flop (didn't bet)
Seat 3: ilaviiitech folded before Flop (didn't bet)
Seat 4: matiko09 collected ($7)
Seat 5: Painkiller72 folded before Flop
Seat 6: InsomniaRU (button) folded before Flop (didn't bet)
Seat 7: le_marc08 (small blind) folded before Flop
Seat 8: DUkalisUA (big blind) folded before Flop
Seat 9: fonng folded before Flop (didn't bet)





PokerStars Hand #151207251432:  Hold'em No Limit ($0.50/$1.00 USD) - 2016/03/31 12:20:49 CET [2016/03/31 6:20:49 ET]
Table 'Icarus III' 9-max Seat #9 is the button
Seat 1: IdiotFromNE ($100 in chips) 
Seat 2: Painkiller72 ($100.14 in chips) 
Seat 4: dizzyryano79 ($30.11 in chips) 
Seat 5: I The King I ($105.60 in chips) 
Seat 6: gudridornot ($120.46 in chips) 
Seat 7: oscarleon ($154.13 in chips) 
Seat 8: matiko09 ($100 in chips) 
Seat 9: apfush ($123.76 in chips) 
IdiotFromNE: posts small blind $0.50
Painkiller72: posts big blind $1
RICKA16: sits out 
*** HOLE CARDS ***
Dealt to matiko09 [Qd Ad]
dizzyryano79: folds 
I The King I: folds 
gudridornot: folds 
oscarleon: folds 
matiko09: raises $1.50 to $2.50
apfush: folds 
IdiotFromNE: folds 
Painkiller72: folds 
Uncalled bet ($1.50) returned to matiko09
matiko09 collected $2.50 from pot
matiko09: doesn't show hand 
*** SUMMARY ***
Total pot $2.50 | Rake $0 
Seat 1: IdiotFromNE (small blind) folded before Flop
Seat 2: Painkiller72 (big blind) folded before Flop
Seat 4: dizzyryano79 folded before Flop (didn't bet)
Seat 5: I The King I folded before Flop (didn't bet)
Seat 6: gudridornot folded before Flop (didn't bet)
Seat 7: oscarleon folded before Flop (didn't bet)
Seat 8: matiko09 collected ($2.50)
Seat 9: apfush (button) folded before Flop (didn't bet)





PokerStars Hand #151207255310:  Hold'em No Limit ($0.50/$1.00 USD) - 2016/03/31 12:20:58 CET [2016/03/31 6:20:58 ET]
Table 'Yazhi' 9-max Seat #9 is the button
Seat 1: matiko09 ($100 in chips) 
Seat 2: xHourglass ($100 in chips) 
Seat 3: Painkiller72 ($100 in chips) 
Seat 4: apfush ($178.50 in chips) 
Seat 5: IdiotFromNE ($106.50 in chips) 
Seat 6: Reven9er ($189.69 in chips) 
Seat 7: vrnMike ($101.50 in chips) 
Seat 8: pk4DW ($43.81 in chips) 
Seat 9: oscarleon ($201.32 in chips) 
matiko09: posts small blind $0.50
xHourglass: posts big blind $1
*** HOLE CARDS ***
Dealt to matiko09 [Kd 6c]
Painkiller72: folds 
apfush: folds 
IdiotFromNE: folds 
Reven9er: raises $1 to $2
vrnMike: folds 
pk4DW: folds 
oscarleon: raises $8 to $10
matiko09: folds 
xHourglass: folds 
Reven9er: folds 
Uncalled bet ($8) returned to oscarleon
oscarleon collected $5.50 from pot
oscarleon: doesn't show hand 
*** SUMMARY ***
Total pot $5.50 | Rake $0 
Seat 1: matiko09 (small blind) folded before Flop
Seat 2: xHourglass (big blind) folded before Flop
Seat 3: Painkiller72 folded before Flop (didn't bet)
Seat 4: apfush folded before Flop (didn't bet)
Seat 5: IdiotFromNE folded before Flop (didn't bet)
Seat 6: Reven9er folded before Flop
Seat 7: vrnMike folded before Flop (didn't bet)
Seat 8: pk4DW folded before Flop (didn't bet)
Seat 9: oscarleon (button) collected ($5.50)





PokerStars Hand #151207259239:  Hold'em No Limit ($0.50/$1.00 USD) - 2016/03/31 12:21:06 CET [2016/03/31 6:21:06 ET]
Table 'Herge II' 9-max Seat #4 is the button
Seat 1: Chiapel ($66.84 in chips) 
Seat 2: DUkalisUA ($100 in chips) 
Seat 3: matiko09 ($200.50 in chips) 
Seat 4: vrnMike ($121.88 in chips) 
Seat 5: I The King I ($100 in chips) 
Seat 6: masaytoo ($104.39 in chips) 
Seat 7: Zeeshka ($100 in chips) 
Seat 8: IdiotFromNE ($100 in chips) 
Seat 9: fatstacks122 ($136.63 in chips) 
I The King I: posts small blind $0.50
masaytoo: posts big blind $1
*** HOLE CARDS ***
Dealt to matiko09 [3d 8s]
Zeeshka: folds 
IdiotFromNE: folds 
fatstacks122: folds 
Chiapel: folds 
DUkalisUA: folds 
matiko09: folds 
vrnMike: raises $2 to $3
I The King I: folds 
masaytoo: folds 
Uncalled bet ($2) returned to vrnMike
vrnMike collected $2.50 from pot
*** SUMMARY ***
Total pot $2.50 | Rake $0 
Seat 1: Chiapel folded before Flop (didn't bet)
Seat 2: DUkalisUA folded before Flop (didn't bet)
Seat 3: matiko09 folded before Flop (didn't bet)
Seat 4: vrnMike (button) collected ($2.50)
Seat 5: I The King I (small blind) folded before Flop
Seat 6: masaytoo (big blind) folded before Flop
Seat 7: Zeeshka folded before Flop (didn't bet)
Seat 8: IdiotFromNE folded before Flop (didn't bet)
Seat 9: fatstacks122 folded before Flop (didn't bet)





PokerStars Hand #151207260859:  Hold'em No Limit (€0.50/€1.00 EUR) - 2016/03/31 12:21:10 CET [2016/03/31 6:21:10 ET]
Table 'Pioneer II' 9-max Seat #1 is the button
Seat 1: Kreuznagel (€102.34 in chips) 
Seat 2: IdiotFromNE (€110 in chips) 
Seat 3: vrnMike (€107.40 in chips) 
Seat 4: Zeeshka (€103.43 in chips) 
Seat 5: MickChick24 (€106.94 in chips) 
Seat 6: matiko09 (€100 in chips) 
Seat 8: Painkiller72 (€136.23 in chips) 
Seat 9: DUkalisUA (€100 in chips) 
IdiotFromNE: posts small blind €0.50
vrnMike: posts big blind €1
*** HOLE CARDS ***
Dealt to matiko09 [Ts 2h]
Zeeshka: folds 
MickChick24: folds 
matiko09: folds 
Painkiller72: folds 
DUkalisUA: folds 
Kreuznagel: raises €1.50 to €2.50
IdiotFromNE: folds 
vrnMike: folds 
Uncalled bet (€1.50) returned to Kreuznagel
Kreuznagel collected €2.50 from pot
Kreuznagel: doesn't show hand 
*** SUMMARY ***
Total pot €2.50 | Rake €0 
Seat 1: Kreuznagel (button) collected (€2.50)
Seat 2: IdiotFromNE (small blind) folded before Flop
Seat 3: vrnMike (big blind) folded before Flop
Seat 4: Zeeshka folded before Flop (didn't bet)
Seat 5: MickChick24 folded before Flop (didn't bet)
Seat 6: matiko09 folded before Flop (didn't bet)
Seat 8: Painkiller72 folded before Flop (didn't bet)
Seat 9: DUkalisUA folded before Flop (didn't bet)





PokerStars Hand #151207261636:  Hold'em No Limit ($0.50/$1.00 USD) - 2016/03/31 12:21:11 CET [2016/03/31 6:21:11 ET]
Table 'Celestia II' 9-max Seat #6 is the button
Seat 1: matiko09 ($131.50 in chips) 
Seat 2: ValentinChit ($40 in chips) 
Seat 3: ilaviiitech ($101.50 in chips) 
Seat 4: I The King I ($153.05 in chips) 
Seat 5: i am owsome ($193.06 in chips) 
Seat 6: IdiotFromNE ($100 in chips) 
Seat 7: Avtovo ($100 in chips) 
Seat 8: DUkalisUA ($114.56 in chips) 
Seat 9: Chin41178 ($102.50 in chips) 
Avtovo: posts small blind $0.50
DUkalisUA: posts big blind $1
*** HOLE CARDS ***
Dealt to matiko09 [Ad 5d]
Chin41178: folds 
matiko09: folds 
ValentinChit: calls $1
ilaviiitech: folds 
I The King I: raises $3 to $4
i am owsome: folds 
IdiotFromNE: folds 
Avtovo: folds 
DUkalisUA: folds 
ValentinChit: calls $3
*** FLOP *** [8h Jh 4c]
ValentinChit: checks 
I The King I: bets $6
ValentinChit: folds 
Uncalled bet ($6) returned to I The King I
I The King I collected $9.02 from pot
I The King I: doesn't show hand 
*** SUMMARY ***
Total pot $9.50 | Rake $0.48 
Board [8h Jh 4c]
Seat 1: matiko09 folded before Flop (didn't bet)
Seat 2: ValentinChit folded on the Flop
Seat 3: ilaviiitech folded before Flop (didn't bet)
Seat 4: I The King I collected ($9.02)
Seat 5: i am owsome folded before Flop (didn't bet)
Seat 6: IdiotFromNE (button) folded before Flop (didn't bet)
Seat 7: Avtovo (small blind) folded before Flop
Seat 8: DUkalisUA (big blind) folded before Flop
Seat 9: Chin41178 folded before Flop (didn't bet)





PokerStars Hand #151207261578:  Hold'em No Limit ($1/$2 USD) - 2016/03/31 12:21:11 CET [2016/03/31 6:21:11 ET]
Table 'Desiderata' 9-max Seat #4 is the button
Seat 1: GALWACONT ($137.45 in chips) 
Seat 2: ilaviiitech ($219.89 in chips) 
Seat 3: InsomniaRU ($281.87 in chips) 
Seat 4: matiko09 ($213.60 in chips) 
Seat 5: Kreuznagel ($318.96 in chips) 
Seat 7: apfush ($200 in chips) 
Seat 8: DUkalisUA ($200 in chips) 
Seat 9: Painkiller72 ($206 in chips) 
Kreuznagel: posts small blind $1
apfush: posts big blind $2
*** HOLE CARDS ***
Dealt to matiko09 [8d 8s]
DUkalisUA: folds 
Painkiller72: raises $3 to $5
GALWACONT: folds 
ilaviiitech: folds 
InsomniaRU: folds 
matiko09: calls $5
Kreuznagel: folds 
apfush: calls $3
*** FLOP *** [6d Kc 8h]
apfush: checks 
Painkiller72: checks 
matiko09: bets $10
apfush: folds 
Painkiller72: calls $10
*** TURN *** [6d Kc 8h] [4d]
Painkiller72: checks 
matiko09: bets $24
Painkiller72: calls $24
*** RIVER *** [6d Kc 8h 4d] [7h]
Painkiller72: checks 
matiko09: bets $64
Painkiller72: calls $64
*** SHOW DOWN ***
matiko09: shows [8d 8s] (three of a kind, Eights)
Painkiller72: mucks hand 
matiko09 collected $209.25 from pot
*** SUMMARY ***
Total pot $212 | Rake $2.75 
Board [6d Kc 8h 4d 7h]
Seat 1: GALWACONT folded before Flop (didn't bet)
Seat 2: ilaviiitech folded before Flop (didn't bet)
Seat 3: InsomniaRU folded before Flop (didn't bet)
Seat 4: matiko09 (button) showed [8d 8s] and won ($209.25) with three of a kind, Eights
Seat 5: Kreuznagel (small blind) folded before Flop
Seat 7: apfush (big blind) folded on the Flop
Seat 8: DUkalisUA folded before Flop (didn't bet)
Seat 9: Painkiller72 mucked [Ks Qs]





PokerStars Hand #151207263665:  Hold'em No Limit ($1/$2 USD) - 2016/03/31 12:21:16 CET [2016/03/31 6:21:16 ET]
Table 'Coelestina II' 9-max Seat #7 is the button
Seat 1: PacPacBum ($200 in chips) 
Seat 2: Kreuznagel ($200 in chips) 
Seat 3: ilaviiitech ($200 in chips) 
Seat 4: matiko09 ($244.25 in chips) 
Seat 5: Painkiller72 ($200 in chips) 
Seat 6: InsomniaRU ($200 in chips) 
Seat 7: le_marc08 ($201.75 in chips) 
Seat 8: DUkalisUA ($200 in chips) 
Seat 9: fonng ($96 in chips) 
DUkalisUA: posts small blind $1
fonng: posts big blind $2
*** HOLE CARDS ***
Dealt to matiko09 [Jd Td]
PacPacBum: folds 
Kreuznagel: folds 
ilaviiitech: folds 
matiko09: raises $3 to $5
Painkiller72: folds 
InsomniaRU: folds 
le_marc08: folds 
DUkalisUA: folds 
fonng: calls $3
*** FLOP *** [8d 4h Ks]
fonng: checks 
matiko09: bets $6.50
fonng: raises $6.50 to $13
matiko09: folds 
Uncalled bet ($6.50) returned to fonng
fonng collected $22.80 from pot
fonng: doesn't show hand 
*** SUMMARY ***
Total pot $24 | Rake $1.20 
Board [8d 4h Ks]
Seat 1: PacPacBum folded before Flop (didn't bet)
Seat 2: Kreuznagel folded before Flop (didn't bet)
Seat 3: ilaviiitech folded before Flop (didn't bet)
Seat 4: matiko09 folded on the Flop
Seat 5: Painkiller72 folded before Flop (didn't bet)
Seat 6: InsomniaRU folded before Flop (didn't bet)
Seat 7: le_marc08 (button) folded before Flop (didn't bet)
Seat 8: DUkalisUA (small blind) folded before Flop
Seat 9: fonng (big blind) collected ($22.80)





PokerStars Hand #151207264073:  Hold'em No Limit ($0.50/$1.00 USD) - 2016/03/31 12:21:17 CET [2016/03/31 6:21:17 ET]
Table 'Icarus III' 9-max Seat #1 is the button
Seat 1: IdiotFromNE ($100 in chips) 
Seat 2: Painkiller72 ($100 in chips) 
Seat 3: RICKA16 ($105.88 in chips) 
Seat 4: dizzyryano79 ($30.11 in chips) 
Seat 5: I The King I ($105.60 in chips) 
Seat 6: gudridornot ($120.46 in chips) 
Seat 7: oscarleon ($154.13 in chips) 
Seat 8: matiko09 ($101.50 in chips) 
Seat 9: apfush ($123.76 in chips) 
Painkiller72: posts small blind $0.50
RICKA16: posts big blind $1
*** HOLE CARDS ***
Dealt to matiko09 [8s 7h]
dizzyryano79: folds 
I The King I: folds 
gudridornot: folds 
oscarleon: folds 
matiko09: folds 
apfush: folds 
IdiotFromNE: folds 
Painkiller72: folds 
Uncalled bet ($0.50) returned to RICKA16
RICKA16 collected $1 from pot
RICKA16: doesn't show hand 
*** SUMMARY ***
Total pot $1 | Rake $0 
Seat 1: IdiotFromNE (button) folded before Flop (didn't bet)
Seat 2: Painkiller72 (small blind) folded before Flop
Seat 3: RICKA16 (big blind) collected ($1)
Seat 4: dizzyryano79 folded before Flop (didn't bet)
Seat 5: I The King I folded before Flop (didn't bet)
Seat 6: gudridornot folded before Flop (didn't bet)
Seat 7: oscarleon folded before Flop (didn't bet)
Seat 8: matiko09 folded before Flop (didn't bet)
Seat 9: apfush folded before Flop (didn't bet)





PokerStars Hand #151207267609:  Hold'em No Limit ($0.50/$1.00 USD) - 2016/03/31 12:21:25 CET [2016/03/31 6:21:25 ET]
Table 'Eugenisis III' 9-max Seat #6 is the button
Seat 1: PacPacBum ($101.50 in chips) 
Seat 2: IdiotFromNE ($101.50 in chips) 
Seat 3: Avtovo ($101.50 in chips) 
Seat 4: alejo22366 ($74.72 in chips) 
Seat 5: Painkiller72 ($119.36 in chips) 
Seat 6: kauff95 ($58.06 in chips) 
Seat 7: djammusic ($43.77 in chips) 
Seat 8: matiko09 ($100 in chips) 
Seat 9: choupai ($23.67 in chips) 
djammusic: posts small blind $0.50
matiko09: posts big blind $1
*** HOLE CARDS ***
Dealt to matiko09 [Td Ac]
choupai: folds 
PacPacBum: folds 
IdiotFromNE: folds 
Avtovo: folds 
alejo22366: folds 
Painkiller72: folds 
kauff95: folds 
djammusic: raises $1.15 to $2.15
matiko09: calls $1.15
*** FLOP *** [4d 4s 7h]
djammusic: bets $2.65
matiko09: calls $2.65
*** TURN *** [4d 4s 7h] [7c]
djammusic: checks 
matiko09: checks 
*** RIVER *** [4d 4s 7h 7c] [Qc]
djammusic: checks 
matiko09: checks 
alejo22366 is disconnected 
*** SHOW DOWN ***
djammusic: shows [6d 8d] (two pair, Sevens and Fours)
matiko09: shows [Td Ac] (two pair, Sevens and Fours - Ace kicker)
matiko09 collected $9.12 from pot
*** SUMMARY ***
Total pot $9.60 | Rake $0.48 
Board [4d 4s 7h 7c Qc]
Seat 1: PacPacBum folded before Flop (didn't bet)
Seat 2: IdiotFromNE folded before Flop (didn't bet)
Seat 3: Avtovo folded before Flop (didn't bet)
Seat 4: alejo22366 folded before Flop (didn't bet)
Seat 5: Painkiller72 folded before Flop (didn't bet)
Seat 6: kauff95 (button) folded before Flop (didn't bet)
Seat 7: djammusic (small blind) showed [6d 8d] and lost with two pair, Sevens and Fours
Seat 8: matiko09 (big blind) showed [Td Ac] and won ($9.12) with two pair, Sevens and Fours
Seat 9: choupai folded before Flop (didn't bet)





PokerStars Hand #151207270523:  Hold'em No Limit ($0.50/$1.00 USD) - 2016/03/31 12:21:31 CET [2016/03/31 6:21:31 ET]
Table 'Yazhi' 9-max Seat #1 is the button
Seat 1: matiko09 ($100 in chips) 
Seat 2: xHourglass ($100 in chips) 
Seat 4: apfush ($178.50 in chips) 
Seat 5: IdiotFromNE ($106.50 in chips) 
Seat 6: Reven9er ($187.69 in chips) 
Seat 7: vrnMike ($101.50 in chips) 
Seat 8: pk4DW ($43.81 in chips) 
Seat 9: oscarleon ($204.82 in chips) 
xHourglass: posts small blind $0.50
Painkiller72: is sitting out 
apfush: posts big blind $1
*** HOLE CARDS ***
Dealt to matiko09 [5c Jh]
Painkiller72 leaves the table
IdiotFromNE: folds 
Reven9er: raises $1 to $2
vrnMike: folds 
pk4DW: folds 
Chin41178 joins the table at seat #3 
oscarleon: folds 
matiko09: folds 
xHourglass: folds 
apfush: folds 
Uncalled bet ($1) returned to Reven9er
Reven9er collected $2.50 from pot
Reven9er: doesn't show hand 
*** SUMMARY ***
Total pot $2.50 | Rake $0 
Seat 1: matiko09 (button) folded before Flop (didn't bet)
Seat 2: xHourglass (small blind) folded before Flop
Seat 4: apfush (big blind) folded before Flop
Seat 5: IdiotFromNE folded before Flop (didn't bet)
Seat 6: Reven9er collected ($2.50)
Seat 7: vrnMike folded before Flop (didn't bet)
Seat 8: pk4DW folded before Flop (didn't bet)
Seat 9: oscarleon folded before Flop (didn't bet)





PokerStars Hand #151207273904:  Hold'em No Limit ($1/$2 USD) - 2016/03/31 12:21:38 CET [2016/03/31 6:21:38 ET]
Table 'Polaris IV' 9-max Seat #9 is the button
Seat 1: BOAYARSKIY ($80 in chips) 
Seat 2: rmanjkeee ($86.94 in chips) 
Seat 3: Kreuznagel ($358.02 in chips) 
Seat 4: coinflip_si ($200 in chips) 
Seat 5: riverfish786 ($200 in chips) 
Seat 6: Mausert0811 ($316.47 in chips) 
Seat 7: matiko09 ($204.50 in chips) 
Seat 8: Painkiller72 ($214 in chips) 
Seat 9: K&K2 ($414.13 in chips) 
BOAYARSKIY: posts small blind $1
rmanjkeee: posts big blind $2
*** HOLE CARDS ***
Dealt to matiko09 [Qh Qc]
Kreuznagel: folds 
coinflip_si: folds 
riverfish786: folds 
Mausert0811: calls $2
matiko09: raises $6 to $8
Painkiller72: folds 
riverfish786 said, "lol twice u cracked the nits aces!"
K&K2: raises $16 to $24
BOAYARSKIY: folds 
rmanjkeee: folds 
Mausert0811: folds 
matiko09: calls $16
*** FLOP *** [Ks 5s 9h]
matiko09: checks 
K&K2: bets $8
matiko09: calls $8
*** TURN *** [Ks 5s 9h] [Jc]
matiko09: checks 
Mausert0811 leaves the table
K&K2: bets $14
matiko09: calls $14
*** RIVER *** [Ks 5s 9h Jc] [4h]
matiko09: checks 
K&K2: bets $14
matiko09: calls $14
*** SHOW DOWN ***
K&K2: shows [Ad Kh] (a pair of Kings)
matiko09: mucks hand 
K&K2 collected $122.25 from pot
*** SUMMARY ***
Total pot $125 | Rake $2.75 
Board [Ks 5s 9h Jc 4h]
Seat 1: BOAYARSKIY (small blind) folded before Flop
Seat 2: rmanjkeee (big blind) folded before Flop
Seat 3: Kreuznagel folded before Flop (didn't bet)
Seat 4: coinflip_si folded before Flop (didn't bet)
Seat 5: riverfish786 folded before Flop (didn't bet)
Seat 6: Mausert0811 folded before Flop
Seat 7: matiko09 mucked [Qh Qc]
Seat 8: Painkiller72 folded before Flop (didn't bet)
Seat 9: K&K2 (button) showed [Ad Kh] and won ($122.25) with a pair of Kings





PokerStars Hand #151207274507:  Hold'em No Limit ($0.50/$1.00 USD) - 2016/03/31 12:21:40 CET [2016/03/31 6:21:40 ET]
Table 'Herge II' 9-max Seat #5 is the button
Seat 1: Chiapel ($66.84 in chips) 
Seat 2: DUkalisUA ($100 in chips) 
Seat 3: matiko09 ($200.50 in chips) 
Seat 4: vrnMike ($123.38 in chips) 
Seat 5: I The King I ($100 in chips) 
Seat 6: masaytoo ($103.39 in chips) 
Seat 7: Zeeshka ($100 in chips) 
Seat 8: IdiotFromNE ($100 in chips) 
Seat 9: fatstacks122 ($136.63 in chips) 
masaytoo: posts small blind $0.50
Zeeshka: posts big blind $1
*** HOLE CARDS ***
Dealt to matiko09 [Jh 5c]
IdiotFromNE: folds 
fatstacks122: folds 
Chiapel: folds 
DUkalisUA: folds 
matiko09: folds 
vrnMike: folds 
Chiapel said, "ALASKA"
I The King I: folds 
masaytoo: folds 
Uncalled bet ($0.50) returned to Zeeshka
Zeeshka collected $1 from pot
Zeeshka: doesn't show hand 
*** SUMMARY ***
Total pot $1 | Rake $0 
Seat 1: Chiapel folded before Flop (didn't bet)
Seat 2: DUkalisUA folded before Flop (didn't bet)
Seat 3: matiko09 folded before Flop (didn't bet)
Seat 4: vrnMike folded before Flop (didn't bet)
Seat 5: I The King I (button) folded before Flop (didn't bet)
Seat 6: masaytoo (small blind) folded before Flop
Seat 7: Zeeshka (big blind) collected ($1)
Seat 8: IdiotFromNE folded before Flop (didn't bet)
Seat 9: fatstacks122 folded before Flop (didn't bet)





PokerStars Hand #151207278060:  Hold'em No Limit (€0.50/€1.00 EUR) - 2016/03/31 12:21:47 CET [2016/03/31 6:21:47 ET]
Table 'Pioneer II' 9-max Seat #2 is the button
Seat 1: Kreuznagel (€103.84 in chips) 
Seat 2: IdiotFromNE (€109.50 in chips) 
Seat 3: vrnMike (€106.40 in chips) 
Seat 4: Zeeshka (€103.43 in chips) 
Seat 5: MickChick24 (€106.94 in chips) 
Seat 6: matiko09 (€100 in chips) 
Seat 8: Painkiller72 (€136.23 in chips) 
Seat 9: DUkalisUA (€100 in chips) 
vrnMike: posts small blind €0.50
Zeeshka: posts big blind €1
*** HOLE CARDS ***
Dealt to matiko09 [8d Jc]
MickChick24: calls €1
matiko09: folds 
Painkiller72: folds 
DUkalisUA: raises €3 to €4
Kreuznagel: folds 
IdiotFromNE: folds 
vrnMike: folds 
Zeeshka: folds 
MickChick24: calls €3
*** FLOP *** [7d Ad 3d]
MickChick24: bets €5
DUkalisUA: calls €5
*** TURN *** [7d Ad 3d] [Kc]
MickChick24: bets €7
DUkalisUA: raises €8 to €15
MickChick24: calls €8
*** RIVER *** [7d Ad 3d Kc] [Js]
MickChick24: checks 
DUkalisUA: checks 
*** SHOW DOWN ***
MickChick24: shows [Ts As] (a pair of Aces)
DUkalisUA: mucks hand 
MickChick24 collected €47.25 from pot
*** SUMMARY ***
Total pot €49.50 | Rake €2.25 
Board [7d Ad 3d Kc Js]
Seat 1: Kreuznagel folded before Flop (didn't bet)
Seat 2: IdiotFromNE (button) folded before Flop (didn't bet)
Seat 3: vrnMike (small blind) folded before Flop
Seat 4: Zeeshka (big blind) folded before Flop
Seat 5: MickChick24 showed [Ts As] and won (€47.25) with a pair of Aces
Seat 6: matiko09 folded before Flop (didn't bet)
Seat 8: Painkiller72 folded before Flop (didn't bet)
Seat 9: DUkalisUA mucked [5h Ah]





PokerStars Hand #151207278583:  Hold'em No Limit ($0.50/$1.00 USD) - 2016/03/31 12:21:49 CET [2016/03/31 6:21:49 ET]
Table 'Icarus III' 9-max Seat #2 is the button
Seat 1: IdiotFromNE ($100 in chips) 
Seat 2: Painkiller72 ($100 in chips) 
Seat 3: RICKA16 ($106.38 in chips) 
Seat 4: dizzyryano79 ($30.11 in chips) 
Seat 5: I The King I ($105.60 in chips) 
Seat 6: gudridornot ($120.46 in chips) 
Seat 7: oscarleon ($154.13 in chips) 
Seat 8: matiko09 ($101.50 in chips) 
Seat 9: apfush ($123.76 in chips) 
RICKA16: posts small blind $0.50
dizzyryano79: posts big blind $1
*** HOLE CARDS ***
Dealt to matiko09 [7s 2s]
I The King I: raises $2 to $3
gudridornot: folds 
oscarleon: folds 
matiko09: folds 
apfush: folds 
IdiotFromNE: folds 
Painkiller72: folds 
RICKA16: folds 
dizzyryano79: calls $2
*** FLOP *** [2d 6h 3s]
dizzyryano79: checks 
I The King I: checks 
*** TURN *** [2d 6h 3s] [Jh]
dizzyryano79: bets $1
I The King I: raises $5 to $6
dizzyryano79: calls $5
*** RIVER *** [2d 6h 3s Jh] [4s]
dizzyryano79: bets $17.58
I The King I: folds 
Uncalled bet ($17.58) returned to dizzyryano79
dizzyryano79 collected $17.58 from pot
dizzyryano79: doesn't show hand 
*** SUMMARY ***
Total pot $18.50 | Rake $0.92 
Board [2d 6h 3s Jh 4s]
Seat 1: IdiotFromNE folded before Flop (didn't bet)
Seat 2: Painkiller72 (button) folded before Flop (didn't bet)
Seat 3: RICKA16 (small blind) folded before Flop
Seat 4: dizzyryano79 (big blind) collected ($17.58)
Seat 5: I The King I folded on the River
Seat 6: gudridornot folded before Flop (didn't bet)
Seat 7: oscarleon folded before Flop (didn't bet)
Seat 8: matiko09 folded before Flop (didn't bet)
Seat 9: apfush folded before Flop (didn't bet)





PokerStars Hand #151207282580:  Hold'em No Limit ($0.50/$1.00 USD) - 2016/03/31 12:21:57 CET [2016/03/31 6:21:57 ET]
Table 'Yazhi' 9-max Seat #2 is the button
Seat 1: matiko09 ($100 in chips) 
Seat 2: xHourglass ($100 in chips) 
Seat 4: apfush ($177.50 in chips) 
Seat 5: IdiotFromNE ($106.50 in chips) 
Seat 6: Reven9er ($189.19 in chips) 
Seat 7: vrnMike ($101.50 in chips) 
Seat 8: pk4DW ($43.81 in chips) 
Seat 9: oscarleon ($204.82 in chips) 
Chin41178 will be allowed to play after the button
apfush: posts small blind $0.50
IdiotFromNE: posts big blind $1
*** HOLE CARDS ***
Dealt to matiko09 [Qd Th]
Reven9er: folds 
vrnMike: folds 
pk4DW: calls $1
oscarleon: folds 
matiko09: raises $3 to $4
xHourglass: folds 
apfush: folds 
IdiotFromNE: folds 
pk4DW: calls $3
*** FLOP *** [9s 3h 9d]
pk4DW: checks 
matiko09: checks 
*** TURN *** [9s 3h 9d] [Tc]
pk4DW: bets $4.51
matiko09: calls $4.51
*** RIVER *** [9s 3h 9d Tc] [Jd]
pk4DW: bets $8.79
matiko09: calls $8.79
*** SHOW DOWN ***
pk4DW: shows [8d 9h] (three of a kind, Nines)
matiko09: mucks hand 
pk4DW collected $34.30 from pot
*** SUMMARY ***
Total pot $36.10 | Rake $1.80 
Board [9s 3h 9d Tc Jd]
Seat 1: matiko09 mucked [Qd Th]
Seat 2: xHourglass (button) folded before Flop (didn't bet)
Seat 4: apfush (small blind) folded before Flop
Seat 5: IdiotFromNE (big blind) folded before Flop
Seat 6: Reven9er folded before Flop (didn't bet)
Seat 7: vrnMike folded before Flop (didn't bet)
Seat 8: pk4DW showed [8d 9h] and won ($34.30) with three of a kind, Nines
Seat 9: oscarleon folded before Flop (didn't bet)





PokerStars Hand #151207284690:  Hold'em No Limit ($0.50/$1.00 USD) - 2016/03/31 12:22:02 CET [2016/03/31 6:22:02 ET]
Table 'Herge II' 9-max Seat #6 is the button
Seat 1: Chiapel ($66.84 in chips) 
Seat 2: DUkalisUA ($100 in chips) 
Seat 3: matiko09 ($200.50 in chips) 
Seat 4: vrnMike ($123.38 in chips) 
Seat 5: I The King I ($100 in chips) 
Seat 6: masaytoo ($102.89 in chips) 
Seat 7: Zeeshka ($100.50 in chips) 
Seat 8: IdiotFromNE ($100 in chips) 
Seat 9: fatstacks122 ($136.63 in chips) 
Zeeshka: posts small blind $0.50
IdiotFromNE: posts big blind $1
*** HOLE CARDS ***
Dealt to matiko09 [Qd 7s]
fatstacks122: raises $2 to $3
Chiapel: folds 
DUkalisUA: folds 
matiko09: folds 
vrnMike: folds 
I The King I: folds 
masaytoo: calls $3
Zeeshka: folds 
IdiotFromNE: folds 
*** FLOP *** [8d 2s 5h]
fatstacks122: checks 
masaytoo: checks 
*** TURN *** [8d 2s 5h] [7h]
fatstacks122: bets $3.75
masaytoo: folds 
Uncalled bet ($3.75) returned to fatstacks122
fatstacks122 collected $7.12 from pot
fatstacks122: doesn't show hand 
*** SUMMARY ***
Total pot $7.50 | Rake $0.38 
Board [8d 2s 5h 7h]
Seat 1: Chiapel folded before Flop (didn't bet)
Seat 2: DUkalisUA folded before Flop (didn't bet)
Seat 3: matiko09 folded before Flop (didn't bet)
Seat 4: vrnMike folded before Flop (didn't bet)
Seat 5: I The King I folded before Flop (didn't bet)
Seat 6: masaytoo (button) folded on the Turn
Seat 7: Zeeshka (small blind) folded before Flop
Seat 8: IdiotFromNE (big blind) folded before Flop
Seat 9: fatstacks122 collected ($7.12)





PokerStars Hand #151207290479:  Hold'em No Limit ($1/$2 USD) - 2016/03/31 12:22:15 CET [2016/03/31 6:22:15 ET]
Table 'Coelestina II' 9-max Seat #8 is the button
Seat 1: PacPacBum ($200 in chips) 
Seat 2: Kreuznagel ($200 in chips) 
Seat 3: ilaviiitech ($200 in chips) 
Seat 4: matiko09 ($232.75 in chips) 
Seat 5: Painkiller72 ($200 in chips) 
Seat 6: InsomniaRU ($200 in chips) 
Seat 7: le_marc08 ($201.75 in chips) 
Seat 8: DUkalisUA ($200 in chips) 
Seat 9: fonng ($107.30 in chips) 
fonng: posts small blind $1
PacPacBum: posts big blind $2
*** HOLE CARDS ***
Dealt to matiko09 [3d 2h]
Kreuznagel: folds 
ilaviiitech: folds 
matiko09: folds 
Painkiller72: folds 
InsomniaRU: raises $3 to $5
le_marc08: folds 
DUkalisUA: folds 
fonng: folds 
PacPacBum: folds 
Uncalled bet ($3) returned to InsomniaRU
InsomniaRU collected $5 from pot
InsomniaRU: doesn't show hand 
*** SUMMARY ***
Total pot $5 | Rake $0 
Seat 1: PacPacBum (big blind) folded before Flop
Seat 2: Kreuznagel folded before Flop (didn't bet)
Seat 3: ilaviiitech folded before Flop (didn't bet)
Seat 4: matiko09 folded before Flop (didn't bet)
Seat 5: Painkiller72 folded before Flop (didn't bet)
Seat 6: InsomniaRU collected ($5)
Seat 7: le_marc08 folded before Flop (didn't bet)
Seat 8: DUkalisUA (button) folded before Flop (didn't bet)
Seat 9: fonng (small blind) folded before Flop





PokerStars Hand #151207292450:  Hold'em No Limit ($0.50/$1.00 USD) - 2016/03/31 12:22:19 CET [2016/03/31 6:22:19 ET]
Table 'Celestia II' 9-max Seat #7 is the button
Seat 1: matiko09 ($131.50 in chips) 
Seat 2: ValentinChit ($36 in chips) 
Seat 3: ilaviiitech ($101.50 in chips) 
Seat 4: I The King I ($158.07 in chips) 
Seat 5: i am owsome ($193.06 in chips) 
Seat 6: IdiotFromNE ($100 in chips) 
Seat 7: Avtovo ($100 in chips) 
Seat 8: DUkalisUA ($113.56 in chips) 
Seat 9: Chin41178 ($102.50 in chips) 
DUkalisUA: posts small blind $0.50
Chin41178: posts big blind $1
*** HOLE CARDS ***
Dealt to matiko09 [Jc Td]
matiko09: folds 
ValentinChit: calls $1
ilaviiitech: folds 
I The King I: raises $3 to $4
i am owsome: folds 
IdiotFromNE: folds 
Avtovo: folds 
DUkalisUA: folds 
Chin41178: folds 
ValentinChit: calls $3
*** FLOP *** [6d 4s Ac]
ValentinChit: checks 
I The King I: bets $5
ValentinChit: calls $5
*** TURN *** [6d 4s Ac] [8c]
ValentinChit: checks 
I The King I: checks 
*** RIVER *** [6d 4s Ac 8c] [6c]
ValentinChit: checks 
I The King I: checks 
*** SHOW DOWN ***
ValentinChit: shows [7d Jd] (a pair of Sixes)
I The King I: shows [Kd Qs] (a pair of Sixes - Ace+King kicker)
I The King I collected $18.52 from pot
*** SUMMARY ***
Total pot $19.50 | Rake $0.98 
Board [6d 4s Ac 8c 6c]
Seat 1: matiko09 folded before Flop (didn't bet)
Seat 2: ValentinChit showed [7d Jd] and lost with a pair of Sixes
Seat 3: ilaviiitech folded before Flop (didn't bet)
Seat 4: I The King I showed [Kd Qs] and won ($18.52) with a pair of Sixes
Seat 5: i am owsome folded before Flop (didn't bet)
Seat 6: IdiotFromNE folded before Flop (didn't bet)
Seat 7: Avtovo (button) folded before Flop (didn't bet)
Seat 8: DUkalisUA (small blind) folded before Flop
Seat 9: Chin41178 (big blind) folded before Flop





PokerStars Hand #151207304540:  Hold'em No Limit ($1/$2 USD) - 2016/03/31 12:22:46 CET [2016/03/31 6:22:46 ET]
Table 'Coelestina II' 9-max Seat #9 is the button
Seat 1: PacPacBum ($200 in chips) 
Seat 2: Kreuznagel ($200 in chips) 
Seat 3: ilaviiitech ($200 in chips) 
Seat 4: matiko09 ($232.75 in chips) 
Seat 5: Painkiller72 ($200 in chips) 
Seat 6: InsomniaRU ($203 in chips) 
Seat 7: le_marc08 ($201.75 in chips) 
Seat 8: DUkalisUA ($200 in chips) 
Seat 9: fonng ($106.30 in chips) 
PacPacBum: posts small blind $1
Kreuznagel: posts big blind $2
*** HOLE CARDS ***
Dealt to matiko09 [6s Ac]
ilaviiitech: folds 
matiko09: folds 
Painkiller72: folds 
InsomniaRU: folds 
le_marc08: folds 
DUkalisUA: folds 
fonng: raises $2 to $4
PacPacBum: calls $3
Kreuznagel: calls $2
*** FLOP *** [8c 4s 2d]
PacPacBum: checks 
Kreuznagel: checks 
fonng: checks 
*** TURN *** [8c 4s 2d] [7s]
PacPacBum: checks 
Kreuznagel: bets $8.43
fonng: folds 
PacPacBum: folds 
Uncalled bet ($8.43) returned to Kreuznagel
Kreuznagel collected $11.40 from pot
Kreuznagel: doesn't show hand 
*** SUMMARY ***
Total pot $12 | Rake $0.60 
Board [8c 4s 2d 7s]
Seat 1: PacPacBum (small blind) folded on the Turn
Seat 2: Kreuznagel (big blind) collected ($11.40)
Seat 3: ilaviiitech folded before Flop (didn't bet)
Seat 4: matiko09 folded before Flop (didn't bet)
Seat 5: Painkiller72 folded before Flop (didn't bet)
Seat 6: InsomniaRU folded before Flop (didn't bet)
Seat 7: le_marc08 folded before Flop (didn't bet)
Seat 8: DUkalisUA folded before Flop (didn't bet)
Seat 9: fonng (button) folded on the Turn





PokerStars Hand #151207305853:  Hold'em No Limit ($0.50/$1.00 USD) - 2016/03/31 12:22:49 CET [2016/03/31 6:22:49 ET]
Table 'Eugenisis III' 9-max Seat #7 is the button
Seat 1: PacPacBum ($101.50 in chips) 
Seat 2: IdiotFromNE ($101.50 in chips) 
Seat 3: Avtovo ($101.50 in chips) 
Seat 4: alejo22366 ($74.72 in chips) 
Seat 5: Painkiller72 ($119.36 in chips) 
Seat 6: kauff95 ($58.06 in chips) 
Seat 7: djammusic ($38.97 in chips) 
Seat 8: matiko09 ($104.32 in chips) 
matiko09: posts small blind $0.50
choupai: is sitting out 
PacPacBum: posts big blind $1
*** HOLE CARDS ***
Dealt to matiko09 [2h 7h]
IdiotFromNE: folds 
Avtovo: raises $1.50 to $2.50
alejo22366: folds 
Painkiller72: folds 
kauff95: folds 
djammusic: folds 
matiko09: folds 
PacPacBum: folds 
Uncalled bet ($1.50) returned to Avtovo
Avtovo collected $2.50 from pot
Avtovo: doesn't show hand 
*** SUMMARY ***
Total pot $2.50 | Rake $0 
Seat 1: PacPacBum (big blind) folded before Flop
Seat 2: IdiotFromNE folded before Flop (didn't bet)
Seat 3: Avtovo collected ($2.50)
Seat 4: alejo22366 folded before Flop (didn't bet)
Seat 5: Painkiller72 folded before Flop (didn't bet)
Seat 6: kauff95 folded before Flop (didn't bet)
Seat 7: djammusic (button) folded before Flop (didn't bet)
Seat 8: matiko09 (small blind) folded before Flop





PokerStars Hand #151207307268:  Hold'em No Limit (€0.50/€1.00 EUR) - 2016/03/31 12:22:52 CET [2016/03/31 6:22:52 ET]
Table 'Pioneer II' 9-max Seat #3 is the button
Seat 1: Kreuznagel (€103.84 in chips) 
Seat 2: IdiotFromNE (€109.50 in chips) 
Seat 3: vrnMike (€105.90 in chips) 
Seat 4: Zeeshka (€102.43 in chips) 
Seat 5: MickChick24 (€130.19 in chips) 
Seat 6: matiko09 (€100 in chips) 
Seat 8: Painkiller72 (€136.23 in chips) 
Seat 9: DUkalisUA (€100 in chips) 
Zeeshka: posts small blind €0.50
MickChick24: posts big blind €1
*** HOLE CARDS ***
Dealt to matiko09 [6d Kc]
matiko09: folds 
Painkiller72: raises €1.50 to €2.50
DUkalisUA: folds 
Kreuznagel: folds 
IdiotFromNE: calls €2.50
vrnMike: folds 
Zeeshka: raises €10.50 to €13
MickChick24: folds 
Painkiller72: folds 
IdiotFromNE: calls €10.50
*** FLOP *** [2s Qs 4d]
Zeeshka: checks 
IdiotFromNE: checks 
*** TURN *** [2s Qs 4d] [3h]
Zeeshka: checks 
IdiotFromNE: checks 
*** RIVER *** [2s Qs 4d 3h] [Js]
Zeeshka: checks 
IdiotFromNE: bets €22.41
Zeeshka: folds 
Uncalled bet (€22.41) returned to IdiotFromNE
IdiotFromNE collected €28.02 from pot
IdiotFromNE: doesn't show hand 
*** SUMMARY ***
Total pot €29.50 | Rake €1.48 
Board [2s Qs 4d 3h Js]
Seat 1: Kreuznagel folded before Flop (didn't bet)
Seat 2: IdiotFromNE collected (€28.02)
Seat 3: vrnMike (button) folded before Flop (didn't bet)
Seat 4: Zeeshka (small blind) folded on the River
Seat 5: MickChick24 (big blind) folded before Flop
Seat 6: matiko09 folded before Flop (didn't bet)
Seat 8: Painkiller72 folded before Flop
Seat 9: DUkalisUA folded before Flop (didn't bet)





PokerStars Hand #151207314882:  Hold'em No Limit ($1/$2 USD) - 2016/03/31 12:23:09 CET [2016/03/31 6:23:09 ET]
Table 'Desiderata' 9-max Seat #5 is the button
Seat 1: GALWACONT ($137.45 in chips) 
Seat 2: ilaviiitech ($219.89 in chips) 
Seat 3: InsomniaRU ($281.87 in chips) 
Seat 4: matiko09 ($319.85 in chips) 
Seat 5: Kreuznagel ($317.96 in chips) 
Seat 7: apfush ($200 in chips) 
Seat 8: DUkalisUA ($200 in chips) 
Seat 9: Painkiller72 ($200 in chips) 
rmanjkeee will be allowed to play after the button
apfush: posts small blind $1
DUkalisUA: posts big blind $2
*** HOLE CARDS ***
Dealt to matiko09 [2s 4d]
Painkiller72: folds 
GALWACONT: folds 
ilaviiitech: folds 
InsomniaRU: folds 
matiko09: folds 
Kreuznagel: folds 
apfush: folds 
Uncalled bet ($1) returned to DUkalisUA
DUkalisUA collected $2 from pot
DUkalisUA: doesn't show hand 
*** SUMMARY ***
Total pot $2 | Rake $0 
Seat 1: GALWACONT folded before Flop (didn't bet)
Seat 2: ilaviiitech folded before Flop (didn't bet)
Seat 3: InsomniaRU folded before Flop (didn't bet)
Seat 4: matiko09 folded before Flop (didn't bet)
Seat 5: Kreuznagel (button) folded before Flop (didn't bet)
Seat 7: apfush (small blind) folded before Flop
Seat 8: DUkalisUA (big blind) collected ($2)
Seat 9: Painkiller72 folded before Flop (didn't bet)





PokerStars Hand #151207316910:  Hold'em No Limit ($0.50/$1.00 USD) - 2016/03/31 12:23:13 CET [2016/03/31 6:23:13 ET]
Table 'Eugenisis III' 9-max Seat #8 is the button
Seat 1: PacPacBum ($100.50 in chips) 
Seat 2: IdiotFromNE ($101.50 in chips) 
Seat 3: Avtovo ($103 in chips) 
Seat 4: alejo22366 ($74.72 in chips) 
Seat 5: Painkiller72 ($119.36 in chips) 
Seat 6: kauff95 ($58.06 in chips) 
Seat 7: djammusic ($38.97 in chips) 
Seat 8: matiko09 ($103.82 in chips) 
choupai will be allowed to play after the button
PacPacBum: posts small blind $0.50
IdiotFromNE: posts big blind $1
*** HOLE CARDS ***
Dealt to matiko09 [Ks Jc]
Avtovo: folds 
alejo22366: folds 
Painkiller72: folds 
kauff95: folds 
djammusic: folds 
matiko09: raises $1.27 to $2.27
PacPacBum: folds 
choupai is disconnected 
IdiotFromNE: folds 
Uncalled bet ($1.27) returned to matiko09
matiko09 collected $2.50 from pot
matiko09: doesn't show hand 
*** SUMMARY ***
Total pot $2.50 | Rake $0 
Seat 1: PacPacBum (small blind) folded before Flop
Seat 2: IdiotFromNE (big blind) folded before Flop
Seat 3: Avtovo folded before Flop (didn't bet)
Seat 4: alejo22366 folded before Flop (didn't bet)
Seat 5: Painkiller72 folded before Flop (didn't bet)
Seat 6: kauff95 folded before Flop (didn't bet)
Seat 7: djammusic folded before Flop (didn't bet)
Seat 8: matiko09 (button) collected ($2.50)





PokerStars Hand #151207317891:  Hold'em No Limit ($0.50/$1.00 USD) - 2016/03/31 12:23:15 CET [2016/03/31 6:23:15 ET]
Table 'Yazhi' 9-max Seat #4 is the button
Seat 1: matiko09 ($100 in chips) 
Seat 2: xHourglass ($100 in chips) 
Seat 4: apfush ($177 in chips) 
Seat 5: IdiotFromNE ($105.50 in chips) 
Seat 6: Reven9er ($189.19 in chips) 
Seat 7: vrnMike ($101.50 in chips) 
Seat 8: pk4DW ($60.81 in chips) 
Seat 9: oscarleon ($204.82 in chips) 
IdiotFromNE: posts small blind $0.50
Reven9er: posts big blind $1
Chin41178: sits out 
*** HOLE CARDS ***
Dealt to matiko09 [2c 8h]
vrnMike: folds 
pk4DW: folds 
oscarleon: folds 
matiko09: folds 
xHourglass: folds 
apfush: raises $1.20 to $2.20
IdiotFromNE: folds 
Reven9er: calls $1.20
*** FLOP *** [Qc 8c 3c]
Reven9er: checks 
apfush: bets $3
Reven9er: folds 
Uncalled bet ($3) returned to apfush
apfush collected $4.66 from pot
apfush: doesn't show hand 
*** SUMMARY ***
Total pot $4.90 | Rake $0.24 
Board [Qc 8c 3c]
Seat 1: matiko09 folded before Flop (didn't bet)
Seat 2: xHourglass folded before Flop (didn't bet)
Seat 4: apfush (button) collected ($4.66)
Seat 5: IdiotFromNE (small blind) folded before Flop
Seat 6: Reven9er (big blind) folded on the Flop
Seat 7: vrnMike folded before Flop (didn't bet)
Seat 8: pk4DW folded before Flop (didn't bet)
Seat 9: oscarleon folded before Flop (didn't bet)





PokerStars Hand #151207322324:  Hold'em No Limit ($1/$2 USD) - 2016/03/31 12:23:25 CET [2016/03/31 6:23:25 ET]
Table 'Desiderata' 9-max Seat #7 is the button
Seat 2: ilaviiitech ($219.89 in chips) 
Seat 3: InsomniaRU ($281.87 in chips) 
Seat 4: matiko09 ($319.85 in chips) 
Seat 5: Kreuznagel ($317.96 in chips) 
Seat 7: apfush ($200 in chips) 
Seat 8: DUkalisUA ($201 in chips) 
Seat 9: Painkiller72 ($200 in chips) 
DUkalisUA: posts small blind $1
Painkiller72: posts big blind $2
rmanjkeee: sits out 
*** HOLE CARDS ***
Dealt to matiko09 [3c Ts]
ilaviiitech: folds 
InsomniaRU: folds 
matiko09: folds 
Kreuznagel: folds 
apfush: raises $2.40 to $4.40
DUkalisUA: raises $12.60 to $17
Painkiller72: folds 
apfush: calls $12.60
*** FLOP *** [4h 5h 5c]
DUkalisUA: bets $18
apfush: folds 
Uncalled bet ($18) returned to DUkalisUA
DUkalisUA collected $34.20 from pot
DUkalisUA: doesn't show hand 
*** SUMMARY ***
Total pot $36 | Rake $1.80 
Board [4h 5h 5c]
Seat 2: ilaviiitech folded before Flop (didn't bet)
Seat 3: InsomniaRU folded before Flop (didn't bet)
Seat 4: matiko09 folded before Flop (didn't bet)
Seat 5: Kreuznagel folded before Flop (didn't bet)
Seat 7: apfush (button) folded on the Flop
Seat 8: DUkalisUA (small blind) collected ($34.20)
Seat 9: Painkiller72 (big blind) folded before Flop





PokerStars Hand #151207322393:  Hold'em No Limit ($0.50/$1.00 USD) - 2016/03/31 12:23:25 CET [2016/03/31 6:23:25 ET]
Table 'Icarus III' 9-max Seat #3 is the button
Seat 1: IdiotFromNE ($100 in chips) 
Seat 2: Painkiller72 ($100 in chips) 
Seat 3: RICKA16 ($105.88 in chips) 
Seat 4: dizzyryano79 ($38.69 in chips) 
Seat 5: I The King I ($100 in chips) 
Seat 6: gudridornot ($120.46 in chips) 
Seat 7: oscarleon ($154.13 in chips) 
Seat 8: matiko09 ($101.50 in chips) 
Seat 9: apfush ($123.76 in chips) 
dizzyryano79: posts small blind $0.50
I The King I: posts big blind $1
*** HOLE CARDS ***
Dealt to matiko09 [4h 4s]
gudridornot: folds 
gudridornot leaves the table
oscarleon: folds 
matiko09: raises $2 to $3
djammusic joins the table at seat #6 
apfush: folds 
IdiotFromNE: folds 
Painkiller72: calls $3
RICKA16: folds 
dizzyryano79: calls $2.50
I The King I: raises $12 to $15
matiko09: folds 
Painkiller72: folds 
dizzyryano79: folds 
Uncalled bet ($12) returned to I The King I
I The King I collected $12 from pot
I The King I: doesn't show hand 
*** SUMMARY ***
Total pot $12 | Rake $0 
Seat 1: IdiotFromNE folded before Flop (didn't bet)
Seat 2: Painkiller72 folded before Flop
Seat 3: RICKA16 (button) folded before Flop (didn't bet)
Seat 4: dizzyryano79 (small blind) folded before Flop
Seat 5: I The King I (big blind) collected ($12)
Seat 6: gudridornot folded before Flop (didn't bet)
Seat 7: oscarleon folded before Flop (didn't bet)
Seat 8: matiko09 folded before Flop
Seat 9: apfush folded before Flop (didn't bet)





PokerStars Hand #151207328462:  Hold'em No Limit ($0.50/$1.00 USD) - 2016/03/31 12:23:38 CET [2016/03/31 6:23:38 ET]
Table 'Eugenisis III' 9-max Seat #1 is the button
Seat 1: PacPacBum ($100 in chips) 
Seat 2: IdiotFromNE ($100.50 in chips) 
Seat 3: Avtovo ($103 in chips) 
Seat 4: alejo22366 ($74.72 in chips) 
Seat 5: Painkiller72 ($119.36 in chips) 
Seat 6: kauff95 ($58.06 in chips) 
Seat 7: djammusic ($38.97 in chips) 
Seat 8: matiko09 ($105.32 in chips) 
IdiotFromNE: posts small blind $0.50
Avtovo: posts big blind $1
choupai has timed out while disconnected
choupai: is sitting out 
*** HOLE CARDS ***
Dealt to matiko09 [6c Qd]
alejo22366: folds 
Painkiller72: folds 
kauff95: folds 
djammusic: folds 
matiko09: folds 
PacPacBum: raises $1.04 to $2.04
IdiotFromNE: folds 
Avtovo: folds 
Uncalled bet ($1.04) returned to PacPacBum
PacPacBum collected $2.50 from pot
PacPacBum: doesn't show hand 
*** SUMMARY ***
Total pot $2.50 | Rake $0 
Seat 1: PacPacBum (button) collected ($2.50)
Seat 2: IdiotFromNE (small blind) folded before Flop
Seat 3: Avtovo (big blind) folded before Flop
Seat 4: alejo22366 folded before Flop (didn't bet)
Seat 5: Painkiller72 folded before Flop (didn't bet)
Seat 6: kauff95 folded before Flop (didn't bet)
Seat 7: djammusic folded before Flop (didn't bet)
Seat 8: matiko09 folded before Flop (didn't bet)





PokerStars Hand #151207332396:  Hold'em No Limit ($1/$2 USD) - 2016/03/31 12:23:47 CET [2016/03/31 6:23:47 ET]
Table 'Polaris IV' 9-max Seat #1 is the button
Seat 1: BOAYARSKIY ($79 in chips) 
Seat 2: rmanjkeee ($84.94 in chips) 
Seat 3: Kreuznagel ($358.02 in chips) 
Seat 4: coinflip_si ($200 in chips) 
Seat 5: riverfish786 ($200 in chips) 
Seat 7: matiko09 ($200 in chips) 
Seat 8: Painkiller72 ($214 in chips) 
Seat 9: K&K2 ($476.38 in chips) 
rmanjkeee: posts small blind $1
Kreuznagel: posts big blind $2
*** HOLE CARDS ***
Dealt to matiko09 [6h Td]
PacPacBum joins the table at seat #6 
coinflip_si: folds 
riverfish786: folds 
matiko09: folds 
Painkiller72: folds 
K&K2: folds 
BOAYARSKIY: raises $2.26 to $4.26
rmanjkeee: folds 
Kreuznagel: folds 
Uncalled bet ($2.26) returned to BOAYARSKIY
BOAYARSKIY collected $5 from pot
BOAYARSKIY: doesn't show hand 
*** SUMMARY ***
Total pot $5 | Rake $0 
Seat 1: BOAYARSKIY (button) collected ($5)
Seat 2: rmanjkeee (small blind) folded before Flop
Seat 3: Kreuznagel (big blind) folded before Flop
Seat 4: coinflip_si folded before Flop (didn't bet)
Seat 5: riverfish786 folded before Flop (didn't bet)
Seat 7: matiko09 folded before Flop (didn't bet)
Seat 8: Painkiller72 folded before Flop (didn't bet)
Seat 9: K&K2 folded before Flop (didn't bet)





PokerStars Hand #151207335591:  Hold'em No Limit ($0.50/$1.00 USD) - 2016/03/31 12:23:53 CET [2016/03/31 6:23:53 ET]
Table 'Herge II' 9-max Seat #7 is the button
Seat 1: Chiapel ($66.84 in chips) 
Seat 2: DUkalisUA ($100 in chips) 
Seat 3: matiko09 ($200.50 in chips) 
Seat 4: vrnMike ($123.38 in chips) 
Seat 5: I The King I ($100 in chips) 
Seat 6: masaytoo ($99.89 in chips) 
Seat 7: Zeeshka ($100 in chips) 
Seat 8: IdiotFromNE ($100 in chips) 
Seat 9: fatstacks122 ($140.75 in chips) 
IdiotFromNE: posts small blind $0.50
fatstacks122: posts big blind $1
*** HOLE CARDS ***
Dealt to matiko09 [Qh 7s]
Chiapel: folds 
DUkalisUA: raises $2 to $3
matiko09: folds 
vrnMike: folds 
I The King I: folds 
masaytoo: folds 
Zeeshka: folds 
IdiotFromNE: folds 
fatstacks122: folds 
Uncalled bet ($2) returned to DUkalisUA
DUkalisUA collected $2.50 from pot
DUkalisUA: doesn't show hand 
*** SUMMARY ***
Total pot $2.50 | Rake $0 
Seat 1: Chiapel folded before Flop (didn't bet)
Seat 2: DUkalisUA collected ($2.50)
Seat 3: matiko09 folded before Flop (didn't bet)
Seat 4: vrnMike folded before Flop (didn't bet)
Seat 5: I The King I folded before Flop (didn't bet)
Seat 6: masaytoo folded before Flop (didn't bet)
Seat 7: Zeeshka (button) folded before Flop (didn't bet)
Seat 8: IdiotFromNE (small blind) folded before Flop
Seat 9: fatstacks122 (big blind) folded before Flop





PokerStars Hand #151207338140:  Hold'em No Limit ($0.50/$1.00 USD) - 2016/03/31 12:23:59 CET [2016/03/31 6:23:59 ET]
Table 'Yazhi' 9-max Seat #5 is the button
Seat 1: matiko09 ($100 in chips) 
Seat 2: xHourglass ($100 in chips) 
Seat 4: apfush ($179.46 in chips) 
Seat 5: IdiotFromNE ($105 in chips) 
Seat 6: Reven9er ($186.99 in chips) 
Seat 8: pk4DW ($60.81 in chips) 
Seat 9: oscarleon ($204.82 in chips) 
Reven9er: posts small blind $0.50
vrnMike: is sitting out 
pk4DW: posts big blind $1
Chin41178: sits out 
*** HOLE CARDS ***
Dealt to matiko09 [Th 4h]
oscarleon: folds 
matiko09: folds 
xHourglass: folds 
apfush: raises $1.50 to $2.50
IdiotFromNE: folds 
Reven9er: folds 
pk4DW: folds 
Uncalled bet ($1.50) returned to apfush
apfush collected $2.50 from pot
apfush: doesn't show hand 
*** SUMMARY ***
Total pot $2.50 | Rake $0 
Seat 1: matiko09 folded before Flop (didn't bet)
Seat 2: xHourglass folded before Flop (didn't bet)
Seat 4: apfush collected ($2.50)
Seat 5: IdiotFromNE (button) folded before Flop (didn't bet)
Seat 6: Reven9er (small blind) folded before Flop
Seat 8: pk4DW (big blind) folded before Flop
Seat 9: oscarleon folded before Flop (didn't bet)





PokerStars Hand #151207339071:  Hold'em No Limit ($0.50/$1.00 USD) - 2016/03/31 12:24:01 CET [2016/03/31 6:24:01 ET]
Table 'Celestia II' 9-max Seat #8 is the button
Seat 1: matiko09 ($131.50 in chips) 
Seat 2: ValentinChit ($27 in chips) 
Seat 3: ilaviiitech ($101.50 in chips) 
Seat 4: I The King I ($167.59 in chips) 
Seat 5: i am owsome ($193.06 in chips) 
Seat 6: IdiotFromNE ($100 in chips) 
Seat 7: Avtovo ($100 in chips) 
Seat 8: DUkalisUA ($113.06 in chips) 
Seat 9: Chin41178 ($101.50 in chips) 
Chin41178: posts small blind $0.50
matiko09: posts big blind $1
*** HOLE CARDS ***
Dealt to matiko09 [7d Qd]
ValentinChit: raises $1 to $2
ilaviiitech: folds 
I The King I: folds 
i am owsome: folds 
i am owsome leaves the table
IdiotFromNE: folds 
Avtovo: folds 
DUkalisUA: folds 
Chin41178: folds 
matiko09: folds 
Uncalled bet ($1) returned to ValentinChit
ValentinChit collected $2.50 from pot
ValentinChit: doesn't show hand 
*** SUMMARY ***
Total pot $2.50 | Rake $0 
Seat 1: matiko09 (big blind) folded before Flop
Seat 2: ValentinChit collected ($2.50)
Seat 3: ilaviiitech folded before Flop (didn't bet)
Seat 4: I The King I folded before Flop (didn't bet)
Seat 5: i am owsome folded before Flop (didn't bet)
Seat 6: IdiotFromNE folded before Flop (didn't bet)
Seat 7: Avtovo folded before Flop (didn't bet)
Seat 8: DUkalisUA (button) folded before Flop (didn't bet)
Seat 9: Chin41178 (small blind) folded before Flop





PokerStars Hand #151207340094:  Hold'em No Limit ($1/$2 USD) - 2016/03/31 12:24:03 CET [2016/03/31 6:24:03 ET]
Table 'Coelestina II' 9-max Seat #1 is the button
Seat 1: PacPacBum ($200 in chips) 
Seat 2: Kreuznagel ($207.40 in chips) 
Seat 3: ilaviiitech ($200 in chips) 
Seat 4: matiko09 ($232.75 in chips) 
Seat 5: Painkiller72 ($200 in chips) 
Seat 6: InsomniaRU ($203 in chips) 
Seat 7: le_marc08 ($201.75 in chips) 
Seat 8: DUkalisUA ($200 in chips) 
Seat 9: fonng ($102.30 in chips) 
Kreuznagel: posts small blind $1
ilaviiitech: posts big blind $2
*** HOLE CARDS ***
Dealt to matiko09 [Jh 8s]
matiko09: folds 
Painkiller72: folds 
InsomniaRU: folds 
le_marc08: folds 
DUkalisUA: raises $4 to $6
fonng: folds 
PacPacBum: folds 
Kreuznagel: folds 
ilaviiitech: folds 
Uncalled bet ($4) returned to DUkalisUA
DUkalisUA collected $5 from pot
DUkalisUA: doesn't show hand 
*** SUMMARY ***
Total pot $5 | Rake $0 
Seat 1: PacPacBum (button) folded before Flop (didn't bet)
Seat 2: Kreuznagel (small blind) folded before Flop
Seat 3: ilaviiitech (big blind) folded before Flop
Seat 4: matiko09 folded before Flop (didn't bet)
Seat 5: Painkiller72 folded before Flop (didn't bet)
Seat 6: InsomniaRU folded before Flop (didn't bet)
Seat 7: le_marc08 folded before Flop (didn't bet)
Seat 8: DUkalisUA collected ($5)
Seat 9: fonng folded before Flop (didn't bet)





PokerStars Hand #151207346388:  Hold'em No Limit ($0.50/$1.00 USD) - 2016/03/31 12:24:17 CET [2016/03/31 6:24:17 ET]
Table 'Eugenisis III' 9-max Seat #2 is the button
Seat 1: PacPacBum ($101.50 in chips) 
Seat 2: IdiotFromNE ($100 in chips) 
Seat 3: Avtovo ($102 in chips) 
Seat 4: alejo22366 ($74.72 in chips) 
Seat 5: Painkiller72 ($119.36 in chips) 
Seat 6: kauff95 ($58.06 in chips) 
Seat 7: djammusic ($38.97 in chips) 
Seat 8: matiko09 ($105.32 in chips) 
Avtovo: posts small blind $0.50
alejo22366: posts big blind $1
*** HOLE CARDS ***
Dealt to matiko09 [Td Js]
Painkiller72: folds 
Painkiller72 leaves the table
kauff95 is disconnected 
ka100pka527 joins the table at seat #5 
kauff95 is connected 
kauff95: folds 
djammusic: folds 
matiko09: folds 
PacPacBum: raises $1.50 to $2.50
IdiotFromNE: folds 
Avtovo: folds 
alejo22366: calls $1.50
*** FLOP *** [6s 2h Ts]
alejo22366: checks 
PacPacBum: checks 
*** TURN *** [6s 2h Ts] [4s]
alejo22366: checks 
PacPacBum: checks 
*** RIVER *** [6s 2h Ts 4s] [8s]
alejo22366: checks 
PacPacBum: bets $2.81
alejo22366: folds 
Uncalled bet ($2.81) returned to PacPacBum
PacPacBum collected $5.22 from pot
PacPacBum: doesn't show hand 
*** SUMMARY ***
Total pot $5.50 | Rake $0.28 
Board [6s 2h Ts 4s 8s]
Seat 1: PacPacBum collected ($5.22)
Seat 2: IdiotFromNE (button) folded before Flop (didn't bet)
Seat 3: Avtovo (small blind) folded before Flop
Seat 4: alejo22366 (big blind) folded on the River
Seat 5: Painkiller72 folded before Flop (didn't bet)
Seat 6: kauff95 folded before Flop (didn't bet)
Seat 7: djammusic folded before Flop (didn't bet)
Seat 8: matiko09 folded before Flop (didn't bet)





PokerStars Hand #151207346261:  Hold'em No Limit ($1/$2 USD) - 2016/03/31 12:24:17 CET [2016/03/31 6:24:17 ET]
Table 'Polaris IV' 9-max Seat #2 is the button
Seat 1: BOAYARSKIY ($82 in chips) 
Seat 2: rmanjkeee ($83.94 in chips) 
Seat 3: Kreuznagel ($356.02 in chips) 
Seat 4: coinflip_si ($200 in chips) 
Seat 5: riverfish786 ($200 in chips) 
Seat 7: matiko09 ($200 in chips) 
Seat 8: Painkiller72 ($214 in chips) 
Seat 9: K&K2 ($476.38 in chips) 
Kreuznagel: posts small blind $1
coinflip_si: posts big blind $2
PacPacBum: sits out 
*** HOLE CARDS ***
Dealt to matiko09 [2h 6d]
riverfish786: raises $2 to $4
matiko09: folds 
Painkiller72: folds 
K&K2: folds 
BOAYARSKIY: folds 
rmanjkeee: folds 
Kreuznagel: folds 
coinflip_si: folds 
Uncalled bet ($2) returned to riverfish786
riverfish786 collected $5 from pot
riverfish786: doesn't show hand 
*** SUMMARY ***
Total pot $5 | Rake $0 
Seat 1: BOAYARSKIY folded before Flop (didn't bet)
Seat 2: rmanjkeee (button) folded before Flop (didn't bet)
Seat 3: Kreuznagel (small blind) folded before Flop
Seat 4: coinflip_si (big blind) folded before Flop
Seat 5: riverfish786 collected ($5)
Seat 7: matiko09 folded before Flop (didn't bet)
Seat 8: Painkiller72 folded before Flop (didn't bet)
Seat 9: K&K2 folded before Flop (didn't bet)





PokerStars Hand #151207347969:  Hold'em No Limit (€0.50/€1.00 EUR) - 2016/03/31 12:24:20 CET [2016/03/31 6:24:20 ET]
Table 'Pioneer II' 9-max Seat #4 is the button
Seat 1: Kreuznagel (€103.84 in chips) 
Seat 2: IdiotFromNE (€124.52 in chips) 
Seat 3: vrnMike (€105.90 in chips) 
Seat 4: Zeeshka (€100 in chips) 
Seat 5: MickChick24 (€129.19 in chips) 
Seat 6: matiko09 (€100 in chips) 
Seat 7: AlKatrone (€125.91 in chips) 
Seat 8: Painkiller72 (€133.73 in chips) 
Seat 9: DUkalisUA (€100 in chips) 
MickChick24: posts small blind €0.50
matiko09: posts big blind €1
*** HOLE CARDS ***
Dealt to matiko09 [8c 8s]
AlKatrone: folds 
Painkiller72: folds 
DUkalisUA: folds 
Kreuznagel: folds 
IdiotFromNE: folds 
vrnMike: folds 
Zeeshka: folds 
MickChick24: folds 
Uncalled bet (€0.50) returned to matiko09
matiko09 collected €1 from pot
matiko09: doesn't show hand 
*** SUMMARY ***
Total pot €1 | Rake €0 
Seat 1: Kreuznagel folded before Flop (didn't bet)
Seat 2: IdiotFromNE folded before Flop (didn't bet)
Seat 3: vrnMike folded before Flop (didn't bet)
Seat 4: Zeeshka (button) folded before Flop (didn't bet)
Seat 5: MickChick24 (small blind) folded before Flop
Seat 6: matiko09 (big blind) collected (€1)
Seat 7: AlKatrone folded before Flop (didn't bet)
Seat 8: Painkiller72 folded before Flop (didn't bet)
Seat 9: DUkalisUA folded before Flop (didn't bet)





PokerStars Hand #151207350270:  Hold'em No Limit ($0.50/$1.00 USD) - 2016/03/31 12:24:25 CET [2016/03/31 6:24:25 ET]
Table 'Celestia II' 9-max Seat #9 is the button
Seat 1: matiko09 ($130.50 in chips) 
Seat 2: ValentinChit ($28.50 in chips) 
Seat 3: ilaviiitech ($101.50 in chips) 
Seat 4: I The King I ($167.59 in chips) 
Seat 6: IdiotFromNE ($100 in chips) 
Seat 7: Avtovo ($100 in chips) 
Seat 8: DUkalisUA ($113.06 in chips) 
Seat 9: Chin41178 ($101 in chips) 
matiko09: posts small blind $0.50
ValentinChit: posts big blind $1
*** HOLE CARDS ***
Dealt to matiko09 [3c Jc]
ilaviiitech: folds 
I The King I: folds 
IdiotFromNE: folds 
Avtovo: raises $1.50 to $2.50
DUkalisUA: folds 
Chin41178: calls $2.50
matiko09: folds 
ValentinChit: calls $1.50
*** FLOP *** [7s Jd Kc]
ValentinChit: bets $4
djammusic joins the table at seat #5 
Avtovo: calls $4
Chin41178: folds 
*** TURN *** [7s Jd Kc] [2s]
ValentinChit: bets $5
Avtovo: raises $6.50 to $11.50
ValentinChit: calls $6.50
*** RIVER *** [7s Jd Kc 2s] [Tc]
ValentinChit: bets $10.50 and is all-in
Avtovo: calls $10.50
*** SHOW DOWN ***
ValentinChit: shows [8s As] (high card Ace)
Avtovo: shows [Ac Ah] (a pair of Aces)
Avtovo collected $57.50 from pot
*** SUMMARY ***
Total pot $60 | Rake $2.50 
Board [7s Jd Kc 2s Tc]
Seat 1: matiko09 (small blind) folded before Flop
Seat 2: ValentinChit (big blind) showed [8s As] and lost with high card Ace
Seat 3: ilaviiitech folded before Flop (didn't bet)
Seat 4: I The King I folded before Flop (didn't bet)
Seat 6: IdiotFromNE folded before Flop (didn't bet)
Seat 7: Avtovo showed [Ac Ah] and won ($57.50) with a pair of Aces
Seat 8: DUkalisUA folded before Flop (didn't bet)
Seat 9: Chin41178 (button) folded on the Flop





PokerStars Hand #151207350637:  Hold'em No Limit ($1/$2 USD) - 2016/03/31 12:24:26 CET [2016/03/31 6:24:26 ET]
Table 'Coelestina II' 9-max Seat #2 is the button
Seat 1: PacPacBum ($200 in chips) 
Seat 2: Kreuznagel ($206.40 in chips) 
Seat 3: ilaviiitech ($200 in chips) 
Seat 4: matiko09 ($232.75 in chips) 
Seat 5: Painkiller72 ($200 in chips) 
Seat 6: InsomniaRU ($203 in chips) 
Seat 7: le_marc08 ($201.75 in chips) 
Seat 8: DUkalisUA ($203 in chips) 
Seat 9: fonng ($102.30 in chips) 
ilaviiitech: posts small blind $1
matiko09: posts big blind $2
*** HOLE CARDS ***
Dealt to matiko09 [8h 3c]
Painkiller72: raises $3 to $5
InsomniaRU: folds 
le_marc08: folds 
DUkalisUA: folds 
fonng: folds 
PacPacBum: folds 
Kreuznagel: calls $5
ilaviiitech: folds 
matiko09: folds 
*** FLOP *** [7c Qc Ac]
Painkiller72: checks 
Kreuznagel: bets $9.13
Painkiller72: folds 
Uncalled bet ($9.13) returned to Kreuznagel
Kreuznagel collected $12.35 from pot
Kreuznagel: doesn't show hand 
*** SUMMARY ***
Total pot $13 | Rake $0.65 
Board [7c Qc Ac]
Seat 1: PacPacBum folded before Flop (didn't bet)
Seat 2: Kreuznagel (button) collected ($12.35)
Seat 3: ilaviiitech (small blind) folded before Flop
Seat 4: matiko09 (big blind) folded before Flop
Seat 5: Painkiller72 folded on the Flop
Seat 6: InsomniaRU folded before Flop (didn't bet)
Seat 7: le_marc08 folded before Flop (didn't bet)
Seat 8: DUkalisUA folded before Flop (didn't bet)
Seat 9: fonng folded before Flop (didn't bet)





PokerStars Hand #151207352792:  Hold'em No Limit ($0.50/$1.00 USD) - 2016/03/31 12:24:31 CET [2016/03/31 6:24:31 ET]
Table 'Yazhi' 9-max Seat #6 is the button
Seat 1: matiko09 ($100 in chips) 
Seat 2: xHourglass ($100 in chips) 
Seat 4: apfush ($180.96 in chips) 
Seat 5: IdiotFromNE ($105 in chips) 
Seat 6: Reven9er ($186.49 in chips) 
Seat 8: pk4DW ($59.81 in chips) 
Seat 9: oscarleon ($204.82 in chips) 
pk4DW: posts small blind $0.50
oscarleon: posts big blind $1
Chin41178: sits out 
*** HOLE CARDS ***
Dealt to matiko09 [Ah Qh]
matiko09: raises $2 to $3
xHourglass: folds 
apfush: folds 
IdiotFromNE: folds 
Reven9er: folds 
pk4DW: folds 
oscarleon: folds 
Uncalled bet ($2) returned to matiko09
matiko09 collected $2.50 from pot
matiko09: doesn't show hand 
*** SUMMARY ***
Total pot $2.50 | Rake $0 
Seat 1: matiko09 collected ($2.50)
Seat 2: xHourglass folded before Flop (didn't bet)
Seat 4: apfush folded before Flop (didn't bet)
Seat 5: IdiotFromNE folded before Flop (didn't bet)
Seat 6: Reven9er (button) folded before Flop (didn't bet)
Seat 8: pk4DW (small blind) folded before Flop
Seat 9: oscarleon (big blind) folded before Flop





PokerStars Hand #151207353500:  Hold'em No Limit ($0.50/$1.00 USD) - 2016/03/31 12:24:32 CET [2016/03/31 6:24:32 ET]
Table 'Herge II' 9-max Seat #8 is the button
Seat 1: Chiapel ($66.84 in chips) 
Seat 2: DUkalisUA ($101.50 in chips) 
Seat 3: matiko09 ($200.50 in chips) 
Seat 4: vrnMike ($123.38 in chips) 
Seat 5: I The King I ($100 in chips) 
Seat 6: masaytoo ($99.89 in chips) 
Seat 7: Zeeshka ($100 in chips) 
Seat 8: IdiotFromNE ($100 in chips) 
Seat 9: fatstacks122 ($139.75 in chips) 
fatstacks122: posts small blind $0.50
Chiapel: posts big blind $1
*** HOLE CARDS ***
Dealt to matiko09 [8d 6d]
DUkalisUA: folds 
matiko09: folds 
vrnMike: folds 
I The King I: raises $2 to $3
masaytoo: raises $9 to $12
Zeeshka: folds 
IdiotFromNE: folds 
fatstacks122: folds 
Chiapel: folds 
I The King I: folds 
Uncalled bet ($9) returned to masaytoo
masaytoo collected $7.50 from pot
masaytoo: doesn't show hand 
*** SUMMARY ***
Total pot $7.50 | Rake $0 
Seat 1: Chiapel (big blind) folded before Flop
Seat 2: DUkalisUA folded before Flop (didn't bet)
Seat 3: matiko09 folded before Flop (didn't bet)
Seat 4: vrnMike folded before Flop (didn't bet)
Seat 5: I The King I folded before Flop
Seat 6: masaytoo collected ($7.50)
Seat 7: Zeeshka folded before Flop (didn't bet)
Seat 8: IdiotFromNE (button) folded before Flop (didn't bet)
Seat 9: fatstacks122 (small blind) folded before Flop





PokerStars Hand #151207353346:  Hold'em No Limit ($1/$2 USD) - 2016/03/31 12:24:32 CET [2016/03/31 6:24:32 ET]
Table 'Desiderata' 9-max Seat #8 is the button
Seat 2: ilaviiitech ($219.89 in chips) 
Seat 3: InsomniaRU ($281.87 in chips) 
Seat 4: matiko09 ($319.85 in chips) 
Seat 5: Kreuznagel ($317.96 in chips) 
Seat 7: apfush ($200 in chips) 
Seat 8: DUkalisUA ($218.20 in chips) 
Seat 9: Painkiller72 ($200 in chips) 
Painkiller72: posts small blind $1
ilaviiitech: posts big blind $2
rmanjkeee: sits out 
*** HOLE CARDS ***
Dealt to matiko09 [Ad 2h]
InsomniaRU: folds 
matiko09: folds 
Kreuznagel: folds 
apfush: folds 
DUkalisUA: raises $2 to $4
Painkiller72: raises $12 to $16
ilaviiitech: folds 
DUkalisUA: folds 
Uncalled bet ($12) returned to Painkiller72
Painkiller72 collected $10 from pot
Painkiller72: doesn't show hand 
*** SUMMARY ***
Total pot $10 | Rake $0 
Seat 2: ilaviiitech (big blind) folded before Flop
Seat 3: InsomniaRU folded before Flop (didn't bet)
Seat 4: matiko09 folded before Flop (didn't bet)
Seat 5: Kreuznagel folded before Flop (didn't bet)
Seat 7: apfush folded before Flop (didn't bet)
Seat 8: DUkalisUA (button) folded before Flop
Seat 9: Painkiller72 (small blind) collected ($10)





PokerStars Hand #151207359031:  Hold'em No Limit ($0.50/$1.00 USD) - 2016/03/31 12:24:45 CET [2016/03/31 6:24:45 ET]
Table 'Icarus III' 9-max Seat #4 is the button
Seat 1: IdiotFromNE ($100 in chips) 
Seat 2: Painkiller72 ($100 in chips) 
Seat 3: RICKA16 ($105.88 in chips) 
Seat 4: dizzyryano79 ($35.69 in chips) 
Seat 5: I The King I ($109 in chips) 
Seat 6: djammusic ($40 in chips) 
Seat 7: oscarleon ($154.13 in chips) 
Seat 8: matiko09 ($100 in chips) 
Seat 9: apfush ($123.76 in chips) 
I The King I: posts small blind $0.50
djammusic: posts big blind $1
*** HOLE CARDS ***
Dealt to matiko09 [Kd Ts]
oscarleon: folds 
matiko09: folds 
apfush: folds 
IdiotFromNE: folds 
Painkiller72: folds 
RICKA16: folds 
dizzyryano79: calls $1
I The King I: folds 
djammusic: checks 
*** FLOP *** [8d 9h 4d]
djammusic: checks 
dizzyryano79: checks 
*** TURN *** [8d 9h 4d] [8s]
djammusic: checks 
dizzyryano79: checks 
*** RIVER *** [8d 9h 4d 8s] [4h]
djammusic: checks 
dizzyryano79: bets $8
djammusic: folds 
Uncalled bet ($8) returned to dizzyryano79
dizzyryano79 collected $2.38 from pot
dizzyryano79: doesn't show hand 
*** SUMMARY ***
Total pot $2.50 | Rake $0.12 
Board [8d 9h 4d 8s 4h]
Seat 1: IdiotFromNE folded before Flop (didn't bet)
Seat 2: Painkiller72 folded before Flop (didn't bet)
Seat 3: RICKA16 folded before Flop (didn't bet)
Seat 4: dizzyryano79 (button) collected ($2.38)
Seat 5: I The King I (small blind) folded before Flop
Seat 6: djammusic (big blind) folded on the River
Seat 7: oscarleon folded before Flop (didn't bet)
Seat 8: matiko09 folded before Flop (didn't bet)
Seat 9: apfush folded before Flop (didn't bet)





PokerStars Hand #151207364838:  Hold'em No Limit ($0.50/$1.00 USD) - 2016/03/31 12:24:57 CET [2016/03/31 6:24:57 ET]
Table 'Yazhi' 9-max Seat #8 is the button
Seat 1: matiko09 ($101.50 in chips) 
Seat 2: xHourglass ($100 in chips) 
Seat 4: apfush ($180.96 in chips) 
Seat 5: IdiotFromNE ($105 in chips) 
Seat 6: Reven9er ($186.49 in chips) 
Seat 8: pk4DW ($59.31 in chips) 
Seat 9: oscarleon ($203.82 in chips) 
oscarleon: posts small blind $0.50
matiko09: posts big blind $1
Chin41178: sits out 
*** HOLE CARDS ***
Dealt to matiko09 [Qc Ah]
xHourglass: folds 
apfush: folds 
IdiotFromNE: folds 
Reven9er: folds 
pk4DW: raises $1 to $2
oscarleon: folds 
matiko09: raises $6 to $8
pk4DW: calls $6
*** FLOP *** [2c 4c 6h]
matiko09: checks 
pk4DW: bets $7.84
matiko09: calls $7.84
*** TURN *** [2c 4c 6h] [3s]
matiko09: checks 
pk4DW: bets $15.28
matiko09: folds 
Uncalled bet ($15.28) returned to pk4DW
pk4DW collected $30.57 from pot
pk4DW: doesn't show hand 
*** SUMMARY ***
Total pot $32.18 | Rake $1.61 
Board [2c 4c 6h 3s]
Seat 1: matiko09 (big blind) folded on the Turn
Seat 2: xHourglass folded before Flop (didn't bet)
Seat 4: apfush folded before Flop (didn't bet)
Seat 5: IdiotFromNE folded before Flop (didn't bet)
Seat 6: Reven9er folded before Flop (didn't bet)
Seat 8: pk4DW (button) collected ($30.57)
Seat 9: oscarleon (small blind) folded before Flop





PokerStars Hand #151207366542:  Hold'em No Limit ($1/$2 USD) - 2016/03/31 12:25:01 CET [2016/03/31 6:25:01 ET]
Table 'Polaris IV' 9-max Seat #3 is the button
Seat 1: BOAYARSKIY ($82 in chips) 
Seat 2: rmanjkeee ($83.94 in chips) 
Seat 3: Kreuznagel ($355.02 in chips) 
Seat 4: coinflip_si ($200 in chips) 
Seat 5: riverfish786 ($203 in chips) 
Seat 7: matiko09 ($200 in chips) 
Seat 8: Painkiller72 ($214 in chips) 
Seat 9: K&K2 ($476.38 in chips) 
coinflip_si: posts small blind $1
riverfish786: posts big blind $2
PacPacBum: sits out 
*** HOLE CARDS ***
Dealt to matiko09 [8s Td]
matiko09: folds 
Painkiller72: raises $3 to $5
K&K2: folds 
BOAYARSKIY: folds 
rmanjkeee: folds 
Kreuznagel: calls $5
coinflip_si: folds 
riverfish786: folds 
*** FLOP *** [Jc Qs 6d]
Painkiller72: checks 
Kreuznagel: bets $7.75
Painkiller72: calls $7.75
*** TURN *** [Jc Qs 6d] [9d]
Painkiller72: checks 
Kreuznagel: bets $24
Painkiller72: folds 
Uncalled bet ($24) returned to Kreuznagel
Kreuznagel collected $27.08 from pot
Kreuznagel: doesn't show hand 
*** SUMMARY ***
Total pot $28.50 | Rake $1.42 
Board [Jc Qs 6d 9d]
Seat 1: BOAYARSKIY folded before Flop (didn't bet)
Seat 2: rmanjkeee folded before Flop (didn't bet)
Seat 3: Kreuznagel (button) collected ($27.08)
Seat 4: coinflip_si (small blind) folded before Flop
Seat 5: riverfish786 (big blind) folded before Flop
Seat 7: matiko09 folded before Flop (didn't bet)
Seat 8: Painkiller72 folded on the Turn
Seat 9: K&K2 folded before Flop (didn't bet)





PokerStars Hand #151207367440:  Hold'em No Limit ($1/$2 USD) - 2016/03/31 12:25:03 CET [2016/03/31 6:25:03 ET]
Table 'Desiderata' 9-max Seat #9 is the button
Seat 2: ilaviiitech ($217.89 in chips) 
Seat 4: matiko09 ($319.85 in chips) 
Seat 5: Kreuznagel ($317.96 in chips) 
Seat 7: apfush ($200 in chips) 
Seat 8: DUkalisUA ($214.20 in chips) 
Seat 9: Painkiller72 ($206 in chips) 
ilaviiitech: posts small blind $1
InsomniaRU: is sitting out 
matiko09: posts big blind $2
InsomniaRU leaves the table
rmanjkeee: sits out 
*** HOLE CARDS ***
Dealt to matiko09 [As Qs]
Kreuznagel: raises $2.78 to $4.78
apfush: folds 
djammusic joins the table at seat #3 
DUkalisUA: folds 
Painkiller72: folds 
ilaviiitech: folds 
matiko09: calls $2.78
*** FLOP *** [Kd Ts 6s]
matiko09: checks 
Kreuznagel: bets $7.44
matiko09: calls $7.44
*** TURN *** [Kd Ts 6s] [7c]
matiko09: checks 
Kreuznagel: checks 
*** RIVER *** [Kd Ts 6s 7c] [2s]
matiko09: bets $18
Kreuznagel: folds 
Uncalled bet ($18) returned to matiko09
matiko09 collected $24.17 from pot
matiko09: doesn't show hand 
*** SUMMARY ***
Total pot $25.44 | Rake $1.27 
Board [Kd Ts 6s 7c 2s]
Seat 2: ilaviiitech (small blind) folded before Flop
Seat 4: matiko09 (big blind) collected ($24.17)
Seat 5: Kreuznagel folded on the River
Seat 7: apfush folded before Flop (didn't bet)
Seat 8: DUkalisUA folded before Flop (didn't bet)
Seat 9: Painkiller72 (button) folded before Flop (didn't bet)





PokerStars Hand #151207369551:  Hold'em No Limit ($0.50/$1.00 USD) - 2016/03/31 12:25:07 CET [2016/03/31 6:25:07 ET]
Table 'Herge II' 9-max Seat #9 is the button
Seat 1: Chiapel ($99 in chips) 
Seat 2: DUkalisUA ($101.50 in chips) 
Seat 3: matiko09 ($200.50 in chips) 
Seat 4: vrnMike ($123.38 in chips) 
Seat 5: I The King I ($100 in chips) 
Seat 6: masaytoo ($104.39 in chips) 
Seat 7: Zeeshka ($100 in chips) 
Seat 8: IdiotFromNE ($100 in chips) 
Seat 9: fatstacks122 ($139.25 in chips) 
Chiapel: posts small blind $0.50
DUkalisUA: posts big blind $1
*** HOLE CARDS ***
Dealt to matiko09 [Jd 6s]
matiko09: folds 
vrnMike: folds 
I The King I: raises $2 to $3
masaytoo: folds 
Zeeshka: folds 
IdiotFromNE: folds 
fatstacks122: folds 
Chiapel: folds 
DUkalisUA: calls $2
*** FLOP *** [7h 5h Kd]
DUkalisUA: checks 
I The King I: checks 
*** TURN *** [7h 5h Kd] [3s]
DUkalisUA: checks 
I The King I: bets $4
DUkalisUA: calls $4
*** RIVER *** [7h 5h Kd 3s] [Qs]
DUkalisUA: checks 
I The King I: checks 
*** SHOW DOWN ***
DUkalisUA: shows [Ad 3d] (a pair of Threes)
I The King I: shows [6h 6c] (a pair of Sixes)
I The King I collected $13.78 from pot
*** SUMMARY ***
Total pot $14.50 | Rake $0.72 
Board [7h 5h Kd 3s Qs]
Seat 1: Chiapel (small blind) folded before Flop
Seat 2: DUkalisUA (big blind) showed [Ad 3d] and lost with a pair of Threes
Seat 3: matiko09 folded before Flop (didn't bet)
Seat 4: vrnMike folded before Flop (didn't bet)
Seat 5: I The King I showed [6h 6c] and won ($13.78) with a pair of Sixes
Seat 6: masaytoo folded before Flop (didn't bet)
Seat 7: Zeeshka folded before Flop (didn't bet)
Seat 8: IdiotFromNE folded before Flop (didn't bet)
Seat 9: fatstacks122 (button) folded before Flop (didn't bet)





PokerStars Hand #151207370173:  Hold'em No Limit ($1/$2 USD) - 2016/03/31 12:25:09 CET [2016/03/31 6:25:09 ET]
Table 'Coelestina II' 9-max Seat #3 is the button
Seat 1: PacPacBum ($200 in chips) 
Seat 2: Kreuznagel ($213.75 in chips) 
Seat 3: ilaviiitech ($200 in chips) 
Seat 4: matiko09 ($230.75 in chips) 
Seat 5: Painkiller72 ($200 in chips) 
Seat 6: InsomniaRU ($203 in chips) 
Seat 7: le_marc08 ($201.75 in chips) 
Seat 8: DUkalisUA ($203 in chips) 
Seat 9: fonng ($102.30 in chips) 
matiko09: posts small blind $1
Painkiller72: posts big blind $2
*** HOLE CARDS ***
Dealt to matiko09 [5s 2c]
InsomniaRU: folds 
le_marc08: folds 
DUkalisUA: raises $4 to $6
fonng: folds 
PacPacBum: folds 
Kreuznagel: folds 
ilaviiitech: calls $6
matiko09: folds 
Painkiller72: folds 
*** FLOP *** [2s Kh 2h]
DUkalisUA: bets $7.83
ilaviiitech: calls $7.83
*** TURN *** [2s Kh 2h] [8h]
DUkalisUA: bets $19
ilaviiitech: folds 
Uncalled bet ($19) returned to DUkalisUA
DUkalisUA collected $29.13 from pot
DUkalisUA: doesn't show hand 
*** SUMMARY ***
Total pot $30.66 | Rake $1.53 
Board [2s Kh 2h 8h]
Seat 1: PacPacBum folded before Flop (didn't bet)
Seat 2: Kreuznagel folded before Flop (didn't bet)
Seat 3: ilaviiitech (button) folded on the Turn
Seat 4: matiko09 (small blind) folded before Flop
Seat 5: Painkiller72 (big blind) folded before Flop
Seat 6: InsomniaRU folded before Flop (didn't bet)
Seat 7: le_marc08 folded before Flop (didn't bet)
Seat 8: DUkalisUA collected ($29.13)
Seat 9: fonng folded before Flop (didn't bet)





PokerStars Hand #151207375565:  Hold'em No Limit (€0.50/€1.00 EUR) - 2016/03/31 12:25:20 CET [2016/03/31 6:25:20 ET]
Table 'Pioneer II' 9-max Seat #5 is the button
Seat 1: Kreuznagel (€103.84 in chips) 
Seat 2: IdiotFromNE (€124.52 in chips) 
Seat 3: vrnMike (€105.90 in chips) 
Seat 4: Zeeshka (€100 in chips) 
Seat 5: MickChick24 (€128.69 in chips) 
Seat 6: matiko09 (€100.50 in chips) 
Seat 7: AlKatrone (€125.91 in chips) 
Seat 8: Painkiller72 (€133.73 in chips) 
Seat 9: DUkalisUA (€100 in chips) 
matiko09: posts small blind €0.50
AlKatrone: posts big blind €1
*** HOLE CARDS ***
Dealt to matiko09 [7d 2s]
Painkiller72: raises €1.50 to €2.50
DUkalisUA: folds 
Kreuznagel: folds 
IdiotFromNE: folds 
vrnMike: folds 
Zeeshka: folds 
MickChick24: calls €2.50
matiko09: folds 
AlKatrone: calls €1.50
*** FLOP *** [7h 9d 7s]
AlKatrone: checks 
Painkiller72: bets €5.32
MickChick24: folds 
AlKatrone: folds 
Uncalled bet (€5.32) returned to Painkiller72
Painkiller72 collected €7.60 from pot
Painkiller72: doesn't show hand 
*** SUMMARY ***
Total pot €8 | Rake €0.40 
Board [7h 9d 7s]
Seat 1: Kreuznagel folded before Flop (didn't bet)
Seat 2: IdiotFromNE folded before Flop (didn't bet)
Seat 3: vrnMike folded before Flop (didn't bet)
Seat 4: Zeeshka folded before Flop (didn't bet)
Seat 5: MickChick24 (button) folded on the Flop
Seat 6: matiko09 (small blind) folded before Flop
Seat 7: AlKatrone (big blind) folded on the Flop
Seat 8: Painkiller72 collected (€7.60)
Seat 9: DUkalisUA folded before Flop (didn't bet)





PokerStars Hand #151207378182:  Hold'em No Limit ($0.50/$1.00 USD) - 2016/03/31 12:25:26 CET [2016/03/31 6:25:26 ET]
Table 'Eugenisis III' 9-max Seat #3 is the button
Seat 1: PacPacBum ($104.22 in chips) 
Seat 2: IdiotFromNE ($100 in chips) 
Seat 3: Avtovo ($101.50 in chips) 
Seat 4: alejo22366 ($72.22 in chips) 
Seat 5: ka100pka527 ($40 in chips) 
Seat 6: kauff95 ($58.06 in chips) 
Seat 7: djammusic ($38.97 in chips) 
Seat 8: matiko09 ($105.32 in chips) 
alejo22366: posts small blind $0.50
ka100pka527: posts big blind $1
*** HOLE CARDS ***
Dealt to matiko09 [Kd Qc]
kauff95: raises $2 to $3
djammusic: folds 
matiko09: folds 
PacPacBum: folds 
IdiotFromNE: folds 
Avtovo: folds 
alejo22366: folds 
ka100pka527: folds 
Uncalled bet ($2) returned to kauff95
kauff95 collected $2.50 from pot
*** SUMMARY ***
Total pot $2.50 | Rake $0 
Seat 1: PacPacBum folded before Flop (didn't bet)
Seat 2: IdiotFromNE folded before Flop (didn't bet)
Seat 3: Avtovo (button) folded before Flop (didn't bet)
Seat 4: alejo22366 (small blind) folded before Flop
Seat 5: ka100pka527 (big blind) folded before Flop
Seat 6: kauff95 collected ($2.50)
Seat 7: djammusic folded before Flop (didn't bet)
Seat 8: matiko09 folded before Flop (didn't bet)





PokerStars Hand #151207379401:  Hold'em No Limit ($0.50/$1.00 USD) - 2016/03/31 12:25:29 CET [2016/03/31 6:25:29 ET]
Table 'Celestia II' 9-max Seat #1 is the button
Seat 1: matiko09 ($130 in chips) 
Seat 3: ilaviiitech ($101.50 in chips) 
Seat 4: I The King I ($167.59 in chips) 
Seat 6: IdiotFromNE ($100 in chips) 
Seat 7: Avtovo ($129 in chips) 
Seat 8: DUkalisUA ($113.06 in chips) 
Seat 9: Chin41178 ($98.50 in chips) 
ilaviiitech: posts small blind $0.50
I The King I: posts big blind $1
djammusic: sits out 
*** HOLE CARDS ***
Dealt to matiko09 [6h 4s]
IdiotFromNE: folds 
Avtovo: raises $1.50 to $2.50
DUkalisUA: folds 
Chin41178: folds 
matiko09: folds 
ilaviiitech: folds 
I The King I: folds 
Uncalled bet ($1.50) returned to Avtovo
Avtovo collected $2.50 from pot
Avtovo: doesn't show hand 
*** SUMMARY ***
Total pot $2.50 | Rake $0 
Seat 1: matiko09 (button) folded before Flop (didn't bet)
Seat 3: ilaviiitech (small blind) folded before Flop
Seat 4: I The King I (big blind) folded before Flop
Seat 6: IdiotFromNE folded before Flop (didn't bet)
Seat 7: Avtovo collected ($2.50)
Seat 8: DUkalisUA folded before Flop (didn't bet)
Seat 9: Chin41178 folded before Flop (didn't bet)





PokerStars Hand #151207386641:  Hold'em No Limit ($0.50/$1.00 USD) - 2016/03/31 12:25:45 CET [2016/03/31 6:25:45 ET]
Table 'Eugenisis III' 9-max Seat #4 is the button
Seat 1: PacPacBum ($104.22 in chips) 
Seat 2: IdiotFromNE ($100 in chips) 
Seat 3: Avtovo ($101.50 in chips) 
Seat 4: alejo22366 ($71.72 in chips) 
Seat 5: ka100pka527 ($39 in chips) 
Seat 6: kauff95 ($59.56 in chips) 
Seat 7: djammusic ($38.97 in chips) 
Seat 8: matiko09 ($105.32 in chips) 
ka100pka527: posts small blind $0.50
kauff95: posts big blind $1
*** HOLE CARDS ***
Dealt to matiko09 [3h Qc]
djammusic: folds 
matiko09: folds 
PacPacBum: folds 
IdiotFromNE: folds 
Avtovo: folds 
alejo22366: folds 
ka100pka527: folds 
Uncalled bet ($0.50) returned to kauff95
kauff95 collected $1 from pot
*** SUMMARY ***
Total pot $1 | Rake $0 
Seat 1: PacPacBum folded before Flop (didn't bet)
Seat 2: IdiotFromNE folded before Flop (didn't bet)
Seat 3: Avtovo folded before Flop (didn't bet)
Seat 4: alejo22366 (button) folded before Flop (didn't bet)
Seat 5: ka100pka527 (small blind) folded before Flop
Seat 6: kauff95 (big blind) collected ($1)
Seat 7: djammusic folded before Flop (didn't bet)
Seat 8: matiko09 folded before Flop (didn't bet)





PokerStars Hand #151207389904:  Hold'em No Limit ($0.50/$1.00 USD) - 2016/03/31 12:25:51 CET [2016/03/31 6:25:51 ET]
Table 'Aquila' 9-max Seat #8 is the button
Seat 5: adelfaz ($60 in chips) 
Seat 6: maxxmeister ($107.98 in chips) 
Seat 8: matiko09 ($100 in chips) 
adelfaz: posts small blind $0.50
PacPacBum joins the table at seat #7 
maxxmeister: posts big blind $1
adelfaz: posts the ante $0.20
maxxmeister: posts the ante $0.20
matiko09: posts the ante $0.20
*** HOLE CARDS ***
Dealt to matiko09 [6d 8d]
matiko09: raises $1.50 to $2.50
adelfaz: folds 
maxxmeister: calls $1.50
*** FLOP *** [5c 7s Qd]
maxxmeister: bets $3
matiko09: raises $7 to $10
maxxmeister: raises $11 to $21
matiko09: calls $11
*** TURN *** [5c 7s Qd] [9s]
maxxmeister: checks 
matiko09: checks 
*** RIVER *** [5c 7s Qd 9s] [Qh]
maxxmeister: checks 
matiko09: bets $35
maxxmeister: folds 
Uncalled bet ($35) returned to matiko09
matiko09 collected $47.10 from pot
matiko09: doesn't show hand 
*** SUMMARY ***
Total pot $48.10 | Rake $1 
Board [5c 7s Qd 9s Qh]
Seat 5: adelfaz (small blind) folded before Flop
Seat 6: maxxmeister (big blind) folded on the River
Seat 8: matiko09 (button) collected ($47.10)





PokerStars Hand #151207391421:  Hold'em No Limit ($0.50/$1.00 USD) - 2016/03/31 12:25:55 CET [2016/03/31 6:25:55 ET]
Table 'Celestia II' 9-max Seat #3 is the button
Seat 1: matiko09 ($130 in chips) 
Seat 3: ilaviiitech ($101 in chips) 
Seat 4: I The King I ($166.59 in chips) 
Seat 5: djammusic ($40 in chips) 
Seat 6: IdiotFromNE ($100 in chips) 
Seat 7: Avtovo ($130.50 in chips) 
Seat 8: DUkalisUA ($113.06 in chips) 
Seat 9: Chin41178 ($98.50 in chips) 
I The King I: posts small blind $0.50
djammusic: posts big blind $1
*** HOLE CARDS ***
Dealt to matiko09 [Kh 4s]
IdiotFromNE: folds 
Avtovo: folds 
DUkalisUA: folds 
Chin41178: raises $2 to $3
matiko09: folds 
ilaviiitech: folds 
I The King I: calls $2.50
djammusic: folds 
*** FLOP *** [Ac Qs 9h]
I The King I: checks 
Chin41178: bets $3.32
I The King I: folds 
Uncalled bet ($3.32) returned to Chin41178
Chin41178 collected $6.65 from pot
Chin41178: doesn't show hand 
*** SUMMARY ***
Total pot $7 | Rake $0.35 
Board [Ac Qs 9h]
Seat 1: matiko09 folded before Flop (didn't bet)
Seat 3: ilaviiitech (button) folded before Flop (didn't bet)
Seat 4: I The King I (small blind) folded on the Flop
Seat 5: djammusic (big blind) folded before Flop
Seat 6: IdiotFromNE folded before Flop (didn't bet)
Seat 7: Avtovo folded before Flop (didn't bet)
Seat 8: DUkalisUA folded before Flop (didn't bet)
Seat 9: Chin41178 collected ($6.65)





PokerStars Hand #151207395759:  Hold'em No Limit ($0.50/$1.00 USD) - 2016/03/31 12:26:05 CET [2016/03/31 6:26:05 ET]
Table 'Eugenisis III' 9-max Seat #5 is the button
Seat 1: PacPacBum ($104.22 in chips) 
Seat 2: IdiotFromNE ($100 in chips) 
Seat 3: Avtovo ($101.50 in chips) 
Seat 4: alejo22366 ($71.72 in chips) 
Seat 5: ka100pka527 ($38.50 in chips) 
Seat 6: kauff95 ($60.06 in chips) 
Seat 7: djammusic ($38.97 in chips) 
Seat 8: matiko09 ($105.32 in chips) 
kauff95: posts small blind $0.50
djammusic: posts big blind $1
*** HOLE CARDS ***
Dealt to matiko09 [5c Js]
matiko09: folds 
PacPacBum: raises $1.04 to $2.04
IdiotFromNE: folds 
Avtovo: folds 
alejo22366: folds 
ka100pka527: folds 
kauff95: folds 
djammusic: folds 
Uncalled bet ($1.04) returned to PacPacBum
PacPacBum collected $2.50 from pot
PacPacBum: doesn't show hand 
*** SUMMARY ***
Total pot $2.50 | Rake $0 
Seat 1: PacPacBum collected ($2.50)
Seat 2: IdiotFromNE folded before Flop (didn't bet)
Seat 3: Avtovo folded before Flop (didn't bet)
Seat 4: alejo22366 folded before Flop (didn't bet)
Seat 5: ka100pka527 (button) folded before Flop (didn't bet)
Seat 6: kauff95 (small blind) folded before Flop
Seat 7: djammusic (big blind) folded before Flop
Seat 8: matiko09 folded before Flop (didn't bet)





PokerStars Hand #151207395959:  Hold'em No Limit ($1/$2 USD) - 2016/03/31 12:26:05 CET [2016/03/31 6:26:05 ET]
Table 'Coelestina II' 9-max Seat #4 is the button
Seat 1: PacPacBum ($200 in chips) 
Seat 2: Kreuznagel ($213.75 in chips) 
Seat 3: ilaviiitech ($200 in chips) 
Seat 4: matiko09 ($229.75 in chips) 
Seat 5: Painkiller72 ($200 in chips) 
Seat 8: DUkalisUA ($218.30 in chips) 
Seat 9: fonng ($200 in chips) 
Painkiller72: posts small blind $1
InsomniaRU: is sitting out 
le_marc08: is sitting out 
InsomniaRU leaves the table
DUkalisUA: posts big blind $2
*** HOLE CARDS ***
Dealt to matiko09 [Jh 3d]
fonng: folds 
PacPacBum: folds 
le_marc08 leaves the table
Kreuznagel: folds 
ilaviiitech: folds 
matiko09: folds 
Painkiller72: folds 
Uncalled bet ($1) returned to DUkalisUA
DUkalisUA collected $2 from pot
DUkalisUA: doesn't show hand 
*** SUMMARY ***
Total pot $2 | Rake $0 
Seat 1: PacPacBum folded before Flop (didn't bet)
Seat 2: Kreuznagel folded before Flop (didn't bet)
Seat 3: ilaviiitech folded before Flop (didn't bet)
Seat 4: matiko09 (button) folded before Flop (didn't bet)
Seat 5: Painkiller72 (small blind) folded before Flop
Seat 8: DUkalisUA (big blind) collected ($2)
Seat 9: fonng folded before Flop (didn't bet)





PokerStars Hand #151207396935:  Hold'em No Limit ($0.50/$1.00 USD) - 2016/03/31 12:26:07 CET [2016/03/31 6:26:07 ET]
Table 'Yazhi' 9-max Seat #9 is the button
Seat 1: matiko09 ($100 in chips) 
Seat 2: xHourglass ($100 in chips) 
Seat 4: apfush ($180.96 in chips) 
Seat 5: IdiotFromNE ($105 in chips) 
Seat 6: Reven9er ($186.49 in chips) 
Seat 8: pk4DW ($74.04 in chips) 
Seat 9: oscarleon ($203.32 in chips) 
matiko09: posts small blind $0.50
xHourglass: posts big blind $1
Chin41178: sits out 
*** HOLE CARDS ***
Dealt to matiko09 [9c 5c]
apfush: folds 
IdiotFromNE: folds 
Reven9er: raises $1 to $2
pk4DW: raises $5.50 to $7.50
oscarleon: folds 
matiko09: folds 
xHourglass: folds 
Reven9er: calls $5.50
*** FLOP *** [Kh Ah As]
Reven9er: checks 
pk4DW: bets $12.34
Reven9er: calls $12.34
*** TURN *** [Kh Ah As] [6d]
Reven9er: bets $24
pk4DW: folds 
Uncalled bet ($24) returned to Reven9er
Reven9er collected $39.12 from pot
Reven9er: doesn't show hand 
*** SUMMARY ***
Total pot $41.18 | Rake $2.06 
Board [Kh Ah As 6d]
Seat 1: matiko09 (small blind) folded before Flop
Seat 2: xHourglass (big blind) folded before Flop
Seat 4: apfush folded before Flop (didn't bet)
Seat 5: IdiotFromNE folded before Flop (didn't bet)
Seat 6: Reven9er collected ($39.12)
Seat 8: pk4DW folded on the Turn
Seat 9: oscarleon (button) folded before Flop (didn't bet)





PokerStars Hand #151207396863:  Hold'em No Limit ($1/$2 USD) - 2016/03/31 12:26:07 CET [2016/03/31 6:26:07 ET]
Table 'Polaris IV' 9-max Seat #4 is the button
Seat 1: BOAYARSKIY ($82 in chips) 
Seat 2: rmanjkeee ($83.94 in chips) 
Seat 3: Kreuznagel ($369.35 in chips) 
Seat 4: coinflip_si ($200 in chips) 
Seat 5: riverfish786 ($201 in chips) 
Seat 6: PacPacBum ($200 in chips) 
Seat 7: matiko09 ($200 in chips) 
Seat 8: Painkiller72 ($201.25 in chips) 
Seat 9: K&K2 ($476.38 in chips) 
riverfish786: posts small blind $1
PacPacBum: posts big blind $2
*** HOLE CARDS ***
Dealt to matiko09 [Qd 4h]
matiko09: folds 
Painkiller72: raises $3 to $5
K&K2: folds 
BOAYARSKIY: folds 
rmanjkeee: folds 
Kreuznagel: folds 
coinflip_si: folds 
riverfish786: folds 
PacPacBum: folds 
Uncalled bet ($3) returned to Painkiller72
Painkiller72 collected $5 from pot
Painkiller72: doesn't show hand 
*** SUMMARY ***
Total pot $5 | Rake $0 
Seat 1: BOAYARSKIY folded before Flop (didn't bet)
Seat 2: rmanjkeee folded before Flop (didn't bet)
Seat 3: Kreuznagel folded before Flop (didn't bet)
Seat 4: coinflip_si (button) folded before Flop (didn't bet)
Seat 5: riverfish786 (small blind) folded before Flop
Seat 6: PacPacBum (big blind) folded before Flop
Seat 7: matiko09 folded before Flop (didn't bet)
Seat 8: Painkiller72 collected ($5)
Seat 9: K&K2 folded before Flop (didn't bet)





PokerStars Hand #151207398188:  Hold'em No Limit ($0.50/$1.00 USD) - 2016/03/31 12:26:10 CET [2016/03/31 6:26:10 ET]
Table 'Icarus III' 9-max Seat #5 is the button
Seat 1: IdiotFromNE ($100 in chips) 
Seat 2: Painkiller72 ($100 in chips) 
Seat 3: RICKA16 ($105.88 in chips) 
Seat 4: dizzyryano79 ($37.07 in chips) 
Seat 5: I The King I ($108.50 in chips) 
Seat 6: djammusic ($39 in chips) 
Seat 7: oscarleon ($154.13 in chips) 
Seat 8: matiko09 ($100 in chips) 
Seat 9: apfush ($123.76 in chips) 
djammusic: posts small blind $0.50
oscarleon: posts big blind $1
*** HOLE CARDS ***
Dealt to matiko09 [Jc 4c]
matiko09: folds 
apfush: folds 
IdiotFromNE: folds 
Painkiller72: folds 
RICKA16: raises $2 to $3
dizzyryano79: folds 
I The King I: folds 
djammusic: folds 
oscarleon: folds 
Uncalled bet ($2) returned to RICKA16
RICKA16 collected $2.50 from pot
RICKA16: doesn't show hand 
*** SUMMARY ***
Total pot $2.50 | Rake $0 
Seat 1: IdiotFromNE folded before Flop (didn't bet)
Seat 2: Painkiller72 folded before Flop (didn't bet)
Seat 3: RICKA16 collected ($2.50)
Seat 4: dizzyryano79 folded before Flop (didn't bet)
Seat 5: I The King I (button) folded before Flop (didn't bet)
Seat 6: djammusic (small blind) folded before Flop
Seat 7: oscarleon (big blind) folded before Flop
Seat 8: matiko09 folded before Flop (didn't bet)
Seat 9: apfush folded before Flop (didn't bet)





PokerStars Hand #151207399360:  Hold'em No Limit ($0.50/$1.00 USD) - 2016/03/31 12:26:12 CET [2016/03/31 6:26:12 ET]
Table 'Herge II' 9-max Seat #1 is the button
Seat 1: Chiapel ($98.50 in chips) 
Seat 2: DUkalisUA ($100 in chips) 
Seat 3: matiko09 ($200.50 in chips) 
Seat 4: vrnMike ($123.38 in chips) 
Seat 5: I The King I ($106.78 in chips) 
Seat 6: masaytoo ($104.39 in chips) 
Seat 7: Zeeshka ($100 in chips) 
Seat 8: IdiotFromNE ($100 in chips) 
Seat 9: fatstacks122 ($139.25 in chips) 
DUkalisUA: posts small blind $0.50
matiko09: posts big blind $1
*** HOLE CARDS ***
Dealt to matiko09 [Jc Jd]
vrnMike: folds 
I The King I: folds 
masaytoo: folds 
Zeeshka: folds 
IdiotFromNE: folds 
fatstacks122: folds 
Chiapel: folds 
DUkalisUA: folds 
Uncalled bet ($0.50) returned to matiko09
matiko09 collected $1 from pot
matiko09: doesn't show hand 
*** SUMMARY ***
Total pot $1 | Rake $0 
Seat 1: Chiapel (button) folded before Flop (didn't bet)
Seat 2: DUkalisUA (small blind) folded before Flop
Seat 3: matiko09 (big blind) collected ($1)
Seat 4: vrnMike folded before Flop (didn't bet)
Seat 5: I The King I folded before Flop (didn't bet)
Seat 6: masaytoo folded before Flop (didn't bet)
Seat 7: Zeeshka folded before Flop (didn't bet)
Seat 8: IdiotFromNE folded before Flop (didn't bet)
Seat 9: fatstacks122 folded before Flop (didn't bet)





PokerStars Hand #151207403588:  Hold'em No Limit ($1/$2 USD) - 2016/03/31 12:26:22 CET [2016/03/31 6:26:22 ET]
Table 'Coelestina II' 9-max Seat #8 is the button
Seat 1: PacPacBum ($200 in chips) 
Seat 2: Kreuznagel ($213.75 in chips) 
Seat 3: ilaviiitech ($200 in chips) 
Seat 4: matiko09 ($229.75 in chips) 
Seat 8: DUkalisUA ($219.30 in chips) 
Seat 9: fonng ($200 in chips) 
fonng: posts small blind $1
PacPacBum: posts big blind $2
*** HOLE CARDS ***
Dealt to matiko09 [Kd 7s]
Kreuznagel: folds 
ilaviiitech: raises $4 to $6
matiko09: folds 
DUkalisUA: folds 
fonng: calls $5
PacPacBum: folds 
*** FLOP *** [Ad Jd 9h]
fonng: checks 
Avtovo joins the table at seat #6 
ilaviiitech: bets $9.31
fonng: folds 
Uncalled bet ($9.31) returned to ilaviiitech
ilaviiitech collected $13.30 from pot
ilaviiitech: doesn't show hand 
*** SUMMARY ***
Total pot $14 | Rake $0.70 
Board [Ad Jd 9h]
Seat 1: PacPacBum (big blind) folded before Flop
Seat 2: Kreuznagel folded before Flop (didn't bet)
Seat 3: ilaviiitech collected ($13.30)
Seat 4: matiko09 folded before Flop (didn't bet)
Seat 8: DUkalisUA (button) folded before Flop (didn't bet)
Seat 9: fonng (small blind) folded on the Flop





PokerStars Hand #151207411166:  Hold'em No Limit ($1/$2 USD) - 2016/03/31 12:26:38 CET [2016/03/31 6:26:38 ET]
Table 'Desiderata' 9-max Seat #2 is the button
Seat 1: GALWACONT ($137.45 in chips) 
Seat 2: ilaviiitech ($216.89 in chips) 
Seat 4: matiko09 ($331.80 in chips) 
Seat 5: Kreuznagel ($305.74 in chips) 
Seat 7: apfush ($200 in chips) 
Seat 8: DUkalisUA ($214.20 in chips) 
djammusic will be allowed to play after the button
matiko09: posts small blind $1
Kreuznagel: posts big blind $2
rmanjkeee: sits out 
GALWACONT: posts small & big blinds $3
*** HOLE CARDS ***
Dealt to matiko09 [Qd 7c]
apfush: folds 
DUkalisUA: folds 
GALWACONT: checks 
ilaviiitech: folds 
matiko09: folds 
Kreuznagel: checks 
*** FLOP *** [3h 6h 4s]
Kreuznagel: checks 
GALWACONT: bets $5.70
Kreuznagel: folds 
Uncalled bet ($5.70) returned to GALWACONT
GALWACONT collected $5.70 from pot
GALWACONT: doesn't show hand 
*** SUMMARY ***
Total pot $6 | Rake $0.30 
Board [3h 6h 4s]
Seat 1: GALWACONT collected ($5.70)
Seat 2: ilaviiitech (button) folded before Flop (didn't bet)
Seat 4: matiko09 (small blind) folded before Flop
Seat 5: Kreuznagel (big blind) folded on the Flop
Seat 7: apfush folded before Flop (didn't bet)
Seat 8: DUkalisUA folded before Flop (didn't bet)





PokerStars Hand #151207411640:  Hold'em No Limit ($0.50/$1.00 USD) - 2016/03/31 12:26:39 CET [2016/03/31 6:26:39 ET]
Table 'Herge II' 9-max Seat #2 is the button
Seat 1: Chiapel ($98.50 in chips) 
Seat 2: DUkalisUA ($100 in chips) 
Seat 3: matiko09 ($201 in chips) 
Seat 5: I The King I ($106.78 in chips) 
Seat 6: masaytoo ($104.39 in chips) 
Seat 7: Zeeshka ($100 in chips) 
Seat 8: IdiotFromNE ($100 in chips) 
Seat 9: fatstacks122 ($139.25 in chips) 
matiko09: posts small blind $0.50
vrnMike: is sitting out 
I The King I: posts big blind $1
*** HOLE CARDS ***
Dealt to matiko09 [5d 7s]
masaytoo: folds 
Zeeshka: folds 
IdiotFromNE: raises $1.50 to $2.50
fatstacks122: calls $2.50
Chiapel: folds 
DUkalisUA: folds 
matiko09: folds 
I The King I: raises $7.50 to $10
IdiotFromNE: folds 
fatstacks122: folds 
Uncalled bet ($7.50) returned to I The King I
I The King I collected $8 from pot
I The King I: doesn't show hand 
*** SUMMARY ***
Total pot $8 | Rake $0 
Seat 1: Chiapel folded before Flop (didn't bet)
Seat 2: DUkalisUA (button) folded before Flop (didn't bet)
Seat 3: matiko09 (small blind) folded before Flop
Seat 5: I The King I (big blind) collected ($8)
Seat 6: masaytoo folded before Flop (didn't bet)
Seat 7: Zeeshka folded before Flop (didn't bet)
Seat 8: IdiotFromNE folded before Flop
Seat 9: fatstacks122 folded before Flop





PokerStars Hand #151207415567:  Hold'em No Limit ($0.50/$1.00 USD) - 2016/03/31 12:26:48 CET [2016/03/31 6:26:48 ET]
Table 'Icarus III' 9-max Seat #6 is the button
Seat 1: IdiotFromNE ($100 in chips) 
Seat 3: RICKA16 ($107.38 in chips) 
Seat 4: dizzyryano79 ($37.07 in chips) 
Seat 5: I The King I ($108.50 in chips) 
Seat 6: djammusic ($38.50 in chips) 
Seat 7: oscarleon ($153.13 in chips) 
Seat 8: matiko09 ($100 in chips) 
Seat 9: apfush ($123.76 in chips) 
oscarleon: posts small blind $0.50
matiko09: posts big blind $1
*** HOLE CARDS ***
Dealt to matiko09 [4s 5d]
apfush: folds 
IdiotFromNE: folds 
RICKA16: folds 
dizzyryano79: folds 
I The King I: raises $1.50 to $2.50
djammusic: raises $4.25 to $6.75
oscarleon: folds 
matiko09: folds 
I The King I: raises $37.25 to $44
djammusic: folds 
Uncalled bet ($37.25) returned to I The King I
I The King I collected $15 from pot
I The King I: doesn't show hand 
*** SUMMARY ***
Total pot $15 | Rake $0 
Seat 1: IdiotFromNE folded before Flop (didn't bet)
Seat 3: RICKA16 folded before Flop (didn't bet)
Seat 4: dizzyryano79 folded before Flop (didn't bet)
Seat 5: I The King I collected ($15)
Seat 6: djammusic (button) folded before Flop
Seat 7: oscarleon (small blind) folded before Flop
Seat 8: matiko09 (big blind) folded before Flop
Seat 9: apfush folded before Flop (didn't bet)





PokerStars Hand #151207415442:  Hold'em No Limit ($0.50/$1.00 USD) - 2016/03/31 12:26:48 CET [2016/03/31 6:26:48 ET]
Table 'Eugenisis III' 9-max Seat #6 is the button
Seat 1: PacPacBum ($105.72 in chips) 
Seat 2: IdiotFromNE ($100 in chips) 
Seat 3: Avtovo ($101.50 in chips) 
Seat 4: alejo22366 ($71.72 in chips) 
Seat 5: ka100pka527 ($38.50 in chips) 
Seat 6: kauff95 ($59.56 in chips) 
Seat 7: djammusic ($37.97 in chips) 
Seat 8: matiko09 ($105.32 in chips) 
djammusic: posts small blind $0.50
matiko09: posts big blind $1
*** HOLE CARDS ***
Dealt to matiko09 [9c 2c]
PacPacBum: folds 
IdiotFromNE: folds 
Avtovo: folds 
alejo22366: folds 
ka100pka527: folds 
kauff95: raises $2 to $3
djammusic: folds 
matiko09: folds 
Uncalled bet ($2) returned to kauff95
kauff95 collected $2.50 from pot
*** SUMMARY ***
Total pot $2.50 | Rake $0 
Seat 1: PacPacBum folded before Flop (didn't bet)
Seat 2: IdiotFromNE folded before Flop (didn't bet)
Seat 3: Avtovo folded before Flop (didn't bet)
Seat 4: alejo22366 folded before Flop (didn't bet)
Seat 5: ka100pka527 folded before Flop (didn't bet)
Seat 6: kauff95 (button) collected ($2.50)
Seat 7: djammusic (small blind) folded before Flop
Seat 8: matiko09 (big blind) folded before Flop





PokerStars Hand #151207418098:  Hold'em No Limit (€0.50/€1.00 EUR) - 2016/03/31 12:26:53 CET [2016/03/31 6:26:53 ET]
Table 'Pioneer II' 9-max Seat #6 is the button
Seat 1: Kreuznagel (€103.84 in chips) 
Seat 2: IdiotFromNE (€124.52 in chips) 
Seat 3: vrnMike (€105.90 in chips) 
Seat 4: Zeeshka (€100 in chips) 
Seat 5: MickChick24 (€126.19 in chips) 
Seat 6: matiko09 (€100 in chips) 
Seat 7: AlKatrone (€123.41 in chips) 
Seat 9: DUkalisUA (€100 in chips) 
AlKatrone: posts small blind €0.50
DUkalisUA: posts big blind €1
*** HOLE CARDS ***
Dealt to matiko09 [Tc Kh]
Painkiller72 leaves the table
Kreuznagel: folds 
IdiotFromNE: folds 
vrnMike: folds 
Zeeshka: folds 
MickChick24: folds 
MickChick24 leaves the table
matiko09: raises €1.27 to €2.27
AlKatrone: folds 
Avtovo joins the table at seat #5 
DUkalisUA: folds 
Uncalled bet (€1.27) returned to matiko09
matiko09 collected €2.50 from pot
matiko09: doesn't show hand 
Avtovo leaves the table
*** SUMMARY ***
Total pot €2.50 | Rake €0 
Seat 1: Kreuznagel folded before Flop (didn't bet)
Seat 2: IdiotFromNE folded before Flop (didn't bet)
Seat 3: vrnMike folded before Flop (didn't bet)
Seat 4: Zeeshka folded before Flop (didn't bet)
Seat 5: MickChick24 folded before Flop (didn't bet)
Seat 6: matiko09 (button) collected (€2.50)
Seat 7: AlKatrone (small blind) folded before Flop
Seat 9: DUkalisUA (big blind) folded before Flop





PokerStars Hand #151207423074:  Hold'em No Limit ($0.50/$1.00 USD) - 2016/03/31 12:27:04 CET [2016/03/31 6:27:04 ET]
Table 'Celestia II' 9-max Seat #4 is the button
Seat 1: matiko09 ($130 in chips) 
Seat 3: ilaviiitech ($101 in chips) 
Seat 4: I The King I ($163.59 in chips) 
Seat 5: djammusic ($39 in chips) 
Seat 6: IdiotFromNE ($100 in chips) 
Seat 7: Avtovo ($130.50 in chips) 
Seat 8: DUkalisUA ($113.06 in chips) 
Seat 9: Chin41178 ($102.15 in chips) 
djammusic: posts small blind $0.50
IdiotFromNE: posts big blind $1
*** HOLE CARDS ***
Dealt to matiko09 [4d 4s]
Avtovo: raises $1.50 to $2.50
DUkalisUA: folds 
Chin41178: folds 
matiko09: folds 
ilaviiitech: folds 
I The King I: folds 
djammusic: folds 
IdiotFromNE: calls $1.50
*** FLOP *** [4c 2d 8s]
IdiotFromNE: checks 
Avtovo: checks 
*** TURN *** [4c 2d 8s] [Tc]
IdiotFromNE: bets $4.17
Avtovo: folds 
Uncalled bet ($4.17) returned to IdiotFromNE
IdiotFromNE collected $5.22 from pot
IdiotFromNE: doesn't show hand 
*** SUMMARY ***
Total pot $5.50 | Rake $0.28 
Board [4c 2d 8s Tc]
Seat 1: matiko09 folded before Flop (didn't bet)
Seat 3: ilaviiitech folded before Flop (didn't bet)
Seat 4: I The King I (button) folded before Flop (didn't bet)
Seat 5: djammusic (small blind) folded before Flop
Seat 6: IdiotFromNE (big blind) collected ($5.22)
Seat 7: Avtovo folded on the Turn
Seat 8: DUkalisUA folded before Flop (didn't bet)
Seat 9: Chin41178 folded before Flop (didn't bet)





PokerStars Hand #151207426639:  Hold'em No Limit ($1/$2 USD) - 2016/03/31 12:27:12 CET [2016/03/31 6:27:12 ET]
Table 'Coelestina II' 9-max Seat #9 is the button
Seat 1: PacPacBum ($200 in chips) 
Seat 2: Kreuznagel ($213.75 in chips) 
Seat 3: ilaviiitech ($207.30 in chips) 
Seat 4: matiko09 ($229.75 in chips) 
Seat 8: DUkalisUA ($219.30 in chips) 
Seat 9: fonng ($194 in chips) 
PacPacBum: posts small blind $1
Kreuznagel: posts big blind $2
Avtovo: sits out 
*** HOLE CARDS ***
Dealt to matiko09 [6c 2c]
ilaviiitech: folds 
matiko09: folds 
DUkalisUA: folds 
fonng: calls $2
PacPacBum: calls $1
Kreuznagel: checks 
*** FLOP *** [3d 2s 5h]
PacPacBum: checks 
Kreuznagel: checks 
fonng: checks 
*** TURN *** [3d 2s 5h] [Ad]
rmanjkeee joins the table at seat #7 
PacPacBum: bets $3.07
Kreuznagel: calls $3.07
fonng: folds 
*** RIVER *** [3d 2s 5h Ad] [9s]
PacPacBum: bets $6.22
Kreuznagel: calls $6.22
*** SHOW DOWN ***
PacPacBum: shows [4d 5d] (a straight, Ace to Five)
Kreuznagel: mucks hand 
PacPacBum collected $23.35 from pot
*** SUMMARY ***
Total pot $24.58 | Rake $1.23 
Board [3d 2s 5h Ad 9s]
Seat 1: PacPacBum (small blind) showed [4d 5d] and won ($23.35) with a straight, Ace to Five
Seat 2: Kreuznagel (big blind) mucked [3s Ah]
Seat 3: ilaviiitech folded before Flop (didn't bet)
Seat 4: matiko09 folded before Flop (didn't bet)
Seat 8: DUkalisUA folded before Flop (didn't bet)
Seat 9: fonng (button) folded on the Turn





PokerStars Hand #151207429875:  Hold'em No Limit ($1/$2 USD) - 2016/03/31 12:27:19 CET [2016/03/31 6:27:19 ET]
Table 'Desiderata' 9-max Seat #4 is the button
Seat 1: GALWACONT ($140.15 in chips) 
Seat 2: ilaviiitech ($216.89 in chips) 
Seat 4: matiko09 ($330.80 in chips) 
Seat 5: Kreuznagel ($303.74 in chips) 
Seat 6: rmanjkeee ($105.75 in chips) 
Seat 7: apfush ($200 in chips) 
Seat 8: DUkalisUA ($214.20 in chips) 
Kreuznagel: posts small blind $1
rmanjkeee: posts big blind $2
djammusic: sits out 
*** HOLE CARDS ***
Dealt to matiko09 [5d Td]
apfush: folds 
DUkalisUA: folds 
GALWACONT: folds 
ilaviiitech: folds 
matiko09: folds 
Kreuznagel: raises $4.26 to $6.26
rmanjkeee: folds 
Uncalled bet ($4.26) returned to Kreuznagel
Kreuznagel collected $4 from pot
Kreuznagel: doesn't show hand 
*** SUMMARY ***
Total pot $4 | Rake $0 
Seat 1: GALWACONT folded before Flop (didn't bet)
Seat 2: ilaviiitech folded before Flop (didn't bet)
Seat 4: matiko09 (button) folded before Flop (didn't bet)
Seat 5: Kreuznagel (small blind) collected ($4)
Seat 6: rmanjkeee (big blind) folded before Flop
Seat 7: apfush folded before Flop (didn't bet)
Seat 8: DUkalisUA folded before Flop (didn't bet)





PokerStars Hand #151207434575:  Hold'em No Limit ($0.50/$1.00 USD) - 2016/03/31 12:27:30 CET [2016/03/31 6:27:30 ET]
Table 'Aquila' 9-max Seat #5 is the button
Seat 5: adelfaz ($59.30 in chips) 
Seat 6: maxxmeister ($100 in chips) 
Seat 7: PacPacBum ($131.50 in chips) 
Seat 8: matiko09 ($123.40 in chips) 
maxxmeister: posts small blind $0.50
PacPacBum: posts big blind $1
adelfaz: posts the ante $0.20
maxxmeister: posts the ante $0.20
PacPacBum: posts the ante $0.20
matiko09: posts the ante $0.20
*** HOLE CARDS ***
Dealt to matiko09 [8h Kc]
matiko09: folds 
adelfaz: folds 
maxxmeister: folds 
Uncalled bet ($0.50) returned to PacPacBum
PacPacBum collected $1.80 from pot
PacPacBum: doesn't show hand 
*** SUMMARY ***
Total pot $1.80 | Rake $0 
Seat 5: adelfaz (button) folded before Flop (didn't bet)
Seat 6: maxxmeister (small blind) folded before Flop
Seat 7: PacPacBum (big blind) collected ($1.80)
Seat 8: matiko09 folded before Flop (didn't bet)





PokerStars Hand #151207434881:  Hold'em No Limit ($0.50/$1.00 USD) - 2016/03/31 12:27:30 CET [2016/03/31 6:27:30 ET]
Table 'Eugenisis III' 9-max Seat #7 is the button
Seat 1: PacPacBum ($105.72 in chips) 
Seat 2: IdiotFromNE ($100 in chips) 
Seat 3: Avtovo ($101.50 in chips) 
Seat 4: alejo22366 ($71.72 in chips) 
Seat 5: ka100pka527 ($38.50 in chips) 
Seat 6: kauff95 ($61.06 in chips) 
Seat 7: djammusic ($37.47 in chips) 
Seat 8: matiko09 ($104.32 in chips) 
matiko09: posts small blind $0.50
PacPacBum: posts big blind $1
*** HOLE CARDS ***
Dealt to matiko09 [8h Tc]
IdiotFromNE: folds 
Avtovo: folds 
alejo22366: folds 
ka100pka527: raises $1 to $2
kauff95: folds 
djammusic: raises $4 to $6
matiko09: folds 
PacPacBum: folds 
ka100pka527: folds 
Uncalled bet ($4) returned to djammusic
djammusic collected $5.50 from pot
djammusic: doesn't show hand 
*** SUMMARY ***
Total pot $5.50 | Rake $0 
Seat 1: PacPacBum (big blind) folded before Flop
Seat 2: IdiotFromNE folded before Flop (didn't bet)
Seat 3: Avtovo folded before Flop (didn't bet)
Seat 4: alejo22366 folded before Flop (didn't bet)
Seat 5: ka100pka527 folded before Flop
Seat 6: kauff95 folded before Flop (didn't bet)
Seat 7: djammusic (button) collected ($5.50)
Seat 8: matiko09 (small blind) folded before Flop





PokerStars Hand #151207435084:  Hold'em No Limit (€0.50/€1.00 EUR) - 2016/03/31 12:27:31 CET [2016/03/31 6:27:31 ET]
Table 'Pioneer II' 9-max Seat #7 is the button
Seat 1: Kreuznagel (€103.84 in chips) 
Seat 2: IdiotFromNE (€124.52 in chips) 
Seat 3: vrnMike (€105.90 in chips) 
Seat 4: Zeeshka (€100 in chips) 
Seat 6: matiko09 (€101.50 in chips) 
Seat 7: AlKatrone (€122.91 in chips) 
Seat 9: DUkalisUA (€100 in chips) 
DUkalisUA: posts small blind €0.50
Kreuznagel: posts big blind €1
*** HOLE CARDS ***
Dealt to matiko09 [4c 2h]
IdiotFromNE: folds 
vrnMike: folds 
Zeeshka: folds 
matiko09: folds 
AlKatrone: folds 
DUkalisUA: folds 
Uncalled bet (€0.50) returned to Kreuznagel
Kreuznagel collected €1 from pot
Kreuznagel: doesn't show hand 
*** SUMMARY ***
Total pot €1 | Rake €0 
Seat 1: Kreuznagel (big blind) collected (€1)
Seat 2: IdiotFromNE folded before Flop (didn't bet)
Seat 3: vrnMike folded before Flop (didn't bet)
Seat 4: Zeeshka folded before Flop (didn't bet)
Seat 6: matiko09 folded before Flop (didn't bet)
Seat 7: AlKatrone (button) folded before Flop (didn't bet)
Seat 9: DUkalisUA (small blind) folded before Flop





PokerStars Hand #151207437886:  Hold'em No Limit ($0.50/$1.00 USD) - 2016/03/31 12:27:37 CET [2016/03/31 6:27:37 ET]
Table 'Herge II' 9-max Seat #3 is the button
Seat 1: Chiapel ($98.50 in chips) 
Seat 2: DUkalisUA ($100 in chips) 
Seat 3: matiko09 ($200.50 in chips) 
Seat 5: I The King I ($112.28 in chips) 
Seat 6: masaytoo ($104.39 in chips) 
Seat 7: Zeeshka ($100 in chips) 
Seat 8: IdiotFromNE ($100 in chips) 
Seat 9: fatstacks122 ($136.75 in chips) 
I The King I: posts small blind $0.50
masaytoo: posts big blind $1
*** HOLE CARDS ***
Dealt to matiko09 [Ac Qc]
Zeeshka: folds 
IdiotFromNE: folds 
fatstacks122: folds 
Chiapel: raises $2 to $3
DUkalisUA: folds 
matiko09: raises $6 to $9
I The King I: folds 
masaytoo: folds 
Chiapel: calls $6
*** FLOP *** [Qh 7s Tc]
Chiapel: checks 
matiko09: bets $11
Chiapel: folds 
Uncalled bet ($11) returned to matiko09
matiko09 collected $18.52 from pot
matiko09: doesn't show hand 
*** SUMMARY ***
Total pot $19.50 | Rake $0.98 
Board [Qh 7s Tc]
Seat 1: Chiapel folded on the Flop
Seat 2: DUkalisUA folded before Flop (didn't bet)
Seat 3: matiko09 (button) collected ($18.52)
Seat 5: I The King I (small blind) folded before Flop
Seat 6: masaytoo (big blind) folded before Flop
Seat 7: Zeeshka folded before Flop (didn't bet)
Seat 8: IdiotFromNE folded before Flop (didn't bet)
Seat 9: fatstacks122 folded before Flop (didn't bet)





PokerStars Hand #151207439034:  Hold'em No Limit ($0.50/$1.00 USD) - 2016/03/31 12:27:40 CET [2016/03/31 6:27:40 ET]
Table 'Aquila' 9-max Seat #6 is the button
Seat 5: adelfaz ($59.10 in chips) 
Seat 6: maxxmeister ($100 in chips) 
Seat 7: PacPacBum ($132.60 in chips) 
Seat 8: matiko09 ($123.20 in chips) 
PacPacBum: posts small blind $0.50
matiko09: posts big blind $1
adelfaz: posts the ante $0.20
maxxmeister: posts the ante $0.20
PacPacBum: posts the ante $0.20
matiko09: posts the ante $0.20
*** HOLE CARDS ***
Dealt to matiko09 [6c 4c]
adelfaz: raises $2 to $3
maxxmeister: raises $6 to $9
PacPacBum: folds 
matiko09: folds 
adelfaz: folds 
Uncalled bet ($6) returned to maxxmeister
maxxmeister collected $8.30 from pot
maxxmeister: doesn't show hand 
*** SUMMARY ***
Total pot $8.30 | Rake $0 
Seat 5: adelfaz folded before Flop
Seat 6: maxxmeister (button) collected ($8.30)
Seat 7: PacPacBum (small blind) folded before Flop
Seat 8: matiko09 (big blind) folded before Flop





PokerStars Hand #151207440727:  Hold'em No Limit ($1/$2 USD) - 2016/03/31 12:27:43 CET [2016/03/31 6:27:43 ET]
Table 'Desiderata' 9-max Seat #5 is the button
Seat 1: GALWACONT ($140.15 in chips) 
Seat 2: ilaviiitech ($216.89 in chips) 
Seat 4: matiko09 ($330.80 in chips) 
Seat 5: Kreuznagel ($305.74 in chips) 
Seat 6: rmanjkeee ($103.75 in chips) 
Seat 7: apfush ($200 in chips) 
Seat 8: DUkalisUA ($214.20 in chips) 
rmanjkeee: posts small blind $1
apfush: posts big blind $2
djammusic: sits out 
*** HOLE CARDS ***
Dealt to matiko09 [Js 7d]
DUkalisUA: folds 
GALWACONT: folds 
ilaviiitech: folds 
matiko09: folds 
Kreuznagel: folds 
rmanjkeee: folds 
Uncalled bet ($1) returned to apfush
apfush collected $2 from pot
apfush: doesn't show hand 
*** SUMMARY ***
Total pot $2 | Rake $0 
Seat 1: GALWACONT folded before Flop (didn't bet)
Seat 2: ilaviiitech folded before Flop (didn't bet)
Seat 4: matiko09 folded before Flop (didn't bet)
Seat 5: Kreuznagel (button) folded before Flop (didn't bet)
Seat 6: rmanjkeee (small blind) folded before Flop
Seat 7: apfush (big blind) collected ($2)
Seat 8: DUkalisUA folded before Flop (didn't bet)





PokerStars Hand #151207442954:  Hold'em No Limit ($0.50/$1.00 USD) - 2016/03/31 12:27:48 CET [2016/03/31 6:27:48 ET]
Table 'Celestia II' 9-max Seat #5 is the button
Seat 1: matiko09 ($130 in chips) 
Seat 3: ilaviiitech ($101 in chips) 
Seat 4: I The King I ($163.59 in chips) 
Seat 5: djammusic ($38.50 in chips) 
Seat 6: IdiotFromNE ($102.72 in chips) 
Seat 7: Avtovo ($128 in chips) 
Seat 8: DUkalisUA ($113.06 in chips) 
Seat 9: Chin41178 ($102.15 in chips) 
IdiotFromNE: posts small blind $0.50
Avtovo: posts big blind $1
*** HOLE CARDS ***
Dealt to matiko09 [7d 6d]
DUkalisUA: folds 
Chin41178: folds 
matiko09: raises $2 to $3
ilaviiitech: calls $3
I The King I: folds 
djammusic: folds 
IdiotFromNE: folds 
Avtovo: folds 
*** FLOP *** [7h 5d 5c]
matiko09: checks 
ilaviiitech: checks 
*** TURN *** [7h 5d 5c] [Ad]
matiko09: checks 
ilaviiitech: checks 
*** RIVER *** [7h 5d 5c Ad] [Qd]
matiko09: bets $6
ilaviiitech: folds 
Uncalled bet ($6) returned to matiko09
matiko09 collected $7.12 from pot
matiko09: doesn't show hand 
*** SUMMARY ***
Total pot $7.50 | Rake $0.38 
Board [7h 5d 5c Ad Qd]
Seat 1: matiko09 collected ($7.12)
Seat 3: ilaviiitech folded on the River
Seat 4: I The King I folded before Flop (didn't bet)
Seat 5: djammusic (button) folded before Flop (didn't bet)
Seat 6: IdiotFromNE (small blind) folded before Flop
Seat 7: Avtovo (big blind) folded before Flop
Seat 8: DUkalisUA folded before Flop (didn't bet)
Seat 9: Chin41178 folded before Flop (didn't bet)





PokerStars Hand #151207446293:  Hold'em No Limit ($0.50/$1.00 USD) - 2016/03/31 12:27:56 CET [2016/03/31 6:27:56 ET]
Table 'Icarus III' 9-max Seat #7 is the button
Seat 1: IdiotFromNE ($100 in chips) 
Seat 3: RICKA16 ($107.38 in chips) 
Seat 4: dizzyryano79 ($37.07 in chips) 
Seat 5: I The King I ($116.75 in chips) 
Seat 6: djammusic ($40 in chips) 
Seat 7: oscarleon ($152.63 in chips) 
Seat 8: matiko09 ($100 in chips) 
Seat 9: apfush ($123.76 in chips) 
matiko09: posts small blind $0.50
apfush: posts big blind $1
*** HOLE CARDS ***
Dealt to matiko09 [6h 4s]
IdiotFromNE: folds 
RICKA16: folds 
dizzyryano79: calls $1
I The King I: folds 
djammusic: raises $2.50 to $3.50
oscarleon: folds 
matiko09: folds 
apfush: folds 
dizzyryano79: calls $2.50
*** FLOP *** [3d 2c 5d]
dizzyryano79: checks 
djammusic: bets $4.20
dizzyryano79: folds 
Uncalled bet ($4.20) returned to djammusic
djammusic collected $8.08 from pot
djammusic: doesn't show hand 
*** SUMMARY ***
Total pot $8.50 | Rake $0.42 
Board [3d 2c 5d]
Seat 1: IdiotFromNE folded before Flop (didn't bet)
Seat 3: RICKA16 folded before Flop (didn't bet)
Seat 4: dizzyryano79 folded on the Flop
Seat 5: I The King I folded before Flop (didn't bet)
Seat 6: djammusic collected ($8.08)
Seat 7: oscarleon (button) folded before Flop (didn't bet)
Seat 8: matiko09 (small blind) folded before Flop
Seat 9: apfush (big blind) folded before Flop





PokerStars Hand #151207448237:  Hold'em No Limit (€0.50/€1.00 EUR) - 2016/03/31 12:28:00 CET [2016/03/31 6:28:00 ET]
Table 'Pioneer II' 9-max Seat #9 is the button
Seat 1: Kreuznagel (€104.34 in chips) 
Seat 2: IdiotFromNE (€124.52 in chips) 
Seat 3: vrnMike (€105.90 in chips) 
Seat 4: Zeeshka (€100 in chips) 
Seat 6: matiko09 (€101.50 in chips) 
Seat 7: AlKatrone (€122.91 in chips) 
Seat 9: DUkalisUA (€100 in chips) 
Kreuznagel: posts small blind €0.50
IdiotFromNE: posts big blind €1
*** HOLE CARDS ***
Dealt to matiko09 [Th Kc]
vrnMike: folds 
Zeeshka: folds 
matiko09: folds 
TOTO220773 joins the table at seat #5 
AlKatrone: folds 
DUkalisUA: folds 
PacPacBum joins the table at seat #8 
Kreuznagel: raises €2.13 to €3.13
IdiotFromNE: calls €2.13
*** FLOP *** [6c Ac Ah]
Kreuznagel: checks 
IdiotFromNE: bets €2.97
Kreuznagel: folds 
Uncalled bet (€2.97) returned to IdiotFromNE
IdiotFromNE collected €5.95 from pot
IdiotFromNE: doesn't show hand 
*** SUMMARY ***
Total pot €6.26 | Rake €0.31 
Board [6c Ac Ah]
Seat 1: Kreuznagel (small blind) folded on the Flop
Seat 2: IdiotFromNE (big blind) collected (€5.95)
Seat 3: vrnMike folded before Flop (didn't bet)
Seat 4: Zeeshka folded before Flop (didn't bet)
Seat 6: matiko09 folded before Flop (didn't bet)
Seat 7: AlKatrone folded before Flop (didn't bet)
Seat 9: DUkalisUA (button) folded before Flop (didn't bet)





PokerStars Hand #151207450003:  Hold'em No Limit ($0.50/$1.00 USD) - 2016/03/31 12:28:04 CET [2016/03/31 6:28:04 ET]
Table 'Aquila' 9-max Seat #7 is the button
Seat 5: adelfaz ($55.90 in chips) 
Seat 6: maxxmeister ($105.10 in chips) 
Seat 7: PacPacBum ($131.90 in chips) 
Seat 8: matiko09 ($122 in chips) 
matiko09: posts small blind $0.50
adelfaz: posts big blind $1
adelfaz: posts the ante $0.20
maxxmeister: posts the ante $0.20
PacPacBum: posts the ante $0.20
matiko09: posts the ante $0.20
*** HOLE CARDS ***
Dealt to matiko09 [5d 5s]
maxxmeister: raises $2.50 to $3.50
ChrisAAKKQQ joins the table at seat #4 
PacPacBum: folds 
apfush joins the table at seat #9 
matiko09: raises $7.50 to $11
adelfaz: folds 
maxxmeister: folds 
Uncalled bet ($7.50) returned to matiko09
matiko09 collected $8.80 from pot
matiko09: doesn't show hand 
*** SUMMARY ***
Total pot $8.80 | Rake $0 
Seat 5: adelfaz (big blind) folded before Flop
Seat 6: maxxmeister folded before Flop
Seat 7: PacPacBum (button) folded before Flop (didn't bet)
Seat 8: matiko09 (small blind) collected ($8.80)





PokerStars Hand #151207454622:  Hold'em No Limit ($1/$2 USD) - 2016/03/31 12:28:14 CET [2016/03/31 6:28:14 ET]
Table 'Desiderata' 9-max Seat #6 is the button
Seat 1: GALWACONT ($140.15 in chips) 
Seat 2: ilaviiitech ($216.89 in chips) 
Seat 4: matiko09 ($330.80 in chips) 
Seat 5: Kreuznagel ($305.74 in chips) 
Seat 6: rmanjkeee ($102.75 in chips) 
Seat 7: apfush ($201 in chips) 
Seat 8: DUkalisUA ($214.20 in chips) 
apfush: posts small blind $1
DUkalisUA: posts big blind $2
djammusic: sits out 
*** HOLE CARDS ***
Dealt to matiko09 [Td 9h]
GALWACONT: folds 
ilaviiitech: folds 
matiko09: folds 
Kreuznagel: raises $3 to $5
rmanjkeee: folds 
apfush: folds 
DUkalisUA: folds 
Uncalled bet ($3) returned to Kreuznagel
Kreuznagel collected $5 from pot
Kreuznagel: doesn't show hand 
*** SUMMARY ***
Total pot $5 | Rake $0 
Seat 1: GALWACONT folded before Flop (didn't bet)
Seat 2: ilaviiitech folded before Flop (didn't bet)
Seat 4: matiko09 folded before Flop (didn't bet)
Seat 5: Kreuznagel collected ($5)
Seat 6: rmanjkeee (button) folded before Flop (didn't bet)
Seat 7: apfush (small blind) folded before Flop
Seat 8: DUkalisUA (big blind) folded before Flop





PokerStars Hand #151207455140:  Hold'em No Limit ($0.50/$1.00 USD) - 2016/03/31 12:28:15 CET [2016/03/31 6:28:15 ET]
Table 'Eugenisis III' 9-max Seat #8 is the button
Seat 1: PacPacBum ($104.72 in chips) 
Seat 2: IdiotFromNE ($100 in chips) 
Seat 3: Avtovo ($101.50 in chips) 
Seat 4: alejo22366 ($71.72 in chips) 
Seat 5: ka100pka527 ($36.50 in chips) 
Seat 6: kauff95 ($61.06 in chips) 
Seat 7: djammusic ($40.97 in chips) 
Seat 8: matiko09 ($103.82 in chips) 
PacPacBum: posts small blind $0.50
IdiotFromNE: posts big blind $1
*** HOLE CARDS ***
Dealt to matiko09 [8d Ad]
Avtovo: raises $1.50 to $2.50
alejo22366: folds 
ka100pka527: folds 
kauff95: folds 
djammusic: folds 
matiko09: folds 
PacPacBum: folds 
IdiotFromNE: folds 
Uncalled bet ($1.50) returned to Avtovo
Avtovo collected $2.50 from pot
Avtovo: doesn't show hand 
*** SUMMARY ***
Total pot $2.50 | Rake $0 
Seat 1: PacPacBum (small blind) folded before Flop
Seat 2: IdiotFromNE (big blind) folded before Flop
Seat 3: Avtovo collected ($2.50)
Seat 4: alejo22366 folded before Flop (didn't bet)
Seat 5: ka100pka527 folded before Flop (didn't bet)
Seat 6: kauff95 folded before Flop (didn't bet)
Seat 7: djammusic folded before Flop (didn't bet)
Seat 8: matiko09 (button) folded before Flop (didn't bet)





PokerStars Hand #151207458525:  Hold'em No Limit ($0.50/$1.00 USD) - 2016/03/31 12:28:22 CET [2016/03/31 6:28:22 ET]
Table 'Yazhi' 9-max Seat #1 is the button
Seat 1: matiko09 ($100 in chips) 
Seat 2: xHourglass ($100 in chips) 
Seat 3: Chin41178 ($100 in chips) 
Seat 4: apfush ($180.96 in chips) 
Seat 5: IdiotFromNE ($105 in chips) 
Seat 6: Reven9er ($205.77 in chips) 
Seat 8: pk4DW ($54.20 in chips) 
Seat 9: oscarleon ($203.32 in chips) 
xHourglass: posts small blind $0.50
Chin41178: posts big blind $1
*** HOLE CARDS ***
Dealt to matiko09 [Ks Ah]
apfush: folds 
IdiotFromNE: folds 
Reven9er: folds 
pk4DW: folds 
oscarleon: folds 
matiko09: raises $1.27 to $2.27
xHourglass: folds 
Chin41178: folds 
Uncalled bet ($1.27) returned to matiko09
matiko09 collected $2.50 from pot
matiko09: doesn't show hand 
*** SUMMARY ***
Total pot $2.50 | Rake $0 
Seat 1: matiko09 (button) collected ($2.50)
Seat 2: xHourglass (small blind) folded before Flop
Seat 3: Chin41178 (big blind) folded before Flop
Seat 4: apfush folded before Flop (didn't bet)
Seat 5: IdiotFromNE folded before Flop (didn't bet)
Seat 6: Reven9er folded before Flop (didn't bet)
Seat 8: pk4DW folded before Flop (didn't bet)
Seat 9: oscarleon folded before Flop (didn't bet)





PokerStars Hand #151207459872:  Hold'em No Limit ($0.50/$1.00 USD) - 2016/03/31 12:28:25 CET [2016/03/31 6:28:25 ET]
Table 'Herge II' 9-max Seat #5 is the button
Seat 1: Chiapel ($89.50 in chips) 
Seat 2: DUkalisUA ($100 in chips) 
Seat 3: matiko09 ($210.02 in chips) 
Seat 5: I The King I ($111.78 in chips) 
Seat 6: masaytoo ($103.39 in chips) 
Seat 7: Zeeshka ($100 in chips) 
Seat 8: IdiotFromNE ($100 in chips) 
Seat 9: fatstacks122 ($136.75 in chips) 
masaytoo: posts small blind $0.50
Zeeshka: posts big blind $1
*** HOLE CARDS ***
Dealt to matiko09 [Qh 8c]
IdiotFromNE: folds 
fatstacks122: raises $1 to $2
Chiapel: folds 
DUkalisUA: folds 
matiko09: folds 
I The King I: folds 
masaytoo: calls $1.50
Zeeshka: calls $1
*** FLOP *** [5h 4d 2h]
masaytoo: checks 
Zeeshka: checks 
fatstacks122: bets $2.65
masaytoo: raises $5.65 to $8.30
Zeeshka: calls $8.30
fatstacks122: folds 
*** TURN *** [5h 4d 2h] [6s]
masaytoo: bets $11.99
Zeeshka: calls $11.99
*** RIVER *** [5h 4d 2h 6s] [Kh]
masaytoo: checks 
Zeeshka: checks 
*** SHOW DOWN ***
masaytoo: shows [5s 5c] (three of a kind, Fives)
Zeeshka: shows [3s 4s] (a straight, Deuce to Six)
Zeeshka collected $46.77 from pot
*** SUMMARY ***
Total pot $49.23 | Rake $2.46 
Board [5h 4d 2h 6s Kh]
Seat 1: Chiapel folded before Flop (didn't bet)
Seat 2: DUkalisUA folded before Flop (didn't bet)
Seat 3: matiko09 folded before Flop (didn't bet)
Seat 5: I The King I (button) folded before Flop (didn't bet)
Seat 6: masaytoo (small blind) showed [5s 5c] and lost with three of a kind, Fives
Seat 7: Zeeshka (big blind) showed [3s 4s] and won ($46.77) with a straight, Deuce to Six
Seat 8: IdiotFromNE folded before Flop (didn't bet)
Seat 9: fatstacks122 folded on the Flop





PokerStars Hand #151207464305:  Hold'em No Limit ($0.50/$1.00 USD) - 2016/03/31 12:28:35 CET [2016/03/31 6:28:35 ET]
Table 'Eugenisis III' 9-max Seat #1 is the button
Seat 1: PacPacBum ($104.22 in chips) 
Seat 2: IdiotFromNE ($100 in chips) 
Seat 3: Avtovo ($103 in chips) 
Seat 4: alejo22366 ($71.72 in chips) 
Seat 5: ka100pka527 ($36.50 in chips) 
Seat 6: kauff95 ($61.06 in chips) 
Seat 7: djammusic ($40.97 in chips) 
Seat 8: matiko09 ($103.82 in chips) 
IdiotFromNE: posts small blind $0.50
Avtovo: posts big blind $1
*** HOLE CARDS ***
Dealt to matiko09 [Kh 9d]
alejo22366: folds 
ka100pka527: folds 
kauff95: folds 
djammusic: folds 
matiko09: folds 
PacPacBum: folds 
IdiotFromNE: raises $1.50 to $2.50
Avtovo: folds 
Uncalled bet ($1.50) returned to IdiotFromNE
IdiotFromNE collected $2 from pot
IdiotFromNE: doesn't show hand 
*** SUMMARY ***
Total pot $2 | Rake $0 
Seat 1: PacPacBum (button) folded before Flop (didn't bet)
Seat 2: IdiotFromNE (small blind) collected ($2)
Seat 3: Avtovo (big blind) folded before Flop
Seat 4: alejo22366 folded before Flop (didn't bet)
Seat 5: ka100pka527 folded before Flop (didn't bet)
Seat 6: kauff95 folded before Flop (didn't bet)
Seat 7: djammusic folded before Flop (didn't bet)
Seat 8: matiko09 folded before Flop (didn't bet)





PokerStars Hand #151207465368:  Hold'em No Limit ($1/$2 USD) - 2016/03/31 12:28:37 CET [2016/03/31 6:28:37 ET]
Table 'Desiderata' 9-max Seat #7 is the button
Seat 1: GALWACONT ($140.15 in chips) 
Seat 2: ilaviiitech ($216.89 in chips) 
Seat 4: matiko09 ($330.80 in chips) 
Seat 5: Kreuznagel ($308.74 in chips) 
Seat 6: rmanjkeee ($102.75 in chips) 
Seat 7: apfush ($200 in chips) 
Seat 8: DUkalisUA ($212.20 in chips) 
DUkalisUA: posts small blind $1
GALWACONT: posts big blind $2
djammusic: sits out 
*** HOLE CARDS ***
Dealt to matiko09 [Kh 4c]
ilaviiitech: folds 
matiko09: folds 
Kreuznagel: folds 
rmanjkeee: folds 
apfush: raises $2.40 to $4.40
DUkalisUA: calls $3.40
GALWACONT: calls $2.40
*** FLOP *** [2s 6d 8h]
DUkalisUA: checks 
GALWACONT: checks 
apfush: bets $10
DUkalisUA: folds 
GALWACONT: folds 
Uncalled bet ($10) returned to apfush
apfush collected $12.54 from pot
apfush: doesn't show hand 
*** SUMMARY ***
Total pot $13.20 | Rake $0.66 
Board [2s 6d 8h]
Seat 1: GALWACONT (big blind) folded on the Flop
Seat 2: ilaviiitech folded before Flop (didn't bet)
Seat 4: matiko09 folded before Flop (didn't bet)
Seat 5: Kreuznagel folded before Flop (didn't bet)
Seat 6: rmanjkeee folded before Flop (didn't bet)
Seat 7: apfush (button) collected ($12.54)
Seat 8: DUkalisUA (small blind) folded on the Flop





PokerStars Hand #151207467052:  Hold'em No Limit ($0.50/$1.00 USD) - 2016/03/31 12:28:41 CET [2016/03/31 6:28:41 ET]
Table 'Celestia II' 9-max Seat #6 is the button
Seat 1: matiko09 ($134.12 in chips) 
Seat 3: ilaviiitech ($100 in chips) 
Seat 4: I The King I ($163.59 in chips) 
Seat 5: djammusic ($38.50 in chips) 
Seat 6: IdiotFromNE ($102.22 in chips) 
Seat 7: Avtovo ($127 in chips) 
Seat 8: DUkalisUA ($113.06 in chips) 
Seat 9: Chin41178 ($102.15 in chips) 
Avtovo: posts small blind $0.50
DUkalisUA: posts big blind $1
*** HOLE CARDS ***
Dealt to matiko09 [8c 3h]
Chin41178: folds 
matiko09: folds 
ilaviiitech: folds 
I The King I: folds 
djammusic: raises $1.02 to $2.02
IdiotFromNE: folds 
Avtovo: folds 
DUkalisUA: calls $1.02
*** FLOP *** [Ah 5h Tc]
DUkalisUA: checks 
djammusic: checks 
*** TURN *** [Ah 5h Tc] [2h]
DUkalisUA: bets $2.84
djammusic: folds 
Uncalled bet ($2.84) returned to DUkalisUA
DUkalisUA collected $4.31 from pot
DUkalisUA: doesn't show hand 
*** SUMMARY ***
Total pot $4.54 | Rake $0.23 
Board [Ah 5h Tc 2h]
Seat 1: matiko09 folded before Flop (didn't bet)
Seat 3: ilaviiitech folded before Flop (didn't bet)
Seat 4: I The King I folded before Flop (didn't bet)
Seat 5: djammusic folded on the Turn
Seat 6: IdiotFromNE (button) folded before Flop (didn't bet)
Seat 7: Avtovo (small blind) folded before Flop
Seat 8: DUkalisUA (big blind) collected ($4.31)
Seat 9: Chin41178 folded before Flop (didn't bet)





PokerStars Hand #151207467146:  Hold'em No Limit ($0.50/$1.00 USD) - 2016/03/31 12:28:41 CET [2016/03/31 6:28:41 ET]
Table 'Yazhi' 9-max Seat #2 is the button
Seat 1: matiko09 ($101.50 in chips) 
Seat 2: xHourglass ($100 in chips) 
Seat 3: Chin41178 ($99 in chips) 
Seat 4: apfush ($180.96 in chips) 
Seat 5: IdiotFromNE ($105 in chips) 
Seat 6: Reven9er ($205.77 in chips) 
Seat 8: pk4DW ($54.20 in chips) 
Seat 9: oscarleon ($203.32 in chips) 
Chin41178: posts small blind $0.50
apfush: posts big blind $1
*** HOLE CARDS ***
Dealt to matiko09 [3h 2h]
IdiotFromNE: folds 
Reven9er: raises $1 to $2
pk4DW: folds 
oscarleon: folds 
matiko09: folds 
xHourglass: calls $2
Chin41178: calls $1.50
apfush: calls $1
*** FLOP *** [3s 9c 2c]
Chin41178: bets $3.80
apfush: folds 
Reven9er: calls $3.80
xHourglass: folds 
*** TURN *** [3s 9c 2c] [4h]
Chin41178: checks 
Reven9er: bets $9
Chin41178: calls $9
*** RIVER *** [3s 9c 2c 4h] [6d]
Chin41178: bets $15.96
Reven9er: calls $15.96
*** SHOW DOWN ***
Chin41178: shows [Tc Jc] (high card Jack)
Reven9er: shows [Qc Qs] (a pair of Queens)
Reven9er collected $63.02 from pot
*** SUMMARY ***
Total pot $65.52 | Rake $2.50 
Board [3s 9c 2c 4h 6d]
Seat 1: matiko09 folded before Flop (didn't bet)
Seat 2: xHourglass (button) folded on the Flop
Seat 3: Chin41178 (small blind) showed [Tc Jc] and lost with high card Jack
Seat 4: apfush (big blind) folded on the Flop
Seat 5: IdiotFromNE folded before Flop (didn't bet)
Seat 6: Reven9er showed [Qc Qs] and won ($63.02) with a pair of Queens
Seat 8: pk4DW folded before Flop (didn't bet)
Seat 9: oscarleon folded before Flop (didn't bet)





PokerStars Hand #151207468161:  Hold'em No Limit ($0.50/$1.00 USD) - 2016/03/31 12:28:44 CET [2016/03/31 6:28:44 ET]
Table 'Aquila' 9-max Seat #8 is the button
Seat 5: adelfaz ($54.70 in chips) 
Seat 6: maxxmeister ($101.40 in chips) 
Seat 7: PacPacBum ($131.70 in chips) 
Seat 8: matiko09 ($127.10 in chips) 
apfush will be allowed to play after the button
ChrisAAKKQQ will be allowed to play after the button
adelfaz: posts small blind $0.50
maxxmeister: posts big blind $1
adelfaz: posts the ante $0.20
maxxmeister: posts the ante $0.20
PacPacBum: posts the ante $0.20
matiko09: posts the ante $0.20
*** HOLE CARDS ***
Dealt to matiko09 [Tc Qc]
PacPacBum: folds 
matiko09: raises $1.50 to $2.50
adelfaz: calls $2
laco121 joins the table at seat #3 
maxxmeister: folds 
*** FLOP *** [2c 4s Kd]
adelfaz: checks 
matiko09: bets $4
adelfaz: folds 
Uncalled bet ($4) returned to matiko09
matiko09 collected $6.46 from pot
matiko09: doesn't show hand 
*** SUMMARY ***
Total pot $6.80 | Rake $0.34 
Board [2c 4s Kd]
Seat 5: adelfaz (small blind) folded on the Flop
Seat 6: maxxmeister (big blind) folded before Flop
Seat 7: PacPacBum folded before Flop (didn't bet)
Seat 8: matiko09 (button) collected ($6.46)





PokerStars Hand #151207470277:  Hold'em No Limit ($0.50/$1.00 USD) - 2016/03/31 12:28:48 CET [2016/03/31 6:28:48 ET]
Table 'Icarus III' 9-max Seat #8 is the button
Seat 1: IdiotFromNE ($100 in chips) 
Seat 3: RICKA16 ($107.38 in chips) 
Seat 4: dizzyryano79 ($33.57 in chips) 
Seat 5: I The King I ($116.75 in chips) 
Seat 6: djammusic ($44.58 in chips) 
Seat 7: oscarleon ($152.63 in chips) 
Seat 8: matiko09 ($100 in chips) 
Seat 9: apfush ($122.76 in chips) 
apfush: posts small blind $0.50
IdiotFromNE: posts big blind $1
*** HOLE CARDS ***
Dealt to matiko09 [4s 3s]
RICKA16: folds 
dizzyryano79: folds 
I The King I: folds 
djammusic: folds 
oscarleon: folds 
matiko09: folds 
apfush: raises $2 to $3
IdiotFromNE: calls $2
*** FLOP *** [2h Qs 9h]
apfush: bets $4
IdiotFromNE: folds 
Uncalled bet ($4) returned to apfush
apfush collected $5.70 from pot
apfush: doesn't show hand 
*** SUMMARY ***
Total pot $6 | Rake $0.30 
Board [2h Qs 9h]
Seat 1: IdiotFromNE (big blind) folded on the Flop
Seat 3: RICKA16 folded before Flop (didn't bet)
Seat 4: dizzyryano79 folded before Flop (didn't bet)
Seat 5: I The King I folded before Flop (didn't bet)
Seat 6: djammusic folded before Flop (didn't bet)
Seat 7: oscarleon folded before Flop (didn't bet)
Seat 8: matiko09 (button) folded before Flop (didn't bet)
Seat 9: apfush (small blind) collected ($5.70)





PokerStars Hand #151207471822:  Hold'em No Limit ($1/$2 USD) - 2016/03/31 12:28:51 CET [2016/03/31 6:28:51 ET]
Table 'Coelestina II' 9-max Seat #1 is the button
Seat 1: PacPacBum ($212.06 in chips) 
Seat 2: Kreuznagel ($202.46 in chips) 
Seat 3: ilaviiitech ($207.30 in chips) 
Seat 4: matiko09 ($229.75 in chips) 
Seat 8: DUkalisUA ($219.30 in chips) 
Seat 9: fonng ($192 in chips) 
Kreuznagel: posts small blind $1
ilaviiitech: posts big blind $2
Avtovo: sits out 
rmanjkeee: sits out 
*** HOLE CARDS ***
Dealt to matiko09 [Ac 7s]
matiko09: folds 
DUkalisUA: raises $4 to $6
fonng: folds 
PacPacBum: folds 
Kreuznagel: folds 
ilaviiitech: folds 
Uncalled bet ($4) returned to DUkalisUA
DUkalisUA collected $5 from pot
DUkalisUA: doesn't show hand 
*** SUMMARY ***
Total pot $5 | Rake $0 
Seat 1: PacPacBum (button) folded before Flop (didn't bet)
Seat 2: Kreuznagel (small blind) folded before Flop
Seat 3: ilaviiitech (big blind) folded before Flop
Seat 4: matiko09 folded before Flop (didn't bet)
Seat 8: DUkalisUA collected ($5)
Seat 9: fonng folded before Flop (didn't bet)





PokerStars Hand #151207476086:  Hold'em No Limit ($0.50/$1.00 USD) - 2016/03/31 12:29:01 CET [2016/03/31 6:29:01 ET]
Table 'Eugenisis III' 9-max Seat #2 is the button
Seat 1: PacPacBum ($104.22 in chips) 
Seat 2: IdiotFromNE ($101 in chips) 
Seat 3: Avtovo ($102 in chips) 
Seat 4: alejo22366 ($71.72 in chips) 
Seat 5: ka100pka527 ($36.50 in chips) 
Seat 6: kauff95 ($61.06 in chips) 
Seat 7: djammusic ($40.97 in chips) 
Seat 8: matiko09 ($103.82 in chips) 
Avtovo: posts small blind $0.50
alejo22366: posts big blind $1
*** HOLE CARDS ***
Dealt to matiko09 [Ks Js]
ka100pka527: folds 
kauff95: raises $2 to $3
djammusic: folds 
matiko09: folds 
PacPacBum: folds 
IdiotFromNE: folds 
Avtovo: folds 
alejo22366: folds 
Uncalled bet ($2) returned to kauff95
kauff95 collected $2.50 from pot
*** SUMMARY ***
Total pot $2.50 | Rake $0 
Seat 1: PacPacBum folded before Flop (didn't bet)
Seat 2: IdiotFromNE (button) folded before Flop (didn't bet)
Seat 3: Avtovo (small blind) folded before Flop
Seat 4: alejo22366 (big blind) folded before Flop
Seat 5: ka100pka527 folded before Flop (didn't bet)
Seat 6: kauff95 collected ($2.50)
Seat 7: djammusic folded before Flop (didn't bet)
Seat 8: matiko09 folded before Flop (didn't bet)





PokerStars Hand #151207480525:  Hold'em No Limit ($0.50/$1.00 USD) - 2016/03/31 12:29:11 CET [2016/03/31 6:29:11 ET]
Table 'Aquila' 9-max Seat #5 is the button
Seat 3: laco121 ($80 in chips) 
Seat 4: ChrisAAKKQQ ($62.11 in chips) 
Seat 5: adelfaz ($52 in chips) 
Seat 6: maxxmeister ($100.20 in chips) 
Seat 7: PacPacBum ($131.50 in chips) 
Seat 8: matiko09 ($130.86 in chips) 
maxxmeister: posts small blind $0.50
PacPacBum: posts big blind $1
apfush: sits out 
laco121: posts big blind $1
ChrisAAKKQQ: posts big blind $1
laco121: posts the ante $0.20
ChrisAAKKQQ: posts the ante $0.20
adelfaz: posts the ante $0.20
maxxmeister: posts the ante $0.20
PacPacBum: posts the ante $0.20
matiko09: posts the ante $0.20
*** HOLE CARDS ***
Dealt to matiko09 [2c 6d]
matiko09: folds 
laco121: checks 
ChrisAAKKQQ: checks 
adelfaz: raises $2 to $3
maxxmeister: folds 
PacPacBum: folds 
laco121: calls $2
ChrisAAKKQQ: folds 
*** FLOP *** [5c Ad Th]
laco121: checks 
adelfaz: bets $9.22
laco121: folds 
Uncalled bet ($9.22) returned to adelfaz
adelfaz collected $9.22 from pot
*** SUMMARY ***
Total pot $9.70 | Rake $0.48 
Board [5c Ad Th]
Seat 3: laco121 folded on the Flop
Seat 4: ChrisAAKKQQ folded before Flop
Seat 5: adelfaz (button) collected ($9.22)
Seat 6: maxxmeister (small blind) folded before Flop
Seat 7: PacPacBum (big blind) folded before Flop
Seat 8: matiko09 folded before Flop (didn't bet)





PokerStars Hand #151207482205:  Hold'em No Limit ($1/$2 USD) - 2016/03/31 12:29:14 CET [2016/03/31 6:29:14 ET]
Table 'Coelestina II' 9-max Seat #2 is the button
Seat 1: PacPacBum ($212.06 in chips) 
Seat 2: Kreuznagel ($201.46 in chips) 
Seat 3: ilaviiitech ($205.30 in chips) 
Seat 4: matiko09 ($229.75 in chips) 
Seat 8: DUkalisUA ($222.30 in chips) 
Seat 9: fonng ($192 in chips) 
ilaviiitech: posts small blind $1
matiko09: posts big blind $2
Avtovo: sits out 
rmanjkeee: sits out 
*** HOLE CARDS ***
Dealt to matiko09 [Th Tc]
DUkalisUA: folds 
fonng: folds 
PacPacBum: folds 
Kreuznagel: folds 
ilaviiitech: folds 
Uncalled bet ($1) returned to matiko09
matiko09 collected $2 from pot
matiko09: doesn't show hand 
*** SUMMARY ***
Total pot $2 | Rake $0 
Seat 1: PacPacBum folded before Flop (didn't bet)
Seat 2: Kreuznagel (button) folded before Flop (didn't bet)
Seat 3: ilaviiitech (small blind) folded before Flop
Seat 4: matiko09 (big blind) collected ($2)
Seat 8: DUkalisUA folded before Flop (didn't bet)
Seat 9: fonng folded before Flop (didn't bet)





PokerStars Hand #151207486277:  Hold'em No Limit (€0.50/€1.00 EUR) - 2016/03/31 12:29:23 CET [2016/03/31 6:29:23 ET]
Table 'Pioneer II' 9-max Seat #1 is the button
Seat 1: Kreuznagel (€101.21 in chips) 
Seat 2: IdiotFromNE (€127.34 in chips) 
Seat 5: TOTO220773 (€80 in chips) 
Seat 6: matiko09 (€101.50 in chips) 
Seat 7: AlKatrone (€122.91 in chips) 
Seat 9: DUkalisUA (€100 in chips) 
IdiotFromNE: posts small blind €0.50
vrnMike: is sitting out 
Zeeshka: is sitting out 
TOTO220773: posts big blind €1
Zeeshka leaves the table
PacPacBum: sits out 
*** HOLE CARDS ***
Dealt to matiko09 [9d Qc]
matiko09: folds 
AlKatrone: folds 
DUkalisUA: folds 
Kreuznagel: folds 
IdiotFromNE: raises €1.50 to €2.50
TOTO220773: folds 
Uncalled bet (€1.50) returned to IdiotFromNE
IdiotFromNE collected €2 from pot
IdiotFromNE: doesn't show hand 
*** SUMMARY ***
Total pot €2 | Rake €0 
Seat 1: Kreuznagel (button) folded before Flop (didn't bet)
Seat 2: IdiotFromNE (small blind) collected (€2)
Seat 5: TOTO220773 (big blind) folded before Flop
Seat 6: matiko09 folded before Flop (didn't bet)
Seat 7: AlKatrone folded before Flop (didn't bet)
Seat 9: DUkalisUA folded before Flop (didn't bet)





PokerStars Hand #151207491118:  Hold'em No Limit ($0.50/$1.00 USD) - 2016/03/31 12:29:34 CET [2016/03/31 6:29:34 ET]
Table 'Eugenisis III' 9-max Seat #3 is the button
Seat 1: PacPacBum ($104.22 in chips) 
Seat 2: IdiotFromNE ($101 in chips) 
Seat 3: Avtovo ($101.50 in chips) 
Seat 4: alejo22366 ($70.72 in chips) 
Seat 5: ka100pka527 ($36.50 in chips) 
Seat 6: kauff95 ($62.56 in chips) 
Seat 7: djammusic ($40.97 in chips) 
Seat 8: matiko09 ($103.82 in chips) 
alejo22366: posts small blind $0.50
ka100pka527: posts big blind $1
*** HOLE CARDS ***
Dealt to matiko09 [Kd 2s]
kauff95: folds 
djammusic: folds 
matiko09: folds 
PacPacBum: raises $2 to $3
IdiotFromNE: folds 
Avtovo: folds 
alejo22366: folds 
ka100pka527: folds 
Uncalled bet ($2) returned to PacPacBum
PacPacBum collected $2.50 from pot
PacPacBum: doesn't show hand 
*** SUMMARY ***
Total pot $2.50 | Rake $0 
Seat 1: PacPacBum collected ($2.50)
Seat 2: IdiotFromNE folded before Flop (didn't bet)
Seat 3: Avtovo (button) folded before Flop (didn't bet)
Seat 4: alejo22366 (small blind) folded before Flop
Seat 5: ka100pka527 (big blind) folded before Flop
Seat 6: kauff95 folded before Flop (didn't bet)
Seat 7: djammusic folded before Flop (didn't bet)
Seat 8: matiko09 folded before Flop (didn't bet)





PokerStars Hand #151207494378:  Hold'em No Limit ($1/$2 USD) - 2016/03/31 12:29:41 CET [2016/03/31 6:29:41 ET]
Table 'Coelestina II' 9-max Seat #3 is the button
Seat 1: PacPacBum ($212.06 in chips) 
Seat 2: Kreuznagel ($201.46 in chips) 
Seat 3: ilaviiitech ($204.30 in chips) 
Seat 4: matiko09 ($230.75 in chips) 
Seat 6: Avtovo ($200 in chips) 
Seat 8: DUkalisUA ($222.30 in chips) 
Seat 9: fonng ($192 in chips) 
matiko09: posts small blind $1
Avtovo: posts big blind $2
rmanjkeee: sits out 
*** HOLE CARDS ***
Dealt to matiko09 [9c 3d]
DUkalisUA: folds 
fonng: folds 
PacPacBum: raises $2.08 to $4.08
Kreuznagel: folds 
ilaviiitech: folds 
matiko09: folds 
Avtovo: raises $11.92 to $16
PacPacBum: folds 
Uncalled bet ($11.92) returned to Avtovo
Avtovo collected $9.16 from pot
Avtovo: doesn't show hand 
*** SUMMARY ***
Total pot $9.16 | Rake $0 
Seat 1: PacPacBum folded before Flop
Seat 2: Kreuznagel folded before Flop (didn't bet)
Seat 3: ilaviiitech (button) folded before Flop (didn't bet)
Seat 4: matiko09 (small blind) folded before Flop
Seat 6: Avtovo (big blind) collected ($9.16)
Seat 8: DUkalisUA folded before Flop (didn't bet)
Seat 9: fonng folded before Flop (didn't bet)





PokerStars Hand #151207498902:  Hold'em No Limit ($1/$2 USD) - 2016/03/31 12:29:51 CET [2016/03/31 6:29:51 ET]
Table 'Desiderata' 9-max Seat #8 is the button
Seat 1: GALWACONT ($135.75 in chips) 
Seat 2: ilaviiitech ($216.89 in chips) 
Seat 4: matiko09 ($330.80 in chips) 
Seat 5: Kreuznagel ($308.74 in chips) 
Seat 6: rmanjkeee ($102.75 in chips) 
Seat 7: apfush ($208.14 in chips) 
Seat 8: DUkalisUA ($207.80 in chips) 
GALWACONT: posts small blind $1
ilaviiitech: posts big blind $2
djammusic: sits out 
*** HOLE CARDS ***
Dealt to matiko09 [Tc 9c]
matiko09: raises $3 to $5
Kreuznagel: folds 
rmanjkeee: folds 
apfush: folds 
DUkalisUA: folds 
GALWACONT: folds 
ilaviiitech: folds 
Uncalled bet ($3) returned to matiko09
matiko09 collected $5 from pot
matiko09: doesn't show hand 
*** SUMMARY ***
Total pot $5 | Rake $0 
Seat 1: GALWACONT (small blind) folded before Flop
Seat 2: ilaviiitech (big blind) folded before Flop
Seat 4: matiko09 collected ($5)
Seat 5: Kreuznagel folded before Flop (didn't bet)
Seat 6: rmanjkeee folded before Flop (didn't bet)
Seat 7: apfush folded before Flop (didn't bet)
Seat 8: DUkalisUA (button) folded before Flop (didn't bet)





PokerStars Hand #151207498871:  Hold'em No Limit ($0.50/$1.00 USD) - 2016/03/31 12:29:51 CET [2016/03/31 6:29:51 ET]
Table 'Icarus III' 9-max Seat #9 is the button
Seat 1: IdiotFromNE ($100 in chips) 
Seat 3: RICKA16 ($107.38 in chips) 
Seat 4: dizzyryano79 ($33.57 in chips) 
Seat 5: I The King I ($116.75 in chips) 
Seat 6: djammusic ($44.58 in chips) 
Seat 7: oscarleon ($152.63 in chips) 
Seat 8: matiko09 ($100 in chips) 
Seat 9: apfush ($125.46 in chips) 
IdiotFromNE: posts small blind $0.50
RICKA16: posts big blind $1
*** HOLE CARDS ***
Dealt to matiko09 [Jc 8d]
dizzyryano79: folds 
I The King I: folds 
djammusic: folds 
oscarleon: folds 
matiko09: folds 
apfush: folds 
IdiotFromNE: raises $1.50 to $2.50
RICKA16: calls $1.50
*** FLOP *** [7c 3c Tc]
IdiotFromNE: bets $2.37
RICKA16: raises $3.63 to $6
IdiotFromNE: calls $3.63
*** TURN *** [7c 3c Tc] [2h]
IdiotFromNE: checks 
RICKA16: bets $10
IdiotFromNE: calls $10
*** RIVER *** [7c 3c Tc 2h] [Th]
IdiotFromNE: checks 
RICKA16: checks 
*** SHOW DOWN ***
IdiotFromNE: shows [4c 9c] (a flush, Ten high)
RICKA16: mucks hand 
IdiotFromNE collected $35.15 from pot
*** SUMMARY ***
Total pot $37 | Rake $1.85 
Board [7c 3c Tc 2h Th]
Seat 1: IdiotFromNE (small blind) showed [4c 9c] and won ($35.15) with a flush, Ten high
Seat 3: RICKA16 (big blind) mucked [Qs Ts]
Seat 4: dizzyryano79 folded before Flop (didn't bet)
Seat 5: I The King I folded before Flop (didn't bet)
Seat 6: djammusic folded before Flop (didn't bet)
Seat 7: oscarleon folded before Flop (didn't bet)
Seat 8: matiko09 folded before Flop (didn't bet)
Seat 9: apfush (button) folded before Flop (didn't bet)





PokerStars Hand #151207500067:  Hold'em No Limit ($0.50/$1.00 USD) - 2016/03/31 12:29:53 CET [2016/03/31 6:29:53 ET]
Table 'Aquila' 9-max Seat #6 is the button
Seat 3: laco121 ($76.80 in chips) 
Seat 4: ChrisAAKKQQ ($60.91 in chips) 
Seat 5: adelfaz ($58.02 in chips) 
Seat 6: maxxmeister ($100 in chips) 
Seat 7: PacPacBum ($130.30 in chips) 
Seat 8: matiko09 ($130.66 in chips) 
PacPacBum: posts small blind $0.50
matiko09: posts big blind $1
apfush: sits out 
laco121: posts the ante $0.20
ChrisAAKKQQ: posts the ante $0.20
adelfaz: posts the ante $0.20
maxxmeister: posts the ante $0.20
PacPacBum: posts the ante $0.20
matiko09: posts the ante $0.20
*** HOLE CARDS ***
Dealt to matiko09 [6c 8h]
laco121: raises $2 to $3
ChrisAAKKQQ: folds 
adelfaz: folds 
maxxmeister: raises $6 to $9
PacPacBum: folds 
matiko09: folds 
laco121: calls $6
*** FLOP *** [7h 5d Td]
laco121: checks 
maxxmeister: bets $11
laco121: calls $11
*** TURN *** [7h 5d Td] [Ts]
laco121: checks 
maxxmeister: checks 
*** RIVER *** [7h 5d Td Ts] [3c]
laco121: bets $5
Painkiller72 joins the table at seat #1 
Painkiller72 leaves the table
maxxmeister: raises $12.08 to $17.08
laco121: folds 
Uncalled bet ($12.08) returned to maxxmeister
maxxmeister collected $50.20 from pot
maxxmeister: doesn't show hand 
*** SUMMARY ***
Total pot $52.70 | Rake $2.50 
Board [7h 5d Td Ts 3c]
Seat 3: laco121 folded on the River
Seat 4: ChrisAAKKQQ folded before Flop (didn't bet)
Seat 5: adelfaz folded before Flop (didn't bet)
Seat 6: maxxmeister (button) collected ($50.20)
Seat 7: PacPacBum (small blind) folded before Flop
Seat 8: matiko09 (big blind) folded before Flop





PokerStars Hand #151207502564:  Hold'em No Limit (€0.50/€1.00 EUR) - 2016/03/31 12:29:59 CET [2016/03/31 6:29:59 ET]
Table 'Pioneer II' 9-max Seat #2 is the button
Seat 1: Kreuznagel (€101.21 in chips) 
Seat 2: IdiotFromNE (€128.34 in chips) 
Seat 5: TOTO220773 (€79 in chips) 
Seat 6: matiko09 (€101.50 in chips) 
Seat 7: AlKatrone (€122.91 in chips) 
Seat 9: DUkalisUA (€100 in chips) 
TOTO220773: posts small blind €0.50
matiko09: posts big blind €1
PacPacBum: sits out 
*** HOLE CARDS ***
Dealt to matiko09 [Kc 9d]
Painkiller72 joins the table at seat #4 
AlKatrone: folds 
DUkalisUA: raises €2 to €3
Kreuznagel: calls €3
IdiotFromNE: folds 
TOTO220773: folds 
matiko09: folds 
*** FLOP *** [2d 2c 2h]
DUkalisUA: bets €4.69
Kreuznagel: folds 
Uncalled bet (€4.69) returned to DUkalisUA
DUkalisUA collected €7.12 from pot
DUkalisUA: doesn't show hand 
*** SUMMARY ***
Total pot €7.50 | Rake €0.38 
Board [2d 2c 2h]
Seat 1: Kreuznagel folded on the Flop
Seat 2: IdiotFromNE (button) folded before Flop (didn't bet)
Seat 5: TOTO220773 (small blind) folded before Flop
Seat 6: matiko09 (big blind) folded before Flop
Seat 7: AlKatrone folded before Flop (didn't bet)
Seat 9: DUkalisUA collected (€7.12)





PokerStars Hand #151207507081:  Hold'em No Limit ($0.50/$1.00 USD) - 2016/03/31 12:30:07 CET [2016/03/31 6:30:07 ET]
Table 'Eugenisis III' 9-max Seat #4 is the button
Seat 1: PacPacBum ($105.72 in chips) 
Seat 2: IdiotFromNE ($101 in chips) 
Seat 3: Avtovo ($101.50 in chips) 
Seat 4: alejo22366 ($70.22 in chips) 
Seat 5: ka100pka527 ($35.50 in chips) 
Seat 6: kauff95 ($62.56 in chips) 
Seat 7: djammusic ($40.97 in chips) 
Seat 8: matiko09 ($103.82 in chips) 
ka100pka527: posts small blind $0.50
kauff95: posts big blind $1
*** HOLE CARDS ***
Dealt to matiko09 [Js 9s]
djammusic: folds 
matiko09: folds 
PacPacBum: folds 
IdiotFromNE: folds 
Avtovo: raises $1.50 to $2.50
alejo22366: calls $2.50
ka100pka527: folds 
kauff95: calls $1.50
*** FLOP *** [7d 7s Kc]
kauff95: checks 
Avtovo: bets $4
alejo22366: calls $4
kauff95: calls $4
*** TURN *** [7d 7s Kc] [6h]
kauff95: checks 
Avtovo: bets $12
alejo22366: folds 
kauff95: calls $12
*** RIVER *** [7d 7s Kc 6h] [Qs]
kauff95: bets $20
Avtovo: raises $63 to $83 and is all-in
kauff95: calls $24.06 and is all-in
Uncalled bet ($38.94) returned to Avtovo
*** SHOW DOWN ***
Avtovo: shows [6c 7c] (a full house, Sevens full of Sixes)
kauff95: shows [Ah 7h] (three of a kind, Sevens)
Avtovo collected $129.62 from pot
*** SUMMARY ***
Total pot $132.12 | Rake $2.50 
Board [7d 7s Kc 6h Qs]
Seat 1: PacPacBum folded before Flop (didn't bet)
Seat 2: IdiotFromNE folded before Flop (didn't bet)
Seat 3: Avtovo showed [6c 7c] and won ($129.62) with a full house, Sevens full of Sixes
Seat 4: alejo22366 (button) folded on the Turn
Seat 5: ka100pka527 (small blind) folded before Flop
Seat 6: kauff95 (big blind) showed [Ah 7h] and lost with three of a kind, Sevens
Seat 7: djammusic folded before Flop (didn't bet)
Seat 8: matiko09 folded before Flop (didn't bet)





PokerStars Hand #151207508363:  Hold'em No Limit ($0.50/$1.00 USD) - 2016/03/31 12:30:10 CET [2016/03/31 6:30:10 ET]
Table 'Celestia II' 9-max Seat #7 is the button
Seat 1: matiko09 ($134.12 in chips) 
Seat 3: ilaviiitech ($100 in chips) 
Seat 4: I The King I ($163.59 in chips) 
Seat 5: djammusic ($36.48 in chips) 
Seat 6: IdiotFromNE ($102.22 in chips) 
Seat 7: Avtovo ($126.50 in chips) 
Seat 8: DUkalisUA ($115.35 in chips) 
Seat 9: Chin41178 ($102.15 in chips) 
DUkalisUA: posts small blind $0.50
Chin41178: posts big blind $1
*** HOLE CARDS ***
Dealt to matiko09 [Td 6s]
ValentinChit leaves the table
matiko09: folds 
ilaviiitech: folds 
I The King I: folds 
djammusic: folds 
IdiotFromNE: raises $1.50 to $2.50
Avtovo: folds 
DUkalisUA: folds 
Chin41178: raises $5.50 to $8
ka100pka527 joins the table at seat #2 
IdiotFromNE: calls $5.50
*** FLOP *** [Jh Tc Jd]
Chin41178: bets $7.84
IdiotFromNE: calls $7.84
*** TURN *** [Jh Tc Jd] [Ad]
Chin41178: checks 
IdiotFromNE: checks 
*** RIVER *** [Jh Tc Jd Ad] [8d]
Chin41178: bets $30.57
IdiotFromNE: folds 
Uncalled bet ($30.57) returned to Chin41178
Chin41178 collected $30.57 from pot
Chin41178: doesn't show hand 
*** SUMMARY ***
Total pot $32.18 | Rake $1.61 
Board [Jh Tc Jd Ad 8d]
Seat 1: matiko09 folded before Flop (didn't bet)
Seat 3: ilaviiitech folded before Flop (didn't bet)
Seat 4: I The King I folded before Flop (didn't bet)
Seat 5: djammusic folded before Flop (didn't bet)
Seat 6: IdiotFromNE folded on the River
Seat 7: Avtovo (button) folded before Flop (didn't bet)
Seat 8: DUkalisUA (small blind) folded before Flop
Seat 9: Chin41178 (big blind) collected ($30.57)





PokerStars Hand #151207509335:  Hold'em No Limit ($1/$2 USD) - 2016/03/31 12:30:12 CET [2016/03/31 6:30:12 ET]
Table 'Coelestina II' 9-max Seat #4 is the button
Seat 1: PacPacBum ($207.98 in chips) 
Seat 2: Kreuznagel ($201.46 in chips) 
Seat 3: ilaviiitech ($204.30 in chips) 
Seat 4: matiko09 ($229.75 in chips) 
Seat 6: Avtovo ($205.08 in chips) 
Seat 7: rmanjkeee ($80 in chips) 
Seat 8: DUkalisUA ($222.30 in chips) 
Seat 9: fonng ($192 in chips) 
Painkiller72 will be allowed to play after the button
Avtovo: posts small blind $1
rmanjkeee: posts big blind $2
*** HOLE CARDS ***
Dealt to matiko09 [7h Ac]
DUkalisUA: folds 
fonng: folds 
PacPacBum: folds 
Kreuznagel: folds 
ilaviiitech: folds 
matiko09: raises $2.54 to $4.54
Avtovo: raises $11.46 to $16
rmanjkeee: folds 
matiko09: folds 
Uncalled bet ($11.46) returned to Avtovo
Avtovo collected $11.08 from pot
Avtovo: doesn't show hand 
*** SUMMARY ***
Total pot $11.08 | Rake $0 
Seat 1: PacPacBum folded before Flop (didn't bet)
Seat 2: Kreuznagel folded before Flop (didn't bet)
Seat 3: ilaviiitech folded before Flop (didn't bet)
Seat 4: matiko09 (button) folded before Flop
Seat 6: Avtovo (small blind) collected ($11.08)
Seat 7: rmanjkeee (big blind) folded before Flop
Seat 8: DUkalisUA folded before Flop (didn't bet)
Seat 9: fonng folded before Flop (didn't bet)





PokerStars Hand #151207513746:  Hold'em No Limit ($0.50/$1.00 USD) - 2016/03/31 12:30:22 CET [2016/03/31 6:30:22 ET]
Table 'Yazhi' 9-max Seat #3 is the button
Seat 1: matiko09 ($101.50 in chips) 
Seat 2: xHourglass ($100 in chips) 
Seat 3: Chin41178 ($68.24 in chips) 
Seat 4: apfush ($178.96 in chips) 
Seat 5: IdiotFromNE ($105 in chips) 
Seat 6: Reven9er ($238.03 in chips) 
Seat 8: pk4DW ($54.20 in chips) 
Seat 9: oscarleon ($203.32 in chips) 
apfush: posts small blind $0.50
IdiotFromNE: posts big blind $1
*** HOLE CARDS ***
Dealt to matiko09 [2d Ad]
Reven9er: folds 
pk4DW: folds 
oscarleon: folds 
matiko09: raises $2 to $3
xHourglass: folds 
Chin41178: folds 
apfush: raises $7 to $10
vrnMike leaves the table
IdiotFromNE: folds 
matiko09: folds 
Uncalled bet ($7) returned to apfush
apfush collected $7 from pot
apfush: doesn't show hand 
*** SUMMARY ***
Total pot $7 | Rake $0 
Seat 1: matiko09 folded before Flop
Seat 2: xHourglass folded before Flop (didn't bet)
Seat 3: Chin41178 (button) folded before Flop (didn't bet)
Seat 4: apfush (small blind) collected ($7)
Seat 5: IdiotFromNE (big blind) folded before Flop
Seat 6: Reven9er folded before Flop (didn't bet)
Seat 8: pk4DW folded before Flop (didn't bet)
Seat 9: oscarleon folded before Flop (didn't bet)





PokerStars Hand #151207514192:  Hold'em No Limit ($1/$2 USD) - 2016/03/31 12:30:22 CET [2016/03/31 6:30:22 ET]
Table 'Desiderata' 9-max Seat #1 is the button
Seat 1: GALWACONT ($134.75 in chips) 
Seat 2: ilaviiitech ($214.89 in chips) 
Seat 3: djammusic ($80 in chips) 
Seat 4: matiko09 ($333.80 in chips) 
Seat 5: Kreuznagel ($308.74 in chips) 
Seat 6: rmanjkeee ($102.75 in chips) 
Seat 7: apfush ($208.14 in chips) 
Seat 8: DUkalisUA ($207.80 in chips) 
ilaviiitech: posts small blind $1
djammusic: posts big blind $2
Painkiller72: sits out 
*** HOLE CARDS ***
Dealt to matiko09 [3d 6c]
matiko09: folds 
Kreuznagel: folds 
rmanjkeee: folds 
apfush: folds 
DUkalisUA: folds 
GALWACONT: folds 
ilaviiitech: folds 
Uncalled bet ($1) returned to djammusic
djammusic collected $2 from pot
djammusic: doesn't show hand 
*** SUMMARY ***
Total pot $2 | Rake $0 
Seat 1: GALWACONT (button) folded before Flop (didn't bet)
Seat 2: ilaviiitech (small blind) folded before Flop
Seat 3: djammusic (big blind) collected ($2)
Seat 4: matiko09 folded before Flop (didn't bet)
Seat 5: Kreuznagel folded before Flop (didn't bet)
Seat 6: rmanjkeee folded before Flop (didn't bet)
Seat 7: apfush folded before Flop (didn't bet)
Seat 8: DUkalisUA folded before Flop (didn't bet)





PokerStars Hand #151207520238:  Hold'em No Limit ($1/$2 USD) - 2016/03/31 12:30:36 CET [2016/03/31 6:30:36 ET]
Table 'Desiderata' 9-max Seat #2 is the button
Seat 1: GALWACONT ($134.75 in chips) 
Seat 2: ilaviiitech ($213.89 in chips) 
Seat 3: djammusic ($81 in chips) 
Seat 4: matiko09 ($333.80 in chips) 
Seat 5: Kreuznagel ($308.74 in chips) 
Seat 6: rmanjkeee ($102.75 in chips) 
Seat 7: apfush ($208.14 in chips) 
Seat 8: DUkalisUA ($207.80 in chips) 
djammusic: posts small blind $1
matiko09: posts big blind $2
Painkiller72: sits out 
*** HOLE CARDS ***
Dealt to matiko09 [Ad Ah]
Kreuznagel: folds 
rmanjkeee: folds 
apfush: folds 
DUkalisUA: folds 
GALWACONT: folds 
ilaviiitech: folds 
djammusic: folds 
Uncalled bet ($1) returned to matiko09
matiko09 collected $2 from pot
matiko09: doesn't show hand 
*** SUMMARY ***
Total pot $2 | Rake $0 
Seat 1: GALWACONT folded before Flop (didn't bet)
Seat 2: ilaviiitech (button) folded before Flop (didn't bet)
Seat 3: djammusic (small blind) folded before Flop
Seat 4: matiko09 (big blind) collected ($2)
Seat 5: Kreuznagel folded before Flop (didn't bet)
Seat 6: rmanjkeee folded before Flop (didn't bet)
Seat 7: apfush folded before Flop (didn't bet)
Seat 8: DUkalisUA folded before Flop (didn't bet)





PokerStars Hand #151207521895:  Hold'em No Limit (€0.50/€1.00 EUR) - 2016/03/31 12:30:39 CET [2016/03/31 6:30:39 ET]
Table 'Pioneer II' 9-max Seat #5 is the button
Seat 1: Kreuznagel (€100 in chips) 
Seat 2: IdiotFromNE (€128.34 in chips) 
Seat 5: TOTO220773 (€78.50 in chips) 
Seat 6: matiko09 (€100.50 in chips) 
Seat 7: AlKatrone (€122.91 in chips) 
Seat 9: DUkalisUA (€104.12 in chips) 
matiko09: posts small blind €0.50
AlKatrone: posts big blind €1
PacPacBum: sits out 
Painkiller72: sits out 
*** HOLE CARDS ***
Dealt to matiko09 [Ac 7h]
DUkalisUA: folds 
vrnMike leaves the table
Kreuznagel: folds 
IdiotFromNE: folds 
TOTO220773: folds 
matiko09: raises €1.50 to €2.50
AlKatrone: folds 
Uncalled bet (€1.50) returned to matiko09
matiko09 collected €2 from pot
matiko09: doesn't show hand 
*** SUMMARY ***
Total pot €2 | Rake €0 
Seat 1: Kreuznagel folded before Flop (didn't bet)
Seat 2: IdiotFromNE folded before Flop (didn't bet)
Seat 5: TOTO220773 (button) folded before Flop (didn't bet)
Seat 6: matiko09 (small blind) collected (€2)
Seat 7: AlKatrone (big blind) folded before Flop
Seat 9: DUkalisUA folded before Flop (didn't bet)





PokerStars Hand #151207521884:  Hold'em No Limit ($0.50/$1.00 USD) - 2016/03/31 12:30:39 CET [2016/03/31 6:30:39 ET]
Table 'Herge II' 9-max Seat #6 is the button
Seat 1: Chiapel ($89.50 in chips) 
Seat 2: DUkalisUA ($100 in chips) 
Seat 3: matiko09 ($210.02 in chips) 
Seat 5: I The King I ($111.78 in chips) 
Seat 6: masaytoo ($100 in chips) 
Seat 7: Zeeshka ($124.48 in chips) 
Seat 8: IdiotFromNE ($100 in chips) 
Seat 9: fatstacks122 ($132.10 in chips) 
Zeeshka: posts small blind $0.50
IdiotFromNE: posts big blind $1
*** HOLE CARDS ***
Dealt to matiko09 [As Td]
fatstacks122: folds 
Chiapel: folds 
vrnMike leaves the table
Kreuznagel joins the table at seat #4 
DUkalisUA: raises $2 to $3
matiko09: folds 
I The King I: folds 
masaytoo: folds 
Zeeshka: folds 
IdiotFromNE: folds 
Uncalled bet ($2) returned to DUkalisUA
DUkalisUA collected $2.50 from pot
DUkalisUA: doesn't show hand 
*** SUMMARY ***
Total pot $2.50 | Rake $0 
Seat 1: Chiapel folded before Flop (didn't bet)
Seat 2: DUkalisUA collected ($2.50)
Seat 3: matiko09 folded before Flop (didn't bet)
Seat 5: I The King I folded before Flop (didn't bet)
Seat 6: masaytoo (button) folded before Flop (didn't bet)
Seat 7: Zeeshka (small blind) folded before Flop
Seat 8: IdiotFromNE (big blind) folded before Flop
Seat 9: fatstacks122 folded before Flop (didn't bet)





PokerStars Hand #151207525224:  Hold'em No Limit ($1/$2 USD) - 2016/03/31 12:30:46 CET [2016/03/31 6:30:46 ET]
Table 'Coelestina II' 9-max Seat #6 is the button
Seat 1: PacPacBum ($207.98 in chips) 
Seat 2: Kreuznagel ($201.46 in chips) 
Seat 3: ilaviiitech ($204.30 in chips) 
Seat 4: matiko09 ($225.21 in chips) 
Seat 6: Avtovo ($211.62 in chips) 
Seat 7: rmanjkeee ($80 in chips) 
Seat 8: DUkalisUA ($222.30 in chips) 
Seat 9: fonng ($192 in chips) 
rmanjkeee: posts small blind $1
DUkalisUA: posts big blind $2
Painkiller72: sits out 
*** HOLE CARDS ***
Dealt to matiko09 [Qs 2s]
fonng: folds 
PacPacBum: folds 
Kreuznagel: folds 
ilaviiitech: folds 
matiko09: folds 
Avtovo: folds 
rmanjkeee: raises $3 to $5
DUkalisUA: calls $3
*** FLOP *** [3s Kd 5c]
rmanjkeee: checks 
DUkalisUA: bets $6.27
rmanjkeee: calls $6.27
*** TURN *** [3s Kd 5c] [9c]
rmanjkeee: checks 
DUkalisUA: bets $11.77
rmanjkeee: calls $11.77
*** RIVER *** [3s Kd 5c 9c] [9h]
rmanjkeee: checks 
DUkalisUA: checks 
*** SHOW DOWN ***
rmanjkeee: shows [Tc Kc] (two pair, Kings and Nines)
DUkalisUA: mucks hand 
rmanjkeee collected $43.78 from pot
*** SUMMARY ***
Total pot $46.08 | Rake $2.30 
Board [3s Kd 5c 9c 9h]
Seat 1: PacPacBum folded before Flop (didn't bet)
Seat 2: Kreuznagel folded before Flop (didn't bet)
Seat 3: ilaviiitech folded before Flop (didn't bet)
Seat 4: matiko09 folded before Flop (didn't bet)
Seat 6: Avtovo (button) folded before Flop (didn't bet)
Seat 7: rmanjkeee (small blind) showed [Tc Kc] and won ($43.78) with two pair, Kings and Nines
Seat 8: DUkalisUA (big blind) mucked [Kh 8c]
Seat 9: fonng folded before Flop (didn't bet)





PokerStars Hand #151207528464:  Hold'em No Limit ($1/$2 USD) - 2016/03/31 12:30:53 CET [2016/03/31 6:30:53 ET]
Table 'Desiderata' 9-max Seat #3 is the button
Seat 1: GALWACONT ($134.75 in chips) 
Seat 2: ilaviiitech ($213.89 in chips) 
Seat 3: djammusic ($80 in chips) 
Seat 4: matiko09 ($334.80 in chips) 
Seat 5: Kreuznagel ($308.74 in chips) 
Seat 6: rmanjkeee ($102.75 in chips) 
Seat 7: apfush ($208.14 in chips) 
Seat 8: DUkalisUA ($207.80 in chips) 
matiko09: posts small blind $1
Kreuznagel: posts big blind $2
Painkiller72: sits out 
*** HOLE CARDS ***
Dealt to matiko09 [8c Ah]
rmanjkeee: folds 
apfush: folds 
DUkalisUA: folds 
GALWACONT: raises $4 to $6
ilaviiitech: folds 
djammusic: folds 
matiko09: folds 
Kreuznagel: folds 
Uncalled bet ($4) returned to GALWACONT
GALWACONT collected $5 from pot
GALWACONT: doesn't show hand 
*** SUMMARY ***
Total pot $5 | Rake $0 
Seat 1: GALWACONT collected ($5)
Seat 2: ilaviiitech folded before Flop (didn't bet)
Seat 3: djammusic (button) folded before Flop (didn't bet)
Seat 4: matiko09 (small blind) folded before Flop
Seat 5: Kreuznagel (big blind) folded before Flop
Seat 6: rmanjkeee folded before Flop (didn't bet)
Seat 7: apfush folded before Flop (didn't bet)
Seat 8: DUkalisUA folded before Flop (didn't bet)





PokerStars Hand #151207534786:  Hold'em No Limit ($0.50/$1.00 USD) - 2016/03/31 12:31:07 CET [2016/03/31 6:31:07 ET]
Table 'Yazhi' 9-max Seat #4 is the button
Seat 1: matiko09 ($100 in chips) 
Seat 2: xHourglass ($100 in chips) 
Seat 3: Chin41178 ($68.24 in chips) 
Seat 4: apfush ($182.96 in chips) 
Seat 5: IdiotFromNE ($104 in chips) 
Seat 6: Reven9er ($238.03 in chips) 
Seat 8: pk4DW ($54.20 in chips) 
Seat 9: oscarleon ($203.32 in chips) 
IdiotFromNE: posts small blind $0.50
Reven9er: posts big blind $1
*** HOLE CARDS ***
Dealt to matiko09 [5h 5s]
pk4DW: folds 
oscarleon: folds 
matiko09: raises $2 to $3
I The King I joins the table at seat #7 
I The King I leaves the table
xHourglass: folds 
Chin41178: raises $6 to $9
apfush: folds 
IdiotFromNE: folds 
Reven9er: folds 
Avtovo joins the table at seat #7 
matiko09: folds 
Uncalled bet ($6) returned to Chin41178
Chin41178 collected $7.50 from pot
Chin41178: doesn't show hand 
*** SUMMARY ***
Total pot $7.50 | Rake $0 
Seat 1: matiko09 folded before Flop
Seat 2: xHourglass folded before Flop (didn't bet)
Seat 3: Chin41178 collected ($7.50)
Seat 4: apfush (button) folded before Flop (didn't bet)
Seat 5: IdiotFromNE (small blind) folded before Flop
Seat 6: Reven9er (big blind) folded before Flop
Seat 8: pk4DW folded before Flop (didn't bet)
Seat 9: oscarleon folded before Flop (didn't bet)





PokerStars Hand #151207535623:  Hold'em No Limit ($0.50/$1.00 USD) - 2016/03/31 12:31:09 CET [2016/03/31 6:31:09 ET]
Table 'Bussolini III' 9-max Seat #3 is the button
Seat 1: I The King I ($194.96 in chips) 
Seat 2: BOAYARSKIY ($40 in chips) 
Seat 3: 20grodt16 ($104.39 in chips) 
Seat 5: Kreuznagel ($124.91 in chips) 
Seat 6: matiko09 ($100 in chips) 
Seat 8: oscarleon ($141.18 in chips) 
Seat 9: RICKA16 ($108.25 in chips) 
Kreuznagel: posts small blind $0.50
matiko09: posts big blind $1
IdiotFromNE: sits out 
*** HOLE CARDS ***
Dealt to matiko09 [4s 2h]
oscarleon: folds 
RICKA16: folds 
I The King I: folds 
BOAYARSKIY: raises $1.13 to $2.13
20grodt16: folds 
Kreuznagel: folds 
matiko09: folds 
Uncalled bet ($1.13) returned to BOAYARSKIY
BOAYARSKIY collected $2.50 from pot
BOAYARSKIY: doesn't show hand 
*** SUMMARY ***
Total pot $2.50 | Rake $0 
Seat 1: I The King I folded before Flop (didn't bet)
Seat 2: BOAYARSKIY collected ($2.50)
Seat 3: 20grodt16 (button) folded before Flop (didn't bet)
Seat 5: Kreuznagel (small blind) folded before Flop
Seat 6: matiko09 (big blind) folded before Flop
Seat 8: oscarleon folded before Flop (didn't bet)
Seat 9: RICKA16 folded before Flop (didn't bet)





PokerStars Hand #151207541475:  Hold'em No Limit ($1/$2 USD) - 2016/03/31 12:31:21 CET [2016/03/31 6:31:21 ET]
Table 'Desiderata' 9-max Seat #4 is the button
Seat 1: GALWACONT ($137.75 in chips) 
Seat 2: ilaviiitech ($213.89 in chips) 
Seat 3: djammusic ($80 in chips) 
Seat 4: matiko09 ($333.80 in chips) 
Seat 5: Kreuznagel ($306.74 in chips) 
Seat 6: rmanjkeee ($102.75 in chips) 
Seat 7: apfush ($208.14 in chips) 
Seat 8: DUkalisUA ($207.80 in chips) 
Kreuznagel: posts small blind $1
rmanjkeee: posts big blind $2
Painkiller72: sits out 
*** HOLE CARDS ***
Dealt to matiko09 [2d Th]
apfush: folds 
DUkalisUA: raises $4 to $6
GALWACONT: calls $6
ilaviiitech: folds 
djammusic: folds 
matiko09: folds 
Kreuznagel: folds 
rmanjkeee: folds 
*** FLOP *** [Jh 3d 3h]
DUkalisUA: bets $9.40
GALWACONT: calls $9.40
*** TURN *** [Jh 3d 3h] [7c]
DUkalisUA: bets $24
GALWACONT: calls $24
*** RIVER *** [Jh 3d 3h 7c] [6d]
DUkalisUA: bets $30
GALWACONT: calls $30
*** SHOW DOWN ***
DUkalisUA: shows [Kc Jc] (two pair, Jacks and Threes)
GALWACONT: shows [Js Ah] (two pair, Jacks and Threes - Ace kicker)
GALWACONT collected $139.05 from pot
*** SUMMARY ***
Total pot $141.80 | Rake $2.75 
Board [Jh 3d 3h 7c 6d]
Seat 1: GALWACONT showed [Js Ah] and won ($139.05) with two pair, Jacks and Threes
Seat 2: ilaviiitech folded before Flop (didn't bet)
Seat 3: djammusic folded before Flop (didn't bet)
Seat 4: matiko09 (button) folded before Flop (didn't bet)
Seat 5: Kreuznagel (small blind) folded before Flop
Seat 6: rmanjkeee (big blind) folded before Flop
Seat 7: apfush folded before Flop (didn't bet)
Seat 8: DUkalisUA showed [Kc Jc] and lost with two pair, Jacks and Threes





PokerStars Hand #151207541974:  Hold'em No Limit ($0.50/$1.00 USD) - 2016/03/31 12:31:23 CET [2016/03/31 6:31:23 ET]
Table 'Eugenisis III' 9-max Seat #5 is the button
Seat 1: PacPacBum ($105.72 in chips) 
Seat 2: IdiotFromNE ($101 in chips) 
Seat 3: Avtovo ($168.56 in chips) 
Seat 4: alejo22366 ($63.72 in chips) 
Seat 5: ka100pka527 ($35 in chips) 
Seat 7: djammusic ($40.97 in chips) 
Seat 8: matiko09 ($103.82 in chips) 
djammusic: posts small blind $0.50
matiko09: posts big blind $1
*** HOLE CARDS ***
Dealt to matiko09 [4c 8s]
PacPacBum: folds 
IdiotFromNE: folds 
Avtovo: folds 
alejo22366: folds 
kauff95 leaves the table
ka100pka527: raises $1 to $2
djammusic: folds 
matiko09: folds 
Uncalled bet ($1) returned to ka100pka527
ka100pka527 collected $2.50 from pot
ka100pka527: doesn't show hand 
apfush joins the table at seat #6 
*** SUMMARY ***
Total pot $2.50 | Rake $0 
Seat 1: PacPacBum folded before Flop (didn't bet)
Seat 2: IdiotFromNE folded before Flop (didn't bet)
Seat 3: Avtovo folded before Flop (didn't bet)
Seat 4: alejo22366 folded before Flop (didn't bet)
Seat 5: ka100pka527 (button) collected ($2.50)
Seat 7: djammusic (small blind) folded before Flop
Seat 8: matiko09 (big blind) folded before Flop





PokerStars Hand #151207542668:  Hold'em No Limit (€0.50/€1.00 EUR) - 2016/03/31 12:31:24 CET [2016/03/31 6:31:24 ET]
Table 'Pioneer II' 9-max Seat #6 is the button
Seat 1: Kreuznagel (€100 in chips) 
Seat 2: IdiotFromNE (€128.34 in chips) 
Seat 5: TOTO220773 (€78.50 in chips) 
Seat 6: matiko09 (€101.50 in chips) 
Seat 7: AlKatrone (€121.91 in chips) 
Seat 8: PacPacBum (€100 in chips) 
Seat 9: DUkalisUA (€104.12 in chips) 
AlKatrone: posts small blind €0.50
PacPacBum: posts big blind €1
Painkiller72: sits out 
*** HOLE CARDS ***
Dealt to matiko09 [Kd 5c]
DUkalisUA: folds 
Kreuznagel: folds 
IdiotFromNE: raises €1.50 to €2.50
TOTO220773: calls €2.50
matiko09: folds 
AlKatrone: folds 
PacPacBum: folds 
*** FLOP *** [8h Qs Ks]
Zeeshka joins the table at seat #3 
IdiotFromNE: checks 
TOTO220773: checks 
*** TURN *** [8h Qs Ks] [2d]
IdiotFromNE: checks 
TOTO220773: checks 
*** RIVER *** [8h Qs Ks 2d] [7c]
IdiotFromNE: checks 
TOTO220773: checks 
*** SHOW DOWN ***
IdiotFromNE: shows [Ac Qh] (a pair of Queens)
TOTO220773: mucks hand 
IdiotFromNE collected €6.18 from pot
*** SUMMARY ***
Total pot €6.50 | Rake €0.32 
Board [8h Qs Ks 2d 7c]
Seat 1: Kreuznagel folded before Flop (didn't bet)
Seat 2: IdiotFromNE showed [Ac Qh] and won (€6.18) with a pair of Queens
Seat 5: TOTO220773 mucked [Tc Ts]
Seat 6: matiko09 (button) folded before Flop (didn't bet)
Seat 7: AlKatrone (small blind) folded before Flop
Seat 8: PacPacBum (big blind) folded before Flop
Seat 9: DUkalisUA folded before Flop (didn't bet)





PokerStars Hand #151207542655:  Hold'em No Limit ($0.50/$1.00 USD) - 2016/03/31 12:31:24 CET [2016/03/31 6:31:24 ET]
Table 'Herge II' 9-max Seat #7 is the button
Seat 1: Chiapel ($89.50 in chips) 
Seat 2: DUkalisUA ($101.50 in chips) 
Seat 3: matiko09 ($210.02 in chips) 
Seat 5: I The King I ($111.78 in chips) 
Seat 6: masaytoo ($100 in chips) 
Seat 7: Zeeshka ($123.98 in chips) 
Seat 8: IdiotFromNE ($100 in chips) 
Seat 9: fatstacks122 ($132.10 in chips) 
IdiotFromNE: posts small blind $0.50
fatstacks122: posts big blind $1
Kreuznagel: sits out 
*** HOLE CARDS ***
Dealt to matiko09 [4h 6s]
Chiapel: folds 
DUkalisUA: folds 
matiko09: folds 
I The King I: folds 
masaytoo: folds 
Zeeshka: raises $1.50 to $2.50
IdiotFromNE: folds 
fatstacks122: raises $2.50 to $5
Zeeshka: calls $2.50
*** FLOP *** [2s 8s 9h]
fatstacks122: checks 
Zeeshka: checks 
*** TURN *** [2s 8s 9h] [3s]
fatstacks122: checks 
Zeeshka: checks 
*** RIVER *** [2s 8s 9h 3s] [Ts]
fatstacks122: bets $3.75
Zeeshka: folds 
Uncalled bet ($3.75) returned to fatstacks122
fatstacks122 collected $9.98 from pot
fatstacks122: doesn't show hand 
*** SUMMARY ***
Total pot $10.50 | Rake $0.52 
Board [2s 8s 9h 3s Ts]
Seat 1: Chiapel folded before Flop (didn't bet)
Seat 2: DUkalisUA folded before Flop (didn't bet)
Seat 3: matiko09 folded before Flop (didn't bet)
Seat 5: I The King I folded before Flop (didn't bet)
Seat 6: masaytoo folded before Flop (didn't bet)
Seat 7: Zeeshka (button) folded on the River
Seat 8: IdiotFromNE (small blind) folded before Flop
Seat 9: fatstacks122 (big blind) collected ($9.98)





PokerStars Hand #151207545624:  Hold'em No Limit ($0.50/$1.00 USD) - 2016/03/31 12:31:30 CET [2016/03/31 6:31:30 ET]
Table 'Icarus III' 9-max Seat #1 is the button
Seat 1: IdiotFromNE ($116.65 in chips) 
Seat 3: RICKA16 ($88.88 in chips) 
Seat 4: dizzyryano79 ($33.57 in chips) 
Seat 5: I The King I ($116.75 in chips) 
Seat 6: djammusic ($44.58 in chips) 
Seat 7: oscarleon ($152.63 in chips) 
Seat 8: matiko09 ($100 in chips) 
Seat 9: apfush ($125.46 in chips) 
Painkiller72 will be allowed to play after the button
RICKA16: posts small blind $0.50
dizzyryano79: posts big blind $1
*** HOLE CARDS ***
Dealt to matiko09 [2d Qc]
I The King I: folds 
djammusic: folds 
oscarleon: folds 
matiko09: folds 
apfush: folds 
IdiotFromNE: raises $1.50 to $2.50
RICKA16: folds 
dizzyryano79: folds 
Uncalled bet ($1.50) returned to IdiotFromNE
IdiotFromNE collected $2.50 from pot
IdiotFromNE: doesn't show hand 
*** SUMMARY ***
Total pot $2.50 | Rake $0 
Seat 1: IdiotFromNE (button) collected ($2.50)
Seat 3: RICKA16 (small blind) folded before Flop
Seat 4: dizzyryano79 (big blind) folded before Flop
Seat 5: I The King I folded before Flop (didn't bet)
Seat 6: djammusic folded before Flop (didn't bet)
Seat 7: oscarleon folded before Flop (didn't bet)
Seat 8: matiko09 folded before Flop (didn't bet)
Seat 9: apfush folded before Flop (didn't bet)





PokerStars Hand #151207547514:  Hold'em No Limit ($0.50/$1.00 USD) - 2016/03/31 12:31:34 CET [2016/03/31 6:31:34 ET]
Table 'Aquila' 9-max Seat #7 is the button
Seat 3: laco121 ($51.60 in chips) 
Seat 4: ChrisAAKKQQ ($60.71 in chips) 
Seat 5: adelfaz ($57.82 in chips) 
Seat 6: maxxmeister ($125 in chips) 
Seat 7: PacPacBum ($129.60 in chips) 
Seat 8: matiko09 ($129.46 in chips) 
Seat 9: apfush ($100 in chips) 
matiko09: posts small blind $0.50
apfush: posts big blind $1
laco121: posts the ante $0.20
ChrisAAKKQQ: posts the ante $0.20
adelfaz: posts the ante $0.20
maxxmeister: posts the ante $0.20
PacPacBum: posts the ante $0.20
matiko09: posts the ante $0.20
apfush: posts the ante $0.20
*** HOLE CARDS ***
Dealt to matiko09 [Jh Tc]
laco121: folds 
ChrisAAKKQQ: calls $1
adelfaz: raises $2 to $3
maxxmeister: folds 
PacPacBum: folds 
matiko09: folds 
apfush: folds 
ChrisAAKKQQ: calls $2
*** FLOP *** [3h Jc Jd]
ChrisAAKKQQ: bets $3
adelfaz: calls $3
*** TURN *** [3h Jc Jd] [Kd]
ChrisAAKKQQ: bets $3
adelfaz: folds 
Uncalled bet ($3) returned to ChrisAAKKQQ
ChrisAAKKQQ collected $14.16 from pot
ChrisAAKKQQ: doesn't show hand 
*** SUMMARY ***
Total pot $14.90 | Rake $0.74 
Board [3h Jc Jd Kd]
Seat 3: laco121 folded before Flop (didn't bet)
Seat 4: ChrisAAKKQQ collected ($14.16)
Seat 5: adelfaz folded on the Turn
Seat 6: maxxmeister folded before Flop (didn't bet)
Seat 7: PacPacBum (button) folded before Flop (didn't bet)
Seat 8: matiko09 (small blind) folded before Flop
Seat 9: apfush (big blind) folded before Flop





PokerStars Hand #151207552837:  Hold'em No Limit ($0.50/$1.00 USD) - 2016/03/31 12:31:46 CET [2016/03/31 6:31:46 ET]
Table 'Bussolini III' 9-max Seat #5 is the button
Seat 1: I The King I ($194.96 in chips) 
Seat 2: BOAYARSKIY ($41.50 in chips) 
Seat 3: 20grodt16 ($104.39 in chips) 
Seat 5: Kreuznagel ($124.41 in chips) 
Seat 6: matiko09 ($100 in chips) 
Seat 7: IdiotFromNE ($100 in chips) 
Seat 8: oscarleon ($141.18 in chips) 
Seat 9: RICKA16 ($108.25 in chips) 
matiko09: posts small blind $0.50
IdiotFromNE: posts big blind $1
*** HOLE CARDS ***
Dealt to matiko09 [Jh 2h]
oscarleon: folds 
RICKA16: folds 
I The King I: folds 
BOAYARSKIY: folds 
20grodt16: folds 
Kreuznagel: raises $1.50 to $2.50
matiko09: folds 
IdiotFromNE: raises $6.50 to $9
Kreuznagel: calls $6.50
*** FLOP *** [4s Kc 9s]
IdiotFromNE: bets $8.79
Kreuznagel: folds 
Uncalled bet ($8.79) returned to IdiotFromNE
IdiotFromNE collected $17.58 from pot
IdiotFromNE: doesn't show hand 
*** SUMMARY ***
Total pot $18.50 | Rake $0.92 
Board [4s Kc 9s]
Seat 1: I The King I folded before Flop (didn't bet)
Seat 2: BOAYARSKIY folded before Flop (didn't bet)
Seat 3: 20grodt16 folded before Flop (didn't bet)
Seat 5: Kreuznagel (button) folded on the Flop
Seat 6: matiko09 (small blind) folded before Flop
Seat 7: IdiotFromNE (big blind) collected ($17.58)
Seat 8: oscarleon folded before Flop (didn't bet)
Seat 9: RICKA16 folded before Flop (didn't bet)





PokerStars Hand #151207555612:  Hold'em No Limit ($0.50/$1.00 USD) - 2016/03/31 12:31:52 CET [2016/03/31 6:31:52 ET]
Table 'Eugenisis III' 9-max Seat #7 is the button
Seat 1: PacPacBum ($105.72 in chips) 
Seat 2: IdiotFromNE ($101 in chips) 
Seat 3: Avtovo ($168.56 in chips) 
Seat 4: alejo22366 ($63.72 in chips) 
Seat 5: ka100pka527 ($36.50 in chips) 
Seat 7: djammusic ($40.47 in chips) 
Seat 8: matiko09 ($102.82 in chips) 
matiko09: posts small blind $0.50
PacPacBum: posts big blind $1
apfush: sits out 
*** HOLE CARDS ***
Dealt to matiko09 [7d 3d]
IdiotFromNE: folds 
Avtovo: folds 
alejo22366: folds 
ka100pka527: raises $1 to $2
djammusic: folds 
matiko09: folds 
PacPacBum: folds 
Uncalled bet ($1) returned to ka100pka527
ka100pka527 collected $2.50 from pot
ka100pka527: doesn't show hand 
*** SUMMARY ***
Total pot $2.50 | Rake $0 
Seat 1: PacPacBum (big blind) folded before Flop
Seat 2: IdiotFromNE folded before Flop (didn't bet)
Seat 3: Avtovo folded before Flop (didn't bet)
Seat 4: alejo22366 folded before Flop (didn't bet)
Seat 5: ka100pka527 collected ($2.50)
Seat 7: djammusic (button) folded before Flop (didn't bet)
Seat 8: matiko09 (small blind) folded before Flop





PokerStars Hand #151207559090:  Hold'em No Limit ($0.50/$1.00 USD) - 2016/03/31 12:31:59 CET [2016/03/31 6:31:59 ET]
Table 'Yazhi' 9-max Seat #5 is the button
Seat 1: matiko09 ($100 in chips) 
Seat 2: xHourglass ($100 in chips) 
Seat 3: Chin41178 ($72.74 in chips) 
Seat 4: apfush ($182.96 in chips) 
Seat 5: IdiotFromNE ($103.50 in chips) 
Seat 6: Reven9er ($237.03 in chips) 
Seat 7: Avtovo ($100 in chips) 
Seat 8: pk4DW ($54.20 in chips) 
Seat 9: oscarleon ($203.32 in chips) 
Reven9er: posts small blind $0.50
Avtovo: posts big blind $1
*** HOLE CARDS ***
Dealt to matiko09 [9c 7d]
pk4DW: folds 
oscarleon: folds 
matiko09: folds 
xHourglass: folds 
Chin41178: folds 
apfush: folds 
IdiotFromNE: folds 
Reven9er: raises $1.50 to $2.50
Avtovo: folds 
Uncalled bet ($1.50) returned to Reven9er
Reven9er collected $2 from pot
Reven9er: doesn't show hand 
*** SUMMARY ***
Total pot $2 | Rake $0 
Seat 1: matiko09 folded before Flop (didn't bet)
Seat 2: xHourglass folded before Flop (didn't bet)
Seat 3: Chin41178 folded before Flop (didn't bet)
Seat 4: apfush folded before Flop (didn't bet)
Seat 5: IdiotFromNE (button) folded before Flop (didn't bet)
Seat 6: Reven9er (small blind) collected ($2)
Seat 7: Avtovo (big blind) folded before Flop
Seat 8: pk4DW folded before Flop (didn't bet)
Seat 9: oscarleon folded before Flop (didn't bet)





PokerStars Hand #151207559462:  Hold'em No Limit ($0.50/$1.00 USD) - 2016/03/31 12:32:00 CET [2016/03/31 6:32:00 ET]
Table 'Celestia II' 9-max Seat #8 is the button
Seat 1: matiko09 ($134.12 in chips) 
Seat 3: ilaviiitech ($100 in chips) 
Seat 4: I The King I ($163.59 in chips) 
Seat 5: djammusic ($36.48 in chips) 
Seat 6: IdiotFromNE ($100 in chips) 
Seat 7: Avtovo ($126.50 in chips) 
Seat 8: DUkalisUA ($114.85 in chips) 
Seat 9: Chin41178 ($116.88 in chips) 
Chin41178: posts small blind $0.50
matiko09: posts big blind $1
ka100pka527: sits out 
*** HOLE CARDS ***
Dealt to matiko09 [7s Ah]
ilaviiitech: folds 
I The King I: folds 
djammusic: raises $1.15 to $2.15
IdiotFromNE: calls $2.15
Avtovo: folds 
DUkalisUA: folds 
Chin41178: folds 
matiko09: folds 
*** FLOP *** [Ad 3s Js]
djammusic: checks 
IdiotFromNE: checks 
*** TURN *** [Ad 3s Js] [6d]
djammusic: checks 
IdiotFromNE: checks 
*** RIVER *** [Ad 3s Js 6d] [3h]
djammusic: bets $2.86
IdiotFromNE: calls $2.86
*** SHOW DOWN ***
djammusic: shows [As Tc] (two pair, Aces and Threes)
IdiotFromNE: mucks hand 
djammusic collected $10.94 from pot
*** SUMMARY ***
Total pot $11.52 | Rake $0.58 
Board [Ad 3s Js 6d 3h]
Seat 1: matiko09 (big blind) folded before Flop
Seat 3: ilaviiitech folded before Flop (didn't bet)
Seat 4: I The King I folded before Flop (didn't bet)
Seat 5: djammusic showed [As Tc] and won ($10.94) with two pair, Aces and Threes
Seat 6: IdiotFromNE mucked [Td Th]
Seat 7: Avtovo folded before Flop (didn't bet)
Seat 8: DUkalisUA (button) folded before Flop (didn't bet)
Seat 9: Chin41178 (small blind) folded before Flop





PokerStars Hand #151207564523:  Hold'em No Limit ($0.50/$1.00 USD) - 2016/03/31 12:32:10 CET [2016/03/31 6:32:10 ET]
Table 'Icarus III' 9-max Seat #3 is the button
Seat 1: IdiotFromNE ($118.15 in chips) 
Seat 3: RICKA16 ($100 in chips) 
Seat 4: dizzyryano79 ($32.57 in chips) 
Seat 5: I The King I ($116.75 in chips) 
Seat 6: djammusic ($44.58 in chips) 
Seat 7: oscarleon ($152.63 in chips) 
Seat 8: matiko09 ($100 in chips) 
Seat 9: apfush ($125.46 in chips) 
dizzyryano79: posts small blind $0.50
I The King I: posts big blind $1
Painkiller72: sits out 
*** HOLE CARDS ***
Dealt to matiko09 [Js Ac]
djammusic: folds 
oscarleon: folds 
matiko09: raises $2 to $3
apfush: folds 
IdiotFromNE: folds 
RICKA16: folds 
dizzyryano79: folds 
I The King I: folds 
Uncalled bet ($2) returned to matiko09
matiko09 collected $2.50 from pot
matiko09: doesn't show hand 
*** SUMMARY ***
Total pot $2.50 | Rake $0 
Seat 1: IdiotFromNE folded before Flop (didn't bet)
Seat 3: RICKA16 (button) folded before Flop (didn't bet)
Seat 4: dizzyryano79 (small blind) folded before Flop
Seat 5: I The King I (big blind) folded before Flop
Seat 6: djammusic folded before Flop (didn't bet)
Seat 7: oscarleon folded before Flop (didn't bet)
Seat 8: matiko09 collected ($2.50)
Seat 9: apfush folded before Flop (didn't bet)





PokerStars Hand #151207567541:  Hold'em No Limit ($0.50/$1.00 USD) - 2016/03/31 12:32:17 CET [2016/03/31 6:32:17 ET]
Table 'Aquila' 9-max Seat #8 is the button
Seat 3: laco121 ($51.40 in chips) 
Seat 4: ChrisAAKKQQ ($68.67 in chips) 
Seat 5: adelfaz ($51.62 in chips) 
Seat 6: maxxmeister ($124.80 in chips) 
Seat 7: PacPacBum ($129.40 in chips) 
Seat 8: matiko09 ($128.76 in chips) 
Seat 9: apfush ($100 in chips) 
apfush: posts small blind $0.50
laco121: posts big blind $1
laco121: posts the ante $0.20
ChrisAAKKQQ: posts the ante $0.20
adelfaz: posts the ante $0.20
maxxmeister: posts the ante $0.20
PacPacBum: posts the ante $0.20
matiko09: posts the ante $0.20
apfush: posts the ante $0.20
*** HOLE CARDS ***
Dealt to matiko09 [4s 7h]
ChrisAAKKQQ: folds 
BOAYARSKIY joins the table at seat #1 
adelfaz: raises $3.90 to $4.90
maxxmeister: folds 
PacPacBum: folds 
matiko09: folds 
apfush: folds 
laco121: calls $3.90
*** FLOP *** [As Jd 4c]
Avtovo joins the table at seat #2 
laco121: checks 
adelfaz: bets $11.12
laco121: folds 
Uncalled bet ($11.12) returned to adelfaz
adelfaz collected $11.12 from pot
*** SUMMARY ***
Total pot $11.70 | Rake $0.58 
Board [As Jd 4c]
Seat 3: laco121 (big blind) folded on the Flop
Seat 4: ChrisAAKKQQ folded before Flop (didn't bet)
Seat 5: adelfaz collected ($11.12)
Seat 6: maxxmeister folded before Flop (didn't bet)
Seat 7: PacPacBum folded before Flop (didn't bet)
Seat 8: matiko09 (button) folded before Flop (didn't bet)
Seat 9: apfush (small blind) folded before Flop





PokerStars Hand #151207568567:  Hold'em No Limit ($1/$2 USD) - 2016/03/31 12:32:19 CET [2016/03/31 6:32:19 ET]
Table 'Coelestina II' 9-max Seat #7 is the button
Seat 1: PacPacBum ($207.98 in chips) 
Seat 2: Kreuznagel ($201.46 in chips) 
Seat 3: ilaviiitech ($204.30 in chips) 
Seat 4: matiko09 ($225.21 in chips) 
Seat 6: Avtovo ($211.62 in chips) 
Seat 7: rmanjkeee ($100.74 in chips) 
Seat 8: DUkalisUA ($200 in chips) 
Seat 9: fonng ($192 in chips) 
DUkalisUA: posts small blind $1
fonng: posts big blind $2
Painkiller72: sits out 
*** HOLE CARDS ***
Dealt to matiko09 [Kc As]
PacPacBum: folds 
Kreuznagel: folds 
ilaviiitech: folds 
matiko09: raises $3 to $5
Avtovo: folds 
rmanjkeee: folds 
DUkalisUA: folds 
fonng: calls $3
*** FLOP *** [2s 8s Jc]
fonng: checks 
matiko09: checks 
*** TURN *** [2s 8s Jc] [Qh]
fonng: checks 
matiko09: checks 
*** RIVER *** [2s 8s Jc Qh] [3d]
fonng: checks 
matiko09: checks 
*** SHOW DOWN ***
fonng: shows [Js 9d] (a pair of Jacks)
matiko09: mucks hand 
fonng collected $10.45 from pot
*** SUMMARY ***
Total pot $11 | Rake $0.55 
Board [2s 8s Jc Qh 3d]
Seat 1: PacPacBum folded before Flop (didn't bet)
Seat 2: Kreuznagel folded before Flop (didn't bet)
Seat 3: ilaviiitech folded before Flop (didn't bet)
Seat 4: matiko09 mucked [Kc As]
Seat 6: Avtovo folded before Flop (didn't bet)
Seat 7: rmanjkeee (button) folded before Flop (didn't bet)
Seat 8: DUkalisUA (small blind) folded before Flop
Seat 9: fonng (big blind) showed [Js 9d] and won ($10.45) with a pair of Jacks





PokerStars Hand #151207570740:  Hold'em No Limit ($0.50/$1.00 USD) - 2016/03/31 12:32:24 CET [2016/03/31 6:32:24 ET]
Table 'Eugenisis III' 9-max Seat #8 is the button
Seat 1: PacPacBum ($104.72 in chips) 
Seat 2: IdiotFromNE ($101 in chips) 
Seat 3: Avtovo ($168.56 in chips) 
Seat 4: alejo22366 ($63.72 in chips) 
Seat 5: ka100pka527 ($38 in chips) 
Seat 7: djammusic ($40.47 in chips) 
Seat 8: matiko09 ($102.32 in chips) 
PacPacBum: posts small blind $0.50
IdiotFromNE: posts big blind $1
apfush: sits out 
*** HOLE CARDS ***
Dealt to matiko09 [Kc 3c]
Avtovo: folds 
alejo22366: folds 
Avtovo leaves the table
DUkalisUA joins the table at seat #3 
ka100pka527: raises $2 to $3
djammusic: folds 
matiko09: folds 
PacPacBum: folds 
IdiotFromNE: folds 
Uncalled bet ($2) returned to ka100pka527
ka100pka527 collected $2.50 from pot
ka100pka527: doesn't show hand 
*** SUMMARY ***
Total pot $2.50 | Rake $0 
Seat 1: PacPacBum (small blind) folded before Flop
Seat 2: IdiotFromNE (big blind) folded before Flop
Seat 3: Avtovo folded before Flop (didn't bet)
Seat 4: alejo22366 folded before Flop (didn't bet)
Seat 5: ka100pka527 collected ($2.50)
Seat 7: djammusic folded before Flop (didn't bet)
Seat 8: matiko09 (button) folded before Flop (didn't bet)





PokerStars Hand #151207571286:  Hold'em No Limit (€0.50/€1.00 EUR) - 2016/03/31 12:32:25 CET [2016/03/31 6:32:25 ET]
Table 'Pioneer II' 9-max Seat #7 is the button
Seat 1: Kreuznagel (€100 in chips) 
Seat 2: IdiotFromNE (€132.02 in chips) 
Seat 5: TOTO220773 (€76 in chips) 
Seat 6: matiko09 (€101.50 in chips) 
Seat 7: AlKatrone (€121.41 in chips) 
Seat 8: PacPacBum (€100 in chips) 
Seat 9: DUkalisUA (€104.12 in chips) 
PacPacBum: posts small blind €0.50
DUkalisUA: posts big blind €1
Zeeshka: sits out 
Painkiller72: sits out 
*** HOLE CARDS ***
Dealt to matiko09 [9h 3s]
Kreuznagel: folds 
IdiotFromNE: raises €1.50 to €2.50
TOTO220773: folds 
matiko09: folds 
AlKatrone: folds 
PacPacBum: folds 
DUkalisUA: folds 
Uncalled bet (€1.50) returned to IdiotFromNE
IdiotFromNE collected €2.50 from pot
IdiotFromNE: doesn't show hand 
*** SUMMARY ***
Total pot €2.50 | Rake €0 
Seat 1: Kreuznagel folded before Flop (didn't bet)
Seat 2: IdiotFromNE collected (€2.50)
Seat 5: TOTO220773 folded before Flop (didn't bet)
Seat 6: matiko09 folded before Flop (didn't bet)
Seat 7: AlKatrone (button) folded before Flop (didn't bet)
Seat 8: PacPacBum (small blind) folded before Flop
Seat 9: DUkalisUA (big blind) folded before Flop





PokerStars Hand #151207573474:  Hold'em No Limit ($0.50/$1.00 USD) - 2016/03/31 12:32:29 CET [2016/03/31 6:32:29 ET]
Table 'Yazhi' 9-max Seat #6 is the button
Seat 1: matiko09 ($100 in chips) 
Seat 2: xHourglass ($100 in chips) 
Seat 3: Chin41178 ($72.74 in chips) 
Seat 4: apfush ($182.96 in chips) 
Seat 5: IdiotFromNE ($103.50 in chips) 
Seat 6: Reven9er ($238.03 in chips) 
Seat 7: Avtovo ($100 in chips) 
Seat 8: pk4DW ($54.20 in chips) 
Seat 9: oscarleon ($203.32 in chips) 
Avtovo: posts small blind $0.50
pk4DW: posts big blind $1
*** HOLE CARDS ***
Dealt to matiko09 [2s Ac]
oscarleon: folds 
matiko09: folds 
xHourglass: folds 
Chin41178: folds 
apfush: folds 
IdiotFromNE: folds 
Reven9er: raises $1 to $2
Avtovo: folds 
pk4DW: calls $1
*** FLOP *** [Kc Jh 5h]
pk4DW: checks 
Reven9er: checks 
*** TURN *** [Kc Jh 5h] [Ks]
pk4DW: checks 
Reven9er: bets $1.50
pk4DW: calls $1.50
*** RIVER *** [Kc Jh 5h Ks] [7s]
pk4DW: checks 
Reven9er: bets $4
pk4DW: calls $4
*** SHOW DOWN ***
Reven9er: shows [Ts 8d] (a pair of Kings)
pk4DW: shows [4s 5s] (two pair, Kings and Fives)
pk4DW collected $14.72 from pot
*** SUMMARY ***
Total pot $15.50 | Rake $0.78 
Board [Kc Jh 5h Ks 7s]
Seat 1: matiko09 folded before Flop (didn't bet)
Seat 2: xHourglass folded before Flop (didn't bet)
Seat 3: Chin41178 folded before Flop (didn't bet)
Seat 4: apfush folded before Flop (didn't bet)
Seat 5: IdiotFromNE folded before Flop (didn't bet)
Seat 6: Reven9er (button) showed [Ts 8d] and lost with a pair of Kings
Seat 7: Avtovo (small blind) folded before Flop
Seat 8: pk4DW (big blind) showed [4s 5s] and won ($14.72) with two pair, Kings and Fives
Seat 9: oscarleon folded before Flop (didn't bet)





PokerStars Hand #151207576058:  Hold'em No Limit ($1/$2 USD) - 2016/03/31 12:32:35 CET [2016/03/31 6:32:35 ET]
Table 'Desiderata' 9-max Seat #5 is the button
Seat 1: GALWACONT ($207.40 in chips) 
Seat 2: ilaviiitech ($213.89 in chips) 
Seat 3: djammusic ($80 in chips) 
Seat 4: matiko09 ($333.80 in chips) 
Seat 5: Kreuznagel ($305.74 in chips) 
Seat 6: rmanjkeee ($100.75 in chips) 
Seat 7: apfush ($208.14 in chips) 
Seat 8: DUkalisUA ($200 in chips) 
rmanjkeee: posts small blind $1
apfush: posts big blind $2
Painkiller72: sits out 
*** HOLE CARDS ***
Dealt to matiko09 [Kc Kd]
DUkalisUA: folds 
GALWACONT: calls $2
ilaviiitech: folds 
djammusic: folds 
matiko09: raises $6 to $8
Kreuznagel: folds 
rmanjkeee: folds 
apfush: folds 
GALWACONT: calls $6
*** FLOP *** [3h Th Ks]
GALWACONT: checks 
matiko09: bets $12
GALWACONT: folds 
Uncalled bet ($12) returned to matiko09
matiko09 collected $18.05 from pot
matiko09: doesn't show hand 
*** SUMMARY ***
Total pot $19 | Rake $0.95 
Board [3h Th Ks]
Seat 1: GALWACONT folded on the Flop
Seat 2: ilaviiitech folded before Flop (didn't bet)
Seat 3: djammusic folded before Flop (didn't bet)
Seat 4: matiko09 collected ($18.05)
Seat 5: Kreuznagel (button) folded before Flop (didn't bet)
Seat 6: rmanjkeee (small blind) folded before Flop
Seat 7: apfush (big blind) folded before Flop
Seat 8: DUkalisUA folded before Flop (didn't bet)





PokerStars Hand #151207579455:  Hold'em No Limit ($0.50/$1.00 USD) - 2016/03/31 12:32:42 CET [2016/03/31 6:32:42 ET]
Table 'Icarus III' 9-max Seat #4 is the button
Seat 1: IdiotFromNE ($118.15 in chips) 
Seat 3: RICKA16 ($100 in chips) 
Seat 4: dizzyryano79 ($32.07 in chips) 
Seat 5: I The King I ($115.75 in chips) 
Seat 6: djammusic ($44.58 in chips) 
Seat 7: oscarleon ($152.63 in chips) 
Seat 8: matiko09 ($101.50 in chips) 
Seat 9: apfush ($125.46 in chips) 
I The King I: posts small blind $0.50
djammusic: posts big blind $1
Painkiller72: sits out 
*** HOLE CARDS ***
Dealt to matiko09 [Kd 5h]
oscarleon: folds 
matiko09: folds 
apfush: folds 
IdiotFromNE: folds 
RICKA16: raises $2 to $3
dizzyryano79: folds 
I The King I: folds 
djammusic: raises $5 to $8
RICKA16: folds 
Uncalled bet ($5) returned to djammusic
djammusic collected $6.50 from pot
djammusic: doesn't show hand 
*** SUMMARY ***
Total pot $6.50 | Rake $0 
Seat 1: IdiotFromNE folded before Flop (didn't bet)
Seat 3: RICKA16 folded before Flop
Seat 4: dizzyryano79 (button) folded before Flop (didn't bet)
Seat 5: I The King I (small blind) folded before Flop
Seat 6: djammusic (big blind) collected ($6.50)
Seat 7: oscarleon folded before Flop (didn't bet)
Seat 8: matiko09 folded before Flop (didn't bet)
Seat 9: apfush folded before Flop (didn't bet)





PokerStars Hand #151207582053:  Hold'em No Limit ($0.50/$1.00 USD) - 2016/03/31 12:32:48 CET [2016/03/31 6:32:48 ET]
Table 'Bussolini III' 9-max Seat #6 is the button
Seat 1: I The King I ($194.96 in chips) 
Seat 2: BOAYARSKIY ($41.50 in chips) 
Seat 3: 20grodt16 ($104.39 in chips) 
Seat 5: Kreuznagel ($115.41 in chips) 
Seat 6: matiko09 ($100 in chips) 
Seat 7: IdiotFromNE ($108.58 in chips) 
Seat 8: oscarleon ($141.18 in chips) 
Seat 9: RICKA16 ($108.25 in chips) 
IdiotFromNE: posts small blind $0.50
oscarleon: posts big blind $1
*** HOLE CARDS ***
Dealt to matiko09 [Kc 6s]
RICKA16: raises $2 to $3
I The King I: folds 
BOAYARSKIY: folds 
20grodt16: folds 
Kreuznagel: folds 
matiko09: folds 
IdiotFromNE: folds 
oscarleon: folds 
Uncalled bet ($2) returned to RICKA16
RICKA16 collected $2.50 from pot
RICKA16: doesn't show hand 
*** SUMMARY ***
Total pot $2.50 | Rake $0 
Seat 1: I The King I folded before Flop (didn't bet)
Seat 2: BOAYARSKIY folded before Flop (didn't bet)
Seat 3: 20grodt16 folded before Flop (didn't bet)
Seat 5: Kreuznagel folded before Flop (didn't bet)
Seat 6: matiko09 (button) folded before Flop (didn't bet)
Seat 7: IdiotFromNE (small blind) folded before Flop
Seat 8: oscarleon (big blind) folded before Flop
Seat 9: RICKA16 collected ($2.50)





PokerStars Hand #151207584719:  Hold'em No Limit ($0.50/$1.00 USD) - 2016/03/31 12:32:53 CET [2016/03/31 6:32:53 ET]
Table 'Aquila' 9-max Seat #9 is the button
Seat 3: laco121 ($46.30 in chips) 
Seat 4: ChrisAAKKQQ ($68.47 in chips) 
Seat 5: adelfaz ($57.64 in chips) 
Seat 6: maxxmeister ($124.60 in chips) 
Seat 7: PacPacBum ($129.20 in chips) 
Seat 8: matiko09 ($128.56 in chips) 
Seat 9: apfush ($100 in chips) 
BOAYARSKIY will be allowed to play after the button
Avtovo will be allowed to play after the button
laco121: posts small blind $0.50
ChrisAAKKQQ: posts big blind $1
laco121: posts the ante $0.20
ChrisAAKKQQ: posts the ante $0.20
adelfaz: posts the ante $0.20
maxxmeister: posts the ante $0.20
PacPacBum: posts the ante $0.20
matiko09: posts the ante $0.20
apfush: posts the ante $0.20
*** HOLE CARDS ***
Dealt to matiko09 [7s Ac]
adelfaz: folds 
maxxmeister: folds 
PacPacBum: folds 
matiko09: folds 
apfush: folds 
laco121: folds 
Uncalled bet ($0.50) returned to ChrisAAKKQQ
ChrisAAKKQQ collected $2.40 from pot
ChrisAAKKQQ: doesn't show hand 
*** SUMMARY ***
Total pot $2.40 | Rake $0 
Seat 3: laco121 (small blind) folded before Flop
Seat 4: ChrisAAKKQQ (big blind) collected ($2.40)
Seat 5: adelfaz folded before Flop (didn't bet)
Seat 6: maxxmeister folded before Flop (didn't bet)
Seat 7: PacPacBum folded before Flop (didn't bet)
Seat 8: matiko09 folded before Flop (didn't bet)
Seat 9: apfush (button) folded before Flop (didn't bet)





PokerStars Hand #151207587722:  Hold'em No Limit ($0.50/$1.00 USD) - 2016/03/31 12:32:59 CET [2016/03/31 6:32:59 ET]
Table 'Celestia II' 9-max Seat #9 is the button
Seat 1: matiko09 ($133.12 in chips) 
Seat 2: ka100pka527 ($40 in chips) 
Seat 3: ilaviiitech ($100 in chips) 
Seat 4: I The King I ($163.59 in chips) 
Seat 5: djammusic ($42.41 in chips) 
Seat 6: IdiotFromNE ($100 in chips) 
Seat 7: Avtovo ($126.50 in chips) 
Seat 8: DUkalisUA ($114.85 in chips) 
Seat 9: Chin41178 ($116.38 in chips) 
matiko09: posts small blind $0.50
ka100pka527: posts big blind $1
*** HOLE CARDS ***
Dealt to matiko09 [4c 5c]
ilaviiitech: folds 
I The King I: folds 
djammusic: folds 
IdiotFromNE: folds 
Avtovo: folds 
DUkalisUA: folds 
Chin41178: folds 
matiko09: folds 
Uncalled bet ($0.50) returned to ka100pka527
ka100pka527 collected $1 from pot
ka100pka527: doesn't show hand 
*** SUMMARY ***
Total pot $1 | Rake $0 
Seat 1: matiko09 (small blind) folded before Flop
Seat 2: ka100pka527 (big blind) collected ($1)
Seat 3: ilaviiitech folded before Flop (didn't bet)
Seat 4: I The King I folded before Flop (didn't bet)
Seat 5: djammusic folded before Flop (didn't bet)
Seat 6: IdiotFromNE folded before Flop (didn't bet)
Seat 7: Avtovo folded before Flop (didn't bet)
Seat 8: DUkalisUA folded before Flop (didn't bet)
Seat 9: Chin41178 (button) folded before Flop (didn't bet)





PokerStars Hand #151207589951:  Hold'em No Limit (€0.50/€1.00 EUR) - 2016/03/31 12:33:04 CET [2016/03/31 6:33:04 ET]
Table 'Pioneer II' 9-max Seat #8 is the button
Seat 1: Kreuznagel (€100 in chips) 
Seat 2: IdiotFromNE (€133.52 in chips) 
Seat 5: TOTO220773 (€76 in chips) 
Seat 6: matiko09 (€101.50 in chips) 
Seat 7: AlKatrone (€121.41 in chips) 
Seat 8: PacPacBum (€100 in chips) 
Seat 9: DUkalisUA (€103.12 in chips) 
DUkalisUA: posts small blind €0.50
Kreuznagel: posts big blind €1
Zeeshka: sits out 
Painkiller72: sits out 
*** HOLE CARDS ***
Dealt to matiko09 [6d 7c]
IdiotFromNE: folds 
TOTO220773: folds 
matiko09: folds 
AlKatrone: folds 
PacPacBum: folds 
DUkalisUA: folds 
Uncalled bet (€0.50) returned to Kreuznagel
Kreuznagel collected €1 from pot
Kreuznagel: doesn't show hand 
*** SUMMARY ***
Total pot €1 | Rake €0 
Seat 1: Kreuznagel (big blind) collected (€1)
Seat 2: IdiotFromNE folded before Flop (didn't bet)
Seat 5: TOTO220773 folded before Flop (didn't bet)
Seat 6: matiko09 folded before Flop (didn't bet)
Seat 7: AlKatrone folded before Flop (didn't bet)
Seat 8: PacPacBum (button) folded before Flop (didn't bet)
Seat 9: DUkalisUA (small blind) folded before Flop





PokerStars Hand #151207591352:  Hold'em No Limit ($1/$2 USD) - 2016/03/31 12:33:07 CET [2016/03/31 6:33:07 ET]
Table 'Desiderata' 9-max Seat #6 is the button
Seat 1: GALWACONT ($199.40 in chips) 
Seat 2: ilaviiitech ($213.89 in chips) 
Seat 3: djammusic ($80 in chips) 
Seat 4: matiko09 ($343.85 in chips) 
Seat 5: Kreuznagel ($305.74 in chips) 
Seat 6: rmanjkeee ($99.75 in chips) 
Seat 7: apfush ($206.14 in chips) 
Seat 8: DUkalisUA ($200 in chips) 
apfush: posts small blind $1
DUkalisUA: posts big blind $2
Painkiller72: sits out 
*** HOLE CARDS ***
Dealt to matiko09 [8h 2h]
GALWACONT: folds 
ilaviiitech: folds 
djammusic: folds 
matiko09: folds 
Kreuznagel: raises $3 to $5
rmanjkeee: calls $5
apfush: folds 
DUkalisUA: folds 
*** FLOP *** [5c 9s Kd]
Kreuznagel: checks 
rmanjkeee: bets $8
Kreuznagel: folds 
Uncalled bet ($8) returned to rmanjkeee
rmanjkeee collected $12.35 from pot
rmanjkeee: doesn't show hand 
*** SUMMARY ***
Total pot $13 | Rake $0.65 
Board [5c 9s Kd]
Seat 1: GALWACONT folded before Flop (didn't bet)
Seat 2: ilaviiitech folded before Flop (didn't bet)
Seat 3: djammusic folded before Flop (didn't bet)
Seat 4: matiko09 folded before Flop (didn't bet)
Seat 5: Kreuznagel folded on the Flop
Seat 6: rmanjkeee (button) collected ($12.35)
Seat 7: apfush (small blind) folded before Flop
Seat 8: DUkalisUA (big blind) folded before Flop





PokerStars Hand #151207593380:  Hold'em No Limit ($0.50/$1.00 USD) - 2016/03/31 12:33:12 CET [2016/03/31 6:33:12 ET]
Table 'Aquila' 9-max Seat #3 is the button
Seat 3: laco121 ($45.60 in chips) 
Seat 4: ChrisAAKKQQ ($70.17 in chips) 
Seat 5: adelfaz ($57.44 in chips) 
Seat 6: maxxmeister ($124.40 in chips) 
Seat 7: PacPacBum ($129 in chips) 
Seat 8: matiko09 ($128.36 in chips) 
Seat 9: apfush ($100 in chips) 
ChrisAAKKQQ: posts small blind $0.50
adelfaz: posts big blind $1
BOAYARSKIY: sits out 
Avtovo: sits out 
laco121: posts the ante $0.20
ChrisAAKKQQ: posts the ante $0.20
adelfaz: posts the ante $0.20
maxxmeister: posts the ante $0.20
PacPacBum: posts the ante $0.20
matiko09: posts the ante $0.20
apfush: posts the ante $0.20
*** HOLE CARDS ***
Dealt to matiko09 [Th 4d]
maxxmeister: folds 
PacPacBum: folds 
matiko09: folds 
apfush: folds 
laco121: raises $5 to $6
ChrisAAKKQQ: folds 
adelfaz: folds 
Uncalled bet ($5) returned to laco121
laco121 collected $3.90 from pot
laco121: doesn't show hand 
*** SUMMARY ***
Total pot $3.90 | Rake $0 
Seat 3: laco121 (button) collected ($3.90)
Seat 4: ChrisAAKKQQ (small blind) folded before Flop
Seat 5: adelfaz (big blind) folded before Flop
Seat 6: maxxmeister folded before Flop (didn't bet)
Seat 7: PacPacBum folded before Flop (didn't bet)
Seat 8: matiko09 folded before Flop (didn't bet)
Seat 9: apfush folded before Flop (didn't bet)





PokerStars Hand #151207594804:  Hold'em No Limit ($0.50/$1.00 USD) - 2016/03/31 12:33:15 CET [2016/03/31 6:33:15 ET]
Table 'Eugenisis III' 9-max Seat #1 is the button
Seat 1: PacPacBum ($104.22 in chips) 
Seat 2: IdiotFromNE ($100 in chips) 
Seat 3: DUkalisUA ($100 in chips) 
Seat 4: alejo22366 ($63.72 in chips) 
Seat 5: ka100pka527 ($39.50 in chips) 
Seat 7: djammusic ($40.47 in chips) 
Seat 8: matiko09 ($102.32 in chips) 
IdiotFromNE: posts small blind $0.50
DUkalisUA: posts big blind $1
apfush: sits out 
*** HOLE CARDS ***
Dealt to matiko09 [3s 5h]
alejo22366: folds 
ka100pka527: raises $2 to $3
choupai was removed from the table for failing to post
I The King I joins the table at seat #9 
I The King I leaves the table
djammusic: folds 
matiko09: folds 
PacPacBum: raises $6 to $9
IdiotFromNE: folds 
spgreek joins the table at seat #9 
DUkalisUA: folds 
ka100pka527: raises $30.50 to $39.50 and is all-in
PacPacBum: calls $30.50
*** FLOP *** [4d Ad 8h]
*** TURN *** [4d Ad 8h] [2s]
*** RIVER *** [4d Ad 8h 2s] [9s]
*** SHOW DOWN ***
ka100pka527: shows [9c 9h] (three of a kind, Nines)
PacPacBum: mucks hand 
ka100pka527 collected $78 from pot
*** SUMMARY ***
Total pot $80.50 | Rake $2.50 
Board [4d Ad 8h 2s 9s]
Seat 1: PacPacBum (button) mucked [Ks As]
Seat 2: IdiotFromNE (small blind) folded before Flop
Seat 3: DUkalisUA (big blind) folded before Flop
Seat 4: alejo22366 folded before Flop (didn't bet)
Seat 5: ka100pka527 showed [9c 9h] and won ($78) with three of a kind, Nines
Seat 7: djammusic folded before Flop (didn't bet)
Seat 8: matiko09 folded before Flop (didn't bet)





PokerStars Hand #151207595407:  Hold'em No Limit ($0.50/$1.00 USD) - 2016/03/31 12:33:16 CET [2016/03/31 6:33:16 ET]
Table 'Herge II' 9-max Seat #8 is the button
Seat 1: Chiapel ($89.50 in chips) 
Seat 2: DUkalisUA ($101.50 in chips) 
Seat 3: matiko09 ($210.02 in chips) 
Seat 5: I The King I ($111.78 in chips) 
Seat 6: masaytoo ($100 in chips) 
Seat 7: Zeeshka ($118.98 in chips) 
Seat 8: IdiotFromNE ($100 in chips) 
Seat 9: fatstacks122 ($137.08 in chips) 
fatstacks122: posts small blind $0.50
Chiapel: posts big blind $1
Kreuznagel: sits out 
*** HOLE CARDS ***
Dealt to matiko09 [2d Ac]
DUkalisUA: folds 
matiko09: folds 
I The King I: folds 
masaytoo: raises $2 to $3
Zeeshka: folds 
IdiotFromNE: folds 
fatstacks122: folds 
Chiapel: calls $2
*** FLOP *** [9h 7h Kh]
Chiapel: checks 
masaytoo: checks 
*** TURN *** [9h 7h Kh] [Jd]
Chiapel: bets $6.18
masaytoo: folds 
Uncalled bet ($6.18) returned to Chiapel
Chiapel collected $6.18 from pot
Chiapel: doesn't show hand 
*** SUMMARY ***
Total pot $6.50 | Rake $0.32 
Board [9h 7h Kh Jd]
Seat 1: Chiapel (big blind) collected ($6.18)
Seat 2: DUkalisUA folded before Flop (didn't bet)
Seat 3: matiko09 folded before Flop (didn't bet)
Seat 5: I The King I folded before Flop (didn't bet)
Seat 6: masaytoo folded on the Turn
Seat 7: Zeeshka folded before Flop (didn't bet)
Seat 8: IdiotFromNE (button) folded before Flop (didn't bet)
Seat 9: fatstacks122 (small blind) folded before Flop





PokerStars Hand #151207596638:  Hold'em No Limit ($0.50/$1.00 USD) - 2016/03/31 12:33:18 CET [2016/03/31 6:33:18 ET]
Table 'Icarus III' 9-max Seat #5 is the button
Seat 1: IdiotFromNE ($118.15 in chips) 
Seat 3: RICKA16 ($100 in chips) 
Seat 4: dizzyryano79 ($32.07 in chips) 
Seat 5: I The King I ($115.25 in chips) 
Seat 6: djammusic ($48.08 in chips) 
Seat 7: oscarleon ($152.63 in chips) 
Seat 8: matiko09 ($101.50 in chips) 
Seat 9: apfush ($125.46 in chips) 
djammusic: posts small blind $0.50
oscarleon: posts big blind $1
Painkiller72: sits out 
*** HOLE CARDS ***
Dealt to matiko09 [Ac 4c]
matiko09: folds 
apfush: folds 
IdiotFromNE: folds 
RICKA16: folds 
dizzyryano79: calls $1
I The King I: folds 
djammusic: folds 
oscarleon: checks 
*** FLOP *** [Td Jd Qd]
oscarleon: bets $2
dizzyryano79: folds 
Uncalled bet ($2) returned to oscarleon
oscarleon collected $2.38 from pot
oscarleon: doesn't show hand 
*** SUMMARY ***
Total pot $2.50 | Rake $0.12 
Board [Td Jd Qd]
Seat 1: IdiotFromNE folded before Flop (didn't bet)
Seat 3: RICKA16 folded before Flop (didn't bet)
Seat 4: dizzyryano79 folded on the Flop
Seat 5: I The King I (button) folded before Flop (didn't bet)
Seat 6: djammusic (small blind) folded before Flop
Seat 7: oscarleon (big blind) collected ($2.38)
Seat 8: matiko09 folded before Flop (didn't bet)
Seat 9: apfush folded before Flop (didn't bet)





PokerStars Hand #151207598329:  Hold'em No Limit ($0.50/$1.00 USD) - 2016/03/31 12:33:22 CET [2016/03/31 6:33:22 ET]
Table 'Yazhi' 9-max Seat #7 is the button
Seat 1: matiko09 ($100 in chips) 
Seat 2: xHourglass ($100 in chips) 
Seat 3: Chin41178 ($72.74 in chips) 
Seat 4: apfush ($182.96 in chips) 
Seat 5: IdiotFromNE ($103.50 in chips) 
Seat 6: Reven9er ($230.53 in chips) 
Seat 7: Avtovo ($100 in chips) 
Seat 8: pk4DW ($61.42 in chips) 
Seat 9: oscarleon ($203.32 in chips) 
pk4DW: posts small blind $0.50
oscarleon: posts big blind $1
*** HOLE CARDS ***
Dealt to matiko09 [Jc 3d]
matiko09: folds 
xHourglass: folds 
Chin41178: raises $1 to $2
apfush: folds 
IdiotFromNE: calls $2
Reven9er: folds 
Avtovo: folds 
pk4DW: folds 
oscarleon: calls $1
*** FLOP *** [7c Qs 7d]
oscarleon: checks 
Chin41178: bets $3.09
IdiotFromNE: folds 
oscarleon: calls $3.09
*** TURN *** [7c Qs 7d] [4s]
oscarleon: checks 
Chin41178: checks 
*** RIVER *** [7c Qs 7d 4s] [5s]
oscarleon: checks 
Chin41178: checks 
*** SHOW DOWN ***
oscarleon: shows [6d 6s] (two pair, Sevens and Sixes)
Chin41178: shows [8c 8d] (two pair, Eights and Sevens)
Chin41178 collected $12.05 from pot
*** SUMMARY ***
Total pot $12.68 | Rake $0.63 
Board [7c Qs 7d 4s 5s]
Seat 1: matiko09 folded before Flop (didn't bet)
Seat 2: xHourglass folded before Flop (didn't bet)
Seat 3: Chin41178 showed [8c 8d] and won ($12.05) with two pair, Eights and Sevens
Seat 4: apfush folded before Flop (didn't bet)
Seat 5: IdiotFromNE folded on the Flop
Seat 6: Reven9er folded before Flop (didn't bet)
Seat 7: Avtovo (button) folded before Flop (didn't bet)
Seat 8: pk4DW (small blind) folded before Flop
Seat 9: oscarleon (big blind) showed [6d 6s] and lost with two pair, Sevens and Sixes





PokerStars Hand #151207600543:  Hold'em No Limit ($1/$2 USD) - 2016/03/31 12:33:26 CET [2016/03/31 6:33:26 ET]
Table 'Coelestina II' 9-max Seat #8 is the button
Seat 1: PacPacBum ($207.98 in chips) 
Seat 2: Kreuznagel ($201.46 in chips) 
Seat 3: ilaviiitech ($204.30 in chips) 
Seat 4: matiko09 ($220.21 in chips) 
Seat 6: Avtovo ($211.62 in chips) 
Seat 7: rmanjkeee ($100.74 in chips) 
Seat 8: DUkalisUA ($200 in chips) 
Seat 9: fonng ($197.45 in chips) 
fonng: posts small blind $1
PacPacBum: posts big blind $2
Painkiller72: sits out 
*** HOLE CARDS ***
Dealt to matiko09 [5s Tc]
Kreuznagel: folds 
ilaviiitech: folds 
matiko09: folds 
Avtovo: folds 
rmanjkeee: raises $2 to $4
DUkalisUA: folds 
fonng: folds 
PacPacBum: calls $2
*** FLOP *** [9h 7c Ts]
PacPacBum: checks 
rmanjkeee: checks 
*** TURN *** [9h 7c Ts] [4s]
PacPacBum: checks 
rmanjkeee: bets $6
PacPacBum: raises $14.17 to $20.17
rmanjkeee: folds 
Uncalled bet ($14.17) returned to PacPacBum
PacPacBum collected $19.95 from pot
PacPacBum: doesn't show hand 
*** SUMMARY ***
Total pot $21 | Rake $1.05 
Board [9h 7c Ts 4s]
Seat 1: PacPacBum (big blind) collected ($19.95)
Seat 2: Kreuznagel folded before Flop (didn't bet)
Seat 3: ilaviiitech folded before Flop (didn't bet)
Seat 4: matiko09 folded before Flop (didn't bet)
Seat 6: Avtovo folded before Flop (didn't bet)
Seat 7: rmanjkeee folded on the Turn
Seat 8: DUkalisUA (button) folded before Flop (didn't bet)
Seat 9: fonng (small blind) folded before Flop





PokerStars Hand #151207603214:  Hold'em No Limit (€0.50/€1.00 EUR) - 2016/03/31 12:33:32 CET [2016/03/31 6:33:32 ET]
Table 'Pioneer II' 9-max Seat #9 is the button
Seat 1: Kreuznagel (€100.50 in chips) 
Seat 2: IdiotFromNE (€133.52 in chips) 
Seat 5: TOTO220773 (€76 in chips) 
Seat 6: matiko09 (€101.50 in chips) 
Seat 7: AlKatrone (€121.41 in chips) 
Seat 8: PacPacBum (€100 in chips) 
Seat 9: DUkalisUA (€102.62 in chips) 
Kreuznagel: posts small blind €0.50
IdiotFromNE: posts big blind €1
Zeeshka: sits out 
Painkiller72: sits out 
*** HOLE CARDS ***
Dealt to matiko09 [7h 8s]
TOTO220773: folds 
matiko09: folds 
AlKatrone: raises €2 to €3
PacPacBum: raises €6 to €9
DUkalisUA: folds 
Kreuznagel: folds 
IdiotFromNE: folds 
AlKatrone: raises €14 to €23
PacPacBum: folds 
Uncalled bet (€14) returned to AlKatrone
AlKatrone collected €19.50 from pot
AlKatrone: doesn't show hand 
*** SUMMARY ***
Total pot €19.50 | Rake €0 
Seat 1: Kreuznagel (small blind) folded before Flop
Seat 2: IdiotFromNE (big blind) folded before Flop
Seat 5: TOTO220773 folded before Flop (didn't bet)
Seat 6: matiko09 folded before Flop (didn't bet)
Seat 7: AlKatrone collected (€19.50)
Seat 8: PacPacBum folded before Flop
Seat 9: DUkalisUA (button) folded before Flop (didn't bet)





PokerStars Hand #151207603321:  Hold'em No Limit ($0.50/$1.00 USD) - 2016/03/31 12:33:32 CET [2016/03/31 6:33:32 ET]
Table 'Bussolini III' 9-max Seat #7 is the button
Seat 1: I The King I ($194.96 in chips) 
Seat 2: BOAYARSKIY ($41.50 in chips) 
Seat 3: 20grodt16 ($104.39 in chips) 
Seat 5: Kreuznagel ($115.41 in chips) 
Seat 6: matiko09 ($100 in chips) 
Seat 7: IdiotFromNE ($108.08 in chips) 
Seat 8: oscarleon ($140.18 in chips) 
Seat 9: RICKA16 ($109.75 in chips) 
oscarleon: posts small blind $0.50
RICKA16: posts big blind $1
*** HOLE CARDS ***
Dealt to matiko09 [3s As]
I The King I: folds 
BOAYARSKIY: folds 
20grodt16: folds 
Kreuznagel: raises $1.39 to $2.39
matiko09: raises $6.61 to $9
IdiotFromNE: folds 
oscarleon: folds 
RICKA16: folds 
Kreuznagel: calls $6.61
*** FLOP *** [4h 5s Kc]
Kreuznagel: checks 
matiko09: bets $10
Kreuznagel: calls $10
*** TURN *** [4h 5s Kc] [8s]
Kreuznagel: checks 
matiko09: bets $20
Kreuznagel: folds 
Uncalled bet ($20) returned to matiko09
matiko09 collected $37.52 from pot
matiko09: doesn't show hand 
*** SUMMARY ***
Total pot $39.50 | Rake $1.98 
Board [4h 5s Kc 8s]
Seat 1: I The King I folded before Flop (didn't bet)
Seat 2: BOAYARSKIY folded before Flop (didn't bet)
Seat 3: 20grodt16 folded before Flop (didn't bet)
Seat 5: Kreuznagel folded on the Turn
Seat 6: matiko09 collected ($37.52)
Seat 7: IdiotFromNE (button) folded before Flop (didn't bet)
Seat 8: oscarleon (small blind) folded before Flop
Seat 9: RICKA16 (big blind) folded before Flop





PokerStars Hand #151207606201:  Hold'em No Limit ($0.50/$1.00 USD) - 2016/03/31 12:33:38 CET [2016/03/31 6:33:38 ET]
Table 'Celestia II' 9-max Seat #1 is the button
Seat 1: matiko09 ($132.62 in chips) 
Seat 2: ka100pka527 ($40.50 in chips) 
Seat 4: I The King I ($163.59 in chips) 
Seat 5: djammusic ($42.41 in chips) 
Seat 6: IdiotFromNE ($100 in chips) 
Seat 7: Avtovo ($126.50 in chips) 
Seat 8: DUkalisUA ($114.85 in chips) 
Seat 9: Chin41178 ($116.38 in chips) 
ka100pka527: posts small blind $0.50
ilaviiitech: is sitting out 
I The King I: posts big blind $1
*** HOLE CARDS ***
Dealt to matiko09 [Kc 4h]
djammusic: folds 
IdiotFromNE: folds 
Avtovo: folds 
DUkalisUA: folds 
Chin41178: folds 
ilaviiitech leaves the table
matiko09: folds 
ka100pka527: folds 
Uncalled bet ($0.50) returned to I The King I
I The King I collected $1 from pot
I The King I: doesn't show hand 
*** SUMMARY ***
Total pot $1 | Rake $0 
Seat 1: matiko09 (button) folded before Flop (didn't bet)
Seat 2: ka100pka527 (small blind) folded before Flop
Seat 4: I The King I (big blind) collected ($1)
Seat 5: djammusic folded before Flop (didn't bet)
Seat 6: IdiotFromNE folded before Flop (didn't bet)
Seat 7: Avtovo folded before Flop (didn't bet)
Seat 8: DUkalisUA folded before Flop (didn't bet)
Seat 9: Chin41178 folded before Flop (didn't bet)





PokerStars Hand #151207609324:  Hold'em No Limit ($0.50/$1.00 USD) - 2016/03/31 12:33:45 CET [2016/03/31 6:33:45 ET]
Table 'Aquila' 9-max Seat #4 is the button
Seat 3: laco121 ($48.30 in chips) 
Seat 4: ChrisAAKKQQ ($69.47 in chips) 
Seat 5: adelfaz ($56.24 in chips) 
Seat 6: maxxmeister ($124.20 in chips) 
Seat 7: PacPacBum ($128.80 in chips) 
Seat 8: matiko09 ($128.16 in chips) 
Seat 9: apfush ($100 in chips) 
adelfaz: posts small blind $0.50
maxxmeister: posts big blind $1
BOAYARSKIY: sits out 
Avtovo: sits out 
laco121: posts the ante $0.20
ChrisAAKKQQ: posts the ante $0.20
adelfaz: posts the ante $0.20
maxxmeister: posts the ante $0.20
PacPacBum: posts the ante $0.20
matiko09: posts the ante $0.20
apfush: posts the ante $0.20
*** HOLE CARDS ***
Dealt to matiko09 [5s 8s]
PacPacBum: folds 
matiko09: folds 
apfush: folds 
laco121: folds 
ChrisAAKKQQ: folds 
adelfaz: folds 
Uncalled bet ($0.50) returned to maxxmeister
maxxmeister collected $2.40 from pot
maxxmeister: doesn't show hand 
*** SUMMARY ***
Total pot $2.40 | Rake $0 
Seat 3: laco121 folded before Flop (didn't bet)
Seat 4: ChrisAAKKQQ (button) folded before Flop (didn't bet)
Seat 5: adelfaz (small blind) folded before Flop
Seat 6: maxxmeister (big blind) collected ($2.40)
Seat 7: PacPacBum folded before Flop (didn't bet)
Seat 8: matiko09 folded before Flop (didn't bet)
Seat 9: apfush folded before Flop (didn't bet)





PokerStars Hand #151207614031:  Hold'em No Limit ($0.50/$1.00 USD) - 2016/03/31 12:33:55 CET [2016/03/31 6:33:55 ET]
Table 'Herge II' 9-max Seat #9 is the button
Seat 1: Chiapel ($92.68 in chips) 
Seat 2: DUkalisUA ($101.50 in chips) 
Seat 3: matiko09 ($210.02 in chips) 
Seat 5: I The King I ($111.78 in chips) 
Seat 6: masaytoo ($97 in chips) 
Seat 7: Zeeshka ($118.98 in chips) 
Seat 8: IdiotFromNE ($100 in chips) 
Seat 9: fatstacks122 ($136.58 in chips) 
Chiapel: posts small blind $0.50
DUkalisUA: posts big blind $1
Kreuznagel: sits out 
*** HOLE CARDS ***
Dealt to matiko09 [5h 2c]
matiko09: folds 
I The King I: raises $2 to $3
masaytoo: folds 
Zeeshka: folds 
IdiotFromNE: folds 
fatstacks122: calls $3
Chiapel: folds 
DUkalisUA: folds 
*** FLOP *** [7c 8c 5s]
I The King I: checks 
fatstacks122: checks 
*** TURN *** [7c 8c 5s] [4d]
I The King I: checks 
fatstacks122: bets $3.75
I The King I: calls $3.75
*** RIVER *** [7c 8c 5s 4d] [Ad]
I The King I: checks 
fatstacks122: checks 
*** SHOW DOWN ***
I The King I: shows [Qs Qd] (a pair of Queens)
fatstacks122: mucks hand 
I The King I collected $14.25 from pot
*** SUMMARY ***
Total pot $15 | Rake $0.75 
Board [7c 8c 5s 4d Ad]
Seat 1: Chiapel (small blind) folded before Flop
Seat 2: DUkalisUA (big blind) folded before Flop
Seat 3: matiko09 folded before Flop (didn't bet)
Seat 5: I The King I showed [Qs Qd] and won ($14.25) with a pair of Queens
Seat 6: masaytoo folded before Flop (didn't bet)
Seat 7: Zeeshka folded before Flop (didn't bet)
Seat 8: IdiotFromNE folded before Flop (didn't bet)
Seat 9: fatstacks122 (button) mucked [2s 2d]





PokerStars Hand #151207616166:  Hold'em No Limit ($0.50/$1.00 USD) - 2016/03/31 12:34:00 CET [2016/03/31 6:34:00 ET]
Table 'Aquila' 9-max Seat #5 is the button
Seat 3: laco121 ($48.10 in chips) 
Seat 4: ChrisAAKKQQ ($69.27 in chips) 
Seat 5: adelfaz ($55.54 in chips) 
Seat 6: maxxmeister ($125.90 in chips) 
Seat 7: PacPacBum ($128.60 in chips) 
Seat 8: matiko09 ($127.96 in chips) 
Seat 9: apfush ($100 in chips) 
maxxmeister: posts small blind $0.50
PacPacBum: posts big blind $1
BOAYARSKIY: sits out 
Avtovo: sits out 
laco121: posts the ante $0.20
ChrisAAKKQQ: posts the ante $0.20
adelfaz: posts the ante $0.20
maxxmeister: posts the ante $0.20
PacPacBum: posts the ante $0.20
matiko09: posts the ante $0.20
apfush: posts the ante $0.20
*** HOLE CARDS ***
Dealt to matiko09 [Tc 2c]
matiko09: folds 
apfush: folds 
laco121: raises $2 to $3
ChrisAAKKQQ: folds 
adelfaz: folds 
maxxmeister: folds 
PacPacBum: folds 
Uncalled bet ($2) returned to laco121
laco121 collected $3.90 from pot
laco121: doesn't show hand 
*** SUMMARY ***
Total pot $3.90 | Rake $0 
Seat 3: laco121 collected ($3.90)
Seat 4: ChrisAAKKQQ folded before Flop (didn't bet)
Seat 5: adelfaz (button) folded before Flop (didn't bet)
Seat 6: maxxmeister (small blind) folded before Flop
Seat 7: PacPacBum (big blind) folded before Flop
Seat 8: matiko09 folded before Flop (didn't bet)
Seat 9: apfush folded before Flop (didn't bet)





PokerStars Hand #151207622786:  Hold'em No Limit ($0.50/$1.00 USD) - 2016/03/31 12:34:14 CET [2016/03/31 6:34:14 ET]
Table 'Celestia II' 9-max Seat #2 is the button
Seat 1: matiko09 ($132.62 in chips) 
Seat 2: ka100pka527 ($40 in chips) 
Seat 4: I The King I ($164.09 in chips) 
Seat 6: IdiotFromNE ($100 in chips) 
Seat 7: Avtovo ($126.50 in chips) 
Seat 8: DUkalisUA ($114.85 in chips) 
Seat 9: Chin41178 ($116.38 in chips) 
I The King I: posts small blind $0.50
djammusic: is sitting out 
IdiotFromNE: posts big blind $1
*** HOLE CARDS ***
Dealt to matiko09 [2h 6c]
Avtovo: folds 
Avtovo leaves the table
DUkalisUA: folds 
xHourglass joins the table at seat #7 
Chin41178: folds 
matiko09: folds 
ka100pka527: folds 
I The King I: calls $0.50
IdiotFromNE: raises $2.50 to $3.50
I The King I: calls $2.50
*** FLOP *** [9s Ac As]
xHourglass leaves the table
kauff95 joins the table at seat #3 
I The King I: checks 
xHourglass joins the table at seat #7 
IdiotFromNE: bets $3.32
I The King I: calls $3.32
*** TURN *** [9s Ac As] [7h]
I The King I: checks 
IdiotFromNE: bets $10.36
I The King I: calls $10.36
*** RIVER *** [9s Ac As 7h] [Td]
I The King I: checks 
IdiotFromNE: bets $26.11
I The King I: raises $85.89 to $112
IdiotFromNE: folds 
Uncalled bet ($85.89) returned to I The King I
I The King I collected $84.08 from pot
I The King I: doesn't show hand 
*** SUMMARY ***
Total pot $86.58 | Rake $2.50 
Board [9s Ac As 7h Td]
Seat 1: matiko09 folded before Flop (didn't bet)
Seat 2: ka100pka527 (button) folded before Flop (didn't bet)
Seat 4: I The King I (small blind) collected ($84.08)
Seat 6: IdiotFromNE (big blind) folded on the River
Seat 7: Avtovo folded before Flop (didn't bet)
Seat 8: DUkalisUA folded before Flop (didn't bet)
Seat 9: Chin41178 folded before Flop (didn't bet)





PokerStars Hand #151207623622:  Hold'em No Limit ($0.50/$1.00 USD) - 2016/03/31 12:34:15 CET [2016/03/31 6:34:15 ET]
Table 'Icarus III' 9-max Seat #6 is the button
Seat 1: IdiotFromNE ($118.15 in chips) 
Seat 3: RICKA16 ($100 in chips) 
Seat 4: dizzyryano79 ($31.07 in chips) 
Seat 5: I The King I ($115.25 in chips) 
Seat 6: djammusic ($47.58 in chips) 
Seat 7: oscarleon ($154.01 in chips) 
Seat 8: matiko09 ($101.50 in chips) 
Seat 9: apfush ($125.46 in chips) 
oscarleon: posts small blind $0.50
matiko09: posts big blind $1
Painkiller72: sits out 
*** HOLE CARDS ***
Dealt to matiko09 [6d 8s]
apfush: folds 
IdiotFromNE: folds 
RICKA16: folds 
dizzyryano79: calls $1
I The King I: folds 
djammusic: folds 
oscarleon: folds 
matiko09: checks 
*** FLOP *** [4c Ac Ks]
matiko09: checks 
dizzyryano79: checks 
*** TURN *** [4c Ac Ks] [3s]
matiko09: checks 
dizzyryano79: checks 
*** RIVER *** [4c Ac Ks 3s] [3c]
matiko09: checks 
dizzyryano79: checks 
*** SHOW DOWN ***
matiko09: shows [6d 8s] (a pair of Threes)
dizzyryano79: shows [Jh 7h] (a pair of Threes - Ace+King+Jack kicker)
dizzyryano79 collected $2.38 from pot
*** SUMMARY ***
Total pot $2.50 | Rake $0.12 
Board [4c Ac Ks 3s 3c]
Seat 1: IdiotFromNE folded before Flop (didn't bet)
Seat 3: RICKA16 folded before Flop (didn't bet)
Seat 4: dizzyryano79 showed [Jh 7h] and won ($2.38) with a pair of Threes
Seat 5: I The King I folded before Flop (didn't bet)
Seat 6: djammusic (button) folded before Flop (didn't bet)
Seat 7: oscarleon (small blind) folded before Flop
Seat 8: matiko09 (big blind) showed [6d 8s] and lost with a pair of Threes
Seat 9: apfush folded before Flop (didn't bet)





PokerStars Hand #151207623837:  Hold'em No Limit ($1/$2 USD) - 2016/03/31 12:34:16 CET [2016/03/31 6:34:16 ET]
Table 'Desiderata' 9-max Seat #7 is the button
Seat 1: GALWACONT ($199.40 in chips) 
Seat 2: ilaviiitech ($213.89 in chips) 
Seat 3: djammusic ($80 in chips) 
Seat 4: matiko09 ($343.85 in chips) 
Seat 5: Kreuznagel ($300.74 in chips) 
Seat 6: rmanjkeee ($107.10 in chips) 
Seat 7: apfush ($205.14 in chips) 
Seat 8: DUkalisUA ($200 in chips) 
Seat 9: Painkiller72 ($206 in chips) 
DUkalisUA: posts small blind $1
Painkiller72: posts big blind $2
*** HOLE CARDS ***
Dealt to matiko09 [2c 6s]
GALWACONT: folds 
ilaviiitech: folds 
djammusic: folds 
matiko09: folds 
Kreuznagel: folds 
rmanjkeee: folds 
apfush: raises $2.40 to $4.40
DUkalisUA: folds 
Painkiller72: calls $2.40
*** FLOP *** [5d Qd Ks]
Painkiller72: checks 
apfush: bets $7
Painkiller72: folds 
Uncalled bet ($7) returned to apfush
apfush collected $9.31 from pot
apfush: doesn't show hand 
*** SUMMARY ***
Total pot $9.80 | Rake $0.49 
Board [5d Qd Ks]
Seat 1: GALWACONT folded before Flop (didn't bet)
Seat 2: ilaviiitech folded before Flop (didn't bet)
Seat 3: djammusic folded before Flop (didn't bet)
Seat 4: matiko09 folded before Flop (didn't bet)
Seat 5: Kreuznagel folded before Flop (didn't bet)
Seat 6: rmanjkeee folded before Flop (didn't bet)
Seat 7: apfush (button) collected ($9.31)
Seat 8: DUkalisUA (small blind) folded before Flop
Seat 9: Painkiller72 (big blind) folded on the Flop





PokerStars Hand #151207627140:  Hold'em No Limit ($0.50/$1.00 USD) - 2016/03/31 12:34:23 CET [2016/03/31 6:34:23 ET]
Table 'Eugenisis III' 9-max Seat #2 is the button
Seat 1: PacPacBum ($100 in chips) 
Seat 2: IdiotFromNE ($100 in chips) 
Seat 3: DUkalisUA ($100 in chips) 
Seat 4: alejo22366 ($63.72 in chips) 
Seat 5: ka100pka527 ($78 in chips) 
Seat 7: djammusic ($40.47 in chips) 
Seat 8: matiko09 ($102.32 in chips) 
Seat 9: spgreek ($40 in chips) 
DUkalisUA: posts small blind $0.50
alejo22366: posts big blind $1
apfush: sits out 
spgreek: posts big blind $1
*** HOLE CARDS ***
Dealt to matiko09 [Kc 2s]
ka100pka527: folds 
djammusic: raises $2.50 to $3.50
matiko09: folds 
spgreek: calls $2.50
PacPacBum: folds 
IdiotFromNE: raises $7 to $10.50
DUkalisUA: folds 
alejo22366: folds 
djammusic: folds 
spgreek: calls $7
*** FLOP *** [Ts Jc Qs]
spgreek: checks 
IdiotFromNE: bets $12.35
spgreek: raises $17.15 to $29.50 and is all-in
IdiotFromNE: calls $17.15
*** TURN *** [Ts Jc Qs] [2h]
*** RIVER *** [Ts Jc Qs 2h] [8d]
*** SHOW DOWN ***
spgreek: shows [Ah Kh] (a straight, Ten to Ace)
IdiotFromNE: shows [Kd Ks] (a pair of Kings)
spgreek collected $82.50 from pot
*** SUMMARY ***
Total pot $85 | Rake $2.50 
Board [Ts Jc Qs 2h 8d]
Seat 1: PacPacBum folded before Flop (didn't bet)
Seat 2: IdiotFromNE (button) showed [Kd Ks] and lost with a pair of Kings
Seat 3: DUkalisUA (small blind) folded before Flop
Seat 4: alejo22366 (big blind) folded before Flop
Seat 5: ka100pka527 folded before Flop (didn't bet)
Seat 7: djammusic folded before Flop
Seat 8: matiko09 folded before Flop (didn't bet)
Seat 9: spgreek showed [Ah Kh] and won ($82.50) with a straight, Ten to Ace





PokerStars Hand #151207629548:  Hold'em No Limit ($0.50/$1.00 USD) - 2016/03/31 12:34:28 CET [2016/03/31 6:34:28 ET]
Table 'Aquila' 9-max Seat #6 is the button
Seat 3: laco121 ($50.80 in chips) 
Seat 4: ChrisAAKKQQ ($69.07 in chips) 
Seat 5: adelfaz ($55.34 in chips) 
Seat 6: maxxmeister ($125.20 in chips) 
Seat 7: PacPacBum ($127.40 in chips) 
Seat 8: matiko09 ($127.76 in chips) 
Seat 9: apfush ($100 in chips) 
PacPacBum: posts small blind $0.50
matiko09: posts big blind $1
BOAYARSKIY: sits out 
Avtovo: sits out 
laco121: posts the ante $0.20
ChrisAAKKQQ: posts the ante $0.20
adelfaz: posts the ante $0.20
maxxmeister: posts the ante $0.20
PacPacBum: posts the ante $0.20
matiko09: posts the ante $0.20
apfush: posts the ante $0.20
*** HOLE CARDS ***
Dealt to matiko09 [Tc 5d]
apfush: folds 
laco121: calls $1
ChrisAAKKQQ: raises $2 to $3
adelfaz: folds 
maxxmeister: calls $3
PacPacBum: folds 
matiko09: folds 
laco121: calls $2
*** FLOP *** [6s 3h 5s]
laco121: bets $10
ChrisAAKKQQ: folds 
maxxmeister: folds 
Uncalled bet ($10) returned to laco121
laco121 collected $11.30 from pot
laco121: doesn't show hand 
*** SUMMARY ***
Total pot $11.90 | Rake $0.60 
Board [6s 3h 5s]
Seat 3: laco121 collected ($11.30)
Seat 4: ChrisAAKKQQ folded on the Flop
Seat 5: adelfaz folded before Flop (didn't bet)
Seat 6: maxxmeister (button) folded on the Flop
Seat 7: PacPacBum (small blind) folded before Flop
Seat 8: matiko09 (big blind) folded before Flop
Seat 9: apfush folded before Flop (didn't bet)





PokerStars Hand #151207631121:  Hold'em No Limit ($0.50/$1.00 USD) - 2016/03/31 12:34:31 CET [2016/03/31 6:34:31 ET]
Table 'Yazhi' 9-max Seat #8 is the button
Seat 1: matiko09 ($100 in chips) 
Seat 2: xHourglass ($100 in chips) 
Seat 3: Chin41178 ($79.70 in chips) 
Seat 4: apfush ($182.96 in chips) 
Seat 5: IdiotFromNE ($101.50 in chips) 
Seat 6: Reven9er ($230.53 in chips) 
Seat 7: Avtovo ($100 in chips) 
Seat 8: pk4DW ($60.92 in chips) 
Seat 9: oscarleon ($198.23 in chips) 
oscarleon: posts small blind $0.50
matiko09: posts big blind $1
*** HOLE CARDS ***
Dealt to matiko09 [2c 8s]
xHourglass: folds 
Chin41178: calls $1
apfush: folds 
IdiotFromNE: raises $2.50 to $3.50
Reven9er: folds 
Avtovo: folds 
pk4DW: folds 
oscarleon: folds 
matiko09: folds 
Chin41178: calls $2.50
*** FLOP *** [Tc 5s 5h]
Chin41178: checks 
IdiotFromNE: checks 
*** TURN *** [Tc 5s 5h] [3c]
Chin41178: bets $4.04
IdiotFromNE: calls $4.04
*** RIVER *** [Tc 5s 5h 3c] [4d]
Chin41178: checks 
IdiotFromNE: checks 
*** SHOW DOWN ***
Chin41178: shows [6s 6h] (two pair, Sixes and Fives)
IdiotFromNE: mucks hand 
Chin41178 collected $15.75 from pot
*** SUMMARY ***
Total pot $16.58 | Rake $0.83 
Board [Tc 5s 5h 3c 4d]
Seat 1: matiko09 (big blind) folded before Flop
Seat 2: xHourglass folded before Flop (didn't bet)
Seat 3: Chin41178 showed [6s 6h] and won ($15.75) with two pair, Sixes and Fives
Seat 4: apfush folded before Flop (didn't bet)
Seat 5: IdiotFromNE mucked [Jd Ac]
Seat 6: Reven9er folded before Flop (didn't bet)
Seat 7: Avtovo folded before Flop (didn't bet)
Seat 8: pk4DW (button) folded before Flop (didn't bet)
Seat 9: oscarleon (small blind) folded before Flop





PokerStars Hand #151207632908:  Hold'em No Limit (€0.50/€1.00 EUR) - 2016/03/31 12:34:35 CET [2016/03/31 6:34:35 ET]
Table 'Pioneer II' 9-max Seat #1 is the button
Seat 1: Kreuznagel (€100 in chips) 
Seat 2: IdiotFromNE (€132.52 in chips) 
Seat 3: Zeeshka (€100 in chips) 
Seat 5: TOTO220773 (€76 in chips) 
Seat 6: matiko09 (€101.50 in chips) 
Seat 7: AlKatrone (€131.91 in chips) 
Seat 8: PacPacBum (€100 in chips) 
Seat 9: DUkalisUA (€102.62 in chips) 
IdiotFromNE: posts small blind €0.50
Zeeshka: posts big blind €1
Painkiller72: sits out 
*** HOLE CARDS ***
Dealt to matiko09 [Ah 4c]
TOTO220773: calls €1
matiko09: folds 
AlKatrone: folds 
PacPacBum: raises €3 to €4
DUkalisUA: folds 
Kreuznagel: folds 
IdiotFromNE: folds 
Zeeshka: folds 
TOTO220773: calls €3
*** FLOP *** [Qd Js Jc]
TOTO220773: checks 
PacPacBum: checks 
*** TURN *** [Qd Js Jc] [Ac]
TOTO220773: checks 
PacPacBum: checks 
*** RIVER *** [Qd Js Jc Ac] [2h]
TOTO220773: bets €9
PacPacBum: folds 
Uncalled bet (€9) returned to TOTO220773
TOTO220773 collected €9.02 from pot
TOTO220773: doesn't show hand 
*** SUMMARY ***
Total pot €9.50 | Rake €0.48 
Board [Qd Js Jc Ac 2h]
Seat 1: Kreuznagel (button) folded before Flop (didn't bet)
Seat 2: IdiotFromNE (small blind) folded before Flop
Seat 3: Zeeshka (big blind) folded before Flop
Seat 5: TOTO220773 collected (€9.02)
Seat 6: matiko09 folded before Flop (didn't bet)
Seat 7: AlKatrone folded before Flop (didn't bet)
Seat 8: PacPacBum folded on the River
Seat 9: DUkalisUA folded before Flop (didn't bet)





PokerStars Hand #151207639562:  Hold'em No Limit ($0.50/$1.00 USD) - 2016/03/31 12:34:49 CET [2016/03/31 6:34:49 ET]
Table 'Bussolini III' 9-max Seat #8 is the button
Seat 1: I The King I ($194.96 in chips) 
Seat 2: BOAYARSKIY ($41.50 in chips) 
Seat 3: 20grodt16 ($104.39 in chips) 
Seat 5: Kreuznagel ($100 in chips) 
Seat 6: matiko09 ($118.52 in chips) 
Seat 7: IdiotFromNE ($108.08 in chips) 
Seat 8: oscarleon ($139.68 in chips) 
Seat 9: RICKA16 ($108.75 in chips) 
RICKA16: posts small blind $0.50
I The King I: posts big blind $1
*** HOLE CARDS ***
Dealt to matiko09 [4d 7h]
BOAYARSKIY: folds 
20grodt16: calls $1
Kreuznagel: folds 
matiko09: folds 
IdiotFromNE: folds 
oscarleon: raises $3.50 to $4.50
RICKA16: folds 
I The King I: folds 
20grodt16: calls $3.50
*** FLOP *** [Kc Ah 9d]
20grodt16: checks 
oscarleon: bets $7
20grodt16: calls $7
*** TURN *** [Kc Ah 9d] [Jd]
20grodt16: checks 
oscarleon: bets $17
20grodt16: raises $19 to $36
oscarleon: calls $19
*** RIVER *** [Kc Ah 9d Jd] [5s]
20grodt16: bets $56.89 and is all-in
oscarleon: calls $56.89
*** SHOW DOWN ***
20grodt16: shows [9s 9c] (three of a kind, Nines)
oscarleon: shows [Jh Ac] (two pair, Aces and Jacks)
20grodt16 collected $207.78 from pot
*** SUMMARY ***
Total pot $210.28 | Rake $2.50 
Board [Kc Ah 9d Jd 5s]
Seat 1: I The King I (big blind) folded before Flop
Seat 2: BOAYARSKIY folded before Flop (didn't bet)
Seat 3: 20grodt16 showed [9s 9c] and won ($207.78) with three of a kind, Nines
Seat 5: Kreuznagel folded before Flop (didn't bet)
Seat 6: matiko09 folded before Flop (didn't bet)
Seat 7: IdiotFromNE folded before Flop (didn't bet)
Seat 8: oscarleon (button) showed [Jh Ac] and lost with two pair, Aces and Jacks
Seat 9: RICKA16 (small blind) folded before Flop





PokerStars Hand #151207649917:  Hold'em No Limit ($0.50/$1.00 USD) - 2016/03/31 12:35:11 CET [2016/03/31 6:35:11 ET]
Table 'Icarus III' 9-max Seat #7 is the button
Seat 1: IdiotFromNE ($118.15 in chips) 
Seat 3: RICKA16 ($100 in chips) 
Seat 4: dizzyryano79 ($32.45 in chips) 
Seat 5: I The King I ($115.25 in chips) 
Seat 6: djammusic ($47.58 in chips) 
Seat 7: oscarleon ($153.51 in chips) 
Seat 8: matiko09 ($100.50 in chips) 
Seat 9: apfush ($125.46 in chips) 
matiko09: posts small blind $0.50
apfush: posts big blind $1
Painkiller72: sits out 
*** HOLE CARDS ***
Dealt to matiko09 [5s 9d]
IdiotFromNE: folds 
RICKA16: folds 
dizzyryano79: calls $1
I The King I: folds 
djammusic: folds 
oscarleon: folds 
matiko09: folds 
apfush: checks 
*** FLOP *** [7s Qs 5d]
apfush: checks 
dizzyryano79: checks 
*** TURN *** [7s Qs 5d] [4d]
apfush: checks 
dizzyryano79: bets $1
apfush: folds 
Uncalled bet ($1) returned to dizzyryano79
dizzyryano79 collected $2.38 from pot
dizzyryano79: doesn't show hand 
*** SUMMARY ***
Total pot $2.50 | Rake $0.12 
Board [7s Qs 5d 4d]
Seat 1: IdiotFromNE folded before Flop (didn't bet)
Seat 3: RICKA16 folded before Flop (didn't bet)
Seat 4: dizzyryano79 collected ($2.38)
Seat 5: I The King I folded before Flop (didn't bet)
Seat 6: djammusic folded before Flop (didn't bet)
Seat 7: oscarleon (button) folded before Flop (didn't bet)
Seat 8: matiko09 (small blind) folded before Flop
Seat 9: apfush (big blind) folded on the Turn





PokerStars Hand #151207650476:  Hold'em No Limit ($1/$2 USD) - 2016/03/31 12:35:12 CET [2016/03/31 6:35:12 ET]
Table 'Coelestina II' 9-max Seat #9 is the button
Seat 1: PacPacBum ($217.93 in chips) 
Seat 2: Kreuznagel ($201.46 in chips) 
Seat 3: ilaviiitech ($204.30 in chips) 
Seat 4: matiko09 ($220.21 in chips) 
Seat 6: Avtovo ($211.62 in chips) 
Seat 7: rmanjkeee ($90.74 in chips) 
Seat 8: DUkalisUA ($200 in chips) 
Seat 9: fonng ($196.45 in chips) 
PacPacBum: posts small blind $1
Kreuznagel: posts big blind $2
Painkiller72: sits out 
*** HOLE CARDS ***
Dealt to matiko09 [5h 8c]
ilaviiitech: folds 
matiko09: folds 
Avtovo: folds 
rmanjkeee: raises $3 to $5
DUkalisUA: folds 
fonng has timed out
fonng: folds 
PacPacBum: folds 
Kreuznagel: calls $3
*** FLOP *** [7h 3h 2h]
Kreuznagel: checks 
rmanjkeee: checks 
*** TURN *** [7h 3h 2h] [6c]
Kreuznagel: checks 
rmanjkeee: bets $8
Kreuznagel: raises $20 to $28
rmanjkeee: folds 
Uncalled bet ($20) returned to Kreuznagel
Kreuznagel collected $25.65 from pot
Kreuznagel: doesn't show hand 
*** SUMMARY ***
Total pot $27 | Rake $1.35 
Board [7h 3h 2h 6c]
Seat 1: PacPacBum (small blind) folded before Flop
Seat 2: Kreuznagel (big blind) collected ($25.65)
Seat 3: ilaviiitech folded before Flop (didn't bet)
Seat 4: matiko09 folded before Flop (didn't bet)
Seat 6: Avtovo folded before Flop (didn't bet)
Seat 7: rmanjkeee folded on the Turn
Seat 8: DUkalisUA folded before Flop (didn't bet)
Seat 9: fonng (button) folded before Flop (didn't bet)





PokerStars Hand #151207651466:  Hold'em No Limit ($1/$2 USD) - 2016/03/31 12:35:14 CET [2016/03/31 6:35:14 ET]
Table 'Desiderata' 9-max Seat #8 is the button
Seat 1: GALWACONT ($199.40 in chips) 
Seat 2: ilaviiitech ($213.89 in chips) 
Seat 3: djammusic ($80 in chips) 
Seat 4: matiko09 ($343.85 in chips) 
Seat 5: Kreuznagel ($300.74 in chips) 
Seat 6: rmanjkeee ($107.10 in chips) 
Seat 7: apfush ($210.05 in chips) 
Seat 8: DUkalisUA ($200 in chips) 
Seat 9: Painkiller72 ($201.60 in chips) 
Painkiller72: posts small blind $1
GALWACONT: posts big blind $2
*** HOLE CARDS ***
Dealt to matiko09 [6h Ac]
ilaviiitech: raises $4 to $6
djammusic: folds 
matiko09: folds 
Kreuznagel: folds 
rmanjkeee: folds 
apfush: calls $6
DUkalisUA: folds 
Painkiller72: folds 
GALWACONT: folds 
*** FLOP *** [2h Kc Kd]
ilaviiitech: checks 
apfush: checks 
*** TURN *** [2h Kc Kd] [Td]
ilaviiitech: bets $11.40
apfush: calls $11.40
*** RIVER *** [2h Kc Kd Td] [8s]
ilaviiitech: bets $25.13
apfush: calls $25.13
*** SHOW DOWN ***
ilaviiitech: shows [5h 5d] (two pair, Kings and Fives)
apfush: shows [Ah Kh] (three of a kind, Kings)
apfush collected $85.31 from pot
*** SUMMARY ***
Total pot $88.06 | Rake $2.75 
Board [2h Kc Kd Td 8s]
Seat 1: GALWACONT (big blind) folded before Flop
Seat 2: ilaviiitech showed [5h 5d] and lost with two pair, Kings and Fives
Seat 3: djammusic folded before Flop (didn't bet)
Seat 4: matiko09 folded before Flop (didn't bet)
Seat 5: Kreuznagel folded before Flop (didn't bet)
Seat 6: rmanjkeee folded before Flop (didn't bet)
Seat 7: apfush showed [Ah Kh] and won ($85.31) with three of a kind, Kings
Seat 8: DUkalisUA (button) folded before Flop (didn't bet)
Seat 9: Painkiller72 (small blind) folded before Flop





PokerStars Hand #151207660565:  Hold'em No Limit ($0.50/$1.00 USD) - 2016/03/31 12:35:33 CET [2016/03/31 6:35:33 ET]
Table 'Eugenisis III' 9-max Seat #3 is the button
Seat 1: PacPacBum ($100 in chips) 
Seat 2: IdiotFromNE ($100 in chips) 
Seat 3: DUkalisUA ($100 in chips) 
Seat 4: alejo22366 ($62.72 in chips) 
Seat 5: ka100pka527 ($78 in chips) 
Seat 7: djammusic ($36.97 in chips) 
Seat 8: matiko09 ($102.32 in chips) 
Seat 9: spgreek ($82.50 in chips) 
alejo22366: posts small blind $0.50
ka100pka527: posts big blind $1
apfush: sits out 
*** HOLE CARDS ***
Dealt to matiko09 [7d Td]
djammusic: folds 
matiko09: folds 
spgreek: calls $1
PacPacBum: folds 
IdiotFromNE: folds 
DUkalisUA: raises $3 to $4
alejo22366: folds 
ka100pka527: folds 
spgreek: calls $3
*** FLOP *** [3h Qc 9c]
spgreek: checks 
DUkalisUA: bets $5.95
spgreek: calls $5.95
*** TURN *** [3h Qc 9c] [4c]
spgreek: checks 
DUkalisUA: bets $13.41
spgreek: raises $59.14 to $72.55 and is all-in
DUkalisUA: folds 
Uncalled bet ($59.14) returned to spgreek
spgreek collected $45.81 from pot
spgreek: doesn't show hand 
*** SUMMARY ***
Total pot $48.22 | Rake $2.41 
Board [3h Qc 9c 4c]
Seat 1: PacPacBum folded before Flop (didn't bet)
Seat 2: IdiotFromNE folded before Flop (didn't bet)
Seat 3: DUkalisUA (button) folded on the Turn
Seat 4: alejo22366 (small blind) folded before Flop
Seat 5: ka100pka527 (big blind) folded before Flop
Seat 7: djammusic folded before Flop (didn't bet)
Seat 8: matiko09 folded before Flop (didn't bet)
Seat 9: spgreek collected ($45.81)





PokerStars Hand #151207661745:  Hold'em No Limit (€0.50/€1.00 EUR) - 2016/03/31 12:35:35 CET [2016/03/31 6:35:35 ET]
Table 'Pioneer II' 9-max Seat #2 is the button
Seat 1: Kreuznagel (€100 in chips) 
Seat 2: IdiotFromNE (€132.02 in chips) 
Seat 3: Zeeshka (€100 in chips) 
Seat 4: Painkiller72 (€138.83 in chips) 
Seat 5: TOTO220773 (€81.02 in chips) 
Seat 6: matiko09 (€101.50 in chips) 
Seat 7: AlKatrone (€131.91 in chips) 
Seat 8: PacPacBum (€100 in chips) 
Seat 9: DUkalisUA (€102.62 in chips) 
Zeeshka: posts small blind €0.50
Painkiller72: posts big blind €1
*** HOLE CARDS ***
Dealt to matiko09 [4c Td]
TOTO220773: folds 
matiko09: folds 
AlKatrone: folds 
PacPacBum: folds 
DUkalisUA: raises €2 to €3
Kreuznagel: folds 
IdiotFromNE: folds 
Zeeshka: folds 
Painkiller72: folds 
Uncalled bet (€2) returned to DUkalisUA
DUkalisUA collected €2.50 from pot
DUkalisUA: doesn't show hand 
*** SUMMARY ***
Total pot €2.50 | Rake €0 
Seat 1: Kreuznagel folded before Flop (didn't bet)
Seat 2: IdiotFromNE (button) folded before Flop (didn't bet)
Seat 3: Zeeshka (small blind) folded before Flop
Seat 4: Painkiller72 (big blind) folded before Flop
Seat 5: TOTO220773 folded before Flop (didn't bet)
Seat 6: matiko09 folded before Flop (didn't bet)
Seat 7: AlKatrone folded before Flop (didn't bet)
Seat 8: PacPacBum folded before Flop (didn't bet)
Seat 9: DUkalisUA collected (€2.50)





PokerStars Hand #151207662223:  Hold'em No Limit ($0.50/$1.00 USD) - 2016/03/31 12:35:36 CET [2016/03/31 6:35:36 ET]
Table 'Aquila' 9-max Seat #7 is the button
Seat 3: laco121 ($58.90 in chips) 
Seat 4: ChrisAAKKQQ ($65.87 in chips) 
Seat 5: adelfaz ($55.14 in chips) 
Seat 6: maxxmeister ($122 in chips) 
Seat 7: PacPacBum ($126.70 in chips) 
Seat 8: matiko09 ($126.56 in chips) 
Seat 9: apfush ($100 in chips) 
matiko09: posts small blind $0.50
apfush: posts big blind $1
BOAYARSKIY: sits out 
Avtovo: sits out 
laco121: posts the ante $0.20
ChrisAAKKQQ: posts the ante $0.20
adelfaz: posts the ante $0.20
maxxmeister: posts the ante $0.20
PacPacBum: posts the ante $0.20
matiko09: posts the ante $0.20
apfush: posts the ante $0.20
*** HOLE CARDS ***
Dealt to matiko09 [Jh 8h]
laco121: raises $4 to $5
ChrisAAKKQQ: calls $5
adelfaz: folds 
maxxmeister: folds 
PacPacBum: folds 
matiko09: folds 
apfush: folds 
*** FLOP *** [9s 9d 9h]
laco121: bets $2
ChrisAAKKQQ: calls $2
*** TURN *** [9s 9d 9h] [2d]
laco121: bets $2
ChrisAAKKQQ: raises $8 to $10
laco121: folds 
Uncalled bet ($8) returned to ChrisAAKKQQ
ChrisAAKKQQ collected $19.86 from pot
ChrisAAKKQQ: doesn't show hand 
*** SUMMARY ***
Total pot $20.90 | Rake $1.04 
Board [9s 9d 9h 2d]
Seat 3: laco121 folded on the Turn
Seat 4: ChrisAAKKQQ collected ($19.86)
Seat 5: adelfaz folded before Flop (didn't bet)
Seat 6: maxxmeister folded before Flop (didn't bet)
Seat 7: PacPacBum (button) folded before Flop (didn't bet)
Seat 8: matiko09 (small blind) folded before Flop
Seat 9: apfush (big blind) folded before Flop





PokerStars Hand #151207668792:  Hold'em No Limit ($0.50/$1.00 USD) - 2016/03/31 12:35:50 CET [2016/03/31 6:35:50 ET]
Table 'Yazhi' 9-max Seat #9 is the button
Seat 1: matiko09 ($100 in chips) 
Seat 2: xHourglass ($100 in chips) 
Seat 3: Chin41178 ($87.91 in chips) 
Seat 4: apfush ($182.96 in chips) 
Seat 5: IdiotFromNE ($100 in chips) 
Seat 6: Reven9er ($230.53 in chips) 
Seat 7: Avtovo ($100 in chips) 
Seat 8: pk4DW ($60.92 in chips) 
Seat 9: oscarleon ($197.73 in chips) 
matiko09: posts small blind $0.50
xHourglass: posts big blind $1
*** HOLE CARDS ***
Dealt to matiko09 [6d As]
Chin41178: folds 
apfush: folds 
IdiotFromNE: folds 
Reven9er: raises $1 to $2
Avtovo: folds 
pk4DW: calls $2
oscarleon: folds 
matiko09: folds 
xHourglass: calls $1
*** FLOP *** [Qc Kd 6h]
xHourglass: checks 
Reven9er: checks 
pk4DW: bets $3.09
xHourglass: folds 
Reven9er: raises $6.91 to $10
pk4DW: folds 
Uncalled bet ($6.91) returned to Reven9er
Reven9er collected $12.05 from pot
Reven9er: doesn't show hand 
*** SUMMARY ***
Total pot $12.68 | Rake $0.63 
Board [Qc Kd 6h]
Seat 1: matiko09 (small blind) folded before Flop
Seat 2: xHourglass (big blind) folded on the Flop
Seat 3: Chin41178 folded before Flop (didn't bet)
Seat 4: apfush folded before Flop (didn't bet)
Seat 5: IdiotFromNE folded before Flop (didn't bet)
Seat 6: Reven9er collected ($12.05)
Seat 7: Avtovo folded before Flop (didn't bet)
Seat 8: pk4DW folded on the Flop
Seat 9: oscarleon (button) folded before Flop (didn't bet)





PokerStars Hand #151207670058:  Hold'em No Limit ($0.50/$1.00 USD) - 2016/03/31 12:35:53 CET [2016/03/31 6:35:53 ET]
Table 'Herge II' 9-max Seat #1 is the button
Seat 1: Chiapel ($92.18 in chips) 
Seat 2: DUkalisUA ($100.50 in chips) 
Seat 3: matiko09 ($210.02 in chips) 
Seat 5: I The King I ($119.28 in chips) 
Seat 6: masaytoo ($97 in chips) 
Seat 7: Zeeshka ($118.98 in chips) 
Seat 8: IdiotFromNE ($100 in chips) 
Seat 9: fatstacks122 ($129.83 in chips) 
DUkalisUA: posts small blind $0.50
matiko09: posts big blind $1
Kreuznagel: sits out 
*** HOLE CARDS ***
Dealt to matiko09 [Td Ts]
I The King I: folds 
masaytoo: folds 
Zeeshka: folds 
IdiotFromNE: folds 
fatstacks122: folds 
Chiapel: folds 
DUkalisUA: raises $1.50 to $2.50
matiko09: calls $1.50
*** FLOP *** [Qs 4d Tc]
DUkalisUA: checks 
matiko09: bets $3.09
DUkalisUA: folds 
Uncalled bet ($3.09) returned to matiko09
matiko09 collected $4.75 from pot
matiko09: doesn't show hand 
*** SUMMARY ***
Total pot $5 | Rake $0.25 
Board [Qs 4d Tc]
Seat 1: Chiapel (button) folded before Flop (didn't bet)
Seat 2: DUkalisUA (small blind) folded on the Flop
Seat 3: matiko09 (big blind) collected ($4.75)
Seat 5: I The King I folded before Flop (didn't bet)
Seat 6: masaytoo folded before Flop (didn't bet)
Seat 7: Zeeshka folded before Flop (didn't bet)
Seat 8: IdiotFromNE folded before Flop (didn't bet)
Seat 9: fatstacks122 folded before Flop (didn't bet)





PokerStars Hand #151207670908:  Hold'em No Limit ($0.50/$1.00 USD) - 2016/03/31 12:35:55 CET [2016/03/31 6:35:55 ET]
Table 'Icarus III' 9-max Seat #8 is the button
Seat 1: IdiotFromNE ($118.15 in chips) 
Seat 3: RICKA16 ($100 in chips) 
Seat 4: dizzyryano79 ($33.83 in chips) 
Seat 5: I The King I ($115.25 in chips) 
Seat 6: djammusic ($47.58 in chips) 
Seat 7: oscarleon ($153.51 in chips) 
Seat 8: matiko09 ($100 in chips) 
Seat 9: apfush ($124.46 in chips) 
apfush: posts small blind $0.50
IdiotFromNE: posts big blind $1
Painkiller72: sits out 
*** HOLE CARDS ***
Dealt to matiko09 [Ts Ac]
RICKA16: folds 
dizzyryano79: folds 
I The King I: folds 
djammusic: folds 
oscarleon: folds 
matiko09: raises $1.27 to $2.27
apfush: folds 
IdiotFromNE: calls $1.27
*** FLOP *** [9c Qh 3c]
IdiotFromNE: checks 
matiko09: bets $3.11
IdiotFromNE: folds 
Uncalled bet ($3.11) returned to matiko09
matiko09 collected $4.79 from pot
matiko09: doesn't show hand 
*** SUMMARY ***
Total pot $5.04 | Rake $0.25 
Board [9c Qh 3c]
Seat 1: IdiotFromNE (big blind) folded on the Flop
Seat 3: RICKA16 folded before Flop (didn't bet)
Seat 4: dizzyryano79 folded before Flop (didn't bet)
Seat 5: I The King I folded before Flop (didn't bet)
Seat 6: djammusic folded before Flop (didn't bet)
Seat 7: oscarleon folded before Flop (didn't bet)
Seat 8: matiko09 (button) collected ($4.79)
Seat 9: apfush (small blind) folded before Flop





PokerStars Hand #151207674524:  Hold'em No Limit (€0.50/€1.00 EUR) - 2016/03/31 12:36:02 CET [2016/03/31 6:36:02 ET]
Table 'Pioneer II' 9-max Seat #3 is the button
Seat 1: Kreuznagel (€100 in chips) 
Seat 2: IdiotFromNE (€132.02 in chips) 
Seat 3: Zeeshka (€100 in chips) 
Seat 4: Painkiller72 (€137.83 in chips) 
Seat 5: TOTO220773 (€81.02 in chips) 
Seat 6: matiko09 (€101.50 in chips) 
Seat 7: AlKatrone (€131.91 in chips) 
Seat 8: PacPacBum (€100 in chips) 
Seat 9: DUkalisUA (€104.12 in chips) 
Painkiller72: posts small blind €0.50
TOTO220773: posts big blind €1
*** HOLE CARDS ***
Dealt to matiko09 [8h 3h]
matiko09: folds 
AlKatrone: folds 
PacPacBum: folds 
DUkalisUA: folds 
Kreuznagel: folds 
IdiotFromNE: folds 
Zeeshka: folds 
Painkiller72: raises €2 to €3
TOTO220773: folds 
Uncalled bet (€2) returned to Painkiller72
Painkiller72 collected €2 from pot
Painkiller72: doesn't show hand 
*** SUMMARY ***
Total pot €2 | Rake €0 
Seat 1: Kreuznagel folded before Flop (didn't bet)
Seat 2: IdiotFromNE folded before Flop (didn't bet)
Seat 3: Zeeshka (button) folded before Flop (didn't bet)
Seat 4: Painkiller72 (small blind) collected (€2)
Seat 5: TOTO220773 (big blind) folded before Flop
Seat 6: matiko09 folded before Flop (didn't bet)
Seat 7: AlKatrone folded before Flop (didn't bet)
Seat 8: PacPacBum folded before Flop (didn't bet)
Seat 9: DUkalisUA folded before Flop (didn't bet)





PokerStars Hand #151207681674:  Hold'em No Limit ($0.50/$1.00 USD) - 2016/03/31 12:36:17 CET [2016/03/31 6:36:17 ET]
Table 'Aquila' 9-max Seat #8 is the button
Seat 1: BOAYARSKIY ($60 in chips) 
Seat 3: laco121 ($49.70 in chips) 
Seat 4: ChrisAAKKQQ ($76.53 in chips) 
Seat 5: adelfaz ($54.94 in chips) 
Seat 6: maxxmeister ($121.80 in chips) 
Seat 7: PacPacBum ($126.50 in chips) 
Seat 8: matiko09 ($125.86 in chips) 
Seat 9: apfush ($100 in chips) 
apfush: posts small blind $0.50
BOAYARSKIY: posts big blind $1
Avtovo: sits out 
BOAYARSKIY: posts the ante $0.20
laco121: posts the ante $0.20
ChrisAAKKQQ: posts the ante $0.20
adelfaz: posts the ante $0.20
maxxmeister: posts the ante $0.20
PacPacBum: posts the ante $0.20
matiko09: posts the ante $0.20
apfush: posts the ante $0.20
*** HOLE CARDS ***
Dealt to matiko09 [3d Th]
laco121: calls $1
ChrisAAKKQQ: raises $4 to $5
adelfaz: folds 
maxxmeister: folds 
PacPacBum: folds 
matiko09: folds 
apfush: folds 
BOAYARSKIY: calls $4
laco121: calls $4
*** FLOP *** [Qc 8c Ac]
BOAYARSKIY: checks 
laco121: bets $7
ChrisAAKKQQ: calls $7
BOAYARSKIY: folds 
*** TURN *** [Qc 8c Ac] [Kd]
laco121: bets $7
ChrisAAKKQQ: calls $7
*** RIVER *** [Qc 8c Ac Kd] [Kh]
laco121: bets $7
ChrisAAKKQQ: raises $50.33 to $57.33 and is all-in
laco121: folds 
Uncalled bet ($50.33) returned to ChrisAAKKQQ
ChrisAAKKQQ collected $56.60 from pot
*** SUMMARY ***
Total pot $59.10 | Rake $2.50 
Board [Qc 8c Ac Kd Kh]
Seat 1: BOAYARSKIY (big blind) folded on the Flop
Seat 3: laco121 folded on the River
Seat 4: ChrisAAKKQQ collected ($56.60)
Seat 5: adelfaz folded before Flop (didn't bet)
Seat 6: maxxmeister folded before Flop (didn't bet)
Seat 7: PacPacBum folded before Flop (didn't bet)
Seat 8: matiko09 (button) folded before Flop (didn't bet)
Seat 9: apfush (small blind) folded before Flop





PokerStars Hand #151207685752:  Hold'em No Limit (€0.50/€1.00 EUR) - 2016/03/31 12:36:26 CET [2016/03/31 6:36:26 ET]
Table 'Pioneer II' 9-max Seat #4 is the button
Seat 1: Kreuznagel (€100 in chips) 
Seat 2: IdiotFromNE (€132.02 in chips) 
Seat 3: Zeeshka (€100 in chips) 
Seat 4: Painkiller72 (€138.83 in chips) 
Seat 5: TOTO220773 (€80.02 in chips) 
Seat 6: matiko09 (€101.50 in chips) 
Seat 7: AlKatrone (€131.91 in chips) 
Seat 8: PacPacBum (€100 in chips) 
Seat 9: DUkalisUA (€104.12 in chips) 
TOTO220773: posts small blind €0.50
matiko09: posts big blind €1
*** HOLE CARDS ***
Dealt to matiko09 [Ks 3d]
AlKatrone: folds 
PacPacBum: raises €1.04 to €2.04
DUkalisUA: folds 
Kreuznagel: calls €2.04
IdiotFromNE: folds 
Zeeshka: folds 
Painkiller72: folds 
TOTO220773: calls €1.54
matiko09: folds 
*** FLOP *** [8s 9d 6s]
TOTO220773: checks 
PacPacBum: checks 
Kreuznagel: checks 
*** TURN *** [8s 9d 6s] [6h]
TOTO220773: checks 
PacPacBum: bets €6.76
Kreuznagel: folds 
TOTO220773: folds 
Uncalled bet (€6.76) returned to PacPacBum
PacPacBum collected €6.76 from pot
PacPacBum: doesn't show hand 
*** SUMMARY ***
Total pot €7.12 | Rake €0.36 
Board [8s 9d 6s 6h]
Seat 1: Kreuznagel folded on the Turn
Seat 2: IdiotFromNE folded before Flop (didn't bet)
Seat 3: Zeeshka folded before Flop (didn't bet)
Seat 4: Painkiller72 (button) folded before Flop (didn't bet)
Seat 5: TOTO220773 (small blind) folded on the Turn
Seat 6: matiko09 (big blind) folded before Flop
Seat 7: AlKatrone folded before Flop (didn't bet)
Seat 8: PacPacBum collected (€6.76)
Seat 9: DUkalisUA folded before Flop (didn't bet)





PokerStars Hand #151207691110:  Hold'em No Limit ($0.50/$1.00 USD) - 2016/03/31 12:36:37 CET [2016/03/31 6:36:37 ET]
Table 'Celestia II' 9-max Seat #4 is the button
Seat 1: matiko09 ($132.62 in chips) 
Seat 2: ka100pka527 ($40 in chips) 
Seat 3: kauff95 ($50 in chips) 
Seat 4: I The King I ($204.88 in chips) 
Seat 6: IdiotFromNE ($100 in chips) 
Seat 7: xHourglass ($100 in chips) 
Seat 8: DUkalisUA ($114.85 in chips) 
Seat 9: Chin41178 ($116.38 in chips) 
djammusic will be allowed to play after the button
IdiotFromNE: posts small blind $0.50
xHourglass: posts big blind $1
kauff95: posts big blind $1
*** HOLE CARDS ***
Dealt to matiko09 [3h Qc]
DUkalisUA: raises $2 to $3
Chin41178: folds 
matiko09: folds 
ka100pka527: folds 
kauff95: calls $2
I The King I: folds 
IdiotFromNE: folds 
xHourglass: folds 
*** FLOP *** [2c 8c 2h]
DUkalisUA: bets $4.69
kauff95: raises $4.69 to $9.38
DUkalisUA: calls $4.69
*** TURN *** [2c 8c 2h] [Th]
DUkalisUA: checks 
kauff95: bets $24.95
DUkalisUA: raises $77.52 to $102.47 and is all-in
kauff95: calls $12.67 and is all-in
Uncalled bet ($64.85) returned to DUkalisUA
*** RIVER *** [2c 8c 2h Th] [3c]
*** SHOW DOWN ***
DUkalisUA: shows [Js Jh] (two pair, Jacks and Deuces)
kauff95: mucks hand 
DUkalisUA collected $99 from pot
*** SUMMARY ***
Total pot $101.50 | Rake $2.50 
Board [2c 8c 2h Th 3c]
Seat 1: matiko09 folded before Flop (didn't bet)
Seat 2: ka100pka527 folded before Flop (didn't bet)
Seat 3: kauff95 mucked [Qs Jc]
Seat 4: I The King I (button) folded before Flop (didn't bet)
Seat 6: IdiotFromNE (small blind) folded before Flop
Seat 7: xHourglass (big blind) folded before Flop
Seat 8: DUkalisUA showed [Js Jh] and won ($99) with two pair, Jacks and Deuces
Seat 9: Chin41178 folded before Flop (didn't bet)





PokerStars Hand #151207694077:  Hold'em No Limit ($0.50/$1.00 USD) - 2016/03/31 12:36:43 CET [2016/03/31 6:36:43 ET]
Table 'Haworth II' 9-max Seat #1 is the button
Seat 1: godfrey004 ($103.40 in chips) 
Seat 2: AlKatrone ($130.96 in chips) 
Seat 3: matiko09 ($100 in chips) 
Seat 4: I The King I ($101.50 in chips) 
Seat 5: Kreuznagel ($103.10 in chips) 
Seat 6: Pvsx. ($101.50 in chips) 
Seat 7: mheris ($125.72 in chips) 
Seat 8: oscarleon ($100 in chips) 
Seat 9: Zeeshka ($100 in chips) 
AlKatrone: posts small blind $0.50
matiko09: posts big blind $1
*** HOLE CARDS ***
Dealt to matiko09 [5d 5s]
I The King I: folds 
Kreuznagel: folds 
Pvsx.: folds 
mheris: raises $2 to $3
oscarleon: folds 
Zeeshka: folds 
godfrey004: folds 
AlKatrone: folds 
matiko09: calls $2
*** FLOP *** [7d Qc 7c]
matiko09: checks 
mheris: checks 
*** TURN *** [7d Qc 7c] [4h]
matiko09: checks 
mheris: checks 
*** RIVER *** [7d Qc 7c 4h] [5h]
matiko09: bets $4.02
mheris: folds 
Uncalled bet ($4.02) returned to matiko09
matiko09 collected $6.18 from pot
matiko09: doesn't show hand 
godfrey004 is disconnected 
*** SUMMARY ***
Total pot $6.50 | Rake $0.32 
Board [7d Qc 7c 4h 5h]
Seat 1: godfrey004 (button) folded before Flop (didn't bet)
Seat 2: AlKatrone (small blind) folded before Flop
Seat 3: matiko09 (big blind) collected ($6.18)
Seat 4: I The King I folded before Flop (didn't bet)
Seat 5: Kreuznagel folded before Flop (didn't bet)
Seat 6: Pvsx. folded before Flop (didn't bet)
Seat 7: mheris folded on the River
Seat 8: oscarleon folded before Flop (didn't bet)
Seat 9: Zeeshka folded before Flop (didn't bet)





PokerStars Hand #151207695231:  Hold'em No Limit ($0.50/$1.00 USD) - 2016/03/31 12:36:46 CET [2016/03/31 6:36:46 ET]
Table 'Eugenisis III' 9-max Seat #4 is the button
Seat 1: PacPacBum ($100 in chips) 
Seat 2: IdiotFromNE ($100 in chips) 
Seat 3: DUkalisUA ($100 in chips) 
Seat 4: alejo22366 ($62.22 in chips) 
Seat 5: ka100pka527 ($77 in chips) 
Seat 6: apfush ($100 in chips) 
Seat 7: djammusic ($36.97 in chips) 
Seat 8: matiko09 ($102.32 in chips) 
Seat 9: spgreek ($104.95 in chips) 
ka100pka527: posts small blind $0.50
apfush: posts big blind $1
*** HOLE CARDS ***
Dealt to matiko09 [4d 2d]
djammusic: folds 
matiko09: folds 
spgreek: folds 
PacPacBum: folds 
IdiotFromNE: folds 
DUkalisUA: folds 
alejo22366: folds 
ka100pka527: folds 
Uncalled bet ($0.50) returned to apfush
apfush collected $1 from pot
apfush: doesn't show hand 
*** SUMMARY ***
Total pot $1 | Rake $0 
Seat 1: PacPacBum folded before Flop (didn't bet)
Seat 2: IdiotFromNE folded before Flop (didn't bet)
Seat 3: DUkalisUA folded before Flop (didn't bet)
Seat 4: alejo22366 (button) folded before Flop (didn't bet)
Seat 5: ka100pka527 (small blind) folded before Flop
Seat 6: apfush (big blind) collected ($1)
Seat 7: djammusic folded before Flop (didn't bet)
Seat 8: matiko09 folded before Flop (didn't bet)
Seat 9: spgreek folded before Flop (didn't bet)





PokerStars Hand #151207695672:  Hold'em No Limit ($0.50/$1.00 USD) - 2016/03/31 12:36:47 CET [2016/03/31 6:36:47 ET]
Table 'Herge II' 9-max Seat #2 is the button
Seat 1: Chiapel ($92.18 in chips) 
Seat 2: DUkalisUA ($100 in chips) 
Seat 3: matiko09 ($212.27 in chips) 
Seat 4: Kreuznagel ($100 in chips) 
Seat 5: I The King I ($119.28 in chips) 
Seat 6: masaytoo ($97 in chips) 
Seat 7: Zeeshka ($118.98 in chips) 
Seat 8: IdiotFromNE ($100 in chips) 
Seat 9: fatstacks122 ($129.83 in chips) 
matiko09: posts small blind $0.50
Kreuznagel: posts big blind $1
*** HOLE CARDS ***
Dealt to matiko09 [Kc 3h]
I The King I: raises $2 to $3
masaytoo: folds 
Zeeshka: folds 
IdiotFromNE: folds 
fatstacks122: folds 
Chiapel: folds 
DUkalisUA: folds 
matiko09: folds 
Kreuznagel: folds 
Uncalled bet ($2) returned to I The King I
I The King I collected $2.50 from pot
I The King I: doesn't show hand 
*** SUMMARY ***
Total pot $2.50 | Rake $0 
Seat 1: Chiapel folded before Flop (didn't bet)
Seat 2: DUkalisUA (button) folded before Flop (didn't bet)
Seat 3: matiko09 (small blind) folded before Flop
Seat 4: Kreuznagel (big blind) folded before Flop
Seat 5: I The King I collected ($2.50)
Seat 6: masaytoo folded before Flop (didn't bet)
Seat 7: Zeeshka folded before Flop (didn't bet)
Seat 8: IdiotFromNE folded before Flop (didn't bet)
Seat 9: fatstacks122 folded before Flop (didn't bet)





PokerStars Hand #151207700476:  Hold'em No Limit ($1/$2 USD) - 2016/03/31 12:36:57 CET [2016/03/31 6:36:57 ET]
Table 'Coelestina II' 9-max Seat #1 is the button
Seat 1: PacPacBum ($216.93 in chips) 
Seat 2: Kreuznagel ($214.11 in chips) 
Seat 3: ilaviiitech ($204.30 in chips) 
Seat 4: matiko09 ($220.21 in chips) 
Seat 6: Avtovo ($211.62 in chips) 
Seat 7: rmanjkeee ($80 in chips) 
Seat 8: DUkalisUA ($200 in chips) 
Seat 9: fonng ($196.45 in chips) 
Kreuznagel: posts small blind $1
ilaviiitech: posts big blind $2
Painkiller72: sits out 
*** HOLE CARDS ***
Dealt to matiko09 [6d 4d]
matiko09: folds 
Avtovo: folds 
rmanjkeee: folds 
DUkalisUA: folds 
fonng: calls $2
PacPacBum: raises $6 to $8
Kreuznagel: folds 
ilaviiitech: folds 
fonng: folds 
Uncalled bet ($6) returned to PacPacBum
PacPacBum collected $7 from pot
PacPacBum: doesn't show hand 
*** SUMMARY ***
Total pot $7 | Rake $0 
Seat 1: PacPacBum (button) collected ($7)
Seat 2: Kreuznagel (small blind) folded before Flop
Seat 3: ilaviiitech (big blind) folded before Flop
Seat 4: matiko09 folded before Flop (didn't bet)
Seat 6: Avtovo folded before Flop (didn't bet)
Seat 7: rmanjkeee folded before Flop (didn't bet)
Seat 8: DUkalisUA folded before Flop (didn't bet)
Seat 9: fonng folded before Flop





PokerStars Hand #151207701145:  Hold'em No Limit ($0.50/$1.00 USD) - 2016/03/31 12:36:58 CET [2016/03/31 6:36:58 ET]
Table 'Yazhi' 9-max Seat #1 is the button
Seat 1: matiko09 ($100 in chips) 
Seat 2: xHourglass ($100 in chips) 
Seat 3: Chin41178 ($87.91 in chips) 
Seat 4: apfush ($182.96 in chips) 
Seat 5: IdiotFromNE ($100 in chips) 
Seat 6: Reven9er ($237.49 in chips) 
Seat 7: Avtovo ($100 in chips) 
Seat 8: pk4DW ($55.83 in chips) 
Seat 9: oscarleon ($197.73 in chips) 
xHourglass: posts small blind $0.50
Chin41178: posts big blind $1
*** HOLE CARDS ***
Dealt to matiko09 [Jd 2d]
apfush: folds 
IdiotFromNE: folds 
Reven9er: folds 
Avtovo: folds 
pk4DW: folds 
oscarleon: folds 
matiko09: raises $1.27 to $2.27
xHourglass: calls $1.77
Chin41178: folds 
*** FLOP *** [Ah 9h Jc]
xHourglass: checks 
matiko09: checks 
*** TURN *** [Ah 9h Jc] [3d]
xHourglass: bets $3.50
matiko09: calls $3.50
*** RIVER *** [Ah 9h Jc 3d] [Ts]
xHourglass: checks 
matiko09: checks 
*** SHOW DOWN ***
xHourglass: shows [Ad 8h] (a pair of Aces)
matiko09: mucks hand 
xHourglass collected $11.91 from pot
*** SUMMARY ***
Total pot $12.54 | Rake $0.63 
Board [Ah 9h Jc 3d Ts]
Seat 1: matiko09 (button) mucked [Jd 2d]
Seat 2: xHourglass (small blind) showed [Ad 8h] and won ($11.91) with a pair of Aces
Seat 3: Chin41178 (big blind) folded before Flop
Seat 4: apfush folded before Flop (didn't bet)
Seat 5: IdiotFromNE folded before Flop (didn't bet)
Seat 6: Reven9er folded before Flop (didn't bet)
Seat 7: Avtovo folded before Flop (didn't bet)
Seat 8: pk4DW folded before Flop (didn't bet)
Seat 9: oscarleon folded before Flop (didn't bet)





PokerStars Hand #151207701243:  Hold'em No Limit ($0.50/$1.00 USD) - 2016/03/31 12:36:58 CET [2016/03/31 6:36:58 ET]
Table 'Icarus III' 9-max Seat #9 is the button
Seat 1: IdiotFromNE ($115.88 in chips) 
Seat 2: Painkiller72 ($100 in chips) 
Seat 3: RICKA16 ($100 in chips) 
Seat 4: dizzyryano79 ($33.83 in chips) 
Seat 5: I The King I ($115.25 in chips) 
Seat 6: djammusic ($47.58 in chips) 
Seat 7: oscarleon ($153.51 in chips) 
Seat 8: matiko09 ($102.52 in chips) 
Seat 9: apfush ($123.96 in chips) 
IdiotFromNE: posts small blind $0.50
Painkiller72: posts big blind $1
*** HOLE CARDS ***
Dealt to matiko09 [Td 6h]
RICKA16: raises $2 to $3
dizzyryano79: folds 
I The King I: folds 
djammusic: folds 
oscarleon: calls $3
matiko09: folds 
apfush: folds 
IdiotFromNE: folds 
Painkiller72: calls $2
*** FLOP *** [6d Jc 4h]
Painkiller72: checks 
RICKA16: bets $7
oscarleon: folds 
Painkiller72: folds 
Uncalled bet ($7) returned to RICKA16
RICKA16 collected $9.02 from pot
RICKA16: doesn't show hand 
*** SUMMARY ***
Total pot $9.50 | Rake $0.48 
Board [6d Jc 4h]
Seat 1: IdiotFromNE (small blind) folded before Flop
Seat 2: Painkiller72 (big blind) folded on the Flop
Seat 3: RICKA16 collected ($9.02)
Seat 4: dizzyryano79 folded before Flop (didn't bet)
Seat 5: I The King I folded before Flop (didn't bet)
Seat 6: djammusic folded before Flop (didn't bet)
Seat 7: oscarleon folded on the Flop
Seat 8: matiko09 folded before Flop (didn't bet)
Seat 9: apfush (button) folded before Flop (didn't bet)





PokerStars Hand #151207703488:  Hold'em No Limit ($0.50/$1.00 USD) - 2016/03/31 12:37:03 CET [2016/03/31 6:37:03 ET]
Table 'Bussolini III' 9-max Seat #9 is the button
Seat 1: I The King I ($193.96 in chips) 
Seat 2: BOAYARSKIY ($41.50 in chips) 
Seat 3: 20grodt16 ($207.78 in chips) 
Seat 5: Kreuznagel ($100 in chips) 
Seat 6: matiko09 ($118.52 in chips) 
Seat 7: IdiotFromNE ($108.08 in chips) 
Seat 8: oscarleon ($100 in chips) 
Seat 9: RICKA16 ($108.25 in chips) 
I The King I: posts small blind $0.50
BOAYARSKIY: posts big blind $1
*** HOLE CARDS ***
Dealt to matiko09 [8s 2c]
20grodt16: calls $1
Kreuznagel: folds 
matiko09: folds 
IdiotFromNE: folds 
oscarleon: folds 
RICKA16: raises $2 to $3
I The King I: folds 
BOAYARSKIY: folds 
20grodt16: calls $2
*** FLOP *** [Qs 2h 6c]
20grodt16: bets $3.56
RICKA16: raises $5.44 to $9
20grodt16: folds 
Uncalled bet ($5.44) returned to RICKA16
RICKA16 collected $13.89 from pot
RICKA16: doesn't show hand 
*** SUMMARY ***
Total pot $14.62 | Rake $0.73 
Board [Qs 2h 6c]
Seat 1: I The King I (small blind) folded before Flop
Seat 2: BOAYARSKIY (big blind) folded before Flop
Seat 3: 20grodt16 folded on the Flop
Seat 5: Kreuznagel folded before Flop (didn't bet)
Seat 6: matiko09 folded before Flop (didn't bet)
Seat 7: IdiotFromNE folded before Flop (didn't bet)
Seat 8: oscarleon folded before Flop (didn't bet)
Seat 9: RICKA16 (button) collected ($13.89)





PokerStars Hand #151207704398:  Hold'em No Limit ($1/$2 USD) - 2016/03/31 12:37:05 CET [2016/03/31 6:37:05 ET]
Table 'Desiderata' 9-max Seat #9 is the button
Seat 1: GALWACONT ($197.40 in chips) 
Seat 2: ilaviiitech ($200 in chips) 
Seat 3: djammusic ($80 in chips) 
Seat 4: matiko09 ($343.85 in chips) 
Seat 5: Kreuznagel ($300.74 in chips) 
Seat 6: rmanjkeee ($107.10 in chips) 
Seat 7: apfush ($252.83 in chips) 
Seat 8: DUkalisUA ($200 in chips) 
Seat 9: Painkiller72 ($200.60 in chips) 
GALWACONT: posts small blind $1
ilaviiitech: posts big blind $2
*** HOLE CARDS ***
Dealt to matiko09 [8s As]
djammusic: folds 
matiko09: folds 
Kreuznagel: folds 
rmanjkeee: folds 
apfush: raises $4 to $6
DUkalisUA: folds 
Painkiller72: folds 
GALWACONT: folds 
ilaviiitech: folds 
Uncalled bet ($4) returned to apfush
apfush collected $5 from pot
apfush: doesn't show hand 
*** SUMMARY ***
Total pot $5 | Rake $0 
Seat 1: GALWACONT (small blind) folded before Flop
Seat 2: ilaviiitech (big blind) folded before Flop
Seat 3: djammusic folded before Flop (didn't bet)
Seat 4: matiko09 folded before Flop (didn't bet)
Seat 5: Kreuznagel folded before Flop (didn't bet)
Seat 6: rmanjkeee folded before Flop (didn't bet)
Seat 7: apfush collected ($5)
Seat 8: DUkalisUA folded before Flop (didn't bet)
Seat 9: Painkiller72 (button) folded before Flop (didn't bet)





PokerStars Hand #151207712976:  Hold'em No Limit (€0.50/€1.00 EUR) - 2016/03/31 12:37:22 CET [2016/03/31 6:37:22 ET]
Table 'Pioneer II' 9-max Seat #5 is the button
Seat 1: Kreuznagel (€100 in chips) 
Seat 2: IdiotFromNE (€132.02 in chips) 
Seat 3: Zeeshka (€100 in chips) 
Seat 4: Painkiller72 (€138.83 in chips) 
Seat 5: TOTO220773 (€77.98 in chips) 
Seat 6: matiko09 (€100.50 in chips) 
Seat 7: AlKatrone (€131.91 in chips) 
Seat 8: PacPacBum (€104.72 in chips) 
Seat 9: DUkalisUA (€104.12 in chips) 
matiko09: posts small blind €0.50
AlKatrone: posts big blind €1
*** HOLE CARDS ***
Dealt to matiko09 [Kh As]
PacPacBum: folds 
DUkalisUA: folds 
Kreuznagel: folds 
IdiotFromNE: folds 
Zeeshka: raises €2 to €3
Painkiller72: folds 
TOTO220773: folds 
matiko09: raises €7 to €10
AlKatrone: folds 
Zeeshka: folds 
Uncalled bet (€7) returned to matiko09
matiko09 collected €7 from pot
matiko09: doesn't show hand 
*** SUMMARY ***
Total pot €7 | Rake €0 
Seat 1: Kreuznagel folded before Flop (didn't bet)
Seat 2: IdiotFromNE folded before Flop (didn't bet)
Seat 3: Zeeshka folded before Flop
Seat 4: Painkiller72 folded before Flop (didn't bet)
Seat 5: TOTO220773 (button) folded before Flop (didn't bet)
Seat 6: matiko09 (small blind) collected (€7)
Seat 7: AlKatrone (big blind) folded before Flop
Seat 8: PacPacBum folded before Flop (didn't bet)
Seat 9: DUkalisUA folded before Flop (didn't bet)





PokerStars Hand #151207715144:  Hold'em No Limit ($0.50/$1.00 USD) - 2016/03/31 12:37:27 CET [2016/03/31 6:37:27 ET]
Table 'Herge II' 9-max Seat #3 is the button
Seat 1: Chiapel ($92.18 in chips) 
Seat 2: DUkalisUA ($100 in chips) 
Seat 3: matiko09 ($211.77 in chips) 
Seat 4: Kreuznagel ($100 in chips) 
Seat 5: I The King I ($120.78 in chips) 
Seat 6: masaytoo ($97 in chips) 
Seat 7: Zeeshka ($118.98 in chips) 
Seat 8: IdiotFromNE ($100 in chips) 
Seat 9: fatstacks122 ($129.83 in chips) 
Kreuznagel: posts small blind $0.50
I The King I: posts big blind $1
*** HOLE CARDS ***
Dealt to matiko09 [8h 5c]
masaytoo: folds 
Zeeshka: raises $2 to $3
IdiotFromNE: folds 
fatstacks122: folds 
Chiapel: folds 
DUkalisUA: folds 
matiko09: folds 
Kreuznagel: raises $7 to $10
I The King I: folds 
Zeeshka: calls $7
*** FLOP *** [3s Jc Tc]
Kreuznagel: checks 
Zeeshka: bets $13.36
Kreuznagel: calls $13.36
*** TURN *** [3s Jc Tc] [Ac]
Kreuznagel: checks 
Zeeshka: checks 
*** RIVER *** [3s Jc Tc Ac] [Kc]
Kreuznagel: checks 
Zeeshka: bets $22
Kreuznagel: folds 
Uncalled bet ($22) returned to Zeeshka
Zeeshka collected $45.33 from pot
Zeeshka: doesn't show hand 
*** SUMMARY ***
Total pot $47.72 | Rake $2.39 
Board [3s Jc Tc Ac Kc]
Seat 1: Chiapel folded before Flop (didn't bet)
Seat 2: DUkalisUA folded before Flop (didn't bet)
Seat 3: matiko09 (button) folded before Flop (didn't bet)
Seat 4: Kreuznagel (small blind) folded on the River
Seat 5: I The King I (big blind) folded before Flop
Seat 6: masaytoo folded before Flop (didn't bet)
Seat 7: Zeeshka collected ($45.33)
Seat 8: IdiotFromNE folded before Flop (didn't bet)
Seat 9: fatstacks122 folded before Flop (didn't bet)





PokerStars Hand #151207717033:  Hold'em No Limit ($0.50/$1.00 USD) - 2016/03/31 12:37:31 CET [2016/03/31 6:37:31 ET]
Table 'Aquila' 9-max Seat #9 is the button
Seat 1: BOAYARSKIY ($54.80 in chips) 
Seat 2: Avtovo ($100 in chips) 
Seat 3: laco121 ($23.50 in chips) 
Seat 4: ChrisAAKKQQ ($106.93 in chips) 
Seat 5: adelfaz ($54.74 in chips) 
Seat 6: maxxmeister ($121.60 in chips) 
Seat 7: PacPacBum ($126.30 in chips) 
Seat 8: matiko09 ($125.66 in chips) 
Seat 9: apfush ($100 in chips) 
BOAYARSKIY: posts small blind $0.50
Avtovo: posts big blind $1
BOAYARSKIY: posts the ante $0.20
Avtovo: posts the ante $0.20
laco121: posts the ante $0.20
ChrisAAKKQQ: posts the ante $0.20
adelfaz: posts the ante $0.20
maxxmeister: posts the ante $0.20
PacPacBum: posts the ante $0.20
matiko09: posts the ante $0.20
apfush: posts the ante $0.20
*** HOLE CARDS ***
Dealt to matiko09 [8s 9s]
laco121: calls $1
ChrisAAKKQQ: folds 
adelfaz: folds 
maxxmeister: folds 
PacPacBum: folds 
matiko09: raises $2 to $3
apfush: folds 
BOAYARSKIY: folds 
Avtovo: folds 
laco121: calls $2
*** FLOP *** [Tc 8d 2h]
laco121: checks 
matiko09: checks 
*** TURN *** [Tc 8d 2h] [9h]
laco121: bets $3
matiko09: raises $18 to $21
laco121: calls $17.30 and is all-in
Uncalled bet ($0.70) returned to matiko09
*** RIVER *** [Tc 8d 2h 9h] [3c]
*** SHOW DOWN ***
laco121: shows [7s Js] (a straight, Seven to Jack)
matiko09: mucks hand 
laco121 collected $47.40 from pot
*** SUMMARY ***
Total pot $49.90 | Rake $2.50 
Board [Tc 8d 2h 9h 3c]
Seat 1: BOAYARSKIY (small blind) folded before Flop
Seat 2: Avtovo (big blind) folded before Flop
Seat 3: laco121 showed [7s Js] and won ($47.40) with a straight, Seven to Jack
Seat 4: ChrisAAKKQQ folded before Flop (didn't bet)
Seat 5: adelfaz folded before Flop (didn't bet)
Seat 6: maxxmeister folded before Flop (didn't bet)
Seat 7: PacPacBum folded before Flop (didn't bet)
Seat 8: matiko09 mucked [8s 9s]
Seat 9: apfush (button) folded before Flop (didn't bet)





PokerStars Hand #151207719091:  Hold'em No Limit ($0.50/$1.00 USD) - 2016/03/31 12:37:35 CET [2016/03/31 6:37:35 ET]
Table 'Celestia II' 9-max Seat #6 is the button
Seat 1: matiko09 ($132.62 in chips) 
Seat 2: ka100pka527 ($40 in chips) 
Seat 4: I The King I ($204.88 in chips) 
Seat 6: IdiotFromNE ($100 in chips) 
Seat 7: xHourglass ($100 in chips) 
Seat 8: DUkalisUA ($163.85 in chips) 
Seat 9: Chin41178 ($116.38 in chips) 
xHourglass: posts small blind $0.50
DUkalisUA: posts big blind $1
djammusic: sits out 
*** HOLE CARDS ***
Dealt to matiko09 [3h 6s]
kauff95 leaves the table
Chin41178: folds 
matiko09: folds 
ka100pka527: folds 
I The King I: folds 
IdiotFromNE: folds 
CBrownBear joins the table at seat #3 
xHourglass: calls $0.50
DUkalisUA: checks 
*** FLOP *** [9c 3d Qh]
xHourglass: checks 
DUkalisUA: checks 
*** TURN *** [9c 3d Qh] [Ts]
xHourglass: checks 
DUkalisUA: checks 
*** RIVER *** [9c 3d Qh Ts] [2c]
xHourglass: checks 
DUkalisUA: checks 
*** SHOW DOWN ***
xHourglass: shows [Ah 5c] (high card Ace)
DUkalisUA: shows [Tc 4h] (a pair of Tens)
DUkalisUA collected $1.90 from pot
*** SUMMARY ***
Total pot $2 | Rake $0.10 
Board [9c 3d Qh Ts 2c]
Seat 1: matiko09 folded before Flop (didn't bet)
Seat 2: ka100pka527 folded before Flop (didn't bet)
Seat 4: I The King I folded before Flop (didn't bet)
Seat 6: IdiotFromNE (button) folded before Flop (didn't bet)
Seat 7: xHourglass (small blind) showed [Ah 5c] and lost with high card Ace
Seat 8: DUkalisUA (big blind) showed [Tc 4h] and won ($1.90) with a pair of Tens
Seat 9: Chin41178 folded before Flop (didn't bet)





PokerStars Hand #151207720436:  Hold'em No Limit ($1/$2 USD) - 2016/03/31 12:37:38 CET [2016/03/31 6:37:38 ET]
Table 'Desiderata' 9-max Seat #1 is the button
Seat 1: GALWACONT ($196.40 in chips) 
Seat 2: ilaviiitech ($200 in chips) 
Seat 3: djammusic ($80 in chips) 
Seat 4: matiko09 ($343.85 in chips) 
Seat 5: Kreuznagel ($300.74 in chips) 
Seat 6: rmanjkeee ($107.10 in chips) 
Seat 7: apfush ($255.83 in chips) 
Seat 8: DUkalisUA ($200 in chips) 
Seat 9: Painkiller72 ($200.60 in chips) 
ilaviiitech: posts small blind $1
djammusic: posts big blind $2
*** HOLE CARDS ***
Dealt to matiko09 [As 3s]
matiko09: folds 
Kreuznagel: folds 
rmanjkeee: raises $3 to $5
apfush: folds 
DUkalisUA: folds 
Painkiller72: folds 
GALWACONT: calls $5
ilaviiitech: folds 
djammusic: folds 
*** FLOP *** [4c 7d 4h]
rmanjkeee: bets $4
GALWACONT: folds 
Uncalled bet ($4) returned to rmanjkeee
rmanjkeee collected $12.35 from pot
rmanjkeee: doesn't show hand 
*** SUMMARY ***
Total pot $13 | Rake $0.65 
Board [4c 7d 4h]
Seat 1: GALWACONT (button) folded on the Flop
Seat 2: ilaviiitech (small blind) folded before Flop
Seat 3: djammusic (big blind) folded before Flop
Seat 4: matiko09 folded before Flop (didn't bet)
Seat 5: Kreuznagel folded before Flop (didn't bet)
Seat 6: rmanjkeee collected ($12.35)
Seat 7: apfush folded before Flop (didn't bet)
Seat 8: DUkalisUA folded before Flop (didn't bet)
Seat 9: Painkiller72 folded before Flop (didn't bet)





PokerStars Hand #151207724445:  Hold'em No Limit ($1/$2 USD) - 2016/03/31 12:37:46 CET [2016/03/31 6:37:46 ET]
Table 'Coelestina II' 9-max Seat #2 is the button
Seat 1: PacPacBum ($221.93 in chips) 
Seat 2: Kreuznagel ($213.11 in chips) 
Seat 3: ilaviiitech ($202.30 in chips) 
Seat 4: matiko09 ($220.21 in chips) 
Seat 6: Avtovo ($211.62 in chips) 
Seat 7: rmanjkeee ($80 in chips) 
Seat 8: DUkalisUA ($200 in chips) 
Seat 9: fonng ($194.45 in chips) 
ilaviiitech: posts small blind $1
matiko09: posts big blind $2
Painkiller72: sits out 
*** HOLE CARDS ***
Dealt to matiko09 [Qc 7c]
Avtovo: folds 
rmanjkeee: folds 
DUkalisUA: folds 
fonng: folds 
PacPacBum: folds 
Kreuznagel: raises $3 to $5
ilaviiitech: folds 
matiko09: calls $3
*** FLOP *** [Ks 7s 2h]
matiko09: checks 
Kreuznagel: bets $5.74
matiko09: calls $5.74
*** TURN *** [Ks 7s 2h] [Kh]
matiko09: checks 
Kreuznagel: bets $22
matiko09: folds 
Uncalled bet ($22) returned to Kreuznagel
Kreuznagel collected $21.36 from pot
Kreuznagel: doesn't show hand 
*** SUMMARY ***
Total pot $22.48 | Rake $1.12 
Board [Ks 7s 2h Kh]
Seat 1: PacPacBum folded before Flop (didn't bet)
Seat 2: Kreuznagel (button) collected ($21.36)
Seat 3: ilaviiitech (small blind) folded before Flop
Seat 4: matiko09 (big blind) folded on the Turn
Seat 6: Avtovo folded before Flop (didn't bet)
Seat 7: rmanjkeee folded before Flop (didn't bet)
Seat 8: DUkalisUA folded before Flop (didn't bet)
Seat 9: fonng folded before Flop (didn't bet)





PokerStars Hand #151207726075:  Hold'em No Limit ($0.50/$1.00 USD) - 2016/03/31 12:37:50 CET [2016/03/31 6:37:50 ET]
Table 'Icarus III' 9-max Seat #1 is the button
Seat 1: IdiotFromNE ($115.38 in chips) 
Seat 2: Painkiller72 ($100 in chips) 
Seat 3: RICKA16 ($106.02 in chips) 
Seat 4: dizzyryano79 ($33.83 in chips) 
Seat 5: I The King I ($115.25 in chips) 
Seat 6: djammusic ($47.58 in chips) 
Seat 7: oscarleon ($150.51 in chips) 
Seat 8: matiko09 ($102.52 in chips) 
Seat 9: apfush ($123.96 in chips) 
Painkiller72: posts small blind $0.50
RICKA16: posts big blind $1
*** HOLE CARDS ***
Dealt to matiko09 [Jd 3h]
dizzyryano79: folds 
I The King I: folds 
djammusic: folds 
oscarleon: folds 
matiko09: folds 
apfush: folds 
IdiotFromNE: folds 
Painkiller72: folds 
Uncalled bet ($0.50) returned to RICKA16
RICKA16 collected $1 from pot
RICKA16: doesn't show hand 
*** SUMMARY ***
Total pot $1 | Rake $0 
Seat 1: IdiotFromNE (button) folded before Flop (didn't bet)
Seat 2: Painkiller72 (small blind) folded before Flop
Seat 3: RICKA16 (big blind) collected ($1)
Seat 4: dizzyryano79 folded before Flop (didn't bet)
Seat 5: I The King I folded before Flop (didn't bet)
Seat 6: djammusic folded before Flop (didn't bet)
Seat 7: oscarleon folded before Flop (didn't bet)
Seat 8: matiko09 folded before Flop (didn't bet)
Seat 9: apfush folded before Flop (didn't bet)





PokerStars Hand #151207732175:  Hold'em No Limit ($0.50/$1.00 USD) - 2016/03/31 12:38:02 CET [2016/03/31 6:38:02 ET]
Table 'Yazhi' 9-max Seat #2 is the button
Seat 1: matiko09 ($100 in chips) 
Seat 2: xHourglass ($106.14 in chips) 
Seat 3: Chin41178 ($86.91 in chips) 
Seat 4: apfush ($182.96 in chips) 
Seat 5: IdiotFromNE ($100 in chips) 
Seat 6: Reven9er ($237.49 in chips) 
Seat 7: Avtovo ($100 in chips) 
Seat 8: pk4DW ($55.83 in chips) 
Seat 9: oscarleon ($197.73 in chips) 
Chin41178: posts small blind $0.50
apfush: posts big blind $1
*** HOLE CARDS ***
Dealt to matiko09 [4d 2d]
IdiotFromNE: folds 
Reven9er: raises $1 to $2
Avtovo: folds 
pk4DW: raises $5.50 to $7.50
oscarleon: folds 
matiko09: folds 
xHourglass: calls $7.50
Chin41178: raises $79.41 to $86.91 and is all-in
apfush: folds 
Reven9er: folds 
pk4DW: folds 
xHourglass: calls $79.41
*** FIRST FLOP *** [7h Qc Ks]
*** FIRST TURN *** [7h Qc Ks] [Jc]
*** FIRST RIVER *** [7h Qc Ks Jc] [Tc]
*** SECOND FLOP *** [3c 5h 8s]
*** SECOND TURN *** [3c 5h 8s] [8h]
*** SECOND RIVER *** [3c 5h 8s 8h] [4s]
*** FIRST SHOW DOWN ***
Chin41178: shows [Kh Ad] (a straight, Ten to Ace)
xHourglass: shows [Qd Qs] (three of a kind, Queens)
Chin41178 collected $90.91 from pot
*** SECOND SHOW DOWN ***
Chin41178: shows [Kh Ad] (a pair of Eights)
xHourglass: shows [Qd Qs] (two pair, Queens and Eights)
xHourglass collected $90.91 from pot
*** SUMMARY ***
Total pot $184.32 | Rake $2.50 
Hand was run twice
FIRST Board [7h Qc Ks Jc Tc]
SECOND Board [3c 5h 8s 8h 4s]
Seat 1: matiko09 folded before Flop (didn't bet)
Seat 2: xHourglass (button) showed [Qd Qs] and lost with three of a kind, Queens, and won ($90.91) with two pair, Queens and Eights
Seat 3: Chin41178 (small blind) showed [Kh Ad] and won ($90.91) with a straight, Ten to Ace, and lost with a pair of Eights
Seat 4: apfush (big blind) folded before Flop
Seat 5: IdiotFromNE folded before Flop (didn't bet)
Seat 6: Reven9er folded before Flop
Seat 7: Avtovo folded before Flop (didn't bet)
Seat 8: pk4DW folded before Flop
Seat 9: oscarleon folded before Flop (didn't bet)





PokerStars Hand #151207737449:  Hold'em No Limit ($0.50/$1.00 USD) - 2016/03/31 12:38:13 CET [2016/03/31 6:38:13 ET]
Table 'Haworth II' 9-max Seat #2 is the button
Seat 1: godfrey004 ($103.40 in chips) 
Seat 2: AlKatrone ($130.46 in chips) 
Seat 3: matiko09 ($103.18 in chips) 
Seat 4: I The King I ($101.50 in chips) 
Seat 5: Kreuznagel ($103.10 in chips) 
Seat 6: Pvsx. ($101.50 in chips) 
Seat 7: mheris ($122.72 in chips) 
Seat 8: oscarleon ($100 in chips) 
Seat 9: Zeeshka ($100 in chips) 
matiko09: posts small blind $0.50
I The King I: posts big blind $1
*** HOLE CARDS ***
Dealt to matiko09 [8s 9h]
Kreuznagel: folds 
Pvsx.: folds 
mheris: folds 
oscarleon: raises $2 to $3
Zeeshka: folds 
godfrey004: folds 
AlKatrone: folds 
matiko09: folds 
I The King I: folds 
Uncalled bet ($2) returned to oscarleon
oscarleon collected $2.50 from pot
oscarleon: doesn't show hand 
*** SUMMARY ***
Total pot $2.50 | Rake $0 
Seat 1: godfrey004 folded before Flop (didn't bet)
Seat 2: AlKatrone (button) folded before Flop (didn't bet)
Seat 3: matiko09 (small blind) folded before Flop
Seat 4: I The King I (big blind) folded before Flop
Seat 5: Kreuznagel folded before Flop (didn't bet)
Seat 6: Pvsx. folded before Flop (didn't bet)
Seat 7: mheris folded before Flop (didn't bet)
Seat 8: oscarleon collected ($2.50)
Seat 9: Zeeshka folded before Flop (didn't bet)





PokerStars Hand #151207738329:  Hold'em No Limit ($0.50/$1.00 USD) - 2016/03/31 12:38:15 CET [2016/03/31 6:38:15 ET]
Table 'Bussolini III' 9-max Seat #1 is the button
Seat 1: I The King I ($193.46 in chips) 
Seat 2: BOAYARSKIY ($40.50 in chips) 
Seat 3: 20grodt16 ($201.22 in chips) 
Seat 5: Kreuznagel ($100 in chips) 
Seat 6: matiko09 ($118.52 in chips) 
Seat 7: IdiotFromNE ($108.08 in chips) 
Seat 8: oscarleon ($100 in chips) 
Seat 9: RICKA16 ($115.58 in chips) 
BOAYARSKIY: posts small blind $0.50
20grodt16: posts big blind $1
*** HOLE CARDS ***
Dealt to matiko09 [7h 6h]
Kreuznagel: folds 
matiko09: raises $2 to $3
IdiotFromNE: folds 
oscarleon: folds 
RICKA16: calls $3
I The King I: folds 
BOAYARSKIY: folds 
20grodt16: folds 
*** FLOP *** [5c As 8s]
matiko09: bets $4.63
RICKA16: raises $9.37 to $14
matiko09: calls $9.37
*** TURN *** [5c As 8s] [Ac]
matiko09: checks 
RICKA16: checks 
*** RIVER *** [5c As 8s Ac] [2c]
matiko09: bets $15
RICKA16: folds 
Uncalled bet ($15) returned to matiko09
matiko09 collected $33.72 from pot
matiko09: doesn't show hand 
*** SUMMARY ***
Total pot $35.50 | Rake $1.78 
Board [5c As 8s Ac 2c]
Seat 1: I The King I (button) folded before Flop (didn't bet)
Seat 2: BOAYARSKIY (small blind) folded before Flop
Seat 3: 20grodt16 (big blind) folded before Flop
Seat 5: Kreuznagel folded before Flop (didn't bet)
Seat 6: matiko09 collected ($33.72)
Seat 7: IdiotFromNE folded before Flop (didn't bet)
Seat 8: oscarleon folded before Flop (didn't bet)
Seat 9: RICKA16 folded on the River





PokerStars Hand #151207740903:  Hold'em No Limit ($0.50/$1.00 USD) - 2016/03/31 12:38:21 CET [2016/03/31 6:38:21 ET]
Table 'Aquila' 9-max Seat #1 is the button
Seat 1: BOAYARSKIY ($54.10 in chips) 
Seat 2: Avtovo ($100 in chips) 
Seat 3: laco121 ($47.40 in chips) 
Seat 4: ChrisAAKKQQ ($106.73 in chips) 
Seat 5: adelfaz ($54.54 in chips) 
Seat 6: maxxmeister ($121.40 in chips) 
Seat 7: PacPacBum ($126.10 in chips) 
Seat 8: matiko09 ($102.16 in chips) 
Seat 9: apfush ($100 in chips) 
Avtovo: posts small blind $0.50
laco121: posts big blind $1
BOAYARSKIY: posts the ante $0.20
Avtovo: posts the ante $0.20
laco121: posts the ante $0.20
ChrisAAKKQQ: posts the ante $0.20
adelfaz: posts the ante $0.20
maxxmeister: posts the ante $0.20
PacPacBum: posts the ante $0.20
matiko09: posts the ante $0.20
apfush: posts the ante $0.20
*** HOLE CARDS ***
Dealt to matiko09 [2s 5s]
ChrisAAKKQQ has timed out
ChrisAAKKQQ: folds 
adelfaz: folds 
maxxmeister: folds 
PacPacBum: folds 
matiko09: folds 
apfush: folds 
BOAYARSKIY: raises $1.50 to $2.50
Avtovo: calls $2
laco121: calls $1.50
*** FLOP *** [8h 3d 9d]
Avtovo: checks 
laco121: bets $6
BOAYARSKIY: folds 
Avtovo: folds 
Uncalled bet ($6) returned to laco121
laco121 collected $8.84 from pot
laco121: doesn't show hand 
*** SUMMARY ***
Total pot $9.30 | Rake $0.46 
Board [8h 3d 9d]
Seat 1: BOAYARSKIY (button) folded on the Flop
Seat 2: Avtovo (small blind) folded on the Flop
Seat 3: laco121 (big blind) collected ($8.84)
Seat 4: ChrisAAKKQQ folded before Flop (didn't bet)
Seat 5: adelfaz folded before Flop (didn't bet)
Seat 6: maxxmeister folded before Flop (didn't bet)
Seat 7: PacPacBum folded before Flop (didn't bet)
Seat 8: matiko09 folded before Flop (didn't bet)
Seat 9: apfush folded before Flop (didn't bet)





PokerStars Hand #151207741462:  Hold'em No Limit (€0.50/€1.00 EUR) - 2016/03/31 12:38:22 CET [2016/03/31 6:38:22 ET]
Table 'Pioneer II' 9-max Seat #6 is the button
Seat 1: Kreuznagel (€100 in chips) 
Seat 2: IdiotFromNE (€132.02 in chips) 
Seat 3: Zeeshka (€100 in chips) 
Seat 4: Painkiller72 (€138.83 in chips) 
Seat 5: TOTO220773 (€77.98 in chips) 
Seat 6: matiko09 (€104.50 in chips) 
Seat 7: AlKatrone (€130.91 in chips) 
Seat 8: PacPacBum (€104.72 in chips) 
Seat 9: DUkalisUA (€104.12 in chips) 
AlKatrone: posts small blind €0.50
PacPacBum: posts big blind €1
*** HOLE CARDS ***
Dealt to matiko09 [Td 2c]
DUkalisUA: folds 
Kreuznagel: folds 
IdiotFromNE: folds 
Zeeshka: folds 
Painkiller72: raises €1.50 to €2.50
TOTO220773: calls €2.50
matiko09: folds 
AlKatrone: folds 
PacPacBum: folds 
*** FLOP *** [4c Ks 8s]
Painkiller72: bets €4.32
TOTO220773: calls €4.32
*** TURN *** [4c Ks 8s] [Jh]
Painkiller72: bets €10.06
TOTO220773: folds 
Uncalled bet (€10.06) returned to Painkiller72
Painkiller72 collected €14.38 from pot
Painkiller72: doesn't show hand 
*** SUMMARY ***
Total pot €15.14 | Rake €0.76 
Board [4c Ks 8s Jh]
Seat 1: Kreuznagel folded before Flop (didn't bet)
Seat 2: IdiotFromNE folded before Flop (didn't bet)
Seat 3: Zeeshka folded before Flop (didn't bet)
Seat 4: Painkiller72 collected (€14.38)
Seat 5: TOTO220773 folded on the Turn
Seat 6: matiko09 (button) folded before Flop (didn't bet)
Seat 7: AlKatrone (small blind) folded before Flop
Seat 8: PacPacBum (big blind) folded before Flop
Seat 9: DUkalisUA folded before Flop (didn't bet)





PokerStars Hand #151207744021:  Hold'em No Limit ($0.50/$1.00 USD) - 2016/03/31 12:38:27 CET [2016/03/31 6:38:27 ET]
Table 'Icarus III' 9-max Seat #2 is the button
Seat 1: IdiotFromNE ($115.38 in chips) 
Seat 2: Painkiller72 ($100 in chips) 
Seat 3: RICKA16 ($106.52 in chips) 
Seat 4: dizzyryano79 ($33.83 in chips) 
Seat 5: I The King I ($115.25 in chips) 
Seat 6: djammusic ($47.58 in chips) 
Seat 7: oscarleon ($150.51 in chips) 
Seat 8: matiko09 ($102.52 in chips) 
Seat 9: apfush ($123.96 in chips) 
RICKA16: posts small blind $0.50
dizzyryano79: posts big blind $1
*** HOLE CARDS ***
Dealt to matiko09 [Td 7c]
I The King I: folds 
djammusic: folds 
oscarleon: folds 
matiko09: folds 
apfush: folds 
IdiotFromNE: raises $1.50 to $2.50
Painkiller72: folds 
RICKA16: folds 
dizzyryano79: calls $1.50
*** FLOP *** [2c 3h 4h]
dizzyryano79: bets $1
IdiotFromNE: folds 
Uncalled bet ($1) returned to dizzyryano79
dizzyryano79 collected $5.22 from pot
*** SUMMARY ***
Total pot $5.50 | Rake $0.28 
Board [2c 3h 4h]
Seat 1: IdiotFromNE folded on the Flop
Seat 2: Painkiller72 (button) folded before Flop (didn't bet)
Seat 3: RICKA16 (small blind) folded before Flop
Seat 4: dizzyryano79 (big blind) collected ($5.22)
Seat 5: I The King I folded before Flop (didn't bet)
Seat 6: djammusic folded before Flop (didn't bet)
Seat 7: oscarleon folded before Flop (didn't bet)
Seat 8: matiko09 folded before Flop (didn't bet)
Seat 9: apfush folded before Flop (didn't bet)





PokerStars Hand #151207749962:  Hold'em No Limit ($1/$2 USD) - 2016/03/31 12:38:40 CET [2016/03/31 6:38:40 ET]
Table 'Desiderata' 9-max Seat #2 is the button
Seat 1: GALWACONT ($191.40 in chips) 
Seat 2: ilaviiitech ($200 in chips) 
Seat 3: djammusic ($78 in chips) 
Seat 4: matiko09 ($343.85 in chips) 
Seat 5: Kreuznagel ($300.74 in chips) 
Seat 6: rmanjkeee ($114.45 in chips) 
Seat 7: apfush ($255.83 in chips) 
Seat 8: DUkalisUA ($200 in chips) 
Seat 9: Painkiller72 ($200.60 in chips) 
djammusic: posts small blind $1
matiko09: posts big blind $2
*** HOLE CARDS ***
Dealt to matiko09 [Ad Ks]
Kreuznagel: raises $2.78 to $4.78
rmanjkeee: folds 
apfush: folds 
DUkalisUA: folds 
Painkiller72: calls $4.78
GALWACONT: calls $4.78
ilaviiitech: folds 
djammusic: folds 
matiko09: raises $19.22 to $24
Kreuznagel: calls $19.22
Painkiller72: folds 
GALWACONT: folds 
*** FLOP *** [Td 7s Ts]
matiko09: checks 
Kreuznagel: checks 
*** TURN *** [Td 7s Ts] [4c]
matiko09: checks 
Kreuznagel: checks 
*** RIVER *** [Td 7s Ts 4c] [Jh]
matiko09: checks 
Kreuznagel: bets $22
matiko09: folds 
Uncalled bet ($22) returned to Kreuznagel
Kreuznagel collected $55.81 from pot
Kreuznagel: doesn't show hand 
*** SUMMARY ***
Total pot $58.56 | Rake $2.75 
Board [Td 7s Ts 4c Jh]
Seat 1: GALWACONT folded before Flop
Seat 2: ilaviiitech (button) folded before Flop (didn't bet)
Seat 3: djammusic (small blind) folded before Flop
Seat 4: matiko09 (big blind) folded on the River
Seat 5: Kreuznagel collected ($55.81)
Seat 6: rmanjkeee folded before Flop (didn't bet)
Seat 7: apfush folded before Flop (didn't bet)
Seat 8: DUkalisUA folded before Flop (didn't bet)
Seat 9: Painkiller72 folded before Flop





PokerStars Hand #151207752809:  Hold'em No Limit ($0.50/$1.00 USD) - 2016/03/31 12:38:46 CET [2016/03/31 6:38:46 ET]
Table 'Haworth II' 9-max Seat #3 is the button
Seat 1: godfrey004 ($103.40 in chips) 
Seat 2: AlKatrone ($130.46 in chips) 
Seat 3: matiko09 ($102.68 in chips) 
Seat 4: I The King I ($100.50 in chips) 
Seat 5: Kreuznagel ($103.10 in chips) 
Seat 6: Pvsx. ($101.50 in chips) 
Seat 7: mheris ($122.72 in chips) 
Seat 8: oscarleon ($101.50 in chips) 
Seat 9: Zeeshka ($100 in chips) 
I The King I: posts small blind $0.50
Kreuznagel: posts big blind $1
*** HOLE CARDS ***
Dealt to matiko09 [3c 8h]
Pvsx.: folds 
mheris: calls $1
oscarleon: folds 
Zeeshka: folds 
godfrey004: calls $1
AlKatrone: folds 
matiko09: folds 
I The King I: calls $0.50
Kreuznagel: checks 
*** FLOP *** [Qc 2h Qd]
I The King I: checks 
Kreuznagel: checks 
mheris: checks 
godfrey004: bets $3
I The King I: folds 
Kreuznagel: folds 
mheris: folds 
Uncalled bet ($3) returned to godfrey004
godfrey004 collected $3.80 from pot
godfrey004: doesn't show hand 
*** SUMMARY ***
Total pot $4 | Rake $0.20 
Board [Qc 2h Qd]
Seat 1: godfrey004 collected ($3.80)
Seat 2: AlKatrone folded before Flop (didn't bet)
Seat 3: matiko09 (button) folded before Flop (didn't bet)
Seat 4: I The King I (small blind) folded on the Flop
Seat 5: Kreuznagel (big blind) folded on the Flop
Seat 6: Pvsx. folded before Flop (didn't bet)
Seat 7: mheris folded on the Flop
Seat 8: oscarleon folded before Flop (didn't bet)
Seat 9: Zeeshka folded before Flop (didn't bet)





PokerStars Hand #151207758440:  Hold'em No Limit ($1/$2 USD) - 2016/03/31 12:38:57 CET [2016/03/31 6:38:57 ET]
Table 'Coelestina II' 9-max Seat #3 is the button
Seat 1: PacPacBum ($221.93 in chips) 
Seat 2: Kreuznagel ($223.73 in chips) 
Seat 3: ilaviiitech ($201.30 in chips) 
Seat 4: matiko09 ($209.47 in chips) 
Seat 5: Painkiller72 ($200 in chips) 
Seat 6: Avtovo ($211.62 in chips) 
Seat 7: rmanjkeee ($80 in chips) 
Seat 8: DUkalisUA ($200 in chips) 
Seat 9: fonng ($194.45 in chips) 
matiko09: posts small blind $1
Painkiller72: posts big blind $2
*** HOLE CARDS ***
Dealt to matiko09 [9s Tc]
Avtovo: folds 
rmanjkeee: folds 
DUkalisUA: folds 
fonng: folds 
PacPacBum: folds 
Kreuznagel: raises $3 to $5
ilaviiitech: folds 
matiko09: folds 
Painkiller72: folds 
Uncalled bet ($3) returned to Kreuznagel
Kreuznagel collected $5 from pot
Kreuznagel: doesn't show hand 
*** SUMMARY ***
Total pot $5 | Rake $0 
Seat 1: PacPacBum folded before Flop (didn't bet)
Seat 2: Kreuznagel collected ($5)
Seat 3: ilaviiitech (button) folded before Flop (didn't bet)
Seat 4: matiko09 (small blind) folded before Flop
Seat 5: Painkiller72 (big blind) folded before Flop
Seat 6: Avtovo folded before Flop (didn't bet)
Seat 7: rmanjkeee folded before Flop (didn't bet)
Seat 8: DUkalisUA folded before Flop (didn't bet)
Seat 9: fonng folded before Flop (didn't bet)





PokerStars Hand #151207759687:  Hold'em No Limit ($0.50/$1.00 USD) - 2016/03/31 12:39:00 CET [2016/03/31 6:39:00 ET]
Table 'Celestia II' 9-max Seat #7 is the button
Seat 1: matiko09 ($132.62 in chips) 
Seat 2: ka100pka527 ($40 in chips) 
Seat 4: I The King I ($204.88 in chips) 
Seat 6: IdiotFromNE ($100 in chips) 
Seat 7: xHourglass ($100 in chips) 
Seat 8: DUkalisUA ($164.75 in chips) 
Seat 9: Chin41178 ($116.38 in chips) 
DUkalisUA: posts small blind $0.50
Chin41178: posts big blind $1
CBrownBear: sits out 
djammusic: sits out 
*** HOLE CARDS ***
Dealt to matiko09 [2c 9s]
matiko09: folds 
ka100pka527: folds 
I The King I: folds 
IdiotFromNE: folds 
xHourglass: folds 
DUkalisUA: raises $2 to $3
Chin41178: folds 
Uncalled bet ($2) returned to DUkalisUA
DUkalisUA collected $2 from pot
DUkalisUA: doesn't show hand 
*** SUMMARY ***
Total pot $2 | Rake $0 
Seat 1: matiko09 folded before Flop (didn't bet)
Seat 2: ka100pka527 folded before Flop (didn't bet)
Seat 4: I The King I folded before Flop (didn't bet)
Seat 6: IdiotFromNE folded before Flop (didn't bet)
Seat 7: xHourglass (button) folded before Flop (didn't bet)
Seat 8: DUkalisUA (small blind) collected ($2)
Seat 9: Chin41178 (big blind) folded before Flop





PokerStars Hand #151207763542:  Hold'em No Limit ($0.50/$1.00 USD) - 2016/03/31 12:39:08 CET [2016/03/31 6:39:08 ET]
Table 'Herge II' 9-max Seat #4 is the button
Seat 1: Chiapel ($92.18 in chips) 
Seat 2: DUkalisUA ($100 in chips) 
Seat 3: matiko09 ($211.77 in chips) 
Seat 4: Kreuznagel ($100 in chips) 
Seat 5: I The King I ($119.78 in chips) 
Seat 6: masaytoo ($97 in chips) 
Seat 7: Zeeshka ($140.95 in chips) 
Seat 8: IdiotFromNE ($100 in chips) 
Seat 9: fatstacks122 ($129.83 in chips) 
I The King I: posts small blind $0.50
masaytoo: posts big blind $1
*** HOLE CARDS ***
Dealt to matiko09 [4d Qd]
Zeeshka: folds 
IdiotFromNE: folds 
fatstacks122: folds 
Chiapel: raises $1 to $2
DUkalisUA: folds 
matiko09: folds 
Kreuznagel: calls $2
I The King I: folds 
masaytoo: calls $1
*** FLOP *** [8s 3s Jd]
masaytoo: checks 
Chiapel: bets $6.18
Kreuznagel: calls $6.18
masaytoo: folds 
*** TURN *** [8s 3s Jd] [4c]
Chiapel: bets $17.92
Kreuznagel: folds 
Uncalled bet ($17.92) returned to Chiapel
Chiapel collected $17.92 from pot
Chiapel: doesn't show hand 
*** SUMMARY ***
Total pot $18.86 | Rake $0.94 
Board [8s 3s Jd 4c]
Seat 1: Chiapel collected ($17.92)
Seat 2: DUkalisUA folded before Flop (didn't bet)
Seat 3: matiko09 folded before Flop (didn't bet)
Seat 4: Kreuznagel (button) folded on the Turn
Seat 5: I The King I (small blind) folded before Flop
Seat 6: masaytoo (big blind) folded on the Flop
Seat 7: Zeeshka folded before Flop (didn't bet)
Seat 8: IdiotFromNE folded before Flop (didn't bet)
Seat 9: fatstacks122 folded before Flop (didn't bet)





PokerStars Hand #151207769015:  Hold'em No Limit ($0.50/$1.00 USD) - 2016/03/31 12:39:19 CET [2016/03/31 6:39:19 ET]
Table 'Yazhi' 9-max Seat #3 is the button
Seat 1: matiko09 ($100 in chips) 
Seat 2: xHourglass ($110.14 in chips) 
Seat 3: Chin41178 ($90.91 in chips) 
Seat 4: apfush ($181.96 in chips) 
Seat 5: IdiotFromNE ($100 in chips) 
Seat 6: Reven9er ($235.49 in chips) 
Seat 7: Avtovo ($100 in chips) 
Seat 8: pk4DW ($48.33 in chips) 
Seat 9: oscarleon ($197.73 in chips) 
apfush: posts small blind $0.50
IdiotFromNE: posts big blind $1
*** HOLE CARDS ***
Dealt to matiko09 [8d Kh]
Reven9er: folds 
Avtovo: folds 
pk4DW: folds 
oscarleon: folds 
matiko09: folds 
xHourglass: folds 
Chin41178: folds 
apfush: raises $2 to $3
IdiotFromNE: raises $6 to $9
apfush: folds 
Uncalled bet ($6) returned to IdiotFromNE
IdiotFromNE collected $6 from pot
IdiotFromNE: doesn't show hand 
*** SUMMARY ***
Total pot $6 | Rake $0 
Seat 1: matiko09 folded before Flop (didn't bet)
Seat 2: xHourglass folded before Flop (didn't bet)
Seat 3: Chin41178 (button) folded before Flop (didn't bet)
Seat 4: apfush (small blind) folded before Flop
Seat 5: IdiotFromNE (big blind) collected ($6)
Seat 6: Reven9er folded before Flop (didn't bet)
Seat 7: Avtovo folded before Flop (didn't bet)
Seat 8: pk4DW folded before Flop (didn't bet)
Seat 9: oscarleon folded before Flop (didn't bet)





PokerStars Hand #151207771119:  Hold'em No Limit (€0.50/€1.00 EUR) - 2016/03/31 12:39:24 CET [2016/03/31 6:39:24 ET]
Table 'Pioneer II' 9-max Seat #7 is the button
Seat 1: Kreuznagel (€100 in chips) 
Seat 2: IdiotFromNE (€132.02 in chips) 
Seat 3: Zeeshka (€100 in chips) 
Seat 4: Painkiller72 (€146.39 in chips) 
Seat 5: TOTO220773 (€71.16 in chips) 
Seat 6: matiko09 (€104.50 in chips) 
Seat 7: AlKatrone (€130.41 in chips) 
Seat 8: PacPacBum (€103.72 in chips) 
Seat 9: DUkalisUA (€104.12 in chips) 
PacPacBum: posts small blind €0.50
DUkalisUA: posts big blind €1
*** HOLE CARDS ***
Dealt to matiko09 [8s 5s]
Kreuznagel: raises €1.39 to €2.39
IdiotFromNE: folds 
Zeeshka: folds 
Painkiller72: folds 
TOTO220773: folds 
matiko09: folds 
AlKatrone: folds 
PacPacBum: folds 
DUkalisUA: folds 
Uncalled bet (€1.39) returned to Kreuznagel
Kreuznagel collected €2.50 from pot
Kreuznagel: doesn't show hand 
*** SUMMARY ***
Total pot €2.50 | Rake €0 
Seat 1: Kreuznagel collected (€2.50)
Seat 2: IdiotFromNE folded before Flop (didn't bet)
Seat 3: Zeeshka folded before Flop (didn't bet)
Seat 4: Painkiller72 folded before Flop (didn't bet)
Seat 5: TOTO220773 folded before Flop (didn't bet)
Seat 6: matiko09 folded before Flop (didn't bet)
Seat 7: AlKatrone (button) folded before Flop (didn't bet)
Seat 8: PacPacBum (small blind) folded before Flop
Seat 9: DUkalisUA (big blind) folded before Flop





PokerStars Hand #151207775204:  Hold'em No Limit ($0.50/$1.00 USD) - 2016/03/31 12:39:32 CET [2016/03/31 6:39:32 ET]
Table 'Egeria II' 9-max Seat #2 is the button
Seat 1: oscarleon ($119.01 in chips) 
Seat 2: I The King I ($196.50 in chips) 
Seat 3: Pvsx. ($103.22 in chips) 
Seat 4: matiko09 ($100 in chips) 
Seat 5: apfush ($142.82 in chips) 
Seat 6: xHourglass ($100 in chips) 
Seat 7: Reven9er ($118.08 in chips) 
Seat 8: Kreuznagel ($135.01 in chips) 
Seat 9: miracolix50 ($79.89 in chips) 
Pvsx.: posts small blind $0.50
matiko09: posts big blind $1
*** HOLE CARDS ***
Dealt to matiko09 [8s Tc]
apfush: folds 
xHourglass: folds 
Reven9er: folds 
Kreuznagel: folds 
miracolix50: calls $1
oscarleon: raises $3 to $4
I The King I: folds 
Pvsx.: folds 
matiko09: folds 
miracolix50: calls $3
*** FLOP *** [As 3d Qh]
miracolix50: checks 
oscarleon: bets $6
miracolix50: folds 
Uncalled bet ($6) returned to oscarleon
oscarleon collected $9.02 from pot
oscarleon: doesn't show hand 
*** SUMMARY ***
Total pot $9.50 | Rake $0.48 
Board [As 3d Qh]
Seat 1: oscarleon collected ($9.02)
Seat 2: I The King I (button) folded before Flop (didn't bet)
Seat 3: Pvsx. (small blind) folded before Flop
Seat 4: matiko09 (big blind) folded before Flop
Seat 5: apfush folded before Flop (didn't bet)
Seat 6: xHourglass folded before Flop (didn't bet)
Seat 7: Reven9er folded before Flop (didn't bet)
Seat 8: Kreuznagel folded before Flop (didn't bet)
Seat 9: miracolix50 folded on the Flop





PokerStars Hand #151207778607:  Hold'em No Limit ($1/$2 USD) - 2016/03/31 12:39:39 CET [2016/03/31 6:39:39 ET]
Table 'Coelestina II' 9-max Seat #4 is the button
Seat 1: PacPacBum ($221.93 in chips) 
Seat 2: Kreuznagel ($226.73 in chips) 
Seat 3: ilaviiitech ($201.30 in chips) 
Seat 4: matiko09 ($208.47 in chips) 
Seat 5: Painkiller72 ($200 in chips) 
Seat 6: Avtovo ($211.62 in chips) 
Seat 7: rmanjkeee ($80 in chips) 
Seat 8: DUkalisUA ($200 in chips) 
Seat 9: fonng ($194.45 in chips) 
Painkiller72: posts small blind $1
Avtovo: posts big blind $2
*** HOLE CARDS ***
Dealt to matiko09 [9d 8d]
rmanjkeee: folds 
DUkalisUA: raises $4 to $6
fonng: folds 
PacPacBum: folds 
Kreuznagel: folds 
ilaviiitech: folds 
matiko09: calls $6
Painkiller72: folds 
Avtovo: folds 
*** FLOP *** [5c 2d 9c]
DUkalisUA: bets $8
matiko09: calls $8
*** TURN *** [5c 2d 9c] [4c]
DUkalisUA: bets $19
matiko09: folds 
Uncalled bet ($19) returned to DUkalisUA
DUkalisUA collected $29.45 from pot
DUkalisUA: doesn't show hand 
*** SUMMARY ***
Total pot $31 | Rake $1.55 
Board [5c 2d 9c 4c]
Seat 1: PacPacBum folded before Flop (didn't bet)
Seat 2: Kreuznagel folded before Flop (didn't bet)
Seat 3: ilaviiitech folded before Flop (didn't bet)
Seat 4: matiko09 (button) folded on the Turn
Seat 5: Painkiller72 (small blind) folded before Flop
Seat 6: Avtovo (big blind) folded before Flop
Seat 7: rmanjkeee folded before Flop (didn't bet)
Seat 8: DUkalisUA collected ($29.45)
Seat 9: fonng folded before Flop (didn't bet)





PokerStars Hand #151207781134:  Hold'em No Limit ($0.50/$1.00 USD) - 2016/03/31 12:39:45 CET [2016/03/31 6:39:45 ET]
Table 'Icarus III' 9-max Seat #3 is the button
Seat 1: IdiotFromNE ($112.88 in chips) 
Seat 2: Painkiller72 ($100 in chips) 
Seat 3: RICKA16 ($106.02 in chips) 
Seat 4: dizzyryano79 ($36.55 in chips) 
Seat 5: I The King I ($115.25 in chips) 
Seat 6: djammusic ($47.58 in chips) 
Seat 7: oscarleon ($150.51 in chips) 
Seat 8: matiko09 ($102.52 in chips) 
Seat 9: apfush ($123.96 in chips) 
dizzyryano79: posts small blind $0.50
I The King I: posts big blind $1
*** HOLE CARDS ***
Dealt to matiko09 [8s Qd]
djammusic: folds 
oscarleon: raises $2 to $3
matiko09: folds 
apfush: folds 
IdiotFromNE: folds 
Painkiller72: folds 
RICKA16: folds 
dizzyryano79: folds 
I The King I: folds 
Uncalled bet ($2) returned to oscarleon
oscarleon collected $2.50 from pot
oscarleon: doesn't show hand 
*** SUMMARY ***
Total pot $2.50 | Rake $0 
Seat 1: IdiotFromNE folded before Flop (didn't bet)
Seat 2: Painkiller72 folded before Flop (didn't bet)
Seat 3: RICKA16 (button) folded before Flop (didn't bet)
Seat 4: dizzyryano79 (small blind) folded before Flop
Seat 5: I The King I (big blind) folded before Flop
Seat 6: djammusic folded before Flop (didn't bet)
Seat 7: oscarleon collected ($2.50)
Seat 8: matiko09 folded before Flop (didn't bet)
Seat 9: apfush folded before Flop (didn't bet)





PokerStars Hand #151207788222:  Hold'em No Limit ($0.50/$1.00 USD) - 2016/03/31 12:39:59 CET [2016/03/31 6:39:59 ET]
Table 'Aquila' 9-max Seat #2 is the button
Seat 1: BOAYARSKIY ($51.40 in chips) 
Seat 2: Avtovo ($100 in chips) 
Seat 3: laco121 ($53.54 in chips) 
Seat 5: adelfaz ($54.34 in chips) 
Seat 6: maxxmeister ($121.20 in chips) 
Seat 7: PacPacBum ($125.90 in chips) 
Seat 8: matiko09 ($101.96 in chips) 
Seat 9: apfush ($100 in chips) 
laco121: posts small blind $0.50
adelfaz: posts big blind $1
BOAYARSKIY: posts the ante $0.20
Avtovo: posts the ante $0.20
laco121: posts the ante $0.20
adelfaz: posts the ante $0.20
maxxmeister: posts the ante $0.20
PacPacBum: posts the ante $0.20
matiko09: posts the ante $0.20
apfush: posts the ante $0.20
*** HOLE CARDS ***
Dealt to matiko09 [9h 6s]
maxxmeister: folds 
PacPacBum: folds 
matiko09: folds 
apfush: folds 
BOAYARSKIY: folds 
Avtovo: folds 
laco121: calls $0.50
adelfaz: raises $3.60 to $4.60
laco121: folds 
Uncalled bet ($3.60) returned to adelfaz
adelfaz collected $3.60 from pot
*** SUMMARY ***
Total pot $3.60 | Rake $0 
Seat 1: BOAYARSKIY folded before Flop (didn't bet)
Seat 2: Avtovo (button) folded before Flop (didn't bet)
Seat 3: laco121 (small blind) folded before Flop
Seat 5: adelfaz (big blind) collected ($3.60)
Seat 6: maxxmeister folded before Flop (didn't bet)
Seat 7: PacPacBum folded before Flop (didn't bet)
Seat 8: matiko09 folded before Flop (didn't bet)
Seat 9: apfush folded before Flop (didn't bet)





PokerStars Hand #151207793516:  Hold'em No Limit ($1/$2 USD) - 2016/03/31 12:40:11 CET [2016/03/31 6:40:11 ET]
Table 'Probitas' 9-max Seat #3 is the button
Seat 1: rmanjkeee ($179.04 in chips) 
Seat 3: azvazdam ($190.99 in chips) 
Seat 4: Painkiller72 ($222.21 in chips) 
Seat 5: matiko09 ($200 in chips) 
Seat 6: Kreuznagel ($449.70 in chips) 
Seat 7: coinflip_si ($301.53 in chips) 
Seat 8: BOAYARSKIY ($143.45 in chips) 
Seat 9: apfush ($309.99 in chips) 
Painkiller72: posts small blind $1
matiko09: posts big blind $2
*** HOLE CARDS ***
Dealt to matiko09 [7d Jd]
Kreuznagel: raises $2.78 to $4.78
coinflip_si: folds 
BOAYARSKIY: folds 
apfush: folds 
rmanjkeee: folds 
azvazdam: calls $4.78
Painkiller72: folds 
matiko09: folds 
*** FLOP *** [4h 3c 9s]
Kreuznagel: checks 
azvazdam: checks 
*** TURN *** [4h 3c 9s] [2c]
Kreuznagel: bets $5.53
azvazdam: calls $5.53
*** RIVER *** [4h 3c 9s 2c] [Td]
Kreuznagel: checks 
azvazdam: checks 
*** SHOW DOWN ***
Kreuznagel: shows [8h 8c] (a pair of Eights)
azvazdam: shows [Tc Ah] (a pair of Tens)
azvazdam collected $22.44 from pot
*** SUMMARY ***
Total pot $23.62 | Rake $1.18 
Board [4h 3c 9s 2c Td]
Seat 1: rmanjkeee folded before Flop (didn't bet)
Seat 3: azvazdam (button) showed [Tc Ah] and won ($22.44) with a pair of Tens
Seat 4: Painkiller72 (small blind) folded before Flop
Seat 5: matiko09 (big blind) folded before Flop
Seat 6: Kreuznagel showed [8h 8c] and lost with a pair of Eights
Seat 7: coinflip_si folded before Flop (didn't bet)
Seat 8: BOAYARSKIY folded before Flop (didn't bet)
Seat 9: apfush folded before Flop (didn't bet)





PokerStars Hand #151207794135:  Hold'em No Limit ($0.50/$1.00 USD) - 2016/03/31 12:40:12 CET [2016/03/31 6:40:12 ET]
Table 'Yazhi' 9-max Seat #4 is the button
Seat 1: matiko09 ($100 in chips) 
Seat 2: xHourglass ($110.14 in chips) 
Seat 3: Chin41178 ($90.91 in chips) 
Seat 4: apfush ($178.96 in chips) 
Seat 5: IdiotFromNE ($103 in chips) 
Seat 6: Reven9er ($235.49 in chips) 
Seat 7: Avtovo ($100 in chips) 
Seat 8: pk4DW ($48.33 in chips) 
Seat 9: oscarleon ($197.73 in chips) 
IdiotFromNE: posts small blind $0.50
Reven9er: posts big blind $1
*** HOLE CARDS ***
Dealt to matiko09 [Jd Qh]
Avtovo: folds 
pk4DW: folds 
oscarleon: folds 
matiko09: folds 
xHourglass: raises $2 to $3
Chin41178: folds 
apfush: folds 
IdiotFromNE: folds 
Reven9er: folds 
Uncalled bet ($2) returned to xHourglass
xHourglass collected $2.50 from pot
xHourglass: doesn't show hand 
*** SUMMARY ***
Total pot $2.50 | Rake $0 
Seat 1: matiko09 folded before Flop (didn't bet)
Seat 2: xHourglass collected ($2.50)
Seat 3: Chin41178 folded before Flop (didn't bet)
Seat 4: apfush (button) folded before Flop (didn't bet)
Seat 5: IdiotFromNE (small blind) folded before Flop
Seat 6: Reven9er (big blind) folded before Flop
Seat 7: Avtovo folded before Flop (didn't bet)
Seat 8: pk4DW folded before Flop (didn't bet)
Seat 9: oscarleon folded before Flop (didn't bet)





PokerStars Hand #151207797171:  Hold'em No Limit ($0.50/$1.00 USD) - 2016/03/31 12:40:18 CET [2016/03/31 6:40:18 ET]
Table 'Bussolini III' 9-max Seat #2 is the button
Seat 1: I The King I ($193.46 in chips) 
Seat 2: BOAYARSKIY ($40 in chips) 
Seat 3: 20grodt16 ($200.22 in chips) 
Seat 5: Kreuznagel ($100 in chips) 
Seat 6: matiko09 ($135.24 in chips) 
Seat 7: IdiotFromNE ($108.08 in chips) 
Seat 8: oscarleon ($100 in chips) 
Seat 9: RICKA16 ($100 in chips) 
20grodt16: posts small blind $0.50
Kreuznagel: posts big blind $1
*** HOLE CARDS ***
Dealt to matiko09 [2s 9s]
matiko09: folds 
IdiotFromNE: folds 
oscarleon: raises $2 to $3
RICKA16: folds 
I The King I: calls $3
BOAYARSKIY: folds 
20grodt16: folds 
Kreuznagel: folds 
*** FLOP *** [Td 5d Ks]
oscarleon: bets $5
I The King I: calls $5
*** TURN *** [Td 5d Ks] [Kc]
oscarleon: bets $12
I The King I: folds 
Uncalled bet ($12) returned to oscarleon
oscarleon collected $16.62 from pot
oscarleon: doesn't show hand 
*** SUMMARY ***
Total pot $17.50 | Rake $0.88 
Board [Td 5d Ks Kc]
Seat 1: I The King I folded on the Turn
Seat 2: BOAYARSKIY (button) folded before Flop (didn't bet)
Seat 3: 20grodt16 (small blind) folded before Flop
Seat 5: Kreuznagel (big blind) folded before Flop
Seat 6: matiko09 folded before Flop (didn't bet)
Seat 7: IdiotFromNE folded before Flop (didn't bet)
Seat 8: oscarleon collected ($16.62)
Seat 9: RICKA16 folded before Flop (didn't bet)





PokerStars Hand #151207800076:  Hold'em No Limit ($0.50/$1.00 USD) - 2016/03/31 12:40:24 CET [2016/03/31 6:40:24 ET]
Table 'Haworth II' 9-max Seat #4 is the button
Seat 1: godfrey004 ($106.20 in chips) 
Seat 2: AlKatrone ($130.46 in chips) 
Seat 3: matiko09 ($102.68 in chips) 
Seat 4: I The King I ($100 in chips) 
Seat 5: Kreuznagel ($102.10 in chips) 
Seat 6: Pvsx. ($101.50 in chips) 
Seat 7: mheris ($121.72 in chips) 
Seat 8: oscarleon ($101.50 in chips) 
Seat 9: Zeeshka ($100 in chips) 
Kreuznagel: posts small blind $0.50
Pvsx.: posts big blind $1
*** HOLE CARDS ***
Dealt to matiko09 [2h 9h]
mheris: folds 
oscarleon: folds 
Zeeshka: folds 
godfrey004: calls $1
AlKatrone: folds 
matiko09: folds 
I The King I: raises $3 to $4
Kreuznagel: folds 
Pvsx.: folds 
godfrey004: calls $3
*** FLOP *** [5s Jh 4h]
godfrey004: checks 
I The King I: bets $6
godfrey004: calls $6
*** TURN *** [5s Jh 4h] [Ac]
godfrey004: checks 
I The King I: bets $14
godfrey004: calls $14
*** RIVER *** [5s Jh 4h Ac] [Qd]
godfrey004: checks 
I The King I: checks 
*** SHOW DOWN ***
godfrey004: shows [3h 3d] (a pair of Threes)
I The King I: shows [8h Qh] (a pair of Queens)
I The King I collected $47.02 from pot
*** SUMMARY ***
Total pot $49.50 | Rake $2.48 
Board [5s Jh 4h Ac Qd]
Seat 1: godfrey004 showed [3h 3d] and lost with a pair of Threes
Seat 2: AlKatrone folded before Flop (didn't bet)
Seat 3: matiko09 folded before Flop (didn't bet)
Seat 4: I The King I (button) showed [8h Qh] and won ($47.02) with a pair of Queens
Seat 5: Kreuznagel (small blind) folded before Flop
Seat 6: Pvsx. (big blind) folded before Flop
Seat 7: mheris folded before Flop (didn't bet)
Seat 8: oscarleon folded before Flop (didn't bet)
Seat 9: Zeeshka folded before Flop (didn't bet)





PokerStars Hand #151207800832:  Hold'em No Limit (€0.50/€1.00 EUR) - 2016/03/31 12:40:26 CET [2016/03/31 6:40:26 ET]
Table 'Pioneer II' 9-max Seat #8 is the button
Seat 1: Kreuznagel (€101.50 in chips) 
Seat 2: IdiotFromNE (€132.02 in chips) 
Seat 3: Zeeshka (€100 in chips) 
Seat 4: Painkiller72 (€146.39 in chips) 
Seat 5: TOTO220773 (€71.16 in chips) 
Seat 6: matiko09 (€104.50 in chips) 
Seat 7: AlKatrone (€130.41 in chips) 
Seat 8: PacPacBum (€103.22 in chips) 
Seat 9: DUkalisUA (€103.12 in chips) 
DUkalisUA: posts small blind €0.50
Kreuznagel: posts big blind €1
*** HOLE CARDS ***
Dealt to matiko09 [Qc 8s]
IdiotFromNE: raises €1.50 to €2.50
Zeeshka: folds 
Painkiller72: folds 
TOTO220773: folds 
TOTO220773 leaves the table
matiko09: folds 
AlKatrone: folds 
PacPacBum: folds 
Avtovo joins the table at seat #5 
Avtovo leaves the table
DUkalisUA: folds 
Kreuznagel: folds 
Uncalled bet (€1.50) returned to IdiotFromNE
IdiotFromNE collected €2.50 from pot
IdiotFromNE: doesn't show hand 
*** SUMMARY ***
Total pot €2.50 | Rake €0 
Seat 1: Kreuznagel (big blind) folded before Flop
Seat 2: IdiotFromNE collected (€2.50)
Seat 3: Zeeshka folded before Flop (didn't bet)
Seat 4: Painkiller72 folded before Flop (didn't bet)
Seat 5: TOTO220773 folded before Flop (didn't bet)
Seat 6: matiko09 folded before Flop (didn't bet)
Seat 7: AlKatrone folded before Flop (didn't bet)
Seat 8: PacPacBum (button) folded before Flop (didn't bet)
Seat 9: DUkalisUA (small blind) folded before Flop





PokerStars Hand #151207801318:  Hold'em No Limit ($0.50/$1.00 USD) - 2016/03/31 12:40:27 CET [2016/03/31 6:40:27 ET]
Table 'Egeria II' 9-max Seat #3 is the button
Seat 1: oscarleon ($124.03 in chips) 
Seat 2: I The King I ($196.50 in chips) 
Seat 3: Pvsx. ($102.72 in chips) 
Seat 4: matiko09 ($100 in chips) 
Seat 5: apfush ($142.82 in chips) 
Seat 6: xHourglass ($100 in chips) 
Seat 7: Reven9er ($118.08 in chips) 
Seat 8: Kreuznagel ($135.01 in chips) 
Seat 9: miracolix50 ($75.89 in chips) 
matiko09: posts small blind $0.50
apfush: posts big blind $1
*** HOLE CARDS ***
Dealt to matiko09 [3s 4d]
xHourglass: folds 
Reven9er: folds 
Kreuznagel: folds 
miracolix50: folds 
oscarleon: folds 
I The King I: raises $1.50 to $2.50
Pvsx.: raises $6.50 to $9
matiko09: folds 
apfush: folds 
I The King I: raises $11 to $20
Pvsx.: calls $11
*** FLOP *** [Jd 4s 7d]
I The King I: checks 
Pvsx.: bets $19.71
I The King I: folds 
Uncalled bet ($19.71) returned to Pvsx.
Pvsx. collected $39.42 from pot
Pvsx.: doesn't show hand 
*** SUMMARY ***
Total pot $41.50 | Rake $2.08 
Board [Jd 4s 7d]
Seat 1: oscarleon folded before Flop (didn't bet)
Seat 2: I The King I folded on the Flop
Seat 3: Pvsx. (button) collected ($39.42)
Seat 4: matiko09 (small blind) folded before Flop
Seat 5: apfush (big blind) folded before Flop
Seat 6: xHourglass folded before Flop (didn't bet)
Seat 7: Reven9er folded before Flop (didn't bet)
Seat 8: Kreuznagel folded before Flop (didn't bet)
Seat 9: miracolix50 folded before Flop (didn't bet)





PokerStars Hand #151207804768:  Hold'em No Limit ($0.50/$1.00 USD) - 2016/03/31 12:40:34 CET [2016/03/31 6:40:34 ET]
Table 'Herge II' 9-max Seat #5 is the button
Seat 1: Chiapel ($101.92 in chips) 
Seat 2: DUkalisUA ($100 in chips) 
Seat 3: matiko09 ($211.77 in chips) 
Seat 4: Kreuznagel ($100 in chips) 
Seat 5: I The King I ($119.28 in chips) 
Seat 6: masaytoo ($95 in chips) 
Seat 7: Zeeshka ($140.95 in chips) 
Seat 8: IdiotFromNE ($100 in chips) 
Seat 9: fatstacks122 ($129.83 in chips) 
masaytoo: posts small blind $0.50
Zeeshka: posts big blind $1
*** HOLE CARDS ***
Dealt to matiko09 [Kd 4d]
IdiotFromNE: folds 
fatstacks122 has timed out
fatstacks122: folds 
Chiapel: raises $1 to $2
DUkalisUA: folds 
matiko09: folds 
Kreuznagel: folds 
I The King I: folds 
masaytoo: calls $1.50
Zeeshka: folds 
*** FLOP *** [8h 6s 2d]
masaytoo: checks 
Chiapel: bets $4.75
masaytoo: folds 
Uncalled bet ($4.75) returned to Chiapel
Chiapel collected $4.75 from pot
Chiapel: doesn't show hand 
*** SUMMARY ***
Total pot $5 | Rake $0.25 
Board [8h 6s 2d]
Seat 1: Chiapel collected ($4.75)
Seat 2: DUkalisUA folded before Flop (didn't bet)
Seat 3: matiko09 folded before Flop (didn't bet)
Seat 4: Kreuznagel folded before Flop (didn't bet)
Seat 5: I The King I (button) folded before Flop (didn't bet)
Seat 6: masaytoo (small blind) folded on the Flop
Seat 7: Zeeshka (big blind) folded before Flop
Seat 8: IdiotFromNE folded before Flop (didn't bet)
Seat 9: fatstacks122 folded before Flop (didn't bet)





PokerStars Hand #151207808481:  Hold'em No Limit ($0.50/$1.00 USD) - 2016/03/31 12:40:42 CET [2016/03/31 6:40:42 ET]
Table 'Icarus III' 9-max Seat #4 is the button
Seat 1: IdiotFromNE ($112.88 in chips) 
Seat 2: Painkiller72 ($100 in chips) 
Seat 3: RICKA16 ($106.02 in chips) 
Seat 4: dizzyryano79 ($36.05 in chips) 
Seat 5: I The King I ($114.25 in chips) 
Seat 6: djammusic ($47.58 in chips) 
Seat 7: oscarleon ($152.01 in chips) 
Seat 8: matiko09 ($102.52 in chips) 
Seat 9: apfush ($123.96 in chips) 
I The King I: posts small blind $0.50
djammusic: posts big blind $1
*** HOLE CARDS ***
Dealt to matiko09 [9d 9c]
oscarleon: raises $2 to $3
matiko09: calls $3
apfush: folds 
IdiotFromNE: folds 
Painkiller72: folds 
RICKA16: folds 
dizzyryano79: folds 
I The King I: folds 
djammusic: folds 
*** FLOP *** [3d 2c Ad]
oscarleon: bets $5
matiko09: calls $5
*** TURN *** [3d 2c Ad] [4c]
oscarleon: checks 
matiko09: checks 
*** RIVER *** [3d 2c Ad 4c] [5s]
oscarleon: checks 
matiko09: checks 
*** SHOW DOWN ***
oscarleon: shows [Jd Ac] (a straight, Ace to Five)
matiko09: shows [9d 9c] (a straight, Ace to Five)
oscarleon collected $8.31 from pot
matiko09 collected $8.31 from pot
*** SUMMARY ***
Total pot $17.50 | Rake $0.88 
Board [3d 2c Ad 4c 5s]
Seat 1: IdiotFromNE folded before Flop (didn't bet)
Seat 2: Painkiller72 folded before Flop (didn't bet)
Seat 3: RICKA16 folded before Flop (didn't bet)
Seat 4: dizzyryano79 (button) folded before Flop (didn't bet)
Seat 5: I The King I (small blind) folded before Flop
Seat 6: djammusic (big blind) folded before Flop
Seat 7: oscarleon showed [Jd Ac] and won ($8.31) with a straight, Ace to Five
Seat 8: matiko09 showed [9d 9c] and won ($8.31) with a straight, Ace to Five
Seat 9: apfush folded before Flop (didn't bet)





PokerStars Hand #151207810198:  Hold'em No Limit ($0.50/$1.00 USD) - 2016/03/31 12:40:46 CET [2016/03/31 6:40:46 ET]
Table 'Yazhi' 9-max Seat #5 is the button
Seat 1: matiko09 ($100 in chips) 
Seat 2: xHourglass ($111.64 in chips) 
Seat 3: Chin41178 ($90.91 in chips) 
Seat 4: apfush ($178.96 in chips) 
Seat 5: IdiotFromNE ($102.50 in chips) 
Seat 6: Reven9er ($234.49 in chips) 
Seat 7: Avtovo ($100 in chips) 
Seat 8: pk4DW ($48.33 in chips) 
Seat 9: oscarleon ($197.73 in chips) 
Reven9er: posts small blind $0.50
Avtovo: posts big blind $1
*** HOLE CARDS ***
Dealt to matiko09 [6d 8h]
pk4DW: folds 
oscarleon: raises $2 to $3
matiko09: folds 
xHourglass: folds 
Chin41178: folds 
apfush: folds 
IdiotFromNE: folds 
Reven9er: folds 
Avtovo: folds 
Uncalled bet ($2) returned to oscarleon
oscarleon collected $2.50 from pot
oscarleon: doesn't show hand 
*** SUMMARY ***
Total pot $2.50 | Rake $0 
Seat 1: matiko09 folded before Flop (didn't bet)
Seat 2: xHourglass folded before Flop (didn't bet)
Seat 3: Chin41178 folded before Flop (didn't bet)
Seat 4: apfush folded before Flop (didn't bet)
Seat 5: IdiotFromNE (button) folded before Flop (didn't bet)
Seat 6: Reven9er (small blind) folded before Flop
Seat 7: Avtovo (big blind) folded before Flop
Seat 8: pk4DW folded before Flop (didn't bet)
Seat 9: oscarleon collected ($2.50)





PokerStars Hand #151207811931:  Hold'em No Limit ($1/$2 USD) - 2016/03/31 12:40:49 CET [2016/03/31 6:40:49 ET]
Table 'Desiderata' 9-max Seat #3 is the button
Seat 1: GALWACONT ($186.62 in chips) 
Seat 2: ilaviiitech ($200 in chips) 
Seat 3: djammusic ($77 in chips) 
Seat 4: matiko09 ($319.85 in chips) 
Seat 5: Kreuznagel ($332.55 in chips) 
Seat 6: rmanjkeee ($114.45 in chips) 
Seat 7: apfush ($255.83 in chips) 
Seat 8: DUkalisUA ($200 in chips) 
Seat 9: Painkiller72 ($200 in chips) 
matiko09: posts small blind $1
Kreuznagel: posts big blind $2
*** HOLE CARDS ***
Dealt to matiko09 [Js 8s]
rmanjkeee: folds 
apfush: folds 
DUkalisUA: folds 
Painkiller72: folds 
GALWACONT: folds 
ilaviiitech: raises $4 to $6
djammusic: folds 
matiko09: folds 
Kreuznagel: raises $14 to $20
ilaviiitech: raises $24 to $44
Kreuznagel: folds 
Uncalled bet ($24) returned to ilaviiitech
ilaviiitech collected $41 from pot
ilaviiitech: doesn't show hand 
*** SUMMARY ***
Total pot $41 | Rake $0 
Seat 1: GALWACONT folded before Flop (didn't bet)
Seat 2: ilaviiitech collected ($41)
Seat 3: djammusic (button) folded before Flop (didn't bet)
Seat 4: matiko09 (small blind) folded before Flop
Seat 5: Kreuznagel (big blind) folded before Flop
Seat 6: rmanjkeee folded before Flop (didn't bet)
Seat 7: apfush folded before Flop (didn't bet)
Seat 8: DUkalisUA folded before Flop (didn't bet)
Seat 9: Painkiller72 folded before Flop (didn't bet)





PokerStars Hand #151207814072:  Hold'em No Limit ($0.50/$1.00 USD) - 2016/03/31 12:40:54 CET [2016/03/31 6:40:54 ET]
Table 'Aquila' 9-max Seat #3 is the button
Seat 1: BOAYARSKIY ($51.20 in chips) 
Seat 2: Avtovo ($100 in chips) 
Seat 3: laco121 ($52.34 in chips) 
Seat 5: adelfaz ($56.74 in chips) 
Seat 6: maxxmeister ($121 in chips) 
Seat 7: PacPacBum ($125.70 in chips) 
Seat 8: matiko09 ($101.76 in chips) 
Seat 9: apfush ($100 in chips) 
adelfaz: posts small blind $0.50
maxxmeister: posts big blind $1
BOAYARSKIY: posts the ante $0.20
Avtovo: posts the ante $0.20
laco121: posts the ante $0.20
adelfaz: posts the ante $0.20
maxxmeister: posts the ante $0.20
PacPacBum: posts the ante $0.20
matiko09: posts the ante $0.20
apfush: posts the ante $0.20
*** HOLE CARDS ***
Dealt to matiko09 [9c Tc]
PacPacBum: folds 
matiko09: raises $2 to $3
apfush: folds 
BOAYARSKIY: folds 
Avtovo: calls $3
laco121: folds 
adelfaz: folds 
maxxmeister: folds 
*** FLOP *** [3c Js Kd]
matiko09: bets $5.62
Avtovo: folds 
Uncalled bet ($5.62) returned to matiko09
matiko09 collected $8.64 from pot
matiko09: doesn't show hand 
*** SUMMARY ***
Total pot $9.10 | Rake $0.46 
Board [3c Js Kd]
Seat 1: BOAYARSKIY folded before Flop (didn't bet)
Seat 2: Avtovo folded on the Flop
Seat 3: laco121 (button) folded before Flop (didn't bet)
Seat 5: adelfaz (small blind) folded before Flop
Seat 6: maxxmeister (big blind) folded before Flop
Seat 7: PacPacBum folded before Flop (didn't bet)
Seat 8: matiko09 collected ($8.64)
Seat 9: apfush folded before Flop (didn't bet)





PokerStars Hand #151207822474:  Hold'em No Limit ($1/$2 USD) - 2016/03/31 12:41:11 CET [2016/03/31 6:41:11 ET]
Table 'Probitas' 9-max Seat #4 is the button
Seat 1: rmanjkeee ($179.04 in chips) 
Seat 3: azvazdam ($203.12 in chips) 
Seat 4: Painkiller72 ($221.21 in chips) 
Seat 5: matiko09 ($200 in chips) 
Seat 6: Kreuznagel ($439.39 in chips) 
Seat 7: coinflip_si ($301.53 in chips) 
Seat 8: BOAYARSKIY ($143.45 in chips) 
Seat 9: apfush ($309.99 in chips) 
matiko09: posts small blind $1
Kreuznagel: posts big blind $2
*** HOLE CARDS ***
Dealt to matiko09 [3c Ks]
coinflip_si: folds 
BOAYARSKIY: folds 
apfush: folds 
rmanjkeee: folds 
azvazdam: folds 
Painkiller72: folds 
matiko09: folds 
Uncalled bet ($1) returned to Kreuznagel
Kreuznagel collected $2 from pot
Kreuznagel: doesn't show hand 
*** SUMMARY ***
Total pot $2 | Rake $0 
Seat 1: rmanjkeee folded before Flop (didn't bet)
Seat 3: azvazdam folded before Flop (didn't bet)
Seat 4: Painkiller72 (button) folded before Flop (didn't bet)
Seat 5: matiko09 (small blind) folded before Flop
Seat 6: Kreuznagel (big blind) collected ($2)
Seat 7: coinflip_si folded before Flop (didn't bet)
Seat 8: BOAYARSKIY folded before Flop (didn't bet)
Seat 9: apfush folded before Flop (didn't bet)





PokerStars Hand #151207825757:  Hold'em No Limit ($1/$2 USD) - 2016/03/31 12:41:18 CET [2016/03/31 6:41:18 ET]
Table 'Coelestina II' 9-max Seat #5 is the button
Seat 1: PacPacBum ($221.93 in chips) 
Seat 2: Kreuznagel ($226.73 in chips) 
Seat 3: ilaviiitech ($201.30 in chips) 
Seat 4: matiko09 ($200 in chips) 
Seat 5: Painkiller72 ($200 in chips) 
Seat 6: Avtovo ($209.62 in chips) 
Seat 7: rmanjkeee ($80 in chips) 
Seat 8: DUkalisUA ($215.45 in chips) 
Seat 9: fonng ($194.45 in chips) 
Avtovo: posts small blind $1
rmanjkeee: posts big blind $2
*** HOLE CARDS ***
Dealt to matiko09 [Jc Kd]
DUkalisUA: folds 
fonng: folds 
PacPacBum: folds 
Kreuznagel: folds 
ilaviiitech: folds 
matiko09: raises $3 to $5
Painkiller72: folds 
Avtovo: raises $13 to $18
rmanjkeee: folds 
matiko09: folds 
Uncalled bet ($13) returned to Avtovo
Avtovo collected $12 from pot
Avtovo: doesn't show hand 
*** SUMMARY ***
Total pot $12 | Rake $0 
Seat 1: PacPacBum folded before Flop (didn't bet)
Seat 2: Kreuznagel folded before Flop (didn't bet)
Seat 3: ilaviiitech folded before Flop (didn't bet)
Seat 4: matiko09 folded before Flop
Seat 5: Painkiller72 (button) folded before Flop (didn't bet)
Seat 6: Avtovo (small blind) collected ($12)
Seat 7: rmanjkeee (big blind) folded before Flop
Seat 8: DUkalisUA folded before Flop (didn't bet)
Seat 9: fonng folded before Flop (didn't bet)





PokerStars Hand #151207826617:  Hold'em No Limit (€0.50/€1.00 EUR) - 2016/03/31 12:41:20 CET [2016/03/31 6:41:20 ET]
Table 'Pioneer II' 9-max Seat #9 is the button
Seat 1: Kreuznagel (€100.50 in chips) 
Seat 2: IdiotFromNE (€133.52 in chips) 
Seat 3: Zeeshka (€100 in chips) 
Seat 4: Painkiller72 (€146.39 in chips) 
Seat 6: matiko09 (€104.50 in chips) 
Seat 7: AlKatrone (€130.41 in chips) 
Seat 8: PacPacBum (€103.22 in chips) 
Seat 9: DUkalisUA (€102.62 in chips) 
Kreuznagel: posts small blind €0.50
IdiotFromNE: posts big blind €1
*** HOLE CARDS ***
Dealt to matiko09 [Qc Tc]
Zeeshka: folds 
Painkiller72: folds 
matiko09: raises €2 to €3
AlKatrone: folds 
PacPacBum: folds 
DUkalisUA: folds 
Kreuznagel: raises €7 to €10
IdiotFromNE: folds 
matiko09: folds 
Uncalled bet (€7) returned to Kreuznagel
Kreuznagel collected €7 from pot
Kreuznagel: doesn't show hand 
*** SUMMARY ***
Total pot €7 | Rake €0 
Seat 1: Kreuznagel (small blind) collected (€7)
Seat 2: IdiotFromNE (big blind) folded before Flop
Seat 3: Zeeshka folded before Flop (didn't bet)
Seat 4: Painkiller72 folded before Flop (didn't bet)
Seat 6: matiko09 folded before Flop
Seat 7: AlKatrone folded before Flop (didn't bet)
Seat 8: PacPacBum folded before Flop (didn't bet)
Seat 9: DUkalisUA (button) folded before Flop (didn't bet)





PokerStars Hand #151207828193:  Hold'em No Limit ($0.50/$1.00 USD) - 2016/03/31 12:41:23 CET [2016/03/31 6:41:23 ET]
Table 'Yazhi' 9-max Seat #6 is the button
Seat 1: matiko09 ($100 in chips) 
Seat 2: xHourglass ($111.64 in chips) 
Seat 3: Chin41178 ($90.91 in chips) 
Seat 4: apfush ($178.96 in chips) 
Seat 5: IdiotFromNE ($102.50 in chips) 
Seat 6: Reven9er ($233.99 in chips) 
Seat 7: Avtovo ($100 in chips) 
Seat 8: pk4DW ($48.33 in chips) 
Seat 9: oscarleon ($199.23 in chips) 
Avtovo: posts small blind $0.50
pk4DW: posts big blind $1
*** HOLE CARDS ***
Dealt to matiko09 [7h 8s]
oscarleon: folds 
matiko09: folds 
xHourglass: raises $2 to $3
Chin41178: folds 
apfush: folds 
IdiotFromNE: folds 
Reven9er: folds 
Avtovo: folds 
pk4DW: folds 
Uncalled bet ($2) returned to xHourglass
xHourglass collected $2.50 from pot
xHourglass: doesn't show hand 
*** SUMMARY ***
Total pot $2.50 | Rake $0 
Seat 1: matiko09 folded before Flop (didn't bet)
Seat 2: xHourglass collected ($2.50)
Seat 3: Chin41178 folded before Flop (didn't bet)
Seat 4: apfush folded before Flop (didn't bet)
Seat 5: IdiotFromNE folded before Flop (didn't bet)
Seat 6: Reven9er (button) folded before Flop (didn't bet)
Seat 7: Avtovo (small blind) folded before Flop
Seat 8: pk4DW (big blind) folded before Flop
Seat 9: oscarleon folded before Flop (didn't bet)





PokerStars Hand #151207832825:  Hold'em No Limit ($1/$2 USD) - 2016/03/31 12:41:33 CET [2016/03/31 6:41:33 ET]
Table 'Probitas' 9-max Seat #5 is the button
Seat 1: rmanjkeee ($179.04 in chips) 
Seat 3: azvazdam ($203.12 in chips) 
Seat 4: Painkiller72 ($221.21 in chips) 
Seat 5: matiko09 ($200 in chips) 
Seat 6: Kreuznagel ($440.39 in chips) 
Seat 7: coinflip_si ($301.53 in chips) 
Seat 8: BOAYARSKIY ($143.45 in chips) 
Seat 9: apfush ($309.99 in chips) 
Kreuznagel: posts small blind $1
coinflip_si: posts big blind $2
*** HOLE CARDS ***
Dealt to matiko09 [Qh 6h]
BOAYARSKIY: folds 
apfush: folds 
rmanjkeee: folds 
azvazdam: folds 
Painkiller72: folds 
matiko09: raises $2.54 to $4.54
Kreuznagel: folds 
coinflip_si: folds 
Uncalled bet ($2.54) returned to matiko09
matiko09 collected $5 from pot
matiko09: doesn't show hand 
*** SUMMARY ***
Total pot $5 | Rake $0 
Seat 1: rmanjkeee folded before Flop (didn't bet)
Seat 3: azvazdam folded before Flop (didn't bet)
Seat 4: Painkiller72 folded before Flop (didn't bet)
Seat 5: matiko09 (button) collected ($5)
Seat 6: Kreuznagel (small blind) folded before Flop
Seat 7: coinflip_si (big blind) folded before Flop
Seat 8: BOAYARSKIY folded before Flop (didn't bet)
Seat 9: apfush folded before Flop (didn't bet)





PokerStars Hand #151207837009:  Hold'em No Limit ($0.50/$1.00 USD) - 2016/03/31 12:41:42 CET [2016/03/31 6:41:42 ET]
Table 'Icarus III' 9-max Seat #5 is the button
Seat 1: IdiotFromNE ($112.88 in chips) 
Seat 2: Painkiller72 ($100 in chips) 
Seat 3: RICKA16 ($106.02 in chips) 
Seat 4: dizzyryano79 ($36.05 in chips) 
Seat 5: I The King I ($113.75 in chips) 
Seat 6: djammusic ($46.58 in chips) 
Seat 7: oscarleon ($152.32 in chips) 
Seat 8: matiko09 ($102.83 in chips) 
Seat 9: apfush ($123.96 in chips) 
djammusic: posts small blind $0.50
oscarleon: posts big blind $1
*** HOLE CARDS ***
Dealt to matiko09 [8d Ah]
matiko09: folds 
apfush: folds 
IdiotFromNE has timed out
IdiotFromNE: folds 
Painkiller72: folds 
RICKA16: folds 
dizzyryano79: calls $1
I The King I: folds 
djammusic: folds 
oscarleon: checks 
*** FLOP *** [Jh 8c Ts]
oscarleon: checks 
dizzyryano79: bets $1.19
oscarleon: folds 
Uncalled bet ($1.19) returned to dizzyryano79
dizzyryano79 collected $2.38 from pot
dizzyryano79: doesn't show hand 
*** SUMMARY ***
Total pot $2.50 | Rake $0.12 
Board [Jh 8c Ts]
Seat 1: IdiotFromNE folded before Flop (didn't bet)
Seat 2: Painkiller72 folded before Flop (didn't bet)
Seat 3: RICKA16 folded before Flop (didn't bet)
Seat 4: dizzyryano79 collected ($2.38)
Seat 5: I The King I (button) folded before Flop (didn't bet)
Seat 6: djammusic (small blind) folded before Flop
Seat 7: oscarleon (big blind) folded on the Flop
Seat 8: matiko09 folded before Flop (didn't bet)
Seat 9: apfush folded before Flop (didn't bet)





PokerStars Hand #151207838372:  Hold'em No Limit ($0.50/$1.00 USD) - 2016/03/31 12:41:45 CET [2016/03/31 6:41:45 ET]
Table 'Herge II' 9-max Seat #6 is the button
Seat 1: Chiapel ($104.67 in chips) 
Seat 2: DUkalisUA ($100 in chips) 
Seat 3: matiko09 ($211.77 in chips) 
Seat 4: Kreuznagel ($100 in chips) 
Seat 5: I The King I ($119.28 in chips) 
Seat 6: masaytoo ($93 in chips) 
Seat 7: Zeeshka ($139.95 in chips) 
Seat 8: IdiotFromNE ($100 in chips) 
Seat 9: fatstacks122 ($129.83 in chips) 
Zeeshka: posts small blind $0.50
IdiotFromNE: posts big blind $1
*** HOLE CARDS ***
Dealt to matiko09 [3c Jh]
fatstacks122: folds 
Chiapel: folds 
DUkalisUA: folds 
matiko09: folds 
Kreuznagel: folds 
I The King I: raises $1.50 to $2.50
masaytoo: folds 
Zeeshka: folds 
IdiotFromNE: calls $1.50
*** FLOP *** [3s 9c Td]
IdiotFromNE: checks 
I The King I: checks 
*** TURN *** [3s 9c Td] [Kd]
IdiotFromNE: bets $4.17
I The King I: calls $4.17
*** RIVER *** [3s 9c Td Kd] [Ah]
IdiotFromNE: bets $10.52
I The King I: calls $10.52
*** SHOW DOWN ***
IdiotFromNE: shows [8c 7c] (high card Ace)
I The King I: shows [Ad Ks] (two pair, Aces and Kings)
I The King I collected $33.14 from pot
*** SUMMARY ***
Total pot $34.88 | Rake $1.74 
Board [3s 9c Td Kd Ah]
Seat 1: Chiapel folded before Flop (didn't bet)
Seat 2: DUkalisUA folded before Flop (didn't bet)
Seat 3: matiko09 folded before Flop (didn't bet)
Seat 4: Kreuznagel folded before Flop (didn't bet)
Seat 5: I The King I showed [Ad Ks] and won ($33.14) with two pair, Aces and Kings
Seat 6: masaytoo (button) folded before Flop (didn't bet)
Seat 7: Zeeshka (small blind) folded before Flop
Seat 8: IdiotFromNE (big blind) showed [8c 7c] and lost with high card Ace
Seat 9: fatstacks122 folded before Flop (didn't bet)





PokerStars Hand #151207838862:  Hold'em No Limit ($0.50/$1.00 USD) - 2016/03/31 12:41:46 CET [2016/03/31 6:41:46 ET]
Table 'Egeria II' 9-max Seat #4 is the button
Seat 1: oscarleon ($124.03 in chips) 
Seat 2: I The King I ($176.50 in chips) 
Seat 3: Pvsx. ($122.14 in chips) 
Seat 4: matiko09 ($100 in chips) 
Seat 5: apfush ($141.82 in chips) 
Seat 7: Reven9er ($118.08 in chips) 
Seat 8: Kreuznagel ($135.01 in chips) 
Seat 9: miracolix50 ($75.89 in chips) 
apfush: posts small blind $0.50
xHourglass: is sitting out 
Reven9er: posts big blind $1
*** HOLE CARDS ***
Dealt to matiko09 [4d 4s]
Kreuznagel: folds 
miracolix50: calls $1
oscarleon: folds 
I The King I: folds 
Pvsx.: folds 
matiko09: raises $2 to $3
apfush: folds 
xHourglass leaves the table
Reven9er: raises $6.50 to $9.50
miracolix50: folds 
DUkalisUA joins the table at seat #6 
matiko09: calls $6.50
*** FLOP *** [6h Kd 3s]
Reven9er: bets $8
matiko09: calls $8
*** TURN *** [6h Kd 3s] [Kc]
Reven9er: bets $34.68
matiko09: folds 
Uncalled bet ($34.68) returned to Reven9er
Reven9er collected $34.68 from pot
Reven9er: doesn't show hand 
*** SUMMARY ***
Total pot $36.50 | Rake $1.82 
Board [6h Kd 3s Kc]
Seat 1: oscarleon folded before Flop (didn't bet)
Seat 2: I The King I folded before Flop (didn't bet)
Seat 3: Pvsx. folded before Flop (didn't bet)
Seat 4: matiko09 (button) folded on the Turn
Seat 5: apfush (small blind) folded before Flop
Seat 7: Reven9er (big blind) collected ($34.68)
Seat 8: Kreuznagel folded before Flop (didn't bet)
Seat 9: miracolix50 folded before Flop





PokerStars Hand #151207842321:  Hold'em No Limit ($1/$2 USD) - 2016/03/31 12:41:53 CET [2016/03/31 6:41:53 ET]
Table 'Coelestina II' 9-max Seat #6 is the button
Seat 1: PacPacBum ($221.93 in chips) 
Seat 2: Kreuznagel ($226.73 in chips) 
Seat 3: ilaviiitech ($201.30 in chips) 
Seat 4: matiko09 ($200 in chips) 
Seat 5: Painkiller72 ($200 in chips) 
Seat 6: Avtovo ($216.62 in chips) 
Seat 7: rmanjkeee ($80 in chips) 
Seat 8: DUkalisUA ($215.45 in chips) 
Seat 9: fonng ($194.45 in chips) 
rmanjkeee: posts small blind $1
DUkalisUA: posts big blind $2
*** HOLE CARDS ***
Dealt to matiko09 [Th 2s]
fonng: folds 
PacPacBum: raises $2.08 to $4.08
Kreuznagel: folds 
ilaviiitech: folds 
matiko09: folds 
Painkiller72: folds 
Avtovo: calls $4.08
rmanjkeee: calls $3.08
DUkalisUA: folds 
*** FLOP *** [8h 6d 5h]
rmanjkeee: checks 
PacPacBum: checks 
Avtovo: checks 
*** TURN *** [8h 6d 5h] [Qs]
rmanjkeee: bets $10
PacPacBum: folds 
Avtovo: calls $10
*** RIVER *** [8h 6d 5h Qs] [2d]
rmanjkeee: checks 
Avtovo: checks 
*** SHOW DOWN ***
rmanjkeee: shows [7h 7c] (a pair of Sevens)
Avtovo: shows [Td Tc] (a pair of Tens)
Avtovo collected $32.53 from pot
*** SUMMARY ***
Total pot $34.24 | Rake $1.71 
Board [8h 6d 5h Qs 2d]
Seat 1: PacPacBum folded on the Turn
Seat 2: Kreuznagel folded before Flop (didn't bet)
Seat 3: ilaviiitech folded before Flop (didn't bet)
Seat 4: matiko09 folded before Flop (didn't bet)
Seat 5: Painkiller72 folded before Flop (didn't bet)
Seat 6: Avtovo (button) showed [Td Tc] and won ($32.53) with a pair of Tens
Seat 7: rmanjkeee (small blind) showed [7h 7c] and lost with a pair of Sevens
Seat 8: DUkalisUA (big blind) folded before Flop
Seat 9: fonng folded before Flop (didn't bet)





PokerStars Hand #151207844449:  Hold'em No Limit ($0.50/$1.00 USD) - 2016/03/31 12:41:58 CET [2016/03/31 6:41:58 ET]
Table 'Haworth II' 9-max Seat #5 is the button
Seat 1: godfrey004 ($82.20 in chips) 
Seat 2: AlKatrone ($130.46 in chips) 
Seat 3: matiko09 ($102.68 in chips) 
Seat 4: I The King I ($123.02 in chips) 
Seat 5: Kreuznagel ($101.60 in chips) 
Seat 6: Pvsx. ($100.50 in chips) 
Seat 7: mheris ($121.72 in chips) 
Seat 8: oscarleon ($101.50 in chips) 
Seat 9: Zeeshka ($100 in chips) 
Pvsx.: posts small blind $0.50
mheris: posts big blind $1
*** HOLE CARDS ***
Dealt to matiko09 [6d 3c]
oscarleon: folds 
Zeeshka: folds 
godfrey004: calls $1
AlKatrone: raises $3 to $4
matiko09: folds 
I The King I: calls $4
Kreuznagel: folds 
mheris is disconnected 
Pvsx.: folds 
mheris is connected 
mheris: folds 
godfrey004: raises $17 to $21
AlKatrone: folds 
I The King I: folds 
Uncalled bet ($17) returned to godfrey004
godfrey004 collected $13.50 from pot
godfrey004: doesn't show hand 
*** SUMMARY ***
Total pot $13.50 | Rake $0 
Seat 1: godfrey004 collected ($13.50)
Seat 2: AlKatrone folded before Flop
Seat 3: matiko09 folded before Flop (didn't bet)
Seat 4: I The King I folded before Flop
Seat 5: Kreuznagel (button) folded before Flop (didn't bet)
Seat 6: Pvsx. (small blind) folded before Flop
Seat 7: mheris (big blind) folded before Flop
Seat 8: oscarleon folded before Flop (didn't bet)
Seat 9: Zeeshka folded before Flop (didn't bet)





PokerStars Hand #151207845895:  Hold'em No Limit ($1/$2 USD) - 2016/03/31 12:42:01 CET [2016/03/31 6:42:01 ET]
Table 'Probitas' 9-max Seat #6 is the button
Seat 1: rmanjkeee ($179.04 in chips) 
Seat 3: azvazdam ($203.12 in chips) 
Seat 4: Painkiller72 ($221.21 in chips) 
Seat 5: matiko09 ($203 in chips) 
Seat 6: Kreuznagel ($439.39 in chips) 
Seat 7: coinflip_si ($299.53 in chips) 
Seat 8: BOAYARSKIY ($143.45 in chips) 
Seat 9: apfush ($309.99 in chips) 
coinflip_si: posts small blind $1
BOAYARSKIY: posts big blind $2
*** HOLE CARDS ***
Dealt to matiko09 [Qs 5c]
apfush: raises $4 to $6
rmanjkeee: folds 
azvazdam: folds 
Painkiller72: folds 
matiko09: folds 
Kreuznagel: folds 
coinflip_si: folds 
BOAYARSKIY: folds 
Uncalled bet ($4) returned to apfush
apfush collected $5 from pot
apfush: doesn't show hand 
*** SUMMARY ***
Total pot $5 | Rake $0 
Seat 1: rmanjkeee folded before Flop (didn't bet)
Seat 3: azvazdam folded before Flop (didn't bet)
Seat 4: Painkiller72 folded before Flop (didn't bet)
Seat 5: matiko09 folded before Flop (didn't bet)
Seat 6: Kreuznagel (button) folded before Flop (didn't bet)
Seat 7: coinflip_si (small blind) folded before Flop
Seat 8: BOAYARSKIY (big blind) folded before Flop
Seat 9: apfush collected ($5)





PokerStars Hand #151207846809:  Hold'em No Limit ($0.50/$1.00 USD) - 2016/03/31 12:42:03 CET [2016/03/31 6:42:03 ET]
Table 'Aquila' 9-max Seat #5 is the button
Seat 1: BOAYARSKIY ($51 in chips) 
Seat 2: Avtovo ($100 in chips) 
Seat 3: laco121 ($52.14 in chips) 
Seat 5: adelfaz ($56.04 in chips) 
Seat 6: maxxmeister ($119.80 in chips) 
Seat 7: PacPacBum ($125.50 in chips) 
Seat 8: matiko09 ($107.20 in chips) 
Seat 9: apfush ($100 in chips) 
maxxmeister: posts small blind $0.50
PacPacBum: posts big blind $1
BOAYARSKIY: posts the ante $0.20
Avtovo: posts the ante $0.20
laco121: posts the ante $0.20
adelfaz: posts the ante $0.20
maxxmeister: posts the ante $0.20
PacPacBum: posts the ante $0.20
matiko09: posts the ante $0.20
apfush: posts the ante $0.20
*** HOLE CARDS ***
Dealt to matiko09 [Jh Jd]
matiko09: raises $2 to $3
apfush: folds 
BOAYARSKIY: folds 
Avtovo: folds 
laco121: folds 
adelfaz: folds 
maxxmeister: folds 
PacPacBum: folds 
Uncalled bet ($2) returned to matiko09
matiko09 collected $4.10 from pot
matiko09: doesn't show hand 
*** SUMMARY ***
Total pot $4.10 | Rake $0 
Seat 1: BOAYARSKIY folded before Flop (didn't bet)
Seat 2: Avtovo folded before Flop (didn't bet)
Seat 3: laco121 folded before Flop (didn't bet)
Seat 5: adelfaz (button) folded before Flop (didn't bet)
Seat 6: maxxmeister (small blind) folded before Flop
Seat 7: PacPacBum (big blind) folded before Flop
Seat 8: matiko09 collected ($4.10)
Seat 9: apfush folded before Flop (didn't bet)





PokerStars Hand #151207848715:  Hold'em No Limit (€0.50/€1.00 EUR) - 2016/03/31 12:42:06 CET [2016/03/31 6:42:06 ET]
Table 'Pioneer II' 9-max Seat #1 is the button
Seat 1: Kreuznagel (€104.50 in chips) 
Seat 2: IdiotFromNE (€132.52 in chips) 
Seat 4: Painkiller72 (€146.39 in chips) 
Seat 6: matiko09 (€101.50 in chips) 
Seat 7: AlKatrone (€130.41 in chips) 
Seat 8: PacPacBum (€103.22 in chips) 
Seat 9: DUkalisUA (€102.62 in chips) 
IdiotFromNE: posts small blind €0.50
Zeeshka: is sitting out 
Painkiller72: posts big blind €1
*** HOLE CARDS ***
Dealt to matiko09 [8s Th]
Zeeshka leaves the table
matiko09: folds 
AlKatrone: folds 
PacPacBum: folds 
DUkalisUA: folds 
Kreuznagel: folds 
IdiotFromNE: raises €1.50 to €2.50
Painkiller72: folds 
Uncalled bet (€1.50) returned to IdiotFromNE
IdiotFromNE collected €2 from pot
IdiotFromNE: doesn't show hand 
*** SUMMARY ***
Total pot €2 | Rake €0 
Seat 1: Kreuznagel (button) folded before Flop (didn't bet)
Seat 2: IdiotFromNE (small blind) collected (€2)
Seat 4: Painkiller72 (big blind) folded before Flop
Seat 6: matiko09 folded before Flop (didn't bet)
Seat 7: AlKatrone folded before Flop (didn't bet)
Seat 8: PacPacBum folded before Flop (didn't bet)
Seat 9: DUkalisUA folded before Flop (didn't bet)





PokerStars Hand #151207851270:  Hold'em No Limit ($1/$2 USD) - 2016/03/31 12:42:12 CET [2016/03/31 6:42:12 ET]
Table 'Desiderata' 9-max Seat #4 is the button
Seat 1: GALWACONT ($186.62 in chips) 
Seat 2: ilaviiitech ($221 in chips) 
Seat 3: djammusic ($77 in chips) 
Seat 4: matiko09 ($318.85 in chips) 
Seat 5: Kreuznagel ($312.55 in chips) 
Seat 6: rmanjkeee ($114.45 in chips) 
Seat 7: apfush ($255.83 in chips) 
Seat 8: DUkalisUA ($200 in chips) 
Seat 9: Painkiller72 ($200 in chips) 
Kreuznagel: posts small blind $1
rmanjkeee: posts big blind $2
*** HOLE CARDS ***
Dealt to matiko09 [2h Jd]
apfush: folds 
DUkalisUA: folds 
Painkiller72: folds 
GALWACONT: folds 
ilaviiitech: folds 
djammusic: folds 
matiko09: folds 
Kreuznagel: raises $2 to $4
rmanjkeee: folds 
Uncalled bet ($2) returned to Kreuznagel
Kreuznagel collected $4 from pot
Kreuznagel: doesn't show hand 
*** SUMMARY ***
Total pot $4 | Rake $0 
Seat 1: GALWACONT folded before Flop (didn't bet)
Seat 2: ilaviiitech folded before Flop (didn't bet)
Seat 3: djammusic folded before Flop (didn't bet)
Seat 4: matiko09 (button) folded before Flop (didn't bet)
Seat 5: Kreuznagel (small blind) collected ($4)
Seat 6: rmanjkeee (big blind) folded before Flop
Seat 7: apfush folded before Flop (didn't bet)
Seat 8: DUkalisUA folded before Flop (didn't bet)
Seat 9: Painkiller72 folded before Flop (didn't bet)





PokerStars Hand #151207855707:  Hold'em No Limit ($1/$2 USD) - 2016/03/31 12:42:21 CET [2016/03/31 6:42:21 ET]
Table 'Probitas' 9-max Seat #7 is the button
Seat 1: rmanjkeee ($179.04 in chips) 
Seat 3: azvazdam ($203.12 in chips) 
Seat 4: Painkiller72 ($221.21 in chips) 
Seat 5: matiko09 ($203 in chips) 
Seat 6: Kreuznagel ($439.39 in chips) 
Seat 7: coinflip_si ($298.53 in chips) 
Seat 8: BOAYARSKIY ($141.45 in chips) 
Seat 9: apfush ($312.99 in chips) 
BOAYARSKIY: posts small blind $1
apfush: posts big blind $2
*** HOLE CARDS ***
Dealt to matiko09 [Kd 8c]
rmanjkeee: folds 
azvazdam: folds 
Painkiller72: folds 
matiko09: folds 
Kreuznagel: folds 
coinflip_si has timed out
coinflip_si: folds 
BOAYARSKIY: folds 
Uncalled bet ($1) returned to apfush
apfush collected $2 from pot
apfush: doesn't show hand 
*** SUMMARY ***
Total pot $2 | Rake $0 
Seat 1: rmanjkeee folded before Flop (didn't bet)
Seat 3: azvazdam folded before Flop (didn't bet)
Seat 4: Painkiller72 folded before Flop (didn't bet)
Seat 5: matiko09 folded before Flop (didn't bet)
Seat 6: Kreuznagel folded before Flop (didn't bet)
Seat 7: coinflip_si (button) folded before Flop (didn't bet)
Seat 8: BOAYARSKIY (small blind) folded before Flop
Seat 9: apfush (big blind) collected ($2)





PokerStars Hand #151207862371:  Hold'em No Limit ($0.50/$1.00 USD) - 2016/03/31 12:42:35 CET [2016/03/31 6:42:35 ET]
Table 'Aquila' 9-max Seat #6 is the button
Seat 1: BOAYARSKIY ($50.80 in chips) 
Seat 2: Avtovo ($100 in chips) 
Seat 3: laco121 ($51.94 in chips) 
Seat 5: adelfaz ($55.84 in chips) 
Seat 6: maxxmeister ($119.10 in chips) 
Seat 7: PacPacBum ($124.30 in chips) 
Seat 8: matiko09 ($110.10 in chips) 
Seat 9: apfush ($100 in chips) 
PacPacBum: posts small blind $0.50
matiko09: posts big blind $1
BOAYARSKIY: posts the ante $0.20
Avtovo: posts the ante $0.20
laco121: posts the ante $0.20
adelfaz: posts the ante $0.20
maxxmeister: posts the ante $0.20
PacPacBum: posts the ante $0.20
matiko09: posts the ante $0.20
apfush: posts the ante $0.20
*** HOLE CARDS ***
Dealt to matiko09 [4c Ah]
apfush: folds 
BOAYARSKIY: folds 
Avtovo: raises $1.50 to $2.50
laco121: folds 
adelfaz: calls $2.50
maxxmeister: folds 
PacPacBum: raises $9.50 to $12
matiko09: folds 
Avtovo: folds 
adelfaz: folds 
Uncalled bet ($9.50) returned to PacPacBum
PacPacBum collected $10.10 from pot
PacPacBum: doesn't show hand 
*** SUMMARY ***
Total pot $10.10 | Rake $0 
Seat 1: BOAYARSKIY folded before Flop (didn't bet)
Seat 2: Avtovo folded before Flop
Seat 3: laco121 folded before Flop (didn't bet)
Seat 5: adelfaz folded before Flop
Seat 6: maxxmeister (button) folded before Flop (didn't bet)
Seat 7: PacPacBum (small blind) collected ($10.10)
Seat 8: matiko09 (big blind) folded before Flop
Seat 9: apfush folded before Flop (didn't bet)





PokerStars Hand #151207868461:  Hold'em No Limit ($0.50/$1.00 USD) - 2016/03/31 12:42:48 CET [2016/03/31 6:42:48 ET]
Table 'Yazhi' 9-max Seat #7 is the button
Seat 1: matiko09 ($100 in chips) 
Seat 2: xHourglass ($113.14 in chips) 
Seat 3: Chin41178 ($90.91 in chips) 
Seat 4: apfush ($178.96 in chips) 
Seat 5: IdiotFromNE ($102.50 in chips) 
Seat 6: Reven9er ($233.99 in chips) 
Seat 7: Avtovo ($100 in chips) 
Seat 8: pk4DW ($47.33 in chips) 
Seat 9: oscarleon ($199.23 in chips) 
pk4DW: posts small blind $0.50
oscarleon: posts big blind $1
*** HOLE CARDS ***
Dealt to matiko09 [6h 9d]
matiko09: folds 
xHourglass: raises $2 to $3
Chin41178: folds 
apfush: folds 
IdiotFromNE: folds 
Reven9er: folds 
Avtovo: folds 
pk4DW: calls $2.50
oscarleon: folds 
*** FLOP *** [7d 3s 7s]
pk4DW: checks 
xHourglass: checks 
*** TURN *** [7d 3s 7s] [8c]
pk4DW: checks 
xHourglass: checks 
*** RIVER *** [7d 3s 7s 8c] [Td]
pk4DW: bets $6.65
xHourglass: calls $6.65
*** SHOW DOWN ***
pk4DW: shows [Tc Kd] (two pair, Tens and Sevens)
xHourglass: mucks hand 
pk4DW collected $19.28 from pot
*** SUMMARY ***
Total pot $20.30 | Rake $1.02 
Board [7d 3s 7s 8c Td]
Seat 1: matiko09 folded before Flop (didn't bet)
Seat 2: xHourglass mucked [Ah Ks]
Seat 3: Chin41178 folded before Flop (didn't bet)
Seat 4: apfush folded before Flop (didn't bet)
Seat 5: IdiotFromNE folded before Flop (didn't bet)
Seat 6: Reven9er folded before Flop (didn't bet)
Seat 7: Avtovo (button) folded before Flop (didn't bet)
Seat 8: pk4DW (small blind) showed [Tc Kd] and won ($19.28) with two pair, Tens and Sevens
Seat 9: oscarleon (big blind) folded before Flop





PokerStars Hand #151207869820:  Hold'em No Limit ($1/$2 USD) - 2016/03/31 12:42:51 CET [2016/03/31 6:42:51 ET]
Table 'Desiderata' 9-max Seat #5 is the button
Seat 1: GALWACONT ($186.62 in chips) 
Seat 2: ilaviiitech ($221 in chips) 
Seat 3: djammusic ($77 in chips) 
Seat 4: matiko09 ($318.85 in chips) 
Seat 5: Kreuznagel ($314.55 in chips) 
Seat 6: rmanjkeee ($112.45 in chips) 
Seat 7: apfush ($255.83 in chips) 
Seat 8: DUkalisUA ($200 in chips) 
Seat 9: Painkiller72 ($200 in chips) 
rmanjkeee: posts small blind $1
apfush: posts big blind $2
*** HOLE CARDS ***
Dealt to matiko09 [Jh 3d]
DUkalisUA: folds 
Painkiller72: folds 
GALWACONT: raises $4 to $6
ilaviiitech: folds 
djammusic: folds 
matiko09: folds 
Kreuznagel: folds 
rmanjkeee: folds 
apfush: folds 
Uncalled bet ($4) returned to GALWACONT
GALWACONT collected $5 from pot
GALWACONT: doesn't show hand 
*** SUMMARY ***
Total pot $5 | Rake $0 
Seat 1: GALWACONT collected ($5)
Seat 2: ilaviiitech folded before Flop (didn't bet)
Seat 3: djammusic folded before Flop (didn't bet)
Seat 4: matiko09 folded before Flop (didn't bet)
Seat 5: Kreuznagel (button) folded before Flop (didn't bet)
Seat 6: rmanjkeee (small blind) folded before Flop
Seat 7: apfush (big blind) folded before Flop
Seat 8: DUkalisUA folded before Flop (didn't bet)
Seat 9: Painkiller72 folded before Flop (didn't bet)





PokerStars Hand #151207871396:  Hold'em No Limit ($0.50/$1.00 USD) - 2016/03/31 12:42:54 CET [2016/03/31 6:42:54 ET]
Table 'Icarus III' 9-max Seat #6 is the button
Seat 2: Painkiller72 ($100 in chips) 
Seat 3: RICKA16 ($106.02 in chips) 
Seat 4: dizzyryano79 ($37.43 in chips) 
Seat 5: I The King I ($113.75 in chips) 
Seat 6: djammusic ($46.08 in chips) 
Seat 7: oscarleon ($151.32 in chips) 
Seat 8: matiko09 ($102.83 in chips) 
Seat 9: apfush ($123.96 in chips) 
oscarleon: posts small blind $0.50
matiko09: posts big blind $1
*** HOLE CARDS ***
Dealt to matiko09 [2c 6c]
apfush: folds 
Painkiller72: folds 
RICKA16: folds 
dizzyryano79: folds 
I The King I: folds 
djammusic: folds 
oscarleon: folds 
Uncalled bet ($0.50) returned to matiko09
matiko09 collected $1 from pot
matiko09: doesn't show hand 
*** SUMMARY ***
Total pot $1 | Rake $0 
Seat 2: Painkiller72 folded before Flop (didn't bet)
Seat 3: RICKA16 folded before Flop (didn't bet)
Seat 4: dizzyryano79 folded before Flop (didn't bet)
Seat 5: I The King I folded before Flop (didn't bet)
Seat 6: djammusic (button) folded before Flop (didn't bet)
Seat 7: oscarleon (small blind) folded before Flop
Seat 8: matiko09 (big blind) collected ($1)
Seat 9: apfush folded before Flop (didn't bet)





PokerStars Hand #151207879469:  Hold'em No Limit ($0.50/$1.00 USD) - 2016/03/31 12:43:11 CET [2016/03/31 6:43:11 ET]
Table 'Egeria II' 9-max Seat #5 is the button
Seat 1: oscarleon ($124.03 in chips) 
Seat 2: I The King I ($176.50 in chips) 
Seat 3: Pvsx. ($122.14 in chips) 
Seat 4: matiko09 ($100 in chips) 
Seat 5: apfush ($141.32 in chips) 
Seat 7: Reven9er ($135.26 in chips) 
Seat 8: Kreuznagel ($135.01 in chips) 
Seat 9: miracolix50 ($74.89 in chips) 
DUkalisUA will be allowed to play after the button
Reven9er: posts small blind $0.50
Kreuznagel: posts big blind $1
*** HOLE CARDS ***
Dealt to matiko09 [4c Kc]
miracolix50: folds 
oscarleon: folds 
I The King I: folds 
Pvsx.: folds 
matiko09: folds 
apfush: folds 
Reven9er: folds 
Uncalled bet ($0.50) returned to Kreuznagel
Kreuznagel collected $1 from pot
Kreuznagel: doesn't show hand 
*** SUMMARY ***
Total pot $1 | Rake $0 
Seat 1: oscarleon folded before Flop (didn't bet)
Seat 2: I The King I folded before Flop (didn't bet)
Seat 3: Pvsx. folded before Flop (didn't bet)
Seat 4: matiko09 folded before Flop (didn't bet)
Seat 5: apfush (button) folded before Flop (didn't bet)
Seat 7: Reven9er (small blind) folded before Flop
Seat 8: Kreuznagel (big blind) collected ($1)
Seat 9: miracolix50 folded before Flop (didn't bet)





PokerStars Hand #151207881254:  Hold'em No Limit ($1/$2 USD) - 2016/03/31 12:43:15 CET [2016/03/31 6:43:15 ET]
Table 'Coelestina II' 9-max Seat #7 is the button
Seat 1: PacPacBum ($217.85 in chips) 
Seat 2: Kreuznagel ($226.73 in chips) 
Seat 3: ilaviiitech ($201.30 in chips) 
Seat 4: matiko09 ($200 in chips) 
Seat 5: Painkiller72 ($200 in chips) 
Seat 6: Avtovo ($235.07 in chips) 
Seat 7: rmanjkeee ($80 in chips) 
Seat 8: DUkalisUA ($213.45 in chips) 
Seat 9: fonng ($194.45 in chips) 
DUkalisUA: posts small blind $1
fonng: posts big blind $2
*** HOLE CARDS ***
Dealt to matiko09 [2d Td]
PacPacBum: folds 
Kreuznagel: folds 
ilaviiitech: folds 
matiko09: folds 
Painkiller72: folds 
Avtovo: folds 
rmanjkeee: raises $2 to $4
DUkalisUA: calls $3
fonng: folds 
*** FLOP *** [9d 3h Js]
DUkalisUA: checks 
rmanjkeee: checks 
*** TURN *** [9d 3h Js] [As]
DUkalisUA: bets $6
rmanjkeee: folds 
Uncalled bet ($6) returned to DUkalisUA
DUkalisUA collected $9.50 from pot
DUkalisUA: doesn't show hand 
*** SUMMARY ***
Total pot $10 | Rake $0.50 
Board [9d 3h Js As]
Seat 1: PacPacBum folded before Flop (didn't bet)
Seat 2: Kreuznagel folded before Flop (didn't bet)
Seat 3: ilaviiitech folded before Flop (didn't bet)
Seat 4: matiko09 folded before Flop (didn't bet)
Seat 5: Painkiller72 folded before Flop (didn't bet)
Seat 6: Avtovo folded before Flop (didn't bet)
Seat 7: rmanjkeee (button) folded on the Turn
Seat 8: DUkalisUA (small blind) collected ($9.50)
Seat 9: fonng (big blind) folded before Flop





PokerStars Hand #151207882498:  Hold'em No Limit ($1/$2 USD) - 2016/03/31 12:43:18 CET [2016/03/31 6:43:18 ET]
Table 'Probitas' 9-max Seat #8 is the button
Seat 1: rmanjkeee ($179.04 in chips) 
Seat 3: azvazdam ($203.12 in chips) 
Seat 4: Painkiller72 ($221.21 in chips) 
Seat 5: matiko09 ($203 in chips) 
Seat 6: Kreuznagel ($439.39 in chips) 
Seat 7: coinflip_si ($298.53 in chips) 
Seat 8: BOAYARSKIY ($140.45 in chips) 
Seat 9: apfush ($313.99 in chips) 
apfush: posts small blind $1
rmanjkeee: posts big blind $2
*** HOLE CARDS ***
Dealt to matiko09 [2h Js]
azvazdam: folds 
Painkiller72: folds 
matiko09: folds 
Kreuznagel: folds 
coinflip_si: folds 
BOAYARSKIY: raises $2.26 to $4.26
apfush: folds 
rmanjkeee: folds 
Uncalled bet ($2.26) returned to BOAYARSKIY
BOAYARSKIY collected $5 from pot
BOAYARSKIY: doesn't show hand 
*** SUMMARY ***
Total pot $5 | Rake $0 
Seat 1: rmanjkeee (big blind) folded before Flop
Seat 3: azvazdam folded before Flop (didn't bet)
Seat 4: Painkiller72 folded before Flop (didn't bet)
Seat 5: matiko09 folded before Flop (didn't bet)
Seat 6: Kreuznagel folded before Flop (didn't bet)
Seat 7: coinflip_si folded before Flop (didn't bet)
Seat 8: BOAYARSKIY (button) collected ($5)
Seat 9: apfush (small blind) folded before Flop





PokerStars Hand #151207884696:  Hold'em No Limit ($0.50/$1.00 USD) - 2016/03/31 12:43:22 CET [2016/03/31 6:43:22 ET]
Table 'Icarus III' 9-max Seat #7 is the button
Seat 2: Painkiller72 ($100 in chips) 
Seat 3: RICKA16 ($106.02 in chips) 
Seat 4: dizzyryano79 ($37.43 in chips) 
Seat 5: I The King I ($113.75 in chips) 
Seat 6: djammusic ($46.08 in chips) 
Seat 7: oscarleon ($150.82 in chips) 
Seat 8: matiko09 ($103.33 in chips) 
Seat 9: apfush ($123.96 in chips) 
matiko09: posts small blind $0.50
apfush: posts big blind $1
*** HOLE CARDS ***
Dealt to matiko09 [7s 6s]
Painkiller72: folds 
RICKA16: folds 
dizzyryano79: folds 
I The King I: folds 
djammusic: folds 
oscarleon: raises $2 to $3
matiko09: raises $7 to $10
apfush: folds 
oscarleon: raises $10.92 to $20.92
matiko09: folds 
Uncalled bet ($10.92) returned to oscarleon
oscarleon collected $21 from pot
oscarleon: doesn't show hand 
*** SUMMARY ***
Total pot $21 | Rake $0 
Seat 2: Painkiller72 folded before Flop (didn't bet)
Seat 3: RICKA16 folded before Flop (didn't bet)
Seat 4: dizzyryano79 folded before Flop (didn't bet)
Seat 5: I The King I folded before Flop (didn't bet)
Seat 6: djammusic folded before Flop (didn't bet)
Seat 7: oscarleon (button) collected ($21)
Seat 8: matiko09 (small blind) folded before Flop
Seat 9: apfush (big blind) folded before Flop





PokerStars Hand #151207885644:  Hold'em No Limit ($0.50/$1.00 USD) - 2016/03/31 12:43:24 CET [2016/03/31 6:43:24 ET]
Table 'Herge II' 9-max Seat #7 is the button
Seat 1: Chiapel ($104.67 in chips) 
Seat 2: DUkalisUA ($100 in chips) 
Seat 3: matiko09 ($211.77 in chips) 
Seat 4: Kreuznagel ($100 in chips) 
Seat 5: I The King I ($135.23 in chips) 
Seat 6: masaytoo ($93 in chips) 
Seat 7: Zeeshka ($139.45 in chips) 
Seat 8: IdiotFromNE ($100 in chips) 
Seat 9: fatstacks122 ($129.83 in chips) 
IdiotFromNE: posts small blind $0.50
fatstacks122: posts big blind $1
*** HOLE CARDS ***
Dealt to matiko09 [8s Ts]
Chiapel: folds 
DUkalisUA: folds 
matiko09: folds 
Kreuznagel: folds 
I The King I: folds 
masaytoo: folds 
Zeeshka: folds 
IdiotFromNE: folds 
Uncalled bet ($0.50) returned to fatstacks122
fatstacks122 collected $1 from pot
fatstacks122: doesn't show hand 
*** SUMMARY ***
Total pot $1 | Rake $0 
Seat 1: Chiapel folded before Flop (didn't bet)
Seat 2: DUkalisUA folded before Flop (didn't bet)
Seat 3: matiko09 folded before Flop (didn't bet)
Seat 4: Kreuznagel folded before Flop (didn't bet)
Seat 5: I The King I folded before Flop (didn't bet)
Seat 6: masaytoo folded before Flop (didn't bet)
Seat 7: Zeeshka (button) folded before Flop (didn't bet)
Seat 8: IdiotFromNE (small blind) folded before Flop
Seat 9: fatstacks122 (big blind) collected ($1)





PokerStars Hand #151207888513:  Hold'em No Limit ($0.50/$1.00 USD) - 2016/03/31 12:43:30 CET [2016/03/31 6:43:30 ET]
Table 'Egeria II' 9-max Seat #7 is the button
Seat 1: oscarleon ($124.03 in chips) 
Seat 2: I The King I ($176.50 in chips) 
Seat 3: Pvsx. ($122.14 in chips) 
Seat 4: matiko09 ($100 in chips) 
Seat 5: apfush ($141.32 in chips) 
Seat 7: Reven9er ($134.76 in chips) 
Seat 8: Kreuznagel ($135.51 in chips) 
Seat 9: miracolix50 ($74.89 in chips) 
Kreuznagel: posts small blind $0.50
miracolix50: posts big blind $1
DUkalisUA: sits out 
*** HOLE CARDS ***
Dealt to matiko09 [3d 5h]
oscarleon: folds 
I The King I: folds 
Pvsx.: raises $1.50 to $2.50
matiko09: folds 
apfush: folds 
Reven9er: calls $2.50
Kreuznagel: folds 
miracolix50: folds 
*** FLOP *** [9h Ah 7c]
Pvsx.: checks 
Reven9er: bets $3.09
Pvsx.: folds 
Uncalled bet ($3.09) returned to Reven9er
Reven9er collected $6.18 from pot
Reven9er: doesn't show hand 
*** SUMMARY ***
Total pot $6.50 | Rake $0.32 
Board [9h Ah 7c]
Seat 1: oscarleon folded before Flop (didn't bet)
Seat 2: I The King I folded before Flop (didn't bet)
Seat 3: Pvsx. folded on the Flop
Seat 4: matiko09 folded before Flop (didn't bet)
Seat 5: apfush folded before Flop (didn't bet)
Seat 7: Reven9er (button) collected ($6.18)
Seat 8: Kreuznagel (small blind) folded before Flop
Seat 9: miracolix50 (big blind) folded before Flop





PokerStars Hand #151207892038:  Hold'em No Limit ($0.50/$1.00 USD) - 2016/03/31 12:43:38 CET [2016/03/31 6:43:38 ET]
Table 'Aquila' 9-max Seat #7 is the button
Seat 1: BOAYARSKIY ($50.60 in chips) 
Seat 2: Avtovo ($100 in chips) 
Seat 3: laco121 ($51.74 in chips) 
Seat 5: adelfaz ($53.14 in chips) 
Seat 6: maxxmeister ($118.90 in chips) 
Seat 7: PacPacBum ($131.70 in chips) 
Seat 8: matiko09 ($108.90 in chips) 
Seat 9: apfush ($100 in chips) 
matiko09: posts small blind $0.50
apfush: posts big blind $1
BOAYARSKIY: posts the ante $0.20
Avtovo: posts the ante $0.20
laco121: posts the ante $0.20
adelfaz: posts the ante $0.20
maxxmeister: posts the ante $0.20
PacPacBum: posts the ante $0.20
matiko09: posts the ante $0.20
apfush: posts the ante $0.20
*** HOLE CARDS ***
Dealt to matiko09 [Jd 8s]
BOAYARSKIY: folds 
Avtovo: folds 
laco121: calls $1
adelfaz: raises $2 to $3
maxxmeister: folds 
PacPacBum: folds 
matiko09: folds 
apfush: folds 
laco121: calls $2
*** FLOP *** [6d 5h 9s]
laco121: bets $8
adelfaz: calls $8
*** TURN *** [6d 5h 9s] [Ad]
laco121: bets $8
adelfaz: calls $8
*** RIVER *** [6d 5h 9s Ad] [Ks]
laco121: checks 
adelfaz: bets $19.52
laco121: folds 
Uncalled bet ($19.52) returned to adelfaz
adelfaz collected $39.04 from pot
*** SUMMARY ***
Total pot $41.10 | Rake $2.06 
Board [6d 5h 9s Ad Ks]
Seat 1: BOAYARSKIY folded before Flop (didn't bet)
Seat 2: Avtovo folded before Flop (didn't bet)
Seat 3: laco121 folded on the River
Seat 5: adelfaz collected ($39.04)
Seat 6: maxxmeister folded before Flop (didn't bet)
Seat 7: PacPacBum (button) folded before Flop (didn't bet)
Seat 8: matiko09 (small blind) folded before Flop
Seat 9: apfush (big blind) folded before Flop





PokerStars Hand #151207893490:  Hold'em No Limit ($0.50/$1.00 USD) - 2016/03/31 12:43:41 CET [2016/03/31 6:43:41 ET]
Table 'Haworth II' 9-max Seat #6 is the button
Seat 1: godfrey004 ($91.70 in chips) 
Seat 2: AlKatrone ($126.46 in chips) 
Seat 3: matiko09 ($102.68 in chips) 
Seat 4: I The King I ($119.02 in chips) 
Seat 5: Kreuznagel ($101.60 in chips) 
Seat 6: Pvsx. ($100 in chips) 
Seat 7: mheris ($120.72 in chips) 
Seat 8: oscarleon ($101.50 in chips) 
Seat 9: Zeeshka ($100 in chips) 
mheris: posts small blind $0.50
oscarleon: posts big blind $1
*** HOLE CARDS ***
Dealt to matiko09 [3d As]
Zeeshka: folds 
godfrey004: calls $1
AlKatrone: folds 
matiko09: folds 
I The King I: folds 
Kreuznagel: folds 
Pvsx.: folds 
mheris: folds 
oscarleon: checks 
*** FLOP *** [Qh 9s Jd]
oscarleon: checks 
godfrey004: bets $2
oscarleon: folds 
Uncalled bet ($2) returned to godfrey004
godfrey004 collected $2.38 from pot
godfrey004: doesn't show hand 
*** SUMMARY ***
Total pot $2.50 | Rake $0.12 
Board [Qh 9s Jd]
Seat 1: godfrey004 collected ($2.38)
Seat 2: AlKatrone folded before Flop (didn't bet)
Seat 3: matiko09 folded before Flop (didn't bet)
Seat 4: I The King I folded before Flop (didn't bet)
Seat 5: Kreuznagel folded before Flop (didn't bet)
Seat 6: Pvsx. (button) folded before Flop (didn't bet)
Seat 7: mheris (small blind) folded before Flop
Seat 8: oscarleon (big blind) folded on the Flop
Seat 9: Zeeshka folded before Flop (didn't bet)





PokerStars Hand #151207897803:  Hold'em No Limit ($1/$2 USD) - 2016/03/31 12:43:50 CET [2016/03/31 6:43:50 ET]
Table 'Probitas' 9-max Seat #9 is the button
Seat 1: rmanjkeee ($177.04 in chips) 
Seat 3: azvazdam ($203.12 in chips) 
Seat 4: Painkiller72 ($221.21 in chips) 
Seat 5: matiko09 ($203 in chips) 
Seat 6: Kreuznagel ($439.39 in chips) 
Seat 7: coinflip_si ($298.53 in chips) 
Seat 8: BOAYARSKIY ($143.45 in chips) 
Seat 9: apfush ($312.99 in chips) 
rmanjkeee: posts small blind $1
azvazdam: posts big blind $2
*** HOLE CARDS ***
Dealt to matiko09 [7s 9h]
Painkiller72: folds 
matiko09: folds 
Kreuznagel: folds 
coinflip_si: folds 
BOAYARSKIY: folds 
apfush: folds 
rmanjkeee: folds 
Uncalled bet ($1) returned to azvazdam
azvazdam collected $2 from pot
azvazdam: doesn't show hand 
*** SUMMARY ***
Total pot $2 | Rake $0 
Seat 1: rmanjkeee (small blind) folded before Flop
Seat 3: azvazdam (big blind) collected ($2)
Seat 4: Painkiller72 folded before Flop (didn't bet)
Seat 5: matiko09 folded before Flop (didn't bet)
Seat 6: Kreuznagel folded before Flop (didn't bet)
Seat 7: coinflip_si folded before Flop (didn't bet)
Seat 8: BOAYARSKIY folded before Flop (didn't bet)
Seat 9: apfush (button) folded before Flop (didn't bet)





PokerStars Hand #151207899383:  Hold'em No Limit ($0.50/$1.00 USD) - 2016/03/31 12:43:53 CET [2016/03/31 6:43:53 ET]
Table 'Yazhi' 9-max Seat #8 is the button
Seat 1: matiko09 ($100 in chips) 
Seat 2: xHourglass ($103.49 in chips) 
Seat 3: Chin41178 ($90.91 in chips) 
Seat 4: apfush ($178.96 in chips) 
Seat 5: IdiotFromNE ($102.50 in chips) 
Seat 6: Reven9er ($233.99 in chips) 
Seat 7: Avtovo ($100 in chips) 
Seat 8: pk4DW ($56.96 in chips) 
Seat 9: oscarleon ($198.23 in chips) 
oscarleon: posts small blind $0.50
matiko09: posts big blind $1
*** HOLE CARDS ***
Dealt to matiko09 [6h 8s]
xHourglass: folds 
Chin41178: folds 
apfush: raises $2 to $3
IdiotFromNE: folds 
Reven9er: folds 
Avtovo: folds 
pk4DW: calls $3
oscarleon: folds 
matiko09: folds 
*** FLOP *** [3s 4d 2c]
apfush: checks 
pk4DW: checks 
*** TURN *** [3s 4d 2c] [8c]
apfush: checks 
pk4DW: checks 
*** RIVER *** [3s 4d 2c 8c] [Js]
apfush: checks 
pk4DW: checks 
*** SHOW DOWN ***
apfush: shows [Ad 9d] (high card Ace)
pk4DW: mucks hand 
apfush collected $7.12 from pot
*** SUMMARY ***
Total pot $7.50 | Rake $0.38 
Board [3s 4d 2c 8c Js]
Seat 1: matiko09 (big blind) folded before Flop
Seat 2: xHourglass folded before Flop (didn't bet)
Seat 3: Chin41178 folded before Flop (didn't bet)
Seat 4: apfush showed [Ad 9d] and won ($7.12) with high card Ace
Seat 5: IdiotFromNE folded before Flop (didn't bet)
Seat 6: Reven9er folded before Flop (didn't bet)
Seat 7: Avtovo folded before Flop (didn't bet)
Seat 8: pk4DW (button) mucked [Ks Ts]
Seat 9: oscarleon (small blind) folded before Flop





PokerStars Hand #151207900194:  Hold'em No Limit ($0.50/$1.00 USD) - 2016/03/31 12:43:55 CET [2016/03/31 6:43:55 ET]
Table 'Herge II' 9-max Seat #8 is the button
Seat 1: Chiapel ($104.67 in chips) 
Seat 2: DUkalisUA ($100 in chips) 
Seat 3: matiko09 ($211.77 in chips) 
Seat 4: Kreuznagel ($100 in chips) 
Seat 5: I The King I ($135.23 in chips) 
Seat 6: masaytoo ($93 in chips) 
Seat 7: Zeeshka ($139.45 in chips) 
Seat 8: IdiotFromNE ($100 in chips) 
Seat 9: fatstacks122 ($130.33 in chips) 
fatstacks122: posts small blind $0.50
Chiapel: posts big blind $1
*** HOLE CARDS ***
Dealt to matiko09 [3h Qs]
DUkalisUA: raises $2 to $3
matiko09: folds 
Kreuznagel: folds 
I The King I: folds 
masaytoo: folds 
Zeeshka: folds 
IdiotFromNE: folds 
fatstacks122: folds 
Chiapel: folds 
Uncalled bet ($2) returned to DUkalisUA
DUkalisUA collected $2.50 from pot
DUkalisUA: doesn't show hand 
*** SUMMARY ***
Total pot $2.50 | Rake $0 
Seat 1: Chiapel (big blind) folded before Flop
Seat 2: DUkalisUA collected ($2.50)
Seat 3: matiko09 folded before Flop (didn't bet)
Seat 4: Kreuznagel folded before Flop (didn't bet)
Seat 5: I The King I folded before Flop (didn't bet)
Seat 6: masaytoo folded before Flop (didn't bet)
Seat 7: Zeeshka folded before Flop (didn't bet)
Seat 8: IdiotFromNE (button) folded before Flop (didn't bet)
Seat 9: fatstacks122 (small blind) folded before Flop





PokerStars Hand #151207902326:  Hold'em No Limit ($1/$2 USD) - 2016/03/31 12:43:59 CET [2016/03/31 6:43:59 ET]
Table 'Desiderata' 9-max Seat #6 is the button
Seat 1: GALWACONT ($189.62 in chips) 
Seat 2: ilaviiitech ($221 in chips) 
Seat 3: djammusic ($77 in chips) 
Seat 4: matiko09 ($318.85 in chips) 
Seat 5: Kreuznagel ($314.55 in chips) 
Seat 6: rmanjkeee ($111.45 in chips) 
Seat 7: apfush ($253.83 in chips) 
Seat 8: DUkalisUA ($200 in chips) 
Seat 9: Painkiller72 ($200 in chips) 
apfush: posts small blind $1
DUkalisUA: posts big blind $2
*** HOLE CARDS ***
Dealt to matiko09 [9d Td]
Painkiller72: folds 
GALWACONT: folds 
ilaviiitech: folds 
djammusic: folds 
matiko09: raises $4 to $6
Kreuznagel: folds 
rmanjkeee: calls $6
apfush: folds 
DUkalisUA: folds 
*** FLOP *** [Jh Ac 2d]
matiko09: bets $9
rmanjkeee: folds 
Uncalled bet ($9) returned to matiko09
matiko09 collected $14.25 from pot
matiko09: doesn't show hand 
*** SUMMARY ***
Total pot $15 | Rake $0.75 
Board [Jh Ac 2d]
Seat 1: GALWACONT folded before Flop (didn't bet)
Seat 2: ilaviiitech folded before Flop (didn't bet)
Seat 3: djammusic folded before Flop (didn't bet)
Seat 4: matiko09 collected ($14.25)
Seat 5: Kreuznagel folded before Flop (didn't bet)
Seat 6: rmanjkeee (button) folded on the Flop
Seat 7: apfush (small blind) folded before Flop
Seat 8: DUkalisUA (big blind) folded before Flop
Seat 9: Painkiller72 folded before Flop (didn't bet)





PokerStars Hand #151207911863:  Hold'em No Limit ($1/$2 USD) - 2016/03/31 12:44:20 CET [2016/03/31 6:44:20 ET]
Table 'Coelestina II' 9-max Seat #8 is the button
Seat 1: PacPacBum ($217.85 in chips) 
Seat 2: Kreuznagel ($226.73 in chips) 
Seat 3: ilaviiitech ($201.30 in chips) 
Seat 4: matiko09 ($200 in chips) 
Seat 5: Painkiller72 ($200 in chips) 
Seat 6: Avtovo ($235.07 in chips) 
Seat 7: rmanjkeee ($80 in chips) 
Seat 8: DUkalisUA ($218.95 in chips) 
Seat 9: fonng ($192.45 in chips) 
fonng: posts small blind $1
PacPacBum: posts big blind $2
*** HOLE CARDS ***
Dealt to matiko09 [Jh Qs]
Kreuznagel: raises $2.78 to $4.78
ilaviiitech: folds 
matiko09: folds 
Painkiller72: folds 
Avtovo: folds 
rmanjkeee: folds 
DUkalisUA: calls $4.78
fonng: folds 
PacPacBum: folds 
*** FLOP *** [7s Jd 5c]
Kreuznagel: bets $6.90
DUkalisUA: calls $6.90
*** TURN *** [7s Jd 5c] [6d]
Kreuznagel: checks 
DUkalisUA: bets $17
Kreuznagel: folds 
Uncalled bet ($17) returned to DUkalisUA
DUkalisUA collected $25.04 from pot
DUkalisUA: doesn't show hand 
fonng is disconnected 
*** SUMMARY ***
Total pot $26.36 | Rake $1.32 
Board [7s Jd 5c 6d]
Seat 1: PacPacBum (big blind) folded before Flop
Seat 2: Kreuznagel folded on the Turn
Seat 3: ilaviiitech folded before Flop (didn't bet)
Seat 4: matiko09 folded before Flop (didn't bet)
Seat 5: Painkiller72 folded before Flop (didn't bet)
Seat 6: Avtovo folded before Flop (didn't bet)
Seat 7: rmanjkeee folded before Flop (didn't bet)
Seat 8: DUkalisUA (button) collected ($25.04)
Seat 9: fonng (small blind) folded before Flop





PokerStars Hand #151207912887:  Hold'em No Limit ($0.50/$1.00 USD) - 2016/03/31 12:44:22 CET [2016/03/31 6:44:22 ET]
Table 'Herge II' 9-max Seat #9 is the button
Seat 1: Chiapel ($103.67 in chips) 
Seat 2: DUkalisUA ($101.50 in chips) 
Seat 3: matiko09 ($211.77 in chips) 
Seat 4: Kreuznagel ($100 in chips) 
Seat 5: I The King I ($135.23 in chips) 
Seat 6: masaytoo ($93 in chips) 
Seat 7: Zeeshka ($139.45 in chips) 
Seat 8: IdiotFromNE ($100 in chips) 
Seat 9: fatstacks122 ($129.83 in chips) 
Chiapel: posts small blind $0.50
DUkalisUA: posts big blind $1
*** HOLE CARDS ***
Dealt to matiko09 [Qh 7s]
matiko09: folds 
Kreuznagel: raises $1.39 to $2.39
I The King I: folds 
masaytoo: folds 
Zeeshka: folds 
IdiotFromNE: folds 
fatstacks122: folds 
Chiapel: folds 
DUkalisUA: folds 
Uncalled bet ($1.39) returned to Kreuznagel
Kreuznagel collected $2.50 from pot
Kreuznagel: doesn't show hand 
*** SUMMARY ***
Total pot $2.50 | Rake $0 
Seat 1: Chiapel (small blind) folded before Flop
Seat 2: DUkalisUA (big blind) folded before Flop
Seat 3: matiko09 folded before Flop (didn't bet)
Seat 4: Kreuznagel collected ($2.50)
Seat 5: I The King I folded before Flop (didn't bet)
Seat 6: masaytoo folded before Flop (didn't bet)
Seat 7: Zeeshka folded before Flop (didn't bet)
Seat 8: IdiotFromNE folded before Flop (didn't bet)
Seat 9: fatstacks122 (button) folded before Flop (didn't bet)





PokerStars Hand #151207914138:  Hold'em No Limit ($0.50/$1.00 USD) - 2016/03/31 12:44:25 CET [2016/03/31 6:44:25 ET]
Table 'Haworth II' 9-max Seat #7 is the button
Seat 1: godfrey004 ($93.08 in chips) 
Seat 2: AlKatrone ($126.46 in chips) 
Seat 3: matiko09 ($102.68 in chips) 
Seat 4: I The King I ($119.02 in chips) 
Seat 5: Kreuznagel ($101.60 in chips) 
Seat 6: Pvsx. ($100 in chips) 
Seat 7: mheris ($120.22 in chips) 
Seat 8: oscarleon ($100.50 in chips) 
Seat 9: Zeeshka ($100 in chips) 
oscarleon: posts small blind $0.50
Zeeshka: posts big blind $1
*** HOLE CARDS ***
Dealt to matiko09 [Jh 9h]
godfrey004: folds 
AlKatrone: raises $2 to $3
matiko09: folds 
I The King I: calls $3
Kreuznagel: folds 
Pvsx.: folds 
mheris: folds 
oscarleon: folds 
Zeeshka: folds 
*** FLOP *** [Qd 9d 3h]
AlKatrone: checks 
I The King I: checks 
*** TURN *** [Qd 9d 3h] [2h]
AlKatrone: bets $5.48
I The King I: folds 
Uncalled bet ($5.48) returned to AlKatrone
AlKatrone collected $7.12 from pot
AlKatrone: doesn't show hand 
*** SUMMARY ***
Total pot $7.50 | Rake $0.38 
Board [Qd 9d 3h 2h]
Seat 1: godfrey004 folded before Flop (didn't bet)
Seat 2: AlKatrone collected ($7.12)
Seat 3: matiko09 folded before Flop (didn't bet)
Seat 4: I The King I folded on the Turn
Seat 5: Kreuznagel folded before Flop (didn't bet)
Seat 6: Pvsx. folded before Flop (didn't bet)
Seat 7: mheris (button) folded before Flop (didn't bet)
Seat 8: oscarleon (small blind) folded before Flop
Seat 9: Zeeshka (big blind) folded before Flop





PokerStars Hand #151207915427:  Hold'em No Limit ($1/$2 USD) - 2016/03/31 12:44:27 CET [2016/03/31 6:44:27 ET]
Table 'Probitas' 9-max Seat #1 is the button
Seat 1: rmanjkeee ($176.04 in chips) 
Seat 3: azvazdam ($204.12 in chips) 
Seat 4: Painkiller72 ($221.21 in chips) 
Seat 5: matiko09 ($203 in chips) 
Seat 6: Kreuznagel ($439.39 in chips) 
Seat 7: coinflip_si ($298.53 in chips) 
Seat 8: BOAYARSKIY ($143.45 in chips) 
Seat 9: apfush ($312.99 in chips) 
azvazdam: posts small blind $1
Painkiller72: posts big blind $2
*** HOLE CARDS ***
Dealt to matiko09 [Td 5d]
matiko09: folds 
Kreuznagel: folds 
coinflip_si: folds 
BOAYARSKIY: folds 
apfush: folds 
rmanjkeee: raises $2 to $4
azvazdam: raises $4 to $8
blackball881 leaves the table
Painkiller72: folds 
rmanjkeee: calls $4
*** FLOP *** [4h 4c Qd]
azvazdam: checks 
rmanjkeee: bets $9
azvazdam: raises $9 to $18
rmanjkeee: calls $9
*** TURN *** [4h 4c Qd] [Ac]
azvazdam: checks 
rmanjkeee: checks 
*** RIVER *** [4h 4c Qd Ac] [Kh]
Avtovo joins the table at seat #2 
azvazdam: bets $24
rmanjkeee: folds 
Uncalled bet ($24) returned to azvazdam
azvazdam collected $51.30 from pot
azvazdam: doesn't show hand 
*** SUMMARY ***
Total pot $54 | Rake $2.70 
Board [4h 4c Qd Ac Kh]
Seat 1: rmanjkeee (button) folded on the River
Seat 3: azvazdam (small blind) collected ($51.30)
Seat 4: Painkiller72 (big blind) folded before Flop
Seat 5: matiko09 folded before Flop (didn't bet)
Seat 6: Kreuznagel folded before Flop (didn't bet)
Seat 7: coinflip_si folded before Flop (didn't bet)
Seat 8: BOAYARSKIY folded before Flop (didn't bet)
Seat 9: apfush folded before Flop (didn't bet)





PokerStars Hand #151207917460:  Hold'em No Limit ($0.50/$1.00 USD) - 2016/03/31 12:44:32 CET [2016/03/31 6:44:32 ET]
Table 'Icarus III' 9-max Seat #8 is the button
Seat 2: Painkiller72 ($100 in chips) 
Seat 3: RICKA16 ($106.02 in chips) 
Seat 4: dizzyryano79 ($37.43 in chips) 
Seat 5: I The King I ($113.75 in chips) 
Seat 6: djammusic ($46.08 in chips) 
Seat 7: oscarleon ($161.82 in chips) 
Seat 8: matiko09 ($100 in chips) 
Seat 9: apfush ($122.96 in chips) 
apfush: posts small blind $0.50
Painkiller72: posts big blind $1
*** HOLE CARDS ***
Dealt to matiko09 [4d 7c]
RICKA16: raises $2 to $3
dizzyryano79: folds 
I The King I: folds 
djammusic: folds 
oscarleon: calls $3
matiko09: folds 
apfush: folds 
Painkiller72: folds 
*** FLOP *** [2c Tc Ks]
RICKA16: bets $5
oscarleon: calls $5
*** TURN *** [2c Tc Ks] [8c]
RICKA16: checks 
oscarleon: bets $9
RICKA16: calls $9
*** RIVER *** [2c Tc Ks 8c] [3h]
RICKA16: bets $12
oscarleon: folds 
Uncalled bet ($12) returned to RICKA16
RICKA16 collected $33.72 from pot
RICKA16: doesn't show hand 
*** SUMMARY ***
Total pot $35.50 | Rake $1.78 
Board [2c Tc Ks 8c 3h]
Seat 2: Painkiller72 (big blind) folded before Flop
Seat 3: RICKA16 collected ($33.72)
Seat 4: dizzyryano79 folded before Flop (didn't bet)
Seat 5: I The King I folded before Flop (didn't bet)
Seat 6: djammusic folded before Flop (didn't bet)
Seat 7: oscarleon folded on the River
Seat 8: matiko09 (button) folded before Flop (didn't bet)
Seat 9: apfush (small blind) folded before Flop





PokerStars Hand #151207919397:  Hold'em No Limit ($0.50/$1.00 USD) - 2016/03/31 12:44:36 CET [2016/03/31 6:44:36 ET]
Table 'Egeria II' 9-max Seat #8 is the button
Seat 1: oscarleon ($124.03 in chips) 
Seat 2: I The King I ($176.50 in chips) 
Seat 3: Pvsx. ($119.64 in chips) 
Seat 4: matiko09 ($100 in chips) 
Seat 5: apfush ($141.32 in chips) 
Seat 7: Reven9er ($138.44 in chips) 
Seat 8: Kreuznagel ($135.01 in chips) 
Seat 9: miracolix50 ($73.89 in chips) 
miracolix50: posts small blind $0.50
oscarleon: posts big blind $1
DUkalisUA: sits out 
*** HOLE CARDS ***
Dealt to matiko09 [4s 2h]
I The King I: folds 
Pvsx.: raises $1.50 to $2.50
matiko09: folds 
apfush: calls $2.50
Reven9er: folds 
Kreuznagel: folds 
miracolix50: folds 
oscarleon: folds 
*** FLOP *** [2d Qh 7d]
Pvsx.: checks 
apfush: bets $4
Pvsx.: folds 
Uncalled bet ($4) returned to apfush
apfush collected $6.18 from pot
apfush: doesn't show hand 
*** SUMMARY ***
Total pot $6.50 | Rake $0.32 
Board [2d Qh 7d]
Seat 1: oscarleon (big blind) folded before Flop
Seat 2: I The King I folded before Flop (didn't bet)
Seat 3: Pvsx. folded on the Flop
Seat 4: matiko09 folded before Flop (didn't bet)
Seat 5: apfush collected ($6.18)
Seat 7: Reven9er folded before Flop (didn't bet)
Seat 8: Kreuznagel (button) folded before Flop (didn't bet)
Seat 9: miracolix50 (small blind) folded before Flop





PokerStars Hand #151207928447:  Hold'em No Limit ($0.50/$1.00 USD) - 2016/03/31 12:44:55 CET [2016/03/31 6:44:55 ET]
Table 'Herge II' 9-max Seat #1 is the button
Seat 1: Chiapel ($103.17 in chips) 
Seat 2: DUkalisUA ($100.50 in chips) 
Seat 3: matiko09 ($211.77 in chips) 
Seat 4: Kreuznagel ($101.50 in chips) 
Seat 5: I The King I ($135.23 in chips) 
Seat 6: masaytoo ($93 in chips) 
Seat 7: Zeeshka ($139.45 in chips) 
Seat 8: IdiotFromNE ($100 in chips) 
Seat 9: fatstacks122 ($129.83 in chips) 
DUkalisUA: posts small blind $0.50
matiko09: posts big blind $1
*** HOLE CARDS ***
Dealt to matiko09 [6c Qs]
Kreuznagel: raises $1.39 to $2.39
I The King I: folds 
masaytoo: folds 
Zeeshka: folds 
IdiotFromNE: folds 
fatstacks122: folds 
Chiapel: folds 
DUkalisUA: folds 
matiko09: folds 
Uncalled bet ($1.39) returned to Kreuznagel
Kreuznagel collected $2.50 from pot
Kreuznagel: doesn't show hand 
*** SUMMARY ***
Total pot $2.50 | Rake $0 
Seat 1: Chiapel (button) folded before Flop (didn't bet)
Seat 2: DUkalisUA (small blind) folded before Flop
Seat 3: matiko09 (big blind) folded before Flop
Seat 4: Kreuznagel collected ($2.50)
Seat 5: I The King I folded before Flop (didn't bet)
Seat 6: masaytoo folded before Flop (didn't bet)
Seat 7: Zeeshka folded before Flop (didn't bet)
Seat 8: IdiotFromNE folded before Flop (didn't bet)
Seat 9: fatstacks122 folded before Flop (didn't bet)





PokerStars Hand #151207933171:  Hold'em No Limit ($1/$2 USD) - 2016/03/31 12:45:04 CET [2016/03/31 6:45:04 ET]
Table 'Desiderata' 9-max Seat #7 is the button
Seat 1: GALWACONT ($189.62 in chips) 
Seat 2: ilaviiitech ($221 in chips) 
Seat 3: djammusic ($77 in chips) 
Seat 4: matiko09 ($327.10 in chips) 
Seat 5: Kreuznagel ($314.55 in chips) 
Seat 6: rmanjkeee ($105.45 in chips) 
Seat 7: apfush ($252.83 in chips) 
Seat 8: DUkalisUA ($200 in chips) 
Seat 9: Painkiller72 ($200 in chips) 
DUkalisUA: posts small blind $1
Painkiller72: posts big blind $2
*** HOLE CARDS ***
Dealt to matiko09 [Th 2h]
GALWACONT: folds 
ilaviiitech: raises $4 to $6
djammusic: folds 
matiko09: folds 
Kreuznagel: folds 
rmanjkeee: folds 
GALWACONT leaves the table
apfush: folds 
DUkalisUA: folds 
Painkiller72: folds 
Uncalled bet ($4) returned to ilaviiitech
ilaviiitech collected $5 from pot
ilaviiitech: doesn't show hand 
*** SUMMARY ***
Total pot $5 | Rake $0 
Seat 1: GALWACONT folded before Flop (didn't bet)
Seat 2: ilaviiitech collected ($5)
Seat 3: djammusic folded before Flop (didn't bet)
Seat 4: matiko09 folded before Flop (didn't bet)
Seat 5: Kreuznagel folded before Flop (didn't bet)
Seat 6: rmanjkeee folded before Flop (didn't bet)
Seat 7: apfush (button) folded before Flop (didn't bet)
Seat 8: DUkalisUA (small blind) folded before Flop
Seat 9: Painkiller72 (big blind) folded before Flop





PokerStars Hand #151207933589:  Hold'em No Limit ($0.50/$1.00 USD) - 2016/03/31 12:45:05 CET [2016/03/31 6:45:05 ET]
Table 'Yazhi' 9-max Seat #9 is the button
Seat 1: matiko09 ($100 in chips) 
Seat 2: xHourglass ($103.49 in chips) 
Seat 3: Chin41178 ($90.91 in chips) 
Seat 4: apfush ($183.08 in chips) 
Seat 5: IdiotFromNE ($102.50 in chips) 
Seat 6: Reven9er ($233.99 in chips) 
Seat 7: Avtovo ($100 in chips) 
Seat 8: pk4DW ($53.96 in chips) 
Seat 9: oscarleon ($197.73 in chips) 
matiko09: posts small blind $0.50
xHourglass: posts big blind $1
*** HOLE CARDS ***
Dealt to matiko09 [3c 9d]
Chin41178: raises $2 to $3
apfush: folds 
IdiotFromNE: folds 
Reven9er: folds 
Avtovo: folds 
pk4DW: folds 
oscarleon: folds 
matiko09: folds 
xHourglass: folds 
Uncalled bet ($2) returned to Chin41178
Chin41178 collected $2.50 from pot
Chin41178: doesn't show hand 
*** SUMMARY ***
Total pot $2.50 | Rake $0 
Seat 1: matiko09 (small blind) folded before Flop
Seat 2: xHourglass (big blind) folded before Flop
Seat 3: Chin41178 collected ($2.50)
Seat 4: apfush folded before Flop (didn't bet)
Seat 5: IdiotFromNE folded before Flop (didn't bet)
Seat 6: Reven9er folded before Flop (didn't bet)
Seat 7: Avtovo folded before Flop (didn't bet)
Seat 8: pk4DW folded before Flop (didn't bet)
Seat 9: oscarleon (button) folded before Flop (didn't bet)





PokerStars Hand #151207936949:  Hold'em No Limit ($0.50/$1.00 USD) - 2016/03/31 12:45:12 CET [2016/03/31 6:45:12 ET]
Table 'Aquila' 9-max Seat #8 is the button
Seat 1: BOAYARSKIY ($50.40 in chips) 
Seat 2: Avtovo ($100 in chips) 
Seat 3: laco121 ($32.54 in chips) 
Seat 5: adelfaz ($72.98 in chips) 
Seat 6: maxxmeister ($118.70 in chips) 
Seat 7: PacPacBum ($131.50 in chips) 
Seat 8: matiko09 ($108.20 in chips) 
Seat 9: apfush ($100 in chips) 
apfush: posts small blind $0.50
BOAYARSKIY: posts big blind $1
BOAYARSKIY: posts the ante $0.20
Avtovo: posts the ante $0.20
laco121: posts the ante $0.20
adelfaz: posts the ante $0.20
maxxmeister: posts the ante $0.20
PacPacBum: posts the ante $0.20
matiko09: posts the ante $0.20
apfush: posts the ante $0.20
*** HOLE CARDS ***
Dealt to matiko09 [2d 7c]
Avtovo: folds 
laco121: folds 
adelfaz: folds 
maxxmeister: folds 
PacPacBum: folds 
matiko09: folds 
apfush: folds 
Uncalled bet ($0.50) returned to BOAYARSKIY
BOAYARSKIY collected $2.60 from pot
BOAYARSKIY: doesn't show hand 
*** SUMMARY ***
Total pot $2.60 | Rake $0 
Seat 1: BOAYARSKIY (big blind) collected ($2.60)
Seat 2: Avtovo folded before Flop (didn't bet)
Seat 3: laco121 folded before Flop (didn't bet)
Seat 5: adelfaz folded before Flop (didn't bet)
Seat 6: maxxmeister folded before Flop (didn't bet)
Seat 7: PacPacBum folded before Flop (didn't bet)
Seat 8: matiko09 (button) folded before Flop (didn't bet)
Seat 9: apfush (small blind) folded before Flop





PokerStars Hand #151207944802:  Hold'em No Limit ($0.50/$1.00 USD) - 2016/03/31 12:45:29 CET [2016/03/31 6:45:29 ET]
Table 'Aquila' 9-max Seat #9 is the button
Seat 1: BOAYARSKIY ($52.30 in chips) 
Seat 2: Avtovo ($100 in chips) 
Seat 3: laco121 ($32.34 in chips) 
Seat 5: adelfaz ($72.78 in chips) 
Seat 6: maxxmeister ($118.50 in chips) 
Seat 7: PacPacBum ($131.30 in chips) 
Seat 8: matiko09 ($108 in chips) 
Seat 9: apfush ($100 in chips) 
BOAYARSKIY: posts small blind $0.50
Avtovo: posts big blind $1
BOAYARSKIY: posts the ante $0.20
Avtovo: posts the ante $0.20
laco121: posts the ante $0.20
adelfaz: posts the ante $0.20
maxxmeister: posts the ante $0.20
PacPacBum: posts the ante $0.20
matiko09: posts the ante $0.20
apfush: posts the ante $0.20
*** HOLE CARDS ***
Dealt to matiko09 [3d Td]
laco121: raises $4 to $5
adelfaz: folds 
maxxmeister: folds 
PacPacBum: folds 
matiko09: folds 
apfush: folds 
BOAYARSKIY: folds 
Avtovo: folds 
Uncalled bet ($4) returned to laco121
laco121 collected $4.10 from pot
laco121: doesn't show hand 
*** SUMMARY ***
Total pot $4.10 | Rake $0 
Seat 1: BOAYARSKIY (small blind) folded before Flop
Seat 2: Avtovo (big blind) folded before Flop
Seat 3: laco121 collected ($4.10)
Seat 5: adelfaz folded before Flop (didn't bet)
Seat 6: maxxmeister folded before Flop (didn't bet)
Seat 7: PacPacBum folded before Flop (didn't bet)
Seat 8: matiko09 folded before Flop (didn't bet)
Seat 9: apfush (button) folded before Flop (didn't bet)





PokerStars Hand #151207948806:  Hold'em No Limit ($0.50/$1.00 USD) - 2016/03/31 12:45:37 CET [2016/03/31 6:45:37 ET]
Table 'Herge II' 9-max Seat #2 is the button
Seat 1: Chiapel ($103.17 in chips) 
Seat 2: DUkalisUA ($100 in chips) 
Seat 3: matiko09 ($210.77 in chips) 
Seat 4: Kreuznagel ($103 in chips) 
Seat 5: I The King I ($135.23 in chips) 
Seat 6: masaytoo ($93 in chips) 
Seat 7: Zeeshka ($139.45 in chips) 
Seat 8: IdiotFromNE ($100 in chips) 
Seat 9: fatstacks122 ($129.83 in chips) 
matiko09: posts small blind $0.50
Kreuznagel: posts big blind $1
*** HOLE CARDS ***
Dealt to matiko09 [2c 7h]
I The King I: folds 
masaytoo: folds 
Zeeshka: folds 
IdiotFromNE: folds 
fatstacks122: folds 
Chiapel: folds 
DUkalisUA: folds 
matiko09: folds 
Uncalled bet ($0.50) returned to Kreuznagel
Kreuznagel collected $1 from pot
Kreuznagel: doesn't show hand 
*** SUMMARY ***
Total pot $1 | Rake $0 
Seat 1: Chiapel folded before Flop (didn't bet)
Seat 2: DUkalisUA (button) folded before Flop (didn't bet)
Seat 3: matiko09 (small blind) folded before Flop
Seat 4: Kreuznagel (big blind) collected ($1)
Seat 5: I The King I folded before Flop (didn't bet)
Seat 6: masaytoo folded before Flop (didn't bet)
Seat 7: Zeeshka folded before Flop (didn't bet)
Seat 8: IdiotFromNE folded before Flop (didn't bet)
Seat 9: fatstacks122 folded before Flop (didn't bet)





PokerStars Hand #151207953695:  Hold'em No Limit ($0.50/$1.00 USD) - 2016/03/31 12:45:47 CET [2016/03/31 6:45:47 ET]
Table 'Yazhi' 9-max Seat #1 is the button
Seat 1: matiko09 ($100 in chips) 
Seat 2: xHourglass ($102.49 in chips) 
Seat 4: apfush ($183.08 in chips) 
Seat 5: IdiotFromNE ($102.50 in chips) 
Seat 6: Reven9er ($233.99 in chips) 
Seat 7: Avtovo ($100 in chips) 
Seat 8: pk4DW ($53.96 in chips) 
Seat 9: oscarleon ($197.73 in chips) 
xHourglass: posts small blind $0.50
Chin41178: is sitting out 
apfush: posts big blind $1
*** HOLE CARDS ***
Dealt to matiko09 [Jh 3c]
IdiotFromNE: folds 
Reven9er: folds 
Avtovo: folds 
pk4DW: raises $1 to $2
oscarleon: folds 
matiko09: folds 
xHourglass: calls $1.50
apfush: calls $1
*** FLOP *** [Ts 6s 7h]
xHourglass: checks 
apfush: checks 
pk4DW: bets $2.85
xHourglass: calls $2.85
apfush: folds 
*** TURN *** [Ts 6s 7h] [Ks]
xHourglass: bets $7
pk4DW: folds 
Uncalled bet ($7) returned to xHourglass
xHourglass collected $11.12 from pot
xHourglass: doesn't show hand 
*** SUMMARY ***
Total pot $11.70 | Rake $0.58 
Board [Ts 6s 7h Ks]
Seat 1: matiko09 (button) folded before Flop (didn't bet)
Seat 2: xHourglass (small blind) collected ($11.12)
Seat 4: apfush (big blind) folded on the Flop
Seat 5: IdiotFromNE folded before Flop (didn't bet)
Seat 6: Reven9er folded before Flop (didn't bet)
Seat 7: Avtovo folded before Flop (didn't bet)
Seat 8: pk4DW folded on the Turn
Seat 9: oscarleon folded before Flop (didn't bet)





PokerStars Hand #151207956734:  Hold'em No Limit ($0.50/$1.00 USD) - 2016/03/31 12:45:53 CET [2016/03/31 6:45:53 ET]
Table 'Egeria II' 9-max Seat #9 is the button
Seat 1: oscarleon ($123.03 in chips) 
Seat 2: I The King I ($176.50 in chips) 
Seat 3: Pvsx. ($117.14 in chips) 
Seat 4: matiko09 ($100 in chips) 
Seat 5: apfush ($145 in chips) 
Seat 7: Reven9er ($138.44 in chips) 
Seat 8: Kreuznagel ($135.01 in chips) 
Seat 9: miracolix50 ($73.39 in chips) 
oscarleon: posts small blind $0.50
I The King I: posts big blind $1
DUkalisUA: sits out 
*** HOLE CARDS ***
Dealt to matiko09 [Kh 2s]
Pvsx.: folds 
matiko09: folds 
apfush: folds 
Reven9er: folds 
Kreuznagel: folds 
miracolix50: calls $1
oscarleon: folds 
I The King I: raises $3 to $4
miracolix50: calls $3
*** FLOP *** [Kd 5c 4d]
I The King I: checks 
miracolix50: checks 
*** TURN *** [Kd 5c 4d] [3h]
I The King I: checks 
miracolix50: checks 
*** RIVER *** [Kd 5c 4d 3h] [Jh]
I The King I: checks 
miracolix50: checks 
*** SHOW DOWN ***
I The King I: shows [Tc Kc] (a pair of Kings)
miracolix50: mucks hand 
I The King I collected $8.08 from pot
*** SUMMARY ***
Total pot $8.50 | Rake $0.42 
Board [Kd 5c 4d 3h Jh]
Seat 1: oscarleon (small blind) folded before Flop
Seat 2: I The King I (big blind) showed [Tc Kc] and won ($8.08) with a pair of Kings
Seat 3: Pvsx. folded before Flop (didn't bet)
Seat 4: matiko09 folded before Flop (didn't bet)
Seat 5: apfush folded before Flop (didn't bet)
Seat 7: Reven9er folded before Flop (didn't bet)
Seat 8: Kreuznagel folded before Flop (didn't bet)
Seat 9: miracolix50 (button) mucked [Qd 7c]





PokerStars Hand #151207957761:  Hold'em No Limit ($0.50/$1.00 USD) - 2016/03/31 12:45:56 CET [2016/03/31 6:45:56 ET]
Table 'Icarus III' 9-max Seat #9 is the button
Seat 2: Painkiller72 ($100 in chips) 
Seat 3: RICKA16 ($122.74 in chips) 
Seat 4: dizzyryano79 ($37.43 in chips) 
Seat 5: I The King I ($113.75 in chips) 
Seat 6: djammusic ($46.08 in chips) 
Seat 7: oscarleon ($144.82 in chips) 
Seat 8: matiko09 ($100 in chips) 
Seat 9: apfush ($122.46 in chips) 
Painkiller72: posts small blind $0.50
RICKA16: posts big blind $1
*** HOLE CARDS ***
Dealt to matiko09 [Qd Kc]
dizzyryano79: raises $1 to $2
I The King I: folds 
djammusic: folds 
oscarleon: folds 
matiko09: calls $2
apfush: folds 
Painkiller72: folds 
RICKA16: folds 
*** FLOP *** [Qc 3c Th]
dizzyryano79: bets $1
matiko09: raises $4.69 to $5.69
dizzyryano79: folds 
Uncalled bet ($4.69) returned to matiko09
matiko09 collected $7.12 from pot
matiko09: doesn't show hand 
*** SUMMARY ***
Total pot $7.50 | Rake $0.38 
Board [Qc 3c Th]
Seat 2: Painkiller72 (small blind) folded before Flop
Seat 3: RICKA16 (big blind) folded before Flop
Seat 4: dizzyryano79 folded on the Flop
Seat 5: I The King I folded before Flop (didn't bet)
Seat 6: djammusic folded before Flop (didn't bet)
Seat 7: oscarleon folded before Flop (didn't bet)
Seat 8: matiko09 collected ($7.12)
Seat 9: apfush (button) folded before Flop (didn't bet)





PokerStars Hand #151207959945:  Hold'em No Limit ($1/$2 USD) - 2016/03/31 12:46:00 CET [2016/03/31 6:46:00 ET]
Table 'Coelestina II' 9-max Seat #9 is the button
Seat 1: PacPacBum ($215.85 in chips) 
Seat 2: Kreuznagel ($215.05 in chips) 
Seat 3: ilaviiitech ($201.30 in chips) 
Seat 4: matiko09 ($200 in chips) 
Seat 5: Painkiller72 ($200 in chips) 
Seat 6: Avtovo ($235.07 in chips) 
Seat 7: rmanjkeee ($80 in chips) 
Seat 8: DUkalisUA ($232.31 in chips) 
Seat 9: fonng ($191.45 in chips) 
PacPacBum: posts small blind $1
Kreuznagel: posts big blind $2
*** HOLE CARDS ***
Dealt to matiko09 [8h 2s]
ilaviiitech: folds 
matiko09: folds 
Painkiller72: folds 
Avtovo: folds 
rmanjkeee: folds 
DUkalisUA: folds 
fonng has timed out while disconnected
fonng: folds 
PacPacBum: folds 
Uncalled bet ($1) returned to Kreuznagel
Kreuznagel collected $2 from pot
Kreuznagel: doesn't show hand 
*** SUMMARY ***
Total pot $2 | Rake $0 
Seat 1: PacPacBum (small blind) folded before Flop
Seat 2: Kreuznagel (big blind) collected ($2)
Seat 3: ilaviiitech folded before Flop (didn't bet)
Seat 4: matiko09 folded before Flop (didn't bet)
Seat 5: Painkiller72 folded before Flop (didn't bet)
Seat 6: Avtovo folded before Flop (didn't bet)
Seat 7: rmanjkeee folded before Flop (didn't bet)
Seat 8: DUkalisUA folded before Flop (didn't bet)
Seat 9: fonng (button) folded before Flop (didn't bet)





PokerStars Hand #151207964853:  Hold'em No Limit ($0.50/$1.00 USD) - 2016/03/31 12:46:10 CET [2016/03/31 6:46:10 ET]
Table 'Herge II' 9-max Seat #3 is the button
Seat 1: Chiapel ($103.17 in chips) 
Seat 2: DUkalisUA ($100 in chips) 
Seat 3: matiko09 ($210.27 in chips) 
Seat 4: Kreuznagel ($103.50 in chips) 
Seat 5: I The King I ($135.23 in chips) 
Seat 6: masaytoo ($93 in chips) 
Seat 7: Zeeshka ($139.45 in chips) 
Seat 8: IdiotFromNE ($100 in chips) 
Seat 9: fatstacks122 ($129.83 in chips) 
Kreuznagel: posts small blind $0.50
I The King I: posts big blind $1
*** HOLE CARDS ***
Dealt to matiko09 [2d 9s]
masaytoo: folds 
Zeeshka: folds 
IdiotFromNE: folds 
fatstacks122: folds 
Chiapel: folds 
DUkalisUA: folds 
matiko09: folds 
Kreuznagel: raises $2.13 to $3.13
I The King I: folds 
Uncalled bet ($2.13) returned to Kreuznagel
Kreuznagel collected $2 from pot
Kreuznagel: doesn't show hand 
*** SUMMARY ***
Total pot $2 | Rake $0 
Seat 1: Chiapel folded before Flop (didn't bet)
Seat 2: DUkalisUA folded before Flop (didn't bet)
Seat 3: matiko09 (button) folded before Flop (didn't bet)
Seat 4: Kreuznagel (small blind) collected ($2)
Seat 5: I The King I (big blind) folded before Flop
Seat 6: masaytoo folded before Flop (didn't bet)
Seat 7: Zeeshka folded before Flop (didn't bet)
Seat 8: IdiotFromNE folded before Flop (didn't bet)
Seat 9: fatstacks122 folded before Flop (didn't bet)





PokerStars Hand #151207965610:  Hold'em No Limit ($0.50/$1.00 USD) - 2016/03/31 12:46:12 CET [2016/03/31 6:46:12 ET]
Table 'Aquila' 9-max Seat #1 is the button
Seat 1: BOAYARSKIY ($51.60 in chips) 
Seat 2: Avtovo ($100 in chips) 
Seat 3: laco121 ($35.24 in chips) 
Seat 5: adelfaz ($72.58 in chips) 
Seat 6: maxxmeister ($118.30 in chips) 
Seat 7: PacPacBum ($131.10 in chips) 
Seat 8: matiko09 ($107.80 in chips) 
Seat 9: apfush ($100 in chips) 
Avtovo: posts small blind $0.50
laco121: posts big blind $1
BOAYARSKIY: posts the ante $0.20
Avtovo: posts the ante $0.20
laco121: posts the ante $0.20
adelfaz: posts the ante $0.20
maxxmeister: posts the ante $0.20
PacPacBum: posts the ante $0.20
matiko09: posts the ante $0.20
apfush: posts the ante $0.20
*** HOLE CARDS ***
Dealt to matiko09 [7s Td]
adelfaz: folds 
maxxmeister: folds 
PacPacBum: folds 
matiko09: folds 
apfush: folds 
BOAYARSKIY: folds 
Avtovo: folds 
Uncalled bet ($0.50) returned to laco121
laco121 collected $2.60 from pot
laco121: doesn't show hand 
*** SUMMARY ***
Total pot $2.60 | Rake $0 
Seat 1: BOAYARSKIY (button) folded before Flop (didn't bet)
Seat 2: Avtovo (small blind) folded before Flop
Seat 3: laco121 (big blind) collected ($2.60)
Seat 5: adelfaz folded before Flop (didn't bet)
Seat 6: maxxmeister folded before Flop (didn't bet)
Seat 7: PacPacBum folded before Flop (didn't bet)
Seat 8: matiko09 folded before Flop (didn't bet)
Seat 9: apfush folded before Flop (didn't bet)





PokerStars Hand #151207965921:  Hold'em No Limit ($0.50/$1.00 USD) - 2016/03/31 12:46:13 CET [2016/03/31 6:46:13 ET]
Table 'Haworth II' 9-max Seat #8 is the button
Seat 2: AlKatrone ($130.58 in chips) 
Seat 3: matiko09 ($102.68 in chips) 
Seat 4: I The King I ($116.02 in chips) 
Seat 5: Kreuznagel ($101.60 in chips) 
Seat 6: Pvsx. ($100 in chips) 
Seat 7: mheris ($120.22 in chips) 
Seat 8: oscarleon ($100 in chips) 
Seat 9: Zeeshka ($100 in chips) 
Zeeshka: posts small blind $0.50
godfrey004: is sitting out 
AlKatrone: posts big blind $1
*** HOLE CARDS ***
Dealt to matiko09 [Ks Kc]
matiko09: raises $2 to $3
I The King I: folds 
Kreuznagel: folds 
Pvsx.: folds 
mheris: calls $3
oscarleon: folds 
Zeeshka: folds 
AlKatrone: folds 
*** FLOP *** [Th 4s 5s]
matiko09: bets $5
mheris: calls $5
*** TURN *** [Th 4s 5s] [Jh]
matiko09: bets $11
mheris: calls $11
*** RIVER *** [Th 4s 5s Jh] [As]
matiko09: checks 
mheris: bets $101.22 and is all-in
matiko09: folds 
Uncalled bet ($101.22) returned to mheris
mheris collected $37.52 from pot
mheris: doesn't show hand 
*** SUMMARY ***
Total pot $39.50 | Rake $1.98 
Board [Th 4s 5s Jh As]
Seat 2: AlKatrone (big blind) folded before Flop
Seat 3: matiko09 folded on the River
Seat 4: I The King I folded before Flop (didn't bet)
Seat 5: Kreuznagel folded before Flop (didn't bet)
Seat 6: Pvsx. folded before Flop (didn't bet)
Seat 7: mheris collected ($37.52)
Seat 8: oscarleon (button) folded before Flop (didn't bet)
Seat 9: Zeeshka (small blind) folded before Flop





PokerStars Hand #151207967683:  Hold'em No Limit (€0.50/€1.00 EUR) - 2016/03/31 12:46:16 CET [2016/03/31 6:46:16 ET]
Table 'Pioneer II' 9-max Seat #4 is the button
Seat 2: IdiotFromNE (€129.52 in chips) 
Seat 3: Kupumalam (€51.60 in chips) 
Seat 4: Painkiller72 (€161.26 in chips) 
Seat 5: Zeeshka (€100 in chips) 
Seat 6: matiko09 (€101.50 in chips) 
Seat 8: PacPacBum (€104.72 in chips) 
Zeeshka: posts small blind €0.50
matiko09: posts big blind €1
AlKatrone: sits out 
*** HOLE CARDS ***
Dealt to matiko09 [3h 4h]
PacPacBum: folds 
IdiotFromNE: folds 
Kupumalam: raises €1 to €2
Painkiller72: folds 
Zeeshka: folds 
matiko09: folds 
Uncalled bet (€1) returned to Kupumalam
Kupumalam collected €2.50 from pot
*** SUMMARY ***
Total pot €2.50 | Rake €0 
Seat 2: IdiotFromNE folded before Flop (didn't bet)
Seat 3: Kupumalam collected (€2.50)
Seat 4: Painkiller72 (button) folded before Flop (didn't bet)
Seat 5: Zeeshka (small blind) folded before Flop
Seat 6: matiko09 (big blind) folded before Flop
Seat 8: PacPacBum folded before Flop (didn't bet)





PokerStars Hand #151207967419:  Hold'em No Limit ($1/$2 USD) - 2016/03/31 12:46:16 CET [2016/03/31 6:46:16 ET]
Table 'Desiderata' 9-max Seat #8 is the button
Seat 3: djammusic ($77 in chips) 
Seat 4: matiko09 ($327.10 in chips) 
Seat 5: Kreuznagel ($314.55 in chips) 
Seat 6: rmanjkeee ($105.45 in chips) 
Seat 7: apfush ($252.83 in chips) 
Seat 8: DUkalisUA ($200 in chips) 
Seat 9: Painkiller72 ($200 in chips) 
Painkiller72: posts small blind $1
ilaviiitech: is sitting out 
djammusic: posts big blind $2
*** HOLE CARDS ***
Dealt to matiko09 [5h Qc]
matiko09: folds 
ilaviiitech leaves the table
Avtovo joins the table at seat #1 
matiko09 leaves the table
Avtovo leaves the table
Kreuznagel: raises $2.78 to $4.78
rmanjkeee: folds 
apfush: folds 
DUkalisUA: folds 
Painkiller72: folds 
djammusic: folds 
Uncalled bet ($2.78) returned to Kreuznagel
Kreuznagel collected $5 from pot
Kreuznagel: doesn't show hand 
*** SUMMARY ***
Total pot $5 | Rake $0 
Seat 3: djammusic (big blind) folded before Flop
Seat 4: matiko09 folded before Flop (didn't bet)
Seat 5: Kreuznagel collected ($5)
Seat 6: rmanjkeee folded before Flop (didn't bet)
Seat 7: apfush folded before Flop (didn't bet)
Seat 8: DUkalisUA (button) folded before Flop (didn't bet)
Seat 9: Painkiller72 (small blind) folded before Flop





PokerStars Hand #151207971008:  Hold'em No Limit ($1/$2 USD) - 2016/03/31 12:46:23 CET [2016/03/31 6:46:23 ET]
Table 'Probitas' 9-max Seat #3 is the button
Seat 1: rmanjkeee ($150.04 in chips) 
Seat 3: azvazdam ($229.42 in chips) 
Seat 4: Painkiller72 ($219.21 in chips) 
Seat 5: matiko09 ($203 in chips) 
Seat 6: Kreuznagel ($439.39 in chips) 
Seat 7: coinflip_si ($298.53 in chips) 
Seat 8: BOAYARSKIY ($143.45 in chips) 
Seat 9: apfush ($312.99 in chips) 
Painkiller72: posts small blind $1
matiko09: posts big blind $2
Avtovo: sits out 
*** HOLE CARDS ***
Dealt to matiko09 [4s 7h]
Kreuznagel: raises $2.78 to $4.78
coinflip_si: folds 
BOAYARSKIY: calls $4.78
apfush: folds 
rmanjkeee: folds 
azvazdam: calls $4.78
Painkiller72: folds 
matiko09: folds 
*** FLOP *** [8d 2d 8s]
Kreuznagel: checks 
BOAYARSKIY: checks 
azvazdam: checks 
*** TURN *** [8d 2d 8s] [Ks]
Kreuznagel: bets $7.85
BOAYARSKIY: folds 
azvazdam: folds 
Uncalled bet ($7.85) returned to Kreuznagel
Kreuznagel collected $16.47 from pot
Kreuznagel: doesn't show hand 
*** SUMMARY ***
Total pot $17.34 | Rake $0.87 
Board [8d 2d 8s Ks]
Seat 1: rmanjkeee folded before Flop (didn't bet)
Seat 3: azvazdam (button) folded on the Turn
Seat 4: Painkiller72 (small blind) folded before Flop
Seat 5: matiko09 (big blind) folded before Flop
Seat 6: Kreuznagel collected ($16.47)
Seat 7: coinflip_si folded before Flop (didn't bet)
Seat 8: BOAYARSKIY folded on the Turn
Seat 9: apfush folded before Flop (didn't bet)





PokerStars Hand #151207974496:  Hold'em No Limit ($1/$2 USD) - 2016/03/31 12:46:30 CET [2016/03/31 6:46:30 ET]
Table 'Coelestina II' 9-max Seat #1 is the button
Seat 1: PacPacBum ($214.85 in chips) 
Seat 2: Kreuznagel ($216.05 in chips) 
Seat 3: ilaviiitech ($201.30 in chips) 
Seat 4: matiko09 ($200 in chips) 
Seat 5: Painkiller72 ($200 in chips) 
Seat 6: Avtovo ($235.07 in chips) 
Seat 7: rmanjkeee ($80 in chips) 
Seat 8: DUkalisUA ($232.31 in chips) 
Seat 9: fonng ($191.45 in chips) 
Kreuznagel: posts small blind $1
ilaviiitech: posts big blind $2
*** HOLE CARDS ***
Dealt to matiko09 [5d Kd]
matiko09: folds 
Painkiller72: raises $3 to $5
Avtovo: folds 
rmanjkeee: folds 
DUkalisUA: folds 
fonng: folds 
PacPacBum: folds 
Kreuznagel: folds 
ilaviiitech: folds 
Uncalled bet ($3) returned to Painkiller72
Painkiller72 collected $5 from pot
Painkiller72: doesn't show hand 
*** SUMMARY ***
Total pot $5 | Rake $0 
Seat 1: PacPacBum (button) folded before Flop (didn't bet)
Seat 2: Kreuznagel (small blind) folded before Flop
Seat 3: ilaviiitech (big blind) folded before Flop
Seat 4: matiko09 folded before Flop (didn't bet)
Seat 5: Painkiller72 collected ($5)
Seat 6: Avtovo folded before Flop (didn't bet)
Seat 7: rmanjkeee folded before Flop (didn't bet)
Seat 8: DUkalisUA folded before Flop (didn't bet)
Seat 9: fonng folded before Flop (didn't bet)





PokerStars Hand #151207978375:  Hold'em No Limit ($0.50/$1.00 USD) - 2016/03/31 12:46:38 CET [2016/03/31 6:46:38 ET]
Table 'Aquila' 9-max Seat #2 is the button
Seat 1: BOAYARSKIY ($51.40 in chips) 
Seat 2: Avtovo ($100 in chips) 
Seat 3: laco121 ($37.14 in chips) 
Seat 5: adelfaz ($72.38 in chips) 
Seat 6: maxxmeister ($118.10 in chips) 
Seat 7: PacPacBum ($130.90 in chips) 
Seat 8: matiko09 ($107.60 in chips) 
Seat 9: apfush ($100 in chips) 
laco121: posts small blind $0.50
adelfaz: posts big blind $1
BOAYARSKIY: posts the ante $0.20
Avtovo: posts the ante $0.20
laco121: posts the ante $0.20
adelfaz: posts the ante $0.20
maxxmeister: posts the ante $0.20
PacPacBum: posts the ante $0.20
matiko09: posts the ante $0.20
apfush: posts the ante $0.20
*** HOLE CARDS ***
Dealt to matiko09 [Jh Ad]
maxxmeister: folds 
PacPacBum: raises $1.50 to $2.50
matiko09: raises $6.50 to $9
apfush: folds 
BOAYARSKIY: folds 
Avtovo: folds 
laco121: calls $8.50
adelfaz: folds 
PacPacBum: folds 
*** FLOP *** [3c Ts 5s]
laco121: bets $27.94 and is all-in
matiko09: calls $27.94
*** TURN *** [3c Ts 5s] [Qh]
*** RIVER *** [3c Ts 5s Qh] [4d]
*** SHOW DOWN ***
laco121: shows [6s 8s] (high card Queen)
matiko09: shows [Jh Ad] (high card Ace)
matiko09 collected $76.48 from pot
*** SUMMARY ***
Total pot $78.98 | Rake $2.50 
Board [3c Ts 5s Qh 4d]
Seat 1: BOAYARSKIY folded before Flop (didn't bet)
Seat 2: Avtovo (button) folded before Flop (didn't bet)
Seat 3: laco121 (small blind) showed [6s 8s] and lost with high card Queen
Seat 5: adelfaz (big blind) folded before Flop
Seat 6: maxxmeister folded before Flop (didn't bet)
Seat 7: PacPacBum folded before Flop
Seat 8: matiko09 showed [Jh Ad] and won ($76.48) with high card Ace
Seat 9: apfush folded before Flop (didn't bet)





PokerStars Hand #151207984857:  Hold'em No Limit ($0.50/$1.00 USD) - 2016/03/31 12:46:52 CET [2016/03/31 6:46:52 ET]
Table 'Yazhi' 9-max Seat #2 is the button
Seat 1: matiko09 ($100 in chips) 
Seat 2: xHourglass ($108.76 in chips) 
Seat 4: apfush ($181.08 in chips) 
Seat 5: IdiotFromNE ($102.50 in chips) 
Seat 6: Reven9er ($233.99 in chips) 
Seat 7: Avtovo ($100 in chips) 
Seat 8: pk4DW ($49.11 in chips) 
Seat 9: oscarleon ($197.73 in chips) 
apfush: posts small blind $0.50
IdiotFromNE: posts big blind $1
*** HOLE CARDS ***
Dealt to matiko09 [5h 8d]
Reven9er: raises $1 to $2
Avtovo: folds 
pk4DW has timed out
pk4DW: folds 
oscarleon: folds 
matiko09: folds 
xHourglass: folds 
apfush: raises $7.50 to $9.50
IdiotFromNE: folds 
Reven9er: calls $7.50
*** FLOP *** [Ad Jc Qs]
apfush: bets $13.50
Reven9er: folds 
Uncalled bet ($13.50) returned to apfush
apfush collected $19 from pot
apfush: doesn't show hand 
*** SUMMARY ***
Total pot $20 | Rake $1 
Board [Ad Jc Qs]
Seat 1: matiko09 folded before Flop (didn't bet)
Seat 2: xHourglass (button) folded before Flop (didn't bet)
Seat 4: apfush (small blind) collected ($19)
Seat 5: IdiotFromNE (big blind) folded before Flop
Seat 6: Reven9er folded on the Flop
Seat 7: Avtovo folded before Flop (didn't bet)
Seat 8: pk4DW folded before Flop (didn't bet)
Seat 9: oscarleon folded before Flop (didn't bet)





PokerStars Hand #151207993600:  Hold'em No Limit ($1/$2 USD) - 2016/03/31 12:47:10 CET [2016/03/31 6:47:10 ET]
Table 'Coelestina II' 9-max Seat #2 is the button
Seat 1: PacPacBum ($214.85 in chips) 
Seat 2: Kreuznagel ($215.05 in chips) 
Seat 3: ilaviiitech ($200 in chips) 
Seat 4: matiko09 ($200 in chips) 
Seat 5: Painkiller72 ($203 in chips) 
Seat 6: Avtovo ($235.07 in chips) 
Seat 7: rmanjkeee ($80 in chips) 
Seat 8: DUkalisUA ($232.31 in chips) 
Seat 9: fonng ($191.45 in chips) 
ilaviiitech: posts small blind $1
matiko09: posts big blind $2
*** HOLE CARDS ***
Dealt to matiko09 [Qc 3d]
Painkiller72: folds 
Avtovo: raises $3 to $5
rmanjkeee: folds 
DUkalisUA: folds 
fonng: folds 
PacPacBum: folds 
Kreuznagel: folds 
ilaviiitech: folds 
matiko09: folds 
Uncalled bet ($3) returned to Avtovo
Avtovo collected $5 from pot
Avtovo: doesn't show hand 
*** SUMMARY ***
Total pot $5 | Rake $0 
Seat 1: PacPacBum folded before Flop (didn't bet)
Seat 2: Kreuznagel (button) folded before Flop (didn't bet)
Seat 3: ilaviiitech (small blind) folded before Flop
Seat 4: matiko09 (big blind) folded before Flop
Seat 5: Painkiller72 folded before Flop (didn't bet)
Seat 6: Avtovo collected ($5)
Seat 7: rmanjkeee folded before Flop (didn't bet)
Seat 8: DUkalisUA folded before Flop (didn't bet)
Seat 9: fonng folded before Flop (didn't bet)





PokerStars Hand #151207993734:  Hold'em No Limit (€0.50/€1.00 EUR) - 2016/03/31 12:47:10 CET [2016/03/31 6:47:10 ET]
Table 'Pioneer II' 9-max Seat #5 is the button
Seat 2: IdiotFromNE (€129.52 in chips) 
Seat 3: Kupumalam (€53.10 in chips) 
Seat 4: Painkiller72 (€161.26 in chips) 
Seat 5: Zeeshka (€100 in chips) 
Seat 6: matiko09 (€100.50 in chips) 
Seat 7: AlKatrone (€130.41 in chips) 
Seat 8: PacPacBum (€104.72 in chips) 
matiko09: posts small blind €0.50
AlKatrone: posts big blind €1
*** HOLE CARDS ***
Dealt to matiko09 [9d Kd]
PacPacBum: raises €1.04 to €2.04
IdiotFromNE: folds 
Kupumalam: folds 
Painkiller72: folds 
Zeeshka: folds 
matiko09: folds 
AlKatrone: folds 
Uncalled bet (€1.04) returned to PacPacBum
PacPacBum collected €2.50 from pot
PacPacBum: doesn't show hand 
*** SUMMARY ***
Total pot €2.50 | Rake €0 
Seat 2: IdiotFromNE folded before Flop (didn't bet)
Seat 3: Kupumalam folded before Flop (didn't bet)
Seat 4: Painkiller72 folded before Flop (didn't bet)
Seat 5: Zeeshka (button) folded before Flop (didn't bet)
Seat 6: matiko09 (small blind) folded before Flop
Seat 7: AlKatrone (big blind) folded before Flop
Seat 8: PacPacBum collected (€2.50)





PokerStars Hand #151207996781:  Hold'em No Limit ($0.50/$1.00 USD) - 2016/03/31 12:47:16 CET [2016/03/31 6:47:16 ET]
Table 'Herge II' 9-max Seat #4 is the button
Seat 1: Chiapel ($103.17 in chips) 
Seat 2: DUkalisUA ($100 in chips) 
Seat 3: matiko09 ($210.27 in chips) 
Seat 4: Kreuznagel ($104.50 in chips) 
Seat 5: I The King I ($134.23 in chips) 
Seat 6: masaytoo ($93 in chips) 
Seat 7: Zeeshka ($139.45 in chips) 
Seat 8: IdiotFromNE ($100 in chips) 
Seat 9: fatstacks122 ($129.83 in chips) 
I The King I: posts small blind $0.50
masaytoo: posts big blind $1
*** HOLE CARDS ***
Dealt to matiko09 [As 7d]
Zeeshka: folds 
IdiotFromNE: folds 
fatstacks122: folds 
Chiapel: folds 
DUkalisUA: raises $2 to $3
matiko09: folds 
Kreuznagel: folds 
I The King I: folds 
masaytoo: folds 
Uncalled bet ($2) returned to DUkalisUA
DUkalisUA collected $2.50 from pot
DUkalisUA: doesn't show hand 
*** SUMMARY ***
Total pot $2.50 | Rake $0 
Seat 1: Chiapel folded before Flop (didn't bet)
Seat 2: DUkalisUA collected ($2.50)
Seat 3: matiko09 folded before Flop (didn't bet)
Seat 4: Kreuznagel (button) folded before Flop (didn't bet)
Seat 5: I The King I (small blind) folded before Flop
Seat 6: masaytoo (big blind) folded before Flop
Seat 7: Zeeshka folded before Flop (didn't bet)
Seat 8: IdiotFromNE folded before Flop (didn't bet)
Seat 9: fatstacks122 folded before Flop (didn't bet)





PokerStars Hand #151208002467:  Hold'em No Limit ($0.50/$1.00 USD) - 2016/03/31 12:47:28 CET [2016/03/31 6:47:28 ET]
Table 'Icarus III' 9-max Seat #2 is the button
Seat 2: Painkiller72 ($100 in chips) 
Seat 3: RICKA16 ($121.74 in chips) 
Seat 4: dizzyryano79 ($34.43 in chips) 
Seat 5: I The King I ($113.75 in chips) 
Seat 6: djammusic ($46.08 in chips) 
Seat 7: oscarleon ($144.82 in chips) 
Seat 8: matiko09 ($104.12 in chips) 
Seat 9: apfush ($122.46 in chips) 
RICKA16: posts small blind $0.50
dizzyryano79: posts big blind $1
*** HOLE CARDS ***
Dealt to matiko09 [Th 5h]
I The King I: folds 
djammusic: folds 
oscarleon: folds 
matiko09: folds 
apfush: folds 
Painkiller72: raises $1 to $2
RICKA16: raises $8 to $10
dizzyryano79: folds 
Painkiller72: folds 
Uncalled bet ($8) returned to RICKA16
RICKA16 collected $5 from pot
RICKA16: doesn't show hand 
*** SUMMARY ***
Total pot $5 | Rake $0 
Seat 2: Painkiller72 (button) folded before Flop
Seat 3: RICKA16 (small blind) collected ($5)
Seat 4: dizzyryano79 (big blind) folded before Flop
Seat 5: I The King I folded before Flop (didn't bet)
Seat 6: djammusic folded before Flop (didn't bet)
Seat 7: oscarleon folded before Flop (didn't bet)
Seat 8: matiko09 folded before Flop (didn't bet)
Seat 9: apfush folded before Flop (didn't bet)





PokerStars Hand #151208005633:  Hold'em No Limit ($0.50/$1.00 USD) - 2016/03/31 12:47:35 CET [2016/03/31 6:47:35 ET]
Table 'Egeria II' 9-max Seat #1 is the button
Seat 1: oscarleon ($122.53 in chips) 
Seat 2: I The King I ($180.58 in chips) 
Seat 3: Pvsx. ($117.14 in chips) 
Seat 4: matiko09 ($100 in chips) 
Seat 5: apfush ($145 in chips) 
Seat 7: Reven9er ($138.44 in chips) 
Seat 8: Kreuznagel ($135.01 in chips) 
Seat 9: miracolix50 ($69.39 in chips) 
I The King I: posts small blind $0.50
Pvsx.: posts big blind $1
DUkalisUA: sits out 
*** HOLE CARDS ***
Dealt to matiko09 [8d 3h]
matiko09: folds 
apfush: folds 
Reven9er: folds 
Kreuznagel: folds 
miracolix50: calls $1
oscarleon: folds 
I The King I: raises $4 to $5
Pvsx.: folds 
miracolix50: calls $4
*** FLOP *** [9s 3d 7h]
I The King I: bets $7
miracolix50: folds 
Uncalled bet ($7) returned to I The King I
I The King I collected $10.45 from pot
I The King I: doesn't show hand 
*** SUMMARY ***
Total pot $11 | Rake $0.55 
Board [9s 3d 7h]
Seat 1: oscarleon (button) folded before Flop (didn't bet)
Seat 2: I The King I (small blind) collected ($10.45)
Seat 3: Pvsx. (big blind) folded before Flop
Seat 4: matiko09 folded before Flop (didn't bet)
Seat 5: apfush folded before Flop (didn't bet)
Seat 7: Reven9er folded before Flop (didn't bet)
Seat 8: Kreuznagel folded before Flop (didn't bet)
Seat 9: miracolix50 folded on the Flop





PokerStars Hand #151208006909:  Hold'em No Limit (€0.50/€1.00 EUR) - 2016/03/31 12:47:37 CET [2016/03/31 6:47:37 ET]
Table 'Pioneer II' 9-max Seat #6 is the button
Seat 3: Kupumalam (€53.10 in chips) 
Seat 4: Painkiller72 (€161.26 in chips) 
Seat 5: Zeeshka (€100 in chips) 
Seat 6: matiko09 (€100 in chips) 
Seat 7: AlKatrone (€129.41 in chips) 
AlKatrone: posts small blind €0.50
PacPacBum: is sitting out 
IdiotFromNE: is sitting out 
Kupumalam: posts big blind €1
*** HOLE CARDS ***
Dealt to matiko09 [6c Ac]
Painkiller72: raises €1.50 to €2.50
Zeeshka: folds 
PacPacBum leaves the table
matiko09: folds 
AlKatrone: raises €6.50 to €9
Kupumalam: folds 
Painkiller72: calls €6.50
*** FLOP *** [Ts 9h Ah]
AlKatrone: checks 
Painkiller72: checks 
*** TURN *** [Ts 9h Ah] [3h]
PacPacBum joins the table at seat #8 
PacPacBum leaves the table
AlKatrone: checks 
Painkiller72: checks 
*** RIVER *** [Ts 9h Ah 3h] [5d]
AlKatrone: checks 
Painkiller72: checks 
*** SHOW DOWN ***
AlKatrone: shows [Qc Qs] (a pair of Queens)
Painkiller72: mucks hand 
AlKatrone collected €18.05 from pot
*** SUMMARY ***
Total pot €19 | Rake €0.95 
Board [Ts 9h Ah 3h 5d]
Seat 3: Kupumalam (big blind) folded before Flop
Seat 4: Painkiller72 mucked [Kc Tc]
Seat 5: Zeeshka folded before Flop (didn't bet)
Seat 6: matiko09 (button) folded before Flop (didn't bet)
Seat 7: AlKatrone (small blind) showed [Qc Qs] and won (€18.05) with a pair of Queens





PokerStars Hand #151208010835:  Hold'em No Limit ($0.50/$1.00 USD) - 2016/03/31 12:47:45 CET [2016/03/31 6:47:45 ET]
Table 'Herge II' 9-max Seat #5 is the button
Seat 1: Chiapel ($103.17 in chips) 
Seat 2: DUkalisUA ($101.50 in chips) 
Seat 3: matiko09 ($210.27 in chips) 
Seat 4: Kreuznagel ($104.50 in chips) 
Seat 5: I The King I ($133.73 in chips) 
Seat 6: masaytoo ($92 in chips) 
Seat 7: Zeeshka ($139.45 in chips) 
Seat 8: IdiotFromNE ($100 in chips) 
Seat 9: fatstacks122 ($129.83 in chips) 
masaytoo: posts small blind $0.50
Zeeshka: posts big blind $1
*** HOLE CARDS ***
Dealt to matiko09 [Tc 5c]
IdiotFromNE: folds 
fatstacks122: folds 
Chiapel: folds 
DUkalisUA: folds 
matiko09: folds 
Kreuznagel: folds 
I The King I: raises $1 to $2
masaytoo: folds 
Zeeshka: folds 
Uncalled bet ($1) returned to I The King I
I The King I collected $2.50 from pot
I The King I: doesn't show hand 
*** SUMMARY ***
Total pot $2.50 | Rake $0 
Seat 1: Chiapel folded before Flop (didn't bet)
Seat 2: DUkalisUA folded before Flop (didn't bet)
Seat 3: matiko09 folded before Flop (didn't bet)
Seat 4: Kreuznagel folded before Flop (didn't bet)
Seat 5: I The King I (button) collected ($2.50)
Seat 6: masaytoo (small blind) folded before Flop
Seat 7: Zeeshka (big blind) folded before Flop
Seat 8: IdiotFromNE folded before Flop (didn't bet)
Seat 9: fatstacks122 folded before Flop (didn't bet)





PokerStars Hand #151208011385:  Hold'em No Limit ($1/$2 USD) - 2016/03/31 12:47:46 CET [2016/03/31 6:47:46 ET]
Table 'Probitas' 9-max Seat #4 is the button
Seat 1: rmanjkeee ($150.04 in chips) 
Seat 3: azvazdam ($224.64 in chips) 
Seat 4: Painkiller72 ($218.21 in chips) 
Seat 5: matiko09 ($201 in chips) 
Seat 6: Kreuznagel ($451.08 in chips) 
Seat 7: coinflip_si ($298.53 in chips) 
Seat 8: BOAYARSKIY ($138.67 in chips) 
Seat 9: apfush ($312.99 in chips) 
matiko09: posts small blind $1
Kreuznagel: posts big blind $2
Avtovo: sits out 
*** HOLE CARDS ***
Dealt to matiko09 [2h 5h]
coinflip_si: folds 
BOAYARSKIY: folds 
apfush: folds 
rmanjkeee: folds 
azvazdam: raises $4 to $6
Painkiller72: folds 
matiko09: folds 
Kreuznagel: calls $4
*** FLOP *** [6h Th 2s]
Kreuznagel: checks 
azvazdam: checks 
*** TURN *** [6h Th 2s] [Ah]
Kreuznagel: checks 
azvazdam: bets $8
Kreuznagel: folds 
Uncalled bet ($8) returned to azvazdam
azvazdam collected $12.35 from pot
azvazdam: doesn't show hand 
*** SUMMARY ***
Total pot $13 | Rake $0.65 
Board [6h Th 2s Ah]
Seat 1: rmanjkeee folded before Flop (didn't bet)
Seat 3: azvazdam collected ($12.35)
Seat 4: Painkiller72 (button) folded before Flop (didn't bet)
Seat 5: matiko09 (small blind) folded before Flop
Seat 6: Kreuznagel (big blind) folded on the Turn
Seat 7: coinflip_si folded before Flop (didn't bet)
Seat 8: BOAYARSKIY folded before Flop (didn't bet)
Seat 9: apfush folded before Flop (didn't bet)





PokerStars Hand #151208015399:  Hold'em No Limit ($1/$2 USD) - 2016/03/31 12:47:54 CET [2016/03/31 6:47:54 ET]
Table 'Coelestina II' 9-max Seat #3 is the button
Seat 1: PacPacBum ($214.85 in chips) 
Seat 2: Kreuznagel ($215.05 in chips) 
Seat 3: ilaviiitech ($200 in chips) 
Seat 4: matiko09 ($200 in chips) 
Seat 5: Painkiller72 ($203 in chips) 
Seat 6: Avtovo ($238.07 in chips) 
Seat 7: rmanjkeee ($80 in chips) 
Seat 8: DUkalisUA ($232.31 in chips) 
Seat 9: fonng ($191.45 in chips) 
matiko09: posts small blind $1
Painkiller72: posts big blind $2
*** HOLE CARDS ***
Dealt to matiko09 [3s 4c]
Avtovo: folds 
rmanjkeee: folds 
DUkalisUA: folds 
fonng: calls $2
PacPacBum: folds 
Kreuznagel: raises $7 to $9
ilaviiitech: folds 
matiko09: folds 
Painkiller72: folds 
fonng: folds 
Uncalled bet ($7) returned to Kreuznagel
Kreuznagel collected $7 from pot
Kreuznagel: doesn't show hand 
*** SUMMARY ***
Total pot $7 | Rake $0 
Seat 1: PacPacBum folded before Flop (didn't bet)
Seat 2: Kreuznagel collected ($7)
Seat 3: ilaviiitech (button) folded before Flop (didn't bet)
Seat 4: matiko09 (small blind) folded before Flop
Seat 5: Painkiller72 (big blind) folded before Flop
Seat 6: Avtovo folded before Flop (didn't bet)
Seat 7: rmanjkeee folded before Flop (didn't bet)
Seat 8: DUkalisUA folded before Flop (didn't bet)
Seat 9: fonng folded before Flop





PokerStars Hand #151208020153:  Hold'em No Limit ($0.50/$1.00 USD) - 2016/03/31 12:48:04 CET [2016/03/31 6:48:04 ET]
Table 'Aquila' 9-max Seat #5 is the button
Seat 1: BOAYARSKIY ($51.20 in chips) 
Seat 2: Avtovo ($100 in chips) 
Seat 5: adelfaz ($71.18 in chips) 
Seat 7: PacPacBum ($128.20 in chips) 
Seat 8: matiko09 ($146.94 in chips) 
Seat 9: apfush ($100 in chips) 
PacPacBum: posts small blind $0.50
matiko09: posts big blind $1
BOAYARSKIY: posts the ante $0.20
Avtovo: posts the ante $0.20
adelfaz: posts the ante $0.20
PacPacBum: posts the ante $0.20
matiko09: posts the ante $0.20
apfush: posts the ante $0.20
*** HOLE CARDS ***
Dealt to matiko09 [6c Jc]
apfush: folds 
laco121 leaves the table
BOAYARSKIY: folds 
Avtovo: folds 
adelfaz: folds 
PacPacBum: raises $1.50 to $2.50
matiko09: raises $6.50 to $9
PacPacBum: folds 
Uncalled bet ($6.50) returned to matiko09
matiko09 collected $6.20 from pot
matiko09: doesn't show hand 
*** SUMMARY ***
Total pot $6.20 | Rake $0 
Seat 1: BOAYARSKIY folded before Flop (didn't bet)
Seat 2: Avtovo folded before Flop (didn't bet)
Seat 5: adelfaz (button) folded before Flop (didn't bet)
Seat 7: PacPacBum (small blind) folded before Flop
Seat 8: matiko09 (big blind) collected ($6.20)
Seat 9: apfush folded before Flop (didn't bet)





PokerStars Hand #151208022827:  Hold'em No Limit ($0.50/$1.00 USD) - 2016/03/31 12:48:10 CET [2016/03/31 6:48:10 ET]
Table 'Miriam' 9-max Seat #7 is the button
Seat 1: matiko09 ($100 in chips) 
Seat 2: ka100pka527 ($52.42 in chips) 
Seat 3: IdiotFromNE ($109.21 in chips) 
Seat 4: oscarleon ($144.53 in chips) 
Seat 5: Sutt_420 ($49.02 in chips) 
Seat 7: Zeeshka ($168.21 in chips) 
Seat 8: nobu-azabu ($133.05 in chips) 
nobu-azabu: posts small blind $0.50
matiko09: posts big blind $1
*** HOLE CARDS ***
Dealt to matiko09 [2c 2s]
ka100pka527: folds 
IdiotFromNE: folds 
oscarleon: folds 
Sutt_420: folds 
Zeeshka: raises $1.50 to $2.50
nobu-azabu: calls $2
matiko09: calls $1.50
*** FLOP *** [5d 6d Tc]
nobu-azabu: checks 
matiko09: checks 
Zeeshka: checks 
*** TURN *** [5d 6d Tc] [As]
nobu-azabu: checks 
matiko09: checks 
Zeeshka: checks 
*** RIVER *** [5d 6d Tc As] [Ac]
nobu-azabu: checks 
matiko09: checks 
Zeeshka: checks 
*** SHOW DOWN ***
nobu-azabu: shows [Js 9h] (a pair of Aces)
matiko09: shows [2c 2s] (two pair, Aces and Deuces)
Zeeshka: mucks hand 
matiko09 collected $7.12 from pot
*** SUMMARY ***
Total pot $7.50 | Rake $0.38 
Board [5d 6d Tc As Ac]
Seat 1: matiko09 (big blind) showed [2c 2s] and won ($7.12) with two pair, Aces and Deuces
Seat 2: ka100pka527 folded before Flop (didn't bet)
Seat 3: IdiotFromNE folded before Flop (didn't bet)
Seat 4: oscarleon folded before Flop (didn't bet)
Seat 5: Sutt_420 folded before Flop (didn't bet)
Seat 7: Zeeshka (button) mucked [Qh 9c]
Seat 8: nobu-azabu (small blind) showed [Js 9h] and lost with a pair of Aces





PokerStars Hand #151208025007:  Hold'em No Limit ($0.50/$1.00 USD) - 2016/03/31 12:48:14 CET [2016/03/31 6:48:14 ET]
Table 'Yazhi' 9-max Seat #4 is the button
Seat 1: matiko09 ($100 in chips) 
Seat 2: xHourglass ($108.76 in chips) 
Seat 4: apfush ($190.58 in chips) 
Seat 5: IdiotFromNE ($101.50 in chips) 
Seat 6: Reven9er ($224.49 in chips) 
Seat 7: Avtovo ($100 in chips) 
Seat 8: pk4DW ($49.11 in chips) 
Seat 9: oscarleon ($197.73 in chips) 
IdiotFromNE: posts small blind $0.50
Reven9er: posts big blind $1
*** HOLE CARDS ***
Dealt to matiko09 [2h 6d]
Avtovo: folds 
pk4DW: calls $1
oscarleon: folds 
matiko09: folds 
xHourglass: raises $2 to $3
apfush: calls $3
IdiotFromNE: folds 
Reven9er: folds 
pk4DW: calls $2
*** FLOP *** [3d 9h Tc]
pk4DW: checks 
xHourglass: bets $6
apfush: calls $6
pk4DW: folds 
*** TURN *** [3d 9h Tc] [5c]
xHourglass: bets $17.75
apfush: calls $17.75
*** RIVER *** [3d 9h Tc 5c] [5s]
xHourglass: bets $42
apfush: folds 
Uncalled bet ($42) returned to xHourglass
xHourglass collected $55.50 from pot
xHourglass: doesn't show hand 
*** SUMMARY ***
Total pot $58 | Rake $2.50 
Board [3d 9h Tc 5c 5s]
Seat 1: matiko09 folded before Flop (didn't bet)
Seat 2: xHourglass collected ($55.50)
Seat 4: apfush (button) folded on the River
Seat 5: IdiotFromNE (small blind) folded before Flop
Seat 6: Reven9er (big blind) folded before Flop
Seat 7: Avtovo folded before Flop (didn't bet)
Seat 8: pk4DW folded on the Flop
Seat 9: oscarleon folded before Flop (didn't bet)





PokerStars Hand #151208028478:  Hold'em No Limit ($0.50/$1.00 USD) - 2016/03/31 12:48:21 CET [2016/03/31 6:48:21 ET]
Table 'Haworth II' 9-max Seat #9 is the button
Seat 2: AlKatrone ($129.58 in chips) 
Seat 3: matiko09 ($100 in chips) 
Seat 4: I The King I ($116.02 in chips) 
Seat 5: Kreuznagel ($101.60 in chips) 
Seat 6: Pvsx. ($100 in chips) 
Seat 7: mheris ($138.74 in chips) 
Seat 8: oscarleon ($100 in chips) 
Seat 9: Zeeshka ($100 in chips) 
AlKatrone: posts small blind $0.50
matiko09: posts big blind $1
*** HOLE CARDS ***
Dealt to matiko09 [5s 6c]
I The King I: folds 
Kreuznagel: folds 
Pvsx.: raises $1.50 to $2.50
mheris: folds 
oscarleon: folds 
Zeeshka: calls $2.50
AlKatrone: calls $2
matiko09: folds 
*** FLOP *** [4c 5d Ac]
AlKatrone: checks 
Pvsx.: bets $4.04
Zeeshka: calls $4.04
AlKatrone: calls $4.04
*** TURN *** [4c 5d Ac] [Qh]
AlKatrone: checks 
Pvsx.: checks 
Zeeshka: checks 
*** RIVER *** [4c 5d Ac Qh] [8s]
AlKatrone: checks 
Pvsx.: checks 
Zeeshka: checks 
*** SHOW DOWN ***
AlKatrone: shows [Tc Qc] (a pair of Queens)
Pvsx.: mucks hand 
Zeeshka: mucks hand 
AlKatrone collected $19.59 from pot
*** SUMMARY ***
Total pot $20.62 | Rake $1.03 
Board [4c 5d Ac Qh 8s]
Seat 2: AlKatrone (small blind) showed [Tc Qc] and won ($19.59) with a pair of Queens
Seat 3: matiko09 (big blind) folded before Flop
Seat 4: I The King I folded before Flop (didn't bet)
Seat 5: Kreuznagel folded before Flop (didn't bet)
Seat 6: Pvsx. mucked [6d 8d]
Seat 7: mheris folded before Flop (didn't bet)
Seat 8: oscarleon folded before Flop (didn't bet)
Seat 9: Zeeshka (button) mucked [9d 9h]





PokerStars Hand #151208030552:  Hold'em No Limit ($0.50/$1.00 USD) - 2016/03/31 12:48:25 CET [2016/03/31 6:48:25 ET]
Table 'Herge II' 9-max Seat #6 is the button
Seat 1: Chiapel ($103.17 in chips) 
Seat 2: DUkalisUA ($101.50 in chips) 
Seat 3: matiko09 ($210.27 in chips) 
Seat 4: Kreuznagel ($104.50 in chips) 
Seat 5: I The King I ($135.23 in chips) 
Seat 6: masaytoo ($91.50 in chips) 
Seat 7: Zeeshka ($138.45 in chips) 
Seat 8: IdiotFromNE ($100 in chips) 
Seat 9: fatstacks122 ($129.83 in chips) 
Zeeshka: posts small blind $0.50
IdiotFromNE: posts big blind $1
*** HOLE CARDS ***
Dealt to matiko09 [2h 5s]
fatstacks122: raises $2 to $3
Chiapel: calls $3
DUkalisUA: folds 
matiko09: folds 
Kreuznagel: calls $3
I The King I: folds 
masaytoo: folds 
Zeeshka: folds 
IdiotFromNE: folds 
*** FLOP *** [Qs 2c 8h]
fatstacks122: checks 
Chiapel: checks 
Kreuznagel: checks 
*** TURN *** [Qs 2c 8h] [9c]
fatstacks122: bets $3.75
Chiapel: calls $3.75
Kreuznagel: folds 
*** RIVER *** [Qs 2c 8h 9c] [5h]
fatstacks122: bets $6.75
Chiapel: raises $6.75 to $13.50
fatstacks122: calls $6.75
*** SHOW DOWN ***
Chiapel: shows [Qd 2d] (two pair, Queens and Deuces)
fatstacks122: shows [8c 8s] (three of a kind, Eights)
fatstacks122 collected $42.75 from pot
*** SUMMARY ***
Total pot $45 | Rake $2.25 
Board [Qs 2c 8h 9c 5h]
Seat 1: Chiapel showed [Qd 2d] and lost with two pair, Queens and Deuces
Seat 2: DUkalisUA folded before Flop (didn't bet)
Seat 3: matiko09 folded before Flop (didn't bet)
Seat 4: Kreuznagel folded on the Turn
Seat 5: I The King I folded before Flop (didn't bet)
Seat 6: masaytoo (button) folded before Flop (didn't bet)
Seat 7: Zeeshka (small blind) folded before Flop
Seat 8: IdiotFromNE (big blind) folded before Flop
Seat 9: fatstacks122 showed [8c 8s] and won ($42.75) with three of a kind, Eights





PokerStars Hand #151208032490:  Hold'em No Limit ($1/$2 USD) - 2016/03/31 12:48:29 CET [2016/03/31 6:48:29 ET]
Table 'Coelestina II' 9-max Seat #4 is the button
Seat 1: PacPacBum ($214.85 in chips) 
Seat 2: Kreuznagel ($220.05 in chips) 
Seat 3: ilaviiitech ($200 in chips) 
Seat 4: matiko09 ($200 in chips) 
Seat 5: Painkiller72 ($201 in chips) 
Seat 6: Avtovo ($238.07 in chips) 
Seat 7: rmanjkeee ($80 in chips) 
Seat 8: DUkalisUA ($232.31 in chips) 
Seat 9: fonng ($189.45 in chips) 
Painkiller72: posts small blind $1
Avtovo: posts big blind $2
*** HOLE CARDS ***
Dealt to matiko09 [Qc Ah]
rmanjkeee: folds 
DUkalisUA: folds 
fonng has timed out
fonng: folds 
PacPacBum: raises $2.08 to $4.08
Kreuznagel: folds 
ilaviiitech: folds 
matiko09: calls $4.08
Painkiller72: folds 
Avtovo: folds 
*** FLOP *** [7c 4c 7d]
PacPacBum: checks 
matiko09: checks 
*** TURN *** [7c 4c 7d] [3h]
PacPacBum: checks 
matiko09: checks 
*** RIVER *** [7c 4c 7d 3h] [Ac]
PacPacBum: bets $5.72
matiko09: calls $5.72
*** SHOW DOWN ***
PacPacBum: shows [Jd Ad] (two pair, Aces and Sevens)
matiko09: shows [Qc Ah] (two pair, Aces and Sevens - Queen kicker)
matiko09 collected $21.47 from pot
*** SUMMARY ***
Total pot $22.60 | Rake $1.13 
Board [7c 4c 7d 3h Ac]
Seat 1: PacPacBum showed [Jd Ad] and lost with two pair, Aces and Sevens
Seat 2: Kreuznagel folded before Flop (didn't bet)
Seat 3: ilaviiitech folded before Flop (didn't bet)
Seat 4: matiko09 (button) showed [Qc Ah] and won ($21.47) with two pair, Aces and Sevens
Seat 5: Painkiller72 (small blind) folded before Flop
Seat 6: Avtovo (big blind) folded before Flop
Seat 7: rmanjkeee folded before Flop (didn't bet)
Seat 8: DUkalisUA folded before Flop (didn't bet)
Seat 9: fonng folded before Flop (didn't bet)





PokerStars Hand #151208037784:  Hold'em No Limit ($0.50/$1.00 USD) - 2016/03/31 12:48:40 CET [2016/03/31 6:48:40 ET]
Table 'Icarus III' 9-max Seat #3 is the button
Seat 2: Painkiller72 ($100 in chips) 
Seat 3: RICKA16 ($124.74 in chips) 
Seat 4: dizzyryano79 ($33.43 in chips) 
Seat 5: I The King I ($113.75 in chips) 
Seat 6: djammusic ($46.08 in chips) 
Seat 7: oscarleon ($144.82 in chips) 
Seat 8: matiko09 ($104.12 in chips) 
Seat 9: apfush ($122.46 in chips) 
dizzyryano79: posts small blind $0.50
I The King I: posts big blind $1
*** HOLE CARDS ***
Dealt to matiko09 [5h 2s]
djammusic: folds 
oscarleon: folds 
matiko09: folds 
apfush: folds 
Painkiller72: folds 
RICKA16: folds 
dizzyryano79: calls $0.50
I The King I: raises $3 to $4
dizzyryano79: calls $3
*** FLOP *** [2d Qc Jh]
dizzyryano79: bets $7
I The King I: folds 
Uncalled bet ($7) returned to dizzyryano79
dizzyryano79 collected $7.60 from pot
dizzyryano79: doesn't show hand 
*** SUMMARY ***
Total pot $8 | Rake $0.40 
Board [2d Qc Jh]
Seat 2: Painkiller72 folded before Flop (didn't bet)
Seat 3: RICKA16 (button) folded before Flop (didn't bet)
Seat 4: dizzyryano79 (small blind) collected ($7.60)
Seat 5: I The King I (big blind) folded on the Flop
Seat 6: djammusic folded before Flop (didn't bet)
Seat 7: oscarleon folded before Flop (didn't bet)
Seat 8: matiko09 folded before Flop (didn't bet)
Seat 9: apfush folded before Flop (didn't bet)





PokerStars Hand #151208042215:  Hold'em No Limit ($0.50/$1.00 USD) - 2016/03/31 12:48:50 CET [2016/03/31 6:48:50 ET]
Table 'Egeria II' 9-max Seat #2 is the button
Seat 1: oscarleon ($122.53 in chips) 
Seat 2: I The King I ($186.03 in chips) 
Seat 3: Pvsx. ($116.14 in chips) 
Seat 4: matiko09 ($100 in chips) 
Seat 5: apfush ($145 in chips) 
Seat 7: Reven9er ($138.44 in chips) 
Seat 8: Kreuznagel ($135.01 in chips) 
Seat 9: miracolix50 ($64.39 in chips) 
Pvsx.: posts small blind $0.50
matiko09: posts big blind $1
DUkalisUA: sits out 
*** HOLE CARDS ***
Dealt to matiko09 [7d Qc]
apfush: folds 
Reven9er: raises $1 to $2
Kreuznagel: folds 
miracolix50: calls $2
oscarleon: folds 
I The King I: folds 
Pvsx.: folds 
matiko09: folds 
*** FLOP *** [5h 2h Ts]
Reven9er: checks 
miracolix50: bets $5.22
Reven9er: calls $5.22
*** TURN *** [5h 2h Ts] [Qd]
Reven9er: checks 
miracolix50: checks 
*** RIVER *** [5h 2h Ts Qd] [Js]
Reven9er: bets $9
miracolix50: calls $9
*** SHOW DOWN ***
Reven9er: shows [2c 2s] (three of a kind, Deuces)
miracolix50: mucks hand 
Reven9er collected $32.24 from pot
*** SUMMARY ***
Total pot $33.94 | Rake $1.70 
Board [5h 2h Ts Qd Js]
Seat 1: oscarleon folded before Flop (didn't bet)
Seat 2: I The King I (button) folded before Flop (didn't bet)
Seat 3: Pvsx. (small blind) folded before Flop
Seat 4: matiko09 (big blind) folded before Flop
Seat 5: apfush folded before Flop (didn't bet)
Seat 7: Reven9er showed [2c 2s] and won ($32.24) with three of a kind, Deuces
Seat 8: Kreuznagel folded before Flop (didn't bet)
Seat 9: miracolix50 mucked [Kd Tc]





PokerStars Hand #151208045265:  Hold'em No Limit ($0.50/$1.00 USD) - 2016/03/31 12:48:56 CET [2016/03/31 6:48:56 ET]
Table 'Aquila' 9-max Seat #7 is the button
Seat 1: BOAYARSKIY ($51 in chips) 
Seat 2: Avtovo ($100 in chips) 
Seat 5: adelfaz ($70.98 in chips) 
Seat 7: PacPacBum ($125.50 in chips) 
Seat 8: matiko09 ($150.44 in chips) 
Seat 9: apfush ($100 in chips) 
matiko09: posts small blind $0.50
apfush: posts big blind $1
BOAYARSKIY: posts the ante $0.20
Avtovo: posts the ante $0.20
adelfaz: posts the ante $0.20
PacPacBum: posts the ante $0.20
matiko09: posts the ante $0.20
apfush: posts the ante $0.20
*** HOLE CARDS ***
Dealt to matiko09 [8h Ad]
Kreuznagel joins the table at seat #3 
BOAYARSKIY: folds 
Avtovo: folds 
adelfaz: raises $2 to $3
PacPacBum: folds 
matiko09: folds 
apfush: folds 
Uncalled bet ($2) returned to adelfaz
adelfaz collected $3.70 from pot
*** SUMMARY ***
Total pot $3.70 | Rake $0 
Seat 1: BOAYARSKIY folded before Flop (didn't bet)
Seat 2: Avtovo folded before Flop (didn't bet)
Seat 5: adelfaz collected ($3.70)
Seat 7: PacPacBum (button) folded before Flop (didn't bet)
Seat 8: matiko09 (small blind) folded before Flop
Seat 9: apfush (big blind) folded before Flop





PokerStars Hand #151208051608:  Hold'em No Limit ($0.50/$1.00 USD) - 2016/03/31 12:49:09 CET [2016/03/31 6:49:09 ET]
Table 'Miriam' 9-max Seat #8 is the button
Seat 1: matiko09 ($104.62 in chips) 
Seat 2: ka100pka527 ($52.42 in chips) 
Seat 3: IdiotFromNE ($109.21 in chips) 
Seat 4: oscarleon ($144.53 in chips) 
Seat 5: Sutt_420 ($49.02 in chips) 
Seat 7: Zeeshka ($165.71 in chips) 
Seat 8: nobu-azabu ($130.55 in chips) 
matiko09: posts small blind $0.50
ka100pka527: posts big blind $1
*** HOLE CARDS ***
Dealt to matiko09 [Qs 5c]
IdiotFromNE: folds 
oscarleon: folds 
Sutt_420: folds 
Zeeshka: folds 
nobu-azabu: raises $2 to $3
matiko09: folds 
ka100pka527: folds 
Uncalled bet ($2) returned to nobu-azabu
nobu-azabu collected $2.50 from pot
*** SUMMARY ***
Total pot $2.50 | Rake $0 
Seat 1: matiko09 (small blind) folded before Flop
Seat 2: ka100pka527 (big blind) folded before Flop
Seat 3: IdiotFromNE folded before Flop (didn't bet)
Seat 4: oscarleon folded before Flop (didn't bet)
Seat 5: Sutt_420 folded before Flop (didn't bet)
Seat 7: Zeeshka folded before Flop (didn't bet)
Seat 8: nobu-azabu (button) collected ($2.50)





PokerStars Hand #151208057154:  Hold'em No Limit ($1/$2 USD) - 2016/03/31 12:49:20 CET [2016/03/31 6:49:20 ET]
Table 'Probitas' 9-max Seat #5 is the button
Seat 1: rmanjkeee ($150.04 in chips) 
Seat 3: azvazdam ($230.99 in chips) 
Seat 4: Painkiller72 ($218.21 in chips) 
Seat 5: matiko09 ($200 in chips) 
Seat 6: Kreuznagel ($445.08 in chips) 
Seat 7: coinflip_si ($298.53 in chips) 
Seat 8: BOAYARSKIY ($138.67 in chips) 
Seat 9: apfush ($312.99 in chips) 
Kreuznagel: posts small blind $1
coinflip_si: posts big blind $2
Avtovo: sits out 
*** HOLE CARDS ***
Dealt to matiko09 [7s Tc]
BOAYARSKIY: folds 
apfush: raises $4 to $6
rmanjkeee: calls $6
azvazdam: folds 
Painkiller72: folds 
matiko09: folds 
Kreuznagel: folds 
coinflip_si: folds 
*** FLOP *** [Qc 2d Jd]
apfush: checks 
rmanjkeee: bets $10
apfush: folds 
Uncalled bet ($10) returned to rmanjkeee
rmanjkeee collected $14.25 from pot
rmanjkeee: doesn't show hand 
*** SUMMARY ***
Total pot $15 | Rake $0.75 
Board [Qc 2d Jd]
Seat 1: rmanjkeee collected ($14.25)
Seat 3: azvazdam folded before Flop (didn't bet)
Seat 4: Painkiller72 folded before Flop (didn't bet)
Seat 5: matiko09 (button) folded before Flop (didn't bet)
Seat 6: Kreuznagel (small blind) folded before Flop
Seat 7: coinflip_si (big blind) folded before Flop
Seat 8: BOAYARSKIY folded before Flop (didn't bet)
Seat 9: apfush folded on the Flop





PokerStars Hand #151208059295:  Hold'em No Limit ($0.50/$1.00 USD) - 2016/03/31 12:49:24 CET [2016/03/31 6:49:24 ET]
Table 'Icarus III' 9-max Seat #4 is the button
Seat 2: Painkiller72 ($100 in chips) 
Seat 3: RICKA16 ($124.74 in chips) 
Seat 4: dizzyryano79 ($37.03 in chips) 
Seat 5: I The King I ($109.75 in chips) 
Seat 6: djammusic ($46.08 in chips) 
Seat 7: oscarleon ($144.82 in chips) 
Seat 8: matiko09 ($104.12 in chips) 
Seat 9: apfush ($122.46 in chips) 
I The King I: posts small blind $0.50
djammusic: posts big blind $1
*** HOLE CARDS ***
Dealt to matiko09 [Ts 8s]
oscarleon: folds 
matiko09: folds 
apfush: folds 
Painkiller72: folds 
RICKA16: folds 
dizzyryano79: folds 
I The King I: folds 
Uncalled bet ($0.50) returned to djammusic
djammusic collected $1 from pot
djammusic: doesn't show hand 
*** SUMMARY ***
Total pot $1 | Rake $0 
Seat 2: Painkiller72 folded before Flop (didn't bet)
Seat 3: RICKA16 folded before Flop (didn't bet)
Seat 4: dizzyryano79 (button) folded before Flop (didn't bet)
Seat 5: I The King I (small blind) folded before Flop
Seat 6: djammusic (big blind) collected ($1)
Seat 7: oscarleon folded before Flop (didn't bet)
Seat 8: matiko09 folded before Flop (didn't bet)
Seat 9: apfush folded before Flop (didn't bet)





PokerStars Hand #151208060005:  Hold'em No Limit (€0.50/€1.00 EUR) - 2016/03/31 12:49:26 CET [2016/03/31 6:49:26 ET]
Table 'Pioneer II' 9-max Seat #7 is the button
Seat 3: Kupumalam (€52.10 in chips) 
Seat 4: Painkiller72 (€152.26 in chips) 
Seat 5: Zeeshka (€100 in chips) 
Seat 6: matiko09 (€100 in chips) 
Seat 7: AlKatrone (€138.46 in chips) 
IdiotFromNE will be allowed to play after the button
Kupumalam: posts small blind €0.50
Painkiller72: posts big blind €1
*** HOLE CARDS ***
Dealt to matiko09 [Qh 6c]
Zeeshka: folds 
matiko09: folds 
AlKatrone: folds 
Kupumalam: raises €2 to €3
Painkiller72: folds 
Uncalled bet (€2) returned to Kupumalam
Kupumalam collected €2 from pot
*** SUMMARY ***
Total pot €2 | Rake €0 
Seat 3: Kupumalam (small blind) collected (€2)
Seat 4: Painkiller72 (big blind) folded before Flop
Seat 5: Zeeshka folded before Flop (didn't bet)
Seat 6: matiko09 folded before Flop (didn't bet)
Seat 7: AlKatrone (button) folded before Flop (didn't bet)





PokerStars Hand #151208063755:  Hold'em No Limit ($0.50/$1.00 USD) - 2016/03/31 12:49:34 CET [2016/03/31 6:49:34 ET]
Table 'Miriam' 9-max Seat #1 is the button
Seat 1: matiko09 ($104.12 in chips) 
Seat 2: ka100pka527 ($51.42 in chips) 
Seat 3: IdiotFromNE ($109.21 in chips) 
Seat 4: oscarleon ($144.53 in chips) 
Seat 5: Sutt_420 ($49.02 in chips) 
Seat 7: Zeeshka ($165.71 in chips) 
Seat 8: nobu-azabu ($132.05 in chips) 
ka100pka527: posts small blind $0.50
IdiotFromNE: posts big blind $1
*** HOLE CARDS ***
Dealt to matiko09 [Ah Js]
oscarleon: folds 
Sutt_420: folds 
Zeeshka: raises $2 to $3
nobu-azabu has timed out
nobu-azabu: folds 
matiko09: folds 
ka100pka527: folds 
IdiotFromNE: folds 
Uncalled bet ($2) returned to Zeeshka
Zeeshka collected $2.50 from pot
Zeeshka: doesn't show hand 
*** SUMMARY ***
Total pot $2.50 | Rake $0 
Seat 1: matiko09 (button) folded before Flop (didn't bet)
Seat 2: ka100pka527 (small blind) folded before Flop
Seat 3: IdiotFromNE (big blind) folded before Flop
Seat 4: oscarleon folded before Flop (didn't bet)
Seat 5: Sutt_420 folded before Flop (didn't bet)
Seat 7: Zeeshka collected ($2.50)
Seat 8: nobu-azabu folded before Flop (didn't bet)





PokerStars Hand #151208067032:  Hold'em No Limit ($0.50/$1.00 USD) - 2016/03/31 12:49:40 CET [2016/03/31 6:49:40 ET]
Table 'Aquila' 9-max Seat #8 is the button
Seat 1: BOAYARSKIY ($50.80 in chips) 
Seat 2: Avtovo ($100 in chips) 
Seat 5: adelfaz ($73.48 in chips) 
Seat 7: PacPacBum ($125.30 in chips) 
Seat 8: matiko09 ($149.74 in chips) 
Seat 9: apfush ($100 in chips) 
apfush: posts small blind $0.50
BOAYARSKIY: posts big blind $1
Kreuznagel: sits out 
BOAYARSKIY: posts the ante $0.20
Avtovo: posts the ante $0.20
adelfaz: posts the ante $0.20
PacPacBum: posts the ante $0.20
matiko09: posts the ante $0.20
apfush: posts the ante $0.20
*** HOLE CARDS ***
Dealt to matiko09 [7d Qs]
Avtovo: folds 
adelfaz: raises $1 to $2
PacPacBum: raises $6 to $8
matiko09: folds 
apfush: raises $11 to $19
BOAYARSKIY: folds 
adelfaz: folds 
PacPacBum: folds 
Uncalled bet ($11) returned to apfush
apfush collected $20.20 from pot
apfush: doesn't show hand 
*** SUMMARY ***
Total pot $20.20 | Rake $0 
Seat 1: BOAYARSKIY (big blind) folded before Flop
Seat 2: Avtovo folded before Flop (didn't bet)
Seat 5: adelfaz folded before Flop
Seat 7: PacPacBum folded before Flop
Seat 8: matiko09 (button) folded before Flop (didn't bet)
Seat 9: apfush (small blind) collected ($20.20)





PokerStars Hand #151208072696:  Hold'em No Limit ($0.50/$1.00 USD) - 2016/03/31 12:49:52 CET [2016/03/31 6:49:52 ET]
Table 'Icarus III' 9-max Seat #5 is the button
Seat 2: Painkiller72 ($100 in chips) 
Seat 3: RICKA16 ($124.74 in chips) 
Seat 4: dizzyryano79 ($37.03 in chips) 
Seat 5: I The King I ($109.25 in chips) 
Seat 6: djammusic ($46.58 in chips) 
Seat 7: oscarleon ($144.82 in chips) 
Seat 8: matiko09 ($104.12 in chips) 
Seat 9: apfush ($122.46 in chips) 
djammusic: posts small blind $0.50
oscarleon: posts big blind $1
*** HOLE CARDS ***
Dealt to matiko09 [Qh 3s]
matiko09: folds 
apfush: folds 
Painkiller72: folds 
RICKA16: folds 
dizzyryano79: calls $1
I The King I: folds 
djammusic: folds 
oscarleon: checks 
*** FLOP *** [Kh 6h Jh]
oscarleon: checks 
dizzyryano79: bets $1.19
oscarleon: folds 
Uncalled bet ($1.19) returned to dizzyryano79
dizzyryano79 collected $2.38 from pot
dizzyryano79: doesn't show hand 
*** SUMMARY ***
Total pot $2.50 | Rake $0.12 
Board [Kh 6h Jh]
Seat 2: Painkiller72 folded before Flop (didn't bet)
Seat 3: RICKA16 folded before Flop (didn't bet)
Seat 4: dizzyryano79 collected ($2.38)
Seat 5: I The King I (button) folded before Flop (didn't bet)
Seat 6: djammusic (small blind) folded before Flop
Seat 7: oscarleon (big blind) folded on the Flop
Seat 8: matiko09 folded before Flop (didn't bet)
Seat 9: apfush folded before Flop (didn't bet)





PokerStars Hand #151208078607:  Hold'em No Limit (€0.50/€1.00 EUR) - 2016/03/31 12:50:04 CET [2016/03/31 6:50:04 ET]
Table 'Pioneer II' 9-max Seat #3 is the button
Seat 3: Kupumalam (€53.10 in chips) 
Seat 4: Painkiller72 (€151.26 in chips) 
Seat 6: matiko09 (€100 in chips) 
Seat 7: AlKatrone (€138.46 in chips) 
Painkiller72: posts small blind €0.50
Zeeshka: is sitting out 
Zeeshka leaves the table
matiko09: posts big blind €1
IdiotFromNE: sits out 
*** HOLE CARDS ***
Dealt to matiko09 [5c Kd]
AlKatrone: folds 
Kupumalam: folds 
Painkiller72: folds 
Uncalled bet (€0.50) returned to matiko09
matiko09 collected €1 from pot
matiko09: doesn't show hand 
*** SUMMARY ***
Total pot €1 | Rake €0 
Seat 3: Kupumalam (button) folded before Flop (didn't bet)
Seat 4: Painkiller72 (small blind) folded before Flop
Seat 6: matiko09 (big blind) collected (€1)
Seat 7: AlKatrone folded before Flop (didn't bet)





PokerStars Hand #151208083771:  Hold'em No Limit (€0.50/€1.00 EUR) - 2016/03/31 12:50:15 CET [2016/03/31 6:50:15 ET]
Table 'Pioneer II' 9-max Seat #4 is the button
Seat 3: Kupumalam (€53.10 in chips) 
Seat 4: Painkiller72 (€150.76 in chips) 
Seat 6: matiko09 (€100.50 in chips) 
Seat 7: AlKatrone (€138.46 in chips) 
matiko09: posts small blind €0.50
AlKatrone: posts big blind €1
IdiotFromNE: sits out 
*** HOLE CARDS ***
Dealt to matiko09 [9d Ad]
PacPacBum joins the table at seat #5 
maxxmeister joins the table at seat #1 
Kupumalam has timed out
Kupumalam: folds 
Painkiller72: folds 
matiko09: raises €1.50 to €2.50
AlKatrone: calls €1.50
*** FLOP *** [Jd 4d 5s]
matiko09: bets €3.09
AlKatrone: calls €3.09
*** TURN *** [Jd 4d 5s] [4h]
matiko09: checks 
AlKatrone: checks 
*** RIVER *** [Jd 4d 5s 4h] [Td]
matiko09: bets €8
AlKatrone: folds 
Uncalled bet (€8) returned to matiko09
matiko09 collected €10.62 from pot
matiko09: doesn't show hand 
*** SUMMARY ***
Total pot €11.18 | Rake €0.56 
Board [Jd 4d 5s 4h Td]
Seat 3: Kupumalam folded before Flop (didn't bet)
Seat 4: Painkiller72 (button) folded before Flop (didn't bet)
Seat 6: matiko09 (small blind) collected (€10.62)
Seat 7: AlKatrone (big blind) folded on the River





PokerStars Hand #151208085498:  Hold'em No Limit ($1/$2 USD) - 2016/03/31 12:50:18 CET [2016/03/31 6:50:18 ET]
Table 'Coelestina II' 9-max Seat #5 is the button
Seat 1: PacPacBum ($205.05 in chips) 
Seat 2: Kreuznagel ($220.05 in chips) 
Seat 3: ilaviiitech ($200 in chips) 
Seat 4: matiko09 ($211.67 in chips) 
Seat 5: Painkiller72 ($200 in chips) 
Seat 6: Avtovo ($236.07 in chips) 
Seat 7: rmanjkeee ($80 in chips) 
Seat 8: DUkalisUA ($232.31 in chips) 
Seat 9: fonng ($189.45 in chips) 
Avtovo: posts small blind $1
rmanjkeee: posts big blind $2
*** HOLE CARDS ***
Dealt to matiko09 [2h 9d]
DUkalisUA: folds 
fonng: folds 
PacPacBum: folds 
Kreuznagel: raises $2.78 to $4.78
ilaviiitech: folds 
matiko09: folds 
Painkiller72: folds 
Avtovo: folds 
rmanjkeee: folds 
Uncalled bet ($2.78) returned to Kreuznagel
Kreuznagel collected $5 from pot
Kreuznagel: doesn't show hand 
*** SUMMARY ***
Total pot $5 | Rake $0 
Seat 1: PacPacBum folded before Flop (didn't bet)
Seat 2: Kreuznagel collected ($5)
Seat 3: ilaviiitech folded before Flop (didn't bet)
Seat 4: matiko09 folded before Flop (didn't bet)
Seat 5: Painkiller72 (button) folded before Flop (didn't bet)
Seat 6: Avtovo (small blind) folded before Flop
Seat 7: rmanjkeee (big blind) folded before Flop
Seat 8: DUkalisUA folded before Flop (didn't bet)
Seat 9: fonng folded before Flop (didn't bet)





PokerStars Hand #151208085862:  Hold'em No Limit ($0.50/$1.00 USD) - 2016/03/31 12:50:19 CET [2016/03/31 6:50:19 ET]
Table 'Egeria II' 9-max Seat #3 is the button
Seat 1: oscarleon ($122.53 in chips) 
Seat 2: I The King I ($186.03 in chips) 
Seat 3: Pvsx. ($115.64 in chips) 
Seat 4: matiko09 ($100 in chips) 
Seat 5: apfush ($145 in chips) 
Seat 7: Reven9er ($154.46 in chips) 
Seat 8: Kreuznagel ($135.01 in chips) 
Seat 9: miracolix50 ($48.17 in chips) 
matiko09: posts small blind $0.50
apfush: posts big blind $1
DUkalisUA: sits out 
*** HOLE CARDS ***
Dealt to matiko09 [9c 5d]
Reven9er: folds 
Kreuznagel: folds 
miracolix50: folds 
oscarleon: folds 
I The King I: folds 
Pvsx.: folds 
matiko09: folds 
Uncalled bet ($0.50) returned to apfush
apfush collected $1 from pot
apfush: doesn't show hand 
*** SUMMARY ***
Total pot $1 | Rake $0 
Seat 1: oscarleon folded before Flop (didn't bet)
Seat 2: I The King I folded before Flop (didn't bet)
Seat 3: Pvsx. (button) folded before Flop (didn't bet)
Seat 4: matiko09 (small blind) folded before Flop
Seat 5: apfush (big blind) collected ($1)
Seat 7: Reven9er folded before Flop (didn't bet)
Seat 8: Kreuznagel folded before Flop (didn't bet)
Seat 9: miracolix50 folded before Flop (didn't bet)





PokerStars Hand #151208094109:  Hold'em No Limit ($0.50/$1.00 USD) - 2016/03/31 12:50:36 CET [2016/03/31 6:50:36 ET]
Table 'Yazhi' 9-max Seat #5 is the button
Seat 1: matiko09 ($100 in chips) 
Seat 2: xHourglass ($137.51 in chips) 
Seat 4: apfush ($163.83 in chips) 
Seat 5: IdiotFromNE ($101 in chips) 
Seat 6: Reven9er ($223.49 in chips) 
Seat 7: Avtovo ($100 in chips) 
Seat 8: pk4DW ($46.11 in chips) 
Seat 9: oscarleon ($197.73 in chips) 
Reven9er: posts small blind $0.50
Avtovo: posts big blind $1
*** HOLE CARDS ***
Dealt to matiko09 [Ac Td]
pk4DW: folds 
oscarleon: folds 
matiko09: raises $2 to $3
xHourglass: folds 
apfush: folds 
IdiotFromNE: folds 
Reven9er: raises $5 to $8
Avtovo: folds 
matiko09: folds 
Uncalled bet ($5) returned to Reven9er
Reven9er collected $7 from pot
Reven9er: doesn't show hand 
*** SUMMARY ***
Total pot $7 | Rake $0 
Seat 1: matiko09 folded before Flop
Seat 2: xHourglass folded before Flop (didn't bet)
Seat 4: apfush folded before Flop (didn't bet)
Seat 5: IdiotFromNE (button) folded before Flop (didn't bet)
Seat 6: Reven9er (small blind) collected ($7)
Seat 7: Avtovo (big blind) folded before Flop
Seat 8: pk4DW folded before Flop (didn't bet)
Seat 9: oscarleon folded before Flop (didn't bet)





PokerStars Hand #151208096277:  Hold'em No Limit ($0.50/$1.00 USD) - 2016/03/31 12:50:40 CET [2016/03/31 6:50:40 ET]
Table 'Herge II' 9-max Seat #7 is the button
Seat 1: Chiapel ($82.92 in chips) 
Seat 2: DUkalisUA ($101.50 in chips) 
Seat 3: matiko09 ($210.27 in chips) 
Seat 4: Kreuznagel ($101.50 in chips) 
Seat 5: I The King I ($135.23 in chips) 
Seat 6: masaytoo ($91.50 in chips) 
Seat 7: Zeeshka ($137.95 in chips) 
Seat 8: IdiotFromNE ($100 in chips) 
Seat 9: fatstacks122 ($152.33 in chips) 
IdiotFromNE: posts small blind $0.50
fatstacks122: posts big blind $1
*** HOLE CARDS ***
Dealt to matiko09 [Kd 2h]
Chiapel: folds 
DUkalisUA: folds 
matiko09: folds 
Kreuznagel: raises $1.39 to $2.39
I The King I: folds 
masaytoo: folds 
Zeeshka: folds 
IdiotFromNE: folds 
fatstacks122: calls $1.39
*** FLOP *** [5s 8h Ac]
fatstacks122: bets $2.75
Kreuznagel: folds 
Uncalled bet ($2.75) returned to fatstacks122
fatstacks122 collected $5.02 from pot
fatstacks122: doesn't show hand 
*** SUMMARY ***
Total pot $5.28 | Rake $0.26 
Board [5s 8h Ac]
Seat 1: Chiapel folded before Flop (didn't bet)
Seat 2: DUkalisUA folded before Flop (didn't bet)
Seat 3: matiko09 folded before Flop (didn't bet)
Seat 4: Kreuznagel folded on the Flop
Seat 5: I The King I folded before Flop (didn't bet)
Seat 6: masaytoo folded before Flop (didn't bet)
Seat 7: Zeeshka (button) folded before Flop (didn't bet)
Seat 8: IdiotFromNE (small blind) folded before Flop
Seat 9: fatstacks122 (big blind) collected ($5.02)





PokerStars Hand #151208096443:  Hold'em No Limit ($1/$2 USD) - 2016/03/31 12:50:41 CET [2016/03/31 6:50:41 ET]
Table 'Probitas' 9-max Seat #6 is the button
Seat 1: rmanjkeee ($158.29 in chips) 
Seat 3: azvazdam ($230.99 in chips) 
Seat 4: Painkiller72 ($218.21 in chips) 
Seat 5: matiko09 ($200 in chips) 
Seat 6: Kreuznagel ($444.08 in chips) 
Seat 7: coinflip_si ($296.53 in chips) 
Seat 8: BOAYARSKIY ($138.67 in chips) 
Seat 9: apfush ($306.99 in chips) 
coinflip_si: posts small blind $1
BOAYARSKIY: posts big blind $2
Avtovo: sits out 
*** HOLE CARDS ***
Dealt to matiko09 [6c Ad]
apfush: folds 
rmanjkeee: folds 
azvazdam: folds 
Painkiller72: folds 
matiko09: folds 
Kreuznagel: raises $3 to $5
coinflip_si: folds 
BOAYARSKIY: folds 
Uncalled bet ($3) returned to Kreuznagel
Kreuznagel collected $5 from pot
Kreuznagel: doesn't show hand 
*** SUMMARY ***
Total pot $5 | Rake $0 
Seat 1: rmanjkeee folded before Flop (didn't bet)
Seat 3: azvazdam folded before Flop (didn't bet)
Seat 4: Painkiller72 folded before Flop (didn't bet)
Seat 5: matiko09 folded before Flop (didn't bet)
Seat 6: Kreuznagel (button) collected ($5)
Seat 7: coinflip_si (small blind) folded before Flop
Seat 8: BOAYARSKIY (big blind) folded before Flop
Seat 9: apfush folded before Flop (didn't bet)





PokerStars Hand #151208097032:  Hold'em No Limit ($0.50/$1.00 USD) - 2016/03/31 12:50:42 CET [2016/03/31 6:50:42 ET]
Table 'Miriam' 9-max Seat #2 is the button
Seat 1: matiko09 ($104.12 in chips) 
Seat 2: ka100pka527 ($50.92 in chips) 
Seat 3: IdiotFromNE ($108.21 in chips) 
Seat 4: oscarleon ($144.53 in chips) 
Seat 5: Sutt_420 ($49.02 in chips) 
Seat 7: Zeeshka ($167.21 in chips) 
Seat 8: nobu-azabu ($132.05 in chips) 
IdiotFromNE: posts small blind $0.50
oscarleon: posts big blind $1
*** HOLE CARDS ***
Dealt to matiko09 [7s 4d]
Sutt_420: folds 
Zeeshka: folds 
nobu-azabu: folds 
matiko09: folds 
ka100pka527: folds 
IdiotFromNE: folds 
Uncalled bet ($0.50) returned to oscarleon
oscarleon collected $1 from pot
oscarleon: doesn't show hand 
*** SUMMARY ***
Total pot $1 | Rake $0 
Seat 1: matiko09 folded before Flop (didn't bet)
Seat 2: ka100pka527 (button) folded before Flop (didn't bet)
Seat 3: IdiotFromNE (small blind) folded before Flop
Seat 4: oscarleon (big blind) collected ($1)
Seat 5: Sutt_420 folded before Flop (didn't bet)
Seat 7: Zeeshka folded before Flop (didn't bet)
Seat 8: nobu-azabu folded before Flop (didn't bet)





PokerStars Hand #151208097185:  Hold'em No Limit ($0.50/$1.00 USD) - 2016/03/31 12:50:42 CET [2016/03/31 6:50:42 ET]
Table 'Egeria II' 9-max Seat #4 is the button
Seat 1: oscarleon ($122.53 in chips) 
Seat 2: I The King I ($186.03 in chips) 
Seat 3: Pvsx. ($115.64 in chips) 
Seat 4: matiko09 ($100 in chips) 
Seat 5: apfush ($145.50 in chips) 
Seat 6: DUkalisUA ($100 in chips) 
Seat 7: Reven9er ($154.46 in chips) 
Seat 8: Kreuznagel ($135.01 in chips) 
Seat 9: miracolix50 ($48.17 in chips) 
apfush: posts small blind $0.50
DUkalisUA: posts big blind $1
*** HOLE CARDS ***
Dealt to matiko09 [4d 2s]
Reven9er: folds 
Kreuznagel: folds 
miracolix50: calls $1
oscarleon: folds 
I The King I: folds 
Pvsx.: folds 
matiko09: folds 
apfush: raises $4 to $5
DUkalisUA: folds 
miracolix50: calls $4
*** FLOP *** [6h 3h 6d]
apfush: bets $6
miracolix50: calls $6
*** TURN *** [6h 3h 6d] [9c]
apfush: checks 
miracolix50: bets $13
apfush: folds 
Uncalled bet ($13) returned to miracolix50
miracolix50 collected $21.85 from pot
miracolix50: doesn't show hand 
*** SUMMARY ***
Total pot $23 | Rake $1.15 
Board [6h 3h 6d 9c]
Seat 1: oscarleon folded before Flop (didn't bet)
Seat 2: I The King I folded before Flop (didn't bet)
Seat 3: Pvsx. folded before Flop (didn't bet)
Seat 4: matiko09 (button) folded before Flop (didn't bet)
Seat 5: apfush (small blind) folded on the Turn
Seat 6: DUkalisUA (big blind) folded before Flop
Seat 7: Reven9er folded before Flop (didn't bet)
Seat 8: Kreuznagel folded before Flop (didn't bet)
Seat 9: miracolix50 collected ($21.85)





PokerStars Hand #151208099156:  Hold'em No Limit ($0.50/$1.00 USD) - 2016/03/31 12:50:46 CET [2016/03/31 6:50:46 ET]
Table 'Aquila' 9-max Seat #9 is the button
Seat 1: BOAYARSKIY ($49.60 in chips) 
Seat 2: Avtovo ($100 in chips) 
Seat 5: adelfaz ($71.28 in chips) 
Seat 7: PacPacBum ($117.10 in chips) 
Seat 8: matiko09 ($149.54 in chips) 
Seat 9: apfush ($112 in chips) 
BOAYARSKIY: posts small blind $0.50
Avtovo: posts big blind $1
Kreuznagel: sits out 
BOAYARSKIY: posts the ante $0.20
Avtovo: posts the ante $0.20
adelfaz: posts the ante $0.20
PacPacBum: posts the ante $0.20
matiko09: posts the ante $0.20
apfush: posts the ante $0.20
*** HOLE CARDS ***
Dealt to matiko09 [8h 8d]
adelfaz: folds 
PacPacBum: folds 
matiko09: raises $1.50 to $2.50
apfush: folds 
BOAYARSKIY: folds 
Avtovo: folds 
Uncalled bet ($1.50) returned to matiko09
matiko09 collected $3.70 from pot
matiko09: doesn't show hand 
*** SUMMARY ***
Total pot $3.70 | Rake $0 
Seat 1: BOAYARSKIY (small blind) folded before Flop
Seat 2: Avtovo (big blind) folded before Flop
Seat 5: adelfaz folded before Flop (didn't bet)
Seat 7: PacPacBum folded before Flop (didn't bet)
Seat 8: matiko09 collected ($3.70)
Seat 9: apfush (button) folded before Flop (didn't bet)





PokerStars Hand #151208099762:  Hold'em No Limit ($1/$2 USD) - 2016/03/31 12:50:48 CET [2016/03/31 6:50:48 ET]
Table 'Coelestina II' 9-max Seat #6 is the button
Seat 1: PacPacBum ($205.05 in chips) 
Seat 2: Kreuznagel ($223.05 in chips) 
Seat 3: ilaviiitech ($200 in chips) 
Seat 4: matiko09 ($211.67 in chips) 
Seat 5: Painkiller72 ($200 in chips) 
Seat 6: Avtovo ($235.07 in chips) 
Seat 7: rmanjkeee ($80 in chips) 
Seat 8: DUkalisUA ($232.31 in chips) 
Seat 9: fonng ($189.45 in chips) 
rmanjkeee: posts small blind $1
DUkalisUA: posts big blind $2
*** HOLE CARDS ***
Dealt to matiko09 [Ah Js]
fonng: calls $2
PacPacBum: folds 
Kreuznagel: folds 
ilaviiitech: folds 
matiko09: raises $6 to $8
Painkiller72: folds 
Avtovo: folds 
rmanjkeee: folds 
DUkalisUA: folds 
fonng: calls $6
*** FLOP *** [3s 8c 4s]
fonng: checks 
matiko09: checks 
*** TURN *** [3s 8c 4s] [Th]
fonng: checks 
matiko09: checks 
*** RIVER *** [3s 8c 4s Th] [6c]
fonng: checks 
matiko09: checks 
*** SHOW DOWN ***
fonng: shows [Jh Kc] (high card King)
matiko09: shows [Ah Js] (high card Ace)
matiko09 collected $18.05 from pot
*** SUMMARY ***
Total pot $19 | Rake $0.95 
Board [3s 8c 4s Th 6c]
Seat 1: PacPacBum folded before Flop (didn't bet)
Seat 2: Kreuznagel folded before Flop (didn't bet)
Seat 3: ilaviiitech folded before Flop (didn't bet)
Seat 4: matiko09 showed [Ah Js] and won ($18.05) with high card Ace
Seat 5: Painkiller72 folded before Flop (didn't bet)
Seat 6: Avtovo (button) folded before Flop (didn't bet)
Seat 7: rmanjkeee (small blind) folded before Flop
Seat 8: DUkalisUA (big blind) folded before Flop
Seat 9: fonng showed [Jh Kc] and lost with high card King





PokerStars Hand #151208101015:  Hold'em No Limit ($0.50/$1.00 USD) - 2016/03/31 12:50:50 CET [2016/03/31 6:50:50 ET]
Table 'Viipuri II' 9-max Seat #3 is the button
Seat 1: Muinmyheart ($101.30 in chips) 
Seat 2: futa317 ($67.20 in chips) 
Seat 3: Zeeshka ($100 in chips) 
Seat 4: Miner604 ($49.26 in chips) 
Seat 5: matiko09 ($100 in chips) 
Seat 6: PacPacBum ($100 in chips) 
Seat 8: ilaviiitech ($115.88 in chips) 
Seat 9: djammusic ($40 in chips) 
Miner604: posts small blind $0.50
matiko09: posts big blind $1
vicdroopy: sits out 
*** HOLE CARDS ***
Dealt to matiko09 [3d 6c]
PacPacBum: folds 
ilaviiitech: folds 
djammusic: folds 
Muinmyheart: folds 
futa317: raises $1 to $2
Zeeshka: folds 
Miner604: calls $1.50
matiko09: folds 
*** FLOP *** [8h 2s 3h]
Miner604: checks 
futa317: bets $4.75
Miner604: calls $4.75
*** TURN *** [8h 2s 3h] [As]
Miner604: checks 
futa317: bets $10
Miner604: folds 
Uncalled bet ($10) returned to futa317
futa317 collected $13.78 from pot
futa317: doesn't show hand 
*** SUMMARY ***
Total pot $14.50 | Rake $0.72 
Board [8h 2s 3h As]
Seat 1: Muinmyheart folded before Flop (didn't bet)
Seat 2: futa317 collected ($13.78)
Seat 3: Zeeshka (button) folded before Flop (didn't bet)
Seat 4: Miner604 (small blind) folded on the Turn
Seat 5: matiko09 (big blind) folded before Flop
Seat 6: PacPacBum folded before Flop (didn't bet)
Seat 8: ilaviiitech folded before Flop (didn't bet)
Seat 9: djammusic folded before Flop (didn't bet)





PokerStars Hand #151208101664:  Hold'em No Limit ($0.50/$1.00 USD) - 2016/03/31 12:50:52 CET [2016/03/31 6:50:52 ET]
Table 'Icarus III' 9-max Seat #6 is the button
Seat 2: Painkiller72 ($100 in chips) 
Seat 3: RICKA16 ($124.74 in chips) 
Seat 4: dizzyryano79 ($38.41 in chips) 
Seat 5: I The King I ($109.25 in chips) 
Seat 6: djammusic ($46.08 in chips) 
Seat 7: oscarleon ($143.82 in chips) 
Seat 8: matiko09 ($104.12 in chips) 
Seat 9: apfush ($122.46 in chips) 
oscarleon: posts small blind $0.50
matiko09: posts big blind $1
*** HOLE CARDS ***
Dealt to matiko09 [2s Js]
apfush: folds 
Painkiller72: folds 
RICKA16: folds 
dizzyryano79: folds 
I The King I: raises $1.50 to $2.50
djammusic: folds 
oscarleon: folds 
matiko09: folds 
Uncalled bet ($1.50) returned to I The King I
I The King I collected $2.50 from pot
I The King I: doesn't show hand 
*** SUMMARY ***
Total pot $2.50 | Rake $0 
Seat 2: Painkiller72 folded before Flop (didn't bet)
Seat 3: RICKA16 folded before Flop (didn't bet)
Seat 4: dizzyryano79 folded before Flop (didn't bet)
Seat 5: I The King I collected ($2.50)
Seat 6: djammusic (button) folded before Flop (didn't bet)
Seat 7: oscarleon (small blind) folded before Flop
Seat 8: matiko09 (big blind) folded before Flop
Seat 9: apfush folded before Flop (didn't bet)





PokerStars Hand #151208108445:  Hold'em No Limit ($0.50/$1.00 USD) - 2016/03/31 12:51:05 CET [2016/03/31 6:51:05 ET]
Table 'Miriam' 9-max Seat #3 is the button
Seat 1: matiko09 ($104.12 in chips) 
Seat 2: ka100pka527 ($50.92 in chips) 
Seat 3: IdiotFromNE ($107.71 in chips) 
Seat 4: oscarleon ($145.03 in chips) 
Seat 5: Sutt_420 ($49.02 in chips) 
Seat 7: Zeeshka ($167.21 in chips) 
Seat 8: nobu-azabu ($132.05 in chips) 
oscarleon: posts small blind $0.50
Sutt_420: posts big blind $1
*** HOLE CARDS ***
Dealt to matiko09 [3c Ks]
Zeeshka: raises $2 to $3
nobu-azabu: folds 
matiko09: folds 
ka100pka527: folds 
IdiotFromNE: folds 
oscarleon: folds 
Sutt_420: folds 
Uncalled bet ($2) returned to Zeeshka
Zeeshka collected $2.50 from pot
Zeeshka: doesn't show hand 
*** SUMMARY ***
Total pot $2.50 | Rake $0 
Seat 1: matiko09 folded before Flop (didn't bet)
Seat 2: ka100pka527 folded before Flop (didn't bet)
Seat 3: IdiotFromNE (button) folded before Flop (didn't bet)
Seat 4: oscarleon (small blind) folded before Flop
Seat 5: Sutt_420 (big blind) folded before Flop
Seat 7: Zeeshka collected ($2.50)
Seat 8: nobu-azabu folded before Flop (didn't bet)





PokerStars Hand #151208110301:  Hold'em No Limit ($0.50/$1.00 USD) - 2016/03/31 12:51:09 CET [2016/03/31 6:51:09 ET]
Table 'Yazhi' 9-max Seat #6 is the button
Seat 1: matiko09 ($100 in chips) 
Seat 2: xHourglass ($137.51 in chips) 
Seat 4: apfush ($163.83 in chips) 
Seat 5: IdiotFromNE ($101 in chips) 
Seat 6: Reven9er ($227.49 in chips) 
Seat 7: Avtovo ($100 in chips) 
Seat 8: pk4DW ($46.11 in chips) 
Seat 9: oscarleon ($197.73 in chips) 
Avtovo: posts small blind $0.50
pk4DW: posts big blind $1
*** HOLE CARDS ***
Dealt to matiko09 [6d 6h]
oscarleon: folds 
matiko09: raises $2 to $3
xHourglass: folds 
apfush: folds 
IdiotFromNE: folds 
Reven9er: folds 
Avtovo: folds 
pk4DW: calls $2
*** FLOP *** [6c Tc 2s]
pk4DW: checks 
matiko09: bets $4.02
pk4DW: folds 
Uncalled bet ($4.02) returned to matiko09
matiko09 collected $6.18 from pot
matiko09: doesn't show hand 
*** SUMMARY ***
Total pot $6.50 | Rake $0.32 
Board [6c Tc 2s]
Seat 1: matiko09 collected ($6.18)
Seat 2: xHourglass folded before Flop (didn't bet)
Seat 4: apfush folded before Flop (didn't bet)
Seat 5: IdiotFromNE folded before Flop (didn't bet)
Seat 6: Reven9er (button) folded before Flop (didn't bet)
Seat 7: Avtovo (small blind) folded before Flop
Seat 8: pk4DW (big blind) folded on the Flop
Seat 9: oscarleon folded before Flop (didn't bet)





PokerStars Hand #151208115941:  Hold'em No Limit ($0.50/$1.00 USD) - 2016/03/31 12:51:21 CET [2016/03/31 6:51:21 ET]
Table 'Haworth II' 9-max Seat #2 is the button
Seat 2: AlKatrone ($142.63 in chips) 
Seat 3: matiko09 ($100 in chips) 
Seat 4: I The King I ($116.02 in chips) 
Seat 5: Kreuznagel ($101.60 in chips) 
Seat 6: Pvsx. ($100 in chips) 
Seat 7: mheris ($138.74 in chips) 
Seat 8: oscarleon ($100 in chips) 
Seat 9: Zeeshka ($100 in chips) 
matiko09: posts small blind $0.50
I The King I: posts big blind $1
*** HOLE CARDS ***
Dealt to matiko09 [4c Qd]
Kreuznagel: folds 
Pvsx.: folds 
mheris: folds 
oscarleon: folds 
Zeeshka: folds 
AlKatrone: folds 
matiko09: folds 
Uncalled bet ($0.50) returned to I The King I
I The King I collected $1 from pot
I The King I: doesn't show hand 
*** SUMMARY ***
Total pot $1 | Rake $0 
Seat 2: AlKatrone (button) folded before Flop (didn't bet)
Seat 3: matiko09 (small blind) folded before Flop
Seat 4: I The King I (big blind) collected ($1)
Seat 5: Kreuznagel folded before Flop (didn't bet)
Seat 6: Pvsx. folded before Flop (didn't bet)
Seat 7: mheris folded before Flop (didn't bet)
Seat 8: oscarleon folded before Flop (didn't bet)
Seat 9: Zeeshka folded before Flop (didn't bet)





PokerStars Hand #151208117066:  Hold'em No Limit ($0.50/$1.00 USD) - 2016/03/31 12:51:23 CET [2016/03/31 6:51:23 ET]
Table 'Icarus III' 9-max Seat #7 is the button
Seat 2: Painkiller72 ($100 in chips) 
Seat 3: RICKA16 ($124.74 in chips) 
Seat 4: dizzyryano79 ($38.41 in chips) 
Seat 5: I The King I ($110.75 in chips) 
Seat 6: djammusic ($46.08 in chips) 
Seat 7: oscarleon ($143.32 in chips) 
Seat 8: matiko09 ($103.12 in chips) 
Seat 9: apfush ($122.46 in chips) 
matiko09: posts small blind $0.50
apfush: posts big blind $1
*** HOLE CARDS ***
Dealt to matiko09 [3s 2h]
Painkiller72: folds 
RICKA16: folds 
dizzyryano79: raises $2 to $3
I The King I: folds 
djammusic: folds 
oscarleon: raises $7 to $10
matiko09: folds 
apfush: folds 
dizzyryano79: calls $7
*** FLOP *** [Tc Js 8c]
dizzyryano79: bets $20.42
oscarleon: raises $39.58 to $60
dizzyryano79: calls $7.99 and is all-in
Uncalled bet ($31.59) returned to oscarleon
*** TURN *** [Tc Js 8c] [2c]
*** RIVER *** [Tc Js 8c 2c] [Qs]
*** SHOW DOWN ***
dizzyryano79: shows [Kd Jd] (a pair of Jacks)
oscarleon: shows [Qc As] (a pair of Queens)
oscarleon collected $75.82 from pot
*** SUMMARY ***
Total pot $78.32 | Rake $2.50 
Board [Tc Js 8c 2c Qs]
Seat 2: Painkiller72 folded before Flop (didn't bet)
Seat 3: RICKA16 folded before Flop (didn't bet)
Seat 4: dizzyryano79 showed [Kd Jd] and lost with a pair of Jacks
Seat 5: I The King I folded before Flop (didn't bet)
Seat 6: djammusic folded before Flop (didn't bet)
Seat 7: oscarleon (button) showed [Qc As] and won ($75.82) with a pair of Queens
Seat 8: matiko09 (small blind) folded before Flop
Seat 9: apfush (big blind) folded before Flop





PokerStars Hand #151208117638:  Hold'em No Limit ($1/$2 USD) - 2016/03/31 12:51:25 CET [2016/03/31 6:51:25 ET]
Table 'Probitas' 9-max Seat #7 is the button
Seat 1: rmanjkeee ($158.29 in chips) 
Seat 3: azvazdam ($230.99 in chips) 
Seat 4: Painkiller72 ($218.21 in chips) 
Seat 5: matiko09 ($200 in chips) 
Seat 6: Kreuznagel ($447.08 in chips) 
Seat 7: coinflip_si ($295.53 in chips) 
Seat 8: BOAYARSKIY ($136.67 in chips) 
Seat 9: apfush ($306.99 in chips) 
BOAYARSKIY: posts small blind $1
apfush: posts big blind $2
Avtovo: sits out 
*** HOLE CARDS ***
Dealt to matiko09 [2d Qh]
rmanjkeee: folds 
azvazdam: folds 
Painkiller72: folds 
matiko09: folds 
Kreuznagel: raises $3 to $5
coinflip_si: folds 
BOAYARSKIY: folds 
apfush: folds 
Uncalled bet ($3) returned to Kreuznagel
Kreuznagel collected $5 from pot
Kreuznagel: doesn't show hand 
*** SUMMARY ***
Total pot $5 | Rake $0 
Seat 1: rmanjkeee folded before Flop (didn't bet)
Seat 3: azvazdam folded before Flop (didn't bet)
Seat 4: Painkiller72 folded before Flop (didn't bet)
Seat 5: matiko09 folded before Flop (didn't bet)
Seat 6: Kreuznagel collected ($5)
Seat 7: coinflip_si (button) folded before Flop (didn't bet)
Seat 8: BOAYARSKIY (small blind) folded before Flop
Seat 9: apfush (big blind) folded before Flop





PokerStars Hand #151208118985:  Hold'em No Limit ($0.50/$1.00 USD) - 2016/03/31 12:51:27 CET [2016/03/31 6:51:27 ET]
Table 'Viipuri II' 9-max Seat #4 is the button
Seat 1: Muinmyheart ($101.30 in chips) 
Seat 2: futa317 ($74.23 in chips) 
Seat 3: Zeeshka ($100 in chips) 
Seat 4: Miner604 ($42.51 in chips) 
Seat 5: matiko09 ($100 in chips) 
Seat 6: PacPacBum ($100 in chips) 
Seat 8: ilaviiitech ($115.88 in chips) 
Seat 9: djammusic ($40 in chips) 
matiko09: posts small blind $0.50
PacPacBum: posts big blind $1
vicdroopy: sits out 
*** HOLE CARDS ***
Dealt to matiko09 [7c 5h]
ilaviiitech: folds 
djammusic: folds 
Muinmyheart: folds 
futa317: folds 
Zeeshka: folds 
Miner604: folds 
matiko09: folds 
Uncalled bet ($0.50) returned to PacPacBum
PacPacBum collected $1 from pot
PacPacBum: doesn't show hand 
*** SUMMARY ***
Total pot $1 | Rake $0 
Seat 1: Muinmyheart folded before Flop (didn't bet)
Seat 2: futa317 folded before Flop (didn't bet)
Seat 3: Zeeshka folded before Flop (didn't bet)
Seat 4: Miner604 (button) folded before Flop (didn't bet)
Seat 5: matiko09 (small blind) folded before Flop
Seat 6: PacPacBum (big blind) collected ($1)
Seat 8: ilaviiitech folded before Flop (didn't bet)
Seat 9: djammusic folded before Flop (didn't bet)





PokerStars Hand #151208121694:  Hold'em No Limit ($0.50/$1.00 USD) - 2016/03/31 12:51:33 CET [2016/03/31 6:51:33 ET]
Table 'Miriam' 9-max Seat #4 is the button
Seat 1: matiko09 ($104.12 in chips) 
Seat 2: ka100pka527 ($50.92 in chips) 
Seat 3: IdiotFromNE ($107.71 in chips) 
Seat 4: oscarleon ($144.53 in chips) 
Seat 5: Sutt_420 ($48.02 in chips) 
Seat 7: Zeeshka ($168.71 in chips) 
Seat 8: nobu-azabu ($132.05 in chips) 
Sutt_420: posts small blind $0.50
Zeeshka: posts big blind $1
*** HOLE CARDS ***
Dealt to matiko09 [Jc Qh]
bre123456626 was removed from the table for failing to post
nobu-azabu: folds 
matiko09: folds 
ka100pka527: raises $1 to $2
IdiotFromNE: folds 
oscarleon: folds 
Sutt_420: folds 
Zeeshka: calls $1
*** FLOP *** [3h Ts 8c]
Zeeshka: checks 
ka100pka527: bets $2.14
Zeeshka: folds 
Uncalled bet ($2.14) returned to ka100pka527
apfush joins the table at seat #9 
ka100pka527 collected $4.28 from pot
ka100pka527: doesn't show hand 
*** SUMMARY ***
Total pot $4.50 | Rake $0.22 
Board [3h Ts 8c]
Seat 1: matiko09 folded before Flop (didn't bet)
Seat 2: ka100pka527 collected ($4.28)
Seat 3: IdiotFromNE folded before Flop (didn't bet)
Seat 4: oscarleon (button) folded before Flop (didn't bet)
Seat 5: Sutt_420 (small blind) folded before Flop
Seat 7: Zeeshka (big blind) folded on the Flop
Seat 8: nobu-azabu folded before Flop (didn't bet)





PokerStars Hand #151208122622:  Hold'em No Limit ($0.50/$1.00 USD) - 2016/03/31 12:51:35 CET [2016/03/31 6:51:35 ET]
Table 'Aquila' 9-max Seat #1 is the button
Seat 1: BOAYARSKIY ($48.90 in chips) 
Seat 2: Avtovo ($100 in chips) 
Seat 3: Kreuznagel ($100 in chips) 
Seat 5: adelfaz ($71.08 in chips) 
Seat 7: PacPacBum ($116.90 in chips) 
Seat 8: matiko09 ($152.04 in chips) 
Seat 9: apfush ($111.80 in chips) 
Avtovo: posts small blind $0.50
Kreuznagel: posts big blind $1
BOAYARSKIY: posts the ante $0.20
Avtovo: posts the ante $0.20
Kreuznagel: posts the ante $0.20
adelfaz: posts the ante $0.20
PacPacBum: posts the ante $0.20
matiko09: posts the ante $0.20
apfush: posts the ante $0.20
*** HOLE CARDS ***
Dealt to matiko09 [Qh 4s]
adelfaz: folds 
PacPacBum: folds 
matiko09: folds 
apfush: folds 
BOAYARSKIY: folds 
Avtovo: folds 
Uncalled bet ($0.50) returned to Kreuznagel
Kreuznagel collected $2.40 from pot
Kreuznagel: doesn't show hand 
*** SUMMARY ***
Total pot $2.40 | Rake $0 
Seat 1: BOAYARSKIY (button) folded before Flop (didn't bet)
Seat 2: Avtovo (small blind) folded before Flop
Seat 3: Kreuznagel (big blind) collected ($2.40)
Seat 5: adelfaz folded before Flop (didn't bet)
Seat 7: PacPacBum folded before Flop (didn't bet)
Seat 8: matiko09 folded before Flop (didn't bet)
Seat 9: apfush folded before Flop (didn't bet)





PokerStars Hand #151208124105:  Hold'em No Limit ($1/$2 USD) - 2016/03/31 12:51:38 CET [2016/03/31 6:51:38 ET]
Table 'Coelestina II' 9-max Seat #7 is the button
Seat 1: PacPacBum ($205.05 in chips) 
Seat 2: Kreuznagel ($223.05 in chips) 
Seat 3: ilaviiitech ($200 in chips) 
Seat 4: matiko09 ($221.72 in chips) 
Seat 5: Painkiller72 ($200 in chips) 
Seat 6: Avtovo ($235.07 in chips) 
Seat 7: rmanjkeee ($80 in chips) 
Seat 8: DUkalisUA ($230.31 in chips) 
Seat 9: fonng ($181.45 in chips) 
DUkalisUA: posts small blind $1
fonng: posts big blind $2
*** HOLE CARDS ***
Dealt to matiko09 [Jc 3c]
PacPacBum: folds 
Kreuznagel: folds 
ilaviiitech: folds 
matiko09: folds 
Painkiller72: raises $3 to $5
Avtovo: folds 
rmanjkeee: calls $5
DUkalisUA: folds 
fonng: calls $3
*** FLOP *** [4c 9h 3s]
fonng: bets $8
Painkiller72: calls $8
rmanjkeee: calls $8
*** TURN *** [4c 9h 3s] [7s]
fonng: checks 
Painkiller72: checks 
rmanjkeee: bets $26
fonng: folds 
Painkiller72: folds 
Uncalled bet ($26) returned to rmanjkeee
rmanjkeee collected $38 from pot
rmanjkeee: doesn't show hand 
*** SUMMARY ***
Total pot $40 | Rake $2 
Board [4c 9h 3s 7s]
Seat 1: PacPacBum folded before Flop (didn't bet)
Seat 2: Kreuznagel folded before Flop (didn't bet)
Seat 3: ilaviiitech folded before Flop (didn't bet)
Seat 4: matiko09 folded before Flop (didn't bet)
Seat 5: Painkiller72 folded on the Turn
Seat 6: Avtovo folded before Flop (didn't bet)
Seat 7: rmanjkeee (button) collected ($38)
Seat 8: DUkalisUA (small blind) folded before Flop
Seat 9: fonng (big blind) folded on the Turn





PokerStars Hand #151208126118:  Hold'em No Limit ($0.50/$1.00 USD) - 2016/03/31 12:51:42 CET [2016/03/31 6:51:42 ET]
Table 'Viipuri II' 9-max Seat #5 is the button
Seat 1: Muinmyheart ($101.30 in chips) 
Seat 2: futa317 ($74.23 in chips) 
Seat 3: Zeeshka ($100 in chips) 
Seat 4: Miner604 ($42.51 in chips) 
Seat 5: matiko09 ($100 in chips) 
Seat 6: PacPacBum ($100.50 in chips) 
Seat 7: vicdroopy ($100 in chips) 
Seat 8: ilaviiitech ($115.88 in chips) 
Seat 9: djammusic ($40 in chips) 
PacPacBum: posts small blind $0.50
vicdroopy: posts big blind $1
*** HOLE CARDS ***
Dealt to matiko09 [Qh 6s]
ilaviiitech: folds 
djammusic: folds 
Muinmyheart: folds 
futa317: folds 
Zeeshka: folds 
Miner604: raises $2 to $3
matiko09: folds 
PacPacBum: folds 
vicdroopy: folds 
Uncalled bet ($2) returned to Miner604
Miner604 collected $2.50 from pot
*** SUMMARY ***
Total pot $2.50 | Rake $0 
Seat 1: Muinmyheart folded before Flop (didn't bet)
Seat 2: futa317 folded before Flop (didn't bet)
Seat 3: Zeeshka folded before Flop (didn't bet)
Seat 4: Miner604 collected ($2.50)
Seat 5: matiko09 (button) folded before Flop (didn't bet)
Seat 6: PacPacBum (small blind) folded before Flop
Seat 7: vicdroopy (big blind) folded before Flop
Seat 8: ilaviiitech folded before Flop (didn't bet)
Seat 9: djammusic folded before Flop (didn't bet)





PokerStars Hand #151208130666:  Hold'em No Limit ($0.50/$1.00 USD) - 2016/03/31 12:51:51 CET [2016/03/31 6:51:51 ET]
Table 'Haworth II' 9-max Seat #3 is the button
Seat 2: AlKatrone ($142.63 in chips) 
Seat 3: matiko09 ($100 in chips) 
Seat 4: I The King I ($116.52 in chips) 
Seat 5: Kreuznagel ($101.60 in chips) 
Seat 6: Pvsx. ($100 in chips) 
Seat 7: mheris ($138.74 in chips) 
Seat 8: oscarleon ($100 in chips) 
Seat 9: Zeeshka ($100 in chips) 
I The King I: posts small blind $0.50
Kreuznagel: posts big blind $1
*** HOLE CARDS ***
Dealt to matiko09 [8s 4d]
Pvsx.: folds 
mheris: folds 
oscarleon: folds 
Zeeshka: folds 
AlKatrone: raises $1.50 to $2.50
matiko09: folds 
I The King I: folds 
Kreuznagel: calls $1.50
*** FLOP *** [6h 3h 9s]
Kreuznagel: checks 
AlKatrone: bets $1.72
Kreuznagel: folds 
Uncalled bet ($1.72) returned to AlKatrone
AlKatrone collected $5.22 from pot
AlKatrone: doesn't show hand 
*** SUMMARY ***
Total pot $5.50 | Rake $0.28 
Board [6h 3h 9s]
Seat 2: AlKatrone collected ($5.22)
Seat 3: matiko09 (button) folded before Flop (didn't bet)
Seat 4: I The King I (small blind) folded before Flop
Seat 5: Kreuznagel (big blind) folded on the Flop
Seat 6: Pvsx. folded before Flop (didn't bet)
Seat 7: mheris folded before Flop (didn't bet)
Seat 8: oscarleon folded before Flop (didn't bet)
Seat 9: Zeeshka folded before Flop (didn't bet)





PokerStars Hand #151208134492:  Hold'em No Limit ($0.50/$1.00 USD) - 2016/03/31 12:51:59 CET [2016/03/31 6:51:59 ET]
Table 'Herge II' 9-max Seat #8 is the button
Seat 1: Chiapel ($82.92 in chips) 
Seat 2: DUkalisUA ($101.50 in chips) 
Seat 3: matiko09 ($210.27 in chips) 
Seat 4: Kreuznagel ($100 in chips) 
Seat 5: I The King I ($135.23 in chips) 
Seat 6: masaytoo ($91.50 in chips) 
Seat 7: Zeeshka ($137.95 in chips) 
Seat 8: IdiotFromNE ($100 in chips) 
Seat 9: fatstacks122 ($154.96 in chips) 
fatstacks122: posts small blind $0.50
Chiapel: posts big blind $1
*** HOLE CARDS ***
Dealt to matiko09 [5d Th]
DUkalisUA: folds 
matiko09: folds 
Kreuznagel: folds 
I The King I: folds 
masaytoo: folds 
Zeeshka: raises $2 to $3
IdiotFromNE: folds 
fatstacks122: folds 
Chiapel: folds 
Uncalled bet ($2) returned to Zeeshka
Zeeshka collected $2.50 from pot
Zeeshka: doesn't show hand 
*** SUMMARY ***
Total pot $2.50 | Rake $0 
Seat 1: Chiapel (big blind) folded before Flop
Seat 2: DUkalisUA folded before Flop (didn't bet)
Seat 3: matiko09 folded before Flop (didn't bet)
Seat 4: Kreuznagel folded before Flop (didn't bet)
Seat 5: I The King I folded before Flop (didn't bet)
Seat 6: masaytoo folded before Flop (didn't bet)
Seat 7: Zeeshka collected ($2.50)
Seat 8: IdiotFromNE (button) folded before Flop (didn't bet)
Seat 9: fatstacks122 (small blind) folded before Flop





PokerStars Hand #151208136208:  Hold'em No Limit ($0.50/$1.00 USD) - 2016/03/31 12:52:03 CET [2016/03/31 6:52:03 ET]
Table 'Aquila' 9-max Seat #2 is the button
Seat 1: BOAYARSKIY ($48.70 in chips) 
Seat 2: Avtovo ($100 in chips) 
Seat 3: Kreuznagel ($101.70 in chips) 
Seat 5: adelfaz ($70.88 in chips) 
Seat 7: PacPacBum ($116.70 in chips) 
Seat 8: matiko09 ($151.84 in chips) 
Seat 9: apfush ($111.60 in chips) 
Kreuznagel: posts small blind $0.50
adelfaz: posts big blind $1
BOAYARSKIY: posts the ante $0.20
Avtovo: posts the ante $0.20
Kreuznagel: posts the ante $0.20
adelfaz: posts the ante $0.20
PacPacBum: posts the ante $0.20
matiko09: posts the ante $0.20
apfush: posts the ante $0.20
*** HOLE CARDS ***
Dealt to matiko09 [5d 9h]
PacPacBum: folds 
matiko09: folds 
apfush: folds 
BOAYARSKIY: folds 
Avtovo: folds 
Kreuznagel: folds 
Uncalled bet ($0.50) returned to adelfaz
adelfaz collected $2.40 from pot
*** SUMMARY ***
Total pot $2.40 | Rake $0 
Seat 1: BOAYARSKIY folded before Flop (didn't bet)
Seat 2: Avtovo (button) folded before Flop (didn't bet)
Seat 3: Kreuznagel (small blind) folded before Flop
Seat 5: adelfaz (big blind) collected ($2.40)
Seat 7: PacPacBum folded before Flop (didn't bet)
Seat 8: matiko09 folded before Flop (didn't bet)
Seat 9: apfush folded before Flop (didn't bet)





PokerStars Hand #151208138354:  Hold'em No Limit ($1/$2 USD) - 2016/03/31 12:52:07 CET [2016/03/31 6:52:07 ET]
Table 'Probitas' 9-max Seat #8 is the button
Seat 1: rmanjkeee ($158.29 in chips) 
Seat 3: azvazdam ($230.99 in chips) 
Seat 4: Painkiller72 ($218.21 in chips) 
Seat 5: matiko09 ($200 in chips) 
Seat 6: Kreuznagel ($450.08 in chips) 
Seat 7: coinflip_si ($295.53 in chips) 
Seat 8: BOAYARSKIY ($135.67 in chips) 
Seat 9: apfush ($304.99 in chips) 
apfush: posts small blind $1
rmanjkeee: posts big blind $2
Avtovo: sits out 
*** HOLE CARDS ***
Dealt to matiko09 [6s 9h]
azvazdam: folds 
Painkiller72: folds 
matiko09: folds 
Kreuznagel: raises $2.78 to $4.78
coinflip_si: folds 
BOAYARSKIY: folds 
apfush: folds 
rmanjkeee: calls $2.78
*** FLOP *** [4s Qc 3h]
rmanjkeee: checks 
Kreuznagel: bets $3.30
rmanjkeee: folds 
Uncalled bet ($3.30) returned to Kreuznagel
Kreuznagel collected $10.03 from pot
Kreuznagel: doesn't show hand 
*** SUMMARY ***
Total pot $10.56 | Rake $0.53 
Board [4s Qc 3h]
Seat 1: rmanjkeee (big blind) folded on the Flop
Seat 3: azvazdam folded before Flop (didn't bet)
Seat 4: Painkiller72 folded before Flop (didn't bet)
Seat 5: matiko09 folded before Flop (didn't bet)
Seat 6: Kreuznagel collected ($10.03)
Seat 7: coinflip_si folded before Flop (didn't bet)
Seat 8: BOAYARSKIY (button) folded before Flop (didn't bet)
Seat 9: apfush (small blind) folded before Flop





PokerStars Hand #151208138315:  Hold'em No Limit ($0.50/$1.00 USD) - 2016/03/31 12:52:07 CET [2016/03/31 6:52:07 ET]
Table 'Yazhi' 9-max Seat #7 is the button
Seat 1: matiko09 ($103.18 in chips) 
Seat 2: xHourglass ($137.51 in chips) 
Seat 4: apfush ($163.83 in chips) 
Seat 5: IdiotFromNE ($101 in chips) 
Seat 6: Reven9er ($227.49 in chips) 
Seat 7: Avtovo ($100 in chips) 
Seat 8: pk4DW ($43.11 in chips) 
Seat 9: oscarleon ($197.73 in chips) 
pk4DW: posts small blind $0.50
oscarleon: posts big blind $1
*** HOLE CARDS ***
Dealt to matiko09 [5s 7d]
matiko09: folds 
xHourglass: folds 
apfush: folds 
IdiotFromNE: folds 
Reven9er: folds 
Avtovo: folds 
pk4DW: folds 
Uncalled bet ($0.50) returned to oscarleon
oscarleon collected $1 from pot
oscarleon: doesn't show hand 
*** SUMMARY ***
Total pot $1 | Rake $0 
Seat 1: matiko09 folded before Flop (didn't bet)
Seat 2: xHourglass folded before Flop (didn't bet)
Seat 4: apfush folded before Flop (didn't bet)
Seat 5: IdiotFromNE folded before Flop (didn't bet)
Seat 6: Reven9er folded before Flop (didn't bet)
Seat 7: Avtovo (button) folded before Flop (didn't bet)
Seat 8: pk4DW (small blind) folded before Flop
Seat 9: oscarleon (big blind) collected ($1)





PokerStars Hand #151208139547:  Hold'em No Limit (€0.50/€1.00 EUR) - 2016/03/31 12:52:10 CET [2016/03/31 6:52:10 ET]
Table 'Pioneer II' 9-max Seat #6 is the button
Seat 2: IdiotFromNE (€129.52 in chips) 
Seat 3: Kupumalam (€53.10 in chips) 
Seat 4: Painkiller72 (€150.76 in chips) 
Seat 6: matiko09 (€105.53 in chips) 
Seat 7: AlKatrone (€132.87 in chips) 
AlKatrone: posts small blind €0.50
IdiotFromNE: posts big blind €1
PacPacBum: sits out 
*** HOLE CARDS ***
Dealt to matiko09 [4s 8h]
Kupumalam: folds 
Painkiller72: folds 
matiko09: folds 
AlKatrone: folds 
Uncalled bet (€0.50) returned to IdiotFromNE
IdiotFromNE collected €1 from pot
IdiotFromNE: doesn't show hand 
*** SUMMARY ***
Total pot €1 | Rake €0 
Seat 2: IdiotFromNE (big blind) collected (€1)
Seat 3: Kupumalam folded before Flop (didn't bet)
Seat 4: Painkiller72 folded before Flop (didn't bet)
Seat 6: matiko09 (button) folded before Flop (didn't bet)
Seat 7: AlKatrone (small blind) folded before Flop





PokerStars Hand #151208139497:  Hold'em No Limit ($0.50/$1.00 USD) - 2016/03/31 12:52:10 CET [2016/03/31 6:52:10 ET]
Table 'Viipuri II' 9-max Seat #6 is the button
Seat 1: Muinmyheart ($101.30 in chips) 
Seat 2: futa317 ($74.23 in chips) 
Seat 3: Zeeshka ($100 in chips) 
Seat 4: Miner604 ($44.01 in chips) 
Seat 5: matiko09 ($100 in chips) 
Seat 6: PacPacBum ($100 in chips) 
Seat 7: vicdroopy ($100 in chips) 
Seat 8: ilaviiitech ($115.88 in chips) 
Seat 9: djammusic ($40 in chips) 
vicdroopy: posts small blind $0.50
ilaviiitech: posts big blind $1
*** HOLE CARDS ***
Dealt to matiko09 [6d 7d]
djammusic: folds 
Muinmyheart: folds 
futa317: folds 
Zeeshka: folds 
Miner604: calls $1
matiko09: raises $2.50 to $3.50
PacPacBum: folds 
vicdroopy: folds 
ilaviiitech: folds 
Miner604: calls $2.50
*** FLOP *** [7h 4d Qs]
Miner604: checks 
matiko09: bets $4.20
Miner604: folds 
Uncalled bet ($4.20) returned to matiko09
matiko09 collected $8.08 from pot
matiko09: doesn't show hand 
*** SUMMARY ***
Total pot $8.50 | Rake $0.42 
Board [7h 4d Qs]
Seat 1: Muinmyheart folded before Flop (didn't bet)
Seat 2: futa317 folded before Flop (didn't bet)
Seat 3: Zeeshka folded before Flop (didn't bet)
Seat 4: Miner604 folded on the Flop
Seat 5: matiko09 collected ($8.08)
Seat 6: PacPacBum (button) folded before Flop (didn't bet)
Seat 7: vicdroopy (small blind) folded before Flop
Seat 8: ilaviiitech (big blind) folded before Flop
Seat 9: djammusic folded before Flop (didn't bet)





PokerStars Hand #151208142896:  Hold'em No Limit ($0.50/$1.00 USD) - 2016/03/31 12:52:16 CET [2016/03/31 6:52:16 ET]
Table 'Egeria II' 9-max Seat #5 is the button
Seat 1: oscarleon ($122.53 in chips) 
Seat 2: I The King I ($186.03 in chips) 
Seat 3: Pvsx. ($115.64 in chips) 
Seat 4: matiko09 ($100 in chips) 
Seat 5: apfush ($134.50 in chips) 
Seat 6: DUkalisUA ($100 in chips) 
Seat 7: Reven9er ($154.46 in chips) 
Seat 8: Kreuznagel ($135.01 in chips) 
Seat 9: miracolix50 ($59.02 in chips) 
DUkalisUA: posts small blind $0.50
Reven9er: posts big blind $1
*** HOLE CARDS ***
Dealt to matiko09 [Ts Kh]
Kreuznagel: folds 
miracolix50: folds 
oscarleon: folds 
I The King I: folds 
Pvsx.: folds 
matiko09: raises $1.50 to $2.50
apfush: folds 
DUkalisUA: folds 
Reven9er: calls $1.50
*** FLOP *** [9c Qc 7d]
Reven9er: checks 
matiko09: checks 
*** TURN *** [9c Qc 7d] [8h]
Reven9er: checks 
matiko09: checks 
*** RIVER *** [9c Qc 7d 8h] [9s]
Reven9er: bets $2.61
matiko09: folds 
Uncalled bet ($2.61) returned to Reven9er
Reven9er collected $5.22 from pot
Reven9er: doesn't show hand 
*** SUMMARY ***
Total pot $5.50 | Rake $0.28 
Board [9c Qc 7d 8h 9s]
Seat 1: oscarleon folded before Flop (didn't bet)
Seat 2: I The King I folded before Flop (didn't bet)
Seat 3: Pvsx. folded before Flop (didn't bet)
Seat 4: matiko09 folded on the River
Seat 5: apfush (button) folded before Flop (didn't bet)
Seat 6: DUkalisUA (small blind) folded before Flop
Seat 7: Reven9er (big blind) collected ($5.22)
Seat 8: Kreuznagel folded before Flop (didn't bet)
Seat 9: miracolix50 folded before Flop (didn't bet)





PokerStars Hand #151208147536:  Hold'em No Limit ($0.50/$1.00 USD) - 2016/03/31 12:52:26 CET [2016/03/31 6:52:26 ET]
Table 'Icarus III' 9-max Seat #8 is the button
Seat 2: Painkiller72 ($100 in chips) 
Seat 3: RICKA16 ($124.74 in chips) 
Seat 5: I The King I ($110.75 in chips) 
Seat 6: djammusic ($46.08 in chips) 
Seat 7: oscarleon ($180.73 in chips) 
Seat 8: matiko09 ($102.62 in chips) 
Seat 9: apfush ($121.46 in chips) 
apfush: posts small blind $0.50
Painkiller72: posts big blind $1
*** HOLE CARDS ***
Dealt to matiko09 [5d 5c]
RICKA16: folds 
I The King I: folds 
djammusic: folds 
RICKA16 leaves the table
oscarleon: folds 
Avtovo joins the table at seat #3 
Avtovo leaves the table
matiko09: raises $1.27 to $2.27
apfush: folds 
dizzyryano79 leaves the table
Painkiller72: folds 
Uncalled bet ($1.27) returned to matiko09
ka100pka527 joins the table at seat #3 
matiko09 collected $2.50 from pot
matiko09: doesn't show hand 
*** SUMMARY ***
Total pot $2.50 | Rake $0 
Seat 2: Painkiller72 (big blind) folded before Flop
Seat 3: RICKA16 folded before Flop (didn't bet)
Seat 5: I The King I folded before Flop (didn't bet)
Seat 6: djammusic folded before Flop (didn't bet)
Seat 7: oscarleon folded before Flop (didn't bet)
Seat 8: matiko09 (button) collected ($2.50)
Seat 9: apfush (small blind) folded before Flop





PokerStars Hand #151208149354:  Hold'em No Limit (€0.50/€1.00 EUR) - 2016/03/31 12:52:30 CET [2016/03/31 6:52:30 ET]
Table 'Pioneer II' 9-max Seat #7 is the button
Seat 2: IdiotFromNE (€130.02 in chips) 
Seat 3: Kupumalam (€53.10 in chips) 
Seat 4: Painkiller72 (€150.76 in chips) 
Seat 6: matiko09 (€105.53 in chips) 
Seat 7: AlKatrone (€132.37 in chips) 
IdiotFromNE: posts small blind €0.50
Kupumalam: posts big blind €1
PacPacBum: sits out 
*** HOLE CARDS ***
Dealt to matiko09 [5c 2s]
Painkiller72: folds 
matiko09: folds 
AlKatrone: folds 
IdiotFromNE: raises €1.50 to €2.50
Kupumalam: raises €4.16 to €6.66
IdiotFromNE: folds 
Uncalled bet (€4.16) returned to Kupumalam
Kupumalam collected €5 from pot
*** SUMMARY ***
Total pot €5 | Rake €0 
Seat 2: IdiotFromNE (small blind) folded before Flop
Seat 3: Kupumalam (big blind) collected (€5)
Seat 4: Painkiller72 folded before Flop (didn't bet)
Seat 6: matiko09 folded before Flop (didn't bet)
Seat 7: AlKatrone (button) folded before Flop (didn't bet)





PokerStars Hand #151208149641:  Hold'em No Limit ($0.50/$1.00 USD) - 2016/03/31 12:52:30 CET [2016/03/31 6:52:30 ET]
Table 'Miriam' 9-max Seat #5 is the button
Seat 1: matiko09 ($104.12 in chips) 
Seat 2: ka100pka527 ($53.20 in chips) 
Seat 3: IdiotFromNE ($107.71 in chips) 
Seat 4: oscarleon ($144.53 in chips) 
Seat 5: Sutt_420 ($47.52 in chips) 
Seat 7: Zeeshka ($166.71 in chips) 
Seat 8: nobu-azabu ($132.05 in chips) 
Zeeshka: posts small blind $0.50
nobu-azabu: posts big blind $1
apfush: sits out 
*** HOLE CARDS ***
Dealt to matiko09 [As 7d]
matiko09: folds 
ka100pka527: folds 
IdiotFromNE: folds 
oscarleon: folds 
Sutt_420: raises $1 to $2
Zeeshka: folds 
nobu-azabu: calls $1
*** FLOP *** [Jd 6c Td]
nobu-azabu: checks 
Sutt_420: bets $3
nobu-azabu: calls $3
*** TURN *** [Jd 6c Td] [2s]
nobu-azabu: checks 
Sutt_420: checks 
*** RIVER *** [Jd 6c Td 2s] [4h]
nobu-azabu: bets $4.99
Sutt_420: calls $4.99
*** SHOW DOWN ***
nobu-azabu: shows [8s Jc] (a pair of Jacks)
Sutt_420: mucks hand 
nobu-azabu collected $19.46 from pot
*** SUMMARY ***
Total pot $20.48 | Rake $1.02 
Board [Jd 6c Td 2s 4h]
Seat 1: matiko09 folded before Flop (didn't bet)
Seat 2: ka100pka527 folded before Flop (didn't bet)
Seat 3: IdiotFromNE folded before Flop (didn't bet)
Seat 4: oscarleon folded before Flop (didn't bet)
Seat 5: Sutt_420 (button) mucked [Th Ah]
Seat 7: Zeeshka (small blind) folded before Flop
Seat 8: nobu-azabu (big blind) showed [8s Jc] and won ($19.46) with a pair of Jacks





PokerStars Hand #151208154751:  Hold'em No Limit ($0.50/$1.00 USD) - 2016/03/31 12:52:41 CET [2016/03/31 6:52:41 ET]
Table 'Viipuri II' 9-max Seat #7 is the button
Seat 1: Muinmyheart ($101.30 in chips) 
Seat 2: futa317 ($74.23 in chips) 
Seat 3: Zeeshka ($100 in chips) 
Seat 4: Miner604 ($40.51 in chips) 
Seat 5: matiko09 ($104.58 in chips) 
Seat 6: PacPacBum ($100 in chips) 
Seat 7: vicdroopy ($100 in chips) 
Seat 8: ilaviiitech ($114.88 in chips) 
Seat 9: djammusic ($40 in chips) 
ilaviiitech: posts small blind $0.50
djammusic: posts big blind $1
*** HOLE CARDS ***
Dealt to matiko09 [Jd 6d]
Muinmyheart: folds 
futa317: folds 
Zeeshka: folds 
Miner604: calls $1
matiko09: folds 
PacPacBum: folds 
vicdroopy: raises $3.50 to $4.50
ilaviiitech: raises $8 to $12.50
djammusic: folds 
Miner604: folds 
vicdroopy: folds 
Uncalled bet ($8) returned to ilaviiitech
ilaviiitech collected $11 from pot
ilaviiitech: doesn't show hand 
*** SUMMARY ***
Total pot $11 | Rake $0 
Seat 1: Muinmyheart folded before Flop (didn't bet)
Seat 2: futa317 folded before Flop (didn't bet)
Seat 3: Zeeshka folded before Flop (didn't bet)
Seat 4: Miner604 folded before Flop
Seat 5: matiko09 folded before Flop (didn't bet)
Seat 6: PacPacBum folded before Flop (didn't bet)
Seat 7: vicdroopy (button) folded before Flop
Seat 8: ilaviiitech (small blind) collected ($11)
Seat 9: djammusic (big blind) folded before Flop





PokerStars Hand #151208155783:  Hold'em No Limit ($0.50/$1.00 USD) - 2016/03/31 12:52:43 CET [2016/03/31 6:52:43 ET]
Table 'Aquila' 9-max Seat #3 is the button
Seat 1: BOAYARSKIY ($48.50 in chips) 
Seat 2: Avtovo ($100 in chips) 
Seat 3: Kreuznagel ($101 in chips) 
Seat 5: adelfaz ($72.58 in chips) 
Seat 7: PacPacBum ($116.50 in chips) 
Seat 8: matiko09 ($151.64 in chips) 
Seat 9: apfush ($111.40 in chips) 
adelfaz: posts small blind $0.50
PacPacBum: posts big blind $1
BOAYARSKIY: posts the ante $0.20
Avtovo: posts the ante $0.20
Kreuznagel: posts the ante $0.20
adelfaz: posts the ante $0.20
PacPacBum: posts the ante $0.20
matiko09: posts the ante $0.20
apfush: posts the ante $0.20
*** HOLE CARDS ***
Dealt to matiko09 [Th 3d]
matiko09: folds 
apfush: folds 
BOAYARSKIY: folds 
Avtovo: folds 
Kreuznagel: folds 
adelfaz: raises $2 to $3
PacPacBum: calls $2
*** FLOP *** [9d 2d Tc]
adelfaz: checks 
PacPacBum: bets $3.79
adelfaz: folds 
Uncalled bet ($3.79) returned to PacPacBum
PacPacBum collected $7.03 from pot
PacPacBum: doesn't show hand 
*** SUMMARY ***
Total pot $7.40 | Rake $0.37 
Board [9d 2d Tc]
Seat 1: BOAYARSKIY folded before Flop (didn't bet)
Seat 2: Avtovo folded before Flop (didn't bet)
Seat 3: Kreuznagel (button) folded before Flop (didn't bet)
Seat 5: adelfaz (small blind) folded on the Flop
Seat 7: PacPacBum (big blind) collected ($7.03)
Seat 8: matiko09 folded before Flop (didn't bet)
Seat 9: apfush folded before Flop (didn't bet)





PokerStars Hand #151208156503:  Hold'em No Limit ($0.50/$1.00 USD) - 2016/03/31 12:52:45 CET [2016/03/31 6:52:45 ET]
Table 'Yazhi' 9-max Seat #8 is the button
Seat 1: matiko09 ($103.18 in chips) 
Seat 2: xHourglass ($137.51 in chips) 
Seat 4: apfush ($163.83 in chips) 
Seat 5: IdiotFromNE ($101 in chips) 
Seat 6: Reven9er ($227.49 in chips) 
Seat 7: Avtovo ($100 in chips) 
Seat 8: pk4DW ($42.61 in chips) 
Seat 9: oscarleon ($198.23 in chips) 
oscarleon: posts small blind $0.50
matiko09: posts big blind $1
*** HOLE CARDS ***
Dealt to matiko09 [Kc Tc]
xHourglass: folds 
apfush: folds 
IdiotFromNE: folds 
Reven9er: folds 
Avtovo: folds 
pk4DW: folds 
oscarleon: folds 
Uncalled bet ($0.50) returned to matiko09
matiko09 collected $1 from pot
matiko09: doesn't show hand 
*** SUMMARY ***
Total pot $1 | Rake $0 
Seat 1: matiko09 (big blind) collected ($1)
Seat 2: xHourglass folded before Flop (didn't bet)
Seat 4: apfush folded before Flop (didn't bet)
Seat 5: IdiotFromNE folded before Flop (didn't bet)
Seat 6: Reven9er folded before Flop (didn't bet)
Seat 7: Avtovo folded before Flop (didn't bet)
Seat 8: pk4DW (button) folded before Flop (didn't bet)
Seat 9: oscarleon (small blind) folded before Flop





PokerStars Hand #151208158597:  Hold'em No Limit ($0.50/$1.00 USD) - 2016/03/31 12:52:49 CET [2016/03/31 6:52:49 ET]
Table 'Herge II' 9-max Seat #9 is the button
Seat 1: Chiapel ($81.92 in chips) 
Seat 3: matiko09 ($210.27 in chips) 
Seat 4: Kreuznagel ($100 in chips) 
Seat 5: I The King I ($135.23 in chips) 
Seat 6: masaytoo ($91.50 in chips) 
Seat 7: Zeeshka ($139.45 in chips) 
Seat 8: IdiotFromNE ($100 in chips) 
Seat 9: fatstacks122 ($154.46 in chips) 
Chiapel: posts small blind $0.50
DUkalisUA: is sitting out 
matiko09: posts big blind $1
*** HOLE CARDS ***
Dealt to matiko09 [As 5s]
DUkalisUA leaves the table
o.miro joins the table at seat #2 
Kreuznagel: raises $1.39 to $2.39
I The King I: folds 
masaytoo: folds 
Zeeshka: folds 
IdiotFromNE: folds 
fatstacks122: folds 
Chiapel: folds 
matiko09: calls $1.39
*** FLOP *** [8h 7d Tc]
matiko09: checks 
Kreuznagel: bets $2.76
matiko09: folds 
Uncalled bet ($2.76) returned to Kreuznagel
Kreuznagel collected $5.02 from pot
Kreuznagel: doesn't show hand 
*** SUMMARY ***
Total pot $5.28 | Rake $0.26 
Board [8h 7d Tc]
Seat 1: Chiapel (small blind) folded before Flop
Seat 3: matiko09 (big blind) folded on the Flop
Seat 4: Kreuznagel collected ($5.02)
Seat 5: I The King I folded before Flop (didn't bet)
Seat 6: masaytoo folded before Flop (didn't bet)
Seat 7: Zeeshka folded before Flop (didn't bet)
Seat 8: IdiotFromNE folded before Flop (didn't bet)
Seat 9: fatstacks122 (button) folded before Flop (didn't bet)





PokerStars Hand #151208160128:  Hold'em No Limit ($0.50/$1.00 USD) - 2016/03/31 12:52:52 CET [2016/03/31 6:52:52 ET]
Table 'Icarus III' 9-max Seat #9 is the button
Seat 2: Painkiller72 ($100 in chips) 
Seat 3: ka100pka527 ($40 in chips) 
Seat 5: I The King I ($110.75 in chips) 
Seat 6: djammusic ($46.08 in chips) 
Seat 7: oscarleon ($180.73 in chips) 
Seat 8: matiko09 ($104.12 in chips) 
Seat 9: apfush ($120.96 in chips) 
Painkiller72: posts small blind $0.50
ka100pka527: posts big blind $1
*** HOLE CARDS ***
Dealt to matiko09 [Qd Th]
I The King I: folds 
djammusic: raises $1.15 to $2.15
oscarleon: folds 
matiko09: folds 
vicdroopy joins the table at seat #4 
apfush: folds 
Painkiller72: folds 
ka100pka527: folds 
Uncalled bet ($1.15) returned to djammusic
djammusic collected $2.50 from pot
djammusic: doesn't show hand 
*** SUMMARY ***
Total pot $2.50 | Rake $0 
Seat 2: Painkiller72 (small blind) folded before Flop
Seat 3: ka100pka527 (big blind) folded before Flop
Seat 5: I The King I folded before Flop (didn't bet)
Seat 6: djammusic collected ($2.50)
Seat 7: oscarleon folded before Flop (didn't bet)
Seat 8: matiko09 folded before Flop (didn't bet)
Seat 9: apfush (button) folded before Flop (didn't bet)





PokerStars Hand #151208164361:  Hold'em No Limit ($0.50/$1.00 USD) - 2016/03/31 12:53:01 CET [2016/03/31 6:53:01 ET]
Table 'Haworth II' 9-max Seat #4 is the button
Seat 2: AlKatrone ($145.35 in chips) 
Seat 3: matiko09 ($100 in chips) 
Seat 4: I The King I ($116.02 in chips) 
Seat 5: Kreuznagel ($100 in chips) 
Seat 6: Pvsx. ($100 in chips) 
Seat 7: mheris ($138.74 in chips) 
Seat 8: oscarleon ($100 in chips) 
Seat 9: Zeeshka ($100 in chips) 
Kreuznagel: posts small blind $0.50
Pvsx.: posts big blind $1
*** HOLE CARDS ***
Dealt to matiko09 [8s 3s]
mheris: raises $3 to $4
oscarleon: folds 
Zeeshka: folds 
AlKatrone: folds 
matiko09: folds 
I The King I: calls $4
Kreuznagel: folds 
Pvsx.: folds 
*** FLOP *** [5h Ah 2s]
mheris: checks 
I The King I: checks 
*** TURN *** [5h Ah 2s] [6h]
mheris: bets $5
I The King I: calls $5
*** RIVER *** [5h Ah 2s 6h] [4d]
mheris: bets $11
I The King I: folds 
Uncalled bet ($11) returned to mheris
mheris collected $18.52 from pot
mheris: doesn't show hand 
*** SUMMARY ***
Total pot $19.50 | Rake $0.98 
Board [5h Ah 2s 6h 4d]
Seat 2: AlKatrone folded before Flop (didn't bet)
Seat 3: matiko09 folded before Flop (didn't bet)
Seat 4: I The King I (button) folded on the River
Seat 5: Kreuznagel (small blind) folded before Flop
Seat 6: Pvsx. (big blind) folded before Flop
Seat 7: mheris collected ($18.52)
Seat 8: oscarleon folded before Flop (didn't bet)
Seat 9: Zeeshka folded before Flop (didn't bet)





PokerStars Hand #151208166774:  Hold'em No Limit ($0.50/$1.00 USD) - 2016/03/31 12:53:06 CET [2016/03/31 6:53:06 ET]
Table 'Yazhi' 9-max Seat #9 is the button
Seat 1: matiko09 ($103.68 in chips) 
Seat 2: xHourglass ($137.51 in chips) 
Seat 4: apfush ($163.83 in chips) 
Seat 5: IdiotFromNE ($101 in chips) 
Seat 6: Reven9er ($227.49 in chips) 
Seat 7: Avtovo ($100 in chips) 
Seat 8: pk4DW ($42.61 in chips) 
Seat 9: oscarleon ($197.73 in chips) 
matiko09: posts small blind $0.50
xHourglass: posts big blind $1
*** HOLE CARDS ***
Dealt to matiko09 [4s Kh]
apfush: folds 
IdiotFromNE: folds 
Reven9er: folds 
Avtovo: folds 
pk4DW: folds 
oscarleon: raises $2 to $3
matiko09: folds 
xHourglass: folds 
Uncalled bet ($2) returned to oscarleon
oscarleon collected $2.50 from pot
oscarleon: doesn't show hand 
*** SUMMARY ***
Total pot $2.50 | Rake $0 
Seat 1: matiko09 (small blind) folded before Flop
Seat 2: xHourglass (big blind) folded before Flop
Seat 4: apfush folded before Flop (didn't bet)
Seat 5: IdiotFromNE folded before Flop (didn't bet)
Seat 6: Reven9er folded before Flop (didn't bet)
Seat 7: Avtovo folded before Flop (didn't bet)
Seat 8: pk4DW folded before Flop (didn't bet)
Seat 9: oscarleon (button) collected ($2.50)





PokerStars Hand #151208170037:  Hold'em No Limit ($1/$2 USD) - 2016/03/31 12:53:13 CET [2016/03/31 6:53:13 ET]
Table 'Delvaux II' 9-max Seat #6 is the button
Seat 6: quinters ($200 in chips) 
Seat 7: PacPacBum ($200 in chips) 
Seat 8: matiko09 ($200 in chips) 
Seat 9: o.miro ($200 in chips) 
Painkiller72 joins the table at seat #1 
PacPacBum: posts small blind $1
matiko09: posts big blind $2
*** HOLE CARDS ***
Dealt to matiko09 [Qc Ts]
o.miro: folds 
quinters: folds 
PacPacBum: folds 
Uncalled bet ($1) returned to matiko09
matiko09 collected $2 from pot
matiko09: doesn't show hand 
*** SUMMARY ***
Total pot $2 | Rake $0 
Seat 6: quinters (button) folded before Flop (didn't bet)
Seat 7: PacPacBum (small blind) folded before Flop
Seat 8: matiko09 (big blind) collected ($2)
Seat 9: o.miro folded before Flop (didn't bet)





PokerStars Hand #151208172329:  Hold'em No Limit (€0.50/€1.00 EUR) - 2016/03/31 12:53:17 CET [2016/03/31 6:53:17 ET]
Table 'Pioneer II' 9-max Seat #2 is the button
Seat 2: IdiotFromNE (€127.52 in chips) 
Seat 3: Kupumalam (€55.60 in chips) 
Seat 4: Painkiller72 (€150.76 in chips) 
Seat 6: matiko09 (€105.53 in chips) 
Seat 7: AlKatrone (€132.37 in chips) 
Kupumalam: posts small blind €0.50
Painkiller72: posts big blind €1
PacPacBum: sits out 
*** HOLE CARDS ***
Dealt to matiko09 [Ah 2s]
matiko09: folds 
AlKatrone: folds 
IdiotFromNE: folds 
Kupumalam: raises €2 to €3
Painkiller72: calls €2
*** FLOP *** [6c Kh Th]
Kupumalam: checks 
Painkiller72: checks 
*** TURN *** [6c Kh Th] [9c]
Kupumalam: checks 
Painkiller72: checks 
*** RIVER *** [6c Kh Th 9c] [2d]
Kupumalam: checks 
Painkiller72: checks 
*** SHOW DOWN ***
Kupumalam: shows [Qd Ac] (high card Ace)
Painkiller72: shows [Ad 6h] (a pair of Sixes)
Painkiller72 collected €5.70 from pot
*** SUMMARY ***
Total pot €6 | Rake €0.30 
Board [6c Kh Th 9c 2d]
Seat 2: IdiotFromNE (button) folded before Flop (didn't bet)
Seat 3: Kupumalam (small blind) showed [Qd Ac] and lost with high card Ace
Seat 4: Painkiller72 (big blind) showed [Ad 6h] and won (€5.70) with a pair of Sixes
Seat 6: matiko09 folded before Flop (didn't bet)
Seat 7: AlKatrone folded before Flop (didn't bet)





PokerStars Hand #151208174883:  Hold'em No Limit ($0.50/$1.00 USD) - 2016/03/31 12:53:23 CET [2016/03/31 6:53:23 ET]
Table 'Icarus III' 9-max Seat #2 is the button
Seat 2: Painkiller72 ($100 in chips) 
Seat 3: ka100pka527 ($39 in chips) 
Seat 5: I The King I ($110.75 in chips) 
Seat 6: djammusic ($47.58 in chips) 
Seat 7: oscarleon ($180.73 in chips) 
Seat 8: matiko09 ($104.12 in chips) 
Seat 9: apfush ($120.96 in chips) 
ka100pka527: posts small blind $0.50
I The King I: posts big blind $1
*** HOLE CARDS ***
Dealt to matiko09 [6h 9s]
djammusic: folds 
oscarleon: folds 
matiko09: folds 
apfush: folds 
Painkiller72: folds 
ka100pka527: raises $1 to $2
I The King I: calls $1
*** FLOP *** [Ts 8s 6s]
ka100pka527: checks 
I The King I: bets $3
ka100pka527: folds 
Uncalled bet ($3) returned to I The King I
I The King I collected $3.80 from pot
I The King I: doesn't show hand 
*** SUMMARY ***
Total pot $4 | Rake $0.20 
Board [Ts 8s 6s]
Seat 2: Painkiller72 (button) folded before Flop (didn't bet)
Seat 3: ka100pka527 (small blind) folded on the Flop
Seat 5: I The King I (big blind) collected ($3.80)
Seat 6: djammusic folded before Flop (didn't bet)
Seat 7: oscarleon folded before Flop (didn't bet)
Seat 8: matiko09 folded before Flop (didn't bet)
Seat 9: apfush folded before Flop (didn't bet)





PokerStars Hand #151208175185:  Hold'em No Limit ($0.50/$1.00 USD) - 2016/03/31 12:53:24 CET [2016/03/31 6:53:24 ET]
Table 'Viipuri II' 9-max Seat #8 is the button
Seat 1: Muinmyheart ($101.30 in chips) 
Seat 2: futa317 ($74.23 in chips) 
Seat 3: Zeeshka ($100 in chips) 
Seat 4: Miner604 ($39.51 in chips) 
Seat 5: matiko09 ($104.58 in chips) 
Seat 6: PacPacBum ($100 in chips) 
Seat 7: vicdroopy ($100 in chips) 
Seat 8: ilaviiitech ($121.38 in chips) 
Seat 9: djammusic ($39 in chips) 
djammusic: posts small blind $0.50
Muinmyheart: posts big blind $1
*** HOLE CARDS ***
Dealt to matiko09 [Kd Ah]
futa317: folds 
Zeeshka: folds 
Miner604: folds 
matiko09: raises $2 to $3
PacPacBum: folds 
vicdroopy: folds 
ilaviiitech: folds 
djammusic: folds 
Muinmyheart: folds 
Uncalled bet ($2) returned to matiko09
matiko09 collected $2.50 from pot
matiko09: doesn't show hand 
*** SUMMARY ***
Total pot $2.50 | Rake $0 
Seat 1: Muinmyheart (big blind) folded before Flop
Seat 2: futa317 folded before Flop (didn't bet)
Seat 3: Zeeshka folded before Flop (didn't bet)
Seat 4: Miner604 folded before Flop (didn't bet)
Seat 5: matiko09 collected ($2.50)
Seat 6: PacPacBum folded before Flop (didn't bet)
Seat 7: vicdroopy folded before Flop (didn't bet)
Seat 8: ilaviiitech (button) folded before Flop (didn't bet)
Seat 9: djammusic (small blind) folded before Flop





PokerStars Hand #151208177750:  Hold'em No Limit ($0.50/$1.00 USD) - 2016/03/31 12:53:29 CET [2016/03/31 6:53:29 ET]
Table 'Aquila' 9-max Seat #5 is the button
Seat 1: BOAYARSKIY ($48.30 in chips) 
Seat 2: Avtovo ($100 in chips) 
Seat 3: Kreuznagel ($100.80 in chips) 
Seat 5: adelfaz ($69.38 in chips) 
Seat 7: PacPacBum ($120.33 in chips) 
Seat 8: matiko09 ($151.44 in chips) 
Seat 9: apfush ($111.20 in chips) 
PacPacBum: posts small blind $0.50
matiko09: posts big blind $1
BOAYARSKIY: posts the ante $0.20
Avtovo: posts the ante $0.20
Kreuznagel: posts the ante $0.20
adelfaz: posts the ante $0.20
PacPacBum: posts the ante $0.20
matiko09: posts the ante $0.20
apfush: posts the ante $0.20
*** HOLE CARDS ***
Dealt to matiko09 [7d Qs]
apfush: folds 
BOAYARSKIY: folds 
Avtovo: folds 
Kreuznagel: folds 
adelfaz: folds 
PacPacBum: raises $1.50 to $2.50
matiko09: calls $1.50
*** FLOP *** [7h 7s Qd]
PacPacBum: checks 
matiko09: checks 
*** TURN *** [7h 7s Qd] [Jh]
PacPacBum: checks 
matiko09: bets $3.95
PacPacBum: folds 
Uncalled bet ($3.95) returned to matiko09
matiko09 collected $6.08 from pot
matiko09: doesn't show hand 
*** SUMMARY ***
Total pot $6.40 | Rake $0.32 
Board [7h 7s Qd Jh]
Seat 1: BOAYARSKIY folded before Flop (didn't bet)
Seat 2: Avtovo folded before Flop (didn't bet)
Seat 3: Kreuznagel folded before Flop (didn't bet)
Seat 5: adelfaz (button) folded before Flop (didn't bet)
Seat 7: PacPacBum (small blind) folded on the Turn
Seat 8: matiko09 (big blind) collected ($6.08)
Seat 9: apfush folded before Flop (didn't bet)





PokerStars Hand #151208179417:  Hold'em No Limit ($0.50/$1.00 USD) - 2016/03/31 12:53:32 CET [2016/03/31 6:53:32 ET]
Table 'Egeria II' 9-max Seat #6 is the button
Seat 1: oscarleon ($122.53 in chips) 
Seat 2: I The King I ($186.03 in chips) 
Seat 3: Pvsx. ($115.64 in chips) 
Seat 4: matiko09 ($100 in chips) 
Seat 5: apfush ($134.50 in chips) 
Seat 6: DUkalisUA ($100 in chips) 
Seat 7: Reven9er ($157.18 in chips) 
Seat 8: Kreuznagel ($135.01 in chips) 
Seat 9: miracolix50 ($59.02 in chips) 
Reven9er: posts small blind $0.50
Kreuznagel: posts big blind $1
*** HOLE CARDS ***
Dealt to matiko09 [7h 4c]
miracolix50: folds 
oscarleon: folds 
I The King I: folds 
Pvsx.: folds 
matiko09: folds 
apfush: folds 
DUkalisUA: raises $1 to $2
Reven9er: raises $4 to $6
Kreuznagel: raises $10 to $16
DUkalisUA: raises $84 to $100 and is all-in
Reven9er: folds 
Kreuznagel: folds 
Uncalled bet ($84) returned to DUkalisUA
DUkalisUA collected $38 from pot
DUkalisUA: doesn't show hand 
*** SUMMARY ***
Total pot $38 | Rake $0 
Seat 1: oscarleon folded before Flop (didn't bet)
Seat 2: I The King I folded before Flop (didn't bet)
Seat 3: Pvsx. folded before Flop (didn't bet)
Seat 4: matiko09 folded before Flop (didn't bet)
Seat 5: apfush folded before Flop (didn't bet)
Seat 6: DUkalisUA (button) collected ($38)
Seat 7: Reven9er (small blind) folded before Flop
Seat 8: Kreuznagel (big blind) folded before Flop
Seat 9: miracolix50 folded before Flop (didn't bet)





PokerStars Hand #151208179525:  Hold'em No Limit ($1/$2 USD) - 2016/03/31 12:53:33 CET [2016/03/31 6:53:33 ET]
Table 'Delvaux II' 9-max Seat #7 is the button
Seat 6: quinters ($200 in chips) 
Seat 7: PacPacBum ($200 in chips) 
Seat 8: matiko09 ($201 in chips) 
Seat 9: o.miro ($200 in chips) 
matiko09: posts small blind $1
o.miro: posts big blind $2
Painkiller72: sits out 
*** HOLE CARDS ***
Dealt to matiko09 [8d 9h]
quinters: folds 
PacPacBum: folds 
rmanjkeee joins the table at seat #2 
matiko09: raises $3 to $5
o.miro: calls $3
*** FLOP *** [2s 5c 3d]
matiko09: checks 
o.miro: checks 
*** TURN *** [2s 5c 3d] [6c]
matiko09: checks 
o.miro: checks 
*** RIVER *** [2s 5c 3d 6c] [Ts]
matiko09: checks 
o.miro: checks 
*** SHOW DOWN ***
matiko09: shows [8d 9h] (high card Ten)
o.miro: shows [Kc Qs] (high card King)
o.miro collected $9.50 from pot
*** SUMMARY ***
Total pot $10 | Rake $0.50 
Board [2s 5c 3d 6c Ts]
Seat 6: quinters folded before Flop (didn't bet)
Seat 7: PacPacBum (button) folded before Flop (didn't bet)
Seat 8: matiko09 (small blind) showed [8d 9h] and lost with high card Ten
Seat 9: o.miro (big blind) showed [Kc Qs] and won ($9.50) with high card King





PokerStars Hand #151208179874:  Hold'em No Limit ($1/$2 USD) - 2016/03/31 12:53:33 CET [2016/03/31 6:53:33 ET]
Table 'Probitas' 9-max Seat #9 is the button
Seat 1: rmanjkeee ($153.51 in chips) 
Seat 2: Avtovo ($200 in chips) 
Seat 3: azvazdam ($230.99 in chips) 
Seat 4: Painkiller72 ($218.21 in chips) 
Seat 5: matiko09 ($200 in chips) 
Seat 6: Kreuznagel ($455.33 in chips) 
Seat 7: coinflip_si ($295.53 in chips) 
Seat 8: BOAYARSKIY ($135.67 in chips) 
Seat 9: apfush ($303.99 in chips) 
rmanjkeee: posts small blind $1
Avtovo: posts big blind $2
*** HOLE CARDS ***
Dealt to matiko09 [8h 7c]
azvazdam: folds 
Painkiller72: raises $3 to $5
matiko09: folds 
Kreuznagel: folds 
coinflip_si: folds 
BOAYARSKIY: folds 
apfush: folds 
rmanjkeee: folds 
Avtovo: folds 
Uncalled bet ($3) returned to Painkiller72
Painkiller72 collected $5 from pot
Painkiller72: doesn't show hand 
*** SUMMARY ***
Total pot $5 | Rake $0 
Seat 1: rmanjkeee (small blind) folded before Flop
Seat 2: Avtovo (big blind) folded before Flop
Seat 3: azvazdam folded before Flop (didn't bet)
Seat 4: Painkiller72 collected ($5)
Seat 5: matiko09 folded before Flop (didn't bet)
Seat 6: Kreuznagel folded before Flop (didn't bet)
Seat 7: coinflip_si folded before Flop (didn't bet)
Seat 8: BOAYARSKIY folded before Flop (didn't bet)
Seat 9: apfush (button) folded before Flop (didn't bet)





PokerStars Hand #151208181417:  Hold'em No Limit ($0.50/$1.00 USD) - 2016/03/31 12:53:37 CET [2016/03/31 6:53:37 ET]
Table 'Herge II' 9-max Seat #1 is the button
Seat 1: Chiapel ($81.42 in chips) 
Seat 3: matiko09 ($207.88 in chips) 
Seat 4: Kreuznagel ($102.63 in chips) 
Seat 5: I The King I ($135.23 in chips) 
Seat 6: masaytoo ($91.50 in chips) 
Seat 7: Zeeshka ($139.45 in chips) 
Seat 8: IdiotFromNE ($100 in chips) 
Seat 9: fatstacks122 ($154.46 in chips) 
o.miro will be allowed to play after the button
matiko09: posts small blind $0.50
Kreuznagel: posts big blind $1
*** HOLE CARDS ***
Dealt to matiko09 [Ad 4s]
I The King I: folds 
masaytoo: folds 
Zeeshka: folds 
IdiotFromNE: raises $1.50 to $2.50
fatstacks122: folds 
Chiapel: folds 
matiko09: folds 
Kreuznagel: folds 
Uncalled bet ($1.50) returned to IdiotFromNE
IdiotFromNE collected $2.50 from pot
IdiotFromNE: doesn't show hand 
*** SUMMARY ***
Total pot $2.50 | Rake $0 
Seat 1: Chiapel (button) folded before Flop (didn't bet)
Seat 3: matiko09 (small blind) folded before Flop
Seat 4: Kreuznagel (big blind) folded before Flop
Seat 5: I The King I folded before Flop (didn't bet)
Seat 6: masaytoo folded before Flop (didn't bet)
Seat 7: Zeeshka folded before Flop (didn't bet)
Seat 8: IdiotFromNE collected ($2.50)
Seat 9: fatstacks122 folded before Flop (didn't bet)





PokerStars Hand #151208184182:  Hold'em No Limit ($1/$2 USD) - 2016/03/31 12:53:42 CET [2016/03/31 6:53:42 ET]
Table 'Coelestina II' 9-max Seat #8 is the button
Seat 1: PacPacBum ($205.05 in chips) 
Seat 2: Kreuznagel ($223.05 in chips) 
Seat 3: ilaviiitech ($200 in chips) 
Seat 4: matiko09 ($221.72 in chips) 
Seat 5: Painkiller72 ($200 in chips) 
Seat 6: Avtovo ($235.07 in chips) 
Seat 7: rmanjkeee ($105 in chips) 
Seat 8: DUkalisUA ($229.31 in chips) 
Seat 9: fonng ($168.45 in chips) 
fonng: posts small blind $1
PacPacBum: posts big blind $2
*** HOLE CARDS ***
Dealt to matiko09 [2c 7d]
Kreuznagel: raises $2.78 to $4.78
ilaviiitech: folds 
matiko09: folds 
Painkiller72: folds 
Avtovo: folds 
rmanjkeee: folds 
DUkalisUA: folds 
fonng: folds 
PacPacBum: folds 
Uncalled bet ($2.78) returned to Kreuznagel
Kreuznagel collected $5 from pot
Kreuznagel: doesn't show hand 
*** SUMMARY ***
Total pot $5 | Rake $0 
Seat 1: PacPacBum (big blind) folded before Flop
Seat 2: Kreuznagel collected ($5)
Seat 3: ilaviiitech folded before Flop (didn't bet)
Seat 4: matiko09 folded before Flop (didn't bet)
Seat 5: Painkiller72 folded before Flop (didn't bet)
Seat 6: Avtovo folded before Flop (didn't bet)
Seat 7: rmanjkeee folded before Flop (didn't bet)
Seat 8: DUkalisUA (button) folded before Flop (didn't bet)
Seat 9: fonng (small blind) folded before Flop





PokerStars Hand #151208184820:  Hold'em No Limit ($0.50/$1.00 USD) - 2016/03/31 12:53:43 CET [2016/03/31 6:53:43 ET]
Table 'Yazhi' 9-max Seat #1 is the button
Seat 1: matiko09 ($103.18 in chips) 
Seat 2: xHourglass ($136.51 in chips) 
Seat 4: apfush ($163.83 in chips) 
Seat 5: IdiotFromNE ($101 in chips) 
Seat 6: Reven9er ($227.49 in chips) 
Seat 7: Avtovo ($100 in chips) 
Seat 8: pk4DW ($42.61 in chips) 
Seat 9: oscarleon ($199.23 in chips) 
xHourglass: posts small blind $0.50
apfush: posts big blind $1
*** HOLE CARDS ***
Dealt to matiko09 [Jc 8s]
IdiotFromNE: folds 
Reven9er: folds 
Avtovo: folds 
pk4DW: folds 
oscarleon: folds 
matiko09: raises $1.27 to $2.27
xHourglass: folds 
apfush: raises $6.23 to $8.50
matiko09: folds 
Uncalled bet ($6.23) returned to apfush
apfush collected $5.04 from pot
apfush: doesn't show hand 
*** SUMMARY ***
Total pot $5.04 | Rake $0 
Seat 1: matiko09 (button) folded before Flop
Seat 2: xHourglass (small blind) folded before Flop
Seat 4: apfush (big blind) collected ($5.04)
Seat 5: IdiotFromNE folded before Flop (didn't bet)
Seat 6: Reven9er folded before Flop (didn't bet)
Seat 7: Avtovo folded before Flop (didn't bet)
Seat 8: pk4DW folded before Flop (didn't bet)
Seat 9: oscarleon folded before Flop (didn't bet)





PokerStars Hand #151208192131:  Hold'em No Limit ($0.50/$1.00 USD) - 2016/03/31 12:53:59 CET [2016/03/31 6:53:59 ET]
Table 'Viipuri II' 9-max Seat #9 is the button
Seat 1: Muinmyheart ($100.30 in chips) 
Seat 2: futa317 ($74.23 in chips) 
Seat 3: Zeeshka ($100 in chips) 
Seat 4: Miner604 ($39.51 in chips) 
Seat 5: matiko09 ($106.08 in chips) 
Seat 6: PacPacBum ($100 in chips) 
Seat 7: vicdroopy ($100 in chips) 
Seat 8: ilaviiitech ($121.38 in chips) 
Seat 9: djammusic ($38.50 in chips) 
Muinmyheart: posts small blind $0.50
futa317: posts big blind $1
*** HOLE CARDS ***
Dealt to matiko09 [9s 5s]
Zeeshka: folds 
Miner604: folds 
matiko09: folds 
PacPacBum: raises $1.04 to $2.04
vicdroopy: folds 
ilaviiitech: folds 
djammusic: folds 
Muinmyheart: calls $1.54
futa317: calls $1.04
*** FLOP *** [2s Tc 4s]
Muinmyheart: checks 
futa317: checks 
PacPacBum: bets $3.13
Muinmyheart: folds 
futa317: folds 
Uncalled bet ($3.13) returned to PacPacBum
PacPacBum collected $5.81 from pot
PacPacBum: doesn't show hand 
*** SUMMARY ***
Total pot $6.12 | Rake $0.31 
Board [2s Tc 4s]
Seat 1: Muinmyheart (small blind) folded on the Flop
Seat 2: futa317 (big blind) folded on the Flop
Seat 3: Zeeshka folded before Flop (didn't bet)
Seat 4: Miner604 folded before Flop (didn't bet)
Seat 5: matiko09 folded before Flop (didn't bet)
Seat 6: PacPacBum collected ($5.81)
Seat 7: vicdroopy folded before Flop (didn't bet)
Seat 8: ilaviiitech folded before Flop (didn't bet)
Seat 9: djammusic (button) folded before Flop (didn't bet)





PokerStars Hand #151208193318:  Hold'em No Limit (€0.50/€1.00 EUR) - 2016/03/31 12:54:01 CET [2016/03/31 6:54:01 ET]
Table 'Pioneer II' 9-max Seat #3 is the button
Seat 2: IdiotFromNE (€127.52 in chips) 
Seat 3: Kupumalam (€52.60 in chips) 
Seat 4: Painkiller72 (€153.46 in chips) 
Seat 5: PacPacBum (€106.22 in chips) 
Seat 6: matiko09 (€105.53 in chips) 
Seat 7: AlKatrone (€132.37 in chips) 
Painkiller72: posts small blind €0.50
PacPacBum: posts big blind €1
*** HOLE CARDS ***
Dealt to matiko09 [6s 3c]
matiko09: folds 
AlKatrone: folds 
IdiotFromNE: raises €1.50 to €2.50
Kupumalam: folds 
Painkiller72: folds 
PacPacBum: folds 
Uncalled bet (€1.50) returned to IdiotFromNE
IdiotFromNE collected €2.50 from pot
IdiotFromNE: doesn't show hand 
*** SUMMARY ***
Total pot €2.50 | Rake €0 
Seat 2: IdiotFromNE collected (€2.50)
Seat 3: Kupumalam (button) folded before Flop (didn't bet)
Seat 4: Painkiller72 (small blind) folded before Flop
Seat 5: PacPacBum (big blind) folded before Flop
Seat 6: matiko09 folded before Flop (didn't bet)
Seat 7: AlKatrone folded before Flop (didn't bet)





PokerStars Hand #151208196712:  Hold'em No Limit ($1/$2 USD) - 2016/03/31 12:54:08 CET [2016/03/31 6:54:08 ET]
Table 'Probitas' 9-max Seat #1 is the button
Seat 1: rmanjkeee ($152.51 in chips) 
Seat 2: Avtovo ($200 in chips) 
Seat 3: azvazdam ($230.99 in chips) 
Seat 4: Painkiller72 ($221.21 in chips) 
Seat 5: matiko09 ($200 in chips) 
Seat 6: Kreuznagel ($455.33 in chips) 
Seat 7: coinflip_si ($295.53 in chips) 
Seat 8: BOAYARSKIY ($135.67 in chips) 
Seat 9: apfush ($303.99 in chips) 
Avtovo: posts small blind $1
azvazdam: posts big blind $2
*** HOLE CARDS ***
Dealt to matiko09 [Ac 7s]
Painkiller72: folds 
matiko09: folds 
Kreuznagel: folds 
coinflip_si: folds 
BOAYARSKIY: folds 
apfush: folds 
rmanjkeee: raises $2 to $4
Avtovo: raises $11 to $15
azvazdam: folds 
rmanjkeee: raises $15 to $30
Avtovo: raises $170 to $200 and is all-in
rmanjkeee: calls $122.51 and is all-in
Uncalled bet ($47.49) returned to Avtovo
*** FIRST FLOP *** [Th 9c Kd]
*** FIRST TURN *** [Th 9c Kd] [Ts]
*** FIRST RIVER *** [Th 9c Kd Ts] [3s]
*** SECOND FLOP *** [5d 4c 3d]
*** SECOND TURN *** [5d 4c 3d] [5h]
*** SECOND RIVER *** [5d 4c 3d 5h] [8c]
*** FIRST SHOW DOWN ***
Avtovo: shows [Jc Jd] (two pair, Jacks and Tens)
rmanjkeee: shows [Ah Ad] (two pair, Aces and Tens)
rmanjkeee collected $152.14 from pot
*** SECOND SHOW DOWN ***
Avtovo: shows [Jc Jd] (two pair, Jacks and Fives)
rmanjkeee: shows [Ah Ad] (two pair, Aces and Fives)
rmanjkeee collected $152.13 from pot
*** SUMMARY ***
Total pot $307.02 | Rake $2.75 
Hand was run twice
FIRST Board [Th 9c Kd Ts 3s]
SECOND Board [5d 4c 3d 5h 8c]
Seat 1: rmanjkeee (button) showed [Ah Ad] and won ($152.14) with two pair, Aces and Tens, and won ($152.13) with two pair, Aces and Fives
Seat 2: Avtovo (small blind) showed [Jc Jd] and lost with two pair, Jacks and Tens, and lost with two pair, Jacks and Fives
Seat 3: azvazdam (big blind) folded before Flop
Seat 4: Painkiller72 folded before Flop (didn't bet)
Seat 5: matiko09 folded before Flop (didn't bet)
Seat 6: Kreuznagel folded before Flop (didn't bet)
Seat 7: coinflip_si folded before Flop (didn't bet)
Seat 8: BOAYARSKIY folded before Flop (didn't bet)
Seat 9: apfush folded before Flop (didn't bet)





PokerStars Hand #151208200262:  Hold'em No Limit ($0.50/$1.00 USD) - 2016/03/31 12:54:15 CET [2016/03/31 6:54:15 ET]
Table 'Herge II' 9-max Seat #3 is the button
Seat 1: Chiapel ($100 in chips) 
Seat 3: matiko09 ($207.38 in chips) 
Seat 4: Kreuznagel ($101.63 in chips) 
Seat 5: I The King I ($135.23 in chips) 
Seat 6: masaytoo ($91.50 in chips) 
Seat 7: Zeeshka ($139.45 in chips) 
Seat 8: IdiotFromNE ($101.50 in chips) 
Seat 9: fatstacks122 ($154.46 in chips) 
Kreuznagel: posts small blind $0.50
I The King I: posts big blind $1
o.miro: sits out 
*** HOLE CARDS ***
Dealt to matiko09 [5s 8h]
masaytoo: folds 
Zeeshka: folds 
IdiotFromNE: raises $1.50 to $2.50
fatstacks122: folds 
Chiapel: folds 
matiko09: folds 
Kreuznagel: folds 
I The King I: folds 
Uncalled bet ($1.50) returned to IdiotFromNE
IdiotFromNE collected $2.50 from pot
IdiotFromNE: doesn't show hand 
*** SUMMARY ***
Total pot $2.50 | Rake $0 
Seat 1: Chiapel folded before Flop (didn't bet)
Seat 3: matiko09 (button) folded before Flop (didn't bet)
Seat 4: Kreuznagel (small blind) folded before Flop
Seat 5: I The King I (big blind) folded before Flop
Seat 6: masaytoo folded before Flop (didn't bet)
Seat 7: Zeeshka folded before Flop (didn't bet)
Seat 8: IdiotFromNE collected ($2.50)
Seat 9: fatstacks122 folded before Flop (didn't bet)





PokerStars Hand #151208200663:  Hold'em No Limit ($1/$2 USD) - 2016/03/31 12:54:16 CET [2016/03/31 6:54:16 ET]
Table 'Coelestina II' 9-max Seat #9 is the button
Seat 1: PacPacBum ($203.05 in chips) 
Seat 2: Kreuznagel ($226.05 in chips) 
Seat 3: ilaviiitech ($200 in chips) 
Seat 4: matiko09 ($221.72 in chips) 
Seat 5: Painkiller72 ($200 in chips) 
Seat 6: Avtovo ($235.07 in chips) 
Seat 7: rmanjkeee ($105 in chips) 
Seat 8: DUkalisUA ($229.31 in chips) 
Seat 9: fonng ($167.45 in chips) 
PacPacBum: posts small blind $1
Kreuznagel: posts big blind $2
*** HOLE CARDS ***
Dealt to matiko09 [4d 6d]
ilaviiitech: raises $4 to $6
matiko09: folds 
Painkiller72: folds 
Avtovo: folds 
rmanjkeee: folds 
DUkalisUA: folds 
fonng: calls $6
PacPacBum: folds 
Kreuznagel: folds 
*** FLOP *** [6c 7d 2s]
ilaviiitech: bets $9.97
fonng: raises $9.97 to $19.94
ilaviiitech: calls $9.97
*** TURN *** [6c 7d 2s] [5c]
ilaviiitech: checks 
fonng: bets $52
ilaviiitech: folds 
Uncalled bet ($52) returned to fonng
fonng collected $52.14 from pot
fonng: doesn't show hand 
*** SUMMARY ***
Total pot $54.88 | Rake $2.74 
Board [6c 7d 2s 5c]
Seat 1: PacPacBum (small blind) folded before Flop
Seat 2: Kreuznagel (big blind) folded before Flop
Seat 3: ilaviiitech folded on the Turn
Seat 4: matiko09 folded before Flop (didn't bet)
Seat 5: Painkiller72 folded before Flop (didn't bet)
Seat 6: Avtovo folded before Flop (didn't bet)
Seat 7: rmanjkeee folded before Flop (didn't bet)
Seat 8: DUkalisUA folded before Flop (didn't bet)
Seat 9: fonng (button) collected ($52.14)





PokerStars Hand #151208202521:  Hold'em No Limit ($1/$2 USD) - 2016/03/31 12:54:20 CET [2016/03/31 6:54:20 ET]
Table 'Delvaux II' 9-max Seat #8 is the button
Seat 1: Painkiller72 ($200 in chips) 
Seat 6: quinters ($200 in chips) 
Seat 7: PacPacBum ($200 in chips) 
Seat 8: matiko09 ($200 in chips) 
Seat 9: o.miro ($204.50 in chips) 
o.miro: posts small blind $1
Painkiller72: posts big blind $2
rmanjkeee: sits out 
*** HOLE CARDS ***
Dealt to matiko09 [Ad 6s]
quinters: raises $3 to $5
PacPacBum: folds 
matiko09: folds 
o.miro: folds 
Painkiller72: folds 
Uncalled bet ($3) returned to quinters
quinters collected $5 from pot
quinters: doesn't show hand 
*** SUMMARY ***
Total pot $5 | Rake $0 
Seat 1: Painkiller72 (big blind) folded before Flop
Seat 6: quinters collected ($5)
Seat 7: PacPacBum folded before Flop (didn't bet)
Seat 8: matiko09 (button) folded before Flop (didn't bet)
Seat 9: o.miro (small blind) folded before Flop





PokerStars Hand #151208203679:  Hold'em No Limit (€0.50/€1.00 EUR) - 2016/03/31 12:54:22 CET [2016/03/31 6:54:22 ET]
Table 'Pioneer II' 9-max Seat #4 is the button
Seat 2: IdiotFromNE (€129.02 in chips) 
Seat 3: Kupumalam (€52.60 in chips) 
Seat 4: Painkiller72 (€152.96 in chips) 
Seat 5: PacPacBum (€105.22 in chips) 
Seat 6: matiko09 (€105.53 in chips) 
Seat 7: AlKatrone (€132.37 in chips) 
PacPacBum: posts small blind €0.50
matiko09: posts big blind €1
*** HOLE CARDS ***
Dealt to matiko09 [Td 6s]
AlKatrone: folds 
IdiotFromNE: folds 
Kupumalam: raises €2 to €3
Painkiller72: folds 
PacPacBum: folds 
matiko09: folds 
Uncalled bet (€2) returned to Kupumalam
Kupumalam collected €2.50 from pot
*** SUMMARY ***
Total pot €2.50 | Rake €0 
Seat 2: IdiotFromNE folded before Flop (didn't bet)
Seat 3: Kupumalam collected (€2.50)
Seat 4: Painkiller72 (button) folded before Flop (didn't bet)
Seat 5: PacPacBum (small blind) folded before Flop
Seat 6: matiko09 (big blind) folded before Flop
Seat 7: AlKatrone folded before Flop (didn't bet)





PokerStars Hand #151208208001:  Hold'em No Limit ($0.50/$1.00 USD) - 2016/03/31 12:54:31 CET [2016/03/31 6:54:31 ET]
Table 'Yazhi' 9-max Seat #2 is the button
Seat 1: matiko09 ($100.91 in chips) 
Seat 2: xHourglass ($136.01 in chips) 
Seat 4: apfush ($166.60 in chips) 
Seat 5: IdiotFromNE ($101 in chips) 
Seat 6: Reven9er ($227.49 in chips) 
Seat 7: Avtovo ($100 in chips) 
Seat 8: pk4DW ($42.61 in chips) 
Seat 9: oscarleon ($199.23 in chips) 
Chin41178 will be allowed to play after the button
apfush: posts small blind $0.50
IdiotFromNE: posts big blind $1
*** HOLE CARDS ***
Dealt to matiko09 [9s Qh]
Reven9er: folds 
Avtovo: folds 
pk4DW: folds 
oscarleon: folds 
matiko09: folds 
xHourglass: folds 
apfush: raises $2 to $3
IdiotFromNE: raises $6 to $9
apfush: raises $14.50 to $23.50
IdiotFromNE: raises $77.50 to $101 and is all-in
apfush: folds 
Uncalled bet ($77.50) returned to IdiotFromNE
IdiotFromNE collected $47 from pot
IdiotFromNE: doesn't show hand 
*** SUMMARY ***
Total pot $47 | Rake $0 
Seat 1: matiko09 folded before Flop (didn't bet)
Seat 2: xHourglass (button) folded before Flop (didn't bet)
Seat 4: apfush (small blind) folded before Flop
Seat 5: IdiotFromNE (big blind) collected ($47)
Seat 6: Reven9er folded before Flop (didn't bet)
Seat 7: Avtovo folded before Flop (didn't bet)
Seat 8: pk4DW folded before Flop (didn't bet)
Seat 9: oscarleon folded before Flop (didn't bet)





PokerStars Hand #151208211813:  Hold'em No Limit ($0.50/$1.00 USD) - 2016/03/31 12:54:39 CET [2016/03/31 6:54:39 ET]
Table 'Aquila' 9-max Seat #7 is the button
Seat 1: BOAYARSKIY ($48.10 in chips) 
Seat 2: Avtovo ($100 in chips) 
Seat 3: Kreuznagel ($100.60 in chips) 
Seat 5: adelfaz ($69.18 in chips) 
Seat 7: PacPacBum ($117.63 in chips) 
Seat 8: matiko09 ($154.82 in chips) 
Seat 9: apfush ($111 in chips) 
matiko09: posts small blind $0.50
apfush: posts big blind $1
BOAYARSKIY: posts the ante $0.20
Avtovo: posts the ante $0.20
Kreuznagel: posts the ante $0.20
adelfaz: posts the ante $0.20
PacPacBum: posts the ante $0.20
matiko09: posts the ante $0.20
apfush: posts the ante $0.20
*** HOLE CARDS ***
Dealt to matiko09 [Th Jd]
BOAYARSKIY: folds 
Avtovo: folds 
Kreuznagel: raises $1.39 to $2.39
adelfaz: calls $2.39
PacPacBum: folds 
matiko09: folds 
apfush: folds 
*** FLOP *** [Jc 9d 4s]
Kreuznagel: checks 
adelfaz: checks 
*** TURN *** [Jc 9d 4s] [Js]
Kreuznagel: bets $4.09
adelfaz: calls $4.09
*** RIVER *** [Jc 9d 4s Js] [Qh]
Kreuznagel: checks 
adelfaz: checks 
*** SHOW DOWN ***
Kreuznagel: shows [9h Kh] (two pair, Jacks and Nines)
adelfaz: mucks hand 
Kreuznagel collected $15.07 from pot
*** SUMMARY ***
Total pot $15.86 | Rake $0.79 
Board [Jc 9d 4s Js Qh]
Seat 1: BOAYARSKIY folded before Flop (didn't bet)
Seat 2: Avtovo folded before Flop (didn't bet)
Seat 3: Kreuznagel showed [9h Kh] and won ($15.07) with two pair, Jacks and Nines
Seat 5: adelfaz mucked [Ah 8c]
Seat 7: PacPacBum (button) folded before Flop (didn't bet)
Seat 8: matiko09 (small blind) folded before Flop
Seat 9: apfush (big blind) folded before Flop





PokerStars Hand #151208213005:  Hold'em No Limit ($1/$2 USD) - 2016/03/31 12:54:42 CET [2016/03/31 6:54:42 ET]
Table 'Delvaux II' 9-max Seat #9 is the button
Seat 1: Painkiller72 ($200 in chips) 
Seat 2: rmanjkeee ($80 in chips) 
Seat 6: quinters ($203 in chips) 
Seat 7: PacPacBum ($200 in chips) 
Seat 8: matiko09 ($200 in chips) 
Seat 9: o.miro ($203.50 in chips) 
Painkiller72: posts small blind $1
rmanjkeee: posts big blind $2
*** HOLE CARDS ***
Dealt to matiko09 [3s Qs]
quinters: raises $3 to $5
PacPacBum: folds 
matiko09: folds 
o.miro: folds 
Painkiller72: folds 
Avtovo joins the table at seat #3 
rmanjkeee: folds 
Uncalled bet ($3) returned to quinters
quinters collected $5 from pot
quinters: doesn't show hand 
*** SUMMARY ***
Total pot $5 | Rake $0 
Seat 1: Painkiller72 (small blind) folded before Flop
Seat 2: rmanjkeee (big blind) folded before Flop
Seat 6: quinters collected ($5)
Seat 7: PacPacBum folded before Flop (didn't bet)
Seat 8: matiko09 folded before Flop (didn't bet)
Seat 9: o.miro (button) folded before Flop (didn't bet)





PokerStars Hand #151208213561:  Hold'em No Limit ($0.50/$1.00 USD) - 2016/03/31 12:54:43 CET [2016/03/31 6:54:43 ET]
Table 'Haworth II' 9-max Seat #5 is the button
Seat 2: AlKatrone ($145.35 in chips) 
Seat 3: matiko09 ($100 in chips) 
Seat 4: I The King I ($107.02 in chips) 
Seat 5: Kreuznagel ($100 in chips) 
Seat 6: Pvsx. ($100 in chips) 
Seat 7: mheris ($148.26 in chips) 
Seat 8: oscarleon ($100 in chips) 
Seat 9: Zeeshka ($100 in chips) 
Pvsx.: posts small blind $0.50
mheris: posts big blind $1
godfrey004: sits out 
*** HOLE CARDS ***
Dealt to matiko09 [Th 2s]
oscarleon: folds 
Zeeshka: folds 
AlKatrone: raises $2 to $3
matiko09: folds 
I The King I: folds 
Kreuznagel: folds 
Pvsx.: calls $2.50
mheris: folds 
*** FLOP *** [4c 2d 4h]
Pvsx.: checks 
AlKatrone: checks 
*** TURN *** [4c 2d 4h] [7h]
Pvsx.: bets $3.32
AlKatrone: folds 
Uncalled bet ($3.32) returned to Pvsx.
Pvsx. collected $6.65 from pot
Pvsx.: doesn't show hand 
*** SUMMARY ***
Total pot $7 | Rake $0.35 
Board [4c 2d 4h 7h]
Seat 2: AlKatrone folded on the Turn
Seat 3: matiko09 folded before Flop (didn't bet)
Seat 4: I The King I folded before Flop (didn't bet)
Seat 5: Kreuznagel (button) folded before Flop (didn't bet)
Seat 6: Pvsx. (small blind) collected ($6.65)
Seat 7: mheris (big blind) folded before Flop
Seat 8: oscarleon folded before Flop (didn't bet)
Seat 9: Zeeshka folded before Flop (didn't bet)





PokerStars Hand #151208214399:  Hold'em No Limit (€0.50/€1.00 EUR) - 2016/03/31 12:54:44 CET [2016/03/31 6:54:44 ET]
Table 'Pioneer II' 9-max Seat #5 is the button
Seat 2: IdiotFromNE (€129.02 in chips) 
Seat 3: Kupumalam (€54.10 in chips) 
Seat 4: Painkiller72 (€152.96 in chips) 
Seat 5: PacPacBum (€104.72 in chips) 
Seat 6: matiko09 (€104.53 in chips) 
Seat 7: AlKatrone (€132.37 in chips) 
matiko09: posts small blind €0.50
AlKatrone: posts big blind €1
*** HOLE CARDS ***
Dealt to matiko09 [6h 5s]
IdiotFromNE: folds 
Kupumalam: folds 
Painkiller72: folds 
PacPacBum: folds 
matiko09: folds 
Uncalled bet (€0.50) returned to AlKatrone
AlKatrone collected €1 from pot
AlKatrone: doesn't show hand 
*** SUMMARY ***
Total pot €1 | Rake €0 
Seat 2: IdiotFromNE folded before Flop (didn't bet)
Seat 3: Kupumalam folded before Flop (didn't bet)
Seat 4: Painkiller72 folded before Flop (didn't bet)
Seat 5: PacPacBum (button) folded before Flop (didn't bet)
Seat 6: matiko09 (small blind) folded before Flop
Seat 7: AlKatrone (big blind) collected (€1)





PokerStars Hand #151208218419:  Hold'em No Limit ($0.50/$1.00 USD) - 2016/03/31 12:54:53 CET [2016/03/31 6:54:53 ET]
Table 'Herge II' 9-max Seat #4 is the button
Seat 1: Chiapel ($100 in chips) 
Seat 3: matiko09 ($207.38 in chips) 
Seat 4: Kreuznagel ($101.13 in chips) 
Seat 5: I The King I ($134.23 in chips) 
Seat 6: masaytoo ($91.50 in chips) 
Seat 7: Zeeshka ($139.45 in chips) 
Seat 8: IdiotFromNE ($103 in chips) 
Seat 9: fatstacks122 ($154.46 in chips) 
I The King I: posts small blind $0.50
masaytoo: posts big blind $1
o.miro: sits out 
*** HOLE CARDS ***
Dealt to matiko09 [Ac 6c]
Zeeshka: folds 
IdiotFromNE: folds 
fatstacks122: folds 
Chiapel: folds 
matiko09: raises $1.50 to $2.50
Kreuznagel: folds 
I The King I: folds 
masaytoo: calls $1.50
*** FLOP *** [9c Jc 4d]
masaytoo: checks 
matiko09: bets $3.39
masaytoo: folds 
Uncalled bet ($3.39) returned to matiko09
matiko09 collected $5.22 from pot
matiko09: doesn't show hand 
*** SUMMARY ***
Total pot $5.50 | Rake $0.28 
Board [9c Jc 4d]
Seat 1: Chiapel folded before Flop (didn't bet)
Seat 3: matiko09 collected ($5.22)
Seat 4: Kreuznagel (button) folded before Flop (didn't bet)
Seat 5: I The King I (small blind) folded before Flop
Seat 6: masaytoo (big blind) folded on the Flop
Seat 7: Zeeshka folded before Flop (didn't bet)
Seat 8: IdiotFromNE folded before Flop (didn't bet)
Seat 9: fatstacks122 folded before Flop (didn't bet)





PokerStars Hand #151208222414:  Hold'em No Limit ($0.50/$1.00 USD) - 2016/03/31 12:55:01 CET [2016/03/31 6:55:01 ET]
Table 'Egeria II' 9-max Seat #7 is the button
Seat 1: oscarleon ($122.53 in chips) 
Seat 2: I The King I ($186.03 in chips) 
Seat 3: Pvsx. ($115.64 in chips) 
Seat 4: matiko09 ($100 in chips) 
Seat 5: apfush ($134.50 in chips) 
Seat 6: DUkalisUA ($122 in chips) 
Seat 7: Reven9er ($151.18 in chips) 
Seat 8: Kreuznagel ($119.01 in chips) 
Seat 9: miracolix50 ($59.02 in chips) 
Kreuznagel: posts small blind $0.50
miracolix50: posts big blind $1
*** HOLE CARDS ***
Dealt to matiko09 [Ad Qc]
oscarleon: folds 
I The King I: folds 
Pvsx.: folds 
matiko09: raises $2 to $3
apfush: folds 
DUkalisUA: folds 
Reven9er: raises $4.50 to $7.50
Kreuznagel: folds 
miracolix50: folds 
matiko09: calls $4.50
*** FLOP *** [9h 6c 7h]
matiko09: checks 
Reven9er: bets $8
matiko09: folds 
Uncalled bet ($8) returned to Reven9er
Reven9er collected $15.68 from pot
Reven9er: doesn't show hand 
*** SUMMARY ***
Total pot $16.50 | Rake $0.82 
Board [9h 6c 7h]
Seat 1: oscarleon folded before Flop (didn't bet)
Seat 2: I The King I folded before Flop (didn't bet)
Seat 3: Pvsx. folded before Flop (didn't bet)
Seat 4: matiko09 folded on the Flop
Seat 5: apfush folded before Flop (didn't bet)
Seat 6: DUkalisUA folded before Flop (didn't bet)
Seat 7: Reven9er (button) collected ($15.68)
Seat 8: Kreuznagel (small blind) folded before Flop
Seat 9: miracolix50 (big blind) folded before Flop





PokerStars Hand #151208225045:  Hold'em No Limit (€0.50/€1.00 EUR) - 2016/03/31 12:55:07 CET [2016/03/31 6:55:07 ET]
Table 'Pioneer II' 9-max Seat #6 is the button
Seat 2: IdiotFromNE (€129.02 in chips) 
Seat 3: Kupumalam (€54.10 in chips) 
Seat 4: Painkiller72 (€152.96 in chips) 
Seat 5: PacPacBum (€104.72 in chips) 
Seat 6: matiko09 (€104.03 in chips) 
Seat 7: AlKatrone (€132.87 in chips) 
AlKatrone: posts small blind €0.50
IdiotFromNE: posts big blind €1
*** HOLE CARDS ***
Dealt to matiko09 [Ac 3d]
Kupumalam: folds 
Painkiller72: folds 
PacPacBum: folds 
matiko09: raises €1.27 to €2.27
AlKatrone: folds 
IdiotFromNE: folds 
Uncalled bet (€1.27) returned to matiko09
matiko09 collected €2.50 from pot
matiko09: doesn't show hand 
*** SUMMARY ***
Total pot €2.50 | Rake €0 
Seat 2: IdiotFromNE (big blind) folded before Flop
Seat 3: Kupumalam folded before Flop (didn't bet)
Seat 4: Painkiller72 folded before Flop (didn't bet)
Seat 5: PacPacBum folded before Flop (didn't bet)
Seat 6: matiko09 (button) collected (€2.50)
Seat 7: AlKatrone (small blind) folded before Flop





PokerStars Hand #151208227580:  Hold'em No Limit ($1/$2 USD) - 2016/03/31 12:55:13 CET [2016/03/31 6:55:13 ET]
Table 'Delvaux II' 9-max Seat #1 is the button
Seat 1: Painkiller72 ($200 in chips) 
Seat 2: rmanjkeee ($80 in chips) 
Seat 3: Avtovo ($200 in chips) 
Seat 6: quinters ($206 in chips) 
Seat 7: PacPacBum ($200 in chips) 
Seat 8: matiko09 ($200 in chips) 
Seat 9: o.miro ($203.50 in chips) 
rmanjkeee: posts small blind $1
Avtovo: posts big blind $2
*** HOLE CARDS ***
Dealt to matiko09 [6s Ks]
quinters: folds 
PacPacBum: folds 
matiko09: folds 
o.miro: folds 
Painkiller72: folds 
rmanjkeee: raises $3 to $5
Avtovo: folds 
Uncalled bet ($3) returned to rmanjkeee
rmanjkeee collected $4 from pot
rmanjkeee: doesn't show hand 
*** SUMMARY ***
Total pot $4 | Rake $0 
Seat 1: Painkiller72 (button) folded before Flop (didn't bet)
Seat 2: rmanjkeee (small blind) collected ($4)
Seat 3: Avtovo (big blind) folded before Flop
Seat 6: quinters folded before Flop (didn't bet)
Seat 7: PacPacBum folded before Flop (didn't bet)
Seat 8: matiko09 folded before Flop (didn't bet)
Seat 9: o.miro folded before Flop (didn't bet)





PokerStars Hand #151208228474:  Hold'em No Limit ($1/$2 USD) - 2016/03/31 12:55:15 CET [2016/03/31 6:55:15 ET]
Table 'Coelestina II' 9-max Seat #1 is the button
Seat 1: PacPacBum ($202.05 in chips) 
Seat 2: Kreuznagel ($224.05 in chips) 
Seat 3: ilaviiitech ($200 in chips) 
Seat 4: matiko09 ($221.72 in chips) 
Seat 5: Painkiller72 ($200 in chips) 
Seat 6: Avtovo ($235.07 in chips) 
Seat 7: rmanjkeee ($105 in chips) 
Seat 8: DUkalisUA ($229.31 in chips) 
Seat 9: fonng ($193.65 in chips) 
Kreuznagel: posts small blind $1
ilaviiitech: posts big blind $2
*** HOLE CARDS ***
Dealt to matiko09 [Th 3d]
matiko09: folds 
Painkiller72: folds 
Avtovo: folds 
rmanjkeee: folds 
DUkalisUA: folds 
fonng: calls $2
PacPacBum: folds 
Kreuznagel: calls $1
ilaviiitech: checks 
*** FLOP *** [3c Qc Ts]
Kreuznagel: checks 
ilaviiitech: checks 
fonng: bets $4
Kreuznagel: raises $10.13 to $14.13
ilaviiitech: folds 
fonng: folds 
Uncalled bet ($10.13) returned to Kreuznagel
Kreuznagel collected $13.30 from pot
Kreuznagel: doesn't show hand 
*** SUMMARY ***
Total pot $14 | Rake $0.70 
Board [3c Qc Ts]
Seat 1: PacPacBum (button) folded before Flop (didn't bet)
Seat 2: Kreuznagel (small blind) collected ($13.30)
Seat 3: ilaviiitech (big blind) folded on the Flop
Seat 4: matiko09 folded before Flop (didn't bet)
Seat 5: Painkiller72 folded before Flop (didn't bet)
Seat 6: Avtovo folded before Flop (didn't bet)
Seat 7: rmanjkeee folded before Flop (didn't bet)
Seat 8: DUkalisUA folded before Flop (didn't bet)
Seat 9: fonng folded on the Flop





PokerStars Hand #151208230111:  Hold'em No Limit ($0.50/$1.00 USD) - 2016/03/31 12:55:19 CET [2016/03/31 6:55:19 ET]
Table 'Viipuri II' 9-max Seat #1 is the button
Seat 1: Muinmyheart ($100 in chips) 
Seat 2: futa317 ($72.19 in chips) 
Seat 3: Zeeshka ($100 in chips) 
Seat 4: Miner604 ($39.51 in chips) 
Seat 5: matiko09 ($106.08 in chips) 
Seat 6: PacPacBum ($103.77 in chips) 
Seat 7: vicdroopy ($100 in chips) 
Seat 8: ilaviiitech ($121.38 in chips) 
Seat 9: djammusic ($38.50 in chips) 
futa317: posts small blind $0.50
Zeeshka: posts big blind $1
*** HOLE CARDS ***
Dealt to matiko09 [6h 7c]
Miner604: folds 
matiko09: folds 
PacPacBum: folds 
vicdroopy: raises $2 to $3
ilaviiitech: folds 
djammusic: folds 
Muinmyheart: folds 
futa317: folds 
Zeeshka: raises $6.90 to $9.90
vicdroopy: folds 
Uncalled bet ($6.90) returned to Zeeshka
Zeeshka collected $6.50 from pot
Zeeshka: doesn't show hand 
*** SUMMARY ***
Total pot $6.50 | Rake $0 
Seat 1: Muinmyheart (button) folded before Flop (didn't bet)
Seat 2: futa317 (small blind) folded before Flop
Seat 3: Zeeshka (big blind) collected ($6.50)
Seat 4: Miner604 folded before Flop (didn't bet)
Seat 5: matiko09 folded before Flop (didn't bet)
Seat 6: PacPacBum folded before Flop (didn't bet)
Seat 7: vicdroopy folded before Flop
Seat 8: ilaviiitech folded before Flop (didn't bet)
Seat 9: djammusic folded before Flop (didn't bet)





PokerStars Hand #151208232985:  Hold'em No Limit ($1/$2 USD) - 2016/03/31 12:55:26 CET [2016/03/31 6:55:26 ET]
Table 'Probitas' 9-max Seat #2 is the button
Seat 1: rmanjkeee ($304.27 in chips) 
Seat 2: Avtovo ($200 in chips) 
Seat 3: azvazdam ($228.99 in chips) 
Seat 4: Painkiller72 ($221.21 in chips) 
Seat 5: matiko09 ($200 in chips) 
Seat 6: Kreuznagel ($455.33 in chips) 
Seat 7: coinflip_si ($295.53 in chips) 
Seat 8: BOAYARSKIY ($135.67 in chips) 
Seat 9: apfush ($303.99 in chips) 
azvazdam: posts small blind $1
Painkiller72: posts big blind $2
*** HOLE CARDS ***
Dealt to matiko09 [Kc 6d]
matiko09: folds 
Kreuznagel: folds 
coinflip_si: folds 
BOAYARSKIY: folds 
apfush: raises $4 to $6
rmanjkeee: folds 
Avtovo: folds 
azvazdam: calls $5
Painkiller72: calls $4
*** FLOP *** [3c Kd 5d]
azvazdam: bets $8
Painkiller72: folds 
apfush: folds 
Uncalled bet ($8) returned to azvazdam
azvazdam collected $17.10 from pot
azvazdam: doesn't show hand 
*** SUMMARY ***
Total pot $18 | Rake $0.90 
Board [3c Kd 5d]
Seat 1: rmanjkeee folded before Flop (didn't bet)
Seat 2: Avtovo (button) folded before Flop (didn't bet)
Seat 3: azvazdam (small blind) collected ($17.10)
Seat 4: Painkiller72 (big blind) folded on the Flop
Seat 5: matiko09 folded before Flop (didn't bet)
Seat 6: Kreuznagel folded before Flop (didn't bet)
Seat 7: coinflip_si folded before Flop (didn't bet)
Seat 8: BOAYARSKIY folded before Flop (didn't bet)
Seat 9: apfush folded on the Flop





PokerStars Hand #151208235214:  Hold'em No Limit ($0.50/$1.00 USD) - 2016/03/31 12:55:31 CET [2016/03/31 6:55:31 ET]
Table 'Aquila' 9-max Seat #8 is the button
Seat 1: BOAYARSKIY ($47.90 in chips) 
Seat 2: Avtovo ($100 in chips) 
Seat 3: Kreuznagel ($108.99 in chips) 
Seat 5: adelfaz ($62.50 in chips) 
Seat 7: PacPacBum ($117.43 in chips) 
Seat 8: matiko09 ($154.12 in chips) 
Seat 9: apfush ($109.80 in chips) 
apfush: posts small blind $0.50
BOAYARSKIY: posts big blind $1
BOAYARSKIY: posts the ante $0.20
Avtovo: posts the ante $0.20
Kreuznagel: posts the ante $0.20
adelfaz: posts the ante $0.20
PacPacBum: posts the ante $0.20
matiko09: posts the ante $0.20
apfush: posts the ante $0.20
*** HOLE CARDS ***
Dealt to matiko09 [Kd Kc]
Avtovo: folds 
Kreuznagel: folds 
adelfaz: folds 
PacPacBum: folds 
matiko09: raises $1.50 to $2.50
apfush: folds 
adelfaz leaves the table
BOAYARSKIY: calls $1.50
*** FLOP *** [5d Ac Kh]
BOAYARSKIY: checks 
matiko09: bets $4.26
BOAYARSKIY: folds 
Uncalled bet ($4.26) returned to matiko09
matiko09 collected $6.56 from pot
matiko09: doesn't show hand 
*** SUMMARY ***
Total pot $6.90 | Rake $0.34 
Board [5d Ac Kh]
Seat 1: BOAYARSKIY (big blind) folded on the Flop
Seat 2: Avtovo folded before Flop (didn't bet)
Seat 3: Kreuznagel folded before Flop (didn't bet)
Seat 5: adelfaz folded before Flop (didn't bet)
Seat 7: PacPacBum folded before Flop (didn't bet)
Seat 8: matiko09 (button) collected ($6.56)
Seat 9: apfush (small blind) folded before Flop





PokerStars Hand #151208237256:  Hold'em No Limit (€0.50/€1.00 EUR) - 2016/03/31 12:55:36 CET [2016/03/31 6:55:36 ET]
Table 'Pioneer II' 9-max Seat #7 is the button
Seat 2: IdiotFromNE (€128.02 in chips) 
Seat 3: Kupumalam (€54.10 in chips) 
Seat 4: Painkiller72 (€152.96 in chips) 
Seat 5: PacPacBum (€104.72 in chips) 
Seat 6: matiko09 (€105.53 in chips) 
Seat 7: AlKatrone (€132.37 in chips) 
IdiotFromNE: posts small blind €0.50
Kupumalam: posts big blind €1
*** HOLE CARDS ***
Dealt to matiko09 [3s 8c]
Painkiller72: folds 
PacPacBum: folds 
matiko09: folds 
AlKatrone: folds 
IdiotFromNE: raises €1.50 to €2.50
Kupumalam: folds 
Uncalled bet (€1.50) returned to IdiotFromNE
IdiotFromNE collected €2 from pot
IdiotFromNE: doesn't show hand 
*** SUMMARY ***
Total pot €2 | Rake €0 
Seat 2: IdiotFromNE (small blind) collected (€2)
Seat 3: Kupumalam (big blind) folded before Flop
Seat 4: Painkiller72 folded before Flop (didn't bet)
Seat 5: PacPacBum folded before Flop (didn't bet)
Seat 6: matiko09 folded before Flop (didn't bet)
Seat 7: AlKatrone (button) folded before Flop (didn't bet)





PokerStars Hand #151208238566:  Hold'em No Limit ($1/$2 USD) - 2016/03/31 12:55:39 CET [2016/03/31 6:55:39 ET]
Table 'Delvaux II' 9-max Seat #2 is the button
Seat 1: Painkiller72 ($200 in chips) 
Seat 2: rmanjkeee ($82 in chips) 
Seat 3: Avtovo ($200 in chips) 
Seat 6: quinters ($206 in chips) 
Seat 7: PacPacBum ($200 in chips) 
Seat 8: matiko09 ($200 in chips) 
Seat 9: o.miro ($203.50 in chips) 
Avtovo: posts small blind $1
quinters: posts big blind $2
*** HOLE CARDS ***
Dealt to matiko09 [9c 2d]
PacPacBum: folds 
matiko09: folds 
o.miro: folds 
Painkiller72: folds 
rmanjkeee: folds 
Avtovo: folds 
Uncalled bet ($1) returned to quinters
quinters collected $2 from pot
quinters: doesn't show hand 
*** SUMMARY ***
Total pot $2 | Rake $0 
Seat 1: Painkiller72 folded before Flop (didn't bet)
Seat 2: rmanjkeee (button) folded before Flop (didn't bet)
Seat 3: Avtovo (small blind) folded before Flop
Seat 6: quinters (big blind) collected ($2)
Seat 7: PacPacBum folded before Flop (didn't bet)
Seat 8: matiko09 folded before Flop (didn't bet)
Seat 9: o.miro folded before Flop (didn't bet)





PokerStars Hand #151208239082:  Hold'em No Limit ($0.50/$1.00 USD) - 2016/03/31 12:55:40 CET [2016/03/31 6:55:40 ET]
Table 'Haworth II' 9-max Seat #6 is the button
Seat 2: AlKatrone ($142.35 in chips) 
Seat 3: matiko09 ($100 in chips) 
Seat 4: I The King I ($107.02 in chips) 
Seat 5: Kreuznagel ($100 in chips) 
Seat 6: Pvsx. ($103.65 in chips) 
Seat 7: mheris ($147.26 in chips) 
Seat 8: oscarleon ($100 in chips) 
Seat 9: Zeeshka ($100 in chips) 
mheris: posts small blind $0.50
oscarleon: posts big blind $1
godfrey004: sits out 
*** HOLE CARDS ***
Dealt to matiko09 [9c 2h]
Zeeshka: folds 
AlKatrone: folds 
matiko09: folds 
I The King I: folds 
Kreuznagel: raises $1.50 to $2.50
Pvsx.: folds 
mheris: calls $2
oscarleon: folds 
*** FLOP *** [Tc 7h Qd]
mheris: checks 
Kreuznagel: checks 
*** TURN *** [Tc 7h Qd] [Td]
mheris: bets $4
Kreuznagel: folds 
Uncalled bet ($4) returned to mheris
mheris collected $5.70 from pot
mheris: doesn't show hand 
*** SUMMARY ***
Total pot $6 | Rake $0.30 
Board [Tc 7h Qd Td]
Seat 2: AlKatrone folded before Flop (didn't bet)
Seat 3: matiko09 folded before Flop (didn't bet)
Seat 4: I The King I folded before Flop (didn't bet)
Seat 5: Kreuznagel folded on the Turn
Seat 6: Pvsx. (button) folded before Flop (didn't bet)
Seat 7: mheris (small blind) collected ($5.70)
Seat 8: oscarleon (big blind) folded before Flop
Seat 9: Zeeshka folded before Flop (didn't bet)





PokerStars Hand #151208239158:  Hold'em No Limit ($0.50/$1.00 USD) - 2016/03/31 12:55:41 CET [2016/03/31 6:55:41 ET]
Table 'Herge II' 9-max Seat #5 is the button
Seat 3: matiko09 ($210.10 in chips) 
Seat 4: Kreuznagel ($101.13 in chips) 
Seat 5: I The King I ($133.73 in chips) 
Seat 6: masaytoo ($100 in chips) 
Seat 7: Zeeshka ($139.45 in chips) 
Seat 8: IdiotFromNE ($103 in chips) 
Seat 9: fatstacks122 ($154.46 in chips) 
masaytoo: posts small blind $0.50
Zeeshka: posts big blind $1
o.miro: sits out 
*** HOLE CARDS ***
Dealt to matiko09 [5d Th]
IdiotFromNE: folds 
fatstacks122: folds 
matiko09: folds 
Kreuznagel: folds 
I The King I: folds 
masaytoo: folds 
Uncalled bet ($0.50) returned to Zeeshka
Zeeshka collected $1 from pot
Zeeshka: doesn't show hand 
*** SUMMARY ***
Total pot $1 | Rake $0 
Seat 3: matiko09 folded before Flop (didn't bet)
Seat 4: Kreuznagel folded before Flop (didn't bet)
Seat 5: I The King I (button) folded before Flop (didn't bet)
Seat 6: masaytoo (small blind) folded before Flop
Seat 7: Zeeshka (big blind) collected ($1)
Seat 8: IdiotFromNE folded before Flop (didn't bet)
Seat 9: fatstacks122 folded before Flop (didn't bet)





PokerStars Hand #151208239690:  Hold'em No Limit ($0.50/$1.00 USD) - 2016/03/31 12:55:42 CET [2016/03/31 6:55:42 ET]
Table 'Yazhi' 9-max Seat #4 is the button
Seat 1: matiko09 ($100.91 in chips) 
Seat 2: xHourglass ($136.01 in chips) 
Seat 4: apfush ($143.10 in chips) 
Seat 5: IdiotFromNE ($124.50 in chips) 
Seat 6: Reven9er ($227.49 in chips) 
Seat 7: Avtovo ($100 in chips) 
Seat 8: pk4DW ($42.61 in chips) 
Seat 9: oscarleon ($199.23 in chips) 
IdiotFromNE: posts small blind $0.50
Reven9er: posts big blind $1
Chin41178: sits out 
*** HOLE CARDS ***
Dealt to matiko09 [Ac Ks]
Avtovo: folds 
pk4DW: folds 
oscarleon: raises $2 to $3
matiko09: calls $3
xHourglass: folds 
apfush: folds 
IdiotFromNE: folds 
Reven9er: folds 
*** FLOP *** [6h Ah 4s]
oscarleon: bets $5
matiko09: calls $5
*** TURN *** [6h Ah 4s] [Qh]
oscarleon: checks 
matiko09: bets $8.64
oscarleon: calls $8.64
*** RIVER *** [6h Ah 4s Qh] [Tc]
oscarleon: checks 
matiko09: checks 
*** SHOW DOWN ***
oscarleon: shows [9d Ad] (a pair of Aces)
matiko09: shows [Ac Ks] (a pair of Aces - King kicker)
matiko09 collected $33.04 from pot
*** SUMMARY ***
Total pot $34.78 | Rake $1.74 
Board [6h Ah 4s Qh Tc]
Seat 1: matiko09 showed [Ac Ks] and won ($33.04) with a pair of Aces
Seat 2: xHourglass folded before Flop (didn't bet)
Seat 4: apfush (button) folded before Flop (didn't bet)
Seat 5: IdiotFromNE (small blind) folded before Flop
Seat 6: Reven9er (big blind) folded before Flop
Seat 7: Avtovo folded before Flop (didn't bet)
Seat 8: pk4DW folded before Flop (didn't bet)
Seat 9: oscarleon showed [9d Ad] and lost with a pair of Aces





PokerStars Hand #151208246980:  Hold'em No Limit ($1/$2 USD) - 2016/03/31 12:55:59 CET [2016/03/31 6:55:59 ET]
Table 'Delvaux II' 9-max Seat #3 is the button
Seat 1: Painkiller72 ($200 in chips) 
Seat 2: rmanjkeee ($82 in chips) 
Seat 3: Avtovo ($200 in chips) 
Seat 6: quinters ($207 in chips) 
Seat 7: PacPacBum ($200 in chips) 
Seat 8: matiko09 ($200 in chips) 
Seat 9: o.miro ($203.50 in chips) 
quinters: posts small blind $1
PacPacBum: posts big blind $2
*** HOLE CARDS ***
Dealt to matiko09 [9c 2h]
matiko09: folds 
o.miro: raises $4 to $6
ansing joins the table at seat #4 
Painkiller72: folds 
ilaviiitech joins the table at seat #5 
rmanjkeee: folds 
Avtovo: folds 
quinters: folds 
PacPacBum: folds 
Uncalled bet ($4) returned to o.miro
o.miro collected $5 from pot
o.miro: doesn't show hand 
*** SUMMARY ***
Total pot $5 | Rake $0 
Seat 1: Painkiller72 folded before Flop (didn't bet)
Seat 2: rmanjkeee folded before Flop (didn't bet)
Seat 3: Avtovo (button) folded before Flop (didn't bet)
Seat 6: quinters (small blind) folded before Flop
Seat 7: PacPacBum (big blind) folded before Flop
Seat 8: matiko09 folded before Flop (didn't bet)
Seat 9: o.miro collected ($5)





PokerStars Hand #151208251695:  Hold'em No Limit ($1/$2 USD) - 2016/03/31 12:56:10 CET [2016/03/31 6:56:10 ET]
Table 'Coelestina II' 9-max Seat #2 is the button
Seat 1: PacPacBum ($202.05 in chips) 
Seat 2: Kreuznagel ($231.35 in chips) 
Seat 3: ilaviiitech ($200 in chips) 
Seat 4: matiko09 ($221.72 in chips) 
Seat 5: Painkiller72 ($200 in chips) 
Seat 6: Avtovo ($235.07 in chips) 
Seat 7: rmanjkeee ($105 in chips) 
Seat 8: DUkalisUA ($229.31 in chips) 
Seat 9: fonng ($187.65 in chips) 
ilaviiitech: posts small blind $1
matiko09: posts big blind $2
*** HOLE CARDS ***
Dealt to matiko09 [5d 2h]
Painkiller72: folds 
Avtovo: folds 
rmanjkeee: folds 
DUkalisUA: folds 
fonng: folds 
PacPacBum: folds 
Kreuznagel: raises $3 to $5
ilaviiitech: folds 
matiko09: folds 
Uncalled bet ($3) returned to Kreuznagel
Kreuznagel collected $5 from pot
Kreuznagel: doesn't show hand 
*** SUMMARY ***
Total pot $5 | Rake $0 
Seat 1: PacPacBum folded before Flop (didn't bet)
Seat 2: Kreuznagel (button) collected ($5)
Seat 3: ilaviiitech (small blind) folded before Flop
Seat 4: matiko09 (big blind) folded before Flop
Seat 5: Painkiller72 folded before Flop (didn't bet)
Seat 6: Avtovo folded before Flop (didn't bet)
Seat 7: rmanjkeee folded before Flop (didn't bet)
Seat 8: DUkalisUA folded before Flop (didn't bet)
Seat 9: fonng folded before Flop (didn't bet)





PokerStars Hand #151208252545:  Hold'em No Limit ($0.50/$1.00 USD) - 2016/03/31 12:56:12 CET [2016/03/31 6:56:12 ET]
Table 'Egeria II' 9-max Seat #8 is the button
Seat 1: oscarleon ($122.53 in chips) 
Seat 2: I The King I ($186.03 in chips) 
Seat 3: Pvsx. ($115.64 in chips) 
Seat 4: matiko09 ($100 in chips) 
Seat 5: apfush ($134.50 in chips) 
Seat 6: DUkalisUA ($122 in chips) 
Seat 7: Reven9er ($159.36 in chips) 
Seat 8: Kreuznagel ($118.51 in chips) 
Seat 9: miracolix50 ($58.02 in chips) 
miracolix50: posts small blind $0.50
oscarleon: posts big blind $1
*** HOLE CARDS ***
Dealt to matiko09 [4h As]
I The King I: folds 
Pvsx.: folds 
matiko09: folds 
apfush: folds 
DUkalisUA: folds 
Reven9er: folds 
Kreuznagel: raises $1.50 to $2.50
miracolix50: calls $2
oscarleon: calls $1.50
*** FLOP *** [Ah Qc Ac]
miracolix50: checks 
oscarleon: checks 
Kreuznagel: checks 
*** TURN *** [Ah Qc Ac] [Td]
miracolix50: checks 
oscarleon: checks 
Kreuznagel: checks 
*** RIVER *** [Ah Qc Ac Td] [7d]
miracolix50: checks 
oscarleon: checks 
Kreuznagel: checks 
*** SHOW DOWN ***
miracolix50: shows [Ks 6h] (a pair of Aces)
oscarleon: mucks hand 
Kreuznagel: mucks hand 
miracolix50 collected $7.12 from pot
*** SUMMARY ***
Total pot $7.50 | Rake $0.38 
Board [Ah Qc Ac Td 7d]
Seat 1: oscarleon (big blind) mucked [8d 9d]
Seat 2: I The King I folded before Flop (didn't bet)
Seat 3: Pvsx. folded before Flop (didn't bet)
Seat 4: matiko09 folded before Flop (didn't bet)
Seat 5: apfush folded before Flop (didn't bet)
Seat 6: DUkalisUA folded before Flop (didn't bet)
Seat 7: Reven9er folded before Flop (didn't bet)
Seat 8: Kreuznagel (button) mucked [5h 9h]
Seat 9: miracolix50 (small blind) showed [Ks 6h] and won ($7.12) with a pair of Aces





PokerStars Hand #151208252594:  Hold'em No Limit (€0.50/€1.00 EUR) - 2016/03/31 12:56:13 CET [2016/03/31 6:56:13 ET]
Table 'Pioneer II' 9-max Seat #2 is the button
Seat 2: IdiotFromNE (€129.02 in chips) 
Seat 3: Kupumalam (€53.10 in chips) 
Seat 4: Painkiller72 (€152.96 in chips) 
Seat 5: PacPacBum (€104.72 in chips) 
Seat 6: matiko09 (€105.53 in chips) 
Seat 7: AlKatrone (€132.37 in chips) 
Kupumalam: posts small blind €0.50
Painkiller72: posts big blind €1
*** HOLE CARDS ***
Dealt to matiko09 [Js 4s]
PacPacBum: raises €2 to €3
matiko09: folds 
AlKatrone: folds 
IdiotFromNE: folds 
Kupumalam: folds 
Painkiller72: folds 
Uncalled bet (€2) returned to PacPacBum
PacPacBum collected €2.50 from pot
PacPacBum: doesn't show hand 
*** SUMMARY ***
Total pot €2.50 | Rake €0 
Seat 2: IdiotFromNE (button) folded before Flop (didn't bet)
Seat 3: Kupumalam (small blind) folded before Flop
Seat 4: Painkiller72 (big blind) folded before Flop
Seat 5: PacPacBum collected (€2.50)
Seat 6: matiko09 folded before Flop (didn't bet)
Seat 7: AlKatrone folded before Flop (didn't bet)





PokerStars Hand #151208252985:  Hold'em No Limit ($0.50/$1.00 USD) - 2016/03/31 12:56:13 CET [2016/03/31 6:56:13 ET]
Table 'Aquila' 9-max Seat #9 is the button
Seat 1: BOAYARSKIY ($45.20 in chips) 
Seat 2: Avtovo ($100 in chips) 
Seat 3: Kreuznagel ($108.79 in chips) 
Seat 7: PacPacBum ($117.23 in chips) 
Seat 8: matiko09 ($157.98 in chips) 
Seat 9: apfush ($109.10 in chips) 
BOAYARSKIY: posts small blind $0.50
Avtovo: posts big blind $1
BOAYARSKIY: posts the ante $0.20
Avtovo: posts the ante $0.20
Kreuznagel: posts the ante $0.20
PacPacBum: posts the ante $0.20
matiko09: posts the ante $0.20
apfush: posts the ante $0.20
*** HOLE CARDS ***
Dealt to matiko09 [Kh Jh]
Kreuznagel: raises $1.39 to $2.39
PacPacBum: folds 
matiko09: folds 
apfush: folds 
BOAYARSKIY: folds 
Avtovo: folds 
Uncalled bet ($1.39) returned to Kreuznagel
Kreuznagel collected $3.70 from pot
Kreuznagel: doesn't show hand 
*** SUMMARY ***
Total pot $3.70 | Rake $0 
Seat 1: BOAYARSKIY (small blind) folded before Flop
Seat 2: Avtovo (big blind) folded before Flop
Seat 3: Kreuznagel collected ($3.70)
Seat 7: PacPacBum folded before Flop (didn't bet)
Seat 8: matiko09 folded before Flop (didn't bet)
Seat 9: apfush (button) folded before Flop (didn't bet)





PokerStars Hand #151208253201:  Hold'em No Limit ($0.50/$1.00 USD) - 2016/03/31 12:56:14 CET [2016/03/31 6:56:14 ET]
Table 'Herge II' 9-max Seat #7 is the button
Seat 3: matiko09 ($210.10 in chips) 
Seat 4: Kreuznagel ($101.13 in chips) 
Seat 5: I The King I ($133.73 in chips) 
Seat 7: Zeeshka ($139.95 in chips) 
Seat 8: IdiotFromNE ($103 in chips) 
Seat 9: fatstacks122 ($154.46 in chips) 
IdiotFromNE: posts small blind $0.50
fatstacks122: posts big blind $1
o.miro: sits out 
*** HOLE CARDS ***
Dealt to matiko09 [7s Jd]
matiko09: folds 
Kreuznagel: raises $1.39 to $2.39
I The King I: folds 
Zeeshka: folds 
IdiotFromNE: folds 
fatstacks122: calls $1.39
*** FLOP *** [Qs 6c 4h]
fatstacks122: bets $2.75
Kreuznagel: calls $2.75
*** TURN *** [Qs 6c 4h] [9c]
fatstacks122: checks 
Kreuznagel: bets $6.04
fatstacks122: folds 
Uncalled bet ($6.04) returned to Kreuznagel
Kreuznagel collected $10.24 from pot
Kreuznagel: doesn't show hand 
*** SUMMARY ***
Total pot $10.78 | Rake $0.54 
Board [Qs 6c 4h 9c]
Seat 3: matiko09 folded before Flop (didn't bet)
Seat 4: Kreuznagel collected ($10.24)
Seat 5: I The King I folded before Flop (didn't bet)
Seat 7: Zeeshka (button) folded before Flop (didn't bet)
Seat 8: IdiotFromNE (small blind) folded before Flop
Seat 9: fatstacks122 (big blind) folded on the Turn





PokerStars Hand #151208253149:  Hold'em No Limit ($0.50/$1.00 USD) - 2016/03/31 12:56:14 CET [2016/03/31 6:56:14 ET]
Table 'Viipuri II' 9-max Seat #2 is the button
Seat 1: Muinmyheart ($100 in chips) 
Seat 2: futa317 ($71.69 in chips) 
Seat 3: Zeeshka ($103.50 in chips) 
Seat 4: Miner604 ($39.51 in chips) 
Seat 5: matiko09 ($106.08 in chips) 
Seat 6: PacPacBum ($103.77 in chips) 
Seat 7: vicdroopy ($100 in chips) 
Seat 8: ilaviiitech ($121.38 in chips) 
Seat 9: djammusic ($38.50 in chips) 
Zeeshka: posts small blind $0.50
Miner604: posts big blind $1
*** HOLE CARDS ***
Dealt to matiko09 [Kc 2h]
matiko09: folds 
PacPacBum: raises $2 to $3
vicdroopy: folds 
ilaviiitech: folds 
djammusic: folds 
Muinmyheart: folds 
futa317: calls $3
Zeeshka: folds 
Miner604: calls $2
*** FLOP *** [Ts Kh Js]
Miner604: checks 
PacPacBum: bets $4.87
futa317: calls $4.87
Miner604: folds 
*** TURN *** [Ts Kh Js] [Ac]
PacPacBum: checks 
futa317: bets $6
PacPacBum: calls $6
*** RIVER *** [Ts Kh Js Ac] [3d]
PacPacBum: checks 
futa317: bets $29.68
PacPacBum: folds 
Uncalled bet ($29.68) returned to futa317
futa317 collected $29.68 from pot
futa317: doesn't show hand 
*** SUMMARY ***
Total pot $31.24 | Rake $1.56 
Board [Ts Kh Js Ac 3d]
Seat 1: Muinmyheart folded before Flop (didn't bet)
Seat 2: futa317 (button) collected ($29.68)
Seat 3: Zeeshka (small blind) folded before Flop
Seat 4: Miner604 (big blind) folded on the Flop
Seat 5: matiko09 folded before Flop (didn't bet)
Seat 6: PacPacBum folded on the River
Seat 7: vicdroopy folded before Flop (didn't bet)
Seat 8: ilaviiitech folded before Flop (didn't bet)
Seat 9: djammusic folded before Flop (didn't bet)





PokerStars Hand #151208258049:  Hold'em No Limit ($1/$2 USD) - 2016/03/31 12:56:25 CET [2016/03/31 6:56:25 ET]
Table 'Probitas' 9-max Seat #3 is the button
Seat 1: rmanjkeee ($304.27 in chips) 
Seat 2: Avtovo ($200 in chips) 
Seat 3: azvazdam ($240.09 in chips) 
Seat 4: Painkiller72 ($215.21 in chips) 
Seat 5: matiko09 ($200 in chips) 
Seat 6: Kreuznagel ($455.33 in chips) 
Seat 7: coinflip_si ($295.53 in chips) 
Seat 8: BOAYARSKIY ($135.67 in chips) 
Seat 9: apfush ($297.99 in chips) 
Painkiller72: posts small blind $1
matiko09: posts big blind $2
*** HOLE CARDS ***
Dealt to matiko09 [5c 7c]
Kreuznagel: folds 
coinflip_si: folds 
BOAYARSKIY: raises $2.26 to $4.26
apfush: folds 
rmanjkeee: folds 
Avtovo: folds 
azvazdam: folds 
Painkiller72: folds 
matiko09: folds 
Uncalled bet ($2.26) returned to BOAYARSKIY
BOAYARSKIY collected $5 from pot
BOAYARSKIY: doesn't show hand 
*** SUMMARY ***
Total pot $5 | Rake $0 
Seat 1: rmanjkeee folded before Flop (didn't bet)
Seat 2: Avtovo folded before Flop (didn't bet)
Seat 3: azvazdam (button) folded before Flop (didn't bet)
Seat 4: Painkiller72 (small blind) folded before Flop
Seat 5: matiko09 (big blind) folded before Flop
Seat 6: Kreuznagel folded before Flop (didn't bet)
Seat 7: coinflip_si folded before Flop (didn't bet)
Seat 8: BOAYARSKIY collected ($5)
Seat 9: apfush folded before Flop (didn't bet)





PokerStars Hand #151208264024:  Hold'em No Limit ($1/$2 USD) - 2016/03/31 12:56:39 CET [2016/03/31 6:56:39 ET]
Table 'Delvaux II' 9-max Seat #6 is the button
Seat 1: Painkiller72 ($200 in chips) 
Seat 2: rmanjkeee ($82 in chips) 
Seat 3: Avtovo ($200 in chips) 
Seat 6: quinters ($206 in chips) 
Seat 7: PacPacBum ($200 in chips) 
Seat 8: matiko09 ($200 in chips) 
Seat 9: o.miro ($206.50 in chips) 
PacPacBum: posts small blind $1
matiko09: posts big blind $2
ansing: sits out 
ilaviiitech: sits out 
*** HOLE CARDS ***
Dealt to matiko09 [Qh 7c]
o.miro: raises $4 to $6
Painkiller72: calls $6
rmanjkeee: folds 
Avtovo: folds 
quinters: folds 
PacPacBum: folds 
matiko09: folds 
*** FLOP *** [9d 9c 6c]
o.miro: checks 
Painkiller72: bets $9.97
o.miro: folds 
Uncalled bet ($9.97) returned to Painkiller72
Painkiller72 collected $14.25 from pot
Painkiller72: doesn't show hand 
*** SUMMARY ***
Total pot $15 | Rake $0.75 
Board [9d 9c 6c]
Seat 1: Painkiller72 collected ($14.25)
Seat 2: rmanjkeee folded before Flop (didn't bet)
Seat 3: Avtovo folded before Flop (didn't bet)
Seat 6: quinters (button) folded before Flop (didn't bet)
Seat 7: PacPacBum (small blind) folded before Flop
Seat 8: matiko09 (big blind) folded before Flop
Seat 9: o.miro folded on the Flop





PokerStars Hand #151208266480:  Hold'em No Limit ($1/$2 USD) - 2016/03/31 12:56:45 CET [2016/03/31 6:56:45 ET]
Table 'Coelestina II' 9-max Seat #3 is the button
Seat 1: PacPacBum ($202.05 in chips) 
Seat 2: Kreuznagel ($234.35 in chips) 
Seat 3: ilaviiitech ($200 in chips) 
Seat 4: matiko09 ($219.72 in chips) 
Seat 5: Painkiller72 ($200 in chips) 
Seat 6: Avtovo ($235.07 in chips) 
Seat 7: rmanjkeee ($105 in chips) 
Seat 8: DUkalisUA ($229.31 in chips) 
Seat 9: fonng ($187.65 in chips) 
matiko09: posts small blind $1
Painkiller72: posts big blind $2
*** HOLE CARDS ***
Dealt to matiko09 [Ts 3s]
Avtovo: folds 
rmanjkeee: raises $3 to $5
DUkalisUA: folds 
fonng: raises $5 to $10
PacPacBum: folds 
Kreuznagel: folds 
ilaviiitech: folds 
matiko09: folds 
Painkiller72: folds 
rmanjkeee: calls $5
*** FLOP *** [6c 9h 5c]
rmanjkeee: checks 
fonng: bets $18
rmanjkeee: calls $18
*** TURN *** [6c 9h 5c] [4c]
rmanjkeee: checks 
fonng: checks 
*** RIVER *** [6c 9h 5c 4c] [8h]
rmanjkeee: checks 
fonng: checks 
*** SHOW DOWN ***
rmanjkeee: shows [9s 9c] (three of a kind, Nines)
fonng: mucks hand 
rmanjkeee collected $56.25 from pot
*** SUMMARY ***
Total pot $59 | Rake $2.75 
Board [6c 9h 5c 4c 8h]
Seat 1: PacPacBum folded before Flop (didn't bet)
Seat 2: Kreuznagel folded before Flop (didn't bet)
Seat 3: ilaviiitech (button) folded before Flop (didn't bet)
Seat 4: matiko09 (small blind) folded before Flop
Seat 5: Painkiller72 (big blind) folded before Flop
Seat 6: Avtovo folded before Flop (didn't bet)
Seat 7: rmanjkeee showed [9s 9c] and won ($56.25) with three of a kind, Nines
Seat 8: DUkalisUA folded before Flop (didn't bet)
Seat 9: fonng mucked [2h 2c]





PokerStars Hand #151208268227:  Hold'em No Limit ($0.50/$1.00 USD) - 2016/03/31 12:56:49 CET [2016/03/31 6:56:49 ET]
Table 'Yazhi' 9-max Seat #5 is the button
Seat 1: matiko09 ($117.31 in chips) 
Seat 2: xHourglass ($136.01 in chips) 
Seat 4: apfush ($143.10 in chips) 
Seat 5: IdiotFromNE ($124 in chips) 
Seat 6: Reven9er ($226.49 in chips) 
Seat 7: Avtovo ($100 in chips) 
Seat 9: oscarleon ($182.59 in chips) 
Reven9er: posts small blind $0.50
Avtovo: posts big blind $1
Chin41178: sits out 
*** HOLE CARDS ***
Dealt to matiko09 [7s 3c]
oscarleon: folds 
matiko09: folds 
xHourglass: folds 
apfush: folds 
IdiotFromNE: raises $1.50 to $2.50
Reven9er: folds 
Avtovo: folds 
Uncalled bet ($1.50) returned to IdiotFromNE
IdiotFromNE collected $2.50 from pot
IdiotFromNE: doesn't show hand 
*** SUMMARY ***
Total pot $2.50 | Rake $0 
Seat 1: matiko09 folded before Flop (didn't bet)
Seat 2: xHourglass folded before Flop (didn't bet)
Seat 4: apfush folded before Flop (didn't bet)
Seat 5: IdiotFromNE (button) collected ($2.50)
Seat 6: Reven9er (small blind) folded before Flop
Seat 7: Avtovo (big blind) folded before Flop
Seat 9: oscarleon folded before Flop (didn't bet)





PokerStars Hand #151208270633:  Hold'em No Limit (€0.50/€1.00 EUR) - 2016/03/31 12:56:54 CET [2016/03/31 6:56:54 ET]
Table 'Pioneer II' 9-max Seat #3 is the button
Seat 2: IdiotFromNE (€129.02 in chips) 
Seat 3: Kupumalam (€52.60 in chips) 
Seat 4: Painkiller72 (€151.96 in chips) 
Seat 5: PacPacBum (€106.22 in chips) 
Seat 6: matiko09 (€105.53 in chips) 
Seat 7: AlKatrone (€132.37 in chips) 
Painkiller72: posts small blind €0.50
PacPacBum: posts big blind €1
*** HOLE CARDS ***
Dealt to matiko09 [2c Ks]
matiko09: folds 
AlKatrone: folds 
IdiotFromNE: raises €1.50 to €2.50
Kupumalam: folds 
Painkiller72: folds 
PacPacBum: folds 
Uncalled bet (€1.50) returned to IdiotFromNE
IdiotFromNE collected €2.50 from pot
IdiotFromNE: doesn't show hand 
*** SUMMARY ***
Total pot €2.50 | Rake €0 
Seat 2: IdiotFromNE collected (€2.50)
Seat 3: Kupumalam (button) folded before Flop (didn't bet)
Seat 4: Painkiller72 (small blind) folded before Flop
Seat 5: PacPacBum (big blind) folded before Flop
Seat 6: matiko09 folded before Flop (didn't bet)
Seat 7: AlKatrone folded before Flop (didn't bet)





PokerStars Hand #151208276914:  Hold'em No Limit ($0.50/$1.00 USD) - 2016/03/31 12:57:09 CET [2016/03/31 6:57:09 ET]
Table 'Haworth II' 9-max Seat #7 is the button
Seat 2: AlKatrone ($142.35 in chips) 
Seat 3: matiko09 ($100 in chips) 
Seat 4: I The King I ($107.02 in chips) 
Seat 5: Kreuznagel ($100 in chips) 
Seat 6: Pvsx. ($103.65 in chips) 
Seat 7: mheris ($150.46 in chips) 
Seat 8: oscarleon ($100 in chips) 
Seat 9: Zeeshka ($100 in chips) 
oscarleon: posts small blind $0.50
Zeeshka: posts big blind $1
godfrey004: sits out 
*** HOLE CARDS ***
Dealt to matiko09 [5c 8d]
AlKatrone: folds 
matiko09: folds 
I The King I: folds 
Kreuznagel: folds 
Pvsx.: folds 
mheris: folds 
oscarleon: folds 
Uncalled bet ($0.50) returned to Zeeshka
Zeeshka collected $1 from pot
Zeeshka: doesn't show hand 
*** SUMMARY ***
Total pot $1 | Rake $0 
Seat 2: AlKatrone folded before Flop (didn't bet)
Seat 3: matiko09 folded before Flop (didn't bet)
Seat 4: I The King I folded before Flop (didn't bet)
Seat 5: Kreuznagel folded before Flop (didn't bet)
Seat 6: Pvsx. folded before Flop (didn't bet)
Seat 7: mheris (button) folded before Flop (didn't bet)
Seat 8: oscarleon (small blind) folded before Flop
Seat 9: Zeeshka (big blind) collected ($1)





PokerStars Hand #151208278963:  Hold'em No Limit (€0.50/€1.00 EUR) - 2016/03/31 12:57:14 CET [2016/03/31 6:57:14 ET]
Table 'Pioneer II' 9-max Seat #4 is the button
Seat 2: IdiotFromNE (€130.52 in chips) 
Seat 3: Kupumalam (€52.60 in chips) 
Seat 4: Painkiller72 (€151.46 in chips) 
Seat 5: PacPacBum (€105.22 in chips) 
Seat 6: matiko09 (€105.53 in chips) 
Seat 7: AlKatrone (€132.37 in chips) 
PacPacBum: posts small blind €0.50
matiko09: posts big blind €1
*** HOLE CARDS ***
Dealt to matiko09 [8c Th]
AlKatrone: folds 
IdiotFromNE: folds 
Kupumalam: folds 
Painkiller72: raises €1 to €2
PacPacBum: folds 
matiko09: folds 
Uncalled bet (€1) returned to Painkiller72
Painkiller72 collected €2.50 from pot
Painkiller72: doesn't show hand 
*** SUMMARY ***
Total pot €2.50 | Rake €0 
Seat 2: IdiotFromNE folded before Flop (didn't bet)
Seat 3: Kupumalam folded before Flop (didn't bet)
Seat 4: Painkiller72 (button) collected (€2.50)
Seat 5: PacPacBum (small blind) folded before Flop
Seat 6: matiko09 (big blind) folded before Flop
Seat 7: AlKatrone folded before Flop (didn't bet)





PokerStars Hand #151208284640:  Hold'em No Limit ($0.50/$1.00 USD) - 2016/03/31 12:57:27 CET [2016/03/31 6:57:27 ET]
Table 'Yazhi' 9-max Seat #6 is the button
Seat 1: matiko09 ($117.31 in chips) 
Seat 2: xHourglass ($136.01 in chips) 
Seat 4: apfush ($143.10 in chips) 
Seat 5: IdiotFromNE ($125.50 in chips) 
Seat 6: Reven9er ($225.99 in chips) 
Seat 7: Avtovo ($100 in chips) 
Seat 9: oscarleon ($182.59 in chips) 
Avtovo: posts small blind $0.50
oscarleon: posts big blind $1
Chin41178: sits out 
*** HOLE CARDS ***
Dealt to matiko09 [9d 3h]
matiko09: folds 
xHourglass: folds 
apfush: raises $2 to $3
IdiotFromNE: folds 
Reven9er: folds 
Avtovo: folds 
oscarleon: folds 
Uncalled bet ($2) returned to apfush
apfush collected $2.50 from pot
apfush: doesn't show hand 
*** SUMMARY ***
Total pot $2.50 | Rake $0 
Seat 1: matiko09 folded before Flop (didn't bet)
Seat 2: xHourglass folded before Flop (didn't bet)
Seat 4: apfush collected ($2.50)
Seat 5: IdiotFromNE folded before Flop (didn't bet)
Seat 6: Reven9er (button) folded before Flop (didn't bet)
Seat 7: Avtovo (small blind) folded before Flop
Seat 9: oscarleon (big blind) folded before Flop





PokerStars Hand #151208286446:  Hold'em No Limit ($1/$2 USD) - 2016/03/31 12:57:31 CET [2016/03/31 6:57:31 ET]
Table 'Delvaux II' 9-max Seat #7 is the button
Seat 1: Painkiller72 ($208.25 in chips) 
Seat 2: rmanjkeee ($82 in chips) 
Seat 3: Avtovo ($200 in chips) 
Seat 6: quinters ($206 in chips) 
Seat 7: PacPacBum ($200 in chips) 
Seat 8: matiko09 ($200 in chips) 
Seat 9: o.miro ($200.50 in chips) 
matiko09: posts small blind $1
o.miro: posts big blind $2
ansing: sits out 
ilaviiitech: sits out 
*** HOLE CARDS ***
Dealt to matiko09 [3d 8c]
Painkiller72: folds 
ansing leaves the table
rmanjkeee: folds 
Avtovo: folds 
quinters: folds 
Kreuznagel joins the table at seat #4 
PacPacBum: folds 
matiko09: folds 
Uncalled bet ($1) returned to o.miro
o.miro collected $2 from pot
o.miro: doesn't show hand 
*** SUMMARY ***
Total pot $2 | Rake $0 
Seat 1: Painkiller72 folded before Flop (didn't bet)
Seat 2: rmanjkeee folded before Flop (didn't bet)
Seat 3: Avtovo folded before Flop (didn't bet)
Seat 6: quinters folded before Flop (didn't bet)
Seat 7: PacPacBum (button) folded before Flop (didn't bet)
Seat 8: matiko09 (small blind) folded before Flop
Seat 9: o.miro (big blind) collected ($2)





PokerStars Hand #151208288341:  Hold'em No Limit ($1/$2 USD) - 2016/03/31 12:57:36 CET [2016/03/31 6:57:36 ET]
Table 'Probitas' 9-max Seat #4 is the button
Seat 1: rmanjkeee ($304.27 in chips) 
Seat 2: Avtovo ($200 in chips) 
Seat 3: azvazdam ($240.09 in chips) 
Seat 4: Painkiller72 ($214.21 in chips) 
Seat 5: matiko09 ($200 in chips) 
Seat 6: Kreuznagel ($455.33 in chips) 
Seat 7: coinflip_si ($295.53 in chips) 
Seat 8: BOAYARSKIY ($138.67 in chips) 
Seat 9: apfush ($297.99 in chips) 
matiko09: posts small blind $1
Kreuznagel: posts big blind $2
*** HOLE CARDS ***
Dealt to matiko09 [8d 9h]
coinflip_si: folds 
BOAYARSKIY: folds 
apfush: folds 
rmanjkeee: folds 
Avtovo: folds 
azvazdam: raises $2 to $4
Painkiller72: folds 
matiko09: folds 
Kreuznagel: calls $2
*** FLOP *** [7c Ac 8c]
Kreuznagel: checks 
azvazdam: checks 
*** TURN *** [7c Ac 8c] [Js]
Kreuznagel: checks 
azvazdam: bets $2
Kreuznagel: folds 
Uncalled bet ($2) returned to azvazdam
azvazdam collected $8.55 from pot
azvazdam: doesn't show hand 
*** SUMMARY ***
Total pot $9 | Rake $0.45 
Board [7c Ac 8c Js]
Seat 1: rmanjkeee folded before Flop (didn't bet)
Seat 2: Avtovo folded before Flop (didn't bet)
Seat 3: azvazdam collected ($8.55)
Seat 4: Painkiller72 (button) folded before Flop (didn't bet)
Seat 5: matiko09 (small blind) folded before Flop
Seat 6: Kreuznagel (big blind) folded on the Turn
Seat 7: coinflip_si folded before Flop (didn't bet)
Seat 8: BOAYARSKIY folded before Flop (didn't bet)
Seat 9: apfush folded before Flop (didn't bet)





PokerStars Hand #151208291093:  Hold'em No Limit ($0.50/$1.00 USD) - 2016/03/31 12:57:42 CET [2016/03/31 6:57:42 ET]
Table 'Haworth II' 9-max Seat #8 is the button
Seat 1: godfrey004 ($93.08 in chips) 
Seat 2: AlKatrone ($142.35 in chips) 
Seat 3: matiko09 ($100 in chips) 
Seat 4: I The King I ($107.02 in chips) 
Seat 5: Kreuznagel ($100 in chips) 
Seat 6: Pvsx. ($103.65 in chips) 
Seat 7: mheris ($150.46 in chips) 
Seat 8: oscarleon ($100 in chips) 
Seat 9: Zeeshka ($100.50 in chips) 
Zeeshka: posts small blind $0.50
godfrey004: posts big blind $1
*** HOLE CARDS ***
Dealt to matiko09 [9d 2s]
AlKatrone: folds 
matiko09: folds 
I The King I: folds 
Kreuznagel: folds 
Pvsx.: folds 
mheris: raises $3 to $4
oscarleon: folds 
Zeeshka: folds 
godfrey004: calls $3
*** FLOP *** [Kh 6s 3c]
godfrey004: checks 
mheris: bets $8
godfrey004: calls $8
*** TURN *** [Kh 6s 3c] [3s]
godfrey004: checks 
mheris: checks 
*** RIVER *** [Kh 6s 3c 3s] [Ts]
godfrey004: bets $8
mheris: folds 
Uncalled bet ($8) returned to godfrey004
godfrey004 collected $23.28 from pot
godfrey004: doesn't show hand 
*** SUMMARY ***
Total pot $24.50 | Rake $1.22 
Board [Kh 6s 3c 3s Ts]
Seat 1: godfrey004 (big blind) collected ($23.28)
Seat 2: AlKatrone folded before Flop (didn't bet)
Seat 3: matiko09 folded before Flop (didn't bet)
Seat 4: I The King I folded before Flop (didn't bet)
Seat 5: Kreuznagel folded before Flop (didn't bet)
Seat 6: Pvsx. folded before Flop (didn't bet)
Seat 7: mheris folded on the River
Seat 8: oscarleon (button) folded before Flop (didn't bet)
Seat 9: Zeeshka (small blind) folded before Flop





PokerStars Hand #151208291715:  Hold'em No Limit ($0.50/$1.00 USD) - 2016/03/31 12:57:44 CET [2016/03/31 6:57:44 ET]
Table 'Egeria II' 9-max Seat #9 is the button
Seat 1: oscarleon ($120.03 in chips) 
Seat 2: I The King I ($186.03 in chips) 
Seat 3: Pvsx. ($115.64 in chips) 
Seat 4: matiko09 ($100 in chips) 
Seat 5: apfush ($134.50 in chips) 
Seat 6: DUkalisUA ($122 in chips) 
Seat 7: Reven9er ($159.36 in chips) 
Seat 8: Kreuznagel ($116.01 in chips) 
Seat 9: miracolix50 ($62.64 in chips) 
oscarleon: posts small blind $0.50
I The King I: posts big blind $1
*** HOLE CARDS ***
Dealt to matiko09 [Ks Ts]
Pvsx.: raises $1.50 to $2.50
matiko09: folds 
apfush: raises $5.50 to $8
DUkalisUA: folds 
Reven9er: folds 
Kreuznagel: folds 
miracolix50: folds 
oscarleon: folds 
I The King I: folds 
Pvsx.: calls $5.50
*** FLOP *** [9h 2s 6c]
Pvsx.: checks 
apfush: bets $9
Pvsx.: folds 
Uncalled bet ($9) returned to apfush
apfush collected $16.62 from pot
apfush: doesn't show hand 
*** SUMMARY ***
Total pot $17.50 | Rake $0.88 
Board [9h 2s 6c]
Seat 1: oscarleon (small blind) folded before Flop
Seat 2: I The King I (big blind) folded before Flop
Seat 3: Pvsx. folded on the Flop
Seat 4: matiko09 folded before Flop (didn't bet)
Seat 5: apfush collected ($16.62)
Seat 6: DUkalisUA folded before Flop (didn't bet)
Seat 7: Reven9er folded before Flop (didn't bet)
Seat 8: Kreuznagel folded before Flop (didn't bet)
Seat 9: miracolix50 (button) folded before Flop (didn't bet)





PokerStars Hand #151208293970:  Hold'em No Limit (€0.50/€1.00 EUR) - 2016/03/31 12:57:49 CET [2016/03/31 6:57:49 ET]
Table 'Pioneer II' 9-max Seat #5 is the button
Seat 2: IdiotFromNE (€130.52 in chips) 
Seat 3: Kupumalam (€52.60 in chips) 
Seat 4: Painkiller72 (€152.96 in chips) 
Seat 5: PacPacBum (€104.72 in chips) 
Seat 6: matiko09 (€104.53 in chips) 
Seat 7: AlKatrone (€132.37 in chips) 
matiko09: posts small blind €0.50
AlKatrone: posts big blind €1
*** HOLE CARDS ***
Dealt to matiko09 [5h Ac]
IdiotFromNE: folds 
Kupumalam: folds 
Painkiller72: folds 
PacPacBum: folds 
matiko09: raises €1.50 to €2.50
AlKatrone: folds 
Uncalled bet (€1.50) returned to matiko09
matiko09 collected €2 from pot
matiko09: doesn't show hand 
*** SUMMARY ***
Total pot €2 | Rake €0 
Seat 2: IdiotFromNE folded before Flop (didn't bet)
Seat 3: Kupumalam folded before Flop (didn't bet)
Seat 4: Painkiller72 folded before Flop (didn't bet)
Seat 5: PacPacBum (button) folded before Flop (didn't bet)
Seat 6: matiko09 (small blind) collected (€2)
Seat 7: AlKatrone (big blind) folded before Flop





PokerStars Hand #151208294773:  Hold'em No Limit ($0.50/$1.00 USD) - 2016/03/31 12:57:51 CET [2016/03/31 6:57:51 ET]
Table 'Yazhi' 9-max Seat #7 is the button
Seat 1: matiko09 ($117.31 in chips) 
Seat 2: xHourglass ($136.01 in chips) 
Seat 4: apfush ($144.60 in chips) 
Seat 5: IdiotFromNE ($125.50 in chips) 
Seat 6: Reven9er ($225.99 in chips) 
Seat 7: Avtovo ($100 in chips) 
Seat 9: oscarleon ($181.59 in chips) 
oscarleon: posts small blind $0.50
matiko09: posts big blind $1
Chin41178: sits out 
*** HOLE CARDS ***
Dealt to matiko09 [5h Td]
xHourglass: folds 
apfush: folds 
IdiotFromNE: folds 
Reven9er: raises $1 to $2
Avtovo: folds 
oscarleon: folds 
matiko09: folds 
Uncalled bet ($1) returned to Reven9er
Reven9er collected $2.50 from pot
Reven9er: doesn't show hand 
*** SUMMARY ***
Total pot $2.50 | Rake $0 
Seat 1: matiko09 (big blind) folded before Flop
Seat 2: xHourglass folded before Flop (didn't bet)
Seat 4: apfush folded before Flop (didn't bet)
Seat 5: IdiotFromNE folded before Flop (didn't bet)
Seat 6: Reven9er collected ($2.50)
Seat 7: Avtovo (button) folded before Flop (didn't bet)
Seat 9: oscarleon (small blind) folded before Flop





PokerStars Hand #151208295846:  Hold'em No Limit ($0.50/$1.00 USD) - 2016/03/31 12:57:53 CET [2016/03/31 6:57:53 ET]
Table 'Herge II' 9-max Seat #8 is the button
Seat 2: o.miro ($100 in chips) 
Seat 3: matiko09 ($210.10 in chips) 
Seat 4: Kreuznagel ($106.23 in chips) 
Seat 5: I The King I ($133.73 in chips) 
Seat 7: Zeeshka ($139.95 in chips) 
Seat 8: IdiotFromNE ($102.50 in chips) 
Seat 9: fatstacks122 ($149.32 in chips) 
fatstacks122: posts small blind $0.50
o.miro: posts big blind $1
*** HOLE CARDS ***
Dealt to matiko09 [2c 3h]
matiko09: folds 
Kreuznagel: folds 
I The King I: folds 
Zeeshka: raises $2 to $3
IdiotFromNE: folds 
fatstacks122: folds 
o.miro: folds 
Uncalled bet ($2) returned to Zeeshka
Zeeshka collected $2.50 from pot
Zeeshka: doesn't show hand 
*** SUMMARY ***
Total pot $2.50 | Rake $0 
Seat 2: o.miro (big blind) folded before Flop
Seat 3: matiko09 folded before Flop (didn't bet)
Seat 4: Kreuznagel folded before Flop (didn't bet)
Seat 5: I The King I folded before Flop (didn't bet)
Seat 7: Zeeshka collected ($2.50)
Seat 8: IdiotFromNE (button) folded before Flop (didn't bet)
Seat 9: fatstacks122 (small blind) folded before Flop





PokerStars Hand #151208300603:  Hold'em No Limit ($0.50/$1.00 USD) - 2016/03/31 12:58:04 CET [2016/03/31 6:58:04 ET]
Table 'Viipuri II' 9-max Seat #3 is the button
Seat 1: Muinmyheart ($100 in chips) 
Seat 2: futa317 ($87.50 in chips) 
Seat 3: Zeeshka ($103 in chips) 
Seat 4: Miner604 ($36.51 in chips) 
Seat 5: matiko09 ($106.08 in chips) 
Seat 6: PacPacBum ($100 in chips) 
Seat 7: vicdroopy ($100 in chips) 
Seat 8: ilaviiitech ($121.38 in chips) 
Seat 9: djammusic ($38.50 in chips) 
Miner604: posts small blind $0.50
matiko09: posts big blind $1
*** HOLE CARDS ***
Dealt to matiko09 [3s 4h]
PacPacBum: folds 
vicdroopy: folds 
ilaviiitech: folds 
djammusic: raises $1.15 to $2.15
Muinmyheart: raises $3.85 to $6
futa317: folds 
Zeeshka: folds 
Miner604: folds 
matiko09: folds 
djammusic: folds 
Uncalled bet ($3.85) returned to Muinmyheart
Muinmyheart collected $5.80 from pot
Muinmyheart: doesn't show hand 
*** SUMMARY ***
Total pot $5.80 | Rake $0 
Seat 1: Muinmyheart collected ($5.80)
Seat 2: futa317 folded before Flop (didn't bet)
Seat 3: Zeeshka (button) folded before Flop (didn't bet)
Seat 4: Miner604 (small blind) folded before Flop
Seat 5: matiko09 (big blind) folded before Flop
Seat 6: PacPacBum folded before Flop (didn't bet)
Seat 7: vicdroopy folded before Flop (didn't bet)
Seat 8: ilaviiitech folded before Flop (didn't bet)
Seat 9: djammusic folded before Flop





PokerStars Hand #151208301687:  Hold'em No Limit ($1/$2 USD) - 2016/03/31 12:58:07 CET [2016/03/31 6:58:07 ET]
Table 'Delvaux II' 9-max Seat #8 is the button
Seat 1: Painkiller72 ($208.25 in chips) 
Seat 2: rmanjkeee ($82 in chips) 
Seat 3: Avtovo ($200 in chips) 
Seat 6: quinters ($206 in chips) 
Seat 7: PacPacBum ($200 in chips) 
Seat 8: matiko09 ($200 in chips) 
Seat 9: o.miro ($201.50 in chips) 
o.miro: posts small blind $1
Painkiller72: posts big blind $2
Kreuznagel: sits out 
ilaviiitech: sits out 
*** HOLE CARDS ***
Dealt to matiko09 [As Ac]
rmanjkeee: folds 
Avtovo: folds 
quinters: raises $4 to $6
PacPacBum: folds 
matiko09: raises $14 to $20
o.miro: folds 
Painkiller72: folds 
quinters: calls $14
*** FLOP *** [2d 8c 3d]
quinters: checks 
matiko09: bets $19.99
quinters: raises $22.01 to $42
matiko09: calls $22.01
*** TURN *** [2d 8c 3d] [7d]
quinters: checks 
matiko09: bets $88
quinters: raises $56 to $144 and is all-in
matiko09: calls $50 and is all-in
Uncalled bet ($6) returned to quinters
*** RIVER *** [2d 8c 3d 7d] [Ah]
*** SHOW DOWN ***
quinters: shows [4d Ad] (a flush, Ace high)
matiko09: mucks hand 
quinters collected $400.25 from pot
*** SUMMARY ***
Total pot $403 | Rake $2.75 
Board [2d 8c 3d 7d Ah]
Seat 1: Painkiller72 (big blind) folded before Flop
Seat 2: rmanjkeee folded before Flop (didn't bet)
Seat 3: Avtovo folded before Flop (didn't bet)
Seat 6: quinters showed [4d Ad] and won ($400.25) with a flush, Ace high
Seat 7: PacPacBum folded before Flop (didn't bet)
Seat 8: matiko09 (button) mucked [As Ac]
Seat 9: o.miro (small blind) folded before Flop





PokerStars Hand #151208301734:  Hold'em No Limit ($1/$2 USD) - 2016/03/31 12:58:07 CET [2016/03/31 6:58:07 ET]
Table 'Coelestina II' 9-max Seat #4 is the button
Seat 1: PacPacBum ($202.05 in chips) 
Seat 2: Kreuznagel ($234.35 in chips) 
Seat 3: ilaviiitech ($200 in chips) 
Seat 4: matiko09 ($218.72 in chips) 
Seat 5: Painkiller72 ($200 in chips) 
Seat 6: Avtovo ($235.07 in chips) 
Seat 7: rmanjkeee ($133.25 in chips) 
Seat 8: DUkalisUA ($229.31 in chips) 
Seat 9: fonng ($159.65 in chips) 
Painkiller72: posts small blind $1
Avtovo: posts big blind $2
*** HOLE CARDS ***
Dealt to matiko09 [6h 9c]
rmanjkeee: folds 
DUkalisUA: folds 
fonng: calls $2
PacPacBum: folds 
Kreuznagel: folds 
ilaviiitech: folds 
matiko09: folds 
Painkiller72: folds 
Avtovo: checks 
*** FLOP *** [8h Ad 3c]
Avtovo: checks 
fonng: checks 
*** TURN *** [8h Ad 3c] [Jc]
Avtovo: checks 
fonng: checks 
*** RIVER *** [8h Ad 3c Jc] [Td]
Avtovo: bets $4.75
fonng: raises $4.75 to $9.50
Avtovo: calls $4.75
*** SHOW DOWN ***
fonng: shows [As Ac] (three of a kind, Aces)
Avtovo: shows [7h 9h] (a straight, Seven to Jack)
Avtovo collected $22.80 from pot
*** SUMMARY ***
Total pot $24 | Rake $1.20 
Board [8h Ad 3c Jc Td]
Seat 1: PacPacBum folded before Flop (didn't bet)
Seat 2: Kreuznagel folded before Flop (didn't bet)
Seat 3: ilaviiitech folded before Flop (didn't bet)
Seat 4: matiko09 (button) folded before Flop (didn't bet)
Seat 5: Painkiller72 (small blind) folded before Flop
Seat 6: Avtovo (big blind) showed [7h 9h] and won ($22.80) with a straight, Seven to Jack
Seat 7: rmanjkeee folded before Flop (didn't bet)
Seat 8: DUkalisUA folded before Flop (didn't bet)
Seat 9: fonng showed [As Ac] and lost with three of a kind, Aces





PokerStars Hand #151208304181:  Hold'em No Limit ($0.50/$1.00 USD) - 2016/03/31 12:58:13 CET [2016/03/31 6:58:13 ET]
Table 'Yazhi' 9-max Seat #9 is the button
Seat 1: matiko09 ($116.31 in chips) 
Seat 2: xHourglass ($136.01 in chips) 
Seat 4: apfush ($144.60 in chips) 
Seat 5: IdiotFromNE ($125.50 in chips) 
Seat 6: Reven9er ($227.49 in chips) 
Seat 7: Avtovo ($100 in chips) 
Seat 9: oscarleon ($181.09 in chips) 
matiko09: posts small blind $0.50
xHourglass: posts big blind $1
Chin41178: sits out 
*** HOLE CARDS ***
Dealt to matiko09 [7h Qd]
apfush: folds 
IdiotFromNE: folds 
Reven9er: folds 
Avtovo: folds 
oscarleon: folds 
matiko09: raises $1.50 to $2.50
xHourglass: folds 
Uncalled bet ($1.50) returned to matiko09
matiko09 collected $2 from pot
matiko09: doesn't show hand 
*** SUMMARY ***
Total pot $2 | Rake $0 
Seat 1: matiko09 (small blind) collected ($2)
Seat 2: xHourglass (big blind) folded before Flop
Seat 4: apfush folded before Flop (didn't bet)
Seat 5: IdiotFromNE folded before Flop (didn't bet)
Seat 6: Reven9er folded before Flop (didn't bet)
Seat 7: Avtovo folded before Flop (didn't bet)
Seat 9: oscarleon (button) folded before Flop (didn't bet)





PokerStars Hand #151208304022:  Hold'em No Limit (€0.50/€1.00 EUR) - 2016/03/31 12:58:13 CET [2016/03/31 6:58:13 ET]
Table 'Pioneer II' 9-max Seat #6 is the button
Seat 2: IdiotFromNE (€130.52 in chips) 
Seat 3: Kupumalam (€52.60 in chips) 
Seat 4: Painkiller72 (€152.96 in chips) 
Seat 5: PacPacBum (€104.72 in chips) 
Seat 6: matiko09 (€105.53 in chips) 
Seat 7: AlKatrone (€131.37 in chips) 
AlKatrone: posts small blind €0.50
IdiotFromNE: posts big blind €1
*** HOLE CARDS ***
Dealt to matiko09 [4c Jc]
Kupumalam: folds 
Painkiller72: folds 
PacPacBum: raises €1.50 to €2.50
matiko09: folds 
AlKatrone: folds 
IdiotFromNE: calls €1.50
*** FLOP *** [Kc 7c 6s]
IdiotFromNE: checks 
PacPacBum: checks 
*** TURN *** [Kc 7c 6s] [3c]
IdiotFromNE: checks 
PacPacBum: checks 
*** RIVER *** [Kc 7c 6s 3c] [Qc]
IdiotFromNE: checks 
PacPacBum: checks 
*** SHOW DOWN ***
IdiotFromNE: shows [Th 7h] (a pair of Sevens)
PacPacBum: shows [9s 9c] (a flush, King high)
PacPacBum collected €5.22 from pot
*** SUMMARY ***
Total pot €5.50 | Rake €0.28 
Board [Kc 7c 6s 3c Qc]
Seat 2: IdiotFromNE (big blind) showed [Th 7h] and lost with a pair of Sevens
Seat 3: Kupumalam folded before Flop (didn't bet)
Seat 4: Painkiller72 folded before Flop (didn't bet)
Seat 5: PacPacBum showed [9s 9c] and won (€5.22) with a flush, King high
Seat 6: matiko09 (button) folded before Flop (didn't bet)
Seat 7: AlKatrone (small blind) folded before Flop





PokerStars Hand #151208310100:  Hold'em No Limit ($0.50/$1.00 USD) - 2016/03/31 12:58:27 CET [2016/03/31 6:58:27 ET]
Table 'Herge II' 9-max Seat #9 is the button
Seat 2: o.miro ($100 in chips) 
Seat 3: matiko09 ($210.10 in chips) 
Seat 4: Kreuznagel ($106.23 in chips) 
Seat 5: I The King I ($133.73 in chips) 
Seat 7: Zeeshka ($141.45 in chips) 
Seat 8: IdiotFromNE ($102.50 in chips) 
Seat 9: fatstacks122 ($148.82 in chips) 
o.miro: posts small blind $0.50
matiko09: posts big blind $1
*** HOLE CARDS ***
Dealt to matiko09 [9s Ks]
Kreuznagel: raises $1.39 to $2.39
I The King I: folds 
Zeeshka: folds 
IdiotFromNE: folds 
fatstacks122: folds 
o.miro: folds 
matiko09: folds 
Uncalled bet ($1.39) returned to Kreuznagel
Kreuznagel collected $2.50 from pot
Kreuznagel: doesn't show hand 
*** SUMMARY ***
Total pot $2.50 | Rake $0 
Seat 2: o.miro (small blind) folded before Flop
Seat 3: matiko09 (big blind) folded before Flop
Seat 4: Kreuznagel collected ($2.50)
Seat 5: I The King I folded before Flop (didn't bet)
Seat 7: Zeeshka folded before Flop (didn't bet)
Seat 8: IdiotFromNE folded before Flop (didn't bet)
Seat 9: fatstacks122 (button) folded before Flop (didn't bet)





PokerStars Hand #151208314283:  Hold'em No Limit ($0.50/$1.00 USD) - 2016/03/31 12:58:37 CET [2016/03/31 6:58:37 ET]
Table 'Yazhi' 9-max Seat #1 is the button
Seat 1: matiko09 ($117.31 in chips) 
Seat 2: xHourglass ($135.01 in chips) 
Seat 3: Chin41178 ($92.41 in chips) 
Seat 4: apfush ($144.60 in chips) 
Seat 5: IdiotFromNE ($125.50 in chips) 
Seat 6: Reven9er ($227.49 in chips) 
Seat 7: Avtovo ($100 in chips) 
Seat 9: oscarleon ($181.09 in chips) 
xHourglass: posts small blind $0.50
Chin41178: posts big blind $1
*** HOLE CARDS ***
Dealt to matiko09 [Ac 7d]
apfush: folds 
IdiotFromNE: folds 
Reven9er: folds 
Avtovo: folds 
oscarleon: folds 
matiko09: raises $1.27 to $2.27
xHourglass: folds 
Chin41178: calls $1.27
*** FLOP *** [8d Kh Js]
Chin41178: checks 
matiko09: checks 
*** TURN *** [8d Kh Js] [7h]
Chin41178: checks 
matiko09: checks 
*** RIVER *** [8d Kh Js 7h] [8h]
Chin41178: checks 
matiko09: checks 
*** SHOW DOWN ***
Chin41178: shows [Tc Qc] (a pair of Eights)
matiko09: shows [Ac 7d] (two pair, Eights and Sevens)
matiko09 collected $4.79 from pot
*** SUMMARY ***
Total pot $5.04 | Rake $0.25 
Board [8d Kh Js 7h 8h]
Seat 1: matiko09 (button) showed [Ac 7d] and won ($4.79) with two pair, Eights and Sevens
Seat 2: xHourglass (small blind) folded before Flop
Seat 3: Chin41178 (big blind) showed [Tc Qc] and lost with a pair of Eights
Seat 4: apfush folded before Flop (didn't bet)
Seat 5: IdiotFromNE folded before Flop (didn't bet)
Seat 6: Reven9er folded before Flop (didn't bet)
Seat 7: Avtovo folded before Flop (didn't bet)
Seat 9: oscarleon folded before Flop (didn't bet)





PokerStars Hand #151208314398:  Hold'em No Limit ($1/$2 USD) - 2016/03/31 12:58:37 CET [2016/03/31 6:58:37 ET]
Table 'Probitas' 9-max Seat #5 is the button
Seat 1: rmanjkeee ($304.27 in chips) 
Seat 2: Avtovo ($200 in chips) 
Seat 3: azvazdam ($244.64 in chips) 
Seat 4: Painkiller72 ($214.21 in chips) 
Seat 5: matiko09 ($200 in chips) 
Seat 6: Kreuznagel ($451.33 in chips) 
Seat 7: coinflip_si ($295.53 in chips) 
Seat 8: BOAYARSKIY ($138.67 in chips) 
Seat 9: apfush ($297.99 in chips) 
Kreuznagel: posts small blind $1
coinflip_si: posts big blind $2
*** HOLE CARDS ***
Dealt to matiko09 [5d 9h]
BOAYARSKIY: folds 
apfush: raises $4 to $6
rmanjkeee: folds 
Avtovo: folds 
azvazdam: folds 
Painkiller72: folds 
matiko09: folds 
Kreuznagel: folds 
coinflip_si: folds 
Uncalled bet ($4) returned to apfush
apfush collected $5 from pot
apfush: doesn't show hand 
*** SUMMARY ***
Total pot $5 | Rake $0 
Seat 1: rmanjkeee folded before Flop (didn't bet)
Seat 2: Avtovo folded before Flop (didn't bet)
Seat 3: azvazdam folded before Flop (didn't bet)
Seat 4: Painkiller72 folded before Flop (didn't bet)
Seat 5: matiko09 (button) folded before Flop (didn't bet)
Seat 6: Kreuznagel (small blind) folded before Flop
Seat 7: coinflip_si (big blind) folded before Flop
Seat 8: BOAYARSKIY folded before Flop (didn't bet)
Seat 9: apfush collected ($5)





PokerStars Hand #151208314953:  Hold'em No Limit ($0.50/$1.00 USD) - 2016/03/31 12:58:38 CET [2016/03/31 6:58:38 ET]
Table 'Viipuri II' 9-max Seat #4 is the button
Seat 1: Muinmyheart ($103.65 in chips) 
Seat 2: futa317 ($87.50 in chips) 
Seat 3: Zeeshka ($103 in chips) 
Seat 4: Miner604 ($36.01 in chips) 
Seat 5: matiko09 ($105.08 in chips) 
Seat 6: PacPacBum ($100 in chips) 
Seat 7: vicdroopy ($100 in chips) 
Seat 8: ilaviiitech ($121.38 in chips) 
Seat 9: djammusic ($36.35 in chips) 
matiko09: posts small blind $0.50
PacPacBum: posts big blind $1
*** HOLE CARDS ***
Dealt to matiko09 [6d 5d]
vicdroopy: folds 
ilaviiitech: folds 
djammusic: folds 
Muinmyheart: folds 
futa317: calls $1
Zeeshka: folds 
Miner604: raises $2 to $3
matiko09: folds 
PacPacBum: folds 
futa317: calls $2
*** FLOP *** [Jd Kh 7s]
futa317: checks 
Miner604: checks 
*** TURN *** [Jd Kh 7s] [7h]
futa317: checks 
Miner604: bets $2
futa317: calls $2
*** RIVER *** [Jd Kh 7s 7h] [8s]
futa317: checks 
Miner604: checks 
*** SHOW DOWN ***
futa317: shows [Qd 8d] (two pair, Eights and Sevens)
Miner604: shows [Tc Jc] (two pair, Jacks and Sevens)
Miner604 collected $10.92 from pot
*** SUMMARY ***
Total pot $11.50 | Rake $0.58 
Board [Jd Kh 7s 7h 8s]
Seat 1: Muinmyheart folded before Flop (didn't bet)
Seat 2: futa317 showed [Qd 8d] and lost with two pair, Eights and Sevens
Seat 3: Zeeshka folded before Flop (didn't bet)
Seat 4: Miner604 (button) showed [Tc Jc] and won ($10.92) with two pair, Jacks and Sevens
Seat 5: matiko09 (small blind) folded before Flop
Seat 6: PacPacBum (big blind) folded before Flop
Seat 7: vicdroopy folded before Flop (didn't bet)
Seat 8: ilaviiitech folded before Flop (didn't bet)
Seat 9: djammusic folded before Flop (didn't bet)





PokerStars Hand #151208325277:  Hold'em No Limit ($0.50/$1.00 USD) - 2016/03/31 12:59:02 CET [2016/03/31 6:59:02 ET]
Table 'Egeria II' 9-max Seat #1 is the button
Seat 1: oscarleon ($119.53 in chips) 
Seat 2: I The King I ($185.03 in chips) 
Seat 3: Pvsx. ($107.64 in chips) 
Seat 4: matiko09 ($100 in chips) 
Seat 5: apfush ($143.12 in chips) 
Seat 6: DUkalisUA ($122 in chips) 
Seat 7: Reven9er ($159.36 in chips) 
Seat 8: Kreuznagel ($116.01 in chips) 
Seat 9: miracolix50 ($62.64 in chips) 
I The King I: posts small blind $0.50
Pvsx.: posts big blind $1
*** HOLE CARDS ***
Dealt to matiko09 [Jh 2h]
matiko09: folds 
apfush: folds 
DUkalisUA: folds 
Reven9er: folds 
Kreuznagel: folds 
miracolix50: folds 
oscarleon: folds 
I The King I: raises $2 to $3
Pvsx.: raises $6 to $9
I The King I: folds 
Uncalled bet ($6) returned to Pvsx.
Pvsx. collected $6 from pot
Pvsx.: doesn't show hand 
*** SUMMARY ***
Total pot $6 | Rake $0 
Seat 1: oscarleon (button) folded before Flop (didn't bet)
Seat 2: I The King I (small blind) folded before Flop
Seat 3: Pvsx. (big blind) collected ($6)
Seat 4: matiko09 folded before Flop (didn't bet)
Seat 5: apfush folded before Flop (didn't bet)
Seat 6: DUkalisUA folded before Flop (didn't bet)
Seat 7: Reven9er folded before Flop (didn't bet)
Seat 8: Kreuznagel folded before Flop (didn't bet)
Seat 9: miracolix50 folded before Flop (didn't bet)





PokerStars Hand #151208327982:  Hold'em No Limit (€0.50/€1.00 EUR) - 2016/03/31 12:59:08 CET [2016/03/31 6:59:08 ET]
Table 'Pioneer II' 9-max Seat #7 is the button
Seat 2: IdiotFromNE (€128.02 in chips) 
Seat 3: Kupumalam (€52.60 in chips) 
Seat 4: Painkiller72 (€152.96 in chips) 
Seat 5: PacPacBum (€107.44 in chips) 
Seat 6: matiko09 (€105.53 in chips) 
Seat 7: AlKatrone (€130.87 in chips) 
IdiotFromNE: posts small blind €0.50
Kupumalam: posts big blind €1
*** HOLE CARDS ***
Dealt to matiko09 [2d Td]
Painkiller72: folds 
PacPacBum: folds 
matiko09: folds 
AlKatrone: folds 
IdiotFromNE: raises €1.50 to €2.50
Kupumalam: raises €4.16 to €6.66
IdiotFromNE: folds 
Uncalled bet (€4.16) returned to Kupumalam
Kupumalam collected €5 from pot
*** SUMMARY ***
Total pot €5 | Rake €0 
Seat 2: IdiotFromNE (small blind) folded before Flop
Seat 3: Kupumalam (big blind) collected (€5)
Seat 4: Painkiller72 folded before Flop (didn't bet)
Seat 5: PacPacBum folded before Flop (didn't bet)
Seat 6: matiko09 folded before Flop (didn't bet)
Seat 7: AlKatrone (button) folded before Flop (didn't bet)





PokerStars Hand #151208328030:  Hold'em No Limit ($0.50/$1.00 USD) - 2016/03/31 12:59:09 CET [2016/03/31 6:59:09 ET]
Table 'Herge II' 9-max Seat #2 is the button
Seat 2: o.miro ($100 in chips) 
Seat 3: matiko09 ($209.10 in chips) 
Seat 4: Kreuznagel ($107.73 in chips) 
Seat 5: I The King I ($133.73 in chips) 
Seat 7: Zeeshka ($141.45 in chips) 
Seat 8: IdiotFromNE ($102.50 in chips) 
Seat 9: fatstacks122 ($148.82 in chips) 
matiko09: posts small blind $0.50
Kreuznagel: posts big blind $1
*** HOLE CARDS ***
Dealt to matiko09 [7s 2h]
I The King I: folds 
Zeeshka: folds 
IdiotFromNE: folds 
fatstacks122: folds 
o.miro: raises $1.50 to $2.50
matiko09: folds 
Kreuznagel: folds 
Uncalled bet ($1.50) returned to o.miro
o.miro collected $2.50 from pot
o.miro: doesn't show hand 
*** SUMMARY ***
Total pot $2.50 | Rake $0 
Seat 2: o.miro (button) collected ($2.50)
Seat 3: matiko09 (small blind) folded before Flop
Seat 4: Kreuznagel (big blind) folded before Flop
Seat 5: I The King I folded before Flop (didn't bet)
Seat 7: Zeeshka folded before Flop (didn't bet)
Seat 8: IdiotFromNE folded before Flop (didn't bet)
Seat 9: fatstacks122 folded before Flop (didn't bet)





PokerStars Hand #151208335321:  Hold'em No Limit ($1/$2 USD) - 2016/03/31 12:59:26 CET [2016/03/31 6:59:26 ET]
Table 'Coelestina II' 9-max Seat #5 is the button
Seat 1: PacPacBum ($202.05 in chips) 
Seat 2: Kreuznagel ($234.35 in chips) 
Seat 3: ilaviiitech ($200 in chips) 
Seat 4: matiko09 ($218.72 in chips) 
Seat 5: Painkiller72 ($200 in chips) 
Seat 6: Avtovo ($246.37 in chips) 
Seat 7: rmanjkeee ($133.25 in chips) 
Seat 8: DUkalisUA ($229.31 in chips) 
Seat 9: fonng ($148.15 in chips) 
Avtovo: posts small blind $1
rmanjkeee: posts big blind $2
*** HOLE CARDS ***
Dealt to matiko09 [Ks Jc]
DUkalisUA: folds 
DUkalisUA leaves the table
fonng: folds 
PacPacBum: folds 
Kreuznagel: folds 
ilaviiitech: folds 
matiko09: raises $3 to $5
Painkiller72: folds 
Avtovo: folds 
rmanjkeee: folds 
Uncalled bet ($3) returned to matiko09
matiko09 collected $5 from pot
matiko09: doesn't show hand 
*** SUMMARY ***
Total pot $5 | Rake $0 
Seat 1: PacPacBum folded before Flop (didn't bet)
Seat 2: Kreuznagel folded before Flop (didn't bet)
Seat 3: ilaviiitech folded before Flop (didn't bet)
Seat 4: matiko09 collected ($5)
Seat 5: Painkiller72 (button) folded before Flop (didn't bet)
Seat 6: Avtovo (small blind) folded before Flop
Seat 7: rmanjkeee (big blind) folded before Flop
Seat 8: DUkalisUA folded before Flop (didn't bet)
Seat 9: fonng folded before Flop (didn't bet)





PokerStars Hand #151208336696:  Hold'em No Limit ($0.50/$1.00 USD) - 2016/03/31 12:59:29 CET [2016/03/31 6:59:29 ET]
Table 'Viipuri II' 9-max Seat #5 is the button
Seat 1: Muinmyheart ($103.65 in chips) 
Seat 2: futa317 ($82.50 in chips) 
Seat 3: Zeeshka ($103 in chips) 
Seat 4: Miner604 ($41.93 in chips) 
Seat 5: matiko09 ($104.58 in chips) 
Seat 6: PacPacBum ($100 in chips) 
Seat 7: vicdroopy ($100 in chips) 
Seat 8: ilaviiitech ($121.38 in chips) 
Seat 9: djammusic ($36.35 in chips) 
PacPacBum: posts small blind $0.50
vicdroopy: posts big blind $1
*** HOLE CARDS ***
Dealt to matiko09 [Td 4s]
ilaviiitech: folds 
djammusic: folds 
Muinmyheart: folds 
futa317: calls $1
Zeeshka: folds 
Miner604: folds 
matiko09: folds 
PacPacBum: calls $0.50
vicdroopy: raises $4.50 to $5.50
futa317: calls $4.50
PacPacBum: calls $4.50
*** FLOP *** [Jh Ad Tc]
PacPacBum: checks 
vicdroopy: bets $12
futa317: folds 
PacPacBum: folds 
Uncalled bet ($12) returned to vicdroopy
vicdroopy collected $15.68 from pot
vicdroopy: doesn't show hand 
*** SUMMARY ***
Total pot $16.50 | Rake $0.82 
Board [Jh Ad Tc]
Seat 1: Muinmyheart folded before Flop (didn't bet)
Seat 2: futa317 folded on the Flop
Seat 3: Zeeshka folded before Flop (didn't bet)
Seat 4: Miner604 folded before Flop (didn't bet)
Seat 5: matiko09 (button) folded before Flop (didn't bet)
Seat 6: PacPacBum (small blind) folded on the Flop
Seat 7: vicdroopy (big blind) collected ($15.68)
Seat 8: ilaviiitech folded before Flop (didn't bet)
Seat 9: djammusic folded before Flop (didn't bet)





PokerStars Hand #151208338125:  Hold'em No Limit ($0.50/$1.00 USD) - 2016/03/31 12:59:32 CET [2016/03/31 6:59:32 ET]
Table 'Haworth II' 9-max Seat #9 is the button
Seat 1: godfrey004 ($104.36 in chips) 
Seat 2: AlKatrone ($142.35 in chips) 
Seat 3: matiko09 ($100 in chips) 
Seat 4: I The King I ($107.02 in chips) 
Seat 5: Kreuznagel ($100 in chips) 
Seat 6: Pvsx. ($103.65 in chips) 
Seat 7: mheris ($138.46 in chips) 
Seat 8: oscarleon ($100 in chips) 
Seat 9: Zeeshka ($100 in chips) 
godfrey004: posts small blind $0.50
AlKatrone: posts big blind $1
*** HOLE CARDS ***
Dealt to matiko09 [Tc 3s]
matiko09: folds 
I The King I: folds 
Kreuznagel: folds 
Pvsx.: raises $1.50 to $2.50
mheris: folds 
oscarleon: folds 
Zeeshka: folds 
godfrey004: folds 
AlKatrone: folds 
Uncalled bet ($1.50) returned to Pvsx.
Pvsx. collected $2.50 from pot
Pvsx.: doesn't show hand 
*** SUMMARY ***
Total pot $2.50 | Rake $0 
Seat 1: godfrey004 (small blind) folded before Flop
Seat 2: AlKatrone (big blind) folded before Flop
Seat 3: matiko09 folded before Flop (didn't bet)
Seat 4: I The King I folded before Flop (didn't bet)
Seat 5: Kreuznagel folded before Flop (didn't bet)
Seat 6: Pvsx. collected ($2.50)
Seat 7: mheris folded before Flop (didn't bet)
Seat 8: oscarleon folded before Flop (didn't bet)
Seat 9: Zeeshka (button) folded before Flop (didn't bet)





PokerStars Hand #151208344620:  Hold'em No Limit ($1/$2 USD) - 2016/03/31 12:59:47 CET [2016/03/31 6:59:47 ET]
Table 'Probitas' 9-max Seat #6 is the button
Seat 1: rmanjkeee ($304.27 in chips) 
Seat 2: Avtovo ($200 in chips) 
Seat 3: azvazdam ($244.64 in chips) 
Seat 4: Painkiller72 ($214.21 in chips) 
Seat 5: matiko09 ($200 in chips) 
Seat 6: Kreuznagel ($450.33 in chips) 
Seat 7: coinflip_si ($293.53 in chips) 
Seat 8: BOAYARSKIY ($138.67 in chips) 
Seat 9: apfush ($300.99 in chips) 
coinflip_si: posts small blind $1
BOAYARSKIY: posts big blind $2
*** HOLE CARDS ***
Dealt to matiko09 [6s Ad]
apfush: folds 
rmanjkeee: folds 
Avtovo: folds 
azvazdam: raises $2 to $4
Painkiller72: folds 
matiko09: folds 
Kreuznagel: folds 
coinflip_si: folds 
BOAYARSKIY: folds 
Uncalled bet ($2) returned to azvazdam
azvazdam collected $5 from pot
azvazdam: doesn't show hand 
*** SUMMARY ***
Total pot $5 | Rake $0 
Seat 1: rmanjkeee folded before Flop (didn't bet)
Seat 2: Avtovo folded before Flop (didn't bet)
Seat 3: azvazdam collected ($5)
Seat 4: Painkiller72 folded before Flop (didn't bet)
Seat 5: matiko09 folded before Flop (didn't bet)
Seat 6: Kreuznagel (button) folded before Flop (didn't bet)
Seat 7: coinflip_si (small blind) folded before Flop
Seat 8: BOAYARSKIY (big blind) folded before Flop
Seat 9: apfush folded before Flop (didn't bet)





PokerStars Hand #151208345524:  Hold'em No Limit ($0.50/$1.00 USD) - 2016/03/31 12:59:49 CET [2016/03/31 6:59:49 ET]
Table 'Yazhi' 9-max Seat #2 is the button
Seat 1: matiko09 ($119.83 in chips) 
Seat 2: xHourglass ($134.51 in chips) 
Seat 3: Chin41178 ($90.14 in chips) 
Seat 4: apfush ($144.60 in chips) 
Seat 5: IdiotFromNE ($125.50 in chips) 
Seat 6: Reven9er ($227.49 in chips) 
Seat 7: Avtovo ($100 in chips) 
Seat 9: oscarleon ($181.09 in chips) 
Chin41178: posts small blind $0.50
apfush: posts big blind $1
*** HOLE CARDS ***
Dealt to matiko09 [8c 4d]
IdiotFromNE: folds 
Reven9er: folds 
Avtovo: folds 
oscarleon: folds 
matiko09: folds 
xHourglass: folds 
Chin41178: calls $0.50
apfush: checks 
*** FLOP *** [Ac Kd Ah]
Chin41178: checks 
apfush: checks 
*** TURN *** [Ac Kd Ah] [5s]
Chin41178: checks 
apfush: checks 
*** RIVER *** [Ac Kd Ah 5s] [8d]
Chin41178: checks 
apfush: checks 
*** SHOW DOWN ***
Chin41178: shows [Tc 7c] (a pair of Aces)
apfush: shows [Js 8h] (two pair, Aces and Eights)
apfush collected $1.90 from pot
*** SUMMARY ***
Total pot $2 | Rake $0.10 
Board [Ac Kd Ah 5s 8d]
Seat 1: matiko09 folded before Flop (didn't bet)
Seat 2: xHourglass (button) folded before Flop (didn't bet)
Seat 3: Chin41178 (small blind) showed [Tc 7c] and lost with a pair of Aces
Seat 4: apfush (big blind) showed [Js 8h] and won ($1.90) with two pair, Aces and Eights
Seat 5: IdiotFromNE folded before Flop (didn't bet)
Seat 6: Reven9er folded before Flop (didn't bet)
Seat 7: Avtovo folded before Flop (didn't bet)
Seat 9: oscarleon folded before Flop (didn't bet)





PokerStars Hand #151208346850:  Hold'em No Limit ($1/$2 USD) - 2016/03/31 12:59:52 CET [2016/03/31 6:59:52 ET]
Table 'Delvaux II' 9-max Seat #9 is the button
Seat 1: Painkiller72 ($206.25 in chips) 
Seat 2: rmanjkeee ($82 in chips) 
Seat 3: Avtovo ($200 in chips) 
Seat 6: quinters ($406.25 in chips) 
Seat 7: PacPacBum ($200 in chips) 
Seat 8: matiko09 ($200 in chips) 
Seat 9: o.miro ($200.50 in chips) 
Painkiller72: posts small blind $1
rmanjkeee: posts big blind $2
Kreuznagel: sits out 
ilaviiitech: sits out 
*** HOLE CARDS ***
Dealt to matiko09 [Tc 4c]
Avtovo: raises $3 to $5
quinters: folds 
PacPacBum: folds 
matiko09: folds 
o.miro: folds 
Painkiller72: folds 
rmanjkeee: calls $3
*** FLOP *** [8h 2h Ts]
rmanjkeee: checks 
Avtovo: bets $6
rmanjkeee: folds 
Uncalled bet ($6) returned to Avtovo
Avtovo collected $10.45 from pot
Avtovo: doesn't show hand 
*** SUMMARY ***
Total pot $11 | Rake $0.55 
Board [8h 2h Ts]
Seat 1: Painkiller72 (small blind) folded before Flop
Seat 2: rmanjkeee (big blind) folded on the Flop
Seat 3: Avtovo collected ($10.45)
Seat 6: quinters folded before Flop (didn't bet)
Seat 7: PacPacBum folded before Flop (didn't bet)
Seat 8: matiko09 folded before Flop (didn't bet)
Seat 9: o.miro (button) folded before Flop (didn't bet)





PokerStars Hand #151208348094:  Hold'em No Limit (€0.50/€1.00 EUR) - 2016/03/31 12:59:55 CET [2016/03/31 6:59:55 ET]
Table 'Pioneer II' 9-max Seat #2 is the button
Seat 2: IdiotFromNE (€125.52 in chips) 
Seat 3: Kupumalam (€55.10 in chips) 
Seat 4: Painkiller72 (€152.96 in chips) 
Seat 5: PacPacBum (€107.44 in chips) 
Seat 6: matiko09 (€105.53 in chips) 
Seat 7: AlKatrone (€130.87 in chips) 
Kupumalam: posts small blind €0.50
Painkiller72: posts big blind €1
*** HOLE CARDS ***
Dealt to matiko09 [Ks 2d]
PacPacBum: folds 
matiko09: folds 
AlKatrone: raises €1.50 to €2.50
IdiotFromNE: folds 
Kupumalam: calls €2
Painkiller72: folds 
*** FLOP *** [2h Jd Tc]
Kupumalam: checks 
AlKatrone: checks 
*** TURN *** [2h Jd Tc] [Th]
Kupumalam: bets €5
AlKatrone: folds 
Uncalled bet (€5) returned to Kupumalam
Kupumalam collected €5.70 from pot
*** SUMMARY ***
Total pot €6 | Rake €0.30 
Board [2h Jd Tc Th]
Seat 2: IdiotFromNE (button) folded before Flop (didn't bet)
Seat 3: Kupumalam (small blind) collected (€5.70)
Seat 4: Painkiller72 (big blind) folded before Flop
Seat 5: PacPacBum folded before Flop (didn't bet)
Seat 6: matiko09 folded before Flop (didn't bet)
Seat 7: AlKatrone folded on the Turn





PokerStars Hand #151208352205:  Hold'em No Limit ($0.50/$1.00 USD) - 2016/03/31 13:00:04 CET [2016/03/31 7:00:04 ET]
Table 'Herge II' 9-max Seat #3 is the button
Seat 2: o.miro ($101.50 in chips) 
Seat 3: matiko09 ($208.60 in chips) 
Seat 4: Kreuznagel ($106.73 in chips) 
Seat 5: I The King I ($133.73 in chips) 
Seat 7: Zeeshka ($141.45 in chips) 
Seat 8: IdiotFromNE ($102.50 in chips) 
Seat 9: fatstacks122 ($148.82 in chips) 
Kreuznagel: posts small blind $0.50
I The King I: posts big blind $1
*** HOLE CARDS ***
Dealt to matiko09 [8s 9d]
Zeeshka: folds 
IdiotFromNE: folds 
fatstacks122: folds 
o.miro: folds 
matiko09: folds 
Kreuznagel: raises $2.13 to $3.13
I The King I: raises $5.87 to $9
Kreuznagel: folds 
Uncalled bet ($5.87) returned to I The King I
I The King I collected $6.26 from pot
I The King I: doesn't show hand 
*** SUMMARY ***
Total pot $6.26 | Rake $0 
Seat 2: o.miro folded before Flop (didn't bet)
Seat 3: matiko09 (button) folded before Flop (didn't bet)
Seat 4: Kreuznagel (small blind) folded before Flop
Seat 5: I The King I (big blind) collected ($6.26)
Seat 7: Zeeshka folded before Flop (didn't bet)
Seat 8: IdiotFromNE folded before Flop (didn't bet)
Seat 9: fatstacks122 folded before Flop (didn't bet)





PokerStars Hand #151208355331:  Hold'em No Limit ($0.50/$1.00 USD) - 2016/03/31 13:00:11 CET [2016/03/31 7:00:11 ET]
Table 'Egeria II' 9-max Seat #2 is the button
Seat 1: oscarleon ($119.53 in chips) 
Seat 2: I The King I ($182.03 in chips) 
Seat 3: Pvsx. ($110.64 in chips) 
Seat 4: matiko09 ($100 in chips) 
Seat 5: apfush ($143.12 in chips) 
Seat 6: DUkalisUA ($122 in chips) 
Seat 7: Reven9er ($159.36 in chips) 
Seat 8: Kreuznagel ($116.01 in chips) 
Seat 9: miracolix50 ($62.64 in chips) 
Pvsx.: posts small blind $0.50
matiko09: posts big blind $1
*** HOLE CARDS ***
Dealt to matiko09 [As 5s]
apfush: folds 
DUkalisUA: folds 
Reven9er: raises $1 to $2
Kreuznagel: folds 
miracolix50: folds 
oscarleon: folds 
I The King I: folds 
Pvsx.: folds 
matiko09: calls $1
*** FLOP *** [9h 7d Ac]
matiko09: checks 
Reven9er: bets $2.50
matiko09: calls $2.50
*** TURN *** [9h 7d Ac] [Jc]
DUkalisUA leaves the table
matiko09: checks 
Reven9er: checks 
*** RIVER *** [9h 7d Ac Jc] [Jd]
Avtovo joins the table at seat #6 
matiko09: checks 
Reven9er: checks 
*** SHOW DOWN ***
matiko09: shows [As 5s] (two pair, Aces and Jacks)
Reven9er: mucks hand 
matiko09 collected $9.02 from pot
*** SUMMARY ***
Total pot $9.50 | Rake $0.48 
Board [9h 7d Ac Jc Jd]
Seat 1: oscarleon folded before Flop (didn't bet)
Seat 2: I The King I (button) folded before Flop (didn't bet)
Seat 3: Pvsx. (small blind) folded before Flop
Seat 4: matiko09 (big blind) showed [As 5s] and won ($9.02) with two pair, Aces and Jacks
Seat 5: apfush folded before Flop (didn't bet)
Seat 6: DUkalisUA folded before Flop (didn't bet)
Seat 7: Reven9er mucked [Tc Th]
Seat 8: Kreuznagel folded before Flop (didn't bet)
Seat 9: miracolix50 folded before Flop (didn't bet)





PokerStars Hand #151208358755:  Hold'em No Limit ($0.50/$1.00 USD) - 2016/03/31 13:00:19 CET [2016/03/31 7:00:19 ET]
Table 'Viipuri II' 9-max Seat #6 is the button
Seat 1: Muinmyheart ($103.65 in chips) 
Seat 2: futa317 ($77 in chips) 
Seat 3: Zeeshka ($103 in chips) 
Seat 4: Miner604 ($41.93 in chips) 
Seat 5: matiko09 ($104.58 in chips) 
Seat 6: PacPacBum ($100 in chips) 
Seat 7: vicdroopy ($110.18 in chips) 
Seat 8: ilaviiitech ($121.38 in chips) 
Seat 9: djammusic ($36.35 in chips) 
vicdroopy: posts small blind $0.50
ilaviiitech: posts big blind $1
*** HOLE CARDS ***
Dealt to matiko09 [3s Ad]
djammusic: folds 
Muinmyheart: folds 
futa317: calls $1
Zeeshka: folds 
Miner604: folds 
matiko09: folds 
PacPacBum: raises $3 to $4
vicdroopy: folds 
ilaviiitech: raises $8 to $12
futa317: calls $11
PacPacBum: folds 
*** FLOP *** [5h 9h 8d]
ilaviiitech: checks 
futa317: bets $13.54
ilaviiitech: folds 
Uncalled bet ($13.54) returned to futa317
futa317 collected $27.08 from pot
futa317: doesn't show hand 
*** SUMMARY ***
Total pot $28.50 | Rake $1.42 
Board [5h 9h 8d]
Seat 1: Muinmyheart folded before Flop (didn't bet)
Seat 2: futa317 collected ($27.08)
Seat 3: Zeeshka folded before Flop (didn't bet)
Seat 4: Miner604 folded before Flop (didn't bet)
Seat 5: matiko09 folded before Flop (didn't bet)
Seat 6: PacPacBum (button) folded before Flop
Seat 7: vicdroopy (small blind) folded before Flop
Seat 8: ilaviiitech (big blind) folded on the Flop
Seat 9: djammusic folded before Flop (didn't bet)





PokerStars Hand #151208358941:  Hold'em No Limit ($0.50/$1.00 USD) - 2016/03/31 13:00:20 CET [2016/03/31 7:00:20 ET]
Table 'Haworth II' 9-max Seat #1 is the button
Seat 1: godfrey004 ($103.86 in chips) 
Seat 2: AlKatrone ($141.35 in chips) 
Seat 3: matiko09 ($100 in chips) 
Seat 4: I The King I ($107.02 in chips) 
Seat 5: Kreuznagel ($100 in chips) 
Seat 6: Pvsx. ($105.15 in chips) 
Seat 7: mheris ($138.46 in chips) 
Seat 8: oscarleon ($100 in chips) 
Seat 9: Zeeshka ($100 in chips) 
AlKatrone: posts small blind $0.50
matiko09: posts big blind $1
*** HOLE CARDS ***
Dealt to matiko09 [Ad Qh]
I The King I: folds 
Kreuznagel: folds 
Pvsx.: raises $1.50 to $2.50
mheris: folds 
oscarleon: folds 
Zeeshka: folds 
godfrey004: folds 
AlKatrone: folds 
matiko09: calls $1.50
*** FLOP *** [Jh 5d 9d]
matiko09: checks 
Pvsx.: bets $2.61
matiko09: raises $7.39 to $10
Pvsx.: calls $7.39
*** TURN *** [Jh 5d 9d] [3c]
matiko09: checks 
Pvsx.: bets $12.11
matiko09: folds 
Uncalled bet ($12.11) returned to Pvsx.
Pvsx. collected $24.22 from pot
Pvsx.: doesn't show hand 
*** SUMMARY ***
Total pot $25.50 | Rake $1.28 
Board [Jh 5d 9d 3c]
Seat 1: godfrey004 (button) folded before Flop (didn't bet)
Seat 2: AlKatrone (small blind) folded before Flop
Seat 3: matiko09 (big blind) folded on the Turn
Seat 4: I The King I folded before Flop (didn't bet)
Seat 5: Kreuznagel folded before Flop (didn't bet)
Seat 6: Pvsx. collected ($24.22)
Seat 7: mheris folded before Flop (didn't bet)
Seat 8: oscarleon folded before Flop (didn't bet)
Seat 9: Zeeshka folded before Flop (didn't bet)





PokerStars Hand #151208361611:  Hold'em No Limit ($1/$2 USD) - 2016/03/31 13:00:26 CET [2016/03/31 7:00:26 ET]
Table 'Delvaux II' 9-max Seat #1 is the button
Seat 1: Painkiller72 ($205.25 in chips) 
Seat 2: rmanjkeee ($80 in chips) 
Seat 3: Avtovo ($205.45 in chips) 
Seat 6: quinters ($406.25 in chips) 
Seat 7: PacPacBum ($200 in chips) 
Seat 8: matiko09 ($200 in chips) 
Seat 9: o.miro ($200.50 in chips) 
rmanjkeee: posts small blind $1
Avtovo: posts big blind $2
Kreuznagel: sits out 
ilaviiitech: sits out 
*** HOLE CARDS ***
Dealt to matiko09 [2s 6s]
quinters: folds 
PacPacBum: folds 
matiko09: folds 
o.miro: folds 
Painkiller72: folds 
rmanjkeee: raises $3 to $5
Avtovo: folds 
Uncalled bet ($3) returned to rmanjkeee
rmanjkeee collected $4 from pot
rmanjkeee: doesn't show hand 
*** SUMMARY ***
Total pot $4 | Rake $0 
Seat 1: Painkiller72 (button) folded before Flop (didn't bet)
Seat 2: rmanjkeee (small blind) collected ($4)
Seat 3: Avtovo (big blind) folded before Flop
Seat 6: quinters folded before Flop (didn't bet)
Seat 7: PacPacBum folded before Flop (didn't bet)
Seat 8: matiko09 folded before Flop (didn't bet)
Seat 9: o.miro folded before Flop (didn't bet)





PokerStars Hand #151208365161:  Hold'em No Limit ($1/$2 USD) - 2016/03/31 13:00:34 CET [2016/03/31 7:00:34 ET]
Table 'Probitas' 9-max Seat #7 is the button
Seat 1: rmanjkeee ($304.27 in chips) 
Seat 2: Avtovo ($200 in chips) 
Seat 3: azvazdam ($247.64 in chips) 
Seat 4: Painkiller72 ($214.21 in chips) 
Seat 5: matiko09 ($200 in chips) 
Seat 6: Kreuznagel ($450.33 in chips) 
Seat 7: coinflip_si ($292.53 in chips) 
Seat 8: BOAYARSKIY ($136.67 in chips) 
Seat 9: apfush ($300.99 in chips) 
BOAYARSKIY: posts small blind $1
apfush: posts big blind $2
*** HOLE CARDS ***
Dealt to matiko09 [Js Ad]
rmanjkeee: folds 
Avtovo: folds 
azvazdam: folds 
Painkiller72: folds 
matiko09: raises $3 to $5
Kreuznagel: folds 
coinflip_si: folds 
BOAYARSKIY: folds 
apfush: folds 
Uncalled bet ($3) returned to matiko09
matiko09 collected $5 from pot
matiko09: doesn't show hand 
*** SUMMARY ***
Total pot $5 | Rake $0 
Seat 1: rmanjkeee folded before Flop (didn't bet)
Seat 2: Avtovo folded before Flop (didn't bet)
Seat 3: azvazdam folded before Flop (didn't bet)
Seat 4: Painkiller72 folded before Flop (didn't bet)
Seat 5: matiko09 collected ($5)
Seat 6: Kreuznagel folded before Flop (didn't bet)
Seat 7: coinflip_si (button) folded before Flop (didn't bet)
Seat 8: BOAYARSKIY (small blind) folded before Flop
Seat 9: apfush (big blind) folded before Flop





PokerStars Hand #151208366333:  Hold'em No Limit ($1/$2 USD) - 2016/03/31 13:00:36 CET [2016/03/31 7:00:36 ET]
Table 'Coelestina II' 9-max Seat #6 is the button
Seat 1: PacPacBum ($202.05 in chips) 
Seat 2: Kreuznagel ($234.35 in chips) 
Seat 3: ilaviiitech ($200 in chips) 
Seat 4: matiko09 ($221.72 in chips) 
Seat 5: Painkiller72 ($200 in chips) 
Seat 6: Avtovo ($245.37 in chips) 
Seat 7: rmanjkeee ($131.25 in chips) 
Seat 9: fonng ($148.15 in chips) 
rmanjkeee: posts small blind $1
fonng: posts big blind $2
*** HOLE CARDS ***
Dealt to matiko09 [Kc 8s]
PacPacBum: folds 
Kreuznagel: folds 
ilaviiitech: folds 
leosnaz joins the table at seat #8 
matiko09: folds 
Painkiller72: folds 
Avtovo: folds 
rmanjkeee: raises $3 to $5
fonng: raises $5 to $10
rmanjkeee: raises $18 to $28
fonng: calls $18
*** FLOP *** [Kh 3h 6d]
rmanjkeee: checks 
fonng: checks 
*** TURN *** [Kh 3h 6d] [As]
rmanjkeee: bets $28
fonng: calls $28
*** RIVER *** [Kh 3h 6d As] [Js]
rmanjkeee: bets $75.25 and is all-in
fonng: folds 
Uncalled bet ($75.25) returned to rmanjkeee
rmanjkeee collected $109.25 from pot
rmanjkeee: doesn't show hand 
*** SUMMARY ***
Total pot $112 | Rake $2.75 
Board [Kh 3h 6d As Js]
Seat 1: PacPacBum folded before Flop (didn't bet)
Seat 2: Kreuznagel folded before Flop (didn't bet)
Seat 3: ilaviiitech folded before Flop (didn't bet)
Seat 4: matiko09 folded before Flop (didn't bet)
Seat 5: Painkiller72 folded before Flop (didn't bet)
Seat 6: Avtovo (button) folded before Flop (didn't bet)
Seat 7: rmanjkeee (small blind) collected ($109.25)
Seat 9: fonng (big blind) folded on the River





PokerStars Hand #151208368828:  Hold'em No Limit ($0.50/$1.00 USD) - 2016/03/31 13:00:42 CET [2016/03/31 7:00:42 ET]
Table 'Herge II' 9-max Seat #4 is the button
Seat 2: o.miro ($101.50 in chips) 
Seat 3: matiko09 ($208.60 in chips) 
Seat 4: Kreuznagel ($103.60 in chips) 
Seat 5: I The King I ($136.86 in chips) 
Seat 7: Zeeshka ($141.45 in chips) 
Seat 8: IdiotFromNE ($102.50 in chips) 
Seat 9: fatstacks122 ($148.82 in chips) 
I The King I: posts small blind $0.50
Zeeshka: posts big blind $1
*** HOLE CARDS ***
Dealt to matiko09 [8d Ac]
IdiotFromNE: folds 
fatstacks122: folds 
o.miro: folds 
matiko09: folds 
Kreuznagel: folds 
I The King I: calls $0.50
Zeeshka: raises $2.95 to $3.95
I The King I: calls $2.95
*** FLOP *** [Tc 4s 5h]
I The King I: checks 
Zeeshka: bets $3.50
I The King I: calls $3.50
*** TURN *** [Tc 4s 5h] [Td]
I The King I: checks 
Zeeshka: checks 
*** RIVER *** [Tc 4s 5h Td] [Ks]
I The King I: checks 
Zeeshka: bets $6
I The King I: calls $6
*** SHOW DOWN ***
Zeeshka: shows [Kc 5c] (two pair, Kings and Tens)
I The King I: mucks hand 
Zeeshka collected $25.56 from pot
*** SUMMARY ***
Total pot $26.90 | Rake $1.34 
Board [Tc 4s 5h Td Ks]
Seat 2: o.miro folded before Flop (didn't bet)
Seat 3: matiko09 folded before Flop (didn't bet)
Seat 4: Kreuznagel (button) folded before Flop (didn't bet)
Seat 5: I The King I (small blind) mucked [As 4h]
Seat 7: Zeeshka (big blind) showed [Kc 5c] and won ($25.56) with two pair, Kings and Tens
Seat 8: IdiotFromNE folded before Flop (didn't bet)
Seat 9: fatstacks122 folded before Flop (didn't bet)





PokerStars Hand #151208371134:  Hold'em No Limit ($1/$2 USD) - 2016/03/31 13:00:47 CET [2016/03/31 7:00:47 ET]
Table 'Delvaux II' 9-max Seat #2 is the button
Seat 1: Painkiller72 ($205.25 in chips) 
Seat 2: rmanjkeee ($82 in chips) 
Seat 3: Avtovo ($203.45 in chips) 
Seat 4: Kreuznagel ($200 in chips) 
Seat 6: quinters ($406.25 in chips) 
Seat 7: PacPacBum ($200 in chips) 
Seat 8: matiko09 ($200 in chips) 
Seat 9: o.miro ($200.50 in chips) 
Avtovo: posts small blind $1
Kreuznagel: posts big blind $2
ilaviiitech: sits out 
*** HOLE CARDS ***
Dealt to matiko09 [8d Td]
quinters: folds 
PacPacBum: folds 
matiko09: folds 
o.miro: folds 
Painkiller72: raises $3 to $5
rmanjkeee: calls $5
Avtovo: folds 
Kreuznagel: folds 
*** FLOP *** [2h 4c 5s]
Painkiller72: bets $8.64
rmanjkeee: folds 
Uncalled bet ($8.64) returned to Painkiller72
Painkiller72 collected $12.35 from pot
Painkiller72: doesn't show hand 
*** SUMMARY ***
Total pot $13 | Rake $0.65 
Board [2h 4c 5s]
Seat 1: Painkiller72 collected ($12.35)
Seat 2: rmanjkeee (button) folded on the Flop
Seat 3: Avtovo (small blind) folded before Flop
Seat 4: Kreuznagel (big blind) folded before Flop
Seat 6: quinters folded before Flop (didn't bet)
Seat 7: PacPacBum folded before Flop (didn't bet)
Seat 8: matiko09 folded before Flop (didn't bet)
Seat 9: o.miro folded before Flop (didn't bet)





PokerStars Hand #151208373992:  Hold'em No Limit ($0.50/$1.00 USD) - 2016/03/31 13:00:53 CET [2016/03/31 7:00:53 ET]
Table 'Kalyke III' 9-max Seat #6 is the button
Seat 5: FranzisFlush ($81.90 in chips) 
Seat 6: PacPacBum ($100 in chips) 
Seat 7: djammusic ($39 in chips) 
Seat 8: matiko09 ($100 in chips) 
djammusic: posts small blind $0.50
matiko09: posts big blind $1
Zeeshka: sits out 
*** HOLE CARDS ***
Dealt to matiko09 [4c Qh]
FranzisFlush: folds 
q3972551 joins the table at seat #4 
PacPacBum: folds 
djammusic: raises $1.15 to $2.15
matiko09: folds 
Uncalled bet ($1.15) returned to djammusic
djammusic collected $2 from pot
djammusic: doesn't show hand 
*** SUMMARY ***
Total pot $2 | Rake $0 
Seat 5: FranzisFlush folded before Flop (didn't bet)
Seat 6: PacPacBum (button) folded before Flop (didn't bet)
Seat 7: djammusic (small blind) collected ($2)
Seat 8: matiko09 (big blind) folded before Flop





PokerStars Hand #151208377697:  Hold'em No Limit ($0.50/$1.00 USD) - 2016/03/31 13:01:01 CET [2016/03/31 7:01:01 ET]
Table 'Yazhi' 9-max Seat #3 is the button
Seat 1: matiko09 ($119.83 in chips) 
Seat 2: xHourglass ($134.51 in chips) 
Seat 3: Chin41178 ($89.14 in chips) 
Seat 4: apfush ($145.50 in chips) 
Seat 5: IdiotFromNE ($125.50 in chips) 
Seat 6: Reven9er ($227.49 in chips) 
Seat 7: Avtovo ($100 in chips) 
Seat 9: oscarleon ($181.09 in chips) 
apfush: posts small blind $0.50
IdiotFromNE: posts big blind $1
*** HOLE CARDS ***
Dealt to matiko09 [5d 5s]
Reven9er: folds 
Avtovo: folds 
oscarleon: folds 
matiko09: raises $2 to $3
xHourglass: folds 
Chin41178: folds 
apfush: folds 
IdiotFromNE: folds 
Uncalled bet ($2) returned to matiko09
matiko09 collected $2.50 from pot
matiko09: doesn't show hand 
*** SUMMARY ***
Total pot $2.50 | Rake $0 
Seat 1: matiko09 collected ($2.50)
Seat 2: xHourglass folded before Flop (didn't bet)
Seat 3: Chin41178 (button) folded before Flop (didn't bet)
Seat 4: apfush (small blind) folded before Flop
Seat 5: IdiotFromNE (big blind) folded before Flop
Seat 6: Reven9er folded before Flop (didn't bet)
Seat 7: Avtovo folded before Flop (didn't bet)
Seat 9: oscarleon folded before Flop (didn't bet)





PokerStars Hand #151208383217:  Hold'em No Limit ($1/$2 USD) - 2016/03/31 13:01:13 CET [2016/03/31 7:01:13 ET]
Table 'Probitas' 9-max Seat #8 is the button
Seat 1: rmanjkeee ($304.27 in chips) 
Seat 2: Avtovo ($200 in chips) 
Seat 3: azvazdam ($247.64 in chips) 
Seat 4: Painkiller72 ($214.21 in chips) 
Seat 5: matiko09 ($203 in chips) 
Seat 6: Kreuznagel ($450.33 in chips) 
Seat 7: coinflip_si ($292.53 in chips) 
Seat 8: BOAYARSKIY ($135.67 in chips) 
Seat 9: apfush ($298.99 in chips) 
apfush: posts small blind $1
rmanjkeee: posts big blind $2
*** HOLE CARDS ***
Dealt to matiko09 [5c Qs]
Avtovo: folds 
azvazdam: raises $4 to $6
Painkiller72: raises $12 to $18
matiko09: folds 
Kreuznagel: folds 
coinflip_si: folds 
BOAYARSKIY: folds 
apfush: folds 
rmanjkeee: folds 
azvazdam: calls $12
*** FLOP *** [7s Tc Ah]
azvazdam: checks 
Painkiller72: checks 
*** TURN *** [7s Tc Ah] [2s]
azvazdam: checks 
Painkiller72: bets $25.93
azvazdam: calls $25.93
*** RIVER *** [7s Tc Ah 2s] [8d]
azvazdam: bets $203.71 and is all-in
Painkiller72: calls $170.28 and is all-in
Uncalled bet ($33.43) returned to azvazdam
*** SHOW DOWN ***
azvazdam: shows [Ac 8c] (two pair, Aces and Eights)
Painkiller72: shows [As Ad] (three of a kind, Aces)
Painkiller72 collected $428.67 from pot
*** SUMMARY ***
Total pot $431.42 | Rake $2.75 
Board [7s Tc Ah 2s 8d]
Seat 1: rmanjkeee (big blind) folded before Flop
Seat 2: Avtovo folded before Flop (didn't bet)
Seat 3: azvazdam showed [Ac 8c] and lost with two pair, Aces and Eights
Seat 4: Painkiller72 showed [As Ad] and won ($428.67) with three of a kind, Aces
Seat 5: matiko09 folded before Flop (didn't bet)
Seat 6: Kreuznagel folded before Flop (didn't bet)
Seat 7: coinflip_si folded before Flop (didn't bet)
Seat 8: BOAYARSKIY (button) folded before Flop (didn't bet)
Seat 9: apfush (small blind) folded before Flop





PokerStars Hand #151208384172:  Hold'em No Limit (€0.50/€1.00 EUR) - 2016/03/31 13:01:15 CET [2016/03/31 7:01:15 ET]
Table 'Pioneer II' 9-max Seat #3 is the button
Seat 2: IdiotFromNE (€125.52 in chips) 
Seat 3: Kupumalam (€58.30 in chips) 
Seat 4: Painkiller72 (€151.96 in chips) 
Seat 5: PacPacBum (€107.44 in chips) 
Seat 6: matiko09 (€105.53 in chips) 
Seat 7: AlKatrone (€128.37 in chips) 
Painkiller72: posts small blind €0.50
PacPacBum: posts big blind €1
*** HOLE CARDS ***
Dealt to matiko09 [7s 9s]
matiko09: folds 
AlKatrone: folds 
IdiotFromNE: raises €1.50 to €2.50
Kupumalam: folds 
Painkiller72: folds 
PacPacBum: folds 
Uncalled bet (€1.50) returned to IdiotFromNE
IdiotFromNE collected €2.50 from pot
IdiotFromNE: doesn't show hand 
*** SUMMARY ***
Total pot €2.50 | Rake €0 
Seat 2: IdiotFromNE collected (€2.50)
Seat 3: Kupumalam (button) folded before Flop (didn't bet)
Seat 4: Painkiller72 (small blind) folded before Flop
Seat 5: PacPacBum (big blind) folded before Flop
Seat 6: matiko09 folded before Flop (didn't bet)
Seat 7: AlKatrone folded before Flop (didn't bet)





PokerStars Hand #151208387342:  Hold'em No Limit ($0.50/$1.00 USD) - 2016/03/31 13:01:22 CET [2016/03/31 7:01:22 ET]
Table 'Kalyke III' 9-max Seat #7 is the button
Seat 3: Zeeshka ($100 in chips) 
Seat 5: FranzisFlush ($81.90 in chips) 
Seat 6: PacPacBum ($100 in chips) 
Seat 7: djammusic ($40 in chips) 
Seat 8: matiko09 ($100 in chips) 
matiko09: posts small blind $0.50
Zeeshka: posts big blind $1
q3972551: sits out 
*** HOLE CARDS ***
Dealt to matiko09 [3s 3d]
FranzisFlush: folds 
PacPacBum: folds 
djammusic: raises $1.02 to $2.02
apfush joins the table at seat #1 
zhano69 joins the table at seat #2 
matiko09: folds 
Zeeshka: raises $4.98 to $7
djammusic: folds 
Uncalled bet ($4.98) returned to Zeeshka
Zeeshka collected $4.54 from pot
Zeeshka: doesn't show hand 
*** SUMMARY ***
Total pot $4.54 | Rake $0 
Seat 3: Zeeshka (big blind) collected ($4.54)
Seat 5: FranzisFlush folded before Flop (didn't bet)
Seat 6: PacPacBum folded before Flop (didn't bet)
Seat 7: djammusic (button) folded before Flop
Seat 8: matiko09 (small blind) folded before Flop





PokerStars Hand #151208389052:  Hold'em No Limit ($0.50/$1.00 USD) - 2016/03/31 13:01:26 CET [2016/03/31 7:01:26 ET]
Table 'Viipuri II' 9-max Seat #7 is the button
Seat 1: Muinmyheart ($103.65 in chips) 
Seat 2: futa317 ($92.08 in chips) 
Seat 3: Zeeshka ($103 in chips) 
Seat 4: Miner604 ($41.93 in chips) 
Seat 5: matiko09 ($104.58 in chips) 
Seat 6: PacPacBum ($100 in chips) 
Seat 7: vicdroopy ($109.68 in chips) 
Seat 8: ilaviiitech ($109.38 in chips) 
Seat 9: djammusic ($36.35 in chips) 
ilaviiitech: posts small blind $0.50
djammusic: posts big blind $1
*** HOLE CARDS ***
Dealt to matiko09 [8h 6s]
Muinmyheart: folds 
futa317: folds 
Zeeshka: folds 
Miner604: folds 
matiko09: folds 
PacPacBum: folds 
vicdroopy: raises $1 to $2
ilaviiitech: folds 
djammusic: folds 
Uncalled bet ($1) returned to vicdroopy
vicdroopy collected $2.50 from pot
vicdroopy: doesn't show hand 
*** SUMMARY ***
Total pot $2.50 | Rake $0 
Seat 1: Muinmyheart folded before Flop (didn't bet)
Seat 2: futa317 folded before Flop (didn't bet)
Seat 3: Zeeshka folded before Flop (didn't bet)
Seat 4: Miner604 folded before Flop (didn't bet)
Seat 5: matiko09 folded before Flop (didn't bet)
Seat 6: PacPacBum folded before Flop (didn't bet)
Seat 7: vicdroopy (button) collected ($2.50)
Seat 8: ilaviiitech (small blind) folded before Flop
Seat 9: djammusic (big blind) folded before Flop





PokerStars Hand #151208393902:  Hold'em No Limit ($1/$2 USD) - 2016/03/31 13:01:36 CET [2016/03/31 7:01:36 ET]
Table 'Delvaux II' 9-max Seat #3 is the button
Seat 1: Painkiller72 ($212.60 in chips) 
Seat 2: rmanjkeee ($80 in chips) 
Seat 3: Avtovo ($202.45 in chips) 
Seat 4: Kreuznagel ($200 in chips) 
Seat 5: ilaviiitech ($200 in chips) 
Seat 6: quinters ($406.25 in chips) 
Seat 7: PacPacBum ($200 in chips) 
Seat 8: matiko09 ($200 in chips) 
Seat 9: o.miro ($200.50 in chips) 
Kreuznagel: posts small blind $1
ilaviiitech: posts big blind $2
*** HOLE CARDS ***
Dealt to matiko09 [9h 2c]
quinters: raises $3 to $5
PacPacBum: folds 
matiko09: folds 
o.miro: folds 
Painkiller72: raises $13 to $18
rmanjkeee: raises $62 to $80 and is all-in
Avtovo: folds 
Kreuznagel: folds 
ilaviiitech: folds 
quinters: folds 
Painkiller72: folds 
Uncalled bet ($62) returned to rmanjkeee
ilaviiitech leaves the table
rmanjkeee collected $44 from pot
rmanjkeee: doesn't show hand 
*** SUMMARY ***
Total pot $44 | Rake $0 
Seat 1: Painkiller72 folded before Flop
Seat 2: rmanjkeee collected ($44)
Seat 3: Avtovo (button) folded before Flop (didn't bet)
Seat 4: Kreuznagel (small blind) folded before Flop
Seat 5: ilaviiitech (big blind) folded before Flop
Seat 6: quinters folded before Flop
Seat 7: PacPacBum folded before Flop (didn't bet)
Seat 8: matiko09 folded before Flop (didn't bet)
Seat 9: o.miro folded before Flop (didn't bet)





PokerStars Hand #151208398042:  Hold'em No Limit (€0.50/€1.00 EUR) - 2016/03/31 13:01:45 CET [2016/03/31 7:01:45 ET]
Table 'Pioneer II' 9-max Seat #4 is the button
Seat 2: IdiotFromNE (€127.02 in chips) 
Seat 3: Kupumalam (€58.30 in chips) 
Seat 4: Painkiller72 (€151.46 in chips) 
Seat 5: PacPacBum (€106.44 in chips) 
Seat 6: matiko09 (€105.53 in chips) 
Seat 7: AlKatrone (€128.37 in chips) 
PacPacBum: posts small blind €0.50
matiko09: posts big blind €1
*** HOLE CARDS ***
Dealt to matiko09 [8h 8c]
AlKatrone: folds 
IdiotFromNE: folds 
Kupumalam: folds 
Painkiller72: folds 
PacPacBum: raises €1.50 to €2.50
matiko09: calls €1.50
*** FLOP *** [5h Kd Jh]
PacPacBum: checks 
matiko09: checks 
*** TURN *** [5h Kd Jh] [As]
PacPacBum: checks 
matiko09: checks 
*** RIVER *** [5h Kd Jh As] [7c]
PacPacBum: checks 
matiko09: checks 
*** SHOW DOWN ***
PacPacBum: shows [Tc Td] (a pair of Tens)
matiko09: mucks hand 
PacPacBum collected €4.75 from pot
*** SUMMARY ***
Total pot €5 | Rake €0.25 
Board [5h Kd Jh As 7c]
Seat 2: IdiotFromNE folded before Flop (didn't bet)
Seat 3: Kupumalam folded before Flop (didn't bet)
Seat 4: Painkiller72 (button) folded before Flop (didn't bet)
Seat 5: PacPacBum (small blind) showed [Tc Td] and won (€4.75) with a pair of Tens
Seat 6: matiko09 (big blind) mucked [8h 8c]
Seat 7: AlKatrone folded before Flop (didn't bet)





PokerStars Hand #151208402283:  Hold'em No Limit ($0.50/$1.00 USD) - 2016/03/31 13:01:53 CET [2016/03/31 7:01:53 ET]
Table 'Yazhi' 9-max Seat #4 is the button
Seat 1: matiko09 ($121.33 in chips) 
Seat 2: xHourglass ($134.51 in chips) 
Seat 3: Chin41178 ($89.14 in chips) 
Seat 4: apfush ($145 in chips) 
Seat 5: IdiotFromNE ($124.50 in chips) 
Seat 6: Reven9er ($227.49 in chips) 
Seat 7: Avtovo ($100 in chips) 
Seat 9: oscarleon ($181.09 in chips) 
IdiotFromNE: posts small blind $0.50
Reven9er: posts big blind $1
pk4DW: sits out 
*** HOLE CARDS ***
Dealt to matiko09 [Jc Jh]
Avtovo: folds 
oscarleon: folds 
matiko09: raises $2 to $3
xHourglass: folds 
Chin41178: folds 
apfush: folds 
IdiotFromNE: folds 
Reven9er: folds 
Uncalled bet ($2) returned to matiko09
matiko09 collected $2.50 from pot
matiko09: doesn't show hand 
*** SUMMARY ***
Total pot $2.50 | Rake $0 
Seat 1: matiko09 collected ($2.50)
Seat 2: xHourglass folded before Flop (didn't bet)
Seat 3: Chin41178 folded before Flop (didn't bet)
Seat 4: apfush (button) folded before Flop (didn't bet)
Seat 5: IdiotFromNE (small blind) folded before Flop
Seat 6: Reven9er (big blind) folded before Flop
Seat 7: Avtovo folded before Flop (didn't bet)
Seat 9: oscarleon folded before Flop (didn't bet)





PokerStars Hand #151208402654:  Hold'em No Limit ($0.50/$1.00 USD) - 2016/03/31 13:01:54 CET [2016/03/31 7:01:54 ET]
Table 'Egeria II' 9-max Seat #3 is the button
Seat 1: oscarleon ($119.53 in chips) 
Seat 2: I The King I ($182.03 in chips) 
Seat 3: Pvsx. ($110.14 in chips) 
Seat 4: matiko09 ($104.52 in chips) 
Seat 5: apfush ($143.12 in chips) 
Seat 7: Reven9er ($154.86 in chips) 
Seat 8: Kreuznagel ($116.01 in chips) 
Seat 9: miracolix50 ($62.64 in chips) 
matiko09: posts small blind $0.50
apfush: posts big blind $1
Avtovo: sits out 
*** HOLE CARDS ***
Dealt to matiko09 [5h 4h]
Reven9er: folds 
Kreuznagel: folds 
miracolix50: calls $1
oscarleon: folds 
I The King I: folds 
Pvsx.: folds 
matiko09: calls $0.50
apfush: checks 
*** FLOP *** [Kc 2h Td]
matiko09: checks 
apfush: checks 
miracolix50: bets $2.85
matiko09: folds 
apfush: raises $14.65 to $17.50
miracolix50: calls $14.65
*** TURN *** [Kc 2h Td] [6c]
apfush: bets $45
miracolix50: calls $44.14 and is all-in
Uncalled bet ($0.86) returned to apfush
*** RIVER *** [Kc 2h Td 6c] [2c]
*** SHOW DOWN ***
apfush: shows [Ts 2d] (a full house, Deuces full of Tens)
miracolix50: shows [Ah Ac] (two pair, Aces and Deuces)
apfush collected $123.78 from pot
*** SUMMARY ***
Total pot $126.28 | Rake $2.50 
Board [Kc 2h Td 6c 2c]
Seat 1: oscarleon folded before Flop (didn't bet)
Seat 2: I The King I folded before Flop (didn't bet)
Seat 3: Pvsx. (button) folded before Flop (didn't bet)
Seat 4: matiko09 (small blind) folded on the Flop
Seat 5: apfush (big blind) showed [Ts 2d] and won ($123.78) with a full house, Deuces full of Tens
Seat 7: Reven9er folded before Flop (didn't bet)
Seat 8: Kreuznagel folded before Flop (didn't bet)
Seat 9: miracolix50 showed [Ah Ac] and lost with two pair, Aces and Deuces





PokerStars Hand #151208408092:  Hold'em No Limit ($0.50/$1.00 USD) - 2016/03/31 13:02:05 CET [2016/03/31 7:02:05 ET]
Table 'Herge II' 9-max Seat #5 is the button
Seat 2: o.miro ($101.50 in chips) 
Seat 3: matiko09 ($208.60 in chips) 
Seat 4: Kreuznagel ($103.60 in chips) 
Seat 5: I The King I ($123.41 in chips) 
Seat 7: Zeeshka ($153.56 in chips) 
Seat 8: IdiotFromNE ($102.50 in chips) 
Seat 9: fatstacks122 ($148.82 in chips) 
Zeeshka: posts small blind $0.50
IdiotFromNE: posts big blind $1
*** HOLE CARDS ***
Dealt to matiko09 [5d As]
fatstacks122: folds 
o.miro: folds 
matiko09: folds 
Kreuznagel: raises $1.50 to $2.50
I The King I: calls $2.50
Zeeshka: folds 
IdiotFromNE: folds 
*** FLOP *** [Qd 3d 4h]
Kreuznagel: checks 
I The King I: checks 
*** TURN *** [Qd 3d 4h] [4s]
Kreuznagel: checks 
I The King I: checks 
*** RIVER *** [Qd 3d 4h 4s] [Td]
Kreuznagel: checks 
I The King I: checks 
*** SHOW DOWN ***
Kreuznagel: shows [Ah 7h] (a pair of Fours)
I The King I: shows [2d 2c] (two pair, Fours and Deuces)
I The King I collected $6.18 from pot
*** SUMMARY ***
Total pot $6.50 | Rake $0.32 
Board [Qd 3d 4h 4s Td]
Seat 2: o.miro folded before Flop (didn't bet)
Seat 3: matiko09 folded before Flop (didn't bet)
Seat 4: Kreuznagel showed [Ah 7h] and lost with a pair of Fours
Seat 5: I The King I (button) showed [2d 2c] and won ($6.18) with two pair, Fours and Deuces
Seat 7: Zeeshka (small blind) folded before Flop
Seat 8: IdiotFromNE (big blind) folded before Flop
Seat 9: fatstacks122 folded before Flop (didn't bet)





PokerStars Hand #151208410493:  Hold'em No Limit ($0.50/$1.00 USD) - 2016/03/31 13:02:10 CET [2016/03/31 7:02:10 ET]
Table 'Kalyke III' 9-max Seat #8 is the button
Seat 3: Zeeshka ($102.52 in chips) 
Seat 4: q3972551 ($68.21 in chips) 
Seat 5: FranzisFlush ($81.90 in chips) 
Seat 6: PacPacBum ($100 in chips) 
Seat 7: djammusic ($37.98 in chips) 
Seat 8: matiko09 ($100 in chips) 
apfush will be allowed to play after the button
zhano69 will be allowed to play after the button
Zeeshka: posts small blind $0.50
q3972551: posts big blind $1
*** HOLE CARDS ***
Dealt to matiko09 [2h Qh]
FranzisFlush: folds 
PacPacBum: folds 
djammusic: folds 
matiko09: folds 
Zeeshka: folds 
Uncalled bet ($0.50) returned to q3972551
q3972551 collected $1 from pot
q3972551: doesn't show hand 
*** SUMMARY ***
Total pot $1 | Rake $0 
Seat 3: Zeeshka (small blind) folded before Flop
Seat 4: q3972551 (big blind) collected ($1)
Seat 5: FranzisFlush folded before Flop (didn't bet)
Seat 6: PacPacBum folded before Flop (didn't bet)
Seat 7: djammusic folded before Flop (didn't bet)
Seat 8: matiko09 (button) folded before Flop (didn't bet)





PokerStars Hand #151208411855:  Hold'em No Limit ($0.50/$1.00 USD) - 2016/03/31 13:02:13 CET [2016/03/31 7:02:13 ET]
Table 'Viipuri II' 9-max Seat #8 is the button
Seat 1: Muinmyheart ($103.65 in chips) 
Seat 2: futa317 ($92.08 in chips) 
Seat 3: Zeeshka ($103 in chips) 
Seat 4: Miner604 ($41.93 in chips) 
Seat 5: matiko09 ($104.58 in chips) 
Seat 6: PacPacBum ($100 in chips) 
Seat 7: vicdroopy ($111.18 in chips) 
Seat 8: ilaviiitech ($108.88 in chips) 
Seat 9: djammusic ($35.35 in chips) 
djammusic: posts small blind $0.50
Muinmyheart: posts big blind $1
*** HOLE CARDS ***
Dealt to matiko09 [3h Td]
futa317: folds 
Zeeshka: folds 
Miner604: calls $1
matiko09: folds 
PacPacBum: folds 
vicdroopy: raises $3.50 to $4.50
ilaviiitech: folds 
djammusic: folds 
Muinmyheart: folds 
Miner604: calls $3.50
*** FLOP *** [2d 8c 2h]
Miner604: checks 
vicdroopy: bets $6.50
Miner604: calls $6.50
*** TURN *** [2d 8c 2h] [Jh]
Miner604: checks 
vicdroopy: checks 
*** RIVER *** [2d 8c 2h Jh] [Qc]
Miner604: bets $15
vicdroopy: folds 
Uncalled bet ($15) returned to Miner604
Miner604 collected $22.32 from pot
*** SUMMARY ***
Total pot $23.50 | Rake $1.18 
Board [2d 8c 2h Jh Qc]
Seat 1: Muinmyheart (big blind) folded before Flop
Seat 2: futa317 folded before Flop (didn't bet)
Seat 3: Zeeshka folded before Flop (didn't bet)
Seat 4: Miner604 collected ($22.32)
Seat 5: matiko09 folded before Flop (didn't bet)
Seat 6: PacPacBum folded before Flop (didn't bet)
Seat 7: vicdroopy folded on the River
Seat 8: ilaviiitech (button) folded before Flop (didn't bet)
Seat 9: djammusic (small blind) folded before Flop





PokerStars Hand #151208412363:  Hold'em No Limit ($0.50/$1.00 USD) - 2016/03/31 13:02:14 CET [2016/03/31 7:02:14 ET]
Table 'Haworth II' 9-max Seat #2 is the button
Seat 1: godfrey004 ($103.86 in chips) 
Seat 2: AlKatrone ($140.85 in chips) 
Seat 3: matiko09 ($100 in chips) 
Seat 4: I The King I ($107.02 in chips) 
Seat 5: Kreuznagel ($100 in chips) 
Seat 6: Pvsx. ($116.87 in chips) 
Seat 7: mheris ($138.46 in chips) 
Seat 8: oscarleon ($100 in chips) 
Seat 9: Zeeshka ($100 in chips) 
matiko09: posts small blind $0.50
I The King I: posts big blind $1
*** HOLE CARDS ***
Dealt to matiko09 [3s 9h]
Kreuznagel: folds 
Pvsx.: folds 
mheris: raises $3 to $4
oscarleon: folds 
Zeeshka: folds 
godfrey004: folds 
AlKatrone: folds 
matiko09: folds 
I The King I: folds 
Uncalled bet ($3) returned to mheris
mheris collected $2.50 from pot
mheris: doesn't show hand 
*** SUMMARY ***
Total pot $2.50 | Rake $0 
Seat 1: godfrey004 folded before Flop (didn't bet)
Seat 2: AlKatrone (button) folded before Flop (didn't bet)
Seat 3: matiko09 (small blind) folded before Flop
Seat 4: I The King I (big blind) folded before Flop
Seat 5: Kreuznagel folded before Flop (didn't bet)
Seat 6: Pvsx. folded before Flop (didn't bet)
Seat 7: mheris collected ($2.50)
Seat 8: oscarleon folded before Flop (didn't bet)
Seat 9: Zeeshka folded before Flop (didn't bet)





PokerStars Hand #151208414666:  Hold'em No Limit ($0.50/$1.00 USD) - 2016/03/31 13:02:19 CET [2016/03/31 7:02:19 ET]
Table 'Reginita II' 9-max Seat #1 is the button
Seat 1: crazymon 36 ($36.69 in chips) 
Seat 2: PacPacBum ($100 in chips) 
Seat 4: matiko09 ($100 in chips) 
Seat 5: Reven9er ($359.13 in chips) 
Seat 6: IdiotFromNE ($103.12 in chips) 
Seat 7: 20grodt16 ($104.15 in chips) 
Seat 8: RICKA16 ($97 in chips) 
Seat 9: oscarleon ($195.96 in chips) 
PacPacBum: posts small blind $0.50
BOAYARSKIY: is sitting out 
matiko09: posts big blind $1
*** HOLE CARDS ***
Dealt to matiko09 [5c 2c]
BOAYARSKIY leaves the table
Reven9er: folds 
IdiotFromNE: folds 
20grodt16: folds 
vicdroopy joins the table at seat #3 
RICKA16: folds 
oscarleon: folds 
crazymon 36: folds 
PacPacBum: raises $1.50 to $2.50
matiko09: folds 
Uncalled bet ($1.50) returned to PacPacBum
PacPacBum collected $2 from pot
PacPacBum: doesn't show hand 
*** SUMMARY ***
Total pot $2 | Rake $0 
Seat 1: crazymon 36 (button) folded before Flop (didn't bet)
Seat 2: PacPacBum (small blind) collected ($2)
Seat 4: matiko09 (big blind) folded before Flop
Seat 5: Reven9er folded before Flop (didn't bet)
Seat 6: IdiotFromNE folded before Flop (didn't bet)
Seat 7: 20grodt16 folded before Flop (didn't bet)
Seat 8: RICKA16 folded before Flop (didn't bet)
Seat 9: oscarleon folded before Flop (didn't bet)





PokerStars Hand #151208415907:  Hold'em No Limit ($1/$2 USD) - 2016/03/31 13:02:22 CET [2016/03/31 7:02:22 ET]
Table 'Coelestina II' 9-max Seat #7 is the button
Seat 1: PacPacBum ($202.05 in chips) 
Seat 2: Kreuznagel ($234.35 in chips) 
Seat 3: ilaviiitech ($200 in chips) 
Seat 4: matiko09 ($221.72 in chips) 
Seat 5: Painkiller72 ($200 in chips) 
Seat 6: Avtovo ($245.37 in chips) 
Seat 7: rmanjkeee ($184.50 in chips) 
Seat 9: fonng ($92.15 in chips) 
leosnaz will be allowed to play after the button
fonng: posts small blind $1
PacPacBum: posts big blind $2
*** HOLE CARDS ***
Dealt to matiko09 [6d As]
Kreuznagel: folds 
ilaviiitech: folds 
matiko09: folds 
Painkiller72: raises $3 to $5
Avtovo: folds 
rmanjkeee: folds 
fonng: folds 
PacPacBum: raises $11 to $16
Painkiller72: folds 
Uncalled bet ($11) returned to PacPacBum
PacPacBum collected $11 from pot
PacPacBum: doesn't show hand 
*** SUMMARY ***
Total pot $11 | Rake $0 
Seat 1: PacPacBum (big blind) collected ($11)
Seat 2: Kreuznagel folded before Flop (didn't bet)
Seat 3: ilaviiitech folded before Flop (didn't bet)
Seat 4: matiko09 folded before Flop (didn't bet)
Seat 5: Painkiller72 folded before Flop
Seat 6: Avtovo folded before Flop (didn't bet)
Seat 7: rmanjkeee (button) folded before Flop (didn't bet)
Seat 9: fonng (small blind) folded before Flop





PokerStars Hand #151208419966:  Hold'em No Limit (€0.50/€1.00 EUR) - 2016/03/31 13:02:31 CET [2016/03/31 7:02:31 ET]
Table 'Pioneer II' 9-max Seat #5 is the button
Seat 2: IdiotFromNE (€127.02 in chips) 
Seat 3: Kupumalam (€58.30 in chips) 
Seat 4: Painkiller72 (€151.46 in chips) 
Seat 5: PacPacBum (€108.69 in chips) 
Seat 6: matiko09 (€103.03 in chips) 
Seat 7: AlKatrone (€128.37 in chips) 
matiko09: posts small blind €0.50
AlKatrone: posts big blind €1
*** HOLE CARDS ***
Dealt to matiko09 [Qh Qc]
IdiotFromNE: folds 
Kupumalam: folds 
Painkiller72: folds 
PacPacBum: folds 
matiko09: raises €1.50 to €2.50
AlKatrone: folds 
Uncalled bet (€1.50) returned to matiko09
matiko09 collected €2 from pot
matiko09: doesn't show hand 
*** SUMMARY ***
Total pot €2 | Rake €0 
Seat 2: IdiotFromNE folded before Flop (didn't bet)
Seat 3: Kupumalam folded before Flop (didn't bet)
Seat 4: Painkiller72 folded before Flop (didn't bet)
Seat 5: PacPacBum (button) folded before Flop (didn't bet)
Seat 6: matiko09 (small blind) collected (€2)
Seat 7: AlKatrone (big blind) folded before Flop





PokerStars Hand #151208422024:  Hold'em No Limit ($0.50/$1.00 USD) - 2016/03/31 13:02:34 CET [2016/03/31 7:02:34 ET]
Table 'Yazhi' 9-max Seat #5 is the button
Seat 1: matiko09 ($122.83 in chips) 
Seat 2: xHourglass ($134.51 in chips) 
Seat 3: Chin41178 ($89.14 in chips) 
Seat 4: apfush ($145 in chips) 
Seat 5: IdiotFromNE ($124 in chips) 
Seat 6: Reven9er ($226.49 in chips) 
Seat 7: Avtovo ($100 in chips) 
Seat 9: oscarleon ($181.09 in chips) 
Reven9er: posts small blind $0.50
Avtovo: posts big blind $1
pk4DW: sits out 
*** HOLE CARDS ***
Dealt to matiko09 [8c Tc]
oscarleon: folds 
matiko09: folds 
xHourglass: folds 
Chin41178: raises $2 to $3
apfush: folds 
IdiotFromNE: folds 
Reven9er: folds 
Avtovo: folds 
Uncalled bet ($2) returned to Chin41178
Chin41178 collected $2.50 from pot
Chin41178: doesn't show hand 
*** SUMMARY ***
Total pot $2.50 | Rake $0 
Seat 1: matiko09 folded before Flop (didn't bet)
Seat 2: xHourglass folded before Flop (didn't bet)
Seat 3: Chin41178 collected ($2.50)
Seat 4: apfush folded before Flop (didn't bet)
Seat 5: IdiotFromNE (button) folded before Flop (didn't bet)
Seat 6: Reven9er (small blind) folded before Flop
Seat 7: Avtovo (big blind) folded before Flop
Seat 9: oscarleon folded before Flop (didn't bet)





PokerStars Hand #151208425073:  Hold'em No Limit ($0.50/$1.00 USD) - 2016/03/31 13:02:41 CET [2016/03/31 7:02:41 ET]
Table 'Kalyke III' 9-max Seat #3 is the button
Seat 3: Zeeshka ($102.02 in chips) 
Seat 4: q3972551 ($68.71 in chips) 
Seat 5: FranzisFlush ($81.90 in chips) 
Seat 6: PacPacBum ($100 in chips) 
Seat 7: djammusic ($37.98 in chips) 
Seat 8: matiko09 ($100 in chips) 
q3972551: posts small blind $0.50
FranzisFlush: posts big blind $1
apfush: sits out 
zhano69: sits out 
*** HOLE CARDS ***
Dealt to matiko09 [Jc 7d]
PacPacBum: folds 
djammusic: folds 
matiko09: folds 
Zeeshka: folds 
q3972551: raises $2 to $3
FranzisFlush: calls $2
*** FLOP *** [8c 8h 2s]
q3972551: checks 
FranzisFlush: checks 
*** TURN *** [8c 8h 2s] [Qh]
q3972551: bets $2.85
FranzisFlush: calls $2.85
*** RIVER *** [8c 8h 2s Qh] [As]
q3972551: checks 
FranzisFlush: checks 
*** SHOW DOWN ***
q3972551: shows [6h Th] (a pair of Eights)
FranzisFlush: shows [7h Kh] (a pair of Eights - Ace+King kicker)
FranzisFlush collected $11.12 from pot
*** SUMMARY ***
Total pot $11.70 | Rake $0.58 
Board [8c 8h 2s Qh As]
Seat 3: Zeeshka (button) folded before Flop (didn't bet)
Seat 4: q3972551 (small blind) showed [6h Th] and lost with a pair of Eights
Seat 5: FranzisFlush (big blind) showed [7h Kh] and won ($11.12) with a pair of Eights
Seat 6: PacPacBum folded before Flop (didn't bet)
Seat 7: djammusic folded before Flop (didn't bet)
Seat 8: matiko09 folded before Flop (didn't bet)





