PokerStars Hand #150801359300:  Hold'em No Limit (€0.50/€1.00 EUR) - 2016/03/23 14:29:35 CET [2016/03/23 9:29:35 ET]
Table 'Lanzia' 9-max Seat #2 is the button
Seat 1: fk154 (€31.75 in chips) 
Seat 2: ardo888 (€100 in chips) 
Seat 3: Effort92 (€197.31 in chips) 
Seat 4: volwebni4ek (€40 in chips) 
Seat 5: matiko09 (€175.23 in chips) 
Seat 6: Red4erT (€40 in chips) 
Seat 7: $-Twackle-$ (€133 in chips) 
Seat 8: Muinmyheart (€102 in chips) 
Seat 9: Butcher1848 (€103.87 in chips) 
Effort92: posts small blind €0.50
volwebni4ek: posts big blind €1
*** HOLE CARDS ***
Dealt to matiko09 [9c Qc]
matiko09: folds 
Red4erT: folds 
$-Twackle-$: folds 
Muinmyheart: folds 
Butcher1848: folds 
fk154: raises €1 to €2
ardo888: folds 
Effort92: calls €1.50
volwebni4ek: folds 
*** FLOP *** [Td Tc 5h]
Effort92: checks 
fk154: checks 
*** TURN *** [Td Tc 5h] [9d]
Effort92: bets €3
fk154: calls €3
*** RIVER *** [Td Tc 5h 9d] [6c]
Effort92: checks 
fk154: checks 
*** SHOW DOWN ***
Effort92: shows [Kh Jc] (a pair of Tens)
fk154: mucks hand 
Effort92 collected €10.50 from pot
*** SUMMARY ***
Total pot €11 | Rake €0.50 
Board [Td Tc 5h 9d 6c]
Seat 1: fk154 mucked [4c Ks]
Seat 2: ardo888 (button) folded before Flop (didn't bet)
Seat 3: Effort92 (small blind) showed [Kh Jc] and won (€10.50) with a pair of Tens
Seat 4: volwebni4ek (big blind) folded before Flop
Seat 5: matiko09 folded before Flop (didn't bet)
Seat 6: Red4erT folded before Flop (didn't bet)
Seat 7: $-Twackle-$ folded before Flop (didn't bet)
Seat 8: Muinmyheart folded before Flop (didn't bet)
Seat 9: Butcher1848 folded before Flop (didn't bet)





PokerStars Hand #150801364287:  Hold'em No Limit ($1/$2 USD) - 2016/03/23 14:29:43 CET [2016/03/23 9:29:43 ET]
Table 'Deipylos II' 9-max Seat #2 is the button
Seat 1: $-Twackle-$ ($207.50 in chips) 
Seat 2: T0ny Adams ($100.52 in chips) 
Seat 3: DUkalisUA ($200 in chips) 
Seat 4: matiko09 ($200 in chips) 
Seat 5: InsomniaRU ($225.88 in chips) 
Seat 6: nickreason17 ($200 in chips) 
Seat 7: volwebni4ek ($91.70 in chips) 
Seat 8: Igoriah ($279.20 in chips) 
DUkalisUA: posts small blind $1
matiko09: posts big blind $2
chaps1988: sits out 
*** HOLE CARDS ***
Dealt to matiko09 [6h Qs]
InsomniaRU: raises $3 to $5
nickreason17: folds 
volwebni4ek: folds 
Igoriah: folds 
$-Twackle-$: folds 
T0ny Adams: folds 
DUkalisUA: folds 
matiko09: folds 
Uncalled bet ($3) returned to InsomniaRU
InsomniaRU collected $5 from pot
InsomniaRU: doesn't show hand 
*** SUMMARY ***
Total pot $5 | Rake $0 
Seat 1: $-Twackle-$ folded before Flop (didn't bet)
Seat 2: T0ny Adams (button) folded before Flop (didn't bet)
Seat 3: DUkalisUA (small blind) folded before Flop
Seat 4: matiko09 (big blind) folded before Flop
Seat 5: InsomniaRU collected ($5)
Seat 6: nickreason17 folded before Flop (didn't bet)
Seat 7: volwebni4ek folded before Flop (didn't bet)
Seat 8: Igoriah folded before Flop (didn't bet)





PokerStars Hand #150801364967:  Hold'em No Limit ($0.25/$0.50 USD) - 2016/03/23 14:29:45 CET [2016/03/23 9:29:45 ET]
Table 'Pyrrhus' 9-max Seat #6 is the button
Seat 2: alemão007 ($53.21 in chips) 
Seat 3: i L00K great ($50 in chips) 
Seat 4: GriffinBerg ($32.09 in chips) 
Seat 5: ZonTTT ($55.11 in chips) 
Seat 6: Ahangama ($50 in chips) 
Seat 7: matiko09 ($138.63 in chips) 
Seat 8: dndngod ($77.48 in chips) 
Seat 9: CvMCvMCvM ($97.31 in chips) 
matiko09: posts small blind $0.25
dndngod: posts big blind $0.50
*** HOLE CARDS ***
Dealt to matiko09 [4c 9d]
CvMCvMCvM: folds 
alemão007: folds 
i L00K great: raises $1 to $1.50
GriffinBerg: folds 
ZonTTT: folds 
Ahangama: folds 
matiko09: folds 
dndngod: folds 
Uncalled bet ($1) returned to i L00K great
i L00K great collected $1.25 from pot
i L00K great: doesn't show hand 
*** SUMMARY ***
Total pot $1.25 | Rake $0 
Seat 2: alemão007 folded before Flop (didn't bet)
Seat 3: i L00K great collected ($1.25)
Seat 4: GriffinBerg folded before Flop (didn't bet)
Seat 5: ZonTTT folded before Flop (didn't bet)
Seat 6: Ahangama (button) folded before Flop (didn't bet)
Seat 7: matiko09 (small blind) folded before Flop
Seat 8: dndngod (big blind) folded before Flop
Seat 9: CvMCvMCvM folded before Flop (didn't bet)





PokerStars Hand #150801367552:  Hold'em No Limit ($1/$2 USD) - 2016/03/23 14:29:49 CET [2016/03/23 9:29:49 ET]
Table 'Achaia' 9-max Seat #3 is the button
Seat 1: Moszes360 ($209 in chips) 
Seat 2: InsomniaRU ($217.66 in chips) 
Seat 3: matiko09 ($200 in chips) 
Seat 4: nailz83 ($199.22 in chips) 
Seat 5: chaps1988 ($200 in chips) 
Seat 6: nickreason17 ($209.30 in chips) 
Seat 7: morosun ($183.20 in chips) 
Seat 8: $-Twackle-$ ($233.07 in chips) 
Seat 9: glanza_mike ($200 in chips) 
nailz83: posts small blind $1
chaps1988: posts big blind $2
*** HOLE CARDS ***
Dealt to matiko09 [4c 3d]
nickreason17: folds 
morosun: raises $2 to $4
$-Twackle-$: folds 
glanza_mike: folds 
Moszes360: folds 
InsomniaRU: folds 
matiko09: folds 
nailz83: calls $3
chaps1988: folds 
*** FLOP *** [8d Kh 8h]
nailz83: checks 
morosun: bets $4
nailz83: calls $4
*** TURN *** [8d Kh 8h] [Ks]
nailz83: checks 
morosun: bets $4
nailz83: calls $4
*** RIVER *** [8d Kh 8h Ks] [8c]
nailz83: bets $14
morosun: calls $14
*** SHOW DOWN ***
nailz83: shows [6c Kc] (a full house, Kings full of Eights)
morosun: mucks hand 
nailz83 collected $51.57 from pot
*** SUMMARY ***
Total pot $54 | Rake $2.43 
Board [8d Kh 8h Ks 8c]
Seat 1: Moszes360 folded before Flop (didn't bet)
Seat 2: InsomniaRU folded before Flop (didn't bet)
Seat 3: matiko09 (button) folded before Flop (didn't bet)
Seat 4: nailz83 (small blind) showed [6c Kc] and won ($51.57) with a full house, Kings full of Eights
Seat 5: chaps1988 (big blind) folded before Flop
Seat 6: nickreason17 folded before Flop (didn't bet)
Seat 7: morosun mucked [Qh Ts]
Seat 8: $-Twackle-$ folded before Flop (didn't bet)
Seat 9: glanza_mike folded before Flop (didn't bet)





PokerStars Hand #150801372153:  Hold'em No Limit ($1/$2 USD) - 2016/03/23 14:29:56 CET [2016/03/23 9:29:56 ET]
Table 'Kiess' 9-max Seat #7 is the button
Seat 1: Cirilico ($232.74 in chips) 
Seat 2: DUkalisUA ($671.10 in chips) 
Seat 4: Moszes360 ($200 in chips) 
Seat 5: chippo boy ($448.96 in chips) 
Seat 6: matiko09 ($279.36 in chips) 
Seat 7: InsomniaRU ($306.97 in chips) 
Seat 8: erfk1958 ($105.13 in chips) 
Seat 9: T0ny Adams ($80 in chips) 
erfk1958: posts small blind $1
T0ny Adams: posts big blind $2
The_red_area: sits out 
*** HOLE CARDS ***
Dealt to matiko09 [9s 6c]
Cirilico: folds 
DUkalisUA: raises $4 to $6
Moszes360: folds 
chippo boy: calls $6
matiko09: folds 
InsomniaRU: folds 
erfk1958: folds 
T0ny Adams: folds 
*** FLOP *** [6s Qs Tc]
DUkalisUA: checks 
chippo boy: bets $8
DUkalisUA: folds 
Uncalled bet ($8) returned to chippo boy
chippo boy collected $14.32 from pot
*** SUMMARY ***
Total pot $15 | Rake $0.68 
Board [6s Qs Tc]
Seat 1: Cirilico folded before Flop (didn't bet)
Seat 2: DUkalisUA folded on the Flop
Seat 4: Moszes360 folded before Flop (didn't bet)
Seat 5: chippo boy collected ($14.32)
Seat 6: matiko09 folded before Flop (didn't bet)
Seat 7: InsomniaRU (button) folded before Flop (didn't bet)
Seat 8: erfk1958 (small blind) folded before Flop
Seat 9: T0ny Adams (big blind) folded before Flop





PokerStars Hand #150801378976:  Hold'em No Limit ($0.50/$1.00 USD) - 2016/03/23 14:30:06 CET [2016/03/23 9:30:06 ET]
Table 'Atlantis' 9-max Seat #5 is the button
Seat 1: xHourglass ($153 in chips) 
Seat 2: tffff2006 ($69.72 in chips) 
Seat 3: CAJUN890 ($102.79 in chips) 
Seat 4: matiko09 ($124.75 in chips) 
Seat 5: Pvsx. ($102.75 in chips) 
Seat 6: Jimy Tiltman ($109.99 in chips) 
Seat 7: Sherlockplay ($134.77 in chips) 
Seat 8: DUkalisUA ($102.50 in chips) 
Jimy Tiltman: posts small blind $0.50
Sherlockplay: posts big blind $1
*** HOLE CARDS ***
Dealt to matiko09 [Ac 6d]
DUkalisUA: raises $2 to $3
xHourglass: folds 
tffff2006: folds 
CAJUN890: folds 
matiko09: folds 
Pvsx.: folds 
Jimy Tiltman: raises $6.50 to $9.50
Sherlockplay: folds 
DUkalisUA: raises $12 to $21.50
Jimy Tiltman: calls $12
*** FLOP *** [Th Js Ad]
Jimy Tiltman: checks 
DUkalisUA: bets $16.80
Jimy Tiltman: calls $16.80
*** TURN *** [Th Js Ad] [5s]
Jimy Tiltman: checks 
DUkalisUA: bets $64.20 and is all-in
Jimy Tiltman: folds 
Uncalled bet ($64.20) returned to DUkalisUA
DUkalisUA collected $74.80 from pot
DUkalisUA: doesn't show hand 
*** SUMMARY ***
Total pot $77.60 | Rake $2.80 
Board [Th Js Ad 5s]
Seat 1: xHourglass folded before Flop (didn't bet)
Seat 2: tffff2006 folded before Flop (didn't bet)
Seat 3: CAJUN890 folded before Flop (didn't bet)
Seat 4: matiko09 folded before Flop (didn't bet)
Seat 5: Pvsx. (button) folded before Flop (didn't bet)
Seat 6: Jimy Tiltman (small blind) folded on the Turn
Seat 7: Sherlockplay (big blind) folded before Flop
Seat 8: DUkalisUA collected ($74.80)





PokerStars Hand #150801378580:  Hold'em No Limit ($0.50/$1.00 USD) - 2016/03/23 14:30:06 CET [2016/03/23 9:30:06 ET]
Table 'Donar II' 9-max Seat #8 is the button
Seat 1: Effort92 ($103.42 in chips) 
Seat 2: nobrunobru1 ($54.04 in chips) 
Seat 3: st-germ30 ($99.49 in chips) 
Seat 4: DUkalisUA ($145.69 in chips) 
Seat 5: matiko09 ($104.07 in chips) 
Seat 6: ardo888 ($132.98 in chips) 
Seat 7: JimineyCrik ($103.02 in chips) 
Seat 8: $-Twackle-$ ($109.15 in chips) 
Seat 9: oxfordtenzin ($123.40 in chips) 
oxfordtenzin: posts small blind $0.50
Effort92: posts big blind $1
Effort92: posts the ante $0.20
nobrunobru1: posts the ante $0.20
st-germ30: posts the ante $0.20
DUkalisUA: posts the ante $0.20
matiko09: posts the ante $0.20
ardo888: posts the ante $0.20
JimineyCrik: posts the ante $0.20
$-Twackle-$: posts the ante $0.20
oxfordtenzin: posts the ante $0.20
*** HOLE CARDS ***
Dealt to matiko09 [5c Qh]
nobrunobru1: folds 
st-germ30: folds 
DUkalisUA: folds 
matiko09: folds 
ardo888: folds 
JimineyCrik: raises $1 to $2
$-Twackle-$: folds 
oxfordtenzin: folds 
Effort92: calls $1
*** FLOP *** [Th Js 2d]
Effort92: checks 
JimineyCrik: checks 
*** TURN *** [Th Js 2d] [8s]
Effort92: bets $3.97
JimineyCrik: calls $3.97
*** RIVER *** [Th Js 2d 8s] [7d]
Effort92: checks 
JimineyCrik: bets $10.33
Effort92: calls $10.33
*** SHOW DOWN ***
JimineyCrik: shows [9c Ac] (a straight, Seven to Jack)
Effort92: shows [9h As] (a straight, Seven to Jack)
Effort92 collected $16.67 from pot
JimineyCrik collected $16.66 from pot
*** SUMMARY ***
Total pot $34.90 | Rake $1.57 
Board [Th Js 2d 8s 7d]
Seat 1: Effort92 (big blind) showed [9h As] and won ($16.67) with a straight, Seven to Jack
Seat 2: nobrunobru1 folded before Flop (didn't bet)
Seat 3: st-germ30 folded before Flop (didn't bet)
Seat 4: DUkalisUA folded before Flop (didn't bet)
Seat 5: matiko09 folded before Flop (didn't bet)
Seat 6: ardo888 folded before Flop (didn't bet)
Seat 7: JimineyCrik showed [9c Ac] and won ($16.66) with a straight, Seven to Jack
Seat 8: $-Twackle-$ (button) folded before Flop (didn't bet)
Seat 9: oxfordtenzin (small blind) folded before Flop





PokerStars Hand #150801379577:  Hold'em No Limit ($0.50/$1.00 USD) - 2016/03/23 14:30:07 CET [2016/03/23 9:30:07 ET]
Table 'Merope II' 9-max Seat #2 is the button
Seat 1: Jimy Tiltman ($142.23 in chips) 
Seat 2: $-Twackle-$ ($100 in chips) 
Seat 3: pablos1922 ($90.25 in chips) 
Seat 4: YuriiSolodya ($88.84 in chips) 
Seat 5: DUkalisUA ($158.37 in chips) 
Seat 6: Effort92 ($100 in chips) 
Seat 7: matiko09 ($109.23 in chips) 
Seat 8: titentei ($89 in chips) 
pablos1922: posts small blind $0.50
YuriiSolodya: posts big blind $1
*** HOLE CARDS ***
Dealt to matiko09 [3d Kc]
DUkalisUA: folds 
Effort92: folds 
matiko09: folds 
titentei: folds 
Jimy Tiltman has timed out
Jimy Tiltman: folds 
$-Twackle-$: folds 
pablos1922: folds 
Uncalled bet ($0.50) returned to YuriiSolodya
YuriiSolodya collected $1 from pot
YuriiSolodya: doesn't show hand 
*** SUMMARY ***
Total pot $1 | Rake $0 
Seat 1: Jimy Tiltman folded before Flop (didn't bet)
Seat 2: $-Twackle-$ (button) folded before Flop (didn't bet)
Seat 3: pablos1922 (small blind) folded before Flop
Seat 4: YuriiSolodya (big blind) collected ($1)
Seat 5: DUkalisUA folded before Flop (didn't bet)
Seat 6: Effort92 folded before Flop (didn't bet)
Seat 7: matiko09 folded before Flop (didn't bet)
Seat 8: titentei folded before Flop (didn't bet)





PokerStars Hand #150801380266:  Hold'em No Limit ($1/$2 USD) - 2016/03/23 14:30:08 CET [2016/03/23 9:30:08 ET]
Table 'Herba II' 9-max Seat #3 is the button
Seat 1: matiko09 ($219.20 in chips) 
Seat 2: Moszes360 ($224.17 in chips) 
Seat 3: Cirilico ($183.84 in chips) 
Seat 4: DUkalisUA ($201 in chips) 
Seat 5: chippo boy ($198.83 in chips) 
Seat 6: Too-Anti-To ($212.46 in chips) 
Seat 7: InsomniaRU ($406.20 in chips) 
Seat 9: mrhighryza ($59.67 in chips) 
DUkalisUA: posts small blind $1
chippo boy: posts big blind $2
The_red_area: sits out 
*** HOLE CARDS ***
Dealt to matiko09 [Jc 9h]
Too-Anti-To: folds 
InsomniaRU: folds 
mrhighryza: calls $2
matiko09: folds 
Moszes360: folds 
Cirilico: calls $2
DUkalisUA: folds 
chippo boy: checks 
*** FLOP *** [8s 8c 4h]
chippo boy: checks 
mrhighryza: checks 
Cirilico: checks 
*** TURN *** [8s 8c 4h] [7c]
chippo boy: bets $4
mrhighryza: calls $4
Cirilico: folds 
*** RIVER *** [8s 8c 4h 7c] [3s]
chippo boy: bets $14
mrhighryza: folds 
Uncalled bet ($14) returned to chippo boy
chippo boy collected $14.32 from pot
*** SUMMARY ***
Total pot $15 | Rake $0.68 
Board [8s 8c 4h 7c 3s]
Seat 1: matiko09 folded before Flop (didn't bet)
Seat 2: Moszes360 folded before Flop (didn't bet)
Seat 3: Cirilico (button) folded on the Turn
Seat 4: DUkalisUA (small blind) folded before Flop
Seat 5: chippo boy (big blind) collected ($14.32)
Seat 6: Too-Anti-To folded before Flop (didn't bet)
Seat 7: InsomniaRU folded before Flop (didn't bet)
Seat 9: mrhighryza folded on the River





PokerStars Hand #150801383585:  Hold'em No Limit ($1/$2 USD) - 2016/03/23 14:30:14 CET [2016/03/23 9:30:14 ET]
Table 'Kypria II' 9-max Seat #5 is the button
Seat 1: geldwolfje ($153.20 in chips) 
Seat 2: coinflip_si ($216.70 in chips) 
Seat 3: seouljam ($140.13 in chips) 
Seat 4: VolanDog ($217.70 in chips) 
Seat 5: InsomniaRU ($374.88 in chips) 
Seat 6: matiko09 ($369.95 in chips) 
Seat 7: DUkalisUA ($208 in chips) 
Seat 8: Pearl Jam87 ($200 in chips) 
Seat 9: Moszes360 ($200 in chips) 
matiko09: posts small blind $1
DUkalisUA: posts big blind $2
*** HOLE CARDS ***
Dealt to matiko09 [3d 5d]
Pearl Jam87: folds 
Moszes360: raises $4 to $6
geldwolfje: folds 
coinflip_si: calls $6
seouljam: calls $6
VolanDog: folds 
InsomniaRU: folds 
matiko09: folds 
DUkalisUA: folds 
*** FLOP *** [4d Tc Kd]
Moszes360: bets $13.23
coinflip_si: folds 
seouljam: calls $13.23
*** TURN *** [4d Tc Kd] [Qh]
Moszes360: checks 
seouljam: bets $18
Moszes360: calls $18
*** RIVER *** [4d Tc Kd Qh] [5h]
Moszes360: checks 
seouljam: bets $102.90 and is all-in
Moszes360: folds 
Uncalled bet ($102.90) returned to seouljam
seouljam collected $80.66 from pot
seouljam: doesn't show hand 
*** SUMMARY ***
Total pot $83.46 | Rake $2.80 
Board [4d Tc Kd Qh 5h]
Seat 1: geldwolfje folded before Flop (didn't bet)
Seat 2: coinflip_si folded on the Flop
Seat 3: seouljam collected ($80.66)
Seat 4: VolanDog folded before Flop (didn't bet)
Seat 5: InsomniaRU (button) folded before Flop (didn't bet)
Seat 6: matiko09 (small blind) folded before Flop
Seat 7: DUkalisUA (big blind) folded before Flop
Seat 8: Pearl Jam87 folded before Flop (didn't bet)
Seat 9: Moszes360 folded on the River





PokerStars Hand #150801383737:  Hold'em No Limit ($0.25/$0.50 USD) - 2016/03/23 14:30:14 CET [2016/03/23 9:30:14 ET]
Table 'Pyrrhus' 9-max Seat #7 is the button
Seat 2: alemão007 ($53.21 in chips) 
Seat 3: i L00K great ($50.75 in chips) 
Seat 4: GriffinBerg ($32.09 in chips) 
Seat 5: ZonTTT ($55.11 in chips) 
Seat 6: Ahangama ($50 in chips) 
Seat 7: matiko09 ($138.38 in chips) 
Seat 8: dndngod ($76.98 in chips) 
Seat 9: CvMCvMCvM ($97.31 in chips) 
dndngod: posts small blind $0.25
CvMCvMCvM: posts big blind $0.50
*** HOLE CARDS ***
Dealt to matiko09 [5h Tc]
alemão007: folds 
i L00K great: folds 
GriffinBerg: calls $0.50
ZonTTT: folds 
Ahangama: folds 
matiko09: folds 
dndngod: raises $2 to $2.50
CvMCvMCvM: folds 
GriffinBerg: calls $2
*** FLOP *** [2s 2d 7s]
dndngod: checks 
GriffinBerg: checks 
*** TURN *** [2s 2d 7s] [Qs]
dndngod: bets $3.25
GriffinBerg: calls $3.25
*** RIVER *** [2s 2d 7s Qs] [6c]
dndngod: checks 
GriffinBerg: bets $5.73
dndngod: folds 
Uncalled bet ($5.73) returned to GriffinBerg
GriffinBerg collected $11.46 from pot
*** SUMMARY ***
Total pot $12 | Rake $0.54 
Board [2s 2d 7s Qs 6c]
Seat 2: alemão007 folded before Flop (didn't bet)
Seat 3: i L00K great folded before Flop (didn't bet)
Seat 4: GriffinBerg collected ($11.46)
Seat 5: ZonTTT folded before Flop (didn't bet)
Seat 6: Ahangama folded before Flop (didn't bet)
Seat 7: matiko09 (button) folded before Flop (didn't bet)
Seat 8: dndngod (small blind) folded on the River
Seat 9: CvMCvMCvM (big blind) folded before Flop





PokerStars Hand #150801390517:  Hold'em No Limit ($0.50/$1.00 USD) - 2016/03/23 14:30:25 CET [2016/03/23 9:30:25 ET]
Table 'Swings' 9-max Seat #5 is the button
Seat 1: Sherlockplay ($100 in chips) 
Seat 2: Harbinger X ($89.79 in chips) 
Seat 3: maxxmeister ($100 in chips) 
Seat 4: chaps1988 ($100 in chips) 
Seat 5: chautinhtri9 ($97.50 in chips) 
Seat 6: matiko09 ($100.50 in chips) 
Seat 7: nickreason17 ($101.50 in chips) 
Seat 9: Vlad_1965_77 ($109.05 in chips) 
matiko09: posts small blind $0.50
nickreason17: posts big blind $1
*** HOLE CARDS ***
Dealt to matiko09 [9s 9h]
Vlad_1965_77: folds 
Sherlockplay: folds 
Harbinger X: raises $2 to $3
maxxmeister: folds 
chaps1988: folds 
chautinhtri9: folds 
matiko09: calls $2.50
nickreason17: folds 
*** FLOP *** [Ah Kc 5c]
matiko09: checks 
Harbinger X: bets $6
matiko09: folds 
Uncalled bet ($6) returned to Harbinger X
Harbinger X collected $6.68 from pot
Harbinger X: doesn't show hand 
*** SUMMARY ***
Total pot $7 | Rake $0.32 
Board [Ah Kc 5c]
Seat 1: Sherlockplay folded before Flop (didn't bet)
Seat 2: Harbinger X collected ($6.68)
Seat 3: maxxmeister folded before Flop (didn't bet)
Seat 4: chaps1988 folded before Flop (didn't bet)
Seat 5: chautinhtri9 (button) folded before Flop (didn't bet)
Seat 6: matiko09 (small blind) folded on the Flop
Seat 7: nickreason17 (big blind) folded before Flop
Seat 9: Vlad_1965_77 folded before Flop (didn't bet)





PokerStars Hand #150801391887:  Hold'em No Limit ($1/$2 USD) - 2016/03/23 14:30:27 CET [2016/03/23 9:30:27 ET]
Table 'Deipylos II' 9-max Seat #3 is the button
Seat 1: $-Twackle-$ ($207.50 in chips) 
Seat 2: T0ny Adams ($100.52 in chips) 
Seat 3: DUkalisUA ($200 in chips) 
Seat 4: matiko09 ($200 in chips) 
Seat 8: Igoriah ($279.20 in chips) 
matiko09: posts small blind $1
InsomniaRU: is sitting out 
nickreason17: is sitting out 
volwebni4ek: is sitting out 
InsomniaRU leaves the table
Igoriah: posts big blind $2
chaps1988: sits out 
*** HOLE CARDS ***
Dealt to matiko09 [Js 9d]
$-Twackle-$: folds 
nickreason17 leaves the table
T0ny Adams: folds 
DUkalisUA: raises $2 to $4
erfk1958 joins the table at seat #5 
matiko09: folds 
Igoriah: folds 
Uncalled bet ($2) returned to DUkalisUA
DUkalisUA collected $5 from pot
DUkalisUA: doesn't show hand 
*** SUMMARY ***
Total pot $5 | Rake $0 
Seat 1: $-Twackle-$ folded before Flop (didn't bet)
Seat 2: T0ny Adams folded before Flop (didn't bet)
Seat 3: DUkalisUA (button) collected ($5)
Seat 4: matiko09 (small blind) folded before Flop
Seat 8: Igoriah (big blind) folded before Flop





PokerStars Hand #150801394181:  Hold'em No Limit ($1/$2 USD) - 2016/03/23 14:30:31 CET [2016/03/23 9:30:31 ET]
Table 'Kiess' 9-max Seat #8 is the button
Seat 1: Cirilico ($232.74 in chips) 
Seat 2: DUkalisUA ($665.10 in chips) 
Seat 4: Moszes360 ($200 in chips) 
Seat 5: chippo boy ($457.28 in chips) 
Seat 6: matiko09 ($279.36 in chips) 
Seat 7: InsomniaRU ($306.97 in chips) 
Seat 8: erfk1958 ($104.13 in chips) 
Seat 9: T0ny Adams ($78 in chips) 
T0ny Adams: posts small blind $1
Cirilico: posts big blind $2
The_red_area: sits out 
*** HOLE CARDS ***
Dealt to matiko09 [Kc 5s]
DUkalisUA: folds 
Moszes360: folds 
chippo boy: raises $4 to $6
matiko09: folds 
InsomniaRU: folds 
erfk1958: folds 
T0ny Adams: folds 
Cirilico: folds 
Uncalled bet ($4) returned to chippo boy
chippo boy collected $5 from pot
*** SUMMARY ***
Total pot $5 | Rake $0 
Seat 1: Cirilico (big blind) folded before Flop
Seat 2: DUkalisUA folded before Flop (didn't bet)
Seat 4: Moszes360 folded before Flop (didn't bet)
Seat 5: chippo boy collected ($5)
Seat 6: matiko09 folded before Flop (didn't bet)
Seat 7: InsomniaRU folded before Flop (didn't bet)
Seat 8: erfk1958 (button) folded before Flop (didn't bet)
Seat 9: T0ny Adams (small blind) folded before Flop





PokerStars Hand #150801400843:  Hold'em No Limit ($1/$2 USD) - 2016/03/23 14:30:41 CET [2016/03/23 9:30:41 ET]
Table 'Ennomos II' 9-max Seat #6 is the button
Seat 1: ilaviiitech ($200 in chips) 
Seat 2: Subam ($443.38 in chips) 
Seat 3: $-Twackle-$ ($231.20 in chips) 
Seat 4: glanza_mike ($200 in chips) 
Seat 5: South011 ($394.02 in chips) 
Seat 6: nickreason17 ($232.40 in chips) 
Seat 8: yyfk ($201.24 in chips) 
Seat 9: matiko09 ($200 in chips) 
T0ny Adams will be allowed to play after the button
yyfk: posts small blind $1
matiko09: posts big blind $2
*** HOLE CARDS ***
Dealt to matiko09 [Ac Kh]
ilaviiitech: folds 
Subam: raises $2 to $4
ilaviiitech leaves the table
InsomniaRU joins the table at seat #1 
$-Twackle-$: folds 
glanza_mike: folds 
South011: folds 
nickreason17: folds 
yyfk: folds 
matiko09: raises $12 to $16
Subam: calls $12
*** FLOP *** [Ks 3c Js]
matiko09: bets $20
Subam: calls $20
*** TURN *** [Ks 3c Js] [Tc]
matiko09: bets $38
Subam: calls $38
*** RIVER *** [Ks 3c Js Tc] [8h]
matiko09: checks 
Subam: bets $50
matiko09: calls $50
*** SHOW DOWN ***
Subam: shows [9s 9h] (a pair of Nines)
matiko09: shows [Ac Kh] (a pair of Kings)
matiko09 collected $246.20 from pot
*** SUMMARY ***
Total pot $249 | Rake $2.80 
Board [Ks 3c Js Tc 8h]
Seat 1: ilaviiitech folded before Flop (didn't bet)
Seat 2: Subam showed [9s 9h] and lost with a pair of Nines
Seat 3: $-Twackle-$ folded before Flop (didn't bet)
Seat 4: glanza_mike folded before Flop (didn't bet)
Seat 5: South011 folded before Flop (didn't bet)
Seat 6: nickreason17 (button) folded before Flop (didn't bet)
Seat 8: yyfk (small blind) folded before Flop
Seat 9: matiko09 (big blind) showed [Ac Kh] and won ($246.20) with a pair of Kings





PokerStars Hand #150801403796:  Hold'em No Limit ($1/$2 USD) - 2016/03/23 14:30:46 CET [2016/03/23 9:30:46 ET]
Table 'Achaia' 9-max Seat #4 is the button
Seat 1: Moszes360 ($209 in chips) 
Seat 2: InsomniaRU ($217.66 in chips) 
Seat 3: matiko09 ($200 in chips) 
Seat 4: nailz83 ($224.79 in chips) 
Seat 5: chaps1988 ($200 in chips) 
Seat 6: nickreason17 ($209.30 in chips) 
Seat 7: morosun ($157.20 in chips) 
Seat 8: $-Twackle-$ ($233.07 in chips) 
Seat 9: glanza_mike ($200 in chips) 
chaps1988: posts small blind $1
nickreason17: posts big blind $2
*** HOLE CARDS ***
Dealt to matiko09 [4s Kc]
morosun: calls $2
$-Twackle-$: folds 
glanza_mike: folds 
Moszes360: folds 
InsomniaRU: raises $6 to $8
matiko09: folds 
nailz83: folds 
chaps1988: folds 
nickreason17: folds 
morosun: calls $6
*** FLOP *** [9c 3c 8h]
morosun: bets $2
InsomniaRU: calls $2
*** TURN *** [9c 3c 8h] [Ks]
morosun: bets $2
InsomniaRU: raises $17.30 to $19.30
morosun: folds 
Uncalled bet ($17.30) returned to InsomniaRU
InsomniaRU collected $25.78 from pot
InsomniaRU: doesn't show hand 
*** SUMMARY ***
Total pot $27 | Rake $1.22 
Board [9c 3c 8h Ks]
Seat 1: Moszes360 folded before Flop (didn't bet)
Seat 2: InsomniaRU collected ($25.78)
Seat 3: matiko09 folded before Flop (didn't bet)
Seat 4: nailz83 (button) folded before Flop (didn't bet)
Seat 5: chaps1988 (small blind) folded before Flop
Seat 6: nickreason17 (big blind) folded before Flop
Seat 7: morosun folded on the Turn
Seat 8: $-Twackle-$ folded before Flop (didn't bet)
Seat 9: glanza_mike folded before Flop (didn't bet)





PokerStars Hand #150801403419:  Hold'em No Limit (€0.50/€1.00 EUR) - 2016/03/23 14:30:46 CET [2016/03/23 9:30:46 ET]
Table 'Lanzia' 9-max Seat #3 is the button
Seat 1: fk154 (€26.75 in chips) 
Seat 2: ardo888 (€100 in chips) 
Seat 3: Effort92 (€202.81 in chips) 
Seat 4: volwebni4ek (€40 in chips) 
Seat 5: matiko09 (€175.23 in chips) 
Seat 6: Red4erT (€40 in chips) 
Seat 7: $-Twackle-$ (€133 in chips) 
Seat 8: Muinmyheart (€102 in chips) 
Seat 9: Butcher1848 (€103.87 in chips) 
volwebni4ek: posts small blind €0.50
matiko09: posts big blind €1
*** HOLE CARDS ***
Dealt to matiko09 [6c Kc]
Red4erT: folds 
$-Twackle-$: folds 
Muinmyheart: folds 
Butcher1848: folds 
fk154: folds 
ardo888: raises €1.50 to €2.50
Effort92: folds 
volwebni4ek: folds 
matiko09: folds 
Uncalled bet (€1.50) returned to ardo888
ardo888 collected €2.50 from pot
ardo888: doesn't show hand 
*** SUMMARY ***
Total pot €2.50 | Rake €0 
Seat 1: fk154 folded before Flop (didn't bet)
Seat 2: ardo888 collected (€2.50)
Seat 3: Effort92 (button) folded before Flop (didn't bet)
Seat 4: volwebni4ek (small blind) folded before Flop
Seat 5: matiko09 (big blind) folded before Flop
Seat 6: Red4erT folded before Flop (didn't bet)
Seat 7: $-Twackle-$ folded before Flop (didn't bet)
Seat 8: Muinmyheart folded before Flop (didn't bet)
Seat 9: Butcher1848 folded before Flop (didn't bet)





PokerStars Hand #150801404186:  Hold'em No Limit ($0.50/$1.00 USD) - 2016/03/23 14:30:47 CET [2016/03/23 9:30:47 ET]
Table 'Kippes' 9-max Seat #3 is the button
Seat 1: Pvsx. ($210.16 in chips) 
Seat 3: CAJUN890 ($126.50 in chips) 
Seat 4: matiko09 ($100 in chips) 
Seat 5: Jimy Tiltman ($130.72 in chips) 
Seat 6: DUkalisUA ($121.94 in chips) 
Seat 8: Sherlockplay ($100 in chips) 
Seat 9: wang19790906 ($100 in chips) 
matiko09: posts small blind $0.50
Jimy Tiltman: posts big blind $1
wang19790906: posts small blind $0.50
*** HOLE CARDS ***
Dealt to matiko09 [4c 2s]
DUkalisUA: raises $2 to $3
Sherlockplay: folds 
wang19790906: calls $3
Pvsx.: raises $10 to $13
CAJUN890: folds 
matiko09: folds 
Jimy Tiltman: folds 
DUkalisUA: folds 
wang19790906: calls $10
*** FLOP *** [8s Ts Jc]
wang19790906: checks 
Pvsx.: bets $20
wang19790906: raises $30 to $50
Pvsx.: raises $129.60 to $179.60
wang19790906: calls $36.50 and is all-in
Uncalled bet ($93.10) returned to Pvsx.
*** TURN *** [8s Ts Jc] [2c]
*** RIVER *** [8s Ts Jc 2c] [Qs]
*** SHOW DOWN ***
wang19790906: shows [7d 9d] (a straight, Eight to Queen)
Pvsx.: shows [Ah As] (a pair of Aces)
wang19790906 collected $201.20 from pot
*** SUMMARY ***
Total pot $204 | Rake $2.80 
Board [8s Ts Jc 2c Qs]
Seat 1: Pvsx. showed [Ah As] and lost with a pair of Aces
Seat 3: CAJUN890 (button) folded before Flop (didn't bet)
Seat 4: matiko09 (small blind) folded before Flop
Seat 5: Jimy Tiltman (big blind) folded before Flop
Seat 6: DUkalisUA folded before Flop
Seat 8: Sherlockplay folded before Flop (didn't bet)
Seat 9: wang19790906 showed [7d 9d] and won ($201.20) with a straight, Eight to Queen





PokerStars Hand #150801405550:  Hold'em No Limit ($1/$2 USD) - 2016/03/23 14:30:49 CET [2016/03/23 9:30:49 ET]
Table 'Deipylos II' 9-max Seat #4 is the button
Seat 1: $-Twackle-$ ($207.50 in chips) 
Seat 2: T0ny Adams ($100.52 in chips) 
Seat 3: DUkalisUA ($203 in chips) 
Seat 4: matiko09 ($200 in chips) 
Seat 8: Igoriah ($277.20 in chips) 
Seat 9: chaps1988 ($200 in chips) 
erfk1958 will be allowed to play after the button
Igoriah: posts small blind $1
chaps1988: posts big blind $2
*** HOLE CARDS ***
Dealt to matiko09 [Qs 7c]
$-Twackle-$: folds 
T0ny Adams: folds 
DUkalisUA: folds 
matiko09: folds 
Igoriah: folds 
Uncalled bet ($1) returned to chaps1988
chaps1988 collected $2 from pot
chaps1988: doesn't show hand 
*** SUMMARY ***
Total pot $2 | Rake $0 
Seat 1: $-Twackle-$ folded before Flop (didn't bet)
Seat 2: T0ny Adams folded before Flop (didn't bet)
Seat 3: DUkalisUA folded before Flop (didn't bet)
Seat 4: matiko09 (button) folded before Flop (didn't bet)
Seat 8: Igoriah (small blind) folded before Flop
Seat 9: chaps1988 (big blind) collected ($2)





PokerStars Hand #150801410091:  Hold'em No Limit ($0.50/$1.00 USD) - 2016/03/23 14:30:56 CET [2016/03/23 9:30:56 ET]
Table 'Merope II' 9-max Seat #3 is the button
Seat 1: Jimy Tiltman ($142.23 in chips) 
Seat 2: $-Twackle-$ ($100 in chips) 
Seat 3: pablos1922 ($89.75 in chips) 
Seat 4: YuriiSolodya ($89.34 in chips) 
Seat 5: DUkalisUA ($158.37 in chips) 
Seat 6: Effort92 ($100 in chips) 
Seat 7: matiko09 ($109.23 in chips) 
Seat 8: titentei ($89 in chips) 
YuriiSolodya: posts small blind $0.50
DUkalisUA: posts big blind $1
*** HOLE CARDS ***
Dealt to matiko09 [3h 8c]
Effort92: folds 
matiko09: folds 
titentei: folds 
Jimy Tiltman: folds 
$-Twackle-$: folds 
pablos1922: folds 
YuriiSolodya: folds 
Uncalled bet ($0.50) returned to DUkalisUA
DUkalisUA collected $1 from pot
DUkalisUA: doesn't show hand 
*** SUMMARY ***
Total pot $1 | Rake $0 
Seat 1: Jimy Tiltman folded before Flop (didn't bet)
Seat 2: $-Twackle-$ folded before Flop (didn't bet)
Seat 3: pablos1922 (button) folded before Flop (didn't bet)
Seat 4: YuriiSolodya (small blind) folded before Flop
Seat 5: DUkalisUA (big blind) collected ($1)
Seat 6: Effort92 folded before Flop (didn't bet)
Seat 7: matiko09 folded before Flop (didn't bet)
Seat 8: titentei folded before Flop (didn't bet)





PokerStars Hand #150801411583:  Hold'em No Limit ($1/$2 USD) - 2016/03/23 14:30:59 CET [2016/03/23 9:30:59 ET]
Table 'Kiess' 9-max Seat #9 is the button
Seat 1: Cirilico ($230.74 in chips) 
Seat 2: DUkalisUA ($665.10 in chips) 
Seat 4: Moszes360 ($200 in chips) 
Seat 5: chippo boy ($460.28 in chips) 
Seat 6: matiko09 ($279.36 in chips) 
Seat 7: InsomniaRU ($306.97 in chips) 
Seat 8: erfk1958 ($104.13 in chips) 
Seat 9: T0ny Adams ($77 in chips) 
Cirilico: posts small blind $1
DUkalisUA: posts big blind $2
The_red_area: sits out 
*** HOLE CARDS ***
Dealt to matiko09 [Ks Ac]
Moszes360: folds 
chippo boy: folds 
matiko09: raises $3 to $5
InsomniaRU: folds 
erfk1958: folds 
T0ny Adams: calls $5
Cirilico: folds 
DUkalisUA: folds 
*** FLOP *** [8h 3d 8s]
matiko09: checks 
T0ny Adams: bets $7.50
matiko09: calls $7.50
*** TURN *** [8h 3d 8s] [6d]
matiko09: checks 
T0ny Adams: checks 
*** RIVER *** [8h 3d 8s 6d] [Qs]
matiko09: checks 
T0ny Adams: checks 
*** SHOW DOWN ***
matiko09: shows [Ks Ac] (a pair of Eights)
T0ny Adams: shows [9h 9c] (two pair, Nines and Eights)
T0ny Adams collected $26.74 from pot
*** SUMMARY ***
Total pot $28 | Rake $1.26 
Board [8h 3d 8s 6d Qs]
Seat 1: Cirilico (small blind) folded before Flop
Seat 2: DUkalisUA (big blind) folded before Flop
Seat 4: Moszes360 folded before Flop (didn't bet)
Seat 5: chippo boy folded before Flop (didn't bet)
Seat 6: matiko09 showed [Ks Ac] and lost with a pair of Eights
Seat 7: InsomniaRU folded before Flop (didn't bet)
Seat 8: erfk1958 folded before Flop (didn't bet)
Seat 9: T0ny Adams (button) showed [9h 9c] and won ($26.74) with two pair, Nines and Eights





PokerStars Hand #150801411719:  Hold'em No Limit ($0.50/$1.00 USD) - 2016/03/23 14:30:59 CET [2016/03/23 9:30:59 ET]
Table 'Swings' 9-max Seat #6 is the button
Seat 1: Sherlockplay ($100 in chips) 
Seat 2: Harbinger X ($93.47 in chips) 
Seat 3: maxxmeister ($100 in chips) 
Seat 4: chaps1988 ($100 in chips) 
Seat 5: chautinhtri9 ($97.50 in chips) 
Seat 6: matiko09 ($100 in chips) 
Seat 7: nickreason17 ($100.50 in chips) 
Seat 9: Vlad_1965_77 ($109.05 in chips) 
nickreason17: posts small blind $0.50
Vlad_1965_77: posts big blind $1
*** HOLE CARDS ***
Dealt to matiko09 [9s Tc]
Sherlockplay: folds 
Harbinger X: folds 
maxxmeister: raises $2 to $3
chaps1988: calls $3
chautinhtri9: folds 
matiko09: folds 
nickreason17: folds 
Vlad_1965_77: folds 
*** FLOP *** [8d 8s 9c]
maxxmeister: bets $4
chaps1988: raises $8 to $12
maxxmeister: calls $8
*** TURN *** [8d 8s 9c] [Qs]
maxxmeister: checks 
chaps1988: checks 
*** RIVER *** [8d 8s 9c Qs] [2s]
maxxmeister: checks 
chaps1988: checks 
*** SHOW DOWN ***
maxxmeister: shows [9d 7d] (two pair, Nines and Eights)
chaps1988: mucks hand 
maxxmeister collected $30.08 from pot
*** SUMMARY ***
Total pot $31.50 | Rake $1.42 
Board [8d 8s 9c Qs 2s]
Seat 1: Sherlockplay folded before Flop (didn't bet)
Seat 2: Harbinger X folded before Flop (didn't bet)
Seat 3: maxxmeister showed [9d 7d] and won ($30.08) with two pair, Nines and Eights
Seat 4: chaps1988 mucked [5c 5h]
Seat 5: chautinhtri9 folded before Flop (didn't bet)
Seat 6: matiko09 (button) folded before Flop (didn't bet)
Seat 7: nickreason17 (small blind) folded before Flop
Seat 9: Vlad_1965_77 (big blind) folded before Flop





PokerStars Hand #150801416168:  Hold'em No Limit ($0.50/$1.00 USD) - 2016/03/23 14:31:06 CET [2016/03/23 9:31:06 ET]
Table 'Atlantis' 9-max Seat #6 is the button
Seat 1: xHourglass ($153 in chips) 
Seat 2: tffff2006 ($69.72 in chips) 
Seat 3: CAJUN890 ($102.79 in chips) 
Seat 4: matiko09 ($124.75 in chips) 
Seat 5: Pvsx. ($102.75 in chips) 
Seat 6: Jimy Tiltman ($100 in chips) 
Seat 7: Sherlockplay ($133.77 in chips) 
Seat 8: DUkalisUA ($139 in chips) 
Sherlockplay: posts small blind $0.50
DUkalisUA: posts big blind $1
*** HOLE CARDS ***
Dealt to matiko09 [Ah 2h]
xHourglass: folds 
tffff2006: folds 
CAJUN890: folds 
matiko09: raises $2 to $3
Pvsx.: folds 
Jimy Tiltman: folds 
Sherlockplay: folds 
DUkalisUA: folds 
Uncalled bet ($2) returned to matiko09
matiko09 collected $2.50 from pot
matiko09: doesn't show hand 
*** SUMMARY ***
Total pot $2.50 | Rake $0 
Seat 1: xHourglass folded before Flop (didn't bet)
Seat 2: tffff2006 folded before Flop (didn't bet)
Seat 3: CAJUN890 folded before Flop (didn't bet)
Seat 4: matiko09 collected ($2.50)
Seat 5: Pvsx. folded before Flop (didn't bet)
Seat 6: Jimy Tiltman (button) folded before Flop (didn't bet)
Seat 7: Sherlockplay (small blind) folded before Flop
Seat 8: DUkalisUA (big blind) folded before Flop





PokerStars Hand #150801426052:  Hold'em No Limit ($0.50/$1.00 USD) - 2016/03/23 14:31:22 CET [2016/03/23 9:31:22 ET]
Table 'Atlantis' 9-max Seat #7 is the button
Seat 1: xHourglass ($153 in chips) 
Seat 2: tffff2006 ($69.72 in chips) 
Seat 3: CAJUN890 ($102.79 in chips) 
Seat 4: matiko09 ($126.25 in chips) 
Seat 5: Pvsx. ($102.75 in chips) 
Seat 6: Jimy Tiltman ($100 in chips) 
Seat 7: Sherlockplay ($133.27 in chips) 
Seat 8: DUkalisUA ($138 in chips) 
DUkalisUA: posts small blind $0.50
xHourglass: posts big blind $1
*** HOLE CARDS ***
Dealt to matiko09 [2c 3d]
tffff2006: folds 
CAJUN890: folds 
matiko09: folds 
Pvsx.: raises $1.50 to $2.50
Jimy Tiltman: raises $6 to $8.50
Sherlockplay: folds 
DUkalisUA: folds 
xHourglass: folds 
Pvsx.: folds 
Uncalled bet ($6) returned to Jimy Tiltman
Jimy Tiltman collected $6.50 from pot
Jimy Tiltman: doesn't show hand 
*** SUMMARY ***
Total pot $6.50 | Rake $0 
Seat 1: xHourglass (big blind) folded before Flop
Seat 2: tffff2006 folded before Flop (didn't bet)
Seat 3: CAJUN890 folded before Flop (didn't bet)
Seat 4: matiko09 folded before Flop (didn't bet)
Seat 5: Pvsx. folded before Flop
Seat 6: Jimy Tiltman collected ($6.50)
Seat 7: Sherlockplay (button) folded before Flop (didn't bet)
Seat 8: DUkalisUA (small blind) folded before Flop





PokerStars Hand #150801428499:  Hold'em No Limit ($1/$2 USD) - 2016/03/23 14:31:26 CET [2016/03/23 9:31:26 ET]
Table 'Kypria II' 9-max Seat #6 is the button
Seat 1: geldwolfje ($153.20 in chips) 
Seat 2: coinflip_si ($210.70 in chips) 
Seat 3: seouljam ($183.56 in chips) 
Seat 4: VolanDog ($217.70 in chips) 
Seat 5: InsomniaRU ($374.88 in chips) 
Seat 6: matiko09 ($368.95 in chips) 
Seat 7: DUkalisUA ($206 in chips) 
Seat 8: Pearl Jam87 ($200 in chips) 
Seat 9: Moszes360 ($200 in chips) 
DUkalisUA: posts small blind $1
Pearl Jam87: posts big blind $2
*** HOLE CARDS ***
Dealt to matiko09 [3c 4s]
Moszes360: folds 
geldwolfje: raises $4 to $6
coinflip_si: folds 
seouljam: folds 
VolanDog: folds 
InsomniaRU: folds 
matiko09: folds 
DUkalisUA: folds 
Pearl Jam87: folds 
Uncalled bet ($4) returned to geldwolfje
geldwolfje collected $5 from pot
geldwolfje: doesn't show hand 
*** SUMMARY ***
Total pot $5 | Rake $0 
Seat 1: geldwolfje collected ($5)
Seat 2: coinflip_si folded before Flop (didn't bet)
Seat 3: seouljam folded before Flop (didn't bet)
Seat 4: VolanDog folded before Flop (didn't bet)
Seat 5: InsomniaRU folded before Flop (didn't bet)
Seat 6: matiko09 (button) folded before Flop (didn't bet)
Seat 7: DUkalisUA (small blind) folded before Flop
Seat 8: Pearl Jam87 (big blind) folded before Flop
Seat 9: Moszes360 folded before Flop (didn't bet)





PokerStars Hand #150801429692:  Hold'em No Limit (€0.50/€1.00 EUR) - 2016/03/23 14:31:28 CET [2016/03/23 9:31:28 ET]
Table 'Lanzia' 9-max Seat #4 is the button
Seat 1: fk154 (€26.75 in chips) 
Seat 2: ardo888 (€101.50 in chips) 
Seat 3: Effort92 (€202.81 in chips) 
Seat 4: volwebni4ek (€40 in chips) 
Seat 5: matiko09 (€174.23 in chips) 
Seat 6: Red4erT (€40 in chips) 
Seat 7: $-Twackle-$ (€133 in chips) 
Seat 8: Muinmyheart (€102 in chips) 
Seat 9: Butcher1848 (€103.87 in chips) 
matiko09: posts small blind €0.50
Red4erT: posts big blind €1
*** HOLE CARDS ***
Dealt to matiko09 [8d 9h]
$-Twackle-$: folds 
Muinmyheart: raises €2 to €3
Butcher1848: folds 
fk154: folds 
ardo888: folds 
Effort92: folds 
volwebni4ek: folds 
matiko09: folds 
Red4erT: folds 
Uncalled bet (€2) returned to Muinmyheart
Muinmyheart collected €2.50 from pot
Muinmyheart: doesn't show hand 
*** SUMMARY ***
Total pot €2.50 | Rake €0 
Seat 1: fk154 folded before Flop (didn't bet)
Seat 2: ardo888 folded before Flop (didn't bet)
Seat 3: Effort92 folded before Flop (didn't bet)
Seat 4: volwebni4ek (button) folded before Flop (didn't bet)
Seat 5: matiko09 (small blind) folded before Flop
Seat 6: Red4erT (big blind) folded before Flop
Seat 7: $-Twackle-$ folded before Flop (didn't bet)
Seat 8: Muinmyheart collected (€2.50)
Seat 9: Butcher1848 folded before Flop (didn't bet)





PokerStars Hand #150801430373:  Hold'em No Limit ($0.25/$0.50 USD) - 2016/03/23 14:31:29 CET [2016/03/23 9:31:29 ET]
Table 'Pyrrhus' 9-max Seat #8 is the button
Seat 3: i L00K great ($50.75 in chips) 
Seat 4: GriffinBerg ($37.80 in chips) 
Seat 5: ZonTTT ($55.11 in chips) 
Seat 6: Ahangama ($50 in chips) 
Seat 7: matiko09 ($138.38 in chips) 
Seat 8: dndngod ($71.23 in chips) 
Seat 9: CvMCvMCvM ($96.81 in chips) 
CvMCvMCvM: posts small blind $0.25
alemão007: is sitting out 
i L00K great: posts big blind $0.50
*** HOLE CARDS ***
Dealt to matiko09 [Kh 8c]
GriffinBerg: calls $0.50
ZonTTT: folds 
alemão007 leaves the table
BSTUSim joins the table at seat #2 
Ahangama: folds 
matiko09: folds 
dndngod: folds 
CvMCvMCvM: calls $0.25
i L00K great: checks 
*** FLOP *** [Qs 5h Jc]
CvMCvMCvM: checks 
i L00K great: checks 
GriffinBerg: bets $0.71
CvMCvMCvM: folds 
i L00K great: folds 
Uncalled bet ($0.71) returned to GriffinBerg
GriffinBerg collected $1.43 from pot
*** SUMMARY ***
Total pot $1.50 | Rake $0.07 
Board [Qs 5h Jc]
Seat 3: i L00K great (big blind) folded on the Flop
Seat 4: GriffinBerg collected ($1.43)
Seat 5: ZonTTT folded before Flop (didn't bet)
Seat 6: Ahangama folded before Flop (didn't bet)
Seat 7: matiko09 folded before Flop (didn't bet)
Seat 8: dndngod (button) folded before Flop (didn't bet)
Seat 9: CvMCvMCvM (small blind) folded on the Flop





PokerStars Hand #150801432418:  Hold'em No Limit ($0.50/$1.00 USD) - 2016/03/23 14:31:32 CET [2016/03/23 9:31:32 ET]
Table 'Merope II' 9-max Seat #4 is the button
Seat 1: Jimy Tiltman ($142.23 in chips) 
Seat 2: $-Twackle-$ ($100 in chips) 
Seat 3: pablos1922 ($89.75 in chips) 
Seat 4: YuriiSolodya ($88.84 in chips) 
Seat 5: DUkalisUA ($158.87 in chips) 
Seat 6: Effort92 ($100 in chips) 
Seat 7: matiko09 ($109.23 in chips) 
Seat 8: titentei ($89 in chips) 
DUkalisUA: posts small blind $0.50
Effort92: posts big blind $1
*** HOLE CARDS ***
Dealt to matiko09 [Th 9h]
matiko09: raises $2 to $3
titentei: calls $3
Jimy Tiltman: calls $3
$-Twackle-$: folds 
pablos1922: folds 
YuriiSolodya: folds 
DUkalisUA: folds 
Effort92: folds 
*** FLOP *** [Qs 5h Kc]
matiko09: checks 
titentei: bets $5.01
Jimy Tiltman: folds 
matiko09: folds 
Uncalled bet ($5.01) returned to titentei
titentei collected $10.03 from pot
titentei: doesn't show hand 
*** SUMMARY ***
Total pot $10.50 | Rake $0.47 
Board [Qs 5h Kc]
Seat 1: Jimy Tiltman folded on the Flop
Seat 2: $-Twackle-$ folded before Flop (didn't bet)
Seat 3: pablos1922 folded before Flop (didn't bet)
Seat 4: YuriiSolodya (button) folded before Flop (didn't bet)
Seat 5: DUkalisUA (small blind) folded before Flop
Seat 6: Effort92 (big blind) folded before Flop
Seat 7: matiko09 folded on the Flop
Seat 8: titentei collected ($10.03)





PokerStars Hand #150801438683:  Hold'em No Limit ($0.50/$1.00 USD) - 2016/03/23 14:31:42 CET [2016/03/23 9:31:42 ET]
Table 'Atlantis' 9-max Seat #8 is the button
Seat 1: xHourglass ($152 in chips) 
Seat 2: tffff2006 ($69.72 in chips) 
Seat 3: CAJUN890 ($102.79 in chips) 
Seat 4: matiko09 ($126.25 in chips) 
Seat 5: Pvsx. ($100.25 in chips) 
Seat 6: Jimy Tiltman ($104 in chips) 
Seat 7: Sherlockplay ($133.27 in chips) 
Seat 8: DUkalisUA ($137.50 in chips) 
xHourglass: posts small blind $0.50
tffff2006: posts big blind $1
*** HOLE CARDS ***
Dealt to matiko09 [3h Ad]
CAJUN890: calls $1
matiko09: folds 
Pvsx.: folds 
Jimy Tiltman: folds 
Sherlockplay: folds 
DUkalisUA: folds 
xHourglass: folds 
tffff2006: raises $2 to $3
CAJUN890: calls $2
*** FLOP *** [9h Kd 8s]
tffff2006: checks 
CAJUN890: bets $3
tffff2006: calls $3
*** TURN *** [9h Kd 8s] [Jd]
tffff2006: checks 
CAJUN890: bets $5.97
tffff2006: calls $5.97
*** RIVER *** [9h Kd 8s Jd] [9c]
tffff2006: bets $11.50
CAJUN890: raises $11.50 to $23
tffff2006: calls $11.50
*** SHOW DOWN ***
CAJUN890: shows [Qd Td] (a straight, Nine to King)
tffff2006: mucks hand 
CAJUN890 collected $67.64 from pot
*** SUMMARY ***
Total pot $70.44 | Rake $2.80 
Board [9h Kd 8s Jd 9c]
Seat 1: xHourglass (small blind) folded before Flop
Seat 2: tffff2006 (big blind) mucked [As Ah]
Seat 3: CAJUN890 showed [Qd Td] and won ($67.64) with a straight, Nine to King
Seat 4: matiko09 folded before Flop (didn't bet)
Seat 5: Pvsx. folded before Flop (didn't bet)
Seat 6: Jimy Tiltman folded before Flop (didn't bet)
Seat 7: Sherlockplay folded before Flop (didn't bet)
Seat 8: DUkalisUA (button) folded before Flop (didn't bet)





PokerStars Hand #150801441614:  Hold'em No Limit ($1/$2 USD) - 2016/03/23 14:31:47 CET [2016/03/23 9:31:47 ET]
Table 'Achaia' 9-max Seat #5 is the button
Seat 1: Moszes360 ($209 in chips) 
Seat 2: InsomniaRU ($231.44 in chips) 
Seat 3: matiko09 ($200 in chips) 
Seat 4: nailz83 ($224.79 in chips) 
Seat 5: chaps1988 ($200 in chips) 
Seat 6: nickreason17 ($207.30 in chips) 
Seat 7: morosun ($145.20 in chips) 
Seat 8: $-Twackle-$ ($233.07 in chips) 
Seat 9: glanza_mike ($200 in chips) 
nickreason17: posts small blind $1
morosun: posts big blind $2
*** HOLE CARDS ***
Dealt to matiko09 [Ks 7d]
$-Twackle-$: folds 
glanza_mike: folds 
Moszes360: raises $4 to $6
InsomniaRU: folds 
matiko09: folds 
nailz83: folds 
chaps1988: folds 
nickreason17: folds 
morosun: folds 
Uncalled bet ($4) returned to Moszes360
Moszes360 collected $5 from pot
Moszes360: doesn't show hand 
*** SUMMARY ***
Total pot $5 | Rake $0 
Seat 1: Moszes360 collected ($5)
Seat 2: InsomniaRU folded before Flop (didn't bet)
Seat 3: matiko09 folded before Flop (didn't bet)
Seat 4: nailz83 folded before Flop (didn't bet)
Seat 5: chaps1988 (button) folded before Flop (didn't bet)
Seat 6: nickreason17 (small blind) folded before Flop
Seat 7: morosun (big blind) folded before Flop
Seat 8: $-Twackle-$ folded before Flop (didn't bet)
Seat 9: glanza_mike folded before Flop (didn't bet)





PokerStars Hand #150801442455:  Hold'em No Limit ($1/$2 USD) - 2016/03/23 14:31:48 CET [2016/03/23 9:31:48 ET]
Table 'Herba II' 9-max Seat #4 is the button
Seat 1: matiko09 ($219.20 in chips) 
Seat 2: Moszes360 ($224.17 in chips) 
Seat 3: Cirilico ($181.84 in chips) 
Seat 4: DUkalisUA ($200 in chips) 
Seat 5: chippo boy ($207.15 in chips) 
Seat 6: Too-Anti-To ($212.46 in chips) 
Seat 7: InsomniaRU ($406.20 in chips) 
Seat 9: mrhighryza ($53.67 in chips) 
chippo boy: posts small blind $1
Too-Anti-To: posts big blind $2
The_red_area: sits out 
*** HOLE CARDS ***
Dealt to matiko09 [Ah 8c]
InsomniaRU: folds 
mrhighryza: folds 
matiko09: folds 
Moszes360: folds 
Cirilico: folds 
DUkalisUA: raises $2 to $4
chippo boy: raises $8 to $12
Too-Anti-To: folds 
DUkalisUA: calls $8
*** FLOP *** [6c 2c 9d]
chippo boy: bets $12
DUkalisUA: calls $12
*** TURN *** [6c 2c 9d] [As]
chippo boy: bets $24
DUkalisUA: calls $24
*** RIVER *** [6c 2c 9d As] [6h]
chippo boy: checks 
DUkalisUA: checks 
*** SHOW DOWN ***
chippo boy: shows [Jd Ad] (two pair, Aces and Sixes)
DUkalisUA: mucks hand 
chippo boy collected $95.20 from pot
*** SUMMARY ***
Total pot $98 | Rake $2.80 
Board [6c 2c 9d As 6h]
Seat 1: matiko09 folded before Flop (didn't bet)
Seat 2: Moszes360 folded before Flop (didn't bet)
Seat 3: Cirilico folded before Flop (didn't bet)
Seat 4: DUkalisUA (button) mucked [7d 8d]
Seat 5: chippo boy (small blind) showed [Jd Ad] and won ($95.20) with two pair, Aces and Sixes
Seat 6: Too-Anti-To (big blind) folded before Flop
Seat 7: InsomniaRU folded before Flop (didn't bet)
Seat 9: mrhighryza folded before Flop (didn't bet)





PokerStars Hand #150801446742:  Hold'em No Limit (€0.50/€1.00 EUR) - 2016/03/23 14:31:55 CET [2016/03/23 9:31:55 ET]
Table 'Lanzia' 9-max Seat #5 is the button
Seat 1: fk154 (€26.75 in chips) 
Seat 2: ardo888 (€101.50 in chips) 
Seat 3: Effort92 (€202.81 in chips) 
Seat 4: volwebni4ek (€40 in chips) 
Seat 5: matiko09 (€173.73 in chips) 
Seat 6: Red4erT (€40 in chips) 
Seat 7: $-Twackle-$ (€133 in chips) 
Seat 8: Muinmyheart (€103.50 in chips) 
Seat 9: Butcher1848 (€103.87 in chips) 
Red4erT: posts small blind €0.50
$-Twackle-$: posts big blind €1
*** HOLE CARDS ***
Dealt to matiko09 [8h 3s]
Muinmyheart: folds 
Butcher1848: folds 
fk154: raises €1 to €2
ardo888: folds 
Effort92: calls €2
volwebni4ek: folds 
matiko09: folds 
Red4erT: folds 
$-Twackle-$: folds 
*** FLOP *** [Jh Qd 7h]
fk154: bets €7
Effort92: raises €8 to €15
fk154: calls €8
*** TURN *** [Jh Qd 7h] [4d]
fk154: bets €9.75 and is all-in
Effort92: calls €9.75
*** RIVER *** [Jh Qd 7h 4d] [8c]
*** SHOW DOWN ***
fk154: shows [Ah 2h] (high card Ace)
Effort92: shows [Kh Qs] (a pair of Queens)
Effort92 collected €52.85 from pot
*** SUMMARY ***
Total pot €55 | Rake €2.15 
Board [Jh Qd 7h 4d 8c]
Seat 1: fk154 showed [Ah 2h] and lost with high card Ace
Seat 2: ardo888 folded before Flop (didn't bet)
Seat 3: Effort92 showed [Kh Qs] and won (€52.85) with a pair of Queens
Seat 4: volwebni4ek folded before Flop (didn't bet)
Seat 5: matiko09 (button) folded before Flop (didn't bet)
Seat 6: Red4erT (small blind) folded before Flop
Seat 7: $-Twackle-$ (big blind) folded before Flop
Seat 8: Muinmyheart folded before Flop (didn't bet)
Seat 9: Butcher1848 folded before Flop (didn't bet)





PokerStars Hand #150801447839:  Hold'em No Limit ($1/$2 USD) - 2016/03/23 14:31:56 CET [2016/03/23 9:31:56 ET]
Table 'Kypria II' 9-max Seat #7 is the button
Seat 1: geldwolfje ($156.20 in chips) 
Seat 2: coinflip_si ($210.70 in chips) 
Seat 3: seouljam ($183.56 in chips) 
Seat 4: VolanDog ($217.70 in chips) 
Seat 5: InsomniaRU ($374.88 in chips) 
Seat 6: matiko09 ($368.95 in chips) 
Seat 7: DUkalisUA ($205 in chips) 
Seat 8: Pearl Jam87 ($200 in chips) 
Seat 9: Moszes360 ($200 in chips) 
Pearl Jam87: posts small blind $1
Moszes360: posts big blind $2
*** HOLE CARDS ***
Dealt to matiko09 [8c Kc]
geldwolfje: folds 
coinflip_si: folds 
seouljam: folds 
VolanDog: folds 
InsomniaRU: folds 
matiko09: raises $3 to $5
DUkalisUA: folds 
Pearl Jam87: folds 
Moszes360: folds 
Uncalled bet ($3) returned to matiko09
matiko09 collected $5 from pot
matiko09: doesn't show hand 
*** SUMMARY ***
Total pot $5 | Rake $0 
Seat 1: geldwolfje folded before Flop (didn't bet)
Seat 2: coinflip_si folded before Flop (didn't bet)
Seat 3: seouljam folded before Flop (didn't bet)
Seat 4: VolanDog folded before Flop (didn't bet)
Seat 5: InsomniaRU folded before Flop (didn't bet)
Seat 6: matiko09 collected ($5)
Seat 7: DUkalisUA (button) folded before Flop (didn't bet)
Seat 8: Pearl Jam87 (small blind) folded before Flop
Seat 9: Moszes360 (big blind) folded before Flop





PokerStars Hand #150801453543:  Hold'em No Limit ($0.50/$1.00 USD) - 2016/03/23 14:32:05 CET [2016/03/23 9:32:05 ET]
Table 'Donar II' 9-max Seat #9 is the button
Seat 1: Effort92 ($103.59 in chips) 
Seat 2: nobrunobru1 ($53.84 in chips) 
Seat 3: st-germ30 ($99.29 in chips) 
Seat 4: DUkalisUA ($145.49 in chips) 
Seat 5: matiko09 ($103.87 in chips) 
Seat 6: ardo888 ($132.78 in chips) 
Seat 7: JimineyCrik ($103.18 in chips) 
Seat 8: $-Twackle-$ ($108.95 in chips) 
Seat 9: oxfordtenzin ($122.70 in chips) 
Effort92: posts small blind $0.50
nobrunobru1: posts big blind $1
Effort92: posts the ante $0.20
nobrunobru1: posts the ante $0.20
st-germ30: posts the ante $0.20
DUkalisUA: posts the ante $0.20
matiko09: posts the ante $0.20
ardo888: posts the ante $0.20
JimineyCrik: posts the ante $0.20
$-Twackle-$: posts the ante $0.20
oxfordtenzin: posts the ante $0.20
*** HOLE CARDS ***
Dealt to matiko09 [Jc 7h]
st-germ30: folds 
DUkalisUA: raises $2 to $3
matiko09: folds 
ardo888: folds 
JimineyCrik: folds 
$-Twackle-$: calls $3
oxfordtenzin: calls $3
Effort92: folds 
nobrunobru1: calls $2
*** FLOP *** [9s 5h Qh]
nobrunobru1: checks 
DUkalisUA: checks 
$-Twackle-$: bets $10
oxfordtenzin: calls $10
nobrunobru1: folds 
DUkalisUA: calls $10
*** TURN *** [9s 5h Qh] [4d]
DUkalisUA: checks 
$-Twackle-$: checks 
oxfordtenzin: bets $21
DUkalisUA: calls $21
$-Twackle-$: raises $74.75 to $95.75 and is all-in
oxfordtenzin: folds 
DUkalisUA: calls $74.75
*** FIRST RIVER *** [9s 5h Qh 4d] [8d]
*** SECOND RIVER *** [9s 5h Qh 4d] [9h]
*** FIRST SHOW DOWN ***
DUkalisUA: shows [Ah 2h] (high card Ace)
$-Twackle-$: shows [Kd Kc] (a pair of Kings)
$-Twackle-$ collected $127 from pot
*** SECOND SHOW DOWN ***
DUkalisUA: shows [Ah 2h] (a flush, Ace high)
$-Twackle-$: shows [Kd Kc] (two pair, Kings and Nines)
DUkalisUA collected $127 from pot
*** SUMMARY ***
Total pot $256.80 | Rake $2.80 
Hand was run twice
FIRST Board [9s 5h Qh 4d 8d]
SECOND Board [9s 5h Qh 4d 9h]
Seat 1: Effort92 (small blind) folded before Flop
Seat 2: nobrunobru1 (big blind) folded on the Flop
Seat 3: st-germ30 folded before Flop (didn't bet)
Seat 4: DUkalisUA showed [Ah 2h] and lost with high card Ace, and won ($127) with a flush, Ace high
Seat 5: matiko09 folded before Flop (didn't bet)
Seat 6: ardo888 folded before Flop (didn't bet)
Seat 7: JimineyCrik folded before Flop (didn't bet)
Seat 8: $-Twackle-$ showed [Kd Kc] and won ($127) with a pair of Kings, and lost with two pair, Kings and Nines
Seat 9: oxfordtenzin (button) folded on the Turn





PokerStars Hand #150801456094:  Hold'em No Limit ($1/$2 USD) - 2016/03/23 14:32:09 CET [2016/03/23 9:32:09 ET]
Table 'Kiess' 9-max Seat #1 is the button
Seat 1: Cirilico ($229.74 in chips) 
Seat 2: DUkalisUA ($663.10 in chips) 
Seat 3: The_red_area ($342.27 in chips) 
Seat 4: Moszes360 ($200 in chips) 
Seat 5: chippo boy ($460.28 in chips) 
Seat 6: matiko09 ($266.86 in chips) 
Seat 7: InsomniaRU ($306.97 in chips) 
Seat 8: erfk1958 ($104.13 in chips) 
Seat 9: T0ny Adams ($91.24 in chips) 
DUkalisUA: posts small blind $1
The_red_area: posts big blind $2
*** HOLE CARDS ***
Dealt to matiko09 [8d Ks]
Moszes360: folds 
chippo boy: calls $2
matiko09: folds 
InsomniaRU: folds 
erfk1958: raises $6 to $8
T0ny Adams: folds 
Cirilico: folds 
DUkalisUA: calls $7
The_red_area: folds 
chippo boy: calls $6
*** FLOP *** [3s Js 9d]
DUkalisUA: checks 
chippo boy: checks 
erfk1958: bets $10
DUkalisUA: folds 
chippo boy: folds 
Uncalled bet ($10) returned to erfk1958
erfk1958 collected $24.83 from pot
erfk1958: doesn't show hand 
*** SUMMARY ***
Total pot $26 | Rake $1.17 
Board [3s Js 9d]
Seat 1: Cirilico (button) folded before Flop (didn't bet)
Seat 2: DUkalisUA (small blind) folded on the Flop
Seat 3: The_red_area (big blind) folded before Flop
Seat 4: Moszes360 folded before Flop (didn't bet)
Seat 5: chippo boy folded on the Flop
Seat 6: matiko09 folded before Flop (didn't bet)
Seat 7: InsomniaRU folded before Flop (didn't bet)
Seat 8: erfk1958 collected ($24.83)
Seat 9: T0ny Adams folded before Flop (didn't bet)





PokerStars Hand #150801458257:  Hold'em No Limit ($0.50/$1.00 USD) - 2016/03/23 14:32:13 CET [2016/03/23 9:32:13 ET]
Table 'Swings' 9-max Seat #7 is the button
Seat 1: Sherlockplay ($100 in chips) 
Seat 2: Harbinger X ($93.47 in chips) 
Seat 3: maxxmeister ($115.08 in chips) 
Seat 4: chaps1988 ($100 in chips) 
Seat 5: chautinhtri9 ($97.50 in chips) 
Seat 6: matiko09 ($100 in chips) 
Seat 7: nickreason17 ($100 in chips) 
Seat 9: Vlad_1965_77 ($108.05 in chips) 
Vlad_1965_77: posts small blind $0.50
Sherlockplay: posts big blind $1
*** HOLE CARDS ***
Dealt to matiko09 [Td Jh]
Harbinger X: folds 
maxxmeister: folds 
chaps1988: raises $1.50 to $2.50
chautinhtri9: calls $2.50
matiko09: folds 
nickreason17: calls $2.50
Vlad_1965_77: folds 
Sherlockplay: folds 
*** FLOP *** [7c 9d 3d]
chaps1988: checks 
chautinhtri9: checks 
nickreason17: checks 
*** TURN *** [7c 9d 3d] [Qh]
chaps1988: bets $6
chautinhtri9: folds 
nickreason17: folds 
Uncalled bet ($6) returned to chaps1988
chaps1988 collected $8.60 from pot
chaps1988: doesn't show hand 
*** SUMMARY ***
Total pot $9 | Rake $0.40 
Board [7c 9d 3d Qh]
Seat 1: Sherlockplay (big blind) folded before Flop
Seat 2: Harbinger X folded before Flop (didn't bet)
Seat 3: maxxmeister folded before Flop (didn't bet)
Seat 4: chaps1988 collected ($8.60)
Seat 5: chautinhtri9 folded on the Turn
Seat 6: matiko09 folded before Flop (didn't bet)
Seat 7: nickreason17 (button) folded on the Turn
Seat 9: Vlad_1965_77 (small blind) folded before Flop





PokerStars Hand #150801460821:  Hold'em No Limit ($1/$2 USD) - 2016/03/23 14:32:17 CET [2016/03/23 9:32:17 ET]
Table 'Achaia' 9-max Seat #6 is the button
Seat 1: Moszes360 ($212 in chips) 
Seat 2: InsomniaRU ($231.44 in chips) 
Seat 3: matiko09 ($200 in chips) 
Seat 4: nailz83 ($224.79 in chips) 
Seat 5: chaps1988 ($200 in chips) 
Seat 6: nickreason17 ($206.30 in chips) 
Seat 7: morosun ($143.20 in chips) 
Seat 8: $-Twackle-$ ($233.07 in chips) 
Seat 9: glanza_mike ($200 in chips) 
morosun: posts small blind $1
$-Twackle-$: posts big blind $2
*** HOLE CARDS ***
Dealt to matiko09 [8c Qh]
glanza_mike: folds 
Moszes360: folds 
InsomniaRU: folds 
matiko09: folds 
nailz83: folds 
chaps1988: folds 
nickreason17: raises $2.08 to $4.08
morosun: raises $2.08 to $6.16
$-Twackle-$: folds 
nickreason17: calls $2.08
*** FLOP *** [4s 5c 6d]
morosun: bets $13.68
nickreason17: folds 
Uncalled bet ($13.68) returned to morosun
morosun collected $13.68 from pot
*** SUMMARY ***
Total pot $14.32 | Rake $0.64 
Board [4s 5c 6d]
Seat 1: Moszes360 folded before Flop (didn't bet)
Seat 2: InsomniaRU folded before Flop (didn't bet)
Seat 3: matiko09 folded before Flop (didn't bet)
Seat 4: nailz83 folded before Flop (didn't bet)
Seat 5: chaps1988 folded before Flop (didn't bet)
Seat 6: nickreason17 (button) folded on the Flop
Seat 7: morosun (small blind) collected ($13.68)
Seat 8: $-Twackle-$ (big blind) folded before Flop
Seat 9: glanza_mike folded before Flop (didn't bet)





PokerStars Hand #150801466400:  Hold'em No Limit ($1/$2 USD) - 2016/03/23 14:32:26 CET [2016/03/23 9:32:26 ET]
Table 'Kypria II' 9-max Seat #8 is the button
Seat 1: geldwolfje ($156.20 in chips) 
Seat 2: coinflip_si ($210.70 in chips) 
Seat 3: seouljam ($183.56 in chips) 
Seat 4: VolanDog ($217.70 in chips) 
Seat 5: InsomniaRU ($374.88 in chips) 
Seat 6: matiko09 ($371.95 in chips) 
Seat 7: DUkalisUA ($205 in chips) 
Seat 8: Pearl Jam87 ($200 in chips) 
Seat 9: Moszes360 ($200 in chips) 
Moszes360: posts small blind $1
geldwolfje: posts big blind $2
*** HOLE CARDS ***
Dealt to matiko09 [4c 9h]
coinflip_si: folds 
seouljam: folds 
VolanDog: folds 
InsomniaRU: folds 
matiko09: folds 
DUkalisUA: folds 
Pearl Jam87: folds 
Moszes360: folds 
Uncalled bet ($1) returned to geldwolfje
geldwolfje collected $2 from pot
geldwolfje: doesn't show hand 
*** SUMMARY ***
Total pot $2 | Rake $0 
Seat 1: geldwolfje (big blind) collected ($2)
Seat 2: coinflip_si folded before Flop (didn't bet)
Seat 3: seouljam folded before Flop (didn't bet)
Seat 4: VolanDog folded before Flop (didn't bet)
Seat 5: InsomniaRU folded before Flop (didn't bet)
Seat 6: matiko09 folded before Flop (didn't bet)
Seat 7: DUkalisUA folded before Flop (didn't bet)
Seat 8: Pearl Jam87 (button) folded before Flop (didn't bet)
Seat 9: Moszes360 (small blind) folded before Flop





PokerStars Hand #150801469704:  Hold'em No Limit ($0.50/$1.00 USD) - 2016/03/23 14:32:31 CET [2016/03/23 9:32:31 ET]
Table 'Merope II' 9-max Seat #5 is the button
Seat 1: Jimy Tiltman ($139.23 in chips) 
Seat 2: $-Twackle-$ ($100 in chips) 
Seat 3: pablos1922 ($89.75 in chips) 
Seat 4: YuriiSolodya ($88.84 in chips) 
Seat 5: DUkalisUA ($158.37 in chips) 
Seat 6: Effort92 ($100 in chips) 
Seat 7: matiko09 ($106.23 in chips) 
Seat 8: titentei ($96.03 in chips) 
Effort92: posts small blind $0.50
matiko09: posts big blind $1
*** HOLE CARDS ***
Dealt to matiko09 [Kd 4d]
titentei: folds 
Jimy Tiltman: folds 
$-Twackle-$: folds 
pablos1922: folds 
YuriiSolodya: raises $2 to $3
DUkalisUA: folds 
Effort92: folds 
matiko09: folds 
Uncalled bet ($2) returned to YuriiSolodya
YuriiSolodya collected $2.50 from pot
YuriiSolodya: doesn't show hand 
*** SUMMARY ***
Total pot $2.50 | Rake $0 
Seat 1: Jimy Tiltman folded before Flop (didn't bet)
Seat 2: $-Twackle-$ folded before Flop (didn't bet)
Seat 3: pablos1922 folded before Flop (didn't bet)
Seat 4: YuriiSolodya collected ($2.50)
Seat 5: DUkalisUA (button) folded before Flop (didn't bet)
Seat 6: Effort92 (small blind) folded before Flop
Seat 7: matiko09 (big blind) folded before Flop
Seat 8: titentei folded before Flop (didn't bet)





PokerStars Hand #150801477274:  Hold'em No Limit ($1/$2 USD) - 2016/03/23 14:32:43 CET [2016/03/23 9:32:43 ET]
Table 'Ennomos II' 9-max Seat #8 is the button
Seat 1: InsomniaRU ($200 in chips) 
Seat 2: Subam ($319.38 in chips) 
Seat 3: $-Twackle-$ ($231.20 in chips) 
Seat 4: glanza_mike ($200 in chips) 
Seat 5: South011 ($394.02 in chips) 
Seat 6: nickreason17 ($232.40 in chips) 
Seat 8: yyfk ($200.24 in chips) 
Seat 9: matiko09 ($322.20 in chips) 
matiko09: posts small blind $1
InsomniaRU: posts big blind $2
T0ny Adams: sits out 
*** HOLE CARDS ***
Dealt to matiko09 [5c 5h]
Subam: raises $4 to $6
$-Twackle-$: folds 
glanza_mike: raises $12 to $18
South011: folds 
nickreason17: raises $27 to $45
yyfk: folds 
matiko09: folds 
InsomniaRU: folds 
Subam: folds 
glanza_mike: folds 
Uncalled bet ($27) returned to nickreason17
nickreason17 collected $45 from pot
*** SUMMARY ***
Total pot $45 | Rake $0 
Seat 1: InsomniaRU (big blind) folded before Flop
Seat 2: Subam folded before Flop
Seat 3: $-Twackle-$ folded before Flop (didn't bet)
Seat 4: glanza_mike folded before Flop
Seat 5: South011 folded before Flop (didn't bet)
Seat 6: nickreason17 collected ($45)
Seat 8: yyfk (button) folded before Flop (didn't bet)
Seat 9: matiko09 (small blind) folded before Flop





PokerStars Hand #150801478633:  Hold'em No Limit ($1/$2 USD) - 2016/03/23 14:32:45 CET [2016/03/23 9:32:45 ET]
Table 'Kypria II' 9-max Seat #9 is the button
Seat 1: geldwolfje ($157.20 in chips) 
Seat 2: coinflip_si ($210.70 in chips) 
Seat 3: seouljam ($183.56 in chips) 
Seat 4: VolanDog ($217.70 in chips) 
Seat 5: InsomniaRU ($374.88 in chips) 
Seat 6: matiko09 ($371.95 in chips) 
Seat 7: DUkalisUA ($205 in chips) 
Seat 8: Pearl Jam87 ($200 in chips) 
Seat 9: Moszes360 ($200 in chips) 
geldwolfje: posts small blind $1
coinflip_si: posts big blind $2
*** HOLE CARDS ***
Dealt to matiko09 [Qs 7c]
seouljam: folds 
VolanDog: folds 
InsomniaRU: folds 
matiko09: folds 
DUkalisUA: folds 
Pearl Jam87: folds 
Moszes360: folds 
geldwolfje: raises $2 to $4
coinflip_si: calls $2
*** FLOP *** [8s 4c 8h]
geldwolfje: bets $4
coinflip_si: folds 
Uncalled bet ($4) returned to geldwolfje
geldwolfje collected $7.64 from pot
geldwolfje: doesn't show hand 
*** SUMMARY ***
Total pot $8 | Rake $0.36 
Board [8s 4c 8h]
Seat 1: geldwolfje (small blind) collected ($7.64)
Seat 2: coinflip_si (big blind) folded on the Flop
Seat 3: seouljam folded before Flop (didn't bet)
Seat 4: VolanDog folded before Flop (didn't bet)
Seat 5: InsomniaRU folded before Flop (didn't bet)
Seat 6: matiko09 folded before Flop (didn't bet)
Seat 7: DUkalisUA folded before Flop (didn't bet)
Seat 8: Pearl Jam87 folded before Flop (didn't bet)
Seat 9: Moszes360 (button) folded before Flop (didn't bet)





PokerStars Hand #150801480349:  Hold'em No Limit ($1/$2 USD) - 2016/03/23 14:32:47 CET [2016/03/23 9:32:47 ET]
Table 'Achaia' 9-max Seat #7 is the button
Seat 1: Moszes360 ($212 in chips) 
Seat 2: InsomniaRU ($231.44 in chips) 
Seat 3: matiko09 ($200 in chips) 
Seat 4: nailz83 ($224.79 in chips) 
Seat 5: chaps1988 ($200 in chips) 
Seat 6: nickreason17 ($200.14 in chips) 
Seat 7: morosun ($150.72 in chips) 
Seat 8: $-Twackle-$ ($231.07 in chips) 
Seat 9: glanza_mike ($200 in chips) 
$-Twackle-$: posts small blind $1
glanza_mike: posts big blind $2
*** HOLE CARDS ***
Dealt to matiko09 [6h Ks]
Moszes360: folds 
InsomniaRU: folds 
matiko09: folds 
nailz83: raises $4 to $6
chaps1988: folds 
nickreason17: folds 
morosun: calls $6
$-Twackle-$: calls $5
glanza_mike: folds 
*** FLOP *** [Js Ac 5h]
$-Twackle-$: checks 
nailz83: checks 
morosun: bets $2
$-Twackle-$: folds 
nailz83: calls $2
*** TURN *** [Js Ac 5h] [7s]
nailz83: checks 
morosun: bets $6
nailz83: calls $6
*** RIVER *** [Js Ac 5h 7s] [2c]
nailz83: checks 
morosun: bets $34.38
nailz83: folds 
Uncalled bet ($34.38) returned to morosun
morosun collected $34.38 from pot
*** SUMMARY ***
Total pot $36 | Rake $1.62 
Board [Js Ac 5h 7s 2c]
Seat 1: Moszes360 folded before Flop (didn't bet)
Seat 2: InsomniaRU folded before Flop (didn't bet)
Seat 3: matiko09 folded before Flop (didn't bet)
Seat 4: nailz83 folded on the River
Seat 5: chaps1988 folded before Flop (didn't bet)
Seat 6: nickreason17 folded before Flop (didn't bet)
Seat 7: morosun (button) collected ($34.38)
Seat 8: $-Twackle-$ (small blind) folded on the Flop
Seat 9: glanza_mike (big blind) folded before Flop





PokerStars Hand #150801480671:  Hold'em No Limit ($0.50/$1.00 USD) - 2016/03/23 14:32:48 CET [2016/03/23 9:32:48 ET]
Table 'Kippes' 9-max Seat #4 is the button
Seat 1: Pvsx. ($110.66 in chips) 
Seat 3: CAJUN890 ($126.50 in chips) 
Seat 4: matiko09 ($100 in chips) 
Seat 5: Jimy Tiltman ($129.72 in chips) 
Seat 6: DUkalisUA ($118.94 in chips) 
Seat 8: Sherlockplay ($100 in chips) 
Seat 9: wang19790906 ($201.20 in chips) 
Jimy Tiltman: posts small blind $0.50
DUkalisUA: posts big blind $1
*** HOLE CARDS ***
Dealt to matiko09 [Jh Qs]
Sherlockplay: folds 
wang19790906: folds 
Pvsx.: folds 
wang19790906 leaves the table
Szevasztopol joins the table at seat #9 
CAJUN890: folds 
matiko09: raises $1.27 to $2.27
Jimy Tiltman: raises $6.23 to $8.50
DUkalisUA: folds 
matiko09: folds 
Uncalled bet ($6.23) returned to Jimy Tiltman
Jimy Tiltman collected $5.54 from pot
Jimy Tiltman: doesn't show hand 
*** SUMMARY ***
Total pot $5.54 | Rake $0 
Seat 1: Pvsx. folded before Flop (didn't bet)
Seat 3: CAJUN890 folded before Flop (didn't bet)
Seat 4: matiko09 (button) folded before Flop
Seat 5: Jimy Tiltman (small blind) collected ($5.54)
Seat 6: DUkalisUA (big blind) folded before Flop
Seat 8: Sherlockplay folded before Flop (didn't bet)
Seat 9: wang19790906 folded before Flop (didn't bet)





PokerStars Hand #150801484396:  Hold'em No Limit ($0.25/$0.50 USD) - 2016/03/23 14:32:54 CET [2016/03/23 9:32:54 ET]
Table 'Pyrrhus' 9-max Seat #9 is the button
Seat 3: i L00K great ($50.25 in chips) 
Seat 4: GriffinBerg ($38.73 in chips) 
Seat 5: ZonTTT ($55.11 in chips) 
Seat 6: Ahangama ($50 in chips) 
Seat 7: matiko09 ($138.38 in chips) 
Seat 8: dndngod ($71.23 in chips) 
Seat 9: CvMCvMCvM ($96.31 in chips) 
BSTUSim will be allowed to play after the button
i L00K great: posts small blind $0.25
GriffinBerg: posts big blind $0.50
*** HOLE CARDS ***
Dealt to matiko09 [7s Qd]
ZonTTT: folds 
Ahangama: folds 
matiko09: folds 
dndngod: folds 
CvMCvMCvM: raises $0.76 to $1.26
i L00K great: folds 
GriffinBerg: calls $0.76
*** FLOP *** [Kc Kd 9h]
GriffinBerg: checks 
CvMCvMCvM: bets $1.53
GriffinBerg: calls $1.53
*** TURN *** [Kc Kd 9h] [2s]
GriffinBerg: checks 
CvMCvMCvM: checks 
*** RIVER *** [Kc Kd 9h 2s] [Ad]
GriffinBerg: bets $3
CvMCvMCvM: folds 
Uncalled bet ($3) returned to GriffinBerg
GriffinBerg collected $5.57 from pot
*** SUMMARY ***
Total pot $5.83 | Rake $0.26 
Board [Kc Kd 9h 2s Ad]
Seat 3: i L00K great (small blind) folded before Flop
Seat 4: GriffinBerg (big blind) collected ($5.57)
Seat 5: ZonTTT folded before Flop (didn't bet)
Seat 6: Ahangama folded before Flop (didn't bet)
Seat 7: matiko09 folded before Flop (didn't bet)
Seat 8: dndngod folded before Flop (didn't bet)
Seat 9: CvMCvMCvM (button) folded on the River





PokerStars Hand #150801486802:  Hold'em No Limit ($0.50/$1.00 USD) - 2016/03/23 14:32:58 CET [2016/03/23 9:32:58 ET]
Table 'Merope II' 9-max Seat #6 is the button
Seat 1: Jimy Tiltman ($139.23 in chips) 
Seat 2: $-Twackle-$ ($100 in chips) 
Seat 3: pablos1922 ($89.75 in chips) 
Seat 4: YuriiSolodya ($90.34 in chips) 
Seat 5: DUkalisUA ($158.37 in chips) 
Seat 6: Effort92 ($100 in chips) 
Seat 7: matiko09 ($105.23 in chips) 
Seat 8: titentei ($96.03 in chips) 
matiko09: posts small blind $0.50
titentei: posts big blind $1
*** HOLE CARDS ***
Dealt to matiko09 [Qd Jc]
Jimy Tiltman: folds 
$-Twackle-$: folds 
pablos1922: folds 
YuriiSolodya: raises $2 to $3
DUkalisUA: folds 
Effort92: folds 
matiko09: folds 
titentei: folds 
Uncalled bet ($2) returned to YuriiSolodya
YuriiSolodya collected $2.50 from pot
YuriiSolodya: doesn't show hand 
*** SUMMARY ***
Total pot $2.50 | Rake $0 
Seat 1: Jimy Tiltman folded before Flop (didn't bet)
Seat 2: $-Twackle-$ folded before Flop (didn't bet)
Seat 3: pablos1922 folded before Flop (didn't bet)
Seat 4: YuriiSolodya collected ($2.50)
Seat 5: DUkalisUA folded before Flop (didn't bet)
Seat 6: Effort92 (button) folded before Flop (didn't bet)
Seat 7: matiko09 (small blind) folded before Flop
Seat 8: titentei (big blind) folded before Flop





PokerStars Hand #150801488928:  Hold'em No Limit ($0.50/$1.00 USD) - 2016/03/23 14:33:01 CET [2016/03/23 9:33:01 ET]
Table 'Swings' 9-max Seat #9 is the button
Seat 1: Sherlockplay ($100 in chips) 
Seat 2: Harbinger X ($93.47 in chips) 
Seat 3: maxxmeister ($115.08 in chips) 
Seat 4: chaps1988 ($106.10 in chips) 
Seat 5: chautinhtri9 ($95 in chips) 
Seat 6: matiko09 ($100 in chips) 
Seat 7: nickreason17 ($100 in chips) 
Seat 9: Vlad_1965_77 ($107.55 in chips) 
Sherlockplay: posts small blind $0.50
Harbinger X: posts big blind $1
*** HOLE CARDS ***
Dealt to matiko09 [Jc 7d]
maxxmeister: folds 
chaps1988: folds 
chautinhtri9: folds 
matiko09: folds 
nickreason17: raises $1.50 to $2.50
Vlad_1965_77: folds 
Sherlockplay: folds 
Harbinger X: raises $4.50 to $7
nickreason17: folds 
Uncalled bet ($4.50) returned to Harbinger X
Harbinger X collected $5.50 from pot
Harbinger X: doesn't show hand 
*** SUMMARY ***
Total pot $5.50 | Rake $0 
Seat 1: Sherlockplay (small blind) folded before Flop
Seat 2: Harbinger X (big blind) collected ($5.50)
Seat 3: maxxmeister folded before Flop (didn't bet)
Seat 4: chaps1988 folded before Flop (didn't bet)
Seat 5: chautinhtri9 folded before Flop (didn't bet)
Seat 6: matiko09 folded before Flop (didn't bet)
Seat 7: nickreason17 folded before Flop
Seat 9: Vlad_1965_77 (button) folded before Flop (didn't bet)





PokerStars Hand #150801489412:  Hold'em No Limit ($1/$2 USD) - 2016/03/23 14:33:02 CET [2016/03/23 9:33:02 ET]
Table 'Herba II' 9-max Seat #5 is the button
Seat 1: matiko09 ($219.20 in chips) 
Seat 2: Moszes360 ($224.17 in chips) 
Seat 3: Cirilico ($181.84 in chips) 
Seat 4: DUkalisUA ($200 in chips) 
Seat 5: chippo boy ($254.35 in chips) 
Seat 6: Too-Anti-To ($210.46 in chips) 
Seat 7: InsomniaRU ($406.20 in chips) 
Seat 9: mrhighryza ($53.67 in chips) 
Too-Anti-To: posts small blind $1
InsomniaRU: posts big blind $2
The_red_area: sits out 
*** HOLE CARDS ***
Dealt to matiko09 [8s 8h]
mrhighryza: folds 
matiko09: raises $3 to $5
Moszes360: folds 
Cirilico: folds 
DUkalisUA: folds 
chippo boy: calls $5
Too-Anti-To: folds 
InsomniaRU: folds 
*** FLOP *** [6c Ah 7d]
matiko09: checks 
chippo boy: checks 
*** TURN *** [6c Ah 7d] [4h]
matiko09: bets $6.45
chippo boy: folds 
Uncalled bet ($6.45) returned to matiko09
matiko09 collected $12.42 from pot
matiko09: doesn't show hand 
*** SUMMARY ***
Total pot $13 | Rake $0.58 
Board [6c Ah 7d 4h]
Seat 1: matiko09 collected ($12.42)
Seat 2: Moszes360 folded before Flop (didn't bet)
Seat 3: Cirilico folded before Flop (didn't bet)
Seat 4: DUkalisUA folded before Flop (didn't bet)
Seat 5: chippo boy (button) folded on the Turn
Seat 6: Too-Anti-To (small blind) folded before Flop
Seat 7: InsomniaRU (big blind) folded before Flop
Seat 9: mrhighryza folded before Flop (didn't bet)





PokerStars Hand #150801498449:  Hold'em No Limit (€0.50/€1.00 EUR) - 2016/03/23 14:33:16 CET [2016/03/23 9:33:16 ET]
Table 'Lanzia' 9-max Seat #6 is the button
Seat 2: ardo888 (€101.50 in chips) 
Seat 3: Effort92 (€228.91 in chips) 
Seat 4: volwebni4ek (€40 in chips) 
Seat 5: matiko09 (€173.73 in chips) 
Seat 6: Red4erT (€40 in chips) 
Seat 7: $-Twackle-$ (€132 in chips) 
Seat 8: Muinmyheart (€103.50 in chips) 
Seat 9: Butcher1848 (€103.87 in chips) 
$-Twackle-$: posts small blind €0.50
Muinmyheart: posts big blind €1
*** HOLE CARDS ***
Dealt to matiko09 [Kd Qh]
fk154 leaves the table
Butcher1848: folds 
chaps1988 joins the table at seat #1 
ardo888: folds 
Effort92: folds 
volwebni4ek: folds 
matiko09: raises €1.50 to €2.50
Red4erT: folds 
$-Twackle-$: folds 
Muinmyheart: folds 
Uncalled bet (€1.50) returned to matiko09
matiko09 collected €2.50 from pot
matiko09: doesn't show hand 
*** SUMMARY ***
Total pot €2.50 | Rake €0 
Seat 2: ardo888 folded before Flop (didn't bet)
Seat 3: Effort92 folded before Flop (didn't bet)
Seat 4: volwebni4ek folded before Flop (didn't bet)
Seat 5: matiko09 collected (€2.50)
Seat 6: Red4erT (button) folded before Flop (didn't bet)
Seat 7: $-Twackle-$ (small blind) folded before Flop
Seat 8: Muinmyheart (big blind) folded before Flop
Seat 9: Butcher1848 folded before Flop (didn't bet)





PokerStars Hand #150801500901:  Hold'em No Limit ($1/$2 USD) - 2016/03/23 14:33:20 CET [2016/03/23 9:33:20 ET]
Table 'Kypria II' 9-max Seat #1 is the button
Seat 1: geldwolfje ($160.84 in chips) 
Seat 2: coinflip_si ($206.70 in chips) 
Seat 3: seouljam ($183.56 in chips) 
Seat 4: VolanDog ($217.70 in chips) 
Seat 5: InsomniaRU ($374.88 in chips) 
Seat 6: matiko09 ($371.95 in chips) 
Seat 7: DUkalisUA ($205 in chips) 
Seat 8: Pearl Jam87 ($200 in chips) 
Seat 9: Moszes360 ($200 in chips) 
coinflip_si: posts small blind $1
seouljam: posts big blind $2
*** HOLE CARDS ***
Dealt to matiko09 [8c 3d]
VolanDog: folds 
InsomniaRU: folds 
matiko09: folds 
DUkalisUA: folds 
Pearl Jam87: folds 
Moszes360: folds 
geldwolfje: raises $4 to $6
coinflip_si: folds 
seouljam: calls $4
*** FLOP *** [Qd 2h 6d]
seouljam: checks 
geldwolfje: bets $12
seouljam: folds 
Uncalled bet ($12) returned to geldwolfje
geldwolfje collected $12.42 from pot
geldwolfje: doesn't show hand 
*** SUMMARY ***
Total pot $13 | Rake $0.58 
Board [Qd 2h 6d]
Seat 1: geldwolfje (button) collected ($12.42)
Seat 2: coinflip_si (small blind) folded before Flop
Seat 3: seouljam (big blind) folded on the Flop
Seat 4: VolanDog folded before Flop (didn't bet)
Seat 5: InsomniaRU folded before Flop (didn't bet)
Seat 6: matiko09 folded before Flop (didn't bet)
Seat 7: DUkalisUA folded before Flop (didn't bet)
Seat 8: Pearl Jam87 folded before Flop (didn't bet)
Seat 9: Moszes360 folded before Flop (didn't bet)





PokerStars Hand #150801500789:  Hold'em No Limit ($1/$2 USD) - 2016/03/23 14:33:20 CET [2016/03/23 9:33:20 ET]
Table 'Kiess' 9-max Seat #2 is the button
Seat 1: Cirilico ($229.74 in chips) 
Seat 2: DUkalisUA ($655.10 in chips) 
Seat 3: The_red_area ($340.27 in chips) 
Seat 4: Moszes360 ($200 in chips) 
Seat 5: chippo boy ($452.28 in chips) 
Seat 6: matiko09 ($266.86 in chips) 
Seat 7: InsomniaRU ($306.97 in chips) 
Seat 8: erfk1958 ($120.96 in chips) 
Seat 9: T0ny Adams ($91.24 in chips) 
The_red_area: posts small blind $1
Moszes360: posts big blind $2
*** HOLE CARDS ***
Dealt to matiko09 [6d Kc]
chippo boy: folds 
matiko09: folds 
InsomniaRU: folds 
erfk1958: folds 
T0ny Adams: folds 
Cirilico: folds 
DUkalisUA: folds 
The_red_area: folds 
Uncalled bet ($1) returned to Moszes360
Moszes360 collected $2 from pot
Moszes360: doesn't show hand 
*** SUMMARY ***
Total pot $2 | Rake $0 
Seat 1: Cirilico folded before Flop (didn't bet)
Seat 2: DUkalisUA (button) folded before Flop (didn't bet)
Seat 3: The_red_area (small blind) folded before Flop
Seat 4: Moszes360 (big blind) collected ($2)
Seat 5: chippo boy folded before Flop (didn't bet)
Seat 6: matiko09 folded before Flop (didn't bet)
Seat 7: InsomniaRU folded before Flop (didn't bet)
Seat 8: erfk1958 folded before Flop (didn't bet)
Seat 9: T0ny Adams folded before Flop (didn't bet)





PokerStars Hand #150801502555:  Hold'em No Limit ($0.50/$1.00 USD) - 2016/03/23 14:33:23 CET [2016/03/23 9:33:23 ET]
Table 'Merope II' 9-max Seat #7 is the button
Seat 1: Jimy Tiltman ($139.23 in chips) 
Seat 2: $-Twackle-$ ($100 in chips) 
Seat 3: pablos1922 ($89.75 in chips) 
Seat 4: YuriiSolodya ($91.84 in chips) 
Seat 5: DUkalisUA ($158.37 in chips) 
Seat 6: Effort92 ($100 in chips) 
Seat 7: matiko09 ($104.73 in chips) 
Seat 8: titentei ($95.03 in chips) 
titentei: posts small blind $0.50
Jimy Tiltman: posts big blind $1
*** HOLE CARDS ***
Dealt to matiko09 [3s 6d]
$-Twackle-$: folds 
pablos1922: folds 
YuriiSolodya: folds 
DUkalisUA: raises $2 to $3
Effort92: folds 
matiko09: folds 
titentei: folds 
Jimy Tiltman: folds 
Uncalled bet ($2) returned to DUkalisUA
DUkalisUA collected $2.50 from pot
DUkalisUA: doesn't show hand 
*** SUMMARY ***
Total pot $2.50 | Rake $0 
Seat 1: Jimy Tiltman (big blind) folded before Flop
Seat 2: $-Twackle-$ folded before Flop (didn't bet)
Seat 3: pablos1922 folded before Flop (didn't bet)
Seat 4: YuriiSolodya folded before Flop (didn't bet)
Seat 5: DUkalisUA collected ($2.50)
Seat 6: Effort92 folded before Flop (didn't bet)
Seat 7: matiko09 (button) folded before Flop (didn't bet)
Seat 8: titentei (small blind) folded before Flop





PokerStars Hand #150801503073:  Hold'em No Limit ($0.50/$1.00 USD) - 2016/03/23 14:33:23 CET [2016/03/23 9:33:23 ET]
Table 'Atlantis' 9-max Seat #1 is the button
Seat 1: xHourglass ($151.50 in chips) 
Seat 2: tffff2006 ($34.75 in chips) 
Seat 3: CAJUN890 ($135.46 in chips) 
Seat 4: matiko09 ($126.25 in chips) 
Seat 5: Pvsx. ($100.25 in chips) 
Seat 6: Jimy Tiltman ($104 in chips) 
Seat 7: Sherlockplay ($133.27 in chips) 
Seat 8: DUkalisUA ($137.50 in chips) 
tffff2006: posts small blind $0.50
CAJUN890: posts big blind $1
*** HOLE CARDS ***
Dealt to matiko09 [2h Jh]
matiko09: folds 
Pvsx.: folds 
Jimy Tiltman: folds 
Sherlockplay: folds 
DUkalisUA: raises $1.50 to $2.50
xHourglass: raises $5 to $7.50
tffff2006: folds 
CAJUN890: folds 
DUkalisUA: folds 
Uncalled bet ($5) returned to xHourglass
tffff2006 leaves the table
xHourglass collected $6.50 from pot
xHourglass: doesn't show hand 
*** SUMMARY ***
Total pot $6.50 | Rake $0 
Seat 1: xHourglass (button) collected ($6.50)
Seat 2: tffff2006 (small blind) folded before Flop
Seat 3: CAJUN890 (big blind) folded before Flop
Seat 4: matiko09 folded before Flop (didn't bet)
Seat 5: Pvsx. folded before Flop (didn't bet)
Seat 6: Jimy Tiltman folded before Flop (didn't bet)
Seat 7: Sherlockplay folded before Flop (didn't bet)
Seat 8: DUkalisUA folded before Flop





PokerStars Hand #150801508584:  Hold'em No Limit ($0.50/$1.00 USD) - 2016/03/23 14:33:32 CET [2016/03/23 9:33:32 ET]
Table 'Swings' 9-max Seat #1 is the button
Seat 1: Sherlockplay ($100 in chips) 
Seat 2: Harbinger X ($96.47 in chips) 
Seat 3: maxxmeister ($115.08 in chips) 
Seat 4: chaps1988 ($106.10 in chips) 
Seat 5: chautinhtri9 ($95 in chips) 
Seat 6: matiko09 ($100 in chips) 
Seat 7: nickreason17 ($100 in chips) 
Seat 9: Vlad_1965_77 ($107.55 in chips) 
Harbinger X: posts small blind $0.50
maxxmeister: posts big blind $1
*** HOLE CARDS ***
Dealt to matiko09 [4d 5c]
chaps1988: folds 
chautinhtri9: folds 
matiko09: folds 
nickreason17: folds 
Vlad_1965_77: folds 
Sherlockplay: folds 
Harbinger X: raises $2 to $3
maxxmeister: calls $2
*** FLOP *** [Ks 6d 4s]
Harbinger X: bets $6
maxxmeister: calls $6
*** TURN *** [Ks 6d 4s] [5h]
Harbinger X: bets $16
maxxmeister: raises $90.08 to $106.08 and is all-in
Harbinger X: calls $71.47 and is all-in
Uncalled bet ($18.61) returned to maxxmeister
*** RIVER *** [Ks 6d 4s 5h] [Qh]
*** SHOW DOWN ***
Harbinger X: shows [Td Kh] (a pair of Kings)
maxxmeister: mucks hand 
Harbinger X collected $190.14 from pot
*** SUMMARY ***
Total pot $192.94 | Rake $2.80 
Board [Ks 6d 4s 5h Qh]
Seat 1: Sherlockplay (button) folded before Flop (didn't bet)
Seat 2: Harbinger X (small blind) showed [Td Kh] and won ($190.14) with a pair of Kings
Seat 3: maxxmeister (big blind) mucked [7s As]
Seat 4: chaps1988 folded before Flop (didn't bet)
Seat 5: chautinhtri9 folded before Flop (didn't bet)
Seat 6: matiko09 folded before Flop (didn't bet)
Seat 7: nickreason17 folded before Flop (didn't bet)
Seat 9: Vlad_1965_77 folded before Flop (didn't bet)





PokerStars Hand #150801512225:  Hold'em No Limit ($1/$2 USD) - 2016/03/23 14:33:38 CET [2016/03/23 9:33:38 ET]
Table 'Kiess' 9-max Seat #3 is the button
Seat 1: Cirilico ($229.74 in chips) 
Seat 2: DUkalisUA ($655.10 in chips) 
Seat 3: The_red_area ($339.27 in chips) 
Seat 4: Moszes360 ($201 in chips) 
Seat 5: chippo boy ($452.28 in chips) 
Seat 6: matiko09 ($266.86 in chips) 
Seat 7: InsomniaRU ($306.97 in chips) 
Seat 8: erfk1958 ($120.96 in chips) 
Seat 9: T0ny Adams ($91.24 in chips) 
Moszes360: posts small blind $1
chippo boy: posts big blind $2
*** HOLE CARDS ***
Dealt to matiko09 [7d Kc]
matiko09: folds 
InsomniaRU: folds 
erfk1958: folds 
T0ny Adams: raises $3 to $5
Cirilico: folds 
DUkalisUA: folds 
The_red_area: folds 
Moszes360: folds 
chippo boy: calls $3
*** FLOP *** [Jh 8h 9d]
chippo boy: checks 
T0ny Adams: checks 
*** TURN *** [Jh 8h 9d] [Ad]
chippo boy: checks 
T0ny Adams: bets $9.30
chippo boy: folds 
Uncalled bet ($9.30) returned to T0ny Adams
T0ny Adams collected $10.50 from pot
T0ny Adams: doesn't show hand 
*** SUMMARY ***
Total pot $11 | Rake $0.50 
Board [Jh 8h 9d Ad]
Seat 1: Cirilico folded before Flop (didn't bet)
Seat 2: DUkalisUA folded before Flop (didn't bet)
Seat 3: The_red_area (button) folded before Flop (didn't bet)
Seat 4: Moszes360 (small blind) folded before Flop
Seat 5: chippo boy (big blind) folded on the Turn
Seat 6: matiko09 folded before Flop (didn't bet)
Seat 7: InsomniaRU folded before Flop (didn't bet)
Seat 8: erfk1958 folded before Flop (didn't bet)
Seat 9: T0ny Adams collected ($10.50)





PokerStars Hand #150801512262:  Hold'em No Limit ($0.50/$1.00 USD) - 2016/03/23 14:33:38 CET [2016/03/23 9:33:38 ET]
Table 'Kippes' 9-max Seat #5 is the button
Seat 1: Pvsx. ($110.66 in chips) 
Seat 3: CAJUN890 ($126.50 in chips) 
Seat 4: matiko09 ($100 in chips) 
Seat 5: Jimy Tiltman ($132.99 in chips) 
Seat 6: DUkalisUA ($117.94 in chips) 
Seat 8: Sherlockplay ($100 in chips) 
DUkalisUA: posts small blind $0.50
Sherlockplay: posts big blind $1
Szevasztopol: sits out 
*** HOLE CARDS ***
Dealt to matiko09 [9c 4h]
Pvsx.: folds 
CAJUN890 has timed out
CAJUN890: folds 
matiko09: folds 
Jimy Tiltman: folds 
DUkalisUA: raises $1.50 to $2.50
Sherlockplay: folds 
Uncalled bet ($1.50) returned to DUkalisUA
DUkalisUA collected $2 from pot
DUkalisUA: doesn't show hand 
*** SUMMARY ***
Total pot $2 | Rake $0 
Seat 1: Pvsx. folded before Flop (didn't bet)
Seat 3: CAJUN890 folded before Flop (didn't bet)
Seat 4: matiko09 folded before Flop (didn't bet)
Seat 5: Jimy Tiltman (button) folded before Flop (didn't bet)
Seat 6: DUkalisUA (small blind) collected ($2)
Seat 8: Sherlockplay (big blind) folded before Flop





PokerStars Hand #150801515638:  Hold'em No Limit ($1/$2 USD) - 2016/03/23 14:33:43 CET [2016/03/23 9:33:43 ET]
Table 'Herba II' 9-max Seat #6 is the button
Seat 1: matiko09 ($226.62 in chips) 
Seat 2: Moszes360 ($224.17 in chips) 
Seat 3: Cirilico ($181.84 in chips) 
Seat 4: DUkalisUA ($200 in chips) 
Seat 5: chippo boy ($249.35 in chips) 
Seat 6: Too-Anti-To ($209.46 in chips) 
Seat 7: InsomniaRU ($404.20 in chips) 
Seat 8: The_red_area ($439.98 in chips) 
Seat 9: mrhighryza ($53.67 in chips) 
InsomniaRU: posts small blind $1
The_red_area: posts big blind $2
*** HOLE CARDS ***
Dealt to matiko09 [2d Tc]
mrhighryza: folds 
matiko09: folds 
Moszes360: folds 
Cirilico: raises $4 to $6
DUkalisUA: folds 
chippo boy: folds 
Too-Anti-To: folds 
InsomniaRU: folds 
The_red_area: folds 
Uncalled bet ($4) returned to Cirilico
Cirilico collected $5 from pot
Cirilico: doesn't show hand 
*** SUMMARY ***
Total pot $5 | Rake $0 
Seat 1: matiko09 folded before Flop (didn't bet)
Seat 2: Moszes360 folded before Flop (didn't bet)
Seat 3: Cirilico collected ($5)
Seat 4: DUkalisUA folded before Flop (didn't bet)
Seat 5: chippo boy folded before Flop (didn't bet)
Seat 6: Too-Anti-To (button) folded before Flop (didn't bet)
Seat 7: InsomniaRU (small blind) folded before Flop
Seat 8: The_red_area (big blind) folded before Flop
Seat 9: mrhighryza folded before Flop (didn't bet)





PokerStars Hand #150801516058:  Hold'em No Limit ($1/$2 USD) - 2016/03/23 14:33:44 CET [2016/03/23 9:33:44 ET]
Table 'Ennomos II' 9-max Seat #9 is the button
Seat 1: InsomniaRU ($200 in chips) 
Seat 2: Subam ($313.38 in chips) 
Seat 3: $-Twackle-$ ($231.20 in chips) 
Seat 4: glanza_mike ($200 in chips) 
Seat 5: South011 ($394.02 in chips) 
Seat 6: nickreason17 ($259.40 in chips) 
Seat 8: yyfk ($200.24 in chips) 
Seat 9: matiko09 ($321.20 in chips) 
InsomniaRU: posts small blind $1
Subam: posts big blind $2
T0ny Adams: sits out 
*** HOLE CARDS ***
Dealt to matiko09 [2c Jh]
$-Twackle-$: folds 
glanza_mike: folds 
South011: folds 
nickreason17: raises $4 to $6
yyfk: folds 
matiko09: folds 
InsomniaRU: folds 
Subam: raises $12 to $18
nickreason17: folds 
Uncalled bet ($12) returned to Subam
Subam collected $13 from pot
Subam: doesn't show hand 
*** SUMMARY ***
Total pot $13 | Rake $0 
Seat 1: InsomniaRU (small blind) folded before Flop
Seat 2: Subam (big blind) collected ($13)
Seat 3: $-Twackle-$ folded before Flop (didn't bet)
Seat 4: glanza_mike folded before Flop (didn't bet)
Seat 5: South011 folded before Flop (didn't bet)
Seat 6: nickreason17 folded before Flop
Seat 8: yyfk folded before Flop (didn't bet)
Seat 9: matiko09 (button) folded before Flop (didn't bet)





PokerStars Hand #150801523401:  Hold'em No Limit ($0.50/$1.00 USD) - 2016/03/23 14:33:55 CET [2016/03/23 9:33:55 ET]
Table 'Merope II' 9-max Seat #8 is the button
Seat 1: Jimy Tiltman ($138.23 in chips) 
Seat 2: $-Twackle-$ ($100 in chips) 
Seat 3: pablos1922 ($89.75 in chips) 
Seat 4: YuriiSolodya ($91.84 in chips) 
Seat 5: DUkalisUA ($159.87 in chips) 
Seat 6: Effort92 ($100 in chips) 
Seat 7: matiko09 ($104.73 in chips) 
Seat 8: titentei ($94.53 in chips) 
Jimy Tiltman: posts small blind $0.50
$-Twackle-$: posts big blind $1
*** HOLE CARDS ***
Dealt to matiko09 [Qs 7c]
pablos1922 has timed out
pablos1922: folds 
YuriiSolodya: folds 
DUkalisUA: folds 
Effort92: folds 
matiko09: folds 
titentei: folds 
Jimy Tiltman: folds 
Uncalled bet ($0.50) returned to $-Twackle-$
$-Twackle-$ collected $1 from pot
$-Twackle-$: doesn't show hand 
*** SUMMARY ***
Total pot $1 | Rake $0 
Seat 1: Jimy Tiltman (small blind) folded before Flop
Seat 2: $-Twackle-$ (big blind) collected ($1)
Seat 3: pablos1922 folded before Flop (didn't bet)
Seat 4: YuriiSolodya folded before Flop (didn't bet)
Seat 5: DUkalisUA folded before Flop (didn't bet)
Seat 6: Effort92 folded before Flop (didn't bet)
Seat 7: matiko09 folded before Flop (didn't bet)
Seat 8: titentei (button) folded before Flop (didn't bet)





PokerStars Hand #150801523521:  Hold'em No Limit ($0.25/$0.50 USD) - 2016/03/23 14:33:55 CET [2016/03/23 9:33:55 ET]
Table 'Pyrrhus' 9-max Seat #3 is the button
Seat 3: i L00K great ($50 in chips) 
Seat 4: GriffinBerg ($41.51 in chips) 
Seat 5: ZonTTT ($55.11 in chips) 
Seat 6: Ahangama ($50 in chips) 
Seat 7: matiko09 ($138.38 in chips) 
Seat 8: dndngod ($71.23 in chips) 
Seat 9: CvMCvMCvM ($93.52 in chips) 
GriffinBerg: posts small blind $0.25
ZonTTT: posts big blind $0.50
BSTUSim: sits out 
*** HOLE CARDS ***
Dealt to matiko09 [Kd 6d]
Ahangama: folds 
matiko09: folds 
dndngod: folds 
CvMCvMCvM: folds 
i L00K great: raises $0.50 to $1
GriffinBerg: raises $1.50 to $2.50
ZonTTT: folds 
i L00K great: calls $1.50
*** FLOP *** [6h 8h Qc]
GriffinBerg: checks 
i L00K great: checks 
*** TURN *** [6h 8h Qc] [5s]
GriffinBerg: checks 
i L00K great: checks 
*** RIVER *** [6h 8h Qc 5s] [3h]
GriffinBerg: bets $2
i L00K great: folds 
Uncalled bet ($2) returned to GriffinBerg
GriffinBerg collected $5.25 from pot
*** SUMMARY ***
Total pot $5.50 | Rake $0.25 
Board [6h 8h Qc 5s 3h]
Seat 3: i L00K great (button) folded on the River
Seat 4: GriffinBerg (small blind) collected ($5.25)
Seat 5: ZonTTT (big blind) folded before Flop
Seat 6: Ahangama folded before Flop (didn't bet)
Seat 7: matiko09 folded before Flop (didn't bet)
Seat 8: dndngod folded before Flop (didn't bet)
Seat 9: CvMCvMCvM folded before Flop (didn't bet)





PokerStars Hand #150801524795:  Hold'em No Limit (€0.50/€1.00 EUR) - 2016/03/23 14:33:57 CET [2016/03/23 9:33:57 ET]
Table 'Lanzia' 9-max Seat #7 is the button
Seat 2: ardo888 (€101.50 in chips) 
Seat 3: Effort92 (€228.91 in chips) 
Seat 4: volwebni4ek (€40 in chips) 
Seat 5: matiko09 (€175.23 in chips) 
Seat 6: Red4erT (€40 in chips) 
Seat 7: $-Twackle-$ (€131.50 in chips) 
Seat 8: Muinmyheart (€102.50 in chips) 
Seat 9: Butcher1848 (€103.87 in chips) 
Muinmyheart: posts small blind €0.50
Butcher1848: posts big blind €1
chaps1988: sits out 
*** HOLE CARDS ***
Dealt to matiko09 [5d 4d]
ardo888: folds 
Effort92: folds 
volwebni4ek: folds 
matiko09: folds 
Red4erT: folds 
$-Twackle-$: raises €1.10 to €2.10
Muinmyheart: raises €5.90 to €8
Butcher1848: folds 
$-Twackle-$: folds 
Uncalled bet (€5.90) returned to Muinmyheart
Muinmyheart collected €5.20 from pot
Muinmyheart: doesn't show hand 
*** SUMMARY ***
Total pot €5.20 | Rake €0 
Seat 2: ardo888 folded before Flop (didn't bet)
Seat 3: Effort92 folded before Flop (didn't bet)
Seat 4: volwebni4ek folded before Flop (didn't bet)
Seat 5: matiko09 folded before Flop (didn't bet)
Seat 6: Red4erT folded before Flop (didn't bet)
Seat 7: $-Twackle-$ (button) folded before Flop
Seat 8: Muinmyheart (small blind) collected (€5.20)
Seat 9: Butcher1848 (big blind) folded before Flop





PokerStars Hand #150801528007:  Hold'em No Limit ($1/$2 USD) - 2016/03/23 14:34:02 CET [2016/03/23 9:34:02 ET]
Table 'Achaia' 9-max Seat #8 is the button
Seat 1: Moszes360 ($212 in chips) 
Seat 2: InsomniaRU ($231.44 in chips) 
Seat 3: matiko09 ($200 in chips) 
Seat 4: nailz83 ($210.79 in chips) 
Seat 5: chaps1988 ($200 in chips) 
Seat 6: nickreason17 ($200.14 in chips) 
Seat 7: morosun ($171.10 in chips) 
Seat 8: $-Twackle-$ ($225.07 in chips) 
Seat 9: glanza_mike ($200 in chips) 
glanza_mike: posts small blind $1
Moszes360: posts big blind $2
*** HOLE CARDS ***
Dealt to matiko09 [8s Tc]
InsomniaRU: folds 
matiko09: folds 
nailz83: folds 
chaps1988: folds 
nickreason17: folds 
morosun: folds 
$-Twackle-$: folds 
glanza_mike: raises $4 to $6
Moszes360: calls $4
*** FLOP *** [Qc 3d 2s]
glanza_mike: bets $3.78
Moszes360: calls $3.78
*** TURN *** [Qc 3d 2s] [7h]
glanza_mike: checks 
Moszes360: checks 
*** RIVER *** [Qc 3d 2s 7h] [9h]
glanza_mike: checks 
Moszes360: checks 
*** SHOW DOWN ***
glanza_mike: shows [3h Ah] (a pair of Threes)
Moszes360: shows [8d 8c] (a pair of Eights)
Moszes360 collected $18.68 from pot
*** SUMMARY ***
Total pot $19.56 | Rake $0.88 
Board [Qc 3d 2s 7h 9h]
Seat 1: Moszes360 (big blind) showed [8d 8c] and won ($18.68) with a pair of Eights
Seat 2: InsomniaRU folded before Flop (didn't bet)
Seat 3: matiko09 folded before Flop (didn't bet)
Seat 4: nailz83 folded before Flop (didn't bet)
Seat 5: chaps1988 folded before Flop (didn't bet)
Seat 6: nickreason17 folded before Flop (didn't bet)
Seat 7: morosun folded before Flop (didn't bet)
Seat 8: $-Twackle-$ (button) folded before Flop (didn't bet)
Seat 9: glanza_mike (small blind) showed [3h Ah] and lost with a pair of Threes





PokerStars Hand #150801531280:  Hold'em No Limit ($1/$2 USD) - 2016/03/23 14:34:08 CET [2016/03/23 9:34:08 ET]
Table 'Herba II' 9-max Seat #7 is the button
Seat 1: matiko09 ($226.62 in chips) 
Seat 2: Moszes360 ($224.17 in chips) 
Seat 3: Cirilico ($184.84 in chips) 
Seat 4: DUkalisUA ($200 in chips) 
Seat 5: chippo boy ($249.35 in chips) 
Seat 6: Too-Anti-To ($209.46 in chips) 
Seat 7: InsomniaRU ($403.20 in chips) 
Seat 8: The_red_area ($437.98 in chips) 
Seat 9: mrhighryza ($53.67 in chips) 
The_red_area: posts small blind $1
mrhighryza: posts big blind $2
*** HOLE CARDS ***
Dealt to matiko09 [Kd 6h]
matiko09: folds 
Moszes360: folds 
Cirilico: folds 
DUkalisUA: folds 
chippo boy: calls $2
Too-Anti-To: folds 
InsomniaRU: folds 
The_red_area: folds 
mrhighryza: checks 
*** FLOP *** [9h Ks Ac]
mrhighryza: checks 
chippo boy: bets $4
mrhighryza: folds 
Uncalled bet ($4) returned to chippo boy
chippo boy collected $4.78 from pot
*** SUMMARY ***
Total pot $5 | Rake $0.22 
Board [9h Ks Ac]
Seat 1: matiko09 folded before Flop (didn't bet)
Seat 2: Moszes360 folded before Flop (didn't bet)
Seat 3: Cirilico folded before Flop (didn't bet)
Seat 4: DUkalisUA folded before Flop (didn't bet)
Seat 5: chippo boy collected ($4.78)
Seat 6: Too-Anti-To folded before Flop (didn't bet)
Seat 7: InsomniaRU (button) folded before Flop (didn't bet)
Seat 8: The_red_area (small blind) folded before Flop
Seat 9: mrhighryza (big blind) folded on the Flop





PokerStars Hand #150801531808:  Hold'em No Limit ($1/$2 USD) - 2016/03/23 14:34:09 CET [2016/03/23 9:34:09 ET]
Table 'Kypria II' 9-max Seat #2 is the button
Seat 1: geldwolfje ($167.26 in chips) 
Seat 2: coinflip_si ($205.70 in chips) 
Seat 3: seouljam ($177.56 in chips) 
Seat 4: VolanDog ($217.70 in chips) 
Seat 5: InsomniaRU ($374.88 in chips) 
Seat 6: matiko09 ($371.95 in chips) 
Seat 7: DUkalisUA ($205 in chips) 
Seat 8: Pearl Jam87 ($200 in chips) 
Seat 9: Moszes360 ($200 in chips) 
seouljam: posts small blind $1
VolanDog: posts big blind $2
*** HOLE CARDS ***
Dealt to matiko09 [4c 2s]
InsomniaRU: raises $3 to $5
matiko09: folds 
DUkalisUA: folds 
Pearl Jam87: folds 
Moszes360: folds 
geldwolfje: folds 
coinflip_si: folds 
seouljam: folds 
VolanDog: folds 
Uncalled bet ($3) returned to InsomniaRU
InsomniaRU collected $5 from pot
InsomniaRU: doesn't show hand 
*** SUMMARY ***
Total pot $5 | Rake $0 
Seat 1: geldwolfje folded before Flop (didn't bet)
Seat 2: coinflip_si (button) folded before Flop (didn't bet)
Seat 3: seouljam (small blind) folded before Flop
Seat 4: VolanDog (big blind) folded before Flop
Seat 5: InsomniaRU collected ($5)
Seat 6: matiko09 folded before Flop (didn't bet)
Seat 7: DUkalisUA folded before Flop (didn't bet)
Seat 8: Pearl Jam87 folded before Flop (didn't bet)
Seat 9: Moszes360 folded before Flop (didn't bet)





PokerStars Hand #150801533202:  Hold'em No Limit ($1/$2 USD) - 2016/03/23 14:34:11 CET [2016/03/23 9:34:11 ET]
Table 'Ennomos II' 9-max Seat #1 is the button
Seat 1: InsomniaRU ($200 in chips) 
Seat 2: Subam ($320.38 in chips) 
Seat 3: $-Twackle-$ ($231.20 in chips) 
Seat 4: glanza_mike ($200 in chips) 
Seat 5: South011 ($394.02 in chips) 
Seat 6: nickreason17 ($253.40 in chips) 
Seat 8: yyfk ($200.24 in chips) 
Seat 9: matiko09 ($321.20 in chips) 
Subam: posts small blind $1
$-Twackle-$: posts big blind $2
T0ny Adams: sits out 
*** HOLE CARDS ***
Dealt to matiko09 [Qs 7h]
glanza_mike: folds 
South011: folds 
nickreason17: raises $4 to $6
yyfk: folds 
matiko09: folds 
InsomniaRU: folds 
Subam: calls $5
$-Twackle-$: folds 
*** FLOP *** [Ah Td 9s]
Subam: checks 
nickreason17: bets $8
Subam: raises $12 to $20
nickreason17: calls $12
*** TURN *** [Ah Td 9s] [Jc]
Subam: bets $20
nickreason17: calls $20
*** RIVER *** [Ah Td 9s Jc] [4c]
Subam: bets $20
nickreason17: raises $46 to $66
Subam: calls $46
*** SHOW DOWN ***
nickreason17: shows [Jh Ac] (two pair, Aces and Jacks)
Subam: mucks hand 
nickreason17 collected $223.20 from pot
*** SUMMARY ***
Total pot $226 | Rake $2.80 
Board [Ah Td 9s Jc 4c]
Seat 1: InsomniaRU (button) folded before Flop (didn't bet)
Seat 2: Subam (small blind) mucked [Qh As]
Seat 3: $-Twackle-$ (big blind) folded before Flop
Seat 4: glanza_mike folded before Flop (didn't bet)
Seat 5: South011 folded before Flop (didn't bet)
Seat 6: nickreason17 showed [Jh Ac] and won ($223.20) with two pair, Aces and Jacks
Seat 8: yyfk folded before Flop (didn't bet)
Seat 9: matiko09 folded before Flop (didn't bet)





PokerStars Hand #150801534006:  Hold'em No Limit ($0.50/$1.00 USD) - 2016/03/23 14:34:12 CET [2016/03/23 9:34:12 ET]
Table 'Kippes' 9-max Seat #6 is the button
Seat 1: Pvsx. ($110.66 in chips) 
Seat 4: matiko09 ($100 in chips) 
Seat 5: Jimy Tiltman ($132.99 in chips) 
Seat 6: DUkalisUA ($118.94 in chips) 
Seat 8: Sherlockplay ($100 in chips) 
Seat 9: Szevasztopol ($100 in chips) 
Sherlockplay: posts small blind $0.50
Szevasztopol: posts big blind $1
RICKA16: sits out 
*** HOLE CARDS ***
Dealt to matiko09 [Jd 6c]
Pvsx.: raises $1.50 to $2.50
matiko09: folds 
Jimy Tiltman: folds 
DUkalisUA: folds 
Sherlockplay: folds 
Szevasztopol: folds 
Uncalled bet ($1.50) returned to Pvsx.
Pvsx. collected $2.50 from pot
Pvsx.: doesn't show hand 
*** SUMMARY ***
Total pot $2.50 | Rake $0 
Seat 1: Pvsx. collected ($2.50)
Seat 4: matiko09 folded before Flop (didn't bet)
Seat 5: Jimy Tiltman folded before Flop (didn't bet)
Seat 6: DUkalisUA (button) folded before Flop (didn't bet)
Seat 8: Sherlockplay (small blind) folded before Flop
Seat 9: Szevasztopol (big blind) folded before Flop





PokerStars Hand #150801539433:  Hold'em No Limit ($0.50/$1.00 USD) - 2016/03/23 14:34:21 CET [2016/03/23 9:34:21 ET]
Table 'Atlantis' 9-max Seat #3 is the button
Seat 1: xHourglass ($155.50 in chips) 
Seat 3: CAJUN890 ($134.46 in chips) 
Seat 4: matiko09 ($126.25 in chips) 
Seat 5: Pvsx. ($100.25 in chips) 
Seat 6: Jimy Tiltman ($104 in chips) 
Seat 7: Sherlockplay ($133.27 in chips) 
Seat 8: DUkalisUA ($135 in chips) 
matiko09: posts small blind $0.50
Pvsx.: posts big blind $1
RICKA16: sits out 
*** HOLE CARDS ***
Dealt to matiko09 [6c 8h]
Szevasztopol joins the table at seat #2 
Jimy Tiltman: folds 
Sherlockplay: folds 
DUkalisUA: folds 
xHourglass: raises $2 to $3
CAJUN890: raises $2 to $5
matiko09: folds 
Pvsx.: folds 
xHourglass: calls $2
*** FLOP *** [Th Ts 2s]
xHourglass: checks 
CAJUN890: bets $5.49
xHourglass: folds 
Uncalled bet ($5.49) returned to CAJUN890
CAJUN890 collected $10.98 from pot
CAJUN890: doesn't show hand 
*** SUMMARY ***
Total pot $11.50 | Rake $0.52 
Board [Th Ts 2s]
Seat 1: xHourglass folded on the Flop
Seat 3: CAJUN890 (button) collected ($10.98)
Seat 4: matiko09 (small blind) folded before Flop
Seat 5: Pvsx. (big blind) folded before Flop
Seat 6: Jimy Tiltman folded before Flop (didn't bet)
Seat 7: Sherlockplay folded before Flop (didn't bet)
Seat 8: DUkalisUA folded before Flop (didn't bet)





PokerStars Hand #150801542660:  Hold'em No Limit ($0.50/$1.00 USD) - 2016/03/23 14:34:26 CET [2016/03/23 9:34:26 ET]
Table 'Merope II' 9-max Seat #1 is the button
Seat 1: Jimy Tiltman ($137.73 in chips) 
Seat 2: $-Twackle-$ ($100.50 in chips) 
Seat 3: pablos1922 ($89.75 in chips) 
Seat 4: YuriiSolodya ($91.84 in chips) 
Seat 5: DUkalisUA ($159.87 in chips) 
Seat 6: Effort92 ($100 in chips) 
Seat 7: matiko09 ($104.73 in chips) 
Seat 8: titentei ($94.53 in chips) 
$-Twackle-$: posts small blind $0.50
pablos1922: posts big blind $1
RICKA16: sits out 
*** HOLE CARDS ***
Dealt to matiko09 [Th 8c]
YuriiSolodya: folds 
DUkalisUA: folds 
Effort92: folds 
matiko09: folds 
titentei: folds 
Jimy Tiltman: folds 
$-Twackle-$: raises $2 to $3
pablos1922: folds 
Uncalled bet ($2) returned to $-Twackle-$
$-Twackle-$ collected $2 from pot
$-Twackle-$: doesn't show hand 
*** SUMMARY ***
Total pot $2 | Rake $0 
Seat 1: Jimy Tiltman (button) folded before Flop (didn't bet)
Seat 2: $-Twackle-$ (small blind) collected ($2)
Seat 3: pablos1922 (big blind) folded before Flop
Seat 4: YuriiSolodya folded before Flop (didn't bet)
Seat 5: DUkalisUA folded before Flop (didn't bet)
Seat 6: Effort92 folded before Flop (didn't bet)
Seat 7: matiko09 folded before Flop (didn't bet)
Seat 8: titentei folded before Flop (didn't bet)





PokerStars Hand #150801544976:  Hold'em No Limit ($1/$2 USD) - 2016/03/23 14:34:29 CET [2016/03/23 9:34:29 ET]
Table 'Kypria II' 9-max Seat #3 is the button
Seat 1: geldwolfje ($167.26 in chips) 
Seat 2: coinflip_si ($205.70 in chips) 
Seat 3: seouljam ($176.56 in chips) 
Seat 4: VolanDog ($215.70 in chips) 
Seat 5: InsomniaRU ($377.88 in chips) 
Seat 6: matiko09 ($371.95 in chips) 
Seat 7: DUkalisUA ($205 in chips) 
Seat 8: Pearl Jam87 ($200 in chips) 
Seat 9: Moszes360 ($200 in chips) 
VolanDog: posts small blind $1
InsomniaRU: posts big blind $2
*** HOLE CARDS ***
Dealt to matiko09 [8h 3s]
matiko09: folds 
DUkalisUA: folds 
Pearl Jam87: folds 
Moszes360: folds 
geldwolfje: folds 
coinflip_si: folds 
seouljam: folds 
VolanDog: raises $4 to $6
InsomniaRU: folds 
Uncalled bet ($4) returned to VolanDog
VolanDog collected $4 from pot
*** SUMMARY ***
Total pot $4 | Rake $0 
Seat 1: geldwolfje folded before Flop (didn't bet)
Seat 2: coinflip_si folded before Flop (didn't bet)
Seat 3: seouljam (button) folded before Flop (didn't bet)
Seat 4: VolanDog (small blind) collected ($4)
Seat 5: InsomniaRU (big blind) folded before Flop
Seat 6: matiko09 folded before Flop (didn't bet)
Seat 7: DUkalisUA folded before Flop (didn't bet)
Seat 8: Pearl Jam87 folded before Flop (didn't bet)
Seat 9: Moszes360 folded before Flop (didn't bet)





PokerStars Hand #150801545973:  Hold'em No Limit ($0.50/$1.00 USD) - 2016/03/23 14:34:31 CET [2016/03/23 9:34:31 ET]
Table 'Swings' 9-max Seat #2 is the button
Seat 1: Sherlockplay ($100 in chips) 
Seat 2: Harbinger X ($190.14 in chips) 
Seat 3: maxxmeister ($100 in chips) 
Seat 4: chaps1988 ($106.10 in chips) 
Seat 5: chautinhtri9 ($95 in chips) 
Seat 6: matiko09 ($100 in chips) 
Seat 7: nickreason17 ($100 in chips) 
Seat 9: Vlad_1965_77 ($107.55 in chips) 
maxxmeister: posts small blind $0.50
chaps1988: posts big blind $1
RICKA16: sits out 
*** HOLE CARDS ***
Dealt to matiko09 [As Qs]
chautinhtri9: folds 
Harbinger X said, "ty"
matiko09: raises $2 to $3
nickreason17: folds 
Vlad_1965_77: folds 
Sherlockplay: folds 
Harbinger X: calls $3
maxxmeister: folds 
chaps1988: calls $2
*** FLOP *** [2s 8d Ad]
chaps1988: checks 
matiko09: bets $5.90
Harbinger X: folds 
chaps1988: folds 
Uncalled bet ($5.90) returned to matiko09
matiko09 collected $9.07 from pot
matiko09: doesn't show hand 
*** SUMMARY ***
Total pot $9.50 | Rake $0.43 
Board [2s 8d Ad]
Seat 1: Sherlockplay folded before Flop (didn't bet)
Seat 2: Harbinger X (button) folded on the Flop
Seat 3: maxxmeister (small blind) folded before Flop
Seat 4: chaps1988 (big blind) folded on the Flop
Seat 5: chautinhtri9 folded before Flop (didn't bet)
Seat 6: matiko09 collected ($9.07)
Seat 7: nickreason17 folded before Flop (didn't bet)
Seat 9: Vlad_1965_77 folded before Flop (didn't bet)





PokerStars Hand #150801547810:  Hold'em No Limit ($0.50/$1.00 USD) - 2016/03/23 14:34:34 CET [2016/03/23 9:34:34 ET]
Table 'Kippes' 9-max Seat #8 is the button
Seat 1: Pvsx. ($112.16 in chips) 
Seat 3: CAJUN890 ($126.50 in chips) 
Seat 4: matiko09 ($100 in chips) 
Seat 5: Jimy Tiltman ($132.99 in chips) 
Seat 6: DUkalisUA ($118.94 in chips) 
Seat 8: Sherlockplay ($100 in chips) 
Seat 9: Szevasztopol ($100 in chips) 
Szevasztopol: posts small blind $0.50
Pvsx.: posts big blind $1
RICKA16: sits out 
*** HOLE CARDS ***
Dealt to matiko09 [2s Ad]
CAJUN890: folds 
matiko09: folds 
Jimy Tiltman: raises $2 to $3
DUkalisUA: folds 
Sherlockplay: folds 
Szevasztopol: folds 
Pvsx.: folds 
Uncalled bet ($2) returned to Jimy Tiltman
Jimy Tiltman collected $2.50 from pot
Jimy Tiltman: doesn't show hand 
*** SUMMARY ***
Total pot $2.50 | Rake $0 
Seat 1: Pvsx. (big blind) folded before Flop
Seat 3: CAJUN890 folded before Flop (didn't bet)
Seat 4: matiko09 folded before Flop (didn't bet)
Seat 5: Jimy Tiltman collected ($2.50)
Seat 6: DUkalisUA folded before Flop (didn't bet)
Seat 8: Sherlockplay (button) folded before Flop (didn't bet)
Seat 9: Szevasztopol (small blind) folded before Flop





PokerStars Hand #150801552495:  Hold'em No Limit ($1/$2 USD) - 2016/03/23 14:34:41 CET [2016/03/23 9:34:41 ET]
Table 'Herba II' 9-max Seat #8 is the button
Seat 1: matiko09 ($226.62 in chips) 
Seat 2: Moszes360 ($224.17 in chips) 
Seat 3: Cirilico ($184.84 in chips) 
Seat 4: DUkalisUA ($200 in chips) 
Seat 5: chippo boy ($252.13 in chips) 
Seat 6: Too-Anti-To ($209.46 in chips) 
Seat 7: InsomniaRU ($403.20 in chips) 
Seat 8: The_red_area ($436.98 in chips) 
Seat 9: mrhighryza ($51.67 in chips) 
mrhighryza: posts small blind $1
matiko09: posts big blind $2
*** HOLE CARDS ***
Dealt to matiko09 [3d 4d]
Moszes360: folds 
Cirilico: raises $4 to $6
DUkalisUA: folds 
chippo boy: folds 
Too-Anti-To: folds 
InsomniaRU: folds 
The_red_area: folds 
mrhighryza: folds 
matiko09: folds 
Uncalled bet ($4) returned to Cirilico
Cirilico collected $5 from pot
Cirilico: doesn't show hand 
*** SUMMARY ***
Total pot $5 | Rake $0 
Seat 1: matiko09 (big blind) folded before Flop
Seat 2: Moszes360 folded before Flop (didn't bet)
Seat 3: Cirilico collected ($5)
Seat 4: DUkalisUA folded before Flop (didn't bet)
Seat 5: chippo boy folded before Flop (didn't bet)
Seat 6: Too-Anti-To folded before Flop (didn't bet)
Seat 7: InsomniaRU folded before Flop (didn't bet)
Seat 8: The_red_area (button) folded before Flop (didn't bet)
Seat 9: mrhighryza (small blind) folded before Flop





PokerStars Hand #150801552908:  Hold'em No Limit (€0.50/€1.00 EUR) - 2016/03/23 14:34:42 CET [2016/03/23 9:34:42 ET]
Table 'Lanzia' 9-max Seat #8 is the button
Seat 1: chaps1988 (€100 in chips) 
Seat 2: ardo888 (€101.50 in chips) 
Seat 3: Effort92 (€228.91 in chips) 
Seat 4: volwebni4ek (€40 in chips) 
Seat 5: matiko09 (€175.23 in chips) 
Seat 6: Red4erT (€40 in chips) 
Seat 7: $-Twackle-$ (€129.40 in chips) 
Seat 8: Muinmyheart (€105.60 in chips) 
Seat 9: Butcher1848 (€102.87 in chips) 
Butcher1848: posts small blind €0.50
chaps1988: posts big blind €1
*** HOLE CARDS ***
Dealt to matiko09 [7d 2c]
ardo888: folds 
Effort92: folds 
ardo888 leaves the table
volwebni4ek: folds 
matiko09: folds 
Red4erT: folds 
$-Twackle-$: raises €1.50 to €2.50
Muinmyheart: folds 
Butcher1848: folds 
chaps1988: folds 
Uncalled bet (€1.50) returned to $-Twackle-$
$-Twackle-$ collected €2.50 from pot
$-Twackle-$: doesn't show hand 
*** SUMMARY ***
Total pot €2.50 | Rake €0 
Seat 1: chaps1988 (big blind) folded before Flop
Seat 2: ardo888 folded before Flop (didn't bet)
Seat 3: Effort92 folded before Flop (didn't bet)
Seat 4: volwebni4ek folded before Flop (didn't bet)
Seat 5: matiko09 folded before Flop (didn't bet)
Seat 6: Red4erT folded before Flop (didn't bet)
Seat 7: $-Twackle-$ collected (€2.50)
Seat 8: Muinmyheart (button) folded before Flop (didn't bet)
Seat 9: Butcher1848 (small blind) folded before Flop





PokerStars Hand #150801554408:  Hold'em No Limit ($1/$2 USD) - 2016/03/23 14:34:44 CET [2016/03/23 9:34:44 ET]
Table 'Kiess' 9-max Seat #4 is the button
Seat 1: Cirilico ($229.74 in chips) 
Seat 2: DUkalisUA ($655.10 in chips) 
Seat 3: The_red_area ($339.27 in chips) 
Seat 4: Moszes360 ($200 in chips) 
Seat 5: chippo boy ($447.28 in chips) 
Seat 6: matiko09 ($266.86 in chips) 
Seat 7: InsomniaRU ($306.97 in chips) 
Seat 8: erfk1958 ($120.96 in chips) 
Seat 9: T0ny Adams ($96.74 in chips) 
chippo boy: posts small blind $1
matiko09: posts big blind $2
*** HOLE CARDS ***
Dealt to matiko09 [Qh 8c]
InsomniaRU: folds 
erfk1958: folds 
T0ny Adams: folds 
Cirilico: raises $4 to $6
DUkalisUA: folds 
The_red_area: calls $6
Moszes360: folds 
chippo boy: calls $5
matiko09: folds 
*** FLOP *** [2s Ac 2c]
chippo boy: checks 
Cirilico: checks 
The_red_area: checks 
*** TURN *** [2s Ac 2c] [Ks]
chippo boy: checks 
Cirilico: bets $12
The_red_area: calls $12
chippo boy: calls $12
*** RIVER *** [2s Ac 2c Ks] [8s]
chippo boy: checks 
Cirilico: bets $38
The_red_area: folds 
chippo boy: folds 
Uncalled bet ($38) returned to Cirilico
Cirilico collected $53.48 from pot
Cirilico: doesn't show hand 
*** SUMMARY ***
Total pot $56 | Rake $2.52 
Board [2s Ac 2c Ks 8s]
Seat 1: Cirilico collected ($53.48)
Seat 2: DUkalisUA folded before Flop (didn't bet)
Seat 3: The_red_area folded on the River
Seat 4: Moszes360 (button) folded before Flop (didn't bet)
Seat 5: chippo boy (small blind) folded on the River
Seat 6: matiko09 (big blind) folded before Flop
Seat 7: InsomniaRU folded before Flop (didn't bet)
Seat 8: erfk1958 folded before Flop (didn't bet)
Seat 9: T0ny Adams folded before Flop (didn't bet)





PokerStars Hand #150801555367:  Hold'em No Limit ($0.25/$0.50 USD) - 2016/03/23 14:34:46 CET [2016/03/23 9:34:46 ET]
Table 'Pyrrhus' 9-max Seat #4 is the button
Seat 3: i L00K great ($50 in chips) 
Seat 4: GriffinBerg ($44.26 in chips) 
Seat 5: ZonTTT ($54.61 in chips) 
Seat 6: Ahangama ($50 in chips) 
Seat 7: matiko09 ($138.38 in chips) 
Seat 8: dndngod ($71.23 in chips) 
Seat 9: CvMCvMCvM ($93.52 in chips) 
ZonTTT: posts small blind $0.25
Ahangama: posts big blind $0.50
BSTUSim: sits out 
*** HOLE CARDS ***
Dealt to matiko09 [Js 9h]
matiko09: folds 
dndngod: folds 
CvMCvMCvM: folds 
i L00K great: folds 
GriffinBerg: calls $0.50
ZonTTT: folds 
Ahangama: checks 
*** FLOP *** [Qs 5s Jh]
Ahangama: checks 
GriffinBerg: checks 
*** TURN *** [Qs 5s Jh] [Kc]
Ahangama: checks 
GriffinBerg: checks 
*** RIVER *** [Qs 5s Jh Kc] [7d]
Ahangama: checks 
GriffinBerg: bets $1.19
Ahangama: folds 
Uncalled bet ($1.19) returned to GriffinBerg
GriffinBerg collected $1.19 from pot
*** SUMMARY ***
Total pot $1.25 | Rake $0.06 
Board [Qs 5s Jh Kc 7d]
Seat 3: i L00K great folded before Flop (didn't bet)
Seat 4: GriffinBerg (button) collected ($1.19)
Seat 5: ZonTTT (small blind) folded before Flop
Seat 6: Ahangama (big blind) folded on the River
Seat 7: matiko09 folded before Flop (didn't bet)
Seat 8: dndngod folded before Flop (didn't bet)
Seat 9: CvMCvMCvM folded before Flop (didn't bet)





PokerStars Hand #150801564187:  Hold'em No Limit ($1/$2 USD) - 2016/03/23 14:35:00 CET [2016/03/23 9:35:00 ET]
Table 'Kypria II' 9-max Seat #4 is the button
Seat 1: geldwolfje ($167.26 in chips) 
Seat 3: seouljam ($176.56 in chips) 
Seat 4: VolanDog ($217.70 in chips) 
Seat 5: InsomniaRU ($375.88 in chips) 
Seat 6: matiko09 ($371.95 in chips) 
Seat 7: DUkalisUA ($205 in chips) 
Seat 8: Pearl Jam87 ($200 in chips) 
Seat 9: Moszes360 ($200 in chips) 
InsomniaRU: posts small blind $1
matiko09: posts big blind $2
*** HOLE CARDS ***
Dealt to matiko09 [2c 3h]
DUkalisUA: folds 
Pearl Jam87: folds 
Moszes360: raises $4 to $6
geldwolfje: folds 
seouljam: folds 
VolanDog: folds 
InsomniaRU: folds 
matiko09: folds 
Uncalled bet ($4) returned to Moszes360
Moszes360 collected $5 from pot
Moszes360: doesn't show hand 
*** SUMMARY ***
Total pot $5 | Rake $0 
Seat 1: geldwolfje folded before Flop (didn't bet)
Seat 3: seouljam folded before Flop (didn't bet)
Seat 4: VolanDog (button) folded before Flop (didn't bet)
Seat 5: InsomniaRU (small blind) folded before Flop
Seat 6: matiko09 (big blind) folded before Flop
Seat 7: DUkalisUA folded before Flop (didn't bet)
Seat 8: Pearl Jam87 folded before Flop (didn't bet)
Seat 9: Moszes360 collected ($5)





PokerStars Hand #150801565345:  Hold'em No Limit ($1/$2 USD) - 2016/03/23 14:35:01 CET [2016/03/23 9:35:01 ET]
Table 'Achaia' 9-max Seat #9 is the button
Seat 1: Moszes360 ($220.90 in chips) 
Seat 2: InsomniaRU ($231.44 in chips) 
Seat 3: matiko09 ($200 in chips) 
Seat 4: nailz83 ($210.79 in chips) 
Seat 5: chaps1988 ($200 in chips) 
Seat 6: nickreason17 ($200.14 in chips) 
Seat 7: morosun ($171.10 in chips) 
Seat 8: $-Twackle-$ ($225.07 in chips) 
Seat 9: glanza_mike ($200 in chips) 
Moszes360: posts small blind $1
InsomniaRU: posts big blind $2
*** HOLE CARDS ***
Dealt to matiko09 [Js Kh]
matiko09: folds 
nailz83: folds 
chaps1988: folds 
nickreason17: folds 
morosun: folds 
$-Twackle-$: folds 
glanza_mike: folds 
Moszes360: raises $4 to $6
InsomniaRU: calls $4
*** FLOP *** [8s Ah 3c]
Moszes360: bets $7.56
InsomniaRU: folds 
Uncalled bet ($7.56) returned to Moszes360
Moszes360 collected $11.46 from pot
Moszes360: doesn't show hand 
*** SUMMARY ***
Total pot $12 | Rake $0.54 
Board [8s Ah 3c]
Seat 1: Moszes360 (small blind) collected ($11.46)
Seat 2: InsomniaRU (big blind) folded on the Flop
Seat 3: matiko09 folded before Flop (didn't bet)
Seat 4: nailz83 folded before Flop (didn't bet)
Seat 5: chaps1988 folded before Flop (didn't bet)
Seat 6: nickreason17 folded before Flop (didn't bet)
Seat 7: morosun folded before Flop (didn't bet)
Seat 8: $-Twackle-$ folded before Flop (didn't bet)
Seat 9: glanza_mike (button) folded before Flop (didn't bet)





PokerStars Hand #150801570485:  Hold'em No Limit ($0.50/$1.00 USD) - 2016/03/23 14:35:10 CET [2016/03/23 9:35:10 ET]
Table 'Swings' 9-max Seat #3 is the button
Seat 1: Sherlockplay ($100 in chips) 
Seat 2: Harbinger X ($187.14 in chips) 
Seat 3: maxxmeister ($100 in chips) 
Seat 4: chaps1988 ($103.10 in chips) 
Seat 5: chautinhtri9 ($95 in chips) 
Seat 6: matiko09 ($106.07 in chips) 
Seat 7: nickreason17 ($100 in chips) 
Seat 9: Vlad_1965_77 ($107.55 in chips) 
chaps1988: posts small blind $0.50
chautinhtri9: posts big blind $1
RICKA16: sits out 
*** HOLE CARDS ***
Dealt to matiko09 [8h 2d]
matiko09: folds 
nickreason17: folds 
Vlad_1965_77: folds 
Sherlockplay: folds 
Harbinger X: folds 
maxxmeister: raises $2 to $3
chaps1988: folds 
chautinhtri9: calls $2
*** FLOP *** [6d 3d 3h]
chautinhtri9: checks 
maxxmeister: bets $4
chautinhtri9: calls $4
*** TURN *** [6d 3d 3h] [Kc]
chautinhtri9: checks 
maxxmeister: bets $9
chautinhtri9: calls $9
*** RIVER *** [6d 3d 3h Kc] [3c]
chautinhtri9: checks 
maxxmeister: bets $82
chautinhtri9: folds 
Uncalled bet ($82) returned to maxxmeister
maxxmeister collected $31.04 from pot
maxxmeister: doesn't show hand 
*** SUMMARY ***
Total pot $32.50 | Rake $1.46 
Board [6d 3d 3h Kc 3c]
Seat 1: Sherlockplay folded before Flop (didn't bet)
Seat 2: Harbinger X folded before Flop (didn't bet)
Seat 3: maxxmeister (button) collected ($31.04)
Seat 4: chaps1988 (small blind) folded before Flop
Seat 5: chautinhtri9 (big blind) folded on the River
Seat 6: matiko09 folded before Flop (didn't bet)
Seat 7: nickreason17 folded before Flop (didn't bet)
Seat 9: Vlad_1965_77 folded before Flop (didn't bet)





PokerStars Hand #150801570790:  Hold'em No Limit ($0.50/$1.00 USD) - 2016/03/23 14:35:10 CET [2016/03/23 9:35:10 ET]
Table 'Merope II' 9-max Seat #2 is the button
Seat 1: Jimy Tiltman ($137.73 in chips) 
Seat 2: $-Twackle-$ ($101.50 in chips) 
Seat 3: pablos1922 ($88.75 in chips) 
Seat 4: YuriiSolodya ($91.84 in chips) 
Seat 5: DUkalisUA ($159.87 in chips) 
Seat 6: Effort92 ($100 in chips) 
Seat 7: matiko09 ($104.73 in chips) 
Seat 8: titentei ($94.53 in chips) 
pablos1922: posts small blind $0.50
YuriiSolodya: posts big blind $1
RICKA16: sits out 
*** HOLE CARDS ***
Dealt to matiko09 [3s 8s]
DUkalisUA: folds 
Effort92: raises $1.50 to $2.50
matiko09: folds 
titentei: calls $2.50
Jimy Tiltman: folds 
$-Twackle-$: folds 
pablos1922: folds 
YuriiSolodya: folds 
*** FLOP *** [Td 7d Ad]
Effort92: bets $4
titentei: folds 
Uncalled bet ($4) returned to Effort92
Effort92 collected $6.21 from pot
Effort92: doesn't show hand 
*** SUMMARY ***
Total pot $6.50 | Rake $0.29 
Board [Td 7d Ad]
Seat 1: Jimy Tiltman folded before Flop (didn't bet)
Seat 2: $-Twackle-$ (button) folded before Flop (didn't bet)
Seat 3: pablos1922 (small blind) folded before Flop
Seat 4: YuriiSolodya (big blind) folded before Flop
Seat 5: DUkalisUA folded before Flop (didn't bet)
Seat 6: Effort92 collected ($6.21)
Seat 7: matiko09 folded before Flop (didn't bet)
Seat 8: titentei folded on the Flop





PokerStars Hand #150801571256:  Hold'em No Limit ($0.50/$1.00 USD) - 2016/03/23 14:35:11 CET [2016/03/23 9:35:11 ET]
Table 'Kippes' 9-max Seat #9 is the button
Seat 1: Pvsx. ($111.16 in chips) 
Seat 2: RICKA16 ($189.45 in chips) 
Seat 3: CAJUN890 ($126.50 in chips) 
Seat 4: matiko09 ($100 in chips) 
Seat 5: Jimy Tiltman ($134.49 in chips) 
Seat 6: DUkalisUA ($118.94 in chips) 
Seat 8: Sherlockplay ($100 in chips) 
Seat 9: Szevasztopol ($100 in chips) 
Pvsx.: posts small blind $0.50
RICKA16: posts big blind $1
*** HOLE CARDS ***
Dealt to matiko09 [2h 7s]
CAJUN890: folds 
matiko09: folds 
Jimy Tiltman: folds 
DUkalisUA: folds 
Sherlockplay: raises $1.50 to $2.50
Szevasztopol: folds 
Pvsx.: calls $2
RICKA16: folds 
*** FLOP *** [9h 2d Qc]
Pvsx.: checks 
Sherlockplay: bets $2.86
Pvsx.: folds 
Uncalled bet ($2.86) returned to Sherlockplay
Sherlockplay collected $5.73 from pot
Sherlockplay: doesn't show hand 
*** SUMMARY ***
Total pot $6 | Rake $0.27 
Board [9h 2d Qc]
Seat 1: Pvsx. (small blind) folded on the Flop
Seat 2: RICKA16 (big blind) folded before Flop
Seat 3: CAJUN890 folded before Flop (didn't bet)
Seat 4: matiko09 folded before Flop (didn't bet)
Seat 5: Jimy Tiltman folded before Flop (didn't bet)
Seat 6: DUkalisUA folded before Flop (didn't bet)
Seat 8: Sherlockplay collected ($5.73)
Seat 9: Szevasztopol (button) folded before Flop (didn't bet)





PokerStars Hand #150801574375:  Hold'em No Limit ($0.50/$1.00 USD) - 2016/03/23 14:35:16 CET [2016/03/23 9:35:16 ET]
Table 'Donar II' 9-max Seat #1 is the button
Seat 1: Effort92 ($102.89 in chips) 
Seat 2: nobrunobru1 ($50.64 in chips) 
Seat 3: st-germ30 ($99.09 in chips) 
Seat 4: DUkalisUA ($163.54 in chips) 
Seat 5: matiko09 ($103.67 in chips) 
Seat 6: ardo888 ($132.58 in chips) 
Seat 7: JimineyCrik ($102.98 in chips) 
Seat 8: $-Twackle-$ ($127 in chips) 
Seat 9: oxfordtenzin ($88.50 in chips) 
nobrunobru1: posts small blind $0.50
st-germ30: posts big blind $1
Effort92: posts the ante $0.20
nobrunobru1: posts the ante $0.20
st-germ30: posts the ante $0.20
DUkalisUA: posts the ante $0.20
matiko09: posts the ante $0.20
ardo888: posts the ante $0.20
JimineyCrik: posts the ante $0.20
$-Twackle-$: posts the ante $0.20
oxfordtenzin: posts the ante $0.20
*** HOLE CARDS ***
Dealt to matiko09 [Td Tc]
DUkalisUA: folds 
matiko09: raises $2 to $3
ardo888: folds 
JimineyCrik: folds 
oxfordtenzin said, "nh"
$-Twackle-$: folds 
oxfordtenzin: folds 
Effort92: calls $3
nobrunobru1: calls $2.50
st-germ30: calls $2
*** FLOP *** [Jh Ad 5h]
nobrunobru1: checks 
st-germ30: checks 
matiko09: checks 
Effort92: checks 
*** TURN *** [Jh Ad 5h] [9s]
nobrunobru1: bets $5
st-germ30: folds 
matiko09: folds 
Effort92: raises $13 to $18
nobrunobru1: folds 
Uncalled bet ($13) returned to Effort92
Effort92 collected $22.73 from pot
Effort92: doesn't show hand 
*** SUMMARY ***
Total pot $23.80 | Rake $1.07 
Board [Jh Ad 5h 9s]
Seat 1: Effort92 (button) collected ($22.73)
Seat 2: nobrunobru1 (small blind) folded on the Turn
Seat 3: st-germ30 (big blind) folded on the Turn
Seat 4: DUkalisUA folded before Flop (didn't bet)
Seat 5: matiko09 folded on the Turn
Seat 6: ardo888 folded before Flop (didn't bet)
Seat 7: JimineyCrik folded before Flop (didn't bet)
Seat 8: $-Twackle-$ folded before Flop (didn't bet)
Seat 9: oxfordtenzin folded before Flop (didn't bet)





PokerStars Hand #150801574872:  Hold'em No Limit ($1/$2 USD) - 2016/03/23 14:35:17 CET [2016/03/23 9:35:17 ET]
Table 'Kypria II' 9-max Seat #5 is the button
Seat 1: geldwolfje ($167.26 in chips) 
Seat 3: seouljam ($176.56 in chips) 
Seat 4: VolanDog ($217.70 in chips) 
Seat 5: InsomniaRU ($374.88 in chips) 
Seat 6: matiko09 ($369.95 in chips) 
Seat 7: DUkalisUA ($205 in chips) 
Seat 8: Pearl Jam87 ($200 in chips) 
Seat 9: Moszes360 ($203 in chips) 
matiko09: posts small blind $1
DUkalisUA: posts big blind $2
*** HOLE CARDS ***
Dealt to matiko09 [6s 7s]
Pearl Jam87: folds 
Moszes360: folds 
geldwolfje: folds 
seouljam: folds 
Pearl Jam87 leaves the table
VolanDog: raises $3 to $5
nickreason17 joins the table at seat #8 
InsomniaRU: calls $5
matiko09: folds 
DUkalisUA: folds 
*** FLOP *** [Qh Kd 4s]
VolanDog: bets $4.50
InsomniaRU: folds 
Uncalled bet ($4.50) returned to VolanDog
VolanDog collected $12.42 from pot
*** SUMMARY ***
Total pot $13 | Rake $0.58 
Board [Qh Kd 4s]
Seat 1: geldwolfje folded before Flop (didn't bet)
Seat 3: seouljam folded before Flop (didn't bet)
Seat 4: VolanDog collected ($12.42)
Seat 5: InsomniaRU (button) folded on the Flop
Seat 6: matiko09 (small blind) folded before Flop
Seat 7: DUkalisUA (big blind) folded before Flop
Seat 8: Pearl Jam87 folded before Flop (didn't bet)
Seat 9: Moszes360 folded before Flop (didn't bet)





PokerStars Hand #150801576299:  Hold'em No Limit (€0.50/€1.00 EUR) - 2016/03/23 14:35:19 CET [2016/03/23 9:35:19 ET]
Table 'Lanzia' 9-max Seat #9 is the button
Seat 1: chaps1988 (€100 in chips) 
Seat 3: Effort92 (€228.91 in chips) 
Seat 4: volwebni4ek (€40 in chips) 
Seat 5: matiko09 (€175.23 in chips) 
Seat 6: Red4erT (€40 in chips) 
Seat 7: $-Twackle-$ (€130.90 in chips) 
Seat 8: Muinmyheart (€105.60 in chips) 
Seat 9: Butcher1848 (€102.37 in chips) 
chaps1988: posts small blind €0.50
Effort92: posts big blind €1
*** HOLE CARDS ***
Dealt to matiko09 [6d 5d]
volwebni4ek: raises €2 to €3
matiko09: folds 
Red4erT: raises €4.50 to €7.50
$-Twackle-$: raises €9.50 to €17
Muinmyheart: folds 
Butcher1848: folds 
chaps1988: folds 
Effort92: folds 
volwebni4ek: folds 
Red4erT: raises €23 to €40 and is all-in
$-Twackle-$: calls €23
*** FIRST FLOP *** [6s Ts Qd]
*** FIRST TURN *** [6s Ts Qd] [8d]
*** FIRST RIVER *** [6s Ts Qd 8d] [3s]
*** SECOND FLOP *** [8s 5c 2c]
*** SECOND TURN *** [8s 5c 2c] [7h]
*** SECOND RIVER *** [8s 5c 2c 7h] [Ah]
*** FIRST SHOW DOWN ***
Red4erT: shows [Kc Kh] (a pair of Kings)
$-Twackle-$: shows [Ks Ac] (high card Ace)
Red4erT collected €41.18 from pot
*** SECOND SHOW DOWN ***
Red4erT: shows [Kc Kh] (a pair of Kings)
$-Twackle-$: shows [Ks Ac] (a pair of Aces)
$-Twackle-$ collected €41.17 from pot
*** SUMMARY ***
Total pot €84.50 | Rake €2.15 
Hand was run twice
FIRST Board [6s Ts Qd 8d 3s]
SECOND Board [8s 5c 2c 7h Ah]
Seat 1: chaps1988 (small blind) folded before Flop
Seat 3: Effort92 (big blind) folded before Flop
Seat 4: volwebni4ek folded before Flop
Seat 5: matiko09 folded before Flop (didn't bet)
Seat 6: Red4erT showed [Kc Kh] and won (€41.18) with a pair of Kings, and lost with a pair of Kings
Seat 7: $-Twackle-$ showed [Ks Ac] and lost with high card Ace, and won (€41.17) with a pair of Aces
Seat 8: Muinmyheart folded before Flop (didn't bet)
Seat 9: Butcher1848 (button) folded before Flop (didn't bet)





PokerStars Hand #150801579828:  Hold'em No Limit ($1/$2 USD) - 2016/03/23 14:35:25 CET [2016/03/23 9:35:25 ET]
Table 'Herba II' 9-max Seat #9 is the button
Seat 1: matiko09 ($224.62 in chips) 
Seat 2: Moszes360 ($224.17 in chips) 
Seat 3: Cirilico ($187.84 in chips) 
Seat 4: DUkalisUA ($200 in chips) 
Seat 5: chippo boy ($252.13 in chips) 
Seat 6: Too-Anti-To ($209.46 in chips) 
Seat 7: InsomniaRU ($403.20 in chips) 
Seat 8: The_red_area ($436.98 in chips) 
Seat 9: mrhighryza ($50.67 in chips) 
matiko09: posts small blind $1
Moszes360: posts big blind $2
*** HOLE CARDS ***
Dealt to matiko09 [8s 4d]
Cirilico: folds 
DUkalisUA: folds 
chippo boy: calls $2
Too-Anti-To: folds 
InsomniaRU: folds 
The_red_area: folds 
mrhighryza: raises $4 to $6
matiko09: folds 
Moszes360: folds 
chippo boy: calls $4
*** FLOP *** [9d Kh Kd]
chippo boy: checks 
mrhighryza: bets $8
chippo boy: calls $8
*** TURN *** [9d Kh Kd] [Td]
chippo boy: checks 
mrhighryza: checks 
*** RIVER *** [9d Kh Kd Td] [3c]
chippo boy: checks 
mrhighryza: checks 
*** SHOW DOWN ***
chippo boy: shows [9h Qh] (two pair, Kings and Nines)
mrhighryza: shows [Tc Ac] (two pair, Kings and Tens)
mrhighryza collected $29.60 from pot
*** SUMMARY ***
Total pot $31 | Rake $1.40 
Board [9d Kh Kd Td 3c]
Seat 1: matiko09 (small blind) folded before Flop
Seat 2: Moszes360 (big blind) folded before Flop
Seat 3: Cirilico folded before Flop (didn't bet)
Seat 4: DUkalisUA folded before Flop (didn't bet)
Seat 5: chippo boy showed [9h Qh] and lost with two pair, Kings and Nines
Seat 6: Too-Anti-To folded before Flop (didn't bet)
Seat 7: InsomniaRU folded before Flop (didn't bet)
Seat 8: The_red_area folded before Flop (didn't bet)
Seat 9: mrhighryza (button) showed [Tc Ac] and won ($29.60) with two pair, Kings and Tens





PokerStars Hand #150801581465:  Hold'em No Limit ($0.50/$1.00 USD) - 2016/03/23 14:35:27 CET [2016/03/23 9:35:27 ET]
Table 'Atlantis' 9-max Seat #4 is the button
Seat 1: xHourglass ($150.50 in chips) 
Seat 3: CAJUN890 ($140.44 in chips) 
Seat 4: matiko09 ($125.75 in chips) 
Seat 5: Pvsx. ($100 in chips) 
Seat 6: Jimy Tiltman ($104 in chips) 
Seat 7: Sherlockplay ($133.27 in chips) 
Seat 8: DUkalisUA ($135 in chips) 
Pvsx.: posts small blind $0.50
Jimy Tiltman: posts big blind $1
RICKA16: sits out 
Szevasztopol: sits out 
*** HOLE CARDS ***
Dealt to matiko09 [4s Qh]
Sherlockplay: folds 
DUkalisUA: folds 
xHourglass: folds 
CAJUN890: raises $1 to $2
matiko09: folds 
Pvsx.: calls $1.50
Jimy Tiltman: calls $1
*** FLOP *** [8s 8d 7c]
Pvsx.: checks 
Jimy Tiltman: checks 
CAJUN890: bets $2.86
Pvsx.: calls $2.86
Jimy Tiltman: calls $2.86
*** TURN *** [8s 8d 7c] [4d]
Pvsx.: checks 
Jimy Tiltman: checks 
CAJUN890: checks 
*** RIVER *** [8s 8d 7c 4d] [8h]
Pvsx.: checks 
Jimy Tiltman: checks 
CAJUN890: checks 
*** SHOW DOWN ***
Pvsx.: shows [2s 2c] (a full house, Eights full of Deuces)
Jimy Tiltman: mucks hand 
CAJUN890: mucks hand 
Pvsx. collected $13.92 from pot
*** SUMMARY ***
Total pot $14.58 | Rake $0.66 
Board [8s 8d 7c 4d 8h]
Seat 1: xHourglass folded before Flop (didn't bet)
Seat 3: CAJUN890 mucked [9c Tc]
Seat 4: matiko09 (button) folded before Flop (didn't bet)
Seat 5: Pvsx. (small blind) showed [2s 2c] and won ($13.92) with a full house, Eights full of Deuces
Seat 6: Jimy Tiltman (big blind) mucked [6s 5c]
Seat 7: Sherlockplay folded before Flop (didn't bet)
Seat 8: DUkalisUA folded before Flop (didn't bet)





PokerStars Hand #150801583315:  Hold'em No Limit ($1/$2 USD) - 2016/03/23 14:35:30 CET [2016/03/23 9:35:30 ET]
Table 'Ennomos II' 9-max Seat #2 is the button
Seat 1: InsomniaRU ($200 in chips) 
Seat 2: Subam ($208.38 in chips) 
Seat 3: $-Twackle-$ ($229.20 in chips) 
Seat 4: glanza_mike ($200 in chips) 
Seat 5: South011 ($394.02 in chips) 
Seat 6: nickreason17 ($364.60 in chips) 
Seat 8: yyfk ($200.24 in chips) 
Seat 9: matiko09 ($321.20 in chips) 
$-Twackle-$: posts small blind $1
glanza_mike: posts big blind $2
T0ny Adams: sits out 
*** HOLE CARDS ***
Dealt to matiko09 [8h Ah]
South011: folds 
nickreason17: folds 
yyfk: folds 
matiko09: raises $3 to $5
InsomniaRU: folds 
Subam: calls $5
$-Twackle-$: folds 
glanza_mike: calls $3
*** FLOP *** [9h 7d Kh]
glanza_mike: checks 
matiko09: bets $9.93
Subam: folds 
glanza_mike: calls $9.93
*** TURN *** [9h 7d Kh] [7h]
glanza_mike: checks 
matiko09: checks 
*** RIVER *** [9h 7d Kh 7h] [3h]
glanza_mike: checks 
matiko09: bets $18
glanza_mike: folds 
Uncalled bet ($18) returned to matiko09
matiko09 collected $34.25 from pot
matiko09: doesn't show hand 
*** SUMMARY ***
Total pot $35.86 | Rake $1.61 
Board [9h 7d Kh 7h 3h]
Seat 1: InsomniaRU folded before Flop (didn't bet)
Seat 2: Subam (button) folded on the Flop
Seat 3: $-Twackle-$ (small blind) folded before Flop
Seat 4: glanza_mike (big blind) folded on the River
Seat 5: South011 folded before Flop (didn't bet)
Seat 6: nickreason17 folded before Flop (didn't bet)
Seat 8: yyfk folded before Flop (didn't bet)
Seat 9: matiko09 collected ($34.25)





PokerStars Hand #150801588724:  Hold'em No Limit ($1/$2 USD) - 2016/03/23 14:35:39 CET [2016/03/23 9:35:39 ET]
Table 'Achaia' 9-max Seat #1 is the button
Seat 1: Moszes360 ($226.36 in chips) 
Seat 2: InsomniaRU ($225.44 in chips) 
Seat 3: matiko09 ($200 in chips) 
Seat 4: nailz83 ($210.79 in chips) 
Seat 5: chaps1988 ($200 in chips) 
Seat 6: nickreason17 ($200.14 in chips) 
Seat 7: morosun ($171.10 in chips) 
Seat 8: $-Twackle-$ ($225.07 in chips) 
Seat 9: glanza_mike ($200 in chips) 
InsomniaRU: posts small blind $1
matiko09: posts big blind $2
*** HOLE CARDS ***
Dealt to matiko09 [6s 3c]
nailz83: folds 
chaps1988: folds 
nickreason17: folds 
morosun: folds 
nailz83 leaves the table
erfk1958 joins the table at seat #4 
$-Twackle-$: folds 
glanza_mike: folds 
Moszes360: folds 
InsomniaRU: folds 
Uncalled bet ($1) returned to matiko09
matiko09 collected $2 from pot
matiko09: doesn't show hand 
*** SUMMARY ***
Total pot $2 | Rake $0 
Seat 1: Moszes360 (button) folded before Flop (didn't bet)
Seat 2: InsomniaRU (small blind) folded before Flop
Seat 3: matiko09 (big blind) collected ($2)
Seat 4: nailz83 folded before Flop (didn't bet)
Seat 5: chaps1988 folded before Flop (didn't bet)
Seat 6: nickreason17 folded before Flop (didn't bet)
Seat 7: morosun folded before Flop (didn't bet)
Seat 8: $-Twackle-$ folded before Flop (didn't bet)
Seat 9: glanza_mike folded before Flop (didn't bet)





PokerStars Hand #150801601700:  Hold'em No Limit ($0.50/$1.00 USD) - 2016/03/23 14:35:59 CET [2016/03/23 9:35:59 ET]
Table 'Merope II' 9-max Seat #3 is the button
Seat 1: Jimy Tiltman ($137.73 in chips) 
Seat 2: $-Twackle-$ ($101.50 in chips) 
Seat 3: pablos1922 ($88.25 in chips) 
Seat 4: YuriiSolodya ($90.84 in chips) 
Seat 5: DUkalisUA ($159.87 in chips) 
Seat 6: Effort92 ($103.71 in chips) 
Seat 7: matiko09 ($104.73 in chips) 
Seat 8: titentei ($92.03 in chips) 
YuriiSolodya: posts small blind $0.50
DUkalisUA: posts big blind $1
RICKA16: sits out 
*** HOLE CARDS ***
Dealt to matiko09 [2s 8s]
Effort92: folds 
matiko09: folds 
titentei: folds 
Jimy Tiltman: folds 
$-Twackle-$: folds 
pablos1922: raises $2 to $3
YuriiSolodya: folds 
DUkalisUA: folds 
Uncalled bet ($2) returned to pablos1922
pablos1922 collected $2.50 from pot
pablos1922: doesn't show hand 
*** SUMMARY ***
Total pot $2.50 | Rake $0 
Seat 1: Jimy Tiltman folded before Flop (didn't bet)
Seat 2: $-Twackle-$ folded before Flop (didn't bet)
Seat 3: pablos1922 (button) collected ($2.50)
Seat 4: YuriiSolodya (small blind) folded before Flop
Seat 5: DUkalisUA (big blind) folded before Flop
Seat 6: Effort92 folded before Flop (didn't bet)
Seat 7: matiko09 folded before Flop (didn't bet)
Seat 8: titentei folded before Flop (didn't bet)





PokerStars Hand #150801604039:  Hold'em No Limit ($1/$2 USD) - 2016/03/23 14:36:03 CET [2016/03/23 9:36:03 ET]
Table 'Kypria II' 9-max Seat #6 is the button
Seat 1: geldwolfje ($167.26 in chips) 
Seat 3: seouljam ($176.56 in chips) 
Seat 4: VolanDog ($225.12 in chips) 
Seat 5: InsomniaRU ($369.88 in chips) 
Seat 6: matiko09 ($368.95 in chips) 
Seat 7: DUkalisUA ($203 in chips) 
Seat 8: nickreason17 ($200 in chips) 
Seat 9: Moszes360 ($203 in chips) 
DUkalisUA: posts small blind $1
nickreason17: posts big blind $2
*** HOLE CARDS ***
Dealt to matiko09 [4c Qh]
Moszes360: folds 
geldwolfje: raises $2 to $4
seouljam: folds 
VolanDog: calls $4
InsomniaRU: calls $4
matiko09: folds 
DUkalisUA: folds 
nickreason17: calls $2
*** FLOP *** [Jh Th 7s]
nickreason17: checks 
geldwolfje: bets $6
VolanDog: folds 
InsomniaRU: folds 
nickreason17: folds 
Uncalled bet ($6) returned to geldwolfje
geldwolfje collected $16.24 from pot
geldwolfje: doesn't show hand 
*** SUMMARY ***
Total pot $17 | Rake $0.76 
Board [Jh Th 7s]
Seat 1: geldwolfje collected ($16.24)
Seat 3: seouljam folded before Flop (didn't bet)
Seat 4: VolanDog folded on the Flop
Seat 5: InsomniaRU folded on the Flop
Seat 6: matiko09 (button) folded before Flop (didn't bet)
Seat 7: DUkalisUA (small blind) folded before Flop
Seat 8: nickreason17 (big blind) folded on the Flop
Seat 9: Moszes360 folded before Flop (didn't bet)





PokerStars Hand #150801607789:  Hold'em No Limit ($1/$2 USD) - 2016/03/23 14:36:09 CET [2016/03/23 9:36:09 ET]
Table 'Achaia' 9-max Seat #2 is the button
Seat 1: Moszes360 ($226.36 in chips) 
Seat 2: InsomniaRU ($224.44 in chips) 
Seat 3: matiko09 ($201 in chips) 
Seat 4: erfk1958 ($122 in chips) 
Seat 5: chaps1988 ($200 in chips) 
Seat 6: nickreason17 ($200.14 in chips) 
Seat 7: morosun ($171.10 in chips) 
Seat 8: $-Twackle-$ ($225.07 in chips) 
Seat 9: glanza_mike ($200 in chips) 
matiko09: posts small blind $1
erfk1958: posts big blind $2
*** HOLE CARDS ***
Dealt to matiko09 [Kc 2d]
chaps1988: folds 
nickreason17: folds 
morosun: calls $2
$-Twackle-$: folds 
glanza_mike: folds 
Moszes360: folds 
InsomniaRU: folds 
matiko09: folds 
erfk1958: checks 
*** FLOP *** [2c 4h 4c]
erfk1958: checks 
morosun: bets $2
erfk1958: folds 
Uncalled bet ($2) returned to morosun
morosun collected $4.78 from pot
*** SUMMARY ***
Total pot $5 | Rake $0.22 
Board [2c 4h 4c]
Seat 1: Moszes360 folded before Flop (didn't bet)
Seat 2: InsomniaRU (button) folded before Flop (didn't bet)
Seat 3: matiko09 (small blind) folded before Flop
Seat 4: erfk1958 (big blind) folded on the Flop
Seat 5: chaps1988 folded before Flop (didn't bet)
Seat 6: nickreason17 folded before Flop (didn't bet)
Seat 7: morosun collected ($4.78)
Seat 8: $-Twackle-$ folded before Flop (didn't bet)
Seat 9: glanza_mike folded before Flop (didn't bet)





PokerStars Hand #150801609941:  Hold'em No Limit ($0.50/$1.00 USD) - 2016/03/23 14:36:12 CET [2016/03/23 9:36:12 ET]
Table 'Swings' 9-max Seat #4 is the button
Seat 1: Sherlockplay ($100 in chips) 
Seat 2: Harbinger X ($187.14 in chips) 
Seat 3: maxxmeister ($115.04 in chips) 
Seat 4: chaps1988 ($102.60 in chips) 
Seat 5: chautinhtri9 ($79 in chips) 
Seat 6: matiko09 ($106.07 in chips) 
Seat 7: nickreason17 ($100 in chips) 
Seat 9: Vlad_1965_77 ($107.55 in chips) 
chautinhtri9: posts small blind $0.50
matiko09: posts big blind $1
RICKA16: sits out 
*** HOLE CARDS ***
Dealt to matiko09 [7s Td]
nickreason17: folds 
Vlad_1965_77: folds 
Sherlockplay: folds 
nickreason17 leaves the table
Harbinger X: raises $2 to $3
maxxmeister: folds 
chaps1988: folds 
chautinhtri9: folds 
matiko09: folds 
Uncalled bet ($2) returned to Harbinger X
Harbinger X collected $2.50 from pot
Harbinger X: doesn't show hand 
*** SUMMARY ***
Total pot $2.50 | Rake $0 
Seat 1: Sherlockplay folded before Flop (didn't bet)
Seat 2: Harbinger X collected ($2.50)
Seat 3: maxxmeister folded before Flop (didn't bet)
Seat 4: chaps1988 (button) folded before Flop (didn't bet)
Seat 5: chautinhtri9 (small blind) folded before Flop
Seat 6: matiko09 (big blind) folded before Flop
Seat 7: nickreason17 folded before Flop (didn't bet)
Seat 9: Vlad_1965_77 folded before Flop (didn't bet)





PokerStars Hand #150801610943:  Hold'em No Limit ($0.25/$0.50 USD) - 2016/03/23 14:36:14 CET [2016/03/23 9:36:14 ET]
Table 'Pyrrhus' 9-max Seat #5 is the button
Seat 3: i L00K great ($50 in chips) 
Seat 4: GriffinBerg ($44.95 in chips) 
Seat 5: ZonTTT ($54.36 in chips) 
Seat 6: Ahangama ($50 in chips) 
Seat 7: matiko09 ($138.38 in chips) 
Seat 8: dndngod ($71.23 in chips) 
Seat 9: CvMCvMCvM ($93.52 in chips) 
Ahangama: posts small blind $0.25
matiko09: posts big blind $0.50
BSTUSim: sits out 
*** HOLE CARDS ***
Dealt to matiko09 [6h 5c]
dndngod: folds 
CvMCvMCvM: folds 
i L00K great: folds 
GriffinBerg: folds 
ZonTTT: raises $0.50 to $1
Ahangama: folds 
matiko09: folds 
Uncalled bet ($0.50) returned to ZonTTT
ZonTTT collected $1.25 from pot
ZonTTT: doesn't show hand 
*** SUMMARY ***
Total pot $1.25 | Rake $0 
Seat 3: i L00K great folded before Flop (didn't bet)
Seat 4: GriffinBerg folded before Flop (didn't bet)
Seat 5: ZonTTT (button) collected ($1.25)
Seat 6: Ahangama (small blind) folded before Flop
Seat 7: matiko09 (big blind) folded before Flop
Seat 8: dndngod folded before Flop (didn't bet)
Seat 9: CvMCvMCvM folded before Flop (didn't bet)





PokerStars Hand #150801619729:  Hold'em No Limit ($0.50/$1.00 USD) - 2016/03/23 14:36:28 CET [2016/03/23 9:36:28 ET]
Table 'Swings' 9-max Seat #5 is the button
Seat 1: Sherlockplay ($100 in chips) 
Seat 2: Harbinger X ($188.64 in chips) 
Seat 3: maxxmeister ($115.04 in chips) 
Seat 4: chaps1988 ($102.60 in chips) 
Seat 5: chautinhtri9 ($78.50 in chips) 
Seat 6: matiko09 ($105.07 in chips) 
Seat 8: RICKA16 ($100 in chips) 
Seat 9: Vlad_1965_77 ($107.55 in chips) 
matiko09: posts small blind $0.50
RICKA16: posts big blind $1
*** HOLE CARDS ***
Dealt to matiko09 [3d 8s]
Vlad_1965_77: raises $2.50 to $3.50
Sherlockplay: folds 
Harbinger X: folds 
maxxmeister: folds 
chaps1988: folds 
chautinhtri9: folds 
matiko09: folds 
RICKA16: folds 
Uncalled bet ($2.50) returned to Vlad_1965_77
Vlad_1965_77 collected $2.50 from pot
*** SUMMARY ***
Total pot $2.50 | Rake $0 
Seat 1: Sherlockplay folded before Flop (didn't bet)
Seat 2: Harbinger X folded before Flop (didn't bet)
Seat 3: maxxmeister folded before Flop (didn't bet)
Seat 4: chaps1988 folded before Flop (didn't bet)
Seat 5: chautinhtri9 (button) folded before Flop (didn't bet)
Seat 6: matiko09 (small blind) folded before Flop
Seat 8: RICKA16 (big blind) folded before Flop
Seat 9: Vlad_1965_77 collected ($2.50)





PokerStars Hand #150801620860:  Hold'em No Limit ($1/$2 USD) - 2016/03/23 14:36:30 CET [2016/03/23 9:36:30 ET]
Table 'Herba II' 9-max Seat #1 is the button
Seat 1: matiko09 ($223.62 in chips) 
Seat 2: Moszes360 ($222.17 in chips) 
Seat 3: Cirilico ($187.84 in chips) 
Seat 4: DUkalisUA ($200 in chips) 
Seat 5: chippo boy ($238.13 in chips) 
Seat 6: Too-Anti-To ($209.46 in chips) 
Seat 7: InsomniaRU ($403.20 in chips) 
Seat 8: The_red_area ($436.98 in chips) 
Seat 9: mrhighryza ($66.27 in chips) 
Moszes360: posts small blind $1
Cirilico: posts big blind $2
*** HOLE CARDS ***
Dealt to matiko09 [9c Js]
DUkalisUA: folds 
chippo boy: folds 
Too-Anti-To: folds 
InsomniaRU: folds 
The_red_area: folds 
mrhighryza: folds 
matiko09: raises $2.54 to $4.54
Moszes360: folds 
Cirilico: folds 
Uncalled bet ($2.54) returned to matiko09
matiko09 collected $5 from pot
matiko09: doesn't show hand 
*** SUMMARY ***
Total pot $5 | Rake $0 
Seat 1: matiko09 (button) collected ($5)
Seat 2: Moszes360 (small blind) folded before Flop
Seat 3: Cirilico (big blind) folded before Flop
Seat 4: DUkalisUA folded before Flop (didn't bet)
Seat 5: chippo boy folded before Flop (didn't bet)
Seat 6: Too-Anti-To folded before Flop (didn't bet)
Seat 7: InsomniaRU folded before Flop (didn't bet)
Seat 8: The_red_area folded before Flop (didn't bet)
Seat 9: mrhighryza folded before Flop (didn't bet)





PokerStars Hand #150801623477:  Hold'em No Limit ($0.50/$1.00 USD) - 2016/03/23 14:36:34 CET [2016/03/23 9:36:34 ET]
Table 'Merope II' 9-max Seat #4 is the button
Seat 1: Jimy Tiltman ($137.73 in chips) 
Seat 2: $-Twackle-$ ($101.50 in chips) 
Seat 3: pablos1922 ($89.75 in chips) 
Seat 4: YuriiSolodya ($90.34 in chips) 
Seat 5: DUkalisUA ($158.87 in chips) 
Seat 6: Effort92 ($103.71 in chips) 
Seat 7: matiko09 ($104.73 in chips) 
Seat 8: titentei ($92.03 in chips) 
DUkalisUA: posts small blind $0.50
Effort92: posts big blind $1
RICKA16: sits out 
*** HOLE CARDS ***
Dealt to matiko09 [Qc 3d]
matiko09: folds 
titentei: folds 
Jimy Tiltman: folds 
$-Twackle-$: folds 
pablos1922: folds 
YuriiSolodya: folds 
DUkalisUA: folds 
Uncalled bet ($0.50) returned to Effort92
Effort92 collected $1 from pot
Effort92: doesn't show hand 
*** SUMMARY ***
Total pot $1 | Rake $0 
Seat 1: Jimy Tiltman folded before Flop (didn't bet)
Seat 2: $-Twackle-$ folded before Flop (didn't bet)
Seat 3: pablos1922 folded before Flop (didn't bet)
Seat 4: YuriiSolodya (button) folded before Flop (didn't bet)
Seat 5: DUkalisUA (small blind) folded before Flop
Seat 6: Effort92 (big blind) collected ($1)
Seat 7: matiko09 folded before Flop (didn't bet)
Seat 8: titentei folded before Flop (didn't bet)





PokerStars Hand #150801624021:  Hold'em No Limit ($1/$2 USD) - 2016/03/23 14:36:35 CET [2016/03/23 9:36:35 ET]
Table 'Achaia' 9-max Seat #3 is the button
Seat 1: Moszes360 ($226.36 in chips) 
Seat 2: InsomniaRU ($224.44 in chips) 
Seat 3: matiko09 ($200 in chips) 
Seat 4: erfk1958 ($120 in chips) 
Seat 5: chaps1988 ($200 in chips) 
Seat 6: nickreason17 ($200.14 in chips) 
Seat 7: morosun ($173.88 in chips) 
Seat 8: $-Twackle-$ ($225.07 in chips) 
Seat 9: glanza_mike ($200 in chips) 
erfk1958: posts small blind $1
chaps1988: posts big blind $2
*** HOLE CARDS ***
Dealt to matiko09 [4d Ac]
nickreason17: folds 
morosun: calls $2
$-Twackle-$: folds 
glanza_mike: folds 
Moszes360: folds 
InsomniaRU: folds 
matiko09: raises $6 to $8
erfk1958: folds 
chaps1988: folds 
morosun: calls $6
*** FLOP *** [Ah 2c 8c]
morosun: bets $6
matiko09: calls $6
*** TURN *** [Ah 2c 8c] [4c]
morosun: bets $8
matiko09: calls $8
*** RIVER *** [Ah 2c 8c 4c] [Kh]
morosun: bets $12
matiko09: raises $16 to $28
morosun: folds 
Uncalled bet ($16) returned to matiko09
matiko09 collected $68.20 from pot
matiko09: doesn't show hand 
*** SUMMARY ***
Total pot $71 | Rake $2.80 
Board [Ah 2c 8c 4c Kh]
Seat 1: Moszes360 folded before Flop (didn't bet)
Seat 2: InsomniaRU folded before Flop (didn't bet)
Seat 3: matiko09 (button) collected ($68.20)
Seat 4: erfk1958 (small blind) folded before Flop
Seat 5: chaps1988 (big blind) folded before Flop
Seat 6: nickreason17 folded before Flop (didn't bet)
Seat 7: morosun folded on the River
Seat 8: $-Twackle-$ folded before Flop (didn't bet)
Seat 9: glanza_mike folded before Flop (didn't bet)





PokerStars Hand #150801625327:  Hold'em No Limit ($1/$2 USD) - 2016/03/23 14:36:37 CET [2016/03/23 9:36:37 ET]
Table 'Kiess' 9-max Seat #5 is the button
Seat 1: Cirilico ($265.22 in chips) 
Seat 2: DUkalisUA ($655.10 in chips) 
Seat 3: The_red_area ($321.27 in chips) 
Seat 4: Moszes360 ($200 in chips) 
Seat 5: chippo boy ($429.28 in chips) 
Seat 6: matiko09 ($264.86 in chips) 
Seat 7: InsomniaRU ($306.97 in chips) 
Seat 8: erfk1958 ($120.96 in chips) 
Seat 9: T0ny Adams ($96.74 in chips) 
matiko09: posts small blind $1
InsomniaRU: posts big blind $2
*** HOLE CARDS ***
Dealt to matiko09 [8h Ad]
erfk1958: raises $2 to $4
T0ny Adams: folds 
Cirilico: folds 
DUkalisUA: folds 
The_red_area: folds 
Moszes360: folds 
chippo boy: calls $4
matiko09: folds 
InsomniaRU: folds 
*** FLOP *** [Kd 3d 3s]
erfk1958: bets $4
chippo boy: calls $4
*** TURN *** [Kd 3d 3s] [4s]
erfk1958: bets $6
chippo boy: calls $6
*** RIVER *** [Kd 3d 3s 4s] [2h]
erfk1958: checks 
chippo boy: bets $14
erfk1958: folds 
Uncalled bet ($14) returned to chippo boy
chippo boy collected $29.60 from pot
*** SUMMARY ***
Total pot $31 | Rake $1.40 
Board [Kd 3d 3s 4s 2h]
Seat 1: Cirilico folded before Flop (didn't bet)
Seat 2: DUkalisUA folded before Flop (didn't bet)
Seat 3: The_red_area folded before Flop (didn't bet)
Seat 4: Moszes360 folded before Flop (didn't bet)
Seat 5: chippo boy (button) collected ($29.60)
Seat 6: matiko09 (small blind) folded before Flop
Seat 7: InsomniaRU (big blind) folded before Flop
Seat 8: erfk1958 folded on the River
Seat 9: T0ny Adams folded before Flop (didn't bet)





PokerStars Hand #150801628211:  Hold'em No Limit ($0.50/$1.00 USD) - 2016/03/23 14:36:42 CET [2016/03/23 9:36:42 ET]
Table 'Atlantis' 9-max Seat #5 is the button
Seat 1: xHourglass ($150.50 in chips) 
Seat 3: CAJUN890 ($135.58 in chips) 
Seat 4: matiko09 ($125.75 in chips) 
Seat 5: Pvsx. ($109.06 in chips) 
Seat 6: Jimy Tiltman ($100 in chips) 
Seat 7: Sherlockplay ($133.27 in chips) 
Seat 8: DUkalisUA ($135 in chips) 
Jimy Tiltman: posts small blind $0.50
Sherlockplay: posts big blind $1
RICKA16: sits out 
Szevasztopol: sits out 
*** HOLE CARDS ***
Dealt to matiko09 [6s Qc]
DUkalisUA: folds 
xHourglass: folds 
CAJUN890: raises $1 to $2
matiko09: folds 
Pvsx.: calls $2
Jimy Tiltman: folds 
Sherlockplay: calls $1
*** FLOP *** [Kh 5h Js]
Sherlockplay: bets $3.50
CAJUN890: folds 
Pvsx.: folds 
Uncalled bet ($3.50) returned to Sherlockplay
Sherlockplay collected $6.21 from pot
Sherlockplay: doesn't show hand 
*** SUMMARY ***
Total pot $6.50 | Rake $0.29 
Board [Kh 5h Js]
Seat 1: xHourglass folded before Flop (didn't bet)
Seat 3: CAJUN890 folded on the Flop
Seat 4: matiko09 folded before Flop (didn't bet)
Seat 5: Pvsx. (button) folded on the Flop
Seat 6: Jimy Tiltman (small blind) folded before Flop
Seat 7: Sherlockplay (big blind) collected ($6.21)
Seat 8: DUkalisUA folded before Flop (didn't bet)





PokerStars Hand #150801631243:  Hold'em No Limit ($0.50/$1.00 USD) - 2016/03/23 14:36:46 CET [2016/03/23 9:36:46 ET]
Table 'Swings' 9-max Seat #6 is the button
Seat 1: Sherlockplay ($100 in chips) 
Seat 2: Harbinger X ($188.64 in chips) 
Seat 3: maxxmeister ($115.04 in chips) 
Seat 4: chaps1988 ($102.60 in chips) 
Seat 5: chautinhtri9 ($100 in chips) 
Seat 6: matiko09 ($104.57 in chips) 
Seat 8: RICKA16 ($99 in chips) 
Seat 9: Vlad_1965_77 ($109.05 in chips) 
RICKA16: posts small blind $0.50
Vlad_1965_77: posts big blind $1
*** HOLE CARDS ***
Dealt to matiko09 [9c 2h]
Sherlockplay: raises $1.50 to $2.50
Harbinger X: folds 
maxxmeister: folds 
chaps1988: folds 
chautinhtri9: folds 
matiko09: folds 
RICKA16: folds 
Vlad_1965_77: folds 
Uncalled bet ($1.50) returned to Sherlockplay
Sherlockplay collected $2.50 from pot
Sherlockplay: doesn't show hand 
*** SUMMARY ***
Total pot $2.50 | Rake $0 
Seat 1: Sherlockplay collected ($2.50)
Seat 2: Harbinger X folded before Flop (didn't bet)
Seat 3: maxxmeister folded before Flop (didn't bet)
Seat 4: chaps1988 folded before Flop (didn't bet)
Seat 5: chautinhtri9 folded before Flop (didn't bet)
Seat 6: matiko09 (button) folded before Flop (didn't bet)
Seat 8: RICKA16 (small blind) folded before Flop
Seat 9: Vlad_1965_77 (big blind) folded before Flop





PokerStars Hand #150801634874:  Hold'em No Limit ($0.25/$0.50 USD) - 2016/03/23 14:36:52 CET [2016/03/23 9:36:52 ET]
Table 'Pyrrhus' 9-max Seat #6 is the button
Seat 3: i L00K great ($50 in chips) 
Seat 4: GriffinBerg ($44.95 in chips) 
Seat 5: ZonTTT ($55.11 in chips) 
Seat 6: Ahangama ($50 in chips) 
Seat 7: matiko09 ($137.88 in chips) 
Seat 8: dndngod ($71.23 in chips) 
Seat 9: CvMCvMCvM ($93.52 in chips) 
matiko09: posts small blind $0.25
dndngod: posts big blind $0.50
BSTUSim: sits out 
*** HOLE CARDS ***
Dealt to matiko09 [5h Ts]
CvMCvMCvM: folds 
i L00K great: raises $1 to $1.50
GriffinBerg: folds 
ZonTTT: folds 
Ahangama: folds 
matiko09: folds 
dndngod: folds 
Uncalled bet ($1) returned to i L00K great
i L00K great collected $1.25 from pot
i L00K great: doesn't show hand 
*** SUMMARY ***
Total pot $1.25 | Rake $0 
Seat 3: i L00K great collected ($1.25)
Seat 4: GriffinBerg folded before Flop (didn't bet)
Seat 5: ZonTTT folded before Flop (didn't bet)
Seat 6: Ahangama (button) folded before Flop (didn't bet)
Seat 7: matiko09 (small blind) folded before Flop
Seat 8: dndngod (big blind) folded before Flop
Seat 9: CvMCvMCvM folded before Flop (didn't bet)





PokerStars Hand #150801645761:  Hold'em No Limit ($1/$2 USD) - 2016/03/23 14:37:10 CET [2016/03/23 9:37:10 ET]
Table 'Herba II' 9-max Seat #2 is the button
Seat 1: matiko09 ($226.62 in chips) 
Seat 2: Moszes360 ($221.17 in chips) 
Seat 3: Cirilico ($185.84 in chips) 
Seat 4: DUkalisUA ($200 in chips) 
Seat 5: chippo boy ($238.13 in chips) 
Seat 6: Too-Anti-To ($209.46 in chips) 
Seat 7: InsomniaRU ($403.20 in chips) 
Seat 8: The_red_area ($436.98 in chips) 
Seat 9: mrhighryza ($66.27 in chips) 
Cirilico: posts small blind $1
DUkalisUA: posts big blind $2
*** HOLE CARDS ***
Dealt to matiko09 [Jd 2d]
chippo boy: folds 
Too-Anti-To: folds 
InsomniaRU: folds 
The_red_area: raises $4 to $6
mrhighryza: folds 
matiko09: folds 
Moszes360: raises $12 to $18
Cirilico: folds 
DUkalisUA: raises $25 to $43
The_red_area: calls $37
Moszes360: folds 
*** FLOP *** [Jh 5d Js]
DUkalisUA: bets $40.88
The_red_area: folds 
Uncalled bet ($40.88) returned to DUkalisUA
DUkalisUA collected $102.20 from pot
DUkalisUA: doesn't show hand 
*** SUMMARY ***
Total pot $105 | Rake $2.80 
Board [Jh 5d Js]
Seat 1: matiko09 folded before Flop (didn't bet)
Seat 2: Moszes360 (button) folded before Flop
Seat 3: Cirilico (small blind) folded before Flop
Seat 4: DUkalisUA (big blind) collected ($102.20)
Seat 5: chippo boy folded before Flop (didn't bet)
Seat 6: Too-Anti-To folded before Flop (didn't bet)
Seat 7: InsomniaRU folded before Flop (didn't bet)
Seat 8: The_red_area folded on the Flop
Seat 9: mrhighryza folded before Flop (didn't bet)





PokerStars Hand #150801647360:  Hold'em No Limit ($0.50/$1.00 USD) - 2016/03/23 14:37:12 CET [2016/03/23 9:37:12 ET]
Table 'Swings' 9-max Seat #8 is the button
Seat 1: Sherlockplay ($101.50 in chips) 
Seat 2: Harbinger X ($188.64 in chips) 
Seat 3: maxxmeister ($115.04 in chips) 
Seat 4: chaps1988 ($102.60 in chips) 
Seat 5: chautinhtri9 ($100 in chips) 
Seat 6: matiko09 ($104.57 in chips) 
Seat 8: RICKA16 ($100 in chips) 
Seat 9: Vlad_1965_77 ($108.05 in chips) 
Vlad_1965_77: posts small blind $0.50
Sherlockplay: posts big blind $1
*** HOLE CARDS ***
Dealt to matiko09 [3d 8s]
Harbinger X: folds 
maxxmeister: raises $2 to $3
chaps1988: folds 
chautinhtri9: folds 
matiko09: folds 
RICKA16: folds 
Vlad_1965_77: folds 
Sherlockplay: folds 
Uncalled bet ($2) returned to maxxmeister
maxxmeister collected $2.50 from pot
maxxmeister: doesn't show hand 
*** SUMMARY ***
Total pot $2.50 | Rake $0 
Seat 1: Sherlockplay (big blind) folded before Flop
Seat 2: Harbinger X folded before Flop (didn't bet)
Seat 3: maxxmeister collected ($2.50)
Seat 4: chaps1988 folded before Flop (didn't bet)
Seat 5: chautinhtri9 folded before Flop (didn't bet)
Seat 6: matiko09 folded before Flop (didn't bet)
Seat 8: RICKA16 (button) folded before Flop (didn't bet)
Seat 9: Vlad_1965_77 (small blind) folded before Flop





PokerStars Hand #150801648788:  Hold'em No Limit ($0.50/$1.00 USD) - 2016/03/23 14:37:15 CET [2016/03/23 9:37:15 ET]
Table 'Merope II' 9-max Seat #5 is the button
Seat 1: Jimy Tiltman ($137.73 in chips) 
Seat 2: $-Twackle-$ ($101.50 in chips) 
Seat 3: pablos1922 ($89.75 in chips) 
Seat 4: YuriiSolodya ($90.34 in chips) 
Seat 5: DUkalisUA ($158.37 in chips) 
Seat 6: Effort92 ($104.21 in chips) 
Seat 7: matiko09 ($104.73 in chips) 
Seat 8: titentei ($92.03 in chips) 
Effort92: posts small blind $0.50
matiko09: posts big blind $1
RICKA16: sits out 
*** HOLE CARDS ***
Dealt to matiko09 [7d 7s]
titentei: folds 
Jimy Tiltman: folds 
$-Twackle-$: folds 
pablos1922: folds 
YuriiSolodya: folds 
DUkalisUA: raises $1 to $2
Effort92: folds 
matiko09: calls $1
*** FLOP *** [2h Ts 9h]
matiko09: checks 
titentei leaves the table
DUkalisUA: checks 
*** TURN *** [2h Ts 9h] [4s]
matiko09: checks 
DUkalisUA: checks 
*** RIVER *** [2h Ts 9h 4s] [Qh]
Red4erT joins the table at seat #8 
matiko09: checks 
DUkalisUA: checks 
*** SHOW DOWN ***
matiko09: shows [7d 7s] (a pair of Sevens)
DUkalisUA: mucks hand 
matiko09 collected $4.30 from pot
*** SUMMARY ***
Total pot $4.50 | Rake $0.20 
Board [2h Ts 9h 4s Qh]
Seat 1: Jimy Tiltman folded before Flop (didn't bet)
Seat 2: $-Twackle-$ folded before Flop (didn't bet)
Seat 3: pablos1922 folded before Flop (didn't bet)
Seat 4: YuriiSolodya folded before Flop (didn't bet)
Seat 5: DUkalisUA (button) mucked [8c Ac]
Seat 6: Effort92 (small blind) folded before Flop
Seat 7: matiko09 (big blind) showed [7d 7s] and won ($4.30) with a pair of Sevens
Seat 8: titentei folded before Flop (didn't bet)





PokerStars Hand #150801649439:  Hold'em No Limit ($0.50/$1.00 USD) - 2016/03/23 14:37:16 CET [2016/03/23 9:37:16 ET]
Table 'Donar II' 9-max Seat #2 is the button
Seat 1: Effort92 ($117.42 in chips) 
Seat 2: nobrunobru1 ($42.44 in chips) 
Seat 3: st-germ30 ($95.89 in chips) 
Seat 4: DUkalisUA ($163.34 in chips) 
Seat 5: matiko09 ($100.47 in chips) 
Seat 6: ardo888 ($132.38 in chips) 
Seat 7: JimineyCrik ($102.78 in chips) 
Seat 8: $-Twackle-$ ($126.80 in chips) 
Seat 9: oxfordtenzin ($88.30 in chips) 
st-germ30: posts small blind $0.50
DUkalisUA: posts big blind $1
Effort92: posts the ante $0.20
nobrunobru1: posts the ante $0.20
st-germ30: posts the ante $0.20
DUkalisUA: posts the ante $0.20
matiko09: posts the ante $0.20
ardo888: posts the ante $0.20
JimineyCrik: posts the ante $0.20
$-Twackle-$: posts the ante $0.20
oxfordtenzin: posts the ante $0.20
*** HOLE CARDS ***
Dealt to matiko09 [8d Js]
matiko09: folds 
ardo888: folds 
JimineyCrik: folds 
$-Twackle-$: folds 
oxfordtenzin: folds 
Effort92: raises $1.50 to $2.50
nobrunobru1: folds 
st-germ30: calls $2
DUkalisUA: folds 
*** FLOP *** [Ts 3c 3s]
st-germ30: checks 
Effort92: bets $3.12
st-germ30: folds 
Uncalled bet ($3.12) returned to Effort92
Effort92 collected $7.45 from pot
Effort92: doesn't show hand 
*** SUMMARY ***
Total pot $7.80 | Rake $0.35 
Board [Ts 3c 3s]
Seat 1: Effort92 collected ($7.45)
Seat 2: nobrunobru1 (button) folded before Flop (didn't bet)
Seat 3: st-germ30 (small blind) folded on the Flop
Seat 4: DUkalisUA (big blind) folded before Flop
Seat 5: matiko09 folded before Flop (didn't bet)
Seat 6: ardo888 folded before Flop (didn't bet)
Seat 7: JimineyCrik folded before Flop (didn't bet)
Seat 8: $-Twackle-$ folded before Flop (didn't bet)
Seat 9: oxfordtenzin folded before Flop (didn't bet)





PokerStars Hand #150801651535:  Hold'em No Limit ($0.25/$0.50 USD) - 2016/03/23 14:37:19 CET [2016/03/23 9:37:19 ET]
Table 'Pyrrhus' 9-max Seat #7 is the button
Seat 3: i L00K great ($50.75 in chips) 
Seat 4: GriffinBerg ($44.95 in chips) 
Seat 5: ZonTTT ($55.11 in chips) 
Seat 6: Ahangama ($50 in chips) 
Seat 7: matiko09 ($137.63 in chips) 
Seat 8: dndngod ($70.73 in chips) 
Seat 9: CvMCvMCvM ($93.52 in chips) 
dndngod: posts small blind $0.25
CvMCvMCvM: posts big blind $0.50
BSTUSim: sits out 
*** HOLE CARDS ***
Dealt to matiko09 [Td 2c]
i L00K great: folds 
GriffinBerg: folds 
ZonTTT: raises $1 to $1.50
Ahangama: raises $3 to $4.50
matiko09: folds 
dndngod: folds 
CvMCvMCvM: folds 
ZonTTT: folds 
Uncalled bet ($3) returned to Ahangama
Ahangama collected $3.75 from pot
Ahangama: doesn't show hand 
*** SUMMARY ***
Total pot $3.75 | Rake $0 
Seat 3: i L00K great folded before Flop (didn't bet)
Seat 4: GriffinBerg folded before Flop (didn't bet)
Seat 5: ZonTTT folded before Flop
Seat 6: Ahangama collected ($3.75)
Seat 7: matiko09 (button) folded before Flop (didn't bet)
Seat 8: dndngod (small blind) folded before Flop
Seat 9: CvMCvMCvM (big blind) folded before Flop





PokerStars Hand #150801658330:  Hold'em No Limit ($0.50/$1.00 USD) - 2016/03/23 14:37:30 CET [2016/03/23 9:37:30 ET]
Table 'Atlantis' 9-max Seat #6 is the button
Seat 1: xHourglass ($150.50 in chips) 
Seat 3: CAJUN890 ($133.58 in chips) 
Seat 4: matiko09 ($125.75 in chips) 
Seat 5: Pvsx. ($107.06 in chips) 
Seat 6: Jimy Tiltman ($100 in chips) 
Seat 7: Sherlockplay ($137.48 in chips) 
Seat 8: DUkalisUA ($135 in chips) 
Sherlockplay: posts small blind $0.50
DUkalisUA: posts big blind $1
RICKA16: sits out 
Szevasztopol: sits out 
*** HOLE CARDS ***
Dealt to matiko09 [6h 7s]
xHourglass: folds 
CAJUN890: folds 
matiko09: folds 
Pvsx.: raises $1.50 to $2.50
Jimy Tiltman: folds 
Sherlockplay: folds 
DUkalisUA: folds 
Uncalled bet ($1.50) returned to Pvsx.
Pvsx. collected $2.50 from pot
Pvsx.: doesn't show hand 
*** SUMMARY ***
Total pot $2.50 | Rake $0 
Seat 1: xHourglass folded before Flop (didn't bet)
Seat 3: CAJUN890 folded before Flop (didn't bet)
Seat 4: matiko09 folded before Flop (didn't bet)
Seat 5: Pvsx. collected ($2.50)
Seat 6: Jimy Tiltman (button) folded before Flop (didn't bet)
Seat 7: Sherlockplay (small blind) folded before Flop
Seat 8: DUkalisUA (big blind) folded before Flop





PokerStars Hand #150801659103:  Hold'em No Limit ($1/$2 USD) - 2016/03/23 14:37:31 CET [2016/03/23 9:37:31 ET]
Table 'Kiess' 9-max Seat #6 is the button
Seat 1: Cirilico ($265.22 in chips) 
Seat 2: DUkalisUA ($655.10 in chips) 
Seat 3: The_red_area ($321.27 in chips) 
Seat 4: Moszes360 ($200 in chips) 
Seat 5: chippo boy ($444.88 in chips) 
Seat 6: matiko09 ($263.86 in chips) 
Seat 7: InsomniaRU ($304.97 in chips) 
Seat 8: erfk1958 ($106.96 in chips) 
Seat 9: T0ny Adams ($96.74 in chips) 
InsomniaRU: posts small blind $1
erfk1958: posts big blind $2
*** HOLE CARDS ***
Dealt to matiko09 [As 8h]
T0ny Adams: folds 
Cirilico: raises $4 to $6
DUkalisUA: folds 
The_red_area: folds 
Moszes360: calls $6
chippo boy: calls $6
matiko09: folds 
InsomniaRU: folds 
erfk1958: folds 
*** FLOP *** [5c Ks 2c]
Cirilico: checks 
Moszes360: checks 
chippo boy: bets $10
Cirilico: calls $10
Moszes360: folds 
*** TURN *** [5c Ks 2c] [2d]
Cirilico: checks 
chippo boy: checks 
*** RIVER *** [5c Ks 2c 2d] [6d]
Cirilico: checks 
chippo boy: bets $22
Cirilico: calls $22
*** SHOW DOWN ***
chippo boy: shows [6c 6h] (a full house, Sixes full of Deuces)
Cirilico: mucks hand 
chippo boy collected $82.20 from pot
*** SUMMARY ***
Total pot $85 | Rake $2.80 
Board [5c Ks 2c 2d 6d]
Seat 1: Cirilico mucked [8s 8c]
Seat 2: DUkalisUA folded before Flop (didn't bet)
Seat 3: The_red_area folded before Flop (didn't bet)
Seat 4: Moszes360 folded on the Flop
Seat 5: chippo boy showed [6c 6h] and won ($82.20) with a full house, Sixes full of Deuces
Seat 6: matiko09 (button) folded before Flop (didn't bet)
Seat 7: InsomniaRU (small blind) folded before Flop
Seat 8: erfk1958 (big blind) folded before Flop
Seat 9: T0ny Adams folded before Flop (didn't bet)





PokerStars Hand #150801659088:  Hold'em No Limit ($1/$2 USD) - 2016/03/23 14:37:31 CET [2016/03/23 9:37:31 ET]
Table 'Kypria II' 9-max Seat #7 is the button
Seat 1: geldwolfje ($179.50 in chips) 
Seat 3: seouljam ($176.56 in chips) 
Seat 4: VolanDog ($221.12 in chips) 
Seat 5: InsomniaRU ($365.88 in chips) 
Seat 6: matiko09 ($368.95 in chips) 
Seat 7: DUkalisUA ($202 in chips) 
Seat 8: nickreason17 ($200 in chips) 
Seat 9: Moszes360 ($203 in chips) 
nickreason17: posts small blind $1
Moszes360: posts big blind $2
*** HOLE CARDS ***
Dealt to matiko09 [9c 3c]
geldwolfje: raises $2 to $4
seouljam: folds 
VolanDog: folds 
InsomniaRU: folds 
matiko09: folds 
DUkalisUA: folds 
nickreason17: folds 
Moszes360: folds 
Uncalled bet ($2) returned to geldwolfje
geldwolfje collected $5 from pot
geldwolfje: doesn't show hand 
*** SUMMARY ***
Total pot $5 | Rake $0 
Seat 1: geldwolfje collected ($5)
Seat 3: seouljam folded before Flop (didn't bet)
Seat 4: VolanDog folded before Flop (didn't bet)
Seat 5: InsomniaRU folded before Flop (didn't bet)
Seat 6: matiko09 folded before Flop (didn't bet)
Seat 7: DUkalisUA (button) folded before Flop (didn't bet)
Seat 8: nickreason17 (small blind) folded before Flop
Seat 9: Moszes360 (big blind) folded before Flop





PokerStars Hand #150801663737:  Hold'em No Limit ($0.50/$1.00 USD) - 2016/03/23 14:37:38 CET [2016/03/23 9:37:38 ET]
Table 'Swings' 9-max Seat #9 is the button
Seat 1: Sherlockplay ($100.50 in chips) 
Seat 2: Harbinger X ($188.64 in chips) 
Seat 3: maxxmeister ($116.54 in chips) 
Seat 4: chaps1988 ($102.60 in chips) 
Seat 5: chautinhtri9 ($100 in chips) 
Seat 6: matiko09 ($104.57 in chips) 
Seat 8: RICKA16 ($100 in chips) 
Seat 9: Vlad_1965_77 ($107.55 in chips) 
Sherlockplay: posts small blind $0.50
Harbinger X: posts big blind $1
*** HOLE CARDS ***
Dealt to matiko09 [Kh 8c]
maxxmeister: folds 
chaps1988: folds 
chautinhtri9: folds 
matiko09: folds 
RICKA16: raises $2 to $3
Vlad_1965_77: folds 
Sherlockplay: folds 
Harbinger X: folds 
Uncalled bet ($2) returned to RICKA16
RICKA16 collected $2.50 from pot
RICKA16: doesn't show hand 
*** SUMMARY ***
Total pot $2.50 | Rake $0 
Seat 1: Sherlockplay (small blind) folded before Flop
Seat 2: Harbinger X (big blind) folded before Flop
Seat 3: maxxmeister folded before Flop (didn't bet)
Seat 4: chaps1988 folded before Flop (didn't bet)
Seat 5: chautinhtri9 folded before Flop (didn't bet)
Seat 6: matiko09 folded before Flop (didn't bet)
Seat 8: RICKA16 collected ($2.50)
Seat 9: Vlad_1965_77 (button) folded before Flop (didn't bet)





PokerStars Hand #150801663536:  Hold'em No Limit ($1/$2 USD) - 2016/03/23 14:37:38 CET [2016/03/23 9:37:38 ET]
Table 'Achaia' 9-max Seat #4 is the button
Seat 1: Moszes360 ($226.36 in chips) 
Seat 2: InsomniaRU ($224.44 in chips) 
Seat 3: matiko09 ($234.20 in chips) 
Seat 4: erfk1958 ($119 in chips) 
Seat 5: chaps1988 ($200 in chips) 
Seat 6: nickreason17 ($200.14 in chips) 
Seat 7: morosun ($139.88 in chips) 
Seat 8: $-Twackle-$ ($225.07 in chips) 
Seat 9: glanza_mike ($200 in chips) 
chaps1988: posts small blind $1
nickreason17: posts big blind $2
*** HOLE CARDS ***
Dealt to matiko09 [2h Ts]
morosun: raises $4 to $6
$-Twackle-$: folds 
glanza_mike: folds 
Moszes360: folds 
InsomniaRU: folds 
matiko09: folds 
erfk1958: folds 
chaps1988: folds 
nickreason17: calls $4
*** FLOP *** [Td 4s 5c]
nickreason17: checks 
morosun: bets $6.21
nickreason17: calls $6.21
*** TURN *** [Td 4s 5c] [Qs]
nickreason17: checks 
morosun: bets $12.14
nickreason17: folds 
Uncalled bet ($12.14) returned to morosun
morosun collected $24.28 from pot
*** SUMMARY ***
Total pot $25.42 | Rake $1.14 
Board [Td 4s 5c Qs]
Seat 1: Moszes360 folded before Flop (didn't bet)
Seat 2: InsomniaRU folded before Flop (didn't bet)
Seat 3: matiko09 folded before Flop (didn't bet)
Seat 4: erfk1958 (button) folded before Flop (didn't bet)
Seat 5: chaps1988 (small blind) folded before Flop
Seat 6: nickreason17 (big blind) folded on the Turn
Seat 7: morosun collected ($24.28)
Seat 8: $-Twackle-$ folded before Flop (didn't bet)
Seat 9: glanza_mike folded before Flop (didn't bet)





PokerStars Hand #150801665886:  Hold'em No Limit ($1/$2 USD) - 2016/03/23 14:37:41 CET [2016/03/23 9:37:41 ET]
Table 'Ennomos II' 9-max Seat #3 is the button
Seat 1: InsomniaRU ($200 in chips) 
Seat 2: Subam ($203.38 in chips) 
Seat 3: $-Twackle-$ ($228.20 in chips) 
Seat 4: glanza_mike ($200 in chips) 
Seat 5: South011 ($394.02 in chips) 
Seat 6: nickreason17 ($364.60 in chips) 
Seat 8: yyfk ($200.24 in chips) 
Seat 9: matiko09 ($340.52 in chips) 
glanza_mike: posts small blind $1
South011: posts big blind $2
T0ny Adams: sits out 
*** HOLE CARDS ***
Dealt to matiko09 [Jd Kc]
nickreason17: raises $4 to $6
yyfk: calls $6
matiko09: folds 
InsomniaRU: folds 
Subam is disconnected 
Subam has timed out while disconnected
Subam: folds 
$-Twackle-$: folds 
glanza_mike: folds 
South011: folds 
*** FLOP *** [Qd 3s 3d]
nickreason17: checks 
yyfk: bets $7.16
nickreason17: calls $7.16
*** TURN *** [Qd 3s 3d] [3c]
nickreason17: checks 
yyfk: checks 
*** RIVER *** [Qd 3s 3d 3c] [5c]
nickreason17: checks 
yyfk: bets $18.66
nickreason17: calls $18.66
*** SHOW DOWN ***
yyfk: shows [7c 7s] (a full house, Threes full of Sevens)
nickreason17: shows [9d 9c] (a full house, Threes full of Nines)
nickreason17 collected $63.84 from pot
*** SUMMARY ***
Total pot $66.64 | Rake $2.80 
Board [Qd 3s 3d 3c 5c]
Seat 1: InsomniaRU folded before Flop (didn't bet)
Seat 2: Subam folded before Flop (didn't bet)
Seat 3: $-Twackle-$ (button) folded before Flop (didn't bet)
Seat 4: glanza_mike (small blind) folded before Flop
Seat 5: South011 (big blind) folded before Flop
Seat 6: nickreason17 showed [9d 9c] and won ($63.84) with a full house, Threes full of Nines
Seat 8: yyfk showed [7c 7s] and lost with a full house, Threes full of Sevens
Seat 9: matiko09 folded before Flop (didn't bet)





PokerStars Hand #150801669232:  Hold'em No Limit ($0.50/$1.00 USD) - 2016/03/23 14:37:47 CET [2016/03/23 9:37:47 ET]
Table 'Atlantis' 9-max Seat #7 is the button
Seat 1: xHourglass ($150.50 in chips) 
Seat 3: CAJUN890 ($133.58 in chips) 
Seat 4: matiko09 ($125.75 in chips) 
Seat 5: Pvsx. ($108.56 in chips) 
Seat 6: Jimy Tiltman ($100 in chips) 
Seat 7: Sherlockplay ($136.98 in chips) 
Seat 8: DUkalisUA ($134 in chips) 
Seat 9: RICKA16 ($104.16 in chips) 
DUkalisUA: posts small blind $0.50
RICKA16: posts big blind $1
Szevasztopol: sits out 
*** HOLE CARDS ***
Dealt to matiko09 [7c Ts]
xHourglass: folds 
CAJUN890: raises $2 to $3
matiko09: folds 
Pvsx.: folds 
Jimy Tiltman: folds 
Sherlockplay: folds 
DUkalisUA: folds 
RICKA16: folds 
Uncalled bet ($2) returned to CAJUN890
CAJUN890 collected $2.50 from pot
CAJUN890: doesn't show hand 
*** SUMMARY ***
Total pot $2.50 | Rake $0 
Seat 1: xHourglass folded before Flop (didn't bet)
Seat 3: CAJUN890 collected ($2.50)
Seat 4: matiko09 folded before Flop (didn't bet)
Seat 5: Pvsx. folded before Flop (didn't bet)
Seat 6: Jimy Tiltman folded before Flop (didn't bet)
Seat 7: Sherlockplay (button) folded before Flop (didn't bet)
Seat 8: DUkalisUA (small blind) folded before Flop
Seat 9: RICKA16 (big blind) folded before Flop





PokerStars Hand #150801680429:  Hold'em No Limit ($0.25/$0.50 USD) - 2016/03/23 14:38:04 CET [2016/03/23 9:38:04 ET]
Table 'Pyrrhus' 9-max Seat #8 is the button
Seat 2: BSTUSim ($50 in chips) 
Seat 3: i L00K great ($50.75 in chips) 
Seat 4: GriffinBerg ($44.95 in chips) 
Seat 5: ZonTTT ($53.61 in chips) 
Seat 6: Ahangama ($52.25 in chips) 
Seat 7: matiko09 ($137.63 in chips) 
Seat 8: dndngod ($70.48 in chips) 
Seat 9: CvMCvMCvM ($93.02 in chips) 
CvMCvMCvM: posts small blind $0.25
BSTUSim: posts big blind $0.50
*** HOLE CARDS ***
Dealt to matiko09 [3c 2d]
i L00K great: folds 
GriffinBerg: calls $0.50
ZonTTT: folds 
Ahangama: raises $1.50 to $2
matiko09: folds 
dndngod: folds 
CvMCvMCvM: folds 
BSTUSim: calls $1.50
GriffinBerg: folds 
*** FLOP *** [Jh 3h 3d]
BSTUSim: checks 
Ahangama: bets $3
BSTUSim: calls $3
*** TURN *** [Jh 3h 3d] [8d]
BSTUSim: checks 
Ahangama: bets $7
BSTUSim: calls $7
*** RIVER *** [Jh 3h 3d 8d] [5h]
BSTUSim: checks 
Ahangama: bets $14
BSTUSim: raises $24 to $38 and is all-in
Ahangama: folds 
Uncalled bet ($24) returned to BSTUSim
BSTUSim collected $50.38 from pot
BSTUSim: doesn't show hand 
*** SUMMARY ***
Total pot $52.75 | Rake $2.37 
Board [Jh 3h 3d 8d 5h]
Seat 2: BSTUSim (big blind) collected ($50.38)
Seat 3: i L00K great folded before Flop (didn't bet)
Seat 4: GriffinBerg folded before Flop
Seat 5: ZonTTT folded before Flop (didn't bet)
Seat 6: Ahangama folded on the River
Seat 7: matiko09 folded before Flop (didn't bet)
Seat 8: dndngod (button) folded before Flop (didn't bet)
Seat 9: CvMCvMCvM (small blind) folded before Flop





PokerStars Hand #150801682960:  Hold'em No Limit ($0.50/$1.00 USD) - 2016/03/23 14:38:08 CET [2016/03/23 9:38:08 ET]
Table 'Atlantis' 9-max Seat #8 is the button
Seat 1: xHourglass ($150.50 in chips) 
Seat 3: CAJUN890 ($135.08 in chips) 
Seat 4: matiko09 ($125.75 in chips) 
Seat 5: Pvsx. ($108.56 in chips) 
Seat 6: Jimy Tiltman ($100 in chips) 
Seat 7: Sherlockplay ($136.98 in chips) 
Seat 8: DUkalisUA ($133.50 in chips) 
Seat 9: RICKA16 ($103.16 in chips) 
RICKA16: posts small blind $0.50
xHourglass: posts big blind $1
Szevasztopol: sits out 
*** HOLE CARDS ***
Dealt to matiko09 [5h Js]
CAJUN890: calls $1
matiko09: folds 
Pvsx.: folds 
Jimy Tiltman: raises $2.50 to $3.50
Sherlockplay: raises $7 to $10.50
DUkalisUA: folds 
RICKA16: folds 
xHourglass: folds 
CAJUN890: folds 
Jimy Tiltman: folds 
Uncalled bet ($7) returned to Sherlockplay
Sherlockplay collected $9.50 from pot
Sherlockplay: doesn't show hand 
*** SUMMARY ***
Total pot $9.50 | Rake $0 
Seat 1: xHourglass (big blind) folded before Flop
Seat 3: CAJUN890 folded before Flop
Seat 4: matiko09 folded before Flop (didn't bet)
Seat 5: Pvsx. folded before Flop (didn't bet)
Seat 6: Jimy Tiltman folded before Flop
Seat 7: Sherlockplay collected ($9.50)
Seat 8: DUkalisUA (button) folded before Flop (didn't bet)
Seat 9: RICKA16 (small blind) folded before Flop





PokerStars Hand #150801683134:  Hold'em No Limit ($1/$2 USD) - 2016/03/23 14:38:08 CET [2016/03/23 9:38:08 ET]
Table 'Kypria II' 9-max Seat #8 is the button
Seat 1: geldwolfje ($182.50 in chips) 
Seat 3: seouljam ($176.56 in chips) 
Seat 4: VolanDog ($221.12 in chips) 
Seat 5: InsomniaRU ($365.88 in chips) 
Seat 6: matiko09 ($368.95 in chips) 
Seat 7: DUkalisUA ($202 in chips) 
Seat 8: nickreason17 ($200 in chips) 
Seat 9: Moszes360 ($201 in chips) 
Moszes360: posts small blind $1
geldwolfje: posts big blind $2
*** HOLE CARDS ***
Dealt to matiko09 [8s 8h]
seouljam: folds 
VolanDog: folds 
InsomniaRU: raises $3 to $5
matiko09: calls $5
DUkalisUA: folds 
nickreason17: folds 
Moszes360: folds 
geldwolfje: calls $3
*** FLOP *** [8d 2h Td]
geldwolfje: checks 
InsomniaRU: bets $10.24
matiko09: calls $10.24
geldwolfje: calls $10.24
*** TURN *** [8d 2h Td] [6h]
geldwolfje: checks 
InsomniaRU: bets $29.90
matiko09: calls $29.90
geldwolfje: folds 
*** RIVER *** [8d 2h Td 6h] [9d]
InsomniaRU: checks 
matiko09: checks 
*** SHOW DOWN ***
InsomniaRU: shows [Jh 9h] (a pair of Nines)
matiko09: shows [8s 8h] (three of a kind, Eights)
matiko09 collected $103.72 from pot
*** SUMMARY ***
Total pot $106.52 | Rake $2.80 
Board [8d 2h Td 6h 9d]
Seat 1: geldwolfje (big blind) folded on the Turn
Seat 3: seouljam folded before Flop (didn't bet)
Seat 4: VolanDog folded before Flop (didn't bet)
Seat 5: InsomniaRU showed [Jh 9h] and lost with a pair of Nines
Seat 6: matiko09 showed [8s 8h] and won ($103.72) with three of a kind, Eights
Seat 7: DUkalisUA folded before Flop (didn't bet)
Seat 8: nickreason17 (button) folded before Flop (didn't bet)
Seat 9: Moszes360 (small blind) folded before Flop





PokerStars Hand #150801687323:  Hold'em No Limit ($0.50/$1.00 USD) - 2016/03/23 14:38:15 CET [2016/03/23 9:38:15 ET]
Table 'Donar II' 9-max Seat #3 is the button
Seat 1: Effort92 ($122.17 in chips) 
Seat 2: nobrunobru1 ($42.24 in chips) 
Seat 3: st-germ30 ($93.19 in chips) 
Seat 4: DUkalisUA ($162.14 in chips) 
Seat 5: matiko09 ($100.27 in chips) 
Seat 6: ardo888 ($132.18 in chips) 
Seat 7: JimineyCrik ($102.58 in chips) 
Seat 8: $-Twackle-$ ($126.60 in chips) 
Seat 9: oxfordtenzin ($88.10 in chips) 
DUkalisUA: posts small blind $0.50
matiko09: posts big blind $1
Effort92: posts the ante $0.20
nobrunobru1: posts the ante $0.20
st-germ30: posts the ante $0.20
DUkalisUA: posts the ante $0.20
matiko09: posts the ante $0.20
ardo888: posts the ante $0.20
JimineyCrik: posts the ante $0.20
$-Twackle-$: posts the ante $0.20
oxfordtenzin: posts the ante $0.20
*** HOLE CARDS ***
Dealt to matiko09 [Kh 2h]
ardo888: raises $2 to $3
JimineyCrik: folds 
$-Twackle-$: folds 
oxfordtenzin: raises $5 to $8
Effort92: folds 
nobrunobru1: folds 
st-germ30: folds 
DUkalisUA: folds 
matiko09: folds 
ardo888: calls $5
*** FLOP *** [9s Ad 2d]
ardo888: checks 
oxfordtenzin: checks 
*** TURN *** [9s Ad 2d] [Jd]
ardo888: bets $13.45
oxfordtenzin: calls $13.45
*** RIVER *** [9s Ad 2d Jd] [Qc]
ardo888: bets $24.50
oxfordtenzin: calls $24.50
*** SHOW DOWN ***
ardo888: shows [As Qd] (two pair, Aces and Queens)
oxfordtenzin: mucks hand 
ardo888 collected $92.40 from pot
*** SUMMARY ***
Total pot $95.20 | Rake $2.80 
Board [9s Ad 2d Jd Qc]
Seat 1: Effort92 folded before Flop (didn't bet)
Seat 2: nobrunobru1 folded before Flop (didn't bet)
Seat 3: st-germ30 (button) folded before Flop (didn't bet)
Seat 4: DUkalisUA (small blind) folded before Flop
Seat 5: matiko09 (big blind) folded before Flop
Seat 6: ardo888 showed [As Qd] and won ($92.40) with two pair, Aces and Queens
Seat 7: JimineyCrik folded before Flop (didn't bet)
Seat 8: $-Twackle-$ folded before Flop (didn't bet)
Seat 9: oxfordtenzin mucked [Ah Jc]





PokerStars Hand #150801688694:  Hold'em No Limit ($1/$2 USD) - 2016/03/23 14:38:17 CET [2016/03/23 9:38:17 ET]
Table 'Achaia' 9-max Seat #5 is the button
Seat 1: Moszes360 ($226.36 in chips) 
Seat 2: InsomniaRU ($224.44 in chips) 
Seat 3: matiko09 ($234.20 in chips) 
Seat 4: erfk1958 ($119 in chips) 
Seat 5: chaps1988 ($200 in chips) 
Seat 6: nickreason17 ($200 in chips) 
Seat 7: morosun ($151.95 in chips) 
Seat 8: $-Twackle-$ ($225.07 in chips) 
Seat 9: glanza_mike ($200 in chips) 
nickreason17: posts small blind $1
morosun: posts big blind $2
*** HOLE CARDS ***
Dealt to matiko09 [9s Ts]
$-Twackle-$: folds 
glanza_mike: folds 
Moszes360: folds 
InsomniaRU: folds 
matiko09: raises $3 to $5
erfk1958: folds 
chaps1988: calls $5
nickreason17: folds 
morosun: folds 
*** FLOP *** [4h 4c 9c]
matiko09: bets $8
chaps1988: raises $16 to $24
matiko09: folds 
Uncalled bet ($16) returned to chaps1988
chaps1988 collected $27.70 from pot
chaps1988: doesn't show hand 
*** SUMMARY ***
Total pot $29 | Rake $1.30 
Board [4h 4c 9c]
Seat 1: Moszes360 folded before Flop (didn't bet)
Seat 2: InsomniaRU folded before Flop (didn't bet)
Seat 3: matiko09 folded on the Flop
Seat 4: erfk1958 folded before Flop (didn't bet)
Seat 5: chaps1988 (button) collected ($27.70)
Seat 6: nickreason17 (small blind) folded before Flop
Seat 7: morosun (big blind) folded before Flop
Seat 8: $-Twackle-$ folded before Flop (didn't bet)
Seat 9: glanza_mike folded before Flop (didn't bet)





PokerStars Hand #150801693814:  Hold'em No Limit ($0.50/$1.00 USD) - 2016/03/23 14:38:25 CET [2016/03/23 9:38:25 ET]
Table 'Swings' 9-max Seat #1 is the button
Seat 1: Sherlockplay ($100 in chips) 
Seat 2: Harbinger X ($187.64 in chips) 
Seat 3: maxxmeister ($116.54 in chips) 
Seat 4: chaps1988 ($102.60 in chips) 
Seat 5: chautinhtri9 ($100 in chips) 
Seat 6: matiko09 ($104.57 in chips) 
Seat 8: RICKA16 ($101.50 in chips) 
Seat 9: Vlad_1965_77 ($107.55 in chips) 
Harbinger X: posts small blind $0.50
maxxmeister: posts big blind $1
*** HOLE CARDS ***
Dealt to matiko09 [9c 9h]
o.miro joins the table at seat #7 
chaps1988: folds 
chautinhtri9: folds 
matiko09: raises $2 to $3
RICKA16: calls $3
Vlad_1965_77: folds 
Sherlockplay: folds 
Harbinger X: folds 
o.miro leaves the table
maxxmeister: calls $2
*** FLOP *** [2h 7s Kc]
maxxmeister: checks 
PacPacBum joins the table at seat #7 
matiko09: checks 
RICKA16: bets $6
maxxmeister: folds 
matiko09: calls $6
*** TURN *** [2h 7s Kc] [9s]
matiko09: checks 
RICKA16: checks 
*** RIVER *** [2h 7s Kc 9s] [8c]
matiko09: bets $13
RICKA16: calls $13
*** SHOW DOWN ***
matiko09: shows [9c 9h] (three of a kind, Nines)
RICKA16: mucks hand 
matiko09 collected $45.36 from pot
*** SUMMARY ***
Total pot $47.50 | Rake $2.14 
Board [2h 7s Kc 9s 8c]
Seat 1: Sherlockplay (button) folded before Flop (didn't bet)
Seat 2: Harbinger X (small blind) folded before Flop
Seat 3: maxxmeister (big blind) folded on the Flop
Seat 4: chaps1988 folded before Flop (didn't bet)
Seat 5: chautinhtri9 folded before Flop (didn't bet)
Seat 6: matiko09 showed [9c 9h] and won ($45.36) with three of a kind, Nines
Seat 8: RICKA16 mucked [Kd Ac]
Seat 9: Vlad_1965_77 folded before Flop (didn't bet)





PokerStars Hand #150801694784:  Hold'em No Limit ($1/$2 USD) - 2016/03/23 14:38:27 CET [2016/03/23 9:38:27 ET]
Table 'Herba II' 9-max Seat #3 is the button
Seat 1: matiko09 ($226.62 in chips) 
Seat 2: Moszes360 ($203.17 in chips) 
Seat 3: Cirilico ($184.84 in chips) 
Seat 4: DUkalisUA ($259.20 in chips) 
Seat 5: chippo boy ($238.13 in chips) 
Seat 6: Too-Anti-To ($209.46 in chips) 
Seat 7: InsomniaRU ($403.20 in chips) 
Seat 8: The_red_area ($393.98 in chips) 
Seat 9: mrhighryza ($66.27 in chips) 
DUkalisUA: posts small blind $1
chippo boy: posts big blind $2
*** HOLE CARDS ***
Dealt to matiko09 [2s Qc]
Too-Anti-To: folds 
InsomniaRU: folds 
The_red_area: folds 
mrhighryza: folds 
matiko09: folds 
Moszes360: folds 
Cirilico: raises $3 to $5
DUkalisUA: folds 
chippo boy: raises $9 to $14
Cirilico: folds 
Uncalled bet ($9) returned to chippo boy
chippo boy collected $11 from pot
*** SUMMARY ***
Total pot $11 | Rake $0 
Seat 1: matiko09 folded before Flop (didn't bet)
Seat 2: Moszes360 folded before Flop (didn't bet)
Seat 3: Cirilico (button) folded before Flop
Seat 4: DUkalisUA (small blind) folded before Flop
Seat 5: chippo boy (big blind) collected ($11)
Seat 6: Too-Anti-To folded before Flop (didn't bet)
Seat 7: InsomniaRU folded before Flop (didn't bet)
Seat 8: The_red_area folded before Flop (didn't bet)
Seat 9: mrhighryza folded before Flop (didn't bet)





PokerStars Hand #150801703264:  Hold'em No Limit ($0.50/$1.00 USD) - 2016/03/23 14:38:40 CET [2016/03/23 9:38:40 ET]
Table 'Merope II' 9-max Seat #6 is the button
Seat 1: Jimy Tiltman ($137.73 in chips) 
Seat 2: $-Twackle-$ ($101.50 in chips) 
Seat 3: pablos1922 ($89.75 in chips) 
Seat 4: YuriiSolodya ($90.34 in chips) 
Seat 5: DUkalisUA ($156.37 in chips) 
Seat 6: Effort92 ($103.71 in chips) 
Seat 7: matiko09 ($107.03 in chips) 
Seat 8: Red4erT ($40 in chips) 
matiko09: posts small blind $0.50
Red4erT: posts big blind $1
RICKA16: sits out 
*** HOLE CARDS ***
Dealt to matiko09 [Qd 4h]
Jimy Tiltman: raises $2 to $3
$-Twackle-$: folds 
pablos1922: folds 
YuriiSolodya: folds 
DUkalisUA: folds 
Effort92: folds 
matiko09: folds 
Red4erT: folds 
Uncalled bet ($2) returned to Jimy Tiltman
Jimy Tiltman collected $2.50 from pot
Jimy Tiltman: doesn't show hand 
*** SUMMARY ***
Total pot $2.50 | Rake $0 
Seat 1: Jimy Tiltman collected ($2.50)
Seat 2: $-Twackle-$ folded before Flop (didn't bet)
Seat 3: pablos1922 folded before Flop (didn't bet)
Seat 4: YuriiSolodya folded before Flop (didn't bet)
Seat 5: DUkalisUA folded before Flop (didn't bet)
Seat 6: Effort92 (button) folded before Flop (didn't bet)
Seat 7: matiko09 (small blind) folded before Flop
Seat 8: Red4erT (big blind) folded before Flop





PokerStars Hand #150801714208:  Hold'em No Limit ($0.50/$1.00 USD) - 2016/03/23 14:38:58 CET [2016/03/23 9:38:58 ET]
Table 'Atlantis' 9-max Seat #9 is the button
Seat 1: xHourglass ($149.50 in chips) 
Seat 2: Szevasztopol ($100 in chips) 
Seat 3: CAJUN890 ($134.08 in chips) 
Seat 4: matiko09 ($125.75 in chips) 
Seat 5: Pvsx. ($108.56 in chips) 
Seat 6: Jimy Tiltman ($100 in chips) 
Seat 7: Sherlockplay ($142.98 in chips) 
Seat 8: DUkalisUA ($133.50 in chips) 
Seat 9: RICKA16 ($102.66 in chips) 
xHourglass: posts small blind $0.50
Szevasztopol: posts big blind $1
*** HOLE CARDS ***
Dealt to matiko09 [Qh 7d]
CAJUN890: folds 
matiko09: folds 
Pvsx.: folds 
Jimy Tiltman: folds 
Sherlockplay: folds 
DUkalisUA: folds 
RICKA16: raises $2 to $3
xHourglass: folds 
Szevasztopol: folds 
Uncalled bet ($2) returned to RICKA16
RICKA16 collected $2.50 from pot
RICKA16: doesn't show hand 
*** SUMMARY ***
Total pot $2.50 | Rake $0 
Seat 1: xHourglass (small blind) folded before Flop
Seat 2: Szevasztopol (big blind) folded before Flop
Seat 3: CAJUN890 folded before Flop (didn't bet)
Seat 4: matiko09 folded before Flop (didn't bet)
Seat 5: Pvsx. folded before Flop (didn't bet)
Seat 6: Jimy Tiltman folded before Flop (didn't bet)
Seat 7: Sherlockplay folded before Flop (didn't bet)
Seat 8: DUkalisUA folded before Flop (didn't bet)
Seat 9: RICKA16 (button) collected ($2.50)





PokerStars Hand #150801716007:  Hold'em No Limit ($1/$2 USD) - 2016/03/23 14:39:01 CET [2016/03/23 9:39:01 ET]
Table 'Ennomos II' 9-max Seat #4 is the button
Seat 1: InsomniaRU ($200 in chips) 
Seat 2: Subam ($203.38 in chips) 
Seat 3: $-Twackle-$ ($228.20 in chips) 
Seat 4: glanza_mike ($200 in chips) 
Seat 5: South011 ($392.02 in chips) 
Seat 6: nickreason17 ($396.62 in chips) 
Seat 8: yyfk ($200 in chips) 
Seat 9: matiko09 ($340.52 in chips) 
South011: posts small blind $1
nickreason17: posts big blind $2
T0ny Adams: sits out 
*** HOLE CARDS ***
Dealt to matiko09 [3c Ad]
yyfk: folds 
matiko09: folds 
InsomniaRU: folds 
Subam: folds 
$-Twackle-$: raises $3 to $5
glanza_mike: calls $5
South011: folds 
nickreason17: folds 
*** FLOP *** [6s 3s Ah]
$-Twackle-$: bets $8
glanza_mike: folds 
Uncalled bet ($8) returned to $-Twackle-$
$-Twackle-$ collected $12.42 from pot
$-Twackle-$: doesn't show hand 
*** SUMMARY ***
Total pot $13 | Rake $0.58 
Board [6s 3s Ah]
Seat 1: InsomniaRU folded before Flop (didn't bet)
Seat 2: Subam folded before Flop (didn't bet)
Seat 3: $-Twackle-$ collected ($12.42)
Seat 4: glanza_mike (button) folded on the Flop
Seat 5: South011 (small blind) folded before Flop
Seat 6: nickreason17 (big blind) folded before Flop
Seat 8: yyfk folded before Flop (didn't bet)
Seat 9: matiko09 folded before Flop (didn't bet)





PokerStars Hand #150801722311:  Hold'em No Limit ($1/$2 USD) - 2016/03/23 14:39:10 CET [2016/03/23 9:39:10 ET]
Table 'Herba II' 9-max Seat #4 is the button
Seat 1: matiko09 ($226.62 in chips) 
Seat 2: Moszes360 ($203.17 in chips) 
Seat 3: Cirilico ($179.84 in chips) 
Seat 4: DUkalisUA ($258.20 in chips) 
Seat 5: chippo boy ($244.13 in chips) 
Seat 6: Too-Anti-To ($209.46 in chips) 
Seat 7: InsomniaRU ($403.20 in chips) 
Seat 8: The_red_area ($393.98 in chips) 
Seat 9: mrhighryza ($66.27 in chips) 
chippo boy: posts small blind $1
Too-Anti-To: posts big blind $2
*** HOLE CARDS ***
Dealt to matiko09 [Ad 9s]
InsomniaRU: folds 
The_red_area: folds 
mrhighryza has timed out
mrhighryza: folds 
matiko09: folds 
Moszes360: folds 
Cirilico: raises $4 to $6
DUkalisUA: calls $6
chippo boy: calls $5
Too-Anti-To: calls $4
*** FLOP *** [Jd 9c Td]
chippo boy: checks 
Too-Anti-To: checks 
Cirilico: checks 
DUkalisUA: checks 
*** TURN *** [Jd 9c Td] [6h]
chippo boy: checks 
Too-Anti-To: bets $13
Cirilico: folds 
DUkalisUA: folds 
chippo boy: folds 
Uncalled bet ($13) returned to Too-Anti-To
Too-Anti-To collected $22.92 from pot
Too-Anti-To: doesn't show hand 
*** SUMMARY ***
Total pot $24 | Rake $1.08 
Board [Jd 9c Td 6h]
Seat 1: matiko09 folded before Flop (didn't bet)
Seat 2: Moszes360 folded before Flop (didn't bet)
Seat 3: Cirilico folded on the Turn
Seat 4: DUkalisUA (button) folded on the Turn
Seat 5: chippo boy (small blind) folded on the Turn
Seat 6: Too-Anti-To (big blind) collected ($22.92)
Seat 7: InsomniaRU folded before Flop (didn't bet)
Seat 8: The_red_area folded before Flop (didn't bet)
Seat 9: mrhighryza folded before Flop (didn't bet)





PokerStars Hand #150801727452:  Hold'em No Limit ($0.50/$1.00 USD) - 2016/03/23 14:39:19 CET [2016/03/23 9:39:19 ET]
Table 'Merope II' 9-max Seat #7 is the button
Seat 1: Jimy Tiltman ($139.23 in chips) 
Seat 2: $-Twackle-$ ($101.50 in chips) 
Seat 3: pablos1922 ($89.75 in chips) 
Seat 4: YuriiSolodya ($90.34 in chips) 
Seat 5: DUkalisUA ($156.37 in chips) 
Seat 6: Effort92 ($103.71 in chips) 
Seat 7: matiko09 ($106.53 in chips) 
Seat 8: Red4erT ($40 in chips) 
Seat 9: RICKA16 ($100 in chips) 
Red4erT: posts small blind $0.50
RICKA16: posts big blind $1
*** HOLE CARDS ***
Dealt to matiko09 [4c 8d]
Jimy Tiltman: folds 
$-Twackle-$: folds 
pablos1922: raises $1.50 to $2.50
YuriiSolodya: folds 
DUkalisUA: folds 
Effort92: folds 
matiko09: folds 
Red4erT: folds 
RICKA16: folds 
Uncalled bet ($1.50) returned to pablos1922
pablos1922 collected $2.50 from pot
pablos1922: doesn't show hand 
*** SUMMARY ***
Total pot $2.50 | Rake $0 
Seat 1: Jimy Tiltman folded before Flop (didn't bet)
Seat 2: $-Twackle-$ folded before Flop (didn't bet)
Seat 3: pablos1922 collected ($2.50)
Seat 4: YuriiSolodya folded before Flop (didn't bet)
Seat 5: DUkalisUA folded before Flop (didn't bet)
Seat 6: Effort92 folded before Flop (didn't bet)
Seat 7: matiko09 (button) folded before Flop (didn't bet)
Seat 8: Red4erT (small blind) folded before Flop
Seat 9: RICKA16 (big blind) folded before Flop





PokerStars Hand #150801728460:  Hold'em No Limit ($1/$2 USD) - 2016/03/23 14:39:20 CET [2016/03/23 9:39:20 ET]
Table 'Kiess' 9-max Seat #7 is the button
Seat 1: Cirilico ($227.22 in chips) 
Seat 2: DUkalisUA ($655.10 in chips) 
Seat 3: The_red_area ($321.27 in chips) 
Seat 4: Moszes360 ($200 in chips) 
Seat 5: chippo boy ($489.08 in chips) 
Seat 6: matiko09 ($263.86 in chips) 
Seat 7: InsomniaRU ($303.97 in chips) 
Seat 8: erfk1958 ($104.96 in chips) 
Seat 9: T0ny Adams ($96.74 in chips) 
erfk1958: posts small blind $1
T0ny Adams: posts big blind $2
*** HOLE CARDS ***
Dealt to matiko09 [2d Jc]
Cirilico: folds 
DUkalisUA: folds 
The_red_area: folds 
Moszes360: folds 
chippo boy: calls $2
matiko09: folds 
InsomniaRU: folds 
erfk1958: calls $1
T0ny Adams: checks 
*** FLOP *** [Js 4d Ac]
erfk1958: checks 
T0ny Adams: checks 
chippo boy: bets $4
erfk1958: calls $4
T0ny Adams: folds 
*** TURN *** [Js 4d Ac] [8d]
erfk1958: checks 
chippo boy: bets $4
erfk1958: calls $4
*** RIVER *** [Js 4d Ac 8d] [5d]
erfk1958: checks 
chippo boy: bets $6
erfk1958: folds 
Uncalled bet ($6) returned to chippo boy
chippo boy collected $21.01 from pot
*** SUMMARY ***
Total pot $22 | Rake $0.99 
Board [Js 4d Ac 8d 5d]
Seat 1: Cirilico folded before Flop (didn't bet)
Seat 2: DUkalisUA folded before Flop (didn't bet)
Seat 3: The_red_area folded before Flop (didn't bet)
Seat 4: Moszes360 folded before Flop (didn't bet)
Seat 5: chippo boy collected ($21.01)
Seat 6: matiko09 folded before Flop (didn't bet)
Seat 7: InsomniaRU (button) folded before Flop (didn't bet)
Seat 8: erfk1958 (small blind) folded on the River
Seat 9: T0ny Adams (big blind) folded on the Flop





PokerStars Hand #150801730613:  Hold'em No Limit ($1/$2 USD) - 2016/03/23 14:39:24 CET [2016/03/23 9:39:24 ET]
Table 'Kypria II' 9-max Seat #9 is the button
Seat 1: geldwolfje ($167.26 in chips) 
Seat 3: seouljam ($176.56 in chips) 
Seat 4: VolanDog ($221.12 in chips) 
Seat 5: InsomniaRU ($320.74 in chips) 
Seat 6: matiko09 ($427.53 in chips) 
Seat 7: DUkalisUA ($202 in chips) 
Seat 8: nickreason17 ($200 in chips) 
Seat 9: Moszes360 ($200 in chips) 
geldwolfje: posts small blind $1
seouljam: posts big blind $2
*** HOLE CARDS ***
Dealt to matiko09 [Ts 9c]
VolanDog: folds 
InsomniaRU: raises $4 to $6
matiko09: folds 
DUkalisUA: folds 
nickreason17: folds 
Moszes360: folds 
geldwolfje: calls $5
seouljam: folds 
*** FLOP *** [5h 8s 4d]
geldwolfje: checks 
InsomniaRU: checks 
*** TURN *** [5h 8s 4d] [3d]
geldwolfje: bets $8
InsomniaRU: folds 
Uncalled bet ($8) returned to geldwolfje
geldwolfje collected $13.37 from pot
geldwolfje: doesn't show hand 
*** SUMMARY ***
Total pot $14 | Rake $0.63 
Board [5h 8s 4d 3d]
Seat 1: geldwolfje (small blind) collected ($13.37)
Seat 3: seouljam (big blind) folded before Flop
Seat 4: VolanDog folded before Flop (didn't bet)
Seat 5: InsomniaRU folded on the Turn
Seat 6: matiko09 folded before Flop (didn't bet)
Seat 7: DUkalisUA folded before Flop (didn't bet)
Seat 8: nickreason17 folded before Flop (didn't bet)
Seat 9: Moszes360 (button) folded before Flop (didn't bet)





PokerStars Hand #150801735213:  Hold'em No Limit ($1/$2 USD) - 2016/03/23 14:39:31 CET [2016/03/23 9:39:31 ET]
Table 'Achaia' 9-max Seat #6 is the button
Seat 1: Moszes360 ($226.36 in chips) 
Seat 2: InsomniaRU ($224.44 in chips) 
Seat 3: matiko09 ($221.20 in chips) 
Seat 4: erfk1958 ($119 in chips) 
Seat 5: chaps1988 ($214.70 in chips) 
Seat 6: nickreason17 ($200 in chips) 
Seat 7: morosun ($149.95 in chips) 
Seat 8: $-Twackle-$ ($225.07 in chips) 
Seat 9: glanza_mike ($200 in chips) 
morosun: posts small blind $1
$-Twackle-$: posts big blind $2
*** HOLE CARDS ***
Dealt to matiko09 [5h 2s]
glanza_mike: folds 
Moszes360: folds 
InsomniaRU: folds 
matiko09: folds 
erfk1958: folds 
chaps1988: folds 
nickreason17: raises $2.08 to $4.08
morosun: calls $3.08
$-Twackle-$: folds 
*** FLOP *** [Kc Ts 7d]
morosun: bets $2
nickreason17: raises $5 to $7
morosun: calls $5
*** TURN *** [Kc Ts 7d] [As]
morosun: checks 
nickreason17: checks 
*** RIVER *** [Kc Ts 7d As] [3d]
morosun: checks 
nickreason17: checks 
*** SHOW DOWN ***
morosun: shows [7h 6s] (a pair of Sevens)
nickreason17: shows [8h Kd] (a pair of Kings)
nickreason17 collected $23.07 from pot
*** SUMMARY ***
Total pot $24.16 | Rake $1.09 
Board [Kc Ts 7d As 3d]
Seat 1: Moszes360 folded before Flop (didn't bet)
Seat 2: InsomniaRU folded before Flop (didn't bet)
Seat 3: matiko09 folded before Flop (didn't bet)
Seat 4: erfk1958 folded before Flop (didn't bet)
Seat 5: chaps1988 folded before Flop (didn't bet)
Seat 6: nickreason17 (button) showed [8h Kd] and won ($23.07) with a pair of Kings
Seat 7: morosun (small blind) showed [7h 6s] and lost with a pair of Sevens
Seat 8: $-Twackle-$ (big blind) folded before Flop
Seat 9: glanza_mike folded before Flop (didn't bet)





PokerStars Hand #150801736714:  Hold'em No Limit ($0.50/$1.00 USD) - 2016/03/23 14:39:33 CET [2016/03/23 9:39:33 ET]
Table 'Donar II' 9-max Seat #4 is the button
Seat 1: Effort92 ($121.97 in chips) 
Seat 2: nobrunobru1 ($42.04 in chips) 
Seat 3: st-germ30 ($100 in chips) 
Seat 4: DUkalisUA ($161.44 in chips) 
Seat 5: matiko09 ($100 in chips) 
Seat 6: ardo888 ($178.43 in chips) 
Seat 7: JimineyCrik ($102.38 in chips) 
Seat 8: $-Twackle-$ ($126.40 in chips) 
Seat 9: oxfordtenzin ($41.95 in chips) 
matiko09: posts small blind $0.50
ardo888: posts big blind $1
Effort92: posts the ante $0.20
nobrunobru1: posts the ante $0.20
st-germ30: posts the ante $0.20
DUkalisUA: posts the ante $0.20
matiko09: posts the ante $0.20
ardo888: posts the ante $0.20
JimineyCrik: posts the ante $0.20
$-Twackle-$: posts the ante $0.20
oxfordtenzin: posts the ante $0.20
*** HOLE CARDS ***
Dealt to matiko09 [7s Qc]
JimineyCrik: folds 
$-Twackle-$: folds 
oxfordtenzin: folds 
Effort92: folds 
nobrunobru1: folds 
st-germ30: folds 
DUkalisUA: folds 
matiko09: raises $2 to $3
ardo888: folds 
Uncalled bet ($2) returned to matiko09
matiko09 collected $3.80 from pot
matiko09: doesn't show hand 
*** SUMMARY ***
Total pot $3.80 | Rake $0 
Seat 1: Effort92 folded before Flop (didn't bet)
Seat 2: nobrunobru1 folded before Flop (didn't bet)
Seat 3: st-germ30 folded before Flop (didn't bet)
Seat 4: DUkalisUA (button) folded before Flop (didn't bet)
Seat 5: matiko09 (small blind) collected ($3.80)
Seat 6: ardo888 (big blind) folded before Flop
Seat 7: JimineyCrik folded before Flop (didn't bet)
Seat 8: $-Twackle-$ folded before Flop (didn't bet)
Seat 9: oxfordtenzin folded before Flop (didn't bet)





PokerStars Hand #150801745955:  Hold'em No Limit ($1/$2 USD) - 2016/03/23 14:39:48 CET [2016/03/23 9:39:48 ET]
Table 'Ennomos II' 9-max Seat #5 is the button
Seat 1: InsomniaRU ($200 in chips) 
Seat 2: Subam ($203.38 in chips) 
Seat 3: $-Twackle-$ ($235.62 in chips) 
Seat 4: glanza_mike ($200 in chips) 
Seat 5: South011 ($391.02 in chips) 
Seat 6: nickreason17 ($394.62 in chips) 
Seat 7: T0ny Adams ($80 in chips) 
Seat 8: yyfk ($200 in chips) 
Seat 9: matiko09 ($340.52 in chips) 
nickreason17: posts small blind $1
T0ny Adams: posts big blind $2
*** HOLE CARDS ***
Dealt to matiko09 [Qs Qh]
yyfk: folds 
matiko09: raises $3 to $5
InsomniaRU: folds 
Subam: folds 
$-Twackle-$: folds 
glanza_mike: calls $5
South011: folds 
nickreason17: folds 
T0ny Adams: folds 
*** FLOP *** [Kc As 4c]
matiko09: checks 
glanza_mike: checks 
*** TURN *** [Kc As 4c] [Jh]
matiko09: checks 
glanza_mike: checks 
*** RIVER *** [Kc As 4c Jh] [7h]
matiko09: checks 
glanza_mike: checks 
*** SHOW DOWN ***
matiko09: shows [Qs Qh] (a pair of Queens)
glanza_mike: mucks hand 
matiko09 collected $12.42 from pot
*** SUMMARY ***
Total pot $13 | Rake $0.58 
Board [Kc As 4c Jh 7h]
Seat 1: InsomniaRU folded before Flop (didn't bet)
Seat 2: Subam folded before Flop (didn't bet)
Seat 3: $-Twackle-$ folded before Flop (didn't bet)
Seat 4: glanza_mike mucked [5s 5d]
Seat 5: South011 (button) folded before Flop (didn't bet)
Seat 6: nickreason17 (small blind) folded before Flop
Seat 7: T0ny Adams (big blind) folded before Flop
Seat 8: yyfk folded before Flop (didn't bet)
Seat 9: matiko09 showed [Qs Qh] and won ($12.42) with a pair of Queens





PokerStars Hand #150801746405:  Hold'em No Limit ($0.50/$1.00 USD) - 2016/03/23 14:39:49 CET [2016/03/23 9:39:49 ET]
Table 'Atlantis' 9-max Seat #1 is the button
Seat 1: xHourglass ($149 in chips) 
Seat 2: Szevasztopol ($100 in chips) 
Seat 3: CAJUN890 ($134.08 in chips) 
Seat 4: matiko09 ($125.75 in chips) 
Seat 5: Pvsx. ($108.56 in chips) 
Seat 6: Jimy Tiltman ($100 in chips) 
Seat 7: Sherlockplay ($142.98 in chips) 
Seat 8: DUkalisUA ($133.50 in chips) 
Seat 9: RICKA16 ($104.16 in chips) 
Szevasztopol: posts small blind $0.50
CAJUN890: posts big blind $1
*** HOLE CARDS ***
Dealt to matiko09 [Jd Kc]
matiko09: folds 
Pvsx.: folds 
Jimy Tiltman: raises $2 to $3
Sherlockplay: folds 
DUkalisUA: folds 
RICKA16: folds 
xHourglass: folds 
Szevasztopol: folds 
CAJUN890: folds 
Uncalled bet ($2) returned to Jimy Tiltman
Jimy Tiltman collected $2.50 from pot
Jimy Tiltman: doesn't show hand 
*** SUMMARY ***
Total pot $2.50 | Rake $0 
Seat 1: xHourglass (button) folded before Flop (didn't bet)
Seat 2: Szevasztopol (small blind) folded before Flop
Seat 3: CAJUN890 (big blind) folded before Flop
Seat 4: matiko09 folded before Flop (didn't bet)
Seat 5: Pvsx. folded before Flop (didn't bet)
Seat 6: Jimy Tiltman collected ($2.50)
Seat 7: Sherlockplay folded before Flop (didn't bet)
Seat 8: DUkalisUA folded before Flop (didn't bet)
Seat 9: RICKA16 folded before Flop (didn't bet)





PokerStars Hand #150801751771:  Hold'em No Limit ($0.25/$0.50 USD) - 2016/03/23 14:39:57 CET [2016/03/23 9:39:57 ET]
Table 'Pyrrhus' 9-max Seat #9 is the button
Seat 2: BSTUSim ($74.38 in chips) 
Seat 3: i L00K great ($50.75 in chips) 
Seat 4: GriffinBerg ($44.45 in chips) 
Seat 5: ZonTTT ($53.61 in chips) 
Seat 6: Ahangama ($50 in chips) 
Seat 7: matiko09 ($137.63 in chips) 
Seat 8: dndngod ($70.48 in chips) 
Seat 9: CvMCvMCvM ($92.77 in chips) 
BSTUSim: posts small blind $0.25
i L00K great: posts big blind $0.50
*** HOLE CARDS ***
Dealt to matiko09 [9s Td]
GriffinBerg: raises $1 to $1.50
ZonTTT: folds 
Ahangama: folds 
matiko09: folds 
dndngod: folds 
CvMCvMCvM: folds 
BSTUSim: folds 
i L00K great: folds 
Uncalled bet ($1) returned to GriffinBerg
GriffinBerg collected $1.25 from pot
*** SUMMARY ***
Total pot $1.25 | Rake $0 
Seat 2: BSTUSim (small blind) folded before Flop
Seat 3: i L00K great (big blind) folded before Flop
Seat 4: GriffinBerg collected ($1.25)
Seat 5: ZonTTT folded before Flop (didn't bet)
Seat 6: Ahangama folded before Flop (didn't bet)
Seat 7: matiko09 folded before Flop (didn't bet)
Seat 8: dndngod folded before Flop (didn't bet)
Seat 9: CvMCvMCvM (button) folded before Flop (didn't bet)





PokerStars Hand #150801752467:  Hold'em No Limit ($0.50/$1.00 USD) - 2016/03/23 14:39:58 CET [2016/03/23 9:39:58 ET]
Table 'Swings' 9-max Seat #2 is the button
Seat 1: Sherlockplay ($100 in chips) 
Seat 2: Harbinger X ($187.14 in chips) 
Seat 3: maxxmeister ($113.54 in chips) 
Seat 4: chaps1988 ($102.60 in chips) 
Seat 5: chautinhtri9 ($100 in chips) 
Seat 6: matiko09 ($127.93 in chips) 
Seat 8: RICKA16 ($79.50 in chips) 
Seat 9: Vlad_1965_77 ($107.55 in chips) 
maxxmeister: posts small blind $0.50
chaps1988: posts big blind $1
PacPacBum: sits out 
*** HOLE CARDS ***
Dealt to matiko09 [5c 9c]
chautinhtri9: folds 
matiko09: folds 
RICKA16: folds 
Vlad_1965_77: folds 
Sherlockplay: folds 
Harbinger X: folds 
maxxmeister: raises $2.50 to $3.50
chaps1988: calls $2.50
*** FLOP *** [2h Js Qs]
maxxmeister: checks 
chaps1988: checks 
*** TURN *** [2h Js Qs] [2d]
maxxmeister: bets $5
chaps1988: calls $5
*** RIVER *** [2h Js Qs 2d] [6h]
maxxmeister: bets $16
chaps1988: folds 
Uncalled bet ($16) returned to maxxmeister
maxxmeister collected $16.24 from pot
maxxmeister: doesn't show hand 
*** SUMMARY ***
Total pot $17 | Rake $0.76 
Board [2h Js Qs 2d 6h]
Seat 1: Sherlockplay folded before Flop (didn't bet)
Seat 2: Harbinger X (button) folded before Flop (didn't bet)
Seat 3: maxxmeister (small blind) collected ($16.24)
Seat 4: chaps1988 (big blind) folded on the River
Seat 5: chautinhtri9 folded before Flop (didn't bet)
Seat 6: matiko09 folded before Flop (didn't bet)
Seat 8: RICKA16 folded before Flop (didn't bet)
Seat 9: Vlad_1965_77 folded before Flop (didn't bet)





PokerStars Hand #150801756338:  Hold'em No Limit ($0.50/$1.00 USD) - 2016/03/23 14:40:04 CET [2016/03/23 9:40:04 ET]
Table 'Merope II' 9-max Seat #8 is the button
Seat 1: Jimy Tiltman ($139.23 in chips) 
Seat 2: $-Twackle-$ ($101.50 in chips) 
Seat 3: pablos1922 ($91.25 in chips) 
Seat 4: YuriiSolodya ($90.34 in chips) 
Seat 5: DUkalisUA ($156.37 in chips) 
Seat 6: Effort92 ($103.71 in chips) 
Seat 7: matiko09 ($106.53 in chips) 
Seat 8: Red4erT ($40 in chips) 
Seat 9: RICKA16 ($99 in chips) 
RICKA16: posts small blind $0.50
Jimy Tiltman: posts big blind $1
*** HOLE CARDS ***
Dealt to matiko09 [Th 6d]
$-Twackle-$: folds 
pablos1922: folds 
YuriiSolodya: folds 
DUkalisUA: raises $2 to $3
Effort92: folds 
matiko09: folds 
Red4erT: folds 
RICKA16: folds 
Jimy Tiltman: folds 
Uncalled bet ($2) returned to DUkalisUA
DUkalisUA collected $2.50 from pot
DUkalisUA: doesn't show hand 
*** SUMMARY ***
Total pot $2.50 | Rake $0 
Seat 1: Jimy Tiltman (big blind) folded before Flop
Seat 2: $-Twackle-$ folded before Flop (didn't bet)
Seat 3: pablos1922 folded before Flop (didn't bet)
Seat 4: YuriiSolodya folded before Flop (didn't bet)
Seat 5: DUkalisUA collected ($2.50)
Seat 6: Effort92 folded before Flop (didn't bet)
Seat 7: matiko09 folded before Flop (didn't bet)
Seat 8: Red4erT (button) folded before Flop (didn't bet)
Seat 9: RICKA16 (small blind) folded before Flop





PokerStars Hand #150801760004:  Hold'em No Limit ($0.50/$1.00 USD) - 2016/03/23 14:40:10 CET [2016/03/23 9:40:10 ET]
Table 'Asmodeus' 9-max Seat #7 is the button
Seat 1: Jimy Tiltman ($107.50 in chips) 
Seat 2: $-Twackle-$ ($100 in chips) 
Seat 3: nickreason17 ($100 in chips) 
Seat 4: Effort92 ($102.70 in chips) 
Seat 5: chaps1988 ($100 in chips) 
Seat 7: PacPacBum ($100 in chips) 
Seat 8: KEBIN1974 ($149.78 in chips) 
Seat 9: matiko09 ($100 in chips) 
KEBIN1974: posts small blind $0.50
matiko09: posts big blind $1
Jimy Tiltman: posts the ante $0.20
$-Twackle-$: posts the ante $0.20
nickreason17: posts the ante $0.20
Effort92: posts the ante $0.20
chaps1988: posts the ante $0.20
PacPacBum: posts the ante $0.20
KEBIN1974: posts the ante $0.20
matiko09: posts the ante $0.20
*** HOLE CARDS ***
Dealt to matiko09 [2s Kd]
Jimy Tiltman: folds 
$-Twackle-$: folds 
nickreason17: folds 
Effort92: folds 
chaps1988: folds 
PacPacBum: raises $1.50 to $2.50
KEBIN1974: calls $2
matiko09: folds 
*** FLOP *** [8s Js Ad]
KEBIN1974: checks 
PacPacBum: bets $3.92
KEBIN1974: calls $3.92
*** TURN *** [8s Js Ad] [Ks]
KEBIN1974: checks 
PacPacBum: checks 
*** RIVER *** [8s Js Ad Ks] [9h]
KEBIN1974: checks 
PacPacBum: checks 
*** SHOW DOWN ***
KEBIN1974: shows [8d 6h] (a pair of Eights)
PacPacBum: shows [Ah 5d] (a pair of Aces)
PacPacBum collected $14.75 from pot
*** SUMMARY ***
Total pot $15.44 | Rake $0.69 
Board [8s Js Ad Ks 9h]
Seat 1: Jimy Tiltman folded before Flop (didn't bet)
Seat 2: $-Twackle-$ folded before Flop (didn't bet)
Seat 3: nickreason17 folded before Flop (didn't bet)
Seat 4: Effort92 folded before Flop (didn't bet)
Seat 5: chaps1988 folded before Flop (didn't bet)
Seat 7: PacPacBum (button) showed [Ah 5d] and won ($14.75) with a pair of Aces
Seat 8: KEBIN1974 (small blind) showed [8d 6h] and lost with a pair of Eights
Seat 9: matiko09 (big blind) folded before Flop





PokerStars Hand #150801763779:  Hold'em No Limit ($1/$2 USD) - 2016/03/23 14:40:16 CET [2016/03/23 9:40:16 ET]
Table 'Kypria II' 9-max Seat #1 is the button
Seat 1: geldwolfje ($174.63 in chips) 
Seat 3: seouljam ($174.56 in chips) 
Seat 4: VolanDog ($221.12 in chips) 
Seat 5: InsomniaRU ($314.74 in chips) 
Seat 6: matiko09 ($427.53 in chips) 
Seat 7: DUkalisUA ($202 in chips) 
Seat 8: nickreason17 ($200 in chips) 
Seat 9: Moszes360 ($200 in chips) 
seouljam: posts small blind $1
VolanDog: posts big blind $2
*** HOLE CARDS ***
Dealt to matiko09 [Ah 7c]
InsomniaRU: folds 
matiko09: folds 
DUkalisUA: folds 
nickreason17: folds 
Moszes360: raises $3 to $5
geldwolfje: calls $5
seouljam: folds 
VolanDog: raises $16 to $21
Moszes360: folds 
geldwolfje: folds 
Uncalled bet ($16) returned to VolanDog
VolanDog collected $16 from pot
*** SUMMARY ***
Total pot $16 | Rake $0 
Seat 1: geldwolfje (button) folded before Flop
Seat 3: seouljam (small blind) folded before Flop
Seat 4: VolanDog (big blind) collected ($16)
Seat 5: InsomniaRU folded before Flop (didn't bet)
Seat 6: matiko09 folded before Flop (didn't bet)
Seat 7: DUkalisUA folded before Flop (didn't bet)
Seat 8: nickreason17 folded before Flop (didn't bet)
Seat 9: Moszes360 folded before Flop





PokerStars Hand #150801764783:  Hold'em No Limit ($0.50/$1.00 USD) - 2016/03/23 14:40:18 CET [2016/03/23 9:40:18 ET]
Table 'Donar II' 9-max Seat #5 is the button
Seat 1: Effort92 ($121.77 in chips) 
Seat 2: nobrunobru1 ($41.84 in chips) 
Seat 3: st-germ30 ($99.80 in chips) 
Seat 4: DUkalisUA ($161.24 in chips) 
Seat 5: matiko09 ($102.60 in chips) 
Seat 6: ardo888 ($177.23 in chips) 
Seat 7: JimineyCrik ($102.18 in chips) 
Seat 8: $-Twackle-$ ($126.20 in chips) 
Seat 9: oxfordtenzin ($41.75 in chips) 
ardo888: posts small blind $0.50
JimineyCrik: posts big blind $1
Effort92: posts the ante $0.20
nobrunobru1: posts the ante $0.20
st-germ30: posts the ante $0.20
DUkalisUA: posts the ante $0.20
matiko09: posts the ante $0.20
ardo888: posts the ante $0.20
JimineyCrik: posts the ante $0.20
$-Twackle-$: posts the ante $0.20
oxfordtenzin: posts the ante $0.20
*** HOLE CARDS ***
Dealt to matiko09 [Ac Jh]
$-Twackle-$: folds 
oxfordtenzin: folds 
Effort92: folds 
nobrunobru1: calls $1
st-germ30: folds 
DUkalisUA: folds 
matiko09: raises $3 to $4
ardo888: folds 
JimineyCrik: calls $3
nobrunobru1: calls $3
*** FLOP *** [6d 9c Tc]
JimineyCrik: bets $3.55
nobrunobru1: folds 
matiko09: calls $3.55
*** TURN *** [6d 9c Tc] [Kc]
JimineyCrik: checks 
matiko09: bets $12
JimineyCrik: calls $12
*** RIVER *** [6d 9c Tc Kc] [9d]
JimineyCrik: bets $43.36
matiko09: folds 
Uncalled bet ($43.36) returned to JimineyCrik
JimineyCrik collected $43.36 from pot
JimineyCrik: doesn't show hand 
*** SUMMARY ***
Total pot $45.40 | Rake $2.04 
Board [6d 9c Tc Kc 9d]
Seat 1: Effort92 folded before Flop (didn't bet)
Seat 2: nobrunobru1 folded on the Flop
Seat 3: st-germ30 folded before Flop (didn't bet)
Seat 4: DUkalisUA folded before Flop (didn't bet)
Seat 5: matiko09 (button) folded on the River
Seat 6: ardo888 (small blind) folded before Flop
Seat 7: JimineyCrik (big blind) collected ($43.36)
Seat 8: $-Twackle-$ folded before Flop (didn't bet)
Seat 9: oxfordtenzin folded before Flop (didn't bet)





PokerStars Hand #150801766690:  Hold'em No Limit ($0.50/$1.00 USD) - 2016/03/23 14:40:21 CET [2016/03/23 9:40:21 ET]
Table 'Atlantis' 9-max Seat #2 is the button
Seat 1: xHourglass ($149 in chips) 
Seat 2: Szevasztopol ($100 in chips) 
Seat 3: CAJUN890 ($133.08 in chips) 
Seat 4: matiko09 ($125.75 in chips) 
Seat 5: Pvsx. ($108.56 in chips) 
Seat 6: Jimy Tiltman ($101.50 in chips) 
Seat 7: Sherlockplay ($142.98 in chips) 
Seat 8: DUkalisUA ($133.50 in chips) 
Seat 9: RICKA16 ($104.16 in chips) 
CAJUN890: posts small blind $0.50
matiko09: posts big blind $1
*** HOLE CARDS ***
Dealt to matiko09 [Ad 3c]
Pvsx.: folds 
Jimy Tiltman: folds 
Sherlockplay: folds 
DUkalisUA: folds 
RICKA16: folds 
xHourglass: folds 
Szevasztopol: raises $2 to $3
CAJUN890: calls $2.50
matiko09: folds 
*** FLOP *** [Kc 9h Jd]
CAJUN890: checks 
Szevasztopol: bets $5
CAJUN890: folds 
Uncalled bet ($5) returned to Szevasztopol
Szevasztopol collected $6.68 from pot
Szevasztopol: doesn't show hand 
*** SUMMARY ***
Total pot $7 | Rake $0.32 
Board [Kc 9h Jd]
Seat 1: xHourglass folded before Flop (didn't bet)
Seat 2: Szevasztopol (button) collected ($6.68)
Seat 3: CAJUN890 (small blind) folded on the Flop
Seat 4: matiko09 (big blind) folded before Flop
Seat 5: Pvsx. folded before Flop (didn't bet)
Seat 6: Jimy Tiltman folded before Flop (didn't bet)
Seat 7: Sherlockplay folded before Flop (didn't bet)
Seat 8: DUkalisUA folded before Flop (didn't bet)
Seat 9: RICKA16 folded before Flop (didn't bet)





PokerStars Hand #150801770626:  Hold'em No Limit ($0.25/$0.50 USD) - 2016/03/23 14:40:27 CET [2016/03/23 9:40:27 ET]
Table 'Pyrrhus' 9-max Seat #2 is the button
Seat 2: BSTUSim ($74.13 in chips) 
Seat 3: i L00K great ($50.25 in chips) 
Seat 4: GriffinBerg ($45.20 in chips) 
Seat 5: ZonTTT ($53.61 in chips) 
Seat 6: Ahangama ($50 in chips) 
Seat 7: matiko09 ($137.63 in chips) 
Seat 8: dndngod ($70.48 in chips) 
Seat 9: CvMCvMCvM ($92.77 in chips) 
i L00K great: posts small blind $0.25
GriffinBerg: posts big blind $0.50
*** HOLE CARDS ***
Dealt to matiko09 [5s 7d]
ZonTTT: folds 
Ahangama: folds 
matiko09: folds 
dndngod: folds 
CvMCvMCvM: folds 
BSTUSim: raises $0.65 to $1.15
i L00K great: folds 
GriffinBerg: folds 
Uncalled bet ($0.65) returned to BSTUSim
BSTUSim collected $1.25 from pot
BSTUSim: doesn't show hand 
*** SUMMARY ***
Total pot $1.25 | Rake $0 
Seat 2: BSTUSim (button) collected ($1.25)
Seat 3: i L00K great (small blind) folded before Flop
Seat 4: GriffinBerg (big blind) folded before Flop
Seat 5: ZonTTT folded before Flop (didn't bet)
Seat 6: Ahangama folded before Flop (didn't bet)
Seat 7: matiko09 folded before Flop (didn't bet)
Seat 8: dndngod folded before Flop (didn't bet)
Seat 9: CvMCvMCvM folded before Flop (didn't bet)





PokerStars Hand #150801770827:  Hold'em No Limit ($1/$2 USD) - 2016/03/23 14:40:27 CET [2016/03/23 9:40:27 ET]
Table 'Kiess' 9-max Seat #8 is the button
Seat 1: Cirilico ($227.22 in chips) 
Seat 2: DUkalisUA ($655.10 in chips) 
Seat 3: The_red_area ($321.27 in chips) 
Seat 4: Moszes360 ($200 in chips) 
Seat 5: chippo boy ($500.09 in chips) 
Seat 6: matiko09 ($263.86 in chips) 
Seat 7: InsomniaRU ($303.97 in chips) 
Seat 8: erfk1958 ($94.96 in chips) 
Seat 9: T0ny Adams ($94.74 in chips) 
T0ny Adams: posts small blind $1
Cirilico: posts big blind $2
*** HOLE CARDS ***
Dealt to matiko09 [3h 8s]
DUkalisUA: raises $4 to $6
The_red_area: folds 
Moszes360: folds 
chippo boy: folds 
matiko09: folds 
InsomniaRU: folds 
erfk1958: folds 
T0ny Adams: folds 
Cirilico: folds 
Uncalled bet ($4) returned to DUkalisUA
DUkalisUA collected $5 from pot
DUkalisUA: doesn't show hand 
*** SUMMARY ***
Total pot $5 | Rake $0 
Seat 1: Cirilico (big blind) folded before Flop
Seat 2: DUkalisUA collected ($5)
Seat 3: The_red_area folded before Flop (didn't bet)
Seat 4: Moszes360 folded before Flop (didn't bet)
Seat 5: chippo boy folded before Flop (didn't bet)
Seat 6: matiko09 folded before Flop (didn't bet)
Seat 7: InsomniaRU folded before Flop (didn't bet)
Seat 8: erfk1958 (button) folded before Flop (didn't bet)
Seat 9: T0ny Adams (small blind) folded before Flop





PokerStars Hand #150801772126:  Hold'em No Limit ($1/$2 USD) - 2016/03/23 14:40:29 CET [2016/03/23 9:40:29 ET]
Table 'Achaia' 9-max Seat #7 is the button
Seat 1: Moszes360 ($226.36 in chips) 
Seat 2: InsomniaRU ($224.44 in chips) 
Seat 3: matiko09 ($221.20 in chips) 
Seat 4: erfk1958 ($119 in chips) 
Seat 5: chaps1988 ($214.70 in chips) 
Seat 6: nickreason17 ($211.99 in chips) 
Seat 7: morosun ($138.87 in chips) 
Seat 8: $-Twackle-$ ($223.07 in chips) 
Seat 9: glanza_mike ($200 in chips) 
$-Twackle-$: posts small blind $1
glanza_mike: posts big blind $2
*** HOLE CARDS ***
Dealt to matiko09 [Kd 2c]
Moszes360: folds 
InsomniaRU: folds 
matiko09: folds 
erfk1958: folds 
chaps1988: folds 
nickreason17: folds 
morosun: raises $4 to $6
$-Twackle-$: folds 
glanza_mike: raises $13 to $19
morosun: calls $13
*** FLOP *** [4s 5c 3s]
glanza_mike: bets $37.24
morosun: calls $37.24
*** TURN *** [4s 5c 3s] [6c]
glanza_mike: bets $143.76 and is all-in
morosun: calls $82.63 and is all-in
Uncalled bet ($61.13) returned to glanza_mike
*** RIVER *** [4s 5c 3s 6c] [5s]
*** SHOW DOWN ***
glanza_mike: shows [Jd Jh] (two pair, Jacks and Fives)
morosun: shows [Ah 7c] (a straight, Three to Seven)
morosun collected $275.94 from pot
*** SUMMARY ***
Total pot $278.74 | Rake $2.80 
Board [4s 5c 3s 6c 5s]
Seat 1: Moszes360 folded before Flop (didn't bet)
Seat 2: InsomniaRU folded before Flop (didn't bet)
Seat 3: matiko09 folded before Flop (didn't bet)
Seat 4: erfk1958 folded before Flop (didn't bet)
Seat 5: chaps1988 folded before Flop (didn't bet)
Seat 6: nickreason17 folded before Flop (didn't bet)
Seat 7: morosun (button) showed [Ah 7c] and won ($275.94) with a straight, Three to Seven
Seat 8: $-Twackle-$ (small blind) folded before Flop
Seat 9: glanza_mike (big blind) showed [Jd Jh] and lost with two pair, Jacks and Fives





PokerStars Hand #150801780982:  Hold'em No Limit ($0.50/$1.00 USD) - 2016/03/23 14:40:43 CET [2016/03/23 9:40:43 ET]
Table 'Merope II' 9-max Seat #9 is the button
Seat 1: Jimy Tiltman ($138.23 in chips) 
Seat 2: $-Twackle-$ ($101.50 in chips) 
Seat 3: pablos1922 ($91.25 in chips) 
Seat 4: YuriiSolodya ($90.34 in chips) 
Seat 5: DUkalisUA ($157.87 in chips) 
Seat 6: Effort92 ($103.71 in chips) 
Seat 7: matiko09 ($106.53 in chips) 
Seat 8: Red4erT ($40 in chips) 
Seat 9: RICKA16 ($98.50 in chips) 
Jimy Tiltman: posts small blind $0.50
$-Twackle-$: posts big blind $1
*** HOLE CARDS ***
Dealt to matiko09 [8d 6h]
pablos1922: folds 
YuriiSolodya: folds 
DUkalisUA: folds 
Effort92: raises $1.50 to $2.50
matiko09: folds 
Red4erT: folds 
RICKA16: raises $7.50 to $10
Jimy Tiltman: folds 
$-Twackle-$: folds 
Effort92: folds 
Uncalled bet ($7.50) returned to RICKA16
RICKA16 collected $6.50 from pot
RICKA16: doesn't show hand 
*** SUMMARY ***
Total pot $6.50 | Rake $0 
Seat 1: Jimy Tiltman (small blind) folded before Flop
Seat 2: $-Twackle-$ (big blind) folded before Flop
Seat 3: pablos1922 folded before Flop (didn't bet)
Seat 4: YuriiSolodya folded before Flop (didn't bet)
Seat 5: DUkalisUA folded before Flop (didn't bet)
Seat 6: Effort92 folded before Flop
Seat 7: matiko09 folded before Flop (didn't bet)
Seat 8: Red4erT folded before Flop (didn't bet)
Seat 9: RICKA16 (button) collected ($6.50)





PokerStars Hand #150801782810:  Hold'em No Limit ($1/$2 USD) - 2016/03/23 14:40:46 CET [2016/03/23 9:40:46 ET]
Table 'Herba II' 9-max Seat #5 is the button
Seat 1: matiko09 ($226.62 in chips) 
Seat 2: Moszes360 ($203.17 in chips) 
Seat 3: Cirilico ($173.84 in chips) 
Seat 4: DUkalisUA ($252.20 in chips) 
Seat 5: chippo boy ($238.13 in chips) 
Seat 6: Too-Anti-To ($226.38 in chips) 
Seat 7: InsomniaRU ($403.20 in chips) 
Seat 8: The_red_area ($393.98 in chips) 
Seat 9: mrhighryza ($66.27 in chips) 
Too-Anti-To: posts small blind $1
InsomniaRU: posts big blind $2
*** HOLE CARDS ***
Dealt to matiko09 [9d Ac]
The_red_area: folds 
mrhighryza: folds 
matiko09: folds 
Moszes360: folds 
Cirilico: folds 
DUkalisUA: folds 
chippo boy: folds 
Too-Anti-To: folds 
Uncalled bet ($1) returned to InsomniaRU
InsomniaRU collected $2 from pot
InsomniaRU: doesn't show hand 
*** SUMMARY ***
Total pot $2 | Rake $0 
Seat 1: matiko09 folded before Flop (didn't bet)
Seat 2: Moszes360 folded before Flop (didn't bet)
Seat 3: Cirilico folded before Flop (didn't bet)
Seat 4: DUkalisUA folded before Flop (didn't bet)
Seat 5: chippo boy (button) folded before Flop (didn't bet)
Seat 6: Too-Anti-To (small blind) folded before Flop
Seat 7: InsomniaRU (big blind) collected ($2)
Seat 8: The_red_area folded before Flop (didn't bet)
Seat 9: mrhighryza folded before Flop (didn't bet)





PokerStars Hand #150801787496:  Hold'em No Limit ($1/$2 USD) - 2016/03/23 14:40:53 CET [2016/03/23 9:40:53 ET]
Table 'Kypria II' 9-max Seat #3 is the button
Seat 1: geldwolfje ($169.63 in chips) 
Seat 3: seouljam ($173.56 in chips) 
Seat 4: VolanDog ($232.12 in chips) 
Seat 5: InsomniaRU ($314.74 in chips) 
Seat 6: matiko09 ($427.53 in chips) 
Seat 7: DUkalisUA ($202 in chips) 
Seat 8: nickreason17 ($200 in chips) 
Seat 9: Moszes360 ($200 in chips) 
VolanDog: posts small blind $1
InsomniaRU: posts big blind $2
*** HOLE CARDS ***
Dealt to matiko09 [Kd Th]
matiko09: folds 
DUkalisUA: folds 
nickreason17: raises $4 to $6
Moszes360: folds 
geldwolfje: folds 
seouljam: raises $12 to $18
VolanDog: folds 
InsomniaRU: folds 
nickreason17: folds 
Uncalled bet ($12) returned to seouljam
seouljam collected $15 from pot
seouljam: doesn't show hand 
*** SUMMARY ***
Total pot $15 | Rake $0 
Seat 1: geldwolfje folded before Flop (didn't bet)
Seat 3: seouljam (button) collected ($15)
Seat 4: VolanDog (small blind) folded before Flop
Seat 5: InsomniaRU (big blind) folded before Flop
Seat 6: matiko09 folded before Flop (didn't bet)
Seat 7: DUkalisUA folded before Flop (didn't bet)
Seat 8: nickreason17 folded before Flop
Seat 9: Moszes360 folded before Flop (didn't bet)





PokerStars Hand #150801790696:  Hold'em No Limit ($1/$2 USD) - 2016/03/23 14:40:58 CET [2016/03/23 9:40:58 ET]
Table 'Ennomos II' 9-max Seat #6 is the button
Seat 1: InsomniaRU ($200 in chips) 
Seat 2: Subam ($203.38 in chips) 
Seat 3: $-Twackle-$ ($235.62 in chips) 
Seat 4: glanza_mike ($200 in chips) 
Seat 5: South011 ($391.02 in chips) 
Seat 6: nickreason17 ($393.62 in chips) 
Seat 7: T0ny Adams ($78 in chips) 
Seat 8: yyfk ($200 in chips) 
Seat 9: matiko09 ($347.94 in chips) 
T0ny Adams: posts small blind $1
yyfk: posts big blind $2
*** HOLE CARDS ***
Dealt to matiko09 [Jh As]
matiko09: folds 
InsomniaRU: folds 
Subam: raises $4 to $6
$-Twackle-$: calls $6
glanza_mike: folds 
South011: folds 
nickreason17: folds 
T0ny Adams: folds 
yyfk: folds 
*** FLOP *** [2c 3d Ts]
Subam: bets $8
$-Twackle-$: calls $8
*** TURN *** [2c 3d Ts] [6c]
Subam: bets $22
$-Twackle-$: calls $22
*** RIVER *** [2c 3d Ts 6c] [4c]
Subam: bets $167.38 and is all-in
$-Twackle-$: calls $167.38
*** SHOW DOWN ***
Subam: shows [7s 7h] (a pair of Sevens)
$-Twackle-$: shows [Th Td] (three of a kind, Tens)
$-Twackle-$ collected $406.96 from pot
*** SUMMARY ***
Total pot $409.76 | Rake $2.80 
Board [2c 3d Ts 6c 4c]
Seat 1: InsomniaRU folded before Flop (didn't bet)
Seat 2: Subam showed [7s 7h] and lost with a pair of Sevens
Seat 3: $-Twackle-$ showed [Th Td] and won ($406.96) with three of a kind, Tens
Seat 4: glanza_mike folded before Flop (didn't bet)
Seat 5: South011 folded before Flop (didn't bet)
Seat 6: nickreason17 (button) folded before Flop (didn't bet)
Seat 7: T0ny Adams (small blind) folded before Flop
Seat 8: yyfk (big blind) folded before Flop
Seat 9: matiko09 folded before Flop (didn't bet)





PokerStars Hand #150801790356:  Hold'em No Limit ($0.25/$0.50 USD) - 2016/03/23 14:40:58 CET [2016/03/23 9:40:58 ET]
Table 'Pyrrhus' 9-max Seat #3 is the button
Seat 2: BSTUSim ($74.88 in chips) 
Seat 3: i L00K great ($50 in chips) 
Seat 4: GriffinBerg ($44.70 in chips) 
Seat 5: ZonTTT ($53.61 in chips) 
Seat 6: Ahangama ($50 in chips) 
Seat 7: matiko09 ($137.63 in chips) 
Seat 8: dndngod ($70.48 in chips) 
Seat 9: CvMCvMCvM ($92.77 in chips) 
GriffinBerg: posts small blind $0.25
ZonTTT: posts big blind $0.50
*** HOLE CARDS ***
Dealt to matiko09 [5c 6c]
Ahangama: folds 
matiko09: folds 
dndngod: folds 
CvMCvMCvM: raises $0.76 to $1.26
BSTUSim: folds 
i L00K great: folds 
GriffinBerg: folds 
ZonTTT: folds 
Uncalled bet ($0.76) returned to CvMCvMCvM
CvMCvMCvM collected $1.25 from pot
CvMCvMCvM: doesn't show hand 
*** SUMMARY ***
Total pot $1.25 | Rake $0 
Seat 2: BSTUSim folded before Flop (didn't bet)
Seat 3: i L00K great (button) folded before Flop (didn't bet)
Seat 4: GriffinBerg (small blind) folded before Flop
Seat 5: ZonTTT (big blind) folded before Flop
Seat 6: Ahangama folded before Flop (didn't bet)
Seat 7: matiko09 folded before Flop (didn't bet)
Seat 8: dndngod folded before Flop (didn't bet)
Seat 9: CvMCvMCvM collected ($1.25)





PokerStars Hand #150801798819:  Hold'em No Limit ($1/$2 USD) - 2016/03/23 14:41:11 CET [2016/03/23 9:41:11 ET]
Table 'Herba II' 9-max Seat #6 is the button
Seat 1: matiko09 ($226.62 in chips) 
Seat 2: Moszes360 ($203.17 in chips) 
Seat 3: Cirilico ($173.84 in chips) 
Seat 4: DUkalisUA ($252.20 in chips) 
Seat 5: chippo boy ($238.13 in chips) 
Seat 6: Too-Anti-To ($225.38 in chips) 
Seat 7: InsomniaRU ($404.20 in chips) 
Seat 8: The_red_area ($393.98 in chips) 
Seat 9: mrhighryza ($66.27 in chips) 
InsomniaRU: posts small blind $1
The_red_area: posts big blind $2
*** HOLE CARDS ***
Dealt to matiko09 [3s Ts]
mrhighryza: folds 
matiko09: folds 
Moszes360: folds 
Cirilico: folds 
DUkalisUA: folds 
chippo boy has timed out
chippo boy: folds 
Too-Anti-To: raises $3 to $5
InsomniaRU: folds 
The_red_area: folds 
Uncalled bet ($3) returned to Too-Anti-To
Too-Anti-To collected $5 from pot
Too-Anti-To: doesn't show hand 
*** SUMMARY ***
Total pot $5 | Rake $0 
Seat 1: matiko09 folded before Flop (didn't bet)
Seat 2: Moszes360 folded before Flop (didn't bet)
Seat 3: Cirilico folded before Flop (didn't bet)
Seat 4: DUkalisUA folded before Flop (didn't bet)
Seat 5: chippo boy folded before Flop (didn't bet)
Seat 6: Too-Anti-To (button) collected ($5)
Seat 7: InsomniaRU (small blind) folded before Flop
Seat 8: The_red_area (big blind) folded before Flop
Seat 9: mrhighryza folded before Flop (didn't bet)





PokerStars Hand #150801805257:  Hold'em No Limit ($0.50/$1.00 USD) - 2016/03/23 14:41:21 CET [2016/03/23 9:41:21 ET]
Table 'Swings' 9-max Seat #3 is the button
Seat 1: Sherlockplay ($100 in chips) 
Seat 2: Harbinger X ($187.14 in chips) 
Seat 3: maxxmeister ($121.28 in chips) 
Seat 4: chaps1988 ($100 in chips) 
Seat 5: chautinhtri9 ($100 in chips) 
Seat 6: matiko09 ($127.93 in chips) 
Seat 8: RICKA16 ($100 in chips) 
Seat 9: Vlad_1965_77 ($107.55 in chips) 
chaps1988: posts small blind $0.50
chautinhtri9: posts big blind $1
PacPacBum: sits out 
*** HOLE CARDS ***
Dealt to matiko09 [6d 9h]
matiko09: folds 
RICKA16: raises $2 to $3
Vlad_1965_77: folds 
Sherlockplay: folds 
Harbinger X: folds 
maxxmeister: folds 
chaps1988: folds 
chautinhtri9: folds 
Uncalled bet ($2) returned to RICKA16
RICKA16 collected $2.50 from pot
RICKA16: doesn't show hand 
*** SUMMARY ***
Total pot $2.50 | Rake $0 
Seat 1: Sherlockplay folded before Flop (didn't bet)
Seat 2: Harbinger X folded before Flop (didn't bet)
Seat 3: maxxmeister (button) folded before Flop (didn't bet)
Seat 4: chaps1988 (small blind) folded before Flop
Seat 5: chautinhtri9 (big blind) folded before Flop
Seat 6: matiko09 folded before Flop (didn't bet)
Seat 8: RICKA16 collected ($2.50)
Seat 9: Vlad_1965_77 folded before Flop (didn't bet)





PokerStars Hand #150801805394:  Hold'em No Limit ($1/$2 USD) - 2016/03/23 14:41:21 CET [2016/03/23 9:41:21 ET]
Table 'Kiess' 9-max Seat #9 is the button
Seat 1: Cirilico ($225.22 in chips) 
Seat 2: DUkalisUA ($658.10 in chips) 
Seat 3: The_red_area ($321.27 in chips) 
Seat 4: Moszes360 ($200 in chips) 
Seat 5: chippo boy ($500.09 in chips) 
Seat 6: matiko09 ($263.86 in chips) 
Seat 7: InsomniaRU ($303.97 in chips) 
Seat 8: erfk1958 ($94.96 in chips) 
Seat 9: T0ny Adams ($93.74 in chips) 
Cirilico: posts small blind $1
DUkalisUA: posts big blind $2
*** HOLE CARDS ***
Dealt to matiko09 [4c Ks]
The_red_area: folds 
Moszes360: folds 
chippo boy: folds 
matiko09: folds 
InsomniaRU: folds 
erfk1958: folds 
T0ny Adams: raises $3.24 to $5.24
Cirilico: raises $10.76 to $16
DUkalisUA: raises $26 to $42
T0ny Adams: folds 
Cirilico: folds 
Uncalled bet ($26) returned to DUkalisUA
DUkalisUA collected $37.24 from pot
DUkalisUA: doesn't show hand 
*** SUMMARY ***
Total pot $37.24 | Rake $0 
Seat 1: Cirilico (small blind) folded before Flop
Seat 2: DUkalisUA (big blind) collected ($37.24)
Seat 3: The_red_area folded before Flop (didn't bet)
Seat 4: Moszes360 folded before Flop (didn't bet)
Seat 5: chippo boy folded before Flop (didn't bet)
Seat 6: matiko09 folded before Flop (didn't bet)
Seat 7: InsomniaRU folded before Flop (didn't bet)
Seat 8: erfk1958 folded before Flop (didn't bet)
Seat 9: T0ny Adams (button) folded before Flop





PokerStars Hand #150801806811:  Hold'em No Limit ($0.50/$1.00 USD) - 2016/03/23 14:41:23 CET [2016/03/23 9:41:23 ET]
Table 'Atlantis' 9-max Seat #3 is the button
Seat 1: xHourglass ($149 in chips) 
Seat 2: Szevasztopol ($103.68 in chips) 
Seat 3: CAJUN890 ($130.08 in chips) 
Seat 4: matiko09 ($124.75 in chips) 
Seat 5: Pvsx. ($108.56 in chips) 
Seat 6: Jimy Tiltman ($101.50 in chips) 
Seat 7: Sherlockplay ($142.98 in chips) 
Seat 8: DUkalisUA ($133.50 in chips) 
Seat 9: RICKA16 ($104.16 in chips) 
matiko09: posts small blind $0.50
Pvsx.: posts big blind $1
*** HOLE CARDS ***
Dealt to matiko09 [Ts Ad]
Jimy Tiltman: folds 
Sherlockplay: folds 
DUkalisUA: raises $2 to $3
RICKA16: folds 
xHourglass: folds 
Szevasztopol: folds 
CAJUN890: folds 
matiko09: folds 
Pvsx.: folds 
Uncalled bet ($2) returned to DUkalisUA
DUkalisUA collected $2.50 from pot
DUkalisUA: doesn't show hand 
*** SUMMARY ***
Total pot $2.50 | Rake $0 
Seat 1: xHourglass folded before Flop (didn't bet)
Seat 2: Szevasztopol folded before Flop (didn't bet)
Seat 3: CAJUN890 (button) folded before Flop (didn't bet)
Seat 4: matiko09 (small blind) folded before Flop
Seat 5: Pvsx. (big blind) folded before Flop
Seat 6: Jimy Tiltman folded before Flop (didn't bet)
Seat 7: Sherlockplay folded before Flop (didn't bet)
Seat 8: DUkalisUA collected ($2.50)
Seat 9: RICKA16 folded before Flop (didn't bet)





PokerStars Hand #150801810469:  Hold'em No Limit ($1/$2 USD) - 2016/03/23 14:41:29 CET [2016/03/23 9:41:29 ET]
Table 'Kypria II' 9-max Seat #4 is the button
Seat 1: geldwolfje ($169.63 in chips) 
Seat 3: seouljam ($182.56 in chips) 
Seat 4: VolanDog ($231.12 in chips) 
Seat 5: InsomniaRU ($312.74 in chips) 
Seat 6: matiko09 ($427.53 in chips) 
Seat 7: DUkalisUA ($202 in chips) 
Seat 8: nickreason17 ($200 in chips) 
Seat 9: Moszes360 ($200 in chips) 
InsomniaRU: posts small blind $1
matiko09: posts big blind $2
*** HOLE CARDS ***
Dealt to matiko09 [3d 4c]
DUkalisUA: raises $4 to $6
nickreason17: folds 
Moszes360: folds 
geldwolfje: folds 
seouljam: folds 
VolanDog: folds 
InsomniaRU: folds 
matiko09: folds 
Uncalled bet ($4) returned to DUkalisUA
DUkalisUA collected $5 from pot
DUkalisUA: doesn't show hand 
*** SUMMARY ***
Total pot $5 | Rake $0 
Seat 1: geldwolfje folded before Flop (didn't bet)
Seat 3: seouljam folded before Flop (didn't bet)
Seat 4: VolanDog (button) folded before Flop (didn't bet)
Seat 5: InsomniaRU (small blind) folded before Flop
Seat 6: matiko09 (big blind) folded before Flop
Seat 7: DUkalisUA collected ($5)
Seat 8: nickreason17 folded before Flop (didn't bet)
Seat 9: Moszes360 folded before Flop (didn't bet)





PokerStars Hand #150801811558:  Hold'em No Limit ($1/$2 USD) - 2016/03/23 14:41:31 CET [2016/03/23 9:41:31 ET]
Table 'Achaia' 9-max Seat #8 is the button
Seat 1: Moszes360 ($226.36 in chips) 
Seat 2: InsomniaRU ($224.44 in chips) 
Seat 3: matiko09 ($221.20 in chips) 
Seat 4: erfk1958 ($119 in chips) 
Seat 5: chaps1988 ($214.70 in chips) 
Seat 6: nickreason17 ($211.99 in chips) 
Seat 7: morosun ($275.94 in chips) 
Seat 8: $-Twackle-$ ($222.07 in chips) 
Seat 9: glanza_mike ($200 in chips) 
glanza_mike: posts small blind $1
Moszes360: posts big blind $2
*** HOLE CARDS ***
Dealt to matiko09 [3d 5d]
InsomniaRU: folds 
matiko09: folds 
erfk1958: folds 
chaps1988: folds 
nickreason17: raises $4 to $6
morosun: folds 
$-Twackle-$: folds 
glanza_mike: folds 
Moszes360: folds 
Uncalled bet ($4) returned to nickreason17
nickreason17 collected $5 from pot
*** SUMMARY ***
Total pot $5 | Rake $0 
Seat 1: Moszes360 (big blind) folded before Flop
Seat 2: InsomniaRU folded before Flop (didn't bet)
Seat 3: matiko09 folded before Flop (didn't bet)
Seat 4: erfk1958 folded before Flop (didn't bet)
Seat 5: chaps1988 folded before Flop (didn't bet)
Seat 6: nickreason17 collected ($5)
Seat 7: morosun folded before Flop (didn't bet)
Seat 8: $-Twackle-$ (button) folded before Flop (didn't bet)
Seat 9: glanza_mike (small blind) folded before Flop





PokerStars Hand #150801811243:  Hold'em No Limit ($0.50/$1.00 USD) - 2016/03/23 14:41:31 CET [2016/03/23 9:41:31 ET]
Table 'Merope II' 9-max Seat #1 is the button
Seat 1: Jimy Tiltman ($137.73 in chips) 
Seat 2: $-Twackle-$ ($100.50 in chips) 
Seat 3: pablos1922 ($91.25 in chips) 
Seat 4: YuriiSolodya ($90.34 in chips) 
Seat 5: DUkalisUA ($157.87 in chips) 
Seat 6: Effort92 ($101.21 in chips) 
Seat 7: matiko09 ($106.53 in chips) 
Seat 8: Red4erT ($40 in chips) 
Seat 9: RICKA16 ($102.50 in chips) 
$-Twackle-$: posts small blind $0.50
pablos1922: posts big blind $1
*** HOLE CARDS ***
Dealt to matiko09 [3d 5h]
YuriiSolodya: folds 
DUkalisUA: folds 
Effort92: folds 
matiko09: folds 
Red4erT: folds 
RICKA16: folds 
Jimy Tiltman: folds 
$-Twackle-$: folds 
Uncalled bet ($0.50) returned to pablos1922
pablos1922 collected $1 from pot
pablos1922: doesn't show hand 
*** SUMMARY ***
Total pot $1 | Rake $0 
Seat 1: Jimy Tiltman (button) folded before Flop (didn't bet)
Seat 2: $-Twackle-$ (small blind) folded before Flop
Seat 3: pablos1922 (big blind) collected ($1)
Seat 4: YuriiSolodya folded before Flop (didn't bet)
Seat 5: DUkalisUA folded before Flop (didn't bet)
Seat 6: Effort92 folded before Flop (didn't bet)
Seat 7: matiko09 folded before Flop (didn't bet)
Seat 8: Red4erT folded before Flop (didn't bet)
Seat 9: RICKA16 folded before Flop (didn't bet)





PokerStars Hand #150801816075:  Hold'em No Limit ($0.25/$0.50 USD) - 2016/03/23 14:41:38 CET [2016/03/23 9:41:38 ET]
Table 'Pyrrhus' 9-max Seat #4 is the button
Seat 2: BSTUSim ($74.88 in chips) 
Seat 3: i L00K great ($50 in chips) 
Seat 4: GriffinBerg ($44.45 in chips) 
Seat 5: ZonTTT ($53.11 in chips) 
Seat 6: Ahangama ($50 in chips) 
Seat 7: matiko09 ($137.63 in chips) 
Seat 8: dndngod ($70.48 in chips) 
Seat 9: CvMCvMCvM ($93.52 in chips) 
ZonTTT: posts small blind $0.25
Ahangama: posts big blind $0.50
*** HOLE CARDS ***
Dealt to matiko09 [Td 3d]
matiko09: folds 
dndngod: folds 
CvMCvMCvM: folds 
BSTUSim: folds 
i L00K great: folds 
GriffinBerg: folds 
ZonTTT: folds 
Uncalled bet ($0.25) returned to Ahangama
Ahangama collected $0.50 from pot
Ahangama: doesn't show hand 
*** SUMMARY ***
Total pot $0.50 | Rake $0 
Seat 2: BSTUSim folded before Flop (didn't bet)
Seat 3: i L00K great folded before Flop (didn't bet)
Seat 4: GriffinBerg (button) folded before Flop (didn't bet)
Seat 5: ZonTTT (small blind) folded before Flop
Seat 6: Ahangama (big blind) collected ($0.50)
Seat 7: matiko09 folded before Flop (didn't bet)
Seat 8: dndngod folded before Flop (didn't bet)
Seat 9: CvMCvMCvM folded before Flop (didn't bet)





PokerStars Hand #150801815734:  Hold'em No Limit ($0.50/$1.00 USD) - 2016/03/23 14:41:38 CET [2016/03/23 9:41:38 ET]
Table 'Asmodeus' 9-max Seat #8 is the button
Seat 1: Jimy Tiltman ($107.30 in chips) 
Seat 2: $-Twackle-$ ($100 in chips) 
Seat 3: nickreason17 ($100 in chips) 
Seat 4: Effort92 ($102.50 in chips) 
Seat 5: chaps1988 ($100 in chips) 
Seat 7: PacPacBum ($108.13 in chips) 
Seat 8: KEBIN1974 ($143.16 in chips) 
Seat 9: matiko09 ($100 in chips) 
matiko09: posts small blind $0.50
Jimy Tiltman: posts big blind $1
Jimy Tiltman: posts the ante $0.20
$-Twackle-$: posts the ante $0.20
nickreason17: posts the ante $0.20
Effort92: posts the ante $0.20
chaps1988: posts the ante $0.20
PacPacBum: posts the ante $0.20
KEBIN1974: posts the ante $0.20
matiko09: posts the ante $0.20
*** HOLE CARDS ***
Dealt to matiko09 [Td 4h]
$-Twackle-$: folds 
nickreason17: folds 
Effort92: raises $1.50 to $2.50
chaps1988: folds 
PacPacBum: folds 
KEBIN1974: calls $2.50
matiko09: folds 
Jimy Tiltman: folds 
*** FLOP *** [As 6s Ks]
Effort92: bets $4
KEBIN1974: calls $4
*** TURN *** [As 6s Ks] [Ts]
Effort92: checks 
KEBIN1974: bets $8.92
Effort92: folds 
Uncalled bet ($8.92) returned to KEBIN1974
KEBIN1974 collected $15.38 from pot
KEBIN1974: doesn't show hand 
*** SUMMARY ***
Total pot $16.10 | Rake $0.72 
Board [As 6s Ks Ts]
Seat 1: Jimy Tiltman (big blind) folded before Flop
Seat 2: $-Twackle-$ folded before Flop (didn't bet)
Seat 3: nickreason17 folded before Flop (didn't bet)
Seat 4: Effort92 folded on the Turn
Seat 5: chaps1988 folded before Flop (didn't bet)
Seat 7: PacPacBum folded before Flop (didn't bet)
Seat 8: KEBIN1974 (button) collected ($15.38)
Seat 9: matiko09 (small blind) folded before Flop





PokerStars Hand #150801820590:  Hold'em No Limit ($1/$2 USD) - 2016/03/23 14:41:45 CET [2016/03/23 9:41:45 ET]
Table 'Herba II' 9-max Seat #7 is the button
Seat 1: matiko09 ($226.62 in chips) 
Seat 2: Moszes360 ($203.17 in chips) 
Seat 3: Cirilico ($173.84 in chips) 
Seat 4: DUkalisUA ($252.20 in chips) 
Seat 6: Too-Anti-To ($228.38 in chips) 
Seat 7: InsomniaRU ($403.20 in chips) 
Seat 8: The_red_area ($391.98 in chips) 
Seat 9: mrhighryza ($66.27 in chips) 
The_red_area: posts small blind $1
mrhighryza: posts big blind $2
*** HOLE CARDS ***
Dealt to matiko09 [5s 8c]
matiko09: folds 
Moszes360: folds 
Cirilico: folds 
DUkalisUA: folds 
Too-Anti-To: folds 
InsomniaRU: raises $3 to $5
The_red_area: folds 
mrhighryza: calls $3
*** FLOP *** [Ad Kd 8h]
mrhighryza: checks 
InsomniaRU: bets $7.04
mrhighryza: folds 
Uncalled bet ($7.04) returned to InsomniaRU
InsomniaRU collected $10.50 from pot
InsomniaRU: doesn't show hand 
*** SUMMARY ***
Total pot $11 | Rake $0.50 
Board [Ad Kd 8h]
Seat 1: matiko09 folded before Flop (didn't bet)
Seat 2: Moszes360 folded before Flop (didn't bet)
Seat 3: Cirilico folded before Flop (didn't bet)
Seat 4: DUkalisUA folded before Flop (didn't bet)
Seat 6: Too-Anti-To folded before Flop (didn't bet)
Seat 7: InsomniaRU (button) collected ($10.50)
Seat 8: The_red_area (small blind) folded before Flop
Seat 9: mrhighryza (big blind) folded on the Flop





PokerStars Hand #150801825168:  Hold'em No Limit ($0.50/$1.00 USD) - 2016/03/23 14:41:52 CET [2016/03/23 9:41:52 ET]
Table 'Swings' 9-max Seat #4 is the button
Seat 1: Sherlockplay ($100 in chips) 
Seat 2: Harbinger X ($187.14 in chips) 
Seat 3: maxxmeister ($121.28 in chips) 
Seat 4: chaps1988 ($100 in chips) 
Seat 5: chautinhtri9 ($99 in chips) 
Seat 6: matiko09 ($127.93 in chips) 
Seat 8: RICKA16 ($101.50 in chips) 
Seat 9: Vlad_1965_77 ($107.55 in chips) 
chautinhtri9: posts small blind $0.50
matiko09: posts big blind $1
PacPacBum: sits out 
*** HOLE CARDS ***
Dealt to matiko09 [As 2h]
RICKA16: folds 
Vlad_1965_77: folds 
Sherlockplay: folds 
Harbinger X: folds 
maxxmeister: raises $2 to $3
chaps1988: folds 
chautinhtri9: folds 
matiko09: folds 
Uncalled bet ($2) returned to maxxmeister
maxxmeister collected $2.50 from pot
maxxmeister: doesn't show hand 
*** SUMMARY ***
Total pot $2.50 | Rake $0 
Seat 1: Sherlockplay folded before Flop (didn't bet)
Seat 2: Harbinger X folded before Flop (didn't bet)
Seat 3: maxxmeister collected ($2.50)
Seat 4: chaps1988 (button) folded before Flop (didn't bet)
Seat 5: chautinhtri9 (small blind) folded before Flop
Seat 6: matiko09 (big blind) folded before Flop
Seat 8: RICKA16 folded before Flop (didn't bet)
Seat 9: Vlad_1965_77 folded before Flop (didn't bet)





PokerStars Hand #150801825137:  Hold'em No Limit ($0.50/$1.00 USD) - 2016/03/23 14:41:52 CET [2016/03/23 9:41:52 ET]
Table 'Atlantis' 9-max Seat #4 is the button
Seat 1: xHourglass ($149 in chips) 
Seat 2: Szevasztopol ($103.68 in chips) 
Seat 3: CAJUN890 ($130.08 in chips) 
Seat 4: matiko09 ($124.25 in chips) 
Seat 5: Pvsx. ($107.56 in chips) 
Seat 6: Jimy Tiltman ($101.50 in chips) 
Seat 7: Sherlockplay ($142.98 in chips) 
Seat 8: DUkalisUA ($135 in chips) 
Seat 9: RICKA16 ($104.16 in chips) 
Pvsx.: posts small blind $0.50
Jimy Tiltman: posts big blind $1
*** HOLE CARDS ***
Dealt to matiko09 [Qc 8d]
Sherlockplay: folds 
DUkalisUA: folds 
RICKA16: folds 
xHourglass: raises $2 to $3
Szevasztopol: folds 
CAJUN890: raises $3 to $6
matiko09: folds 
Pvsx.: folds 
Jimy Tiltman: folds 
xHourglass: calls $3
*** FLOP *** [7h 7s 4d]
xHourglass: checks 
CAJUN890: bets $7
xHourglass: calls $7
*** TURN *** [7h 7s 4d] [Kd]
xHourglass: checks 
CAJUN890: bets $13.13
xHourglass: folds 
Uncalled bet ($13.13) returned to CAJUN890
CAJUN890 collected $26.26 from pot
CAJUN890: doesn't show hand 
*** SUMMARY ***
Total pot $27.50 | Rake $1.24 
Board [7h 7s 4d Kd]
Seat 1: xHourglass folded on the Turn
Seat 2: Szevasztopol folded before Flop (didn't bet)
Seat 3: CAJUN890 collected ($26.26)
Seat 4: matiko09 (button) folded before Flop (didn't bet)
Seat 5: Pvsx. (small blind) folded before Flop
Seat 6: Jimy Tiltman (big blind) folded before Flop
Seat 7: Sherlockplay folded before Flop (didn't bet)
Seat 8: DUkalisUA folded before Flop (didn't bet)
Seat 9: RICKA16 folded before Flop (didn't bet)





PokerStars Hand #150801828675:  Hold'em No Limit ($1/$2 USD) - 2016/03/23 14:41:58 CET [2016/03/23 9:41:58 ET]
Table 'Achaia' 9-max Seat #9 is the button
Seat 1: Moszes360 ($224.36 in chips) 
Seat 2: InsomniaRU ($224.44 in chips) 
Seat 3: matiko09 ($221.20 in chips) 
Seat 4: erfk1958 ($119 in chips) 
Seat 5: chaps1988 ($214.70 in chips) 
Seat 6: nickreason17 ($214.99 in chips) 
Seat 7: morosun ($275.94 in chips) 
Seat 8: $-Twackle-$ ($222.07 in chips) 
Seat 9: glanza_mike ($200 in chips) 
Moszes360: posts small blind $1
InsomniaRU: posts big blind $2
*** HOLE CARDS ***
Dealt to matiko09 [2c Jc]
matiko09: folds 
erfk1958: folds 
chaps1988: folds 
nickreason17: folds 
morosun: folds 
$-Twackle-$: folds 
glanza_mike: folds 
Moszes360: raises $4 to $6
InsomniaRU: folds 
Uncalled bet ($4) returned to Moszes360
Moszes360 collected $4 from pot
Moszes360: doesn't show hand 
*** SUMMARY ***
Total pot $4 | Rake $0 
Seat 1: Moszes360 (small blind) collected ($4)
Seat 2: InsomniaRU (big blind) folded before Flop
Seat 3: matiko09 folded before Flop (didn't bet)
Seat 4: erfk1958 folded before Flop (didn't bet)
Seat 5: chaps1988 folded before Flop (didn't bet)
Seat 6: nickreason17 folded before Flop (didn't bet)
Seat 7: morosun folded before Flop (didn't bet)
Seat 8: $-Twackle-$ folded before Flop (didn't bet)
Seat 9: glanza_mike (button) folded before Flop (didn't bet)





PokerStars Hand #150801832202:  Hold'em No Limit ($1/$2 USD) - 2016/03/23 14:42:03 CET [2016/03/23 9:42:03 ET]
Table 'Kiess' 9-max Seat #1 is the button
Seat 1: Cirilico ($209.22 in chips) 
Seat 2: DUkalisUA ($679.34 in chips) 
Seat 3: The_red_area ($321.27 in chips) 
Seat 4: Moszes360 ($200 in chips) 
Seat 5: chippo boy ($500.09 in chips) 
Seat 6: matiko09 ($263.86 in chips) 
Seat 7: InsomniaRU ($303.97 in chips) 
Seat 8: erfk1958 ($94.96 in chips) 
Seat 9: T0ny Adams ($88.50 in chips) 
DUkalisUA: posts small blind $1
The_red_area: posts big blind $2
*** HOLE CARDS ***
Dealt to matiko09 [Qs 4h]
Moszes360: folds 
chippo boy: calls $2
matiko09: folds 
InsomniaRU: folds 
erfk1958: folds 
T0ny Adams: raises $8 to $10
Cirilico: folds 
DUkalisUA: folds 
The_red_area: folds 
chippo boy: calls $8
*** FLOP *** [8s 5s Kh]
chippo boy: checks 
T0ny Adams: bets $18.20
chippo boy: folds 
Uncalled bet ($18.20) returned to T0ny Adams
T0ny Adams collected $21.96 from pot
T0ny Adams: doesn't show hand 
*** SUMMARY ***
Total pot $23 | Rake $1.04 
Board [8s 5s Kh]
Seat 1: Cirilico (button) folded before Flop (didn't bet)
Seat 2: DUkalisUA (small blind) folded before Flop
Seat 3: The_red_area (big blind) folded before Flop
Seat 4: Moszes360 folded before Flop (didn't bet)
Seat 5: chippo boy folded on the Flop
Seat 6: matiko09 folded before Flop (didn't bet)
Seat 7: InsomniaRU folded before Flop (didn't bet)
Seat 8: erfk1958 folded before Flop (didn't bet)
Seat 9: T0ny Adams collected ($21.96)





PokerStars Hand #150801831866:  Hold'em No Limit ($0.25/$0.50 USD) - 2016/03/23 14:42:03 CET [2016/03/23 9:42:03 ET]
Table 'Pyrrhus' 9-max Seat #5 is the button
Seat 2: BSTUSim ($74.88 in chips) 
Seat 3: i L00K great ($50 in chips) 
Seat 4: GriffinBerg ($44.45 in chips) 
Seat 5: ZonTTT ($52.86 in chips) 
Seat 6: Ahangama ($50.25 in chips) 
Seat 7: matiko09 ($137.63 in chips) 
Seat 8: dndngod ($70.48 in chips) 
Seat 9: CvMCvMCvM ($93.52 in chips) 
Ahangama: posts small blind $0.25
matiko09: posts big blind $0.50
*** HOLE CARDS ***
Dealt to matiko09 [Ac Td]
dndngod: folds 
CvMCvMCvM: folds 
BSTUSim: folds 
i L00K great: folds 
GriffinBerg: raises $1 to $1.50
ZonTTT: folds 
Ahangama: folds 
matiko09: calls $1
*** FLOP *** [5h Ts 7s]
matiko09: checks 
GriffinBerg: checks 
*** TURN *** [5h Ts 7s] [Jd]
matiko09: checks 
GriffinBerg: checks 
*** RIVER *** [5h Ts 7s Jd] [Th]
matiko09: bets $2.02
GriffinBerg: folds 
Uncalled bet ($2.02) returned to matiko09
matiko09 collected $3.10 from pot
matiko09: doesn't show hand 
*** SUMMARY ***
Total pot $3.25 | Rake $0.15 
Board [5h Ts 7s Jd Th]
Seat 2: BSTUSim folded before Flop (didn't bet)
Seat 3: i L00K great folded before Flop (didn't bet)
Seat 4: GriffinBerg folded on the River
Seat 5: ZonTTT (button) folded before Flop (didn't bet)
Seat 6: Ahangama (small blind) folded before Flop
Seat 7: matiko09 (big blind) collected ($3.10)
Seat 8: dndngod folded before Flop (didn't bet)
Seat 9: CvMCvMCvM folded before Flop (didn't bet)





PokerStars Hand #150801833278:  Hold'em No Limit ($1/$2 USD) - 2016/03/23 14:42:05 CET [2016/03/23 9:42:05 ET]
Table 'Kypria II' 9-max Seat #5 is the button
Seat 1: geldwolfje ($169.63 in chips) 
Seat 3: seouljam ($182.56 in chips) 
Seat 4: VolanDog ($231.12 in chips) 
Seat 5: InsomniaRU ($311.74 in chips) 
Seat 6: matiko09 ($425.53 in chips) 
Seat 7: DUkalisUA ($205 in chips) 
Seat 8: nickreason17 ($200 in chips) 
Seat 9: Moszes360 ($200 in chips) 
matiko09: posts small blind $1
DUkalisUA: posts big blind $2
*** HOLE CARDS ***
Dealt to matiko09 [Tc 9h]
nickreason17: folds 
Moszes360: folds 
geldwolfje: raises $2 to $4
seouljam: raises $8 to $12
VolanDog: folds 
InsomniaRU: folds 
matiko09: folds 
DUkalisUA: folds 
geldwolfje: calls $8
*** FLOP *** [3c Jd 5h]
geldwolfje: checks 
seouljam: bets $14
geldwolfje: calls $14
*** TURN *** [3c Jd 5h] [8d]
geldwolfje: checks 
seouljam: bets $52.52
geldwolfje: folds 
Uncalled bet ($52.52) returned to seouljam
seouljam collected $52.52 from pot
seouljam: doesn't show hand 
*** SUMMARY ***
Total pot $55 | Rake $2.48 
Board [3c Jd 5h 8d]
Seat 1: geldwolfje folded on the Turn
Seat 3: seouljam collected ($52.52)
Seat 4: VolanDog folded before Flop (didn't bet)
Seat 5: InsomniaRU (button) folded before Flop (didn't bet)
Seat 6: matiko09 (small blind) folded before Flop
Seat 7: DUkalisUA (big blind) folded before Flop
Seat 8: nickreason17 folded before Flop (didn't bet)
Seat 9: Moszes360 folded before Flop (didn't bet)





PokerStars Hand #150801833301:  Hold'em No Limit ($0.50/$1.00 USD) - 2016/03/23 14:42:05 CET [2016/03/23 9:42:05 ET]
Table 'Merope II' 9-max Seat #2 is the button
Seat 1: Jimy Tiltman ($137.73 in chips) 
Seat 2: $-Twackle-$ ($100 in chips) 
Seat 3: pablos1922 ($91.75 in chips) 
Seat 4: YuriiSolodya ($90.34 in chips) 
Seat 5: DUkalisUA ($157.87 in chips) 
Seat 6: Effort92 ($101.21 in chips) 
Seat 7: matiko09 ($106.53 in chips) 
Seat 8: Red4erT ($40 in chips) 
Seat 9: RICKA16 ($102.50 in chips) 
pablos1922: posts small blind $0.50
YuriiSolodya: posts big blind $1
*** HOLE CARDS ***
Dealt to matiko09 [8h 6h]
DUkalisUA: folds 
Effort92: folds 
matiko09: folds 
Red4erT: folds 
RICKA16: folds 
Jimy Tiltman: folds 
$-Twackle-$: raises $1.10 to $2.10
pablos1922: calls $1.60
YuriiSolodya: folds 
*** FLOP *** [3c 9h 9d]
pablos1922: checks 
$-Twackle-$: checks 
*** TURN *** [3c 9h 9d] [Qc]
pablos1922: checks 
$-Twackle-$: bets $4
pablos1922: folds 
Uncalled bet ($4) returned to $-Twackle-$
$-Twackle-$ collected $4.97 from pot
$-Twackle-$: doesn't show hand 
*** SUMMARY ***
Total pot $5.20 | Rake $0.23 
Board [3c 9h 9d Qc]
Seat 1: Jimy Tiltman folded before Flop (didn't bet)
Seat 2: $-Twackle-$ (button) collected ($4.97)
Seat 3: pablos1922 (small blind) folded on the Turn
Seat 4: YuriiSolodya (big blind) folded before Flop
Seat 5: DUkalisUA folded before Flop (didn't bet)
Seat 6: Effort92 folded before Flop (didn't bet)
Seat 7: matiko09 folded before Flop (didn't bet)
Seat 8: Red4erT folded before Flop (didn't bet)
Seat 9: RICKA16 folded before Flop (didn't bet)





PokerStars Hand #150801836642:  Hold'em No Limit ($0.50/$1.00 USD) - 2016/03/23 14:42:10 CET [2016/03/23 9:42:10 ET]
Table 'Donar II' 9-max Seat #6 is the button
Seat 1: Effort92 ($121.57 in chips) 
Seat 2: nobrunobru1 ($37.64 in chips) 
Seat 3: st-germ30 ($99.60 in chips) 
Seat 4: DUkalisUA ($161.04 in chips) 
Seat 5: matiko09 ($100 in chips) 
Seat 6: ardo888 ($176.53 in chips) 
Seat 7: JimineyCrik ($125.79 in chips) 
Seat 8: $-Twackle-$ ($126 in chips) 
Seat 9: oxfordtenzin ($41.55 in chips) 
JimineyCrik: posts small blind $0.50
$-Twackle-$: posts big blind $1
Effort92: posts the ante $0.20
nobrunobru1: posts the ante $0.20
st-germ30: posts the ante $0.20
DUkalisUA: posts the ante $0.20
matiko09: posts the ante $0.20
ardo888: posts the ante $0.20
JimineyCrik: posts the ante $0.20
$-Twackle-$: posts the ante $0.20
oxfordtenzin: posts the ante $0.20
*** HOLE CARDS ***
Dealt to matiko09 [3c 8h]
oxfordtenzin: raises $1 to $2
Effort92: folds 
nobrunobru1: folds 
st-germ30: folds 
DUkalisUA: folds 
matiko09: folds 
ardo888: calls $2
JimineyCrik: folds 
$-Twackle-$: calls $1
*** FLOP *** [5s 9s 9h]
$-Twackle-$: checks 
oxfordtenzin: checks 
ardo888: bets $4.20
$-Twackle-$: folds 
oxfordtenzin: calls $4.20
*** TURN *** [5s 9s 9h] [Ks]
oxfordtenzin: checks 
ardo888: checks 
*** RIVER *** [5s 9s 9h Ks] [Qc]
oxfordtenzin: bets $10
ardo888: folds 
Uncalled bet ($10) returned to oxfordtenzin
oxfordtenzin collected $15.95 from pot
oxfordtenzin: doesn't show hand 
*** SUMMARY ***
Total pot $16.70 | Rake $0.75 
Board [5s 9s 9h Ks Qc]
Seat 1: Effort92 folded before Flop (didn't bet)
Seat 2: nobrunobru1 folded before Flop (didn't bet)
Seat 3: st-germ30 folded before Flop (didn't bet)
Seat 4: DUkalisUA folded before Flop (didn't bet)
Seat 5: matiko09 folded before Flop (didn't bet)
Seat 6: ardo888 (button) folded on the River
Seat 7: JimineyCrik (small blind) folded before Flop
Seat 8: $-Twackle-$ (big blind) folded on the Flop
Seat 9: oxfordtenzin collected ($15.95)





PokerStars Hand #150801841438:  Hold'em No Limit ($0.50/$1.00 USD) - 2016/03/23 14:42:18 CET [2016/03/23 9:42:18 ET]
Table 'Swings' 9-max Seat #5 is the button
Seat 1: Sherlockplay ($100 in chips) 
Seat 2: Harbinger X ($187.14 in chips) 
Seat 3: maxxmeister ($122.78 in chips) 
Seat 4: chaps1988 ($100 in chips) 
Seat 5: chautinhtri9 ($98.50 in chips) 
Seat 6: matiko09 ($126.93 in chips) 
Seat 7: PacPacBum ($100 in chips) 
Seat 8: RICKA16 ($101.50 in chips) 
Seat 9: Vlad_1965_77 ($107.55 in chips) 
matiko09: posts small blind $0.50
PacPacBum: posts big blind $1
*** HOLE CARDS ***
Dealt to matiko09 [Qd Th]
RICKA16: folds 
Vlad_1965_77: raises $2 to $3
Sherlockplay: folds 
Harbinger X: folds 
maxxmeister: folds 
chaps1988: folds 
chautinhtri9: calls $3
matiko09: folds 
PacPacBum: folds 
*** FLOP *** [8s Tc 9d]
Vlad_1965_77: bets $3.58
chautinhtri9: folds 
Uncalled bet ($3.58) returned to Vlad_1965_77
Vlad_1965_77 collected $7.16 from pot
*** SUMMARY ***
Total pot $7.50 | Rake $0.34 
Board [8s Tc 9d]
Seat 1: Sherlockplay folded before Flop (didn't bet)
Seat 2: Harbinger X folded before Flop (didn't bet)
Seat 3: maxxmeister folded before Flop (didn't bet)
Seat 4: chaps1988 folded before Flop (didn't bet)
Seat 5: chautinhtri9 (button) folded on the Flop
Seat 6: matiko09 (small blind) folded before Flop
Seat 7: PacPacBum (big blind) folded before Flop
Seat 8: RICKA16 folded before Flop (didn't bet)
Seat 9: Vlad_1965_77 collected ($7.16)





PokerStars Hand #150801846284:  Hold'em No Limit ($1/$2 USD) - 2016/03/23 14:42:26 CET [2016/03/23 9:42:26 ET]
Table 'Achaia' 9-max Seat #1 is the button
Seat 1: Moszes360 ($226.36 in chips) 
Seat 2: InsomniaRU ($222.44 in chips) 
Seat 3: matiko09 ($221.20 in chips) 
Seat 4: erfk1958 ($119 in chips) 
Seat 5: chaps1988 ($214.70 in chips) 
Seat 6: nickreason17 ($214.99 in chips) 
Seat 7: morosun ($275.94 in chips) 
Seat 8: $-Twackle-$ ($222.07 in chips) 
Seat 9: glanza_mike ($200 in chips) 
InsomniaRU: posts small blind $1
matiko09: posts big blind $2
*** HOLE CARDS ***
Dealt to matiko09 [Qd 2s]
erfk1958: folds 
chaps1988: folds 
nickreason17: folds 
morosun: folds 
$-Twackle-$: folds 
glanza_mike: folds 
Moszes360: folds 
InsomniaRU: raises $4 to $6
matiko09: folds 
Uncalled bet ($4) returned to InsomniaRU
InsomniaRU collected $4 from pot
InsomniaRU: doesn't show hand 
*** SUMMARY ***
Total pot $4 | Rake $0 
Seat 1: Moszes360 (button) folded before Flop (didn't bet)
Seat 2: InsomniaRU (small blind) collected ($4)
Seat 3: matiko09 (big blind) folded before Flop
Seat 4: erfk1958 folded before Flop (didn't bet)
Seat 5: chaps1988 folded before Flop (didn't bet)
Seat 6: nickreason17 folded before Flop (didn't bet)
Seat 7: morosun folded before Flop (didn't bet)
Seat 8: $-Twackle-$ folded before Flop (didn't bet)
Seat 9: glanza_mike folded before Flop (didn't bet)





PokerStars Hand #150801847169:  Hold'em No Limit ($1/$2 USD) - 2016/03/23 14:42:27 CET [2016/03/23 9:42:27 ET]
Table 'Ennomos II' 9-max Seat #7 is the button
Seat 1: InsomniaRU ($200 in chips) 
Seat 3: $-Twackle-$ ($439.20 in chips) 
Seat 4: glanza_mike ($200 in chips) 
Seat 5: South011 ($391.02 in chips) 
Seat 6: nickreason17 ($393.62 in chips) 
Seat 7: T0ny Adams ($77 in chips) 
Seat 8: yyfk ($200 in chips) 
Seat 9: matiko09 ($347.94 in chips) 
yyfk: posts small blind $1
matiko09: posts big blind $2
*** HOLE CARDS ***
Dealt to matiko09 [6h 4h]
InsomniaRU: raises $3 to $5
$-Twackle-$: folds 
glanza_mike: folds 
Subam leaves the table
Moszes360 joins the table at seat #2 
South011: folds 
nickreason17: folds 
T0ny Adams: folds 
yyfk: folds 
matiko09: folds 
Uncalled bet ($3) returned to InsomniaRU
InsomniaRU collected $5 from pot
InsomniaRU: doesn't show hand 
*** SUMMARY ***
Total pot $5 | Rake $0 
Seat 1: InsomniaRU collected ($5)
Seat 3: $-Twackle-$ folded before Flop (didn't bet)
Seat 4: glanza_mike folded before Flop (didn't bet)
Seat 5: South011 folded before Flop (didn't bet)
Seat 6: nickreason17 folded before Flop (didn't bet)
Seat 7: T0ny Adams (button) folded before Flop (didn't bet)
Seat 8: yyfk (small blind) folded before Flop
Seat 9: matiko09 (big blind) folded before Flop





PokerStars Hand #150801851571:  Hold'em No Limit ($1/$2 USD) - 2016/03/23 14:42:34 CET [2016/03/23 9:42:34 ET]
Table 'Herba II' 9-max Seat #8 is the button
Seat 1: matiko09 ($226.62 in chips) 
Seat 2: Moszes360 ($203.17 in chips) 
Seat 3: Cirilico ($173.84 in chips) 
Seat 4: DUkalisUA ($252.20 in chips) 
Seat 5: chippo boy ($238.13 in chips) 
Seat 6: Too-Anti-To ($228.38 in chips) 
Seat 7: InsomniaRU ($408.70 in chips) 
Seat 8: The_red_area ($390.98 in chips) 
Seat 9: mrhighryza ($61.27 in chips) 
mrhighryza: posts small blind $1
matiko09: posts big blind $2
*** HOLE CARDS ***
Dealt to matiko09 [6d As]
Moszes360: folds 
Cirilico: raises $4 to $6
DUkalisUA: folds 
chippo boy: calls $6
Too-Anti-To: folds 
InsomniaRU: folds 
The_red_area: folds 
mrhighryza: calls $5
matiko09: folds 
*** FLOP *** [Jc Ad Td]
mrhighryza: checks 
Cirilico: checks 
chippo boy: checks 
*** TURN *** [Jc Ad Td] [Kc]
mrhighryza: checks 
Cirilico: checks 
chippo boy: bets $10
mrhighryza: folds 
Cirilico: calls $10
*** RIVER *** [Jc Ad Td Kc] [4d]
Cirilico: checks 
chippo boy: bets $14
Cirilico: calls $14
*** SHOW DOWN ***
chippo boy: shows [Qc 5c] (a straight, Ten to Ace)
Cirilico: mucks hand 
chippo boy collected $65.20 from pot
*** SUMMARY ***
Total pot $68 | Rake $2.80 
Board [Jc Ad Td Kc 4d]
Seat 1: matiko09 (big blind) folded before Flop
Seat 2: Moszes360 folded before Flop (didn't bet)
Seat 3: Cirilico mucked [Kh Jh]
Seat 4: DUkalisUA folded before Flop (didn't bet)
Seat 5: chippo boy showed [Qc 5c] and won ($65.20) with a straight, Ten to Ace
Seat 6: Too-Anti-To folded before Flop (didn't bet)
Seat 7: InsomniaRU folded before Flop (didn't bet)
Seat 8: The_red_area (button) folded before Flop (didn't bet)
Seat 9: mrhighryza (small blind) folded on the Turn





PokerStars Hand #150801853032:  Hold'em No Limit ($0.50/$1.00 USD) - 2016/03/23 14:42:36 CET [2016/03/23 9:42:36 ET]
Table 'Atlantis' 9-max Seat #5 is the button
Seat 1: xHourglass ($136 in chips) 
Seat 2: Szevasztopol ($103.68 in chips) 
Seat 3: CAJUN890 ($143.34 in chips) 
Seat 4: matiko09 ($124.25 in chips) 
Seat 5: Pvsx. ($107.06 in chips) 
Seat 6: Jimy Tiltman ($100.50 in chips) 
Seat 7: Sherlockplay ($142.98 in chips) 
Seat 8: DUkalisUA ($135 in chips) 
Seat 9: RICKA16 ($104.16 in chips) 
Jimy Tiltman: posts small blind $0.50
Sherlockplay: posts big blind $1
*** HOLE CARDS ***
Dealt to matiko09 [7h 3h]
DUkalisUA: folds 
RICKA16: folds 
xHourglass has timed out
xHourglass: folds 
Szevasztopol: folds 
CAJUN890: folds 
matiko09: folds 
Pvsx.: folds 
Jimy Tiltman: raises $2 to $3
Sherlockplay: folds 
Uncalled bet ($2) returned to Jimy Tiltman
Jimy Tiltman collected $2 from pot
Jimy Tiltman: doesn't show hand 
*** SUMMARY ***
Total pot $2 | Rake $0 
Seat 1: xHourglass folded before Flop (didn't bet)
Seat 2: Szevasztopol folded before Flop (didn't bet)
Seat 3: CAJUN890 folded before Flop (didn't bet)
Seat 4: matiko09 folded before Flop (didn't bet)
Seat 5: Pvsx. (button) folded before Flop (didn't bet)
Seat 6: Jimy Tiltman (small blind) collected ($2)
Seat 7: Sherlockplay (big blind) folded before Flop
Seat 8: DUkalisUA folded before Flop (didn't bet)
Seat 9: RICKA16 folded before Flop (didn't bet)





PokerStars Hand #150801859508:  Hold'em No Limit ($1/$2 USD) - 2016/03/23 14:42:46 CET [2016/03/23 9:42:46 ET]
Table 'Achaia' 9-max Seat #2 is the button
Seat 1: Moszes360 ($226.36 in chips) 
Seat 2: InsomniaRU ($224.44 in chips) 
Seat 3: matiko09 ($219.20 in chips) 
Seat 4: erfk1958 ($119 in chips) 
Seat 5: chaps1988 ($214.70 in chips) 
Seat 6: nickreason17 ($214.99 in chips) 
Seat 7: morosun ($275.94 in chips) 
Seat 8: $-Twackle-$ ($222.07 in chips) 
Seat 9: glanza_mike ($200 in chips) 
matiko09: posts small blind $1
erfk1958: posts big blind $2
*** HOLE CARDS ***
Dealt to matiko09 [Js Ks]
chaps1988: folds 
nickreason17: folds 
morosun: calls $2
$-Twackle-$: folds 
glanza_mike: folds 
Moszes360: folds 
InsomniaRU: raises $5 to $7
matiko09: calls $6
erfk1958: folds 
morosun: calls $5
*** FLOP *** [9s Qs 7h]
matiko09: bets $14
morosun: folds 
InsomniaRU: folds 
Uncalled bet ($14) returned to matiko09
matiko09 collected $21.96 from pot
matiko09: doesn't show hand 
*** SUMMARY ***
Total pot $23 | Rake $1.04 
Board [9s Qs 7h]
Seat 1: Moszes360 folded before Flop (didn't bet)
Seat 2: InsomniaRU (button) folded on the Flop
Seat 3: matiko09 (small blind) collected ($21.96)
Seat 4: erfk1958 (big blind) folded before Flop
Seat 5: chaps1988 folded before Flop (didn't bet)
Seat 6: nickreason17 folded before Flop (didn't bet)
Seat 7: morosun folded on the Flop
Seat 8: $-Twackle-$ folded before Flop (didn't bet)
Seat 9: glanza_mike folded before Flop (didn't bet)





PokerStars Hand #150801861878:  Hold'em No Limit ($0.50/$1.00 USD) - 2016/03/23 14:42:50 CET [2016/03/23 9:42:50 ET]
Table 'Asmodeus' 9-max Seat #9 is the button
Seat 1: Jimy Tiltman ($106.10 in chips) 
Seat 2: $-Twackle-$ ($100 in chips) 
Seat 3: nickreason17 ($100 in chips) 
Seat 4: Effort92 ($100 in chips) 
Seat 5: chaps1988 ($100 in chips) 
Seat 7: PacPacBum ($107.93 in chips) 
Seat 8: KEBIN1974 ($151.84 in chips) 
Seat 9: matiko09 ($100 in chips) 
Jimy Tiltman: posts small blind $0.50
$-Twackle-$: posts big blind $1
Jimy Tiltman: posts the ante $0.20
$-Twackle-$: posts the ante $0.20
nickreason17: posts the ante $0.20
Effort92: posts the ante $0.20
chaps1988: posts the ante $0.20
PacPacBum: posts the ante $0.20
KEBIN1974: posts the ante $0.20
matiko09: posts the ante $0.20
*** HOLE CARDS ***
Dealt to matiko09 [9s 8c]
nickreason17: raises $2 to $3
Effort92: folds 
chaps1988: raises $7 to $10
PacPacBum: folds 
KEBIN1974: folds 
matiko09: folds 
Jimy Tiltman: folds 
$-Twackle-$: folds 
nickreason17: folds 
Uncalled bet ($7) returned to chaps1988
chaps1988 collected $9.10 from pot
chaps1988: doesn't show hand 
*** SUMMARY ***
Total pot $9.10 | Rake $0 
Seat 1: Jimy Tiltman (small blind) folded before Flop
Seat 2: $-Twackle-$ (big blind) folded before Flop
Seat 3: nickreason17 folded before Flop
Seat 4: Effort92 folded before Flop (didn't bet)
Seat 5: chaps1988 collected ($9.10)
Seat 7: PacPacBum folded before Flop (didn't bet)
Seat 8: KEBIN1974 folded before Flop (didn't bet)
Seat 9: matiko09 (button) folded before Flop (didn't bet)





PokerStars Hand #150801863861:  Hold'em No Limit ($1/$2 USD) - 2016/03/23 14:42:53 CET [2016/03/23 9:42:53 ET]
Table 'Ennomos II' 9-max Seat #8 is the button
Seat 1: InsomniaRU ($203 in chips) 
Seat 3: $-Twackle-$ ($439.20 in chips) 
Seat 4: glanza_mike ($200 in chips) 
Seat 5: South011 ($391.02 in chips) 
Seat 6: nickreason17 ($393.62 in chips) 
Seat 7: T0ny Adams ($77 in chips) 
Seat 8: yyfk ($200 in chips) 
Seat 9: matiko09 ($345.94 in chips) 
matiko09: posts small blind $1
InsomniaRU: posts big blind $2
Moszes360: sits out 
*** HOLE CARDS ***
Dealt to matiko09 [Qd 3s]
$-Twackle-$: folds 
glanza_mike: folds 
South011: folds 
nickreason17: folds 
T0ny Adams: raises $3 to $5
yyfk: folds 
matiko09: folds 
InsomniaRU: raises $7 to $12
T0ny Adams: folds 
Uncalled bet ($7) returned to InsomniaRU
InsomniaRU collected $11 from pot
InsomniaRU: doesn't show hand 
*** SUMMARY ***
Total pot $11 | Rake $0 
Seat 1: InsomniaRU (big blind) collected ($11)
Seat 3: $-Twackle-$ folded before Flop (didn't bet)
Seat 4: glanza_mike folded before Flop (didn't bet)
Seat 5: South011 folded before Flop (didn't bet)
Seat 6: nickreason17 folded before Flop (didn't bet)
Seat 7: T0ny Adams folded before Flop
Seat 8: yyfk (button) folded before Flop (didn't bet)
Seat 9: matiko09 (small blind) folded before Flop





PokerStars Hand #150801873558:  Hold'em No Limit ($0.50/$1.00 USD) - 2016/03/23 14:43:08 CET [2016/03/23 9:43:08 ET]
Table 'Merope II' 9-max Seat #3 is the button
Seat 1: Jimy Tiltman ($137.73 in chips) 
Seat 2: $-Twackle-$ ($102.87 in chips) 
Seat 3: pablos1922 ($89.65 in chips) 
Seat 4: YuriiSolodya ($89.34 in chips) 
Seat 6: Effort92 ($101.21 in chips) 
Seat 7: matiko09 ($106.53 in chips) 
Seat 8: Red4erT ($40 in chips) 
Seat 9: RICKA16 ($102.50 in chips) 
YuriiSolodya: posts small blind $0.50
DUkalisUA: is sitting out 
Effort92: posts big blind $1
*** HOLE CARDS ***
Dealt to matiko09 [Jd 6d]
DUkalisUA leaves the table
matiko09: folds 
Red4erT: folds 
RICKA16: folds 
Butcher1848 joins the table at seat #5 
Jimy Tiltman: folds 
$-Twackle-$: folds 
pablos1922: folds 
YuriiSolodya: folds 
Uncalled bet ($0.50) returned to Effort92
Effort92 collected $1 from pot
Effort92: doesn't show hand 
*** SUMMARY ***
Total pot $1 | Rake $0 
Seat 1: Jimy Tiltman folded before Flop (didn't bet)
Seat 2: $-Twackle-$ folded before Flop (didn't bet)
Seat 3: pablos1922 (button) folded before Flop (didn't bet)
Seat 4: YuriiSolodya (small blind) folded before Flop
Seat 6: Effort92 (big blind) collected ($1)
Seat 7: matiko09 folded before Flop (didn't bet)
Seat 8: Red4erT folded before Flop (didn't bet)
Seat 9: RICKA16 folded before Flop (didn't bet)





PokerStars Hand #150801875994:  Hold'em No Limit ($0.50/$1.00 USD) - 2016/03/23 14:43:12 CET [2016/03/23 9:43:12 ET]
Table 'Swings' 9-max Seat #6 is the button
Seat 1: Sherlockplay ($100 in chips) 
Seat 2: Harbinger X ($187.14 in chips) 
Seat 3: maxxmeister ($122.78 in chips) 
Seat 4: chaps1988 ($100 in chips) 
Seat 5: chautinhtri9 ($95.50 in chips) 
Seat 6: matiko09 ($126.43 in chips) 
Seat 7: PacPacBum ($100 in chips) 
Seat 8: RICKA16 ($101.50 in chips) 
Seat 9: Vlad_1965_77 ($111.71 in chips) 
PacPacBum: posts small blind $0.50
RICKA16: posts big blind $1
*** HOLE CARDS ***
Dealt to matiko09 [9s Jc]
Vlad_1965_77: folds 
Sherlockplay: raises $1.50 to $2.50
Harbinger X: folds 
maxxmeister: folds 
chaps1988: folds 
chautinhtri9: folds 
matiko09: folds 
PacPacBum: folds 
RICKA16: folds 
Uncalled bet ($1.50) returned to Sherlockplay
Sherlockplay collected $2.50 from pot
Sherlockplay: doesn't show hand 
*** SUMMARY ***
Total pot $2.50 | Rake $0 
Seat 1: Sherlockplay collected ($2.50)
Seat 2: Harbinger X folded before Flop (didn't bet)
Seat 3: maxxmeister folded before Flop (didn't bet)
Seat 4: chaps1988 folded before Flop (didn't bet)
Seat 5: chautinhtri9 folded before Flop (didn't bet)
Seat 6: matiko09 (button) folded before Flop (didn't bet)
Seat 7: PacPacBum (small blind) folded before Flop
Seat 8: RICKA16 (big blind) folded before Flop
Seat 9: Vlad_1965_77 folded before Flop (didn't bet)





PokerStars Hand #150801877367:  Hold'em No Limit ($0.25/$0.50 USD) - 2016/03/23 14:43:14 CET [2016/03/23 9:43:14 ET]
Table 'Pyrrhus' 9-max Seat #6 is the button
Seat 2: BSTUSim ($74.88 in chips) 
Seat 3: i L00K great ($50 in chips) 
Seat 4: GriffinBerg ($42.95 in chips) 
Seat 5: ZonTTT ($52.86 in chips) 
Seat 6: Ahangama ($50 in chips) 
Seat 7: matiko09 ($139.23 in chips) 
Seat 8: dndngod ($70.48 in chips) 
Seat 9: CvMCvMCvM ($93.52 in chips) 
matiko09: posts small blind $0.25
dndngod: posts big blind $0.50
*** HOLE CARDS ***
Dealt to matiko09 [5c 3c]
CvMCvMCvM: folds 
BSTUSim: folds 
i L00K great: folds 
GriffinBerg: folds 
ZonTTT: folds 
Ahangama: raises $0.50 to $1
matiko09: folds 
dndngod: folds 
Uncalled bet ($0.50) returned to Ahangama
Ahangama collected $1.25 from pot
Ahangama: doesn't show hand 
*** SUMMARY ***
Total pot $1.25 | Rake $0 
Seat 2: BSTUSim folded before Flop (didn't bet)
Seat 3: i L00K great folded before Flop (didn't bet)
Seat 4: GriffinBerg folded before Flop (didn't bet)
Seat 5: ZonTTT folded before Flop (didn't bet)
Seat 6: Ahangama (button) collected ($1.25)
Seat 7: matiko09 (small blind) folded before Flop
Seat 8: dndngod (big blind) folded before Flop
Seat 9: CvMCvMCvM folded before Flop (didn't bet)





PokerStars Hand #150801878271:  Hold'em No Limit ($1/$2 USD) - 2016/03/23 14:43:16 CET [2016/03/23 9:43:16 ET]
Table 'Kypria II' 9-max Seat #6 is the button
Seat 1: geldwolfje ($143.63 in chips) 
Seat 3: seouljam ($209.08 in chips) 
Seat 4: VolanDog ($231.12 in chips) 
Seat 5: InsomniaRU ($311.74 in chips) 
Seat 6: matiko09 ($424.53 in chips) 
Seat 7: DUkalisUA ($203 in chips) 
Seat 8: nickreason17 ($200 in chips) 
Seat 9: Moszes360 ($200 in chips) 
DUkalisUA: posts small blind $1
nickreason17: posts big blind $2
*** HOLE CARDS ***
Dealt to matiko09 [8s 9h]
Moszes360: folds 
geldwolfje: raises $2 to $4
seouljam: calls $4
VolanDog: folds 
InsomniaRU: folds 
matiko09: folds 
DUkalisUA: folds 
nickreason17: calls $2
*** FLOP *** [Qs 3d Ts]
nickreason17: checks 
geldwolfje: checks 
seouljam: bets $8
nickreason17: calls $8
geldwolfje: calls $8
*** TURN *** [Qs 3d Ts] [2h]
nickreason17: checks 
geldwolfje: checks 
seouljam: bets $16
nickreason17: folds 
geldwolfje: folds 
Uncalled bet ($16) returned to seouljam
seouljam collected $35.34 from pot
seouljam: doesn't show hand 
*** SUMMARY ***
Total pot $37 | Rake $1.66 
Board [Qs 3d Ts 2h]
Seat 1: geldwolfje folded on the Turn
Seat 3: seouljam collected ($35.34)
Seat 4: VolanDog folded before Flop (didn't bet)
Seat 5: InsomniaRU folded before Flop (didn't bet)
Seat 6: matiko09 (button) folded before Flop (didn't bet)
Seat 7: DUkalisUA (small blind) folded before Flop
Seat 8: nickreason17 (big blind) folded on the Turn
Seat 9: Moszes360 folded before Flop (didn't bet)





PokerStars Hand #150801882533:  Hold'em No Limit ($1/$2 USD) - 2016/03/23 14:43:22 CET [2016/03/23 9:43:22 ET]
Table 'Achaia' 9-max Seat #3 is the button
Seat 1: Moszes360 ($226.36 in chips) 
Seat 2: InsomniaRU ($217.44 in chips) 
Seat 3: matiko09 ($234.16 in chips) 
Seat 4: erfk1958 ($117 in chips) 
Seat 5: chaps1988 ($214.70 in chips) 
Seat 6: nickreason17 ($214.99 in chips) 
Seat 7: morosun ($268.94 in chips) 
Seat 8: $-Twackle-$ ($222.07 in chips) 
Seat 9: glanza_mike ($200 in chips) 
erfk1958: posts small blind $1
chaps1988: posts big blind $2
*** HOLE CARDS ***
Dealt to matiko09 [6h 8h]
nickreason17: folds 
morosun: folds 
$-Twackle-$: folds 
glanza_mike: folds 
Moszes360: folds 
InsomniaRU: folds 
matiko09: raises $2.54 to $4.54
erfk1958: folds 
chaps1988: folds 
Uncalled bet ($2.54) returned to matiko09
matiko09 collected $5 from pot
matiko09: doesn't show hand 
*** SUMMARY ***
Total pot $5 | Rake $0 
Seat 1: Moszes360 folded before Flop (didn't bet)
Seat 2: InsomniaRU folded before Flop (didn't bet)
Seat 3: matiko09 (button) collected ($5)
Seat 4: erfk1958 (small blind) folded before Flop
Seat 5: chaps1988 (big blind) folded before Flop
Seat 6: nickreason17 folded before Flop (didn't bet)
Seat 7: morosun folded before Flop (didn't bet)
Seat 8: $-Twackle-$ folded before Flop (didn't bet)
Seat 9: glanza_mike folded before Flop (didn't bet)





PokerStars Hand #150801884830:  Hold'em No Limit ($0.50/$1.00 USD) - 2016/03/23 14:43:26 CET [2016/03/23 9:43:26 ET]
Table 'Atlantis' 9-max Seat #6 is the button
Seat 1: xHourglass ($136 in chips) 
Seat 2: Szevasztopol ($103.68 in chips) 
Seat 3: CAJUN890 ($143.34 in chips) 
Seat 4: matiko09 ($124.25 in chips) 
Seat 5: Pvsx. ($107.06 in chips) 
Seat 6: Jimy Tiltman ($101.50 in chips) 
Seat 7: Sherlockplay ($141.98 in chips) 
Seat 8: DUkalisUA ($135 in chips) 
Seat 9: RICKA16 ($104.16 in chips) 
Sherlockplay: posts small blind $0.50
DUkalisUA: posts big blind $1
*** HOLE CARDS ***
Dealt to matiko09 [Jc 9h]
RICKA16: folds 
xHourglass: folds 
Szevasztopol: folds 
CAJUN890: folds 
matiko09: folds 
Pvsx.: folds 
Jimy Tiltman: raises $1 to $2
Sherlockplay: folds 
DUkalisUA: calls $1
*** FLOP *** [2h 8c 7c]
DUkalisUA: checks 
Jimy Tiltman: checks 
*** TURN *** [2h 8c 7c] [4c]
DUkalisUA: bets $3.87
Jimy Tiltman: folds 
Uncalled bet ($3.87) returned to DUkalisUA
DUkalisUA collected $4.30 from pot
DUkalisUA: doesn't show hand 
*** SUMMARY ***
Total pot $4.50 | Rake $0.20 
Board [2h 8c 7c 4c]
Seat 1: xHourglass folded before Flop (didn't bet)
Seat 2: Szevasztopol folded before Flop (didn't bet)
Seat 3: CAJUN890 folded before Flop (didn't bet)
Seat 4: matiko09 folded before Flop (didn't bet)
Seat 5: Pvsx. folded before Flop (didn't bet)
Seat 6: Jimy Tiltman (button) folded on the Turn
Seat 7: Sherlockplay (small blind) folded before Flop
Seat 8: DUkalisUA (big blind) collected ($4.30)
Seat 9: RICKA16 folded before Flop (didn't bet)





PokerStars Hand #150801885893:  Hold'em No Limit ($0.50/$1.00 USD) - 2016/03/23 14:43:28 CET [2016/03/23 9:43:28 ET]
Table 'Asmodeus' 9-max Seat #1 is the button
Seat 1: Jimy Tiltman ($105.40 in chips) 
Seat 2: $-Twackle-$ ($100 in chips) 
Seat 3: nickreason17 ($100 in chips) 
Seat 4: Effort92 ($100 in chips) 
Seat 5: chaps1988 ($105.90 in chips) 
Seat 7: PacPacBum ($107.73 in chips) 
Seat 8: KEBIN1974 ($151.64 in chips) 
Seat 9: matiko09 ($100 in chips) 
$-Twackle-$: posts small blind $0.50
nickreason17: posts big blind $1
Jimy Tiltman: posts the ante $0.20
$-Twackle-$: posts the ante $0.20
nickreason17: posts the ante $0.20
Effort92: posts the ante $0.20
chaps1988: posts the ante $0.20
PacPacBum: posts the ante $0.20
KEBIN1974: posts the ante $0.20
matiko09: posts the ante $0.20
*** HOLE CARDS ***
Dealt to matiko09 [7d 3d]
Effort92: raises $1.50 to $2.50
chaps1988: folds 
PacPacBum: folds 
KEBIN1974: folds 
matiko09: folds 
Jimy Tiltman: folds 
$-Twackle-$: folds 
nickreason17: calls $1.50
*** FLOP *** [4c 6d Ah]
nickreason17: checks 
Effort92: bets $2.84
nickreason17: calls $2.84
*** TURN *** [4c 6d Ah] [4s]
nickreason17: checks 
Effort92: checks 
*** RIVER *** [4c 6d Ah 4s] [9s]
nickreason17: checks 
Effort92: checks 
*** SHOW DOWN ***
nickreason17: shows [7s 7c] (two pair, Sevens and Fours)
Effort92: shows [Ts Tc] (two pair, Tens and Fours)
Effort92 collected $12.20 from pot
*** SUMMARY ***
Total pot $12.78 | Rake $0.58 
Board [4c 6d Ah 4s 9s]
Seat 1: Jimy Tiltman (button) folded before Flop (didn't bet)
Seat 2: $-Twackle-$ (small blind) folded before Flop
Seat 3: nickreason17 (big blind) showed [7s 7c] and lost with two pair, Sevens and Fours
Seat 4: Effort92 showed [Ts Tc] and won ($12.20) with two pair, Tens and Fours
Seat 5: chaps1988 folded before Flop (didn't bet)
Seat 7: PacPacBum folded before Flop (didn't bet)
Seat 8: KEBIN1974 folded before Flop (didn't bet)
Seat 9: matiko09 folded before Flop (didn't bet)





PokerStars Hand #150801888167:  Hold'em No Limit ($1/$2 USD) - 2016/03/23 14:43:32 CET [2016/03/23 9:43:32 ET]
Table 'Kiess' 9-max Seat #2 is the button
Seat 1: Cirilico ($209.22 in chips) 
Seat 2: DUkalisUA ($678.34 in chips) 
Seat 3: The_red_area ($319.27 in chips) 
Seat 4: Moszes360 ($200 in chips) 
Seat 5: chippo boy ($490.09 in chips) 
Seat 6: matiko09 ($263.86 in chips) 
Seat 7: InsomniaRU ($303.97 in chips) 
Seat 8: erfk1958 ($94.96 in chips) 
Seat 9: T0ny Adams ($100.46 in chips) 
The_red_area: posts small blind $1
Moszes360: posts big blind $2
*** HOLE CARDS ***
Dealt to matiko09 [9s Ks]
chippo boy: calls $2
matiko09: folds 
InsomniaRU: folds 
erfk1958: folds 
T0ny Adams: folds 
Cirilico: folds 
DUkalisUA: folds 
The_red_area: raises $6 to $8
Moszes360: folds 
chippo boy: calls $6
*** FLOP *** [Jh 9h 4c]
The_red_area: bets $17.19
chippo boy: folds 
Uncalled bet ($17.19) returned to The_red_area
The_red_area collected $17.19 from pot
The_red_area: doesn't show hand 
*** SUMMARY ***
Total pot $18 | Rake $0.81 
Board [Jh 9h 4c]
Seat 1: Cirilico folded before Flop (didn't bet)
Seat 2: DUkalisUA (button) folded before Flop (didn't bet)
Seat 3: The_red_area (small blind) collected ($17.19)
Seat 4: Moszes360 (big blind) folded before Flop
Seat 5: chippo boy folded on the Flop
Seat 6: matiko09 folded before Flop (didn't bet)
Seat 7: InsomniaRU folded before Flop (didn't bet)
Seat 8: erfk1958 folded before Flop (didn't bet)
Seat 9: T0ny Adams folded before Flop (didn't bet)





PokerStars Hand #150801888724:  Hold'em No Limit ($0.50/$1.00 USD) - 2016/03/23 14:43:32 CET [2016/03/23 9:43:32 ET]
Table 'Merope II' 9-max Seat #4 is the button
Seat 1: Jimy Tiltman ($137.73 in chips) 
Seat 2: $-Twackle-$ ($102.87 in chips) 
Seat 3: pablos1922 ($89.65 in chips) 
Seat 4: YuriiSolodya ($88.84 in chips) 
Seat 6: Effort92 ($101.71 in chips) 
Seat 7: matiko09 ($106.53 in chips) 
Seat 8: Red4erT ($40 in chips) 
Seat 9: RICKA16 ($102.50 in chips) 
Butcher1848 will be allowed to play after the button
Effort92: posts small blind $0.50
matiko09: posts big blind $1
*** HOLE CARDS ***
Dealt to matiko09 [Ts Qh]
Red4erT: folds 
RICKA16: folds 
Jimy Tiltman: folds 
$-Twackle-$: folds 
pablos1922: raises $2 to $3
YuriiSolodya: calls $3
Effort92: folds 
matiko09: folds 
*** FLOP *** [3c As Tc]
pablos1922: bets $3.58
YuriiSolodya: folds 
Uncalled bet ($3.58) returned to pablos1922
pablos1922 collected $7.16 from pot
pablos1922: doesn't show hand 
*** SUMMARY ***
Total pot $7.50 | Rake $0.34 
Board [3c As Tc]
Seat 1: Jimy Tiltman folded before Flop (didn't bet)
Seat 2: $-Twackle-$ folded before Flop (didn't bet)
Seat 3: pablos1922 collected ($7.16)
Seat 4: YuriiSolodya (button) folded on the Flop
Seat 6: Effort92 (small blind) folded before Flop
Seat 7: matiko09 (big blind) folded before Flop
Seat 8: Red4erT folded before Flop (didn't bet)
Seat 9: RICKA16 folded before Flop (didn't bet)





PokerStars Hand #150801892080:  Hold'em No Limit ($0.25/$0.50 USD) - 2016/03/23 14:43:38 CET [2016/03/23 9:43:38 ET]
Table 'Pyrrhus' 9-max Seat #7 is the button
Seat 2: BSTUSim ($74.88 in chips) 
Seat 3: i L00K great ($50 in chips) 
Seat 4: GriffinBerg ($42.95 in chips) 
Seat 5: ZonTTT ($52.86 in chips) 
Seat 6: Ahangama ($50.75 in chips) 
Seat 7: matiko09 ($138.98 in chips) 
Seat 8: dndngod ($69.98 in chips) 
Seat 9: CvMCvMCvM ($93.52 in chips) 
dndngod: posts small blind $0.25
CvMCvMCvM: posts big blind $0.50
*** HOLE CARDS ***
Dealt to matiko09 [Qd 9h]
BSTUSim: folds 
i L00K great: folds 
GriffinBerg: folds 
ZonTTT: folds 
Ahangama: folds 
matiko09: raises $0.63 to $1.13
dndngod: folds 
CvMCvMCvM: calls $0.63
*** FLOP *** [Jd Js 5c]
CvMCvMCvM: checks 
matiko09: checks 
*** TURN *** [Jd Js 5c] [2h]
CvMCvMCvM: checks 
matiko09: checks 
*** RIVER *** [Jd Js 5c 2h] [Ah]
CvMCvMCvM: checks 
matiko09: checks 
*** SHOW DOWN ***
CvMCvMCvM: shows [6d 7d] (a pair of Jacks)
matiko09: shows [Qd 9h] (a pair of Jacks - Ace+Queen kicker)
matiko09 collected $2.40 from pot
*** SUMMARY ***
Total pot $2.51 | Rake $0.11 
Board [Jd Js 5c 2h Ah]
Seat 2: BSTUSim folded before Flop (didn't bet)
Seat 3: i L00K great folded before Flop (didn't bet)
Seat 4: GriffinBerg folded before Flop (didn't bet)
Seat 5: ZonTTT folded before Flop (didn't bet)
Seat 6: Ahangama folded before Flop (didn't bet)
Seat 7: matiko09 (button) showed [Qd 9h] and won ($2.40) with a pair of Jacks
Seat 8: dndngod (small blind) folded before Flop
Seat 9: CvMCvMCvM (big blind) showed [6d 7d] and lost with a pair of Jacks





PokerStars Hand #150801892079:  Hold'em No Limit ($0.50/$1.00 USD) - 2016/03/23 14:43:38 CET [2016/03/23 9:43:38 ET]
Table 'Swings' 9-max Seat #7 is the button
Seat 1: Sherlockplay ($101.50 in chips) 
Seat 2: Harbinger X ($187.14 in chips) 
Seat 3: maxxmeister ($122.78 in chips) 
Seat 4: chaps1988 ($100 in chips) 
Seat 5: chautinhtri9 ($95.50 in chips) 
Seat 6: matiko09 ($126.43 in chips) 
Seat 7: PacPacBum ($100 in chips) 
Seat 8: RICKA16 ($100.50 in chips) 
Seat 9: Vlad_1965_77 ($111.71 in chips) 
RICKA16: posts small blind $0.50
Vlad_1965_77: posts big blind $1
*** HOLE CARDS ***
Dealt to matiko09 [6c 3c]
Sherlockplay: raises $1.50 to $2.50
Harbinger X: folds 
maxxmeister: folds 
chaps1988: folds 
chautinhtri9: calls $2.50
matiko09: folds 
PacPacBum: folds 
RICKA16: folds 
Vlad_1965_77: folds 
*** FLOP *** [6s 6d Kh]
Sherlockplay: checks 
chautinhtri9: bets $4
Sherlockplay: calls $4
*** TURN *** [6s 6d Kh] [Qh]
Sherlockplay: checks 
chautinhtri9: bets $8
Sherlockplay: calls $8
*** RIVER *** [6s 6d Kh Qh] [Js]
Sherlockplay: checks 
chautinhtri9: checks 
*** SHOW DOWN ***
Sherlockplay: shows [Ad Ah] (two pair, Aces and Sixes)
chautinhtri9: mucks hand 
Sherlockplay collected $29.13 from pot
*** SUMMARY ***
Total pot $30.50 | Rake $1.37 
Board [6s 6d Kh Qh Js]
Seat 1: Sherlockplay showed [Ad Ah] and won ($29.13) with two pair, Aces and Sixes
Seat 2: Harbinger X folded before Flop (didn't bet)
Seat 3: maxxmeister folded before Flop (didn't bet)
Seat 4: chaps1988 folded before Flop (didn't bet)
Seat 5: chautinhtri9 mucked [Th 7h]
Seat 6: matiko09 folded before Flop (didn't bet)
Seat 7: PacPacBum (button) folded before Flop (didn't bet)
Seat 8: RICKA16 (small blind) folded before Flop
Seat 9: Vlad_1965_77 (big blind) folded before Flop





PokerStars Hand #150801896478:  Hold'em No Limit ($1/$2 USD) - 2016/03/23 14:43:45 CET [2016/03/23 9:43:45 ET]
Table 'Herba II' 9-max Seat #9 is the button
Seat 1: matiko09 ($224.62 in chips) 
Seat 2: Moszes360 ($203.17 in chips) 
Seat 3: Cirilico ($160 in chips) 
Seat 4: DUkalisUA ($252.20 in chips) 
Seat 5: chippo boy ($273.33 in chips) 
Seat 6: Too-Anti-To ($228.38 in chips) 
Seat 7: InsomniaRU ($408.70 in chips) 
Seat 8: The_red_area ($390.98 in chips) 
Seat 9: mrhighryza ($55.27 in chips) 
matiko09: posts small blind $1
Moszes360: posts big blind $2
*** HOLE CARDS ***
Dealt to matiko09 [8h Ts]
Cirilico: folds 
DUkalisUA: folds 
chippo boy: folds 
Too-Anti-To: folds 
InsomniaRU: folds 
The_red_area: folds 
mrhighryza: calls $2
matiko09: calls $1
Moszes360: checks 
*** FLOP *** [9s 3s 8d]
matiko09: checks 
Moszes360: bets $3.78
mrhighryza: calls $3.78
matiko09: folds 
*** TURN *** [9s 3s 8d] [5d]
Moszes360: checks 
mrhighryza: checks 
*** RIVER *** [9s 3s 8d 5d] [Js]
Moszes360: checks 
mrhighryza: bets $16
Moszes360: folds 
Uncalled bet ($16) returned to mrhighryza
mrhighryza collected $12.95 from pot
*** SUMMARY ***
Total pot $13.56 | Rake $0.61 
Board [9s 3s 8d 5d Js]
Seat 1: matiko09 (small blind) folded on the Flop
Seat 2: Moszes360 (big blind) folded on the River
Seat 3: Cirilico folded before Flop (didn't bet)
Seat 4: DUkalisUA folded before Flop (didn't bet)
Seat 5: chippo boy folded before Flop (didn't bet)
Seat 6: Too-Anti-To folded before Flop (didn't bet)
Seat 7: InsomniaRU folded before Flop (didn't bet)
Seat 8: The_red_area folded before Flop (didn't bet)
Seat 9: mrhighryza (button) collected ($12.95)





PokerStars Hand #150801896317:  Hold'em No Limit ($1/$2 USD) - 2016/03/23 14:43:45 CET [2016/03/23 9:43:45 ET]
Table 'Ennomos II' 9-max Seat #9 is the button
Seat 1: InsomniaRU ($209 in chips) 
Seat 2: Moszes360 ($200 in chips) 
Seat 3: $-Twackle-$ ($439.20 in chips) 
Seat 4: glanza_mike ($200 in chips) 
Seat 5: South011 ($391.02 in chips) 
Seat 6: nickreason17 ($393.62 in chips) 
Seat 7: T0ny Adams ($72 in chips) 
Seat 8: yyfk ($200 in chips) 
Seat 9: matiko09 ($344.94 in chips) 
InsomniaRU: posts small blind $1
Moszes360: posts big blind $2
*** HOLE CARDS ***
Dealt to matiko09 [Kd 4d]
$-Twackle-$: folds 
glanza_mike: folds 
South011: folds 
nickreason17: folds 
T0ny Adams: folds 
yyfk: folds 
matiko09: raises $2.54 to $4.54
InsomniaRU: raises $12.46 to $17
Moszes360: folds 
matiko09: folds 
Uncalled bet ($12.46) returned to InsomniaRU
InsomniaRU collected $11.08 from pot
InsomniaRU: doesn't show hand 
*** SUMMARY ***
Total pot $11.08 | Rake $0 
Seat 1: InsomniaRU (small blind) collected ($11.08)
Seat 2: Moszes360 (big blind) folded before Flop
Seat 3: $-Twackle-$ folded before Flop (didn't bet)
Seat 4: glanza_mike folded before Flop (didn't bet)
Seat 5: South011 folded before Flop (didn't bet)
Seat 6: nickreason17 folded before Flop (didn't bet)
Seat 7: T0ny Adams folded before Flop (didn't bet)
Seat 8: yyfk folded before Flop (didn't bet)
Seat 9: matiko09 (button) folded before Flop





PokerStars Hand #150801899305:  Hold'em No Limit ($0.50/$1.00 USD) - 2016/03/23 14:43:49 CET [2016/03/23 9:43:49 ET]
Table 'Donar II' 9-max Seat #7 is the button
Seat 1: Effort92 ($121.37 in chips) 
Seat 2: nobrunobru1 ($37.44 in chips) 
Seat 3: st-germ30 ($99.40 in chips) 
Seat 4: DUkalisUA ($160.84 in chips) 
Seat 5: matiko09 ($100 in chips) 
Seat 7: JimineyCrik ($125.09 in chips) 
Seat 8: $-Twackle-$ ($123.80 in chips) 
Seat 9: oxfordtenzin ($51.10 in chips) 
$-Twackle-$: posts small blind $0.50
oxfordtenzin: posts big blind $1
Effort92: posts the ante $0.20
nobrunobru1: posts the ante $0.20
st-germ30: posts the ante $0.20
DUkalisUA: posts the ante $0.20
matiko09: posts the ante $0.20
JimineyCrik: posts the ante $0.20
$-Twackle-$: posts the ante $0.20
oxfordtenzin: posts the ante $0.20
*** HOLE CARDS ***
Dealt to matiko09 [5d Ts]
Effort92: folds 
nobrunobru1: calls $1
st-germ30: folds 
DUkalisUA: folds 
matiko09: folds 
JimineyCrik: folds 
$-Twackle-$: calls $0.50
oxfordtenzin: checks 
*** FLOP *** [5s Jc 9c]
$-Twackle-$: checks 
oxfordtenzin: checks 
nobrunobru1: checks 
*** TURN *** [5s Jc 9c] [6s]
$-Twackle-$: bets $3
oxfordtenzin: calls $3
nobrunobru1: folds 
*** RIVER *** [5s Jc 9c 6s] [8d]
$-Twackle-$: checks 
oxfordtenzin: bets $10.12
$-Twackle-$: folds 
Uncalled bet ($10.12) returned to oxfordtenzin
oxfordtenzin collected $10.12 from pot
oxfordtenzin: doesn't show hand 
*** SUMMARY ***
Total pot $10.60 | Rake $0.48 
Board [5s Jc 9c 6s 8d]
Seat 1: Effort92 folded before Flop (didn't bet)
Seat 2: nobrunobru1 folded on the Turn
Seat 3: st-germ30 folded before Flop (didn't bet)
Seat 4: DUkalisUA folded before Flop (didn't bet)
Seat 5: matiko09 folded before Flop (didn't bet)
Seat 7: JimineyCrik (button) folded before Flop (didn't bet)
Seat 8: $-Twackle-$ (small blind) folded on the River
Seat 9: oxfordtenzin (big blind) collected ($10.12)





PokerStars Hand #150801902839:  Hold'em No Limit ($1/$2 USD) - 2016/03/23 14:43:55 CET [2016/03/23 9:43:55 ET]
Table 'Achaia' 9-max Seat #4 is the button
Seat 1: Moszes360 ($226.36 in chips) 
Seat 2: InsomniaRU ($217.44 in chips) 
Seat 3: matiko09 ($237.16 in chips) 
Seat 4: erfk1958 ($116 in chips) 
Seat 5: chaps1988 ($212.70 in chips) 
Seat 6: nickreason17 ($214.99 in chips) 
Seat 7: morosun ($268.94 in chips) 
Seat 8: $-Twackle-$ ($222.07 in chips) 
Seat 9: glanza_mike ($200 in chips) 
chaps1988: posts small blind $1
nickreason17: posts big blind $2
*** HOLE CARDS ***
Dealt to matiko09 [6s Kd]
morosun: folds 
$-Twackle-$: folds 
glanza_mike: folds 
Moszes360: folds 
InsomniaRU: raises $3 to $5
matiko09: folds 
erfk1958: folds 
chaps1988: folds 
nickreason17: folds 
Uncalled bet ($3) returned to InsomniaRU
InsomniaRU collected $5 from pot
InsomniaRU: doesn't show hand 
*** SUMMARY ***
Total pot $5 | Rake $0 
Seat 1: Moszes360 folded before Flop (didn't bet)
Seat 2: InsomniaRU collected ($5)
Seat 3: matiko09 folded before Flop (didn't bet)
Seat 4: erfk1958 (button) folded before Flop (didn't bet)
Seat 5: chaps1988 (small blind) folded before Flop
Seat 6: nickreason17 (big blind) folded before Flop
Seat 7: morosun folded before Flop (didn't bet)
Seat 8: $-Twackle-$ folded before Flop (didn't bet)
Seat 9: glanza_mike folded before Flop (didn't bet)





PokerStars Hand #150801903596:  Hold'em No Limit ($1/$2 USD) - 2016/03/23 14:43:56 CET [2016/03/23 9:43:56 ET]
Table 'Kypria II' 9-max Seat #7 is the button
Seat 1: geldwolfje ($131.63 in chips) 
Seat 3: seouljam ($232.42 in chips) 
Seat 4: VolanDog ($231.12 in chips) 
Seat 5: InsomniaRU ($311.74 in chips) 
Seat 6: matiko09 ($424.53 in chips) 
Seat 7: DUkalisUA ($202 in chips) 
Seat 8: nickreason17 ($200 in chips) 
Seat 9: Moszes360 ($200 in chips) 
nickreason17: posts small blind $1
Moszes360: posts big blind $2
*** HOLE CARDS ***
Dealt to matiko09 [Ah Jc]
geldwolfje: folds 
seouljam: folds 
VolanDog: raises $4 to $6
InsomniaRU: folds 
matiko09: folds 
DUkalisUA: folds 
nickreason17: folds 
Moszes360: folds 
Uncalled bet ($4) returned to VolanDog
VolanDog collected $5 from pot
*** SUMMARY ***
Total pot $5 | Rake $0 
Seat 1: geldwolfje folded before Flop (didn't bet)
Seat 3: seouljam folded before Flop (didn't bet)
Seat 4: VolanDog collected ($5)
Seat 5: InsomniaRU folded before Flop (didn't bet)
Seat 6: matiko09 folded before Flop (didn't bet)
Seat 7: DUkalisUA (button) folded before Flop (didn't bet)
Seat 8: nickreason17 (small blind) folded before Flop
Seat 9: Moszes360 (big blind) folded before Flop





PokerStars Hand #150801912329:  Hold'em No Limit ($0.50/$1.00 USD) - 2016/03/23 14:44:10 CET [2016/03/23 9:44:10 ET]
Table 'Atlantis' 9-max Seat #7 is the button
Seat 1: xHourglass ($136 in chips) 
Seat 2: Szevasztopol ($103.68 in chips) 
Seat 3: CAJUN890 ($143.34 in chips) 
Seat 4: matiko09 ($124.25 in chips) 
Seat 5: Pvsx. ($107.06 in chips) 
Seat 6: Jimy Tiltman ($100 in chips) 
Seat 7: Sherlockplay ($141.48 in chips) 
Seat 8: DUkalisUA ($137.30 in chips) 
Seat 9: RICKA16 ($104.16 in chips) 
DUkalisUA: posts small blind $0.50
RICKA16: posts big blind $1
*** HOLE CARDS ***
Dealt to matiko09 [Qs Qd]
xHourglass: raises $2 to $3
Szevasztopol: folds 
CAJUN890: folds 
matiko09: calls $3
Pvsx.: folds 
Jimy Tiltman: calls $3
Sherlockplay: folds 
DUkalisUA: folds 
RICKA16: calls $2
*** FLOP *** [Jh 4s Jc]
RICKA16: checks 
xHourglass: checks 
matiko09: bets $6.20
Jimy Tiltman: calls $6.20
RICKA16: folds 
xHourglass: folds 
*** TURN *** [Jh 4s Jc] [Js]
matiko09: checks 
Jimy Tiltman: bets $8
matiko09: calls $8
*** RIVER *** [Jh 4s Jc Js] [6d]
matiko09: checks 
Jimy Tiltman: checks 
*** SHOW DOWN ***
matiko09: shows [Qs Qd] (a full house, Jacks full of Queens)
Jimy Tiltman: mucks hand 
matiko09 collected $39.06 from pot
*** SUMMARY ***
Total pot $40.90 | Rake $1.84 
Board [Jh 4s Jc Js 6d]
Seat 1: xHourglass folded on the Flop
Seat 2: Szevasztopol folded before Flop (didn't bet)
Seat 3: CAJUN890 folded before Flop (didn't bet)
Seat 4: matiko09 showed [Qs Qd] and won ($39.06) with a full house, Jacks full of Queens
Seat 5: Pvsx. folded before Flop (didn't bet)
Seat 6: Jimy Tiltman mucked [Tc Td]
Seat 7: Sherlockplay (button) folded before Flop (didn't bet)
Seat 8: DUkalisUA (small blind) folded before Flop
Seat 9: RICKA16 (big blind) folded on the Flop





PokerStars Hand #150801920618:  Hold'em No Limit ($1/$2 USD) - 2016/03/23 14:44:23 CET [2016/03/23 9:44:23 ET]
Table 'Kiess' 9-max Seat #3 is the button
Seat 1: Cirilico ($209.22 in chips) 
Seat 2: DUkalisUA ($678.34 in chips) 
Seat 3: The_red_area ($328.46 in chips) 
Seat 4: Moszes360 ($200 in chips) 
Seat 5: chippo boy ($482.09 in chips) 
Seat 6: matiko09 ($263.86 in chips) 
Seat 7: InsomniaRU ($303.97 in chips) 
Seat 8: erfk1958 ($94.96 in chips) 
Seat 9: T0ny Adams ($100.46 in chips) 
Moszes360: posts small blind $1
chippo boy: posts big blind $2
*** HOLE CARDS ***
Dealt to matiko09 [Qs 7c]
matiko09: folds 
InsomniaRU: raises $3 to $5
erfk1958: folds 
T0ny Adams: folds 
Cirilico: folds 
DUkalisUA: folds 
The_red_area: folds 
Moszes360: folds 
chippo boy: calls $3
*** FLOP *** [Th 8d 7d]
chippo boy: checks 
InsomniaRU: bets $7.04
chippo boy: calls $7.04
*** TURN *** [Th 8d 7d] [9h]
chippo boy: checks 
InsomniaRU: checks 
*** RIVER *** [Th 8d 7d 9h] [5d]
chippo boy: bets $20
InsomniaRU: raises $51.16 to $71.16
chippo boy: folds 
Uncalled bet ($51.16) returned to InsomniaRU
InsomniaRU collected $62.28 from pot
InsomniaRU: doesn't show hand 
*** SUMMARY ***
Total pot $65.08 | Rake $2.80 
Board [Th 8d 7d 9h 5d]
Seat 1: Cirilico folded before Flop (didn't bet)
Seat 2: DUkalisUA folded before Flop (didn't bet)
Seat 3: The_red_area (button) folded before Flop (didn't bet)
Seat 4: Moszes360 (small blind) folded before Flop
Seat 5: chippo boy (big blind) folded on the River
Seat 6: matiko09 folded before Flop (didn't bet)
Seat 7: InsomniaRU collected ($62.28)
Seat 8: erfk1958 folded before Flop (didn't bet)
Seat 9: T0ny Adams folded before Flop (didn't bet)





PokerStars Hand #150801921878:  Hold'em No Limit ($1/$2 USD) - 2016/03/23 14:44:25 CET [2016/03/23 9:44:25 ET]
Table 'Achaia' 9-max Seat #5 is the button
Seat 1: Moszes360 ($226.36 in chips) 
Seat 2: InsomniaRU ($220.44 in chips) 
Seat 3: matiko09 ($237.16 in chips) 
Seat 4: erfk1958 ($116 in chips) 
Seat 5: chaps1988 ($211.70 in chips) 
Seat 6: nickreason17 ($212.99 in chips) 
Seat 7: morosun ($268.94 in chips) 
Seat 8: $-Twackle-$ ($222.07 in chips) 
Seat 9: glanza_mike ($200 in chips) 
nickreason17: posts small blind $1
morosun: posts big blind $2
*** HOLE CARDS ***
Dealt to matiko09 [8h As]
$-Twackle-$: folds 
glanza_mike: folds 
Moszes360: raises $4 to $6
InsomniaRU: folds 
matiko09: folds 
erfk1958: folds 
chaps1988: folds 
nickreason17: folds 
morosun: calls $4
*** FLOP *** [Jc Kd 9c]
morosun: bets $4
Moszes360: raises $19.60 to $23.60
morosun: folds 
Uncalled bet ($19.60) returned to Moszes360
Moszes360 collected $20.06 from pot
Moszes360: doesn't show hand 
*** SUMMARY ***
Total pot $21 | Rake $0.94 
Board [Jc Kd 9c]
Seat 1: Moszes360 collected ($20.06)
Seat 2: InsomniaRU folded before Flop (didn't bet)
Seat 3: matiko09 folded before Flop (didn't bet)
Seat 4: erfk1958 folded before Flop (didn't bet)
Seat 5: chaps1988 (button) folded before Flop (didn't bet)
Seat 6: nickreason17 (small blind) folded before Flop
Seat 7: morosun (big blind) folded on the Flop
Seat 8: $-Twackle-$ folded before Flop (didn't bet)
Seat 9: glanza_mike folded before Flop (didn't bet)





PokerStars Hand #150801923358:  Hold'em No Limit ($1/$2 USD) - 2016/03/23 14:44:28 CET [2016/03/23 9:44:28 ET]
Table 'Ennomos II' 9-max Seat #1 is the button
Seat 1: InsomniaRU ($215.54 in chips) 
Seat 2: Moszes360 ($200 in chips) 
Seat 3: $-Twackle-$ ($439.20 in chips) 
Seat 4: glanza_mike ($200 in chips) 
Seat 5: South011 ($391.02 in chips) 
Seat 6: nickreason17 ($393.62 in chips) 
Seat 7: T0ny Adams ($72 in chips) 
Seat 8: yyfk ($200 in chips) 
Seat 9: matiko09 ($340.40 in chips) 
Moszes360: posts small blind $1
$-Twackle-$: posts big blind $2
*** HOLE CARDS ***
Dealt to matiko09 [Kd Td]
glanza_mike: raises $4 to $6
South011: folds 
nickreason17: folds 
T0ny Adams: folds 
yyfk: folds 
matiko09: folds 
InsomniaRU: folds 
Moszes360: folds 
$-Twackle-$: folds 
Uncalled bet ($4) returned to glanza_mike
glanza_mike collected $5 from pot
glanza_mike: doesn't show hand 
*** SUMMARY ***
Total pot $5 | Rake $0 
Seat 1: InsomniaRU (button) folded before Flop (didn't bet)
Seat 2: Moszes360 (small blind) folded before Flop
Seat 3: $-Twackle-$ (big blind) folded before Flop
Seat 4: glanza_mike collected ($5)
Seat 5: South011 folded before Flop (didn't bet)
Seat 6: nickreason17 folded before Flop (didn't bet)
Seat 7: T0ny Adams folded before Flop (didn't bet)
Seat 8: yyfk folded before Flop (didn't bet)
Seat 9: matiko09 folded before Flop (didn't bet)





PokerStars Hand #150801926316:  Hold'em No Limit ($0.50/$1.00 USD) - 2016/03/23 14:44:32 CET [2016/03/23 9:44:32 ET]
Table 'Merope II' 9-max Seat #6 is the button
Seat 1: Jimy Tiltman ($137.73 in chips) 
Seat 2: $-Twackle-$ ($102.87 in chips) 
Seat 3: pablos1922 ($93.81 in chips) 
Seat 4: YuriiSolodya ($85.84 in chips) 
Seat 6: Effort92 ($101.21 in chips) 
Seat 7: matiko09 ($105.53 in chips) 
Seat 8: Red4erT ($40 in chips) 
Seat 9: RICKA16 ($102.50 in chips) 
matiko09: posts small blind $0.50
Red4erT: posts big blind $1
Butcher1848: sits out 
*** HOLE CARDS ***
Dealt to matiko09 [3s Th]
RICKA16: folds 
Jimy Tiltman: folds 
$-Twackle-$: folds 
pablos1922: folds 
YuriiSolodya: folds 
Effort92: folds 
matiko09: folds 
Uncalled bet ($0.50) returned to Red4erT
Red4erT collected $1 from pot
Red4erT: doesn't show hand 
*** SUMMARY ***
Total pot $1 | Rake $0 
Seat 1: Jimy Tiltman folded before Flop (didn't bet)
Seat 2: $-Twackle-$ folded before Flop (didn't bet)
Seat 3: pablos1922 folded before Flop (didn't bet)
Seat 4: YuriiSolodya folded before Flop (didn't bet)
Seat 6: Effort92 (button) folded before Flop (didn't bet)
Seat 7: matiko09 (small blind) folded before Flop
Seat 8: Red4erT (big blind) collected ($1)
Seat 9: RICKA16 folded before Flop (didn't bet)





PokerStars Hand #150801931938:  Hold'em No Limit ($1/$2 USD) - 2016/03/23 14:44:41 CET [2016/03/23 9:44:41 ET]
Table 'Herba II' 9-max Seat #1 is the button
Seat 1: matiko09 ($222.62 in chips) 
Seat 2: Moszes360 ($200 in chips) 
Seat 3: Cirilico ($160 in chips) 
Seat 4: DUkalisUA ($252.20 in chips) 
Seat 5: chippo boy ($273.33 in chips) 
Seat 6: Too-Anti-To ($228.38 in chips) 
Seat 7: InsomniaRU ($408.70 in chips) 
Seat 8: The_red_area ($390.98 in chips) 
Seat 9: mrhighryza ($62.44 in chips) 
Moszes360: posts small blind $1
Cirilico: posts big blind $2
*** HOLE CARDS ***
Dealt to matiko09 [3s As]
DUkalisUA: folds 
chippo boy: raises $4 to $6
Too-Anti-To: folds 
InsomniaRU: folds 
The_red_area: calls $6
mrhighryza: calls $6
matiko09: calls $6
Moszes360: raises $24 to $30
Cirilico: folds 
chippo boy: calls $24
The_red_area: calls $24
mrhighryza: folds 
matiko09: folds 
*** FLOP *** [8s 4h 4c]
Moszes360: checks 
chippo boy: checks 
The_red_area: bets $101.20
Moszes360: folds 
chippo boy: folds 
Uncalled bet ($101.20) returned to The_red_area
The_red_area collected $101.20 from pot
The_red_area: doesn't show hand 
*** SUMMARY ***
Total pot $104 | Rake $2.80 
Board [8s 4h 4c]
Seat 1: matiko09 (button) folded before Flop
Seat 2: Moszes360 (small blind) folded on the Flop
Seat 3: Cirilico (big blind) folded before Flop
Seat 4: DUkalisUA folded before Flop (didn't bet)
Seat 5: chippo boy folded on the Flop
Seat 6: Too-Anti-To folded before Flop (didn't bet)
Seat 7: InsomniaRU folded before Flop (didn't bet)
Seat 8: The_red_area collected ($101.20)
Seat 9: mrhighryza folded before Flop





PokerStars Hand #150801935045:  Hold'em No Limit ($1/$2 USD) - 2016/03/23 14:44:46 CET [2016/03/23 9:44:46 ET]
Table 'Kypria II' 9-max Seat #8 is the button
Seat 1: geldwolfje ($131.63 in chips) 
Seat 3: seouljam ($232.42 in chips) 
Seat 4: VolanDog ($234.12 in chips) 
Seat 5: InsomniaRU ($311.74 in chips) 
Seat 6: matiko09 ($424.53 in chips) 
Seat 7: DUkalisUA ($202 in chips) 
Seat 8: nickreason17 ($200 in chips) 
Seat 9: Moszes360 ($200 in chips) 
Moszes360: posts small blind $1
geldwolfje: posts big blind $2
*** HOLE CARDS ***
Dealt to matiko09 [3d 9c]
seouljam: folds 
VolanDog: folds 
InsomniaRU: folds 
matiko09: folds 
DUkalisUA: raises $3 to $5
nickreason17: folds 
Moszes360: folds 
geldwolfje: calls $3
*** FLOP *** [4d 7c 8h]
geldwolfje: bets $12
DUkalisUA: calls $12
*** TURN *** [4d 7c 8h] [Ts]
geldwolfje: bets $18
DUkalisUA: folds 
Uncalled bet ($18) returned to geldwolfje
geldwolfje collected $33.42 from pot
geldwolfje: doesn't show hand 
*** SUMMARY ***
Total pot $35 | Rake $1.58 
Board [4d 7c 8h Ts]
Seat 1: geldwolfje (big blind) collected ($33.42)
Seat 3: seouljam folded before Flop (didn't bet)
Seat 4: VolanDog folded before Flop (didn't bet)
Seat 5: InsomniaRU folded before Flop (didn't bet)
Seat 6: matiko09 folded before Flop (didn't bet)
Seat 7: DUkalisUA folded on the Turn
Seat 8: nickreason17 (button) folded before Flop (didn't bet)
Seat 9: Moszes360 (small blind) folded before Flop





PokerStars Hand #150801942871:  Hold'em No Limit ($0.50/$1.00 USD) - 2016/03/23 14:44:59 CET [2016/03/23 9:44:59 ET]
Table 'Merope II' 9-max Seat #7 is the button
Seat 1: Jimy Tiltman ($137.73 in chips) 
Seat 2: $-Twackle-$ ($102.87 in chips) 
Seat 3: pablos1922 ($93.81 in chips) 
Seat 4: YuriiSolodya ($85.84 in chips) 
Seat 6: Effort92 ($101.21 in chips) 
Seat 7: matiko09 ($105.03 in chips) 
Seat 8: Red4erT ($40.50 in chips) 
Seat 9: RICKA16 ($102.50 in chips) 
Red4erT: posts small blind $0.50
RICKA16: posts big blind $1
Butcher1848: sits out 
*** HOLE CARDS ***
Dealt to matiko09 [6s Kd]
Jimy Tiltman: raises $2 to $3
$-Twackle-$: folds 
pablos1922: folds 
YuriiSolodya: folds 
Effort92: folds 
matiko09: folds 
Red4erT: raises $5 to $8
RICKA16: folds 
Jimy Tiltman: calls $5
*** FLOP *** [Ac 3d Jh]
Red4erT: bets $5.52
Jimy Tiltman: calls $5.52
*** TURN *** [Ac 3d Jh] [2s]
Red4erT: checks 
Jimy Tiltman: checks 
*** RIVER *** [Ac 3d Jh 2s] [Jc]
Red4erT: checks 
Jimy Tiltman: bets $13.39
Red4erT: folds 
Uncalled bet ($13.39) returned to Jimy Tiltman
Jimy Tiltman collected $26.78 from pot
Jimy Tiltman: doesn't show hand 
*** SUMMARY ***
Total pot $28.04 | Rake $1.26 
Board [Ac 3d Jh 2s Jc]
Seat 1: Jimy Tiltman collected ($26.78)
Seat 2: $-Twackle-$ folded before Flop (didn't bet)
Seat 3: pablos1922 folded before Flop (didn't bet)
Seat 4: YuriiSolodya folded before Flop (didn't bet)
Seat 6: Effort92 folded before Flop (didn't bet)
Seat 7: matiko09 (button) folded before Flop (didn't bet)
Seat 8: Red4erT (small blind) folded on the River
Seat 9: RICKA16 (big blind) folded before Flop





PokerStars Hand #150801948082:  Hold'em No Limit ($0.50/$1.00 USD) - 2016/03/23 14:45:07 CET [2016/03/23 9:45:07 ET]
Table 'Donar II' 9-max Seat #8 is the button
Seat 1: Effort92 ($121.17 in chips) 
Seat 2: nobrunobru1 ($36.24 in chips) 
Seat 4: DUkalisUA ($160.64 in chips) 
Seat 5: matiko09 ($100 in chips) 
Seat 7: JimineyCrik ($124.89 in chips) 
Seat 8: $-Twackle-$ ($119.60 in chips) 
Seat 9: oxfordtenzin ($57.02 in chips) 
oxfordtenzin: posts small blind $0.50
Effort92: posts big blind $1
Effort92: posts the ante $0.20
nobrunobru1: posts the ante $0.20
DUkalisUA: posts the ante $0.20
matiko09: posts the ante $0.20
JimineyCrik: posts the ante $0.20
$-Twackle-$: posts the ante $0.20
oxfordtenzin: posts the ante $0.20
*** HOLE CARDS ***
Dealt to matiko09 [Qh Tc]
nobrunobru1: calls $1
DUkalisUA: folds 
matiko09: folds 
JimineyCrik: folds 
$-Twackle-$: folds 
oxfordtenzin: folds 
Effort92: checks 
*** FLOP *** [7h 7c Th]
Effort92: bets $2
nobrunobru1: calls $2
*** TURN *** [7h 7c Th] [2h]
Effort92: bets $4.97
nobrunobru1: folds 
Uncalled bet ($4.97) returned to Effort92
Effort92 collected $7.54 from pot
Effort92: doesn't show hand 
*** SUMMARY ***
Total pot $7.90 | Rake $0.36 
Board [7h 7c Th 2h]
Seat 1: Effort92 (big blind) collected ($7.54)
Seat 2: nobrunobru1 folded on the Turn
Seat 4: DUkalisUA folded before Flop (didn't bet)
Seat 5: matiko09 folded before Flop (didn't bet)
Seat 7: JimineyCrik folded before Flop (didn't bet)
Seat 8: $-Twackle-$ (button) folded before Flop (didn't bet)
Seat 9: oxfordtenzin (small blind) folded before Flop





PokerStars Hand #150801948744:  Hold'em No Limit ($1/$2 USD) - 2016/03/23 14:45:08 CET [2016/03/23 9:45:08 ET]
Table 'Ennomos II' 9-max Seat #2 is the button
Seat 1: InsomniaRU ($215.54 in chips) 
Seat 2: Moszes360 ($200 in chips) 
Seat 3: $-Twackle-$ ($437.20 in chips) 
Seat 5: South011 ($391.02 in chips) 
Seat 6: nickreason17 ($393.62 in chips) 
Seat 7: T0ny Adams ($72 in chips) 
Seat 8: yyfk ($200 in chips) 
Seat 9: matiko09 ($340.40 in chips) 
$-Twackle-$: posts small blind $1
glanza_mike: is sitting out 
South011: posts big blind $2
*** HOLE CARDS ***
Dealt to matiko09 [3d Ks]
nickreason17: folds 
nickreason17 leaves the table
DUkalisUA joins the table at seat #6 
T0ny Adams: folds 
glanza_mike leaves the table
yyfk: raises $3 to $5
Red4erT joins the table at seat #4 
matiko09: folds 
InsomniaRU: folds 
Moszes360: folds 
$-Twackle-$: folds 
South011: calls $3
*** FLOP *** [4h 6h Js]
South011: checks 
yyfk: bets $5.25
South011: raises $10.75 to $16
yyfk: folds 
Uncalled bet ($10.75) returned to South011
South011 collected $20.53 from pot
South011: doesn't show hand 
*** SUMMARY ***
Total pot $21.50 | Rake $0.97 
Board [4h 6h Js]
Seat 1: InsomniaRU folded before Flop (didn't bet)
Seat 2: Moszes360 (button) folded before Flop (didn't bet)
Seat 3: $-Twackle-$ (small blind) folded before Flop
Seat 5: South011 (big blind) collected ($20.53)
Seat 6: nickreason17 folded before Flop (didn't bet)
Seat 7: T0ny Adams folded before Flop (didn't bet)
Seat 8: yyfk folded on the Flop
Seat 9: matiko09 folded before Flop (didn't bet)





PokerStars Hand #150801951331:  Hold'em No Limit ($0.25/$0.50 USD) - 2016/03/23 14:45:12 CET [2016/03/23 9:45:12 ET]
Table 'Pyrrhus' 9-max Seat #8 is the button
Seat 2: BSTUSim ($74.88 in chips) 
Seat 3: i L00K great ($50 in chips) 
Seat 4: GriffinBerg ($42.95 in chips) 
Seat 5: ZonTTT ($52.86 in chips) 
Seat 6: Ahangama ($50.75 in chips) 
Seat 7: matiko09 ($140.25 in chips) 
Seat 8: dndngod ($69.73 in chips) 
Seat 9: CvMCvMCvM ($92.39 in chips) 
CvMCvMCvM: posts small blind $0.25
BSTUSim: posts big blind $0.50
*** HOLE CARDS ***
Dealt to matiko09 [4h 7s]
i L00K great: folds 
GriffinBerg: raises $1 to $1.50
ZonTTT: folds 
Ahangama: folds 
matiko09: folds 
dndngod: folds 
CvMCvMCvM: folds 
BSTUSim: folds 
Uncalled bet ($1) returned to GriffinBerg
GriffinBerg collected $1.25 from pot
*** SUMMARY ***
Total pot $1.25 | Rake $0 
Seat 2: BSTUSim (big blind) folded before Flop
Seat 3: i L00K great folded before Flop (didn't bet)
Seat 4: GriffinBerg collected ($1.25)
Seat 5: ZonTTT folded before Flop (didn't bet)
Seat 6: Ahangama folded before Flop (didn't bet)
Seat 7: matiko09 folded before Flop (didn't bet)
Seat 8: dndngod (button) folded before Flop (didn't bet)
Seat 9: CvMCvMCvM (small blind) folded before Flop





PokerStars Hand #150801952193:  Hold'em No Limit ($1/$2 USD) - 2016/03/23 14:45:13 CET [2016/03/23 9:45:13 ET]
Table 'Achaia' 9-max Seat #6 is the button
Seat 1: Moszes360 ($236.42 in chips) 
Seat 2: InsomniaRU ($220.44 in chips) 
Seat 3: matiko09 ($237.16 in chips) 
Seat 4: erfk1958 ($116 in chips) 
Seat 5: chaps1988 ($211.70 in chips) 
Seat 6: nickreason17 ($211.99 in chips) 
Seat 7: morosun ($258.94 in chips) 
Seat 8: $-Twackle-$ ($222.07 in chips) 
Seat 9: glanza_mike ($200 in chips) 
morosun: posts small blind $1
$-Twackle-$: posts big blind $2
*** HOLE CARDS ***
Dealt to matiko09 [Qh Td]
glanza_mike: folds 
Moszes360: folds 
InsomniaRU: folds 
matiko09: folds 
erfk1958: raises $2 to $4
chaps1988: folds 
nickreason17: folds 
morosun: calls $3
$-Twackle-$: folds 
*** FLOP *** [Qc Ad 5c]
morosun: bets $2
erfk1958: calls $2
*** TURN *** [Qc Ad 5c] [Ks]
morosun: bets $2
erfk1958: calls $2
*** RIVER *** [Qc Ad 5c Ks] [7c]
morosun: checks 
erfk1958: checks 
*** SHOW DOWN ***
morosun: shows [Qd Th] (a pair of Queens)
erfk1958: mucks hand 
morosun collected $17.19 from pot
*** SUMMARY ***
Total pot $18 | Rake $0.81 
Board [Qc Ad 5c Ks 7c]
Seat 1: Moszes360 folded before Flop (didn't bet)
Seat 2: InsomniaRU folded before Flop (didn't bet)
Seat 3: matiko09 folded before Flop (didn't bet)
Seat 4: erfk1958 mucked [Js Jh]
Seat 5: chaps1988 folded before Flop (didn't bet)
Seat 6: nickreason17 (button) folded before Flop (didn't bet)
Seat 7: morosun (small blind) showed [Qd Th] and won ($17.19) with a pair of Queens
Seat 8: $-Twackle-$ (big blind) folded before Flop
Seat 9: glanza_mike folded before Flop (didn't bet)





PokerStars Hand #150801951858:  Hold'em No Limit ($0.50/$1.00 USD) - 2016/03/23 14:45:13 CET [2016/03/23 9:45:13 ET]
Table 'Swings' 9-max Seat #8 is the button
Seat 1: Sherlockplay ($116.13 in chips) 
Seat 2: Harbinger X ($187.14 in chips) 
Seat 3: maxxmeister ($122.78 in chips) 
Seat 4: chaps1988 ($100 in chips) 
Seat 5: chautinhtri9 ($81 in chips) 
Seat 6: matiko09 ($126.43 in chips) 
Seat 7: PacPacBum ($100 in chips) 
Seat 8: RICKA16 ($100 in chips) 
Seat 9: Vlad_1965_77 ($110.71 in chips) 
Vlad_1965_77: posts small blind $0.50
Sherlockplay: posts big blind $1
*** HOLE CARDS ***
Dealt to matiko09 [3s 6d]
Harbinger X: folds 
maxxmeister: raises $2.50 to $3.50
chaps1988: folds 
chautinhtri9: folds 
matiko09: folds 
PacPacBum: calls $3.50
RICKA16: calls $3.50
Vlad_1965_77: folds 
Sherlockplay: folds 
*** FLOP *** [9d 2d Kh]
maxxmeister: checks 
PacPacBum: checks 
RICKA16: bets $7
maxxmeister: folds 
PacPacBum: folds 
Uncalled bet ($7) returned to RICKA16
RICKA16 collected $11.46 from pot
RICKA16: doesn't show hand 
*** SUMMARY ***
Total pot $12 | Rake $0.54 
Board [9d 2d Kh]
Seat 1: Sherlockplay (big blind) folded before Flop
Seat 2: Harbinger X folded before Flop (didn't bet)
Seat 3: maxxmeister folded on the Flop
Seat 4: chaps1988 folded before Flop (didn't bet)
Seat 5: chautinhtri9 folded before Flop (didn't bet)
Seat 6: matiko09 folded before Flop (didn't bet)
Seat 7: PacPacBum folded on the Flop
Seat 8: RICKA16 (button) collected ($11.46)
Seat 9: Vlad_1965_77 (small blind) folded before Flop





PokerStars Hand #150801957545:  Hold'em No Limit ($0.50/$1.00 USD) - 2016/03/23 14:45:22 CET [2016/03/23 9:45:22 ET]
Table 'Atlantis' 9-max Seat #8 is the button
Seat 1: xHourglass ($133 in chips) 
Seat 2: Szevasztopol ($103.68 in chips) 
Seat 3: CAJUN890 ($143.34 in chips) 
Seat 4: matiko09 ($146.11 in chips) 
Seat 5: Pvsx. ($107.06 in chips) 
Seat 6: Jimy Tiltman ($100 in chips) 
Seat 7: Sherlockplay ($141.48 in chips) 
Seat 8: DUkalisUA ($136.80 in chips) 
Seat 9: RICKA16 ($101.16 in chips) 
RICKA16: posts small blind $0.50
xHourglass: posts big blind $1
*** HOLE CARDS ***
Dealt to matiko09 [Js 4h]
Szevasztopol: folds 
CAJUN890: folds 
matiko09: folds 
Pvsx.: folds 
Jimy Tiltman: folds 
Sherlockplay: folds 
DUkalisUA: folds 
RICKA16: raises $2 to $3
xHourglass: folds 
Uncalled bet ($2) returned to RICKA16
RICKA16 collected $2 from pot
RICKA16: doesn't show hand 
*** SUMMARY ***
Total pot $2 | Rake $0 
Seat 1: xHourglass (big blind) folded before Flop
Seat 2: Szevasztopol folded before Flop (didn't bet)
Seat 3: CAJUN890 folded before Flop (didn't bet)
Seat 4: matiko09 folded before Flop (didn't bet)
Seat 5: Pvsx. folded before Flop (didn't bet)
Seat 6: Jimy Tiltman folded before Flop (didn't bet)
Seat 7: Sherlockplay folded before Flop (didn't bet)
Seat 8: DUkalisUA (button) folded before Flop (didn't bet)
Seat 9: RICKA16 (small blind) collected ($2)





PokerStars Hand #150801965908:  Hold'em No Limit ($1/$2 USD) - 2016/03/23 14:45:35 CET [2016/03/23 9:45:35 ET]
Table 'Kypria II' 9-max Seat #9 is the button
Seat 1: geldwolfje ($148.05 in chips) 
Seat 3: seouljam ($232.42 in chips) 
Seat 4: VolanDog ($234.12 in chips) 
Seat 5: InsomniaRU ($311.74 in chips) 
Seat 6: matiko09 ($424.53 in chips) 
Seat 7: DUkalisUA ($200 in chips) 
Seat 8: nickreason17 ($200 in chips) 
Seat 9: Moszes360 ($200 in chips) 
geldwolfje: posts small blind $1
seouljam: posts big blind $2
*** HOLE CARDS ***
Dealt to matiko09 [4s Kc]
VolanDog: folds 
InsomniaRU: raises $2 to $4
matiko09: folds 
DUkalisUA: folds 
nickreason17: folds 
Moszes360: folds 
geldwolfje: folds 
seouljam: calls $2
*** FLOP *** [Qh Ks 5d]
seouljam: checks 
InsomniaRU: bets $5.76
seouljam: folds 
Uncalled bet ($5.76) returned to InsomniaRU
InsomniaRU collected $8.60 from pot
InsomniaRU: doesn't show hand 
*** SUMMARY ***
Total pot $9 | Rake $0.40 
Board [Qh Ks 5d]
Seat 1: geldwolfje (small blind) folded before Flop
Seat 3: seouljam (big blind) folded on the Flop
Seat 4: VolanDog folded before Flop (didn't bet)
Seat 5: InsomniaRU collected ($8.60)
Seat 6: matiko09 folded before Flop (didn't bet)
Seat 7: DUkalisUA folded before Flop (didn't bet)
Seat 8: nickreason17 folded before Flop (didn't bet)
Seat 9: Moszes360 (button) folded before Flop (didn't bet)





PokerStars Hand #150801970415:  Hold'em No Limit ($0.50/$1.00 USD) - 2016/03/23 14:45:42 CET [2016/03/23 9:45:42 ET]
Table 'Asmodeus' 9-max Seat #2 is the button
Seat 1: Jimy Tiltman ($105.20 in chips) 
Seat 2: $-Twackle-$ ($100 in chips) 
Seat 3: nickreason17 ($100 in chips) 
Seat 4: Effort92 ($106.66 in chips) 
Seat 5: chaps1988 ($105.70 in chips) 
Seat 7: PacPacBum ($107.53 in chips) 
Seat 8: KEBIN1974 ($151.44 in chips) 
Seat 9: matiko09 ($100 in chips) 
nickreason17: posts small blind $0.50
Effort92: posts big blind $1
florrin92: sits out 
Jimy Tiltman: posts the ante $0.20
$-Twackle-$: posts the ante $0.20
nickreason17: posts the ante $0.20
Effort92: posts the ante $0.20
chaps1988: posts the ante $0.20
PacPacBum: posts the ante $0.20
KEBIN1974: posts the ante $0.20
matiko09: posts the ante $0.20
*** HOLE CARDS ***
Dealt to matiko09 [Qc 4h]
chaps1988: folds 
PacPacBum: raises $2 to $3
KEBIN1974: folds 
matiko09: folds 
Jimy Tiltman: folds 
$-Twackle-$: folds 
nickreason17: folds 
Effort92: folds 
Uncalled bet ($2) returned to PacPacBum
PacPacBum collected $4.10 from pot
PacPacBum: doesn't show hand 
*** SUMMARY ***
Total pot $4.10 | Rake $0 
Seat 1: Jimy Tiltman folded before Flop (didn't bet)
Seat 2: $-Twackle-$ (button) folded before Flop (didn't bet)
Seat 3: nickreason17 (small blind) folded before Flop
Seat 4: Effort92 (big blind) folded before Flop
Seat 5: chaps1988 folded before Flop (didn't bet)
Seat 7: PacPacBum collected ($4.10)
Seat 8: KEBIN1974 folded before Flop (didn't bet)
Seat 9: matiko09 folded before Flop (didn't bet)





PokerStars Hand #150801981971:  Hold'em No Limit ($0.50/$1.00 USD) - 2016/03/23 14:46:01 CET [2016/03/23 9:46:01 ET]
Table 'Atlantis' 9-max Seat #9 is the button
Seat 1: xHourglass ($132 in chips) 
Seat 2: Szevasztopol ($103.68 in chips) 
Seat 3: CAJUN890 ($143.34 in chips) 
Seat 4: matiko09 ($146.11 in chips) 
Seat 5: Pvsx. ($107.06 in chips) 
Seat 6: Jimy Tiltman ($100 in chips) 
Seat 7: Sherlockplay ($141.48 in chips) 
Seat 8: DUkalisUA ($136.80 in chips) 
Seat 9: RICKA16 ($102.16 in chips) 
xHourglass: posts small blind $0.50
Szevasztopol: posts big blind $1
*** HOLE CARDS ***
Dealt to matiko09 [Js 8s]
CAJUN890: raises $2.50 to $3.50
matiko09: folds 
Pvsx.: folds 
Jimy Tiltman: folds 
Sherlockplay: folds 
DUkalisUA: folds 
RICKA16: folds 
xHourglass: folds 
Szevasztopol: folds 
Uncalled bet ($2.50) returned to CAJUN890
CAJUN890 collected $2.50 from pot
CAJUN890: doesn't show hand 
*** SUMMARY ***
Total pot $2.50 | Rake $0 
Seat 1: xHourglass (small blind) folded before Flop
Seat 2: Szevasztopol (big blind) folded before Flop
Seat 3: CAJUN890 collected ($2.50)
Seat 4: matiko09 folded before Flop (didn't bet)
Seat 5: Pvsx. folded before Flop (didn't bet)
Seat 6: Jimy Tiltman folded before Flop (didn't bet)
Seat 7: Sherlockplay folded before Flop (didn't bet)
Seat 8: DUkalisUA folded before Flop (didn't bet)
Seat 9: RICKA16 (button) folded before Flop (didn't bet)





PokerStars Hand #150801982786:  Hold'em No Limit ($0.25/$0.50 USD) - 2016/03/23 14:46:02 CET [2016/03/23 9:46:02 ET]
Table 'Pyrrhus' 9-max Seat #9 is the button
Seat 2: BSTUSim ($74.38 in chips) 
Seat 3: i L00K great ($50 in chips) 
Seat 4: GriffinBerg ($43.70 in chips) 
Seat 5: ZonTTT ($52.86 in chips) 
Seat 6: Ahangama ($50.75 in chips) 
Seat 7: matiko09 ($140.25 in chips) 
Seat 8: dndngod ($69.73 in chips) 
Seat 9: CvMCvMCvM ($92.14 in chips) 
lumen21 will be allowed to play after the button
BSTUSim: posts small blind $0.25
i L00K great: posts big blind $0.50
*** HOLE CARDS ***
Dealt to matiko09 [6h 4h]
GriffinBerg: folds 
ZonTTT: folds 
Ahangama: folds 
matiko09: folds 
dndngod: folds 
CvMCvMCvM: raises $0.76 to $1.26
BSTUSim: raises $2.74 to $4
i L00K great: folds 
CvMCvMCvM: folds 
Uncalled bet ($2.74) returned to BSTUSim
BSTUSim collected $3.02 from pot
BSTUSim: doesn't show hand 
*** SUMMARY ***
Total pot $3.02 | Rake $0 
Seat 2: BSTUSim (small blind) collected ($3.02)
Seat 3: i L00K great (big blind) folded before Flop
Seat 4: GriffinBerg folded before Flop (didn't bet)
Seat 5: ZonTTT folded before Flop (didn't bet)
Seat 6: Ahangama folded before Flop (didn't bet)
Seat 7: matiko09 folded before Flop (didn't bet)
Seat 8: dndngod folded before Flop (didn't bet)
Seat 9: CvMCvMCvM (button) folded before Flop





PokerStars Hand #150801985629:  Hold'em No Limit ($1/$2 USD) - 2016/03/23 14:46:07 CET [2016/03/23 9:46:07 ET]
Table 'Achaia' 9-max Seat #7 is the button
Seat 1: Moszes360 ($236.42 in chips) 
Seat 2: InsomniaRU ($220.44 in chips) 
Seat 3: matiko09 ($237.16 in chips) 
Seat 4: erfk1958 ($108 in chips) 
Seat 5: chaps1988 ($211.70 in chips) 
Seat 6: nickreason17 ($211.99 in chips) 
Seat 7: morosun ($268.13 in chips) 
Seat 8: $-Twackle-$ ($220.07 in chips) 
$-Twackle-$: posts small blind $1
glanza_mike: is sitting out 
Moszes360: posts big blind $2
*** HOLE CARDS ***
Dealt to matiko09 [8s 7d]
InsomniaRU: folds 
matiko09: folds 
glanza_mike leaves the table
erfk1958: folds 
chaps1988: folds 
nickreason17: folds 
morosun: folds 
$-Twackle-$: raises $4 to $6
PacPacBum joins the table at seat #9 
Moszes360: raises $12 to $18
$-Twackle-$: folds 
Uncalled bet ($12) returned to Moszes360
Moszes360 collected $12 from pot
Moszes360: doesn't show hand 
*** SUMMARY ***
Total pot $12 | Rake $0 
Seat 1: Moszes360 (big blind) collected ($12)
Seat 2: InsomniaRU folded before Flop (didn't bet)
Seat 3: matiko09 folded before Flop (didn't bet)
Seat 4: erfk1958 folded before Flop (didn't bet)
Seat 5: chaps1988 folded before Flop (didn't bet)
Seat 6: nickreason17 folded before Flop (didn't bet)
Seat 7: morosun (button) folded before Flop (didn't bet)
Seat 8: $-Twackle-$ (small blind) folded before Flop





PokerStars Hand #150801987025:  Hold'em No Limit ($1/$2 USD) - 2016/03/23 14:46:09 CET [2016/03/23 9:46:09 ET]
Table 'Kiess' 9-max Seat #4 is the button
Seat 1: Cirilico ($209.22 in chips) 
Seat 2: DUkalisUA ($678.34 in chips) 
Seat 3: The_red_area ($328.46 in chips) 
Seat 4: Moszes360 ($200 in chips) 
Seat 5: chippo boy ($450.05 in chips) 
Seat 6: matiko09 ($263.86 in chips) 
Seat 7: InsomniaRU ($334.21 in chips) 
Seat 8: erfk1958 ($94.96 in chips) 
Seat 9: T0ny Adams ($100.46 in chips) 
chippo boy: posts small blind $1
matiko09: posts big blind $2
*** HOLE CARDS ***
Dealt to matiko09 [8s Kh]
InsomniaRU: folds 
erfk1958: raises $2 to $4
T0ny Adams: folds 
Cirilico: folds 
DUkalisUA: folds 
The_red_area: folds 
Moszes360: folds 
chippo boy: calls $3
matiko09: folds 
*** FLOP *** [7h 3h 7d]
chippo boy: checks 
erfk1958: bets $4
chippo boy: raises $4 to $8
erfk1958: calls $4
*** TURN *** [7h 3h 7d] [Ks]
chippo boy: bets $12
erfk1958: folds 
Uncalled bet ($12) returned to chippo boy
chippo boy collected $24.83 from pot
*** SUMMARY ***
Total pot $26 | Rake $1.17 
Board [7h 3h 7d Ks]
Seat 1: Cirilico folded before Flop (didn't bet)
Seat 2: DUkalisUA folded before Flop (didn't bet)
Seat 3: The_red_area folded before Flop (didn't bet)
Seat 4: Moszes360 (button) folded before Flop (didn't bet)
Seat 5: chippo boy (small blind) collected ($24.83)
Seat 6: matiko09 (big blind) folded before Flop
Seat 7: InsomniaRU folded before Flop (didn't bet)
Seat 8: erfk1958 folded on the Turn
Seat 9: T0ny Adams folded before Flop (didn't bet)





PokerStars Hand #150801987883:  Hold'em No Limit ($0.50/$1.00 USD) - 2016/03/23 14:46:10 CET [2016/03/23 9:46:10 ET]
Table 'Asmodeus' 9-max Seat #3 is the button
Seat 1: Jimy Tiltman ($105 in chips) 
Seat 2: $-Twackle-$ ($100 in chips) 
Seat 3: nickreason17 ($100 in chips) 
Seat 4: Effort92 ($105.46 in chips) 
Seat 5: chaps1988 ($105.50 in chips) 
Seat 7: PacPacBum ($110.43 in chips) 
Seat 8: KEBIN1974 ($151.24 in chips) 
Seat 9: matiko09 ($100 in chips) 
Effort92: posts small blind $0.50
chaps1988: posts big blind $1
florrin92: sits out 
Jimy Tiltman: posts the ante $0.20
$-Twackle-$: posts the ante $0.20
nickreason17: posts the ante $0.20
Effort92: posts the ante $0.20
chaps1988: posts the ante $0.20
PacPacBum: posts the ante $0.20
KEBIN1974: posts the ante $0.20
matiko09: posts the ante $0.20
*** HOLE CARDS ***
Dealt to matiko09 [6s 5h]
PacPacBum: folds 
KEBIN1974: raises $2 to $3
matiko09: folds 
Jimy Tiltman: folds 
$-Twackle-$: folds 
nickreason17: folds 
Effort92: folds 
chaps1988: calls $2
*** FLOP *** [4h 9h Qh]
chaps1988: checks 
KEBIN1974: bets $2.63
chaps1988: calls $2.63
*** TURN *** [4h 9h Qh] [As]
chaps1988: checks 
KEBIN1974: bets $7.40
chaps1988: calls $7.40
*** RIVER *** [4h 9h Qh As] [6c]
chaps1988: checks 
KEBIN1974: bets $10
chaps1988: folds 
Uncalled bet ($10) returned to KEBIN1974
KEBIN1974 collected $26.89 from pot
KEBIN1974: doesn't show hand 
*** SUMMARY ***
Total pot $28.16 | Rake $1.27 
Board [4h 9h Qh As 6c]
Seat 1: Jimy Tiltman folded before Flop (didn't bet)
Seat 2: $-Twackle-$ folded before Flop (didn't bet)
Seat 3: nickreason17 (button) folded before Flop (didn't bet)
Seat 4: Effort92 (small blind) folded before Flop
Seat 5: chaps1988 (big blind) folded on the River
Seat 7: PacPacBum folded before Flop (didn't bet)
Seat 8: KEBIN1974 collected ($26.89)
Seat 9: matiko09 folded before Flop (didn't bet)





PokerStars Hand #150801990747:  Hold'em No Limit ($1/$2 USD) - 2016/03/23 14:46:15 CET [2016/03/23 9:46:15 ET]
Table 'Ennomos II' 9-max Seat #3 is the button
Seat 1: InsomniaRU ($215.54 in chips) 
Seat 2: Moszes360 ($200 in chips) 
Seat 3: $-Twackle-$ ($436.20 in chips) 
Seat 5: South011 ($401.30 in chips) 
Seat 6: DUkalisUA ($200 in chips) 
Seat 7: T0ny Adams ($72 in chips) 
Seat 8: yyfk ($200 in chips) 
Seat 9: matiko09 ($340.40 in chips) 
Red4erT will be allowed to play after the button
South011: posts small blind $1
DUkalisUA: posts big blind $2
*** HOLE CARDS ***
Dealt to matiko09 [6h Ks]
T0ny Adams: folds 
yyfk: folds 
matiko09: folds 
InsomniaRU: raises $3 to $5
Moszes360: folds 
$-Twackle-$: folds 
South011: calls $4
DUkalisUA: folds 
*** FLOP *** [8s As 6d]
South011: checks 
InsomniaRU: bets $7.68
South011: folds 
Uncalled bet ($7.68) returned to InsomniaRU
InsomniaRU collected $11.46 from pot
InsomniaRU: doesn't show hand 
*** SUMMARY ***
Total pot $12 | Rake $0.54 
Board [8s As 6d]
Seat 1: InsomniaRU collected ($11.46)
Seat 2: Moszes360 folded before Flop (didn't bet)
Seat 3: $-Twackle-$ (button) folded before Flop (didn't bet)
Seat 5: South011 (small blind) folded on the Flop
Seat 6: DUkalisUA (big blind) folded before Flop
Seat 7: T0ny Adams folded before Flop (didn't bet)
Seat 8: yyfk folded before Flop (didn't bet)
Seat 9: matiko09 folded before Flop (didn't bet)





PokerStars Hand #150801993151:  Hold'em No Limit ($0.50/$1.00 USD) - 2016/03/23 14:46:19 CET [2016/03/23 9:46:19 ET]
Table 'Donar II' 9-max Seat #9 is the button
Seat 1: Effort92 ($125.51 in chips) 
Seat 2: nobrunobru1 ($33.04 in chips) 
Seat 4: DUkalisUA ($160.44 in chips) 
Seat 5: matiko09 ($100 in chips) 
Seat 7: JimineyCrik ($124.69 in chips) 
Seat 8: $-Twackle-$ ($119.40 in chips) 
Seat 9: oxfordtenzin ($56.32 in chips) 
Effort92: posts small blind $0.50
nobrunobru1: posts big blind $1
Effort92: posts the ante $0.20
nobrunobru1: posts the ante $0.20
DUkalisUA: posts the ante $0.20
matiko09: posts the ante $0.20
JimineyCrik: posts the ante $0.20
$-Twackle-$: posts the ante $0.20
oxfordtenzin: posts the ante $0.20
*** HOLE CARDS ***
Dealt to matiko09 [7d Td]
DUkalisUA: folds 
matiko09: folds 
JimineyCrik: raises $1.40 to $2.40
$-Twackle-$: folds 
oxfordtenzin: calls $2.40
Effort92: folds 
nobrunobru1: calls $1.40
*** FLOP *** [2d 4s Kh]
nobrunobru1: checks 
JimineyCrik: bets $2.25
oxfordtenzin: raises $2.75 to $5
nobrunobru1: folds 
JimineyCrik: raises $9.53 to $14.53
oxfordtenzin: calls $9.53
*** TURN *** [2d 4s Kh] [3d]
JimineyCrik: checks 
oxfordtenzin: checks 
*** RIVER *** [2d 4s Kh 3d] [7s]
JimineyCrik: bets $18.58
oxfordtenzin: raises $20.61 to $39.19 and is all-in
JimineyCrik: calls $20.61
*** SHOW DOWN ***
oxfordtenzin: shows [3c 6c] (a pair of Threes)
JimineyCrik: shows [Qd Kd] (a pair of Kings)
JimineyCrik collected $113.74 from pot
oxfordtenzin leaves the table
*** SUMMARY ***
Total pot $116.54 | Rake $2.80 
Board [2d 4s Kh 3d 7s]
Seat 1: Effort92 (small blind) folded before Flop
Seat 2: nobrunobru1 (big blind) folded on the Flop
Seat 4: DUkalisUA folded before Flop (didn't bet)
Seat 5: matiko09 folded before Flop (didn't bet)
Seat 7: JimineyCrik showed [Qd Kd] and won ($113.74) with a pair of Kings
Seat 8: $-Twackle-$ folded before Flop (didn't bet)
Seat 9: oxfordtenzin (button) showed [3c 6c] and lost with a pair of Threes





PokerStars Hand #150801996675:  Hold'em No Limit ($1/$2 USD) - 2016/03/23 14:46:24 CET [2016/03/23 9:46:24 ET]
Table 'Kypria II' 9-max Seat #1 is the button
Seat 1: geldwolfje ($147.05 in chips) 
Seat 3: seouljam ($228.42 in chips) 
Seat 4: VolanDog ($234.12 in chips) 
Seat 5: InsomniaRU ($316.34 in chips) 
Seat 6: matiko09 ($424.53 in chips) 
Seat 7: DUkalisUA ($200 in chips) 
Seat 8: nickreason17 ($200 in chips) 
Seat 9: Moszes360 ($200 in chips) 
coinflip_si will be allowed to play after the button
seouljam: posts small blind $1
VolanDog: posts big blind $2
*** HOLE CARDS ***
Dealt to matiko09 [2d Jd]
InsomniaRU: folds 
matiko09: folds 
DUkalisUA: folds 
nickreason17: folds 
Moszes360: folds 
geldwolfje: raises $2 to $4
seouljam: folds 
VolanDog: folds 
Uncalled bet ($2) returned to geldwolfje
geldwolfje collected $5 from pot
geldwolfje: doesn't show hand 
*** SUMMARY ***
Total pot $5 | Rake $0 
Seat 1: geldwolfje (button) collected ($5)
Seat 3: seouljam (small blind) folded before Flop
Seat 4: VolanDog (big blind) folded before Flop
Seat 5: InsomniaRU folded before Flop (didn't bet)
Seat 6: matiko09 folded before Flop (didn't bet)
Seat 7: DUkalisUA folded before Flop (didn't bet)
Seat 8: nickreason17 folded before Flop (didn't bet)
Seat 9: Moszes360 folded before Flop (didn't bet)





PokerStars Hand #150801998630:  Hold'em No Limit ($1/$2 USD) - 2016/03/23 14:46:27 CET [2016/03/23 9:46:27 ET]
Table 'Herba II' 9-max Seat #2 is the button
Seat 1: matiko09 ($216.62 in chips) 
Seat 2: Moszes360 ($200 in chips) 
Seat 3: Cirilico ($160 in chips) 
Seat 4: DUkalisUA ($252.20 in chips) 
Seat 5: chippo boy ($243.33 in chips) 
Seat 6: Too-Anti-To ($228.38 in chips) 
Seat 7: InsomniaRU ($408.70 in chips) 
Seat 8: The_red_area ($462.18 in chips) 
Seat 9: mrhighryza ($56.44 in chips) 
Cirilico: posts small blind $1
DUkalisUA: posts big blind $2
*** HOLE CARDS ***
Dealt to matiko09 [7d 3c]
chippo boy: calls $2
Too-Anti-To: folds 
InsomniaRU: folds 
The_red_area: folds 
mrhighryza: folds 
matiko09: folds 
Moszes360: folds 
Cirilico: folds 
DUkalisUA: raises $6 to $8
chippo boy: calls $6
*** FLOP *** [Th Kh 2d]
DUkalisUA: bets $9
chippo boy: calls $9
*** TURN *** [Th Kh 2d] [6d]
DUkalisUA: bets $15
chippo boy: raises $15 to $30
DUkalisUA: calls $15
*** RIVER *** [Th Kh 2d 6d] [7s]
DUkalisUA: checks 
chippo boy: bets $44
DUkalisUA: folds 
Uncalled bet ($44) returned to chippo boy
chippo boy collected $92.20 from pot
*** SUMMARY ***
Total pot $95 | Rake $2.80 
Board [Th Kh 2d 6d 7s]
Seat 1: matiko09 folded before Flop (didn't bet)
Seat 2: Moszes360 (button) folded before Flop (didn't bet)
Seat 3: Cirilico (small blind) folded before Flop
Seat 4: DUkalisUA (big blind) folded on the River
Seat 5: chippo boy collected ($92.20)
Seat 6: Too-Anti-To folded before Flop (didn't bet)
Seat 7: InsomniaRU folded before Flop (didn't bet)
Seat 8: The_red_area folded before Flop (didn't bet)
Seat 9: mrhighryza folded before Flop (didn't bet)





PokerStars Hand #150802002578:  Hold'em No Limit ($0.50/$1.00 USD) - 2016/03/23 14:46:34 CET [2016/03/23 9:46:34 ET]
Table 'Atlantis' 9-max Seat #1 is the button
Seat 1: xHourglass ($131.50 in chips) 
Seat 2: Szevasztopol ($102.68 in chips) 
Seat 3: CAJUN890 ($144.84 in chips) 
Seat 4: matiko09 ($146.11 in chips) 
Seat 5: Pvsx. ($107.06 in chips) 
Seat 6: Jimy Tiltman ($100 in chips) 
Seat 7: Sherlockplay ($141.48 in chips) 
Seat 8: DUkalisUA ($136.80 in chips) 
Seat 9: RICKA16 ($102.16 in chips) 
Szevasztopol: posts small blind $0.50
CAJUN890: posts big blind $1
*** HOLE CARDS ***
Dealt to matiko09 [Kd 4s]
matiko09: folds 
Pvsx.: raises $1.50 to $2.50
Jimy Tiltman: folds 
Sherlockplay: folds 
DUkalisUA: folds 
RICKA16: folds 
xHourglass: folds 
Szevasztopol: folds 
CAJUN890: folds 
Uncalled bet ($1.50) returned to Pvsx.
Pvsx. collected $2.50 from pot
Pvsx.: doesn't show hand 
*** SUMMARY ***
Total pot $2.50 | Rake $0 
Seat 1: xHourglass (button) folded before Flop (didn't bet)
Seat 2: Szevasztopol (small blind) folded before Flop
Seat 3: CAJUN890 (big blind) folded before Flop
Seat 4: matiko09 folded before Flop (didn't bet)
Seat 5: Pvsx. collected ($2.50)
Seat 6: Jimy Tiltman folded before Flop (didn't bet)
Seat 7: Sherlockplay folded before Flop (didn't bet)
Seat 8: DUkalisUA folded before Flop (didn't bet)
Seat 9: RICKA16 folded before Flop (didn't bet)





PokerStars Hand #150802007522:  Hold'em No Limit ($1/$2 USD) - 2016/03/23 14:46:42 CET [2016/03/23 9:46:42 ET]
Table 'Achaia' 9-max Seat #8 is the button
Seat 1: Moszes360 ($242.42 in chips) 
Seat 2: InsomniaRU ($220.44 in chips) 
Seat 3: matiko09 ($237.16 in chips) 
Seat 4: erfk1958 ($108 in chips) 
Seat 5: chaps1988 ($211.70 in chips) 
Seat 6: nickreason17 ($211.99 in chips) 
Seat 7: morosun ($268.13 in chips) 
Seat 8: $-Twackle-$ ($214.07 in chips) 
PacPacBum will be allowed to play after the button
Moszes360: posts small blind $1
InsomniaRU: posts big blind $2
*** HOLE CARDS ***
Dealt to matiko09 [4d 6h]
matiko09: folds 
erfk1958: folds 
chaps1988: folds 
nickreason17: folds 
morosun: folds 
$-Twackle-$: folds 
Moszes360: folds 
Uncalled bet ($1) returned to InsomniaRU
InsomniaRU collected $2 from pot
InsomniaRU: doesn't show hand 
*** SUMMARY ***
Total pot $2 | Rake $0 
Seat 1: Moszes360 (small blind) folded before Flop
Seat 2: InsomniaRU (big blind) collected ($2)
Seat 3: matiko09 folded before Flop (didn't bet)
Seat 4: erfk1958 folded before Flop (didn't bet)
Seat 5: chaps1988 folded before Flop (didn't bet)
Seat 6: nickreason17 folded before Flop (didn't bet)
Seat 7: morosun folded before Flop (didn't bet)
Seat 8: $-Twackle-$ (button) folded before Flop (didn't bet)





PokerStars Hand #150802007519:  Hold'em No Limit ($0.50/$1.00 USD) - 2016/03/23 14:46:42 CET [2016/03/23 9:46:42 ET]
Table 'Swings' 9-max Seat #9 is the button
Seat 1: Sherlockplay ($115.13 in chips) 
Seat 2: Harbinger X ($187.14 in chips) 
Seat 3: maxxmeister ($119.28 in chips) 
Seat 4: chaps1988 ($100 in chips) 
Seat 5: chautinhtri9 ($81 in chips) 
Seat 6: matiko09 ($126.43 in chips) 
Seat 7: PacPacBum ($100 in chips) 
Seat 8: RICKA16 ($107.96 in chips) 
Seat 9: Vlad_1965_77 ($110.21 in chips) 
Sherlockplay: posts small blind $0.50
Harbinger X: posts big blind $1
*** HOLE CARDS ***
Dealt to matiko09 [9d 4s]
maxxmeister: folds 
chaps1988: folds 
chautinhtri9: raises $1 to $2
matiko09: folds 
PacPacBum: raises $5 to $7
RICKA16: folds 
Vlad_1965_77: calls $7
Sherlockplay: folds 
Harbinger X: folds 
chautinhtri9: calls $5
*** FLOP *** [8h 2h 6c]
chautinhtri9: checks 
PacPacBum: bets $14.82
Vlad_1965_77: folds 
chautinhtri9: folds 
Uncalled bet ($14.82) returned to PacPacBum
PacPacBum collected $21.49 from pot
PacPacBum: doesn't show hand 
*** SUMMARY ***
Total pot $22.50 | Rake $1.01 
Board [8h 2h 6c]
Seat 1: Sherlockplay (small blind) folded before Flop
Seat 2: Harbinger X (big blind) folded before Flop
Seat 3: maxxmeister folded before Flop (didn't bet)
Seat 4: chaps1988 folded before Flop (didn't bet)
Seat 5: chautinhtri9 folded on the Flop
Seat 6: matiko09 folded before Flop (didn't bet)
Seat 7: PacPacBum collected ($21.49)
Seat 8: RICKA16 folded before Flop (didn't bet)
Seat 9: Vlad_1965_77 (button) folded on the Flop





PokerStars Hand #150802008988:  Hold'em No Limit ($1/$2 USD) - 2016/03/23 14:46:44 CET [2016/03/23 9:46:44 ET]
Table 'Kypria II' 9-max Seat #3 is the button
Seat 1: geldwolfje ($150.05 in chips) 
Seat 3: seouljam ($227.42 in chips) 
Seat 4: VolanDog ($232.12 in chips) 
Seat 5: InsomniaRU ($316.34 in chips) 
Seat 6: matiko09 ($424.53 in chips) 
Seat 7: DUkalisUA ($200 in chips) 
Seat 8: nickreason17 ($200 in chips) 
Seat 9: Moszes360 ($200 in chips) 
VolanDog: posts small blind $1
InsomniaRU: posts big blind $2
coinflip_si: sits out 
*** HOLE CARDS ***
Dealt to matiko09 [Ah 7c]
matiko09: folds 
DUkalisUA: folds 
nickreason17: folds 
Moszes360: folds 
geldwolfje: folds 
seouljam: folds 
VolanDog: folds 
Uncalled bet ($1) returned to InsomniaRU
InsomniaRU collected $2 from pot
InsomniaRU: doesn't show hand 
*** SUMMARY ***
Total pot $2 | Rake $0 
Seat 1: geldwolfje folded before Flop (didn't bet)
Seat 3: seouljam (button) folded before Flop (didn't bet)
Seat 4: VolanDog (small blind) folded before Flop
Seat 5: InsomniaRU (big blind) collected ($2)
Seat 6: matiko09 folded before Flop (didn't bet)
Seat 7: DUkalisUA folded before Flop (didn't bet)
Seat 8: nickreason17 folded before Flop (didn't bet)
Seat 9: Moszes360 folded before Flop (didn't bet)





PokerStars Hand #150802015931:  Hold'em No Limit ($0.50/$1.00 USD) - 2016/03/23 14:46:55 CET [2016/03/23 9:46:55 ET]
Table 'Merope II' 9-max Seat #8 is the button
Seat 1: Jimy Tiltman ($150.99 in chips) 
Seat 2: $-Twackle-$ ($102.87 in chips) 
Seat 3: pablos1922 ($93.81 in chips) 
Seat 4: YuriiSolodya ($85.84 in chips) 
Seat 6: Effort92 ($101.21 in chips) 
Seat 7: matiko09 ($105.03 in chips) 
Seat 8: Red4erT ($40 in chips) 
Seat 9: RICKA16 ($101.50 in chips) 
RICKA16: posts small blind $0.50
Jimy Tiltman: posts big blind $1
Butcher1848: sits out 
*** HOLE CARDS ***
Dealt to matiko09 [4h Qh]
$-Twackle-$: folds 
pablos1922: folds 
YuriiSolodya: folds 
Effort92: folds 
matiko09: folds 
Red4erT: folds 
RICKA16: raises $2 to $3
Jimy Tiltman: calls $2
*** FLOP *** [9h 9c 8h]
RICKA16: bets $4
Jimy Tiltman: calls $4
*** TURN *** [9h 9c 8h] [Ah]
RICKA16: checks 
Jimy Tiltman: checks 
*** RIVER *** [9h 9c 8h Ah] [5c]
RICKA16: bets $9
Jimy Tiltman: calls $9
*** SHOW DOWN ***
RICKA16: shows [9d 5d] (a full house, Nines full of Fives)
Jimy Tiltman: mucks hand 
RICKA16 collected $30.56 from pot
*** SUMMARY ***
Total pot $32 | Rake $1.44 
Board [9h 9c 8h Ah 5c]
Seat 1: Jimy Tiltman (big blind) mucked [8d Ac]
Seat 2: $-Twackle-$ folded before Flop (didn't bet)
Seat 3: pablos1922 folded before Flop (didn't bet)
Seat 4: YuriiSolodya folded before Flop (didn't bet)
Seat 6: Effort92 folded before Flop (didn't bet)
Seat 7: matiko09 folded before Flop (didn't bet)
Seat 8: Red4erT (button) folded before Flop (didn't bet)
Seat 9: RICKA16 (small blind) showed [9d 5d] and won ($30.56) with a full house, Nines full of Fives





PokerStars Hand #150802016819:  Hold'em No Limit ($1/$2 USD) - 2016/03/23 14:46:56 CET [2016/03/23 9:46:56 ET]
Table 'Kypria II' 9-max Seat #4 is the button
Seat 1: geldwolfje ($150.05 in chips) 
Seat 3: seouljam ($227.42 in chips) 
Seat 4: VolanDog ($231.12 in chips) 
Seat 5: InsomniaRU ($317.34 in chips) 
Seat 6: matiko09 ($424.53 in chips) 
Seat 7: DUkalisUA ($200 in chips) 
Seat 8: nickreason17 ($200 in chips) 
Seat 9: Moszes360 ($200 in chips) 
InsomniaRU: posts small blind $1
matiko09: posts big blind $2
coinflip_si: sits out 
*** HOLE CARDS ***
Dealt to matiko09 [8s 2s]
DUkalisUA: folds 
nickreason17: folds 
Moszes360: folds 
geldwolfje: folds 
seouljam: folds 
VolanDog: raises $2 to $4
InsomniaRU: folds 
matiko09: folds 
Uncalled bet ($2) returned to VolanDog
VolanDog collected $5 from pot
*** SUMMARY ***
Total pot $5 | Rake $0 
Seat 1: geldwolfje folded before Flop (didn't bet)
Seat 3: seouljam folded before Flop (didn't bet)
Seat 4: VolanDog (button) collected ($5)
Seat 5: InsomniaRU (small blind) folded before Flop
Seat 6: matiko09 (big blind) folded before Flop
Seat 7: DUkalisUA folded before Flop (didn't bet)
Seat 8: nickreason17 folded before Flop (didn't bet)
Seat 9: Moszes360 folded before Flop (didn't bet)





PokerStars Hand #150802017364:  Hold'em No Limit ($0.25/$0.50 USD) - 2016/03/23 14:46:57 CET [2016/03/23 9:46:57 ET]
Table 'Pyrrhus' 9-max Seat #2 is the button
Seat 2: BSTUSim ($76.14 in chips) 
Seat 3: i L00K great ($50 in chips) 
Seat 4: GriffinBerg ($43.70 in chips) 
Seat 5: ZonTTT ($52.86 in chips) 
Seat 6: Ahangama ($50.75 in chips) 
Seat 7: matiko09 ($140.25 in chips) 
Seat 8: dndngod ($69.73 in chips) 
Seat 9: CvMCvMCvM ($90.88 in chips) 
i L00K great: posts small blind $0.25
GriffinBerg: posts big blind $0.50
lumen21: sits out 
*** HOLE CARDS ***
Dealt to matiko09 [7s Kh]
ZonTTT: raises $1 to $1.50
Ahangama: folds 
matiko09: folds 
dndngod: folds 
CvMCvMCvM: folds 
BSTUSim: folds 
i L00K great: folds 
GriffinBerg: folds 
Uncalled bet ($1) returned to ZonTTT
ZonTTT collected $1.25 from pot
ZonTTT: doesn't show hand 
*** SUMMARY ***
Total pot $1.25 | Rake $0 
Seat 2: BSTUSim (button) folded before Flop (didn't bet)
Seat 3: i L00K great (small blind) folded before Flop
Seat 4: GriffinBerg (big blind) folded before Flop
Seat 5: ZonTTT collected ($1.25)
Seat 6: Ahangama folded before Flop (didn't bet)
Seat 7: matiko09 folded before Flop (didn't bet)
Seat 8: dndngod folded before Flop (didn't bet)
Seat 9: CvMCvMCvM folded before Flop (didn't bet)





PokerStars Hand #150802019219:  Hold'em No Limit ($1/$2 USD) - 2016/03/23 14:47:00 CET [2016/03/23 9:47:00 ET]
Table 'Kiess' 9-max Seat #5 is the button
Seat 1: Cirilico ($209.22 in chips) 
Seat 2: DUkalisUA ($678.34 in chips) 
Seat 3: The_red_area ($328.46 in chips) 
Seat 4: Moszes360 ($200 in chips) 
Seat 5: chippo boy ($462.88 in chips) 
Seat 6: matiko09 ($261.86 in chips) 
Seat 7: InsomniaRU ($334.21 in chips) 
Seat 8: erfk1958 ($82.96 in chips) 
Seat 9: T0ny Adams ($100.46 in chips) 
matiko09: posts small blind $1
InsomniaRU: posts big blind $2
*** HOLE CARDS ***
Dealt to matiko09 [9d 7c]
erfk1958: folds 
T0ny Adams: raises $3 to $5
Cirilico: folds 
DUkalisUA: folds 
The_red_area: folds 
Moszes360: folds 
chippo boy: folds 
matiko09: folds 
InsomniaRU: folds 
Uncalled bet ($3) returned to T0ny Adams
T0ny Adams collected $5 from pot
T0ny Adams: doesn't show hand 
*** SUMMARY ***
Total pot $5 | Rake $0 
Seat 1: Cirilico folded before Flop (didn't bet)
Seat 2: DUkalisUA folded before Flop (didn't bet)
Seat 3: The_red_area folded before Flop (didn't bet)
Seat 4: Moszes360 folded before Flop (didn't bet)
Seat 5: chippo boy (button) folded before Flop (didn't bet)
Seat 6: matiko09 (small blind) folded before Flop
Seat 7: InsomniaRU (big blind) folded before Flop
Seat 8: erfk1958 folded before Flop (didn't bet)
Seat 9: T0ny Adams collected ($5)





PokerStars Hand #150802028377:  Hold'em No Limit ($0.50/$1.00 USD) - 2016/03/23 14:47:09 CET [2016/03/23 9:47:09 ET]
Table 'Atlantis' 9-max Seat #2 is the button
Seat 1: xHourglass ($131.50 in chips) 
Seat 2: Szevasztopol ($102.18 in chips) 
Seat 3: CAJUN890 ($143.84 in chips) 
Seat 4: matiko09 ($146.11 in chips) 
Seat 5: Pvsx. ($108.56 in chips) 
Seat 6: Jimy Tiltman ($100 in chips) 
Seat 7: Sherlockplay ($141.48 in chips) 
Seat 8: DUkalisUA ($136.80 in chips) 
Seat 9: RICKA16 ($102.16 in chips) 
CAJUN890: posts small blind $0.50
matiko09: posts big blind $1
*** HOLE CARDS ***
Dealt to matiko09 [Kc 9d]
Pvsx.: folds 
Jimy Tiltman: folds 
Sherlockplay: folds 
DUkalisUA: folds 
RICKA16: folds 
xHourglass: folds 
Szevasztopol: raises $2 to $3
CAJUN890: calls $2.50
matiko09: calls $2
*** FLOP *** [As 4d 7h]
CAJUN890: checks 
matiko09: checks 
Szevasztopol: checks 
*** TURN *** [As 4d 7h] [5h]
CAJUN890: checks 
matiko09: checks 
Szevasztopol: checks 
*** RIVER *** [As 4d 7h 5h] [Jd]
CAJUN890: checks 
matiko09: checks 
Szevasztopol: bets $4
CAJUN890: folds 
matiko09: folds 
Uncalled bet ($4) returned to Szevasztopol
Szevasztopol collected $8.60 from pot
Szevasztopol: doesn't show hand 
*** SUMMARY ***
Total pot $9 | Rake $0.40 
Board [As 4d 7h 5h Jd]
Seat 1: xHourglass folded before Flop (didn't bet)
Seat 2: Szevasztopol (button) collected ($8.60)
Seat 3: CAJUN890 (small blind) folded on the River
Seat 4: matiko09 (big blind) folded on the River
Seat 5: Pvsx. folded before Flop (didn't bet)
Seat 6: Jimy Tiltman folded before Flop (didn't bet)
Seat 7: Sherlockplay folded before Flop (didn't bet)
Seat 8: DUkalisUA folded before Flop (didn't bet)
Seat 9: RICKA16 folded before Flop (didn't bet)





PokerStars Hand #150802029278:  Hold'em No Limit ($1/$2 USD) - 2016/03/23 14:47:10 CET [2016/03/23 9:47:10 ET]
Table 'Achaia' 9-max Seat #1 is the button
Seat 1: Moszes360 ($241.42 in chips) 
Seat 2: InsomniaRU ($221.44 in chips) 
Seat 3: matiko09 ($237.16 in chips) 
Seat 4: erfk1958 ($108 in chips) 
Seat 5: chaps1988 ($211.70 in chips) 
Seat 6: nickreason17 ($211.99 in chips) 
Seat 7: morosun ($268.13 in chips) 
Seat 8: $-Twackle-$ ($214.07 in chips) 
InsomniaRU: posts small blind $1
matiko09: posts big blind $2
PacPacBum: sits out 
*** HOLE CARDS ***
Dealt to matiko09 [Jh 9c]
erfk1958: folds 
chaps1988: folds 
nickreason17: folds 
morosun: folds 
$-Twackle-$: folds 
Moszes360: folds 
InsomniaRU: folds 
Uncalled bet ($1) returned to matiko09
matiko09 collected $2 from pot
matiko09: doesn't show hand 
*** SUMMARY ***
Total pot $2 | Rake $0 
Seat 1: Moszes360 (button) folded before Flop (didn't bet)
Seat 2: InsomniaRU (small blind) folded before Flop
Seat 3: matiko09 (big blind) collected ($2)
Seat 4: erfk1958 folded before Flop (didn't bet)
Seat 5: chaps1988 folded before Flop (didn't bet)
Seat 6: nickreason17 folded before Flop (didn't bet)
Seat 7: morosun folded before Flop (didn't bet)
Seat 8: $-Twackle-$ folded before Flop (didn't bet)





PokerStars Hand #150802037250:  Hold'em No Limit ($1/$2 USD) - 2016/03/23 14:47:17 CET [2016/03/23 9:47:17 ET]
Table 'Kypria II' 9-max Seat #5 is the button
Seat 1: geldwolfje ($150.05 in chips) 
Seat 3: seouljam ($227.42 in chips) 
Seat 4: VolanDog ($234.12 in chips) 
Seat 5: InsomniaRU ($316.34 in chips) 
Seat 6: matiko09 ($422.53 in chips) 
Seat 7: DUkalisUA ($200 in chips) 
Seat 8: nickreason17 ($200 in chips) 
Seat 9: Moszes360 ($200 in chips) 
matiko09: posts small blind $1
DUkalisUA: posts big blind $2
coinflip_si: sits out 
*** HOLE CARDS ***
Dealt to matiko09 [8d 7s]
nickreason17: folds 
Moszes360: folds 
geldwolfje: folds 
seouljam: folds 
VolanDog: raises $2 to $4
InsomniaRU: folds 
matiko09: folds 
DUkalisUA: folds 
Uncalled bet ($2) returned to VolanDog
VolanDog collected $5 from pot
*** SUMMARY ***
Total pot $5 | Rake $0 
Seat 1: geldwolfje folded before Flop (didn't bet)
Seat 3: seouljam folded before Flop (didn't bet)
Seat 4: VolanDog collected ($5)
Seat 5: InsomniaRU (button) folded before Flop (didn't bet)
Seat 6: matiko09 (small blind) folded before Flop
Seat 7: DUkalisUA (big blind) folded before Flop
Seat 8: nickreason17 folded before Flop (didn't bet)
Seat 9: Moszes360 folded before Flop (didn't bet)





PokerStars Hand #150802048068:  Hold'em No Limit ($0.25/$0.50 USD) - 2016/03/23 14:47:27 CET [2016/03/23 9:47:27 ET]
Table 'Pyrrhus' 9-max Seat #3 is the button
Seat 2: BSTUSim ($76.14 in chips) 
Seat 3: i L00K great ($50 in chips) 
Seat 4: GriffinBerg ($43.20 in chips) 
Seat 5: ZonTTT ($53.61 in chips) 
Seat 6: Ahangama ($50.75 in chips) 
Seat 7: matiko09 ($140.25 in chips) 
Seat 8: dndngod ($69.73 in chips) 
Seat 9: CvMCvMCvM ($90.88 in chips) 
GriffinBerg: posts small blind $0.25
ZonTTT: posts big blind $0.50
lumen21: sits out 
*** HOLE CARDS ***
Dealt to matiko09 [2d Kc]
Ahangama: folds 
matiko09: folds 
dndngod: folds 
CvMCvMCvM: folds 
BSTUSim: folds 
i L00K great: folds 
GriffinBerg: calls $0.25
ZonTTT: checks 
*** FLOP *** [Js 9c 4d]
GriffinBerg: checks 
ZonTTT: checks 
*** TURN *** [Js 9c 4d] [6h]
GriffinBerg: bets $0.50
ZonTTT: folds 
Uncalled bet ($0.50) returned to GriffinBerg
GriffinBerg collected $0.96 from pot
*** SUMMARY ***
Total pot $1 | Rake $0.04 
Board [Js 9c 4d 6h]
Seat 2: BSTUSim folded before Flop (didn't bet)
Seat 3: i L00K great (button) folded before Flop (didn't bet)
Seat 4: GriffinBerg (small blind) collected ($0.96)
Seat 5: ZonTTT (big blind) folded on the Turn
Seat 6: Ahangama folded before Flop (didn't bet)
Seat 7: matiko09 folded before Flop (didn't bet)
Seat 8: dndngod folded before Flop (didn't bet)
Seat 9: CvMCvMCvM folded before Flop (didn't bet)





PokerStars Hand #150802049028:  Hold'em No Limit ($1/$2 USD) - 2016/03/23 14:47:29 CET [2016/03/23 9:47:29 ET]
Table 'Ennomos II' 9-max Seat #5 is the button
Seat 1: InsomniaRU ($222 in chips) 
Seat 2: Moszes360 ($200 in chips) 
Seat 3: $-Twackle-$ ($436.20 in chips) 
Seat 5: South011 ($396.30 in chips) 
Seat 6: DUkalisUA ($200 in chips) 
Seat 7: T0ny Adams ($72 in chips) 
Seat 8: yyfk ($200 in chips) 
Seat 9: matiko09 ($340.40 in chips) 
DUkalisUA: posts small blind $1
T0ny Adams: posts big blind $2
Red4erT: sits out 
*** HOLE CARDS ***
Dealt to matiko09 [Kc 7h]
yyfk: folds 
matiko09: folds 
InsomniaRU: folds 
Moszes360: folds 
$-Twackle-$: raises $3 to $5
South011: folds 
DUkalisUA: folds 
T0ny Adams: folds 
Uncalled bet ($3) returned to $-Twackle-$
$-Twackle-$ collected $5 from pot
$-Twackle-$: doesn't show hand 
*** SUMMARY ***
Total pot $5 | Rake $0 
Seat 1: InsomniaRU folded before Flop (didn't bet)
Seat 2: Moszes360 folded before Flop (didn't bet)
Seat 3: $-Twackle-$ collected ($5)
Seat 5: South011 (button) folded before Flop (didn't bet)
Seat 6: DUkalisUA (small blind) folded before Flop
Seat 7: T0ny Adams (big blind) folded before Flop
Seat 8: yyfk folded before Flop (didn't bet)
Seat 9: matiko09 folded before Flop (didn't bet)





PokerStars Hand #150802050879:  Hold'em No Limit ($1/$2 USD) - 2016/03/23 14:47:32 CET [2016/03/23 9:47:32 ET]
Table 'Kiess' 9-max Seat #6 is the button
Seat 1: Cirilico ($209.22 in chips) 
Seat 2: DUkalisUA ($678.34 in chips) 
Seat 3: The_red_area ($328.46 in chips) 
Seat 4: Moszes360 ($200 in chips) 
Seat 5: chippo boy ($462.88 in chips) 
Seat 6: matiko09 ($260.86 in chips) 
Seat 7: InsomniaRU ($332.21 in chips) 
Seat 8: erfk1958 ($82.96 in chips) 
Seat 9: T0ny Adams ($103.46 in chips) 
InsomniaRU: posts small blind $1
erfk1958: posts big blind $2
*** HOLE CARDS ***
Dealt to matiko09 [2s Ks]
T0ny Adams: folds 
Cirilico: folds 
DUkalisUA: folds 
The_red_area: folds 
Moszes360: raises $4 to $6
chippo boy: calls $6
matiko09: folds 
InsomniaRU: folds 
erfk1958: calls $4
*** FLOP *** [Ad Js Jc]
erfk1958: checks 
Moszes360: checks 
chippo boy: checks 
*** TURN *** [Ad Js Jc] [5s]
erfk1958: checks 
Moszes360: bets $6
chippo boy: folds 
erfk1958: folds 
Uncalled bet ($6) returned to Moszes360
Moszes360 collected $18.14 from pot
Moszes360: doesn't show hand 
*** SUMMARY ***
Total pot $19 | Rake $0.86 
Board [Ad Js Jc 5s]
Seat 1: Cirilico folded before Flop (didn't bet)
Seat 2: DUkalisUA folded before Flop (didn't bet)
Seat 3: The_red_area folded before Flop (didn't bet)
Seat 4: Moszes360 collected ($18.14)
Seat 5: chippo boy folded on the Turn
Seat 6: matiko09 (button) folded before Flop (didn't bet)
Seat 7: InsomniaRU (small blind) folded before Flop
Seat 8: erfk1958 (big blind) folded on the Turn
Seat 9: T0ny Adams folded before Flop (didn't bet)





PokerStars Hand #150802052495:  Hold'em No Limit ($1/$2 USD) - 2016/03/23 14:47:35 CET [2016/03/23 9:47:35 ET]
Table 'Kypria II' 9-max Seat #6 is the button
Seat 1: geldwolfje ($150.05 in chips) 
Seat 3: seouljam ($227.42 in chips) 
Seat 4: VolanDog ($237.12 in chips) 
Seat 5: InsomniaRU ($316.34 in chips) 
Seat 6: matiko09 ($421.53 in chips) 
Seat 7: DUkalisUA ($200 in chips) 
Seat 8: nickreason17 ($200 in chips) 
Seat 9: Moszes360 ($200 in chips) 
DUkalisUA: posts small blind $1
nickreason17: posts big blind $2
coinflip_si: sits out 
*** HOLE CARDS ***
Dealt to matiko09 [As 9h]
Moszes360: folds 
geldwolfje: folds 
seouljam: folds 
VolanDog: raises $2 to $4
InsomniaRU: folds 
matiko09: folds 
DUkalisUA: folds 
nickreason17: calls $2
*** FLOP *** [8s 8c 4h]
nickreason17: checks 
VolanDog: bets $4
nickreason17: folds 
Uncalled bet ($4) returned to VolanDog
VolanDog collected $8.60 from pot
*** SUMMARY ***
Total pot $9 | Rake $0.40 
Board [8s 8c 4h]
Seat 1: geldwolfje folded before Flop (didn't bet)
Seat 3: seouljam folded before Flop (didn't bet)
Seat 4: VolanDog collected ($8.60)
Seat 5: InsomniaRU folded before Flop (didn't bet)
Seat 6: matiko09 (button) folded before Flop (didn't bet)
Seat 7: DUkalisUA (small blind) folded before Flop
Seat 8: nickreason17 (big blind) folded on the Flop
Seat 9: Moszes360 folded before Flop (didn't bet)





PokerStars Hand #150802060217:  Hold'em No Limit ($1/$2 USD) - 2016/03/23 14:47:42 CET [2016/03/23 9:47:42 ET]
Table 'Achaia' 9-max Seat #2 is the button
Seat 1: Moszes360 ($241.42 in chips) 
Seat 2: InsomniaRU ($220.44 in chips) 
Seat 3: matiko09 ($238.16 in chips) 
Seat 4: erfk1958 ($108 in chips) 
Seat 5: chaps1988 ($211.70 in chips) 
Seat 6: nickreason17 ($211.99 in chips) 
Seat 7: morosun ($268.13 in chips) 
Seat 8: $-Twackle-$ ($214.07 in chips) 
matiko09: posts small blind $1
erfk1958: posts big blind $2
PacPacBum: sits out 
*** HOLE CARDS ***
Dealt to matiko09 [7s 5d]
chaps1988: folds 
nickreason17: folds 
morosun: folds 
$-Twackle-$: folds 
Moszes360: raises $3 to $5
InsomniaRU: folds 
matiko09: folds 
erfk1958: folds 
Uncalled bet ($3) returned to Moszes360
Moszes360 collected $5 from pot
Moszes360: doesn't show hand 
*** SUMMARY ***
Total pot $5 | Rake $0 
Seat 1: Moszes360 collected ($5)
Seat 2: InsomniaRU (button) folded before Flop (didn't bet)
Seat 3: matiko09 (small blind) folded before Flop
Seat 4: erfk1958 (big blind) folded before Flop
Seat 5: chaps1988 folded before Flop (didn't bet)
Seat 6: nickreason17 folded before Flop (didn't bet)
Seat 7: morosun folded before Flop (didn't bet)
Seat 8: $-Twackle-$ folded before Flop (didn't bet)





PokerStars Hand #150802060569:  Hold'em No Limit ($1/$2 USD) - 2016/03/23 14:47:42 CET [2016/03/23 9:47:42 ET]
Table 'Herba II' 9-max Seat #3 is the button
Seat 1: matiko09 ($216.62 in chips) 
Seat 2: Moszes360 ($200 in chips) 
Seat 3: Cirilico ($160 in chips) 
Seat 4: DUkalisUA ($205.20 in chips) 
Seat 5: chippo boy ($288.53 in chips) 
Seat 6: Too-Anti-To ($228.38 in chips) 
Seat 7: InsomniaRU ($408.70 in chips) 
Seat 8: The_red_area ($462.18 in chips) 
Seat 9: mrhighryza ($56.44 in chips) 
DUkalisUA: posts small blind $1
chippo boy: posts big blind $2
*** HOLE CARDS ***
Dealt to matiko09 [Qs Qc]
Too-Anti-To: folds 
InsomniaRU: folds 
The_red_area: folds 
mrhighryza: folds 
matiko09: raises $3 to $5
Moszes360: folds 
Cirilico: folds 
DUkalisUA: calls $4
chippo boy: calls $3
*** FLOP *** [5d Ks 9h]
DUkalisUA: checks 
chippo boy: checks 
matiko09: checks 
*** TURN *** [5d Ks 9h] [Js]
DUkalisUA: checks 
chippo boy: bets $6
matiko09: calls $6
DUkalisUA: folds 
*** RIVER *** [5d Ks 9h Js] [2h]
chippo boy: bets $8
matiko09: calls $8
*** SHOW DOWN ***
chippo boy: shows [Qh Jd] (a pair of Jacks)
matiko09: shows [Qs Qc] (a pair of Queens)
matiko09 collected $41.06 from pot
*** SUMMARY ***
Total pot $43 | Rake $1.94 
Board [5d Ks 9h Js 2h]
Seat 1: matiko09 showed [Qs Qc] and won ($41.06) with a pair of Queens
Seat 2: Moszes360 folded before Flop (didn't bet)
Seat 3: Cirilico (button) folded before Flop (didn't bet)
Seat 4: DUkalisUA (small blind) folded on the Turn
Seat 5: chippo boy (big blind) showed [Qh Jd] and lost with a pair of Jacks
Seat 6: Too-Anti-To folded before Flop (didn't bet)
Seat 7: InsomniaRU folded before Flop (didn't bet)
Seat 8: The_red_area folded before Flop (didn't bet)
Seat 9: mrhighryza folded before Flop (didn't bet)





PokerStars Hand #150802060112:  Hold'em No Limit ($0.50/$1.00 USD) - 2016/03/23 14:47:42 CET [2016/03/23 9:47:42 ET]
Table 'Swings' 9-max Seat #1 is the button
Seat 1: Sherlockplay ($114.63 in chips) 
Seat 2: Harbinger X ($186.14 in chips) 
Seat 3: maxxmeister ($119.28 in chips) 
Seat 4: chaps1988 ($100 in chips) 
Seat 5: chautinhtri9 ($74 in chips) 
Seat 6: matiko09 ($126.43 in chips) 
Seat 7: PacPacBum ($114.49 in chips) 
Seat 8: RICKA16 ($107.96 in chips) 
Seat 9: Vlad_1965_77 ($103.21 in chips) 
Harbinger X: posts small blind $0.50
maxxmeister: posts big blind $1
*** HOLE CARDS ***
Dealt to matiko09 [9c Ks]
chaps1988: raises $2 to $3
chautinhtri9: folds 
matiko09: folds 
PacPacBum: folds 
RICKA16: folds 
Vlad_1965_77: folds 
Sherlockplay: folds 
Harbinger X: folds 
maxxmeister: folds 
Uncalled bet ($2) returned to chaps1988
chaps1988 collected $2.50 from pot
chaps1988: doesn't show hand 
*** SUMMARY ***
Total pot $2.50 | Rake $0 
Seat 1: Sherlockplay (button) folded before Flop (didn't bet)
Seat 2: Harbinger X (small blind) folded before Flop
Seat 3: maxxmeister (big blind) folded before Flop
Seat 4: chaps1988 collected ($2.50)
Seat 5: chautinhtri9 folded before Flop (didn't bet)
Seat 6: matiko09 folded before Flop (didn't bet)
Seat 7: PacPacBum folded before Flop (didn't bet)
Seat 8: RICKA16 folded before Flop (didn't bet)
Seat 9: Vlad_1965_77 folded before Flop (didn't bet)





PokerStars Hand #150802060716:  Hold'em No Limit ($0.50/$1.00 USD) - 2016/03/23 14:47:43 CET [2016/03/23 9:47:43 ET]
Table 'Donar II' 9-max Seat #1 is the button
Seat 1: Effort92 ($124.81 in chips) 
Seat 2: nobrunobru1 ($30.44 in chips) 
Seat 4: DUkalisUA ($160.24 in chips) 
Seat 5: matiko09 ($100 in chips) 
Seat 7: JimineyCrik ($182.11 in chips) 
Seat 8: $-Twackle-$ ($119.20 in chips) 
nobrunobru1: posts small blind $0.50
DUkalisUA: posts big blind $1
Effort92: posts the ante $0.20
nobrunobru1: posts the ante $0.20
DUkalisUA: posts the ante $0.20
matiko09: posts the ante $0.20
JimineyCrik: posts the ante $0.20
$-Twackle-$: posts the ante $0.20
*** HOLE CARDS ***
Dealt to matiko09 [Jd Kh]
matiko09: raises $2 to $3
JimineyCrik: folds 
$-Twackle-$: folds 
Effort92: folds 
nobrunobru1: calls $2.50
DUkalisUA: folds 
*** FLOP *** [9c 5s Kc]
nobrunobru1: checks 
matiko09: bets $5.09
nobrunobru1: calls $5.09
*** TURN *** [9c 5s Kc] [2h]
nobrunobru1: checks 
matiko09: bets $12
nobrunobru1: raises $10.15 to $22.15 and is all-in
matiko09: calls $10.15
*** RIVER *** [9c 5s Kc 2h] [7h]
*** SHOW DOWN ***
nobrunobru1: shows [Ks Td] (a pair of Kings)
matiko09: shows [Jd Kh] (a pair of Kings - Jack kicker)
matiko09 collected $59.88 from pot
*** SUMMARY ***
Total pot $62.68 | Rake $2.80 
Board [9c 5s Kc 2h 7h]
Seat 1: Effort92 (button) folded before Flop (didn't bet)
Seat 2: nobrunobru1 (small blind) showed [Ks Td] and lost with a pair of Kings
Seat 4: DUkalisUA (big blind) folded before Flop
Seat 5: matiko09 showed [Jd Kh] and won ($59.88) with a pair of Kings
Seat 7: JimineyCrik folded before Flop (didn't bet)
Seat 8: $-Twackle-$ folded before Flop (didn't bet)





PokerStars Hand #150802071164:  Hold'em No Limit ($0.50/$1.00 USD) - 2016/03/23 14:47:56 CET [2016/03/23 9:47:56 ET]
Table 'Merope II' 9-max Seat #9 is the button
Seat 1: Jimy Tiltman ($134.99 in chips) 
Seat 2: $-Twackle-$ ($102.87 in chips) 
Seat 3: pablos1922 ($93.81 in chips) 
Seat 4: YuriiSolodya ($85.84 in chips) 
Seat 6: Effort92 ($101.21 in chips) 
Seat 7: matiko09 ($105.03 in chips) 
Seat 8: Red4erT ($40 in chips) 
Seat 9: RICKA16 ($116.06 in chips) 
Jimy Tiltman: posts small blind $0.50
$-Twackle-$: posts big blind $1
Butcher1848: sits out 
*** HOLE CARDS ***
Dealt to matiko09 [8d Qs]
Jimy Tiltman said, "sure"
Jimy Tiltman said, "sure"
Jimy Tiltman said, "sure"
pablos1922: folds 
YuriiSolodya: folds 
Effort92: folds 
Jimy Tiltman said, "just the idiots"
matiko09: folds 
Red4erT: folds 
RICKA16: raises $2 to $3
Jimy Tiltman: folds 
$-Twackle-$: folds 
Uncalled bet ($2) returned to RICKA16
RICKA16 collected $2.50 from pot
RICKA16: doesn't show hand 
*** SUMMARY ***
Total pot $2.50 | Rake $0 
Seat 1: Jimy Tiltman (small blind) folded before Flop
Seat 2: $-Twackle-$ (big blind) folded before Flop
Seat 3: pablos1922 folded before Flop (didn't bet)
Seat 4: YuriiSolodya folded before Flop (didn't bet)
Seat 6: Effort92 folded before Flop (didn't bet)
Seat 7: matiko09 folded before Flop (didn't bet)
Seat 8: Red4erT folded before Flop (didn't bet)
Seat 9: RICKA16 (button) collected ($2.50)





PokerStars Hand #150802081481:  Hold'em No Limit ($0.25/$0.50 USD) - 2016/03/23 14:48:11 CET [2016/03/23 9:48:11 ET]
Table 'Pyrrhus' 9-max Seat #4 is the button
Seat 2: BSTUSim ($76.14 in chips) 
Seat 3: i L00K great ($50 in chips) 
Seat 4: GriffinBerg ($43.66 in chips) 
Seat 5: ZonTTT ($53.11 in chips) 
Seat 6: Ahangama ($50.75 in chips) 
Seat 7: matiko09 ($140.25 in chips) 
Seat 8: dndngod ($69.73 in chips) 
Seat 9: CvMCvMCvM ($90.88 in chips) 
ZonTTT: posts small blind $0.25
Ahangama: posts big blind $0.50
lumen21: sits out 
*** HOLE CARDS ***
Dealt to matiko09 [3d 8d]
matiko09: folds 
dndngod: raises $1 to $1.50
CvMCvMCvM: folds 
BSTUSim: calls $1.50
i L00K great: folds 
GriffinBerg: folds 
ZonTTT: folds 
Ahangama: folds 
*** FLOP *** [8c Js Tc]
dndngod: bets $2.50
BSTUSim: calls $2.50
*** TURN *** [8c Js Tc] [Td]
dndngod: checks 
BSTUSim: bets $4.77
dndngod: raises $8.73 to $13.50
BSTUSim: folds 
Uncalled bet ($8.73) returned to dndngod
dndngod collected $17.47 from pot
*** SUMMARY ***
Total pot $18.29 | Rake $0.82 
Board [8c Js Tc Td]
Seat 2: BSTUSim folded on the Turn
Seat 3: i L00K great folded before Flop (didn't bet)
Seat 4: GriffinBerg (button) folded before Flop (didn't bet)
Seat 5: ZonTTT (small blind) folded before Flop
Seat 6: Ahangama (big blind) folded before Flop
Seat 7: matiko09 folded before Flop (didn't bet)
Seat 8: dndngod collected ($17.47)
Seat 9: CvMCvMCvM folded before Flop (didn't bet)





PokerStars Hand #150802082143:  Hold'em No Limit ($1/$2 USD) - 2016/03/23 14:48:12 CET [2016/03/23 9:48:12 ET]
Table 'Achaia' 9-max Seat #3 is the button
Seat 1: Moszes360 ($244.42 in chips) 
Seat 2: InsomniaRU ($220.44 in chips) 
Seat 3: matiko09 ($237.16 in chips) 
Seat 4: erfk1958 ($106 in chips) 
Seat 5: chaps1988 ($211.70 in chips) 
Seat 6: nickreason17 ($211.99 in chips) 
Seat 7: morosun ($268.13 in chips) 
Seat 8: $-Twackle-$ ($214.07 in chips) 
erfk1958: posts small blind $1
chaps1988: posts big blind $2
PacPacBum: sits out 
*** HOLE CARDS ***
Dealt to matiko09 [Js 9s]
nickreason17: folds 
morosun: folds 
$-Twackle-$: folds 
Moszes360: folds 
InsomniaRU: raises $3 to $5
matiko09: folds 
erfk1958: folds 
chaps1988: calls $3
*** FLOP *** [2s 3s 2h]
chaps1988: checks 
InsomniaRU: bets $7.04
chaps1988: folds 
Uncalled bet ($7.04) returned to InsomniaRU
InsomniaRU collected $10.50 from pot
InsomniaRU: doesn't show hand 
*** SUMMARY ***
Total pot $11 | Rake $0.50 
Board [2s 3s 2h]
Seat 1: Moszes360 folded before Flop (didn't bet)
Seat 2: InsomniaRU collected ($10.50)
Seat 3: matiko09 (button) folded before Flop (didn't bet)
Seat 4: erfk1958 (small blind) folded before Flop
Seat 5: chaps1988 (big blind) folded on the Flop
Seat 6: nickreason17 folded before Flop (didn't bet)
Seat 7: morosun folded before Flop (didn't bet)
Seat 8: $-Twackle-$ folded before Flop (didn't bet)





PokerStars Hand #150802082993:  Hold'em No Limit ($0.50/$1.00 USD) - 2016/03/23 14:48:14 CET [2016/03/23 9:48:14 ET]
Table 'Swings' 9-max Seat #2 is the button
Seat 1: Sherlockplay ($114.63 in chips) 
Seat 2: Harbinger X ($185.64 in chips) 
Seat 3: maxxmeister ($118.28 in chips) 
Seat 4: chaps1988 ($101.50 in chips) 
Seat 5: chautinhtri9 ($74 in chips) 
Seat 6: matiko09 ($126.43 in chips) 
Seat 7: PacPacBum ($114.49 in chips) 
Seat 8: RICKA16 ($107.96 in chips) 
Seat 9: Vlad_1965_77 ($103.21 in chips) 
maxxmeister: posts small blind $0.50
chaps1988: posts big blind $1
*** HOLE CARDS ***
Dealt to matiko09 [Ks 7d]
chautinhtri9: folds 
matiko09: folds 
PacPacBum: folds 
RICKA16: folds 
Vlad_1965_77: folds 
Sherlockplay: folds 
Harbinger X: folds 
maxxmeister: raises $2.50 to $3.50
chaps1988: folds 
Uncalled bet ($2.50) returned to maxxmeister
maxxmeister collected $2 from pot
maxxmeister: doesn't show hand 
*** SUMMARY ***
Total pot $2 | Rake $0 
Seat 1: Sherlockplay folded before Flop (didn't bet)
Seat 2: Harbinger X (button) folded before Flop (didn't bet)
Seat 3: maxxmeister (small blind) collected ($2)
Seat 4: chaps1988 (big blind) folded before Flop
Seat 5: chautinhtri9 folded before Flop (didn't bet)
Seat 6: matiko09 folded before Flop (didn't bet)
Seat 7: PacPacBum folded before Flop (didn't bet)
Seat 8: RICKA16 folded before Flop (didn't bet)
Seat 9: Vlad_1965_77 folded before Flop (didn't bet)





PokerStars Hand #150802088899:  Hold'em No Limit ($1/$2 USD) - 2016/03/23 14:48:23 CET [2016/03/23 9:48:23 ET]
Table 'Kypria II' 9-max Seat #7 is the button
Seat 1: geldwolfje ($150.05 in chips) 
Seat 3: seouljam ($227.42 in chips) 
Seat 4: VolanDog ($241.72 in chips) 
Seat 5: InsomniaRU ($316.34 in chips) 
Seat 6: matiko09 ($421.53 in chips) 
Seat 7: DUkalisUA ($200 in chips) 
Seat 8: nickreason17 ($200 in chips) 
nickreason17: posts small blind $1
Moszes360: is sitting out 
Moszes360 leaves the table
geldwolfje: posts big blind $2
coinflip_si: sits out 
*** HOLE CARDS ***
Dealt to matiko09 [9c Ad]
seouljam: folds 
VolanDog: folds 
InsomniaRU: folds 
matiko09: raises $3 to $5
DUkalisUA: folds 
nickreason17: folds 
geldwolfje: calls $3
*** FLOP *** [Th 2s 9s]
geldwolfje: checks 
sanrs57 joins the table at seat #9 
matiko09: checks 
*** TURN *** [Th 2s 9s] [Ks]
geldwolfje: bets $8
matiko09: folds 
Uncalled bet ($8) returned to geldwolfje
geldwolfje collected $10.50 from pot
geldwolfje: doesn't show hand 
*** SUMMARY ***
Total pot $11 | Rake $0.50 
Board [Th 2s 9s Ks]
Seat 1: geldwolfje (big blind) collected ($10.50)
Seat 3: seouljam folded before Flop (didn't bet)
Seat 4: VolanDog folded before Flop (didn't bet)
Seat 5: InsomniaRU folded before Flop (didn't bet)
Seat 6: matiko09 folded on the Turn
Seat 7: DUkalisUA (button) folded before Flop (didn't bet)
Seat 8: nickreason17 (small blind) folded before Flop





PokerStars Hand #150802091432:  Hold'em No Limit ($0.50/$1.00 USD) - 2016/03/23 14:48:27 CET [2016/03/23 9:48:27 ET]
Table 'Asmodeus' 9-max Seat #4 is the button
Seat 1: Jimy Tiltman ($104.80 in chips) 
Seat 2: $-Twackle-$ ($100 in chips) 
Seat 3: nickreason17 ($100 in chips) 
Seat 4: Effort92 ($104.76 in chips) 
Seat 5: chaps1988 ($100 in chips) 
Seat 6: florrin92 ($100 in chips) 
Seat 7: PacPacBum ($110.23 in chips) 
Seat 8: KEBIN1974 ($164.90 in chips) 
Seat 9: matiko09 ($100 in chips) 
chaps1988: posts small blind $0.50
florrin92: posts big blind $1
Jimy Tiltman: posts the ante $0.20
$-Twackle-$: posts the ante $0.20
nickreason17: posts the ante $0.20
Effort92: posts the ante $0.20
chaps1988: posts the ante $0.20
florrin92: posts the ante $0.20
PacPacBum: posts the ante $0.20
KEBIN1974: posts the ante $0.20
matiko09: posts the ante $0.20
*** HOLE CARDS ***
Dealt to matiko09 [Kh Jd]
PacPacBum: folds 
KEBIN1974: folds 
matiko09: folds 
Jimy Tiltman: folds 
$-Twackle-$: raises $2 to $3
nickreason17: raises $6 to $9
Effort92: folds 
chaps1988: folds 
florrin92: folds 
$-Twackle-$: folds 
Uncalled bet ($6) returned to nickreason17
nickreason17 collected $9.30 from pot
*** SUMMARY ***
Total pot $9.30 | Rake $0 
Seat 1: Jimy Tiltman folded before Flop (didn't bet)
Seat 2: $-Twackle-$ folded before Flop
Seat 3: nickreason17 collected ($9.30)
Seat 4: Effort92 (button) folded before Flop (didn't bet)
Seat 5: chaps1988 (small blind) folded before Flop
Seat 6: florrin92 (big blind) folded before Flop
Seat 7: PacPacBum folded before Flop (didn't bet)
Seat 8: KEBIN1974 folded before Flop (didn't bet)
Seat 9: matiko09 folded before Flop (didn't bet)





PokerStars Hand #150802092890:  Hold'em No Limit ($0.50/$1.00 USD) - 2016/03/23 14:48:29 CET [2016/03/23 9:48:29 ET]
Table 'Swings' 9-max Seat #3 is the button
Seat 1: Sherlockplay ($114.63 in chips) 
Seat 2: Harbinger X ($185.64 in chips) 
Seat 3: maxxmeister ($119.28 in chips) 
Seat 4: chaps1988 ($100.50 in chips) 
Seat 5: chautinhtri9 ($74 in chips) 
Seat 6: matiko09 ($126.43 in chips) 
Seat 7: PacPacBum ($114.49 in chips) 
Seat 8: RICKA16 ($107.96 in chips) 
Seat 9: Vlad_1965_77 ($103.21 in chips) 
chaps1988: posts small blind $0.50
chautinhtri9: posts big blind $1
*** HOLE CARDS ***
Dealt to matiko09 [4d 9c]
matiko09: folds 
PacPacBum: folds 
RICKA16: folds 
Vlad_1965_77: raises $2.50 to $3.50
Sherlockplay: folds 
Harbinger X: folds 
maxxmeister: folds 
chaps1988: folds 
chautinhtri9: folds 
Uncalled bet ($2.50) returned to Vlad_1965_77
Vlad_1965_77 collected $2.50 from pot
*** SUMMARY ***
Total pot $2.50 | Rake $0 
Seat 1: Sherlockplay folded before Flop (didn't bet)
Seat 2: Harbinger X folded before Flop (didn't bet)
Seat 3: maxxmeister (button) folded before Flop (didn't bet)
Seat 4: chaps1988 (small blind) folded before Flop
Seat 5: chautinhtri9 (big blind) folded before Flop
Seat 6: matiko09 folded before Flop (didn't bet)
Seat 7: PacPacBum folded before Flop (didn't bet)
Seat 8: RICKA16 folded before Flop (didn't bet)
Seat 9: Vlad_1965_77 collected ($2.50)





PokerStars Hand #150802094339:  Hold'em No Limit ($1/$2 USD) - 2016/03/23 14:48:32 CET [2016/03/23 9:48:32 ET]
Table 'Kiess' 9-max Seat #7 is the button
Seat 1: Cirilico ($209.22 in chips) 
Seat 2: DUkalisUA ($678.34 in chips) 
Seat 3: The_red_area ($328.46 in chips) 
Seat 4: Moszes360 ($212.14 in chips) 
Seat 5: chippo boy ($456.88 in chips) 
Seat 6: matiko09 ($260.86 in chips) 
Seat 7: InsomniaRU ($331.21 in chips) 
Seat 8: erfk1958 ($76.96 in chips) 
Seat 9: T0ny Adams ($103.46 in chips) 
erfk1958: posts small blind $1
T0ny Adams: posts big blind $2
*** HOLE CARDS ***
Dealt to matiko09 [8s 5d]
Cirilico: folds 
DUkalisUA: raises $4 to $6
The_red_area: folds 
Moszes360: folds 
chippo boy: calls $6
matiko09: folds 
InsomniaRU: folds 
erfk1958: folds 
T0ny Adams: folds 
*** FLOP *** [3h 4h 3c]
DUkalisUA: bets $10.74
chippo boy: calls $10.74
*** TURN *** [3h 4h 3c] [7s]
DUkalisUA: checks 
chippo boy: bets $16
DUkalisUA: calls $16
*** RIVER *** [3h 4h 3c 7s] [9d]
DUkalisUA: bets $42
chippo boy: folds 
Uncalled bet ($42) returned to DUkalisUA
DUkalisUA collected $65.68 from pot
DUkalisUA: doesn't show hand 
*** SUMMARY ***
Total pot $68.48 | Rake $2.80 
Board [3h 4h 3c 7s 9d]
Seat 1: Cirilico folded before Flop (didn't bet)
Seat 2: DUkalisUA collected ($65.68)
Seat 3: The_red_area folded before Flop (didn't bet)
Seat 4: Moszes360 folded before Flop (didn't bet)
Seat 5: chippo boy folded on the River
Seat 6: matiko09 folded before Flop (didn't bet)
Seat 7: InsomniaRU (button) folded before Flop (didn't bet)
Seat 8: erfk1958 (small blind) folded before Flop
Seat 9: T0ny Adams (big blind) folded before Flop





PokerStars Hand #150802099098:  Hold'em No Limit ($0.50/$1.00 USD) - 2016/03/23 14:48:39 CET [2016/03/23 9:48:39 ET]
Table 'Merope II' 9-max Seat #1 is the button
Seat 1: Jimy Tiltman ($134.49 in chips) 
Seat 2: $-Twackle-$ ($101.87 in chips) 
Seat 3: pablos1922 ($93.81 in chips) 
Seat 4: YuriiSolodya ($85.84 in chips) 
Seat 6: Effort92 ($101.21 in chips) 
Seat 7: matiko09 ($105.03 in chips) 
Seat 8: Red4erT ($40 in chips) 
Seat 9: RICKA16 ($117.56 in chips) 
$-Twackle-$: posts small blind $0.50
pablos1922: posts big blind $1
Butcher1848: sits out 
*** HOLE CARDS ***
Dealt to matiko09 [4s Ac]
YuriiSolodya: raises $1 to $2
Effort92: folds 
matiko09: folds 
Red4erT: folds 
RICKA16: calls $2
Jimy Tiltman: folds 
$-Twackle-$: calls $1.50
pablos1922: folds 
*** FLOP *** [2s 8s 7s]
$-Twackle-$: checks 
YuriiSolodya: checks 
RICKA16: bets $5
$-Twackle-$: folds 
YuriiSolodya: folds 
Uncalled bet ($5) returned to RICKA16
RICKA16 collected $6.68 from pot
RICKA16: doesn't show hand 
Butcher1848 leaves the table
*** SUMMARY ***
Total pot $7 | Rake $0.32 
Board [2s 8s 7s]
Seat 1: Jimy Tiltman (button) folded before Flop (didn't bet)
Seat 2: $-Twackle-$ (small blind) folded on the Flop
Seat 3: pablos1922 (big blind) folded before Flop
Seat 4: YuriiSolodya folded on the Flop
Seat 6: Effort92 folded before Flop (didn't bet)
Seat 7: matiko09 folded before Flop (didn't bet)
Seat 8: Red4erT folded before Flop (didn't bet)
Seat 9: RICKA16 collected ($6.68)





PokerStars Hand #150802100972:  Hold'em No Limit ($0.50/$1.00 USD) - 2016/03/23 14:48:42 CET [2016/03/23 9:48:42 ET]
Table 'Donar II' 9-max Seat #4 is the button
Seat 1: Effort92 ($124.61 in chips) 
Seat 4: DUkalisUA ($159.04 in chips) 
Seat 5: matiko09 ($129.44 in chips) 
Seat 7: JimineyCrik ($181.91 in chips) 
Seat 8: $-Twackle-$ ($119 in chips) 
matiko09: posts small blind $0.50
JimineyCrik: posts big blind $1
Effort92: posts the ante $0.20
DUkalisUA: posts the ante $0.20
matiko09: posts the ante $0.20
JimineyCrik: posts the ante $0.20
$-Twackle-$: posts the ante $0.20
*** HOLE CARDS ***
Dealt to matiko09 [Ts Qc]
$-Twackle-$: folds 
Effort92: folds 
nobrunobru1 leaves the table
nickreason17 joins the table at seat #9 
chaps1988 joins the table at seat #2 
DUkalisUA has timed out
DUkalisUA: folds 
matiko09: raises $2 to $3
JimineyCrik: folds 
Uncalled bet ($2) returned to matiko09
matiko09 collected $3 from pot
matiko09: doesn't show hand 
*** SUMMARY ***
Total pot $3 | Rake $0 
Seat 1: Effort92 folded before Flop (didn't bet)
Seat 4: DUkalisUA (button) folded before Flop (didn't bet)
Seat 5: matiko09 (small blind) collected ($3)
Seat 7: JimineyCrik (big blind) folded before Flop
Seat 8: $-Twackle-$ folded before Flop (didn't bet)





PokerStars Hand #150802108736:  Hold'em No Limit ($0.50/$1.00 USD) - 2016/03/23 14:48:55 CET [2016/03/23 9:48:55 ET]
Table 'Atlantis' 9-max Seat #3 is the button
Seat 1: xHourglass ($131.50 in chips) 
Seat 2: Szevasztopol ($107.78 in chips) 
Seat 3: CAJUN890 ($140.84 in chips) 
Seat 4: matiko09 ($143.11 in chips) 
Seat 5: Pvsx. ($108.56 in chips) 
Seat 6: Jimy Tiltman ($100 in chips) 
Seat 7: Sherlockplay ($141.48 in chips) 
Seat 8: DUkalisUA ($136.80 in chips) 
Seat 9: RICKA16 ($102.16 in chips) 
matiko09: posts small blind $0.50
Pvsx.: posts big blind $1
*** HOLE CARDS ***
Dealt to matiko09 [3h 4d]
Jimy Tiltman: folds 
Sherlockplay: raises $1.50 to $2.50
DUkalisUA: folds 
RICKA16: folds 
xHourglass: folds 
Szevasztopol: folds 
CAJUN890: folds 
matiko09: folds 
Pvsx.: folds 
Uncalled bet ($1.50) returned to Sherlockplay
Sherlockplay collected $2.50 from pot
Sherlockplay: doesn't show hand 
*** SUMMARY ***
Total pot $2.50 | Rake $0 
Seat 1: xHourglass folded before Flop (didn't bet)
Seat 2: Szevasztopol folded before Flop (didn't bet)
Seat 3: CAJUN890 (button) folded before Flop (didn't bet)
Seat 4: matiko09 (small blind) folded before Flop
Seat 5: Pvsx. (big blind) folded before Flop
Seat 6: Jimy Tiltman folded before Flop (didn't bet)
Seat 7: Sherlockplay collected ($2.50)
Seat 8: DUkalisUA folded before Flop (didn't bet)
Seat 9: RICKA16 folded before Flop (didn't bet)





PokerStars Hand #150802110574:  Hold'em No Limit ($0.50/$1.00 USD) - 2016/03/23 14:48:58 CET [2016/03/23 9:48:58 ET]
Table 'Swings' 9-max Seat #4 is the button
Seat 1: Sherlockplay ($114.63 in chips) 
Seat 2: Harbinger X ($185.64 in chips) 
Seat 3: maxxmeister ($119.28 in chips) 
Seat 4: chaps1988 ($100 in chips) 
Seat 5: chautinhtri9 ($73 in chips) 
Seat 6: matiko09 ($126.43 in chips) 
Seat 7: PacPacBum ($114.49 in chips) 
Seat 8: RICKA16 ($107.96 in chips) 
Seat 9: Vlad_1965_77 ($104.71 in chips) 
chautinhtri9: posts small blind $0.50
matiko09: posts big blind $1
*** HOLE CARDS ***
Dealt to matiko09 [3s Kc]
PacPacBum: folds 
RICKA16: folds 
Vlad_1965_77: raises $2 to $3
Sherlockplay: folds 
Harbinger X: folds 
maxxmeister: folds 
chaps1988: folds 
chautinhtri9: folds 
matiko09: folds 
Uncalled bet ($2) returned to Vlad_1965_77
Vlad_1965_77 collected $2.50 from pot
*** SUMMARY ***
Total pot $2.50 | Rake $0 
Seat 1: Sherlockplay folded before Flop (didn't bet)
Seat 2: Harbinger X folded before Flop (didn't bet)
Seat 3: maxxmeister folded before Flop (didn't bet)
Seat 4: chaps1988 (button) folded before Flop (didn't bet)
Seat 5: chautinhtri9 (small blind) folded before Flop
Seat 6: matiko09 (big blind) folded before Flop
Seat 7: PacPacBum folded before Flop (didn't bet)
Seat 8: RICKA16 folded before Flop (didn't bet)
Seat 9: Vlad_1965_77 collected ($2.50)





PokerStars Hand #150802112324:  Hold'em No Limit ($1/$2 USD) - 2016/03/23 14:49:01 CET [2016/03/23 9:49:01 ET]
Table 'Herba II' 9-max Seat #4 is the button
Seat 1: matiko09 ($238.68 in chips) 
Seat 2: Moszes360 ($200 in chips) 
Seat 3: Cirilico ($160 in chips) 
Seat 4: DUkalisUA ($200.20 in chips) 
Seat 5: chippo boy ($269.53 in chips) 
Seat 6: Too-Anti-To ($228.38 in chips) 
Seat 7: InsomniaRU ($408.70 in chips) 
Seat 8: The_red_area ($462.18 in chips) 
Seat 9: mrhighryza ($56.44 in chips) 
chippo boy: posts small blind $1
Too-Anti-To: posts big blind $2
*** HOLE CARDS ***
Dealt to matiko09 [6s Ks]
InsomniaRU: raises $3 to $5
The_red_area: folds 
mrhighryza: folds 
matiko09: folds 
Moszes360: folds 
Cirilico: folds 
DUkalisUA: folds 
chippo boy: folds 
Too-Anti-To: folds 
Uncalled bet ($3) returned to InsomniaRU
InsomniaRU collected $5 from pot
InsomniaRU: doesn't show hand 
*** SUMMARY ***
Total pot $5 | Rake $0 
Seat 1: matiko09 folded before Flop (didn't bet)
Seat 2: Moszes360 folded before Flop (didn't bet)
Seat 3: Cirilico folded before Flop (didn't bet)
Seat 4: DUkalisUA (button) folded before Flop (didn't bet)
Seat 5: chippo boy (small blind) folded before Flop
Seat 6: Too-Anti-To (big blind) folded before Flop
Seat 7: InsomniaRU collected ($5)
Seat 8: The_red_area folded before Flop (didn't bet)
Seat 9: mrhighryza folded before Flop (didn't bet)





PokerStars Hand #150802116105:  Hold'em No Limit ($1/$2 USD) - 2016/03/23 14:49:07 CET [2016/03/23 9:49:07 ET]
Table 'Achaia' 9-max Seat #4 is the button
Seat 1: Moszes360 ($244.42 in chips) 
Seat 2: InsomniaRU ($225.94 in chips) 
Seat 3: matiko09 ($237.16 in chips) 
Seat 4: erfk1958 ($105 in chips) 
Seat 5: chaps1988 ($206.70 in chips) 
Seat 6: nickreason17 ($211.99 in chips) 
Seat 7: morosun ($268.13 in chips) 
Seat 8: $-Twackle-$ ($214.07 in chips) 
chaps1988: posts small blind $1
nickreason17: posts big blind $2
PacPacBum: sits out 
*** HOLE CARDS ***
Dealt to matiko09 [Jd 2h]
morosun: calls $2
$-Twackle-$: folds 
Moszes360: folds 
InsomniaRU: raises $3 to $5
matiko09: folds 
erfk1958: folds 
chaps1988: folds 
nickreason17: folds 
morosun: calls $3
*** FLOP *** [Qc 9c 9s]
morosun: checks 
InsomniaRU: checks 
*** TURN *** [Qc 9c 9s] [7h]
morosun: bets $2
InsomniaRU: raises $10.94 to $12.94
morosun: calls $10.94
*** RIVER *** [Qc 9c 9s 7h] [Ac]
morosun: checks 
InsomniaRU: checks 
*** SHOW DOWN ***
morosun: shows [Td Jc] (a pair of Nines)
InsomniaRU: shows [Qs Ks] (two pair, Queens and Nines)
InsomniaRU collected $37.13 from pot
*** SUMMARY ***
Total pot $38.88 | Rake $1.75 
Board [Qc 9c 9s 7h Ac]
Seat 1: Moszes360 folded before Flop (didn't bet)
Seat 2: InsomniaRU showed [Qs Ks] and won ($37.13) with two pair, Queens and Nines
Seat 3: matiko09 folded before Flop (didn't bet)
Seat 4: erfk1958 (button) folded before Flop (didn't bet)
Seat 5: chaps1988 (small blind) folded before Flop
Seat 6: nickreason17 (big blind) folded before Flop
Seat 7: morosun showed [Td Jc] and lost with a pair of Nines
Seat 8: $-Twackle-$ folded before Flop (didn't bet)





PokerStars Hand #150802117335:  Hold'em No Limit ($1/$2 USD) - 2016/03/23 14:49:09 CET [2016/03/23 9:49:09 ET]
Table 'Kypria II' 9-max Seat #8 is the button
Seat 1: geldwolfje ($155.55 in chips) 
Seat 2: coinflip_si ($205.70 in chips) 
Seat 3: seouljam ($227.42 in chips) 
Seat 4: VolanDog ($241.72 in chips) 
Seat 5: InsomniaRU ($316.34 in chips) 
Seat 6: matiko09 ($416.53 in chips) 
Seat 7: DUkalisUA ($200 in chips) 
Seat 8: nickreason17 ($200 in chips) 
sanrs57 will be allowed to play after the button
geldwolfje: posts small blind $1
coinflip_si: posts big blind $2
*** HOLE CARDS ***
Dealt to matiko09 [9h 5d]
seouljam: raises $2.90 to $4.90
VolanDog: folds 
InsomniaRU: calls $4.90
matiko09: folds 
DUkalisUA: folds 
nickreason17: calls $4.90
geldwolfje: calls $3.90
coinflip_si: calls $2.90
*** FLOP *** [Js 2s Kh]
geldwolfje: checks 
coinflip_si: checks 
seouljam: checks 
InsomniaRU: checks 
nickreason17: checks 
*** TURN *** [Js 2s Kh] [Qh]
geldwolfje: checks 
coinflip_si: checks 
seouljam: checks 
InsomniaRU: bets $15.68
nickreason17: calls $15.68
geldwolfje: folds 
coinflip_si: calls $15.68
seouljam: folds 
*** RIVER *** [Js 2s Kh Qh] [4h]
coinflip_si: checks 
InsomniaRU: checks 
nickreason17: checks 
*** SHOW DOWN ***
coinflip_si: shows [Ts 8s] (high card King)
InsomniaRU: shows [Jd Qd] (two pair, Queens and Jacks)
nickreason17: mucks hand 
InsomniaRU collected $68.74 from pot
*** SUMMARY ***
Total pot $71.54 | Rake $2.80 
Board [Js 2s Kh Qh 4h]
Seat 1: geldwolfje (small blind) folded on the Turn
Seat 2: coinflip_si (big blind) showed [Ts 8s] and lost with high card King
Seat 3: seouljam folded on the Turn
Seat 4: VolanDog folded before Flop (didn't bet)
Seat 5: InsomniaRU showed [Jd Qd] and won ($68.74) with two pair, Queens and Jacks
Seat 6: matiko09 folded before Flop (didn't bet)
Seat 7: DUkalisUA folded before Flop (didn't bet)
Seat 8: nickreason17 (button) mucked [5s 4s]





PokerStars Hand #150802123437:  Hold'em No Limit ($0.50/$1.00 USD) - 2016/03/23 14:49:18 CET [2016/03/23 9:49:18 ET]
Table 'Asmodeus' 9-max Seat #5 is the button
Seat 1: Jimy Tiltman ($104.60 in chips) 
Seat 2: $-Twackle-$ ($100 in chips) 
Seat 3: nickreason17 ($106.10 in chips) 
Seat 4: Effort92 ($104.56 in chips) 
Seat 5: chaps1988 ($100 in chips) 
Seat 6: florrin92 ($100 in chips) 
Seat 8: KEBIN1974 ($164.70 in chips) 
Seat 9: matiko09 ($100 in chips) 
florrin92: posts small blind $0.50
PacPacBum: is sitting out 
KEBIN1974: posts big blind $1
Jimy Tiltman: posts the ante $0.20
$-Twackle-$: posts the ante $0.20
nickreason17: posts the ante $0.20
Effort92: posts the ante $0.20
chaps1988: posts the ante $0.20
florrin92: posts the ante $0.20
KEBIN1974: posts the ante $0.20
matiko09: posts the ante $0.20
*** HOLE CARDS ***
Dealt to matiko09 [Qh 7d]
matiko09: folds 
PacPacBum leaves the table
Jimy Tiltman: folds 
$-Twackle-$: folds 
nickreason17: folds 
Effort92: folds 
chaps1988: raises $1 to $2
florrin92: folds 
KEBIN1974: calls $1
*** FLOP *** [5h Th Td]
KEBIN1974: checks 
chaps1988: bets $3
KEBIN1974: folds 
Uncalled bet ($3) returned to chaps1988
chaps1988 collected $5.83 from pot
chaps1988: doesn't show hand 
*** SUMMARY ***
Total pot $6.10 | Rake $0.27 
Board [5h Th Td]
Seat 1: Jimy Tiltman folded before Flop (didn't bet)
Seat 2: $-Twackle-$ folded before Flop (didn't bet)
Seat 3: nickreason17 folded before Flop (didn't bet)
Seat 4: Effort92 folded before Flop (didn't bet)
Seat 5: chaps1988 (button) collected ($5.83)
Seat 6: florrin92 (small blind) folded before Flop
Seat 8: KEBIN1974 (big blind) folded on the Flop
Seat 9: matiko09 folded before Flop (didn't bet)





PokerStars Hand #150802123052:  Hold'em No Limit ($0.50/$1.00 USD) - 2016/03/23 14:49:18 CET [2016/03/23 9:49:18 ET]
Table 'Swings' 9-max Seat #5 is the button
Seat 1: Sherlockplay ($114.63 in chips) 
Seat 2: Harbinger X ($185.64 in chips) 
Seat 3: maxxmeister ($119.28 in chips) 
Seat 4: chaps1988 ($100 in chips) 
Seat 5: chautinhtri9 ($72.50 in chips) 
Seat 6: matiko09 ($125.43 in chips) 
Seat 7: PacPacBum ($114.49 in chips) 
Seat 8: RICKA16 ($107.96 in chips) 
Seat 9: Vlad_1965_77 ($106.21 in chips) 
matiko09: posts small blind $0.50
PacPacBum: posts big blind $1
*** HOLE CARDS ***
Dealt to matiko09 [7c 8c]
RICKA16: folds 
Vlad_1965_77: raises $2 to $3
Sherlockplay: folds 
Harbinger X: folds 
maxxmeister: folds 
chaps1988: folds 
chautinhtri9: calls $3
matiko09: folds 
PacPacBum: folds 
*** FLOP *** [Qd 2s Ad]
Vlad_1965_77: bets $3.58
chautinhtri9: calls $3.58
*** TURN *** [Qd 2s Ad] [6h]
Vlad_1965_77: bets $14
chautinhtri9: folds 
Uncalled bet ($14) returned to Vlad_1965_77
Vlad_1965_77 collected $14 from pot
*** SUMMARY ***
Total pot $14.66 | Rake $0.66 
Board [Qd 2s Ad 6h]
Seat 1: Sherlockplay folded before Flop (didn't bet)
Seat 2: Harbinger X folded before Flop (didn't bet)
Seat 3: maxxmeister folded before Flop (didn't bet)
Seat 4: chaps1988 folded before Flop (didn't bet)
Seat 5: chautinhtri9 (button) folded on the Turn
Seat 6: matiko09 (small blind) folded before Flop
Seat 7: PacPacBum (big blind) folded before Flop
Seat 8: RICKA16 folded before Flop (didn't bet)
Seat 9: Vlad_1965_77 collected ($14)





PokerStars Hand #150802125764:  Hold'em No Limit ($0.50/$1.00 USD) - 2016/03/23 14:49:22 CET [2016/03/23 9:49:22 ET]
Table 'Donar II' 9-max Seat #5 is the button
Seat 1: Effort92 ($124.41 in chips) 
Seat 5: matiko09 ($131.24 in chips) 
Seat 7: JimineyCrik ($180.71 in chips) 
Seat 8: $-Twackle-$ ($118.80 in chips) 
JimineyCrik: posts small blind $0.50
$-Twackle-$: posts big blind $1
nickreason17: sits out 
chaps1988: sits out 
Effort92: posts the ante $0.20
matiko09: posts the ante $0.20
JimineyCrik: posts the ante $0.20
$-Twackle-$: posts the ante $0.20
*** HOLE CARDS ***
Dealt to matiko09 [3c Jh]
Effort92: folds 
matiko09: folds 
JimineyCrik: folds 
Uncalled bet ($0.50) returned to $-Twackle-$
$-Twackle-$ collected $1.80 from pot
$-Twackle-$: doesn't show hand 
*** SUMMARY ***
Total pot $1.80 | Rake $0 
Seat 1: Effort92 folded before Flop (didn't bet)
Seat 5: matiko09 (button) folded before Flop (didn't bet)
Seat 7: JimineyCrik (small blind) folded before Flop
Seat 8: $-Twackle-$ (big blind) collected ($1.80)





PokerStars Hand #150802131032:  Hold'em No Limit ($0.50/$1.00 USD) - 2016/03/23 14:49:31 CET [2016/03/23 9:49:31 ET]
Table 'Atlantis' 9-max Seat #4 is the button
Seat 1: xHourglass ($131.50 in chips) 
Seat 2: Szevasztopol ($107.78 in chips) 
Seat 3: CAJUN890 ($140.84 in chips) 
Seat 4: matiko09 ($142.61 in chips) 
Seat 5: Pvsx. ($107.56 in chips) 
Seat 7: Sherlockplay ($142.98 in chips) 
Seat 8: DUkalisUA ($136.80 in chips) 
Seat 9: RICKA16 ($102.16 in chips) 
Pvsx.: posts small blind $0.50
Jimy Tiltman: is sitting out 
Sherlockplay: posts big blind $1
*** HOLE CARDS ***
Dealt to matiko09 [7s 8s]
Jimy Tiltman leaves the table
DUkalisUA: folds 
nickreason17 joins the table at seat #6 
RICKA16: raises $2 to $3
nickreason17 leaves the table
xHourglass: raises $6 to $9
Szevasztopol: folds 
CAJUN890: folds 
matiko09: folds 
Pvsx.: folds 
Sherlockplay: folds 
RICKA16: folds 
Uncalled bet ($6) returned to xHourglass
xHourglass collected $7.50 from pot
xHourglass: doesn't show hand 
*** SUMMARY ***
Total pot $7.50 | Rake $0 
Seat 1: xHourglass collected ($7.50)
Seat 2: Szevasztopol folded before Flop (didn't bet)
Seat 3: CAJUN890 folded before Flop (didn't bet)
Seat 4: matiko09 (button) folded before Flop (didn't bet)
Seat 5: Pvsx. (small blind) folded before Flop
Seat 7: Sherlockplay (big blind) folded before Flop
Seat 8: DUkalisUA folded before Flop (didn't bet)
Seat 9: RICKA16 folded before Flop





PokerStars Hand #150802132525:  Hold'em No Limit ($0.50/$1.00 USD) - 2016/03/23 14:49:33 CET [2016/03/23 9:49:33 ET]
Table 'Merope II' 9-max Seat #2 is the button
Seat 1: Jimy Tiltman ($134.49 in chips) 
Seat 2: $-Twackle-$ ($100 in chips) 
Seat 3: pablos1922 ($92.81 in chips) 
Seat 4: YuriiSolodya ($83.84 in chips) 
Seat 6: Effort92 ($101.21 in chips) 
Seat 7: matiko09 ($105.03 in chips) 
Seat 8: Red4erT ($40 in chips) 
Seat 9: RICKA16 ($122.24 in chips) 
pablos1922: posts small blind $0.50
YuriiSolodya: posts big blind $1
*** HOLE CARDS ***
Dealt to matiko09 [2c Ks]
Effort92: folds 
matiko09: folds 
Red4erT: folds 
RICKA16: folds 
Jimy Tiltman: folds 
nickreason17 joins the table at seat #5 
nickreason17 leaves the table
chaps1988 joins the table at seat #5 
$-Twackle-$: folds 
pablos1922: folds 
Uncalled bet ($0.50) returned to YuriiSolodya
YuriiSolodya collected $1 from pot
YuriiSolodya: doesn't show hand 
*** SUMMARY ***
Total pot $1 | Rake $0 
Seat 1: Jimy Tiltman folded before Flop (didn't bet)
Seat 2: $-Twackle-$ (button) folded before Flop (didn't bet)
Seat 3: pablos1922 (small blind) folded before Flop
Seat 4: YuriiSolodya (big blind) collected ($1)
Seat 6: Effort92 folded before Flop (didn't bet)
Seat 7: matiko09 folded before Flop (didn't bet)
Seat 8: Red4erT folded before Flop (didn't bet)
Seat 9: RICKA16 folded before Flop (didn't bet)





PokerStars Hand #150802134801:  Hold'em No Limit ($0.50/$1.00 USD) - 2016/03/23 14:49:37 CET [2016/03/23 9:49:37 ET]
Table 'Donar II' 9-max Seat #7 is the button
Seat 1: Effort92 ($124.21 in chips) 
Seat 4: DUkalisUA ($158.84 in chips) 
Seat 5: matiko09 ($131.04 in chips) 
Seat 7: JimineyCrik ($180.01 in chips) 
Seat 8: $-Twackle-$ ($119.90 in chips) 
Seat 9: nickreason17 ($100 in chips) 
$-Twackle-$: posts small blind $0.50
nickreason17: posts big blind $1
chaps1988: sits out 
Effort92: posts the ante $0.20
DUkalisUA: posts the ante $0.20
matiko09: posts the ante $0.20
JimineyCrik: posts the ante $0.20
$-Twackle-$: posts the ante $0.20
nickreason17: posts the ante $0.20
*** HOLE CARDS ***
Dealt to matiko09 [9s Qh]
Effort92: folds 
DUkalisUA: folds 
matiko09: folds 
JimineyCrik: folds 
$-Twackle-$: folds 
Uncalled bet ($0.50) returned to nickreason17
nickreason17 collected $2.20 from pot
*** SUMMARY ***
Total pot $2.20 | Rake $0 
Seat 1: Effort92 folded before Flop (didn't bet)
Seat 4: DUkalisUA folded before Flop (didn't bet)
Seat 5: matiko09 folded before Flop (didn't bet)
Seat 7: JimineyCrik (button) folded before Flop (didn't bet)
Seat 8: $-Twackle-$ (small blind) folded before Flop
Seat 9: nickreason17 (big blind) collected ($2.20)





PokerStars Hand #150802136113:  Hold'em No Limit ($0.25/$0.50 USD) - 2016/03/23 14:49:39 CET [2016/03/23 9:49:39 ET]
Table 'Pyrrhus' 9-max Seat #5 is the button
Seat 2: BSTUSim ($67.37 in chips) 
Seat 3: i L00K great ($50 in chips) 
Seat 4: GriffinBerg ($43.66 in chips) 
Seat 5: ZonTTT ($52.86 in chips) 
Seat 6: Ahangama ($50.25 in chips) 
Seat 7: matiko09 ($140.25 in chips) 
Seat 8: dndngod ($78.43 in chips) 
Seat 9: CvMCvMCvM ($90.88 in chips) 
Ahangama: posts small blind $0.25
matiko09: posts big blind $0.50
lumen21: sits out 
*** HOLE CARDS ***
Dealt to matiko09 [2d 5c]
dndngod: raises $1 to $1.50
CvMCvMCvM: folds 
BSTUSim: folds 
i L00K great: folds 
GriffinBerg: folds 
ZonTTT: folds 
Ahangama: folds 
matiko09: folds 
Uncalled bet ($1) returned to dndngod
dndngod collected $1.25 from pot
dndngod: doesn't show hand 
*** SUMMARY ***
Total pot $1.25 | Rake $0 
Seat 2: BSTUSim folded before Flop (didn't bet)
Seat 3: i L00K great folded before Flop (didn't bet)
Seat 4: GriffinBerg folded before Flop (didn't bet)
Seat 5: ZonTTT (button) folded before Flop (didn't bet)
Seat 6: Ahangama (small blind) folded before Flop
Seat 7: matiko09 (big blind) folded before Flop
Seat 8: dndngod collected ($1.25)
Seat 9: CvMCvMCvM folded before Flop (didn't bet)





PokerStars Hand #150802139251:  Hold'em No Limit ($1/$2 USD) - 2016/03/23 14:49:44 CET [2016/03/23 9:49:44 ET]
Table 'Herba II' 9-max Seat #5 is the button
Seat 1: matiko09 ($238.68 in chips) 
Seat 2: Moszes360 ($200 in chips) 
Seat 3: Cirilico ($160 in chips) 
Seat 4: DUkalisUA ($200.20 in chips) 
Seat 5: chippo boy ($268.53 in chips) 
Seat 6: Too-Anti-To ($226.38 in chips) 
Seat 7: InsomniaRU ($411.70 in chips) 
Seat 8: The_red_area ($462.18 in chips) 
Seat 9: mrhighryza ($56.44 in chips) 
Too-Anti-To: posts small blind $1
InsomniaRU: posts big blind $2
*** HOLE CARDS ***
Dealt to matiko09 [8s 7h]
The_red_area: folds 
The_red_area leaves the table
mrhighryza: folds 
matiko09: folds 
Moszes360: raises $4 to $6
Cirilico: folds 
DUkalisUA: calls $6
chippo boy: folds 
Too-Anti-To: folds 
InsomniaRU: folds 
*** FLOP *** [6c 7s 4c]
T0ny Adams joins the table at seat #8 
Moszes360: checks 
DUkalisUA: bets $10.74
Moszes360: raises $19.26 to $30
DUkalisUA: raises $164.20 to $194.20 and is all-in
Moszes360: calls $164 and is all-in
Uncalled bet ($0.20) returned to DUkalisUA
*** TURN *** [6c 7s 4c] [2d]
*** RIVER *** [6c 7s 4c 2d] [Qs]
*** SHOW DOWN ***
Moszes360: shows [4d 4h] (three of a kind, Fours)
DUkalisUA: shows [6h 6s] (three of a kind, Sixes)
DUkalisUA collected $400.20 from pot
*** SUMMARY ***
Total pot $403 | Rake $2.80 
Board [6c 7s 4c 2d Qs]
Seat 1: matiko09 folded before Flop (didn't bet)
Seat 2: Moszes360 showed [4d 4h] and lost with three of a kind, Fours
Seat 3: Cirilico folded before Flop (didn't bet)
Seat 4: DUkalisUA showed [6h 6s] and won ($400.20) with three of a kind, Sixes
Seat 5: chippo boy (button) folded before Flop (didn't bet)
Seat 6: Too-Anti-To (small blind) folded before Flop
Seat 7: InsomniaRU (big blind) folded before Flop
Seat 8: The_red_area folded before Flop (didn't bet)
Seat 9: mrhighryza folded before Flop (didn't bet)





PokerStars Hand #150802143906:  Hold'em No Limit ($0.50/$1.00 USD) - 2016/03/23 14:49:51 CET [2016/03/23 9:49:51 ET]
Table 'Donar II' 9-max Seat #8 is the button
Seat 1: Effort92 ($124.01 in chips) 
Seat 4: DUkalisUA ($158.64 in chips) 
Seat 5: matiko09 ($130.84 in chips) 
Seat 7: JimineyCrik ($179.81 in chips) 
Seat 8: $-Twackle-$ ($119.20 in chips) 
Seat 9: nickreason17 ($101.50 in chips) 
nickreason17: posts small blind $0.50
Effort92: posts big blind $1
chaps1988: sits out 
Effort92: posts the ante $0.20
DUkalisUA: posts the ante $0.20
matiko09: posts the ante $0.20
JimineyCrik: posts the ante $0.20
$-Twackle-$: posts the ante $0.20
nickreason17: posts the ante $0.20
*** HOLE CARDS ***
Dealt to matiko09 [2h Qh]
DUkalisUA: folds 
matiko09: folds 
JimineyCrik: raises $1.40 to $2.40
$-Twackle-$: folds 
nickreason17: folds 
Effort92: calls $1.40
*** FLOP *** [Qs 6h 3s]
Effort92: checks 
JimineyCrik: bets $3.16
Effort92: folds 
Uncalled bet ($3.16) returned to JimineyCrik
JimineyCrik collected $6.21 from pot
JimineyCrik: doesn't show hand 
*** SUMMARY ***
Total pot $6.50 | Rake $0.29 
Board [Qs 6h 3s]
Seat 1: Effort92 (big blind) folded on the Flop
Seat 4: DUkalisUA folded before Flop (didn't bet)
Seat 5: matiko09 folded before Flop (didn't bet)
Seat 7: JimineyCrik collected ($6.21)
Seat 8: $-Twackle-$ (button) folded before Flop (didn't bet)
Seat 9: nickreason17 (small blind) folded before Flop





PokerStars Hand #150802144147:  Hold'em No Limit ($1/$2 USD) - 2016/03/23 14:49:52 CET [2016/03/23 9:49:52 ET]
Table 'Kiess' 9-max Seat #8 is the button
Seat 2: DUkalisUA ($711.28 in chips) 
Seat 3: The_red_area ($328.46 in chips) 
Seat 4: Moszes360 ($212.14 in chips) 
Seat 5: chippo boy ($424.14 in chips) 
Seat 6: matiko09 ($260.86 in chips) 
Seat 7: InsomniaRU ($331.21 in chips) 
Seat 8: erfk1958 ($75.96 in chips) 
Seat 9: T0ny Adams ($101.46 in chips) 
T0ny Adams: posts small blind $1
Cirilico: is sitting out 
DUkalisUA: posts big blind $2
*** HOLE CARDS ***
Dealt to matiko09 [2d 3c]
The_red_area: folds 
Moszes360: folds 
chippo boy: folds 
The_red_area leaves the table
matiko09: folds 
InsomniaRU: folds 
erfk1958: raises $2 to $4
T0ny Adams: raises $8 to $12
DUkalisUA: folds 
erfk1958: calls $8
*** FLOP *** [9d 8d Ts]
T0ny Adams: bets $18.50
erfk1958: raises $45.46 to $63.96 and is all-in
Red4erT joins the table at seat #3 
T0ny Adams: calls $45.46
*** FIRST TURN *** [9d 8d Ts] [9h]
*** FIRST RIVER *** [9d 8d Ts 9h] [2s]
*** SECOND TURN *** [9d 8d Ts] [Tc]
*** SECOND RIVER *** [9d 8d Ts Tc] [5h]
*** FIRST SHOW DOWN ***
T0ny Adams: shows [Kd Ks] (two pair, Kings and Nines)
erfk1958: shows [Jd Js] (two pair, Jacks and Nines)
T0ny Adams collected $75.56 from pot
*** SECOND SHOW DOWN ***
T0ny Adams: shows [Kd Ks] (two pair, Kings and Tens)
erfk1958: shows [Jd Js] (two pair, Jacks and Tens)
T0ny Adams collected $75.56 from pot
*** SUMMARY ***
Total pot $153.92 | Rake $2.80 
Hand was run twice
FIRST Board [9d 8d Ts 9h 2s]
SECOND Board [9d 8d Ts Tc 5h]
Seat 2: DUkalisUA (big blind) folded before Flop
Seat 3: The_red_area folded before Flop (didn't bet)
Seat 4: Moszes360 folded before Flop (didn't bet)
Seat 5: chippo boy folded before Flop (didn't bet)
Seat 6: matiko09 folded before Flop (didn't bet)
Seat 7: InsomniaRU folded before Flop (didn't bet)
Seat 8: erfk1958 (button) showed [Jd Js] and lost with two pair, Jacks and Nines, and lost with two pair, Jacks and Tens
Seat 9: T0ny Adams (small blind) showed [Kd Ks] and won ($75.56) with two pair, Kings and Nines, and won ($75.56) with two pair, Kings and Tens





PokerStars Hand #150802145538:  Hold'em No Limit ($1/$2 USD) - 2016/03/23 14:49:54 CET [2016/03/23 9:49:54 ET]
Table 'Achaia' 9-max Seat #5 is the button
Seat 1: Moszes360 ($244.42 in chips) 
Seat 2: InsomniaRU ($245.13 in chips) 
Seat 3: matiko09 ($237.16 in chips) 
Seat 4: erfk1958 ($105 in chips) 
Seat 5: chaps1988 ($205.70 in chips) 
Seat 6: nickreason17 ($209.99 in chips) 
Seat 7: morosun ($250.19 in chips) 
Seat 8: $-Twackle-$ ($214.07 in chips) 
nickreason17: posts small blind $1
morosun: posts big blind $2
PacPacBum: sits out 
*** HOLE CARDS ***
Dealt to matiko09 [8c Jc]
$-Twackle-$: folds 
Moszes360: folds 
InsomniaRU: folds 
matiko09: folds 
erfk1958: folds 
chaps1988: raises $2 to $4
nickreason17: folds 
morosun: calls $2
*** FLOP *** [3s 6d Qh]
morosun: bets $6
chaps1988: folds 
Uncalled bet ($6) returned to morosun
morosun collected $8.60 from pot
*** SUMMARY ***
Total pot $9 | Rake $0.40 
Board [3s 6d Qh]
Seat 1: Moszes360 folded before Flop (didn't bet)
Seat 2: InsomniaRU folded before Flop (didn't bet)
Seat 3: matiko09 folded before Flop (didn't bet)
Seat 4: erfk1958 folded before Flop (didn't bet)
Seat 5: chaps1988 (button) folded on the Flop
Seat 6: nickreason17 (small blind) folded before Flop
Seat 7: morosun (big blind) collected ($8.60)
Seat 8: $-Twackle-$ folded before Flop (didn't bet)





PokerStars Hand #150802148002:  Hold'em No Limit ($0.50/$1.00 USD) - 2016/03/23 14:49:58 CET [2016/03/23 9:49:58 ET]
Table 'Merope II' 9-max Seat #3 is the button
Seat 1: Jimy Tiltman ($134.49 in chips) 
Seat 2: $-Twackle-$ ($100 in chips) 
Seat 3: pablos1922 ($92.31 in chips) 
Seat 4: YuriiSolodya ($84.34 in chips) 
Seat 5: chaps1988 ($100 in chips) 
Seat 6: Effort92 ($101.21 in chips) 
Seat 7: matiko09 ($105.03 in chips) 
Seat 8: Red4erT ($40 in chips) 
Seat 9: RICKA16 ($122.24 in chips) 
YuriiSolodya: posts small blind $0.50
chaps1988: posts big blind $1
*** HOLE CARDS ***
Dealt to matiko09 [Ks 2h]
Effort92: folds 
matiko09: folds 
Red4erT: raises $1.50 to $2.50
RICKA16: folds 
Jimy Tiltman: folds 
$-Twackle-$: folds 
pablos1922 has timed out
pablos1922: folds 
YuriiSolodya: folds 
chaps1988: folds 
Uncalled bet ($1.50) returned to Red4erT
Red4erT collected $2.50 from pot
Red4erT: doesn't show hand 
*** SUMMARY ***
Total pot $2.50 | Rake $0 
Seat 1: Jimy Tiltman folded before Flop (didn't bet)
Seat 2: $-Twackle-$ folded before Flop (didn't bet)
Seat 3: pablos1922 (button) folded before Flop (didn't bet)
Seat 4: YuriiSolodya (small blind) folded before Flop
Seat 5: chaps1988 (big blind) folded before Flop
Seat 6: Effort92 folded before Flop (didn't bet)
Seat 7: matiko09 folded before Flop (didn't bet)
Seat 8: Red4erT collected ($2.50)
Seat 9: RICKA16 folded before Flop (didn't bet)





PokerStars Hand #150802149961:  Hold'em No Limit ($0.25/$0.50 USD) - 2016/03/23 14:50:01 CET [2016/03/23 9:50:01 ET]
Table 'Pyrrhus' 9-max Seat #6 is the button
Seat 2: BSTUSim ($67.37 in chips) 
Seat 3: i L00K great ($50 in chips) 
Seat 4: GriffinBerg ($43.66 in chips) 
Seat 5: ZonTTT ($52.86 in chips) 
Seat 6: Ahangama ($50 in chips) 
Seat 7: matiko09 ($139.75 in chips) 
Seat 8: dndngod ($79.18 in chips) 
Seat 9: CvMCvMCvM ($90.88 in chips) 
matiko09: posts small blind $0.25
dndngod: posts big blind $0.50
lumen21: sits out 
*** HOLE CARDS ***
Dealt to matiko09 [5h 4d]
CvMCvMCvM: folds 
BSTUSim: folds 
i L00K great: folds 
GriffinBerg: folds 
ZonTTT: folds 
Ahangama: raises $0.50 to $1
matiko09: folds 
dndngod: folds 
Uncalled bet ($0.50) returned to Ahangama
Ahangama collected $1.25 from pot
Ahangama: doesn't show hand 
*** SUMMARY ***
Total pot $1.25 | Rake $0 
Seat 2: BSTUSim folded before Flop (didn't bet)
Seat 3: i L00K great folded before Flop (didn't bet)
Seat 4: GriffinBerg folded before Flop (didn't bet)
Seat 5: ZonTTT folded before Flop (didn't bet)
Seat 6: Ahangama (button) collected ($1.25)
Seat 7: matiko09 (small blind) folded before Flop
Seat 8: dndngod (big blind) folded before Flop
Seat 9: CvMCvMCvM folded before Flop (didn't bet)





PokerStars Hand #150802157016:  Hold'em No Limit ($0.50/$1.00 USD) - 2016/03/23 14:50:13 CET [2016/03/23 9:50:13 ET]
Table 'Swings' 9-max Seat #6 is the button
Seat 1: Sherlockplay ($114.63 in chips) 
Seat 2: Harbinger X ($185.64 in chips) 
Seat 3: maxxmeister ($119.28 in chips) 
Seat 4: chaps1988 ($100 in chips) 
Seat 5: chautinhtri9 ($65.92 in chips) 
Seat 6: matiko09 ($124.93 in chips) 
Seat 7: PacPacBum ($113.49 in chips) 
Seat 8: RICKA16 ($107.96 in chips) 
Seat 9: Vlad_1965_77 ($113.63 in chips) 
PacPacBum: posts small blind $0.50
RICKA16: posts big blind $1
*** HOLE CARDS ***
Dealt to matiko09 [8s 6c]
Vlad_1965_77: raises $2 to $3
Sherlockplay: folds 
Harbinger X: folds 
maxxmeister: folds 
chaps1988: folds 
chautinhtri9: folds 
matiko09: folds 
PacPacBum: folds 
RICKA16: folds 
Uncalled bet ($2) returned to Vlad_1965_77
Vlad_1965_77 collected $2.50 from pot
*** SUMMARY ***
Total pot $2.50 | Rake $0 
Seat 1: Sherlockplay folded before Flop (didn't bet)
Seat 2: Harbinger X folded before Flop (didn't bet)
Seat 3: maxxmeister folded before Flop (didn't bet)
Seat 4: chaps1988 folded before Flop (didn't bet)
Seat 5: chautinhtri9 folded before Flop (didn't bet)
Seat 6: matiko09 (button) folded before Flop (didn't bet)
Seat 7: PacPacBum (small blind) folded before Flop
Seat 8: RICKA16 (big blind) folded before Flop
Seat 9: Vlad_1965_77 collected ($2.50)





PokerStars Hand #150802158056:  Hold'em No Limit ($0.50/$1.00 USD) - 2016/03/23 14:50:14 CET [2016/03/23 9:50:14 ET]
Table 'Atlantis' 9-max Seat #5 is the button
Seat 1: xHourglass ($136 in chips) 
Seat 2: Szevasztopol ($107.78 in chips) 
Seat 3: CAJUN890 ($140.84 in chips) 
Seat 4: matiko09 ($142.61 in chips) 
Seat 5: Pvsx. ($107.06 in chips) 
Seat 7: Sherlockplay ($141.98 in chips) 
Seat 8: DUkalisUA ($136.80 in chips) 
Seat 9: RICKA16 ($99.16 in chips) 
Sherlockplay: posts small blind $0.50
DUkalisUA: posts big blind $1
*** HOLE CARDS ***
Dealt to matiko09 [Qc Jh]
PacPacBum joins the table at seat #6 
RICKA16: raises $2 to $3
xHourglass: folds 
Szevasztopol: folds 
CAJUN890: folds 
matiko09: folds 
Pvsx.: calls $3
Sherlockplay: folds 
DUkalisUA: folds 
*** FLOP *** [3h 7h 6h]
RICKA16: checks 
Pvsx.: bets $3.58
RICKA16: folds 
Uncalled bet ($3.58) returned to Pvsx.
Pvsx. collected $7.16 from pot
Pvsx.: doesn't show hand 
*** SUMMARY ***
Total pot $7.50 | Rake $0.34 
Board [3h 7h 6h]
Seat 1: xHourglass folded before Flop (didn't bet)
Seat 2: Szevasztopol folded before Flop (didn't bet)
Seat 3: CAJUN890 folded before Flop (didn't bet)
Seat 4: matiko09 folded before Flop (didn't bet)
Seat 5: Pvsx. (button) collected ($7.16)
Seat 7: Sherlockplay (small blind) folded before Flop
Seat 8: DUkalisUA (big blind) folded before Flop
Seat 9: RICKA16 folded on the Flop





PokerStars Hand #150802158248:  Hold'em No Limit ($0.50/$1.00 USD) - 2016/03/23 14:50:15 CET [2016/03/23 9:50:15 ET]
Table 'Asmodeus' 9-max Seat #6 is the button
Seat 1: Jimy Tiltman ($104.40 in chips) 
Seat 2: $-Twackle-$ ($100 in chips) 
Seat 3: nickreason17 ($105.90 in chips) 
Seat 4: Effort92 ($104.36 in chips) 
Seat 5: chaps1988 ($103.63 in chips) 
Seat 6: florrin92 ($100 in chips) 
Seat 8: KEBIN1974 ($162.50 in chips) 
Seat 9: matiko09 ($100 in chips) 
KEBIN1974: posts small blind $0.50
matiko09: posts big blind $1
Jimy Tiltman: posts the ante $0.20
$-Twackle-$: posts the ante $0.20
nickreason17: posts the ante $0.20
Effort92: posts the ante $0.20
chaps1988: posts the ante $0.20
florrin92: posts the ante $0.20
KEBIN1974: posts the ante $0.20
matiko09: posts the ante $0.20
*** HOLE CARDS ***
Dealt to matiko09 [Qc Js]
mycka86 joins the table at seat #7 
Jimy Tiltman: folds 
$-Twackle-$: folds 
nickreason17: folds 
Effort92: raises $1.50 to $2.50
chaps1988: folds 
florrin92: raises $5.50 to $8
KEBIN1974: folds 
matiko09: folds 
Effort92: folds 
Uncalled bet ($5.50) returned to florrin92
florrin92 collected $8.10 from pot
florrin92: doesn't show hand 
*** SUMMARY ***
Total pot $8.10 | Rake $0 
Seat 1: Jimy Tiltman folded before Flop (didn't bet)
Seat 2: $-Twackle-$ folded before Flop (didn't bet)
Seat 3: nickreason17 folded before Flop (didn't bet)
Seat 4: Effort92 folded before Flop
Seat 5: chaps1988 folded before Flop (didn't bet)
Seat 6: florrin92 (button) collected ($8.10)
Seat 8: KEBIN1974 (small blind) folded before Flop
Seat 9: matiko09 (big blind) folded before Flop





PokerStars Hand #150802168201:  Hold'em No Limit ($0.25/$0.50 USD) - 2016/03/23 14:50:31 CET [2016/03/23 9:50:31 ET]
Table 'Pyrrhus' 9-max Seat #7 is the button
Seat 2: BSTUSim ($67.37 in chips) 
Seat 3: i L00K great ($50 in chips) 
Seat 4: GriffinBerg ($43.66 in chips) 
Seat 5: ZonTTT ($52.86 in chips) 
Seat 6: Ahangama ($50.75 in chips) 
Seat 7: matiko09 ($139.50 in chips) 
Seat 8: dndngod ($78.68 in chips) 
Seat 9: CvMCvMCvM ($90.88 in chips) 
dndngod: posts small blind $0.25
CvMCvMCvM: posts big blind $0.50
lumen21: sits out 
*** HOLE CARDS ***
Dealt to matiko09 [2d 4d]
BSTUSim: raises $1 to $1.50
i L00K great: folds 
GriffinBerg: folds 
ZonTTT: folds 
Ahangama: folds 
matiko09: folds 
dndngod: folds 
CvMCvMCvM: folds 
Uncalled bet ($1) returned to BSTUSim
BSTUSim collected $1.25 from pot
BSTUSim: doesn't show hand 
*** SUMMARY ***
Total pot $1.25 | Rake $0 
Seat 2: BSTUSim collected ($1.25)
Seat 3: i L00K great folded before Flop (didn't bet)
Seat 4: GriffinBerg folded before Flop (didn't bet)
Seat 5: ZonTTT folded before Flop (didn't bet)
Seat 6: Ahangama folded before Flop (didn't bet)
Seat 7: matiko09 (button) folded before Flop (didn't bet)
Seat 8: dndngod (small blind) folded before Flop
Seat 9: CvMCvMCvM (big blind) folded before Flop





PokerStars Hand #150802171246:  Hold'em No Limit ($1/$2 USD) - 2016/03/23 14:50:36 CET [2016/03/23 9:50:36 ET]
Table 'Achaia' 9-max Seat #6 is the button
Seat 1: Moszes360 ($244.42 in chips) 
Seat 2: InsomniaRU ($245.13 in chips) 
Seat 3: matiko09 ($237.16 in chips) 
Seat 4: erfk1958 ($105 in chips) 
Seat 5: chaps1988 ($201.70 in chips) 
Seat 6: nickreason17 ($208.99 in chips) 
Seat 7: morosun ($254.79 in chips) 
Seat 8: $-Twackle-$ ($214.07 in chips) 
morosun: posts small blind $1
$-Twackle-$: posts big blind $2
PacPacBum: sits out 
*** HOLE CARDS ***
Dealt to matiko09 [8h 2c]
Moszes360: folds 
InsomniaRU: folds 
matiko09: folds 
erfk1958: folds 
chaps1988: folds 
nickreason17: raises $2.08 to $4.08
morosun: calls $3.08
$-Twackle-$: raises $16.92 to $21
nickreason17: calls $16.92
morosun: calls $16.92
*** FLOP *** [4h 5c Js]
morosun: checks 
$-Twackle-$: bets $50
nickreason17: folds 
morosun: folds 
Uncalled bet ($50) returned to $-Twackle-$
$-Twackle-$ collected $60.20 from pot
$-Twackle-$: doesn't show hand 
*** SUMMARY ***
Total pot $63 | Rake $2.80 
Board [4h 5c Js]
Seat 1: Moszes360 folded before Flop (didn't bet)
Seat 2: InsomniaRU folded before Flop (didn't bet)
Seat 3: matiko09 folded before Flop (didn't bet)
Seat 4: erfk1958 folded before Flop (didn't bet)
Seat 5: chaps1988 folded before Flop (didn't bet)
Seat 6: nickreason17 (button) folded on the Flop
Seat 7: morosun (small blind) folded on the Flop
Seat 8: $-Twackle-$ (big blind) collected ($60.20)





PokerStars Hand #150802172515:  Hold'em No Limit ($0.50/$1.00 USD) - 2016/03/23 14:50:38 CET [2016/03/23 9:50:38 ET]
Table 'Swings' 9-max Seat #7 is the button
Seat 1: Sherlockplay ($114.63 in chips) 
Seat 2: Harbinger X ($185.64 in chips) 
Seat 3: maxxmeister ($119.28 in chips) 
Seat 4: chaps1988 ($100 in chips) 
Seat 5: chautinhtri9 ($100 in chips) 
Seat 6: matiko09 ($124.93 in chips) 
Seat 7: PacPacBum ($112.99 in chips) 
Seat 8: RICKA16 ($106.96 in chips) 
Seat 9: Vlad_1965_77 ($115.13 in chips) 
RICKA16: posts small blind $0.50
Vlad_1965_77: posts big blind $1
*** HOLE CARDS ***
Dealt to matiko09 [9h 8s]
Sherlockplay: folds 
Harbinger X: folds 
maxxmeister: folds 
chaps1988: folds 
chautinhtri9: folds 
matiko09: folds 
PacPacBum: raises $1.04 to $2.04
RICKA16: folds 
Vlad_1965_77: folds 
Uncalled bet ($1.04) returned to PacPacBum
PacPacBum collected $2.50 from pot
PacPacBum: doesn't show hand 
*** SUMMARY ***
Total pot $2.50 | Rake $0 
Seat 1: Sherlockplay folded before Flop (didn't bet)
Seat 2: Harbinger X folded before Flop (didn't bet)
Seat 3: maxxmeister folded before Flop (didn't bet)
Seat 4: chaps1988 folded before Flop (didn't bet)
Seat 5: chautinhtri9 folded before Flop (didn't bet)
Seat 6: matiko09 folded before Flop (didn't bet)
Seat 7: PacPacBum (button) collected ($2.50)
Seat 8: RICKA16 (small blind) folded before Flop
Seat 9: Vlad_1965_77 (big blind) folded before Flop





PokerStars Hand #150802174483:  Hold'em No Limit ($1/$2 USD) - 2016/03/23 14:50:41 CET [2016/03/23 9:50:41 ET]
Table 'Kypria II' 9-max Seat #1 is the button
Seat 1: geldwolfje ($150.65 in chips) 
Seat 2: coinflip_si ($200 in chips) 
Seat 3: seouljam ($222.52 in chips) 
Seat 4: VolanDog ($241.72 in chips) 
Seat 5: InsomniaRU ($364.50 in chips) 
Seat 6: matiko09 ($416.53 in chips) 
Seat 7: DUkalisUA ($200 in chips) 
Seat 8: nickreason17 ($200 in chips) 
coinflip_si: posts small blind $1
seouljam: posts big blind $2
sanrs57: sits out 
*** HOLE CARDS ***
Dealt to matiko09 [9h As]
VolanDog: folds 
InsomniaRU: folds 
matiko09: folds 
DUkalisUA: folds 
nickreason17: folds 
geldwolfje: raises $4 to $6
coinflip_si: folds 
seouljam: calls $4
*** FLOP *** [Td 5s 3d]
seouljam: checks 
geldwolfje: bets $10
seouljam: calls $10
*** TURN *** [Td 5s 3d] [7d]
seouljam: checks 
geldwolfje: bets $20
seouljam: calls $20
*** RIVER *** [Td 5s 3d 7d] [3h]
seouljam: checks 
geldwolfje: checks 
*** SHOW DOWN ***
seouljam: shows [Ts Kd] (two pair, Tens and Threes)
geldwolfje: mucks hand 
seouljam collected $70.20 from pot
*** SUMMARY ***
Total pot $73 | Rake $2.80 
Board [Td 5s 3d 7d 3h]
Seat 1: geldwolfje (button) mucked [Ah 5c]
Seat 2: coinflip_si (small blind) folded before Flop
Seat 3: seouljam (big blind) showed [Ts Kd] and won ($70.20) with two pair, Tens and Threes
Seat 4: VolanDog folded before Flop (didn't bet)
Seat 5: InsomniaRU folded before Flop (didn't bet)
Seat 6: matiko09 folded before Flop (didn't bet)
Seat 7: DUkalisUA folded before Flop (didn't bet)
Seat 8: nickreason17 folded before Flop (didn't bet)





PokerStars Hand #150802177467:  Hold'em No Limit ($0.50/$1.00 USD) - 2016/03/23 14:50:45 CET [2016/03/23 9:50:45 ET]
Table 'Donar II' 9-max Seat #9 is the button
Seat 1: Effort92 ($121.41 in chips) 
Seat 2: chaps1988 ($100 in chips) 
Seat 4: DUkalisUA ($158.44 in chips) 
Seat 5: matiko09 ($130.64 in chips) 
Seat 7: JimineyCrik ($183.42 in chips) 
Seat 8: $-Twackle-$ ($119 in chips) 
Seat 9: nickreason17 ($100.80 in chips) 
Effort92: posts small blind $0.50
chaps1988: posts big blind $1
Effort92: posts the ante $0.20
chaps1988: posts the ante $0.20
DUkalisUA: posts the ante $0.20
matiko09: posts the ante $0.20
JimineyCrik: posts the ante $0.20
$-Twackle-$: posts the ante $0.20
nickreason17: posts the ante $0.20
*** HOLE CARDS ***
Dealt to matiko09 [7h 5s]
DUkalisUA has timed out
DUkalisUA: folds 
matiko09: folds 
JimineyCrik: folds 
$-Twackle-$: raises $1.50 to $2.50
nickreason17: calls $2.50
Effort92: folds 
chaps1988: calls $1.50
*** FLOP *** [3h 2c Kh]
chaps1988: checks 
$-Twackle-$: checks 
nickreason17: bets $5
chaps1988: calls $5
$-Twackle-$: folds 
*** TURN *** [3h 2c Kh] [Ts]
chaps1988: checks 
nickreason17: bets $12
chaps1988: calls $12
*** RIVER *** [3h 2c Kh Ts] [8s]
chaps1988: checks 
nickreason17: checks 
*** SHOW DOWN ***
chaps1988: shows [Kd Tc] (two pair, Kings and Tens)
nickreason17: mucks hand 
chaps1988 collected $41.45 from pot
*** SUMMARY ***
Total pot $43.40 | Rake $1.95 
Board [3h 2c Kh Ts 8s]
Seat 1: Effort92 (small blind) folded before Flop
Seat 2: chaps1988 (big blind) showed [Kd Tc] and won ($41.45) with two pair, Kings and Tens
Seat 4: DUkalisUA folded before Flop (didn't bet)
Seat 5: matiko09 folded before Flop (didn't bet)
Seat 7: JimineyCrik folded before Flop (didn't bet)
Seat 8: $-Twackle-$ folded on the Flop
Seat 9: nickreason17 (button) mucked [Jh As]





PokerStars Hand #150802179056:  Hold'em No Limit ($0.50/$1.00 USD) - 2016/03/23 14:50:48 CET [2016/03/23 9:50:48 ET]
Table 'Merope II' 9-max Seat #4 is the button
Seat 1: Jimy Tiltman ($134.49 in chips) 
Seat 2: $-Twackle-$ ($100 in chips) 
Seat 3: pablos1922 ($92.31 in chips) 
Seat 4: YuriiSolodya ($83.84 in chips) 
Seat 5: chaps1988 ($100 in chips) 
Seat 6: Effort92 ($101.21 in chips) 
Seat 7: matiko09 ($105.03 in chips) 
Seat 8: Red4erT ($41.50 in chips) 
Seat 9: RICKA16 ($122.24 in chips) 
chaps1988: posts small blind $0.50
Effort92: posts big blind $1
*** HOLE CARDS ***
Dealt to matiko09 [8h 7c]
matiko09: folds 
Red4erT: folds 
RICKA16: raises $2 to $3
Jimy Tiltman: folds 
$-Twackle-$: folds 
pablos1922: folds 
YuriiSolodya: folds 
chaps1988: raises $8 to $11
Effort92: folds 
RICKA16: folds 
Uncalled bet ($8) returned to chaps1988
chaps1988 collected $7 from pot
chaps1988: doesn't show hand 
*** SUMMARY ***
Total pot $7 | Rake $0 
Seat 1: Jimy Tiltman folded before Flop (didn't bet)
Seat 2: $-Twackle-$ folded before Flop (didn't bet)
Seat 3: pablos1922 folded before Flop (didn't bet)
Seat 4: YuriiSolodya (button) folded before Flop (didn't bet)
Seat 5: chaps1988 (small blind) collected ($7)
Seat 6: Effort92 (big blind) folded before Flop
Seat 7: matiko09 folded before Flop (didn't bet)
Seat 8: Red4erT folded before Flop (didn't bet)
Seat 9: RICKA16 folded before Flop





PokerStars Hand #150802185940:  Hold'em No Limit ($0.50/$1.00 USD) - 2016/03/23 14:50:59 CET [2016/03/23 9:50:59 ET]
Table 'Swings' 9-max Seat #8 is the button
Seat 3: maxxmeister ($119.28 in chips) 
Seat 4: chaps1988 ($100 in chips) 
Seat 5: chautinhtri9 ($100 in chips) 
Seat 6: matiko09 ($124.93 in chips) 
Seat 7: PacPacBum ($114.49 in chips) 
Seat 8: RICKA16 ($106.46 in chips) 
Seat 9: Vlad_1965_77 ($114.13 in chips) 
Vlad_1965_77: posts small blind $0.50
Sherlockplay: is sitting out 
Harbinger X: is sitting out 
maxxmeister: posts big blind $1
*** HOLE CARDS ***
Dealt to matiko09 [2s 7h]
chaps1988: folds 
Sherlockplay leaves the table
Harbinger X leaves the table
chautinhtri9: folds 
carrsseis joins the table at seat #1 
matiko09: folds 
PacPacBum: folds 
RICKA16: folds 
tomver0809 joins the table at seat #2 
Vlad_1965_77: folds 
Uncalled bet ($0.50) returned to maxxmeister
maxxmeister collected $1 from pot
maxxmeister: doesn't show hand 
*** SUMMARY ***
Total pot $1 | Rake $0 
Seat 3: maxxmeister (big blind) collected ($1)
Seat 4: chaps1988 folded before Flop (didn't bet)
Seat 5: chautinhtri9 folded before Flop (didn't bet)
Seat 6: matiko09 folded before Flop (didn't bet)
Seat 7: PacPacBum folded before Flop (didn't bet)
Seat 8: RICKA16 (button) folded before Flop (didn't bet)
Seat 9: Vlad_1965_77 (small blind) folded before Flop





PokerStars Hand #150802191970:  Hold'em No Limit ($0.50/$1.00 USD) - 2016/03/23 14:51:09 CET [2016/03/23 9:51:09 ET]
Table 'Asmodeus' 9-max Seat #8 is the button
Seat 1: Jimy Tiltman ($104.20 in chips) 
Seat 2: $-Twackle-$ ($100 in chips) 
Seat 3: nickreason17 ($105.70 in chips) 
Seat 4: Effort92 ($101.66 in chips) 
Seat 6: florrin92 ($105.40 in chips) 
Seat 8: KEBIN1974 ($161.80 in chips) 
Seat 9: matiko09 ($100 in chips) 
matiko09: posts small blind $0.50
Jimy Tiltman: posts big blind $1
mycka86: sits out 
Jimy Tiltman: posts the ante $0.20
$-Twackle-$: posts the ante $0.20
nickreason17: posts the ante $0.20
Effort92: posts the ante $0.20
florrin92: posts the ante $0.20
KEBIN1974: posts the ante $0.20
matiko09: posts the ante $0.20
*** HOLE CARDS ***
Dealt to matiko09 [4d As]
$-Twackle-$: folds 
nickreason17: folds 
Effort92: folds 
florrin92: folds 
KEBIN1974: calls $1
matiko09: calls $0.50
Jimy Tiltman: checks 
*** FLOP *** [Th 2c 6s]
matiko09: checks 
Jimy Tiltman: checks 
KEBIN1974: bets $2.43
matiko09: folds 
Jimy Tiltman: calls $2.43
*** TURN *** [Th 2c 6s] [Jh]
Jimy Tiltman: checks 
KEBIN1974: bets $7.86
Jimy Tiltman: folds 
Uncalled bet ($7.86) returned to KEBIN1974
KEBIN1974 collected $8.84 from pot
KEBIN1974: doesn't show hand 
*** SUMMARY ***
Total pot $9.26 | Rake $0.42 
Board [Th 2c 6s Jh]
Seat 1: Jimy Tiltman (big blind) folded on the Turn
Seat 2: $-Twackle-$ folded before Flop (didn't bet)
Seat 3: nickreason17 folded before Flop (didn't bet)
Seat 4: Effort92 folded before Flop (didn't bet)
Seat 6: florrin92 folded before Flop (didn't bet)
Seat 8: KEBIN1974 (button) collected ($8.84)
Seat 9: matiko09 (small blind) folded on the Flop





PokerStars Hand #150802192708:  Hold'em No Limit ($0.25/$0.50 USD) - 2016/03/23 14:51:10 CET [2016/03/23 9:51:10 ET]
Table 'Pyrrhus' 9-max Seat #8 is the button
Seat 1: lumen21 ($79.77 in chips) 
Seat 2: BSTUSim ($68.12 in chips) 
Seat 3: i L00K great ($50 in chips) 
Seat 4: GriffinBerg ($43.66 in chips) 
Seat 5: ZonTTT ($52.86 in chips) 
Seat 6: Ahangama ($50.75 in chips) 
Seat 7: matiko09 ($139.50 in chips) 
Seat 8: dndngod ($78.43 in chips) 
Seat 9: CvMCvMCvM ($90.38 in chips) 
CvMCvMCvM: posts small blind $0.25
lumen21: posts big blind $0.50
*** HOLE CARDS ***
Dealt to matiko09 [3s 6d]
BSTUSim: folds 
i L00K great: folds 
GriffinBerg: folds 
ZonTTT: raises $1 to $1.50
Ahangama: folds 
matiko09: folds 
dndngod: folds 
CvMCvMCvM: folds 
lumen21: folds 
Uncalled bet ($1) returned to ZonTTT
ZonTTT collected $1.25 from pot
ZonTTT: doesn't show hand 
*** SUMMARY ***
Total pot $1.25 | Rake $0 
Seat 1: lumen21 (big blind) folded before Flop
Seat 2: BSTUSim folded before Flop (didn't bet)
Seat 3: i L00K great folded before Flop (didn't bet)
Seat 4: GriffinBerg folded before Flop (didn't bet)
Seat 5: ZonTTT collected ($1.25)
Seat 6: Ahangama folded before Flop (didn't bet)
Seat 7: matiko09 folded before Flop (didn't bet)
Seat 8: dndngod (button) folded before Flop (didn't bet)
Seat 9: CvMCvMCvM (small blind) folded before Flop





PokerStars Hand #150802195689:  Hold'em No Limit ($1/$2 USD) - 2016/03/23 14:51:15 CET [2016/03/23 9:51:15 ET]
Table 'Kiess' 9-max Seat #9 is the button
Seat 2: DUkalisUA ($709.28 in chips) 
Seat 3: Red4erT ($80 in chips) 
Seat 4: Moszes360 ($212.14 in chips) 
Seat 5: chippo boy ($424.14 in chips) 
Seat 6: matiko09 ($260.86 in chips) 
Seat 7: InsomniaRU ($331.21 in chips) 
Seat 9: T0ny Adams ($176.62 in chips) 
DUkalisUA: posts small blind $1
Red4erT: posts big blind $2
*** HOLE CARDS ***
Dealt to matiko09 [7d Ad]
Moszes360: folds 
chippo boy: folds 
matiko09: folds 
InsomniaRU: raises $3 to $5
T0ny Adams: folds 
DUkalisUA: folds 
Red4erT: folds 
Uncalled bet ($3) returned to InsomniaRU
InsomniaRU collected $5 from pot
InsomniaRU: doesn't show hand 
*** SUMMARY ***
Total pot $5 | Rake $0 
Seat 2: DUkalisUA (small blind) folded before Flop
Seat 3: Red4erT (big blind) folded before Flop
Seat 4: Moszes360 folded before Flop (didn't bet)
Seat 5: chippo boy folded before Flop (didn't bet)
Seat 6: matiko09 folded before Flop (didn't bet)
Seat 7: InsomniaRU collected ($5)
Seat 9: T0ny Adams (button) folded before Flop (didn't bet)





PokerStars Hand #150802202914:  Hold'em No Limit ($0.50/$1.00 USD) - 2016/03/23 14:51:26 CET [2016/03/23 9:51:26 ET]
Table 'Swings' 9-max Seat #9 is the button
Seat 3: maxxmeister ($119.78 in chips) 
Seat 5: chautinhtri9 ($100 in chips) 
Seat 6: matiko09 ($124.93 in chips) 
Seat 7: PacPacBum ($114.49 in chips) 
Seat 8: RICKA16 ($106.46 in chips) 
Seat 9: Vlad_1965_77 ($113.63 in chips) 
carrsseis will be allowed to play after the button
tomver0809 will be allowed to play after the button
maxxmeister: posts small blind $0.50
chautinhtri9: posts big blind $1
*** HOLE CARDS ***
Dealt to matiko09 [Js Jh]
matiko09: raises $2 to $3
PacPacBum: folds 
RICKA16: folds 
Vlad_1965_77: folds 
maxxmeister: folds 
chautinhtri9: folds 
Uncalled bet ($2) returned to matiko09
matiko09 collected $2.50 from pot
matiko09: doesn't show hand 
*** SUMMARY ***
Total pot $2.50 | Rake $0 
Seat 3: maxxmeister (small blind) folded before Flop
Seat 5: chautinhtri9 (big blind) folded before Flop
Seat 6: matiko09 collected ($2.50)
Seat 7: PacPacBum folded before Flop (didn't bet)
Seat 8: RICKA16 folded before Flop (didn't bet)
Seat 9: Vlad_1965_77 (button) folded before Flop (didn't bet)





PokerStars Hand #150802203842:  Hold'em No Limit ($0.50/$1.00 USD) - 2016/03/23 14:51:27 CET [2016/03/23 9:51:27 ET]
Table 'Atlantis' 9-max Seat #7 is the button
Seat 1: xHourglass ($136 in chips) 
Seat 2: Szevasztopol ($107.78 in chips) 
Seat 3: CAJUN890 ($140.84 in chips) 
Seat 4: matiko09 ($142.61 in chips) 
Seat 5: Pvsx. ($111.22 in chips) 
Seat 7: Sherlockplay ($141.48 in chips) 
Seat 8: DUkalisUA ($135.80 in chips) 
Seat 9: RICKA16 ($96.16 in chips) 
DUkalisUA: posts small blind $0.50
RICKA16: posts big blind $1
PacPacBum: sits out 
*** HOLE CARDS ***
Dealt to matiko09 [7h 4d]
xHourglass: raises $2 to $3
Szevasztopol: folds 
CAJUN890: folds 
matiko09: folds 
Pvsx.: folds 
Sherlockplay: folds 
DUkalisUA: calls $2.50
RICKA16: folds 
*** FLOP *** [4s As Qs]
DUkalisUA: bets $5.01
xHourglass: raises $9.99 to $15
DUkalisUA: calls $9.99
*** TURN *** [4s As Qs] [Ad]
DUkalisUA: checks 
xHourglass: checks 
*** RIVER *** [4s As Qs Ad] [7s]
DUkalisUA: checks 
xHourglass: checks 
*** SHOW DOWN ***
DUkalisUA: shows [Ac Qc] (a full house, Aces full of Queens)
xHourglass: mucks hand 
DUkalisUA collected $35.34 from pot
*** SUMMARY ***
Total pot $37 | Rake $1.66 
Board [4s As Qs Ad 7s]
Seat 1: xHourglass mucked [8d 8s]
Seat 2: Szevasztopol folded before Flop (didn't bet)
Seat 3: CAJUN890 folded before Flop (didn't bet)
Seat 4: matiko09 folded before Flop (didn't bet)
Seat 5: Pvsx. folded before Flop (didn't bet)
Seat 7: Sherlockplay (button) folded before Flop (didn't bet)
Seat 8: DUkalisUA (small blind) showed [Ac Qc] and won ($35.34) with a full house, Aces full of Queens
Seat 9: RICKA16 (big blind) folded before Flop





PokerStars Hand #150802206152:  Hold'em No Limit ($1/$2 USD) - 2016/03/23 14:51:31 CET [2016/03/23 9:51:31 ET]
Table 'Herba II' 9-max Seat #6 is the button
Seat 1: matiko09 ($238.68 in chips) 
Seat 2: Moszes360 ($200 in chips) 
Seat 3: Cirilico ($160 in chips) 
Seat 4: DUkalisUA ($400.40 in chips) 
Seat 5: chippo boy ($268.53 in chips) 
Seat 6: Too-Anti-To ($225.38 in chips) 
Seat 7: InsomniaRU ($409.70 in chips) 
Seat 8: T0ny Adams ($80 in chips) 
Seat 9: mrhighryza ($56.44 in chips) 
InsomniaRU: posts small blind $1
T0ny Adams: posts big blind $2
*** HOLE CARDS ***
Dealt to matiko09 [9d Th]
mrhighryza: folds 
matiko09: folds 
Moszes360: folds 
Cirilico: folds 
DUkalisUA: folds 
chippo boy: calls $2
Too-Anti-To: folds 
InsomniaRU: folds 
T0ny Adams: checks 
*** FLOP *** [Js As 4c]
T0ny Adams: checks 
chippo boy: checks 
*** TURN *** [Js As 4c] [Ad]
T0ny Adams: checks 
chippo boy: checks 
*** RIVER *** [Js As 4c Ad] [5s]
T0ny Adams: checks 
chippo boy: bets $8
T0ny Adams: folds 
Uncalled bet ($8) returned to chippo boy
chippo boy collected $4.78 from pot
*** SUMMARY ***
Total pot $5 | Rake $0.22 
Board [Js As 4c Ad 5s]
Seat 1: matiko09 folded before Flop (didn't bet)
Seat 2: Moszes360 folded before Flop (didn't bet)
Seat 3: Cirilico folded before Flop (didn't bet)
Seat 4: DUkalisUA folded before Flop (didn't bet)
Seat 5: chippo boy collected ($4.78)
Seat 6: Too-Anti-To (button) folded before Flop (didn't bet)
Seat 7: InsomniaRU (small blind) folded before Flop
Seat 8: T0ny Adams (big blind) folded on the River
Seat 9: mrhighryza folded before Flop (didn't bet)





PokerStars Hand #150802211870:  Hold'em No Limit ($0.25/$0.50 USD) - 2016/03/23 14:51:40 CET [2016/03/23 9:51:40 ET]
Table 'Pyrrhus' 9-max Seat #9 is the button
Seat 1: lumen21 ($79.27 in chips) 
Seat 2: BSTUSim ($68.12 in chips) 
Seat 3: i L00K great ($50 in chips) 
Seat 4: GriffinBerg ($43.66 in chips) 
Seat 5: ZonTTT ($53.61 in chips) 
Seat 6: Ahangama ($50.75 in chips) 
Seat 7: matiko09 ($139.50 in chips) 
Seat 8: dndngod ($78.43 in chips) 
Seat 9: CvMCvMCvM ($90.13 in chips) 
lumen21: posts small blind $0.25
BSTUSim: posts big blind $0.50
*** HOLE CARDS ***
Dealt to matiko09 [4s 9h]
i L00K great: folds 
GriffinBerg: calls $0.50
ZonTTT: folds 
Ahangama: folds 
matiko09: folds 
dndngod: folds 
CvMCvMCvM: folds 
lumen21: raises $1.75 to $2.25
BSTUSim: calls $1.75
GriffinBerg: calls $1.75
*** FLOP *** [6d 7h 2d]
lumen21: bets $6.19
BSTUSim: folds 
GriffinBerg: folds 
Uncalled bet ($6.19) returned to lumen21
lumen21 collected $6.45 from pot
lumen21: doesn't show hand 
*** SUMMARY ***
Total pot $6.75 | Rake $0.30 
Board [6d 7h 2d]
Seat 1: lumen21 (small blind) collected ($6.45)
Seat 2: BSTUSim (big blind) folded on the Flop
Seat 3: i L00K great folded before Flop (didn't bet)
Seat 4: GriffinBerg folded on the Flop
Seat 5: ZonTTT folded before Flop (didn't bet)
Seat 6: Ahangama folded before Flop (didn't bet)
Seat 7: matiko09 folded before Flop (didn't bet)
Seat 8: dndngod folded before Flop (didn't bet)
Seat 9: CvMCvMCvM (button) folded before Flop (didn't bet)





PokerStars Hand #150802213316:  Hold'em No Limit ($1/$2 USD) - 2016/03/23 14:51:42 CET [2016/03/23 9:51:42 ET]
Table 'Kiess' 9-max Seat #2 is the button
Seat 2: DUkalisUA ($708.28 in chips) 
Seat 3: Red4erT ($80 in chips) 
Seat 5: chippo boy ($424.14 in chips) 
Seat 6: matiko09 ($260.86 in chips) 
Seat 7: InsomniaRU ($334.21 in chips) 
Seat 8: erfk1958 ($122 in chips) 
Seat 9: T0ny Adams ($176.62 in chips) 
Red4erT: posts small blind $1
Moszes360: is sitting out 
Moszes360 leaves the table
chippo boy: posts big blind $2
*** HOLE CARDS ***
Dealt to matiko09 [4s Qd]
Igoriah joins the table at seat #4 
matiko09: folds 
InsomniaRU: folds 
erfk1958: raises $2 to $4
T0ny Adams: calls $4
DUkalisUA: folds 
Red4erT: folds 
chippo boy: calls $2
*** FLOP *** [4c Ah Jh]
chippo boy: checks 
erfk1958: bets $6
T0ny Adams: folds 
chippo boy: folds 
Uncalled bet ($6) returned to erfk1958
erfk1958 collected $12.42 from pot
erfk1958: doesn't show hand 
*** SUMMARY ***
Total pot $13 | Rake $0.58 
Board [4c Ah Jh]
Seat 2: DUkalisUA (button) folded before Flop (didn't bet)
Seat 3: Red4erT (small blind) folded before Flop
Seat 5: chippo boy (big blind) folded on the Flop
Seat 6: matiko09 folded before Flop (didn't bet)
Seat 7: InsomniaRU folded before Flop (didn't bet)
Seat 8: erfk1958 collected ($12.42)
Seat 9: T0ny Adams folded on the Flop





PokerStars Hand #150802215697:  Hold'em No Limit ($0.50/$1.00 USD) - 2016/03/23 14:51:46 CET [2016/03/23 9:51:46 ET]
Table 'Swings' 9-max Seat #3 is the button
Seat 3: maxxmeister ($119.28 in chips) 
Seat 5: chautinhtri9 ($99 in chips) 
Seat 6: matiko09 ($126.43 in chips) 
Seat 7: PacPacBum ($114.49 in chips) 
Seat 8: RICKA16 ($106.46 in chips) 
Seat 9: Vlad_1965_77 ($113.63 in chips) 
chautinhtri9: posts small blind $0.50
matiko09: posts big blind $1
carrsseis: sits out 
tomver0809: sits out 
*** HOLE CARDS ***
Dealt to matiko09 [2s 3c]
PacPacBum: folds 
RICKA16: folds 
Vlad_1965_77: folds 
maxxmeister: folds 
chautinhtri9: folds 
Uncalled bet ($0.50) returned to matiko09
matiko09 collected $1 from pot
matiko09: doesn't show hand 
*** SUMMARY ***
Total pot $1 | Rake $0 
Seat 3: maxxmeister (button) folded before Flop (didn't bet)
Seat 5: chautinhtri9 (small blind) folded before Flop
Seat 6: matiko09 (big blind) collected ($1)
Seat 7: PacPacBum folded before Flop (didn't bet)
Seat 8: RICKA16 folded before Flop (didn't bet)
Seat 9: Vlad_1965_77 folded before Flop (didn't bet)





PokerStars Hand #150802218601:  Hold'em No Limit ($1/$2 USD) - 2016/03/23 14:51:51 CET [2016/03/23 9:51:51 ET]
Table 'Achaia' 9-max Seat #7 is the button
Seat 1: Moszes360 ($244.42 in chips) 
Seat 2: InsomniaRU ($245.13 in chips) 
Seat 3: matiko09 ($237.16 in chips) 
Seat 4: erfk1958 ($105 in chips) 
Seat 6: nickreason17 ($200 in chips) 
Seat 7: morosun ($233.79 in chips) 
Seat 8: $-Twackle-$ ($253.27 in chips) 
Seat 9: PacPacBum ($200 in chips) 
$-Twackle-$: posts small blind $1
PacPacBum: posts big blind $2
*** HOLE CARDS ***
Dealt to matiko09 [4h 5h]
Moszes360: folds 
InsomniaRU: folds 
matiko09: folds 
erfk1958: folds 
nickreason17: raises $3 to $5
morosun: calls $5
$-Twackle-$: folds 
PacPacBum: folds 
*** FLOP *** [8h Qc 9h]
nickreason17: checks 
morosun: bets $4
nickreason17: calls $4
*** TURN *** [8h Qc 9h] [9c]
nickreason17: checks 
morosun: bets $4
nickreason17: raises $19 to $23
morosun: calls $19
*** RIVER *** [8h Qc 9h 9c] [Kc]
nickreason17: bets $48.15
morosun: calls $48.15
*** SHOW DOWN ***
nickreason17: shows [9d Kd] (a full house, Nines full of Kings)
morosun: mucks hand 
nickreason17 collected $160.50 from pot
*** SUMMARY ***
Total pot $163.30 | Rake $2.80 
Board [8h Qc 9h 9c Kc]
Seat 1: Moszes360 folded before Flop (didn't bet)
Seat 2: InsomniaRU folded before Flop (didn't bet)
Seat 3: matiko09 folded before Flop (didn't bet)
Seat 4: erfk1958 folded before Flop (didn't bet)
Seat 6: nickreason17 showed [9d Kd] and won ($160.50) with a full house, Nines full of Kings
Seat 7: morosun (button) mucked [Kh Qh]
Seat 8: $-Twackle-$ (small blind) folded before Flop
Seat 9: PacPacBum (big blind) folded before Flop





PokerStars Hand #150802220803:  Hold'em No Limit ($1/$2 USD) - 2016/03/23 14:51:54 CET [2016/03/23 9:51:54 ET]
Table 'Kypria II' 9-max Seat #2 is the button
Seat 1: geldwolfje ($114.65 in chips) 
Seat 2: coinflip_si ($200 in chips) 
Seat 3: seouljam ($256.72 in chips) 
Seat 4: VolanDog ($241.72 in chips) 
Seat 5: InsomniaRU ($364.50 in chips) 
Seat 6: matiko09 ($416.53 in chips) 
Seat 7: DUkalisUA ($200 in chips) 
Seat 8: nickreason17 ($200 in chips) 
Seat 9: sanrs57 ($200 in chips) 
seouljam: posts small blind $1
VolanDog: posts big blind $2
sanrs57: posts big blind $2
*** HOLE CARDS ***
Dealt to matiko09 [Ad 5c]
seouljam said, "thx"
InsomniaRU: folds 
matiko09: folds 
DUkalisUA: raises $6 to $8
nickreason17: folds 
sanrs57: folds 
geldwolfje said, "fine"
geldwolfje: raises $6 to $14
coinflip_si: folds 
seouljam: folds 
VolanDog: folds 
seouljam said, "just so you know i wouldve called allin too"
DUkalisUA: folds 
Uncalled bet ($6) returned to geldwolfje
geldwolfje collected $21 from pot
geldwolfje: doesn't show hand 
*** SUMMARY ***
Total pot $21 | Rake $0 
Seat 1: geldwolfje collected ($21)
Seat 2: coinflip_si (button) folded before Flop (didn't bet)
Seat 3: seouljam (small blind) folded before Flop
Seat 4: VolanDog (big blind) folded before Flop
Seat 5: InsomniaRU folded before Flop (didn't bet)
Seat 6: matiko09 folded before Flop (didn't bet)
Seat 7: DUkalisUA folded before Flop
Seat 8: nickreason17 folded before Flop (didn't bet)
Seat 9: sanrs57 folded before Flop





PokerStars Hand #150802224866:  Hold'em No Limit ($0.50/$1.00 USD) - 2016/03/23 14:52:01 CET [2016/03/23 9:52:01 ET]
Table 'Merope II' 9-max Seat #6 is the button
Seat 1: Jimy Tiltman ($134.49 in chips) 
Seat 2: $-Twackle-$ ($100 in chips) 
Seat 3: pablos1922 ($92.31 in chips) 
Seat 4: YuriiSolodya ($83.84 in chips) 
Seat 6: Effort92 ($100.21 in chips) 
Seat 7: matiko09 ($105.03 in chips) 
Seat 8: Red4erT ($41.50 in chips) 
Seat 9: RICKA16 ($119.24 in chips) 
matiko09: posts small blind $0.50
Red4erT: posts big blind $1
*** HOLE CARDS ***
Dealt to matiko09 [Jh 4h]
RICKA16: folds 
Jimy Tiltman: folds 
$-Twackle-$: raises $2 to $3
pablos1922: folds 
YuriiSolodya: folds 
Effort92: folds 
matiko09: folds 
Red4erT: folds 
Uncalled bet ($2) returned to $-Twackle-$
$-Twackle-$ collected $2.50 from pot
$-Twackle-$: doesn't show hand 
*** SUMMARY ***
Total pot $2.50 | Rake $0 
Seat 1: Jimy Tiltman folded before Flop (didn't bet)
Seat 2: $-Twackle-$ collected ($2.50)
Seat 3: pablos1922 folded before Flop (didn't bet)
Seat 4: YuriiSolodya folded before Flop (didn't bet)
Seat 6: Effort92 (button) folded before Flop (didn't bet)
Seat 7: matiko09 (small blind) folded before Flop
Seat 8: Red4erT (big blind) folded before Flop
Seat 9: RICKA16 folded before Flop (didn't bet)





PokerStars Hand #150802227093:  Hold'em No Limit ($0.50/$1.00 USD) - 2016/03/23 14:52:05 CET [2016/03/23 9:52:05 ET]
Table 'Asmodeus' 9-max Seat #9 is the button
Seat 1: Jimy Tiltman ($100.57 in chips) 
Seat 2: $-Twackle-$ ($100 in chips) 
Seat 3: nickreason17 ($105.50 in chips) 
Seat 4: Effort92 ($101.46 in chips) 
Seat 6: florrin92 ($105.20 in chips) 
Seat 8: KEBIN1974 ($167.01 in chips) 
Seat 9: matiko09 ($100 in chips) 
Jimy Tiltman: posts small blind $0.50
$-Twackle-$: posts big blind $1
mycka86: sits out 
Jimy Tiltman: posts the ante $0.20
$-Twackle-$: posts the ante $0.20
nickreason17: posts the ante $0.20
Effort92: posts the ante $0.20
florrin92: posts the ante $0.20
KEBIN1974: posts the ante $0.20
matiko09: posts the ante $0.20
*** HOLE CARDS ***
Dealt to matiko09 [5s Ad]
nickreason17: folds 
Effort92: folds 
florrin92: folds 
KEBIN1974: folds 
matiko09: raises $1.50 to $2.50
Jimy Tiltman: folds 
$-Twackle-$: calls $1.50
*** FLOP *** [5d Td 9s]
$-Twackle-$: checks 
matiko09: checks 
*** TURN *** [5d Td 9s] [3h]
$-Twackle-$: checks 
matiko09: checks 
*** RIVER *** [5d Td 9s 3h] [Qs]
$-Twackle-$: checks 
matiko09: checks 
*** SHOW DOWN ***
$-Twackle-$: shows [7c Ah] (high card Ace)
matiko09: shows [5s Ad] (a pair of Fives)
matiko09 collected $6.59 from pot
*** SUMMARY ***
Total pot $6.90 | Rake $0.31 
Board [5d Td 9s 3h Qs]
Seat 1: Jimy Tiltman (small blind) folded before Flop
Seat 2: $-Twackle-$ (big blind) showed [7c Ah] and lost with high card Ace
Seat 3: nickreason17 folded before Flop (didn't bet)
Seat 4: Effort92 folded before Flop (didn't bet)
Seat 6: florrin92 folded before Flop (didn't bet)
Seat 8: KEBIN1974 folded before Flop (didn't bet)
Seat 9: matiko09 (button) showed [5s Ad] and won ($6.59) with a pair of Fives





PokerStars Hand #150802231829:  Hold'em No Limit ($0.50/$1.00 USD) - 2016/03/23 14:52:12 CET [2016/03/23 9:52:12 ET]
Table 'Swings' 9-max Seat #5 is the button
Seat 3: maxxmeister ($119.28 in chips) 
Seat 5: chautinhtri9 ($98.50 in chips) 
Seat 6: matiko09 ($126.93 in chips) 
Seat 7: PacPacBum ($114.49 in chips) 
Seat 8: RICKA16 ($106.46 in chips) 
Seat 9: Vlad_1965_77 ($113.63 in chips) 
matiko09: posts small blind $0.50
PacPacBum: posts big blind $1
carrsseis: sits out 
tomver0809: sits out 
*** HOLE CARDS ***
Dealt to matiko09 [Jd 3c]
RICKA16: folds 
Vlad_1965_77: folds 
maxxmeister: raises $2 to $3
chautinhtri9: calls $3
matiko09: folds 
PacPacBum: calls $2
*** FLOP *** [Kd 5d 5h]
PacPacBum: checks 
maxxmeister: bets $6
chautinhtri9: calls $6
PacPacBum: folds 
*** TURN *** [Kd 5d 5h] [9h]
maxxmeister: checks 
chautinhtri9: bets $12
maxxmeister: calls $12
*** RIVER *** [Kd 5d 5h 9h] [Qh]
maxxmeister: checks 
chautinhtri9: checks 
*** SHOW DOWN ***
maxxmeister: shows [7s 7d] (two pair, Sevens and Fives)
chautinhtri9: shows [Kc Jh] (two pair, Kings and Fives)
chautinhtri9 collected $43.45 from pot
*** SUMMARY ***
Total pot $45.50 | Rake $2.05 
Board [Kd 5d 5h 9h Qh]
Seat 3: maxxmeister showed [7s 7d] and lost with two pair, Sevens and Fives
Seat 5: chautinhtri9 (button) showed [Kc Jh] and won ($43.45) with two pair, Kings and Fives
Seat 6: matiko09 (small blind) folded before Flop
Seat 7: PacPacBum (big blind) folded on the Flop
Seat 8: RICKA16 folded before Flop (didn't bet)
Seat 9: Vlad_1965_77 folded before Flop (didn't bet)





PokerStars Hand #150802241573:  Hold'em No Limit ($1/$2 USD) - 2016/03/23 14:52:28 CET [2016/03/23 9:52:28 ET]
Table 'Herba II' 9-max Seat #7 is the button
Seat 1: matiko09 ($238.68 in chips) 
Seat 2: Moszes360 ($200 in chips) 
Seat 4: DUkalisUA ($400.40 in chips) 
Seat 5: chippo boy ($271.31 in chips) 
Seat 6: Too-Anti-To ($225.38 in chips) 
Seat 7: InsomniaRU ($408.70 in chips) 
Seat 8: T0ny Adams ($78 in chips) 
Seat 9: mrhighryza ($56.44 in chips) 
T0ny Adams: posts small blind $1
mrhighryza: posts big blind $2
*** HOLE CARDS ***
Dealt to matiko09 [Qs As]
matiko09: raises $3 to $5
Moszes360: folds 
DUkalisUA: folds 
chippo boy: folds 
Too-Anti-To: folds 
InsomniaRU: folds 
T0ny Adams: folds 
mrhighryza: calls $3
*** FLOP *** [7s 9c 3d]
mrhighryza: checks 
matiko09: bets $6
mrhighryza: folds 
Uncalled bet ($6) returned to matiko09
matiko09 collected $10.50 from pot
matiko09: doesn't show hand 
*** SUMMARY ***
Total pot $11 | Rake $0.50 
Board [7s 9c 3d]
Seat 1: matiko09 collected ($10.50)
Seat 2: Moszes360 folded before Flop (didn't bet)
Seat 4: DUkalisUA folded before Flop (didn't bet)
Seat 5: chippo boy folded before Flop (didn't bet)
Seat 6: Too-Anti-To folded before Flop (didn't bet)
Seat 7: InsomniaRU (button) folded before Flop (didn't bet)
Seat 8: T0ny Adams (small blind) folded before Flop
Seat 9: mrhighryza (big blind) folded on the Flop





PokerStars Hand #150802244747:  Hold'em No Limit ($0.50/$1.00 USD) - 2016/03/23 14:52:33 CET [2016/03/23 9:52:33 ET]
Table 'Sylvia III' 9-max Seat #2 is the button
Seat 2: florrin92 ($100 in chips) 
Seat 3: carrsseis ($87.34 in chips) 
Seat 5: matiko09 ($100 in chips) 
Seat 6: PacPacBum ($109.10 in chips) 
Seat 7: $-Twackle-$ ($104.30 in chips) 
Seat 8: Muinmyheart ($100 in chips) 
carrsseis: posts small blind $0.50
volwebni4ek: is sitting out 
matiko09: posts big blind $1
mycka86: sits out 
florrin92: posts the ante $0.20
carrsseis: posts the ante $0.20
matiko09: posts the ante $0.20
PacPacBum: posts the ante $0.20
$-Twackle-$: posts the ante $0.20
Muinmyheart: posts the ante $0.20
*** HOLE CARDS ***
Dealt to matiko09 [Kd 8c]
PacPacBum: folds 
$-Twackle-$: folds 
Muinmyheart: folds 
florrin92: folds 
carrsseis: folds 
Uncalled bet ($0.50) returned to matiko09
matiko09 collected $2.20 from pot
matiko09: doesn't show hand 
*** SUMMARY ***
Total pot $2.20 | Rake $0 
Seat 2: florrin92 (button) folded before Flop (didn't bet)
Seat 3: carrsseis (small blind) folded before Flop
Seat 5: matiko09 (big blind) collected ($2.20)
Seat 6: PacPacBum folded before Flop (didn't bet)
Seat 7: $-Twackle-$ folded before Flop (didn't bet)
Seat 8: Muinmyheart folded before Flop (didn't bet)





PokerStars Hand #150802252665:  Hold'em No Limit ($0.50/$1.00 USD) - 2016/03/23 14:52:46 CET [2016/03/23 9:52:46 ET]
Table 'Sylvia III' 9-max Seat #3 is the button
Seat 2: florrin92 ($100 in chips) 
Seat 3: carrsseis ($86.64 in chips) 
Seat 5: matiko09 ($101.50 in chips) 
Seat 6: PacPacBum ($108.90 in chips) 
Seat 7: $-Twackle-$ ($104.10 in chips) 
Seat 8: Muinmyheart ($100 in chips) 
matiko09: posts small blind $0.50
PacPacBum: posts big blind $1
mycka86: sits out 
florrin92: posts the ante $0.20
carrsseis: posts the ante $0.20
matiko09: posts the ante $0.20
PacPacBum: posts the ante $0.20
$-Twackle-$: posts the ante $0.20
Muinmyheart: posts the ante $0.20
*** HOLE CARDS ***
Dealt to matiko09 [4h 9d]
volwebni4ek leaves the table
$-Twackle-$: folds 
Muinmyheart: folds 
florrin92: folds 
carrsseis: raises $1.20 to $2.20
matiko09: folds 
PacPacBum: calls $1.20
*** FLOP *** [2s 9s Th]
PacPacBum: checks 
carrsseis: checks 
*** TURN *** [2s 9s Th] [7d]
PacPacBum: bets $4.02
carrsseis: raises $6.48 to $10.50
PacPacBum: folds 
Uncalled bet ($6.48) returned to carrsseis
carrsseis collected $13.50 from pot
carrsseis: doesn't show hand 
*** SUMMARY ***
Total pot $14.14 | Rake $0.64 
Board [2s 9s Th 7d]
Seat 2: florrin92 folded before Flop (didn't bet)
Seat 3: carrsseis (button) collected ($13.50)
Seat 5: matiko09 (small blind) folded before Flop
Seat 6: PacPacBum (big blind) folded on the Turn
Seat 7: $-Twackle-$ folded before Flop (didn't bet)
Seat 8: Muinmyheart folded before Flop (didn't bet)





PokerStars Hand #150802252902:  Hold'em No Limit ($0.50/$1.00 USD) - 2016/03/23 14:52:47 CET [2016/03/23 9:52:47 ET]
Table 'Merope II' 9-max Seat #7 is the button
Seat 1: Jimy Tiltman ($134.49 in chips) 
Seat 2: $-Twackle-$ ($101.50 in chips) 
Seat 3: pablos1922 ($92.31 in chips) 
Seat 4: YuriiSolodya ($83.84 in chips) 
Seat 6: Effort92 ($100.21 in chips) 
Seat 7: matiko09 ($104.53 in chips) 
Seat 8: Red4erT ($40.50 in chips) 
Seat 9: RICKA16 ($119.24 in chips) 
Red4erT: posts small blind $0.50
RICKA16: posts big blind $1
*** HOLE CARDS ***
Dealt to matiko09 [3h Qc]
Jimy Tiltman: raises $2 to $3
$-Twackle-$: folds 
pablos1922: folds 
YuriiSolodya: folds 
Effort92: folds 
YuriiSolodya leaves the table
matiko09: folds 
Red4erT: folds 
RICKA16: calls $2
*** FLOP *** [7s 4s 2c]
RICKA16: checks 
PacPacBum joins the table at seat #4 
Jimy Tiltman: bets $4
RICKA16: raises $8 to $12
Jimy Tiltman: folds 
Uncalled bet ($8) returned to RICKA16
RICKA16 collected $13.85 from pot
RICKA16: doesn't show hand 
*** SUMMARY ***
Total pot $14.50 | Rake $0.65 
Board [7s 4s 2c]
Seat 1: Jimy Tiltman folded on the Flop
Seat 2: $-Twackle-$ folded before Flop (didn't bet)
Seat 3: pablos1922 folded before Flop (didn't bet)
Seat 4: YuriiSolodya folded before Flop (didn't bet)
Seat 6: Effort92 folded before Flop (didn't bet)
Seat 7: matiko09 (button) folded before Flop (didn't bet)
Seat 8: Red4erT (small blind) folded before Flop
Seat 9: RICKA16 (big blind) collected ($13.85)





PokerStars Hand #150802253224:  Hold'em No Limit ($1/$2 USD) - 2016/03/23 14:52:47 CET [2016/03/23 9:52:47 ET]
Table 'Kypria II' 9-max Seat #3 is the button
Seat 1: geldwolfje ($127.65 in chips) 
Seat 2: coinflip_si ($200 in chips) 
Seat 3: seouljam ($255.72 in chips) 
Seat 4: VolanDog ($239.72 in chips) 
Seat 5: InsomniaRU ($364.50 in chips) 
Seat 6: matiko09 ($416.53 in chips) 
Seat 7: DUkalisUA ($200 in chips) 
Seat 8: nickreason17 ($200 in chips) 
Seat 9: sanrs57 ($198 in chips) 
VolanDog: posts small blind $1
InsomniaRU: posts big blind $2
*** HOLE CARDS ***
Dealt to matiko09 [5c Jd]
matiko09: folds 
DUkalisUA: folds 
nickreason17: folds 
sanrs57: folds 
geldwolfje: raises $2 to $4
coinflip_si: folds 
seouljam: calls $4
VolanDog: folds 
InsomniaRU: raises $16 to $20
geldwolfje said, "i know you are to good for me"
geldwolfje: folds 
seouljam: folds 
Uncalled bet ($16) returned to InsomniaRU
InsomniaRU collected $13 from pot
InsomniaRU: doesn't show hand 
*** SUMMARY ***
Total pot $13 | Rake $0 
Seat 1: geldwolfje folded before Flop
Seat 2: coinflip_si folded before Flop (didn't bet)
Seat 3: seouljam (button) folded before Flop
Seat 4: VolanDog (small blind) folded before Flop
Seat 5: InsomniaRU (big blind) collected ($13)
Seat 6: matiko09 folded before Flop (didn't bet)
Seat 7: DUkalisUA folded before Flop (didn't bet)
Seat 8: nickreason17 folded before Flop (didn't bet)
Seat 9: sanrs57 folded before Flop (didn't bet)





PokerStars Hand #150802255081:  Hold'em No Limit ($0.50/$1.00 USD) - 2016/03/23 14:52:50 CET [2016/03/23 9:52:50 ET]
Table 'Asmodeus' 9-max Seat #1 is the button
Seat 1: Jimy Tiltman ($100 in chips) 
Seat 2: $-Twackle-$ ($100 in chips) 
Seat 3: nickreason17 ($105.30 in chips) 
Seat 4: Effort92 ($101.26 in chips) 
Seat 6: florrin92 ($105 in chips) 
Seat 8: KEBIN1974 ($166.81 in chips) 
Seat 9: matiko09 ($103.89 in chips) 
$-Twackle-$: posts small blind $0.50
nickreason17: posts big blind $1
mycka86: sits out 
Jimy Tiltman: posts the ante $0.20
$-Twackle-$: posts the ante $0.20
nickreason17: posts the ante $0.20
Effort92: posts the ante $0.20
florrin92: posts the ante $0.20
KEBIN1974: posts the ante $0.20
matiko09: posts the ante $0.20
*** HOLE CARDS ***
Dealt to matiko09 [As 4s]
Effort92: folds 
florrin92: folds 
KEBIN1974: raises $2.50 to $3.50
matiko09: folds 
Jimy Tiltman: folds 
$-Twackle-$: folds 
nickreason17: folds 
Uncalled bet ($2.50) returned to KEBIN1974
KEBIN1974 collected $3.90 from pot
KEBIN1974: doesn't show hand 
*** SUMMARY ***
Total pot $3.90 | Rake $0 
Seat 1: Jimy Tiltman (button) folded before Flop (didn't bet)
Seat 2: $-Twackle-$ (small blind) folded before Flop
Seat 3: nickreason17 (big blind) folded before Flop
Seat 4: Effort92 folded before Flop (didn't bet)
Seat 6: florrin92 folded before Flop (didn't bet)
Seat 8: KEBIN1974 collected ($3.90)
Seat 9: matiko09 folded before Flop (didn't bet)





PokerStars Hand #150802255135:  Hold'em No Limit ($0.25/$0.50 USD) - 2016/03/23 14:52:50 CET [2016/03/23 9:52:50 ET]
Table 'Pyrrhus' 9-max Seat #1 is the button
Seat 1: lumen21 ($83.47 in chips) 
Seat 2: BSTUSim ($65.87 in chips) 
Seat 3: i L00K great ($50 in chips) 
Seat 4: GriffinBerg ($41.41 in chips) 
Seat 5: ZonTTT ($53.61 in chips) 
Seat 6: Ahangama ($50.75 in chips) 
Seat 7: matiko09 ($139.50 in chips) 
Seat 8: dndngod ($78.43 in chips) 
Seat 9: CvMCvMCvM ($90.13 in chips) 
BSTUSim: posts small blind $0.25
i L00K great: posts big blind $0.50
*** HOLE CARDS ***
Dealt to matiko09 [Kd 5c]
GriffinBerg: folds 
ZonTTT: folds 
Ahangama: folds 
matiko09: folds 
dndngod: folds 
CvMCvMCvM: folds 
lumen21: raises $0.62 to $1.12
BSTUSim: folds 
i L00K great: folds 
Uncalled bet ($0.62) returned to lumen21
lumen21 collected $1.25 from pot
lumen21: doesn't show hand 
*** SUMMARY ***
Total pot $1.25 | Rake $0 
Seat 1: lumen21 (button) collected ($1.25)
Seat 2: BSTUSim (small blind) folded before Flop
Seat 3: i L00K great (big blind) folded before Flop
Seat 4: GriffinBerg folded before Flop (didn't bet)
Seat 5: ZonTTT folded before Flop (didn't bet)
Seat 6: Ahangama folded before Flop (didn't bet)
Seat 7: matiko09 folded before Flop (didn't bet)
Seat 8: dndngod folded before Flop (didn't bet)
Seat 9: CvMCvMCvM folded before Flop (didn't bet)





PokerStars Hand #150802256344:  Hold'em No Limit ($0.50/$1.00 USD) - 2016/03/23 14:52:52 CET [2016/03/23 9:52:52 ET]
Table 'Drakonia II' 9-max Seat #4 is the button
Seat 1: chautinhtri9 ($100 in chips) 
Seat 2: carrsseis ($100 in chips) 
Seat 3: dunga119 ($100 in chips) 
Seat 4: nickreason17 ($100 in chips) 
Seat 5: gchs83 ($40 in chips) 
Seat 6: Dantist1122 ($100 in chips) 
Seat 7: YuriiSolodya ($40 in chips) 
Seat 8: matiko09 ($100 in chips) 
Seat 9: mycka86 ($100 in chips) 
gchs83: posts small blind $0.50
Dantist1122: posts big blind $1
*** HOLE CARDS ***
Dealt to matiko09 [3h Tc]
YuriiSolodya: folds 
matiko09: folds 
mycka86: folds 
chautinhtri9: folds 
carrsseis: raises $1.70 to $2.70
dunga119: folds 
nickreason17: folds 
gchs83: folds 
Dantist1122: folds 
Uncalled bet ($1.70) returned to carrsseis
carrsseis collected $2.50 from pot
carrsseis: doesn't show hand 
*** SUMMARY ***
Total pot $2.50 | Rake $0 
Seat 1: chautinhtri9 folded before Flop (didn't bet)
Seat 2: carrsseis collected ($2.50)
Seat 3: dunga119 folded before Flop (didn't bet)
Seat 4: nickreason17 (button) folded before Flop (didn't bet)
Seat 5: gchs83 (small blind) folded before Flop
Seat 6: Dantist1122 (big blind) folded before Flop
Seat 7: YuriiSolodya folded before Flop (didn't bet)
Seat 8: matiko09 folded before Flop (didn't bet)
Seat 9: mycka86 folded before Flop (didn't bet)





PokerStars Hand #150802258813:  Hold'em No Limit ($0.50/$1.00 USD) - 2016/03/23 14:52:57 CET [2016/03/23 9:52:57 ET]
Table 'Donar II' 9-max Seat #1 is the button
Seat 1: Effort92 ($120.71 in chips) 
Seat 4: DUkalisUA ($158.24 in chips) 
Seat 5: matiko09 ($130.44 in chips) 
Seat 8: $-Twackle-$ ($116.30 in chips) 
Seat 9: nickreason17 ($100 in chips) 
DUkalisUA: posts small blind $0.50
matiko09: posts big blind $1
Effort92: posts the ante $0.20
DUkalisUA: posts the ante $0.20
matiko09: posts the ante $0.20
$-Twackle-$: posts the ante $0.20
nickreason17: posts the ante $0.20
*** HOLE CARDS ***
Dealt to matiko09 [8s 7h]
$-Twackle-$: folds 
nickreason17: folds 
Effort92: raises $2 to $3
DUkalisUA: folds 
matiko09: folds 
Uncalled bet ($2) returned to Effort92
Effort92 collected $3.50 from pot
Effort92: doesn't show hand 
*** SUMMARY ***
Total pot $3.50 | Rake $0 
Seat 1: Effort92 (button) collected ($3.50)
Seat 4: DUkalisUA (small blind) folded before Flop
Seat 5: matiko09 (big blind) folded before Flop
Seat 8: $-Twackle-$ folded before Flop (didn't bet)
Seat 9: nickreason17 folded before Flop (didn't bet)





PokerStars Hand #150802260378:  Hold'em No Limit ($0.50/$1.00 USD) - 2016/03/23 14:52:59 CET [2016/03/23 9:52:59 ET]
Table 'Atlantis' 9-max Seat #8 is the button
Seat 1: xHourglass ($118 in chips) 
Seat 2: Szevasztopol ($107.78 in chips) 
Seat 3: CAJUN890 ($140.84 in chips) 
Seat 4: matiko09 ($142.61 in chips) 
Seat 5: Pvsx. ($111.22 in chips) 
Seat 7: Sherlockplay ($141.48 in chips) 
Seat 8: DUkalisUA ($153.14 in chips) 
Seat 9: RICKA16 ($95.16 in chips) 
RICKA16: posts small blind $0.50
xHourglass: posts big blind $1
PacPacBum: sits out 
*** HOLE CARDS ***
Dealt to matiko09 [Jd Qc]
Szevasztopol: folds 
CAJUN890: folds 
matiko09: folds 
Pvsx.: folds 
Sherlockplay: folds 
DUkalisUA: folds 
RICKA16: raises $2 to $3
xHourglass: folds 
Uncalled bet ($2) returned to RICKA16
RICKA16 collected $2 from pot
RICKA16: doesn't show hand 
*** SUMMARY ***
Total pot $2 | Rake $0 
Seat 1: xHourglass (big blind) folded before Flop
Seat 2: Szevasztopol folded before Flop (didn't bet)
Seat 3: CAJUN890 folded before Flop (didn't bet)
Seat 4: matiko09 folded before Flop (didn't bet)
Seat 5: Pvsx. folded before Flop (didn't bet)
Seat 7: Sherlockplay folded before Flop (didn't bet)
Seat 8: DUkalisUA (button) folded before Flop (didn't bet)
Seat 9: RICKA16 (small blind) collected ($2)





PokerStars Hand #150802262334:  Hold'em No Limit ($1/$2 USD) - 2016/03/23 14:53:03 CET [2016/03/23 9:53:03 ET]
Table 'Kiess' 9-max Seat #3 is the button
Seat 2: DUkalisUA ($708.28 in chips) 
Seat 3: Red4erT ($80 in chips) 
Seat 5: chippo boy ($420.14 in chips) 
Seat 6: matiko09 ($260.86 in chips) 
Seat 7: InsomniaRU ($334.21 in chips) 
Seat 8: erfk1958 ($130.42 in chips) 
Seat 9: T0ny Adams ($172.62 in chips) 
Igoriah will be allowed to play after the button
chippo boy: posts small blind $1
matiko09: posts big blind $2
*** HOLE CARDS ***
Dealt to matiko09 [5h Tc]
InsomniaRU: folds 
erfk1958: raises $2 to $4
T0ny Adams: folds 
DUkalisUA: folds 
Red4erT: folds 
chippo boy: calls $3
matiko09: folds 
*** FLOP *** [5d 8s 3c]
chippo boy: checks 
erfk1958: checks 
*** TURN *** [5d 8s 3c] [Jd]
chippo boy: bets $4
erfk1958: calls $4
*** RIVER *** [5d 8s 3c Jd] [Jc]
chippo boy: checks 
erfk1958: checks 
*** SHOW DOWN ***
chippo boy: shows [As 2s] (a pair of Jacks)
erfk1958: shows [6s 6h] (two pair, Jacks and Sixes)
erfk1958 collected $17.19 from pot
*** SUMMARY ***
Total pot $18 | Rake $0.81 
Board [5d 8s 3c Jd Jc]
Seat 2: DUkalisUA folded before Flop (didn't bet)
Seat 3: Red4erT (button) folded before Flop (didn't bet)
Seat 5: chippo boy (small blind) showed [As 2s] and lost with a pair of Jacks
Seat 6: matiko09 (big blind) folded before Flop
Seat 7: InsomniaRU folded before Flop (didn't bet)
Seat 8: erfk1958 showed [6s 6h] and won ($17.19) with two pair, Jacks and Sixes
Seat 9: T0ny Adams folded before Flop (didn't bet)





PokerStars Hand #150802269759:  Hold'em No Limit ($0.50/$1.00 USD) - 2016/03/23 14:53:15 CET [2016/03/23 9:53:15 ET]
Table 'Donar II' 9-max Seat #4 is the button
Seat 1: Effort92 ($123.01 in chips) 
Seat 4: DUkalisUA ($157.54 in chips) 
Seat 5: matiko09 ($129.24 in chips) 
Seat 9: nickreason17 ($100 in chips) 
matiko09: posts small blind $0.50
$-Twackle-$: is sitting out 
nickreason17: posts big blind $1
Effort92: posts the ante $0.20
DUkalisUA: posts the ante $0.20
matiko09: posts the ante $0.20
nickreason17: posts the ante $0.20
*** HOLE CARDS ***
Dealt to matiko09 [2c Th]
$-Twackle-$ leaves the table
Effort92: raises $2 to $3
DUkalisUA: raises $5.50 to $8.50
matiko09: folds 
nickreason17: folds 
Effort92: calls $5.50
*** FLOP *** [8c 8s 3c]
Effort92: checks 
DUkalisUA: bets $10.13
carrsseis joins the table at seat #8 
Effort92: calls $10.13
*** TURN *** [8c 8s 3c] [7c]
Effort92: checks 
DUkalisUA: checks 
*** RIVER *** [8c 8s 3c 7c] [Ah]
Effort92: checks 
DUkalisUA: checks 
*** SHOW DOWN ***
Effort92: shows [Ts Td] (two pair, Tens and Eights)
DUkalisUA: mucks hand 
Effort92 collected $38.06 from pot
*** SUMMARY ***
Total pot $39.56 | Rake $1.50 
Board [8c 8s 3c 7c Ah]
Seat 1: Effort92 showed [Ts Td] and won ($38.06) with two pair, Tens and Eights
Seat 4: DUkalisUA (button) mucked [7s 6s]
Seat 5: matiko09 (small blind) folded before Flop
Seat 9: nickreason17 (big blind) folded before Flop





PokerStars Hand #150802270791:  Hold'em No Limit ($0.50/$1.00 USD) - 2016/03/23 14:53:17 CET [2016/03/23 9:53:17 ET]
Table 'Atlantis' 9-max Seat #9 is the button
Seat 1: xHourglass ($117 in chips) 
Seat 2: Szevasztopol ($107.78 in chips) 
Seat 3: CAJUN890 ($140.84 in chips) 
Seat 4: matiko09 ($142.61 in chips) 
Seat 5: Pvsx. ($111.22 in chips) 
Seat 7: Sherlockplay ($141.48 in chips) 
Seat 8: DUkalisUA ($153.14 in chips) 
Seat 9: RICKA16 ($96.16 in chips) 
xHourglass: posts small blind $0.50
Szevasztopol: posts big blind $1
PacPacBum: sits out 
*** HOLE CARDS ***
Dealt to matiko09 [Ah 5c]
CAJUN890: folds 
matiko09: folds 
Pvsx.: folds 
Sherlockplay: folds 
DUkalisUA: folds 
RICKA16: folds 
xHourglass: folds 
Uncalled bet ($0.50) returned to Szevasztopol
Szevasztopol collected $1 from pot
Szevasztopol: doesn't show hand 
*** SUMMARY ***
Total pot $1 | Rake $0 
Seat 1: xHourglass (small blind) folded before Flop
Seat 2: Szevasztopol (big blind) collected ($1)
Seat 3: CAJUN890 folded before Flop (didn't bet)
Seat 4: matiko09 folded before Flop (didn't bet)
Seat 5: Pvsx. folded before Flop (didn't bet)
Seat 7: Sherlockplay folded before Flop (didn't bet)
Seat 8: DUkalisUA folded before Flop (didn't bet)
Seat 9: RICKA16 (button) folded before Flop (didn't bet)





PokerStars Hand #150802274168:  Hold'em No Limit (€0.50/€1.00 EUR) - 2016/03/23 14:53:23 CET [2016/03/23 9:53:23 ET]
Table 'Mercury III' 9-max Seat #8 is the button
Seat 1: matiko09 (€100 in chips) 
Seat 2: o.miro (€117.27 in chips) 
Seat 3: PacPacBum (€102.33 in chips) 
Seat 4: florrin92 (€101.36 in chips) 
Seat 5: nickreason17 (€120.86 in chips) 
Seat 6: mycka86 (€100 in chips) 
Seat 7: $-Twackle-$ (€141.67 in chips) 
Seat 8: gfxed (€31.50 in chips) 
Seat 9: Indr3k (€100 in chips) 
Indr3k: posts small blind €0.50
matiko09: posts big blind €1
*** HOLE CARDS ***
Dealt to matiko09 [6d Qh]
o.miro: folds 
PacPacBum: folds 
florrin92: folds 
nickreason17: folds 
mycka86: folds 
$-Twackle-$: folds 
gfxed: raises €1.23 to €2.23
Indr3k: folds 
matiko09: folds 
Uncalled bet (€1.23) returned to gfxed
gfxed collected €2.50 from pot
*** SUMMARY ***
Total pot €2.50 | Rake €0 
Seat 1: matiko09 (big blind) folded before Flop
Seat 2: o.miro folded before Flop (didn't bet)
Seat 3: PacPacBum folded before Flop (didn't bet)
Seat 4: florrin92 folded before Flop (didn't bet)
Seat 5: nickreason17 folded before Flop (didn't bet)
Seat 6: mycka86 folded before Flop (didn't bet)
Seat 7: $-Twackle-$ folded before Flop (didn't bet)
Seat 8: gfxed (button) collected (€2.50)
Seat 9: Indr3k (small blind) folded before Flop





PokerStars Hand #150802275642:  Hold'em No Limit ($0.50/$1.00 USD) - 2016/03/23 14:53:25 CET [2016/03/23 9:53:25 ET]
Table 'Swings' 9-max Seat #6 is the button
Seat 3: maxxmeister ($100 in chips) 
Seat 5: chautinhtri9 ($120.95 in chips) 
Seat 6: matiko09 ($126.43 in chips) 
Seat 7: PacPacBum ($111.49 in chips) 
Seat 8: RICKA16 ($106.46 in chips) 
Seat 9: Vlad_1965_77 ($113.63 in chips) 
PacPacBum: posts small blind $0.50
RICKA16: posts big blind $1
carrsseis: sits out 
tomver0809: sits out 
*** HOLE CARDS ***
Dealt to matiko09 [9h 7h]
Vlad_1965_77: raises $2 to $3
maxxmeister: calls $3
chautinhtri9: folds 
matiko09: folds 
PacPacBum: folds 
RICKA16: folds 
*** FLOP *** [Jd 6s 3d]
Vlad_1965_77: bets $3.58
maxxmeister: calls $3.58
*** TURN *** [Jd 6s 3d] [Kh]
Vlad_1965_77: bets $7
maxxmeister: folds 
Uncalled bet ($7) returned to Vlad_1965_77
Vlad_1965_77 collected $14 from pot
*** SUMMARY ***
Total pot $14.66 | Rake $0.66 
Board [Jd 6s 3d Kh]
Seat 3: maxxmeister folded on the Turn
Seat 5: chautinhtri9 folded before Flop (didn't bet)
Seat 6: matiko09 (button) folded before Flop (didn't bet)
Seat 7: PacPacBum (small blind) folded before Flop
Seat 8: RICKA16 (big blind) folded before Flop
Seat 9: Vlad_1965_77 collected ($14)





PokerStars Hand #150802276240:  Hold'em No Limit ($0.25/$0.50 USD) - 2016/03/23 14:53:26 CET [2016/03/23 9:53:26 ET]
Table 'Pyrrhus' 9-max Seat #2 is the button
Seat 1: lumen21 ($84.22 in chips) 
Seat 2: BSTUSim ($65.62 in chips) 
Seat 3: i L00K great ($50 in chips) 
Seat 4: GriffinBerg ($41.41 in chips) 
Seat 5: ZonTTT ($53.61 in chips) 
Seat 6: Ahangama ($50.75 in chips) 
Seat 7: matiko09 ($139.50 in chips) 
Seat 8: dndngod ($78.43 in chips) 
Seat 9: CvMCvMCvM ($90.13 in chips) 
i L00K great: posts small blind $0.25
GriffinBerg: posts big blind $0.50
*** HOLE CARDS ***
Dealt to matiko09 [5c Kd]
ZonTTT: raises $1 to $1.50
Ahangama: folds 
matiko09: folds 
dndngod: folds 
CvMCvMCvM: folds 
lumen21: folds 
BSTUSim: folds 
i L00K great: folds 
GriffinBerg: folds 
Uncalled bet ($1) returned to ZonTTT
ZonTTT collected $1.25 from pot
ZonTTT: doesn't show hand 
*** SUMMARY ***
Total pot $1.25 | Rake $0 
Seat 1: lumen21 folded before Flop (didn't bet)
Seat 2: BSTUSim (button) folded before Flop (didn't bet)
Seat 3: i L00K great (small blind) folded before Flop
Seat 4: GriffinBerg (big blind) folded before Flop
Seat 5: ZonTTT collected ($1.25)
Seat 6: Ahangama folded before Flop (didn't bet)
Seat 7: matiko09 folded before Flop (didn't bet)
Seat 8: dndngod folded before Flop (didn't bet)
Seat 9: CvMCvMCvM folded before Flop (didn't bet)





PokerStars Hand #150802278823:  Hold'em No Limit ($1/$2 USD) - 2016/03/23 14:53:30 CET [2016/03/23 9:53:30 ET]
Table 'Kypria II' 9-max Seat #4 is the button
Seat 1: geldwolfje ($123.65 in chips) 
Seat 2: coinflip_si ($200 in chips) 
Seat 3: seouljam ($251.72 in chips) 
Seat 4: VolanDog ($238.72 in chips) 
Seat 5: InsomniaRU ($373.50 in chips) 
Seat 6: matiko09 ($416.53 in chips) 
Seat 7: DUkalisUA ($200 in chips) 
Seat 8: nickreason17 ($200 in chips) 
Seat 9: sanrs57 ($198 in chips) 
InsomniaRU: posts small blind $1
matiko09: posts big blind $2
*** HOLE CARDS ***
Dealt to matiko09 [6h Qd]
DUkalisUA has timed out
DUkalisUA: folds 
nickreason17: folds 
sanrs57: folds 
geldwolfje: raises $2 to $4
coinflip_si: folds 
seouljam: calls $4
VolanDog: folds 
InsomniaRU: folds 
matiko09: folds 
*** FLOP *** [8d Qh 5h]
geldwolfje: checks 
seouljam: checks 
*** TURN *** [8d Qh 5h] [Jc]
geldwolfje: checks 
seouljam: checks 
*** RIVER *** [8d Qh 5h Jc] [4h]
geldwolfje: checks 
seouljam: bets $8
geldwolfje: raises $22 to $30
seouljam: calls $22
*** SHOW DOWN ***
geldwolfje: shows [Tc 7c] (high card Queen)
seouljam: shows [Qc Jh] (two pair, Queens and Jacks)
seouljam collected $68.20 from pot
*** SUMMARY ***
Total pot $71 | Rake $2.80 
Board [8d Qh 5h Jc 4h]
Seat 1: geldwolfje showed [Tc 7c] and lost with high card Queen
Seat 2: coinflip_si folded before Flop (didn't bet)
Seat 3: seouljam showed [Qc Jh] and won ($68.20) with two pair, Queens and Jacks
Seat 4: VolanDog (button) folded before Flop (didn't bet)
Seat 5: InsomniaRU (small blind) folded before Flop
Seat 6: matiko09 (big blind) folded before Flop
Seat 7: DUkalisUA folded before Flop (didn't bet)
Seat 8: nickreason17 folded before Flop (didn't bet)
Seat 9: sanrs57 folded before Flop (didn't bet)





PokerStars Hand #150802279017:  Hold'em No Limit ($1/$2 USD) - 2016/03/23 14:53:30 CET [2016/03/23 9:53:30 ET]
Table 'Achaia' 9-max Seat #8 is the button
Seat 2: InsomniaRU ($245.13 in chips) 
Seat 3: matiko09 ($237.16 in chips) 
Seat 4: erfk1958 ($105 in chips) 
Seat 6: nickreason17 ($280.35 in chips) 
Seat 7: morosun ($153.64 in chips) 
Seat 8: $-Twackle-$ ($252.27 in chips) 
Seat 9: PacPacBum ($200 in chips) 
PacPacBum: posts small blind $1
Moszes360: is sitting out 
Moszes360 leaves the table
InsomniaRU: posts big blind $2
*** HOLE CARDS ***
Dealt to matiko09 [Qs 8h]
matiko09: folds 
erfk1958: folds 
nickreason17: folds 
morosun: raises $4 to $6
$-Twackle-$: folds 
PacPacBum: folds 
InsomniaRU: folds 
Uncalled bet ($4) returned to morosun
morosun collected $5 from pot
*** SUMMARY ***
Total pot $5 | Rake $0 
Seat 2: InsomniaRU (big blind) folded before Flop
Seat 3: matiko09 folded before Flop (didn't bet)
Seat 4: erfk1958 folded before Flop (didn't bet)
Seat 6: nickreason17 folded before Flop (didn't bet)
Seat 7: morosun collected ($5)
Seat 8: $-Twackle-$ (button) folded before Flop (didn't bet)
Seat 9: PacPacBum (small blind) folded before Flop





PokerStars Hand #150802280125:  Hold'em No Limit ($1/$2 USD) - 2016/03/23 14:53:32 CET [2016/03/23 9:53:32 ET]
Table 'Herba II' 9-max Seat #8 is the button
Seat 1: matiko09 ($244.18 in chips) 
Seat 2: Moszes360 ($200 in chips) 
Seat 4: DUkalisUA ($400.40 in chips) 
Seat 5: chippo boy ($271.31 in chips) 
Seat 6: Too-Anti-To ($225.38 in chips) 
Seat 7: InsomniaRU ($408.70 in chips) 
Seat 8: T0ny Adams ($77 in chips) 
Seat 9: mrhighryza ($51.44 in chips) 
mrhighryza: posts small blind $1
matiko09: posts big blind $2
*** HOLE CARDS ***
Dealt to matiko09 [Kd Jd]
Moszes360: folds 
Moszes360 leaves the table
nickreason17 joins the table at seat #2 
DUkalisUA: folds 
chippo boy: calls $2
Too-Anti-To: folds 
InsomniaRU: folds 
T0ny Adams: folds 
mrhighryza: calls $1
matiko09: raises $8 to $10
chippo boy: calls $8
mrhighryza: folds 
*** FLOP *** [Jh 3d 9c]
matiko09: bets $12
chippo boy: calls $12
*** TURN *** [Jh 3d 9c] [6c]
matiko09: bets $26
chippo boy: calls $26
*** RIVER *** [Jh 3d 9c 6c] [Kh]
matiko09: bets $64
chippo boy: folds 
Uncalled bet ($64) returned to matiko09
matiko09 collected $95.20 from pot
matiko09: doesn't show hand 
*** SUMMARY ***
Total pot $98 | Rake $2.80 
Board [Jh 3d 9c 6c Kh]
Seat 1: matiko09 (big blind) collected ($95.20)
Seat 2: Moszes360 folded before Flop (didn't bet)
Seat 4: DUkalisUA folded before Flop (didn't bet)
Seat 5: chippo boy folded on the River
Seat 6: Too-Anti-To folded before Flop (didn't bet)
Seat 7: InsomniaRU folded before Flop (didn't bet)
Seat 8: T0ny Adams (button) folded before Flop (didn't bet)
Seat 9: mrhighryza (small blind) folded before Flop





PokerStars Hand #150802288944:  Hold'em No Limit ($0.50/$1.00 USD) - 2016/03/23 14:53:47 CET [2016/03/23 9:53:47 ET]
Table 'Asmodeus' 9-max Seat #2 is the button
Seat 1: Jimy Tiltman ($100 in chips) 
Seat 2: $-Twackle-$ ($100 in chips) 
Seat 3: nickreason17 ($104.10 in chips) 
Seat 4: Effort92 ($101.06 in chips) 
Seat 6: florrin92 ($104.80 in chips) 
Seat 8: KEBIN1974 ($169.51 in chips) 
Seat 9: matiko09 ($103.69 in chips) 
nickreason17: posts small blind $0.50
Effort92: posts big blind $1
mycka86: sits out 
Jimy Tiltman: posts the ante $0.20
$-Twackle-$: posts the ante $0.20
nickreason17: posts the ante $0.20
Effort92: posts the ante $0.20
florrin92: posts the ante $0.20
KEBIN1974: posts the ante $0.20
matiko09: posts the ante $0.20
*** HOLE CARDS ***
Dealt to matiko09 [9c Td]
florrin92: folds 
KEBIN1974: raises $2.50 to $3.50
matiko09: folds 
Jimy Tiltman: folds 
$-Twackle-$: folds 
nickreason17: folds 
Effort92: folds 
Uncalled bet ($2.50) returned to KEBIN1974
KEBIN1974 collected $3.90 from pot
KEBIN1974: doesn't show hand 
*** SUMMARY ***
Total pot $3.90 | Rake $0 
Seat 1: Jimy Tiltman folded before Flop (didn't bet)
Seat 2: $-Twackle-$ (button) folded before Flop (didn't bet)
Seat 3: nickreason17 (small blind) folded before Flop
Seat 4: Effort92 (big blind) folded before Flop
Seat 6: florrin92 folded before Flop (didn't bet)
Seat 8: KEBIN1974 collected ($3.90)
Seat 9: matiko09 folded before Flop (didn't bet)





PokerStars Hand #150802291408:  Hold'em No Limit ($0.50/$1.00 USD) - 2016/03/23 14:53:51 CET [2016/03/23 9:53:51 ET]
Table 'Merope II' 9-max Seat #8 is the button
Seat 1: Jimy Tiltman ($127.49 in chips) 
Seat 2: $-Twackle-$ ($101.50 in chips) 
Seat 3: pablos1922 ($92.31 in chips) 
Seat 6: Effort92 ($100.21 in chips) 
Seat 7: matiko09 ($104.53 in chips) 
Seat 8: Red4erT ($40 in chips) 
Seat 9: RICKA16 ($126.09 in chips) 
RICKA16: posts small blind $0.50
Jimy Tiltman: posts big blind $1
PacPacBum: sits out 
*** HOLE CARDS ***
Dealt to matiko09 [9c Td]
$-Twackle-$: folds 
pablos1922: raises $1 to $2
Effort92: folds 
matiko09: folds 
Red4erT: folds 
RICKA16: folds 
Jimy Tiltman: calls $1
*** FLOP *** [5c 2s Th]
Jimy Tiltman: checks 
pablos1922: checks 
*** TURN *** [5c 2s Th] [Ks]
Jimy Tiltman: bets $2.50
pablos1922: folds 
Uncalled bet ($2.50) returned to Jimy Tiltman
Jimy Tiltman collected $4.30 from pot
Jimy Tiltman: doesn't show hand 
*** SUMMARY ***
Total pot $4.50 | Rake $0.20 
Board [5c 2s Th Ks]
Seat 1: Jimy Tiltman (big blind) collected ($4.30)
Seat 2: $-Twackle-$ folded before Flop (didn't bet)
Seat 3: pablos1922 folded on the Turn
Seat 6: Effort92 folded before Flop (didn't bet)
Seat 7: matiko09 folded before Flop (didn't bet)
Seat 8: Red4erT (button) folded before Flop (didn't bet)
Seat 9: RICKA16 (small blind) folded before Flop





PokerStars Hand #150802292634:  Hold'em No Limit ($1/$2 USD) - 2016/03/23 14:53:53 CET [2016/03/23 9:53:53 ET]
Table 'Achaia' 9-max Seat #9 is the button
Seat 2: InsomniaRU ($243.13 in chips) 
Seat 3: matiko09 ($237.16 in chips) 
Seat 4: erfk1958 ($105 in chips) 
Seat 6: nickreason17 ($280.35 in chips) 
Seat 7: morosun ($156.64 in chips) 
Seat 8: $-Twackle-$ ($252.27 in chips) 
Seat 9: PacPacBum ($200 in chips) 
InsomniaRU: posts small blind $1
matiko09: posts big blind $2
*** HOLE CARDS ***
Dealt to matiko09 [7c Js]
erfk1958: raises $2 to $4
nickreason17: folds 
DUkalisUA joins the table at seat #1 
morosun: calls $4
$-Twackle-$: folds 
PacPacBum: folds 
InsomniaRU: folds 
matiko09: folds 
*** FLOP *** [2h 7s Jc]
erfk1958: checks 
morosun: bets $4
erfk1958: calls $4
*** TURN *** [2h 7s Jc] [4c]
erfk1958: checks 
morosun: bets $6
DUkalisUA leaves the table
erfk1958: folds 
Uncalled bet ($6) returned to morosun
morosun collected $18.14 from pot
*** SUMMARY ***
Total pot $19 | Rake $0.86 
Board [2h 7s Jc 4c]
Seat 2: InsomniaRU (small blind) folded before Flop
Seat 3: matiko09 (big blind) folded before Flop
Seat 4: erfk1958 folded on the Turn
Seat 6: nickreason17 folded before Flop (didn't bet)
Seat 7: morosun collected ($18.14)
Seat 8: $-Twackle-$ folded before Flop (didn't bet)
Seat 9: PacPacBum (button) folded before Flop (didn't bet)





PokerStars Hand #150802297400:  Hold'em No Limit ($1/$2 USD) - 2016/03/23 14:54:01 CET [2016/03/23 9:54:01 ET]
Table 'Kiess' 9-max Seat #5 is the button
Seat 2: DUkalisUA ($708.28 in chips) 
Seat 3: Red4erT ($80 in chips) 
Seat 5: chippo boy ($412.14 in chips) 
Seat 6: matiko09 ($258.86 in chips) 
Seat 7: InsomniaRU ($334.21 in chips) 
Seat 8: erfk1958 ($139.61 in chips) 
Seat 9: T0ny Adams ($172.62 in chips) 
matiko09: posts small blind $1
InsomniaRU: posts big blind $2
Igoriah: sits out 
*** HOLE CARDS ***
Dealt to matiko09 [Td 5d]
erfk1958: raises $2 to $4
T0ny Adams: folds 
DUkalisUA: folds 
Red4erT: folds 
chippo boy: folds 
matiko09: folds 
InsomniaRU: calls $2
*** FLOP *** [Kh 2d 2c]
InsomniaRU: checks 
erfk1958: bets $4
InsomniaRU: folds 
Uncalled bet ($4) returned to erfk1958
erfk1958 collected $8.60 from pot
erfk1958: doesn't show hand 
*** SUMMARY ***
Total pot $9 | Rake $0.40 
Board [Kh 2d 2c]
Seat 2: DUkalisUA folded before Flop (didn't bet)
Seat 3: Red4erT folded before Flop (didn't bet)
Seat 5: chippo boy (button) folded before Flop (didn't bet)
Seat 6: matiko09 (small blind) folded before Flop
Seat 7: InsomniaRU (big blind) folded on the Flop
Seat 8: erfk1958 collected ($8.60)
Seat 9: T0ny Adams folded before Flop (didn't bet)





PokerStars Hand #150802298304:  Hold'em No Limit (€0.50/€1.00 EUR) - 2016/03/23 14:54:02 CET [2016/03/23 9:54:02 ET]
Table 'Mercury III' 9-max Seat #9 is the button
Seat 1: matiko09 (€100 in chips) 
Seat 2: o.miro (€117.27 in chips) 
Seat 3: PacPacBum (€102.33 in chips) 
Seat 4: florrin92 (€101.36 in chips) 
Seat 5: nickreason17 (€120.86 in chips) 
Seat 6: mycka86 (€100 in chips) 
Seat 7: $-Twackle-$ (€141.67 in chips) 
Seat 8: gfxed (€33 in chips) 
Seat 9: Indr3k (€100 in chips) 
matiko09: posts small blind €0.50
o.miro: posts big blind €1
*** HOLE CARDS ***
Dealt to matiko09 [Kd 9d]
PacPacBum: folds 
florrin92: folds 
nickreason17: folds 
mycka86: folds 
$-Twackle-$: folds 
gfxed: folds 
Indr3k: raises €1.50 to €2.50
matiko09: folds 
o.miro: folds 
Uncalled bet (€1.50) returned to Indr3k
Indr3k collected €2.50 from pot
Indr3k: doesn't show hand 
*** SUMMARY ***
Total pot €2.50 | Rake €0 
Seat 1: matiko09 (small blind) folded before Flop
Seat 2: o.miro (big blind) folded before Flop
Seat 3: PacPacBum folded before Flop (didn't bet)
Seat 4: florrin92 folded before Flop (didn't bet)
Seat 5: nickreason17 folded before Flop (didn't bet)
Seat 6: mycka86 folded before Flop (didn't bet)
Seat 7: $-Twackle-$ folded before Flop (didn't bet)
Seat 8: gfxed folded before Flop (didn't bet)
Seat 9: Indr3k (button) collected (€2.50)





PokerStars Hand #150802300181:  Hold'em No Limit ($0.25/$0.50 USD) - 2016/03/23 14:54:05 CET [2016/03/23 9:54:05 ET]
Table 'Pyrrhus' 9-max Seat #3 is the button
Seat 1: lumen21 ($84.22 in chips) 
Seat 2: BSTUSim ($65.62 in chips) 
Seat 3: i L00K great ($50 in chips) 
Seat 4: GriffinBerg ($40.91 in chips) 
Seat 5: ZonTTT ($54.36 in chips) 
Seat 6: Ahangama ($50.75 in chips) 
Seat 7: matiko09 ($139.50 in chips) 
Seat 8: dndngod ($78.43 in chips) 
Seat 9: CvMCvMCvM ($90.13 in chips) 
GriffinBerg: posts small blind $0.25
ZonTTT: posts big blind $0.50
*** HOLE CARDS ***
Dealt to matiko09 [8h 4c]
Ahangama: folds 
matiko09: folds 
dndngod: folds 
CvMCvMCvM: folds 
lumen21: folds 
BSTUSim: folds 
i L00K great: raises $0.50 to $1
GriffinBerg: folds 
ZonTTT: calls $0.50
*** FLOP *** [8c 6s 9h]
ZonTTT: checks 
i L00K great: bets $1.41
ZonTTT: calls $1.41
*** TURN *** [8c 6s 9h] [7c]
ZonTTT: checks 
i L00K great: bets $3.19
ZonTTT: calls $3.19
*** RIVER *** [8c 6s 9h 7c] [Td]
ZonTTT: checks 
i L00K great: checks 
*** SHOW DOWN ***
ZonTTT: shows [9c Kc] (a straight, Six to Ten)
i L00K great: shows [Ac Tc] (a straight, Six to Ten)
ZonTTT collected $5.47 from pot
i L00K great collected $5.46 from pot
*** SUMMARY ***
Total pot $11.45 | Rake $0.52 
Board [8c 6s 9h 7c Td]
Seat 1: lumen21 folded before Flop (didn't bet)
Seat 2: BSTUSim folded before Flop (didn't bet)
Seat 3: i L00K great (button) showed [Ac Tc] and won ($5.46) with a straight, Six to Ten
Seat 4: GriffinBerg (small blind) folded before Flop
Seat 5: ZonTTT (big blind) showed [9c Kc] and won ($5.47) with a straight, Six to Ten
Seat 6: Ahangama folded before Flop (didn't bet)
Seat 7: matiko09 folded before Flop (didn't bet)
Seat 8: dndngod folded before Flop (didn't bet)
Seat 9: CvMCvMCvM folded before Flop (didn't bet)





PokerStars Hand #150802301712:  Hold'em No Limit ($0.50/$1.00 USD) - 2016/03/23 14:54:08 CET [2016/03/23 9:54:08 ET]
Table 'Swings' 9-max Seat #7 is the button
Seat 3: maxxmeister ($100 in chips) 
Seat 5: chautinhtri9 ($120.95 in chips) 
Seat 6: matiko09 ($126.43 in chips) 
Seat 7: PacPacBum ($110.99 in chips) 
Seat 8: RICKA16 ($105.46 in chips) 
Seat 9: Vlad_1965_77 ($121.05 in chips) 
RICKA16: posts small blind $0.50
Vlad_1965_77: posts big blind $1
carrsseis: sits out 
tomver0809: sits out 
*** HOLE CARDS ***
Dealt to matiko09 [5h 8d]
maxxmeister: folds 
chautinhtri9: folds 
matiko09: folds 
PacPacBum: folds 
RICKA16: folds 
Uncalled bet ($0.50) returned to Vlad_1965_77
Vlad_1965_77 collected $1 from pot
*** SUMMARY ***
Total pot $1 | Rake $0 
Seat 3: maxxmeister folded before Flop (didn't bet)
Seat 5: chautinhtri9 folded before Flop (didn't bet)
Seat 6: matiko09 folded before Flop (didn't bet)
Seat 7: PacPacBum (button) folded before Flop (didn't bet)
Seat 8: RICKA16 (small blind) folded before Flop
Seat 9: Vlad_1965_77 (big blind) collected ($1)





PokerStars Hand #150802305861:  Hold'em No Limit ($0.50/$1.00 USD) - 2016/03/23 14:54:15 CET [2016/03/23 9:54:15 ET]
Table 'Sylvia III' 9-max Seat #5 is the button
Seat 1: mycka86 ($100 in chips) 
Seat 2: florrin92 ($100 in chips) 
Seat 3: carrsseis ($93.72 in chips) 
Seat 5: matiko09 ($100.80 in chips) 
Seat 6: PacPacBum ($102.48 in chips) 
PacPacBum: posts small blind $0.50
$-Twackle-$: is sitting out 
$-Twackle-$ leaves the table
Muinmyheart: is sitting out 
mycka86: posts big blind $1
mycka86: posts the ante $0.20
florrin92: posts the ante $0.20
carrsseis: posts the ante $0.20
matiko09: posts the ante $0.20
PacPacBum: posts the ante $0.20
*** HOLE CARDS ***
Dealt to matiko09 [8h Qc]
florrin92: raises $2 to $3
carrsseis: folds 
matiko09: folds 
PacPacBum: folds 
mycka86: folds 
Uncalled bet ($2) returned to florrin92
florrin92 collected $3.50 from pot
florrin92: doesn't show hand 
*** SUMMARY ***
Total pot $3.50 | Rake $0 
Seat 1: mycka86 (big blind) folded before Flop
Seat 2: florrin92 collected ($3.50)
Seat 3: carrsseis folded before Flop (didn't bet)
Seat 5: matiko09 (button) folded before Flop (didn't bet)
Seat 6: PacPacBum (small blind) folded before Flop





PokerStars Hand #150802308946:  Hold'em No Limit ($0.50/$1.00 USD) - 2016/03/23 14:54:20 CET [2016/03/23 9:54:20 ET]
Table 'Asmodeus' 9-max Seat #3 is the button
Seat 1: Jimy Tiltman ($100 in chips) 
Seat 2: $-Twackle-$ ($100 in chips) 
Seat 3: nickreason17 ($103.40 in chips) 
Seat 4: Effort92 ($100 in chips) 
Seat 6: florrin92 ($104.60 in chips) 
Seat 8: KEBIN1974 ($172.21 in chips) 
Seat 9: matiko09 ($103.49 in chips) 
Effort92: posts small blind $0.50
florrin92: posts big blind $1
mycka86: sits out 
Jimy Tiltman: posts the ante $0.20
$-Twackle-$: posts the ante $0.20
nickreason17: posts the ante $0.20
Effort92: posts the ante $0.20
florrin92: posts the ante $0.20
KEBIN1974: posts the ante $0.20
matiko09: posts the ante $0.20
*** HOLE CARDS ***
Dealt to matiko09 [7d 2s]
KEBIN1974: folds 
KEBIN1974 leaves the table
matiko09: folds 
Jimy Tiltman: raises $1.50 to $2.50
$-Twackle-$: calls $2.50
nickreason17: folds 
Effort92: folds 
florrin92: folds 
*** FLOP *** [Ts Td 4d]
Jimy Tiltman: bets $4.88
$-Twackle-$: calls $4.88
*** TURN *** [Ts Td 4d] [9c]
Jimy Tiltman: bets $11
$-Twackle-$: folds 
Uncalled bet ($11) returned to Jimy Tiltman
Jimy Tiltman collected $16.87 from pot
Jimy Tiltman: doesn't show hand 
*** SUMMARY ***
Total pot $17.66 | Rake $0.79 
Board [Ts Td 4d 9c]
Seat 1: Jimy Tiltman collected ($16.87)
Seat 2: $-Twackle-$ folded on the Turn
Seat 3: nickreason17 (button) folded before Flop (didn't bet)
Seat 4: Effort92 (small blind) folded before Flop
Seat 6: florrin92 (big blind) folded before Flop
Seat 8: KEBIN1974 folded before Flop (didn't bet)
Seat 9: matiko09 folded before Flop (didn't bet)





PokerStars Hand #150802311497:  Hold'em No Limit ($1/$2 USD) - 2016/03/23 14:54:24 CET [2016/03/23 9:54:24 ET]
Table 'Kypria II' 9-max Seat #5 is the button
Seat 1: geldwolfje ($89.65 in chips) 
Seat 2: coinflip_si ($200 in chips) 
Seat 3: seouljam ($285.92 in chips) 
Seat 4: VolanDog ($238.72 in chips) 
Seat 5: InsomniaRU ($372.50 in chips) 
Seat 6: matiko09 ($414.53 in chips) 
Seat 7: DUkalisUA ($200 in chips) 
Seat 8: nickreason17 ($200 in chips) 
Seat 9: sanrs57 ($198 in chips) 
matiko09: posts small blind $1
DUkalisUA: posts big blind $2
*** HOLE CARDS ***
Dealt to matiko09 [Qd Jh]
nickreason17: folds 
seouljam said, "lol"
sanrs57: folds 
geldwolfje: folds 
coinflip_si: folds 
geldwolfje said, "yess"
seouljam said, "camon now"
seouljam: folds 
VolanDog: folds 
InsomniaRU: raises $3 to $5
matiko09: folds 
DUkalisUA: folds 
Uncalled bet ($3) returned to InsomniaRU
InsomniaRU collected $5 from pot
InsomniaRU: doesn't show hand 
*** SUMMARY ***
Total pot $5 | Rake $0 
Seat 1: geldwolfje folded before Flop (didn't bet)
Seat 2: coinflip_si folded before Flop (didn't bet)
Seat 3: seouljam folded before Flop (didn't bet)
Seat 4: VolanDog folded before Flop (didn't bet)
Seat 5: InsomniaRU (button) collected ($5)
Seat 6: matiko09 (small blind) folded before Flop
Seat 7: DUkalisUA (big blind) folded before Flop
Seat 8: nickreason17 folded before Flop (didn't bet)
Seat 9: sanrs57 folded before Flop (didn't bet)





PokerStars Hand #150802314202:  Hold'em No Limit ($0.50/$1.00 USD) - 2016/03/23 14:54:29 CET [2016/03/23 9:54:29 ET]
Table 'Swings' 9-max Seat #8 is the button
Seat 1: carrsseis ($100 in chips) 
Seat 3: maxxmeister ($100 in chips) 
Seat 5: chautinhtri9 ($120.95 in chips) 
Seat 6: matiko09 ($126.43 in chips) 
Seat 7: PacPacBum ($110.99 in chips) 
Seat 8: RICKA16 ($104.96 in chips) 
Seat 9: Vlad_1965_77 ($121.55 in chips) 
Vlad_1965_77: posts small blind $0.50
carrsseis: posts big blind $1
tomver0809: sits out 
chaps1988: sits out 
*** HOLE CARDS ***
Dealt to matiko09 [7d 4h]
maxxmeister: folds 
chautinhtri9: raises $1 to $2
matiko09: folds 
PacPacBum: folds 
RICKA16: folds 
Vlad_1965_77: calls $1.50
carrsseis: calls $1
*** FLOP *** [Ah 3d Qd]
Vlad_1965_77: bets $5.73
carrsseis: folds 
chautinhtri9: folds 
Uncalled bet ($5.73) returned to Vlad_1965_77
Vlad_1965_77 collected $5.73 from pot
*** SUMMARY ***
Total pot $6 | Rake $0.27 
Board [Ah 3d Qd]
Seat 1: carrsseis (big blind) folded on the Flop
Seat 3: maxxmeister folded before Flop (didn't bet)
Seat 5: chautinhtri9 folded on the Flop
Seat 6: matiko09 folded before Flop (didn't bet)
Seat 7: PacPacBum folded before Flop (didn't bet)
Seat 8: RICKA16 (button) folded before Flop (didn't bet)
Seat 9: Vlad_1965_77 (small blind) collected ($5.73)





PokerStars Hand #150802318550:  Hold'em No Limit (€0.50/€1.00 EUR) - 2016/03/23 14:54:37 CET [2016/03/23 9:54:37 ET]
Table 'Mercury III' 9-max Seat #1 is the button
Seat 1: matiko09 (€100 in chips) 
Seat 2: o.miro (€116.27 in chips) 
Seat 3: PacPacBum (€102.33 in chips) 
Seat 4: florrin92 (€101.36 in chips) 
Seat 5: nickreason17 (€120.86 in chips) 
Seat 6: mycka86 (€100 in chips) 
Seat 7: $-Twackle-$ (€141.67 in chips) 
Seat 8: gfxed (€33 in chips) 
Seat 9: Indr3k (€101.50 in chips) 
o.miro: posts small blind €0.50
PacPacBum: posts big blind €1
*** HOLE CARDS ***
Dealt to matiko09 [4d Qs]
florrin92: folds 
nickreason17: folds 
mycka86: raises €2 to €3
$-Twackle-$: calls €3
gfxed: folds 
Indr3k: folds 
matiko09: folds 
o.miro: folds 
PacPacBum: folds 
*** FLOP *** [Tc 9h 2d]
mycka86: checks 
$-Twackle-$: checks 
*** TURN *** [Tc 9h 2d] [Kc]
mycka86: bets €5.20
$-Twackle-$: folds 
Uncalled bet (€5.20) returned to mycka86
mycka86 collected €7.16 from pot
*** SUMMARY ***
Total pot €7.50 | Rake €0.34 
Board [Tc 9h 2d Kc]
Seat 1: matiko09 (button) folded before Flop (didn't bet)
Seat 2: o.miro (small blind) folded before Flop
Seat 3: PacPacBum (big blind) folded before Flop
Seat 4: florrin92 folded before Flop (didn't bet)
Seat 5: nickreason17 folded before Flop (didn't bet)
Seat 6: mycka86 collected (€7.16)
Seat 7: $-Twackle-$ folded on the Turn
Seat 8: gfxed folded before Flop (didn't bet)
Seat 9: Indr3k folded before Flop (didn't bet)





PokerStars Hand #150802319943:  Hold'em No Limit ($1/$2 USD) - 2016/03/23 14:54:39 CET [2016/03/23 9:54:39 ET]
Table 'Achaia' 9-max Seat #2 is the button
Seat 2: InsomniaRU ($242.13 in chips) 
Seat 3: matiko09 ($235.16 in chips) 
Seat 4: erfk1958 ($97 in chips) 
Seat 5: chaps1988 ($201.70 in chips) 
Seat 6: nickreason17 ($280.35 in chips) 
Seat 7: morosun ($166.78 in chips) 
Seat 8: $-Twackle-$ ($252.27 in chips) 
Seat 9: PacPacBum ($200 in chips) 
matiko09: posts small blind $1
erfk1958: posts big blind $2
*** HOLE CARDS ***
Dealt to matiko09 [8d Jc]
chaps1988: folds 
nickreason17: folds 
morosun: folds 
$-Twackle-$: folds 
PacPacBum: folds 
RamiroAgujis joins the table at seat #1 
InsomniaRU: folds 
matiko09: folds 
Uncalled bet ($1) returned to erfk1958
erfk1958 collected $2 from pot
erfk1958: doesn't show hand 
*** SUMMARY ***
Total pot $2 | Rake $0 
Seat 2: InsomniaRU (button) folded before Flop (didn't bet)
Seat 3: matiko09 (small blind) folded before Flop
Seat 4: erfk1958 (big blind) collected ($2)
Seat 5: chaps1988 folded before Flop (didn't bet)
Seat 6: nickreason17 folded before Flop (didn't bet)
Seat 7: morosun folded before Flop (didn't bet)
Seat 8: $-Twackle-$ folded before Flop (didn't bet)
Seat 9: PacPacBum folded before Flop (didn't bet)





PokerStars Hand #150802320903:  Hold'em No Limit ($0.50/$1.00 USD) - 2016/03/23 14:54:41 CET [2016/03/23 9:54:41 ET]
Table 'Drakonia II' 9-max Seat #5 is the button
Seat 1: chautinhtri9 ($100 in chips) 
Seat 2: carrsseis ($101.50 in chips) 
Seat 3: dunga119 ($100 in chips) 
Seat 4: nickreason17 ($100 in chips) 
Seat 5: gchs83 ($39.50 in chips) 
Seat 6: Dantist1122 ($100 in chips) 
Seat 7: YuriiSolodya ($40 in chips) 
Seat 8: matiko09 ($100 in chips) 
Seat 9: mycka86 ($100 in chips) 
Dantist1122: posts small blind $0.50
YuriiSolodya: posts big blind $1
*** HOLE CARDS ***
Dealt to matiko09 [Ac Jd]
matiko09: folds 
mycka86: raises $2 to $3
chautinhtri9: folds 
carrsseis: folds 
dunga119: folds 
nickreason17: folds 
gchs83: folds 
Dantist1122: folds 
YuriiSolodya: folds 
Uncalled bet ($2) returned to mycka86
mycka86 collected $2.50 from pot
*** SUMMARY ***
Total pot $2.50 | Rake $0 
Seat 1: chautinhtri9 folded before Flop (didn't bet)
Seat 2: carrsseis folded before Flop (didn't bet)
Seat 3: dunga119 folded before Flop (didn't bet)
Seat 4: nickreason17 folded before Flop (didn't bet)
Seat 5: gchs83 (button) folded before Flop (didn't bet)
Seat 6: Dantist1122 (small blind) folded before Flop
Seat 7: YuriiSolodya (big blind) folded before Flop
Seat 8: matiko09 folded before Flop (didn't bet)
Seat 9: mycka86 collected ($2.50)





PokerStars Hand #150802326628:  Hold'em No Limit ($0.50/$1.00 USD) - 2016/03/23 14:54:51 CET [2016/03/23 9:54:51 ET]
Table 'Donar II' 9-max Seat #5 is the button
Seat 2: chaps1988 ($121.75 in chips) 
Seat 4: DUkalisUA ($138.71 in chips) 
Seat 5: matiko09 ($128.54 in chips) 
Seat 9: nickreason17 ($100 in chips) 
nickreason17: posts small blind $0.50
Effort92: is sitting out 
chaps1988: posts big blind $1
chaps1988: posts the ante $0.20
DUkalisUA: posts the ante $0.20
matiko09: posts the ante $0.20
nickreason17: posts the ante $0.20
*** HOLE CARDS ***
Dealt to matiko09 [5d Jh]
DUkalisUA: folds 
Effort92 leaves the table
matiko09: folds 
nickreason17: folds 
Uncalled bet ($0.50) returned to chaps1988
chaps1988 collected $1.80 from pot
chaps1988: doesn't show hand 
*** SUMMARY ***
Total pot $1.80 | Rake $0 
Seat 2: chaps1988 (big blind) collected ($1.80)
Seat 4: DUkalisUA folded before Flop (didn't bet)
Seat 5: matiko09 (button) folded before Flop (didn't bet)
Seat 9: nickreason17 (small blind) folded before Flop





PokerStars Hand #150802328946:  Hold'em No Limit ($1/$2 USD) - 2016/03/23 14:54:55 CET [2016/03/23 9:54:55 ET]
Table 'Kypria II' 9-max Seat #6 is the button
Seat 1: geldwolfje ($89.65 in chips) 
Seat 2: coinflip_si ($200 in chips) 
Seat 3: seouljam ($285.92 in chips) 
Seat 4: VolanDog ($238.72 in chips) 
Seat 5: InsomniaRU ($375.50 in chips) 
Seat 6: matiko09 ($413.53 in chips) 
Seat 7: DUkalisUA ($200 in chips) 
Seat 8: nickreason17 ($200 in chips) 
Seat 9: sanrs57 ($198 in chips) 
DUkalisUA: posts small blind $1
nickreason17: posts big blind $2
*** HOLE CARDS ***
Dealt to matiko09 [2d 8s]
geldwolfje said, "im coming now"
sanrs57: folds 
geldwolfje: raises $4 to $6
coinflip_si: folds 
seouljam: folds 
VolanDog: folds 
geldwolfje said, "ohhh"
InsomniaRU: folds 
matiko09: folds 
DUkalisUA: folds 
nickreason17: folds 
Uncalled bet ($4) returned to geldwolfje
geldwolfje collected $5 from pot
geldwolfje: doesn't show hand 
*** SUMMARY ***
Total pot $5 | Rake $0 
Seat 1: geldwolfje collected ($5)
Seat 2: coinflip_si folded before Flop (didn't bet)
Seat 3: seouljam folded before Flop (didn't bet)
Seat 4: VolanDog folded before Flop (didn't bet)
Seat 5: InsomniaRU folded before Flop (didn't bet)
Seat 6: matiko09 (button) folded before Flop (didn't bet)
Seat 7: DUkalisUA (small blind) folded before Flop
Seat 8: nickreason17 (big blind) folded before Flop
Seat 9: sanrs57 folded before Flop (didn't bet)





PokerStars Hand #150802329341:  Hold'em No Limit ($0.50/$1.00 USD) - 2016/03/23 14:54:56 CET [2016/03/23 9:54:56 ET]
Table 'Merope II' 9-max Seat #9 is the button
Seat 1: Jimy Tiltman ($129.79 in chips) 
Seat 2: $-Twackle-$ ($101.50 in chips) 
Seat 3: pablos1922 ($90.31 in chips) 
Seat 5: chaps1988 ($104 in chips) 
Seat 6: Effort92 ($100.21 in chips) 
Seat 7: matiko09 ($104.53 in chips) 
Seat 8: Red4erT ($40 in chips) 
Seat 9: RICKA16 ($125.59 in chips) 
Jimy Tiltman: posts small blind $0.50
$-Twackle-$: posts big blind $1
PacPacBum: sits out 
*** HOLE CARDS ***
Dealt to matiko09 [7c 4s]
pablos1922: folds 
chaps1988: folds 
Effort92: raises $1.50 to $2.50
matiko09: folds 
Red4erT: raises $3.50 to $6
RICKA16: folds 
Jimy Tiltman: folds 
$-Twackle-$: folds 
Effort92: raises $6 to $12
Red4erT: calls $6
*** FLOP *** [6h Tc Qh]
Effort92: bets $7
Red4erT: calls $7
*** TURN *** [6h Tc Qh] [8d]
Effort92: bets $28
Red4erT: calls $21 and is all-in
Uncalled bet ($7) returned to Effort92
*** FIRST RIVER *** [6h Tc Qh 8d] [Qc]
*** SECOND RIVER *** [6h Tc Qh 8d] [As]
*** FIRST SHOW DOWN ***
Effort92: shows [Ac Ad] (two pair, Aces and Queens)
Red4erT: mucks hand 
Effort92 collected $39.35 from pot
*** SECOND SHOW DOWN ***
Effort92: shows [Ac Ad] (three of a kind, Aces)
Red4erT: mucks hand 
Effort92 collected $39.35 from pot
*** SUMMARY ***
Total pot $81.50 | Rake $2.80 
Hand was run twice
FIRST Board [6h Tc Qh 8d Qc]
SECOND Board [6h Tc Qh 8d As]
Seat 1: Jimy Tiltman (small blind) folded before Flop
Seat 2: $-Twackle-$ (big blind) folded before Flop
Seat 3: pablos1922 folded before Flop (didn't bet)
Seat 5: chaps1988 folded before Flop (didn't bet)
Seat 6: Effort92 showed [Ac Ad] and won ($39.35) with two pair, Aces and Queens, and won ($39.35) with three of a kind, Aces
Seat 7: matiko09 folded before Flop (didn't bet)
Seat 8: Red4erT mucked [Ks Ah]
Seat 9: RICKA16 (button) folded before Flop (didn't bet)





PokerStars Hand #150802330563:  Hold'em No Limit ($0.50/$1.00 USD) - 2016/03/23 14:54:58 CET [2016/03/23 9:54:58 ET]
Table 'Sylvia III' 9-max Seat #6 is the button
Seat 1: mycka86 ($100 in chips) 
Seat 2: florrin92 ($102.30 in chips) 
Seat 3: carrsseis ($93.52 in chips) 
Seat 5: matiko09 ($100.60 in chips) 
Seat 6: PacPacBum ($101.78 in chips) 
mycka86: posts small blind $0.50
florrin92: posts big blind $1
mycka86: posts the ante $0.20
florrin92: posts the ante $0.20
carrsseis: posts the ante $0.20
matiko09: posts the ante $0.20
PacPacBum: posts the ante $0.20
*** HOLE CARDS ***
Dealt to matiko09 [6h 5c]
carrsseis: folds 
matiko09: folds 
PacPacBum: raises $2 to $3
mycka86: folds 
florrin92: calls $2
*** FLOP *** [Kh 7d 7c]
florrin92: checks 
bigacsiga joins the table at seat #4 
PacPacBum: checks 
*** TURN *** [Kh 7d 7c] [Ks]
florrin92: bets $5
PacPacBum: calls $5
*** RIVER *** [Kh 7d 7c Ks] [8s]
bigacsiga is disconnected 
easytalk777 joins the table at seat #7 
Blanky-Bad joins the table at seat #9 
florrin92: bets $11
PacPacBum: folds 
Uncalled bet ($11) returned to florrin92
florrin92 collected $16.71 from pot
florrin92: doesn't show hand 
*** SUMMARY ***
Total pot $17.50 | Rake $0.79 
Board [Kh 7d 7c Ks 8s]
Seat 1: mycka86 (small blind) folded before Flop
Seat 2: florrin92 (big blind) collected ($16.71)
Seat 3: carrsseis folded before Flop (didn't bet)
Seat 5: matiko09 folded before Flop (didn't bet)
Seat 6: PacPacBum (button) folded on the River





PokerStars Hand #150802334293:  Hold'em No Limit ($0.25/$0.50 USD) - 2016/03/23 14:55:04 CET [2016/03/23 9:55:04 ET]
Table 'Pyrrhus' 9-max Seat #4 is the button
Seat 1: lumen21 ($84.22 in chips) 
Seat 2: BSTUSim ($65.62 in chips) 
Seat 3: i L00K great ($50 in chips) 
Seat 4: GriffinBerg ($40.66 in chips) 
Seat 5: ZonTTT ($54.23 in chips) 
Seat 6: Ahangama ($50.75 in chips) 
Seat 7: matiko09 ($139.50 in chips) 
Seat 8: dndngod ($78.43 in chips) 
Seat 9: CvMCvMCvM ($90.13 in chips) 
ZonTTT: posts small blind $0.25
Ahangama: posts big blind $0.50
*** HOLE CARDS ***
Dealt to matiko09 [9h 3s]
matiko09: folds 
dndngod: folds 
CvMCvMCvM: folds 
lumen21: folds 
BSTUSim: raises $1 to $1.50
i L00K great: raises $3 to $4.50
GriffinBerg: folds 
ZonTTT: folds 
Ahangama: folds 
BSTUSim: folds 
Uncalled bet ($3) returned to i L00K great
i L00K great collected $3.75 from pot
i L00K great: doesn't show hand 
*** SUMMARY ***
Total pot $3.75 | Rake $0 
Seat 1: lumen21 folded before Flop (didn't bet)
Seat 2: BSTUSim folded before Flop
Seat 3: i L00K great collected ($3.75)
Seat 4: GriffinBerg (button) folded before Flop (didn't bet)
Seat 5: ZonTTT (small blind) folded before Flop
Seat 6: Ahangama (big blind) folded before Flop
Seat 7: matiko09 folded before Flop (didn't bet)
Seat 8: dndngod folded before Flop (didn't bet)
Seat 9: CvMCvMCvM folded before Flop (didn't bet)





PokerStars Hand #150802337818:  Hold'em No Limit ($0.50/$1.00 USD) - 2016/03/23 14:55:11 CET [2016/03/23 9:55:11 ET]
Table 'Swings' 9-max Seat #9 is the button
Seat 1: carrsseis ($100 in chips) 
Seat 2: tomver0809 ($100 in chips) 
Seat 3: maxxmeister ($100 in chips) 
Seat 5: chautinhtri9 ($118.95 in chips) 
Seat 6: matiko09 ($126.43 in chips) 
Seat 7: PacPacBum ($110.99 in chips) 
Seat 8: RICKA16 ($104.96 in chips) 
Seat 9: Vlad_1965_77 ($125.28 in chips) 
carrsseis: posts small blind $0.50
tomver0809: posts big blind $1
chaps1988: sits out 
*** HOLE CARDS ***
Dealt to matiko09 [9d Td]
maxxmeister: folds 
chautinhtri9: folds 
matiko09: raises $2 to $3
PacPacBum: folds 
RICKA16: folds 
Vlad_1965_77: folds 
carrsseis: folds 
tomver0809: calls $2
*** FLOP *** [8s 5s 7d]
tomver0809: checks 
matiko09: bets $4.04
tomver0809: folds 
Uncalled bet ($4.04) returned to matiko09
matiko09 collected $6.21 from pot
matiko09: doesn't show hand 
*** SUMMARY ***
Total pot $6.50 | Rake $0.29 
Board [8s 5s 7d]
Seat 1: carrsseis (small blind) folded before Flop
Seat 2: tomver0809 (big blind) folded on the Flop
Seat 3: maxxmeister folded before Flop (didn't bet)
Seat 5: chautinhtri9 folded before Flop (didn't bet)
Seat 6: matiko09 collected ($6.21)
Seat 7: PacPacBum folded before Flop (didn't bet)
Seat 8: RICKA16 folded before Flop (didn't bet)
Seat 9: Vlad_1965_77 (button) folded before Flop (didn't bet)





PokerStars Hand #150802340362:  Hold'em No Limit ($1/$2 USD) - 2016/03/23 14:55:16 CET [2016/03/23 9:55:16 ET]
Table 'Achaia' 9-max Seat #3 is the button
Seat 2: InsomniaRU ($242.13 in chips) 
Seat 3: matiko09 ($234.16 in chips) 
Seat 4: erfk1958 ($98 in chips) 
Seat 5: chaps1988 ($201.70 in chips) 
Seat 6: nickreason17 ($280.35 in chips) 
Seat 7: morosun ($166.78 in chips) 
Seat 8: $-Twackle-$ ($252.27 in chips) 
Seat 9: PacPacBum ($200 in chips) 
erfk1958: posts small blind $1
chaps1988: posts big blind $2
RamiroAgujis: sits out 
*** HOLE CARDS ***
Dealt to matiko09 [Kc 6h]
nickreason17: folds 
morosun: raises $4 to $6
$-Twackle-$: folds 
PacPacBum: folds 
InsomniaRU: folds 
matiko09: folds 
erfk1958: folds 
chaps1988: folds 
Uncalled bet ($4) returned to morosun
morosun collected $5 from pot
*** SUMMARY ***
Total pot $5 | Rake $0 
Seat 2: InsomniaRU folded before Flop (didn't bet)
Seat 3: matiko09 (button) folded before Flop (didn't bet)
Seat 4: erfk1958 (small blind) folded before Flop
Seat 5: chaps1988 (big blind) folded before Flop
Seat 6: nickreason17 folded before Flop (didn't bet)
Seat 7: morosun collected ($5)
Seat 8: $-Twackle-$ folded before Flop (didn't bet)
Seat 9: PacPacBum folded before Flop (didn't bet)





PokerStars Hand #150802344439:  Hold'em No Limit ($0.50/$1.00 USD) - 2016/03/23 14:55:25 CET [2016/03/23 9:55:25 ET]
Table 'Drakonia II' 9-max Seat #6 is the button
Seat 1: chautinhtri9 ($100 in chips) 
Seat 2: carrsseis ($101.50 in chips) 
Seat 3: dunga119 ($100 in chips) 
Seat 4: nickreason17 ($100 in chips) 
Seat 5: gchs83 ($39.50 in chips) 
Seat 6: Dantist1122 ($100 in chips) 
Seat 7: YuriiSolodya ($39 in chips) 
Seat 8: matiko09 ($100 in chips) 
Seat 9: mycka86 ($101.50 in chips) 
YuriiSolodya: posts small blind $0.50
matiko09: posts big blind $1
*** HOLE CARDS ***
Dealt to matiko09 [Qs 8h]
mycka86: folds 
chautinhtri9: folds 
carrsseis: folds 
dunga119: calls $1
nickreason17: folds 
gchs83: folds 
Dantist1122: folds 
YuriiSolodya: folds 
matiko09: checks 
*** FLOP *** [9d 6d 3h]
matiko09: checks 
dunga119: checks 
*** TURN *** [9d 6d 3h] [3d]
matiko09: checks 
dunga119: bets $1.19
matiko09: folds 
Uncalled bet ($1.19) returned to dunga119
dunga119 collected $2.39 from pot
dunga119: doesn't show hand 
*** SUMMARY ***
Total pot $2.50 | Rake $0.11 
Board [9d 6d 3h 3d]
Seat 1: chautinhtri9 folded before Flop (didn't bet)
Seat 2: carrsseis folded before Flop (didn't bet)
Seat 3: dunga119 collected ($2.39)
Seat 4: nickreason17 folded before Flop (didn't bet)
Seat 5: gchs83 folded before Flop (didn't bet)
Seat 6: Dantist1122 (button) folded before Flop (didn't bet)
Seat 7: YuriiSolodya (small blind) folded before Flop
Seat 8: matiko09 (big blind) folded on the Turn
Seat 9: mycka86 folded before Flop (didn't bet)





PokerStars Hand #150802344657:  Hold'em No Limit ($1/$2 USD) - 2016/03/23 14:55:26 CET [2016/03/23 9:55:26 ET]
Table 'Kiess' 9-max Seat #6 is the button
Seat 2: DUkalisUA ($708.28 in chips) 
Seat 3: Red4erT ($80 in chips) 
Seat 5: chippo boy ($412.14 in chips) 
Seat 6: matiko09 ($257.86 in chips) 
Seat 7: InsomniaRU ($330.21 in chips) 
InsomniaRU: posts small blind $1
T0ny Adams: is sitting out 
DUkalisUA: posts big blind $2
Igoriah: sits out 
*** HOLE CARDS ***
Dealt to matiko09 [6c Ad]
T0ny Adams leaves the table
volwebni4ek joins the table at seat #9 
Red4erT: folds 
chippo boy: folds 
matiko09: raises $2.54 to $4.54
InsomniaRU: folds 
DUkalisUA: folds 
Uncalled bet ($2.54) returned to matiko09
matiko09 collected $5 from pot
matiko09: doesn't show hand 
*** SUMMARY ***
Total pot $5 | Rake $0 
Seat 2: DUkalisUA (big blind) folded before Flop
Seat 3: Red4erT folded before Flop (didn't bet)
Seat 5: chippo boy folded before Flop (didn't bet)
Seat 6: matiko09 (button) collected ($5)
Seat 7: InsomniaRU (small blind) folded before Flop





PokerStars Hand #150802345519:  Hold'em No Limit ($1/$2 USD) - 2016/03/23 14:55:28 CET [2016/03/23 9:55:28 ET]
Table 'Kypria II' 9-max Seat #7 is the button
Seat 1: geldwolfje ($92.65 in chips) 
Seat 2: coinflip_si ($200 in chips) 
Seat 3: seouljam ($285.92 in chips) 
Seat 4: VolanDog ($238.72 in chips) 
Seat 5: InsomniaRU ($375.50 in chips) 
Seat 6: matiko09 ($413.53 in chips) 
Seat 7: DUkalisUA ($200 in chips) 
Seat 8: nickreason17 ($200 in chips) 
Seat 9: sanrs57 ($198 in chips) 
nickreason17: posts small blind $1
sanrs57: posts big blind $2
*** HOLE CARDS ***
Dealt to matiko09 [7h Tc]
geldwolfje: raises $2 to $4
coinflip_si: raises $8 to $12
geldwolfje said, "again"
seouljam: folds 
VolanDog: calls $12
InsomniaRU: folds 
matiko09: folds 
DUkalisUA: folds 
nickreason17: folds 
sanrs57: calls $10
geldwolfje: raises $80.65 to $92.65 and is all-in
coinflip_si: raises $107.35 to $200 and is all-in
VolanDog: folds 
sanrs57: folds 
Uncalled bet ($107.35) returned to coinflip_si
geldwolfje said, "yess"
*** FLOP *** [8h 2s 2h]
*** TURN *** [8h 2s 2h] [8d]
*** RIVER *** [8h 2s 2h 8d] [Td]
*** SHOW DOWN ***
geldwolfje: shows [9s Ts] (two pair, Tens and Eights)
coinflip_si: shows [Qc Qs] (two pair, Queens and Eights)
coinflip_si collected $207.50 from pot
*** SUMMARY ***
Total pot $210.30 | Rake $2.80 
Board [8h 2s 2h 8d Td]
Seat 1: geldwolfje showed [9s Ts] and lost with two pair, Tens and Eights
Seat 2: coinflip_si showed [Qc Qs] and won ($207.50) with two pair, Queens and Eights
Seat 3: seouljam folded before Flop (didn't bet)
Seat 4: VolanDog folded before Flop
Seat 5: InsomniaRU folded before Flop (didn't bet)
Seat 6: matiko09 folded before Flop (didn't bet)
Seat 7: DUkalisUA (button) folded before Flop (didn't bet)
Seat 8: nickreason17 (small blind) folded before Flop
Seat 9: sanrs57 (big blind) folded before Flop





PokerStars Hand #150802345517:  Hold'em No Limit ($1/$2 USD) - 2016/03/23 14:55:28 CET [2016/03/23 9:55:28 ET]
Table 'Herba II' 9-max Seat #9 is the button
Seat 1: matiko09 ($291.38 in chips) 
Seat 2: nickreason17 ($200 in chips) 
Seat 4: DUkalisUA ($400.40 in chips) 
Seat 5: chippo boy ($223.31 in chips) 
Seat 6: Too-Anti-To ($225.38 in chips) 
Seat 7: InsomniaRU ($408.70 in chips) 
Seat 8: T0ny Adams ($77 in chips) 
Seat 9: mrhighryza ($49.44 in chips) 
matiko09: posts small blind $1
nickreason17: posts big blind $2
*** HOLE CARDS ***
Dealt to matiko09 [4h Ks]
DUkalisUA: folds 
chippo boy: calls $2
Too-Anti-To: folds 
InsomniaRU: raises $5 to $7
T0ny Adams: folds 
mrhighryza: folds 
matiko09: folds 
nickreason17: folds 
chippo boy: calls $5
*** FLOP *** [7h Jc 5h]
chippo boy: checks 
InsomniaRU: checks 
*** TURN *** [7h Jc 5h] [6d]
chippo boy: bets $8
InsomniaRU: calls $8
*** RIVER *** [7h Jc 5h 6d] [Qd]
chippo boy: bets $16
InsomniaRU: calls $16
*** SHOW DOWN ***
chippo boy: shows [Qc 8c] (a pair of Queens)
InsomniaRU: mucks hand 
chippo boy collected $62.20 from pot
*** SUMMARY ***
Total pot $65 | Rake $2.80 
Board [7h Jc 5h 6d Qd]
Seat 1: matiko09 (small blind) folded before Flop
Seat 2: nickreason17 (big blind) folded before Flop
Seat 4: DUkalisUA folded before Flop (didn't bet)
Seat 5: chippo boy showed [Qc 8c] and won ($62.20) with a pair of Queens
Seat 6: Too-Anti-To folded before Flop (didn't bet)
Seat 7: InsomniaRU mucked [8s 8d]
Seat 8: T0ny Adams folded before Flop (didn't bet)
Seat 9: mrhighryza (button) folded before Flop (didn't bet)





PokerStars Hand #150802349962:  Hold'em No Limit (€0.50/€1.00 EUR) - 2016/03/23 14:55:38 CET [2016/03/23 9:55:38 ET]
Table 'Mercury III' 9-max Seat #2 is the button
Seat 1: matiko09 (€100 in chips) 
Seat 2: o.miro (€115.77 in chips) 
Seat 3: PacPacBum (€101.33 in chips) 
Seat 6: mycka86 (€104.16 in chips) 
Seat 7: $-Twackle-$ (€138.67 in chips) 
Seat 8: gfxed (€33 in chips) 
Seat 9: Indr3k (€101.50 in chips) 
PacPacBum: posts small blind €0.50
florrin92: is sitting out 
florrin92 leaves the table
nickreason17: is sitting out 
mycka86: posts big blind €1
*** HOLE CARDS ***
Dealt to matiko09 [Tc 6s]
Muinmyheart joins the table at seat #4 
nickreason17 leaves the table
$-Twackle-$: folds 
gfxed: folds 
Indr3k: folds 
matiko09: folds 
o.miro: raises €1.50 to €2.50
PacPacBum: folds 
mycka86: calls €1.50
*** FLOP *** [Qs 8d 4s]
mycka86: checks 
o.miro: bets €3.50
mycka86: calls €3.50
*** TURN *** [Qs 8d 4s] [Jc]
mycka86: checks 
o.miro: bets €9.50
mycka86: folds 
Uncalled bet (€9.50) returned to o.miro
o.miro collected €11.94 from pot
o.miro: doesn't show hand 
*** SUMMARY ***
Total pot €12.50 | Rake €0.56 
Board [Qs 8d 4s Jc]
Seat 1: matiko09 folded before Flop (didn't bet)
Seat 2: o.miro (button) collected (€11.94)
Seat 3: PacPacBum (small blind) folded before Flop
Seat 6: mycka86 (big blind) folded on the Turn
Seat 7: $-Twackle-$ folded before Flop (didn't bet)
Seat 8: gfxed folded before Flop (didn't bet)
Seat 9: Indr3k folded before Flop (didn't bet)





PokerStars Hand #150802355734:  Hold'em No Limit ($1/$2 USD) - 2016/03/23 14:55:52 CET [2016/03/23 9:55:52 ET]
Table 'Achaia' 9-max Seat #5 is the button
Seat 2: InsomniaRU ($242.13 in chips) 
Seat 3: matiko09 ($234.16 in chips) 
Seat 5: chaps1988 ($200 in chips) 
Seat 6: nickreason17 ($280.35 in chips) 
Seat 7: morosun ($169.78 in chips) 
Seat 8: $-Twackle-$ ($252.27 in chips) 
Seat 9: PacPacBum ($200 in chips) 
nickreason17: posts small blind $1
morosun: posts big blind $2
RamiroAgujis: sits out 
*** HOLE CARDS ***
Dealt to matiko09 [9d 8d]
$-Twackle-$: folds 
PacPacBum: folds 
InsomniaRU: folds 
matiko09: raises $3 to $5
chaps1988: folds 
nickreason17: folds 
morosun: folds 
Uncalled bet ($3) returned to matiko09
matiko09 collected $5 from pot
matiko09: doesn't show hand 
*** SUMMARY ***
Total pot $5 | Rake $0 
Seat 2: InsomniaRU folded before Flop (didn't bet)
Seat 3: matiko09 collected ($5)
Seat 5: chaps1988 (button) folded before Flop (didn't bet)
Seat 6: nickreason17 (small blind) folded before Flop
Seat 7: morosun (big blind) folded before Flop
Seat 8: $-Twackle-$ folded before Flop (didn't bet)
Seat 9: PacPacBum folded before Flop (didn't bet)





PokerStars Hand #150802357871:  Hold'em No Limit ($0.25/$0.50 USD) - 2016/03/23 14:55:57 CET [2016/03/23 9:55:57 ET]
Table 'Pyrrhus' 9-max Seat #5 is the button
Seat 1: lumen21 ($84.22 in chips) 
Seat 2: BSTUSim ($64.12 in chips) 
Seat 3: i L00K great ($52.25 in chips) 
Seat 4: GriffinBerg ($40.66 in chips) 
Seat 5: ZonTTT ($53.98 in chips) 
Seat 6: Ahangama ($50.25 in chips) 
Seat 7: matiko09 ($139.50 in chips) 
Seat 8: dndngod ($78.43 in chips) 
Seat 9: CvMCvMCvM ($90.13 in chips) 
Ahangama: posts small blind $0.25
matiko09: posts big blind $0.50
*** HOLE CARDS ***
Dealt to matiko09 [3h 9d]
dndngod: folds 
CvMCvMCvM: folds 
lumen21: folds 
BSTUSim: folds 
i L00K great: folds 
GriffinBerg: raises $1 to $1.50
ZonTTT: folds 
Ahangama: folds 
matiko09: folds 
Uncalled bet ($1) returned to GriffinBerg
GriffinBerg collected $1.25 from pot
*** SUMMARY ***
Total pot $1.25 | Rake $0 
Seat 1: lumen21 folded before Flop (didn't bet)
Seat 2: BSTUSim folded before Flop (didn't bet)
Seat 3: i L00K great folded before Flop (didn't bet)
Seat 4: GriffinBerg collected ($1.25)
Seat 5: ZonTTT (button) folded before Flop (didn't bet)
Seat 6: Ahangama (small blind) folded before Flop
Seat 7: matiko09 (big blind) folded before Flop
Seat 8: dndngod folded before Flop (didn't bet)
Seat 9: CvMCvMCvM folded before Flop (didn't bet)





PokerStars Hand #150802358145:  Hold'em No Limit ($0.50/$1.00 USD) - 2016/03/23 14:55:58 CET [2016/03/23 9:55:58 ET]
Table 'Swings' 9-max Seat #1 is the button
Seat 1: carrsseis ($100 in chips) 
Seat 2: tomver0809 ($97 in chips) 
Seat 4: chaps1988 ($100 in chips) 
Seat 5: chautinhtri9 ($118.95 in chips) 
Seat 6: matiko09 ($129.64 in chips) 
Seat 7: PacPacBum ($110.99 in chips) 
Seat 8: RICKA16 ($104.96 in chips) 
Seat 9: Vlad_1965_77 ($125.28 in chips) 
tomver0809: posts small blind $0.50
maxxmeister: is sitting out 
chaps1988: posts big blind $1
*** HOLE CARDS ***
Dealt to matiko09 [Ad Kh]
chautinhtri9: folds 
matiko09: raises $2 to $3
PacPacBum: folds 
RICKA16: folds 
Vlad_1965_77: folds 
carrsseis: folds 
tomver0809: calls $2.50
chaps1988: folds 
*** FLOP *** [8h Td Kc]
tomver0809: checks 
matiko09: bets $4.34
tomver0809: calls $4.34
*** TURN *** [8h Td Kc] [6c]
tomver0809: checks 
matiko09: bets $9.50
tomver0809: folds 
Uncalled bet ($9.50) returned to matiko09
matiko09 collected $14.97 from pot
matiko09: doesn't show hand 
*** SUMMARY ***
Total pot $15.68 | Rake $0.71 
Board [8h Td Kc 6c]
Seat 1: carrsseis (button) folded before Flop (didn't bet)
Seat 2: tomver0809 (small blind) folded on the Turn
Seat 4: chaps1988 (big blind) folded before Flop
Seat 5: chautinhtri9 folded before Flop (didn't bet)
Seat 6: matiko09 collected ($14.97)
Seat 7: PacPacBum folded before Flop (didn't bet)
Seat 8: RICKA16 folded before Flop (didn't bet)
Seat 9: Vlad_1965_77 folded before Flop (didn't bet)





PokerStars Hand #150802359054:  Hold'em No Limit ($0.50/$1.00 USD) - 2016/03/23 14:56:00 CET [2016/03/23 9:56:00 ET]
Table 'Asmodeus' 9-max Seat #4 is the button
Seat 1: Jimy Tiltman ($109.29 in chips) 
Seat 2: $-Twackle-$ ($100 in chips) 
Seat 3: nickreason17 ($103.20 in chips) 
Seat 4: Effort92 ($100 in chips) 
Seat 6: florrin92 ($103.40 in chips) 
Seat 7: mycka86 ($100 in chips) 
Seat 9: matiko09 ($103.29 in chips) 
chaps1988 will be allowed to play after the button
florrin92: posts small blind $0.50
mycka86: posts big blind $1
Jimy Tiltman: posts the ante $0.20
$-Twackle-$: posts the ante $0.20
nickreason17: posts the ante $0.20
Effort92: posts the ante $0.20
florrin92: posts the ante $0.20
mycka86: posts the ante $0.20
matiko09: posts the ante $0.20
*** HOLE CARDS ***
Dealt to matiko09 [Ah Js]
matiko09: folds 
Jimy Tiltman: folds 
$-Twackle-$: folds 
nickreason17: folds 
Effort92: raises $2 to $3
florrin92: folds 
mycka86: calls $2
*** FLOP *** [Ac Qc Jd]
mycka86: checks 
Effort92: checks 
*** TURN *** [Ac Qc Jd] [Tc]
bonifacioppl joins the table at seat #8 
mycka86: bets $5
Effort92: folds 
Uncalled bet ($5) returned to mycka86
mycka86 collected $7.54 from pot
*** SUMMARY ***
Total pot $7.90 | Rake $0.36 
Board [Ac Qc Jd Tc]
Seat 1: Jimy Tiltman folded before Flop (didn't bet)
Seat 2: $-Twackle-$ folded before Flop (didn't bet)
Seat 3: nickreason17 folded before Flop (didn't bet)
Seat 4: Effort92 (button) folded on the Turn
Seat 6: florrin92 (small blind) folded before Flop
Seat 7: mycka86 (big blind) collected ($7.54)
Seat 9: matiko09 folded before Flop (didn't bet)





PokerStars Hand #150802362548:  Hold'em No Limit ($1/$2 USD) - 2016/03/23 14:56:09 CET [2016/03/23 9:56:09 ET]
Table 'Kiess' 9-max Seat #7 is the button
Seat 2: DUkalisUA ($706.28 in chips) 
Seat 3: Red4erT ($80 in chips) 
Seat 5: chippo boy ($412.14 in chips) 
Seat 6: matiko09 ($260.86 in chips) 
Seat 7: InsomniaRU ($329.21 in chips) 
volwebni4ek will be allowed to play after the button
DUkalisUA: posts small blind $1
Red4erT: posts big blind $2
Igoriah: sits out 
*** HOLE CARDS ***
Dealt to matiko09 [Td 9s]
chippo boy: folds 
matiko09: folds 
InsomniaRU: raises $3 to $5
DUkalisUA: folds 
Red4erT: folds 
Uncalled bet ($3) returned to InsomniaRU
InsomniaRU collected $5 from pot
InsomniaRU: doesn't show hand 
*** SUMMARY ***
Total pot $5 | Rake $0 
Seat 2: DUkalisUA (small blind) folded before Flop
Seat 3: Red4erT (big blind) folded before Flop
Seat 5: chippo boy folded before Flop (didn't bet)
Seat 6: matiko09 folded before Flop (didn't bet)
Seat 7: InsomniaRU (button) collected ($5)





PokerStars Hand #150802363323:  Hold'em No Limit ($1/$2 USD) - 2016/03/23 14:56:11 CET [2016/03/23 9:56:11 ET]
Table 'Achaia' 9-max Seat #6 is the button
Seat 2: InsomniaRU ($242.13 in chips) 
Seat 3: matiko09 ($237.16 in chips) 
Seat 5: chaps1988 ($200 in chips) 
Seat 6: nickreason17 ($279.35 in chips) 
Seat 7: morosun ($167.78 in chips) 
Seat 9: PacPacBum ($200 in chips) 
morosun: posts small blind $1
$-Twackle-$: is sitting out 
$-Twackle-$ leaves the table
PacPacBum: posts big blind $2
RamiroAgujis: sits out 
*** HOLE CARDS ***
Dealt to matiko09 [Ah 3c]
IseeUcards joins the table at seat #8 
InsomniaRU: folds 
matiko09: folds 
chaps1988: folds 
nickreason17: raises $2.08 to $4.08
morosun: calls $3.08
PacPacBum: folds 
*** FLOP *** [4c 9d Qc]
morosun: checks 
nickreason17: bets $5.08
morosun: folds 
Uncalled bet ($5.08) returned to nickreason17
nickreason17 collected $9.70 from pot
*** SUMMARY ***
Total pot $10.16 | Rake $0.46 
Board [4c 9d Qc]
Seat 2: InsomniaRU folded before Flop (didn't bet)
Seat 3: matiko09 folded before Flop (didn't bet)
Seat 5: chaps1988 folded before Flop (didn't bet)
Seat 6: nickreason17 (button) collected ($9.70)
Seat 7: morosun (small blind) folded on the Flop
Seat 9: PacPacBum (big blind) folded before Flop





PokerStars Hand #150802366906:  Hold'em No Limit ($0.50/$1.00 USD) - 2016/03/23 14:56:20 CET [2016/03/23 9:56:20 ET]
Table 'Sylvia III' 9-max Seat #1 is the button
Seat 1: mycka86 ($100 in chips) 
Seat 2: florrin92 ($110.81 in chips) 
Seat 4: bigacsiga ($100 in chips) 
Seat 5: matiko09 ($100.40 in chips) 
Seat 6: PacPacBum ($100 in chips) 
florrin92: posts small blind $0.50
carrsseis: is sitting out 
bigacsiga: posts big blind $1
easytalk777: sits out 
Blanky-Bad: sits out 
mycka86: posts the ante $0.20
florrin92: posts the ante $0.20
bigacsiga: posts the ante $0.20
matiko09: posts the ante $0.20
PacPacBum: posts the ante $0.20
*** HOLE CARDS ***
Dealt to matiko09 [4d 7s]
matiko09: folds 
PacPacBum: folds 
mycka86: raises $2 to $3
florrin92: raises $7 to $10
bigacsiga: folds 
mycka86: folds 
Uncalled bet ($7) returned to florrin92
florrin92 collected $8 from pot
florrin92: doesn't show hand 
*** SUMMARY ***
Total pot $8 | Rake $0 
Seat 1: mycka86 (button) folded before Flop
Seat 2: florrin92 (small blind) collected ($8)
Seat 4: bigacsiga (big blind) folded before Flop
Seat 5: matiko09 folded before Flop (didn't bet)
Seat 6: PacPacBum folded before Flop (didn't bet)





PokerStars Hand #150802368030:  Hold'em No Limit ($0.50/$1.00 USD) - 2016/03/23 14:56:23 CET [2016/03/23 9:56:23 ET]
Table 'Drakonia II' 9-max Seat #7 is the button
Seat 1: chautinhtri9 ($100 in chips) 
Seat 2: carrsseis ($101.50 in chips) 
Seat 3: dunga119 ($101.39 in chips) 
Seat 4: nickreason17 ($100 in chips) 
Seat 5: gchs83 ($39.50 in chips) 
Seat 6: Dantist1122 ($100 in chips) 
Seat 7: YuriiSolodya ($38.50 in chips) 
Seat 8: matiko09 ($100 in chips) 
Seat 9: mycka86 ($101.50 in chips) 
matiko09: posts small blind $0.50
mycka86: posts big blind $1
*** HOLE CARDS ***
Dealt to matiko09 [Ks 2h]
chautinhtri9: raises $1 to $2
carrsseis: folds 
dunga119: folds 
nickreason17: folds 
gchs83: folds 
Dantist1122: folds 
YuriiSolodya: calls $2
matiko09: folds 
mycka86: calls $1
*** FLOP *** [8c 8s 5d]
mycka86: checks 
chautinhtri9: checks 
YuriiSolodya: bets $3.10
mycka86: folds 
chautinhtri9: calls $3.10
*** TURN *** [8c 8s 5d] [4d]
chautinhtri9: checks 
YuriiSolodya: bets $1
chautinhtri9: raises $5 to $6
YuriiSolodya: folds 
Uncalled bet ($5) returned to chautinhtri9
chautinhtri9 collected $14.04 from pot
chautinhtri9: doesn't show hand 
*** SUMMARY ***
Total pot $14.70 | Rake $0.66 
Board [8c 8s 5d 4d]
Seat 1: chautinhtri9 collected ($14.04)
Seat 2: carrsseis folded before Flop (didn't bet)
Seat 3: dunga119 folded before Flop (didn't bet)
Seat 4: nickreason17 folded before Flop (didn't bet)
Seat 5: gchs83 folded before Flop (didn't bet)
Seat 6: Dantist1122 folded before Flop (didn't bet)
Seat 7: YuriiSolodya (button) folded on the Turn
Seat 8: matiko09 (small blind) folded before Flop
Seat 9: mycka86 (big blind) folded on the Flop





PokerStars Hand #150802369174:  Hold'em No Limit ($0.25/$0.50 USD) - 2016/03/23 14:56:25 CET [2016/03/23 9:56:25 ET]
Table 'Pyrrhus' 9-max Seat #6 is the button
Seat 1: lumen21 ($84.22 in chips) 
Seat 2: BSTUSim ($64.12 in chips) 
Seat 3: i L00K great ($52.25 in chips) 
Seat 4: GriffinBerg ($41.41 in chips) 
Seat 5: ZonTTT ($53.98 in chips) 
Seat 6: Ahangama ($50 in chips) 
Seat 7: matiko09 ($139 in chips) 
Seat 8: dndngod ($78.43 in chips) 
Seat 9: CvMCvMCvM ($90.13 in chips) 
matiko09: posts small blind $0.25
dndngod: posts big blind $0.50
*** HOLE CARDS ***
Dealt to matiko09 [5d 9h]
CvMCvMCvM: calls $0.50
lumen21: folds 
BSTUSim: folds 
i L00K great: folds 
GriffinBerg: calls $0.50
ZonTTT: folds 
Ahangama: folds 
matiko09: folds 
dndngod: checks 
*** FLOP *** [3s 3c 5c]
dndngod: checks 
CvMCvMCvM: bets $1.20
GriffinBerg: folds 
dndngod: folds 
Uncalled bet ($1.20) returned to CvMCvMCvM
CvMCvMCvM collected $1.67 from pot
CvMCvMCvM: doesn't show hand 
*** SUMMARY ***
Total pot $1.75 | Rake $0.08 
Board [3s 3c 5c]
Seat 1: lumen21 folded before Flop (didn't bet)
Seat 2: BSTUSim folded before Flop (didn't bet)
Seat 3: i L00K great folded before Flop (didn't bet)
Seat 4: GriffinBerg folded on the Flop
Seat 5: ZonTTT folded before Flop (didn't bet)
Seat 6: Ahangama (button) folded before Flop (didn't bet)
Seat 7: matiko09 (small blind) folded before Flop
Seat 8: dndngod (big blind) folded on the Flop
Seat 9: CvMCvMCvM collected ($1.67)





PokerStars Hand #150802373063:  Hold'em No Limit ($1/$2 USD) - 2016/03/23 14:56:35 CET [2016/03/23 9:56:35 ET]
Table 'Kiess' 9-max Seat #2 is the button
Seat 2: DUkalisUA ($705.28 in chips) 
Seat 3: Red4erT ($80 in chips) 
Seat 4: Igoriah ($200 in chips) 
Seat 5: chippo boy ($412.14 in chips) 
Seat 6: matiko09 ($260.86 in chips) 
Seat 7: InsomniaRU ($332.21 in chips) 
Red4erT: posts small blind $1
Igoriah: posts big blind $2
volwebni4ek: sits out 
*** HOLE CARDS ***
Dealt to matiko09 [4h 8d]
chippo boy: raises $4 to $6
matiko09: folds 
InsomniaRU: folds 
DUkalisUA: folds 
Red4erT: folds 
Igoriah: folds 
Uncalled bet ($4) returned to chippo boy
chippo boy collected $5 from pot
*** SUMMARY ***
Total pot $5 | Rake $0 
Seat 2: DUkalisUA (button) folded before Flop (didn't bet)
Seat 3: Red4erT (small blind) folded before Flop
Seat 4: Igoriah (big blind) folded before Flop
Seat 5: chippo boy collected ($5)
Seat 6: matiko09 folded before Flop (didn't bet)
Seat 7: InsomniaRU folded before Flop (didn't bet)





PokerStars Hand #150802374436:  Hold'em No Limit ($1/$2 USD) - 2016/03/23 14:56:39 CET [2016/03/23 9:56:39 ET]
Table 'Achaia' 9-max Seat #7 is the button
Seat 1: RamiroAgujis ($200 in chips) 
Seat 2: InsomniaRU ($242.13 in chips) 
Seat 3: matiko09 ($237.16 in chips) 
Seat 5: chaps1988 ($200 in chips) 
Seat 6: nickreason17 ($284.97 in chips) 
Seat 7: morosun ($163.70 in chips) 
Seat 9: PacPacBum ($200 in chips) 
IseeUcards will be allowed to play after the button
PacPacBum: posts small blind $1
RamiroAgujis: posts big blind $2
*** HOLE CARDS ***
Dealt to matiko09 [7h Qc]
InsomniaRU: folds 
matiko09: folds 
chaps1988: folds 
nickreason17: folds 
morosun: folds 
PacPacBum: raises $2.08 to $4.08
RamiroAgujis: calls $2.08
*** FLOP *** [Tc 6h 2d]
PacPacBum: checks 
RamiroAgujis: bets $4
PacPacBum: calls $4
*** TURN *** [Tc 6h 2d] [4s]
PacPacBum: checks 
RamiroAgujis: checks 
*** RIVER *** [Tc 6h 2d 4s] [8c]
PacPacBum: checks 
RamiroAgujis: checks 
*** SHOW DOWN ***
PacPacBum: shows [Td Js] (a pair of Tens)
RamiroAgujis: mucks hand 
PacPacBum collected $15.43 from pot
*** SUMMARY ***
Total pot $16.16 | Rake $0.73 
Board [Tc 6h 2d 4s 8c]
Seat 1: RamiroAgujis (big blind) mucked [8h Qs]
Seat 2: InsomniaRU folded before Flop (didn't bet)
Seat 3: matiko09 folded before Flop (didn't bet)
Seat 5: chaps1988 folded before Flop (didn't bet)
Seat 6: nickreason17 folded before Flop (didn't bet)
Seat 7: morosun (button) folded before Flop (didn't bet)
Seat 9: PacPacBum (small blind) showed [Td Js] and won ($15.43) with a pair of Tens





PokerStars Hand #150802377288:  Hold'em No Limit ($0.50/$1.00 USD) - 2016/03/23 14:56:46 CET [2016/03/23 9:56:46 ET]
Table 'Swings' 9-max Seat #2 is the button
Seat 1: carrsseis ($100 in chips) 
Seat 2: tomver0809 ($89.66 in chips) 
Seat 4: chaps1988 ($100 in chips) 
Seat 5: chautinhtri9 ($118.95 in chips) 
Seat 6: matiko09 ($137.27 in chips) 
Seat 7: PacPacBum ($110.99 in chips) 
Seat 8: RICKA16 ($104.96 in chips) 
Seat 9: Vlad_1965_77 ($125.28 in chips) 
maxxmeister will be allowed to play after the button
chaps1988: posts small blind $0.50
chautinhtri9: posts big blind $1
*** HOLE CARDS ***
Dealt to matiko09 [Td Js]
matiko09: folds 
PacPacBum: folds 
RICKA16: raises $2 to $3
Vlad_1965_77: folds 
carrsseis: calls $3
tomver0809: folds 
chaps1988: folds 
chautinhtri9: folds 
*** FLOP *** [Qs 9h Th]
RICKA16 has timed out
RICKA16: checks 
carrsseis: bets $5.50
RICKA16: folds 
Uncalled bet ($5.50) returned to carrsseis
carrsseis collected $7.16 from pot
carrsseis: doesn't show hand 
*** SUMMARY ***
Total pot $7.50 | Rake $0.34 
Board [Qs 9h Th]
Seat 1: carrsseis collected ($7.16)
Seat 2: tomver0809 (button) folded before Flop (didn't bet)
Seat 4: chaps1988 (small blind) folded before Flop
Seat 5: chautinhtri9 (big blind) folded before Flop
Seat 6: matiko09 folded before Flop (didn't bet)
Seat 7: PacPacBum folded before Flop (didn't bet)
Seat 8: RICKA16 folded on the Flop
Seat 9: Vlad_1965_77 folded before Flop (didn't bet)





PokerStars Hand #150802377130:  Hold'em No Limit ($0.50/$1.00 USD) - 2016/03/23 14:56:46 CET [2016/03/23 9:56:46 ET]
Table 'Merope II' 9-max Seat #1 is the button
Seat 1: Jimy Tiltman ($129.29 in chips) 
Seat 2: $-Twackle-$ ($100.50 in chips) 
Seat 3: pablos1922 ($90.31 in chips) 
Seat 5: chaps1988 ($104 in chips) 
Seat 6: Effort92 ($138.91 in chips) 
Seat 7: matiko09 ($104.53 in chips) 
Seat 8: Red4erT ($40 in chips) 
Seat 9: RICKA16 ($125.59 in chips) 
$-Twackle-$: posts small blind $0.50
pablos1922: posts big blind $1
PacPacBum: sits out 
*** HOLE CARDS ***
Dealt to matiko09 [Qs Ts]
chaps1988: raises $2 to $3
Effort92: folds 
matiko09: folds 
Red4erT: folds 
RICKA16: calls $3
Jimy Tiltman: folds 
$-Twackle-$: folds 
pablos1922: folds 
*** FLOP *** [7d 4s 7c]
chaps1988: bets $4.40
RICKA16: folds 
Uncalled bet ($4.40) returned to chaps1988
chaps1988 collected $7.16 from pot
chaps1988: doesn't show hand 
*** SUMMARY ***
Total pot $7.50 | Rake $0.34 
Board [7d 4s 7c]
Seat 1: Jimy Tiltman (button) folded before Flop (didn't bet)
Seat 2: $-Twackle-$ (small blind) folded before Flop
Seat 3: pablos1922 (big blind) folded before Flop
Seat 5: chaps1988 collected ($7.16)
Seat 6: Effort92 folded before Flop (didn't bet)
Seat 7: matiko09 folded before Flop (didn't bet)
Seat 8: Red4erT folded before Flop (didn't bet)
Seat 9: RICKA16 folded on the Flop





PokerStars Hand #150802377537:  Hold'em No Limit ($1/$2 USD) - 2016/03/23 14:56:47 CET [2016/03/23 9:56:47 ET]
Table 'Kypria II' 9-max Seat #8 is the button
Seat 2: coinflip_si ($314.85 in chips) 
Seat 3: seouljam ($285.92 in chips) 
Seat 4: VolanDog ($226.72 in chips) 
Seat 5: InsomniaRU ($375.50 in chips) 
Seat 6: matiko09 ($413.53 in chips) 
Seat 7: DUkalisUA ($200 in chips) 
Seat 8: nickreason17 ($200 in chips) 
Seat 9: sanrs57 ($186 in chips) 
seouljam said, "rebuy rebuy"
seouljam said, "camon reload"
sanrs57: posts small blind $1
coinflip_si: posts big blind $2
*** HOLE CARDS ***
Dealt to matiko09 [Qd Tc]
seouljam: folds 
seouljam said, "dont go"
VolanDog: raises $3 to $5
seouljam said, "no money honey?"
geldwolfje said, "haha end of money"
InsomniaRU: folds 
geldwolfje said, "no"
matiko09: folds 
seouljam said, "so deposit"
DUkalisUA: folds 
nickreason17: folds 
sanrs57: folds 
coinflip_si: folds 
Uncalled bet ($3) returned to VolanDog
VolanDog collected $5 from pot
geldwolfje said, "yess"
*** SUMMARY ***
Total pot $5 | Rake $0 
Seat 2: coinflip_si (big blind) folded before Flop
Seat 3: seouljam folded before Flop (didn't bet)
Seat 4: VolanDog collected ($5)
Seat 5: InsomniaRU folded before Flop (didn't bet)
Seat 6: matiko09 folded before Flop (didn't bet)
Seat 7: DUkalisUA folded before Flop (didn't bet)
Seat 8: nickreason17 (button) folded before Flop (didn't bet)
Seat 9: sanrs57 (small blind) folded before Flop





PokerStars Hand #150802378379:  Hold'em No Limit ($0.50/$1.00 USD) - 2016/03/23 14:56:49 CET [2016/03/23 9:56:49 ET]
Table 'Sylvia III' 9-max Seat #2 is the button
Seat 1: mycka86 ($100 in chips) 
Seat 2: florrin92 ($115.61 in chips) 
Seat 4: bigacsiga ($100 in chips) 
Seat 5: matiko09 ($100.20 in chips) 
Seat 6: PacPacBum ($100 in chips) 
bigacsiga: posts small blind $0.50
matiko09: posts big blind $1
easytalk777: sits out 
Blanky-Bad: sits out 
mycka86: posts the ante $0.20
florrin92: posts the ante $0.20
bigacsiga: posts the ante $0.20
matiko09: posts the ante $0.20
PacPacBum: posts the ante $0.20
*** HOLE CARDS ***
Dealt to matiko09 [5h Ac]
PacPacBum: folds 
mycka86: folds 
Muinmyheart leaves the table
nickreason17 joins the table at seat #8 
florrin92: folds 
bigacsiga: raises $2 to $3
matiko09: calls $2
*** FLOP *** [Qc 2s 9d]
bigacsiga: bets $4.50
matiko09: folds 
Uncalled bet ($4.50) returned to bigacsiga
bigacsiga collected $6.68 from pot
bigacsiga: doesn't show hand 
*** SUMMARY ***
Total pot $7 | Rake $0.32 
Board [Qc 2s 9d]
Seat 1: mycka86 folded before Flop (didn't bet)
Seat 2: florrin92 (button) folded before Flop (didn't bet)
Seat 4: bigacsiga (small blind) collected ($6.68)
Seat 5: matiko09 (big blind) folded on the Flop
Seat 6: PacPacBum folded before Flop (didn't bet)





PokerStars Hand #150802382092:  Hold'em No Limit ($0.50/$1.00 USD) - 2016/03/23 14:56:59 CET [2016/03/23 9:56:59 ET]
Table 'Asmodeus' 9-max Seat #6 is the button
Seat 1: Jimy Tiltman ($109.09 in chips) 
Seat 2: $-Twackle-$ ($100 in chips) 
Seat 3: nickreason17 ($103 in chips) 
Seat 4: Effort92 ($100 in chips) 
Seat 6: florrin92 ($102.70 in chips) 
Seat 7: mycka86 ($104.34 in chips) 
Seat 8: bonifacioppl ($100 in chips) 
Seat 9: matiko09 ($103.09 in chips) 
mycka86: posts small blind $0.50
bonifacioppl: posts big blind $1
chaps1988: sits out 
Jimy Tiltman: posts the ante $0.20
$-Twackle-$: posts the ante $0.20
nickreason17: posts the ante $0.20
Effort92: posts the ante $0.20
florrin92: posts the ante $0.20
mycka86: posts the ante $0.20
bonifacioppl: posts the ante $0.20
matiko09: posts the ante $0.20
*** HOLE CARDS ***
Dealt to matiko09 [5d 2h]
matiko09: folds 
Jimy Tiltman: folds 
$-Twackle-$: folds 
nickreason17: folds 
Effort92: folds 
florrin92: folds 
mycka86: folds 
Uncalled bet ($0.50) returned to bonifacioppl
bonifacioppl collected $2.60 from pot
bonifacioppl: doesn't show hand 
*** SUMMARY ***
Total pot $2.60 | Rake $0 
Seat 1: Jimy Tiltman folded before Flop (didn't bet)
Seat 2: $-Twackle-$ folded before Flop (didn't bet)
Seat 3: nickreason17 folded before Flop (didn't bet)
Seat 4: Effort92 folded before Flop (didn't bet)
Seat 6: florrin92 (button) folded before Flop (didn't bet)
Seat 7: mycka86 (small blind) folded before Flop
Seat 8: bonifacioppl (big blind) collected ($2.60)
Seat 9: matiko09 folded before Flop (didn't bet)





PokerStars Hand #150802382958:  Hold'em No Limit ($1/$2 USD) - 2016/03/23 14:57:01 CET [2016/03/23 9:57:01 ET]
Table 'Kiess' 9-max Seat #3 is the button
Seat 2: DUkalisUA ($705.28 in chips) 
Seat 3: Red4erT ($80 in chips) 
Seat 4: Igoriah ($200 in chips) 
Seat 5: chippo boy ($415.14 in chips) 
Seat 6: matiko09 ($260.86 in chips) 
Seat 7: InsomniaRU ($332.21 in chips) 
Igoriah: posts small blind $1
chippo boy: posts big blind $2
volwebni4ek: sits out 
*** HOLE CARDS ***
Dealt to matiko09 [7d 8h]
matiko09: folds 
InsomniaRU: folds 
DUkalisUA: folds 
Red4erT: raises $3 to $5
Igoriah: folds 
chippo boy: calls $3
*** FLOP *** [9s 5s Qc]
chippo boy: checks 
Red4erT: checks 
*** TURN *** [9s 5s Qc] [Th]
chippo boy: bets $6
Red4erT: folds 
Uncalled bet ($6) returned to chippo boy
chippo boy collected $10.50 from pot
*** SUMMARY ***
Total pot $11 | Rake $0.50 
Board [9s 5s Qc Th]
Seat 2: DUkalisUA folded before Flop (didn't bet)
Seat 3: Red4erT (button) folded on the Turn
Seat 4: Igoriah (small blind) folded before Flop
Seat 5: chippo boy (big blind) collected ($10.50)
Seat 6: matiko09 folded before Flop (didn't bet)
Seat 7: InsomniaRU folded before Flop (didn't bet)





PokerStars Hand #150802385337:  Hold'em No Limit (€0.50/€1.00 EUR) - 2016/03/23 14:57:07 CET [2016/03/23 9:57:07 ET]
Table 'Mercury III' 9-max Seat #3 is the button
Seat 1: matiko09 (€100 in chips) 
Seat 2: o.miro (€121.71 in chips) 
Seat 3: PacPacBum (€100.83 in chips) 
Seat 6: mycka86 (€100 in chips) 
Seat 8: gfxed (€33 in chips) 
Seat 9: Indr3k (€101.50 in chips) 
Muinmyheart will be allowed to play after the button
mycka86: posts small blind €0.50
$-Twackle-$: is sitting out 
gfxed: posts big blind €1
*** HOLE CARDS ***
Dealt to matiko09 [5h 5d]
$-Twackle-$ leaves the table
Indr3k: folds 
matiko09: folds 
o.miro: folds 
PacPacBum: folds 
mycka86: raises €1.75 to €2.75
gfxed: folds 
Uncalled bet (€1.75) returned to mycka86
mycka86 collected €2 from pot
*** SUMMARY ***
Total pot €2 | Rake €0 
Seat 1: matiko09 folded before Flop (didn't bet)
Seat 2: o.miro folded before Flop (didn't bet)
Seat 3: PacPacBum (button) folded before Flop (didn't bet)
Seat 6: mycka86 (small blind) collected (€2)
Seat 8: gfxed (big blind) folded before Flop
Seat 9: Indr3k folded before Flop (didn't bet)





PokerStars Hand #150802390712:  Hold'em No Limit ($0.25/$0.50 USD) - 2016/03/23 14:57:22 CET [2016/03/23 9:57:22 ET]
Table 'Pyrrhus' 9-max Seat #7 is the button
Seat 1: lumen21 ($84.22 in chips) 
Seat 2: BSTUSim ($64.12 in chips) 
Seat 3: i L00K great ($52.25 in chips) 
Seat 4: GriffinBerg ($40.91 in chips) 
Seat 5: ZonTTT ($53.98 in chips) 
Seat 6: Ahangama ($50 in chips) 
Seat 7: matiko09 ($138.75 in chips) 
Seat 8: dndngod ($77.93 in chips) 
Seat 9: CvMCvMCvM ($91.30 in chips) 
dndngod: posts small blind $0.25
CvMCvMCvM: posts big blind $0.50
*** HOLE CARDS ***
Dealt to matiko09 [8d As]
lumen21: folds 
BSTUSim: folds 
i L00K great: folds 
GriffinBerg: calls $0.50
ZonTTT: folds 
Ahangama: folds 
matiko09: raises $1.50 to $2
dndngod: folds 
CvMCvMCvM: calls $1.50
GriffinBerg: calls $1.50
*** FLOP *** [Tc Qd 5h]
CvMCvMCvM: checks 
GriffinBerg: checks 
matiko09: checks 
*** TURN *** [Tc Qd 5h] [3c]
CvMCvMCvM: checks 
GriffinBerg: bets $2
matiko09: folds 
CvMCvMCvM: folds 
Uncalled bet ($2) returned to GriffinBerg
GriffinBerg collected $5.97 from pot
*** SUMMARY ***
Total pot $6.25 | Rake $0.28 
Board [Tc Qd 5h 3c]
Seat 1: lumen21 folded before Flop (didn't bet)
Seat 2: BSTUSim folded before Flop (didn't bet)
Seat 3: i L00K great folded before Flop (didn't bet)
Seat 4: GriffinBerg collected ($5.97)
Seat 5: ZonTTT folded before Flop (didn't bet)
Seat 6: Ahangama folded before Flop (didn't bet)
Seat 7: matiko09 (button) folded on the Turn
Seat 8: dndngod (small blind) folded before Flop
Seat 9: CvMCvMCvM (big blind) folded on the Turn





PokerStars Hand #150802391281:  Hold'em No Limit ($0.50/$1.00 USD) - 2016/03/23 14:57:23 CET [2016/03/23 9:57:23 ET]
Table 'Sylvia III' 9-max Seat #4 is the button
Seat 1: mycka86 ($100 in chips) 
Seat 2: florrin92 ($115.41 in chips) 
Seat 4: bigacsiga ($103.48 in chips) 
Seat 5: matiko09 ($100 in chips) 
Seat 6: PacPacBum ($100 in chips) 
matiko09: posts small blind $0.50
PacPacBum: posts big blind $1
easytalk777: sits out 
nickreason17: sits out 
Blanky-Bad: sits out 
mycka86: posts the ante $0.20
florrin92: posts the ante $0.20
bigacsiga: posts the ante $0.20
matiko09: posts the ante $0.20
PacPacBum: posts the ante $0.20
*** HOLE CARDS ***
Dealt to matiko09 [Kh Qs]
mycka86: folds 
florrin92: folds 
bigacsiga: raises $1 to $2
matiko09: raises $7 to $9
PacPacBum: folds 
bigacsiga: calls $7
*** FLOP *** [9h 3s 2d]
carrsseis leaves the table
matiko09: checks 
bigacsiga: bets $10
matiko09: folds 
Uncalled bet ($10) returned to bigacsiga
bigacsiga collected $19.10 from pot
bigacsiga: doesn't show hand 
*** SUMMARY ***
Total pot $20 | Rake $0.90 
Board [9h 3s 2d]
Seat 1: mycka86 folded before Flop (didn't bet)
Seat 2: florrin92 folded before Flop (didn't bet)
Seat 4: bigacsiga (button) collected ($19.10)
Seat 5: matiko09 (small blind) folded on the Flop
Seat 6: PacPacBum (big blind) folded before Flop





PokerStars Hand #150802392323:  Hold'em No Limit ($0.50/$1.00 USD) - 2016/03/23 14:57:26 CET [2016/03/23 9:57:26 ET]
Table 'Asmodeus' 9-max Seat #7 is the button
Seat 1: Jimy Tiltman ($108.89 in chips) 
Seat 2: $-Twackle-$ ($100 in chips) 
Seat 3: nickreason17 ($102.80 in chips) 
Seat 4: Effort92 ($100 in chips) 
Seat 6: florrin92 ($102.50 in chips) 
Seat 7: mycka86 ($103.64 in chips) 
Seat 8: bonifacioppl ($101.90 in chips) 
Seat 9: matiko09 ($102.89 in chips) 
bonifacioppl: posts small blind $0.50
matiko09: posts big blind $1
chaps1988: sits out 
Jimy Tiltman: posts the ante $0.20
$-Twackle-$: posts the ante $0.20
nickreason17: posts the ante $0.20
Effort92: posts the ante $0.20
florrin92: posts the ante $0.20
mycka86: posts the ante $0.20
bonifacioppl: posts the ante $0.20
matiko09: posts the ante $0.20
*** HOLE CARDS ***
Dealt to matiko09 [5c 9h]
Jimy Tiltman: folds 
$-Twackle-$: folds 
nickreason17: folds 
Effort92: folds 
florrin92: folds 
mycka86: raises $2 to $3
bonifacioppl: folds 
matiko09: folds 
Uncalled bet ($2) returned to mycka86
mycka86 collected $4.10 from pot
*** SUMMARY ***
Total pot $4.10 | Rake $0 
Seat 1: Jimy Tiltman folded before Flop (didn't bet)
Seat 2: $-Twackle-$ folded before Flop (didn't bet)
Seat 3: nickreason17 folded before Flop (didn't bet)
Seat 4: Effort92 folded before Flop (didn't bet)
Seat 6: florrin92 folded before Flop (didn't bet)
Seat 7: mycka86 (button) collected ($4.10)
Seat 8: bonifacioppl (small blind) folded before Flop
Seat 9: matiko09 (big blind) folded before Flop





PokerStars Hand #150802393511:  Hold'em No Limit ($1/$2 USD) - 2016/03/23 14:57:30 CET [2016/03/23 9:57:30 ET]
Table 'Herba II' 9-max Seat #1 is the button
Seat 1: matiko09 ($290.38 in chips) 
Seat 2: nickreason17 ($200 in chips) 
Seat 3: Cirilico ($160 in chips) 
Seat 4: DUkalisUA ($400.40 in chips) 
Seat 5: chippo boy ($254.51 in chips) 
Seat 6: Too-Anti-To ($225.38 in chips) 
Seat 7: InsomniaRU ($377.70 in chips) 
Seat 8: T0ny Adams ($77 in chips) 
Seat 9: mrhighryza ($49.44 in chips) 
nickreason17: posts small blind $1
Cirilico: posts big blind $2
*** HOLE CARDS ***
Dealt to matiko09 [7d Kc]
DUkalisUA: folds 
chippo boy: calls $2
Too-Anti-To: folds 
InsomniaRU: folds 
T0ny Adams: folds 
mrhighryza: folds 
matiko09: folds 
nickreason17: folds 
Cirilico: raises $6 to $8
chippo boy: calls $6
*** FLOP *** [Kh 7s As]
Cirilico: bets $11
chippo boy: folds 
Uncalled bet ($11) returned to Cirilico
Cirilico collected $16.24 from pot
Cirilico: doesn't show hand 
*** SUMMARY ***
Total pot $17 | Rake $0.76 
Board [Kh 7s As]
Seat 1: matiko09 (button) folded before Flop (didn't bet)
Seat 2: nickreason17 (small blind) folded before Flop
Seat 3: Cirilico (big blind) collected ($16.24)
Seat 4: DUkalisUA folded before Flop (didn't bet)
Seat 5: chippo boy folded on the Flop
Seat 6: Too-Anti-To folded before Flop (didn't bet)
Seat 7: InsomniaRU folded before Flop (didn't bet)
Seat 8: T0ny Adams folded before Flop (didn't bet)
Seat 9: mrhighryza folded before Flop (didn't bet)





PokerStars Hand #150802394144:  Hold'em No Limit ($0.50/$1.00 USD) - 2016/03/23 14:57:31 CET [2016/03/23 9:57:31 ET]
Table 'Drakonia II' 9-max Seat #8 is the button
Seat 1: chautinhtri9 ($107.94 in chips) 
Seat 2: carrsseis ($101.50 in chips) 
Seat 3: dunga119 ($101.39 in chips) 
Seat 4: nickreason17 ($100 in chips) 
Seat 5: gchs83 ($39.50 in chips) 
Seat 6: Dantist1122 ($100 in chips) 
Seat 7: YuriiSolodya ($32.40 in chips) 
Seat 8: matiko09 ($100 in chips) 
Seat 9: mycka86 ($100 in chips) 
mycka86: posts small blind $0.50
chautinhtri9: posts big blind $1
*** HOLE CARDS ***
Dealt to matiko09 [Qd 9d]
carrsseis: folds 
dunga119: folds 
nickreason17: folds 
gchs83: folds 
Dantist1122: folds 
YuriiSolodya: folds 
matiko09: raises $1.27 to $2.27
mycka86: folds 
chautinhtri9: calls $1.27
*** FLOP *** [7d Kc 2d]
chautinhtri9: checks 
matiko09: bets $3.13
chautinhtri9: calls $3.13
*** TURN *** [7d Kc 2d] [8c]
chautinhtri9: checks 
matiko09: bets $7
chautinhtri9: folds 
Uncalled bet ($7) returned to matiko09
matiko09 collected $10.79 from pot
matiko09: doesn't show hand 
*** SUMMARY ***
Total pot $11.30 | Rake $0.51 
Board [7d Kc 2d 8c]
Seat 1: chautinhtri9 (big blind) folded on the Turn
Seat 2: carrsseis folded before Flop (didn't bet)
Seat 3: dunga119 folded before Flop (didn't bet)
Seat 4: nickreason17 folded before Flop (didn't bet)
Seat 5: gchs83 folded before Flop (didn't bet)
Seat 6: Dantist1122 folded before Flop (didn't bet)
Seat 7: YuriiSolodya folded before Flop (didn't bet)
Seat 8: matiko09 (button) collected ($10.79)
Seat 9: mycka86 (small blind) folded before Flop





PokerStars Hand #150802394395:  Hold'em No Limit (€0.50/€1.00 EUR) - 2016/03/23 14:57:32 CET [2016/03/23 9:57:32 ET]
Table 'Mercury III' 9-max Seat #6 is the button
Seat 1: matiko09 (€100 in chips) 
Seat 2: o.miro (€121.71 in chips) 
Seat 3: PacPacBum (€100.83 in chips) 
Seat 6: mycka86 (€101 in chips) 
Seat 8: gfxed (€32 in chips) 
Seat 9: Indr3k (€101.50 in chips) 
gfxed: posts small blind €0.50
Indr3k: posts big blind €1
Muinmyheart: sits out 
*** HOLE CARDS ***
Dealt to matiko09 [8s 9h]
matiko09: folds 
o.miro: folds 
PacPacBum: folds 
mycka86: raises €1.10 to €2.10
gfxed: folds 
Indr3k: folds 
Uncalled bet (€1.10) returned to mycka86
mycka86 collected €2.50 from pot
*** SUMMARY ***
Total pot €2.50 | Rake €0 
Seat 1: matiko09 folded before Flop (didn't bet)
Seat 2: o.miro folded before Flop (didn't bet)
Seat 3: PacPacBum folded before Flop (didn't bet)
Seat 6: mycka86 (button) collected (€2.50)
Seat 8: gfxed (small blind) folded before Flop
Seat 9: Indr3k (big blind) folded before Flop





PokerStars Hand #150802399200:  Hold'em No Limit ($1/$2 USD) - 2016/03/23 14:57:46 CET [2016/03/23 9:57:46 ET]
Table 'Kypria II' 9-max Seat #9 is the button
Seat 2: coinflip_si ($312.85 in chips) 
Seat 3: seouljam ($285.92 in chips) 
Seat 4: VolanDog ($229.72 in chips) 
Seat 5: InsomniaRU ($375.50 in chips) 
Seat 6: matiko09 ($413.53 in chips) 
Seat 7: DUkalisUA ($200 in chips) 
Seat 8: nickreason17 ($200 in chips) 
Seat 9: sanrs57 ($185 in chips) 
coinflip_si: posts small blind $1
seouljam: posts big blind $2
*** HOLE CARDS ***
Dealt to matiko09 [8d 8s]
VolanDog: folds 
seouljam said, "this is a good table"
InsomniaRU: folds 
matiko09: raises $3 to $5
geldwolfje said, "do you have money for me"
DUkalisUA: folds 
nickreason17: folds 
seouljam said, "lol"
sanrs57: folds 
geldwolfje said, "haha"
coinflip_si: calls $4
seouljam: folds 
*** FLOP *** [5c Qh 4h]
geldwolfje said, "come on"
coinflip_si: checks 
seouljam said, "i only have 2k in my bankroll"
matiko09: checks 
*** TURN *** [5c Qh 4h] [3d]
coinflip_si: bets $6.41
matiko09: calls $6.41
*** RIVER *** [5c Qh 4h 3d] [8c]
geldwolfje said, "oh that is a lot"
coinflip_si: bets $16
seouljam said, "no way"
matiko09: raises $28 to $44
coinflip_si: folds 
Uncalled bet ($28) returned to matiko09
matiko09 collected $54.26 from pot
matiko09: doesn't show hand 
*** SUMMARY ***
Total pot $56.82 | Rake $2.56 
Board [5c Qh 4h 3d 8c]
Seat 2: coinflip_si (small blind) folded on the River
Seat 3: seouljam (big blind) folded before Flop
Seat 4: VolanDog folded before Flop (didn't bet)
Seat 5: InsomniaRU folded before Flop (didn't bet)
Seat 6: matiko09 collected ($54.26)
Seat 7: DUkalisUA folded before Flop (didn't bet)
Seat 8: nickreason17 folded before Flop (didn't bet)
Seat 9: sanrs57 (button) folded before Flop (didn't bet)





PokerStars Hand #150802401001:  Hold'em No Limit (€0.50/€1.00 EUR) - 2016/03/23 14:57:50 CET [2016/03/23 9:57:50 ET]
Table 'Mercury III' 9-max Seat #8 is the button
Seat 1: matiko09 (€100 in chips) 
Seat 2: o.miro (€121.71 in chips) 
Seat 3: PacPacBum (€100.83 in chips) 
Seat 6: mycka86 (€102.50 in chips) 
Seat 8: gfxed (€31.50 in chips) 
Seat 9: Indr3k (€100.50 in chips) 
Indr3k: posts small blind €0.50
matiko09: posts big blind €1
Muinmyheart: sits out 
*** HOLE CARDS ***
Dealt to matiko09 [6s 9s]
o.miro: folds 
PacPacBum: raises €1.04 to €2.04
mycka86: folds 
gfxed: calls €2.04
Indr3k: folds 
matiko09: folds 
*** FLOP *** [2s Td 6c]
PacPacBum: checks 
gfxed: checks 
*** TURN *** [2s Td 6c] [9h]
PacPacBum: checks 
gfxed: bets €2
PacPacBum: folds 
Uncalled bet (€2) returned to gfxed
gfxed collected €5.33 from pot
*** SUMMARY ***
Total pot €5.58 | Rake €0.25 
Board [2s Td 6c 9h]
Seat 1: matiko09 (big blind) folded before Flop
Seat 2: o.miro folded before Flop (didn't bet)
Seat 3: PacPacBum folded on the Turn
Seat 6: mycka86 folded before Flop (didn't bet)
Seat 8: gfxed (button) collected (€5.33)
Seat 9: Indr3k (small blind) folded before Flop





PokerStars Hand #150802402734:  Hold'em No Limit ($1/$2 USD) - 2016/03/23 14:57:55 CET [2016/03/23 9:57:55 ET]
Table 'Achaia' 9-max Seat #9 is the button
Seat 1: RamiroAgujis ($200 in chips) 
Seat 3: matiko09 ($237.16 in chips) 
Seat 5: chaps1988 ($200 in chips) 
Seat 6: nickreason17 ($284.97 in chips) 
Seat 7: morosun ($163.70 in chips) 
Seat 9: PacPacBum ($207.35 in chips) 
RamiroAgujis: posts small blind $1
InsomniaRU: is sitting out 
matiko09: posts big blind $2
IseeUcards: sits out 
*** HOLE CARDS ***
Dealt to matiko09 [Jd Qd]
InsomniaRU leaves the table
chaps1988: folds 
nickreason17: raises $4 to $6
morosun: calls $6
PacPacBum: folds 
RamiroAgujis: raises $22 to $28
DUkalisUA joins the table at seat #2 
matiko09: folds 
nickreason17: folds 
morosun: calls $22
*** FLOP *** [6c 9c 3s]
RamiroAgujis: bets $33
morosun: calls $33
*** TURN *** [6c 9c 3s] [Ts]
DUkalisUA leaves the table
RamiroAgujis: checks 
morosun: bets $102.70 and is all-in
RamiroAgujis: folds 
Uncalled bet ($102.70) returned to morosun
morosun collected $127.20 from pot
*** SUMMARY ***
Total pot $130 | Rake $2.80 
Board [6c 9c 3s Ts]
Seat 1: RamiroAgujis (small blind) folded on the Turn
Seat 3: matiko09 (big blind) folded before Flop
Seat 5: chaps1988 folded before Flop (didn't bet)
Seat 6: nickreason17 folded before Flop
Seat 7: morosun collected ($127.20)
Seat 9: PacPacBum (button) folded before Flop (didn't bet)





PokerStars Hand #150802404244:  Hold'em No Limit ($0.50/$1.00 USD) - 2016/03/23 14:58:00 CET [2016/03/23 9:58:00 ET]
Table 'Merope II' 9-max Seat #2 is the button
Seat 1: Jimy Tiltman ($129.29 in chips) 
Seat 2: $-Twackle-$ ($100 in chips) 
Seat 3: pablos1922 ($89.31 in chips) 
Seat 4: PacPacBum ($100 in chips) 
Seat 5: chaps1988 ($108.16 in chips) 
Seat 6: Effort92 ($138.91 in chips) 
Seat 7: matiko09 ($104.53 in chips) 
Seat 8: Red4erT ($40 in chips) 
Seat 9: RICKA16 ($122.59 in chips) 
pablos1922: posts small blind $0.50
PacPacBum: posts big blind $1
*** HOLE CARDS ***
Dealt to matiko09 [4s 2c]
chaps1988: folds 
Effort92: folds 
matiko09: folds 
Red4erT: raises $1.50 to $2.50
RICKA16: folds 
Jimy Tiltman: folds 
$-Twackle-$: folds 
pablos1922: folds 
PacPacBum: folds 
Uncalled bet ($1.50) returned to Red4erT
Red4erT collected $2.50 from pot
Red4erT: doesn't show hand 
*** SUMMARY ***
Total pot $2.50 | Rake $0 
Seat 1: Jimy Tiltman folded before Flop (didn't bet)
Seat 2: $-Twackle-$ (button) folded before Flop (didn't bet)
Seat 3: pablos1922 (small blind) folded before Flop
Seat 4: PacPacBum (big blind) folded before Flop
Seat 5: chaps1988 folded before Flop (didn't bet)
Seat 6: Effort92 folded before Flop (didn't bet)
Seat 7: matiko09 folded before Flop (didn't bet)
Seat 8: Red4erT collected ($2.50)
Seat 9: RICKA16 folded before Flop (didn't bet)





PokerStars Hand #150802407606:  Hold'em No Limit ($1/$2 USD) - 2016/03/23 14:58:09 CET [2016/03/23 9:58:09 ET]
Table 'Kiess' 9-max Seat #4 is the button
Seat 2: DUkalisUA ($705.28 in chips) 
Seat 3: Red4erT ($80 in chips) 
Seat 4: Igoriah ($200 in chips) 
Seat 5: chippo boy ($420.64 in chips) 
Seat 6: matiko09 ($260.86 in chips) 
Seat 7: InsomniaRU ($332.21 in chips) 
chippo boy: posts small blind $1
matiko09: posts big blind $2
volwebni4ek: sits out 
Cirilico: sits out 
*** HOLE CARDS ***
Dealt to matiko09 [Qc Ks]
InsomniaRU: folds 
DUkalisUA: folds 
Red4erT: raises $3 to $5
Igoriah: folds 
chippo boy: folds 
matiko09: calls $3
*** FLOP *** [6s 4c Jh]
matiko09: checks 
Red4erT: bets $5.46
matiko09: folds 
Uncalled bet ($5.46) returned to Red4erT
Red4erT collected $10.50 from pot
Red4erT: doesn't show hand 
*** SUMMARY ***
Total pot $11 | Rake $0.50 
Board [6s 4c Jh]
Seat 2: DUkalisUA folded before Flop (didn't bet)
Seat 3: Red4erT collected ($10.50)
Seat 4: Igoriah (button) folded before Flop (didn't bet)
Seat 5: chippo boy (small blind) folded before Flop
Seat 6: matiko09 (big blind) folded on the Flop
Seat 7: InsomniaRU folded before Flop (didn't bet)





PokerStars Hand #150802409044:  Hold'em No Limit ($0.50/$1.00 USD) - 2016/03/23 14:58:13 CET [2016/03/23 9:58:13 ET]
Table 'Swings' 9-max Seat #4 is the button
Seat 1: carrsseis ($104.16 in chips) 
Seat 2: tomver0809 ($89.66 in chips) 
Seat 4: chaps1988 ($100 in chips) 
Seat 5: chautinhtri9 ($117.95 in chips) 
Seat 6: matiko09 ($137.27 in chips) 
Seat 7: PacPacBum ($110.99 in chips) 
Seat 8: RICKA16 ($101.96 in chips) 
Seat 9: Vlad_1965_77 ($125.28 in chips) 
chautinhtri9: posts small blind $0.50
matiko09: posts big blind $1
maxxmeister: sits out 
*** HOLE CARDS ***
Dealt to matiko09 [9h 3c]
PacPacBum: folds 
RICKA16: folds 
Vlad_1965_77: raises $2 to $3
carrsseis: folds 
tomver0809: folds 
chaps1988: folds 
chautinhtri9: folds 
matiko09: folds 
Uncalled bet ($2) returned to Vlad_1965_77
Vlad_1965_77 collected $2.50 from pot
*** SUMMARY ***
Total pot $2.50 | Rake $0 
Seat 1: carrsseis folded before Flop (didn't bet)
Seat 2: tomver0809 folded before Flop (didn't bet)
Seat 4: chaps1988 (button) folded before Flop (didn't bet)
Seat 5: chautinhtri9 (small blind) folded before Flop
Seat 6: matiko09 (big blind) folded before Flop
Seat 7: PacPacBum folded before Flop (didn't bet)
Seat 8: RICKA16 folded before Flop (didn't bet)
Seat 9: Vlad_1965_77 collected ($2.50)





PokerStars Hand #150802409067:  Hold'em No Limit ($0.50/$1.00 USD) - 2016/03/23 14:58:13 CET [2016/03/23 9:58:13 ET]
Table 'Asmodeus' 9-max Seat #8 is the button
Seat 1: Jimy Tiltman ($108.69 in chips) 
Seat 2: $-Twackle-$ ($100 in chips) 
Seat 3: nickreason17 ($102.60 in chips) 
Seat 4: Effort92 ($100 in chips) 
Seat 6: florrin92 ($102.30 in chips) 
Seat 7: mycka86 ($106.54 in chips) 
Seat 8: bonifacioppl ($101.20 in chips) 
Seat 9: matiko09 ($101.69 in chips) 
matiko09: posts small blind $0.50
Jimy Tiltman: posts big blind $1
chaps1988: sits out 
Jimy Tiltman: posts the ante $0.20
$-Twackle-$: posts the ante $0.20
nickreason17: posts the ante $0.20
Effort92: posts the ante $0.20
florrin92: posts the ante $0.20
mycka86: posts the ante $0.20
bonifacioppl: posts the ante $0.20
matiko09: posts the ante $0.20
*** HOLE CARDS ***
Dealt to matiko09 [4h As]
$-Twackle-$: folds 
nickreason17: folds 
Effort92: folds 
florrin92: folds 
mycka86: raises $2 to $3
bonifacioppl: folds 
matiko09: folds 
Jimy Tiltman: calls $2
*** FLOP *** [9s Kd Qh]
Jimy Tiltman: checks 
mycka86: bets $5.40
chaps1988 leaves the table
Jimy Tiltman: calls $5.40
*** TURN *** [9s Kd Qh] [Js]
Jimy Tiltman: checks 
mycka86: checks 
*** RIVER *** [9s Kd Qh Js] [3c]
Jimy Tiltman: checks 
mycka86: checks 
*** SHOW DOWN ***
Jimy Tiltman: shows [8h Kh] (a pair of Kings)
mycka86: shows [Ks 9d] (two pair, Kings and Nines)
mycka86 collected $18.05 from pot
*** SUMMARY ***
Total pot $18.90 | Rake $0.85 
Board [9s Kd Qh Js 3c]
Seat 1: Jimy Tiltman (big blind) showed [8h Kh] and lost with a pair of Kings
Seat 2: $-Twackle-$ folded before Flop (didn't bet)
Seat 3: nickreason17 folded before Flop (didn't bet)
Seat 4: Effort92 folded before Flop (didn't bet)
Seat 6: florrin92 folded before Flop (didn't bet)
Seat 7: mycka86 showed [Ks 9d] and won ($18.05) with two pair, Kings and Nines
Seat 8: bonifacioppl (button) folded before Flop (didn't bet)
Seat 9: matiko09 (small blind) folded before Flop





PokerStars Hand #150802411293:  Hold'em No Limit ($0.50/$1.00 USD) - 2016/03/23 14:58:20 CET [2016/03/23 9:58:20 ET]
Table 'Drakonia II' 9-max Seat #9 is the button
Seat 1: chautinhtri9 ($102.54 in chips) 
Seat 2: carrsseis ($101.50 in chips) 
Seat 3: dunga119 ($101.39 in chips) 
Seat 4: nickreason17 ($100 in chips) 
Seat 5: gchs83 ($39.50 in chips) 
Seat 6: Dantist1122 ($100 in chips) 
Seat 7: YuriiSolodya ($32.40 in chips) 
Seat 8: matiko09 ($105.39 in chips) 
Seat 9: mycka86 ($100 in chips) 
chautinhtri9: posts small blind $0.50
carrsseis: posts big blind $1
*** HOLE CARDS ***
Dealt to matiko09 [Jh 9c]
dunga119: folds 
nickreason17: folds 
gchs83 has timed out
gchs83: folds 
Dantist1122: folds 
YuriiSolodya: folds 
matiko09: folds 
mycka86: raises $1.10 to $2.10
chautinhtri9: calls $1.60
carrsseis: raises $6.40 to $8.50
mycka86: folds 
chautinhtri9: calls $6.40
*** FLOP *** [5h 4s 5c]
chautinhtri9: checks 
carrsseis: bets $8.50
chautinhtri9: raises $12.50 to $21
carrsseis: folds 
Uncalled bet ($12.50) returned to chautinhtri9
chautinhtri9 collected $34.48 from pot
chautinhtri9: doesn't show hand 
*** SUMMARY ***
Total pot $36.10 | Rake $1.62 
Board [5h 4s 5c]
Seat 1: chautinhtri9 (small blind) collected ($34.48)
Seat 2: carrsseis (big blind) folded on the Flop
Seat 3: dunga119 folded before Flop (didn't bet)
Seat 4: nickreason17 folded before Flop (didn't bet)
Seat 5: gchs83 folded before Flop (didn't bet)
Seat 6: Dantist1122 folded before Flop (didn't bet)
Seat 7: YuriiSolodya folded before Flop (didn't bet)
Seat 8: matiko09 folded before Flop (didn't bet)
Seat 9: mycka86 (button) folded before Flop





PokerStars Hand #150802412953:  Hold'em No Limit ($0.50/$1.00 USD) - 2016/03/23 14:58:25 CET [2016/03/23 9:58:25 ET]
Table 'Sylvia III' 9-max Seat #5 is the button
Seat 1: mycka86 ($100 in chips) 
Seat 2: florrin92 ($115.21 in chips) 
Seat 4: bigacsiga ($113.38 in chips) 
Seat 5: matiko09 ($100 in chips) 
Seat 6: PacPacBum ($100 in chips) 
Seat 7: easytalk777 ($100 in chips) 
PacPacBum: posts small blind $0.50
easytalk777: posts big blind $1
nickreason17: sits out 
Blanky-Bad: sits out 
mycka86: posts the ante $0.20
florrin92: posts the ante $0.20
bigacsiga: posts the ante $0.20
matiko09: posts the ante $0.20
PacPacBum: posts the ante $0.20
easytalk777: posts the ante $0.20
*** HOLE CARDS ***
Dealt to matiko09 [Kh 6d]
mycka86: folds 
florrin92: folds 
bigacsiga: folds 
bigacsiga leaves the table
matiko09: folds 
PacPacBum: folds 
Uncalled bet ($0.50) returned to easytalk777
easytalk777 collected $2.20 from pot
easytalk777: doesn't show hand 
*** SUMMARY ***
Total pot $2.20 | Rake $0 
Seat 1: mycka86 folded before Flop (didn't bet)
Seat 2: florrin92 folded before Flop (didn't bet)
Seat 4: bigacsiga folded before Flop (didn't bet)
Seat 5: matiko09 (button) folded before Flop (didn't bet)
Seat 6: PacPacBum (small blind) folded before Flop
Seat 7: easytalk777 (big blind) collected ($2.20)





PokerStars Hand #150802416263:  Hold'em No Limit ($0.50/$1.00 USD) - 2016/03/23 14:58:35 CET [2016/03/23 9:58:35 ET]
Table 'Merope II' 9-max Seat #3 is the button
Seat 1: Jimy Tiltman ($129.29 in chips) 
Seat 2: $-Twackle-$ ($100 in chips) 
Seat 3: pablos1922 ($88.81 in chips) 
Seat 4: PacPacBum ($100 in chips) 
Seat 5: chaps1988 ($108.16 in chips) 
Seat 6: Effort92 ($138.91 in chips) 
Seat 7: matiko09 ($104.53 in chips) 
Seat 8: Red4erT ($41.50 in chips) 
Seat 9: RICKA16 ($122.59 in chips) 
PacPacBum: posts small blind $0.50
chaps1988: posts big blind $1
*** HOLE CARDS ***
Dealt to matiko09 [4c Ts]
Effort92: folds 
matiko09: folds 
Red4erT: raises $1.50 to $2.50
RICKA16: folds 
Jimy Tiltman: folds 
$-Twackle-$: folds 
pablos1922: folds 
PacPacBum: folds 
chaps1988: calls $1.50
*** FLOP *** [8d 5s Td]
chaps1988: checks 
Red4erT: bets $2.73
chaps1988: folds 
Uncalled bet ($2.73) returned to Red4erT
Red4erT collected $5.25 from pot
Red4erT: doesn't show hand 
*** SUMMARY ***
Total pot $5.50 | Rake $0.25 
Board [8d 5s Td]
Seat 1: Jimy Tiltman folded before Flop (didn't bet)
Seat 2: $-Twackle-$ folded before Flop (didn't bet)
Seat 3: pablos1922 (button) folded before Flop (didn't bet)
Seat 4: PacPacBum (small blind) folded before Flop
Seat 5: chaps1988 (big blind) folded on the Flop
Seat 6: Effort92 folded before Flop (didn't bet)
Seat 7: matiko09 folded before Flop (didn't bet)
Seat 8: Red4erT collected ($5.25)
Seat 9: RICKA16 folded before Flop (didn't bet)





PokerStars Hand #150802417976:  Hold'em No Limit ($1/$2 USD) - 2016/03/23 14:58:40 CET [2016/03/23 9:58:40 ET]
Table 'Herba II' 9-max Seat #2 is the button
Seat 1: matiko09 ($290.38 in chips) 
Seat 2: nickreason17 ($200 in chips) 
Seat 3: Cirilico ($168.24 in chips) 
Seat 4: DUkalisUA ($400.40 in chips) 
Seat 5: chippo boy ($246.51 in chips) 
Seat 6: Too-Anti-To ($225.38 in chips) 
Seat 7: InsomniaRU ($377.70 in chips) 
Seat 8: T0ny Adams ($77 in chips) 
Seat 9: mrhighryza ($49.44 in chips) 
Cirilico: posts small blind $1
DUkalisUA: posts big blind $2
*** HOLE CARDS ***
Dealt to matiko09 [Qh 8d]
chippo boy: folds 
Too-Anti-To: folds 
InsomniaRU: folds 
T0ny Adams: folds 
mrhighryza: folds 
matiko09: folds 
nickreason17: folds 
Cirilico: raises $4 to $6
DUkalisUA: raises $11 to $17
Cirilico: folds 
Uncalled bet ($11) returned to DUkalisUA
DUkalisUA collected $12 from pot
DUkalisUA: doesn't show hand 
*** SUMMARY ***
Total pot $12 | Rake $0 
Seat 1: matiko09 folded before Flop (didn't bet)
Seat 2: nickreason17 (button) folded before Flop (didn't bet)
Seat 3: Cirilico (small blind) folded before Flop
Seat 4: DUkalisUA (big blind) collected ($12)
Seat 5: chippo boy folded before Flop (didn't bet)
Seat 6: Too-Anti-To folded before Flop (didn't bet)
Seat 7: InsomniaRU folded before Flop (didn't bet)
Seat 8: T0ny Adams folded before Flop (didn't bet)
Seat 9: mrhighryza folded before Flop (didn't bet)





PokerStars Hand #150802418561:  Hold'em No Limit (€0.50/€1.00 EUR) - 2016/03/23 14:58:41 CET [2016/03/23 9:58:41 ET]
Table 'Mercury III' 9-max Seat #9 is the button
Seat 1: matiko09 (€100 in chips) 
Seat 2: o.miro (€121.71 in chips) 
Seat 3: PacPacBum (€100 in chips) 
Seat 6: mycka86 (€102.50 in chips) 
Seat 8: gfxed (€34.79 in chips) 
Seat 9: Indr3k (€100 in chips) 
matiko09: posts small blind €0.50
o.miro: posts big blind €1
Muinmyheart: sits out 
*** HOLE CARDS ***
Dealt to matiko09 [Ts Ks]
PacPacBum: folds 
mycka86: folds 
gfxed: raises €1.70 to €2.70
Indr3k: folds 
matiko09: folds 
STrakDD joins the table at seat #7 
o.miro: calls €1.70
*** FLOP *** [Jd Kd 6s]
o.miro: checks 
gfxed: bets €3
o.miro: folds 
Uncalled bet (€3) returned to gfxed
gfxed collected €5.63 from pot
*** SUMMARY ***
Total pot €5.90 | Rake €0.27 
Board [Jd Kd 6s]
Seat 1: matiko09 (small blind) folded before Flop
Seat 2: o.miro (big blind) folded on the Flop
Seat 3: PacPacBum folded before Flop (didn't bet)
Seat 6: mycka86 folded before Flop (didn't bet)
Seat 8: gfxed collected (€5.63)
Seat 9: Indr3k (button) folded before Flop (didn't bet)





PokerStars Hand #150802418897:  Hold'em No Limit ($0.25/$0.50 USD) - 2016/03/23 14:58:42 CET [2016/03/23 9:58:42 ET]
Table 'Pyrrhus' 9-max Seat #8 is the button
Seat 1: lumen21 ($84.22 in chips) 
Seat 2: BSTUSim ($64.12 in chips) 
Seat 3: i L00K great ($52.25 in chips) 
Seat 4: GriffinBerg ($44.88 in chips) 
Seat 5: ZonTTT ($53.98 in chips) 
Seat 6: Ahangama ($50 in chips) 
Seat 7: matiko09 ($136.75 in chips) 
Seat 8: dndngod ($77.68 in chips) 
Seat 9: CvMCvMCvM ($89.30 in chips) 
CvMCvMCvM: posts small blind $0.25
lumen21: posts big blind $0.50
*** HOLE CARDS ***
Dealt to matiko09 [3c Js]
BSTUSim: folds 
i L00K great: folds 
GriffinBerg: calls $0.50
ZonTTT: folds 
Ahangama: raises $1.50 to $2
matiko09: folds 
dndngod: folds 
CvMCvMCvM: folds 
lumen21: folds 
GriffinBerg: folds 
Uncalled bet ($1.50) returned to Ahangama
Ahangama collected $1.75 from pot
Ahangama: doesn't show hand 
*** SUMMARY ***
Total pot $1.75 | Rake $0 
Seat 1: lumen21 (big blind) folded before Flop
Seat 2: BSTUSim folded before Flop (didn't bet)
Seat 3: i L00K great folded before Flop (didn't bet)
Seat 4: GriffinBerg folded before Flop
Seat 5: ZonTTT folded before Flop (didn't bet)
Seat 6: Ahangama collected ($1.75)
Seat 7: matiko09 folded before Flop (didn't bet)
Seat 8: dndngod (button) folded before Flop (didn't bet)
Seat 9: CvMCvMCvM (small blind) folded before Flop





PokerStars Hand #150802419300:  Hold'em No Limit ($0.50/$1.00 USD) - 2016/03/23 14:58:43 CET [2016/03/23 9:58:43 ET]
Table 'Swings' 9-max Seat #5 is the button
Seat 1: carrsseis ($104.16 in chips) 
Seat 2: tomver0809 ($89.66 in chips) 
Seat 4: chaps1988 ($100 in chips) 
Seat 5: chautinhtri9 ($117.45 in chips) 
Seat 6: matiko09 ($136.27 in chips) 
Seat 7: PacPacBum ($110.99 in chips) 
Seat 8: RICKA16 ($101.96 in chips) 
Seat 9: Vlad_1965_77 ($126.78 in chips) 
matiko09: posts small blind $0.50
PacPacBum: posts big blind $1
maxxmeister: sits out 
*** HOLE CARDS ***
Dealt to matiko09 [Kc Ts]
RICKA16: folds 
Vlad_1965_77: folds 
carrsseis: folds 
tomver0809: calls $1
chaps1988: folds 
chautinhtri9: folds 
matiko09: calls $0.50
PacPacBum: checks 
*** FLOP *** [4h 8h 2d]
matiko09: checks 
PacPacBum: checks 
tomver0809: bets $3
matiko09: folds 
PacPacBum: folds 
Uncalled bet ($3) returned to tomver0809
tomver0809 collected $2.86 from pot
tomver0809: doesn't show hand 
*** SUMMARY ***
Total pot $3 | Rake $0.14 
Board [4h 8h 2d]
Seat 1: carrsseis folded before Flop (didn't bet)
Seat 2: tomver0809 collected ($2.86)
Seat 4: chaps1988 folded before Flop (didn't bet)
Seat 5: chautinhtri9 (button) folded before Flop (didn't bet)
Seat 6: matiko09 (small blind) folded on the Flop
Seat 7: PacPacBum (big blind) folded on the Flop
Seat 8: RICKA16 folded before Flop (didn't bet)
Seat 9: Vlad_1965_77 folded before Flop (didn't bet)





PokerStars Hand #150802420764:  Hold'em No Limit ($1/$2 USD) - 2016/03/23 14:58:48 CET [2016/03/23 9:58:48 ET]
Table 'Achaia' 9-max Seat #1 is the button
Seat 1: RamiroAgujis ($200 in chips) 
Seat 3: matiko09 ($235.16 in chips) 
Seat 4: erfk1958 ($97 in chips) 
Seat 5: chaps1988 ($200 in chips) 
Seat 6: nickreason17 ($278.97 in chips) 
Seat 7: morosun ($229.90 in chips) 
Seat 9: PacPacBum ($207.35 in chips) 
matiko09: posts small blind $1
erfk1958: posts big blind $2
IseeUcards: sits out 
*** HOLE CARDS ***
Dealt to matiko09 [Ts 3d]
chaps1988: folds 
nickreason17: folds 
morosun: raises $4 to $6
PacPacBum: folds 
RamiroAgujis: folds 
matiko09: folds 
erfk1958: calls $4
*** FLOP *** [Ks 2d 9c]
erfk1958: checks 
morosun: bets $4
erfk1958: folds 
Uncalled bet ($4) returned to morosun
morosun collected $12.42 from pot
*** SUMMARY ***
Total pot $13 | Rake $0.58 
Board [Ks 2d 9c]
Seat 1: RamiroAgujis (button) folded before Flop (didn't bet)
Seat 3: matiko09 (small blind) folded before Flop
Seat 4: erfk1958 (big blind) folded on the Flop
Seat 5: chaps1988 folded before Flop (didn't bet)
Seat 6: nickreason17 folded before Flop (didn't bet)
Seat 7: morosun collected ($12.42)
Seat 9: PacPacBum folded before Flop (didn't bet)





PokerStars Hand #150802422329:  Hold'em No Limit ($0.50/$1.00 USD) - 2016/03/23 14:58:53 CET [2016/03/23 9:58:53 ET]
Table 'Sylvia III' 9-max Seat #6 is the button
Seat 1: mycka86 ($100 in chips) 
Seat 2: florrin92 ($115.01 in chips) 
Seat 5: matiko09 ($100 in chips) 
Seat 6: PacPacBum ($100 in chips) 
Seat 7: easytalk777 ($101.50 in chips) 
Seat 8: nickreason17 ($119.43 in chips) 
easytalk777: posts small blind $0.50
nickreason17: posts big blind $1
Blanky-Bad: sits out 
mycka86: posts the ante $0.20
florrin92: posts the ante $0.20
matiko09: posts the ante $0.20
PacPacBum: posts the ante $0.20
easytalk777: posts the ante $0.20
nickreason17: posts the ante $0.20
*** HOLE CARDS ***
Dealt to matiko09 [7s 8s]
mycka86: folds 
florrin92: folds 
matiko09: raises $1.50 to $2.50
PacPacBum: folds 
easytalk777: folds 
nickreason17: calls $1.50
*** FLOP *** [2h As 8c]
nickreason17: checks 
matiko09: checks 
*** TURN *** [2h As 8c] [2c]
lombardo11 joins the table at seat #4 
nickreason17: bets $3.84
matiko09: calls $3.84
*** RIVER *** [2h As 8c 2c] [5d]
nickreason17: checks 
matiko09: checks 
*** SHOW DOWN ***
nickreason17: shows [9s Qs] (a pair of Deuces)
matiko09: shows [7s 8s] (two pair, Eights and Deuces)
matiko09 collected $13.73 from pot
*** SUMMARY ***
Total pot $14.38 | Rake $0.65 
Board [2h As 8c 2c 5d]
Seat 1: mycka86 folded before Flop (didn't bet)
Seat 2: florrin92 folded before Flop (didn't bet)
Seat 5: matiko09 showed [7s 8s] and won ($13.73) with two pair, Eights and Deuces
Seat 6: PacPacBum (button) folded before Flop (didn't bet)
Seat 7: easytalk777 (small blind) folded before Flop
Seat 8: nickreason17 (big blind) showed [9s Qs] and lost with a pair of Deuces





PokerStars Hand #150802425936:  Hold'em No Limit ($1/$2 USD) - 2016/03/23 14:59:03 CET [2016/03/23 9:59:03 ET]
Table 'Kiess' 9-max Seat #5 is the button
Seat 2: DUkalisUA ($705.28 in chips) 
Seat 3: Red4erT ($85.50 in chips) 
Seat 4: Igoriah ($200 in chips) 
Seat 5: chippo boy ($419.64 in chips) 
Seat 6: matiko09 ($255.86 in chips) 
Seat 8: erfk1958 ($144.21 in chips) 
matiko09: posts small blind $1
InsomniaRU: is sitting out 
InsomniaRU leaves the table
erfk1958: posts big blind $2
volwebni4ek: sits out 
Cirilico: sits out 
*** HOLE CARDS ***
Dealt to matiko09 [9h 6s]
chaps1988 joins the table at seat #7 
DUkalisUA: folds 
Red4erT: folds 
Igoriah: folds 
chippo boy: folds 
matiko09: folds 
Uncalled bet ($1) returned to erfk1958
erfk1958 collected $2 from pot
erfk1958: doesn't show hand 
*** SUMMARY ***
Total pot $2 | Rake $0 
Seat 2: DUkalisUA folded before Flop (didn't bet)
Seat 3: Red4erT folded before Flop (didn't bet)
Seat 4: Igoriah folded before Flop (didn't bet)
Seat 5: chippo boy (button) folded before Flop (didn't bet)
Seat 6: matiko09 (small blind) folded before Flop
Seat 8: erfk1958 (big blind) collected ($2)





PokerStars Hand #150802431544:  Hold'em No Limit ($1/$2 USD) - 2016/03/23 14:59:20 CET [2016/03/23 9:59:20 ET]
Table 'Kiess' 9-max Seat #6 is the button
Seat 2: DUkalisUA ($705.28 in chips) 
Seat 3: Red4erT ($85.50 in chips) 
Seat 4: Igoriah ($200 in chips) 
Seat 5: chippo boy ($419.64 in chips) 
Seat 6: matiko09 ($254.86 in chips) 
Seat 8: erfk1958 ($145.21 in chips) 
Seat 9: volwebni4ek ($80 in chips) 
chaps1988 will be allowed to play after the button
erfk1958: posts small blind $1
volwebni4ek: posts big blind $2
Cirilico: sits out 
*** HOLE CARDS ***
Dealt to matiko09 [3h 5c]
DUkalisUA: folds 
Red4erT: raises $4 to $6
Igoriah: folds 
chippo boy: calls $6
matiko09: folds 
erfk1958: folds 
volwebni4ek: folds 
*** FLOP *** [6s 8h Qd]
Red4erT: checks 
chippo boy: checks 
*** TURN *** [6s 8h Qd] [Ad]
Red4erT: checks 
chippo boy: checks 
*** RIVER *** [6s 8h Qd Ad] [7h]
Red4erT: bets $10.74
chippo boy: folds 
Uncalled bet ($10.74) returned to Red4erT
Red4erT collected $14.32 from pot
Red4erT: doesn't show hand 
*** SUMMARY ***
Total pot $15 | Rake $0.68 
Board [6s 8h Qd Ad 7h]
Seat 2: DUkalisUA folded before Flop (didn't bet)
Seat 3: Red4erT collected ($14.32)
Seat 4: Igoriah folded before Flop (didn't bet)
Seat 5: chippo boy folded on the River
Seat 6: matiko09 (button) folded before Flop (didn't bet)
Seat 8: erfk1958 (small blind) folded before Flop
Seat 9: volwebni4ek (big blind) folded before Flop





PokerStars Hand #150802432045:  Hold'em No Limit ($1/$2 USD) - 2016/03/23 14:59:22 CET [2016/03/23 9:59:22 ET]
Table 'Achaia' 9-max Seat #3 is the button
Seat 1: RamiroAgujis ($200 in chips) 
Seat 3: matiko09 ($234.16 in chips) 
Seat 4: erfk1958 ($91 in chips) 
Seat 5: chaps1988 ($200 in chips) 
Seat 6: nickreason17 ($278.97 in chips) 
Seat 7: morosun ($236.32 in chips) 
Seat 9: PacPacBum ($207.35 in chips) 
erfk1958: posts small blind $1
chaps1988: posts big blind $2
IseeUcards: sits out 
*** HOLE CARDS ***
Dealt to matiko09 [4s Tc]
nickreason17: raises $4 to $6
morosun: folds 
PacPacBum: folds 
RamiroAgujis: folds 
matiko09: folds 
erfk1958: folds 
chaps1988: folds 
Uncalled bet ($4) returned to nickreason17
nickreason17 collected $5 from pot
*** SUMMARY ***
Total pot $5 | Rake $0 
Seat 1: RamiroAgujis folded before Flop (didn't bet)
Seat 3: matiko09 (button) folded before Flop (didn't bet)
Seat 4: erfk1958 (small blind) folded before Flop
Seat 5: chaps1988 (big blind) folded before Flop
Seat 6: nickreason17 collected ($5)
Seat 7: morosun folded before Flop (didn't bet)
Seat 9: PacPacBum folded before Flop (didn't bet)





PokerStars Hand #150802433422:  Hold'em No Limit ($0.25/$0.50 USD) - 2016/03/23 14:59:26 CET [2016/03/23 9:59:26 ET]
Table 'Pyrrhus' 9-max Seat #9 is the button
Seat 1: lumen21 ($83.72 in chips) 
Seat 2: BSTUSim ($64.12 in chips) 
Seat 3: i L00K great ($52.25 in chips) 
Seat 4: GriffinBerg ($44.38 in chips) 
Seat 5: ZonTTT ($53.98 in chips) 
Seat 6: Ahangama ($51.25 in chips) 
Seat 7: matiko09 ($136.75 in chips) 
Seat 9: CvMCvMCvM ($89.05 in chips) 
lumen21: posts small blind $0.25
BSTUSim: posts big blind $0.50
*** HOLE CARDS ***
Dealt to matiko09 [8d As]
i L00K great: folds 
GriffinBerg: folds 
ZonTTT: folds 
Ahangama: folds 
matiko09: folds 
CvMCvMCvM: folds 
dndngod leaves the table
lumen21: raises $1 to $1.50
BSTUSim: calls $1
*** FLOP *** [Ks Kc Qc]
suitedaces02 joins the table at seat #8 
lumen21: checks 
BSTUSim: checks 
*** TURN *** [Ks Kc Qc] [Qs]
lumen21: bets $1.75
BSTUSim: folds 
Uncalled bet ($1.75) returned to lumen21
lumen21 collected $2.86 from pot
lumen21: doesn't show hand 
*** SUMMARY ***
Total pot $3 | Rake $0.14 
Board [Ks Kc Qc Qs]
Seat 1: lumen21 (small blind) collected ($2.86)
Seat 2: BSTUSim (big blind) folded on the Turn
Seat 3: i L00K great folded before Flop (didn't bet)
Seat 4: GriffinBerg folded before Flop (didn't bet)
Seat 5: ZonTTT folded before Flop (didn't bet)
Seat 6: Ahangama folded before Flop (didn't bet)
Seat 7: matiko09 folded before Flop (didn't bet)
Seat 9: CvMCvMCvM (button) folded before Flop (didn't bet)





PokerStars Hand #150802435652:  Hold'em No Limit (€0.50/€1.00 EUR) - 2016/03/23 14:59:33 CET [2016/03/23 9:59:33 ET]
Table 'Mercury III' 9-max Seat #1 is the button
Seat 1: matiko09 (€100 in chips) 
Seat 2: o.miro (€119.01 in chips) 
Seat 3: PacPacBum (€100 in chips) 
Seat 6: mycka86 (€102.50 in chips) 
Seat 8: gfxed (€37.72 in chips) 
Seat 9: Indr3k (€100 in chips) 
o.miro: posts small blind €0.50
PacPacBum: posts big blind €1
Muinmyheart: sits out 
STrakDD: sits out 
*** HOLE CARDS ***
Dealt to matiko09 [Ah 8s]
mycka86: folds 
gfxed: calls €1
Indr3k: folds 
matiko09: raises €3 to €4
o.miro: folds 
PacPacBum: folds 
gfxed: calls €3
*** FLOP *** [Qh 9s Ad]
gfxed: checks 
matiko09: checks 
*** TURN *** [Qh 9s Ad] [4c]
gfxed: bets €4
matiko09: calls €4
*** RIVER *** [Qh 9s Ad 4c] [6d]
gfxed: bets €7
matiko09: calls €7
*** SHOW DOWN ***
gfxed: shows [Kd 9h] (a pair of Nines)
matiko09: shows [Ah 8s] (a pair of Aces)
matiko09 collected €30.08 from pot
*** SUMMARY ***
Total pot €31.50 | Rake €1.42 
Board [Qh 9s Ad 4c 6d]
Seat 1: matiko09 (button) showed [Ah 8s] and won (€30.08) with a pair of Aces
Seat 2: o.miro (small blind) folded before Flop
Seat 3: PacPacBum (big blind) folded before Flop
Seat 6: mycka86 folded before Flop (didn't bet)
Seat 8: gfxed showed [Kd 9h] and lost with a pair of Nines
Seat 9: Indr3k folded before Flop (didn't bet)





PokerStars Hand #150802435694:  Hold'em No Limit ($1/$2 USD) - 2016/03/23 14:59:33 CET [2016/03/23 9:59:33 ET]
Table 'Herba II' 9-max Seat #3 is the button
Seat 1: matiko09 ($290.38 in chips) 
Seat 2: nickreason17 ($200 in chips) 
Seat 3: Cirilico ($162.24 in chips) 
Seat 4: DUkalisUA ($406.40 in chips) 
Seat 5: chippo boy ($246.51 in chips) 
Seat 6: Too-Anti-To ($225.38 in chips) 
Seat 7: InsomniaRU ($377.70 in chips) 
Seat 8: T0ny Adams ($77 in chips) 
Seat 9: mrhighryza ($49.44 in chips) 
DUkalisUA: posts small blind $1
chippo boy: posts big blind $2
*** HOLE CARDS ***
Dealt to matiko09 [3d 9c]
Too-Anti-To: folds 
InsomniaRU: folds 
T0ny Adams: folds 
mrhighryza: folds 
matiko09: folds 
nickreason17: folds 
Cirilico: raises $3 to $5
DUkalisUA: calls $4
chippo boy: raises $15 to $20
Cirilico: folds 
DUkalisUA: calls $15
*** FLOP *** [Ad Jd 3c]
DUkalisUA: checks 
chippo boy: bets $20
DUkalisUA: folds 
Uncalled bet ($20) returned to chippo boy
chippo boy collected $42.98 from pot
*** SUMMARY ***
Total pot $45 | Rake $2.02 
Board [Ad Jd 3c]
Seat 1: matiko09 folded before Flop (didn't bet)
Seat 2: nickreason17 folded before Flop (didn't bet)
Seat 3: Cirilico (button) folded before Flop
Seat 4: DUkalisUA (small blind) folded on the Flop
Seat 5: chippo boy (big blind) collected ($42.98)
Seat 6: Too-Anti-To folded before Flop (didn't bet)
Seat 7: InsomniaRU folded before Flop (didn't bet)
Seat 8: T0ny Adams folded before Flop (didn't bet)
Seat 9: mrhighryza folded before Flop (didn't bet)





PokerStars Hand #150802436259:  Hold'em No Limit ($0.50/$1.00 USD) - 2016/03/23 14:59:35 CET [2016/03/23 9:59:35 ET]
Table 'Sylvia III' 9-max Seat #7 is the button
Seat 1: mycka86 ($100 in chips) 
Seat 2: florrin92 ($114.81 in chips) 
Seat 5: matiko09 ($107.19 in chips) 
Seat 6: PacPacBum ($100 in chips) 
Seat 7: easytalk777 ($100.80 in chips) 
Seat 8: nickreason17 ($112.89 in chips) 
Seat 9: Blanky-Bad ($88 in chips) 
nickreason17: posts small blind $0.50
Blanky-Bad: posts big blind $1
lombardo11: sits out 
mycka86: posts the ante $0.20
florrin92: posts the ante $0.20
matiko09: posts the ante $0.20
PacPacBum: posts the ante $0.20
easytalk777: posts the ante $0.20
nickreason17: posts the ante $0.20
Blanky-Bad: posts the ante $0.20
*** HOLE CARDS ***
Dealt to matiko09 [Td As]
mycka86: folds 
florrin92: raises $2 to $3
matiko09: folds 
PacPacBum: folds 
easytalk777: raises $6 to $9
nickreason17: folds 
Blanky-Bad: folds 
florrin92: folds 
Uncalled bet ($6) returned to easytalk777
easytalk777 collected $8.90 from pot
easytalk777: doesn't show hand 
*** SUMMARY ***
Total pot $8.90 | Rake $0 
Seat 1: mycka86 folded before Flop (didn't bet)
Seat 2: florrin92 folded before Flop
Seat 5: matiko09 folded before Flop (didn't bet)
Seat 6: PacPacBum folded before Flop (didn't bet)
Seat 7: easytalk777 (button) collected ($8.90)
Seat 8: nickreason17 (small blind) folded before Flop
Seat 9: Blanky-Bad (big blind) folded before Flop





PokerStars Hand #150802436818:  Hold'em No Limit ($0.50/$1.00 USD) - 2016/03/23 14:59:37 CET [2016/03/23 9:59:37 ET]
Table 'Swings' 9-max Seat #6 is the button
Seat 1: carrsseis ($104.16 in chips) 
Seat 2: tomver0809 ($91.52 in chips) 
Seat 4: chaps1988 ($100 in chips) 
Seat 5: chautinhtri9 ($117.45 in chips) 
Seat 6: matiko09 ($135.27 in chips) 
Seat 7: PacPacBum ($109.99 in chips) 
Seat 8: RICKA16 ($101.96 in chips) 
Seat 9: Vlad_1965_77 ($126.78 in chips) 
PacPacBum: posts small blind $0.50
RICKA16: posts big blind $1
maxxmeister: sits out 
*** HOLE CARDS ***
Dealt to matiko09 [2c Kc]
Vlad_1965_77: raises $2.50 to $3.50
carrsseis: folds 
tomver0809: folds 
chaps1988: folds 
chautinhtri9: folds 
matiko09: folds 
PacPacBum: folds 
RICKA16: folds 
Uncalled bet ($2.50) returned to Vlad_1965_77
Vlad_1965_77 collected $2.50 from pot
*** SUMMARY ***
Total pot $2.50 | Rake $0 
Seat 1: carrsseis folded before Flop (didn't bet)
Seat 2: tomver0809 folded before Flop (didn't bet)
Seat 4: chaps1988 folded before Flop (didn't bet)
Seat 5: chautinhtri9 folded before Flop (didn't bet)
Seat 6: matiko09 (button) folded before Flop (didn't bet)
Seat 7: PacPacBum (small blind) folded before Flop
Seat 8: RICKA16 (big blind) folded before Flop
Seat 9: Vlad_1965_77 collected ($2.50)





PokerStars Hand #150802437259:  Hold'em No Limit ($0.50/$1.00 USD) - 2016/03/23 14:59:38 CET [2016/03/23 9:59:38 ET]
Table 'Asmodeus' 9-max Seat #9 is the button
Seat 1: Jimy Tiltman ($100.09 in chips) 
Seat 3: nickreason17 ($102.40 in chips) 
Seat 4: Effort92 ($100 in chips) 
Seat 6: florrin92 ($102.10 in chips) 
Seat 7: mycka86 ($115.99 in chips) 
Seat 8: bonifacioppl ($101 in chips) 
Seat 9: matiko09 ($100.99 in chips) 
Jimy Tiltman: posts small blind $0.50
$-Twackle-$: is sitting out 
$-Twackle-$ leaves the table
nickreason17: posts big blind $1
Jimy Tiltman: posts the ante $0.20
nickreason17: posts the ante $0.20
Effort92: posts the ante $0.20
florrin92: posts the ante $0.20
mycka86: posts the ante $0.20
bonifacioppl: posts the ante $0.20
matiko09: posts the ante $0.20
*** HOLE CARDS ***
Dealt to matiko09 [3s Ah]
Effort92: folds 
florrin92: folds 
mycka86: folds 
bonifacioppl: folds 
matiko09: raises $1.50 to $2.50
Jimy Tiltman: folds 
nickreason17: folds 
Uncalled bet ($1.50) returned to matiko09
matiko09 collected $3.90 from pot
matiko09: doesn't show hand 
*** SUMMARY ***
Total pot $3.90 | Rake $0 
Seat 1: Jimy Tiltman (small blind) folded before Flop
Seat 3: nickreason17 (big blind) folded before Flop
Seat 4: Effort92 folded before Flop (didn't bet)
Seat 6: florrin92 folded before Flop (didn't bet)
Seat 7: mycka86 folded before Flop (didn't bet)
Seat 8: bonifacioppl folded before Flop (didn't bet)
Seat 9: matiko09 (button) collected ($3.90)





PokerStars Hand #150802437473:  Hold'em No Limit ($1/$2 USD) - 2016/03/23 14:59:39 CET [2016/03/23 9:59:39 ET]
Table 'Kypria II' 9-max Seat #2 is the button
Seat 2: coinflip_si ($285.44 in chips) 
Seat 3: seouljam ($283.92 in chips) 
Seat 6: matiko09 ($440.38 in chips) 
Seat 7: DUkalisUA ($200 in chips) 
Seat 8: nickreason17 ($200 in chips) 
Seat 9: sanrs57 ($185 in chips) 
seouljam: posts small blind $1
VolanDog: is sitting out 
InsomniaRU: is sitting out 
matiko09: posts big blind $2
*** HOLE CARDS ***
Dealt to matiko09 [Qh 5c]
InsomniaRU leaves the table
DUkalisUA: folds 
nickreason17: folds 
sanrs57: folds 
coinflip_si: folds 
seouljam: folds 
Uncalled bet ($1) returned to matiko09
matiko09 collected $2 from pot
matiko09: doesn't show hand 
*** SUMMARY ***
Total pot $2 | Rake $0 
Seat 2: coinflip_si (button) folded before Flop (didn't bet)
Seat 3: seouljam (small blind) folded before Flop
Seat 6: matiko09 (big blind) collected ($2)
Seat 7: DUkalisUA folded before Flop (didn't bet)
Seat 8: nickreason17 folded before Flop (didn't bet)
Seat 9: sanrs57 folded before Flop (didn't bet)





PokerStars Hand #150802439979:  Hold'em No Limit ($0.50/$1.00 USD) - 2016/03/23 14:59:46 CET [2016/03/23 9:59:46 ET]
Table 'Merope II' 9-max Seat #4 is the button
Seat 1: Jimy Tiltman ($129.29 in chips) 
Seat 2: $-Twackle-$ ($100 in chips) 
Seat 3: pablos1922 ($88.81 in chips) 
Seat 4: PacPacBum ($100 in chips) 
Seat 5: chaps1988 ($105.66 in chips) 
Seat 6: Effort92 ($138.91 in chips) 
Seat 7: matiko09 ($104.53 in chips) 
Seat 8: Red4erT ($44.25 in chips) 
Seat 9: RICKA16 ($122.59 in chips) 
chaps1988: posts small blind $0.50
Effort92: posts big blind $1
*** HOLE CARDS ***
Dealt to matiko09 [3c 9h]
matiko09: folds 
Red4erT: raises $1.50 to $2.50
RICKA16: calls $2.50
Jimy Tiltman: calls $2.50
$-Twackle-$: calls $2.50
pablos1922: folds 
PacPacBum: calls $2.50
chaps1988: folds 
Effort92: folds 
*** FLOP *** [Js Th 3s]
Red4erT: checks 
RICKA16: bets $10
Jimy Tiltman: folds 
$-Twackle-$: folds 
PacPacBum: folds 
Red4erT: raises $31.75 to $41.75 and is all-in
RICKA16: calls $31.75
*** TURN *** [Js Th 3s] [5h]
*** RIVER *** [Js Th 3s 5h] [Ts]
*** SHOW DOWN ***
Red4erT: shows [Ad Ac] (two pair, Aces and Tens)
RICKA16: shows [Ks Kd] (two pair, Kings and Tens)
Red4erT collected $94.70 from pot
*** SUMMARY ***
Total pot $97.50 | Rake $2.80 
Board [Js Th 3s 5h Ts]
Seat 1: Jimy Tiltman folded on the Flop
Seat 2: $-Twackle-$ folded on the Flop
Seat 3: pablos1922 folded before Flop (didn't bet)
Seat 4: PacPacBum (button) folded on the Flop
Seat 5: chaps1988 (small blind) folded before Flop
Seat 6: Effort92 (big blind) folded before Flop
Seat 7: matiko09 folded before Flop (didn't bet)
Seat 8: Red4erT showed [Ad Ac] and won ($94.70) with two pair, Aces and Tens
Seat 9: RICKA16 showed [Ks Kd] and lost with two pair, Kings and Tens





PokerStars Hand #150802440519:  Hold'em No Limit ($0.50/$1.00 USD) - 2016/03/23 14:59:48 CET [2016/03/23 9:59:48 ET]
Table 'Smiley' 9-max Seat #6 is the button
Seat 1: xHourglass ($104 in chips) 
Seat 2: Jimy Tiltman ($133.28 in chips) 
Seat 3: Robert201202 ($100.06 in chips) 
Seat 4: CAJUN890 ($109.93 in chips) 
Seat 5: Szevasztopol ($100 in chips) 
Seat 6: blackmont111 ($119.50 in chips) 
Seat 7: nickreason17 ($100 in chips) 
Seat 8: matiko09 ($100 in chips) 
Seat 9: Pvsx. ($225.48 in chips) 
nickreason17: posts small blind $0.50
matiko09: posts big blind $1
*** HOLE CARDS ***
Dealt to matiko09 [Js 8s]
Pvsx.: folds 
xHourglass: folds 
Jimy Tiltman: folds 
Robert201202: folds 
CAJUN890: folds 
Szevasztopol: folds 
blackmont111: folds 
nickreason17: folds 
Uncalled bet ($0.50) returned to matiko09
matiko09 collected $1 from pot
matiko09: doesn't show hand 
*** SUMMARY ***
Total pot $1 | Rake $0 
Seat 1: xHourglass folded before Flop (didn't bet)
Seat 2: Jimy Tiltman folded before Flop (didn't bet)
Seat 3: Robert201202 folded before Flop (didn't bet)
Seat 4: CAJUN890 folded before Flop (didn't bet)
Seat 5: Szevasztopol folded before Flop (didn't bet)
Seat 6: blackmont111 (button) folded before Flop (didn't bet)
Seat 7: nickreason17 (small blind) folded before Flop
Seat 8: matiko09 (big blind) collected ($1)
Seat 9: Pvsx. folded before Flop (didn't bet)





PokerStars Hand #150802441826:  Hold'em No Limit ($1/$2 USD) - 2016/03/23 14:59:52 CET [2016/03/23 9:59:52 ET]
Table 'Achaia' 9-max Seat #4 is the button
Seat 1: RamiroAgujis ($200 in chips) 
Seat 3: matiko09 ($234.16 in chips) 
Seat 4: erfk1958 ($90 in chips) 
Seat 5: chaps1988 ($200 in chips) 
Seat 6: nickreason17 ($281.97 in chips) 
Seat 7: morosun ($236.32 in chips) 
Seat 9: PacPacBum ($207.35 in chips) 
chaps1988: posts small blind $1
nickreason17: posts big blind $2
IseeUcards: sits out 
*** HOLE CARDS ***
Dealt to matiko09 [9h Ks]
morosun: calls $2
PacPacBum: folds 
RamiroAgujis: raises $4 to $6
matiko09: folds 
erfk1958: folds 
chaps1988: folds 
nickreason17: calls $4
morosun: folds 
*** FLOP *** [5s 7d Kd]
nickreason17: checks 
RamiroAgujis: bets $8
nickreason17: calls $8
*** TURN *** [5s 7d Kd] [4h]
nickreason17: checks 
RamiroAgujis: checks 
*** RIVER *** [5s 7d Kd 4h] [3s]
nickreason17: bets $14.80
RamiroAgujis: calls $14.80
*** SHOW DOWN ***
nickreason17: shows [Ah 5h] (a pair of Fives)
RamiroAgujis: shows [9c Kc] (a pair of Kings)
RamiroAgujis collected $57.87 from pot
*** SUMMARY ***
Total pot $60.60 | Rake $2.73 
Board [5s 7d Kd 4h 3s]
Seat 1: RamiroAgujis showed [9c Kc] and won ($57.87) with a pair of Kings
Seat 3: matiko09 folded before Flop (didn't bet)
Seat 4: erfk1958 (button) folded before Flop (didn't bet)
Seat 5: chaps1988 (small blind) folded before Flop
Seat 6: nickreason17 (big blind) showed [Ah 5h] and lost with a pair of Fives
Seat 7: morosun folded before Flop
Seat 9: PacPacBum folded before Flop (didn't bet)





PokerStars Hand #150802445404:  Hold'em No Limit ($0.50/$1.00 USD) - 2016/03/23 15:00:03 CET [2016/03/23 10:00:03 ET]
Table 'Asmodeus' 9-max Seat #1 is the button
Seat 1: Jimy Tiltman ($100 in chips) 
Seat 3: nickreason17 ($101.20 in chips) 
Seat 4: Effort92 ($100 in chips) 
Seat 6: florrin92 ($101.90 in chips) 
Seat 7: mycka86 ($115.79 in chips) 
Seat 8: bonifacioppl ($100.80 in chips) 
Seat 9: matiko09 ($103.69 in chips) 
nickreason17: posts small blind $0.50
Effort92: posts big blind $1
Jimy Tiltman: posts the ante $0.20
nickreason17: posts the ante $0.20
Effort92: posts the ante $0.20
florrin92: posts the ante $0.20
mycka86: posts the ante $0.20
bonifacioppl: posts the ante $0.20
matiko09: posts the ante $0.20
*** HOLE CARDS ***
Dealt to matiko09 [Jc Qc]
florrin92: folds 
mycka86: folds 
bonifacioppl: folds 
matiko09: raises $1.50 to $2.50
Jimy Tiltman: folds 
nickreason17: folds 
Effort92: calls $1.50
*** FLOP *** [Ah 3s 5c]
Effort92: checks 
matiko09: bets $4.28
Effort92: folds 
Uncalled bet ($4.28) returned to matiko09
matiko09 collected $6.59 from pot
matiko09: doesn't show hand 
*** SUMMARY ***
Total pot $6.90 | Rake $0.31 
Board [Ah 3s 5c]
Seat 1: Jimy Tiltman (button) folded before Flop (didn't bet)
Seat 3: nickreason17 (small blind) folded before Flop
Seat 4: Effort92 (big blind) folded on the Flop
Seat 6: florrin92 folded before Flop (didn't bet)
Seat 7: mycka86 folded before Flop (didn't bet)
Seat 8: bonifacioppl folded before Flop (didn't bet)
Seat 9: matiko09 collected ($6.59)





PokerStars Hand #150802445598:  Hold'em No Limit ($1/$2 USD) - 2016/03/23 15:00:03 CET [2016/03/23 10:00:03 ET]
Table 'Kypria II' 9-max Seat #3 is the button
Seat 2: coinflip_si ($285.44 in chips) 
Seat 3: seouljam ($282.92 in chips) 
Seat 6: matiko09 ($441.38 in chips) 
Seat 7: DUkalisUA ($200 in chips) 
Seat 8: nickreason17 ($200 in chips) 
Seat 9: sanrs57 ($185 in chips) 
matiko09: posts small blind $1
DUkalisUA: posts big blind $2
*** HOLE CARDS ***
Dealt to matiko09 [Jc 7h]
nickreason17: folds 
sanrs57: folds 
coinflip_si: folds 
seouljam: folds 
Igoriah joins the table at seat #5 
matiko09: folds 
Uncalled bet ($1) returned to DUkalisUA
DUkalisUA collected $2 from pot
DUkalisUA: doesn't show hand 
*** SUMMARY ***
Total pot $2 | Rake $0 
Seat 2: coinflip_si folded before Flop (didn't bet)
Seat 3: seouljam (button) folded before Flop (didn't bet)
Seat 6: matiko09 (small blind) folded before Flop
Seat 7: DUkalisUA (big blind) collected ($2)
Seat 8: nickreason17 folded before Flop (didn't bet)
Seat 9: sanrs57 folded before Flop (didn't bet)





PokerStars Hand #150802446006:  Hold'em No Limit ($0.50/$1.00 USD) - 2016/03/23 15:00:04 CET [2016/03/23 10:00:04 ET]
Table 'Swings' 9-max Seat #7 is the button
Seat 1: carrsseis ($104.16 in chips) 
Seat 2: tomver0809 ($91.52 in chips) 
Seat 4: chaps1988 ($100 in chips) 
Seat 5: chautinhtri9 ($117.45 in chips) 
Seat 6: matiko09 ($135.27 in chips) 
Seat 7: PacPacBum ($109.49 in chips) 
Seat 8: RICKA16 ($100.96 in chips) 
Seat 9: Vlad_1965_77 ($128.28 in chips) 
RICKA16: posts small blind $0.50
Vlad_1965_77: posts big blind $1
maxxmeister: sits out 
*** HOLE CARDS ***
Dealt to matiko09 [6d Js]
carrsseis: folds 
tomver0809: folds 
chaps1988: folds 
chautinhtri9: folds 
matiko09: folds 
PacPacBum: raises $1.04 to $2.04
RICKA16: folds 
Vlad_1965_77: calls $1.04
*** FLOP *** [3h Ks 5c]
Vlad_1965_77: bets $4.37
PacPacBum: folds 
Uncalled bet ($4.37) returned to Vlad_1965_77
Vlad_1965_77 collected $4.37 from pot
*** SUMMARY ***
Total pot $4.58 | Rake $0.21 
Board [3h Ks 5c]
Seat 1: carrsseis folded before Flop (didn't bet)
Seat 2: tomver0809 folded before Flop (didn't bet)
Seat 4: chaps1988 folded before Flop (didn't bet)
Seat 5: chautinhtri9 folded before Flop (didn't bet)
Seat 6: matiko09 folded before Flop (didn't bet)
Seat 7: PacPacBum (button) folded on the Flop
Seat 8: RICKA16 (small blind) folded before Flop
Seat 9: Vlad_1965_77 (big blind) collected ($4.37)





PokerStars Hand #150802447644:  Hold'em No Limit ($0.50/$1.00 USD) - 2016/03/23 15:00:10 CET [2016/03/23 10:00:10 ET]
Table 'Smiley' 9-max Seat #7 is the button
Seat 1: xHourglass ($104 in chips) 
Seat 2: Jimy Tiltman ($133.28 in chips) 
Seat 3: Robert201202 ($100.06 in chips) 
Seat 4: CAJUN890 ($109.93 in chips) 
Seat 5: Szevasztopol ($100 in chips) 
Seat 6: blackmont111 ($119.50 in chips) 
Seat 7: nickreason17 ($100 in chips) 
Seat 8: matiko09 ($100.50 in chips) 
Seat 9: Pvsx. ($225.48 in chips) 
matiko09: posts small blind $0.50
Pvsx.: posts big blind $1
*** HOLE CARDS ***
Dealt to matiko09 [8d 3s]
xHourglass: folds 
Jimy Tiltman: folds 
Robert201202: raises $2 to $3
CAJUN890: folds 
Szevasztopol: folds 
blackmont111: folds 
nickreason17: folds 
matiko09: folds 
Pvsx.: folds 
Uncalled bet ($2) returned to Robert201202
Robert201202 collected $2.50 from pot
*** SUMMARY ***
Total pot $2.50 | Rake $0 
Seat 1: xHourglass folded before Flop (didn't bet)
Seat 2: Jimy Tiltman folded before Flop (didn't bet)
Seat 3: Robert201202 collected ($2.50)
Seat 4: CAJUN890 folded before Flop (didn't bet)
Seat 5: Szevasztopol folded before Flop (didn't bet)
Seat 6: blackmont111 folded before Flop (didn't bet)
Seat 7: nickreason17 (button) folded before Flop (didn't bet)
Seat 8: matiko09 (small blind) folded before Flop
Seat 9: Pvsx. (big blind) folded before Flop





PokerStars Hand #150802447653:  Hold'em No Limit ($1/$2 USD) - 2016/03/23 15:00:10 CET [2016/03/23 10:00:10 ET]
Table 'Kiess' 9-max Seat #8 is the button
Seat 1: Cirilico ($209.22 in chips) 
Seat 2: DUkalisUA ($705.28 in chips) 
Seat 3: Red4erT ($93.82 in chips) 
Seat 4: Igoriah ($200 in chips) 
Seat 5: chippo boy ($413.64 in chips) 
Seat 6: matiko09 ($254.86 in chips) 
Seat 8: erfk1958 ($144.21 in chips) 
Seat 9: volwebni4ek ($80 in chips) 
volwebni4ek: posts small blind $1
Cirilico: posts big blind $2
chaps1988: sits out 
*** HOLE CARDS ***
Dealt to matiko09 [4s 6d]
DUkalisUA: folds 
Red4erT: folds 
Igoriah: folds 
chippo boy: folds 
matiko09: folds 
erfk1958: folds 
volwebni4ek: raises $3 to $5
Cirilico: folds 
Uncalled bet ($3) returned to volwebni4ek
volwebni4ek collected $4 from pot
volwebni4ek: doesn't show hand 
*** SUMMARY ***
Total pot $4 | Rake $0 
Seat 1: Cirilico (big blind) folded before Flop
Seat 2: DUkalisUA folded before Flop (didn't bet)
Seat 3: Red4erT folded before Flop (didn't bet)
Seat 4: Igoriah folded before Flop (didn't bet)
Seat 5: chippo boy folded before Flop (didn't bet)
Seat 6: matiko09 folded before Flop (didn't bet)
Seat 8: erfk1958 (button) folded before Flop (didn't bet)
Seat 9: volwebni4ek (small blind) collected ($4)





PokerStars Hand #150802448522:  Hold'em No Limit (€0.50/€1.00 EUR) - 2016/03/23 15:00:12 CET [2016/03/23 10:00:12 ET]
Table 'Mercury III' 9-max Seat #2 is the button
Seat 1: matiko09 (€115.08 in chips) 
Seat 2: o.miro (€118.51 in chips) 
Seat 3: PacPacBum (€100 in chips) 
Seat 4: Muinmyheart (€100 in chips) 
Seat 6: mycka86 (€102.50 in chips) 
Seat 8: gfxed (€22.72 in chips) 
Seat 9: Indr3k (€100 in chips) 
PacPacBum: posts small blind €0.50
Muinmyheart: posts big blind €1
STrakDD: sits out 
*** HOLE CARDS ***
Dealt to matiko09 [Kc 5h]
mycka86: folds 
gfxed: folds 
Indr3k: folds 
matiko09: folds 
DUkalisUA joins the table at seat #5 
o.miro: raises €1.50 to €2.50
PacPacBum: folds 
Muinmyheart: folds 
Uncalled bet (€1.50) returned to o.miro
o.miro collected €2.50 from pot
o.miro: doesn't show hand 
*** SUMMARY ***
Total pot €2.50 | Rake €0 
Seat 1: matiko09 folded before Flop (didn't bet)
Seat 2: o.miro (button) collected (€2.50)
Seat 3: PacPacBum (small blind) folded before Flop
Seat 4: Muinmyheart (big blind) folded before Flop
Seat 6: mycka86 folded before Flop (didn't bet)
Seat 8: gfxed folded before Flop (didn't bet)
Seat 9: Indr3k folded before Flop (didn't bet)





PokerStars Hand #150802452736:  Hold'em No Limit ($1/$2 USD) - 2016/03/23 15:00:26 CET [2016/03/23 10:00:26 ET]
Table 'Kypria II' 9-max Seat #6 is the button
Seat 2: coinflip_si ($285.44 in chips) 
Seat 3: seouljam ($282.92 in chips) 
Seat 6: matiko09 ($440.38 in chips) 
Seat 7: DUkalisUA ($201 in chips) 
DUkalisUA: posts small blind $1
nickreason17: is sitting out 
seouljam said, "there we go, nice"
sanrs57 is disconnected 
geldwolfje said, "found something"
sanrs57 has timed out while disconnected
sanrs57: is sitting out 
coinflip_si: posts big blind $2
Igoriah: sits out 
*** HOLE CARDS ***
Dealt to matiko09 [6h 6s]
seouljam said, "the game has been dead since you left"
seouljam: folds 
matiko09: raises $2.54 to $4.54
DUkalisUA: folds 
coinflip_si: folds 
Uncalled bet ($2.54) returned to matiko09
matiko09 collected $5 from pot
matiko09: doesn't show hand 
*** SUMMARY ***
Total pot $5 | Rake $0 
Seat 2: coinflip_si (big blind) folded before Flop
Seat 3: seouljam folded before Flop (didn't bet)
Seat 6: matiko09 (button) collected ($5)
Seat 7: DUkalisUA (small blind) folded before Flop





PokerStars Hand #150802452971:  Hold'em No Limit ($0.50/$1.00 USD) - 2016/03/23 15:00:26 CET [2016/03/23 10:00:26 ET]
Table 'Sylvia III' 9-max Seat #8 is the button
Seat 1: mycka86 ($100 in chips) 
Seat 2: florrin92 ($111.61 in chips) 
Seat 5: matiko09 ($106.99 in chips) 
Seat 6: PacPacBum ($100 in chips) 
Seat 7: easytalk777 ($106.50 in chips) 
Seat 8: nickreason17 ($112.19 in chips) 
Seat 9: Blanky-Bad ($86.80 in chips) 
Blanky-Bad: posts small blind $0.50
mycka86: posts big blind $1
lombardo11: sits out 
mycka86: posts the ante $0.20
florrin92: posts the ante $0.20
matiko09: posts the ante $0.20
PacPacBum: posts the ante $0.20
easytalk777: posts the ante $0.20
nickreason17: posts the ante $0.20
Blanky-Bad: posts the ante $0.20
*** HOLE CARDS ***
Dealt to matiko09 [Td Qs]
florrin92: folds 
florrin92 leaves the table
matiko09: folds 
PacPacBum: folds 
easytalk777: folds 
nickreason17: folds 
Blanky-Bad: calls $0.50
BLANKCHEQUE1 joins the table at seat #3 
mycka86: checks 
*** FLOP *** [4s Kd 4d]
Blanky-Bad: checks 
mycka86: checks 
*** TURN *** [4s Kd 4d] [3h]
Blanky-Bad: bets $1
BLANKCHEQUE1 leaves the table
mycka86: folds 
Uncalled bet ($1) returned to Blanky-Bad
Blanky-Bad collected $3.25 from pot
Blanky-Bad: doesn't show hand 
*** SUMMARY ***
Total pot $3.40 | Rake $0.15 
Board [4s Kd 4d 3h]
Seat 1: mycka86 (big blind) folded on the Turn
Seat 2: florrin92 folded before Flop (didn't bet)
Seat 5: matiko09 folded before Flop (didn't bet)
Seat 6: PacPacBum folded before Flop (didn't bet)
Seat 7: easytalk777 folded before Flop (didn't bet)
Seat 8: nickreason17 (button) folded before Flop (didn't bet)
Seat 9: Blanky-Bad (small blind) collected ($3.25)





PokerStars Hand #150802456599:  Hold'em No Limit ($0.50/$1.00 USD) - 2016/03/23 15:00:38 CET [2016/03/23 10:00:38 ET]
Table 'Smiley' 9-max Seat #8 is the button
Seat 1: xHourglass ($104 in chips) 
Seat 2: Jimy Tiltman ($133.28 in chips) 
Seat 3: Robert201202 ($101.56 in chips) 
Seat 4: CAJUN890 ($109.93 in chips) 
Seat 5: Szevasztopol ($100 in chips) 
Seat 6: blackmont111 ($119.50 in chips) 
Seat 7: nickreason17 ($100 in chips) 
Seat 8: matiko09 ($100 in chips) 
Seat 9: Pvsx. ($224.48 in chips) 
Pvsx.: posts small blind $0.50
xHourglass: posts big blind $1
*** HOLE CARDS ***
Dealt to matiko09 [9c 7h]
Jimy Tiltman: folds 
Robert201202: folds 
CAJUN890: folds 
Szevasztopol: folds 
blackmont111: raises $2 to $3
nickreason17: folds 
matiko09: folds 
Pvsx.: folds 
xHourglass: folds 
Uncalled bet ($2) returned to blackmont111
blackmont111 collected $2.50 from pot
blackmont111: doesn't show hand 
*** SUMMARY ***
Total pot $2.50 | Rake $0 
Seat 1: xHourglass (big blind) folded before Flop
Seat 2: Jimy Tiltman folded before Flop (didn't bet)
Seat 3: Robert201202 folded before Flop (didn't bet)
Seat 4: CAJUN890 folded before Flop (didn't bet)
Seat 5: Szevasztopol folded before Flop (didn't bet)
Seat 6: blackmont111 collected ($2.50)
Seat 7: nickreason17 folded before Flop (didn't bet)
Seat 8: matiko09 (button) folded before Flop (didn't bet)
Seat 9: Pvsx. (small blind) folded before Flop





PokerStars Hand #150802457172:  Hold'em No Limit ($1/$2 USD) - 2016/03/23 15:00:39 CET [2016/03/23 10:00:39 ET]
Table 'Kiess' 9-max Seat #9 is the button
Seat 1: Cirilico ($207.22 in chips) 
Seat 2: DUkalisUA ($705.28 in chips) 
Seat 3: Red4erT ($93.82 in chips) 
Seat 4: Igoriah ($200 in chips) 
Seat 5: chippo boy ($413.64 in chips) 
Seat 6: matiko09 ($254.86 in chips) 
Seat 8: erfk1958 ($144.21 in chips) 
Seat 9: volwebni4ek ($82 in chips) 
Cirilico: posts small blind $1
DUkalisUA: posts big blind $2
chaps1988: sits out 
*** HOLE CARDS ***
Dealt to matiko09 [Jc As]
Red4erT: folds 
Igoriah: folds 
chippo boy: folds 
matiko09: raises $3 to $5
erfk1958: folds 
volwebni4ek: raises $10 to $15
Cirilico: folds 
DUkalisUA: folds 
matiko09: folds 
Uncalled bet ($10) returned to volwebni4ek
volwebni4ek collected $13 from pot
volwebni4ek: doesn't show hand 
*** SUMMARY ***
Total pot $13 | Rake $0 
Seat 1: Cirilico (small blind) folded before Flop
Seat 2: DUkalisUA (big blind) folded before Flop
Seat 3: Red4erT folded before Flop (didn't bet)
Seat 4: Igoriah folded before Flop (didn't bet)
Seat 5: chippo boy folded before Flop (didn't bet)
Seat 6: matiko09 folded before Flop
Seat 8: erfk1958 folded before Flop (didn't bet)
Seat 9: volwebni4ek (button) collected ($13)





PokerStars Hand #150802457559:  Hold'em No Limit ($0.25/$0.50 USD) - 2016/03/23 15:00:40 CET [2016/03/23 10:00:40 ET]
Table 'Pyrrhus' 9-max Seat #1 is the button
Seat 1: lumen21 ($85.08 in chips) 
Seat 2: BSTUSim ($62.62 in chips) 
Seat 4: GriffinBerg ($44.38 in chips) 
Seat 5: ZonTTT ($53.98 in chips) 
Seat 6: Ahangama ($51.25 in chips) 
Seat 7: matiko09 ($136.75 in chips) 
Seat 9: CvMCvMCvM ($89.05 in chips) 
BSTUSim: posts small blind $0.25
i L00K great: is sitting out 
GriffinBerg: posts big blind $0.50
i L00K great leaves the table
suitedaces02: sits out 
*** HOLE CARDS ***
Dealt to matiko09 [Ts 3h]
ZonTTT: raises $1 to $1.50
Ahangama: folds 
matiko09: folds 
CvMCvMCvM: folds 
lumen21: folds 
BSTUSim: folds 
GriffinBerg: calls $1
*** FLOP *** [4h 6h 7h]
GriffinBerg: checks 
ZonTTT: bets $1.76
GriffinBerg: raises $1.76 to $3.52
ZonTTT: folds 
Uncalled bet ($1.76) returned to GriffinBerg
GriffinBerg collected $6.47 from pot
GriffinBerg: doesn't show hand 
*** SUMMARY ***
Total pot $6.77 | Rake $0.30 
Board [4h 6h 7h]
Seat 1: lumen21 (button) folded before Flop (didn't bet)
Seat 2: BSTUSim (small blind) folded before Flop
Seat 4: GriffinBerg (big blind) collected ($6.47)
Seat 5: ZonTTT folded on the Flop
Seat 6: Ahangama folded before Flop (didn't bet)
Seat 7: matiko09 folded before Flop (didn't bet)
Seat 9: CvMCvMCvM folded before Flop (didn't bet)





PokerStars Hand #150802457364:  Hold'em No Limit ($0.50/$1.00 USD) - 2016/03/23 15:00:40 CET [2016/03/23 10:00:40 ET]
Table 'Asmodeus' 9-max Seat #3 is the button
Seat 1: Jimy Tiltman ($100 in chips) 
Seat 3: nickreason17 ($100.50 in chips) 
Seat 4: Effort92 ($100 in chips) 
Seat 7: mycka86 ($115.59 in chips) 
Seat 8: bonifacioppl ($100.60 in chips) 
Seat 9: matiko09 ($107.58 in chips) 
Effort92: posts small blind $0.50
florrin92: is sitting out 
florrin92 leaves the table
mycka86: posts big blind $1
Jimy Tiltman: posts the ante $0.20
nickreason17: posts the ante $0.20
Effort92: posts the ante $0.20
mycka86: posts the ante $0.20
bonifacioppl: posts the ante $0.20
matiko09: posts the ante $0.20
*** HOLE CARDS ***
Dealt to matiko09 [Jd Qd]
bonifacioppl: folds 
matiko09: raises $2 to $3
Jimy Tiltman: folds 
nickreason17: folds 
Effort92: folds 
mycka86: folds 
Uncalled bet ($2) returned to matiko09
matiko09 collected $3.70 from pot
matiko09: doesn't show hand 
*** SUMMARY ***
Total pot $3.70 | Rake $0 
Seat 1: Jimy Tiltman folded before Flop (didn't bet)
Seat 3: nickreason17 (button) folded before Flop (didn't bet)
Seat 4: Effort92 (small blind) folded before Flop
Seat 7: mycka86 (big blind) folded before Flop
Seat 8: bonifacioppl folded before Flop (didn't bet)
Seat 9: matiko09 collected ($3.70)





PokerStars Hand #150802458240:  Hold'em No Limit ($0.50/$1.00 USD) - 2016/03/23 15:00:42 CET [2016/03/23 10:00:42 ET]
Table 'Swings' 9-max Seat #8 is the button
Seat 1: carrsseis ($104.16 in chips) 
Seat 2: tomver0809 ($91.52 in chips) 
Seat 4: chaps1988 ($100 in chips) 
Seat 5: chautinhtri9 ($117.45 in chips) 
Seat 6: matiko09 ($135.27 in chips) 
Seat 7: PacPacBum ($107.45 in chips) 
Seat 8: RICKA16 ($100.46 in chips) 
Seat 9: Vlad_1965_77 ($130.61 in chips) 
Vlad_1965_77: posts small blind $0.50
carrsseis: posts big blind $1
maxxmeister: sits out 
*** HOLE CARDS ***
Dealt to matiko09 [Ks 9d]
tomver0809: raises $2 to $3
chaps1988: folds 
chautinhtri9: folds 
matiko09: folds 
PacPacBum: folds 
RICKA16: folds 
Vlad_1965_77: folds 
carrsseis: folds 
Uncalled bet ($2) returned to tomver0809
tomver0809 collected $2.50 from pot
tomver0809: doesn't show hand 
*** SUMMARY ***
Total pot $2.50 | Rake $0 
Seat 1: carrsseis (big blind) folded before Flop
Seat 2: tomver0809 collected ($2.50)
Seat 4: chaps1988 folded before Flop (didn't bet)
Seat 5: chautinhtri9 folded before Flop (didn't bet)
Seat 6: matiko09 folded before Flop (didn't bet)
Seat 7: PacPacBum folded before Flop (didn't bet)
Seat 8: RICKA16 (button) folded before Flop (didn't bet)
Seat 9: Vlad_1965_77 (small blind) folded before Flop





PokerStars Hand #150802458855:  Hold'em No Limit (€0.50/€1.00 EUR) - 2016/03/23 15:00:44 CET [2016/03/23 10:00:44 ET]
Table 'Mercury III' 9-max Seat #3 is the button
Seat 1: matiko09 (€115.08 in chips) 
Seat 2: o.miro (€120.01 in chips) 
Seat 3: PacPacBum (€100 in chips) 
Seat 4: Muinmyheart (€100 in chips) 
Seat 5: DUkalisUA (€100 in chips) 
Seat 6: mycka86 (€102.50 in chips) 
Seat 8: gfxed (€22.72 in chips) 
Seat 9: Indr3k (€100 in chips) 
Muinmyheart: posts small blind €0.50
DUkalisUA: posts big blind €1
STrakDD: sits out 
*** HOLE CARDS ***
Dealt to matiko09 [Th 2c]
mycka86: folds 
gfxed: folds 
Indr3k: raises €2 to €3
matiko09: folds 
o.miro: calls €3
PacPacBum: folds 
Muinmyheart: folds 
DUkalisUA: folds 
*** FLOP *** [6c Ac Qc]
Indr3k: checks 
o.miro: checks 
*** TURN *** [6c Ac Qc] [Jd]
Indr3k: checks 
o.miro: checks 
*** RIVER *** [6c Ac Qc Jd] [3c]
Indr3k: checks 
o.miro: checks 
*** SHOW DOWN ***
Indr3k: shows [Ks Kd] (a pair of Kings)
o.miro: shows [5d 5c] (a flush, Ace high)
o.miro collected €7.16 from pot
*** SUMMARY ***
Total pot €7.50 | Rake €0.34 
Board [6c Ac Qc Jd 3c]
Seat 1: matiko09 folded before Flop (didn't bet)
Seat 2: o.miro showed [5d 5c] and won (€7.16) with a flush, Ace high
Seat 3: PacPacBum (button) folded before Flop (didn't bet)
Seat 4: Muinmyheart (small blind) folded before Flop
Seat 5: DUkalisUA (big blind) folded before Flop
Seat 6: mycka86 folded before Flop (didn't bet)
Seat 8: gfxed folded before Flop (didn't bet)
Seat 9: Indr3k showed [Ks Kd] and lost with a pair of Kings





PokerStars Hand #150802459763:  Hold'em No Limit ($1/$2 USD) - 2016/03/23 15:00:47 CET [2016/03/23 10:00:47 ET]
Table 'Achaia' 9-max Seat #5 is the button
Seat 1: RamiroAgujis ($229.07 in chips) 
Seat 3: matiko09 ($234.16 in chips) 
Seat 4: erfk1958 ($90 in chips) 
Seat 5: chaps1988 ($200 in chips) 
Seat 6: nickreason17 ($253.17 in chips) 
Seat 7: morosun ($234.32 in chips) 
Seat 9: PacPacBum ($207.35 in chips) 
nickreason17: posts small blind $1
morosun: posts big blind $2
IseeUcards: sits out 
*** HOLE CARDS ***
Dealt to matiko09 [8d 5d]
PacPacBum: folds 
RamiroAgujis: folds 
matiko09: folds 
erfk1958: folds 
chaps1988: folds 
nickreason17: calls $1
morosun: raises $4 to $6
nickreason17: folds 
Uncalled bet ($4) returned to morosun
morosun collected $4 from pot
*** SUMMARY ***
Total pot $4 | Rake $0 
Seat 1: RamiroAgujis folded before Flop (didn't bet)
Seat 3: matiko09 folded before Flop (didn't bet)
Seat 4: erfk1958 folded before Flop (didn't bet)
Seat 5: chaps1988 (button) folded before Flop (didn't bet)
Seat 6: nickreason17 (small blind) folded before Flop
Seat 7: morosun (big blind) collected ($4)
Seat 9: PacPacBum folded before Flop (didn't bet)





PokerStars Hand #150802460621:  Hold'em No Limit ($1/$2 USD) - 2016/03/23 15:00:50 CET [2016/03/23 10:00:50 ET]
Table 'Herba II' 9-max Seat #4 is the button
Seat 1: matiko09 ($290.38 in chips) 
Seat 2: nickreason17 ($200 in chips) 
Seat 3: Cirilico ($160 in chips) 
Seat 4: DUkalisUA ($386.40 in chips) 
Seat 5: chippo boy ($269.49 in chips) 
Seat 6: Too-Anti-To ($225.38 in chips) 
Seat 7: InsomniaRU ($377.70 in chips) 
Seat 8: T0ny Adams ($77 in chips) 
Seat 9: mrhighryza ($49.44 in chips) 
chippo boy: posts small blind $1
Too-Anti-To: posts big blind $2
*** HOLE CARDS ***
Dealt to matiko09 [4s Jh]
InsomniaRU: raises $3 to $5
T0ny Adams: folds 
mrhighryza: calls $5
matiko09: folds 
nickreason17: folds 
Cirilico: folds 
DUkalisUA: folds 
chippo boy: calls $4
Too-Anti-To: folds 
*** FLOP *** [5h 4h Js]
chippo boy: checks 
InsomniaRU: checks 
mrhighryza: checks 
*** TURN *** [5h 4h Js] [Jd]
chippo boy: bets $10
InsomniaRU: folds 
mrhighryza: folds 
Uncalled bet ($10) returned to chippo boy
chippo boy collected $16.24 from pot
*** SUMMARY ***
Total pot $17 | Rake $0.76 
Board [5h 4h Js Jd]
Seat 1: matiko09 folded before Flop (didn't bet)
Seat 2: nickreason17 folded before Flop (didn't bet)
Seat 3: Cirilico folded before Flop (didn't bet)
Seat 4: DUkalisUA (button) folded before Flop (didn't bet)
Seat 5: chippo boy (small blind) collected ($16.24)
Seat 6: Too-Anti-To (big blind) folded before Flop
Seat 7: InsomniaRU folded on the Turn
Seat 8: T0ny Adams folded before Flop (didn't bet)
Seat 9: mrhighryza folded on the Turn





PokerStars Hand #150802462296:  Hold'em No Limit ($0.50/$1.00 USD) - 2016/03/23 15:00:55 CET [2016/03/23 10:00:55 ET]
Table 'Asmodeus' 9-max Seat #4 is the button
Seat 1: Jimy Tiltman ($100 in chips) 
Seat 3: nickreason17 ($100.30 in chips) 
Seat 4: Effort92 ($100 in chips) 
Seat 7: mycka86 ($114.39 in chips) 
Seat 8: bonifacioppl ($100.40 in chips) 
Seat 9: matiko09 ($110.08 in chips) 
mycka86: posts small blind $0.50
PacPacBum joins the table at seat #2 
bonifacioppl: posts big blind $1
Jimy Tiltman: posts the ante $0.20
nickreason17: posts the ante $0.20
Effort92: posts the ante $0.20
mycka86: posts the ante $0.20
bonifacioppl: posts the ante $0.20
matiko09: posts the ante $0.20
*** HOLE CARDS ***
Dealt to matiko09 [Tc Jh]
matiko09: folds 
Jimy Tiltman: folds 
nickreason17: folds 
Effort92: raises $2 to $3
mycka86: folds 
bonifacioppl: folds 
Uncalled bet ($2) returned to Effort92
Effort92 collected $3.70 from pot
Effort92: doesn't show hand 
*** SUMMARY ***
Total pot $3.70 | Rake $0 
Seat 1: Jimy Tiltman folded before Flop (didn't bet)
Seat 3: nickreason17 folded before Flop (didn't bet)
Seat 4: Effort92 (button) collected ($3.70)
Seat 7: mycka86 (small blind) folded before Flop
Seat 8: bonifacioppl (big blind) folded before Flop
Seat 9: matiko09 folded before Flop (didn't bet)





PokerStars Hand #150802462872:  Hold'em No Limit ($0.50/$1.00 USD) - 2016/03/23 15:00:56 CET [2016/03/23 10:00:56 ET]
Table 'Drakonia II' 9-max Seat #1 is the button
Seat 1: chautinhtri9 ($120.02 in chips) 
Seat 2: carrsseis ($100 in chips) 
Seat 3: dunga119 ($101.39 in chips) 
Seat 4: nickreason17 ($100 in chips) 
Seat 5: gchs83 ($39.50 in chips) 
Seat 6: Dantist1122 ($100 in chips) 
Seat 7: YuriiSolodya ($32.40 in chips) 
Seat 8: matiko09 ($105.39 in chips) 
Seat 9: mycka86 ($100 in chips) 
carrsseis: posts small blind $0.50
dunga119: posts big blind $1
*** HOLE CARDS ***
Dealt to matiko09 [Ts 4h]
nickreason17: folds 
gchs83: raises $1 to $2
Dantist1122: folds 
YuriiSolodya: folds 
matiko09: folds 
mycka86: folds 
chautinhtri9: calls $2
carrsseis: folds 
dunga119: calls $1
*** FLOP *** [Kh Qc Kd]
dunga119: checks 
gchs83: checks 
chautinhtri9: checks 
*** TURN *** [Kh Qc Kd] [5h]
dunga119: bets $3.10
gchs83: calls $3.10
chautinhtri9: folds 
*** RIVER *** [Kh Qc Kd 5h] [2c]
dunga119: bets $6.06
gchs83: calls $6.06
*** SHOW DOWN ***
dunga119: shows [Qd 5s] (two pair, Kings and Queens)
gchs83: shows [Ks 6s] (three of a kind, Kings)
gchs83 collected $23.70 from pot
*** SUMMARY ***
Total pot $24.82 | Rake $1.12 
Board [Kh Qc Kd 5h 2c]
Seat 1: chautinhtri9 (button) folded on the Turn
Seat 2: carrsseis (small blind) folded before Flop
Seat 3: dunga119 (big blind) showed [Qd 5s] and lost with two pair, Kings and Queens
Seat 4: nickreason17 folded before Flop (didn't bet)
Seat 5: gchs83 showed [Ks 6s] and won ($23.70) with three of a kind, Kings
Seat 6: Dantist1122 folded before Flop (didn't bet)
Seat 7: YuriiSolodya folded before Flop (didn't bet)
Seat 8: matiko09 folded before Flop (didn't bet)
Seat 9: mycka86 folded before Flop (didn't bet)





PokerStars Hand #150802465592:  Hold'em No Limit ($0.50/$1.00 USD) - 2016/03/23 15:01:04 CET [2016/03/23 10:01:04 ET]
Table 'Smiley' 9-max Seat #9 is the button
Seat 1: xHourglass ($103 in chips) 
Seat 2: Jimy Tiltman ($133.28 in chips) 
Seat 3: Robert201202 ($101.56 in chips) 
Seat 4: CAJUN890 ($109.93 in chips) 
Seat 5: Szevasztopol ($100 in chips) 
Seat 6: blackmont111 ($121 in chips) 
Seat 7: nickreason17 ($100 in chips) 
Seat 8: matiko09 ($100 in chips) 
Seat 9: Pvsx. ($223.98 in chips) 
xHourglass: posts small blind $0.50
Jimy Tiltman: posts big blind $1
*** HOLE CARDS ***
Dealt to matiko09 [As 7d]
Robert201202: folds 
CAJUN890: folds 
Szevasztopol: folds 
blackmont111: folds 
nickreason17: folds 
matiko09: folds 
Pvsx.: folds 
xHourglass: folds 
Uncalled bet ($0.50) returned to Jimy Tiltman
Jimy Tiltman collected $1 from pot
Jimy Tiltman: doesn't show hand 
*** SUMMARY ***
Total pot $1 | Rake $0 
Seat 1: xHourglass (small blind) folded before Flop
Seat 2: Jimy Tiltman (big blind) collected ($1)
Seat 3: Robert201202 folded before Flop (didn't bet)
Seat 4: CAJUN890 folded before Flop (didn't bet)
Seat 5: Szevasztopol folded before Flop (didn't bet)
Seat 6: blackmont111 folded before Flop (didn't bet)
Seat 7: nickreason17 folded before Flop (didn't bet)
Seat 8: matiko09 folded before Flop (didn't bet)
Seat 9: Pvsx. (button) folded before Flop (didn't bet)





PokerStars Hand #150802466911:  Hold'em No Limit ($1/$2 USD) - 2016/03/23 15:01:08 CET [2016/03/23 10:01:08 ET]
Table 'Kypria II' 9-max Seat #7 is the button
Seat 2: coinflip_si ($283.44 in chips) 
Seat 3: seouljam ($282.92 in chips) 
Seat 6: matiko09 ($443.38 in chips) 
Seat 7: DUkalisUA ($200 in chips) 
nickreason17 will be allowed to play after the button
geldwolfje will be allowed to play after the button
coinflip_si: posts small blind $1
seouljam: posts big blind $2
VolanDog: sits out 
Igoriah: sits out 
*** HOLE CARDS ***
Dealt to matiko09 [Kh Td]
seouljam said, "we need your 4 dollar preflop action"
matiko09: raises $3 to $5
DUkalisUA: folds 
coinflip_si: calls $4
seouljam: folds 
*** FLOP *** [Kd 9h Jd]
coinflip_si: checks 
matiko09: checks 
*** TURN *** [Kd 9h Jd] [Jc]
coinflip_si: checks 
matiko09: bets $5.95
coinflip_si: calls $5.95
*** RIVER *** [Kd 9h Jd Jc] [Qh]
coinflip_si: checks 
matiko09: checks 
*** SHOW DOWN ***
coinflip_si: shows [Ad Kc] (two pair, Kings and Jacks)
matiko09: shows [Kh Td] (a straight, Nine to King)
matiko09 collected $22.82 from pot
*** SUMMARY ***
Total pot $23.90 | Rake $1.08 
Board [Kd 9h Jd Jc Qh]
Seat 2: coinflip_si (small blind) showed [Ad Kc] and lost with two pair, Kings and Jacks
Seat 3: seouljam (big blind) folded before Flop
Seat 6: matiko09 showed [Kh Td] and won ($22.82) with a straight, Nine to King
Seat 7: DUkalisUA (button) folded before Flop (didn't bet)





PokerStars Hand #150802467862:  Hold'em No Limit ($0.50/$1.00 USD) - 2016/03/23 15:01:11 CET [2016/03/23 10:01:11 ET]
Table 'Swings' 9-max Seat #9 is the button
Seat 1: carrsseis ($103.16 in chips) 
Seat 2: tomver0809 ($93.02 in chips) 
Seat 4: chaps1988 ($100 in chips) 
Seat 5: chautinhtri9 ($117.45 in chips) 
Seat 6: matiko09 ($135.27 in chips) 
Seat 7: PacPacBum ($107.45 in chips) 
Seat 8: RICKA16 ($100.46 in chips) 
Seat 9: Vlad_1965_77 ($130.11 in chips) 
carrsseis: posts small blind $0.50
tomver0809: posts big blind $1
maxxmeister: sits out 
*** HOLE CARDS ***
Dealt to matiko09 [8d As]
chaps1988: folds 
chautinhtri9: folds 
matiko09: folds 
PacPacBum: folds 
RICKA16: folds 
Vlad_1965_77: raises $2.50 to $3.50
carrsseis: folds 
tomver0809: calls $2.50
*** FLOP *** [5d 4h 2d]
tomver0809: bets $5
Vlad_1965_77: folds 
Uncalled bet ($5) returned to tomver0809
tomver0809 collected $7.16 from pot
tomver0809: doesn't show hand 
*** SUMMARY ***
Total pot $7.50 | Rake $0.34 
Board [5d 4h 2d]
Seat 1: carrsseis (small blind) folded before Flop
Seat 2: tomver0809 (big blind) collected ($7.16)
Seat 4: chaps1988 folded before Flop (didn't bet)
Seat 5: chautinhtri9 folded before Flop (didn't bet)
Seat 6: matiko09 folded before Flop (didn't bet)
Seat 7: PacPacBum folded before Flop (didn't bet)
Seat 8: RICKA16 folded before Flop (didn't bet)
Seat 9: Vlad_1965_77 (button) folded on the Flop





PokerStars Hand #150802470173:  Hold'em No Limit ($0.25/$0.50 USD) - 2016/03/23 15:01:18 CET [2016/03/23 10:01:18 ET]
Table 'Pyrrhus' 9-max Seat #2 is the button
Seat 1: lumen21 ($85.08 in chips) 
Seat 2: BSTUSim ($62.37 in chips) 
Seat 4: GriffinBerg ($47.59 in chips) 
Seat 6: Ahangama ($51.25 in chips) 
Seat 7: matiko09 ($136.75 in chips) 
Seat 9: CvMCvMCvM ($89.05 in chips) 
GriffinBerg: posts small blind $0.25
ZonTTT: is sitting out 
Ahangama: posts big blind $0.50
suitedaces02: sits out 
*** HOLE CARDS ***
Dealt to matiko09 [4c 3d]
ZonTTT leaves the table
Kuca :P joins the table at seat #3 
Kuca :P leaves the table
xxxibgdrgn joins the table at seat #5 
Muinmyheart joins the table at seat #3 
matiko09: folds 
CvMCvMCvM: raises $0.76 to $1.26
lumen21: folds 
BSTUSim: folds 
GriffinBerg: folds 
Ahangama: folds 
Uncalled bet ($0.76) returned to CvMCvMCvM
CvMCvMCvM collected $1.25 from pot
CvMCvMCvM: doesn't show hand 
*** SUMMARY ***
Total pot $1.25 | Rake $0 
Seat 1: lumen21 folded before Flop (didn't bet)
Seat 2: BSTUSim (button) folded before Flop (didn't bet)
Seat 4: GriffinBerg (small blind) folded before Flop
Seat 6: Ahangama (big blind) folded before Flop
Seat 7: matiko09 folded before Flop (didn't bet)
Seat 9: CvMCvMCvM collected ($1.25)





PokerStars Hand #150802470283:  Hold'em No Limit ($1/$2 USD) - 2016/03/23 15:01:18 CET [2016/03/23 10:01:18 ET]
Table 'Kiess' 9-max Seat #1 is the button
Seat 1: Cirilico ($206.22 in chips) 
Seat 2: DUkalisUA ($703.28 in chips) 
Seat 3: Red4erT ($93.82 in chips) 
Seat 4: Igoriah ($200 in chips) 
Seat 5: chippo boy ($413.64 in chips) 
Seat 6: matiko09 ($249.86 in chips) 
Seat 8: erfk1958 ($144.21 in chips) 
Seat 9: volwebni4ek ($90 in chips) 
DUkalisUA: posts small blind $1
Red4erT: posts big blind $2
chaps1988: sits out 
*** HOLE CARDS ***
Dealt to matiko09 [Kd Kh]
Igoriah: folds 
chippo boy: folds 
matiko09: raises $3 to $5
erfk1958: folds 
volwebni4ek: folds 
Cirilico: folds 
DUkalisUA: folds 
Red4erT: folds 
Uncalled bet ($3) returned to matiko09
matiko09 collected $5 from pot
matiko09: doesn't show hand 
*** SUMMARY ***
Total pot $5 | Rake $0 
Seat 1: Cirilico (button) folded before Flop (didn't bet)
Seat 2: DUkalisUA (small blind) folded before Flop
Seat 3: Red4erT (big blind) folded before Flop
Seat 4: Igoriah folded before Flop (didn't bet)
Seat 5: chippo boy folded before Flop (didn't bet)
Seat 6: matiko09 collected ($5)
Seat 8: erfk1958 folded before Flop (didn't bet)
Seat 9: volwebni4ek folded before Flop (didn't bet)





PokerStars Hand #150802470581:  Hold'em No Limit ($1/$2 USD) - 2016/03/23 15:01:19 CET [2016/03/23 10:01:19 ET]
Table 'Achaia' 9-max Seat #6 is the button
Seat 1: RamiroAgujis ($229.07 in chips) 
Seat 3: matiko09 ($234.16 in chips) 
Seat 4: erfk1958 ($90 in chips) 
Seat 5: chaps1988 ($200 in chips) 
Seat 6: nickreason17 ($251.17 in chips) 
Seat 7: morosun ($236.32 in chips) 
Seat 8: IseeUcards ($200 in chips) 
Seat 9: PacPacBum ($207.35 in chips) 
morosun: posts small blind $1
IseeUcards: posts big blind $2
*** HOLE CARDS ***
Dealt to matiko09 [Kd 7d]
PacPacBum: folds 
RamiroAgujis: folds 
bananajoe001 joins the table at seat #2 
matiko09: folds 
erfk1958: folds 
chaps1988: folds 
nickreason17: folds 
morosun: raises $4 to $6
IseeUcards: folds 
Uncalled bet ($4) returned to morosun
morosun collected $4 from pot
*** SUMMARY ***
Total pot $4 | Rake $0 
Seat 1: RamiroAgujis folded before Flop (didn't bet)
Seat 3: matiko09 folded before Flop (didn't bet)
Seat 4: erfk1958 folded before Flop (didn't bet)
Seat 5: chaps1988 folded before Flop (didn't bet)
Seat 6: nickreason17 (button) folded before Flop (didn't bet)
Seat 7: morosun (small blind) collected ($4)
Seat 8: IseeUcards (big blind) folded before Flop
Seat 9: PacPacBum folded before Flop (didn't bet)





PokerStars Hand #150802470660:  Hold'em No Limit ($0.50/$1.00 USD) - 2016/03/23 15:01:19 CET [2016/03/23 10:01:19 ET]
Table 'Asmodeus' 9-max Seat #7 is the button
Seat 1: Jimy Tiltman ($100 in chips) 
Seat 3: nickreason17 ($100.10 in chips) 
Seat 4: Effort92 ($102.50 in chips) 
Seat 7: mycka86 ($113.69 in chips) 
Seat 8: bonifacioppl ($99.20 in chips) 
Seat 9: matiko09 ($109.88 in chips) 
bonifacioppl: posts small blind $0.50
matiko09: posts big blind $1
PacPacBum: sits out 
Jimy Tiltman: posts the ante $0.20
nickreason17: posts the ante $0.20
Effort92: posts the ante $0.20
mycka86: posts the ante $0.20
bonifacioppl: posts the ante $0.20
matiko09: posts the ante $0.20
*** HOLE CARDS ***
Dealt to matiko09 [Ad Kc]
Jimy Tiltman: raises $2 to $3
nickreason17: folds 
Effort92: folds 
mycka86: folds 
bonifacioppl: folds 
Muinmyheart joins the table at seat #5 
fuppeee joins the table at seat #6 
matiko09: raises $7 to $10
Jimy Tiltman: calls $7
*** FLOP *** [8d 5s Jd]
matiko09: bets $12
Jimy Tiltman: calls $12
*** TURN *** [8d 5s Jd] [8h]
matiko09: checks 
Jimy Tiltman: bets $18
matiko09: folds 
Uncalled bet ($18) returned to Jimy Tiltman
Jimy Tiltman collected $43.64 from pot
Jimy Tiltman: doesn't show hand 
*** SUMMARY ***
Total pot $45.70 | Rake $2.06 
Board [8d 5s Jd 8h]
Seat 1: Jimy Tiltman collected ($43.64)
Seat 3: nickreason17 folded before Flop (didn't bet)
Seat 4: Effort92 folded before Flop (didn't bet)
Seat 7: mycka86 (button) folded before Flop (didn't bet)
Seat 8: bonifacioppl (small blind) folded before Flop
Seat 9: matiko09 (big blind) folded on the Turn





PokerStars Hand #150802471284:  Hold'em No Limit ($0.50/$1.00 USD) - 2016/03/23 15:01:21 CET [2016/03/23 10:01:21 ET]
Table 'Sylvia III' 9-max Seat #9 is the button
Seat 1: mycka86 ($100 in chips) 
Seat 4: lombardo11 ($80 in chips) 
Seat 5: matiko09 ($106.79 in chips) 
Seat 6: PacPacBum ($100 in chips) 
Seat 7: easytalk777 ($106.30 in chips) 
Seat 8: nickreason17 ($111.99 in chips) 
Seat 9: Blanky-Bad ($88.85 in chips) 
mycka86: posts small blind $0.50
lombardo11: posts big blind $1
mycka86: posts the ante $0.20
lombardo11: posts the ante $0.20
matiko09: posts the ante $0.20
PacPacBum: posts the ante $0.20
easytalk777: posts the ante $0.20
nickreason17: posts the ante $0.20
Blanky-Bad: posts the ante $0.20
*** HOLE CARDS ***
Dealt to matiko09 [8d 6s]
matiko09: folds 
PacPacBum: folds 
easytalk777: folds 
nickreason17: raises $1.50 to $2.50
Blanky-Bad: folds 
mycka86: folds 
lombardo11: folds 
Uncalled bet ($1.50) returned to nickreason17
nickreason17 collected $3.90 from pot
*** SUMMARY ***
Total pot $3.90 | Rake $0 
Seat 1: mycka86 (small blind) folded before Flop
Seat 4: lombardo11 (big blind) folded before Flop
Seat 5: matiko09 folded before Flop (didn't bet)
Seat 6: PacPacBum folded before Flop (didn't bet)
Seat 7: easytalk777 folded before Flop (didn't bet)
Seat 8: nickreason17 collected ($3.90)
Seat 9: Blanky-Bad (button) folded before Flop (didn't bet)





PokerStars Hand #150802473028:  Hold'em No Limit ($0.50/$1.00 USD) - 2016/03/23 15:01:26 CET [2016/03/23 10:01:26 ET]
Table 'Merope II' 9-max Seat #5 is the button
Seat 1: Jimy Tiltman ($126.79 in chips) 
Seat 2: $-Twackle-$ ($100 in chips) 
Seat 3: pablos1922 ($88.81 in chips) 
Seat 4: PacPacBum ($100 in chips) 
Seat 5: chaps1988 ($105.16 in chips) 
Seat 6: Effort92 ($137.91 in chips) 
Seat 7: matiko09 ($104.53 in chips) 
Seat 8: Red4erT ($94.70 in chips) 
Seat 9: RICKA16 ($100 in chips) 
Effort92: posts small blind $0.50
matiko09: posts big blind $1
*** HOLE CARDS ***
Dealt to matiko09 [2h Qs]
Red4erT: raises $2 to $3
RICKA16: folds 
Jimy Tiltman: folds 
$-Twackle-$: folds 
pablos1922: folds 
PacPacBum: folds 
chaps1988: folds 
Effort92: folds 
matiko09: folds 
Uncalled bet ($2) returned to Red4erT
Red4erT collected $2.50 from pot
Red4erT: doesn't show hand 
*** SUMMARY ***
Total pot $2.50 | Rake $0 
Seat 1: Jimy Tiltman folded before Flop (didn't bet)
Seat 2: $-Twackle-$ folded before Flop (didn't bet)
Seat 3: pablos1922 folded before Flop (didn't bet)
Seat 4: PacPacBum folded before Flop (didn't bet)
Seat 5: chaps1988 (button) folded before Flop (didn't bet)
Seat 6: Effort92 (small blind) folded before Flop
Seat 7: matiko09 (big blind) folded before Flop
Seat 8: Red4erT collected ($2.50)
Seat 9: RICKA16 folded before Flop (didn't bet)





PokerStars Hand #150802473973:  Hold'em No Limit ($0.50/$1.00 USD) - 2016/03/23 15:01:29 CET [2016/03/23 10:01:29 ET]
Table 'Smiley' 9-max Seat #1 is the button
Seat 1: xHourglass ($102.50 in chips) 
Seat 2: Jimy Tiltman ($133.78 in chips) 
Seat 3: Robert201202 ($101.56 in chips) 
Seat 4: CAJUN890 ($109.93 in chips) 
Seat 5: Szevasztopol ($100 in chips) 
Seat 6: blackmont111 ($121 in chips) 
Seat 7: nickreason17 ($100 in chips) 
Seat 8: matiko09 ($100 in chips) 
Seat 9: Pvsx. ($223.98 in chips) 
Jimy Tiltman: posts small blind $0.50
Robert201202: posts big blind $1
*** HOLE CARDS ***
Dealt to matiko09 [Kd Ad]
CAJUN890: folds 
Szevasztopol: folds 
blackmont111: folds 
nickreason17: folds 
matiko09: raises $2 to $3
Pvsx.: calls $3
xHourglass: folds 
Jimy Tiltman: calls $2.50
Robert201202: folds 
*** FLOP *** [9s Js 4c]
Jimy Tiltman: checks 
matiko09: checks 
Pvsx.: checks 
*** TURN *** [9s Js 4c] [4d]
Jimy Tiltman: checks 
matiko09: checks 
Pvsx.: bets $4.77
Jimy Tiltman: calls $4.77
matiko09: folds 
*** RIVER *** [9s Js 4c 4d] [Jd]
Jimy Tiltman: checks 
Pvsx.: checks 
*** SHOW DOWN ***
Jimy Tiltman: shows [Th Qd] (two pair, Jacks and Fours)
Pvsx.: shows [6h 6d] (two pair, Jacks and Sixes)
Pvsx. collected $18.66 from pot
*** SUMMARY ***
Total pot $19.54 | Rake $0.88 
Board [9s Js 4c 4d Jd]
Seat 1: xHourglass (button) folded before Flop (didn't bet)
Seat 2: Jimy Tiltman (small blind) showed [Th Qd] and lost with two pair, Jacks and Fours
Seat 3: Robert201202 (big blind) folded before Flop
Seat 4: CAJUN890 folded before Flop (didn't bet)
Seat 5: Szevasztopol folded before Flop (didn't bet)
Seat 6: blackmont111 folded before Flop (didn't bet)
Seat 7: nickreason17 folded before Flop (didn't bet)
Seat 8: matiko09 folded on the Turn
Seat 9: Pvsx. showed [6h 6d] and won ($18.66) with two pair, Jacks and Sixes





PokerStars Hand #150802479101:  Hold'em No Limit ($0.25/$0.50 USD) - 2016/03/23 15:01:43 CET [2016/03/23 10:01:43 ET]
Table 'Pyrrhus' 9-max Seat #4 is the button
Seat 1: lumen21 ($85.08 in chips) 
Seat 2: BSTUSim ($62.37 in chips) 
Seat 4: GriffinBerg ($47.34 in chips) 
Seat 6: Ahangama ($50.75 in chips) 
Seat 7: matiko09 ($136.75 in chips) 
Seat 9: CvMCvMCvM ($89.80 in chips) 
xxxibgdrgn will be allowed to play after the button
Ahangama: posts small blind $0.25
matiko09: posts big blind $0.50
suitedaces02: sits out 
Muinmyheart: sits out 
*** HOLE CARDS ***
Dealt to matiko09 [6d 3d]
CvMCvMCvM: folds 
lumen21: folds 
BSTUSim: folds 
GriffinBerg: raises $1 to $1.50
Ahangama: folds 
matiko09: folds 
Uncalled bet ($1) returned to GriffinBerg
GriffinBerg collected $1.25 from pot
GriffinBerg: doesn't show hand 
*** SUMMARY ***
Total pot $1.25 | Rake $0 
Seat 1: lumen21 folded before Flop (didn't bet)
Seat 2: BSTUSim folded before Flop (didn't bet)
Seat 4: GriffinBerg (button) collected ($1.25)
Seat 6: Ahangama (small blind) folded before Flop
Seat 7: matiko09 (big blind) folded before Flop
Seat 9: CvMCvMCvM folded before Flop (didn't bet)





PokerStars Hand #150802479557:  Hold'em No Limit ($0.50/$1.00 USD) - 2016/03/23 15:01:45 CET [2016/03/23 10:01:45 ET]
Table 'Sylvia III' 9-max Seat #1 is the button
Seat 1: mycka86 ($100 in chips) 
Seat 4: lombardo11 ($78.80 in chips) 
Seat 5: matiko09 ($106.59 in chips) 
Seat 6: PacPacBum ($100 in chips) 
Seat 7: easytalk777 ($106.10 in chips) 
Seat 8: nickreason17 ($114.69 in chips) 
Seat 9: Blanky-Bad ($88.65 in chips) 
lombardo11: posts small blind $0.50
matiko09: posts big blind $1
mycka86: posts the ante $0.20
lombardo11: posts the ante $0.20
matiko09: posts the ante $0.20
PacPacBum: posts the ante $0.20
easytalk777: posts the ante $0.20
nickreason17: posts the ante $0.20
Blanky-Bad: posts the ante $0.20
*** HOLE CARDS ***
Dealt to matiko09 [6h 9c]
se7en_$tars joins the table at seat #3 
PacPacBum: folds 
easytalk777: folds 
nickreason17: folds 
Blanky-Bad: folds 
mycka86: raises $2 to $3
lombardo11: calls $2.50
matiko09: folds 
*** FLOP *** [5s 7c Ac]
Dantist1122 joins the table at seat #2 
lombardo11: checks 
mycka86: checks 
*** TURN *** [5s 7c Ac] [7s]
lombardo11: bets $3
mycka86: folds 
Uncalled bet ($3) returned to lombardo11
lombardo11 collected $8.02 from pot
lombardo11: doesn't show hand 
*** SUMMARY ***
Total pot $8.40 | Rake $0.38 
Board [5s 7c Ac 7s]
Seat 1: mycka86 (button) folded on the Turn
Seat 4: lombardo11 (small blind) collected ($8.02)
Seat 5: matiko09 (big blind) folded before Flop
Seat 6: PacPacBum folded before Flop (didn't bet)
Seat 7: easytalk777 folded before Flop (didn't bet)
Seat 8: nickreason17 folded before Flop (didn't bet)
Seat 9: Blanky-Bad folded before Flop (didn't bet)





PokerStars Hand #150802482463:  Hold'em No Limit ($1/$2 USD) - 2016/03/23 15:01:52 CET [2016/03/23 10:01:52 ET]
Table 'Kiess' 9-max Seat #2 is the button
Seat 1: Cirilico ($206.22 in chips) 
Seat 2: DUkalisUA ($702.28 in chips) 
Seat 3: Red4erT ($91.82 in chips) 
Seat 4: Igoriah ($200 in chips) 
Seat 5: chippo boy ($413.64 in chips) 
Seat 6: matiko09 ($252.86 in chips) 
Seat 8: erfk1958 ($144.21 in chips) 
Seat 9: volwebni4ek ($90 in chips) 
Red4erT: posts small blind $1
Igoriah: posts big blind $2
chaps1988: sits out 
*** HOLE CARDS ***
Dealt to matiko09 [7h 8s]
chippo boy: raises $4 to $6
matiko09: folds 
erfk1958: folds 
volwebni4ek: folds 
Cirilico: raises $12 to $18
DUkalisUA: folds 
Red4erT: folds 
Igoriah: folds 
chippo boy: calls $12
*** FLOP *** [6s Jd 5c]
chippo boy: checks 
Cirilico: bets $18.62
chippo boy: folds 
Uncalled bet ($18.62) returned to Cirilico
Cirilico collected $37.24 from pot
Cirilico: doesn't show hand 
*** SUMMARY ***
Total pot $39 | Rake $1.76 
Board [6s Jd 5c]
Seat 1: Cirilico collected ($37.24)
Seat 2: DUkalisUA (button) folded before Flop (didn't bet)
Seat 3: Red4erT (small blind) folded before Flop
Seat 4: Igoriah (big blind) folded before Flop
Seat 5: chippo boy folded on the Flop
Seat 6: matiko09 folded before Flop (didn't bet)
Seat 8: erfk1958 folded before Flop (didn't bet)
Seat 9: volwebni4ek folded before Flop (didn't bet)





PokerStars Hand #150802483496:  Hold'em No Limit ($1/$2 USD) - 2016/03/23 15:01:55 CET [2016/03/23 10:01:55 ET]
Table 'Achaia' 9-max Seat #7 is the button
Seat 1: RamiroAgujis ($229.07 in chips) 
Seat 2: bananajoe001 ($193.24 in chips) 
Seat 3: matiko09 ($234.16 in chips) 
Seat 4: erfk1958 ($90 in chips) 
Seat 5: chaps1988 ($200 in chips) 
Seat 6: nickreason17 ($251.17 in chips) 
Seat 7: morosun ($238.32 in chips) 
Seat 8: IseeUcards ($200 in chips) 
Seat 9: PacPacBum ($207.35 in chips) 
IseeUcards: posts small blind $1
PacPacBum: posts big blind $2
bananajoe001: posts big blind $2
*** HOLE CARDS ***
Dealt to matiko09 [6h Qd]
RamiroAgujis: folds 
bananajoe001: checks 
matiko09: folds 
erfk1958: folds 
chaps1988: folds 
nickreason17: folds 
morosun: folds 
IseeUcards: raises $6 to $8
PacPacBum: folds 
bananajoe001: raises $12 to $20
IseeUcards: calls $12
*** FLOP *** [6c 2h Td]
IseeUcards: checks 
bananajoe001: bets $34
IseeUcards: folds 
Uncalled bet ($34) returned to bananajoe001
bananajoe001 collected $40.11 from pot
bananajoe001: doesn't show hand 
*** SUMMARY ***
Total pot $42 | Rake $1.89 
Board [6c 2h Td]
Seat 1: RamiroAgujis folded before Flop (didn't bet)
Seat 2: bananajoe001 collected ($40.11)
Seat 3: matiko09 folded before Flop (didn't bet)
Seat 4: erfk1958 folded before Flop (didn't bet)
Seat 5: chaps1988 folded before Flop (didn't bet)
Seat 6: nickreason17 folded before Flop (didn't bet)
Seat 7: morosun (button) folded before Flop (didn't bet)
Seat 8: IseeUcards (small blind) folded on the Flop
Seat 9: PacPacBum (big blind) folded before Flop





PokerStars Hand #150802485278:  Hold'em No Limit ($1/$2 USD) - 2016/03/23 15:02:00 CET [2016/03/23 10:02:00 ET]
Table 'Kypria II' 9-max Seat #2 is the button
Seat 2: coinflip_si ($272.49 in chips) 
Seat 3: seouljam ($280.92 in chips) 
Seat 4: VolanDog ($229.72 in chips) 
Seat 6: matiko09 ($455.25 in chips) 
Seat 7: DUkalisUA ($200 in chips) 
Seat 8: nickreason17 ($200 in chips) 
seouljam: posts small blind $1
VolanDog: posts big blind $2
Igoriah: sits out 
nickreason17: posts small & big blinds $3
geldwolfje: sits out 
*** HOLE CARDS ***
Dealt to matiko09 [Tc Jh]
matiko09: folds 
DUkalisUA: folds 
nickreason17: raises $4 to $6
coinflip_si: folds 
seouljam: folds 
VolanDog: calls $4
*** FLOP *** [2s 6h Td]
VolanDog: checks 
nickreason17: bets $8.02
VolanDog: folds 
Uncalled bet ($8.02) returned to nickreason17
nickreason17 collected $13.37 from pot
*** SUMMARY ***
Total pot $14 | Rake $0.63 
Board [2s 6h Td]
Seat 2: coinflip_si (button) folded before Flop (didn't bet)
Seat 3: seouljam (small blind) folded before Flop
Seat 4: VolanDog (big blind) folded on the Flop
Seat 6: matiko09 folded before Flop (didn't bet)
Seat 7: DUkalisUA folded before Flop (didn't bet)
Seat 8: nickreason17 collected ($13.37)





PokerStars Hand #150802485440:  Hold'em No Limit ($0.50/$1.00 USD) - 2016/03/23 15:02:00 CET [2016/03/23 10:02:00 ET]
Table 'Swings' 9-max Seat #1 is the button
Seat 1: carrsseis ($102.66 in chips) 
Seat 2: tomver0809 ($96.68 in chips) 
Seat 3: maxxmeister ($100 in chips) 
Seat 4: chaps1988 ($100 in chips) 
Seat 5: chautinhtri9 ($117.45 in chips) 
Seat 6: matiko09 ($135.27 in chips) 
Seat 7: PacPacBum ($107.45 in chips) 
Seat 8: RICKA16 ($100.46 in chips) 
Seat 9: Vlad_1965_77 ($126.61 in chips) 
tomver0809: posts small blind $0.50
maxxmeister: posts big blind $1
*** HOLE CARDS ***
Dealt to matiko09 [9c 2c]
chaps1988: folds 
chautinhtri9: folds 
matiko09: folds 
PacPacBum: folds 
RICKA16: folds 
Vlad_1965_77: folds 
carrsseis: raises $1.50 to $2.50
tomver0809: folds 
maxxmeister: folds 
Uncalled bet ($1.50) returned to carrsseis
carrsseis collected $2.50 from pot
carrsseis: doesn't show hand 
*** SUMMARY ***
Total pot $2.50 | Rake $0 
Seat 1: carrsseis (button) collected ($2.50)
Seat 2: tomver0809 (small blind) folded before Flop
Seat 3: maxxmeister (big blind) folded before Flop
Seat 4: chaps1988 folded before Flop (didn't bet)
Seat 5: chautinhtri9 folded before Flop (didn't bet)
Seat 6: matiko09 folded before Flop (didn't bet)
Seat 7: PacPacBum folded before Flop (didn't bet)
Seat 8: RICKA16 folded before Flop (didn't bet)
Seat 9: Vlad_1965_77 folded before Flop (didn't bet)





PokerStars Hand #150802488370:  Hold'em No Limit ($0.50/$1.00 USD) - 2016/03/23 15:02:08 CET [2016/03/23 10:02:08 ET]
Table 'Merope II' 9-max Seat #6 is the button
Seat 1: Jimy Tiltman ($126.79 in chips) 
Seat 2: $-Twackle-$ ($100 in chips) 
Seat 3: pablos1922 ($88.81 in chips) 
Seat 4: PacPacBum ($100 in chips) 
Seat 5: chaps1988 ($105.16 in chips) 
Seat 6: Effort92 ($137.41 in chips) 
Seat 7: matiko09 ($103.53 in chips) 
matiko09: posts small blind $0.50
Red4erT: is sitting out 
RICKA16: is sitting out 
Jimy Tiltman: posts big blind $1
*** HOLE CARDS ***
Dealt to matiko09 [Qh Js]
Red4erT leaves the table
RICKA16 leaves the table
$-Twackle-$: folds 
$-Twackle-$ leaves the table
pablos1922: raises $1 to $2
PacPacBum: calls $2
chaps1988: folds 
Effort92: folds 
matiko09: folds 
MRR100 joins the table at seat #2 
Jimy Tiltman: folds 
*** FLOP *** [2s As 7h]
soyolo joins the table at seat #8 
ChiChioChi joins the table at seat #9 
pablos1922: checks 
PacPacBum: bets $2.83
pablos1922: calls $2.83
*** TURN *** [2s As 7h] [3c]
pablos1922: checks 
PacPacBum: bets $5.75
pablos1922: folds 
Uncalled bet ($5.75) returned to PacPacBum
PacPacBum collected $10.66 from pot
PacPacBum: doesn't show hand 
*** SUMMARY ***
Total pot $11.16 | Rake $0.50 
Board [2s As 7h 3c]
Seat 1: Jimy Tiltman (big blind) folded before Flop
Seat 2: $-Twackle-$ folded before Flop (didn't bet)
Seat 3: pablos1922 folded on the Turn
Seat 4: PacPacBum collected ($10.66)
Seat 5: chaps1988 folded before Flop (didn't bet)
Seat 6: Effort92 (button) folded before Flop (didn't bet)
Seat 7: matiko09 (small blind) folded before Flop





PokerStars Hand #150802489686:  Hold'em No Limit ($0.50/$1.00 USD) - 2016/03/23 15:02:11 CET [2016/03/23 10:02:11 ET]
Table 'Drakonia II' 9-max Seat #2 is the button
Seat 1: chautinhtri9 ($118.02 in chips) 
Seat 2: carrsseis ($100 in chips) 
Seat 3: dunga119 ($90.23 in chips) 
Seat 4: nickreason17 ($100 in chips) 
Seat 5: gchs83 ($52.04 in chips) 
Seat 6: Dantist1122 ($100 in chips) 
Seat 7: YuriiSolodya ($32.40 in chips) 
Seat 8: matiko09 ($105.39 in chips) 
Seat 9: mycka86 ($100 in chips) 
dunga119: posts small blind $0.50
nickreason17: posts big blind $1
*** HOLE CARDS ***
Dealt to matiko09 [Ac 9c]
gchs83: folds 
Dantist1122: folds 
YuriiSolodya: folds 
matiko09: raises $2 to $3
mycka86: folds 
chautinhtri9: calls $3
carrsseis: folds 
dunga119: folds 
nickreason17: folds 
*** FLOP *** [9d 3d 4h]
matiko09: bets $4.65
chautinhtri9: calls $4.65
*** TURN *** [9d 3d 4h] [7s]
matiko09: bets $9
chautinhtri9: raises $13 to $22
matiko09: folds 
Uncalled bet ($13) returned to chautinhtri9
chautinhtri9 collected $33.23 from pot
chautinhtri9: doesn't show hand 
*** SUMMARY ***
Total pot $34.80 | Rake $1.57 
Board [9d 3d 4h 7s]
Seat 1: chautinhtri9 collected ($33.23)
Seat 2: carrsseis (button) folded before Flop (didn't bet)
Seat 3: dunga119 (small blind) folded before Flop
Seat 4: nickreason17 (big blind) folded before Flop
Seat 5: gchs83 folded before Flop (didn't bet)
Seat 6: Dantist1122 folded before Flop (didn't bet)
Seat 7: YuriiSolodya folded before Flop (didn't bet)
Seat 8: matiko09 folded on the Turn
Seat 9: mycka86 folded before Flop (didn't bet)





PokerStars Hand #150802489741:  Hold'em No Limit ($1/$2 USD) - 2016/03/23 15:02:11 CET [2016/03/23 10:02:11 ET]
Table 'Herba II' 9-max Seat #5 is the button
Seat 1: matiko09 ($290.38 in chips) 
Seat 2: nickreason17 ($200 in chips) 
Seat 3: Cirilico ($160 in chips) 
Seat 4: DUkalisUA ($386.40 in chips) 
Seat 5: chippo boy ($280.73 in chips) 
Seat 6: Too-Anti-To ($223.38 in chips) 
Seat 8: T0ny Adams ($77 in chips) 
Seat 9: mrhighryza ($44.44 in chips) 
Too-Anti-To: posts small blind $1
InsomniaRU: is sitting out 
InsomniaRU leaves the table
T0ny Adams: posts big blind $2
*** HOLE CARDS ***
Dealt to matiko09 [5h Jc]
mrhighryza: folds 
matiko09: folds 
nickreason17: folds 
Cirilico: folds 
DUkalisUA: folds 
chippo boy: calls $2
Too-Anti-To: calls $1
T0ny Adams: checks 
*** FLOP *** [7c Kh Td]
Too-Anti-To: bets $3.43
T0ny Adams: folds 
chippo boy: folds 
Uncalled bet ($3.43) returned to Too-Anti-To
Too-Anti-To collected $5.73 from pot
Too-Anti-To: doesn't show hand 
*** SUMMARY ***
Total pot $6 | Rake $0.27 
Board [7c Kh Td]
Seat 1: matiko09 folded before Flop (didn't bet)
Seat 2: nickreason17 folded before Flop (didn't bet)
Seat 3: Cirilico folded before Flop (didn't bet)
Seat 4: DUkalisUA folded before Flop (didn't bet)
Seat 5: chippo boy (button) folded on the Flop
Seat 6: Too-Anti-To (small blind) collected ($5.73)
Seat 8: T0ny Adams (big blind) folded on the Flop
Seat 9: mrhighryza folded before Flop (didn't bet)





PokerStars Hand #150802490428:  Hold'em No Limit ($0.25/$0.50 USD) - 2016/03/23 15:02:14 CET [2016/03/23 10:02:14 ET]
Table 'Pyrrhus' 9-max Seat #6 is the button
Seat 1: lumen21 ($85.08 in chips) 
Seat 2: BSTUSim ($62.37 in chips) 
Seat 4: GriffinBerg ($48.09 in chips) 
Seat 6: Ahangama ($50.50 in chips) 
Seat 7: matiko09 ($136.25 in chips) 
Seat 8: suitedaces02 ($50 in chips) 
Seat 9: CvMCvMCvM ($89.80 in chips) 
matiko09: posts small blind $0.25
suitedaces02: posts big blind $0.50
Muinmyheart: sits out 
xxxibgdrgn: sits out 
*** HOLE CARDS ***
Dealt to matiko09 [3s Kd]
CvMCvMCvM: folds 
lumen21: folds 
BSTUSim: folds 
GriffinBerg: raises $1 to $1.50
Ahangama: raises $3 to $4.50
matiko09: folds 
suitedaces02: folds 
GriffinBerg: folds 
Uncalled bet ($3) returned to Ahangama
Ahangama collected $3.75 from pot
Ahangama: doesn't show hand 
*** SUMMARY ***
Total pot $3.75 | Rake $0 
Seat 1: lumen21 folded before Flop (didn't bet)
Seat 2: BSTUSim folded before Flop (didn't bet)
Seat 4: GriffinBerg folded before Flop
Seat 6: Ahangama (button) collected ($3.75)
Seat 7: matiko09 (small blind) folded before Flop
Seat 8: suitedaces02 (big blind) folded before Flop
Seat 9: CvMCvMCvM folded before Flop (didn't bet)





PokerStars Hand #150802490988:  Hold'em No Limit (€0.50/€1.00 EUR) - 2016/03/23 15:02:15 CET [2016/03/23 10:02:15 ET]
Table 'Mercury III' 9-max Seat #4 is the button
Seat 1: matiko09 (€115.08 in chips) 
Seat 2: o.miro (€124.17 in chips) 
Seat 3: PacPacBum (€100 in chips) 
Seat 4: Muinmyheart (€100 in chips) 
Seat 5: DUkalisUA (€100 in chips) 
Seat 6: mycka86 (€102.50 in chips) 
Seat 8: gfxed (€22.72 in chips) 
Seat 9: Indr3k (€100 in chips) 
DUkalisUA: posts small blind €0.50
mycka86: posts big blind €1
STrakDD: sits out 
*** HOLE CARDS ***
Dealt to matiko09 [4s Kh]
gfxed: folds 
Indr3k: folds 
matiko09: folds 
o.miro: folds 
PacPacBum: raises €1.04 to €2.04
Muinmyheart: folds 
DUkalisUA: folds 
mycka86: calls €1.04
*** FLOP *** [Qs As Jh]
mycka86: checks 
PacPacBum: bets €2.35
mycka86: folds 
Uncalled bet (€2.35) returned to PacPacBum
PacPacBum collected €4.37 from pot
PacPacBum: doesn't show hand 
*** SUMMARY ***
Total pot €4.58 | Rake €0.21 
Board [Qs As Jh]
Seat 1: matiko09 folded before Flop (didn't bet)
Seat 2: o.miro folded before Flop (didn't bet)
Seat 3: PacPacBum collected (€4.37)
Seat 4: Muinmyheart (button) folded before Flop (didn't bet)
Seat 5: DUkalisUA (small blind) folded before Flop
Seat 6: mycka86 (big blind) folded on the Flop
Seat 8: gfxed folded before Flop (didn't bet)
Seat 9: Indr3k folded before Flop (didn't bet)





PokerStars Hand #150802497993:  Hold'em No Limit ($0.50/$1.00 USD) - 2016/03/23 15:02:34 CET [2016/03/23 10:02:34 ET]
Table 'Swings' 9-max Seat #2 is the button
Seat 1: carrsseis ($104.16 in chips) 
Seat 2: tomver0809 ($96.18 in chips) 
Seat 3: maxxmeister ($100 in chips) 
Seat 4: chaps1988 ($100 in chips) 
Seat 5: chautinhtri9 ($117.45 in chips) 
Seat 6: matiko09 ($135.27 in chips) 
Seat 7: PacPacBum ($107.45 in chips) 
Seat 8: RICKA16 ($100.46 in chips) 
Seat 9: Vlad_1965_77 ($126.61 in chips) 
maxxmeister: posts small blind $0.50
chaps1988: posts big blind $1
*** HOLE CARDS ***
Dealt to matiko09 [4c Ah]
chautinhtri9: folds 
matiko09: folds 
PacPacBum: folds 
RICKA16: folds 
Vlad_1965_77: folds 
carrsseis: raises $1.50 to $2.50
tomver0809: calls $2.50
maxxmeister: raises $9.25 to $11.75
chaps1988: folds 
carrsseis: raises $14.25 to $26
tomver0809: folds 
maxxmeister: raises $74 to $100 and is all-in
carrsseis: folds 
Uncalled bet ($74) returned to maxxmeister
maxxmeister collected $55.50 from pot
maxxmeister: doesn't show hand 
*** SUMMARY ***
Total pot $55.50 | Rake $0 
Seat 1: carrsseis folded before Flop
Seat 2: tomver0809 (button) folded before Flop
Seat 3: maxxmeister (small blind) collected ($55.50)
Seat 4: chaps1988 (big blind) folded before Flop
Seat 5: chautinhtri9 folded before Flop (didn't bet)
Seat 6: matiko09 folded before Flop (didn't bet)
Seat 7: PacPacBum folded before Flop (didn't bet)
Seat 8: RICKA16 folded before Flop (didn't bet)
Seat 9: Vlad_1965_77 folded before Flop (didn't bet)





PokerStars Hand #150802498390:  Hold'em No Limit ($0.50/$1.00 USD) - 2016/03/23 15:02:35 CET [2016/03/23 10:02:35 ET]
Table 'Smiley' 9-max Seat #2 is the button
Seat 1: xHourglass ($102.50 in chips) 
Seat 2: Jimy Tiltman ($126.01 in chips) 
Seat 3: Robert201202 ($100.56 in chips) 
Seat 4: CAJUN890 ($109.93 in chips) 
Seat 5: Szevasztopol ($100 in chips) 
Seat 6: blackmont111 ($121 in chips) 
Seat 7: nickreason17 ($100 in chips) 
Seat 8: matiko09 ($100 in chips) 
Seat 9: Pvsx. ($234.87 in chips) 
Robert201202: posts small blind $0.50
CAJUN890: posts big blind $1
*** HOLE CARDS ***
Dealt to matiko09 [3s 9s]
Szevasztopol: folds 
blackmont111: raises $2 to $3
nickreason17: folds 
matiko09: folds 
Pvsx.: folds 
xHourglass: calls $3
Jimy Tiltman: folds 
Robert201202: folds 
CAJUN890: calls $2
*** FLOP *** [Th Kd 2d]
CAJUN890: checks 
blackmont111: bets $5
xHourglass: calls $5
CAJUN890: calls $5
*** TURN *** [Th Kd 2d] [7c]
CAJUN890: checks 
blackmont111: checks 
xHourglass: checks 
*** RIVER *** [Th Kd 2d 7c] [6c]
CAJUN890: bets $11.70
blackmont111: folds 
xHourglass: folds 
Uncalled bet ($11.70) returned to CAJUN890
CAJUN890 collected $23.40 from pot
CAJUN890: doesn't show hand 
*** SUMMARY ***
Total pot $24.50 | Rake $1.10 
Board [Th Kd 2d 7c 6c]
Seat 1: xHourglass folded on the River
Seat 2: Jimy Tiltman (button) folded before Flop (didn't bet)
Seat 3: Robert201202 (small blind) folded before Flop
Seat 4: CAJUN890 (big blind) collected ($23.40)
Seat 5: Szevasztopol folded before Flop (didn't bet)
Seat 6: blackmont111 folded on the River
Seat 7: nickreason17 folded before Flop (didn't bet)
Seat 8: matiko09 folded before Flop (didn't bet)
Seat 9: Pvsx. folded before Flop (didn't bet)





PokerStars Hand #150802502137:  Hold'em No Limit ($1/$2 USD) - 2016/03/23 15:02:45 CET [2016/03/23 10:02:45 ET]
Table 'Kiess' 9-max Seat #3 is the button
Seat 1: Cirilico ($225.46 in chips) 
Seat 2: DUkalisUA ($702.28 in chips) 
Seat 3: Red4erT ($90.82 in chips) 
Seat 4: Igoriah ($200 in chips) 
Seat 5: chippo boy ($395.64 in chips) 
Seat 6: matiko09 ($252.86 in chips) 
Seat 8: erfk1958 ($144.21 in chips) 
Seat 9: volwebni4ek ($90 in chips) 
Igoriah: posts small blind $1
chippo boy: posts big blind $2
chaps1988: sits out 
*** HOLE CARDS ***
Dealt to matiko09 [8h 3s]
matiko09: folds 
erfk1958: folds 
volwebni4ek: raises $4 to $6
Cirilico: calls $6
DUkalisUA: folds 
Red4erT: raises $18 to $24
Igoriah: folds 
chippo boy: folds 
volwebni4ek: folds 
Cirilico: folds 
Uncalled bet ($18) returned to Red4erT
Red4erT collected $21 from pot
Red4erT: doesn't show hand 
*** SUMMARY ***
Total pot $21 | Rake $0 
Seat 1: Cirilico folded before Flop
Seat 2: DUkalisUA folded before Flop (didn't bet)
Seat 3: Red4erT (button) collected ($21)
Seat 4: Igoriah (small blind) folded before Flop
Seat 5: chippo boy (big blind) folded before Flop
Seat 6: matiko09 folded before Flop (didn't bet)
Seat 8: erfk1958 folded before Flop (didn't bet)
Seat 9: volwebni4ek folded before Flop





PokerStars Hand #150802503548:  Hold'em No Limit ($1/$2 USD) - 2016/03/23 15:02:49 CET [2016/03/23 10:02:49 ET]
Table 'Kypria II' 9-max Seat #3 is the button
Seat 2: coinflip_si ($272.49 in chips) 
Seat 3: seouljam ($279.92 in chips) 
Seat 4: VolanDog ($223.72 in chips) 
Seat 5: Igoriah ($200 in chips) 
Seat 6: matiko09 ($455.25 in chips) 
Seat 7: DUkalisUA ($200 in chips) 
Seat 8: nickreason17 ($206.37 in chips) 
VolanDog: posts small blind $1
Igoriah: posts big blind $2
sanrs57: sits out 
geldwolfje: sits out 
*** HOLE CARDS ***
Dealt to matiko09 [6c 6s]
matiko09: raises $3 to $5
DUkalisUA: folds 
nickreason17: folds 
coinflip_si: calls $5
seouljam: folds 
VolanDog: folds 
Igoriah: folds 
*** FLOP *** [Jd 4s 4c]
matiko09: checks 
coinflip_si: checks 
*** TURN *** [Jd 4s 4c] [Qh]
matiko09: checks 
coinflip_si: checks 
*** RIVER *** [Jd 4s 4c Qh] [As]
matiko09: checks 
coinflip_si: bets $6.95
matiko09: folds 
Uncalled bet ($6.95) returned to coinflip_si
coinflip_si collected $12.42 from pot
coinflip_si: doesn't show hand 
*** SUMMARY ***
Total pot $13 | Rake $0.58 
Board [Jd 4s 4c Qh As]
Seat 2: coinflip_si collected ($12.42)
Seat 3: seouljam (button) folded before Flop (didn't bet)
Seat 4: VolanDog (small blind) folded before Flop
Seat 5: Igoriah (big blind) folded before Flop
Seat 6: matiko09 folded on the River
Seat 7: DUkalisUA folded before Flop (didn't bet)
Seat 8: nickreason17 folded before Flop (didn't bet)





PokerStars Hand #150802503512:  Hold'em No Limit ($0.50/$1.00 USD) - 2016/03/23 15:02:49 CET [2016/03/23 10:02:49 ET]
Table 'Sylvia III' 9-max Seat #4 is the button
Seat 1: mycka86 ($100 in chips) 
Seat 3: se7en_$tars ($66.35 in chips) 
Seat 4: lombardo11 ($83.62 in chips) 
Seat 5: matiko09 ($105.39 in chips) 
Seat 6: PacPacBum ($100 in chips) 
Seat 7: easytalk777 ($105.90 in chips) 
Seat 8: nickreason17 ($114.49 in chips) 
Seat 9: Blanky-Bad ($88.45 in chips) 
matiko09: posts small blind $0.50
PacPacBum: posts big blind $1
Dantist1122: sits out 
se7en_$tars: posts big blind $1
mycka86: posts the ante $0.20
se7en_$tars: posts the ante $0.20
lombardo11: posts the ante $0.20
matiko09: posts the ante $0.20
PacPacBum: posts the ante $0.20
easytalk777: posts the ante $0.20
nickreason17: posts the ante $0.20
Blanky-Bad: posts the ante $0.20
*** HOLE CARDS ***
Dealt to matiko09 [Ah Td]
easytalk777: folds 
nickreason17: folds 
Blanky-Bad: folds 
mycka86: raises $2.50 to $3.50
se7en_$tars: folds 
lombardo11: folds 
matiko09: folds 
PacPacBum: folds 
Uncalled bet ($2.50) returned to mycka86
mycka86 collected $5.10 from pot
*** SUMMARY ***
Total pot $5.10 | Rake $0 
Seat 1: mycka86 collected ($5.10)
Seat 3: se7en_$tars folded before Flop
Seat 4: lombardo11 (button) folded before Flop (didn't bet)
Seat 5: matiko09 (small blind) folded before Flop
Seat 6: PacPacBum (big blind) folded before Flop
Seat 7: easytalk777 folded before Flop (didn't bet)
Seat 8: nickreason17 folded before Flop (didn't bet)
Seat 9: Blanky-Bad folded before Flop (didn't bet)





PokerStars Hand #150802503666:  Hold'em No Limit ($1/$2 USD) - 2016/03/23 15:02:50 CET [2016/03/23 10:02:50 ET]
Table 'Herba II' 9-max Seat #6 is the button
Seat 1: matiko09 ($290.38 in chips) 
Seat 2: nickreason17 ($200 in chips) 
Seat 3: Cirilico ($160 in chips) 
Seat 4: DUkalisUA ($386.40 in chips) 
Seat 5: chippo boy ($278.73 in chips) 
Seat 6: Too-Anti-To ($227.11 in chips) 
Seat 8: T0ny Adams ($75 in chips) 
Seat 9: mrhighryza ($44.44 in chips) 
T0ny Adams: posts small blind $1
mrhighryza: posts big blind $2
*** HOLE CARDS ***
Dealt to matiko09 [3h Ah]
matiko09: folds 
nickreason17: folds 
Cirilico: folds 
Igoriah joins the table at seat #7 
DUkalisUA: raises $2 to $4
chippo boy: folds 
Too-Anti-To: folds 
T0ny Adams: folds 
mrhighryza: folds 
Uncalled bet ($2) returned to DUkalisUA
DUkalisUA collected $5 from pot
DUkalisUA: doesn't show hand 
*** SUMMARY ***
Total pot $5 | Rake $0 
Seat 1: matiko09 folded before Flop (didn't bet)
Seat 2: nickreason17 folded before Flop (didn't bet)
Seat 3: Cirilico folded before Flop (didn't bet)
Seat 4: DUkalisUA collected ($5)
Seat 5: chippo boy folded before Flop (didn't bet)
Seat 6: Too-Anti-To (button) folded before Flop (didn't bet)
Seat 8: T0ny Adams (small blind) folded before Flop
Seat 9: mrhighryza (big blind) folded before Flop





PokerStars Hand #150802506103:  Hold'em No Limit ($1/$2 USD) - 2016/03/23 15:02:56 CET [2016/03/23 10:02:56 ET]
Table 'Achaia' 9-max Seat #8 is the button
Seat 1: RamiroAgujis ($229.07 in chips) 
Seat 2: bananajoe001 ($213.35 in chips) 
Seat 3: matiko09 ($234.16 in chips) 
Seat 4: erfk1958 ($90 in chips) 
Seat 5: chaps1988 ($200 in chips) 
Seat 6: nickreason17 ($251.17 in chips) 
Seat 7: morosun ($238.32 in chips) 
Seat 8: IseeUcards ($200 in chips) 
Seat 9: PacPacBum ($205.35 in chips) 
PacPacBum: posts small blind $1
RamiroAgujis: posts big blind $2
*** HOLE CARDS ***
Dealt to matiko09 [2s Js]
bananajoe001: folds 
matiko09: folds 
erfk1958: folds 
chaps1988: folds 
nickreason17: folds 
morosun: folds 
IseeUcards: raises $2.50 to $4.50
PacPacBum: folds 
RamiroAgujis: raises $13.50 to $18
IseeUcards: folds 
Uncalled bet ($13.50) returned to RamiroAgujis
RamiroAgujis collected $10 from pot
RamiroAgujis: doesn't show hand 
*** SUMMARY ***
Total pot $10 | Rake $0 
Seat 1: RamiroAgujis (big blind) collected ($10)
Seat 2: bananajoe001 folded before Flop (didn't bet)
Seat 3: matiko09 folded before Flop (didn't bet)
Seat 4: erfk1958 folded before Flop (didn't bet)
Seat 5: chaps1988 folded before Flop (didn't bet)
Seat 6: nickreason17 folded before Flop (didn't bet)
Seat 7: morosun folded before Flop (didn't bet)
Seat 8: IseeUcards (button) folded before Flop
Seat 9: PacPacBum (small blind) folded before Flop





PokerStars Hand #150802508969:  Hold'em No Limit ($0.50/$1.00 USD) - 2016/03/23 15:03:04 CET [2016/03/23 10:03:04 ET]
Table 'Asmodeus' 9-max Seat #8 is the button
Seat 1: Jimy Tiltman ($121.44 in chips) 
Seat 3: nickreason17 ($100 in chips) 
Seat 4: Effort92 ($102.30 in chips) 
Seat 7: mycka86 ($113.49 in chips) 
Seat 8: bonifacioppl ($98.50 in chips) 
Seat 9: matiko09 ($100 in chips) 
matiko09: posts small blind $0.50
Jimy Tiltman: posts big blind $1
PacPacBum: sits out 
Muinmyheart: sits out 
fuppeee: sits out 
Jimy Tiltman: posts the ante $0.20
nickreason17: posts the ante $0.20
Effort92: posts the ante $0.20
mycka86: posts the ante $0.20
bonifacioppl: posts the ante $0.20
matiko09: posts the ante $0.20
*** HOLE CARDS ***
Dealt to matiko09 [Ac Qc]
nickreason17: folds 
Effort92: folds 
mycka86: folds 
bonifacioppl: raises $2.50 to $3.50
matiko09: raises $6.50 to $10
Jimy Tiltman: folds 
bonifacioppl: folds 
Uncalled bet ($6.50) returned to matiko09
matiko09 collected $9.20 from pot
matiko09: doesn't show hand 
*** SUMMARY ***
Total pot $9.20 | Rake $0 
Seat 1: Jimy Tiltman (big blind) folded before Flop
Seat 3: nickreason17 folded before Flop (didn't bet)
Seat 4: Effort92 folded before Flop (didn't bet)
Seat 7: mycka86 folded before Flop (didn't bet)
Seat 8: bonifacioppl (button) folded before Flop
Seat 9: matiko09 (small blind) collected ($9.20)





PokerStars Hand #150802509339:  Hold'em No Limit ($0.25/$0.50 USD) - 2016/03/23 15:03:04 CET [2016/03/23 10:03:04 ET]
Table 'Pyrrhus' 9-max Seat #7 is the button
Seat 1: lumen21 ($85.08 in chips) 
Seat 2: BSTUSim ($62.37 in chips) 
Seat 4: GriffinBerg ($46.59 in chips) 
Seat 6: Ahangama ($52.75 in chips) 
Seat 7: matiko09 ($136 in chips) 
Seat 8: suitedaces02 ($50 in chips) 
Seat 9: CvMCvMCvM ($89.80 in chips) 
suitedaces02: posts small blind $0.25
CvMCvMCvM: posts big blind $0.50
Muinmyheart: sits out 
xxxibgdrgn: sits out 
*** HOLE CARDS ***
Dealt to matiko09 [Ad Kd]
lumen21: folds 
BSTUSim: folds 
GriffinBerg: calls $0.50
Ahangama: folds 
matiko09 has timed out
matiko09: folds 
suitedaces02: folds 
CvMCvMCvM: checks 
*** FLOP *** [5c Th Ah]
CvMCvMCvM: checks 
GriffinBerg: checks 
*** TURN *** [5c Th Ah] [9h]
CvMCvMCvM: checks 
GriffinBerg: bets $1.19
CvMCvMCvM: folds 
Uncalled bet ($1.19) returned to GriffinBerg
GriffinBerg collected $1.19 from pot
*** SUMMARY ***
Total pot $1.25 | Rake $0.06 
Board [5c Th Ah 9h]
Seat 1: lumen21 folded before Flop (didn't bet)
Seat 2: BSTUSim folded before Flop (didn't bet)
Seat 4: GriffinBerg collected ($1.19)
Seat 6: Ahangama folded before Flop (didn't bet)
Seat 7: matiko09 (button) folded before Flop (didn't bet)
Seat 8: suitedaces02 (small blind) folded before Flop
Seat 9: CvMCvMCvM (big blind) folded on the Turn





PokerStars Hand #150802512803:  Hold'em No Limit ($0.50/$1.00 USD) - 2016/03/23 15:03:14 CET [2016/03/23 10:03:14 ET]
Table 'Sylvia III' 9-max Seat #5 is the button
Seat 1: mycka86 ($103.90 in chips) 
Seat 3: se7en_$tars ($65.15 in chips) 
Seat 4: lombardo11 ($83.42 in chips) 
Seat 5: matiko09 ($104.69 in chips) 
Seat 6: PacPacBum ($100 in chips) 
Seat 7: easytalk777 ($105.70 in chips) 
Seat 8: nickreason17 ($114.29 in chips) 
Seat 9: Blanky-Bad ($88.25 in chips) 
PacPacBum: posts small blind $0.50
easytalk777: posts big blind $1
Dantist1122: sits out 
mycka86: posts the ante $0.20
se7en_$tars: posts the ante $0.20
lombardo11: posts the ante $0.20
matiko09: posts the ante $0.20
PacPacBum: posts the ante $0.20
easytalk777: posts the ante $0.20
nickreason17: posts the ante $0.20
Blanky-Bad: posts the ante $0.20
*** HOLE CARDS ***
Dealt to matiko09 [3h 7s]
nickreason17: folds 
Blanky-Bad: raises $1.27 to $2.27
mycka86: folds 
se7en_$tars: folds 
lombardo11: folds 
matiko09: folds 
PacPacBum: folds 
easytalk777: calls $1.27
*** FLOP *** [4s Th Qc]
easytalk777: checks 
Blanky-Bad: checks 
*** TURN *** [4s Th Qc] [Ac]
easytalk777: bets $5
Blanky-Bad: raises $8.17 to $13.17
easytalk777: folds 
Uncalled bet ($8.17) returned to Blanky-Bad
Blanky-Bad collected $15.89 from pot
Blanky-Bad: doesn't show hand 
*** SUMMARY ***
Total pot $16.64 | Rake $0.75 
Board [4s Th Qc Ac]
Seat 1: mycka86 folded before Flop (didn't bet)
Seat 3: se7en_$tars folded before Flop (didn't bet)
Seat 4: lombardo11 folded before Flop (didn't bet)
Seat 5: matiko09 (button) folded before Flop (didn't bet)
Seat 6: PacPacBum (small blind) folded before Flop
Seat 7: easytalk777 (big blind) folded on the Turn
Seat 8: nickreason17 folded before Flop (didn't bet)
Seat 9: Blanky-Bad collected ($15.89)





PokerStars Hand #150802515404:  Hold'em No Limit ($1/$2 USD) - 2016/03/23 15:03:21 CET [2016/03/23 10:03:21 ET]
Table 'Herba II' 9-max Seat #8 is the button
Seat 1: matiko09 ($290.38 in chips) 
Seat 2: nickreason17 ($200 in chips) 
Seat 3: Cirilico ($160 in chips) 
Seat 4: DUkalisUA ($389.40 in chips) 
Seat 5: chippo boy ($278.73 in chips) 
Seat 6: Too-Anti-To ($227.11 in chips) 
Seat 8: T0ny Adams ($74 in chips) 
Seat 9: mrhighryza ($42.44 in chips) 
mrhighryza: posts small blind $1
matiko09: posts big blind $2
Igoriah: sits out 
*** HOLE CARDS ***
Dealt to matiko09 [9c 2h]
nickreason17: folds 
Cirilico: folds 
DUkalisUA: folds 
chippo boy: calls $2
Too-Anti-To: folds 
T0ny Adams: folds 
mrhighryza: calls $1
matiko09: checks 
*** FLOP *** [3h Jh 4h]
mrhighryza: bets $4
matiko09: folds 
chippo boy: calls $4
*** TURN *** [3h Jh 4h] [7s]
mrhighryza: bets $6
chippo boy: calls $6
*** RIVER *** [3h Jh 4h 7s] [Kh]
mrhighryza: checks 
chippo boy: checks 
*** SHOW DOWN ***
mrhighryza: shows [Th Js] (a flush, King high)
chippo boy: mucks hand 
mrhighryza collected $24.83 from pot
*** SUMMARY ***
Total pot $26 | Rake $1.17 
Board [3h Jh 4h 7s Kh]
Seat 1: matiko09 (big blind) folded on the Flop
Seat 2: nickreason17 folded before Flop (didn't bet)
Seat 3: Cirilico folded before Flop (didn't bet)
Seat 4: DUkalisUA folded before Flop (didn't bet)
Seat 5: chippo boy mucked [6c 7d]
Seat 6: Too-Anti-To folded before Flop (didn't bet)
Seat 8: T0ny Adams (button) folded before Flop (didn't bet)
Seat 9: mrhighryza (small blind) showed [Th Js] and won ($24.83) with a flush, King high





PokerStars Hand #150802516635:  Hold'em No Limit ($0.50/$1.00 USD) - 2016/03/23 15:03:24 CET [2016/03/23 10:03:24 ET]
Table 'Merope II' 9-max Seat #7 is the button
Seat 1: Jimy Tiltman ($125.79 in chips) 
Seat 2: MRR100 ($100 in chips) 
Seat 3: pablos1922 ($83.98 in chips) 
Seat 4: PacPacBum ($105.83 in chips) 
Seat 5: chaps1988 ($105.16 in chips) 
Seat 6: Effort92 ($137.41 in chips) 
Seat 7: matiko09 ($103.03 in chips) 
soyolo will be allowed to play after the button
ChiChioChi will be allowed to play after the button
Jimy Tiltman: posts small blind $0.50
MRR100: posts big blind $1
*** HOLE CARDS ***
Dealt to matiko09 [7c Ts]
pablos1922: folds 
PacPacBum: folds 
chaps1988: folds 
Effort92: raises $1.50 to $2.50
matiko09: folds 
Jimy Tiltman: folds 
MRR100: folds 
Uncalled bet ($1.50) returned to Effort92
Effort92 collected $2.50 from pot
Effort92: doesn't show hand 
*** SUMMARY ***
Total pot $2.50 | Rake $0 
Seat 1: Jimy Tiltman (small blind) folded before Flop
Seat 2: MRR100 (big blind) folded before Flop
Seat 3: pablos1922 folded before Flop (didn't bet)
Seat 4: PacPacBum folded before Flop (didn't bet)
Seat 5: chaps1988 folded before Flop (didn't bet)
Seat 6: Effort92 collected ($2.50)
Seat 7: matiko09 (button) folded before Flop (didn't bet)





PokerStars Hand #150802519267:  Hold'em No Limit ($1/$2 USD) - 2016/03/23 15:03:30 CET [2016/03/23 10:03:30 ET]
Table 'Clarissa II' 9-max Seat #4 is the button
Seat 1: DUkalisUA ($702.47 in chips) 
Seat 2: Igoriah ($205.24 in chips) 
Seat 3: PtizaXXX ($182.60 in chips) 
Seat 4: sanrs57 ($195 in chips) 
Seat 5: Red4erT ($84 in chips) 
Seat 6: matiko09 ($200 in chips) 
Seat 8: chaps1988 ($208.32 in chips) 
Red4erT: posts small blind $1
matiko09: posts big blind $2
PacPacBum: sits out 
RamiroAgujis: sits out 
*** HOLE CARDS ***
Dealt to matiko09 [7d 6h]
chaps1988: raises $4 to $6
DUkalisUA: folds 
Igoriah: folds 
PtizaXXX: folds 
sanrs57: folds 
Red4erT: folds 
matiko09: folds 
Uncalled bet ($4) returned to chaps1988
chaps1988 collected $5 from pot
chaps1988: doesn't show hand 
*** SUMMARY ***
Total pot $5 | Rake $0 
Seat 1: DUkalisUA folded before Flop (didn't bet)
Seat 2: Igoriah folded before Flop (didn't bet)
Seat 3: PtizaXXX folded before Flop (didn't bet)
Seat 4: sanrs57 (button) folded before Flop (didn't bet)
Seat 5: Red4erT (small blind) folded before Flop
Seat 6: matiko09 (big blind) folded before Flop
Seat 8: chaps1988 collected ($5)





PokerStars Hand #150802518974:  Hold'em No Limit (€0.50/€1.00 EUR) - 2016/03/23 15:03:30 CET [2016/03/23 10:03:30 ET]
Table 'Mercury III' 9-max Seat #5 is the button
Seat 1: matiko09 (€115.08 in chips) 
Seat 2: o.miro (€124.17 in chips) 
Seat 3: PacPacBum (€102.33 in chips) 
Seat 4: Muinmyheart (€100 in chips) 
Seat 5: DUkalisUA (€100 in chips) 
Seat 6: mycka86 (€100.46 in chips) 
Seat 7: STrakDD (€100 in chips) 
Seat 8: gfxed (€22.72 in chips) 
Seat 9: Indr3k (€100 in chips) 
mycka86: posts small blind €0.50
STrakDD: posts big blind €1
*** HOLE CARDS ***
Dealt to matiko09 [8s Qh]
gfxed: raises €1.23 to €2.23
Indr3k: folds 
matiko09: folds 
o.miro: folds 
PacPacBum: folds 
Muinmyheart: folds 
DUkalisUA: folds 
mycka86: folds 
STrakDD: folds 
Uncalled bet (€1.23) returned to gfxed
gfxed collected €2.50 from pot
*** SUMMARY ***
Total pot €2.50 | Rake €0 
Seat 1: matiko09 folded before Flop (didn't bet)
Seat 2: o.miro folded before Flop (didn't bet)
Seat 3: PacPacBum folded before Flop (didn't bet)
Seat 4: Muinmyheart folded before Flop (didn't bet)
Seat 5: DUkalisUA (button) folded before Flop (didn't bet)
Seat 6: mycka86 (small blind) folded before Flop
Seat 7: STrakDD (big blind) folded before Flop
Seat 8: gfxed collected (€2.50)
Seat 9: Indr3k folded before Flop (didn't bet)





PokerStars Hand #150802519362:  Hold'em No Limit ($0.50/$1.00 USD) - 2016/03/23 15:03:31 CET [2016/03/23 10:03:31 ET]
Table 'Asmodeus' 9-max Seat #9 is the button
Seat 1: Jimy Tiltman ($120.24 in chips) 
Seat 2: PacPacBum ($110.03 in chips) 
Seat 3: nickreason17 ($100 in chips) 
Seat 4: Effort92 ($102.10 in chips) 
Seat 7: mycka86 ($113.29 in chips) 
Seat 8: bonifacioppl ($94.80 in chips) 
Seat 9: matiko09 ($105.50 in chips) 
Jimy Tiltman: posts small blind $0.50
PacPacBum: posts big blind $1
Muinmyheart: sits out 
fuppeee: sits out 
Jimy Tiltman: posts the ante $0.20
PacPacBum: posts the ante $0.20
nickreason17: posts the ante $0.20
Effort92: posts the ante $0.20
mycka86: posts the ante $0.20
bonifacioppl: posts the ante $0.20
matiko09: posts the ante $0.20
*** HOLE CARDS ***
Dealt to matiko09 [Ts Ks]
nickreason17: raises $2 to $3
Effort92: folds 
mycka86: folds 
bonifacioppl: folds 
matiko09: folds 
Jimy Tiltman: folds 
PacPacBum: folds 
Uncalled bet ($2) returned to nickreason17
nickreason17 collected $3.90 from pot
*** SUMMARY ***
Total pot $3.90 | Rake $0 
Seat 1: Jimy Tiltman (small blind) folded before Flop
Seat 2: PacPacBum (big blind) folded before Flop
Seat 3: nickreason17 collected ($3.90)
Seat 4: Effort92 folded before Flop (didn't bet)
Seat 7: mycka86 folded before Flop (didn't bet)
Seat 8: bonifacioppl folded before Flop (didn't bet)
Seat 9: matiko09 (button) folded before Flop (didn't bet)





PokerStars Hand #150802522774:  Hold'em No Limit ($1/$2 USD) - 2016/03/23 15:03:40 CET [2016/03/23 10:03:40 ET]
Table 'Achaia' 9-max Seat #9 is the button
Seat 1: RamiroAgujis ($234.57 in chips) 
Seat 2: bananajoe001 ($213.35 in chips) 
Seat 3: matiko09 ($234.16 in chips) 
Seat 4: erfk1958 ($90 in chips) 
Seat 5: chaps1988 ($200 in chips) 
Seat 6: nickreason17 ($251.17 in chips) 
Seat 7: morosun ($238.32 in chips) 
Seat 8: IseeUcards ($200 in chips) 
Seat 9: PacPacBum ($204.35 in chips) 
RamiroAgujis: posts small blind $1
bananajoe001: posts big blind $2
*** HOLE CARDS ***
Dealt to matiko09 [Ad 5s]
matiko09: folds 
erfk1958: folds 
chaps1988: folds 
nickreason17: folds 
morosun: raises $4 to $6
IseeUcards: raises $12 to $18
PacPacBum: folds 
RamiroAgujis: folds 
bananajoe001: folds 
morosun: calls $12
*** FLOP *** [Tc Kh 8c]
morosun: checks 
IseeUcards: bets $20
morosun: calls $20
*** TURN *** [Tc Kh 8c] [Qs]
morosun: checks 
IseeUcards: bets $46
morosun: calls $46
*** RIVER *** [Tc Kh 8c Qs] [4c]
morosun: checks 
IseeUcards: checks 
*** SHOW DOWN ***
morosun: shows [As Kd] (a pair of Kings)
IseeUcards: shows [Kc Ah] (a pair of Kings)
morosun collected $84.10 from pot
IseeUcards collected $84.10 from pot
*** SUMMARY ***
Total pot $171 | Rake $2.80 
Board [Tc Kh 8c Qs 4c]
Seat 1: RamiroAgujis (small blind) folded before Flop
Seat 2: bananajoe001 (big blind) folded before Flop
Seat 3: matiko09 folded before Flop (didn't bet)
Seat 4: erfk1958 folded before Flop (didn't bet)
Seat 5: chaps1988 folded before Flop (didn't bet)
Seat 6: nickreason17 folded before Flop (didn't bet)
Seat 7: morosun showed [As Kd] and won ($84.10) with a pair of Kings
Seat 8: IseeUcards showed [Kc Ah] and won ($84.10) with a pair of Kings
Seat 9: PacPacBum (button) folded before Flop (didn't bet)





PokerStars Hand #150802525821:  Hold'em No Limit ($1/$2 USD) - 2016/03/23 15:03:48 CET [2016/03/23 10:03:48 ET]
Table 'Kiess' 9-max Seat #4 is the button
Seat 1: Cirilico ($219.46 in chips) 
Seat 2: DUkalisUA ($702.28 in chips) 
Seat 3: Red4erT ($105.82 in chips) 
Seat 4: Igoriah ($200 in chips) 
Seat 5: chippo boy ($393.64 in chips) 
Seat 6: matiko09 ($252.86 in chips) 
Seat 8: erfk1958 ($144.21 in chips) 
Seat 9: volwebni4ek ($84 in chips) 
chippo boy: posts small blind $1
matiko09: posts big blind $2
chaps1988: sits out 
*** HOLE CARDS ***
Dealt to matiko09 [As Jh]
erfk1958: folds 
volwebni4ek: raises $4 to $6
Cirilico: folds 
DUkalisUA: folds 
Red4erT: calls $6
Igoriah: folds 
chippo boy: raises $16 to $22
matiko09: folds 
volwebni4ek: folds 
Red4erT: folds 
Uncalled bet ($16) returned to chippo boy
chippo boy collected $20 from pot
*** SUMMARY ***
Total pot $20 | Rake $0 
Seat 1: Cirilico folded before Flop (didn't bet)
Seat 2: DUkalisUA folded before Flop (didn't bet)
Seat 3: Red4erT folded before Flop
Seat 4: Igoriah (button) folded before Flop (didn't bet)
Seat 5: chippo boy (small blind) collected ($20)
Seat 6: matiko09 (big blind) folded before Flop
Seat 8: erfk1958 folded before Flop (didn't bet)
Seat 9: volwebni4ek folded before Flop





PokerStars Hand #150802526764:  Hold'em No Limit ($0.50/$1.00 USD) - 2016/03/23 15:03:50 CET [2016/03/23 10:03:50 ET]
Table 'Smiley' 9-max Seat #3 is the button
Seat 1: xHourglass ($100 in chips) 
Seat 2: Jimy Tiltman ($126.01 in chips) 
Seat 3: Robert201202 ($100.06 in chips) 
Seat 4: CAJUN890 ($125.33 in chips) 
Seat 5: Szevasztopol ($100 in chips) 
Seat 6: blackmont111 ($113 in chips) 
Seat 7: nickreason17 ($100 in chips) 
Seat 8: matiko09 ($100 in chips) 
Seat 9: Pvsx. ($234.87 in chips) 
CAJUN890: posts small blind $0.50
Szevasztopol: posts big blind $1
*** HOLE CARDS ***
Dealt to matiko09 [Kc 8c]
blackmont111: raises $2 to $3
nickreason17: folds 
matiko09: folds 
Pvsx.: folds 
xHourglass: folds 
Jimy Tiltman: folds 
Robert201202: folds 
CAJUN890: calls $2.50
Szevasztopol: folds 
*** FLOP *** [9c Th 8s]
CAJUN890: bets $3.34
blackmont111: calls $3.34
*** TURN *** [9c Th 8s] [Ad]
CAJUN890: bets $6.53
blackmont111: raises $10.47 to $17
CAJUN890: calls $10.47
*** RIVER *** [9c Th 8s Ad] [Kd]
CAJUN890: checks 
blackmont111: bets $27
CAJUN890: calls $27
*** SHOW DOWN ***
blackmont111: shows [Jd Qd] (a straight, Ten to Ace)
CAJUN890: mucks hand 
blackmont111 collected $98.88 from pot
*** SUMMARY ***
Total pot $101.68 | Rake $2.80 
Board [9c Th 8s Ad Kd]
Seat 1: xHourglass folded before Flop (didn't bet)
Seat 2: Jimy Tiltman folded before Flop (didn't bet)
Seat 3: Robert201202 (button) folded before Flop (didn't bet)
Seat 4: CAJUN890 (small blind) mucked [9s As]
Seat 5: Szevasztopol (big blind) folded before Flop
Seat 6: blackmont111 showed [Jd Qd] and won ($98.88) with a straight, Ten to Ace
Seat 7: nickreason17 folded before Flop (didn't bet)
Seat 8: matiko09 folded before Flop (didn't bet)
Seat 9: Pvsx. folded before Flop (didn't bet)





PokerStars Hand #150802526972:  Hold'em No Limit ($0.50/$1.00 USD) - 2016/03/23 15:03:51 CET [2016/03/23 10:03:51 ET]
Table 'Drakonia II' 9-max Seat #3 is the button
Seat 1: chautinhtri9 ($134.60 in chips) 
Seat 2: carrsseis ($100 in chips) 
Seat 3: dunga119 ($89.73 in chips) 
Seat 4: nickreason17 ($100 in chips) 
Seat 5: gchs83 ($52.04 in chips) 
Seat 6: Dantist1122 ($100 in chips) 
Seat 7: YuriiSolodya ($32.40 in chips) 
Seat 8: matiko09 ($100 in chips) 
Seat 9: mycka86 ($100 in chips) 
nickreason17: posts small blind $0.50
gchs83: posts big blind $1
*** HOLE CARDS ***
Dealt to matiko09 [7s 6s]
Dantist1122: folds 
YuriiSolodya: raises $1 to $2
matiko09: folds 
mycka86: folds 
chautinhtri9: folds 
carrsseis: folds 
dunga119: calls $2
nickreason17: folds 
gchs83: calls $1
*** FLOP *** [Kh Qc Tc]
gchs83: checks 
YuriiSolodya: checks 
dunga119: checks 
*** TURN *** [Kh Qc Tc] [Qs]
gchs83: bets $1
YuriiSolodya: calls $1
dunga119: calls $1
*** RIVER *** [Kh Qc Tc Qs] [9s]
gchs83: bets $9.07
YuriiSolodya: folds 
dunga119: folds 
Uncalled bet ($9.07) returned to gchs83
gchs83 collected $9.07 from pot
gchs83: doesn't show hand 
*** SUMMARY ***
Total pot $9.50 | Rake $0.43 
Board [Kh Qc Tc Qs 9s]
Seat 1: chautinhtri9 folded before Flop (didn't bet)
Seat 2: carrsseis folded before Flop (didn't bet)
Seat 3: dunga119 (button) folded on the River
Seat 4: nickreason17 (small blind) folded before Flop
Seat 5: gchs83 (big blind) collected ($9.07)
Seat 6: Dantist1122 folded before Flop (didn't bet)
Seat 7: YuriiSolodya folded on the River
Seat 8: matiko09 folded before Flop (didn't bet)
Seat 9: mycka86 folded before Flop (didn't bet)





PokerStars Hand #150802527083:  Hold'em No Limit ($0.50/$1.00 USD) - 2016/03/23 15:03:51 CET [2016/03/23 10:03:51 ET]
Table 'Swings' 9-max Seat #3 is the button
Seat 1: carrsseis ($100 in chips) 
Seat 2: tomver0809 ($93.68 in chips) 
Seat 3: maxxmeister ($129.50 in chips) 
Seat 4: chaps1988 ($100 in chips) 
Seat 5: chautinhtri9 ($117.45 in chips) 
Seat 6: matiko09 ($135.27 in chips) 
Seat 7: PacPacBum ($107.45 in chips) 
Seat 8: RICKA16 ($100.46 in chips) 
Seat 9: Vlad_1965_77 ($126.61 in chips) 
chaps1988: posts small blind $0.50
chautinhtri9: posts big blind $1
*** HOLE CARDS ***
Dealt to matiko09 [7c Ad]
matiko09: folds 
PacPacBum: folds 
RICKA16: folds 
Vlad_1965_77: folds 
carrsseis: folds 
tomver0809: folds 
maxxmeister: folds 
chaps1988: raises $2 to $3
chautinhtri9: calls $2
*** FLOP *** [8h Ks 8d]
chaps1988: bets $3.50
chautinhtri9: folds 
Uncalled bet ($3.50) returned to chaps1988
chaps1988 collected $5.73 from pot
chaps1988: doesn't show hand 
*** SUMMARY ***
Total pot $6 | Rake $0.27 
Board [8h Ks 8d]
Seat 1: carrsseis folded before Flop (didn't bet)
Seat 2: tomver0809 folded before Flop (didn't bet)
Seat 3: maxxmeister (button) folded before Flop (didn't bet)
Seat 4: chaps1988 (small blind) collected ($5.73)
Seat 5: chautinhtri9 (big blind) folded on the Flop
Seat 6: matiko09 folded before Flop (didn't bet)
Seat 7: PacPacBum folded before Flop (didn't bet)
Seat 8: RICKA16 folded before Flop (didn't bet)
Seat 9: Vlad_1965_77 folded before Flop (didn't bet)





PokerStars Hand #150802528115:  Hold'em No Limit ($0.50/$1.00 USD) - 2016/03/23 15:03:54 CET [2016/03/23 10:03:54 ET]
Table 'Asmodeus' 9-max Seat #1 is the button
Seat 1: Jimy Tiltman ($119.54 in chips) 
Seat 2: PacPacBum ($108.83 in chips) 
Seat 3: nickreason17 ($102.70 in chips) 
Seat 4: Effort92 ($101.90 in chips) 
Seat 7: mycka86 ($113.09 in chips) 
Seat 8: bonifacioppl ($94.60 in chips) 
Seat 9: matiko09 ($105.30 in chips) 
PacPacBum: posts small blind $0.50
nickreason17: posts big blind $1
Muinmyheart: sits out 
fuppeee: sits out 
Jimy Tiltman: posts the ante $0.20
PacPacBum: posts the ante $0.20
nickreason17: posts the ante $0.20
Effort92: posts the ante $0.20
mycka86: posts the ante $0.20
bonifacioppl: posts the ante $0.20
matiko09: posts the ante $0.20
*** HOLE CARDS ***
Dealt to matiko09 [Ah 9h]
Effort92: folds 
mycka86: folds 
bonifacioppl: raises $1.37 to $2.37
matiko09: folds 
Jimy Tiltman: folds 
PacPacBum: folds 
nickreason17: folds 
Uncalled bet ($1.37) returned to bonifacioppl
bonifacioppl collected $3.90 from pot
bonifacioppl: doesn't show hand 
*** SUMMARY ***
Total pot $3.90 | Rake $0 
Seat 1: Jimy Tiltman (button) folded before Flop (didn't bet)
Seat 2: PacPacBum (small blind) folded before Flop
Seat 3: nickreason17 (big blind) folded before Flop
Seat 4: Effort92 folded before Flop (didn't bet)
Seat 7: mycka86 folded before Flop (didn't bet)
Seat 8: bonifacioppl collected ($3.90)
Seat 9: matiko09 folded before Flop (didn't bet)





PokerStars Hand #150802531483:  Hold'em No Limit ($0.50/$1.00 USD) - 2016/03/23 15:04:03 CET [2016/03/23 10:04:03 ET]
Table 'Sylvia III' 9-max Seat #6 is the button
Seat 1: mycka86 ($103.70 in chips) 
Seat 3: se7en_$tars ($64.95 in chips) 
Seat 4: lombardo11 ($83.22 in chips) 
Seat 5: matiko09 ($104.49 in chips) 
Seat 6: PacPacBum ($100 in chips) 
Seat 7: easytalk777 ($98.23 in chips) 
Seat 8: nickreason17 ($114.09 in chips) 
Seat 9: Blanky-Bad ($96.67 in chips) 
easytalk777: posts small blind $0.50
nickreason17: posts big blind $1
Dantist1122: sits out 
mycka86: posts the ante $0.20
se7en_$tars: posts the ante $0.20
lombardo11: posts the ante $0.20
matiko09: posts the ante $0.20
PacPacBum: posts the ante $0.20
easytalk777: posts the ante $0.20
nickreason17: posts the ante $0.20
Blanky-Bad: posts the ante $0.20
*** HOLE CARDS ***
Dealt to matiko09 [6c Ts]
Blanky-Bad: folds 
mycka86: folds 
se7en_$tars: folds 
lombardo11: folds 
matiko09: folds 
PacPacBum: folds 
easytalk777: folds 
Uncalled bet ($0.50) returned to nickreason17
nickreason17 collected $2.60 from pot
*** SUMMARY ***
Total pot $2.60 | Rake $0 
Seat 1: mycka86 folded before Flop (didn't bet)
Seat 3: se7en_$tars folded before Flop (didn't bet)
Seat 4: lombardo11 folded before Flop (didn't bet)
Seat 5: matiko09 folded before Flop (didn't bet)
Seat 6: PacPacBum (button) folded before Flop (didn't bet)
Seat 7: easytalk777 (small blind) folded before Flop
Seat 8: nickreason17 (big blind) collected ($2.60)
Seat 9: Blanky-Bad folded before Flop (didn't bet)





PokerStars Hand #150802531753:  Hold'em No Limit ($1/$2 USD) - 2016/03/23 15:04:03 CET [2016/03/23 10:04:03 ET]
Table 'Kypria II' 9-max Seat #4 is the button
Seat 1: geldwolfje ($200 in chips) 
Seat 2: coinflip_si ($279.91 in chips) 
Seat 3: seouljam ($279.92 in chips) 
Seat 4: VolanDog ($222.72 in chips) 
Seat 5: Igoriah ($200 in chips) 
Seat 6: matiko09 ($450.25 in chips) 
Seat 7: DUkalisUA ($200 in chips) 
Seat 8: nickreason17 ($206.37 in chips) 
Igoriah: posts small blind $1
matiko09: posts big blind $2
sanrs57: sits out 
geldwolfje: posts small & big blinds $3
*** HOLE CARDS ***
Dealt to matiko09 [Kd Tc]
DUkalisUA: folds 
nickreason17: folds 
geldwolfje: checks 
coinflip_si: raises $8 to $10
seouljam: folds 
VolanDog: folds 
Igoriah: folds 
matiko09: folds 
geldwolfje: calls $8
*** FLOP *** [7h 2h 9c]
geldwolfje: checks 
coinflip_si: checks 
*** TURN *** [7h 2h 9c] [Ah]
geldwolfje: checks 
coinflip_si: checks 
*** RIVER *** [7h 2h 9c Ah] [Qc]
geldwolfje: checks 
coinflip_si: bets $6
geldwolfje: folds 
Uncalled bet ($6) returned to coinflip_si
coinflip_si collected $22.92 from pot
coinflip_si: doesn't show hand 
*** SUMMARY ***
Total pot $24 | Rake $1.08 
Board [7h 2h 9c Ah Qc]
Seat 1: geldwolfje folded on the River
Seat 2: coinflip_si collected ($22.92)
Seat 3: seouljam folded before Flop (didn't bet)
Seat 4: VolanDog (button) folded before Flop (didn't bet)
Seat 5: Igoriah (small blind) folded before Flop
Seat 6: matiko09 (big blind) folded before Flop
Seat 7: DUkalisUA folded before Flop (didn't bet)
Seat 8: nickreason17 folded before Flop (didn't bet)





PokerStars Hand #150802533709:  Hold'em No Limit ($0.50/$1.00 USD) - 2016/03/23 15:04:08 CET [2016/03/23 10:04:08 ET]
Table 'Merope II' 9-max Seat #1 is the button
Seat 1: Jimy Tiltman ($125.29 in chips) 
Seat 2: MRR100 ($100 in chips) 
Seat 3: pablos1922 ($83.98 in chips) 
Seat 4: PacPacBum ($105.83 in chips) 
Seat 5: chaps1988 ($105.16 in chips) 
Seat 6: Effort92 ($138.91 in chips) 
Seat 7: matiko09 ($103.03 in chips) 
Seat 8: soyolo ($90.51 in chips) 
Seat 9: ChiChioChi ($80 in chips) 
MRR100: posts small blind $0.50
pablos1922: posts big blind $1
soyolo: posts big blind $1
ChiChioChi: posts big blind $1
*** HOLE CARDS ***
Dealt to matiko09 [6d 5c]
PacPacBum: folds 
chaps1988: folds 
Effort92: folds 
matiko09: folds 
soyolo: checks 
ChiChioChi: checks 
Jimy Tiltman: raises $4 to $5
MRR100: folds 
pablos1922: folds 
soyolo: folds 
ChiChioChi: folds 
Uncalled bet ($4) returned to Jimy Tiltman
Jimy Tiltman collected $4.50 from pot
Jimy Tiltman: doesn't show hand 
*** SUMMARY ***
Total pot $4.50 | Rake $0 
Seat 1: Jimy Tiltman (button) collected ($4.50)
Seat 2: MRR100 (small blind) folded before Flop
Seat 3: pablos1922 (big blind) folded before Flop
Seat 4: PacPacBum folded before Flop (didn't bet)
Seat 5: chaps1988 folded before Flop (didn't bet)
Seat 6: Effort92 folded before Flop (didn't bet)
Seat 7: matiko09 folded before Flop (didn't bet)
Seat 8: soyolo folded before Flop
Seat 9: ChiChioChi folded before Flop





PokerStars Hand #150802535542:  Hold'em No Limit ($0.50/$1.00 USD) - 2016/03/23 15:04:13 CET [2016/03/23 10:04:13 ET]
Table 'Asmodeus' 9-max Seat #2 is the button
Seat 1: Jimy Tiltman ($119.34 in chips) 
Seat 2: PacPacBum ($108.13 in chips) 
Seat 3: nickreason17 ($101.50 in chips) 
Seat 4: Effort92 ($101.70 in chips) 
Seat 7: mycka86 ($112.89 in chips) 
Seat 8: bonifacioppl ($97.30 in chips) 
Seat 9: matiko09 ($105.10 in chips) 
nickreason17: posts small blind $0.50
Effort92: posts big blind $1
Muinmyheart: sits out 
fuppeee: sits out 
Jimy Tiltman: posts the ante $0.20
PacPacBum: posts the ante $0.20
nickreason17: posts the ante $0.20
Effort92: posts the ante $0.20
mycka86: posts the ante $0.20
bonifacioppl: posts the ante $0.20
matiko09: posts the ante $0.20
*** HOLE CARDS ***
Dealt to matiko09 [4c Tc]
mycka86: folds 
bonifacioppl: folds 
matiko09: folds 
Jimy Tiltman: raises $1 to $2
PacPacBum: folds 
nickreason17: folds 
Effort92: calls $1
*** FLOP *** [Qs Qc 8h]
Effort92: checks 
Jimy Tiltman: bets $2.81
Effort92: calls $2.81
*** TURN *** [Qs Qc 8h] [8d]
Effort92: checks 
Jimy Tiltman: checks 
*** RIVER *** [Qs Qc 8h 8d] [5s]
Effort92: checks 
Jimy Tiltman: bets $4
Effort92 said, ")))))"
Effort92: calls $4
*** SHOW DOWN ***
Jimy Tiltman: shows [Kc 8c] (a full house, Eights full of Queens)
Effort92: mucks hand 
Jimy Tiltman collected $18.64 from pot
*** SUMMARY ***
Total pot $19.52 | Rake $0.88 
Board [Qs Qc 8h 8d 5s]
Seat 1: Jimy Tiltman showed [Kc 8c] and won ($18.64) with a full house, Eights full of Queens
Seat 2: PacPacBum (button) folded before Flop (didn't bet)
Seat 3: nickreason17 (small blind) folded before Flop
Seat 4: Effort92 (big blind) mucked [Ad 2h]
Seat 7: mycka86 folded before Flop (didn't bet)
Seat 8: bonifacioppl folded before Flop (didn't bet)
Seat 9: matiko09 folded before Flop (didn't bet)





PokerStars Hand #150802536568:  Hold'em No Limit ($1/$2 USD) - 2016/03/23 15:04:16 CET [2016/03/23 10:04:16 ET]
Table 'Clarissa II' 9-max Seat #5 is the button
Seat 1: DUkalisUA ($702.47 in chips) 
Seat 2: Igoriah ($205.24 in chips) 
Seat 3: PtizaXXX ($182.60 in chips) 
Seat 4: sanrs57 ($195 in chips) 
Seat 5: Red4erT ($83 in chips) 
Seat 6: matiko09 ($200 in chips) 
Seat 7: PacPacBum ($200 in chips) 
Seat 8: chaps1988 ($211.32 in chips) 
matiko09: posts small blind $1
PacPacBum: posts big blind $2
RamiroAgujis: sits out 
*** HOLE CARDS ***
Dealt to matiko09 [4c 5h]
chaps1988: folds 
DUkalisUA: folds 
Igoriah: folds 
PtizaXXX: folds 
sanrs57: folds 
Red4erT: raises $3 to $5
matiko09: folds 
PacPacBum: folds 
Uncalled bet ($3) returned to Red4erT
Red4erT collected $5 from pot
Red4erT: doesn't show hand 
*** SUMMARY ***
Total pot $5 | Rake $0 
Seat 1: DUkalisUA folded before Flop (didn't bet)
Seat 2: Igoriah folded before Flop (didn't bet)
Seat 3: PtizaXXX folded before Flop (didn't bet)
Seat 4: sanrs57 folded before Flop (didn't bet)
Seat 5: Red4erT (button) collected ($5)
Seat 6: matiko09 (small blind) folded before Flop
Seat 7: PacPacBum (big blind) folded before Flop
Seat 8: chaps1988 folded before Flop (didn't bet)





PokerStars Hand #150802537161:  Hold'em No Limit (€0.50/€1.00 EUR) - 2016/03/23 15:04:17 CET [2016/03/23 10:04:17 ET]
Table 'Mercury III' 9-max Seat #6 is the button
Seat 1: matiko09 (€115.08 in chips) 
Seat 2: o.miro (€124.17 in chips) 
Seat 3: PacPacBum (€102.33 in chips) 
Seat 4: Muinmyheart (€100 in chips) 
Seat 5: DUkalisUA (€100 in chips) 
Seat 6: mycka86 (€100 in chips) 
Seat 7: STrakDD (€100 in chips) 
Seat 8: gfxed (€24.22 in chips) 
Seat 9: Indr3k (€100 in chips) 
STrakDD: posts small blind €0.50
gfxed: posts big blind €1
*** HOLE CARDS ***
Dealt to matiko09 [5s 7c]
Indr3k: raises €2 to €3
matiko09: folds 
o.miro: folds 
PacPacBum: folds 
Muinmyheart: folds 
DUkalisUA: folds 
mycka86: folds 
STrakDD: folds 
gfxed: raises €5.50 to €8.50
Indr3k: folds 
Uncalled bet (€5.50) returned to gfxed
gfxed collected €6.50 from pot
*** SUMMARY ***
Total pot €6.50 | Rake €0 
Seat 1: matiko09 folded before Flop (didn't bet)
Seat 2: o.miro folded before Flop (didn't bet)
Seat 3: PacPacBum folded before Flop (didn't bet)
Seat 4: Muinmyheart folded before Flop (didn't bet)
Seat 5: DUkalisUA folded before Flop (didn't bet)
Seat 6: mycka86 (button) folded before Flop (didn't bet)
Seat 7: STrakDD (small blind) folded before Flop
Seat 8: gfxed (big blind) collected (€6.50)
Seat 9: Indr3k folded before Flop





PokerStars Hand #150802537571:  Hold'em No Limit ($0.25/$0.50 USD) - 2016/03/23 15:04:18 CET [2016/03/23 10:04:18 ET]
Table 'Pyrrhus' 9-max Seat #8 is the button
Seat 1: lumen21 ($85.08 in chips) 
Seat 2: BSTUSim ($62.37 in chips) 
Seat 4: GriffinBerg ($47.28 in chips) 
Seat 6: Ahangama ($52.75 in chips) 
Seat 7: matiko09 ($136 in chips) 
Seat 8: suitedaces02 ($50 in chips) 
Seat 9: CvMCvMCvM ($89.30 in chips) 
CvMCvMCvM: posts small blind $0.25
lumen21: posts big blind $0.50
Muinmyheart: sits out 
xxxibgdrgn: sits out 
*** HOLE CARDS ***
Dealt to matiko09 [Ks 9c]
BSTUSim: folds 
GriffinBerg: calls $0.50
Ahangama: folds 
matiko09: folds 
suitedaces02: folds 
CvMCvMCvM: folds 
lumen21: checks 
*** FLOP *** [5d 8s 8d]
lumen21: checks 
GriffinBerg: checks 
*** TURN *** [5d 8s 8d] [4c]
lumen21: checks 
GriffinBerg: checks 
*** RIVER *** [5d 8s 8d 4c] [9s]
lumen21: checks 
GriffinBerg: bets $0.70
lumen21: folds 
Uncalled bet ($0.70) returned to GriffinBerg
GriffinBerg collected $1.19 from pot
GriffinBerg: doesn't show hand 
*** SUMMARY ***
Total pot $1.25 | Rake $0.06 
Board [5d 8s 8d 4c 9s]
Seat 1: lumen21 (big blind) folded on the River
Seat 2: BSTUSim folded before Flop (didn't bet)
Seat 4: GriffinBerg collected ($1.19)
Seat 6: Ahangama folded before Flop (didn't bet)
Seat 7: matiko09 folded before Flop (didn't bet)
Seat 8: suitedaces02 (button) folded before Flop (didn't bet)
Seat 9: CvMCvMCvM (small blind) folded before Flop





PokerStars Hand #150802544597:  Hold'em No Limit ($1/$2 USD) - 2016/03/23 15:04:37 CET [2016/03/23 10:04:37 ET]
Table 'Achaia' 9-max Seat #1 is the button
Seat 1: RamiroAgujis ($233.57 in chips) 
Seat 2: bananajoe001 ($211.35 in chips) 
Seat 3: matiko09 ($234.16 in chips) 
Seat 4: erfk1958 ($90 in chips) 
Seat 5: chaps1988 ($200 in chips) 
Seat 6: nickreason17 ($251.17 in chips) 
Seat 7: morosun ($238.42 in chips) 
Seat 8: IseeUcards ($200.10 in chips) 
Seat 9: PacPacBum ($204.35 in chips) 
bananajoe001: posts small blind $1
matiko09: posts big blind $2
*** HOLE CARDS ***
Dealt to matiko09 [Jc 8c]
erfk1958: folds 
morosun said, "wow"
chaps1988: folds 
nickreason17: raises $4 to $6
morosun: folds 
IseeUcards: folds 
PacPacBum: folds 
RamiroAgujis: folds 
bananajoe001: folds 
matiko09: folds 
Uncalled bet ($4) returned to nickreason17
nickreason17 collected $5 from pot
*** SUMMARY ***
Total pot $5 | Rake $0 
Seat 1: RamiroAgujis (button) folded before Flop (didn't bet)
Seat 2: bananajoe001 (small blind) folded before Flop
Seat 3: matiko09 (big blind) folded before Flop
Seat 4: erfk1958 folded before Flop (didn't bet)
Seat 5: chaps1988 folded before Flop (didn't bet)
Seat 6: nickreason17 collected ($5)
Seat 7: morosun folded before Flop (didn't bet)
Seat 8: IseeUcards folded before Flop (didn't bet)
Seat 9: PacPacBum folded before Flop (didn't bet)





PokerStars Hand #150802544950:  Hold'em No Limit ($0.50/$1.00 USD) - 2016/03/23 15:04:38 CET [2016/03/23 10:04:38 ET]
Table 'Swings' 9-max Seat #4 is the button
Seat 1: carrsseis ($100 in chips) 
Seat 3: maxxmeister ($129.50 in chips) 
Seat 4: chaps1988 ($102.73 in chips) 
Seat 5: chautinhtri9 ($114.45 in chips) 
Seat 6: matiko09 ($135.27 in chips) 
Seat 7: PacPacBum ($107.45 in chips) 
Seat 8: RICKA16 ($100.46 in chips) 
Seat 9: Vlad_1965_77 ($126.61 in chips) 
chautinhtri9: posts small blind $0.50
matiko09: posts big blind $1
*** HOLE CARDS ***
Dealt to matiko09 [Js Qs]
PacPacBum: folds 
RICKA16: folds 
Vlad_1965_77: folds 
carrsseis: folds 
maxxmeister: folds 
chaps1988: raises $1 to $2
chautinhtri9: calls $1.50
matiko09: calls $1
*** FLOP *** [Th Kc Td]
chautinhtri9: checks 
matiko09: checks 
chaps1988: bets $3.50
chautinhtri9: folds 
matiko09: calls $3.50
*** TURN *** [Th Kc Td] [Qd]
matiko09: checks 
chaps1988: checks 
*** RIVER *** [Th Kc Td Qd] [2d]
matiko09: checks 
chaps1988: checks 
*** SHOW DOWN ***
matiko09: shows [Js Qs] (two pair, Queens and Tens)
chaps1988: mucks hand 
matiko09 collected $12.42 from pot
*** SUMMARY ***
Total pot $13 | Rake $0.58 
Board [Th Kc Td Qd 2d]
Seat 1: carrsseis folded before Flop (didn't bet)
Seat 3: maxxmeister folded before Flop (didn't bet)
Seat 4: chaps1988 (button) mucked [6d Ac]
Seat 5: chautinhtri9 (small blind) folded on the Flop
Seat 6: matiko09 (big blind) showed [Js Qs] and won ($12.42) with two pair, Queens and Tens
Seat 7: PacPacBum folded before Flop (didn't bet)
Seat 8: RICKA16 folded before Flop (didn't bet)
Seat 9: Vlad_1965_77 folded before Flop (didn't bet)





PokerStars Hand #150802544811:  Hold'em No Limit ($1/$2 USD) - 2016/03/23 15:04:38 CET [2016/03/23 10:04:38 ET]
Table 'Herba II' 9-max Seat #9 is the button
Seat 1: matiko09 ($288.38 in chips) 
Seat 2: nickreason17 ($200 in chips) 
Seat 3: Cirilico ($160 in chips) 
Seat 4: DUkalisUA ($389.40 in chips) 
Seat 5: chippo boy ($266.73 in chips) 
Seat 6: Too-Anti-To ($227.11 in chips) 
Seat 8: T0ny Adams ($74 in chips) 
Seat 9: mrhighryza ($55.27 in chips) 
matiko09: posts small blind $1
nickreason17: posts big blind $2
Igoriah: sits out 
*** HOLE CARDS ***
Dealt to matiko09 [Kh 3h]
Cirilico: folds 
DUkalisUA: raises $4 to $6
chippo boy: folds 
Too-Anti-To: folds 
T0ny Adams: folds 
mrhighryza: calls $6
matiko09: folds 
nickreason17: calls $4
*** FLOP *** [Qs 6c 8s]
nickreason17: checks 
DUkalisUA: checks 
mrhighryza: bets $8
nickreason17: folds 
DUkalisUA: folds 
Uncalled bet ($8) returned to mrhighryza
mrhighryza collected $18.14 from pot
*** SUMMARY ***
Total pot $19 | Rake $0.86 
Board [Qs 6c 8s]
Seat 1: matiko09 (small blind) folded before Flop
Seat 2: nickreason17 (big blind) folded on the Flop
Seat 3: Cirilico folded before Flop (didn't bet)
Seat 4: DUkalisUA folded on the Flop
Seat 5: chippo boy folded before Flop (didn't bet)
Seat 6: Too-Anti-To folded before Flop (didn't bet)
Seat 8: T0ny Adams folded before Flop (didn't bet)
Seat 9: mrhighryza (button) collected ($18.14)





PokerStars Hand #150802546270:  Hold'em No Limit ($0.50/$1.00 USD) - 2016/03/23 15:04:41 CET [2016/03/23 10:04:41 ET]
Table 'Sylvia III' 9-max Seat #7 is the button
Seat 1: mycka86 ($103.50 in chips) 
Seat 3: se7en_$tars ($64.75 in chips) 
Seat 4: lombardo11 ($83.02 in chips) 
Seat 5: matiko09 ($104.29 in chips) 
Seat 6: PacPacBum ($100 in chips) 
Seat 7: easytalk777 ($97.53 in chips) 
Seat 8: nickreason17 ($115.99 in chips) 
Seat 9: Blanky-Bad ($96.47 in chips) 
nickreason17: posts small blind $0.50
Blanky-Bad: posts big blind $1
Dantist1122: sits out 
mycka86: posts the ante $0.20
se7en_$tars: posts the ante $0.20
lombardo11: posts the ante $0.20
matiko09: posts the ante $0.20
PacPacBum: posts the ante $0.20
easytalk777: posts the ante $0.20
nickreason17: posts the ante $0.20
Blanky-Bad: posts the ante $0.20
*** HOLE CARDS ***
Dealt to matiko09 [8d Ad]
mycka86: folds 
se7en_$tars: raises $4.10 to $5.10
lombardo11: folds 
matiko09: folds 
PacPacBum: calls $5.10
easytalk777: folds 
nickreason17: folds 
Blanky-Bad: folds 
*** FLOP *** [Tc 5h 8s]
se7en_$tars: bets $6
PacPacBum: calls $6
*** TURN *** [Tc 5h 8s] [Ac]
se7en_$tars: bets $12
PacPacBum: calls $12
*** RIVER *** [Tc 5h 8s Ac] [Ah]
se7en_$tars: bets $41.45 and is all-in
PacPacBum: folds 
Uncalled bet ($41.45) returned to se7en_$tars
se7en_$tars collected $47.08 from pot
*** SUMMARY ***
Total pot $49.30 | Rake $2.22 
Board [Tc 5h 8s Ac Ah]
Seat 1: mycka86 folded before Flop (didn't bet)
Seat 3: se7en_$tars collected ($47.08)
Seat 4: lombardo11 folded before Flop (didn't bet)
Seat 5: matiko09 folded before Flop (didn't bet)
Seat 6: PacPacBum folded on the River
Seat 7: easytalk777 (button) folded before Flop (didn't bet)
Seat 8: nickreason17 (small blind) folded before Flop
Seat 9: Blanky-Bad (big blind) folded before Flop





PokerStars Hand #150802547661:  Hold'em No Limit ($0.50/$1.00 USD) - 2016/03/23 15:04:45 CET [2016/03/23 10:04:45 ET]
Table 'Drakonia II' 9-max Seat #4 is the button
Seat 1: chautinhtri9 ($134.60 in chips) 
Seat 2: carrsseis ($100 in chips) 
Seat 3: dunga119 ($86.73 in chips) 
Seat 4: nickreason17 ($100 in chips) 
Seat 5: gchs83 ($58.11 in chips) 
Seat 6: Dantist1122 ($100 in chips) 
Seat 7: YuriiSolodya ($29.40 in chips) 
Seat 8: matiko09 ($100 in chips) 
Seat 9: mycka86 ($100 in chips) 
gchs83: posts small blind $0.50
Dantist1122: posts big blind $1
*** HOLE CARDS ***
Dealt to matiko09 [4c 8s]
YuriiSolodya: folds 
matiko09: folds 
mycka86: folds 
chautinhtri9: folds 
carrsseis: folds 
dunga119: raises $2 to $3
nickreason17: folds 
gchs83: folds 
Dantist1122: folds 
Uncalled bet ($2) returned to dunga119
dunga119 collected $2.50 from pot
dunga119: doesn't show hand 
*** SUMMARY ***
Total pot $2.50 | Rake $0 
Seat 1: chautinhtri9 folded before Flop (didn't bet)
Seat 2: carrsseis folded before Flop (didn't bet)
Seat 3: dunga119 collected ($2.50)
Seat 4: nickreason17 (button) folded before Flop (didn't bet)
Seat 5: gchs83 (small blind) folded before Flop
Seat 6: Dantist1122 (big blind) folded before Flop
Seat 7: YuriiSolodya folded before Flop (didn't bet)
Seat 8: matiko09 folded before Flop (didn't bet)
Seat 9: mycka86 folded before Flop (didn't bet)





PokerStars Hand #150802548118:  Hold'em No Limit ($1/$2 USD) - 2016/03/23 15:04:46 CET [2016/03/23 10:04:46 ET]
Table 'Kiess' 9-max Seat #5 is the button
Seat 1: Cirilico ($219.46 in chips) 
Seat 2: DUkalisUA ($702.28 in chips) 
Seat 3: Red4erT ($99.82 in chips) 
Seat 4: Igoriah ($200 in chips) 
Seat 5: chippo boy ($407.64 in chips) 
Seat 6: matiko09 ($250.86 in chips) 
Seat 7: chaps1988 ($200 in chips) 
Seat 8: erfk1958 ($144.21 in chips) 
Seat 9: volwebni4ek ($80 in chips) 
matiko09: posts small blind $1
chaps1988: posts big blind $2
*** HOLE CARDS ***
Dealt to matiko09 [2s 9h]
erfk1958: folds 
volwebni4ek: raises $4 to $6
Cirilico: folds 
DUkalisUA: folds 
Red4erT: folds 
Igoriah: folds 
chippo boy: folds 
matiko09: folds 
chaps1988: folds 
Uncalled bet ($4) returned to volwebni4ek
volwebni4ek collected $5 from pot
volwebni4ek: doesn't show hand 
*** SUMMARY ***
Total pot $5 | Rake $0 
Seat 1: Cirilico folded before Flop (didn't bet)
Seat 2: DUkalisUA folded before Flop (didn't bet)
Seat 3: Red4erT folded before Flop (didn't bet)
Seat 4: Igoriah folded before Flop (didn't bet)
Seat 5: chippo boy (button) folded before Flop (didn't bet)
Seat 6: matiko09 (small blind) folded before Flop
Seat 7: chaps1988 (big blind) folded before Flop
Seat 8: erfk1958 folded before Flop (didn't bet)
Seat 9: volwebni4ek collected ($5)





PokerStars Hand #150802550637:  Hold'em No Limit ($0.50/$1.00 USD) - 2016/03/23 15:04:53 CET [2016/03/23 10:04:53 ET]
Table 'Merope II' 9-max Seat #2 is the button
Seat 1: Jimy Tiltman ($128.79 in chips) 
Seat 2: MRR100 ($100 in chips) 
Seat 3: pablos1922 ($82.98 in chips) 
Seat 4: PacPacBum ($105.83 in chips) 
Seat 5: chaps1988 ($105.16 in chips) 
Seat 6: Effort92 ($138.91 in chips) 
Seat 7: matiko09 ($103.03 in chips) 
Seat 8: soyolo ($89.51 in chips) 
Seat 9: ChiChioChi ($79 in chips) 
pablos1922: posts small blind $0.50
PacPacBum: posts big blind $1
*** HOLE CARDS ***
Dealt to matiko09 [6d 7s]
chaps1988: folds 
Effort92: folds 
matiko09: folds 
soyolo: folds 
ChiChioChi: folds 
Jimy Tiltman: folds 
MRR100: folds 
pablos1922: folds 
Uncalled bet ($0.50) returned to PacPacBum
PacPacBum collected $1 from pot
PacPacBum: doesn't show hand 
*** SUMMARY ***
Total pot $1 | Rake $0 
Seat 1: Jimy Tiltman folded before Flop (didn't bet)
Seat 2: MRR100 (button) folded before Flop (didn't bet)
Seat 3: pablos1922 (small blind) folded before Flop
Seat 4: PacPacBum (big blind) collected ($1)
Seat 5: chaps1988 folded before Flop (didn't bet)
Seat 6: Effort92 folded before Flop (didn't bet)
Seat 7: matiko09 folded before Flop (didn't bet)
Seat 8: soyolo folded before Flop (didn't bet)
Seat 9: ChiChioChi folded before Flop (didn't bet)





PokerStars Hand #150802551404:  Hold'em No Limit ($0.50/$1.00 USD) - 2016/03/23 15:04:55 CET [2016/03/23 10:04:55 ET]
Table 'Smiley' 9-max Seat #4 is the button
Seat 1: xHourglass ($100 in chips) 
Seat 2: Jimy Tiltman ($126.01 in chips) 
Seat 3: Robert201202 ($100.06 in chips) 
Seat 4: CAJUN890 ($74.99 in chips) 
Seat 5: Szevasztopol ($100 in chips) 
Seat 6: blackmont111 ($161.54 in chips) 
Seat 7: nickreason17 ($100 in chips) 
Seat 8: matiko09 ($100 in chips) 
Seat 9: Pvsx. ($234.87 in chips) 
Szevasztopol: posts small blind $0.50
blackmont111: posts big blind $1
*** HOLE CARDS ***
Dealt to matiko09 [9c 3h]
nickreason17: raises $2 to $3
matiko09: folds 
Pvsx.: folds 
xHourglass: folds 
Jimy Tiltman: folds 
Robert201202: calls $3
CAJUN890: folds 
Szevasztopol: folds 
blackmont111: folds 
*** FLOP *** [Tc Ks 7d]
nickreason17: checks 
Robert201202: checks 
*** TURN *** [Tc Ks 7d] [3s]
nickreason17: checks 
Robert201202: bets $5
nickreason17: calls $5
*** RIVER *** [Tc Ks 7d 3s] [Jc]
nickreason17: checks 
Robert201202: checks 
*** SHOW DOWN ***
nickreason17: shows [8s 8d] (a pair of Eights)
Robert201202: mucks hand 
nickreason17 collected $16.71 from pot
*** SUMMARY ***
Total pot $17.50 | Rake $0.79 
Board [Tc Ks 7d 3s Jc]
Seat 1: xHourglass folded before Flop (didn't bet)
Seat 2: Jimy Tiltman folded before Flop (didn't bet)
Seat 3: Robert201202 mucked [Qc 8c]
Seat 4: CAJUN890 (button) folded before Flop (didn't bet)
Seat 5: Szevasztopol (small blind) folded before Flop
Seat 6: blackmont111 (big blind) folded before Flop
Seat 7: nickreason17 showed [8s 8d] and won ($16.71) with a pair of Eights
Seat 8: matiko09 folded before Flop (didn't bet)
Seat 9: Pvsx. folded before Flop (didn't bet)





PokerStars Hand #150802555234:  Hold'em No Limit ($0.50/$1.00 USD) - 2016/03/23 15:05:05 CET [2016/03/23 10:05:05 ET]
Table 'Merope II' 9-max Seat #3 is the button
Seat 1: Jimy Tiltman ($128.79 in chips) 
Seat 2: MRR100 ($100 in chips) 
Seat 3: pablos1922 ($82.48 in chips) 
Seat 4: PacPacBum ($106.33 in chips) 
Seat 5: chaps1988 ($105.16 in chips) 
Seat 6: Effort92 ($138.91 in chips) 
Seat 7: matiko09 ($103.03 in chips) 
Seat 8: soyolo ($89.51 in chips) 
Seat 9: ChiChioChi ($79 in chips) 
PacPacBum: posts small blind $0.50
chaps1988: posts big blind $1
*** HOLE CARDS ***
Dealt to matiko09 [Kh 3c]
Effort92: folds 
matiko09: folds 
soyolo: folds 
ChiChioChi: folds 
Jimy Tiltman: folds 
MRR100: folds 
pablos1922: raises $1 to $2
PacPacBum: folds 
chaps1988: folds 
Uncalled bet ($1) returned to pablos1922
pablos1922 collected $2.50 from pot
pablos1922: doesn't show hand 
*** SUMMARY ***
Total pot $2.50 | Rake $0 
Seat 1: Jimy Tiltman folded before Flop (didn't bet)
Seat 2: MRR100 folded before Flop (didn't bet)
Seat 3: pablos1922 (button) collected ($2.50)
Seat 4: PacPacBum (small blind) folded before Flop
Seat 5: chaps1988 (big blind) folded before Flop
Seat 6: Effort92 folded before Flop (didn't bet)
Seat 7: matiko09 folded before Flop (didn't bet)
Seat 8: soyolo folded before Flop (didn't bet)
Seat 9: ChiChioChi folded before Flop (didn't bet)





PokerStars Hand #150802555885:  Hold'em No Limit ($1/$2 USD) - 2016/03/23 15:05:06 CET [2016/03/23 10:05:06 ET]
Table 'Kiess' 9-max Seat #6 is the button
Seat 1: Cirilico ($219.46 in chips) 
Seat 2: DUkalisUA ($702.28 in chips) 
Seat 3: Red4erT ($99.82 in chips) 
Seat 4: Igoriah ($200 in chips) 
Seat 6: matiko09 ($249.86 in chips) 
Seat 7: chaps1988 ($200 in chips) 
Seat 8: erfk1958 ($144.21 in chips) 
Seat 9: volwebni4ek ($83 in chips) 
chaps1988: posts small blind $1
erfk1958: posts big blind $2
*** HOLE CARDS ***
Dealt to matiko09 [8h Js]
volwebni4ek: folds 
Cirilico: folds 
DUkalisUA: folds 
Red4erT: raises $3 to $5
Igoriah: folds 
matiko09: folds 
chaps1988: folds 
erfk1958: folds 
Uncalled bet ($3) returned to Red4erT
Red4erT collected $5 from pot
Red4erT: doesn't show hand 
*** SUMMARY ***
Total pot $5 | Rake $0 
Seat 1: Cirilico folded before Flop (didn't bet)
Seat 2: DUkalisUA folded before Flop (didn't bet)
Seat 3: Red4erT collected ($5)
Seat 4: Igoriah folded before Flop (didn't bet)
Seat 6: matiko09 (button) folded before Flop (didn't bet)
Seat 7: chaps1988 (small blind) folded before Flop
Seat 8: erfk1958 (big blind) folded before Flop
Seat 9: volwebni4ek folded before Flop (didn't bet)





PokerStars Hand #150802556430:  Hold'em No Limit ($1/$2 USD) - 2016/03/23 15:05:08 CET [2016/03/23 10:05:08 ET]
Table 'Clarissa II' 9-max Seat #6 is the button
Seat 1: DUkalisUA ($702.47 in chips) 
Seat 2: Igoriah ($205.24 in chips) 
Seat 3: PtizaXXX ($182.60 in chips) 
Seat 4: sanrs57 ($195 in chips) 
Seat 5: Red4erT ($86 in chips) 
Seat 6: matiko09 ($200 in chips) 
Seat 7: PacPacBum ($200 in chips) 
Seat 8: chaps1988 ($211.32 in chips) 
PacPacBum: posts small blind $1
chaps1988: posts big blind $2
RamiroAgujis: sits out 
*** HOLE CARDS ***
Dealt to matiko09 [6d 8c]
DUkalisUA: folds 
Igoriah: folds 
PtizaXXX: raises $4 to $6
sanrs57: folds 
Red4erT: folds 
matiko09: folds 
PacPacBum: folds 
chaps1988: folds 
Uncalled bet ($4) returned to PtizaXXX
PtizaXXX collected $5 from pot
PtizaXXX: doesn't show hand 
*** SUMMARY ***
Total pot $5 | Rake $0 
Seat 1: DUkalisUA folded before Flop (didn't bet)
Seat 2: Igoriah folded before Flop (didn't bet)
Seat 3: PtizaXXX collected ($5)
Seat 4: sanrs57 folded before Flop (didn't bet)
Seat 5: Red4erT folded before Flop (didn't bet)
Seat 6: matiko09 (button) folded before Flop (didn't bet)
Seat 7: PacPacBum (small blind) folded before Flop
Seat 8: chaps1988 (big blind) folded before Flop





PokerStars Hand #150802558605:  Hold'em No Limit ($1/$2 USD) - 2016/03/23 15:05:13 CET [2016/03/23 10:05:13 ET]
Table 'Achaia' 9-max Seat #2 is the button
Seat 1: RamiroAgujis ($233.57 in chips) 
Seat 2: bananajoe001 ($210.35 in chips) 
Seat 3: matiko09 ($232.16 in chips) 
Seat 4: erfk1958 ($90 in chips) 
Seat 5: chaps1988 ($200 in chips) 
Seat 6: nickreason17 ($254.17 in chips) 
Seat 7: morosun ($238.42 in chips) 
Seat 8: IseeUcards ($200.10 in chips) 
Seat 9: PacPacBum ($204.35 in chips) 
matiko09: posts small blind $1
erfk1958: posts big blind $2
*** HOLE CARDS ***
Dealt to matiko09 [3s 2s]
chaps1988: folds 
nickreason17: folds 
morosun: raises $2 to $4
IseeUcards: folds 
PacPacBum: folds 
RamiroAgujis: folds 
bananajoe001: calls $4
matiko09: folds 
erfk1958: folds 
*** FLOP *** [6c 4s 8s]
morosun: checks 
bananajoe001: checks 
*** TURN *** [6c 4s 8s] [7h]
morosun: checks 
bananajoe001: checks 
*** RIVER *** [6c 4s 8s 7h] [7s]
morosun: checks 
bananajoe001: checks 
*** SHOW DOWN ***
morosun: shows [Kh Js] (a pair of Sevens)
bananajoe001: mucks hand 
morosun collected $10.50 from pot
*** SUMMARY ***
Total pot $11 | Rake $0.50 
Board [6c 4s 8s 7h 7s]
Seat 1: RamiroAgujis folded before Flop (didn't bet)
Seat 2: bananajoe001 (button) mucked [Ts Jd]
Seat 3: matiko09 (small blind) folded before Flop
Seat 4: erfk1958 (big blind) folded before Flop
Seat 5: chaps1988 folded before Flop (didn't bet)
Seat 6: nickreason17 folded before Flop (didn't bet)
Seat 7: morosun showed [Kh Js] and won ($10.50) with a pair of Sevens
Seat 8: IseeUcards folded before Flop (didn't bet)
Seat 9: PacPacBum folded before Flop (didn't bet)





PokerStars Hand #150802559421:  Hold'em No Limit ($0.50/$1.00 USD) - 2016/03/23 15:05:16 CET [2016/03/23 10:05:16 ET]
Table 'Drakonia II' 9-max Seat #5 is the button
Seat 1: chautinhtri9 ($134.60 in chips) 
Seat 2: carrsseis ($100 in chips) 
Seat 3: dunga119 ($100 in chips) 
Seat 4: nickreason17 ($100 in chips) 
Seat 5: gchs83 ($57.61 in chips) 
Seat 6: Dantist1122 ($100 in chips) 
Seat 7: YuriiSolodya ($29.40 in chips) 
Seat 8: matiko09 ($100 in chips) 
Seat 9: mycka86 ($100 in chips) 
Dantist1122: posts small blind $0.50
YuriiSolodya: posts big blind $1
*** HOLE CARDS ***
Dealt to matiko09 [7h Kc]
matiko09: folds 
mycka86: folds 
chautinhtri9: folds 
carrsseis: folds 
dunga119: calls $1
nickreason17: raises $3 to $4
gchs83: folds 
Dantist1122: folds 
YuriiSolodya: folds 
dunga119: calls $3
*** FLOP *** [3d 5h Ts]
dunga119: checks 
nickreason17: bets $4.75
dunga119: raises $4.75 to $9.50
nickreason17: calls $4.75
*** TURN *** [3d 5h Ts] [Jc]
dunga119: checks 
nickreason17: bets $16
dunga119: folds 
Uncalled bet ($16) returned to nickreason17
nickreason17 collected $27.22 from pot
*** SUMMARY ***
Total pot $28.50 | Rake $1.28 
Board [3d 5h Ts Jc]
Seat 1: chautinhtri9 folded before Flop (didn't bet)
Seat 2: carrsseis folded before Flop (didn't bet)
Seat 3: dunga119 folded on the Turn
Seat 4: nickreason17 collected ($27.22)
Seat 5: gchs83 (button) folded before Flop (didn't bet)
Seat 6: Dantist1122 (small blind) folded before Flop
Seat 7: YuriiSolodya (big blind) folded before Flop
Seat 8: matiko09 folded before Flop (didn't bet)
Seat 9: mycka86 folded before Flop (didn't bet)





PokerStars Hand #150802559826:  Hold'em No Limit (€0.50/€1.00 EUR) - 2016/03/23 15:05:17 CET [2016/03/23 10:05:17 ET]
Table 'Mercury III' 9-max Seat #7 is the button
Seat 1: matiko09 (€115.08 in chips) 
Seat 2: o.miro (€124.17 in chips) 
Seat 3: PacPacBum (€102.33 in chips) 
Seat 4: Muinmyheart (€100 in chips) 
Seat 5: DUkalisUA (€100 in chips) 
Seat 6: mycka86 (€100 in chips) 
Seat 7: STrakDD (€100 in chips) 
Seat 8: gfxed (€27.72 in chips) 
Seat 9: Indr3k (€100 in chips) 
gfxed: posts small blind €0.50
Indr3k: posts big blind €1
*** HOLE CARDS ***
Dealt to matiko09 [8s Kh]
matiko09: folds 
o.miro: folds 
PacPacBum: folds 
Muinmyheart: folds 
DUkalisUA: folds 
mycka86: folds 
STrakDD: folds 
gfxed: calls €0.50
Indr3k: checks 
*** FLOP *** [9s Jh Qc]
gfxed: checks 
Indr3k: checks 
*** TURN *** [9s Jh Qc] [2s]
gfxed: bets €1.20
Indr3k: folds 
Uncalled bet (€1.20) returned to gfxed
gfxed collected €1.91 from pot
*** SUMMARY ***
Total pot €2 | Rake €0.09 
Board [9s Jh Qc 2s]
Seat 1: matiko09 folded before Flop (didn't bet)
Seat 2: o.miro folded before Flop (didn't bet)
Seat 3: PacPacBum folded before Flop (didn't bet)
Seat 4: Muinmyheart folded before Flop (didn't bet)
Seat 5: DUkalisUA folded before Flop (didn't bet)
Seat 6: mycka86 folded before Flop (didn't bet)
Seat 7: STrakDD (button) folded before Flop (didn't bet)
Seat 8: gfxed (small blind) collected (€1.91)
Seat 9: Indr3k (big blind) folded on the Turn





PokerStars Hand #150802560188:  Hold'em No Limit ($1/$2 USD) - 2016/03/23 15:05:18 CET [2016/03/23 10:05:18 ET]
Table 'Kypria II' 9-max Seat #5 is the button
Seat 1: geldwolfje ($189 in chips) 
Seat 2: coinflip_si ($292.83 in chips) 
Seat 3: seouljam ($279.92 in chips) 
Seat 4: VolanDog ($222.72 in chips) 
Seat 5: Igoriah ($200 in chips) 
Seat 6: matiko09 ($448.25 in chips) 
Seat 7: DUkalisUA ($200 in chips) 
Seat 8: nickreason17 ($206.37 in chips) 
Seat 9: sanrs57 ($185 in chips) 
matiko09: posts small blind $1
DUkalisUA: posts big blind $2
sanrs57: posts small & big blinds $3
*** HOLE CARDS ***
Dealt to matiko09 [4h Qc]
nickreason17: folds 
sanrs57: checks 
geldwolfje: folds 
coinflip_si: folds 
geldwolfje leaves the table
seouljam: raises $2.70 to $4.70
VolanDog: folds 
volwebni4ek joins the table at seat #1 
Igoriah: folds 
matiko09: folds 
volwebni4ek leaves the table
chaps1988 joins the table at seat #1 
DUkalisUA: folds 
coinflip_si leaves the table
sanrs57: calls $2.70
*** FLOP *** [4c Td 8d]
sanrs57: checks 
PacPacBum joins the table at seat #2 
seouljam: bets $6
sanrs57: raises $10 to $16
seouljam: calls $10
*** TURN *** [4c Td 8d] [7s]
sanrs57: checks 
seouljam: checks 
*** RIVER *** [4c Td 8d 7s] [3s]
sanrs57: checks 
seouljam: checks 
*** SHOW DOWN ***
sanrs57: shows [7c Ac] (a pair of Sevens)
seouljam: shows [Tc Qs] (a pair of Tens)
seouljam collected $43.36 from pot
*** SUMMARY ***
Total pot $45.40 | Rake $2.04 
Board [4c Td 8d 7s 3s]
Seat 1: geldwolfje folded before Flop (didn't bet)
Seat 2: coinflip_si folded before Flop (didn't bet)
Seat 3: seouljam showed [Tc Qs] and won ($43.36) with a pair of Tens
Seat 4: VolanDog folded before Flop (didn't bet)
Seat 5: Igoriah (button) folded before Flop (didn't bet)
Seat 6: matiko09 (small blind) folded before Flop
Seat 7: DUkalisUA (big blind) folded before Flop
Seat 8: nickreason17 folded before Flop (didn't bet)
Seat 9: sanrs57 showed [7c Ac] and lost with a pair of Sevens





PokerStars Hand #150802567626:  Hold'em No Limit ($1/$2 USD) - 2016/03/23 15:05:37 CET [2016/03/23 10:05:37 ET]
Table 'Kiess' 9-max Seat #7 is the button
Seat 1: Cirilico ($219.46 in chips) 
Seat 2: DUkalisUA ($702.28 in chips) 
Seat 3: Red4erT ($102.82 in chips) 
Seat 4: Igoriah ($200 in chips) 
Seat 6: matiko09 ($249.86 in chips) 
Seat 7: chaps1988 ($200 in chips) 
Seat 8: erfk1958 ($142.21 in chips) 
erfk1958: posts small blind $1
volwebni4ek: is sitting out 
Cirilico: posts big blind $2
*** HOLE CARDS ***
Dealt to matiko09 [3c 2s]
DUkalisUA: folds 
Red4erT: raises $4 to $6
Igoriah: folds 
matiko09: folds 
chaps1988: folds 
erfk1958: folds 
Cirilico: folds 
Uncalled bet ($4) returned to Red4erT
Red4erT collected $5 from pot
Red4erT: doesn't show hand 
*** SUMMARY ***
Total pot $5 | Rake $0 
Seat 1: Cirilico (big blind) folded before Flop
Seat 2: DUkalisUA folded before Flop (didn't bet)
Seat 3: Red4erT collected ($5)
Seat 4: Igoriah folded before Flop (didn't bet)
Seat 6: matiko09 folded before Flop (didn't bet)
Seat 7: chaps1988 (button) folded before Flop (didn't bet)
Seat 8: erfk1958 (small blind) folded before Flop





PokerStars Hand #150802567536:  Hold'em No Limit ($0.50/$1.00 USD) - 2016/03/23 15:05:37 CET [2016/03/23 10:05:37 ET]
Table 'Asmodeus' 9-max Seat #3 is the button
Seat 1: Jimy Tiltman ($128.97 in chips) 
Seat 2: PacPacBum ($107.93 in chips) 
Seat 3: nickreason17 ($100.80 in chips) 
Seat 4: Effort92 ($100 in chips) 
Seat 5: Muinmyheart ($100 in chips) 
Seat 7: mycka86 ($112.69 in chips) 
Seat 8: bonifacioppl ($97.10 in chips) 
Seat 9: matiko09 ($104.90 in chips) 
Effort92: posts small blind $0.50
Muinmyheart: posts big blind $1
fuppeee: sits out 
Jimy Tiltman: posts the ante $0.20
PacPacBum: posts the ante $0.20
nickreason17: posts the ante $0.20
Effort92: posts the ante $0.20
Muinmyheart: posts the ante $0.20
mycka86: posts the ante $0.20
bonifacioppl: posts the ante $0.20
matiko09: posts the ante $0.20
*** HOLE CARDS ***
Dealt to matiko09 [Jd Ah]
mycka86: folds 
bonifacioppl: folds 
matiko09: raises $2 to $3
Effort92 said, "wp"
Jimy Tiltman: folds 
PacPacBum: folds 
nickreason17: folds 
Effort92: folds 
Jimy Tiltman said, "WP"
Jimy Tiltman said, "nice flop call"
Jimy Tiltman said, ":D"
Muinmyheart: folds 
Uncalled bet ($2) returned to matiko09
matiko09 collected $4.10 from pot
matiko09: doesn't show hand 
*** SUMMARY ***
Total pot $4.10 | Rake $0 
Seat 1: Jimy Tiltman folded before Flop (didn't bet)
Seat 2: PacPacBum folded before Flop (didn't bet)
Seat 3: nickreason17 (button) folded before Flop (didn't bet)
Seat 4: Effort92 (small blind) folded before Flop
Seat 5: Muinmyheart (big blind) folded before Flop
Seat 7: mycka86 folded before Flop (didn't bet)
Seat 8: bonifacioppl folded before Flop (didn't bet)
Seat 9: matiko09 collected ($4.10)





PokerStars Hand #150802568042:  Hold'em No Limit ($1/$2 USD) - 2016/03/23 15:05:38 CET [2016/03/23 10:05:38 ET]
Table 'Herba II' 9-max Seat #1 is the button
Seat 1: matiko09 ($287.38 in chips) 
Seat 2: nickreason17 ($200 in chips) 
Seat 3: Cirilico ($160 in chips) 
Seat 4: DUkalisUA ($383.40 in chips) 
Seat 6: Too-Anti-To ($227.11 in chips) 
Seat 8: T0ny Adams ($74 in chips) 
Seat 9: mrhighryza ($67.41 in chips) 
nickreason17: posts small blind $1
Cirilico: posts big blind $2
Igoriah: sits out 
*** HOLE CARDS ***
Dealt to matiko09 [6c 7s]
DUkalisUA: folds 
Too-Anti-To: folds 
T0ny Adams: folds 
mrhighryza: folds 
matiko09: folds 
nickreason17: raises $3 to $5
Cirilico: calls $3
*** FLOP *** [2h Ks 4c]
nickreason17: bets $5.73
Cirilico: calls $5.73
*** TURN *** [2h Ks 4c] [2c]
nickreason17: checks 
Cirilico: checks 
*** RIVER *** [2h Ks 4c 2c] [Qs]
nickreason17: bets $10.24
Cirilico: folds 
Uncalled bet ($10.24) returned to nickreason17
nickreason17 collected $20.49 from pot
*** SUMMARY ***
Total pot $21.46 | Rake $0.97 
Board [2h Ks 4c 2c Qs]
Seat 1: matiko09 (button) folded before Flop (didn't bet)
Seat 2: nickreason17 (small blind) collected ($20.49)
Seat 3: Cirilico (big blind) folded on the River
Seat 4: DUkalisUA folded before Flop (didn't bet)
Seat 6: Too-Anti-To folded before Flop (didn't bet)
Seat 8: T0ny Adams folded before Flop (didn't bet)
Seat 9: mrhighryza folded before Flop (didn't bet)





PokerStars Hand #150802570754:  Hold'em No Limit ($0.50/$1.00 USD) - 2016/03/23 15:05:45 CET [2016/03/23 10:05:45 ET]
Table 'Swings' 9-max Seat #5 is the button
Seat 1: carrsseis ($100 in chips) 
Seat 3: maxxmeister ($129.50 in chips) 
Seat 4: chaps1988 ($100 in chips) 
Seat 5: chautinhtri9 ($112.45 in chips) 
Seat 6: matiko09 ($142.19 in chips) 
Seat 7: PacPacBum ($107.45 in chips) 
Seat 8: RICKA16 ($100.46 in chips) 
Seat 9: Vlad_1965_77 ($126.61 in chips) 
matiko09: posts small blind $0.50
PacPacBum: posts big blind $1
*** HOLE CARDS ***
Dealt to matiko09 [4d Jd]
RICKA16: folds 
Vlad_1965_77: folds 
carrsseis: folds 
maxxmeister: folds 
chaps1988: folds 
chautinhtri9: folds 
matiko09: folds 
Uncalled bet ($0.50) returned to PacPacBum
PacPacBum collected $1 from pot
PacPacBum: doesn't show hand 
*** SUMMARY ***
Total pot $1 | Rake $0 
Seat 1: carrsseis folded before Flop (didn't bet)
Seat 3: maxxmeister folded before Flop (didn't bet)
Seat 4: chaps1988 folded before Flop (didn't bet)
Seat 5: chautinhtri9 (button) folded before Flop (didn't bet)
Seat 6: matiko09 (small blind) folded before Flop
Seat 7: PacPacBum (big blind) collected ($1)
Seat 8: RICKA16 folded before Flop (didn't bet)
Seat 9: Vlad_1965_77 folded before Flop (didn't bet)





PokerStars Hand #150802571516:  Hold'em No Limit ($0.50/$1.00 USD) - 2016/03/23 15:05:47 CET [2016/03/23 10:05:47 ET]
Table 'Smiley' 9-max Seat #5 is the button
Seat 1: xHourglass ($100 in chips) 
Seat 2: Jimy Tiltman ($126.01 in chips) 
Seat 3: Robert201202 ($92.06 in chips) 
Seat 4: CAJUN890 ($74.99 in chips) 
Seat 5: Szevasztopol ($100 in chips) 
Seat 6: blackmont111 ($160.54 in chips) 
Seat 7: nickreason17 ($108.71 in chips) 
Seat 8: matiko09 ($100 in chips) 
Seat 9: Pvsx. ($234.87 in chips) 
blackmont111: posts small blind $0.50
nickreason17: posts big blind $1
*** HOLE CARDS ***
Dealt to matiko09 [As 6c]
matiko09: folds 
Pvsx.: folds 
xHourglass: folds 
Jimy Tiltman has timed out
Jimy Tiltman: folds 
Robert201202: raises $2 to $3
CAJUN890: calls $3
Szevasztopol: folds 
blackmont111: calls $2.50
nickreason17: calls $2
*** FLOP *** [2d 2h 8h]
blackmont111: checks 
nickreason17: checks 
Robert201202: bets $5
CAJUN890: folds 
blackmont111: calls $5
nickreason17: folds 
*** TURN *** [2d 2h 8h] [6h]
blackmont111: checks 
Robert201202: bets $11
blackmont111: folds 
Uncalled bet ($11) returned to Robert201202
Robert201202 collected $21.01 from pot
*** SUMMARY ***
Total pot $22 | Rake $0.99 
Board [2d 2h 8h 6h]
Seat 1: xHourglass folded before Flop (didn't bet)
Seat 2: Jimy Tiltman folded before Flop (didn't bet)
Seat 3: Robert201202 collected ($21.01)
Seat 4: CAJUN890 folded on the Flop
Seat 5: Szevasztopol (button) folded before Flop (didn't bet)
Seat 6: blackmont111 (small blind) folded on the Turn
Seat 7: nickreason17 (big blind) folded on the Flop
Seat 8: matiko09 folded before Flop (didn't bet)
Seat 9: Pvsx. folded before Flop (didn't bet)





PokerStars Hand #150802574653:  Hold'em No Limit ($1/$2 USD) - 2016/03/23 15:05:56 CET [2016/03/23 10:05:56 ET]
Table 'Achaia' 9-max Seat #3 is the button
Seat 1: RamiroAgujis ($233.57 in chips) 
Seat 2: bananajoe001 ($206.35 in chips) 
Seat 3: matiko09 ($231.16 in chips) 
Seat 4: erfk1958 ($88 in chips) 
Seat 5: chaps1988 ($200 in chips) 
Seat 6: nickreason17 ($254.17 in chips) 
Seat 7: morosun ($244.92 in chips) 
Seat 8: IseeUcards ($200.10 in chips) 
Seat 9: PacPacBum ($204.35 in chips) 
erfk1958: posts small blind $1
chaps1988: posts big blind $2
*** HOLE CARDS ***
Dealt to matiko09 [6s 7c]
nickreason17: folds 
morosun: folds 
IseeUcards: folds 
PacPacBum: folds 
RamiroAgujis: folds 
bananajoe001: folds 
matiko09: folds 
erfk1958: folds 
Uncalled bet ($1) returned to chaps1988
chaps1988 collected $2 from pot
chaps1988: doesn't show hand 
*** SUMMARY ***
Total pot $2 | Rake $0 
Seat 1: RamiroAgujis folded before Flop (didn't bet)
Seat 2: bananajoe001 folded before Flop (didn't bet)
Seat 3: matiko09 (button) folded before Flop (didn't bet)
Seat 4: erfk1958 (small blind) folded before Flop
Seat 5: chaps1988 (big blind) collected ($2)
Seat 6: nickreason17 folded before Flop (didn't bet)
Seat 7: morosun folded before Flop (didn't bet)
Seat 8: IseeUcards folded before Flop (didn't bet)
Seat 9: PacPacBum folded before Flop (didn't bet)





PokerStars Hand #150802576363:  Hold'em No Limit ($1/$2 USD) - 2016/03/23 15:06:00 CET [2016/03/23 10:06:00 ET]
Table 'Clarissa II' 9-max Seat #7 is the button
Seat 1: DUkalisUA ($702.47 in chips) 
Seat 2: Igoriah ($205.24 in chips) 
Seat 3: PtizaXXX ($185.60 in chips) 
Seat 4: sanrs57 ($195 in chips) 
Seat 5: Red4erT ($86 in chips) 
Seat 6: matiko09 ($200 in chips) 
Seat 7: PacPacBum ($200 in chips) 
Seat 8: chaps1988 ($209.32 in chips) 
Seat 9: RamiroAgujis ($200 in chips) 
chaps1988: posts small blind $1
RamiroAgujis: posts big blind $2
*** HOLE CARDS ***
Dealt to matiko09 [Js 2h]
DUkalisUA: folds 
Igoriah: folds 
PtizaXXX: folds 
sanrs57: folds 
Red4erT: folds 
matiko09: folds 
PacPacBum: folds 
chaps1988: folds 
Uncalled bet ($1) returned to RamiroAgujis
RamiroAgujis collected $2 from pot
*** SUMMARY ***
Total pot $2 | Rake $0 
Seat 1: DUkalisUA folded before Flop (didn't bet)
Seat 2: Igoriah folded before Flop (didn't bet)
Seat 3: PtizaXXX folded before Flop (didn't bet)
Seat 4: sanrs57 folded before Flop (didn't bet)
Seat 5: Red4erT folded before Flop (didn't bet)
Seat 6: matiko09 folded before Flop (didn't bet)
Seat 7: PacPacBum (button) folded before Flop (didn't bet)
Seat 8: chaps1988 (small blind) folded before Flop
Seat 9: RamiroAgujis (big blind) collected ($2)





PokerStars Hand #150802577316:  Hold'em No Limit ($0.50/$1.00 USD) - 2016/03/23 15:06:03 CET [2016/03/23 10:06:03 ET]
Table 'Sylvia III' 9-max Seat #8 is the button
Seat 1: mycka86 ($103.30 in chips) 
Seat 3: se7en_$tars ($88.53 in chips) 
Seat 4: lombardo11 ($82.82 in chips) 
Seat 5: matiko09 ($104.09 in chips) 
Seat 6: PacPacBum ($100 in chips) 
Seat 7: easytalk777 ($97.33 in chips) 
Seat 8: nickreason17 ($115.29 in chips) 
Seat 9: Blanky-Bad ($95.27 in chips) 
Blanky-Bad: posts small blind $0.50
mycka86: posts big blind $1
Dantist1122: sits out 
mycka86: posts the ante $0.20
se7en_$tars: posts the ante $0.20
lombardo11: posts the ante $0.20
matiko09: posts the ante $0.20
PacPacBum: posts the ante $0.20
easytalk777: posts the ante $0.20
nickreason17: posts the ante $0.20
Blanky-Bad: posts the ante $0.20
*** HOLE CARDS ***
Dealt to matiko09 [3h 6s]
se7en_$tars: folds 
lombardo11: folds 
matiko09: folds 
PacPacBum: folds 
easytalk777: folds 
nickreason17: folds 
Blanky-Bad: folds 
Uncalled bet ($0.50) returned to mycka86
mycka86 collected $2.60 from pot
*** SUMMARY ***
Total pot $2.60 | Rake $0 
Seat 1: mycka86 (big blind) collected ($2.60)
Seat 3: se7en_$tars folded before Flop (didn't bet)
Seat 4: lombardo11 folded before Flop (didn't bet)
Seat 5: matiko09 folded before Flop (didn't bet)
Seat 6: PacPacBum folded before Flop (didn't bet)
Seat 7: easytalk777 folded before Flop (didn't bet)
Seat 8: nickreason17 (button) folded before Flop (didn't bet)
Seat 9: Blanky-Bad (small blind) folded before Flop





PokerStars Hand #150802577859:  Hold'em No Limit ($1/$2 USD) - 2016/03/23 15:06:04 CET [2016/03/23 10:06:04 ET]
Table 'Kiess' 9-max Seat #8 is the button
Seat 1: Cirilico ($217.46 in chips) 
Seat 2: DUkalisUA ($702.28 in chips) 
Seat 3: Red4erT ($105.82 in chips) 
Seat 4: Igoriah ($200 in chips) 
Seat 6: matiko09 ($249.86 in chips) 
Seat 7: chaps1988 ($200 in chips) 
Seat 8: erfk1958 ($141.21 in chips) 
Cirilico: posts small blind $1
DUkalisUA: posts big blind $2
*** HOLE CARDS ***
Dealt to matiko09 [Td 9c]
Red4erT: folds 
Igoriah: raises $3 to $5
matiko09: folds 
chaps1988: folds 
erfk1958: folds 
Cirilico: folds 
DUkalisUA: folds 
Uncalled bet ($3) returned to Igoriah
Igoriah collected $5 from pot
Igoriah: doesn't show hand 
*** SUMMARY ***
Total pot $5 | Rake $0 
Seat 1: Cirilico (small blind) folded before Flop
Seat 2: DUkalisUA (big blind) folded before Flop
Seat 3: Red4erT folded before Flop (didn't bet)
Seat 4: Igoriah collected ($5)
Seat 6: matiko09 folded before Flop (didn't bet)
Seat 7: chaps1988 folded before Flop (didn't bet)
Seat 8: erfk1958 (button) folded before Flop (didn't bet)





PokerStars Hand #150802579216:  Hold'em No Limit ($0.50/$1.00 USD) - 2016/03/23 15:06:08 CET [2016/03/23 10:06:08 ET]
Table 'Drakonia II' 9-max Seat #6 is the button
Seat 1: chautinhtri9 ($134.60 in chips) 
Seat 2: carrsseis ($100 in chips) 
Seat 3: dunga119 ($86.50 in chips) 
Seat 4: nickreason17 ($113.72 in chips) 
Seat 5: gchs83 ($57.61 in chips) 
Seat 6: Dantist1122 ($100 in chips) 
Seat 7: YuriiSolodya ($28.40 in chips) 
Seat 8: matiko09 ($100 in chips) 
Seat 9: mycka86 ($100 in chips) 
YuriiSolodya: posts small blind $0.50
matiko09: posts big blind $1
*** HOLE CARDS ***
Dealt to matiko09 [2c Jc]
mycka86: folds 
chautinhtri9: raises $1 to $2
carrsseis: folds 
dunga119: calls $2
nickreason17: folds 
gchs83: calls $2
Dantist1122: folds 
YuriiSolodya: folds 
matiko09: folds 
*** FLOP *** [Js Qh 4d]
chautinhtri9: checks 
dunga119: checks 
gchs83: checks 
*** TURN *** [Js Qh 4d] [4h]
chautinhtri9: checks 
dunga119: checks 
gchs83: checks 
*** RIVER *** [Js Qh 4d 4h] [Ad]
chautinhtri9: checks 
dunga119: bets $7.16
gchs83: folds 
chautinhtri9: folds 
Uncalled bet ($7.16) returned to dunga119
dunga119 collected $7.16 from pot
dunga119: doesn't show hand 
*** SUMMARY ***
Total pot $7.50 | Rake $0.34 
Board [Js Qh 4d 4h Ad]
Seat 1: chautinhtri9 folded on the River
Seat 2: carrsseis folded before Flop (didn't bet)
Seat 3: dunga119 collected ($7.16)
Seat 4: nickreason17 folded before Flop (didn't bet)
Seat 5: gchs83 folded on the River
Seat 6: Dantist1122 (button) folded before Flop (didn't bet)
Seat 7: YuriiSolodya (small blind) folded before Flop
Seat 8: matiko09 (big blind) folded before Flop
Seat 9: mycka86 folded before Flop (didn't bet)





PokerStars Hand #150802579594:  Hold'em No Limit ($0.25/$0.50 USD) - 2016/03/23 15:06:09 CET [2016/03/23 10:06:09 ET]
Table 'Pyrrhus' 9-max Seat #9 is the button
Seat 1: lumen21 ($84.58 in chips) 
Seat 2: BSTUSim ($62.37 in chips) 
Seat 4: GriffinBerg ($47.97 in chips) 
Seat 6: Ahangama ($52.75 in chips) 
Seat 7: matiko09 ($136 in chips) 
Seat 8: suitedaces02 ($50 in chips) 
Seat 9: CvMCvMCvM ($89.05 in chips) 
lumen21: posts small blind $0.25
BSTUSim: posts big blind $0.50
Muinmyheart: sits out 
xxxibgdrgn: sits out 
*** HOLE CARDS ***
Dealt to matiko09 [8s 5d]
GriffinBerg: calls $0.50
Ahangama: folds 
matiko09: folds 
suitedaces02: folds 
CvMCvMCvM: folds 
lumen21: folds 
BSTUSim: checks 
*** FLOP *** [Jd Qc 5h]
BSTUSim: checks 
GriffinBerg: bets $1.19
BSTUSim: folds 
Uncalled bet ($1.19) returned to GriffinBerg
GriffinBerg collected $1.19 from pot
*** SUMMARY ***
Total pot $1.25 | Rake $0.06 
Board [Jd Qc 5h]
Seat 1: lumen21 (small blind) folded before Flop
Seat 2: BSTUSim (big blind) folded on the Flop
Seat 4: GriffinBerg collected ($1.19)
Seat 6: Ahangama folded before Flop (didn't bet)
Seat 7: matiko09 folded before Flop (didn't bet)
Seat 8: suitedaces02 folded before Flop (didn't bet)
Seat 9: CvMCvMCvM (button) folded before Flop (didn't bet)





PokerStars Hand #150802580591:  Hold'em No Limit ($0.50/$1.00 USD) - 2016/03/23 15:06:12 CET [2016/03/23 10:06:12 ET]
Table 'Asmodeus' 9-max Seat #4 is the button
Seat 1: Jimy Tiltman ($128.77 in chips) 
Seat 2: PacPacBum ($107.73 in chips) 
Seat 3: nickreason17 ($100.60 in chips) 
Seat 4: Effort92 ($100 in chips) 
Seat 5: Muinmyheart ($100 in chips) 
Seat 6: fuppeee ($66.71 in chips) 
Seat 7: mycka86 ($112.49 in chips) 
Seat 8: bonifacioppl ($96.90 in chips) 
Seat 9: matiko09 ($107.80 in chips) 
Muinmyheart: posts small blind $0.50
fuppeee: posts big blind $1
Jimy Tiltman: posts the ante $0.20
PacPacBum: posts the ante $0.20
nickreason17: posts the ante $0.20
Effort92: posts the ante $0.20
Muinmyheart: posts the ante $0.20
fuppeee: posts the ante $0.20
mycka86: posts the ante $0.20
bonifacioppl: posts the ante $0.20
matiko09: posts the ante $0.20
*** HOLE CARDS ***
Dealt to matiko09 [5c 6d]
mycka86: raises $2 to $3
bonifacioppl: folds 
matiko09: folds 
Jimy Tiltman: folds 
PacPacBum: folds 
nickreason17: folds 
Effort92: folds 
Muinmyheart: folds 
fuppeee: calls $2
*** FLOP *** [As Jh 3c]
fuppeee: checks 
mycka86: checks 
*** TURN *** [As Jh 3c] [2d]
fuppeee: checks 
mycka86: bets $4.36
fuppeee: folds 
Uncalled bet ($4.36) returned to mycka86
mycka86 collected $7.93 from pot
*** SUMMARY ***
Total pot $8.30 | Rake $0.37 
Board [As Jh 3c 2d]
Seat 1: Jimy Tiltman folded before Flop (didn't bet)
Seat 2: PacPacBum folded before Flop (didn't bet)
Seat 3: nickreason17 folded before Flop (didn't bet)
Seat 4: Effort92 (button) folded before Flop (didn't bet)
Seat 5: Muinmyheart (small blind) folded before Flop
Seat 6: fuppeee (big blind) folded on the Turn
Seat 7: mycka86 collected ($7.93)
Seat 8: bonifacioppl folded before Flop (didn't bet)
Seat 9: matiko09 folded before Flop (didn't bet)





PokerStars Hand #150802582521:  Hold'em No Limit ($0.50/$1.00 USD) - 2016/03/23 15:06:17 CET [2016/03/23 10:06:17 ET]
Table 'Swings' 9-max Seat #6 is the button
Seat 1: carrsseis ($100 in chips) 
Seat 3: maxxmeister ($129.50 in chips) 
Seat 4: chaps1988 ($100 in chips) 
Seat 5: chautinhtri9 ($112.45 in chips) 
Seat 6: matiko09 ($141.69 in chips) 
Seat 7: PacPacBum ($107.95 in chips) 
Seat 8: RICKA16 ($100.46 in chips) 
Seat 9: Vlad_1965_77 ($126.61 in chips) 
PacPacBum: posts small blind $0.50
RICKA16: posts big blind $1
*** HOLE CARDS ***
Dealt to matiko09 [7h Kd]
Vlad_1965_77: folds 
carrsseis: folds 
maxxmeister: folds 
chaps1988: folds 
chautinhtri9: folds 
matiko09: raises $1.27 to $2.27
PacPacBum: raises $5.73 to $8
RICKA16: folds 
matiko09: folds 
Uncalled bet ($5.73) returned to PacPacBum
PacPacBum collected $5.54 from pot
PacPacBum: doesn't show hand 
*** SUMMARY ***
Total pot $5.54 | Rake $0 
Seat 1: carrsseis folded before Flop (didn't bet)
Seat 3: maxxmeister folded before Flop (didn't bet)
Seat 4: chaps1988 folded before Flop (didn't bet)
Seat 5: chautinhtri9 folded before Flop (didn't bet)
Seat 6: matiko09 (button) folded before Flop
Seat 7: PacPacBum (small blind) collected ($5.54)
Seat 8: RICKA16 (big blind) folded before Flop
Seat 9: Vlad_1965_77 folded before Flop (didn't bet)





PokerStars Hand #150802584983:  Hold'em No Limit ($1/$2 USD) - 2016/03/23 15:06:23 CET [2016/03/23 10:06:23 ET]
Table 'Kiess' 9-max Seat #1 is the button
Seat 1: Cirilico ($216.46 in chips) 
Seat 2: DUkalisUA ($700.28 in chips) 
Seat 3: Red4erT ($105.82 in chips) 
Seat 4: Igoriah ($203 in chips) 
Seat 6: matiko09 ($249.86 in chips) 
Seat 7: chaps1988 ($200 in chips) 
Seat 8: erfk1958 ($141.21 in chips) 
DUkalisUA: posts small blind $1
Red4erT: posts big blind $2
*** HOLE CARDS ***
Dealt to matiko09 [Kh 9c]
Igoriah: folds 
matiko09: folds 
chaps1988: folds 
erfk1958: folds 
Cirilico: raises $3 to $5
DUkalisUA: folds 
Red4erT: folds 
Uncalled bet ($3) returned to Cirilico
Cirilico collected $5 from pot
Cirilico: doesn't show hand 
*** SUMMARY ***
Total pot $5 | Rake $0 
Seat 1: Cirilico (button) collected ($5)
Seat 2: DUkalisUA (small blind) folded before Flop
Seat 3: Red4erT (big blind) folded before Flop
Seat 4: Igoriah folded before Flop (didn't bet)
Seat 6: matiko09 folded before Flop (didn't bet)
Seat 7: chaps1988 folded before Flop (didn't bet)
Seat 8: erfk1958 folded before Flop (didn't bet)





PokerStars Hand #150802585452:  Hold'em No Limit ($0.50/$1.00 USD) - 2016/03/23 15:06:24 CET [2016/03/23 10:06:24 ET]
Table 'Sylvia III' 9-max Seat #9 is the button
Seat 1: mycka86 ($105.20 in chips) 
Seat 2: Dantist1122 ($100 in chips) 
Seat 3: se7en_$tars ($88.33 in chips) 
Seat 4: lombardo11 ($82.62 in chips) 
Seat 5: matiko09 ($103.89 in chips) 
Seat 6: PacPacBum ($100 in chips) 
Seat 7: easytalk777 ($97.13 in chips) 
Seat 8: nickreason17 ($115.09 in chips) 
Seat 9: Blanky-Bad ($94.57 in chips) 
mycka86: posts small blind $0.50
Dantist1122: posts big blind $1
mycka86: posts the ante $0.20
Dantist1122: posts the ante $0.20
se7en_$tars: posts the ante $0.20
lombardo11: posts the ante $0.20
matiko09: posts the ante $0.20
PacPacBum: posts the ante $0.20
easytalk777: posts the ante $0.20
nickreason17: posts the ante $0.20
Blanky-Bad: posts the ante $0.20
*** HOLE CARDS ***
Dealt to matiko09 [Jc 8c]
se7en_$tars: folds 
lombardo11: folds 
matiko09: folds 
PacPacBum: raises $1.50 to $2.50
easytalk777: folds 
nickreason17: folds 
Blanky-Bad: folds 
mycka86: raises $7.02 to $9.52
Dantist1122: folds 
PacPacBum: folds 
Uncalled bet ($7.02) returned to mycka86
mycka86 collected $7.80 from pot
*** SUMMARY ***
Total pot $7.80 | Rake $0 
Seat 1: mycka86 (small blind) collected ($7.80)
Seat 2: Dantist1122 (big blind) folded before Flop
Seat 3: se7en_$tars folded before Flop (didn't bet)
Seat 4: lombardo11 folded before Flop (didn't bet)
Seat 5: matiko09 folded before Flop (didn't bet)
Seat 6: PacPacBum folded before Flop
Seat 7: easytalk777 folded before Flop (didn't bet)
Seat 8: nickreason17 folded before Flop (didn't bet)
Seat 9: Blanky-Bad (button) folded before Flop (didn't bet)





PokerStars Hand #150802586768:  Hold'em No Limit (€0.50/€1.00 EUR) - 2016/03/23 15:06:28 CET [2016/03/23 10:06:28 ET]
Table 'Mercury III' 9-max Seat #8 is the button
Seat 1: matiko09 (€115.08 in chips) 
Seat 2: o.miro (€124.17 in chips) 
Seat 3: PacPacBum (€102.33 in chips) 
Seat 4: Muinmyheart (€100 in chips) 
Seat 5: DUkalisUA (€100 in chips) 
Seat 6: mycka86 (€100 in chips) 
Seat 7: STrakDD (€100 in chips) 
Seat 8: gfxed (€28.63 in chips) 
Seat 9: Indr3k (€100 in chips) 
Indr3k: posts small blind €0.50
matiko09: posts big blind €1
*** HOLE CARDS ***
Dealt to matiko09 [9d 5c]
o.miro: folds 
PacPacBum: folds 
Muinmyheart: folds 
DUkalisUA: folds 
mycka86: raises €1.50 to €2.50
STrakDD: folds 
gfxed: calls €2.50
Indr3k: folds 
matiko09: folds 
*** FLOP *** [4s 8c 2d]
mycka86: checks 
gfxed: bets €2.20
mycka86: calls €2.20
*** TURN *** [4s 8c 2d] [2h]
mycka86: checks 
gfxed: bets €5
mycka86: folds 
Uncalled bet (€5) returned to gfxed
gfxed collected €10.41 from pot
*** SUMMARY ***
Total pot €10.90 | Rake €0.49 
Board [4s 8c 2d 2h]
Seat 1: matiko09 (big blind) folded before Flop
Seat 2: o.miro folded before Flop (didn't bet)
Seat 3: PacPacBum folded before Flop (didn't bet)
Seat 4: Muinmyheart folded before Flop (didn't bet)
Seat 5: DUkalisUA folded before Flop (didn't bet)
Seat 6: mycka86 folded on the Turn
Seat 7: STrakDD folded before Flop (didn't bet)
Seat 8: gfxed (button) collected (€10.41)
Seat 9: Indr3k (small blind) folded before Flop





PokerStars Hand #150802587943:  Hold'em No Limit ($1/$2 USD) - 2016/03/23 15:06:31 CET [2016/03/23 10:06:31 ET]
Table 'Clarissa II' 9-max Seat #8 is the button
Seat 1: DUkalisUA ($702.47 in chips) 
Seat 2: Igoriah ($205.24 in chips) 
Seat 3: PtizaXXX ($185.60 in chips) 
Seat 4: sanrs57 ($195 in chips) 
Seat 5: Red4erT ($86 in chips) 
Seat 6: matiko09 ($200 in chips) 
Seat 7: PacPacBum ($200 in chips) 
Seat 8: chaps1988 ($208.32 in chips) 
Seat 9: RamiroAgujis ($201 in chips) 
RamiroAgujis: posts small blind $1
DUkalisUA: posts big blind $2
*** HOLE CARDS ***
Dealt to matiko09 [9c Jc]
Igoriah: folds 
PtizaXXX: folds 
sanrs57: folds 
Red4erT: folds 
matiko09: folds 
PacPacBum: folds 
chaps1988: folds 
RamiroAgujis: raises $3 to $5
DUkalisUA: raises $12 to $17
RamiroAgujis: folds 
Uncalled bet ($12) returned to DUkalisUA
DUkalisUA collected $10 from pot
DUkalisUA: doesn't show hand 
*** SUMMARY ***
Total pot $10 | Rake $0 
Seat 1: DUkalisUA (big blind) collected ($10)
Seat 2: Igoriah folded before Flop (didn't bet)
Seat 3: PtizaXXX folded before Flop (didn't bet)
Seat 4: sanrs57 folded before Flop (didn't bet)
Seat 5: Red4erT folded before Flop (didn't bet)
Seat 6: matiko09 folded before Flop (didn't bet)
Seat 7: PacPacBum folded before Flop (didn't bet)
Seat 8: chaps1988 (button) folded before Flop (didn't bet)
Seat 9: RamiroAgujis (small blind) folded before Flop





PokerStars Hand #150802591204:  Hold'em No Limit ($1/$2 USD) - 2016/03/23 15:06:39 CET [2016/03/23 10:06:39 ET]
Table 'Achaia' 9-max Seat #4 is the button
Seat 1: RamiroAgujis ($233.57 in chips) 
Seat 2: bananajoe001 ($206.35 in chips) 
Seat 3: matiko09 ($231.16 in chips) 
Seat 4: erfk1958 ($87 in chips) 
Seat 5: chaps1988 ($201 in chips) 
Seat 6: nickreason17 ($254.17 in chips) 
Seat 8: IseeUcards ($200.10 in chips) 
Seat 9: PacPacBum ($204.35 in chips) 
chaps1988: posts small blind $1
nickreason17: posts big blind $2
*** HOLE CARDS ***
Dealt to matiko09 [Js 7d]
IseeUcards: folds 
PacPacBum: raises $2.08 to $4.08
RamiroAgujis: folds 
bananajoe001: folds 
matiko09: folds 
erfk1958: folds 
chaps1988: folds 
nickreason17: folds 
Uncalled bet ($2.08) returned to PacPacBum
PacPacBum collected $5 from pot
PacPacBum: doesn't show hand 
*** SUMMARY ***
Total pot $5 | Rake $0 
Seat 1: RamiroAgujis folded before Flop (didn't bet)
Seat 2: bananajoe001 folded before Flop (didn't bet)
Seat 3: matiko09 folded before Flop (didn't bet)
Seat 4: erfk1958 (button) folded before Flop (didn't bet)
Seat 5: chaps1988 (small blind) folded before Flop
Seat 6: nickreason17 (big blind) folded before Flop
Seat 8: IseeUcards folded before Flop (didn't bet)
Seat 9: PacPacBum collected ($5)





PokerStars Hand #150802596571:  Hold'em No Limit ($1/$2 USD) - 2016/03/23 15:06:54 CET [2016/03/23 10:06:54 ET]
Table 'Achaia' 9-max Seat #5 is the button
Seat 1: RamiroAgujis ($233.57 in chips) 
Seat 2: bananajoe001 ($206.35 in chips) 
Seat 3: matiko09 ($231.16 in chips) 
Seat 4: erfk1958 ($87 in chips) 
Seat 5: chaps1988 ($200 in chips) 
Seat 6: nickreason17 ($252.17 in chips) 
Seat 8: IseeUcards ($200.10 in chips) 
Seat 9: PacPacBum ($207.35 in chips) 
nickreason17: posts small blind $1
IseeUcards: posts big blind $2
*** HOLE CARDS ***
Dealt to matiko09 [Jd 2c]
PacPacBum: folds 
RamiroAgujis: folds 
bananajoe001: folds 
matiko09: folds 
erfk1958: folds 
chaps1988: folds 
nickreason17: raises $3 to $5
IseeUcards: calls $3
*** FLOP *** [Ks 7h 4d]
nickreason17: bets $5.73
IseeUcards: calls $5.73
*** TURN *** [Ks 7h 4d] [5h]
nickreason17: checks 
IseeUcards: checks 
*** RIVER *** [Ks 7h 4d 5h] [6d]
nickreason17: checks 
IseeUcards: bets $18
nickreason17: folds 
Uncalled bet ($18) returned to IseeUcards
IseeUcards collected $20.49 from pot
IseeUcards: doesn't show hand 
*** SUMMARY ***
Total pot $21.46 | Rake $0.97 
Board [Ks 7h 4d 5h 6d]
Seat 1: RamiroAgujis folded before Flop (didn't bet)
Seat 2: bananajoe001 folded before Flop (didn't bet)
Seat 3: matiko09 folded before Flop (didn't bet)
Seat 4: erfk1958 folded before Flop (didn't bet)
Seat 5: chaps1988 (button) folded before Flop (didn't bet)
Seat 6: nickreason17 (small blind) folded on the River
Seat 8: IseeUcards (big blind) collected ($20.49)
Seat 9: PacPacBum folded before Flop (didn't bet)





PokerStars Hand #150802598087:  Hold'em No Limit ($0.25/$0.50 USD) - 2016/03/23 15:06:58 CET [2016/03/23 10:06:58 ET]
Table 'Pyrrhus' 9-max Seat #1 is the button
Seat 1: lumen21 ($84.33 in chips) 
Seat 2: BSTUSim ($61.87 in chips) 
Seat 3: Muinmyheart ($50 in chips) 
Seat 4: GriffinBerg ($48.66 in chips) 
Seat 6: Ahangama ($52.75 in chips) 
Seat 7: matiko09 ($136 in chips) 
Seat 8: suitedaces02 ($50 in chips) 
Seat 9: CvMCvMCvM ($89.05 in chips) 
BSTUSim: posts small blind $0.25
Muinmyheart: posts big blind $0.50
xxxibgdrgn: sits out 
*** HOLE CARDS ***
Dealt to matiko09 [Kc 9d]
GriffinBerg: folds 
Ahangama: folds 
matiko09: folds 
suitedaces02: folds 
CvMCvMCvM: folds 
lumen21: folds 
BSTUSim: folds 
Uncalled bet ($0.25) returned to Muinmyheart
Muinmyheart collected $0.50 from pot
Muinmyheart: doesn't show hand 
*** SUMMARY ***
Total pot $0.50 | Rake $0 
Seat 1: lumen21 (button) folded before Flop (didn't bet)
Seat 2: BSTUSim (small blind) folded before Flop
Seat 3: Muinmyheart (big blind) collected ($0.50)
Seat 4: GriffinBerg folded before Flop (didn't bet)
Seat 6: Ahangama folded before Flop (didn't bet)
Seat 7: matiko09 folded before Flop (didn't bet)
Seat 8: suitedaces02 folded before Flop (didn't bet)
Seat 9: CvMCvMCvM folded before Flop (didn't bet)





PokerStars Hand #150802598156:  Hold'em No Limit ($1/$2 USD) - 2016/03/23 15:06:58 CET [2016/03/23 10:06:58 ET]
Table 'Kiess' 9-max Seat #2 is the button
Seat 1: Cirilico ($219.46 in chips) 
Seat 2: DUkalisUA ($699.28 in chips) 
Seat 3: Red4erT ($103.82 in chips) 
Seat 4: Igoriah ($203 in chips) 
Seat 6: matiko09 ($249.86 in chips) 
Seat 7: chaps1988 ($200 in chips) 
Seat 8: erfk1958 ($141.21 in chips) 
Red4erT: posts small blind $1
Igoriah: posts big blind $2
*** HOLE CARDS ***
Dealt to matiko09 [As 3h]
volwebni4ek leaves the table
matiko09: folds 
chaps1988: folds 
PacPacBum joins the table at seat #9 
erfk1958: folds 
Cirilico: folds 
DUkalisUA: raises $2 to $4
Red4erT: folds 
Igoriah: folds 
Uncalled bet ($2) returned to DUkalisUA
DUkalisUA collected $5 from pot
DUkalisUA: doesn't show hand 
*** SUMMARY ***
Total pot $5 | Rake $0 
Seat 1: Cirilico folded before Flop (didn't bet)
Seat 2: DUkalisUA (button) collected ($5)
Seat 3: Red4erT (small blind) folded before Flop
Seat 4: Igoriah (big blind) folded before Flop
Seat 6: matiko09 folded before Flop (didn't bet)
Seat 7: chaps1988 folded before Flop (didn't bet)
Seat 8: erfk1958 folded before Flop (didn't bet)





PokerStars Hand #150802599720:  Hold'em No Limit ($1/$2 USD) - 2016/03/23 15:07:02 CET [2016/03/23 10:07:02 ET]
Table 'Herba II' 9-max Seat #2 is the button
Seat 1: matiko09 ($287.38 in chips) 
Seat 2: nickreason17 ($209.76 in chips) 
Seat 3: Cirilico ($200 in chips) 
Seat 4: DUkalisUA ($383.40 in chips) 
Seat 6: Too-Anti-To ($227.11 in chips) 
Seat 8: T0ny Adams ($74 in chips) 
Seat 9: mrhighryza ($67.41 in chips) 
Cirilico: posts small blind $1
DUkalisUA: posts big blind $2
Igoriah: sits out 
*** HOLE CARDS ***
Dealt to matiko09 [4h 5c]
Too-Anti-To: folds 
T0ny Adams: raises $3 to $5
mrhighryza: calls $5
matiko09: folds 
nickreason17: folds 
Cirilico: folds 
DUkalisUA: folds 
*** FLOP *** [7s 2d 3s]
T0ny Adams: bets $7
mrhighryza: calls $7
*** TURN *** [7s 2d 3s] [9c]
T0ny Adams: checks 
mrhighryza: bets $10
T0ny Adams: folds 
Uncalled bet ($10) returned to mrhighryza
mrhighryza collected $25.78 from pot
*** SUMMARY ***
Total pot $27 | Rake $1.22 
Board [7s 2d 3s 9c]
Seat 1: matiko09 folded before Flop (didn't bet)
Seat 2: nickreason17 (button) folded before Flop (didn't bet)
Seat 3: Cirilico (small blind) folded before Flop
Seat 4: DUkalisUA (big blind) folded before Flop
Seat 6: Too-Anti-To folded before Flop (didn't bet)
Seat 8: T0ny Adams folded on the Turn
Seat 9: mrhighryza collected ($25.78)





PokerStars Hand #150802599964:  Hold'em No Limit ($0.50/$1.00 USD) - 2016/03/23 15:07:03 CET [2016/03/23 10:07:03 ET]
Table 'Swings' 9-max Seat #7 is the button
Seat 1: carrsseis ($100 in chips) 
Seat 3: maxxmeister ($129.50 in chips) 
Seat 4: chaps1988 ($100 in chips) 
Seat 5: chautinhtri9 ($112.45 in chips) 
Seat 6: matiko09 ($139.42 in chips) 
Seat 7: PacPacBum ($111.22 in chips) 
Seat 8: RICKA16 ($99.46 in chips) 
Seat 9: Vlad_1965_77 ($126.61 in chips) 
RICKA16: posts small blind $0.50
Vlad_1965_77: posts big blind $1
*** HOLE CARDS ***
Dealt to matiko09 [8c Ts]
carrsseis: folds 
maxxmeister: raises $2 to $3
chaps1988: folds 
chautinhtri9: folds 
matiko09: folds 
PacPacBum: folds 
RICKA16: folds 
Vlad_1965_77: calls $2
*** FLOP *** [5d Qs 7s]
Vlad_1965_77: bets $3.10
maxxmeister: raises $10.90 to $14
Vlad_1965_77: folds 
Uncalled bet ($10.90) returned to maxxmeister
maxxmeister collected $12.13 from pot
maxxmeister: doesn't show hand 
*** SUMMARY ***
Total pot $12.70 | Rake $0.57 
Board [5d Qs 7s]
Seat 1: carrsseis folded before Flop (didn't bet)
Seat 3: maxxmeister collected ($12.13)
Seat 4: chaps1988 folded before Flop (didn't bet)
Seat 5: chautinhtri9 folded before Flop (didn't bet)
Seat 6: matiko09 folded before Flop (didn't bet)
Seat 7: PacPacBum (button) folded before Flop (didn't bet)
Seat 8: RICKA16 (small blind) folded before Flop
Seat 9: Vlad_1965_77 (big blind) folded on the Flop





PokerStars Hand #150802603998:  Hold'em No Limit ($0.50/$1.00 USD) - 2016/03/23 15:07:14 CET [2016/03/23 10:07:14 ET]
Table 'Sylvia III' 9-max Seat #1 is the button
Seat 1: mycka86 ($110.30 in chips) 
Seat 2: Dantist1122 ($100 in chips) 
Seat 3: se7en_$tars ($88.13 in chips) 
Seat 4: lombardo11 ($82.42 in chips) 
Seat 5: matiko09 ($103.69 in chips) 
Seat 6: PacPacBum ($100 in chips) 
Seat 7: easytalk777 ($96.93 in chips) 
Seat 8: nickreason17 ($114.89 in chips) 
Seat 9: Blanky-Bad ($94.37 in chips) 
Dantist1122: posts small blind $0.50
se7en_$tars: posts big blind $1
mycka86: posts the ante $0.20
Dantist1122: posts the ante $0.20
se7en_$tars: posts the ante $0.20
lombardo11: posts the ante $0.20
matiko09: posts the ante $0.20
PacPacBum: posts the ante $0.20
easytalk777: posts the ante $0.20
nickreason17: posts the ante $0.20
Blanky-Bad: posts the ante $0.20
*** HOLE CARDS ***
Dealt to matiko09 [6c 3h]
lombardo11: folds 
matiko09: folds 
PacPacBum: raises $1.50 to $2.50
easytalk777: folds 
nickreason17: folds 
Blanky-Bad: folds 
mycka86: folds 
Dantist1122: folds 
se7en_$tars: calls $1.50
*** FLOP *** [2h 3s 3d]
se7en_$tars: bets $5
PacPacBum: folds 
Uncalled bet ($5) returned to se7en_$tars
se7en_$tars collected $6.97 from pot
*** SUMMARY ***
Total pot $7.30 | Rake $0.33 
Board [2h 3s 3d]
Seat 1: mycka86 (button) folded before Flop (didn't bet)
Seat 2: Dantist1122 (small blind) folded before Flop
Seat 3: se7en_$tars (big blind) collected ($6.97)
Seat 4: lombardo11 folded before Flop (didn't bet)
Seat 5: matiko09 folded before Flop (didn't bet)
Seat 6: PacPacBum folded on the Flop
Seat 7: easytalk777 folded before Flop (didn't bet)
Seat 8: nickreason17 folded before Flop (didn't bet)
Seat 9: Blanky-Bad folded before Flop (didn't bet)





PokerStars Hand #150802603997:  Hold'em No Limit ($0.50/$1.00 USD) - 2016/03/23 15:07:14 CET [2016/03/23 10:07:14 ET]
Table 'Asmodeus' 9-max Seat #5 is the button
Seat 1: Jimy Tiltman ($128.57 in chips) 
Seat 2: PacPacBum ($107.53 in chips) 
Seat 3: nickreason17 ($100.40 in chips) 
Seat 4: Effort92 ($100 in chips) 
Seat 5: Muinmyheart ($100 in chips) 
Seat 6: fuppeee ($63.51 in chips) 
Seat 7: mycka86 ($117.22 in chips) 
Seat 8: bonifacioppl ($96.70 in chips) 
Seat 9: matiko09 ($107.60 in chips) 
fuppeee: posts small blind $0.50
mycka86: posts big blind $1
Jimy Tiltman: posts the ante $0.20
PacPacBum: posts the ante $0.20
nickreason17: posts the ante $0.20
Effort92: posts the ante $0.20
Muinmyheart: posts the ante $0.20
fuppeee: posts the ante $0.20
mycka86: posts the ante $0.20
bonifacioppl: posts the ante $0.20
matiko09: posts the ante $0.20
*** HOLE CARDS ***
Dealt to matiko09 [Th 6c]
bonifacioppl: raises $1.37 to $2.37
matiko09: folds 
Jimy Tiltman: folds 
PacPacBum: folds 
nickreason17: folds 
Effort92: folds 
Muinmyheart: folds 
fuppeee: folds 
mycka86: calls $1.37
*** FLOP *** [Js Kd 7h]
mycka86: checks 
bonifacioppl: bets $3.76
mycka86: folds 
Uncalled bet ($3.76) returned to bonifacioppl
bonifacioppl collected $6.72 from pot
bonifacioppl: doesn't show hand 
*** SUMMARY ***
Total pot $7.04 | Rake $0.32 
Board [Js Kd 7h]
Seat 1: Jimy Tiltman folded before Flop (didn't bet)
Seat 2: PacPacBum folded before Flop (didn't bet)
Seat 3: nickreason17 folded before Flop (didn't bet)
Seat 4: Effort92 folded before Flop (didn't bet)
Seat 5: Muinmyheart (button) folded before Flop (didn't bet)
Seat 6: fuppeee (small blind) folded before Flop
Seat 7: mycka86 (big blind) folded on the Flop
Seat 8: bonifacioppl collected ($6.72)
Seat 9: matiko09 folded before Flop (didn't bet)





PokerStars Hand #150802604490:  Hold'em No Limit ($1/$2 USD) - 2016/03/23 15:07:15 CET [2016/03/23 10:07:15 ET]
Table 'Clarissa II' 9-max Seat #9 is the button
Seat 1: DUkalisUA ($707.47 in chips) 
Seat 2: Igoriah ($205.24 in chips) 
Seat 3: PtizaXXX ($185.60 in chips) 
Seat 4: sanrs57 ($195 in chips) 
Seat 5: Red4erT ($86 in chips) 
Seat 6: matiko09 ($200 in chips) 
Seat 7: PacPacBum ($200 in chips) 
Seat 8: chaps1988 ($208.32 in chips) 
Seat 9: RamiroAgujis ($200 in chips) 
DUkalisUA: posts small blind $1
Igoriah: posts big blind $2
*** HOLE CARDS ***
Dealt to matiko09 [8h 4h]
PtizaXXX: folds 
sanrs57: folds 
Red4erT: folds 
matiko09: folds 
PacPacBum: folds 
chaps1988: folds 
RamiroAgujis: raises $3 to $5
DUkalisUA: folds 
Igoriah: folds 
Uncalled bet ($3) returned to RamiroAgujis
RamiroAgujis collected $5 from pot
*** SUMMARY ***
Total pot $5 | Rake $0 
Seat 1: DUkalisUA (small blind) folded before Flop
Seat 2: Igoriah (big blind) folded before Flop
Seat 3: PtizaXXX folded before Flop (didn't bet)
Seat 4: sanrs57 folded before Flop (didn't bet)
Seat 5: Red4erT folded before Flop (didn't bet)
Seat 6: matiko09 folded before Flop (didn't bet)
Seat 7: PacPacBum folded before Flop (didn't bet)
Seat 8: chaps1988 folded before Flop (didn't bet)
Seat 9: RamiroAgujis (button) collected ($5)





PokerStars Hand #150802604394:  Hold'em No Limit ($0.50/$1.00 USD) - 2016/03/23 15:07:15 CET [2016/03/23 10:07:15 ET]
Table 'Smiley' 9-max Seat #6 is the button
Seat 1: xHourglass ($100 in chips) 
Seat 2: Jimy Tiltman ($126.01 in chips) 
Seat 3: Robert201202 ($105.07 in chips) 
Seat 4: CAJUN890 ($71.99 in chips) 
Seat 5: Szevasztopol ($100 in chips) 
Seat 6: blackmont111 ($152.54 in chips) 
Seat 7: nickreason17 ($105.71 in chips) 
Seat 8: matiko09 ($100 in chips) 
Seat 9: Pvsx. ($234.87 in chips) 
nickreason17: posts small blind $0.50
matiko09: posts big blind $1
*** HOLE CARDS ***
Dealt to matiko09 [Kc Th]
Pvsx.: folds 
xHourglass: folds 
Jimy Tiltman: folds 
Robert201202: raises $2 to $3
CAJUN890: folds 
Szevasztopol: folds 
blackmont111: folds 
nickreason17: folds 
matiko09: folds 
Uncalled bet ($2) returned to Robert201202
Robert201202 collected $2.50 from pot
Robert201202: doesn't show hand 
*** SUMMARY ***
Total pot $2.50 | Rake $0 
Seat 1: xHourglass folded before Flop (didn't bet)
Seat 2: Jimy Tiltman folded before Flop (didn't bet)
Seat 3: Robert201202 collected ($2.50)
Seat 4: CAJUN890 folded before Flop (didn't bet)
Seat 5: Szevasztopol folded before Flop (didn't bet)
Seat 6: blackmont111 (button) folded before Flop (didn't bet)
Seat 7: nickreason17 (small blind) folded before Flop
Seat 8: matiko09 (big blind) folded before Flop
Seat 9: Pvsx. folded before Flop (didn't bet)





PokerStars Hand #150802608361:  Hold'em No Limit ($1/$2 USD) - 2016/03/23 15:07:25 CET [2016/03/23 10:07:25 ET]
Table 'Kypria II' 9-max Seat #6 is the button
Seat 3: seouljam ($302.58 in chips) 
Seat 4: VolanDog ($222.72 in chips) 
Seat 5: Igoriah ($200 in chips) 
Seat 6: matiko09 ($447.25 in chips) 
Seat 7: DUkalisUA ($200 in chips) 
Seat 8: nickreason17 ($206.37 in chips) 
Seat 9: sanrs57 ($163.30 in chips) 
DUkalisUA: posts small blind $1
nickreason17: posts big blind $2
chaps1988: sits out 
PacPacBum: sits out 
*** HOLE CARDS ***
Dealt to matiko09 [7s Jd]
sanrs57: folds 
seouljam: folds 
VolanDog: raises $3 to $5
Igoriah: raises $12 to $17
matiko09: folds 
DUkalisUA: folds 
nickreason17: folds 
VolanDog: folds 
Uncalled bet ($12) returned to Igoriah
Igoriah collected $13 from pot
Igoriah: doesn't show hand 
*** SUMMARY ***
Total pot $13 | Rake $0 
Seat 3: seouljam folded before Flop (didn't bet)
Seat 4: VolanDog folded before Flop
Seat 5: Igoriah collected ($13)
Seat 6: matiko09 (button) folded before Flop (didn't bet)
Seat 7: DUkalisUA (small blind) folded before Flop
Seat 8: nickreason17 (big blind) folded before Flop
Seat 9: sanrs57 folded before Flop (didn't bet)





PokerStars Hand #150802610063:  Hold'em No Limit ($0.25/$0.50 USD) - 2016/03/23 15:07:30 CET [2016/03/23 10:07:30 ET]
Table 'Pyrrhus' 9-max Seat #2 is the button
Seat 1: lumen21 ($84.33 in chips) 
Seat 2: BSTUSim ($61.62 in chips) 
Seat 3: Muinmyheart ($50.25 in chips) 
Seat 4: GriffinBerg ($48.66 in chips) 
Seat 6: Ahangama ($52.75 in chips) 
Seat 7: matiko09 ($136 in chips) 
Seat 8: suitedaces02 ($50 in chips) 
Seat 9: CvMCvMCvM ($89.05 in chips) 
Muinmyheart: posts small blind $0.25
GriffinBerg: posts big blind $0.50
xxxibgdrgn: sits out 
*** HOLE CARDS ***
Dealt to matiko09 [Ks 6h]
Ahangama: raises $0.75 to $1.25
matiko09: folds 
suitedaces02: folds 
CvMCvMCvM: folds 
lumen21: folds 
BSTUSim: folds 
Muinmyheart: folds 
GriffinBerg: raises $1.65 to $2.90
Ahangama: calls $1.65
*** FLOP *** [9h 3s Kd]
GriffinBerg: checks 
Ahangama: checks 
*** TURN *** [9h 3s Kd] [7s]
GriffinBerg: bets $2.89
Ahangama: folds 
Uncalled bet ($2.89) returned to GriffinBerg
GriffinBerg collected $5.78 from pot
*** SUMMARY ***
Total pot $6.05 | Rake $0.27 
Board [9h 3s Kd 7s]
Seat 1: lumen21 folded before Flop (didn't bet)
Seat 2: BSTUSim (button) folded before Flop (didn't bet)
Seat 3: Muinmyheart (small blind) folded before Flop
Seat 4: GriffinBerg (big blind) collected ($5.78)
Seat 6: Ahangama folded on the Turn
Seat 7: matiko09 folded before Flop (didn't bet)
Seat 8: suitedaces02 folded before Flop (didn't bet)
Seat 9: CvMCvMCvM folded before Flop (didn't bet)





PokerStars Hand #150802610644:  Hold'em No Limit ($0.50/$1.00 USD) - 2016/03/23 15:07:32 CET [2016/03/23 10:07:32 ET]
Table 'Drakonia II' 9-max Seat #7 is the button
Seat 1: chautinhtri9 ($132.60 in chips) 
Seat 2: carrsseis ($100 in chips) 
Seat 3: dunga119 ($100 in chips) 
Seat 4: nickreason17 ($113.72 in chips) 
Seat 5: gchs83 ($55.61 in chips) 
Seat 6: Dantist1122 ($100 in chips) 
Seat 7: YuriiSolodya ($27.90 in chips) 
Seat 8: matiko09 ($100 in chips) 
Seat 9: mycka86 ($100 in chips) 
matiko09: posts small blind $0.50
mycka86: posts big blind $1
*** HOLE CARDS ***
Dealt to matiko09 [As 8s]
chautinhtri9: folds 
carrsseis: folds 
dunga119: calls $1
nickreason17: folds 
gchs83: folds 
Dantist1122: folds 
YuriiSolodya: folds 
matiko09: calls $0.50
mycka86: checks 
*** FLOP *** [5d 5c 7c]
matiko09: checks 
mycka86: bets $2.10
dunga119: calls $2.10
matiko09: folds 
*** TURN *** [5d 5c 7c] [7d]
mycka86: checks 
dunga119: bets $3.44
mycka86: folds 
Uncalled bet ($3.44) returned to dunga119
dunga119 collected $6.88 from pot
dunga119: doesn't show hand 
*** SUMMARY ***
Total pot $7.20 | Rake $0.32 
Board [5d 5c 7c 7d]
Seat 1: chautinhtri9 folded before Flop (didn't bet)
Seat 2: carrsseis folded before Flop (didn't bet)
Seat 3: dunga119 collected ($6.88)
Seat 4: nickreason17 folded before Flop (didn't bet)
Seat 5: gchs83 folded before Flop (didn't bet)
Seat 6: Dantist1122 folded before Flop (didn't bet)
Seat 7: YuriiSolodya (button) folded before Flop (didn't bet)
Seat 8: matiko09 (small blind) folded on the Flop
Seat 9: mycka86 (big blind) folded on the Turn





PokerStars Hand #150802610807:  Hold'em No Limit ($0.50/$1.00 USD) - 2016/03/23 15:07:32 CET [2016/03/23 10:07:32 ET]
Table 'Smiley' 9-max Seat #7 is the button
Seat 1: xHourglass ($100 in chips) 
Seat 2: Jimy Tiltman ($126.01 in chips) 
Seat 3: Robert201202 ($106.57 in chips) 
Seat 4: CAJUN890 ($71.99 in chips) 
Seat 5: Szevasztopol ($100 in chips) 
Seat 6: blackmont111 ($152.54 in chips) 
Seat 7: nickreason17 ($105.21 in chips) 
Seat 8: matiko09 ($100 in chips) 
Seat 9: Pvsx. ($234.87 in chips) 
matiko09: posts small blind $0.50
Pvsx.: posts big blind $1
*** HOLE CARDS ***
Dealt to matiko09 [9c Qc]
xHourglass: folds 
Jimy Tiltman: folds 
Robert201202: folds 
CAJUN890: raises $2 to $3
Szevasztopol: folds 
blackmont111: folds 
nickreason17: calls $3
matiko09: folds 
Pvsx.: folds 
*** FLOP *** [4h 8h 9h]
CAJUN890: checks 
nickreason17: checks 
*** TURN *** [4h 8h 9h] [Ah]
CAJUN890: bets $4
nickreason17: calls $4
*** RIVER *** [4h 8h 9h Ah] [Js]
CAJUN890: checks 
nickreason17: checks 
*** SHOW DOWN ***
CAJUN890: shows [Ac Kd] (a pair of Aces)
nickreason17: mucks hand 
CAJUN890 collected $14.80 from pot
*** SUMMARY ***
Total pot $15.50 | Rake $0.70 
Board [4h 8h 9h Ah Js]
Seat 1: xHourglass folded before Flop (didn't bet)
Seat 2: Jimy Tiltman folded before Flop (didn't bet)
Seat 3: Robert201202 folded before Flop (didn't bet)
Seat 4: CAJUN890 showed [Ac Kd] and won ($14.80) with a pair of Aces
Seat 5: Szevasztopol folded before Flop (didn't bet)
Seat 6: blackmont111 folded before Flop (didn't bet)
Seat 7: nickreason17 (button) mucked [As Qs]
Seat 8: matiko09 (small blind) folded before Flop
Seat 9: Pvsx. (big blind) folded before Flop





PokerStars Hand #150802613208:  Hold'em No Limit ($1/$2 USD) - 2016/03/23 15:07:38 CET [2016/03/23 10:07:38 ET]
Table 'Kiess' 9-max Seat #3 is the button
Seat 1: Cirilico ($219.46 in chips) 
Seat 2: DUkalisUA ($702.28 in chips) 
Seat 3: Red4erT ($102.82 in chips) 
Seat 4: Igoriah ($201 in chips) 
Seat 6: matiko09 ($249.86 in chips) 
Seat 7: chaps1988 ($200 in chips) 
Seat 8: erfk1958 ($141.21 in chips) 
Igoriah: posts small blind $1
matiko09: posts big blind $2
PacPacBum: sits out 
*** HOLE CARDS ***
Dealt to matiko09 [4d Kd]
chaps1988: folds 
erfk1958: folds 
Cirilico: folds 
DUkalisUA: folds 
Red4erT: folds 
Igoriah: raises $2 to $4
matiko09: calls $2
*** FLOP *** [7c 8h Ts]
Igoriah: bets $5.04
matiko09: folds 
Uncalled bet ($5.04) returned to Igoriah
Igoriah collected $7.64 from pot
Igoriah: doesn't show hand 
*** SUMMARY ***
Total pot $8 | Rake $0.36 
Board [7c 8h Ts]
Seat 1: Cirilico folded before Flop (didn't bet)
Seat 2: DUkalisUA folded before Flop (didn't bet)
Seat 3: Red4erT (button) folded before Flop (didn't bet)
Seat 4: Igoriah (small blind) collected ($7.64)
Seat 6: matiko09 (big blind) folded on the Flop
Seat 7: chaps1988 folded before Flop (didn't bet)
Seat 8: erfk1958 folded before Flop (didn't bet)





PokerStars Hand #150802614159:  Hold'em No Limit ($1/$2 USD) - 2016/03/23 15:07:41 CET [2016/03/23 10:07:41 ET]
Table 'Clarissa II' 9-max Seat #1 is the button
Seat 1: DUkalisUA ($706.47 in chips) 
Seat 2: Igoriah ($203.24 in chips) 
Seat 3: PtizaXXX ($185.60 in chips) 
Seat 4: sanrs57 ($195 in chips) 
Seat 5: Red4erT ($86 in chips) 
Seat 6: matiko09 ($200 in chips) 
Seat 7: PacPacBum ($200 in chips) 
Seat 8: chaps1988 ($208.32 in chips) 
Seat 9: RamiroAgujis ($203 in chips) 
Igoriah: posts small blind $1
PtizaXXX: posts big blind $2
*** HOLE CARDS ***
Dealt to matiko09 [9s As]
sanrs57: folds 
Red4erT: folds 
matiko09: folds 
PacPacBum: folds 
chaps1988: folds 
RamiroAgujis: raises $4 to $6
DUkalisUA: folds 
Igoriah: folds 
PtizaXXX: folds 
Uncalled bet ($4) returned to RamiroAgujis
RamiroAgujis collected $5 from pot
RamiroAgujis: doesn't show hand 
*** SUMMARY ***
Total pot $5 | Rake $0 
Seat 1: DUkalisUA (button) folded before Flop (didn't bet)
Seat 2: Igoriah (small blind) folded before Flop
Seat 3: PtizaXXX (big blind) folded before Flop
Seat 4: sanrs57 folded before Flop (didn't bet)
Seat 5: Red4erT folded before Flop (didn't bet)
Seat 6: matiko09 folded before Flop (didn't bet)
Seat 7: PacPacBum folded before Flop (didn't bet)
Seat 8: chaps1988 folded before Flop (didn't bet)
Seat 9: RamiroAgujis collected ($5)





PokerStars Hand #150802619219:  Hold'em No Limit ($1/$2 USD) - 2016/03/23 15:07:54 CET [2016/03/23 10:07:54 ET]
Table 'Achaia' 9-max Seat #6 is the button
Seat 1: RamiroAgujis ($233.57 in chips) 
Seat 2: bananajoe001 ($206.35 in chips) 
Seat 3: matiko09 ($231.16 in chips) 
Seat 4: erfk1958 ($87 in chips) 
Seat 5: chaps1988 ($200 in chips) 
Seat 6: nickreason17 ($241.44 in chips) 
Seat 8: IseeUcards ($209.86 in chips) 
Seat 9: PacPacBum ($207.35 in chips) 
IseeUcards: posts small blind $1
PacPacBum: posts big blind $2
*** HOLE CARDS ***
Dealt to matiko09 [Ac 3c]
RamiroAgujis: folds 
bananajoe001: calls $2
matiko09: raises $6 to $8
erfk1958: folds 
chaps1988: folds 
nickreason17: folds 
IseeUcards: folds 
PacPacBum: folds 
bananajoe001: calls $6
*** FLOP *** [7d 8d Ks]
bananajoe001: checks 
matiko09: checks 
*** TURN *** [7d 8d Ks] [Td]
bananajoe001: bets $2
matiko09: folds 
Uncalled bet ($2) returned to bananajoe001
bananajoe001 collected $18.14 from pot
bananajoe001: doesn't show hand 
*** SUMMARY ***
Total pot $19 | Rake $0.86 
Board [7d 8d Ks Td]
Seat 1: RamiroAgujis folded before Flop (didn't bet)
Seat 2: bananajoe001 collected ($18.14)
Seat 3: matiko09 folded on the Turn
Seat 4: erfk1958 folded before Flop (didn't bet)
Seat 5: chaps1988 folded before Flop (didn't bet)
Seat 6: nickreason17 (button) folded before Flop (didn't bet)
Seat 8: IseeUcards (small blind) folded before Flop
Seat 9: PacPacBum (big blind) folded before Flop





PokerStars Hand #150802619614:  Hold'em No Limit ($0.50/$1.00 USD) - 2016/03/23 15:07:56 CET [2016/03/23 10:07:56 ET]
Table 'Asmodeus' 9-max Seat #6 is the button
Seat 1: Jimy Tiltman ($128.37 in chips) 
Seat 2: PacPacBum ($107.33 in chips) 
Seat 3: nickreason17 ($100.20 in chips) 
Seat 4: Effort92 ($100 in chips) 
Seat 5: Muinmyheart ($100 in chips) 
Seat 6: fuppeee ($62.81 in chips) 
Seat 7: mycka86 ($114.65 in chips) 
Seat 8: bonifacioppl ($100.85 in chips) 
Seat 9: matiko09 ($107.40 in chips) 
mycka86: posts small blind $0.50
bonifacioppl: posts big blind $1
Jimy Tiltman: posts the ante $0.20
PacPacBum: posts the ante $0.20
nickreason17: posts the ante $0.20
Effort92: posts the ante $0.20
Muinmyheart: posts the ante $0.20
fuppeee: posts the ante $0.20
mycka86: posts the ante $0.20
bonifacioppl: posts the ante $0.20
matiko09: posts the ante $0.20
*** HOLE CARDS ***
Dealt to matiko09 [Jc Js]
matiko09: raises $2 to $3
Jimy Tiltman: folds 
PacPacBum: folds 
nickreason17: folds 
Effort92: folds 
Muinmyheart: folds 
fuppeee: raises $4 to $7
mycka86: folds 
bonifacioppl: calls $6
matiko09: calls $4
*** FLOP *** [2d 5h Kd]
bonifacioppl: checks 
matiko09: checks 
fuppeee: bets $11.12
bonifacioppl: folds 
matiko09: folds 
Uncalled bet ($11.12) returned to fuppeee
fuppeee collected $22.25 from pot
*** SUMMARY ***
Total pot $23.30 | Rake $1.05 
Board [2d 5h Kd]
Seat 1: Jimy Tiltman folded before Flop (didn't bet)
Seat 2: PacPacBum folded before Flop (didn't bet)
Seat 3: nickreason17 folded before Flop (didn't bet)
Seat 4: Effort92 folded before Flop (didn't bet)
Seat 5: Muinmyheart folded before Flop (didn't bet)
Seat 6: fuppeee (button) collected ($22.25)
Seat 7: mycka86 (small blind) folded before Flop
Seat 8: bonifacioppl (big blind) folded on the Flop
Seat 9: matiko09 folded on the Flop





PokerStars Hand #150802620342:  Hold'em No Limit ($0.50/$1.00 USD) - 2016/03/23 15:07:58 CET [2016/03/23 10:07:58 ET]
Table 'Swings' 9-max Seat #8 is the button
Seat 1: carrsseis ($100 in chips) 
Seat 3: maxxmeister ($135.53 in chips) 
Seat 4: chaps1988 ($100 in chips) 
Seat 5: chautinhtri9 ($112.45 in chips) 
Seat 6: matiko09 ($139.42 in chips) 
Seat 7: PacPacBum ($111.22 in chips) 
Seat 8: RICKA16 ($98.96 in chips) 
Seat 9: Vlad_1965_77 ($120.51 in chips) 
Vlad_1965_77: posts small blind $0.50
carrsseis: posts big blind $1
*** HOLE CARDS ***
Dealt to matiko09 [5d 3c]
maxxmeister: folds 
chaps1988: folds 
chautinhtri9: raises $1 to $2
matiko09: folds 
PacPacBum: folds 
RICKA16: folds 
Vlad_1965_77: folds 
carrsseis: calls $1
*** FLOP *** [4d Ah 3s]
carrsseis: checks 
chautinhtri9: checks 
*** TURN *** [4d Ah 3s] [6c]
carrsseis: bets $7
chautinhtri9: folds 
Uncalled bet ($7) returned to carrsseis
carrsseis collected $4.30 from pot
carrsseis: doesn't show hand 
*** SUMMARY ***
Total pot $4.50 | Rake $0.20 
Board [4d Ah 3s 6c]
Seat 1: carrsseis (big blind) collected ($4.30)
Seat 3: maxxmeister folded before Flop (didn't bet)
Seat 4: chaps1988 folded before Flop (didn't bet)
Seat 5: chautinhtri9 folded on the Turn
Seat 6: matiko09 folded before Flop (didn't bet)
Seat 7: PacPacBum folded before Flop (didn't bet)
Seat 8: RICKA16 (button) folded before Flop (didn't bet)
Seat 9: Vlad_1965_77 (small blind) folded before Flop





PokerStars Hand #150802620837:  Hold'em No Limit ($1/$2 USD) - 2016/03/23 15:07:59 CET [2016/03/23 10:07:59 ET]
Table 'Kypria II' 9-max Seat #7 is the button
Seat 3: seouljam ($302.58 in chips) 
Seat 4: VolanDog ($217.72 in chips) 
Seat 5: Igoriah ($208 in chips) 
Seat 6: matiko09 ($447.25 in chips) 
Seat 7: DUkalisUA ($200 in chips) 
Seat 8: nickreason17 ($204.37 in chips) 
Seat 9: sanrs57 ($163.30 in chips) 
nickreason17: posts small blind $1
sanrs57: posts big blind $2
chaps1988: sits out 
PacPacBum: sits out 
*** HOLE CARDS ***
Dealt to matiko09 [5h 9s]
seouljam: folds 
VolanDog: folds 
Igoriah: folds 
matiko09: folds 
DUkalisUA: raises $2 to $4
nickreason17: folds 
sanrs57 is connected 
sanrs57: folds 
Uncalled bet ($2) returned to DUkalisUA
DUkalisUA collected $5 from pot
DUkalisUA: doesn't show hand 
*** SUMMARY ***
Total pot $5 | Rake $0 
Seat 3: seouljam folded before Flop (didn't bet)
Seat 4: VolanDog folded before Flop (didn't bet)
Seat 5: Igoriah folded before Flop (didn't bet)
Seat 6: matiko09 folded before Flop (didn't bet)
Seat 7: DUkalisUA (button) collected ($5)
Seat 8: nickreason17 (small blind) folded before Flop
Seat 9: sanrs57 (big blind) folded before Flop





PokerStars Hand #150802625435:  Hold'em No Limit ($0.50/$1.00 USD) - 2016/03/23 15:08:11 CET [2016/03/23 10:08:11 ET]
Table 'Smiley' 9-max Seat #8 is the button
Seat 1: xHourglass ($100 in chips) 
Seat 2: Jimy Tiltman ($126.01 in chips) 
Seat 3: Robert201202 ($106.57 in chips) 
Seat 4: CAJUN890 ($79.79 in chips) 
Seat 5: Szevasztopol ($100 in chips) 
Seat 6: blackmont111 ($152.54 in chips) 
Seat 7: nickreason17 ($100 in chips) 
Seat 8: matiko09 ($100 in chips) 
Seat 9: Pvsx. ($233.87 in chips) 
Pvsx.: posts small blind $0.50
xHourglass: posts big blind $1
*** HOLE CARDS ***
Dealt to matiko09 [3d Ac]
Jimy Tiltman: folds 
Robert201202: folds 
CAJUN890: folds 
Szevasztopol: folds 
blackmont111: folds 
nickreason17: folds 
matiko09: raises $1.27 to $2.27
Pvsx.: raises $5.54 to $7.81
xHourglass: folds 
matiko09: folds 
Uncalled bet ($5.54) returned to Pvsx.
Pvsx. collected $5.54 from pot
*** SUMMARY ***
Total pot $5.54 | Rake $0 
Seat 1: xHourglass (big blind) folded before Flop
Seat 2: Jimy Tiltman folded before Flop (didn't bet)
Seat 3: Robert201202 folded before Flop (didn't bet)
Seat 4: CAJUN890 folded before Flop (didn't bet)
Seat 5: Szevasztopol folded before Flop (didn't bet)
Seat 6: blackmont111 folded before Flop (didn't bet)
Seat 7: nickreason17 folded before Flop (didn't bet)
Seat 8: matiko09 (button) folded before Flop
Seat 9: Pvsx. (small blind) collected ($5.54)





PokerStars Hand #150802625230:  Hold'em No Limit ($1/$2 USD) - 2016/03/23 15:08:11 CET [2016/03/23 10:08:11 ET]
Table 'Herba II' 9-max Seat #3 is the button
Seat 1: matiko09 ($287.38 in chips) 
Seat 2: nickreason17 ($209.76 in chips) 
Seat 3: Cirilico ($199 in chips) 
Seat 4: DUkalisUA ($381.40 in chips) 
Seat 7: Igoriah ($200 in chips) 
Seat 8: T0ny Adams ($62 in chips) 
Seat 9: mrhighryza ($81.19 in chips) 
DUkalisUA: posts small blind $1
Too-Anti-To: is sitting out 
Igoriah: posts big blind $2
*** HOLE CARDS ***
Dealt to matiko09 [7d 9h]
T0ny Adams: folds 
mrhighryza: folds 
matiko09: folds 
nickreason17: raises $3 to $5
Cirilico: folds 
DUkalisUA: folds 
Igoriah: folds 
Uncalled bet ($3) returned to nickreason17
nickreason17 collected $5 from pot
*** SUMMARY ***
Total pot $5 | Rake $0 
Seat 1: matiko09 folded before Flop (didn't bet)
Seat 2: nickreason17 collected ($5)
Seat 3: Cirilico (button) folded before Flop (didn't bet)
Seat 4: DUkalisUA (small blind) folded before Flop
Seat 7: Igoriah (big blind) folded before Flop
Seat 8: T0ny Adams folded before Flop (didn't bet)
Seat 9: mrhighryza folded before Flop (didn't bet)





PokerStars Hand #150802625497:  Hold'em No Limit ($1/$2 USD) - 2016/03/23 15:08:12 CET [2016/03/23 10:08:12 ET]
Table 'Clarissa II' 9-max Seat #2 is the button
Seat 1: DUkalisUA ($706.47 in chips) 
Seat 2: Igoriah ($202.24 in chips) 
Seat 3: PtizaXXX ($183.60 in chips) 
Seat 4: sanrs57 ($195 in chips) 
Seat 5: Red4erT ($86 in chips) 
Seat 6: matiko09 ($200 in chips) 
Seat 7: PacPacBum ($200 in chips) 
Seat 8: chaps1988 ($208.32 in chips) 
Seat 9: RamiroAgujis ($206 in chips) 
PtizaXXX: posts small blind $1
sanrs57: posts big blind $2
*** HOLE CARDS ***
Dealt to matiko09 [5d 3d]
Red4erT: folds 
matiko09: folds 
PacPacBum: folds 
chaps1988: folds 
RamiroAgujis: folds 
DUkalisUA: folds 
Igoriah: raises $2 to $4
PtizaXXX: folds 
sanrs57: folds 
Uncalled bet ($2) returned to Igoriah
Igoriah collected $5 from pot
Igoriah: doesn't show hand 
*** SUMMARY ***
Total pot $5 | Rake $0 
Seat 1: DUkalisUA folded before Flop (didn't bet)
Seat 2: Igoriah (button) collected ($5)
Seat 3: PtizaXXX (small blind) folded before Flop
Seat 4: sanrs57 (big blind) folded before Flop
Seat 5: Red4erT folded before Flop (didn't bet)
Seat 6: matiko09 folded before Flop (didn't bet)
Seat 7: PacPacBum folded before Flop (didn't bet)
Seat 8: chaps1988 folded before Flop (didn't bet)
Seat 9: RamiroAgujis folded before Flop (didn't bet)





PokerStars Hand #150802625745:  Hold'em No Limit ($0.50/$1.00 USD) - 2016/03/23 15:08:12 CET [2016/03/23 10:08:12 ET]
Table 'Sylvia III' 9-max Seat #2 is the button
Seat 1: mycka86 ($110.10 in chips) 
Seat 2: Dantist1122 ($100 in chips) 
Seat 3: se7en_$tars ($92.40 in chips) 
Seat 4: lombardo11 ($82.22 in chips) 
Seat 5: matiko09 ($103.49 in chips) 
Seat 6: PacPacBum ($100 in chips) 
Seat 7: easytalk777 ($96.73 in chips) 
Seat 8: nickreason17 ($114.69 in chips) 
Seat 9: Blanky-Bad ($94.17 in chips) 
se7en_$tars: posts small blind $0.50
lombardo11: posts big blind $1
mycka86: posts the ante $0.20
Dantist1122: posts the ante $0.20
se7en_$tars: posts the ante $0.20
lombardo11: posts the ante $0.20
matiko09: posts the ante $0.20
PacPacBum: posts the ante $0.20
easytalk777: posts the ante $0.20
nickreason17: posts the ante $0.20
Blanky-Bad: posts the ante $0.20
*** HOLE CARDS ***
Dealt to matiko09 [Qh 6h]
matiko09: folds 
PacPacBum: folds 
easytalk777: folds 
nickreason17: folds 
Blanky-Bad: folds 
mycka86: folds 
Dantist1122: folds 
se7en_$tars: raises $2 to $3
lombardo11: folds 
Uncalled bet ($2) returned to se7en_$tars
se7en_$tars collected $3.80 from pot
se7en_$tars: doesn't show hand 
*** SUMMARY ***
Total pot $3.80 | Rake $0 
Seat 1: mycka86 folded before Flop (didn't bet)
Seat 2: Dantist1122 (button) folded before Flop (didn't bet)
Seat 3: se7en_$tars (small blind) collected ($3.80)
Seat 4: lombardo11 (big blind) folded before Flop
Seat 5: matiko09 folded before Flop (didn't bet)
Seat 6: PacPacBum folded before Flop (didn't bet)
Seat 7: easytalk777 folded before Flop (didn't bet)
Seat 8: nickreason17 folded before Flop (didn't bet)
Seat 9: Blanky-Bad folded before Flop (didn't bet)





PokerStars Hand #150802631040:  Hold'em No Limit (€0.50/€1.00 EUR) - 2016/03/23 15:08:27 CET [2016/03/23 10:08:27 ET]
Table 'Mercury III' 9-max Seat #9 is the button
Seat 1: matiko09 (€114.08 in chips) 
Seat 2: o.miro (€124.17 in chips) 
Seat 3: PacPacBum (€102.33 in chips) 
Seat 4: Muinmyheart (€100 in chips) 
Seat 5: DUkalisUA (€100 in chips) 
Seat 6: mycka86 (€100 in chips) 
Seat 7: STrakDD (€100 in chips) 
Seat 8: gfxed (€34.34 in chips) 
Seat 9: Indr3k (€100 in chips) 
matiko09: posts small blind €0.50
o.miro: posts big blind €1
*** HOLE CARDS ***
Dealt to matiko09 [9d Tc]
PacPacBum: folds 
Muinmyheart: folds 
DUkalisUA: folds 
mycka86: folds 
STrakDD: folds 
gfxed: raises €1.23 to €2.23
Indr3k: folds 
matiko09: folds 
o.miro: folds 
Uncalled bet (€1.23) returned to gfxed
gfxed collected €2.50 from pot
*** SUMMARY ***
Total pot €2.50 | Rake €0 
Seat 1: matiko09 (small blind) folded before Flop
Seat 2: o.miro (big blind) folded before Flop
Seat 3: PacPacBum folded before Flop (didn't bet)
Seat 4: Muinmyheart folded before Flop (didn't bet)
Seat 5: DUkalisUA folded before Flop (didn't bet)
Seat 6: mycka86 folded before Flop (didn't bet)
Seat 7: STrakDD folded before Flop (didn't bet)
Seat 8: gfxed collected (€2.50)
Seat 9: Indr3k (button) folded before Flop (didn't bet)





PokerStars Hand #150802634144:  Hold'em No Limit ($1/$2 USD) - 2016/03/23 15:08:35 CET [2016/03/23 10:08:35 ET]
Table 'Kiess' 9-max Seat #4 is the button
Seat 1: Cirilico ($219.46 in chips) 
Seat 2: DUkalisUA ($702.28 in chips) 
Seat 3: Red4erT ($102.82 in chips) 
Seat 4: Igoriah ($204.64 in chips) 
Seat 6: matiko09 ($245.86 in chips) 
Seat 7: chaps1988 ($200 in chips) 
Seat 8: erfk1958 ($141.21 in chips) 
matiko09: posts small blind $1
chaps1988: posts big blind $2
PacPacBum: sits out 
*** HOLE CARDS ***
Dealt to matiko09 [7s 9c]
erfk1958: folds 
Cirilico: folds 
DUkalisUA: raises $4 to $6
Red4erT: folds 
Igoriah: folds 
matiko09: folds 
chaps1988: folds 
Uncalled bet ($4) returned to DUkalisUA
DUkalisUA collected $5 from pot
DUkalisUA: doesn't show hand 
*** SUMMARY ***
Total pot $5 | Rake $0 
Seat 1: Cirilico folded before Flop (didn't bet)
Seat 2: DUkalisUA collected ($5)
Seat 3: Red4erT folded before Flop (didn't bet)
Seat 4: Igoriah (button) folded before Flop (didn't bet)
Seat 6: matiko09 (small blind) folded before Flop
Seat 7: chaps1988 (big blind) folded before Flop
Seat 8: erfk1958 folded before Flop (didn't bet)





PokerStars Hand #150802634353:  Hold'em No Limit ($0.50/$1.00 USD) - 2016/03/23 15:08:36 CET [2016/03/23 10:08:36 ET]
Table 'Drakonia II' 9-max Seat #8 is the button
Seat 1: chautinhtri9 ($132.60 in chips) 
Seat 2: carrsseis ($100 in chips) 
Seat 3: dunga119 ($103.78 in chips) 
Seat 4: nickreason17 ($113.72 in chips) 
Seat 5: gchs83 ($55.61 in chips) 
Seat 6: Dantist1122 ($100 in chips) 
Seat 7: YuriiSolodya ($27.90 in chips) 
Seat 8: matiko09 ($100 in chips) 
Seat 9: mycka86 ($100 in chips) 
mycka86: posts small blind $0.50
chautinhtri9: posts big blind $1
*** HOLE CARDS ***
Dealt to matiko09 [3h 4h]
carrsseis: raises $1.20 to $2.20
dunga119: calls $2.20
nickreason17: folds 
gchs83: folds 
Dantist1122: folds 
YuriiSolodya: folds 
matiko09: folds 
mycka86: folds 
chautinhtri9: folds 
*** FLOP *** [Jh 6c Ts]
carrsseis: bets $3.50
dunga119: calls $3.50
*** TURN *** [Jh 6c Ts] [2d]
carrsseis: bets $25
dunga119: folds 
Uncalled bet ($25) returned to carrsseis
carrsseis collected $12.32 from pot
carrsseis: doesn't show hand 
*** SUMMARY ***
Total pot $12.90 | Rake $0.58 
Board [Jh 6c Ts 2d]
Seat 1: chautinhtri9 (big blind) folded before Flop
Seat 2: carrsseis collected ($12.32)
Seat 3: dunga119 folded on the Turn
Seat 4: nickreason17 folded before Flop (didn't bet)
Seat 5: gchs83 folded before Flop (didn't bet)
Seat 6: Dantist1122 folded before Flop (didn't bet)
Seat 7: YuriiSolodya folded before Flop (didn't bet)
Seat 8: matiko09 (button) folded before Flop (didn't bet)
Seat 9: mycka86 (small blind) folded before Flop





PokerStars Hand #150802634810:  Hold'em No Limit ($1/$2 USD) - 2016/03/23 15:08:37 CET [2016/03/23 10:08:37 ET]
Table 'Herba II' 9-max Seat #4 is the button
Seat 1: matiko09 ($287.38 in chips) 
Seat 2: nickreason17 ($212.76 in chips) 
Seat 3: Cirilico ($199 in chips) 
Seat 4: DUkalisUA ($380.40 in chips) 
Seat 7: Igoriah ($200 in chips) 
Seat 9: mrhighryza ($81.19 in chips) 
Igoriah: posts small blind $1
T0ny Adams: is sitting out 
mrhighryza: posts big blind $2
*** HOLE CARDS ***
Dealt to matiko09 [2d Ad]
matiko09: raises $3 to $5
nickreason17: folds 
Cirilico: folds 
DUkalisUA: folds 
Igoriah: folds 
mrhighryza: calls $3
*** FLOP *** [5d 5c Jc]
mrhighryza: checks 
matiko09: bets $6.83
mrhighryza: folds 
Uncalled bet ($6.83) returned to matiko09
matiko09 collected $10.50 from pot
matiko09: doesn't show hand 
*** SUMMARY ***
Total pot $11 | Rake $0.50 
Board [5d 5c Jc]
Seat 1: matiko09 collected ($10.50)
Seat 2: nickreason17 folded before Flop (didn't bet)
Seat 3: Cirilico folded before Flop (didn't bet)
Seat 4: DUkalisUA (button) folded before Flop (didn't bet)
Seat 7: Igoriah (small blind) folded before Flop
Seat 9: mrhighryza (big blind) folded on the Flop





PokerStars Hand #150802635536:  Hold'em No Limit ($1/$2 USD) - 2016/03/23 15:08:39 CET [2016/03/23 10:08:39 ET]
Table 'Achaia' 9-max Seat #8 is the button
Seat 1: RamiroAgujis ($233.57 in chips) 
Seat 2: bananajoe001 ($216.49 in chips) 
Seat 3: matiko09 ($223.16 in chips) 
Seat 4: erfk1958 ($87 in chips) 
Seat 5: chaps1988 ($200 in chips) 
Seat 6: nickreason17 ($241.44 in chips) 
Seat 7: morosun ($244.92 in chips) 
Seat 8: IseeUcards ($208.86 in chips) 
Seat 9: PacPacBum ($205.35 in chips) 
PacPacBum: posts small blind $1
RamiroAgujis: posts big blind $2
morosun: posts small & big blinds $3
*** HOLE CARDS ***
Dealt to matiko09 [5d Kd]
bananajoe001: folds 
matiko09: folds 
erfk1958: folds 
chaps1988: raises $4 to $6
nickreason17: folds 
morosun: calls $4
IseeUcards: folds 
PacPacBum: folds 
RamiroAgujis: folds 
*** FLOP *** [2h 8d Ad]
chaps1988: bets $6
morosun: folds 
Uncalled bet ($6) returned to chaps1988
chaps1988 collected $15.28 from pot
chaps1988: doesn't show hand 
*** SUMMARY ***
Total pot $16 | Rake $0.72 
Board [2h 8d Ad]
Seat 1: RamiroAgujis (big blind) folded before Flop
Seat 2: bananajoe001 folded before Flop (didn't bet)
Seat 3: matiko09 folded before Flop (didn't bet)
Seat 4: erfk1958 folded before Flop (didn't bet)
Seat 5: chaps1988 collected ($15.28)
Seat 6: nickreason17 folded before Flop (didn't bet)
Seat 7: morosun folded on the Flop
Seat 8: IseeUcards (button) folded before Flop (didn't bet)
Seat 9: PacPacBum (small blind) folded before Flop





PokerStars Hand #150802638957:  Hold'em No Limit ($0.50/$1.00 USD) - 2016/03/23 15:08:48 CET [2016/03/23 10:08:48 ET]
Table 'Swings' 9-max Seat #9 is the button
Seat 1: carrsseis ($102.30 in chips) 
Seat 4: chaps1988 ($100 in chips) 
Seat 5: chautinhtri9 ($110.45 in chips) 
Seat 6: matiko09 ($139.42 in chips) 
Seat 7: PacPacBum ($111.22 in chips) 
Seat 8: RICKA16 ($98.96 in chips) 
Seat 9: Vlad_1965_77 ($120.01 in chips) 
carrsseis: posts small blind $0.50
maxxmeister: is sitting out 
chaps1988: posts big blind $1
*** HOLE CARDS ***
Dealt to matiko09 [2c 3c]
chautinhtri9: folds 
matiko09: folds 
PacPacBum: folds 
RICKA16: raises $2 to $3
Vlad_1965_77: folds 
carrsseis: folds 
chaps1988: folds 
Uncalled bet ($2) returned to RICKA16
RICKA16 collected $2.50 from pot
RICKA16: doesn't show hand 
*** SUMMARY ***
Total pot $2.50 | Rake $0 
Seat 1: carrsseis (small blind) folded before Flop
Seat 4: chaps1988 (big blind) folded before Flop
Seat 5: chautinhtri9 folded before Flop (didn't bet)
Seat 6: matiko09 folded before Flop (didn't bet)
Seat 7: PacPacBum folded before Flop (didn't bet)
Seat 8: RICKA16 collected ($2.50)
Seat 9: Vlad_1965_77 (button) folded before Flop (didn't bet)





PokerStars Hand #150802638756:  Hold'em No Limit ($0.50/$1.00 USD) - 2016/03/23 15:08:48 CET [2016/03/23 10:08:48 ET]
Table 'Sylvia III' 9-max Seat #3 is the button
Seat 1: mycka86 ($109.90 in chips) 
Seat 2: Dantist1122 ($100 in chips) 
Seat 3: se7en_$tars ($95 in chips) 
Seat 4: lombardo11 ($81.02 in chips) 
Seat 5: matiko09 ($103.29 in chips) 
Seat 6: PacPacBum ($100 in chips) 
Seat 7: easytalk777 ($96.53 in chips) 
Seat 8: nickreason17 ($114.49 in chips) 
Seat 9: Blanky-Bad ($93.97 in chips) 
lombardo11: posts small blind $0.50
matiko09: posts big blind $1
mycka86: posts the ante $0.20
Dantist1122: posts the ante $0.20
se7en_$tars: posts the ante $0.20
lombardo11: posts the ante $0.20
matiko09: posts the ante $0.20
PacPacBum: posts the ante $0.20
easytalk777: posts the ante $0.20
nickreason17: posts the ante $0.20
Blanky-Bad: posts the ante $0.20
*** HOLE CARDS ***
Dealt to matiko09 [As 9d]
PacPacBum: folds 
easytalk777: folds 
nickreason17: folds 
Blanky-Bad: folds 
mycka86: folds 
Dantist1122: raises $1.70 to $2.70
se7en_$tars: folds 
lombardo11: folds 
matiko09: folds 
Uncalled bet ($1.70) returned to Dantist1122
Dantist1122 collected $4.30 from pot
Dantist1122: doesn't show hand 
*** SUMMARY ***
Total pot $4.30 | Rake $0 
Seat 1: mycka86 folded before Flop (didn't bet)
Seat 2: Dantist1122 collected ($4.30)
Seat 3: se7en_$tars (button) folded before Flop (didn't bet)
Seat 4: lombardo11 (small blind) folded before Flop
Seat 5: matiko09 (big blind) folded before Flop
Seat 6: PacPacBum folded before Flop (didn't bet)
Seat 7: easytalk777 folded before Flop (didn't bet)
Seat 8: nickreason17 folded before Flop (didn't bet)
Seat 9: Blanky-Bad folded before Flop (didn't bet)





PokerStars Hand #150802639544:  Hold'em No Limit ($0.50/$1.00 USD) - 2016/03/23 15:08:50 CET [2016/03/23 10:08:50 ET]
Table 'Smiley' 9-max Seat #9 is the button
Seat 1: xHourglass ($100 in chips) 
Seat 2: Jimy Tiltman ($126.01 in chips) 
Seat 3: Robert201202 ($106.57 in chips) 
Seat 4: CAJUN890 ($79.79 in chips) 
Seat 5: Szevasztopol ($100 in chips) 
Seat 6: blackmont111 ($152.54 in chips) 
Seat 7: nickreason17 ($100 in chips) 
Seat 8: matiko09 ($100 in chips) 
Seat 9: Pvsx. ($237.14 in chips) 
xHourglass: posts small blind $0.50
Jimy Tiltman: posts big blind $1
*** HOLE CARDS ***
Dealt to matiko09 [7d Jc]
Robert201202: folds 
CAJUN890: calls $1
Szevasztopol: folds 
blackmont111: folds 
nickreason17: folds 
matiko09: folds 
Pvsx.: folds 
xHourglass: calls $0.50
Jimy Tiltman: checks 
*** FLOP *** [4s Jh Qh]
xHourglass: checks 
Jimy Tiltman: checks 
CAJUN890: bets $2.86
xHourglass: raises $3.64 to $6.50
Jimy Tiltman: folds 
CAJUN890: calls $3.64
*** TURN *** [4s Jh Qh] [2d]
xHourglass: checks 
CAJUN890: checks 
*** RIVER *** [4s Jh Qh 2d] [6c]
xHourglass: bets $9.50
CAJUN890: calls $9.50
*** SHOW DOWN ***
xHourglass: shows [Ac 4h] (a pair of Fours)
CAJUN890: shows [Kd Js] (a pair of Jacks)
CAJUN890 collected $33.42 from pot
*** SUMMARY ***
Total pot $35 | Rake $1.58 
Board [4s Jh Qh 2d 6c]
Seat 1: xHourglass (small blind) showed [Ac 4h] and lost with a pair of Fours
Seat 2: Jimy Tiltman (big blind) folded on the Flop
Seat 3: Robert201202 folded before Flop (didn't bet)
Seat 4: CAJUN890 showed [Kd Js] and won ($33.42) with a pair of Jacks
Seat 5: Szevasztopol folded before Flop (didn't bet)
Seat 6: blackmont111 folded before Flop (didn't bet)
Seat 7: nickreason17 folded before Flop (didn't bet)
Seat 8: matiko09 folded before Flop (didn't bet)
Seat 9: Pvsx. (button) folded before Flop (didn't bet)





PokerStars Hand #150802640353:  Hold'em No Limit ($0.25/$0.50 USD) - 2016/03/23 15:08:52 CET [2016/03/23 10:08:52 ET]
Table 'Pyrrhus' 9-max Seat #3 is the button
Seat 1: lumen21 ($84.33 in chips) 
Seat 2: BSTUSim ($61.62 in chips) 
Seat 3: Muinmyheart ($50 in chips) 
Seat 4: GriffinBerg ($51.54 in chips) 
Seat 5: xxxibgdrgn ($50 in chips) 
Seat 6: Ahangama ($50 in chips) 
Seat 7: matiko09 ($136 in chips) 
Seat 8: suitedaces02 ($50 in chips) 
Seat 9: CvMCvMCvM ($89.05 in chips) 
GriffinBerg: posts small blind $0.25
xxxibgdrgn: posts big blind $0.50
*** HOLE CARDS ***
Dealt to matiko09 [5c Ts]
Ahangama: folds 
matiko09: folds 
suitedaces02: folds 
CvMCvMCvM: folds 
lumen21: folds 
BSTUSim: folds 
Muinmyheart: folds 
GriffinBerg: raises $1 to $1.50
xxxibgdrgn: calls $1
*** FLOP *** [5d 8c 6s]
GriffinBerg: bets $1.43
xxxibgdrgn: calls $1.43
*** TURN *** [5d 8c 6s] [5s]
GriffinBerg: checks 
xxxibgdrgn: bets $4
GriffinBerg: calls $4
*** RIVER *** [5d 8c 6s 5s] [3s]
GriffinBerg: bets $6.62
xxxibgdrgn: calls $6.62
*** SHOW DOWN ***
GriffinBerg: shows [Kd 7h] (a pair of Fives)
xxxibgdrgn: shows [Qc 8s] (two pair, Eights and Fives)
xxxibgdrgn collected $25.88 from pot
*** SUMMARY ***
Total pot $27.10 | Rake $1.22 
Board [5d 8c 6s 5s 3s]
Seat 1: lumen21 folded before Flop (didn't bet)
Seat 2: BSTUSim folded before Flop (didn't bet)
Seat 3: Muinmyheart (button) folded before Flop (didn't bet)
Seat 4: GriffinBerg (small blind) showed [Kd 7h] and lost with a pair of Fives
Seat 5: xxxibgdrgn (big blind) showed [Qc 8s] and won ($25.88) with two pair, Eights and Fives
Seat 6: Ahangama folded before Flop (didn't bet)
Seat 7: matiko09 folded before Flop (didn't bet)
Seat 8: suitedaces02 folded before Flop (didn't bet)
Seat 9: CvMCvMCvM folded before Flop (didn't bet)





PokerStars Hand #150802641207:  Hold'em No Limit ($1/$2 USD) - 2016/03/23 15:08:55 CET [2016/03/23 10:08:55 ET]
Table 'Kypria II' 9-max Seat #8 is the button
Seat 1: chaps1988 ($200 in chips) 
Seat 3: seouljam ($302.58 in chips) 
Seat 4: VolanDog ($217.72 in chips) 
Seat 5: Igoriah ($208 in chips) 
Seat 6: matiko09 ($447.25 in chips) 
Seat 7: DUkalisUA ($203 in chips) 
Seat 8: nickreason17 ($203.37 in chips) 
Seat 9: sanrs57 ($161.30 in chips) 
sanrs57: posts small blind $1
chaps1988: posts big blind $2
PacPacBum: sits out 
*** HOLE CARDS ***
Dealt to matiko09 [Qs Jc]
seouljam: folds 
VolanDog: folds 
Igoriah: raises $3 to $5
matiko09: folds 
DUkalisUA: folds 
nickreason17: folds 
sanrs57: folds 
chaps1988: calls $3
*** FLOP *** [9d Ad 2d]
chaps1988: checks 
Igoriah: bets $7
chaps1988: raises $15 to $22
Igoriah: folds 
Uncalled bet ($15) returned to chaps1988
chaps1988 collected $23.88 from pot
chaps1988: doesn't show hand 
*** SUMMARY ***
Total pot $25 | Rake $1.12 
Board [9d Ad 2d]
Seat 1: chaps1988 (big blind) collected ($23.88)
Seat 3: seouljam folded before Flop (didn't bet)
Seat 4: VolanDog folded before Flop (didn't bet)
Seat 5: Igoriah folded on the Flop
Seat 6: matiko09 folded before Flop (didn't bet)
Seat 7: DUkalisUA folded before Flop (didn't bet)
Seat 8: nickreason17 (button) folded before Flop (didn't bet)
Seat 9: sanrs57 (small blind) folded before Flop





PokerStars Hand #150802642043:  Hold'em No Limit ($0.50/$1.00 USD) - 2016/03/23 15:08:57 CET [2016/03/23 10:08:57 ET]
Table 'Asmodeus' 9-max Seat #7 is the button
Seat 1: Jimy Tiltman ($128.17 in chips) 
Seat 2: PacPacBum ($107.13 in chips) 
Seat 3: nickreason17 ($100 in chips) 
Seat 4: Effort92 ($100 in chips) 
Seat 5: Muinmyheart ($100 in chips) 
Seat 6: fuppeee ($77.86 in chips) 
Seat 7: mycka86 ($113.95 in chips) 
Seat 8: bonifacioppl ($93.65 in chips) 
Seat 9: matiko09 ($100.20 in chips) 
bonifacioppl: posts small blind $0.50
matiko09: posts big blind $1
Jimy Tiltman: posts the ante $0.20
PacPacBum: posts the ante $0.20
nickreason17: posts the ante $0.20
Effort92: posts the ante $0.20
Muinmyheart: posts the ante $0.20
fuppeee: posts the ante $0.20
mycka86: posts the ante $0.20
bonifacioppl: posts the ante $0.20
matiko09: posts the ante $0.20
*** HOLE CARDS ***
Dealt to matiko09 [As 2h]
Jimy Tiltman: folds 
PacPacBum: folds 
nickreason17: folds 
Effort92: folds 
Muinmyheart: folds 
fuppeee: folds 
mycka86: raises $2 to $3
bonifacioppl: raises $4 to $7
matiko09: folds 
mycka86: calls $4
*** FLOP *** [Td Qs 8c]
bonifacioppl: checks 
mycka86: checks 
*** TURN *** [Td Qs 8c] [9h]
bonifacioppl: bets $8.98
mycka86: raises $15.22 to $24.20
bonifacioppl: calls $15.22
*** RIVER *** [Td Qs 8c 9h] [4s]
bonifacioppl: checks 
mycka86: bets $34.32
bonifacioppl: folds 
Uncalled bet ($34.32) returned to mycka86
mycka86 collected $62.40 from pot
*** SUMMARY ***
Total pot $65.20 | Rake $2.80 
Board [Td Qs 8c 9h 4s]
Seat 1: Jimy Tiltman folded before Flop (didn't bet)
Seat 2: PacPacBum folded before Flop (didn't bet)
Seat 3: nickreason17 folded before Flop (didn't bet)
Seat 4: Effort92 folded before Flop (didn't bet)
Seat 5: Muinmyheart folded before Flop (didn't bet)
Seat 6: fuppeee folded before Flop (didn't bet)
Seat 7: mycka86 (button) collected ($62.40)
Seat 8: bonifacioppl (small blind) folded on the River
Seat 9: matiko09 (big blind) folded before Flop





PokerStars Hand #150802641987:  Hold'em No Limit ($1/$2 USD) - 2016/03/23 15:08:57 CET [2016/03/23 10:08:57 ET]
Table 'Clarissa II' 9-max Seat #3 is the button
Seat 1: DUkalisUA ($706.47 in chips) 
Seat 2: Igoriah ($205.24 in chips) 
Seat 3: PtizaXXX ($182.60 in chips) 
Seat 4: sanrs57 ($193 in chips) 
Seat 5: Red4erT ($86 in chips) 
Seat 6: matiko09 ($200 in chips) 
Seat 7: PacPacBum ($200 in chips) 
Seat 8: chaps1988 ($208.32 in chips) 
Seat 9: RamiroAgujis ($206 in chips) 
sanrs57: posts small blind $1
Red4erT: posts big blind $2
*** HOLE CARDS ***
Dealt to matiko09 [Tc Ks]
matiko09: folds 
PacPacBum: folds 
chaps1988: folds 
RamiroAgujis: folds 
DUkalisUA: raises $4 to $6
Igoriah: folds 
PtizaXXX: folds 
sanrs57: folds 
Red4erT: folds 
Uncalled bet ($4) returned to DUkalisUA
DUkalisUA collected $5 from pot
DUkalisUA: doesn't show hand 
*** SUMMARY ***
Total pot $5 | Rake $0 
Seat 1: DUkalisUA collected ($5)
Seat 2: Igoriah folded before Flop (didn't bet)
Seat 3: PtizaXXX (button) folded before Flop (didn't bet)
Seat 4: sanrs57 (small blind) folded before Flop
Seat 5: Red4erT (big blind) folded before Flop
Seat 6: matiko09 folded before Flop (didn't bet)
Seat 7: PacPacBum folded before Flop (didn't bet)
Seat 8: chaps1988 folded before Flop (didn't bet)
Seat 9: RamiroAgujis folded before Flop (didn't bet)





PokerStars Hand #150802645705:  Hold'em No Limit ($1/$2 USD) - 2016/03/23 15:09:07 CET [2016/03/23 10:09:07 ET]
Table 'Kiess' 9-max Seat #6 is the button
Seat 1: Cirilico ($219.46 in chips) 
Seat 2: DUkalisUA ($705.28 in chips) 
Seat 3: Red4erT ($102.82 in chips) 
Seat 4: Igoriah ($204.64 in chips) 
Seat 6: matiko09 ($244.86 in chips) 
Seat 7: chaps1988 ($200 in chips) 
Seat 8: erfk1958 ($141.21 in chips) 
chaps1988: posts small blind $1
erfk1958: posts big blind $2
PacPacBum: sits out 
*** HOLE CARDS ***
Dealt to matiko09 [As 9s]
Cirilico: folds 
DUkalisUA: folds 
Red4erT: folds 
Igoriah: raises $3 to $5
matiko09: raises $11 to $16
chaps1988: folds 
erfk1958: folds 
Igoriah: calls $11
*** FLOP *** [Kh 2h 2s]
Igoriah: checks 
matiko09: bets $16
Igoriah: folds 
Uncalled bet ($16) returned to matiko09
matiko09 collected $33.42 from pot
matiko09: doesn't show hand 
*** SUMMARY ***
Total pot $35 | Rake $1.58 
Board [Kh 2h 2s]
Seat 1: Cirilico folded before Flop (didn't bet)
Seat 2: DUkalisUA folded before Flop (didn't bet)
Seat 3: Red4erT folded before Flop (didn't bet)
Seat 4: Igoriah folded on the Flop
Seat 6: matiko09 (button) collected ($33.42)
Seat 7: chaps1988 (small blind) folded before Flop
Seat 8: erfk1958 (big blind) folded before Flop





PokerStars Hand #150802647146:  Hold'em No Limit ($1/$2 USD) - 2016/03/23 15:09:11 CET [2016/03/23 10:09:11 ET]
Table 'Herba II' 9-max Seat #7 is the button
Seat 1: matiko09 ($292.88 in chips) 
Seat 2: nickreason17 ($212.76 in chips) 
Seat 3: Cirilico ($199 in chips) 
Seat 4: DUkalisUA ($380.40 in chips) 
Seat 7: Igoriah ($200 in chips) 
Seat 9: mrhighryza ($76.19 in chips) 
mrhighryza: posts small blind $1
matiko09: posts big blind $2
*** HOLE CARDS ***
Dealt to matiko09 [9h 6d]
nickreason17: folds 
Cirilico: folds 
DUkalisUA: folds 
Igoriah: raises $2 to $4
mrhighryza: raises $8 to $12
matiko09: folds 
Igoriah: calls $8
*** FLOP *** [8d Kd 5d]
mrhighryza: bets $8
Igoriah: calls $8
*** TURN *** [8d Kd 5d] [Kc]
mrhighryza: checks 
Igoriah: bets $17
mrhighryza: raises $23 to $40
Igoriah: raises $23 to $63
mrhighryza: calls $16.19 and is all-in
Uncalled bet ($6.81) returned to Igoriah
*** FIRST RIVER *** [8d Kd 5d Kc] [Td]
*** SECOND RIVER *** [8d Kd 5d Kc] [3s]
*** FIRST SHOW DOWN ***
mrhighryza: shows [Ks Ad] (a flush, Ace high)
Igoriah: shows [5s 5h] (a full house, Fives full of Kings)
Igoriah collected $75.79 from pot
*** SECOND SHOW DOWN ***
mrhighryza: shows [Ks Ad] (three of a kind, Kings)
Igoriah: shows [5s 5h] (a full house, Fives full of Kings)
Igoriah collected $75.79 from pot
*** SUMMARY ***
Total pot $154.38 | Rake $2.80 
Hand was run twice
FIRST Board [8d Kd 5d Kc Td]
SECOND Board [8d Kd 5d Kc 3s]
Seat 1: matiko09 (big blind) folded before Flop
Seat 2: nickreason17 folded before Flop (didn't bet)
Seat 3: Cirilico folded before Flop (didn't bet)
Seat 4: DUkalisUA folded before Flop (didn't bet)
Seat 7: Igoriah (button) showed [5s 5h] and won ($75.79) with a full house, Fives full of Kings, and won ($75.79) with a full house, Fives full of Kings
Seat 9: mrhighryza (small blind) showed [Ks Ad] and lost with a flush, Ace high, and lost with three of a kind, Kings





PokerStars Hand #150802648093:  Hold'em No Limit ($0.50/$1.00 USD) - 2016/03/23 15:09:13 CET [2016/03/23 10:09:13 ET]
Table 'Swings' 9-max Seat #1 is the button
Seat 1: carrsseis ($101.80 in chips) 
Seat 4: chaps1988 ($100 in chips) 
Seat 5: chautinhtri9 ($110.45 in chips) 
Seat 6: matiko09 ($139.42 in chips) 
Seat 7: PacPacBum ($111.22 in chips) 
Seat 8: RICKA16 ($100.46 in chips) 
Seat 9: Vlad_1965_77 ($120.01 in chips) 
chaps1988: posts small blind $0.50
chautinhtri9: posts big blind $1
*** HOLE CARDS ***
Dealt to matiko09 [Qc Qh]
matiko09: raises $2 to $3
PacPacBum: folds 
RICKA16: folds 
Vlad_1965_77: folds 
carrsseis: folds 
chaps1988: folds 
chautinhtri9: folds 
Uncalled bet ($2) returned to matiko09
matiko09 collected $2.50 from pot
matiko09: doesn't show hand 
*** SUMMARY ***
Total pot $2.50 | Rake $0 
Seat 1: carrsseis (button) folded before Flop (didn't bet)
Seat 4: chaps1988 (small blind) folded before Flop
Seat 5: chautinhtri9 (big blind) folded before Flop
Seat 6: matiko09 collected ($2.50)
Seat 7: PacPacBum folded before Flop (didn't bet)
Seat 8: RICKA16 folded before Flop (didn't bet)
Seat 9: Vlad_1965_77 folded before Flop (didn't bet)





PokerStars Hand #150802648287:  Hold'em No Limit ($0.50/$1.00 USD) - 2016/03/23 15:09:14 CET [2016/03/23 10:09:14 ET]
Table 'Sylvia III' 9-max Seat #4 is the button
Seat 1: mycka86 ($109.70 in chips) 
Seat 2: Dantist1122 ($103.10 in chips) 
Seat 3: se7en_$tars ($94.80 in chips) 
Seat 4: lombardo11 ($80.32 in chips) 
Seat 5: matiko09 ($102.09 in chips) 
Seat 6: PacPacBum ($100 in chips) 
Seat 7: easytalk777 ($96.33 in chips) 
Seat 8: nickreason17 ($114.29 in chips) 
Seat 9: Blanky-Bad ($93.77 in chips) 
matiko09: posts small blind $0.50
PacPacBum: posts big blind $1
mycka86: posts the ante $0.20
Dantist1122: posts the ante $0.20
se7en_$tars: posts the ante $0.20
lombardo11: posts the ante $0.20
matiko09: posts the ante $0.20
PacPacBum: posts the ante $0.20
easytalk777: posts the ante $0.20
nickreason17: posts the ante $0.20
Blanky-Bad: posts the ante $0.20
*** HOLE CARDS ***
Dealt to matiko09 [7c Ac]
easytalk777: folds 
nickreason17: folds 
Blanky-Bad: folds 
mycka86: folds 
Dantist1122: folds 
se7en_$tars: folds 
lombardo11: raises $1 to $2
matiko09: folds 
PacPacBum: folds 
Uncalled bet ($1) returned to lombardo11
lombardo11 collected $4.30 from pot
lombardo11: doesn't show hand 
*** SUMMARY ***
Total pot $4.30 | Rake $0 
Seat 1: mycka86 folded before Flop (didn't bet)
Seat 2: Dantist1122 folded before Flop (didn't bet)
Seat 3: se7en_$tars folded before Flop (didn't bet)
Seat 4: lombardo11 (button) collected ($4.30)
Seat 5: matiko09 (small blind) folded before Flop
Seat 6: PacPacBum (big blind) folded before Flop
Seat 7: easytalk777 folded before Flop (didn't bet)
Seat 8: nickreason17 folded before Flop (didn't bet)
Seat 9: Blanky-Bad folded before Flop (didn't bet)





PokerStars Hand #150802650738:  Hold'em No Limit (€0.50/€1.00 EUR) - 2016/03/23 15:09:20 CET [2016/03/23 10:09:20 ET]
Table 'Mercury III' 9-max Seat #1 is the button
Seat 1: matiko09 (€113.58 in chips) 
Seat 2: o.miro (€123.17 in chips) 
Seat 3: PacPacBum (€102.33 in chips) 
Seat 4: Muinmyheart (€100 in chips) 
Seat 5: DUkalisUA (€100 in chips) 
Seat 6: mycka86 (€100 in chips) 
Seat 7: STrakDD (€100 in chips) 
Seat 8: gfxed (€35.84 in chips) 
Seat 9: Indr3k (€100 in chips) 
o.miro: posts small blind €0.50
PacPacBum: posts big blind €1
*** HOLE CARDS ***
Dealt to matiko09 [6c 4h]
Muinmyheart: raises €2 to €3
DUkalisUA: folds 
mycka86: folds 
STrakDD: folds 
gfxed: folds 
Indr3k: folds 
matiko09: folds 
o.miro: folds 
PacPacBum: folds 
Uncalled bet (€2) returned to Muinmyheart
Muinmyheart collected €2.50 from pot
Muinmyheart: doesn't show hand 
*** SUMMARY ***
Total pot €2.50 | Rake €0 
Seat 1: matiko09 (button) folded before Flop (didn't bet)
Seat 2: o.miro (small blind) folded before Flop
Seat 3: PacPacBum (big blind) folded before Flop
Seat 4: Muinmyheart collected (€2.50)
Seat 5: DUkalisUA folded before Flop (didn't bet)
Seat 6: mycka86 folded before Flop (didn't bet)
Seat 7: STrakDD folded before Flop (didn't bet)
Seat 8: gfxed folded before Flop (didn't bet)
Seat 9: Indr3k folded before Flop (didn't bet)





PokerStars Hand #150802654097:  Hold'em No Limit ($1/$2 USD) - 2016/03/23 15:09:30 CET [2016/03/23 10:09:30 ET]
Table 'Achaia' 9-max Seat #9 is the button
Seat 1: RamiroAgujis ($231.57 in chips) 
Seat 2: bananajoe001 ($216.49 in chips) 
Seat 3: matiko09 ($223.16 in chips) 
Seat 4: erfk1958 ($87 in chips) 
Seat 5: chaps1988 ($209.28 in chips) 
Seat 6: nickreason17 ($241.44 in chips) 
Seat 7: morosun ($237.92 in chips) 
Seat 8: IseeUcards ($208.86 in chips) 
Seat 9: PacPacBum ($204.35 in chips) 
RamiroAgujis: posts small blind $1
bananajoe001: posts big blind $2
*** HOLE CARDS ***
Dealt to matiko09 [Ad Jh]
matiko09: raises $3 to $5
erfk1958: folds 
chaps1988: folds 
nickreason17: folds 
morosun: folds 
IseeUcards: folds 
PacPacBum: folds 
RamiroAgujis: folds 
bananajoe001: calls $3
*** FLOP *** [5s Qs 5d]
bananajoe001: checks 
matiko09: checks 
*** TURN *** [5s Qs 5d] [7h]
bananajoe001: checks 
matiko09: checks 
*** RIVER *** [5s Qs 5d 7h] [9c]
bananajoe001: bets $2
matiko09: calls $2
*** SHOW DOWN ***
bananajoe001: shows [8d 9s] (two pair, Nines and Fives)
matiko09: mucks hand 
bananajoe001 collected $14.32 from pot
*** SUMMARY ***
Total pot $15 | Rake $0.68 
Board [5s Qs 5d 7h 9c]
Seat 1: RamiroAgujis (small blind) folded before Flop
Seat 2: bananajoe001 (big blind) showed [8d 9s] and won ($14.32) with two pair, Nines and Fives
Seat 3: matiko09 mucked [Ad Jh]
Seat 4: erfk1958 folded before Flop (didn't bet)
Seat 5: chaps1988 folded before Flop (didn't bet)
Seat 6: nickreason17 folded before Flop (didn't bet)
Seat 7: morosun folded before Flop (didn't bet)
Seat 8: IseeUcards folded before Flop (didn't bet)
Seat 9: PacPacBum (button) folded before Flop (didn't bet)





PokerStars Hand #150802657787:  Hold'em No Limit ($0.50/$1.00 USD) - 2016/03/23 15:09:40 CET [2016/03/23 10:09:40 ET]
Table 'Swings' 9-max Seat #4 is the button
Seat 1: carrsseis ($101.80 in chips) 
Seat 4: chaps1988 ($100 in chips) 
Seat 5: chautinhtri9 ($109.45 in chips) 
Seat 6: matiko09 ($140.92 in chips) 
Seat 7: PacPacBum ($111.22 in chips) 
Seat 8: RICKA16 ($100.46 in chips) 
Seat 9: Vlad_1965_77 ($120.01 in chips) 
chautinhtri9: posts small blind $0.50
matiko09: posts big blind $1
*** HOLE CARDS ***
Dealt to matiko09 [Jd 9d]
PacPacBum: folds 
RICKA16: folds 
Vlad_1965_77: folds 
carrsseis: folds 
chaps1988: folds 
chautinhtri9: folds 
Uncalled bet ($0.50) returned to matiko09
matiko09 collected $1 from pot
matiko09: doesn't show hand 
*** SUMMARY ***
Total pot $1 | Rake $0 
Seat 1: carrsseis folded before Flop (didn't bet)
Seat 4: chaps1988 (button) folded before Flop (didn't bet)
Seat 5: chautinhtri9 (small blind) folded before Flop
Seat 6: matiko09 (big blind) collected ($1)
Seat 7: PacPacBum folded before Flop (didn't bet)
Seat 8: RICKA16 folded before Flop (didn't bet)
Seat 9: Vlad_1965_77 folded before Flop (didn't bet)





PokerStars Hand #150802658539:  Hold'em No Limit ($0.50/$1.00 USD) - 2016/03/23 15:09:42 CET [2016/03/23 10:09:42 ET]
Table 'Smiley' 9-max Seat #1 is the button
Seat 1: xHourglass ($100 in chips) 
Seat 2: Jimy Tiltman ($125.01 in chips) 
Seat 3: Robert201202 ($106.57 in chips) 
Seat 4: CAJUN890 ($96.21 in chips) 
Seat 5: Szevasztopol ($100 in chips) 
Seat 6: blackmont111 ($152.54 in chips) 
Seat 7: nickreason17 ($100 in chips) 
Seat 8: matiko09 ($100 in chips) 
Seat 9: Pvsx. ($237.14 in chips) 
Jimy Tiltman: posts small blind $0.50
Robert201202: posts big blind $1
*** HOLE CARDS ***
Dealt to matiko09 [2h Ts]
CAJUN890: folds 
Szevasztopol: folds 
blackmont111: folds 
nickreason17: folds 
matiko09: folds 
Pvsx.: folds 
xHourglass: folds 
Jimy Tiltman: raises $2 to $3
Robert201202: calls $2
*** FLOP *** [Tc 4d 5h]
Jimy Tiltman: bets $3.50
Robert201202: raises $6.50 to $10
Jimy Tiltman: calls $6.50
*** TURN *** [Tc 4d 5h] [2c]
Jimy Tiltman: checks 
Robert201202: checks 
*** RIVER *** [Tc 4d 5h 2c] [5s]
Jimy Tiltman: checks 
Robert201202: checks 
*** SHOW DOWN ***
Jimy Tiltman: shows [8h 7h] (a pair of Fives)
Robert201202: shows [Ad 7c] (a pair of Fives - Ace kicker)
Robert201202 collected $24.83 from pot
*** SUMMARY ***
Total pot $26 | Rake $1.17 
Board [Tc 4d 5h 2c 5s]
Seat 1: xHourglass (button) folded before Flop (didn't bet)
Seat 2: Jimy Tiltman (small blind) showed [8h 7h] and lost with a pair of Fives
Seat 3: Robert201202 (big blind) showed [Ad 7c] and won ($24.83) with a pair of Fives
Seat 4: CAJUN890 folded before Flop (didn't bet)
Seat 5: Szevasztopol folded before Flop (didn't bet)
Seat 6: blackmont111 folded before Flop (didn't bet)
Seat 7: nickreason17 folded before Flop (didn't bet)
Seat 8: matiko09 folded before Flop (didn't bet)
Seat 9: Pvsx. folded before Flop (didn't bet)





PokerStars Hand #150802658661:  Hold'em No Limit ($1/$2 USD) - 2016/03/23 15:09:42 CET [2016/03/23 10:09:42 ET]
Table 'Clarissa II' 9-max Seat #4 is the button
Seat 1: DUkalisUA ($709.47 in chips) 
Seat 2: Igoriah ($205.24 in chips) 
Seat 3: PtizaXXX ($182.60 in chips) 
Seat 4: sanrs57 ($192 in chips) 
Seat 5: Red4erT ($84 in chips) 
Seat 6: matiko09 ($200 in chips) 
Seat 7: PacPacBum ($200 in chips) 
Seat 8: chaps1988 ($208.32 in chips) 
Seat 9: RamiroAgujis ($206 in chips) 
Red4erT: posts small blind $1
matiko09: posts big blind $2
*** HOLE CARDS ***
Dealt to matiko09 [Js 7c]
PacPacBum: folds 
chaps1988: folds 
RamiroAgujis: folds 
DUkalisUA: folds 
Igoriah: folds 
PtizaXXX: folds 
sanrs57: raises $4 to $6
Red4erT: folds 
matiko09: folds 
Uncalled bet ($4) returned to sanrs57
sanrs57 collected $5 from pot
*** SUMMARY ***
Total pot $5 | Rake $0 
Seat 1: DUkalisUA folded before Flop (didn't bet)
Seat 2: Igoriah folded before Flop (didn't bet)
Seat 3: PtizaXXX folded before Flop (didn't bet)
Seat 4: sanrs57 (button) collected ($5)
Seat 5: Red4erT (small blind) folded before Flop
Seat 6: matiko09 (big blind) folded before Flop
Seat 7: PacPacBum folded before Flop (didn't bet)
Seat 8: chaps1988 folded before Flop (didn't bet)
Seat 9: RamiroAgujis folded before Flop (didn't bet)





PokerStars Hand #150802661387:  Hold'em No Limit (€0.50/€1.00 EUR) - 2016/03/23 15:09:49 CET [2016/03/23 10:09:49 ET]
Table 'Mercury III' 9-max Seat #2 is the button
Seat 1: matiko09 (€113.58 in chips) 
Seat 2: o.miro (€122.67 in chips) 
Seat 3: PacPacBum (€101.33 in chips) 
Seat 4: Muinmyheart (€101.50 in chips) 
Seat 5: DUkalisUA (€100 in chips) 
Seat 6: mycka86 (€100 in chips) 
Seat 7: STrakDD (€100 in chips) 
Seat 8: gfxed (€35.84 in chips) 
Seat 9: Indr3k (€100 in chips) 
PacPacBum: posts small blind €0.50
Muinmyheart: posts big blind €1
*** HOLE CARDS ***
Dealt to matiko09 [2d Th]
DUkalisUA: folds 
mycka86: raises €2 to €3
STrakDD: folds 
gfxed: folds 
Indr3k: folds 
matiko09: folds 
o.miro: folds 
PacPacBum: folds 
Muinmyheart: folds 
Uncalled bet (€2) returned to mycka86
mycka86 collected €2.50 from pot
*** SUMMARY ***
Total pot €2.50 | Rake €0 
Seat 1: matiko09 folded before Flop (didn't bet)
Seat 2: o.miro (button) folded before Flop (didn't bet)
Seat 3: PacPacBum (small blind) folded before Flop
Seat 4: Muinmyheart (big blind) folded before Flop
Seat 5: DUkalisUA folded before Flop (didn't bet)
Seat 6: mycka86 collected (€2.50)
Seat 7: STrakDD folded before Flop (didn't bet)
Seat 8: gfxed folded before Flop (didn't bet)
Seat 9: Indr3k folded before Flop (didn't bet)





PokerStars Hand #150802661925:  Hold'em No Limit ($0.50/$1.00 USD) - 2016/03/23 15:09:51 CET [2016/03/23 10:09:51 ET]
Table 'Sylvia III' 9-max Seat #5 is the button
Seat 1: mycka86 ($109.50 in chips) 
Seat 2: Dantist1122 ($102.90 in chips) 
Seat 3: se7en_$tars ($94.60 in chips) 
Seat 4: lombardo11 ($83.42 in chips) 
Seat 5: matiko09 ($101.39 in chips) 
Seat 6: PacPacBum ($100 in chips) 
Seat 7: easytalk777 ($96.13 in chips) 
Seat 8: nickreason17 ($114.09 in chips) 
Seat 9: Blanky-Bad ($93.57 in chips) 
PacPacBum: posts small blind $0.50
easytalk777: posts big blind $1
mycka86: posts the ante $0.20
Dantist1122: posts the ante $0.20
se7en_$tars: posts the ante $0.20
lombardo11: posts the ante $0.20
matiko09: posts the ante $0.20
PacPacBum: posts the ante $0.20
easytalk777: posts the ante $0.20
nickreason17: posts the ante $0.20
Blanky-Bad: posts the ante $0.20
*** HOLE CARDS ***
Dealt to matiko09 [Qs 4s]
nickreason17: folds 
Blanky-Bad: folds 
mycka86: folds 
Dantist1122: raises $2 to $3
se7en_$tars: folds 
lombardo11: folds 
matiko09: folds 
PacPacBum: folds 
easytalk777: folds 
Uncalled bet ($2) returned to Dantist1122
Dantist1122 collected $4.30 from pot
Dantist1122: doesn't show hand 
*** SUMMARY ***
Total pot $4.30 | Rake $0 
Seat 1: mycka86 folded before Flop (didn't bet)
Seat 2: Dantist1122 collected ($4.30)
Seat 3: se7en_$tars folded before Flop (didn't bet)
Seat 4: lombardo11 folded before Flop (didn't bet)
Seat 5: matiko09 (button) folded before Flop (didn't bet)
Seat 6: PacPacBum (small blind) folded before Flop
Seat 7: easytalk777 (big blind) folded before Flop
Seat 8: nickreason17 folded before Flop (didn't bet)
Seat 9: Blanky-Bad folded before Flop (didn't bet)





PokerStars Hand #150802663794:  Hold'em No Limit ($0.50/$1.00 USD) - 2016/03/23 15:09:56 CET [2016/03/23 10:09:56 ET]
Table 'Drakonia II' 9-max Seat #9 is the button
Seat 1: chautinhtri9 ($131.60 in chips) 
Seat 2: carrsseis ($106.62 in chips) 
Seat 3: dunga119 ($98.08 in chips) 
Seat 4: nickreason17 ($113.72 in chips) 
Seat 5: gchs83 ($55.61 in chips) 
Seat 6: Dantist1122 ($100 in chips) 
Seat 7: YuriiSolodya ($27.90 in chips) 
Seat 8: matiko09 ($100 in chips) 
Seat 9: mycka86 ($100 in chips) 
chautinhtri9: posts small blind $0.50
carrsseis: posts big blind $1
*** HOLE CARDS ***
Dealt to matiko09 [Tc 4s]
dunga119: folds 
nickreason17: folds 
gchs83: folds 
Dantist1122: raises $2 to $3
YuriiSolodya: folds 
matiko09: folds 
mycka86: folds 
chautinhtri9: folds 
carrsseis: calls $2
*** FLOP *** [3d Qc Ad]
carrsseis: checks 
Dantist1122: bets $5
carrsseis: calls $5
*** TURN *** [3d Qc Ad] [Kc]
carrsseis: checks 
Dantist1122: bets $13
carrsseis: folds 
Uncalled bet ($13) returned to Dantist1122
Dantist1122 collected $15.76 from pot
Dantist1122: doesn't show hand 
*** SUMMARY ***
Total pot $16.50 | Rake $0.74 
Board [3d Qc Ad Kc]
Seat 1: chautinhtri9 (small blind) folded before Flop
Seat 2: carrsseis (big blind) folded on the Turn
Seat 3: dunga119 folded before Flop (didn't bet)
Seat 4: nickreason17 folded before Flop (didn't bet)
Seat 5: gchs83 folded before Flop (didn't bet)
Seat 6: Dantist1122 collected ($15.76)
Seat 7: YuriiSolodya folded before Flop (didn't bet)
Seat 8: matiko09 folded before Flop (didn't bet)
Seat 9: mycka86 (button) folded before Flop (didn't bet)





PokerStars Hand #150802664317:  Hold'em No Limit ($0.50/$1.00 USD) - 2016/03/23 15:09:57 CET [2016/03/23 10:09:57 ET]
Table 'Swings' 9-max Seat #5 is the button
Seat 1: carrsseis ($101.80 in chips) 
Seat 4: chaps1988 ($100 in chips) 
Seat 5: chautinhtri9 ($108.95 in chips) 
Seat 6: matiko09 ($141.42 in chips) 
Seat 7: PacPacBum ($111.22 in chips) 
Seat 8: RICKA16 ($100.46 in chips) 
Seat 9: Vlad_1965_77 ($120.01 in chips) 
matiko09: posts small blind $0.50
PacPacBum: posts big blind $1
*** HOLE CARDS ***
Dealt to matiko09 [2d Js]
RICKA16: raises $2 to $3
Vlad_1965_77: folds 
carrsseis: folds 
chaps1988: folds 
chautinhtri9: folds 
matiko09: folds 
PacPacBum: folds 
Uncalled bet ($2) returned to RICKA16
RICKA16 collected $2.50 from pot
RICKA16: doesn't show hand 
*** SUMMARY ***
Total pot $2.50 | Rake $0 
Seat 1: carrsseis folded before Flop (didn't bet)
Seat 4: chaps1988 folded before Flop (didn't bet)
Seat 5: chautinhtri9 (button) folded before Flop (didn't bet)
Seat 6: matiko09 (small blind) folded before Flop
Seat 7: PacPacBum (big blind) folded before Flop
Seat 8: RICKA16 collected ($2.50)
Seat 9: Vlad_1965_77 folded before Flop (didn't bet)





PokerStars Hand #150802667280:  Hold'em No Limit ($1/$2 USD) - 2016/03/23 15:10:05 CET [2016/03/23 10:10:05 ET]
Table 'Kiess' 9-max Seat #7 is the button
Seat 1: Cirilico ($219.46 in chips) 
Seat 2: DUkalisUA ($705.28 in chips) 
Seat 3: Red4erT ($102.82 in chips) 
Seat 4: Igoriah ($200 in chips) 
Seat 6: matiko09 ($262.28 in chips) 
Seat 7: chaps1988 ($200 in chips) 
Seat 8: erfk1958 ($139.21 in chips) 
Seat 9: PacPacBum ($200 in chips) 
erfk1958: posts small blind $1
PacPacBum: posts big blind $2
*** HOLE CARDS ***
Dealt to matiko09 [5d Js]
Cirilico: folds 
DUkalisUA: folds 
Red4erT: folds 
Igoriah: folds 
matiko09: folds 
chaps1988: folds 
erfk1958: folds 
Uncalled bet ($1) returned to PacPacBum
PacPacBum collected $2 from pot
PacPacBum: doesn't show hand 
*** SUMMARY ***
Total pot $2 | Rake $0 
Seat 1: Cirilico folded before Flop (didn't bet)
Seat 2: DUkalisUA folded before Flop (didn't bet)
Seat 3: Red4erT folded before Flop (didn't bet)
Seat 4: Igoriah folded before Flop (didn't bet)
Seat 6: matiko09 folded before Flop (didn't bet)
Seat 7: chaps1988 (button) folded before Flop (didn't bet)
Seat 8: erfk1958 (small blind) folded before Flop
Seat 9: PacPacBum (big blind) collected ($2)





PokerStars Hand #150802667587:  Hold'em No Limit ($1/$2 USD) - 2016/03/23 15:10:06 CET [2016/03/23 10:10:06 ET]
Table 'Kypria II' 9-max Seat #9 is the button
Seat 1: chaps1988 ($211.88 in chips) 
Seat 2: PacPacBum ($200 in chips) 
Seat 3: seouljam ($302.58 in chips) 
Seat 4: VolanDog ($217.72 in chips) 
Seat 5: Igoriah ($200 in chips) 
Seat 6: matiko09 ($447.25 in chips) 
Seat 7: DUkalisUA ($203 in chips) 
Seat 8: nickreason17 ($203.37 in chips) 
Seat 9: sanrs57 ($160.30 in chips) 
chaps1988: posts small blind $1
PacPacBum: posts big blind $2
*** HOLE CARDS ***
Dealt to matiko09 [8c 9c]
seouljam: folds 
VolanDog: folds 
Igoriah: folds 
matiko09: raises $3 to $5
DUkalisUA: folds 
nickreason17: folds 
sanrs57: folds 
chaps1988: folds 
PacPacBum: folds 
Uncalled bet ($3) returned to matiko09
matiko09 collected $5 from pot
matiko09: doesn't show hand 
*** SUMMARY ***
Total pot $5 | Rake $0 
Seat 1: chaps1988 (small blind) folded before Flop
Seat 2: PacPacBum (big blind) folded before Flop
Seat 3: seouljam folded before Flop (didn't bet)
Seat 4: VolanDog folded before Flop (didn't bet)
Seat 5: Igoriah folded before Flop (didn't bet)
Seat 6: matiko09 collected ($5)
Seat 7: DUkalisUA folded before Flop (didn't bet)
Seat 8: nickreason17 folded before Flop (didn't bet)
Seat 9: sanrs57 (button) folded before Flop (didn't bet)





PokerStars Hand #150802670211:  Hold'em No Limit ($0.50/$1.00 USD) - 2016/03/23 15:10:13 CET [2016/03/23 10:10:13 ET]
Table 'Swings' 9-max Seat #6 is the button
Seat 1: carrsseis ($101.80 in chips) 
Seat 4: chaps1988 ($100 in chips) 
Seat 5: chautinhtri9 ($108.95 in chips) 
Seat 6: matiko09 ($140.92 in chips) 
Seat 7: PacPacBum ($110.22 in chips) 
Seat 8: RICKA16 ($101.96 in chips) 
Seat 9: Vlad_1965_77 ($120.01 in chips) 
PacPacBum: posts small blind $0.50
RICKA16: posts big blind $1
*** HOLE CARDS ***
Dealt to matiko09 [Kd 4h]
Vlad_1965_77: folds 
carrsseis: folds 
chaps1988: folds 
Vlad_1965_77 leaves the table
chautinhtri9: raises $2 to $3
Effort92 joins the table at seat #9 
matiko09: folds 
PacPacBum: folds 
RICKA16: folds 
Uncalled bet ($2) returned to chautinhtri9
chautinhtri9 collected $2.50 from pot
*** SUMMARY ***
Total pot $2.50 | Rake $0 
Seat 1: carrsseis folded before Flop (didn't bet)
Seat 4: chaps1988 folded before Flop (didn't bet)
Seat 5: chautinhtri9 collected ($2.50)
Seat 6: matiko09 (button) folded before Flop (didn't bet)
Seat 7: PacPacBum (small blind) folded before Flop
Seat 8: RICKA16 (big blind) folded before Flop
Seat 9: Vlad_1965_77 folded before Flop (didn't bet)





PokerStars Hand #150802672862:  Hold'em No Limit ($0.50/$1.00 USD) - 2016/03/23 15:10:20 CET [2016/03/23 10:10:20 ET]
Table 'Asmodeus' 9-max Seat #8 is the button
Seat 1: Jimy Tiltman ($127.97 in chips) 
Seat 2: PacPacBum ($106.93 in chips) 
Seat 3: nickreason17 ($100 in chips) 
Seat 4: Effort92 ($100 in chips) 
Seat 5: Muinmyheart ($100 in chips) 
Seat 6: fuppeee ($77.66 in chips) 
Seat 7: mycka86 ($144.95 in chips) 
Seat 8: bonifacioppl ($62.25 in chips) 
Seat 9: matiko09 ($100 in chips) 
matiko09: posts small blind $0.50
Jimy Tiltman: posts big blind $1
Jimy Tiltman: posts the ante $0.20
PacPacBum: posts the ante $0.20
nickreason17: posts the ante $0.20
Effort92: posts the ante $0.20
Muinmyheart: posts the ante $0.20
fuppeee: posts the ante $0.20
mycka86: posts the ante $0.20
bonifacioppl: posts the ante $0.20
matiko09: posts the ante $0.20
*** HOLE CARDS ***
Dealt to matiko09 [Ac 2h]
PacPacBum: raises $2 to $3
nickreason17: folds 
Effort92: folds 
Muinmyheart: folds 
fuppeee: folds 
mycka86: folds 
bonifacioppl: folds 
matiko09: folds 
Jimy Tiltman: calls $2
*** FLOP *** [Qh 9d Kc]
Jimy Tiltman: checks 
PacPacBum: checks 
*** TURN *** [Qh 9d Kc] [As]
Jimy Tiltman: checks 
PacPacBum: checks 
*** RIVER *** [Qh 9d Kc As] [Kd]
Jimy Tiltman: checks 
PacPacBum: checks 
*** SHOW DOWN ***
Jimy Tiltman: shows [8s Qs] (two pair, Kings and Queens)
PacPacBum: mucks hand 
Jimy Tiltman collected $7.93 from pot
*** SUMMARY ***
Total pot $8.30 | Rake $0.37 
Board [Qh 9d Kc As Kd]
Seat 1: Jimy Tiltman (big blind) showed [8s Qs] and won ($7.93) with two pair, Kings and Queens
Seat 2: PacPacBum mucked [Jh Js]
Seat 3: nickreason17 folded before Flop (didn't bet)
Seat 4: Effort92 folded before Flop (didn't bet)
Seat 5: Muinmyheart folded before Flop (didn't bet)
Seat 6: fuppeee folded before Flop (didn't bet)
Seat 7: mycka86 folded before Flop (didn't bet)
Seat 8: bonifacioppl (button) folded before Flop (didn't bet)
Seat 9: matiko09 (small blind) folded before Flop





PokerStars Hand #150802672598:  Hold'em No Limit ($1/$2 USD) - 2016/03/23 15:10:20 CET [2016/03/23 10:10:20 ET]
Table 'Herba II' 9-max Seat #1 is the button
Seat 1: matiko09 ($290.88 in chips) 
Seat 2: nickreason17 ($212.76 in chips) 
Seat 3: Cirilico ($199 in chips) 
Seat 4: DUkalisUA ($380.40 in chips) 
Seat 7: Igoriah ($275.39 in chips) 
nickreason17: posts small blind $1
Cirilico: posts big blind $2
*** HOLE CARDS ***
Dealt to matiko09 [8d Qs]
DUkalisUA: folds 
Igoriah: folds 
matiko09: raises $2.54 to $4.54
nickreason17: raises $13.46 to $18
Cirilico: folds 
matiko09: folds 
Uncalled bet ($13.46) returned to nickreason17
nickreason17 collected $11.08 from pot
*** SUMMARY ***
Total pot $11.08 | Rake $0 
Seat 1: matiko09 (button) folded before Flop
Seat 2: nickreason17 (small blind) collected ($11.08)
Seat 3: Cirilico (big blind) folded before Flop
Seat 4: DUkalisUA folded before Flop (didn't bet)
Seat 7: Igoriah folded before Flop (didn't bet)





PokerStars Hand #150802673198:  Hold'em No Limit ($1/$2 USD) - 2016/03/23 15:10:21 CET [2016/03/23 10:10:21 ET]
Table 'Achaia' 9-max Seat #1 is the button
Seat 1: RamiroAgujis ($230.57 in chips) 
Seat 2: bananajoe001 ($223.81 in chips) 
Seat 3: matiko09 ($216.16 in chips) 
Seat 4: erfk1958 ($87 in chips) 
Seat 5: chaps1988 ($209.28 in chips) 
Seat 6: nickreason17 ($241.44 in chips) 
Seat 7: morosun ($237.92 in chips) 
Seat 8: IseeUcards ($208.86 in chips) 
Seat 9: PacPacBum ($204.35 in chips) 
bananajoe001: posts small blind $1
matiko09: posts big blind $2
*** HOLE CARDS ***
Dealt to matiko09 [3d Kh]
erfk1958: raises $2 to $4
chaps1988: raises $8 to $12
nickreason17: folds 
morosun: folds 
IseeUcards: folds 
PacPacBum: folds 
RamiroAgujis: folds 
bananajoe001: folds 
matiko09: folds 
erfk1958: calls $8
*** FLOP *** [9d Th 6h]
erfk1958: checks 
chaps1988: checks 
*** TURN *** [9d Th 6h] [7h]
erfk1958: checks 
chaps1988: checks 
*** RIVER *** [9d Th 6h 7h] [5d]
erfk1958: checks 
chaps1988: checks 
*** SHOW DOWN ***
erfk1958: shows [2h 2d] (a pair of Deuces)
chaps1988: mucks hand 
erfk1958 collected $25.78 from pot
*** SUMMARY ***
Total pot $27 | Rake $1.22 
Board [9d Th 6h 7h 5d]
Seat 1: RamiroAgujis (button) folded before Flop (didn't bet)
Seat 2: bananajoe001 (small blind) folded before Flop
Seat 3: matiko09 (big blind) folded before Flop
Seat 4: erfk1958 showed [2h 2d] and won ($25.78) with a pair of Deuces
Seat 5: chaps1988 mucked [Ac Js]
Seat 6: nickreason17 folded before Flop (didn't bet)
Seat 7: morosun folded before Flop (didn't bet)
Seat 8: IseeUcards folded before Flop (didn't bet)
Seat 9: PacPacBum folded before Flop (didn't bet)





PokerStars Hand #150802674555:  Hold'em No Limit ($0.25/$0.50 USD) - 2016/03/23 15:10:25 CET [2016/03/23 10:10:25 ET]
Table 'Pyrrhus' 9-max Seat #4 is the button
Seat 1: lumen21 ($84.33 in chips) 
Seat 2: BSTUSim ($61.62 in chips) 
Seat 3: Muinmyheart ($50 in chips) 
Seat 4: GriffinBerg ($37.99 in chips) 
Seat 5: xxxibgdrgn ($62.33 in chips) 
Seat 6: Ahangama ($50 in chips) 
Seat 7: matiko09 ($136 in chips) 
Seat 8: suitedaces02 ($50 in chips) 
Seat 9: CvMCvMCvM ($89.05 in chips) 
xxxibgdrgn: posts small blind $0.25
Ahangama: posts big blind $0.50
*** HOLE CARDS ***
Dealt to matiko09 [8s Kh]
matiko09: folds 
suitedaces02: folds 
CvMCvMCvM: folds 
lumen21: raises $1 to $1.50
BSTUSim: folds 
Muinmyheart: calls $1.50
GriffinBerg: folds 
GriffinBerg leaves the table
xxxibgdrgn: folds 
Ahangama: folds 
*** FLOP *** [6d 3c Kd]
lucky83o joins the table at seat #4 
lucky83o leaves the table
lumen21: checks 
Muinmyheart: checks 
*** TURN *** [6d 3c Kd] [As]
lumen21: bets $2.75
9lKBXKTT6 joins the table at seat #4 
9lKBXKTT6 leaves the table
Muinmyheart: folds 
Uncalled bet ($2.75) returned to lumen21
lumen21 collected $3.58 from pot
lumen21: doesn't show hand 
*** SUMMARY ***
Total pot $3.75 | Rake $0.17 
Board [6d 3c Kd As]
Seat 1: lumen21 collected ($3.58)
Seat 2: BSTUSim folded before Flop (didn't bet)
Seat 3: Muinmyheart folded on the Turn
Seat 4: GriffinBerg (button) folded before Flop (didn't bet)
Seat 5: xxxibgdrgn (small blind) folded before Flop
Seat 6: Ahangama (big blind) folded before Flop
Seat 7: matiko09 folded before Flop (didn't bet)
Seat 8: suitedaces02 folded before Flop (didn't bet)
Seat 9: CvMCvMCvM folded before Flop (didn't bet)





PokerStars Hand #150802676718:  Hold'em No Limit ($1/$2 USD) - 2016/03/23 15:10:31 CET [2016/03/23 10:10:31 ET]
Table 'Clarissa II' 9-max Seat #5 is the button
Seat 1: DUkalisUA ($709.47 in chips) 
Seat 2: Igoriah ($205.24 in chips) 
Seat 3: PtizaXXX ($182.60 in chips) 
Seat 4: sanrs57 ($195 in chips) 
Seat 5: Red4erT ($83 in chips) 
Seat 6: matiko09 ($200 in chips) 
Seat 7: PacPacBum ($200 in chips) 
Seat 8: chaps1988 ($208.32 in chips) 
Seat 9: RamiroAgujis ($206 in chips) 
matiko09: posts small blind $1
PacPacBum: posts big blind $2
*** HOLE CARDS ***
Dealt to matiko09 [2s 9s]
chaps1988: folds 
RamiroAgujis: folds 
DUkalisUA: raises $4 to $6
Igoriah: folds 
PtizaXXX: calls $6
sanrs57: folds 
Red4erT: folds 
matiko09: folds 
PacPacBum: raises $18 to $24
DUkalisUA: folds 
PtizaXXX: folds 
Uncalled bet ($18) returned to PacPacBum
PacPacBum collected $19 from pot
PacPacBum: doesn't show hand 
*** SUMMARY ***
Total pot $19 | Rake $0 
Seat 1: DUkalisUA folded before Flop
Seat 2: Igoriah folded before Flop (didn't bet)
Seat 3: PtizaXXX folded before Flop
Seat 4: sanrs57 folded before Flop (didn't bet)
Seat 5: Red4erT (button) folded before Flop (didn't bet)
Seat 6: matiko09 (small blind) folded before Flop
Seat 7: PacPacBum (big blind) collected ($19)
Seat 8: chaps1988 folded before Flop (didn't bet)
Seat 9: RamiroAgujis folded before Flop (didn't bet)





PokerStars Hand #150802677452:  Hold'em No Limit ($0.50/$1.00 USD) - 2016/03/23 15:10:33 CET [2016/03/23 10:10:33 ET]
Table 'Swings' 9-max Seat #7 is the button
Seat 1: carrsseis ($101.80 in chips) 
Seat 4: chaps1988 ($100 in chips) 
Seat 5: chautinhtri9 ($110.45 in chips) 
Seat 6: matiko09 ($140.92 in chips) 
Seat 7: PacPacBum ($109.72 in chips) 
Seat 8: RICKA16 ($100.96 in chips) 
Seat 9: Effort92 ($100 in chips) 
RICKA16: posts small blind $0.50
Effort92: posts big blind $1
*** HOLE CARDS ***
Dealt to matiko09 [Qh 9d]
carrsseis: folds 
chaps1988: raises $2 to $3
chautinhtri9: folds 
matiko09: folds 
PacPacBum: folds 
RICKA16: folds 
Effort92: folds 
Uncalled bet ($2) returned to chaps1988
chaps1988 collected $2.50 from pot
chaps1988: doesn't show hand 
*** SUMMARY ***
Total pot $2.50 | Rake $0 
Seat 1: carrsseis folded before Flop (didn't bet)
Seat 4: chaps1988 collected ($2.50)
Seat 5: chautinhtri9 folded before Flop (didn't bet)
Seat 6: matiko09 folded before Flop (didn't bet)
Seat 7: PacPacBum (button) folded before Flop (didn't bet)
Seat 8: RICKA16 (small blind) folded before Flop
Seat 9: Effort92 (big blind) folded before Flop





PokerStars Hand #150802678559:  Hold'em No Limit ($0.50/$1.00 USD) - 2016/03/23 15:10:36 CET [2016/03/23 10:10:36 ET]
Table 'Sylvia III' 9-max Seat #6 is the button
Seat 1: mycka86 ($109.30 in chips) 
Seat 2: Dantist1122 ($106 in chips) 
Seat 3: se7en_$tars ($94.40 in chips) 
Seat 4: lombardo11 ($83.22 in chips) 
Seat 5: matiko09 ($101.19 in chips) 
Seat 6: PacPacBum ($100 in chips) 
Seat 7: easytalk777 ($94.93 in chips) 
Seat 8: nickreason17 ($113.89 in chips) 
Seat 9: Blanky-Bad ($93.37 in chips) 
easytalk777: posts small blind $0.50
nickreason17: posts big blind $1
mycka86: posts the ante $0.20
Dantist1122: posts the ante $0.20
se7en_$tars: posts the ante $0.20
lombardo11: posts the ante $0.20
matiko09: posts the ante $0.20
PacPacBum: posts the ante $0.20
easytalk777: posts the ante $0.20
nickreason17: posts the ante $0.20
Blanky-Bad: posts the ante $0.20
*** HOLE CARDS ***
Dealt to matiko09 [6h 7s]
Blanky-Bad: folds 
mycka86: folds 
Dantist1122: folds 
se7en_$tars: folds 
lombardo11: folds 
matiko09: folds 
PacPacBum: folds 
easytalk777: folds 
Uncalled bet ($0.50) returned to nickreason17
nickreason17 collected $2.80 from pot
*** SUMMARY ***
Total pot $2.80 | Rake $0 
Seat 1: mycka86 folded before Flop (didn't bet)
Seat 2: Dantist1122 folded before Flop (didn't bet)
Seat 3: se7en_$tars folded before Flop (didn't bet)
Seat 4: lombardo11 folded before Flop (didn't bet)
Seat 5: matiko09 folded before Flop (didn't bet)
Seat 6: PacPacBum (button) folded before Flop (didn't bet)
Seat 7: easytalk777 (small blind) folded before Flop
Seat 8: nickreason17 (big blind) collected ($2.80)
Seat 9: Blanky-Bad folded before Flop (didn't bet)





PokerStars Hand #150802679124:  Hold'em No Limit ($1/$2 USD) - 2016/03/23 15:10:38 CET [2016/03/23 10:10:38 ET]
Table 'Kypria II' 9-max Seat #1 is the button
Seat 1: chaps1988 ($210.88 in chips) 
Seat 2: PacPacBum ($200 in chips) 
Seat 3: seouljam ($302.58 in chips) 
Seat 4: VolanDog ($217.72 in chips) 
Seat 5: Igoriah ($200 in chips) 
Seat 6: matiko09 ($450.25 in chips) 
Seat 7: DUkalisUA ($203 in chips) 
Seat 8: nickreason17 ($203.37 in chips) 
Seat 9: sanrs57 ($160.30 in chips) 
PacPacBum: posts small blind $1
seouljam: posts big blind $2
*** HOLE CARDS ***
Dealt to matiko09 [6d 2d]
VolanDog: folds 
Igoriah: folds 
matiko09: folds 
DUkalisUA: folds 
nickreason17: folds 
sanrs57: raises $4 to $6
chaps1988: calls $6
PacPacBum: folds 
seouljam: folds 
*** FLOP *** [Ac 8d 9c]
sanrs57: checks 
chaps1988: checks 
*** TURN *** [Ac 8d 9c] [3c]
sanrs57: checks 
chaps1988: bets $10
sanrs57: calls $10
*** RIVER *** [Ac 8d 9c 3c] [7c]
sanrs57: bets $16.71
chaps1988: folds 
Uncalled bet ($16.71) returned to sanrs57
sanrs57 collected $33.42 from pot
*** SUMMARY ***
Total pot $35 | Rake $1.58 
Board [Ac 8d 9c 3c 7c]
Seat 1: chaps1988 (button) folded on the River
Seat 2: PacPacBum (small blind) folded before Flop
Seat 3: seouljam (big blind) folded before Flop
Seat 4: VolanDog folded before Flop (didn't bet)
Seat 5: Igoriah folded before Flop (didn't bet)
Seat 6: matiko09 folded before Flop (didn't bet)
Seat 7: DUkalisUA folded before Flop (didn't bet)
Seat 8: nickreason17 folded before Flop (didn't bet)
Seat 9: sanrs57 collected ($33.42)





PokerStars Hand #150802679686:  Hold'em No Limit (€0.50/€1.00 EUR) - 2016/03/23 15:10:39 CET [2016/03/23 10:10:39 ET]
Table 'Mercury III' 9-max Seat #3 is the button
Seat 1: matiko09 (€113.58 in chips) 
Seat 2: o.miro (€122.67 in chips) 
Seat 3: PacPacBum (€100.83 in chips) 
Seat 4: Muinmyheart (€100.50 in chips) 
Seat 5: DUkalisUA (€100 in chips) 
Seat 6: mycka86 (€101.50 in chips) 
Seat 7: STrakDD (€100 in chips) 
Seat 8: gfxed (€35.84 in chips) 
Seat 9: Indr3k (€100 in chips) 
Muinmyheart: posts small blind €0.50
DUkalisUA: posts big blind €1
*** HOLE CARDS ***
Dealt to matiko09 [Js Th]
mycka86: folds 
STrakDD: folds 
gfxed: folds 
Indr3k: folds 
matiko09: folds 
o.miro: folds 
PacPacBum: folds 
Muinmyheart: raises €2 to €3
DUkalisUA: folds 
Uncalled bet (€2) returned to Muinmyheart
Muinmyheart collected €2 from pot
Muinmyheart: doesn't show hand 
*** SUMMARY ***
Total pot €2 | Rake €0 
Seat 1: matiko09 folded before Flop (didn't bet)
Seat 2: o.miro folded before Flop (didn't bet)
Seat 3: PacPacBum (button) folded before Flop (didn't bet)
Seat 4: Muinmyheart (small blind) collected (€2)
Seat 5: DUkalisUA (big blind) folded before Flop
Seat 6: mycka86 folded before Flop (didn't bet)
Seat 7: STrakDD folded before Flop (didn't bet)
Seat 8: gfxed folded before Flop (didn't bet)
Seat 9: Indr3k folded before Flop (didn't bet)





PokerStars Hand #150802679941:  Hold'em No Limit ($0.50/$1.00 USD) - 2016/03/23 15:10:40 CET [2016/03/23 10:10:40 ET]
Table 'Smiley' 9-max Seat #2 is the button
Seat 1: xHourglass ($100 in chips) 
Seat 2: Jimy Tiltman ($112.01 in chips) 
Seat 3: Robert201202 ($118.40 in chips) 
Seat 4: CAJUN890 ($96.21 in chips) 
Seat 5: Szevasztopol ($100 in chips) 
Seat 6: blackmont111 ($152.54 in chips) 
Seat 7: nickreason17 ($100 in chips) 
Seat 8: matiko09 ($100 in chips) 
Seat 9: Pvsx. ($237.14 in chips) 
Robert201202: posts small blind $0.50
CAJUN890: posts big blind $1
*** HOLE CARDS ***
Dealt to matiko09 [Ad 2s]
Szevasztopol: folds 
blackmont111: folds 
nickreason17: folds 
matiko09: folds 
Pvsx.: raises $1.50 to $2.50
xHourglass: raises $5 to $7.50
Jimy Tiltman: folds 
Robert201202: folds 
CAJUN890: folds 
Pvsx.: folds 
Uncalled bet ($5) returned to xHourglass
xHourglass collected $6.50 from pot
xHourglass: doesn't show hand 
*** SUMMARY ***
Total pot $6.50 | Rake $0 
Seat 1: xHourglass collected ($6.50)
Seat 2: Jimy Tiltman (button) folded before Flop (didn't bet)
Seat 3: Robert201202 (small blind) folded before Flop
Seat 4: CAJUN890 (big blind) folded before Flop
Seat 5: Szevasztopol folded before Flop (didn't bet)
Seat 6: blackmont111 folded before Flop (didn't bet)
Seat 7: nickreason17 folded before Flop (didn't bet)
Seat 8: matiko09 folded before Flop (didn't bet)
Seat 9: Pvsx. folded before Flop





PokerStars Hand #150802679916:  Hold'em No Limit ($1/$2 USD) - 2016/03/23 15:10:40 CET [2016/03/23 10:10:40 ET]
Table 'Kiess' 9-max Seat #8 is the button
Seat 1: Cirilico ($219.46 in chips) 
Seat 2: DUkalisUA ($705.28 in chips) 
Seat 3: Red4erT ($102.82 in chips) 
Seat 4: Igoriah ($200 in chips) 
Seat 6: matiko09 ($262.28 in chips) 
Seat 7: chaps1988 ($200 in chips) 
Seat 8: erfk1958 ($138.21 in chips) 
Seat 9: PacPacBum ($201 in chips) 
PacPacBum: posts small blind $1
Cirilico: posts big blind $2
*** HOLE CARDS ***
Dealt to matiko09 [8s Td]
DUkalisUA: folds 
Red4erT: folds 
Igoriah: folds 
matiko09: folds 
chaps1988: folds 
erfk1958: folds 
PacPacBum: folds 
Uncalled bet ($1) returned to Cirilico
Cirilico collected $2 from pot
Cirilico: doesn't show hand 
*** SUMMARY ***
Total pot $2 | Rake $0 
Seat 1: Cirilico (big blind) collected ($2)
Seat 2: DUkalisUA folded before Flop (didn't bet)
Seat 3: Red4erT folded before Flop (didn't bet)
Seat 4: Igoriah folded before Flop (didn't bet)
Seat 6: matiko09 folded before Flop (didn't bet)
Seat 7: chaps1988 folded before Flop (didn't bet)
Seat 8: erfk1958 (button) folded before Flop (didn't bet)
Seat 9: PacPacBum (small blind) folded before Flop





PokerStars Hand #150802682203:  Hold'em No Limit ($1/$2 USD) - 2016/03/23 15:10:46 CET [2016/03/23 10:10:46 ET]
Table 'Herba II' 9-max Seat #2 is the button
Seat 1: matiko09 ($286.34 in chips) 
Seat 2: nickreason17 ($219.30 in chips) 
Seat 3: Cirilico ($197 in chips) 
Seat 4: DUkalisUA ($380.40 in chips) 
Seat 7: Igoriah ($275.39 in chips) 
Cirilico: posts small blind $1
DUkalisUA: posts big blind $2
*** HOLE CARDS ***
Dealt to matiko09 [8c 3h]
Igoriah: folds 
matiko09: folds 
nickreason17: folds 
Cirilico: folds 
Uncalled bet ($1) returned to DUkalisUA
DUkalisUA collected $2 from pot
DUkalisUA: doesn't show hand 
*** SUMMARY ***
Total pot $2 | Rake $0 
Seat 1: matiko09 folded before Flop (didn't bet)
Seat 2: nickreason17 (button) folded before Flop (didn't bet)
Seat 3: Cirilico (small blind) folded before Flop
Seat 4: DUkalisUA (big blind) collected ($2)
Seat 7: Igoriah folded before Flop (didn't bet)





PokerStars Hand #150802684815:  Hold'em No Limit ($1/$2 USD) - 2016/03/23 15:10:53 CET [2016/03/23 10:10:53 ET]
Table 'Kiess' 9-max Seat #9 is the button
Seat 1: Cirilico ($220.46 in chips) 
Seat 2: DUkalisUA ($705.28 in chips) 
Seat 3: Red4erT ($102.82 in chips) 
Seat 4: Igoriah ($200 in chips) 
Seat 6: matiko09 ($262.28 in chips) 
Seat 7: chaps1988 ($200 in chips) 
Seat 8: erfk1958 ($138.21 in chips) 
Seat 9: PacPacBum ($200 in chips) 
Cirilico: posts small blind $1
DUkalisUA: posts big blind $2
*** HOLE CARDS ***
Dealt to matiko09 [Qs 2c]
Red4erT: folds 
Igoriah: folds 
matiko09: folds 
chaps1988: folds 
erfk1958: folds 
PacPacBum: folds 
Cirilico: raises $4 to $6
DUkalisUA: folds 
Uncalled bet ($4) returned to Cirilico
Cirilico collected $4 from pot
Cirilico: doesn't show hand 
*** SUMMARY ***
Total pot $4 | Rake $0 
Seat 1: Cirilico (small blind) collected ($4)
Seat 2: DUkalisUA (big blind) folded before Flop
Seat 3: Red4erT folded before Flop (didn't bet)
Seat 4: Igoriah folded before Flop (didn't bet)
Seat 6: matiko09 folded before Flop (didn't bet)
Seat 7: chaps1988 folded before Flop (didn't bet)
Seat 8: erfk1958 folded before Flop (didn't bet)
Seat 9: PacPacBum (button) folded before Flop (didn't bet)





PokerStars Hand #150802687796:  Hold'em No Limit ($0.50/$1.00 USD) - 2016/03/23 15:11:01 CET [2016/03/23 10:11:01 ET]
Table 'Swings' 9-max Seat #8 is the button
Seat 4: chaps1988 ($101.50 in chips) 
Seat 5: chautinhtri9 ($110.45 in chips) 
Seat 6: matiko09 ($140.92 in chips) 
Seat 7: PacPacBum ($109.72 in chips) 
Seat 8: RICKA16 ($100.46 in chips) 
Seat 9: Effort92 ($100 in chips) 
Effort92: posts small blind $0.50
carrsseis: is sitting out 
chaps1988: posts big blind $1
*** HOLE CARDS ***
Dealt to matiko09 [8c Ts]
chautinhtri9: folds 
matiko09: folds 
PacPacBum: raises $1.04 to $2.04
RICKA16: folds 
Effort92: folds 
chaps1988: folds 
Uncalled bet ($1.04) returned to PacPacBum
PacPacBum collected $2.50 from pot
PacPacBum: doesn't show hand 
*** SUMMARY ***
Total pot $2.50 | Rake $0 
Seat 4: chaps1988 (big blind) folded before Flop
Seat 5: chautinhtri9 folded before Flop (didn't bet)
Seat 6: matiko09 folded before Flop (didn't bet)
Seat 7: PacPacBum collected ($2.50)
Seat 8: RICKA16 (button) folded before Flop (didn't bet)
Seat 9: Effort92 (small blind) folded before Flop





PokerStars Hand #150802688091:  Hold'em No Limit ($1/$2 USD) - 2016/03/23 15:11:02 CET [2016/03/23 10:11:02 ET]
Table 'Herba II' 9-max Seat #3 is the button
Seat 1: matiko09 ($286.34 in chips) 
Seat 2: nickreason17 ($219.30 in chips) 
Seat 3: Cirilico ($196 in chips) 
Seat 4: DUkalisUA ($381.40 in chips) 
Seat 7: Igoriah ($275.39 in chips) 
DUkalisUA: posts small blind $1
Igoriah: posts big blind $2
*** HOLE CARDS ***
Dealt to matiko09 [Qh Ks]
mrhighryza leaves the table
matiko09: raises $3 to $5
nickreason17: folds 
Cirilico: folds 
DUkalisUA: folds 
Igoriah: folds 
Uncalled bet ($3) returned to matiko09
matiko09 collected $5 from pot
matiko09: doesn't show hand 
*** SUMMARY ***
Total pot $5 | Rake $0 
Seat 1: matiko09 collected ($5)
Seat 2: nickreason17 folded before Flop (didn't bet)
Seat 3: Cirilico (button) folded before Flop (didn't bet)
Seat 4: DUkalisUA (small blind) folded before Flop
Seat 7: Igoriah (big blind) folded before Flop





PokerStars Hand #150802692187:  Hold'em No Limit ($1/$2 USD) - 2016/03/23 15:11:13 CET [2016/03/23 10:11:13 ET]
Table 'Achaia' 9-max Seat #2 is the button
Seat 1: RamiroAgujis ($230.57 in chips) 
Seat 2: bananajoe001 ($222.81 in chips) 
Seat 3: matiko09 ($214.16 in chips) 
Seat 4: erfk1958 ($100.78 in chips) 
Seat 5: chaps1988 ($200 in chips) 
Seat 6: nickreason17 ($241.44 in chips) 
Seat 7: morosun ($237.92 in chips) 
Seat 8: IseeUcards ($208.86 in chips) 
Seat 9: PacPacBum ($204.35 in chips) 
matiko09: posts small blind $1
erfk1958: posts big blind $2
*** HOLE CARDS ***
Dealt to matiko09 [6s 5d]
chaps1988: folds 
nickreason17: folds 
morosun: raises $2 to $4
IseeUcards: folds 
PacPacBum: folds 
RamiroAgujis: folds 
bananajoe001: calls $4
matiko09: folds 
erfk1958: calls $2
*** FLOP *** [9d 2c Qh]
erfk1958: checks 
morosun: bets $6
bananajoe001: calls $6
erfk1958: folds 
*** TURN *** [9d 2c Qh] [6c]
morosun: bets $6
bananajoe001: calls $6
*** RIVER *** [9d 2c Qh 6c] [Ks]
morosun: bets $10
bananajoe001: folds [9h]
Uncalled bet ($10) returned to morosun
morosun collected $35.34 from pot
*** SUMMARY ***
Total pot $37 | Rake $1.66 
Board [9d 2c Qh 6c Ks]
Seat 1: RamiroAgujis folded before Flop (didn't bet)
Seat 2: bananajoe001 (button) folded on the River
Seat 3: matiko09 (small blind) folded before Flop
Seat 4: erfk1958 (big blind) folded on the Flop
Seat 5: chaps1988 folded before Flop (didn't bet)
Seat 6: nickreason17 folded before Flop (didn't bet)
Seat 7: morosun collected ($35.34)
Seat 8: IseeUcards folded before Flop (didn't bet)
Seat 9: PacPacBum folded before Flop (didn't bet)





PokerStars Hand #150802692319:  Hold'em No Limit ($1/$2 USD) - 2016/03/23 15:11:13 CET [2016/03/23 10:11:13 ET]
Table 'Clarissa II' 9-max Seat #6 is the button
Seat 1: DUkalisUA ($703.47 in chips) 
Seat 2: Igoriah ($205.24 in chips) 
Seat 3: PtizaXXX ($176.60 in chips) 
Seat 4: sanrs57 ($195 in chips) 
Seat 5: Red4erT ($83 in chips) 
Seat 6: matiko09 ($200 in chips) 
Seat 7: PacPacBum ($213 in chips) 
Seat 8: chaps1988 ($208.32 in chips) 
Seat 9: RamiroAgujis ($206 in chips) 
PacPacBum: posts small blind $1
chaps1988: posts big blind $2
*** HOLE CARDS ***
Dealt to matiko09 [6d 4s]
RamiroAgujis: folds 
DUkalisUA: folds 
Igoriah: folds 
PtizaXXX: folds 
sanrs57: folds 
Red4erT: folds 
matiko09: folds 
PacPacBum: folds 
Uncalled bet ($1) returned to chaps1988
chaps1988 collected $2 from pot
chaps1988: doesn't show hand 
*** SUMMARY ***
Total pot $2 | Rake $0 
Seat 1: DUkalisUA folded before Flop (didn't bet)
Seat 2: Igoriah folded before Flop (didn't bet)
Seat 3: PtizaXXX folded before Flop (didn't bet)
Seat 4: sanrs57 folded before Flop (didn't bet)
Seat 5: Red4erT folded before Flop (didn't bet)
Seat 6: matiko09 (button) folded before Flop (didn't bet)
Seat 7: PacPacBum (small blind) folded before Flop
Seat 8: chaps1988 (big blind) collected ($2)
Seat 9: RamiroAgujis folded before Flop (didn't bet)





PokerStars Hand #150802693148:  Hold'em No Limit ($0.50/$1.00 USD) - 2016/03/23 15:11:16 CET [2016/03/23 10:11:16 ET]
Table 'Smiley' 9-max Seat #3 is the button
Seat 1: xHourglass ($104 in chips) 
Seat 2: Jimy Tiltman ($112.01 in chips) 
Seat 3: Robert201202 ($117.90 in chips) 
Seat 4: CAJUN890 ($95.21 in chips) 
Seat 7: nickreason17 ($100 in chips) 
Seat 8: matiko09 ($100 in chips) 
Seat 9: Pvsx. ($234.64 in chips) 
CAJUN890: posts small blind $0.50
Szevasztopol: is sitting out 
blackmont111: is sitting out 
nickreason17: posts big blind $1
*** HOLE CARDS ***
Dealt to matiko09 [7d Kd]
matiko09: folds 
Pvsx.: folds 
xHourglass: folds 
Jimy Tiltman: raises $1 to $2
Robert201202: folds 
CAJUN890: folds 
nickreason17: calls $1
*** FLOP *** [6d 2h 4s]
nickreason17: checks 
Jimy Tiltman: checks 
*** TURN *** [6d 2h 4s] [9c]
nickreason17: bets $3.38
Jimy Tiltman: calls $3.38
*** RIVER *** [6d 2h 4s 9c] [Tc]
nickreason17: bets $8.44
Jimy Tiltman: calls $8.44
*** SHOW DOWN ***
nickreason17: shows [5s 7s] (high card Ten)
Jimy Tiltman: shows [9h Ts] (two pair, Tens and Nines)
Jimy Tiltman collected $26.87 from pot
*** SUMMARY ***
Total pot $28.14 | Rake $1.27 
Board [6d 2h 4s 9c Tc]
Seat 1: xHourglass folded before Flop (didn't bet)
Seat 2: Jimy Tiltman showed [9h Ts] and won ($26.87) with two pair, Tens and Nines
Seat 3: Robert201202 (button) folded before Flop (didn't bet)
Seat 4: CAJUN890 (small blind) folded before Flop
Seat 7: nickreason17 (big blind) showed [5s 7s] and lost with high card Ten
Seat 8: matiko09 folded before Flop (didn't bet)
Seat 9: Pvsx. folded before Flop (didn't bet)





PokerStars Hand #150802693763:  Hold'em No Limit ($0.50/$1.00 USD) - 2016/03/23 15:11:17 CET [2016/03/23 10:11:17 ET]
Table 'Swings' 9-max Seat #9 is the button
Seat 4: chaps1988 ($100.50 in chips) 
Seat 5: chautinhtri9 ($110.45 in chips) 
Seat 6: matiko09 ($140.92 in chips) 
Seat 7: PacPacBum ($111.22 in chips) 
Seat 8: RICKA16 ($100.46 in chips) 
Seat 9: Effort92 ($100 in chips) 
tomver0809 will be allowed to play after the button
chaps1988: posts small blind $0.50
chautinhtri9: posts big blind $1
*** HOLE CARDS ***
Dealt to matiko09 [8h Js]
matiko09: folds 
PacPacBum: folds 
RICKA16: folds 
Effort92: raises $1 to $2
chaps1988: folds 
carrsseis leaves the table
chautinhtri9: raises $5 to $7
Effort92: folds 
Uncalled bet ($5) returned to chautinhtri9
chautinhtri9 collected $4.50 from pot
*** SUMMARY ***
Total pot $4.50 | Rake $0 
Seat 4: chaps1988 (small blind) folded before Flop
Seat 5: chautinhtri9 (big blind) collected ($4.50)
Seat 6: matiko09 folded before Flop (didn't bet)
Seat 7: PacPacBum folded before Flop (didn't bet)
Seat 8: RICKA16 folded before Flop (didn't bet)
Seat 9: Effort92 (button) folded before Flop





PokerStars Hand #150802693992:  Hold'em No Limit ($0.50/$1.00 USD) - 2016/03/23 15:11:18 CET [2016/03/23 10:11:18 ET]
Table 'Sylvia III' 9-max Seat #7 is the button
Seat 1: mycka86 ($109.10 in chips) 
Seat 2: Dantist1122 ($105.80 in chips) 
Seat 3: se7en_$tars ($94.20 in chips) 
Seat 4: lombardo11 ($83.02 in chips) 
Seat 5: matiko09 ($100.99 in chips) 
Seat 6: PacPacBum ($100 in chips) 
Seat 7: easytalk777 ($94.23 in chips) 
Seat 8: nickreason17 ($115.99 in chips) 
Seat 9: Blanky-Bad ($93.17 in chips) 
nickreason17: posts small blind $0.50
Blanky-Bad: posts big blind $1
mycka86: posts the ante $0.20
Dantist1122: posts the ante $0.20
se7en_$tars: posts the ante $0.20
lombardo11: posts the ante $0.20
matiko09: posts the ante $0.20
PacPacBum: posts the ante $0.20
easytalk777: posts the ante $0.20
nickreason17: posts the ante $0.20
Blanky-Bad: posts the ante $0.20
*** HOLE CARDS ***
Dealt to matiko09 [Qs 5s]
mycka86: folds 
Dantist1122: folds 
se7en_$tars: folds 
lombardo11: raises $2 to $3
matiko09: folds 
PacPacBum: folds 
easytalk777: folds 
nickreason17: folds 
Blanky-Bad: folds 
Uncalled bet ($2) returned to lombardo11
lombardo11 collected $4.30 from pot
lombardo11: doesn't show hand 
*** SUMMARY ***
Total pot $4.30 | Rake $0 
Seat 1: mycka86 folded before Flop (didn't bet)
Seat 2: Dantist1122 folded before Flop (didn't bet)
Seat 3: se7en_$tars folded before Flop (didn't bet)
Seat 4: lombardo11 collected ($4.30)
Seat 5: matiko09 folded before Flop (didn't bet)
Seat 6: PacPacBum folded before Flop (didn't bet)
Seat 7: easytalk777 (button) folded before Flop (didn't bet)
Seat 8: nickreason17 (small blind) folded before Flop
Seat 9: Blanky-Bad (big blind) folded before Flop





PokerStars Hand #150802698849:  Hold'em No Limit ($1/$2 USD) - 2016/03/23 15:11:31 CET [2016/03/23 10:11:31 ET]
Table 'Kiess' 9-max Seat #1 is the button
Seat 1: Cirilico ($222.46 in chips) 
Seat 2: DUkalisUA ($703.28 in chips) 
Seat 3: Red4erT ($102.82 in chips) 
Seat 4: Igoriah ($200 in chips) 
Seat 6: matiko09 ($262.28 in chips) 
Seat 7: chaps1988 ($200 in chips) 
Seat 8: erfk1958 ($138.21 in chips) 
Seat 9: PacPacBum ($200 in chips) 
DUkalisUA: posts small blind $1
Red4erT: posts big blind $2
*** HOLE CARDS ***
Dealt to matiko09 [5c Qc]
Igoriah: folds 
matiko09: folds 
chaps1988: folds 
erfk1958: folds 
PacPacBum: raises $2.08 to $4.08
Cirilico: folds 
DUkalisUA: folds 
Red4erT: calls $2.08
*** FLOP *** [Qh 4d 5h]
Red4erT: checks 
PacPacBum: bets $4.72
Red4erT: folds 
Uncalled bet ($4.72) returned to PacPacBum
PacPacBum collected $8.75 from pot
PacPacBum: doesn't show hand 
*** SUMMARY ***
Total pot $9.16 | Rake $0.41 
Board [Qh 4d 5h]
Seat 1: Cirilico (button) folded before Flop (didn't bet)
Seat 2: DUkalisUA (small blind) folded before Flop
Seat 3: Red4erT (big blind) folded on the Flop
Seat 4: Igoriah folded before Flop (didn't bet)
Seat 6: matiko09 folded before Flop (didn't bet)
Seat 7: chaps1988 folded before Flop (didn't bet)
Seat 8: erfk1958 folded before Flop (didn't bet)
Seat 9: PacPacBum collected ($8.75)





PokerStars Hand #150802702650:  Hold'em No Limit ($1/$2 USD) - 2016/03/23 15:11:41 CET [2016/03/23 10:11:41 ET]
Table 'Clarissa II' 9-max Seat #7 is the button
Seat 1: DUkalisUA ($703.47 in chips) 
Seat 2: Igoriah ($205.24 in chips) 
Seat 3: PtizaXXX ($176.60 in chips) 
Seat 4: sanrs57 ($195 in chips) 
Seat 5: Red4erT ($83 in chips) 
Seat 6: matiko09 ($200 in chips) 
Seat 7: PacPacBum ($212 in chips) 
Seat 8: chaps1988 ($209.32 in chips) 
Seat 9: RamiroAgujis ($206 in chips) 
chaps1988: posts small blind $1
RamiroAgujis: posts big blind $2
*** HOLE CARDS ***
Dealt to matiko09 [Th Td]
DUkalisUA: raises $4 to $6
Igoriah: folds 
PtizaXXX: folds 
sanrs57: folds 
Red4erT: folds 
matiko09: calls $6
PacPacBum: folds 
chaps1988: folds 
RamiroAgujis: folds 
*** FLOP *** [7c 5h Jh]
DUkalisUA: bets $9
matiko09: calls $9
*** TURN *** [7c 5h Jh] [Kc]
DUkalisUA: bets $22
matiko09: folds 
Uncalled bet ($22) returned to DUkalisUA
DUkalisUA collected $31.52 from pot
DUkalisUA: doesn't show hand 
*** SUMMARY ***
Total pot $33 | Rake $1.48 
Board [7c 5h Jh Kc]
Seat 1: DUkalisUA collected ($31.52)
Seat 2: Igoriah folded before Flop (didn't bet)
Seat 3: PtizaXXX folded before Flop (didn't bet)
Seat 4: sanrs57 folded before Flop (didn't bet)
Seat 5: Red4erT folded before Flop (didn't bet)
Seat 6: matiko09 folded on the Turn
Seat 7: PacPacBum (button) folded before Flop (didn't bet)
Seat 8: chaps1988 (small blind) folded before Flop
Seat 9: RamiroAgujis (big blind) folded before Flop





PokerStars Hand #150802702882:  Hold'em No Limit ($0.50/$1.00 USD) - 2016/03/23 15:11:42 CET [2016/03/23 10:11:42 ET]
Table 'Drakonia II' 9-max Seat #1 is the button
Seat 1: chautinhtri9 ($131.10 in chips) 
Seat 2: carrsseis ($100 in chips) 
Seat 3: dunga119 ($98.08 in chips) 
Seat 4: nickreason17 ($113.72 in chips) 
Seat 5: gchs83 ($55.61 in chips) 
Seat 6: Dantist1122 ($107.76 in chips) 
Seat 7: YuriiSolodya ($27.90 in chips) 
Seat 8: matiko09 ($100 in chips) 
Seat 9: mycka86 ($100 in chips) 
carrsseis: posts small blind $0.50
dunga119: posts big blind $1
*** HOLE CARDS ***
Dealt to matiko09 [2s As]
nickreason17: folds 
gchs83: raises $1 to $2
Dantist1122: folds 
YuriiSolodya: folds 
matiko09: folds 
mycka86: folds 
chautinhtri9: folds 
carrsseis: folds 
dunga119: calls $1
*** FLOP *** [7d Ks Ah]
dunga119: checks 
gchs83: bets $2
dunga119: folds 
Uncalled bet ($2) returned to gchs83
gchs83 collected $4.30 from pot
gchs83: doesn't show hand 
*** SUMMARY ***
Total pot $4.50 | Rake $0.20 
Board [7d Ks Ah]
Seat 1: chautinhtri9 (button) folded before Flop (didn't bet)
Seat 2: carrsseis (small blind) folded before Flop
Seat 3: dunga119 (big blind) folded on the Flop
Seat 4: nickreason17 folded before Flop (didn't bet)
Seat 5: gchs83 collected ($4.30)
Seat 6: Dantist1122 folded before Flop (didn't bet)
Seat 7: YuriiSolodya folded before Flop (didn't bet)
Seat 8: matiko09 folded before Flop (didn't bet)
Seat 9: mycka86 folded before Flop (didn't bet)





PokerStars Hand #150802703060:  Hold'em No Limit ($0.50/$1.00 USD) - 2016/03/23 15:11:42 CET [2016/03/23 10:11:42 ET]
Table 'Asmodeus' 9-max Seat #9 is the button
Seat 1: Jimy Tiltman ($132.70 in chips) 
Seat 2: PacPacBum ($103.73 in chips) 
Seat 3: nickreason17 ($100 in chips) 
Seat 4: Effort92 ($100 in chips) 
Seat 5: Muinmyheart ($100 in chips) 
Seat 6: fuppeee ($77.46 in chips) 
Seat 7: mycka86 ($144.75 in chips) 
Seat 8: bonifacioppl ($62.05 in chips) 
Seat 9: matiko09 ($100 in chips) 
Jimy Tiltman: posts small blind $0.50
PacPacBum: posts big blind $1
Jimy Tiltman: posts the ante $0.20
PacPacBum: posts the ante $0.20
nickreason17: posts the ante $0.20
Effort92: posts the ante $0.20
Muinmyheart: posts the ante $0.20
fuppeee: posts the ante $0.20
mycka86: posts the ante $0.20
bonifacioppl: posts the ante $0.20
matiko09: posts the ante $0.20
*** HOLE CARDS ***
Dealt to matiko09 [4d 9h]
nickreason17: folds 
Effort92: folds 
Muinmyheart: folds 
fuppeee: raises $2 to $3
mycka86: folds 
bonifacioppl: folds 
matiko09: folds 
Jimy Tiltman: folds 
PacPacBum: calls $2
*** FLOP *** [Kh 6h 8h]
PacPacBum: checks 
fuppeee: bets $7.93
PacPacBum: folds 
Uncalled bet ($7.93) returned to fuppeee
fuppeee collected $7.93 from pot
*** SUMMARY ***
Total pot $8.30 | Rake $0.37 
Board [Kh 6h 8h]
Seat 1: Jimy Tiltman (small blind) folded before Flop
Seat 2: PacPacBum (big blind) folded on the Flop
Seat 3: nickreason17 folded before Flop (didn't bet)
Seat 4: Effort92 folded before Flop (didn't bet)
Seat 5: Muinmyheart folded before Flop (didn't bet)
Seat 6: fuppeee collected ($7.93)
Seat 7: mycka86 folded before Flop (didn't bet)
Seat 8: bonifacioppl folded before Flop (didn't bet)
Seat 9: matiko09 (button) folded before Flop (didn't bet)





PokerStars Hand #150802703927:  Hold'em No Limit ($0.25/$0.50 USD) - 2016/03/23 15:11:45 CET [2016/03/23 10:11:45 ET]
Table 'Pyrrhus' 9-max Seat #5 is the button
Seat 1: lumen21 ($86.41 in chips) 
Seat 2: BSTUSim ($61.62 in chips) 
Seat 3: Muinmyheart ($50 in chips) 
Seat 5: xxxibgdrgn ($62.08 in chips) 
Seat 6: Ahangama ($50 in chips) 
Seat 7: matiko09 ($136 in chips) 
Seat 8: suitedaces02 ($50 in chips) 
Seat 9: CvMCvMCvM ($89.05 in chips) 
Ahangama: posts small blind $0.25
matiko09: posts big blind $0.50
*** HOLE CARDS ***
Dealt to matiko09 [8s Td]
seblafstian joins the table at seat #4 
suitedaces02: folds 
CvMCvMCvM: raises $0.76 to $1.26
lumen21: folds 
BSTUSim: calls $1.26
Muinmyheart: folds 
xxxibgdrgn: folds 
Ahangama: folds 
matiko09: folds 
*** FLOP *** [Kd Kc 8d]
CvMCvMCvM: checks 
BSTUSim: bets $1.78
CvMCvMCvM: calls $1.78
*** TURN *** [Kd Kc 8d] [6h]
CvMCvMCvM: checks 
BSTUSim: bets $4.30
CvMCvMCvM: calls $4.30
*** RIVER *** [Kd Kc 8d 6h] [2h]
CvMCvMCvM: checks 
BSTUSim: bets $10.50
CvMCvMCvM: folds 
Uncalled bet ($10.50) returned to BSTUSim
BSTUSim collected $14.74 from pot
BSTUSim: doesn't show hand 
*** SUMMARY ***
Total pot $15.43 | Rake $0.69 
Board [Kd Kc 8d 6h 2h]
Seat 1: lumen21 folded before Flop (didn't bet)
Seat 2: BSTUSim collected ($14.74)
Seat 3: Muinmyheart folded before Flop (didn't bet)
Seat 5: xxxibgdrgn (button) folded before Flop (didn't bet)
Seat 6: Ahangama (small blind) folded before Flop
Seat 7: matiko09 (big blind) folded before Flop
Seat 8: suitedaces02 folded before Flop (didn't bet)
Seat 9: CvMCvMCvM folded on the River





PokerStars Hand #150802704799:  Hold'em No Limit ($0.50/$1.00 USD) - 2016/03/23 15:11:47 CET [2016/03/23 10:11:47 ET]
Table 'Sylvia III' 9-max Seat #8 is the button
Seat 1: mycka86 ($108.90 in chips) 
Seat 2: Dantist1122 ($105.60 in chips) 
Seat 3: se7en_$tars ($94 in chips) 
Seat 4: lombardo11 ($86.12 in chips) 
Seat 5: matiko09 ($100.79 in chips) 
Seat 6: PacPacBum ($100 in chips) 
Seat 7: easytalk777 ($94.03 in chips) 
Seat 8: nickreason17 ($115.29 in chips) 
Seat 9: Blanky-Bad ($91.97 in chips) 
Blanky-Bad: posts small blind $0.50
mycka86: posts big blind $1
mycka86: posts the ante $0.20
Dantist1122: posts the ante $0.20
se7en_$tars: posts the ante $0.20
lombardo11: posts the ante $0.20
matiko09: posts the ante $0.20
PacPacBum: posts the ante $0.20
easytalk777: posts the ante $0.20
nickreason17: posts the ante $0.20
Blanky-Bad: posts the ante $0.20
*** HOLE CARDS ***
Dealt to matiko09 [8s Jc]
Dantist1122: folds 
se7en_$tars: folds 
lombardo11: folds 
matiko09: folds 
PacPacBum: raises $1.50 to $2.50
easytalk777: folds 
nickreason17: folds 
Blanky-Bad: folds 
mycka86: folds 
Uncalled bet ($1.50) returned to PacPacBum
PacPacBum collected $4.30 from pot
PacPacBum: doesn't show hand 
*** SUMMARY ***
Total pot $4.30 | Rake $0 
Seat 1: mycka86 (big blind) folded before Flop
Seat 2: Dantist1122 folded before Flop (didn't bet)
Seat 3: se7en_$tars folded before Flop (didn't bet)
Seat 4: lombardo11 folded before Flop (didn't bet)
Seat 5: matiko09 folded before Flop (didn't bet)
Seat 6: PacPacBum collected ($4.30)
Seat 7: easytalk777 folded before Flop (didn't bet)
Seat 8: nickreason17 (button) folded before Flop (didn't bet)
Seat 9: Blanky-Bad (small blind) folded before Flop





PokerStars Hand #150802707771:  Hold'em No Limit ($0.50/$1.00 USD) - 2016/03/23 15:11:55 CET [2016/03/23 10:11:55 ET]
Table 'Swings' 9-max Seat #4 is the button
Seat 2: tomver0809 ($93.68 in chips) 
Seat 4: chaps1988 ($100 in chips) 
Seat 5: chautinhtri9 ($112.95 in chips) 
Seat 6: matiko09 ($140.92 in chips) 
Seat 7: PacPacBum ($111.22 in chips) 
Seat 8: RICKA16 ($100.46 in chips) 
Seat 9: Effort92 ($100 in chips) 
chautinhtri9: posts small blind $0.50
matiko09: posts big blind $1
tomver0809: posts small & big blinds $1.50
*** HOLE CARDS ***
Dealt to matiko09 [Qc 3c]
lumen21 joins the table at seat #1 
PacPacBum: folds 
RICKA16: folds 
Effort92: folds 
tomver0809: checks 
chaps1988: folds 
chautinhtri9: calls $0.50
matiko09: checks 
*** FLOP *** [Js 9s 6d]
chautinhtri9: checks 
matiko09: checks 
tomver0809: bets $3
chautinhtri9: folds 
matiko09: folds 
Uncalled bet ($3) returned to tomver0809
tomver0809 collected $3.34 from pot
tomver0809: doesn't show hand 
*** SUMMARY ***
Total pot $3.50 | Rake $0.16 
Board [Js 9s 6d]
Seat 2: tomver0809 collected ($3.34)
Seat 4: chaps1988 (button) folded before Flop (didn't bet)
Seat 5: chautinhtri9 (small blind) folded on the Flop
Seat 6: matiko09 (big blind) folded on the Flop
Seat 7: PacPacBum folded before Flop (didn't bet)
Seat 8: RICKA16 folded before Flop (didn't bet)
Seat 9: Effort92 folded before Flop (didn't bet)





PokerStars Hand #150802708140:  Hold'em No Limit (€0.50/€1.00 EUR) - 2016/03/23 15:11:56 CET [2016/03/23 10:11:56 ET]
Table 'Mercury III' 9-max Seat #4 is the button
Seat 1: matiko09 (€113.58 in chips) 
Seat 2: o.miro (€122.67 in chips) 
Seat 3: PacPacBum (€100.83 in chips) 
Seat 4: Muinmyheart (€101.50 in chips) 
Seat 5: DUkalisUA (€100 in chips) 
Seat 6: mycka86 (€101.50 in chips) 
Seat 7: STrakDD (€100 in chips) 
Seat 8: gfxed (€35.84 in chips) 
Seat 9: Indr3k (€100 in chips) 
DUkalisUA: posts small blind €0.50
mycka86: posts big blind €1
*** HOLE CARDS ***
Dealt to matiko09 [6h Tc]
STrakDD: folds 
gfxed: calls €1
Indr3k: folds 
matiko09: folds 
o.miro: folds 
PacPacBum: folds 
Muinmyheart: folds 
DUkalisUA: folds 
mycka86: checks 
*** FLOP *** [Jc 6c 6s]
mycka86: bets €2
gfxed: folds 
Uncalled bet (€2) returned to mycka86
mycka86 collected €2.39 from pot
*** SUMMARY ***
Total pot €2.50 | Rake €0.11 
Board [Jc 6c 6s]
Seat 1: matiko09 folded before Flop (didn't bet)
Seat 2: o.miro folded before Flop (didn't bet)
Seat 3: PacPacBum folded before Flop (didn't bet)
Seat 4: Muinmyheart (button) folded before Flop (didn't bet)
Seat 5: DUkalisUA (small blind) folded before Flop
Seat 6: mycka86 (big blind) collected (€2.39)
Seat 7: STrakDD folded before Flop (didn't bet)
Seat 8: gfxed folded on the Flop
Seat 9: Indr3k folded before Flop (didn't bet)





PokerStars Hand #150802710905:  Hold'em No Limit ($0.50/$1.00 USD) - 2016/03/23 15:12:04 CET [2016/03/23 10:12:04 ET]
Table 'Smiley' 9-max Seat #4 is the button
Seat 1: xHourglass ($104 in chips) 
Seat 2: Jimy Tiltman ($125.06 in chips) 
Seat 3: Robert201202 ($117.90 in chips) 
Seat 4: CAJUN890 ($94.71 in chips) 
Seat 7: nickreason17 ($100 in chips) 
Seat 8: matiko09 ($100 in chips) 
Seat 9: Pvsx. ($234.64 in chips) 
nickreason17: posts small blind $0.50
matiko09: posts big blind $1
*** HOLE CARDS ***
Dealt to matiko09 [Th 9d]
Pvsx.: folds 
xHourglass: folds 
Jimy Tiltman said, "(whew)"
Jimy Tiltman: raises $2 to $3
Robert201202: folds 
CAJUN890: folds 
nickreason17: folds 
matiko09: folds 
Uncalled bet ($2) returned to Jimy Tiltman
Jimy Tiltman collected $2.50 from pot
Jimy Tiltman: doesn't show hand 
*** SUMMARY ***
Total pot $2.50 | Rake $0 
Seat 1: xHourglass folded before Flop (didn't bet)
Seat 2: Jimy Tiltman collected ($2.50)
Seat 3: Robert201202 folded before Flop (didn't bet)
Seat 4: CAJUN890 (button) folded before Flop (didn't bet)
Seat 7: nickreason17 (small blind) folded before Flop
Seat 8: matiko09 (big blind) folded before Flop
Seat 9: Pvsx. folded before Flop (didn't bet)





PokerStars Hand #150802712827:  Hold'em No Limit ($1/$2 USD) - 2016/03/23 15:12:09 CET [2016/03/23 10:12:09 ET]
Table 'Kypria II' 9-max Seat #2 is the button
Seat 1: chaps1988 ($200 in chips) 
Seat 2: PacPacBum ($200 in chips) 
Seat 3: seouljam ($300.58 in chips) 
Seat 4: VolanDog ($217.72 in chips) 
Seat 5: Igoriah ($200 in chips) 
Seat 6: matiko09 ($450.25 in chips) 
Seat 7: DUkalisUA ($203 in chips) 
Seat 8: nickreason17 ($203.37 in chips) 
Seat 9: sanrs57 ($177.72 in chips) 
seouljam: posts small blind $1
VolanDog: posts big blind $2
*** HOLE CARDS ***
Dealt to matiko09 [9h Jc]
Igoriah: folds 
matiko09: folds 
DUkalisUA: folds 
nickreason17: raises $4 to $6
sanrs57: folds 
chaps1988: folds 
PacPacBum: folds 
seouljam: folds 
VolanDog: folds 
Uncalled bet ($4) returned to nickreason17
nickreason17 collected $5 from pot
*** SUMMARY ***
Total pot $5 | Rake $0 
Seat 1: chaps1988 folded before Flop (didn't bet)
Seat 2: PacPacBum (button) folded before Flop (didn't bet)
Seat 3: seouljam (small blind) folded before Flop
Seat 4: VolanDog (big blind) folded before Flop
Seat 5: Igoriah folded before Flop (didn't bet)
Seat 6: matiko09 folded before Flop (didn't bet)
Seat 7: DUkalisUA folded before Flop (didn't bet)
Seat 8: nickreason17 collected ($5)
Seat 9: sanrs57 folded before Flop (didn't bet)





PokerStars Hand #150802713798:  Hold'em No Limit ($1/$2 USD) - 2016/03/23 15:12:12 CET [2016/03/23 10:12:12 ET]
Table 'Kiess' 9-max Seat #2 is the button
Seat 1: Cirilico ($222.46 in chips) 
Seat 2: DUkalisUA ($702.28 in chips) 
Seat 3: Red4erT ($98.74 in chips) 
Seat 4: Igoriah ($200 in chips) 
Seat 6: matiko09 ($262.28 in chips) 
Seat 7: chaps1988 ($200 in chips) 
Seat 8: erfk1958 ($138.21 in chips) 
Seat 9: PacPacBum ($204.67 in chips) 
Red4erT: posts small blind $1
Igoriah: posts big blind $2
*** HOLE CARDS ***
Dealt to matiko09 [5h 9c]
matiko09: folds 
chaps1988: folds 
erfk1958: folds 
PacPacBum: folds 
Cirilico: folds 
DUkalisUA: folds 
Red4erT: raises $3 to $5
Igoriah: calls $3
*** FLOP *** [6d 3d 7c]
Red4erT: bets $4.96
Igoriah: folds 
Uncalled bet ($4.96) returned to Red4erT
Red4erT collected $9.55 from pot
Red4erT: doesn't show hand 
*** SUMMARY ***
Total pot $10 | Rake $0.45 
Board [6d 3d 7c]
Seat 1: Cirilico folded before Flop (didn't bet)
Seat 2: DUkalisUA (button) folded before Flop (didn't bet)
Seat 3: Red4erT (small blind) collected ($9.55)
Seat 4: Igoriah (big blind) folded on the Flop
Seat 6: matiko09 folded before Flop (didn't bet)
Seat 7: chaps1988 folded before Flop (didn't bet)
Seat 8: erfk1958 folded before Flop (didn't bet)
Seat 9: PacPacBum folded before Flop (didn't bet)





PokerStars Hand #150802715128:  Hold'em No Limit ($1/$2 USD) - 2016/03/23 15:12:15 CET [2016/03/23 10:12:15 ET]
Table 'Achaia' 9-max Seat #3 is the button
Seat 1: RamiroAgujis ($230.57 in chips) 
Seat 2: bananajoe001 ($206.81 in chips) 
Seat 3: matiko09 ($213.16 in chips) 
Seat 4: erfk1958 ($96.78 in chips) 
Seat 5: chaps1988 ($200 in chips) 
Seat 6: nickreason17 ($241.44 in chips) 
Seat 7: morosun ($257.26 in chips) 
Seat 8: IseeUcards ($208.86 in chips) 
Seat 9: PacPacBum ($204.35 in chips) 
erfk1958: posts small blind $1
chaps1988: posts big blind $2
*** HOLE CARDS ***
Dealt to matiko09 [3s Ks]
nickreason17: folds 
morosun: folds 
IseeUcards: folds 
nickreason17 leaves the table
PacPacBum: raises $2.08 to $4.08
RamiroAgujis: folds 
bananajoe001: calls $4.08
matiko09: folds 
XKTTBOBV11 joins the table at seat #6 
erfk1958: folds 
chaps1988: calls $2.08
*** FLOP *** [As 8d Qd]
chaps1988: checks 
PacPacBum: checks 
bananajoe001: bets $6
chaps1988: raises $13.30 to $19.30
PacPacBum: folds 
bananajoe001: calls $13.30
*** TURN *** [As 8d Qd] [Qs]
chaps1988: bets $37.44
bananajoe001: raises $48.56 to $86
chaps1988: raises $90.62 to $176.62 and is all-in
bananajoe001: calls $90.62
*** RIVER *** [As 8d Qd Qs] [7s]
*** SHOW DOWN ***
chaps1988: shows [Ad Qh] (a full house, Queens full of Aces)
bananajoe001: shows [8h 8s] (a full house, Eights full of Queens)
chaps1988 collected $402.28 from pot
*** SUMMARY ***
Total pot $405.08 | Rake $2.80 
Board [As 8d Qd Qs 7s]
Seat 1: RamiroAgujis folded before Flop (didn't bet)
Seat 2: bananajoe001 showed [8h 8s] and lost with a full house, Eights full of Queens
Seat 3: matiko09 (button) folded before Flop (didn't bet)
Seat 4: erfk1958 (small blind) folded before Flop
Seat 5: chaps1988 (big blind) showed [Ad Qh] and won ($402.28) with a full house, Queens full of Aces
Seat 6: nickreason17 folded before Flop (didn't bet)
Seat 7: morosun folded before Flop (didn't bet)
Seat 8: IseeUcards folded before Flop (didn't bet)
Seat 9: PacPacBum folded on the Flop





PokerStars Hand #150802716191:  Hold'em No Limit ($0.50/$1.00 USD) - 2016/03/23 15:12:18 CET [2016/03/23 10:12:18 ET]
Table 'Smiley' 9-max Seat #7 is the button
Seat 1: xHourglass ($104 in chips) 
Seat 2: Jimy Tiltman ($126.56 in chips) 
Seat 3: Robert201202 ($117.90 in chips) 
Seat 4: CAJUN890 ($94.71 in chips) 
Seat 7: nickreason17 ($100 in chips) 
Seat 8: matiko09 ($100 in chips) 
Seat 9: Pvsx. ($234.64 in chips) 
matiko09: posts small blind $0.50
Pvsx.: posts big blind $1
*** HOLE CARDS ***
Dealt to matiko09 [4d Jh]
xHourglass: folds 
Jimy Tiltman: folds 
Robert201202: folds 
CAJUN890: folds 
nickreason17: folds 
matiko09: folds 
Uncalled bet ($0.50) returned to Pvsx.
Pvsx. collected $1 from pot
Pvsx.: doesn't show hand 
*** SUMMARY ***
Total pot $1 | Rake $0 
Seat 1: xHourglass folded before Flop (didn't bet)
Seat 2: Jimy Tiltman folded before Flop (didn't bet)
Seat 3: Robert201202 folded before Flop (didn't bet)
Seat 4: CAJUN890 folded before Flop (didn't bet)
Seat 7: nickreason17 (button) folded before Flop (didn't bet)
Seat 8: matiko09 (small blind) folded before Flop
Seat 9: Pvsx. (big blind) collected ($1)





PokerStars Hand #150802717482:  Hold'em No Limit ($0.50/$1.00 USD) - 2016/03/23 15:12:22 CET [2016/03/23 10:12:22 ET]
Table 'Asmodeus' 9-max Seat #1 is the button
Seat 1: Jimy Tiltman ($132 in chips) 
Seat 2: PacPacBum ($100.53 in chips) 
Seat 4: Effort92 ($100 in chips) 
Seat 5: Muinmyheart ($100 in chips) 
Seat 6: fuppeee ($82.19 in chips) 
Seat 7: mycka86 ($144.55 in chips) 
Seat 8: bonifacioppl ($61.85 in chips) 
Seat 9: matiko09 ($100 in chips) 
PacPacBum: posts small blind $0.50
nickreason17: is sitting out 
Effort92: posts big blind $1
Jimy Tiltman: posts the ante $0.20
PacPacBum: posts the ante $0.20
Effort92: posts the ante $0.20
Muinmyheart: posts the ante $0.20
fuppeee: posts the ante $0.20
mycka86: posts the ante $0.20
bonifacioppl: posts the ante $0.20
matiko09: posts the ante $0.20
*** HOLE CARDS ***
Dealt to matiko09 [5h Jc]
nickreason17 leaves the table
Muinmyheart: folds 
fuppeee: folds 
mycka86: raises $2 to $3
bonifacioppl: calls $3
matiko09: folds 
Jimy Tiltman: calls $3
PacPacBum: folds 
edidaz joins the table at seat #3 
Effort92: folds 
*** FLOP *** [Ks 8s 9d]
edidaz leaves the table
mycka86: checks 
bonifacioppl: checks 
jahwe joins the table at seat #3 
Jimy Tiltman: bets $6.75
mycka86: folds 
bonifacioppl: folds 
Uncalled bet ($6.75) returned to Jimy Tiltman
Jimy Tiltman collected $11.56 from pot
Jimy Tiltman: doesn't show hand 
*** SUMMARY ***
Total pot $12.10 | Rake $0.54 
Board [Ks 8s 9d]
Seat 1: Jimy Tiltman (button) collected ($11.56)
Seat 2: PacPacBum (small blind) folded before Flop
Seat 4: Effort92 (big blind) folded before Flop
Seat 5: Muinmyheart folded before Flop (didn't bet)
Seat 6: fuppeee folded before Flop (didn't bet)
Seat 7: mycka86 folded on the Flop
Seat 8: bonifacioppl folded on the Flop
Seat 9: matiko09 folded before Flop (didn't bet)





PokerStars Hand #150802718881:  Hold'em No Limit ($0.50/$1.00 USD) - 2016/03/23 15:12:26 CET [2016/03/23 10:12:26 ET]
Table 'Sylvia III' 9-max Seat #9 is the button
Seat 1: mycka86 ($107.70 in chips) 
Seat 2: Dantist1122 ($105.40 in chips) 
Seat 3: se7en_$tars ($93.80 in chips) 
Seat 4: lombardo11 ($85.92 in chips) 
Seat 5: matiko09 ($100.59 in chips) 
Seat 6: PacPacBum ($103.10 in chips) 
Seat 7: easytalk777 ($93.83 in chips) 
Seat 8: nickreason17 ($115.09 in chips) 
Seat 9: Blanky-Bad ($91.27 in chips) 
mycka86: posts small blind $0.50
Dantist1122: posts big blind $1
mycka86: posts the ante $0.20
Dantist1122: posts the ante $0.20
se7en_$tars: posts the ante $0.20
lombardo11: posts the ante $0.20
matiko09: posts the ante $0.20
PacPacBum: posts the ante $0.20
easytalk777: posts the ante $0.20
nickreason17: posts the ante $0.20
Blanky-Bad: posts the ante $0.20
*** HOLE CARDS ***
Dealt to matiko09 [8c 6s]
se7en_$tars: calls $1
lombardo11: folds 
matiko09: folds 
PacPacBum: folds 
easytalk777: folds 
nickreason17: raises $3 to $4
Blanky-Bad: folds 
mycka86: folds 
Dantist1122: folds 
se7en_$tars: calls $3
*** FLOP *** [4c 9s Js]
se7en_$tars: checks 
nickreason17: bets $4.75
se7en_$tars: calls $4.75
*** TURN *** [4c 9s Js] [7h]
se7en_$tars: checks 
nickreason17: checks 
*** RIVER *** [4c 9s Js 7h] [4d]
se7en_$tars: bets $10
nickreason17: folds 
Uncalled bet ($10) returned to se7en_$tars
se7en_$tars collected $19.86 from pot
*** SUMMARY ***
Total pot $20.80 | Rake $0.94 
Board [4c 9s Js 7h 4d]
Seat 1: mycka86 (small blind) folded before Flop
Seat 2: Dantist1122 (big blind) folded before Flop
Seat 3: se7en_$tars collected ($19.86)
Seat 4: lombardo11 folded before Flop (didn't bet)
Seat 5: matiko09 folded before Flop (didn't bet)
Seat 6: PacPacBum folded before Flop (didn't bet)
Seat 7: easytalk777 folded before Flop (didn't bet)
Seat 8: nickreason17 folded on the River
Seat 9: Blanky-Bad (button) folded before Flop (didn't bet)





PokerStars Hand #150802721667:  Hold'em No Limit ($0.50/$1.00 USD) - 2016/03/23 15:12:33 CET [2016/03/23 10:12:33 ET]
Table 'Smiley' 9-max Seat #8 is the button
Seat 1: xHourglass ($104 in chips) 
Seat 2: Jimy Tiltman ($126.56 in chips) 
Seat 3: Robert201202 ($117.90 in chips) 
Seat 4: CAJUN890 ($94.71 in chips) 
Seat 7: nickreason17 ($100 in chips) 
Seat 8: matiko09 ($100 in chips) 
Seat 9: Pvsx. ($235.14 in chips) 
Pvsx.: posts small blind $0.50
xHourglass: posts big blind $1
*** HOLE CARDS ***
Dealt to matiko09 [Ah Qc]
Jimy Tiltman: raises $2 to $3
Robert201202: folds 
CAJUN890: folds 
nickreason17: folds 
matiko09: calls $3
Pvsx.: folds 
xHourglass: folds 
*** FLOP *** [Qh Th Qs]
Jimy Tiltman: bets $4
matiko09: calls $4
*** TURN *** [Qh Th Qs] [9s]
Jimy Tiltman: checks 
matiko09: bets $10
Jimy Tiltman: folds 
Uncalled bet ($10) returned to matiko09
matiko09 collected $14.80 from pot
matiko09: doesn't show hand 
*** SUMMARY ***
Total pot $15.50 | Rake $0.70 
Board [Qh Th Qs 9s]
Seat 1: xHourglass (big blind) folded before Flop
Seat 2: Jimy Tiltman folded on the Turn
Seat 3: Robert201202 folded before Flop (didn't bet)
Seat 4: CAJUN890 folded before Flop (didn't bet)
Seat 7: nickreason17 folded before Flop (didn't bet)
Seat 8: matiko09 (button) collected ($14.80)
Seat 9: Pvsx. (small blind) folded before Flop





PokerStars Hand #150802724174:  Hold'em No Limit ($0.50/$1.00 USD) - 2016/03/23 15:12:40 CET [2016/03/23 10:12:40 ET]
Table 'Drakonia II' 9-max Seat #2 is the button
Seat 1: chautinhtri9 ($131.10 in chips) 
Seat 2: carrsseis ($100 in chips) 
Seat 3: dunga119 ($96.08 in chips) 
Seat 5: gchs83 ($57.91 in chips) 
Seat 6: Dantist1122 ($107.76 in chips) 
Seat 7: YuriiSolodya ($27.90 in chips) 
Seat 8: matiko09 ($100 in chips) 
Seat 9: mycka86 ($100 in chips) 
dunga119: posts small blind $0.50
nickreason17: is sitting out 
nickreason17 leaves the table
gchs83: posts big blind $1
*** HOLE CARDS ***
Dealt to matiko09 [7d 9c]
Dantist1122: folds 
YuriiSolodya: folds 
lumen21 joins the table at seat #4 
matiko09: folds 
mycka86: folds 
chautinhtri9: folds 
carrsseis: raises $1.20 to $2.20
dunga119: folds 
gchs83: folds 
Uncalled bet ($1.20) returned to carrsseis
carrsseis collected $2.50 from pot
carrsseis: doesn't show hand 
*** SUMMARY ***
Total pot $2.50 | Rake $0 
Seat 1: chautinhtri9 folded before Flop (didn't bet)
Seat 2: carrsseis (button) collected ($2.50)
Seat 3: dunga119 (small blind) folded before Flop
Seat 5: gchs83 (big blind) folded before Flop
Seat 6: Dantist1122 folded before Flop (didn't bet)
Seat 7: YuriiSolodya folded before Flop (didn't bet)
Seat 8: matiko09 folded before Flop (didn't bet)
Seat 9: mycka86 folded before Flop (didn't bet)





PokerStars Hand #150802724994:  Hold'em No Limit ($0.50/$1.00 USD) - 2016/03/23 15:12:42 CET [2016/03/23 10:12:42 ET]
Table 'Swings' 9-max Seat #5 is the button
Seat 2: tomver0809 ($95.52 in chips) 
Seat 4: chaps1988 ($100 in chips) 
Seat 5: chautinhtri9 ($111.95 in chips) 
Seat 6: matiko09 ($139.92 in chips) 
Seat 7: PacPacBum ($111.22 in chips) 
Seat 8: RICKA16 ($100.46 in chips) 
Seat 9: Effort92 ($100 in chips) 
matiko09: posts small blind $0.50
PacPacBum: posts big blind $1
lumen21: sits out 
*** HOLE CARDS ***
Dealt to matiko09 [Ac Qh]
RICKA16: folds 
Effort92: folds 
tomver0809: calls $1
chaps1988: folds 
chautinhtri9: folds 
matiko09: raises $4 to $5
PacPacBum: folds 
tomver0809: calls $4
*** FLOP *** [Th As Qs]
matiko09: bets $7
tomver0809: folds 
Uncalled bet ($7) returned to matiko09
matiko09 collected $10.50 from pot
matiko09: doesn't show hand 
*** SUMMARY ***
Total pot $11 | Rake $0.50 
Board [Th As Qs]
Seat 2: tomver0809 folded on the Flop
Seat 4: chaps1988 folded before Flop (didn't bet)
Seat 5: chautinhtri9 (button) folded before Flop (didn't bet)
Seat 6: matiko09 (small blind) collected ($10.50)
Seat 7: PacPacBum (big blind) folded before Flop
Seat 8: RICKA16 folded before Flop (didn't bet)
Seat 9: Effort92 folded before Flop (didn't bet)





PokerStars Hand #150802726361:  Hold'em No Limit (€0.50/€1.00 EUR) - 2016/03/23 15:12:46 CET [2016/03/23 10:12:46 ET]
Table 'Mercury III' 9-max Seat #5 is the button
Seat 1: matiko09 (€113.58 in chips) 
Seat 2: o.miro (€122.67 in chips) 
Seat 3: PacPacBum (€100.83 in chips) 
Seat 4: Muinmyheart (€101.50 in chips) 
Seat 5: DUkalisUA (€100 in chips) 
Seat 6: mycka86 (€102.89 in chips) 
Seat 7: STrakDD (€100 in chips) 
Seat 8: gfxed (€34.84 in chips) 
Seat 9: Indr3k (€100 in chips) 
mycka86: posts small blind €0.50
STrakDD: posts big blind €1
*** HOLE CARDS ***
Dealt to matiko09 [8h Tc]
gfxed: raises €2 to €3
Indr3k: folds 
matiko09: folds 
o.miro: folds 
PacPacBum: folds 
Muinmyheart: folds 
DUkalisUA: folds 
mycka86: folds 
STrakDD: folds 
Uncalled bet (€2) returned to gfxed
gfxed collected €2.50 from pot
*** SUMMARY ***
Total pot €2.50 | Rake €0 
Seat 1: matiko09 folded before Flop (didn't bet)
Seat 2: o.miro folded before Flop (didn't bet)
Seat 3: PacPacBum folded before Flop (didn't bet)
Seat 4: Muinmyheart folded before Flop (didn't bet)
Seat 5: DUkalisUA (button) folded before Flop (didn't bet)
Seat 6: mycka86 (small blind) folded before Flop
Seat 7: STrakDD (big blind) folded before Flop
Seat 8: gfxed collected (€2.50)
Seat 9: Indr3k folded before Flop (didn't bet)





PokerStars Hand #150802727108:  Hold'em No Limit ($1/$2 USD) - 2016/03/23 15:12:48 CET [2016/03/23 10:12:48 ET]
Table 'Kypria II' 9-max Seat #3 is the button
Seat 1: chaps1988 ($200 in chips) 
Seat 2: PacPacBum ($200 in chips) 
Seat 3: seouljam ($299.58 in chips) 
Seat 4: VolanDog ($215.72 in chips) 
Seat 5: Igoriah ($200 in chips) 
Seat 6: matiko09 ($450.25 in chips) 
Seat 7: DUkalisUA ($203 in chips) 
Seat 8: nickreason17 ($206.37 in chips) 
Seat 9: sanrs57 ($177.72 in chips) 
VolanDog: posts small blind $1
Igoriah: posts big blind $2
*** HOLE CARDS ***
Dealt to matiko09 [3h 9c]
matiko09: folds 
DUkalisUA: folds 
nickreason17: folds 
sanrs57: raises $4 to $6
chaps1988: folds 
PacPacBum: folds 
seouljam: calls $6
VolanDog: folds 
Igoriah: raises $24 to $30
sanrs57: calls $24
seouljam: folds 
*** FLOP *** [7d Qs 9d]
Igoriah: bets $29
sanrs57: calls $29
*** TURN *** [7d Qs 9d] [Kd]
Igoriah: bets $122.20
sanrs57: folds 
Uncalled bet ($122.20) returned to Igoriah
Igoriah collected $122.20 from pot
Igoriah: doesn't show hand 
*** SUMMARY ***
Total pot $125 | Rake $2.80 
Board [7d Qs 9d Kd]
Seat 1: chaps1988 folded before Flop (didn't bet)
Seat 2: PacPacBum folded before Flop (didn't bet)
Seat 3: seouljam (button) folded before Flop
Seat 4: VolanDog (small blind) folded before Flop
Seat 5: Igoriah (big blind) collected ($122.20)
Seat 6: matiko09 folded before Flop (didn't bet)
Seat 7: DUkalisUA folded before Flop (didn't bet)
Seat 8: nickreason17 folded before Flop (didn't bet)
Seat 9: sanrs57 folded on the Turn





PokerStars Hand #150802728207:  Hold'em No Limit ($1/$2 USD) - 2016/03/23 15:12:51 CET [2016/03/23 10:12:51 ET]
Table 'Kiess' 9-max Seat #3 is the button
Seat 1: Cirilico ($222.46 in chips) 
Seat 2: DUkalisUA ($702.28 in chips) 
Seat 3: Red4erT ($103.29 in chips) 
Seat 4: Igoriah ($200 in chips) 
Seat 6: matiko09 ($262.28 in chips) 
Seat 7: chaps1988 ($200 in chips) 
Seat 8: erfk1958 ($138.21 in chips) 
Seat 9: PacPacBum ($204.67 in chips) 
Igoriah: posts small blind $1
matiko09: posts big blind $2
*** HOLE CARDS ***
Dealt to matiko09 [6d Th]
chaps1988: folds 
erfk1958: folds 
PacPacBum: folds 
Cirilico: folds 
DUkalisUA: folds 
Red4erT: raises $3 to $5
Igoriah: folds 
matiko09: folds 
Uncalled bet ($3) returned to Red4erT
Red4erT collected $5 from pot
Red4erT: doesn't show hand 
*** SUMMARY ***
Total pot $5 | Rake $0 
Seat 1: Cirilico folded before Flop (didn't bet)
Seat 2: DUkalisUA folded before Flop (didn't bet)
Seat 3: Red4erT (button) collected ($5)
Seat 4: Igoriah (small blind) folded before Flop
Seat 6: matiko09 (big blind) folded before Flop
Seat 7: chaps1988 folded before Flop (didn't bet)
Seat 8: erfk1958 folded before Flop (didn't bet)
Seat 9: PacPacBum folded before Flop (didn't bet)





PokerStars Hand #150802731371:  Hold'em No Limit ($1/$2 USD) - 2016/03/23 15:13:00 CET [2016/03/23 10:13:00 ET]
Table 'Clarissa II' 9-max Seat #8 is the button
Seat 2: Igoriah ($205.24 in chips) 
Seat 3: PtizaXXX ($176.60 in chips) 
Seat 4: sanrs57 ($195 in chips) 
Seat 5: Red4erT ($83 in chips) 
Seat 6: matiko09 ($200 in chips) 
Seat 7: PacPacBum ($212 in chips) 
Seat 8: chaps1988 ($208.32 in chips) 
Seat 9: RamiroAgujis ($204 in chips) 
RamiroAgujis: posts small blind $1
DUkalisUA: is sitting out 
Igoriah: posts big blind $2
*** HOLE CARDS ***
Dealt to matiko09 [2s Js]
DUkalisUA leaves the table
IseeUcards joins the table at seat #1 
PtizaXXX: folds 
sanrs57: folds 
Red4erT: folds 
matiko09: folds 
PacPacBum: folds 
chaps1988: folds 
RamiroAgujis: raises $3 to $5
Igoriah: raises $12 to $17
RamiroAgujis: folds 
Uncalled bet ($12) returned to Igoriah
Igoriah collected $10 from pot
Igoriah: doesn't show hand 
*** SUMMARY ***
Total pot $10 | Rake $0 
Seat 2: Igoriah (big blind) collected ($10)
Seat 3: PtizaXXX folded before Flop (didn't bet)
Seat 4: sanrs57 folded before Flop (didn't bet)
Seat 5: Red4erT folded before Flop (didn't bet)
Seat 6: matiko09 folded before Flop (didn't bet)
Seat 7: PacPacBum folded before Flop (didn't bet)
Seat 8: chaps1988 (button) folded before Flop (didn't bet)
Seat 9: RamiroAgujis (small blind) folded before Flop





PokerStars Hand #150802734448:  Hold'em No Limit ($0.50/$1.00 USD) - 2016/03/23 15:13:08 CET [2016/03/23 10:13:08 ET]
Table 'Drakonia II' 9-max Seat #3 is the button
Seat 1: chautinhtri9 ($131.10 in chips) 
Seat 2: carrsseis ($101.50 in chips) 
Seat 3: dunga119 ($95.58 in chips) 
Seat 5: gchs83 ($56.91 in chips) 
Seat 6: Dantist1122 ($107.76 in chips) 
Seat 7: YuriiSolodya ($27.90 in chips) 
Seat 8: matiko09 ($100 in chips) 
Seat 9: mycka86 ($100 in chips) 
lumen21 will be allowed to play after the button
gchs83: posts small blind $0.50
Dantist1122: posts big blind $1
*** HOLE CARDS ***
Dealt to matiko09 [Jd 7c]
YuriiSolodya: folds 
matiko09: folds 
mycka86: folds 
chautinhtri9: folds 
carrsseis: folds 
dunga119: folds 
gchs83: folds 
Uncalled bet ($0.50) returned to Dantist1122
Dantist1122 collected $1 from pot
Dantist1122: doesn't show hand 
*** SUMMARY ***
Total pot $1 | Rake $0 
Seat 1: chautinhtri9 folded before Flop (didn't bet)
Seat 2: carrsseis folded before Flop (didn't bet)
Seat 3: dunga119 (button) folded before Flop (didn't bet)
Seat 5: gchs83 (small blind) folded before Flop
Seat 6: Dantist1122 (big blind) collected ($1)
Seat 7: YuriiSolodya folded before Flop (didn't bet)
Seat 8: matiko09 folded before Flop (didn't bet)
Seat 9: mycka86 folded before Flop (didn't bet)





PokerStars Hand #150802738457:  Hold'em No Limit (€0.50/€1.00 EUR) - 2016/03/23 15:13:19 CET [2016/03/23 10:13:19 ET]
Table 'Mercury III' 9-max Seat #6 is the button
Seat 1: matiko09 (€113.58 in chips) 
Seat 2: o.miro (€122.67 in chips) 
Seat 3: PacPacBum (€100.83 in chips) 
Seat 4: Muinmyheart (€101.50 in chips) 
Seat 5: DUkalisUA (€100 in chips) 
Seat 6: mycka86 (€102.39 in chips) 
Seat 7: STrakDD (€100 in chips) 
Seat 8: gfxed (€36.34 in chips) 
Seat 9: Indr3k (€100 in chips) 
STrakDD: posts small blind €0.50
gfxed: posts big blind €1
*** HOLE CARDS ***
Dealt to matiko09 [8c Ad]
Indr3k: folds 
matiko09: folds 
o.miro: folds 
PacPacBum: folds 
Muinmyheart: folds 
DUkalisUA: folds 
mycka86: raises €1.10 to €2.10
STrakDD: folds 
gfxed: folds 
Uncalled bet (€1.10) returned to mycka86
mycka86 collected €2.50 from pot
*** SUMMARY ***
Total pot €2.50 | Rake €0 
Seat 1: matiko09 folded before Flop (didn't bet)
Seat 2: o.miro folded before Flop (didn't bet)
Seat 3: PacPacBum folded before Flop (didn't bet)
Seat 4: Muinmyheart folded before Flop (didn't bet)
Seat 5: DUkalisUA folded before Flop (didn't bet)
Seat 6: mycka86 (button) collected (€2.50)
Seat 7: STrakDD (small blind) folded before Flop
Seat 8: gfxed (big blind) folded before Flop
Seat 9: Indr3k folded before Flop (didn't bet)





PokerStars Hand #150802740068:  Hold'em No Limit ($0.50/$1.00 USD) - 2016/03/23 15:13:24 CET [2016/03/23 10:13:24 ET]
Table 'Asmodeus' 9-max Seat #2 is the button
Seat 1: Jimy Tiltman ($140.36 in chips) 
Seat 2: PacPacBum ($100 in chips) 
Seat 4: Effort92 ($100 in chips) 
Seat 5: Muinmyheart ($100 in chips) 
Seat 6: fuppeee ($81.99 in chips) 
Seat 7: mycka86 ($141.35 in chips) 
Seat 8: bonifacioppl ($58.65 in chips) 
Seat 9: matiko09 ($100 in chips) 
jahwe will be allowed to play after the button
Effort92: posts small blind $0.50
Muinmyheart: posts big blind $1
Jimy Tiltman: posts the ante $0.20
PacPacBum: posts the ante $0.20
Effort92: posts the ante $0.20
Muinmyheart: posts the ante $0.20
fuppeee: posts the ante $0.20
mycka86: posts the ante $0.20
bonifacioppl: posts the ante $0.20
matiko09: posts the ante $0.20
*** HOLE CARDS ***
Dealt to matiko09 [Jh 6s]
fuppeee: calls $1
mycka86: folds 
bonifacioppl: folds 
matiko09: folds 
Jimy Tiltman: folds 
PacPacBum: folds 
Effort92: folds 
Muinmyheart: checks 
*** FLOP *** [4s Ts 7d]
Muinmyheart: checks 
fuppeee: checks 
*** TURN *** [4s Ts 7d] [Ac]
Muinmyheart: checks 
fuppeee: bets $1.96
Muinmyheart: folds 
Uncalled bet ($1.96) returned to fuppeee
fuppeee collected $3.92 from pot
*** SUMMARY ***
Total pot $4.10 | Rake $0.18 
Board [4s Ts 7d Ac]
Seat 1: Jimy Tiltman folded before Flop (didn't bet)
Seat 2: PacPacBum (button) folded before Flop (didn't bet)
Seat 4: Effort92 (small blind) folded before Flop
Seat 5: Muinmyheart (big blind) folded on the Turn
Seat 6: fuppeee collected ($3.92)
Seat 7: mycka86 folded before Flop (didn't bet)
Seat 8: bonifacioppl folded before Flop (didn't bet)
Seat 9: matiko09 folded before Flop (didn't bet)





PokerStars Hand #150802740768:  Hold'em No Limit ($1/$2 USD) - 2016/03/23 15:13:25 CET [2016/03/23 10:13:25 ET]
Table 'Kiess' 9-max Seat #4 is the button
Seat 1: Cirilico ($222.46 in chips) 
Seat 2: DUkalisUA ($702.28 in chips) 
Seat 3: Red4erT ($106.29 in chips) 
Seat 4: Igoriah ($200 in chips) 
Seat 6: matiko09 ($260.28 in chips) 
Seat 7: chaps1988 ($200 in chips) 
Seat 8: erfk1958 ($138.21 in chips) 
Seat 9: PacPacBum ($204.67 in chips) 
matiko09: posts small blind $1
chaps1988: posts big blind $2
*** HOLE CARDS ***
Dealt to matiko09 [6s 2d]
erfk1958: folds 
PacPacBum: folds 
Cirilico: folds 
DUkalisUA: folds 
Red4erT: folds 
Igoriah: folds 
matiko09: folds 
Uncalled bet ($1) returned to chaps1988
chaps1988 collected $2 from pot
chaps1988: doesn't show hand 
*** SUMMARY ***
Total pot $2 | Rake $0 
Seat 1: Cirilico folded before Flop (didn't bet)
Seat 2: DUkalisUA folded before Flop (didn't bet)
Seat 3: Red4erT folded before Flop (didn't bet)
Seat 4: Igoriah (button) folded before Flop (didn't bet)
Seat 6: matiko09 (small blind) folded before Flop
Seat 7: chaps1988 (big blind) collected ($2)
Seat 8: erfk1958 folded before Flop (didn't bet)
Seat 9: PacPacBum folded before Flop (didn't bet)





PokerStars Hand #150802741452:  Hold'em No Limit ($0.50/$1.00 USD) - 2016/03/23 15:13:27 CET [2016/03/23 10:13:27 ET]
Table 'Drakonia II' 9-max Seat #5 is the button
Seat 1: chautinhtri9 ($131.10 in chips) 
Seat 2: carrsseis ($101.50 in chips) 
Seat 3: dunga119 ($95.58 in chips) 
Seat 5: gchs83 ($56.41 in chips) 
Seat 6: Dantist1122 ($108.26 in chips) 
Seat 7: YuriiSolodya ($27.90 in chips) 
Seat 8: matiko09 ($100 in chips) 
Seat 9: mycka86 ($100 in chips) 
Dantist1122: posts small blind $0.50
YuriiSolodya: posts big blind $1
lumen21: sits out 
*** HOLE CARDS ***
Dealt to matiko09 [9h 7h]
matiko09: folds 
mycka86: folds 
chautinhtri9: folds 
carrsseis: raises $2 to $3
dunga119: folds 
gchs83: folds 
Dantist1122: folds 
YuriiSolodya: folds 
Uncalled bet ($2) returned to carrsseis
carrsseis collected $2.50 from pot
carrsseis: doesn't show hand 
*** SUMMARY ***
Total pot $2.50 | Rake $0 
Seat 1: chautinhtri9 folded before Flop (didn't bet)
Seat 2: carrsseis collected ($2.50)
Seat 3: dunga119 folded before Flop (didn't bet)
Seat 5: gchs83 (button) folded before Flop (didn't bet)
Seat 6: Dantist1122 (small blind) folded before Flop
Seat 7: YuriiSolodya (big blind) folded before Flop
Seat 8: matiko09 folded before Flop (didn't bet)
Seat 9: mycka86 folded before Flop (didn't bet)





PokerStars Hand #150802741535:  Hold'em No Limit ($0.25/$0.50 USD) - 2016/03/23 15:13:28 CET [2016/03/23 10:13:28 ET]
Table 'Pyrrhus' 9-max Seat #6 is the button
Seat 1: lumen21 ($86.41 in chips) 
Seat 2: BSTUSim ($69.02 in chips) 
Seat 3: Muinmyheart ($50 in chips) 
Seat 5: xxxibgdrgn ($62.08 in chips) 
Seat 6: Ahangama ($50 in chips) 
Seat 7: matiko09 ($135.50 in chips) 
Seat 8: suitedaces02 ($50 in chips) 
Seat 9: CvMCvMCvM ($81.71 in chips) 
matiko09: posts small blind $0.25
suitedaces02: posts big blind $0.50
seblafstian: sits out 
*** HOLE CARDS ***
Dealt to matiko09 [4h 4c]
CvMCvMCvM: folds 
lumen21: folds 
BSTUSim: raises $1 to $1.50
Muinmyheart: folds 
lumen21 leaves the table
xxxibgdrgn: folds 
Ahangama: folds 
matiko09: folds 
Indr3k joins the table at seat #1 
Indr3k leaves the table
nubpoker joins the table at seat #1 
suitedaces02: folds 
Uncalled bet ($1) returned to BSTUSim
BSTUSim collected $1.25 from pot
BSTUSim: doesn't show hand 
*** SUMMARY ***
Total pot $1.25 | Rake $0 
Seat 1: lumen21 folded before Flop (didn't bet)
Seat 2: BSTUSim collected ($1.25)
Seat 3: Muinmyheart folded before Flop (didn't bet)
Seat 5: xxxibgdrgn folded before Flop (didn't bet)
Seat 6: Ahangama (button) folded before Flop (didn't bet)
Seat 7: matiko09 (small blind) folded before Flop
Seat 8: suitedaces02 (big blind) folded before Flop
Seat 9: CvMCvMCvM folded before Flop (didn't bet)





PokerStars Hand #150802742760:  Hold'em No Limit ($0.50/$1.00 USD) - 2016/03/23 15:13:31 CET [2016/03/23 10:13:31 ET]
Table 'Smiley' 9-max Seat #9 is the button
Seat 1: xHourglass ($103 in chips) 
Seat 2: Jimy Tiltman ($119.56 in chips) 
Seat 3: Robert201202 ($117.90 in chips) 
Seat 4: CAJUN890 ($94.71 in chips) 
Seat 7: nickreason17 ($100 in chips) 
Seat 8: matiko09 ($107.80 in chips) 
Seat 9: Pvsx. ($234.64 in chips) 
xHourglass: posts small blind $0.50
Jimy Tiltman: posts big blind $1
*** HOLE CARDS ***
Dealt to matiko09 [Qc 2d]
Robert201202: raises $2 to $3
CAJUN890: folds 
nickreason17: folds 
matiko09: folds 
Pvsx.: folds 
xHourglass: calls $2.50
Jimy Tiltman: folds 
*** FLOP *** [6c 3d 7s]
xHourglass: checks 
Robert201202: checks 
*** TURN *** [6c 3d 7s] [Ts]
xHourglass: bets $4.50
Robert201202: calls $4.50
*** RIVER *** [6c 3d 7s Ts] [8s]
xHourglass: checks 
Robert201202: checks 
*** SHOW DOWN ***
xHourglass: shows [Kh Js] (high card King)
Robert201202: shows [Kd 8c] (a pair of Eights)
Robert201202 collected $15.28 from pot
*** SUMMARY ***
Total pot $16 | Rake $0.72 
Board [6c 3d 7s Ts 8s]
Seat 1: xHourglass (small blind) showed [Kh Js] and lost with high card King
Seat 2: Jimy Tiltman (big blind) folded before Flop
Seat 3: Robert201202 showed [Kd 8c] and won ($15.28) with a pair of Eights
Seat 4: CAJUN890 folded before Flop (didn't bet)
Seat 7: nickreason17 folded before Flop (didn't bet)
Seat 8: matiko09 folded before Flop (didn't bet)
Seat 9: Pvsx. (button) folded before Flop (didn't bet)





PokerStars Hand #150802743730:  Hold'em No Limit ($0.50/$1.00 USD) - 2016/03/23 15:13:34 CET [2016/03/23 10:13:34 ET]
Table 'Swings' 9-max Seat #6 is the button
Seat 2: tomver0809 ($90.52 in chips) 
Seat 4: chaps1988 ($100 in chips) 
Seat 5: chautinhtri9 ($111.95 in chips) 
Seat 6: matiko09 ($145.42 in chips) 
Seat 7: PacPacBum ($110.22 in chips) 
Seat 8: RICKA16 ($100.46 in chips) 
Seat 9: Effort92 ($100 in chips) 
PacPacBum: posts small blind $0.50
RICKA16: posts big blind $1
lumen21: sits out 
*** HOLE CARDS ***
Dealt to matiko09 [6d 3h]
Effort92: folds 
tomver0809: folds 
chaps1988: raises $2 to $3
chautinhtri9: folds 
matiko09: folds 
PacPacBum: folds 
RICKA16: folds 
Uncalled bet ($2) returned to chaps1988
chaps1988 collected $2.50 from pot
chaps1988: doesn't show hand 
*** SUMMARY ***
Total pot $2.50 | Rake $0 
Seat 2: tomver0809 folded before Flop (didn't bet)
Seat 4: chaps1988 collected ($2.50)
Seat 5: chautinhtri9 folded before Flop (didn't bet)
Seat 6: matiko09 (button) folded before Flop (didn't bet)
Seat 7: PacPacBum (small blind) folded before Flop
Seat 8: RICKA16 (big blind) folded before Flop
Seat 9: Effort92 folded before Flop (didn't bet)





PokerStars Hand #150802744540:  Hold'em No Limit ($0.50/$1.00 USD) - 2016/03/23 15:13:36 CET [2016/03/23 10:13:36 ET]
Table 'Sylvia III' 9-max Seat #1 is the button
Seat 1: mycka86 ($107 in chips) 
Seat 2: Dantist1122 ($104.20 in chips) 
Seat 3: se7en_$tars ($104.71 in chips) 
Seat 4: lombardo11 ($85.72 in chips) 
Seat 5: matiko09 ($100.39 in chips) 
Seat 6: PacPacBum ($102.90 in chips) 
Seat 7: easytalk777 ($93.63 in chips) 
Seat 8: nickreason17 ($106.14 in chips) 
Seat 9: Blanky-Bad ($91.07 in chips) 
Dantist1122: posts small blind $0.50
se7en_$tars: posts big blind $1
mycka86: posts the ante $0.20
Dantist1122: posts the ante $0.20
se7en_$tars: posts the ante $0.20
lombardo11: posts the ante $0.20
matiko09: posts the ante $0.20
PacPacBum: posts the ante $0.20
easytalk777: posts the ante $0.20
nickreason17: posts the ante $0.20
Blanky-Bad: posts the ante $0.20
*** HOLE CARDS ***
Dealt to matiko09 [4d Ad]
lombardo11: raises $1 to $2
matiko09: folds 
PacPacBum: folds 
easytalk777: folds 
nickreason17: folds 
Blanky-Bad: folds 
mycka86: folds 
Dantist1122: folds 
se7en_$tars: calls $1
*** FLOP *** [Th 3c 4c]
se7en_$tars: checks 
lombardo11: bets $3
se7en_$tars: calls $3
*** TURN *** [Th 3c 4c] [Qs]
se7en_$tars: checks 
lombardo11: bets $6
se7en_$tars: calls $6
*** RIVER *** [Th 3c 4c Qs] [7d]
se7en_$tars: checks 
lombardo11: bets $12
se7en_$tars: raises $47 to $59
lombardo11: folds 
Uncalled bet ($47) returned to se7en_$tars
se7en_$tars collected $46.13 from pot
se7en_$tars: doesn't show hand 
*** SUMMARY ***
Total pot $48.30 | Rake $2.17 
Board [Th 3c 4c Qs 7d]
Seat 1: mycka86 (button) folded before Flop (didn't bet)
Seat 2: Dantist1122 (small blind) folded before Flop
Seat 3: se7en_$tars (big blind) collected ($46.13)
Seat 4: lombardo11 folded on the River
Seat 5: matiko09 folded before Flop (didn't bet)
Seat 6: PacPacBum folded before Flop (didn't bet)
Seat 7: easytalk777 folded before Flop (didn't bet)
Seat 8: nickreason17 folded before Flop (didn't bet)
Seat 9: Blanky-Bad folded before Flop (didn't bet)





PokerStars Hand #150802749505:  Hold'em No Limit ($0.50/$1.00 USD) - 2016/03/23 15:13:50 CET [2016/03/23 10:13:50 ET]
Table 'Drakonia II' 9-max Seat #6 is the button
Seat 1: chautinhtri9 ($131.10 in chips) 
Seat 2: carrsseis ($103 in chips) 
Seat 3: dunga119 ($95.58 in chips) 
Seat 5: gchs83 ($56.41 in chips) 
Seat 6: Dantist1122 ($107.76 in chips) 
Seat 7: YuriiSolodya ($26.90 in chips) 
Seat 8: matiko09 ($100 in chips) 
Seat 9: mycka86 ($100 in chips) 
YuriiSolodya: posts small blind $0.50
matiko09: posts big blind $1
lumen21: sits out 
*** HOLE CARDS ***
Dealt to matiko09 [7s 2d]
mycka86: folds 
chautinhtri9: raises $1 to $2
carrsseis: folds 
dunga119: calls $2
gchs83: calls $2
Dantist1122: folds 
YuriiSolodya: folds 
matiko09: folds 
*** FLOP *** [4s Kd Ac]
chautinhtri9: checks 
dunga119: bets $7.16
gchs83: calls $7.16
chautinhtri9: folds 
*** TURN *** [4s Kd Ac] [Tc]
dunga119: bets $20.84
gchs83: raises $26.41 to $47.25 and is all-in
dunga119: calls $26.41
*** RIVER *** [4s Kd Ac Tc] [6d]
*** SHOW DOWN ***
dunga119: shows [Qc Jh] (a straight, Ten to Ace)
gchs83: shows [Ad Td] (two pair, Aces and Tens)
dunga119 collected $113.52 from pot
*** SUMMARY ***
Total pot $116.32 | Rake $2.80 
Board [4s Kd Ac Tc 6d]
Seat 1: chautinhtri9 folded on the Flop
Seat 2: carrsseis folded before Flop (didn't bet)
Seat 3: dunga119 showed [Qc Jh] and won ($113.52) with a straight, Ten to Ace
Seat 5: gchs83 showed [Ad Td] and lost with two pair, Aces and Tens
Seat 6: Dantist1122 (button) folded before Flop (didn't bet)
Seat 7: YuriiSolodya (small blind) folded before Flop
Seat 8: matiko09 (big blind) folded before Flop
Seat 9: mycka86 folded before Flop (didn't bet)





PokerStars Hand #150802750518:  Hold'em No Limit ($0.50/$1.00 USD) - 2016/03/23 15:13:52 CET [2016/03/23 10:13:52 ET]
Table 'Swings' 9-max Seat #7 is the button
Seat 2: tomver0809 ($90.52 in chips) 
Seat 4: chaps1988 ($101.50 in chips) 
Seat 5: chautinhtri9 ($111.95 in chips) 
Seat 6: matiko09 ($145.42 in chips) 
Seat 7: PacPacBum ($109.72 in chips) 
Seat 8: RICKA16 ($99.46 in chips) 
Seat 9: Effort92 ($100 in chips) 
RICKA16: posts small blind $0.50
Effort92: posts big blind $1
lumen21: sits out 
maxxmeister: sits out 
*** HOLE CARDS ***
Dealt to matiko09 [Kc 6s]
tomver0809: folds 
chaps1988: raises $2 to $3
chautinhtri9: folds 
matiko09: folds 
PacPacBum: folds 
RICKA16: folds 
Effort92 has timed out
Effort92: folds 
Uncalled bet ($2) returned to chaps1988
chaps1988 collected $2.50 from pot
chaps1988: doesn't show hand 
*** SUMMARY ***
Total pot $2.50 | Rake $0 
Seat 2: tomver0809 folded before Flop (didn't bet)
Seat 4: chaps1988 collected ($2.50)
Seat 5: chautinhtri9 folded before Flop (didn't bet)
Seat 6: matiko09 folded before Flop (didn't bet)
Seat 7: PacPacBum (button) folded before Flop (didn't bet)
Seat 8: RICKA16 (small blind) folded before Flop
Seat 9: Effort92 (big blind) folded before Flop





PokerStars Hand #150802750347:  Hold'em No Limit ($1/$2 USD) - 2016/03/23 15:13:52 CET [2016/03/23 10:13:52 ET]
Table 'Kiess' 9-max Seat #6 is the button
Seat 1: Cirilico ($222.46 in chips) 
Seat 2: DUkalisUA ($702.28 in chips) 
Seat 3: Red4erT ($106.29 in chips) 
Seat 4: Igoriah ($200 in chips) 
Seat 6: matiko09 ($259.28 in chips) 
Seat 7: chaps1988 ($201 in chips) 
Seat 8: erfk1958 ($138.21 in chips) 
Seat 9: PacPacBum ($204.67 in chips) 
chaps1988: posts small blind $1
erfk1958: posts big blind $2
*** HOLE CARDS ***
Dealt to matiko09 [Ad 2d]
PacPacBum: calls $2
Cirilico: folds 
DUkalisUA: raises $7 to $9
Red4erT: folds 
Igoriah: folds 
matiko09: folds 
chaps1988: folds 
erfk1958: folds 
PacPacBum: raises $15 to $24
DUkalisUA: calls $15
*** FLOP *** [9s 6h 8d]
PacPacBum: checks 
DUkalisUA: bets $22
PacPacBum: folds 
Uncalled bet ($22) returned to DUkalisUA
DUkalisUA collected $48.70 from pot
DUkalisUA: doesn't show hand 
*** SUMMARY ***
Total pot $51 | Rake $2.30 
Board [9s 6h 8d]
Seat 1: Cirilico folded before Flop (didn't bet)
Seat 2: DUkalisUA collected ($48.70)
Seat 3: Red4erT folded before Flop (didn't bet)
Seat 4: Igoriah folded before Flop (didn't bet)
Seat 6: matiko09 (button) folded before Flop (didn't bet)
Seat 7: chaps1988 (small blind) folded before Flop
Seat 8: erfk1958 (big blind) folded before Flop
Seat 9: PacPacBum folded on the Flop





PokerStars Hand #150802750628:  Hold'em No Limit ($1/$2 USD) - 2016/03/23 15:13:53 CET [2016/03/23 10:13:53 ET]
Table 'Clarissa II' 9-max Seat #9 is the button
Seat 2: Igoriah ($210.24 in chips) 
Seat 3: PtizaXXX ($176.60 in chips) 
Seat 4: sanrs57 ($195 in chips) 
Seat 5: Red4erT ($83 in chips) 
Seat 6: matiko09 ($200 in chips) 
Seat 7: PacPacBum ($212 in chips) 
Seat 8: chaps1988 ($208.32 in chips) 
Seat 9: RamiroAgujis ($200 in chips) 
IseeUcards will be allowed to play after the button
Igoriah: posts small blind $1
PtizaXXX: posts big blind $2
*** HOLE CARDS ***
Dealt to matiko09 [Kc Tc]
sanrs57: folds 
Red4erT: raises $3 to $5
matiko09: folds 
PacPacBum: folds 
chaps1988: folds 
RamiroAgujis: folds 
Igoriah: folds 
PtizaXXX: folds 
Uncalled bet ($3) returned to Red4erT
Red4erT collected $5 from pot
Red4erT: doesn't show hand 
*** SUMMARY ***
Total pot $5 | Rake $0 
Seat 2: Igoriah (small blind) folded before Flop
Seat 3: PtizaXXX (big blind) folded before Flop
Seat 4: sanrs57 folded before Flop (didn't bet)
Seat 5: Red4erT collected ($5)
Seat 6: matiko09 folded before Flop (didn't bet)
Seat 7: PacPacBum folded before Flop (didn't bet)
Seat 8: chaps1988 folded before Flop (didn't bet)
Seat 9: RamiroAgujis (button) folded before Flop (didn't bet)





PokerStars Hand #150802751970:  Hold'em No Limit ($0.25/$0.50 USD) - 2016/03/23 15:13:57 CET [2016/03/23 10:13:57 ET]
Table 'Pyrrhus' 9-max Seat #7 is the button
Seat 1: nubpoker ($50 in chips) 
Seat 2: BSTUSim ($69.77 in chips) 
Seat 3: Muinmyheart ($50 in chips) 
Seat 5: xxxibgdrgn ($62.08 in chips) 
Seat 6: Ahangama ($50 in chips) 
Seat 7: matiko09 ($135.25 in chips) 
Seat 8: suitedaces02 ($50 in chips) 
suitedaces02: posts small blind $0.25
CvMCvMCvM: is sitting out 
nubpoker: posts big blind $0.50
seblafstian: sits out 
*** HOLE CARDS ***
Dealt to matiko09 [Td 8c]
BSTUSim: folds 
Muinmyheart: folds 
CvMCvMCvM leaves the table
xxxibgdrgn: folds 
Ahangama: folds 
matiko09: folds 
suitedaces02: folds 
Uncalled bet ($0.25) returned to nubpoker
nubpoker collected $0.50 from pot
nubpoker: doesn't show hand 
*** SUMMARY ***
Total pot $0.50 | Rake $0 
Seat 1: nubpoker (big blind) collected ($0.50)
Seat 2: BSTUSim folded before Flop (didn't bet)
Seat 3: Muinmyheart folded before Flop (didn't bet)
Seat 5: xxxibgdrgn folded before Flop (didn't bet)
Seat 6: Ahangama folded before Flop (didn't bet)
Seat 7: matiko09 (button) folded before Flop (didn't bet)
Seat 8: suitedaces02 (small blind) folded before Flop





PokerStars Hand #150802755705:  Hold'em No Limit ($0.50/$1.00 USD) - 2016/03/23 15:14:07 CET [2016/03/23 10:14:07 ET]
Table 'Asmodeus' 9-max Seat #4 is the button
Seat 1: Jimy Tiltman ($140.16 in chips) 
Seat 2: PacPacBum ($100 in chips) 
Seat 4: Effort92 ($100 in chips) 
Seat 5: Muinmyheart ($100 in chips) 
Seat 6: fuppeee ($84.71 in chips) 
Seat 7: mycka86 ($141.15 in chips) 
Seat 8: bonifacioppl ($58.45 in chips) 
Seat 9: matiko09 ($100 in chips) 
Muinmyheart: posts small blind $0.50
fuppeee: posts big blind $1
jahwe: sits out 
Jimy Tiltman: posts the ante $0.20
PacPacBum: posts the ante $0.20
Effort92: posts the ante $0.20
Muinmyheart: posts the ante $0.20
fuppeee: posts the ante $0.20
mycka86: posts the ante $0.20
bonifacioppl: posts the ante $0.20
matiko09: posts the ante $0.20
*** HOLE CARDS ***
Dealt to matiko09 [7h 2c]
mycka86: folds 
bonifacioppl: folds 
matiko09: folds 
Jimy Tiltman: folds 
PacPacBum: folds 
Effort92 has timed out
Effort92: folds 
Muinmyheart: folds 
Uncalled bet ($0.50) returned to fuppeee
fuppeee collected $2.60 from pot
*** SUMMARY ***
Total pot $2.60 | Rake $0 
Seat 1: Jimy Tiltman folded before Flop (didn't bet)
Seat 2: PacPacBum folded before Flop (didn't bet)
Seat 4: Effort92 (button) folded before Flop (didn't bet)
Seat 5: Muinmyheart (small blind) folded before Flop
Seat 6: fuppeee (big blind) collected ($2.60)
Seat 7: mycka86 folded before Flop (didn't bet)
Seat 8: bonifacioppl folded before Flop (didn't bet)
Seat 9: matiko09 folded before Flop (didn't bet)





PokerStars Hand #150802757669:  Hold'em No Limit (€0.50/€1.00 EUR) - 2016/03/23 15:14:12 CET [2016/03/23 10:14:12 ET]
Table 'Mercury III' 9-max Seat #7 is the button
Seat 1: matiko09 (€113.58 in chips) 
Seat 2: o.miro (€122.67 in chips) 
Seat 3: PacPacBum (€100.83 in chips) 
Seat 4: Muinmyheart (€101.50 in chips) 
Seat 5: DUkalisUA (€100 in chips) 
Seat 6: mycka86 (€103.89 in chips) 
Seat 7: STrakDD (€100 in chips) 
Seat 8: gfxed (€35.34 in chips) 
Seat 9: Indr3k (€100 in chips) 
gfxed: posts small blind €0.50
Indr3k: posts big blind €1
*** HOLE CARDS ***
Dealt to matiko09 [Kd 9d]
matiko09: folds 
o.miro: folds 
PacPacBum: folds 
Muinmyheart: folds 
DUkalisUA: folds 
mycka86: folds 
STrakDD: folds 
gfxed: calls €0.50
Indr3k: checks 
*** FLOP *** [Ad Jd 9s]
gfxed: checks 
Indr3k: bets €1.50
gfxed: folds 
Uncalled bet (€1.50) returned to Indr3k
Indr3k collected €1.91 from pot
Indr3k: doesn't show hand 
*** SUMMARY ***
Total pot €2 | Rake €0.09 
Board [Ad Jd 9s]
Seat 1: matiko09 folded before Flop (didn't bet)
Seat 2: o.miro folded before Flop (didn't bet)
Seat 3: PacPacBum folded before Flop (didn't bet)
Seat 4: Muinmyheart folded before Flop (didn't bet)
Seat 5: DUkalisUA folded before Flop (didn't bet)
Seat 6: mycka86 folded before Flop (didn't bet)
Seat 7: STrakDD (button) folded before Flop (didn't bet)
Seat 8: gfxed (small blind) folded on the Flop
Seat 9: Indr3k (big blind) collected (€1.91)





PokerStars Hand #150802758490:  Hold'em No Limit ($0.50/$1.00 USD) - 2016/03/23 15:14:14 CET [2016/03/23 10:14:14 ET]
Table 'Smiley' 9-max Seat #1 is the button
Seat 1: xHourglass ($100 in chips) 
Seat 2: Jimy Tiltman ($118.56 in chips) 
Seat 3: Robert201202 ($125.68 in chips) 
Seat 4: CAJUN890 ($94.71 in chips) 
Seat 7: nickreason17 ($100 in chips) 
Seat 8: matiko09 ($107.80 in chips) 
Seat 9: Pvsx. ($234.64 in chips) 
Jimy Tiltman: posts small blind $0.50
Robert201202: posts big blind $1
*** HOLE CARDS ***
Dealt to matiko09 [8h Qh]
CAJUN890: folds 
nickreason17: raises $2 to $3
matiko09: folds 
Pvsx.: folds 
xHourglass: folds 
Jimy Tiltman: folds 
Robert201202: folds 
Uncalled bet ($2) returned to nickreason17
nickreason17 collected $2.50 from pot
*** SUMMARY ***
Total pot $2.50 | Rake $0 
Seat 1: xHourglass (button) folded before Flop (didn't bet)
Seat 2: Jimy Tiltman (small blind) folded before Flop
Seat 3: Robert201202 (big blind) folded before Flop
Seat 4: CAJUN890 folded before Flop (didn't bet)
Seat 7: nickreason17 collected ($2.50)
Seat 8: matiko09 folded before Flop (didn't bet)
Seat 9: Pvsx. folded before Flop (didn't bet)





PokerStars Hand #150802760412:  Hold'em No Limit ($1/$2 USD) - 2016/03/23 15:14:20 CET [2016/03/23 10:14:20 ET]
Table 'Achaia' 9-max Seat #4 is the button
Seat 1: RamiroAgujis ($230.57 in chips) 
Seat 2: bananajoe001 ($6.81 in chips) 
Seat 3: matiko09 ($213.16 in chips) 
Seat 4: erfk1958 ($95.78 in chips) 
Seat 5: chaps1988 ($402.28 in chips) 
Seat 7: morosun ($257.26 in chips) 
Seat 8: IseeUcards ($208.86 in chips) 
Seat 9: PacPacBum ($200.27 in chips) 
chaps1988: posts small blind $1
morosun: posts big blind $2
*** HOLE CARDS ***
Dealt to matiko09 [Jc 8s]
IseeUcards: raises $4 to $6
PacPacBum: folds 
RamiroAgujis: folds 
bananajoe001: raises $0.81 to $6.81 and is all-in
matiko09: folds 
erfk1958: folds 
chaps1988: folds 
morosun: folds 
IseeUcards: calls $0.81
*** FLOP *** [Ad 4c Qc]
*** TURN *** [Ad 4c Qc] [Js]
*** RIVER *** [Ad 4c Qc Js] [9c]
*** SHOW DOWN ***
IseeUcards: shows [4h Ah] (two pair, Aces and Fours)
bananajoe001: shows [Tc 7c] (a flush, Queen high)
bananajoe001 collected $15.87 from pot
*** SUMMARY ***
Total pot $16.62 | Rake $0.75 
Board [Ad 4c Qc Js 9c]
Seat 1: RamiroAgujis folded before Flop (didn't bet)
Seat 2: bananajoe001 showed [Tc 7c] and won ($15.87) with a flush, Queen high
Seat 3: matiko09 folded before Flop (didn't bet)
Seat 4: erfk1958 (button) folded before Flop (didn't bet)
Seat 5: chaps1988 (small blind) folded before Flop
Seat 7: morosun (big blind) folded before Flop
Seat 8: IseeUcards showed [4h Ah] and lost with two pair, Aces and Fours
Seat 9: PacPacBum folded before Flop (didn't bet)





PokerStars Hand #150802760410:  Hold'em No Limit ($0.25/$0.50 USD) - 2016/03/23 15:14:20 CET [2016/03/23 10:14:20 ET]
Table 'Pyrrhus' 9-max Seat #8 is the button
Seat 1: nubpoker ($50.25 in chips) 
Seat 2: BSTUSim ($69.77 in chips) 
Seat 3: Muinmyheart ($50 in chips) 
Seat 5: xxxibgdrgn ($62.08 in chips) 
Seat 6: Ahangama ($50 in chips) 
Seat 7: matiko09 ($135.25 in chips) 
Seat 8: suitedaces02 ($50 in chips) 
nubpoker: posts small blind $0.25
BSTUSim: posts big blind $0.50
seblafstian: sits out 
*** HOLE CARDS ***
Dealt to matiko09 [6d 2c]
Muinmyheart: folds 
xxxibgdrgn: folds 
Ahangama: folds 
matiko09: folds 
suitedaces02: raises $0.50 to $1
nubpoker: raises $3 to $4
BSTUSim: folds 
suitedaces02: folds 
Uncalled bet ($3) returned to nubpoker
nubpoker collected $2.50 from pot
nubpoker: doesn't show hand 
*** SUMMARY ***
Total pot $2.50 | Rake $0 
Seat 1: nubpoker (small blind) collected ($2.50)
Seat 2: BSTUSim (big blind) folded before Flop
Seat 3: Muinmyheart folded before Flop (didn't bet)
Seat 5: xxxibgdrgn folded before Flop (didn't bet)
Seat 6: Ahangama folded before Flop (didn't bet)
Seat 7: matiko09 folded before Flop (didn't bet)
Seat 8: suitedaces02 (button) folded before Flop





PokerStars Hand #150802764779:  Hold'em No Limit ($0.50/$1.00 USD) - 2016/03/23 15:14:32 CET [2016/03/23 10:14:32 ET]
Table 'Smiley' 9-max Seat #2 is the button
Seat 1: xHourglass ($100 in chips) 
Seat 2: Jimy Tiltman ($118.06 in chips) 
Seat 3: Robert201202 ($124.68 in chips) 
Seat 4: CAJUN890 ($94.71 in chips) 
Seat 7: nickreason17 ($101.50 in chips) 
Seat 8: matiko09 ($107.80 in chips) 
Seat 9: Pvsx. ($234.64 in chips) 
Robert201202: posts small blind $0.50
CAJUN890: posts big blind $1
*** HOLE CARDS ***
Dealt to matiko09 [3h 6c]
nickreason17: folds 
matiko09: folds 
Pvsx.: folds 
xHourglass: folds 
Jimy Tiltman: raises $2 to $3
Robert201202: calls $2.50
CAJUN890: folds 
*** FLOP *** [Tc 2h Ad]
Robert201202: checks 
Jimy Tiltman: bets $3.34
Robert201202: folds 
Uncalled bet ($3.34) returned to Jimy Tiltman
Jimy Tiltman collected $6.68 from pot
Jimy Tiltman: doesn't show hand 
*** SUMMARY ***
Total pot $7 | Rake $0.32 
Board [Tc 2h Ad]
Seat 1: xHourglass folded before Flop (didn't bet)
Seat 2: Jimy Tiltman (button) collected ($6.68)
Seat 3: Robert201202 (small blind) folded on the Flop
Seat 4: CAJUN890 (big blind) folded before Flop
Seat 7: nickreason17 folded before Flop (didn't bet)
Seat 8: matiko09 folded before Flop (didn't bet)
Seat 9: Pvsx. folded before Flop (didn't bet)





PokerStars Hand #150802772749:  Hold'em No Limit ($1/$2 USD) - 2016/03/23 15:14:53 CET [2016/03/23 10:14:53 ET]
Table 'Clarissa II' 9-max Seat #2 is the button
Seat 2: Igoriah ($209.24 in chips) 
Seat 3: PtizaXXX ($174.60 in chips) 
Seat 4: sanrs57 ($195 in chips) 
Seat 5: Red4erT ($86 in chips) 
Seat 6: matiko09 ($200 in chips) 
Seat 7: PacPacBum ($212 in chips) 
Seat 8: chaps1988 ($208.32 in chips) 
Seat 9: RamiroAgujis ($200 in chips) 
PtizaXXX: posts small blind $1
sanrs57: posts big blind $2
IseeUcards: sits out 
*** HOLE CARDS ***
Dealt to matiko09 [2c 8c]
Red4erT: folds 
matiko09: folds 
PacPacBum: raises $2.08 to $4.08
chaps1988: folds 
RamiroAgujis: calls $4.08
Igoriah: raises $15.92 to $20
PtizaXXX: folds 
sanrs57: folds 
PacPacBum: folds 
RamiroAgujis: folds 
Uncalled bet ($15.92) returned to Igoriah
Igoriah collected $15.24 from pot
Igoriah: doesn't show hand 
*** SUMMARY ***
Total pot $15.24 | Rake $0 
Seat 2: Igoriah (button) collected ($15.24)
Seat 3: PtizaXXX (small blind) folded before Flop
Seat 4: sanrs57 (big blind) folded before Flop
Seat 5: Red4erT folded before Flop (didn't bet)
Seat 6: matiko09 folded before Flop (didn't bet)
Seat 7: PacPacBum folded before Flop
Seat 8: chaps1988 folded before Flop (didn't bet)
Seat 9: RamiroAgujis folded before Flop





PokerStars Hand #150802774090:  Hold'em No Limit ($0.25/$0.50 USD) - 2016/03/23 15:14:57 CET [2016/03/23 10:14:57 ET]
Table 'Pyrrhus' 9-max Seat #1 is the button
Seat 1: nubpoker ($51.75 in chips) 
Seat 2: BSTUSim ($69.27 in chips) 
Seat 3: Muinmyheart ($50 in chips) 
Seat 5: xxxibgdrgn ($62.08 in chips) 
Seat 6: Ahangama ($50 in chips) 
Seat 7: matiko09 ($135.25 in chips) 
Seat 8: suitedaces02 ($50 in chips) 
BSTUSim: posts small blind $0.25
Muinmyheart: posts big blind $0.50
seblafstian: sits out 
*** HOLE CARDS ***
Dealt to matiko09 [2c 3c]
xxxibgdrgn: folds 
yourpro joins the table at seat #9 
Ahangama: folds 
matiko09: folds 
yourpro leaves the table
suitedaces02: folds 
lucky83o joins the table at seat #9 
nubpoker: raises $0.75 to $1.25
BSTUSim: folds 
lucky83o leaves the table
Muinmyheart: folds 
Uncalled bet ($0.75) returned to nubpoker
nubpoker collected $1.25 from pot
nubpoker: doesn't show hand 
*** SUMMARY ***
Total pot $1.25 | Rake $0 
Seat 1: nubpoker (button) collected ($1.25)
Seat 2: BSTUSim (small blind) folded before Flop
Seat 3: Muinmyheart (big blind) folded before Flop
Seat 5: xxxibgdrgn folded before Flop (didn't bet)
Seat 6: Ahangama folded before Flop (didn't bet)
Seat 7: matiko09 folded before Flop (didn't bet)
Seat 8: suitedaces02 folded before Flop (didn't bet)





PokerStars Hand #150802776707:  Hold'em No Limit ($1/$2 USD) - 2016/03/23 15:15:04 CET [2016/03/23 10:15:04 ET]
Table 'Achaia' 9-max Seat #5 is the button
Seat 1: RamiroAgujis ($230.57 in chips) 
Seat 2: bananajoe001 ($15.87 in chips) 
Seat 3: matiko09 ($213.16 in chips) 
Seat 4: erfk1958 ($95.78 in chips) 
Seat 5: chaps1988 ($401.28 in chips) 
Seat 7: morosun ($255.26 in chips) 
Seat 8: IseeUcards ($202.05 in chips) 
Seat 9: PacPacBum ($200.27 in chips) 
morosun: posts small blind $1
IseeUcards: posts big blind $2
*** HOLE CARDS ***
Dealt to matiko09 [Kh 6s]
PacPacBum: folds 
RamiroAgujis: folds 
bananajoe001: raises $13.87 to $15.87 and is all-in
matiko09: folds 
erfk1958: folds 
chaps1988: folds 
morosun: folds 
IseeUcards: folds 
Uncalled bet ($13.87) returned to bananajoe001
bananajoe001 collected $5 from pot
bananajoe001: doesn't show hand 
*** SUMMARY ***
Total pot $5 | Rake $0 
Seat 1: RamiroAgujis folded before Flop (didn't bet)
Seat 2: bananajoe001 collected ($5)
Seat 3: matiko09 folded before Flop (didn't bet)
Seat 4: erfk1958 folded before Flop (didn't bet)
Seat 5: chaps1988 (button) folded before Flop (didn't bet)
Seat 7: morosun (small blind) folded before Flop
Seat 8: IseeUcards (big blind) folded before Flop
Seat 9: PacPacBum folded before Flop (didn't bet)





PokerStars Hand #150802777892:  Hold'em No Limit ($0.50/$1.00 USD) - 2016/03/23 15:15:07 CET [2016/03/23 10:15:07 ET]
Table 'Swings' 9-max Seat #8 is the button
Seat 1: lumen21 ($100 in chips) 
Seat 2: tomver0809 ($90.52 in chips) 
Seat 4: chaps1988 ($103 in chips) 
Seat 5: chautinhtri9 ($111.95 in chips) 
Seat 6: matiko09 ($145.42 in chips) 
Seat 7: PacPacBum ($109.72 in chips) 
Seat 8: RICKA16 ($98.96 in chips) 
Seat 9: Effort92 ($100 in chips) 
Effort92: posts small blind $0.50
lumen21: posts big blind $1
maxxmeister: sits out 
*** HOLE CARDS ***
Dealt to matiko09 [2h 4h]
tomver0809: folds 
chaps1988: folds 
chautinhtri9: raises $1 to $2
matiko09: folds 
PacPacBum: folds 
RICKA16: folds 
Effort92: folds 
lumen21: folds 
Uncalled bet ($1) returned to chautinhtri9
chautinhtri9 collected $2.50 from pot
*** SUMMARY ***
Total pot $2.50 | Rake $0 
Seat 1: lumen21 (big blind) folded before Flop
Seat 2: tomver0809 folded before Flop (didn't bet)
Seat 4: chaps1988 folded before Flop (didn't bet)
Seat 5: chautinhtri9 collected ($2.50)
Seat 6: matiko09 folded before Flop (didn't bet)
Seat 7: PacPacBum folded before Flop (didn't bet)
Seat 8: RICKA16 (button) folded before Flop (didn't bet)
Seat 9: Effort92 (small blind) folded before Flop





PokerStars Hand #150802778075:  Hold'em No Limit ($0.50/$1.00 USD) - 2016/03/23 15:15:08 CET [2016/03/23 10:15:08 ET]
Table 'Drakonia II' 9-max Seat #7 is the button
Seat 1: chautinhtri9 ($129.10 in chips) 
Seat 2: carrsseis ($103 in chips) 
Seat 3: dunga119 ($152.69 in chips) 
Seat 6: Dantist1122 ($107.76 in chips) 
Seat 7: YuriiSolodya ($26.40 in chips) 
Seat 8: matiko09 ($100 in chips) 
Seat 9: mycka86 ($100 in chips) 
matiko09: posts small blind $0.50
mycka86: posts big blind $1
lumen21: sits out 
*** HOLE CARDS ***
Dealt to matiko09 [9s 3d]
chautinhtri9: folds 
carrsseis: folds 
dunga119: calls $1
gchs83 leaves the table
Dantist1122: raises $4 to $5
YuriiSolodya: folds 
matiko09: folds 
Muinmyheart joins the table at seat #5 
mycka86: folds 
dunga119: folds 
Uncalled bet ($4) returned to Dantist1122
Dantist1122 collected $3.50 from pot
Dantist1122: doesn't show hand 
*** SUMMARY ***
Total pot $3.50 | Rake $0 
Seat 1: chautinhtri9 folded before Flop (didn't bet)
Seat 2: carrsseis folded before Flop (didn't bet)
Seat 3: dunga119 folded before Flop
Seat 6: Dantist1122 collected ($3.50)
Seat 7: YuriiSolodya (button) folded before Flop (didn't bet)
Seat 8: matiko09 (small blind) folded before Flop
Seat 9: mycka86 (big blind) folded before Flop





PokerStars Hand #150802778391:  Hold'em No Limit ($0.50/$1.00 USD) - 2016/03/23 15:15:08 CET [2016/03/23 10:15:08 ET]
Table 'Smiley' 9-max Seat #3 is the button
Seat 1: xHourglass ($100 in chips) 
Seat 2: Jimy Tiltman ($121.74 in chips) 
Seat 3: Robert201202 ($121.68 in chips) 
Seat 4: CAJUN890 ($93.71 in chips) 
Seat 8: matiko09 ($107.80 in chips) 
Seat 9: Pvsx. ($234.64 in chips) 
CAJUN890: posts small blind $0.50
nickreason17: is sitting out 
matiko09: posts big blind $1
*** HOLE CARDS ***
Dealt to matiko09 [Kc 2s]
nickreason17 leaves the table
Pvsx.: raises $1.50 to $2.50
xHourglass: folds 
Jimy Tiltman: folds 
Robert201202: folds 
CAJUN890: folds 
matiko09: folds 
Uncalled bet ($1.50) returned to Pvsx.
Pvsx. collected $2.50 from pot
bennetb77 joins the table at seat #7 
Pvsx.: doesn't show hand 
*** SUMMARY ***
Total pot $2.50 | Rake $0 
Seat 1: xHourglass folded before Flop (didn't bet)
Seat 2: Jimy Tiltman folded before Flop (didn't bet)
Seat 3: Robert201202 (button) folded before Flop (didn't bet)
Seat 4: CAJUN890 (small blind) folded before Flop
Seat 8: matiko09 (big blind) folded before Flop
Seat 9: Pvsx. collected ($2.50)





PokerStars Hand #150802779281:  Hold'em No Limit ($0.50/$1.00 USD) - 2016/03/23 15:15:11 CET [2016/03/23 10:15:11 ET]
Table 'Asmodeus' 9-max Seat #5 is the button
Seat 1: Jimy Tiltman ($139.96 in chips) 
Seat 2: PacPacBum ($100 in chips) 
Seat 4: Effort92 ($100 in chips) 
Seat 5: Muinmyheart ($100 in chips) 
Seat 6: fuppeee ($86.61 in chips) 
Seat 7: mycka86 ($140.95 in chips) 
Seat 8: bonifacioppl ($58.25 in chips) 
Seat 9: matiko09 ($100 in chips) 
fuppeee: posts small blind $0.50
mycka86: posts big blind $1
jahwe: sits out 
Jimy Tiltman: posts the ante $0.20
PacPacBum: posts the ante $0.20
Effort92: posts the ante $0.20
Muinmyheart: posts the ante $0.20
fuppeee: posts the ante $0.20
mycka86: posts the ante $0.20
bonifacioppl: posts the ante $0.20
matiko09: posts the ante $0.20
*** HOLE CARDS ***
Dealt to matiko09 [7h 5s]
bonifacioppl: folds 
matiko09: folds 
Jimy Tiltman: folds 
PacPacBum: folds 
Effort92: raises $2 to $3
Muinmyheart: folds 
fuppeee: folds 
mycka86: calls $2
*** FLOP *** [Ts 8h Qc]
mycka86: checks 
Effort92: bets $4
mycka86: folds 
Uncalled bet ($4) returned to Effort92
Effort92 collected $7.74 from pot
Effort92: doesn't show hand 
*** SUMMARY ***
Total pot $8.10 | Rake $0.36 
Board [Ts 8h Qc]
Seat 1: Jimy Tiltman folded before Flop (didn't bet)
Seat 2: PacPacBum folded before Flop (didn't bet)
Seat 4: Effort92 collected ($7.74)
Seat 5: Muinmyheart (button) folded before Flop (didn't bet)
Seat 6: fuppeee (small blind) folded before Flop
Seat 7: mycka86 (big blind) folded on the Flop
Seat 8: bonifacioppl folded before Flop (didn't bet)
Seat 9: matiko09 folded before Flop (didn't bet)





PokerStars Hand #150802782659:  Hold'em No Limit ($1/$2 USD) - 2016/03/23 15:15:20 CET [2016/03/23 10:15:20 ET]
Table 'Kiess' 9-max Seat #7 is the button
Seat 1: Cirilico ($222.46 in chips) 
Seat 2: DUkalisUA ($726.98 in chips) 
Seat 3: Red4erT ($106.29 in chips) 
Seat 4: Igoriah ($200 in chips) 
Seat 6: matiko09 ($259.28 in chips) 
Seat 7: chaps1988 ($200 in chips) 
Seat 8: erfk1958 ($136.21 in chips) 
Seat 9: PacPacBum ($200 in chips) 
erfk1958: posts small blind $1
PacPacBum: posts big blind $2
*** HOLE CARDS ***
Dealt to matiko09 [3c Ts]
Cirilico: raises $4 to $6
DUkalisUA: folds 
Red4erT: folds 
Igoriah: folds 
matiko09: folds 
chaps1988: folds 
erfk1958: calls $5
PacPacBum: folds 
*** FLOP *** [9s Qc Qs]
erfk1958: checks 
Cirilico: bets $9
erfk1958: calls $9
*** TURN *** [9s Qc Qs] [2s]
erfk1958: checks 
Cirilico: bets $23
erfk1958: folds 
Uncalled bet ($23) returned to Cirilico
Cirilico collected $30.56 from pot
Cirilico: doesn't show hand 
*** SUMMARY ***
Total pot $32 | Rake $1.44 
Board [9s Qc Qs 2s]
Seat 1: Cirilico collected ($30.56)
Seat 2: DUkalisUA folded before Flop (didn't bet)
Seat 3: Red4erT folded before Flop (didn't bet)
Seat 4: Igoriah folded before Flop (didn't bet)
Seat 6: matiko09 folded before Flop (didn't bet)
Seat 7: chaps1988 (button) folded before Flop (didn't bet)
Seat 8: erfk1958 (small blind) folded on the Turn
Seat 9: PacPacBum (big blind) folded before Flop





PokerStars Hand #150802784417:  Hold'em No Limit ($0.50/$1.00 USD) - 2016/03/23 15:15:25 CET [2016/03/23 10:15:25 ET]
Table 'Smiley' 9-max Seat #4 is the button
Seat 1: xHourglass ($100 in chips) 
Seat 2: Jimy Tiltman ($121.74 in chips) 
Seat 3: Robert201202 ($121.68 in chips) 
Seat 4: CAJUN890 ($93.21 in chips) 
Seat 8: matiko09 ($106.80 in chips) 
bennetb77 will be allowed to play after the button
matiko09: posts small blind $0.50
Pvsx.: is sitting out 
xHourglass: posts big blind $1
*** HOLE CARDS ***
Dealt to matiko09 [5c Qs]
Jimy Tiltman: folds 
Robert201202: folds 
Pvsx. leaves the table
CAJUN890: folds 
matiko09: folds 
Uncalled bet ($0.50) returned to xHourglass
xHourglass collected $1 from pot
xHourglass: doesn't show hand 
*** SUMMARY ***
Total pot $1 | Rake $0 
Seat 1: xHourglass (big blind) collected ($1)
Seat 2: Jimy Tiltman folded before Flop (didn't bet)
Seat 3: Robert201202 folded before Flop (didn't bet)
Seat 4: CAJUN890 (button) folded before Flop (didn't bet)
Seat 8: matiko09 (small blind) folded before Flop





PokerStars Hand #150802789031:  Hold'em No Limit ($1/$2 USD) - 2016/03/23 15:15:38 CET [2016/03/23 10:15:38 ET]
Table 'Achaia' 9-max Seat #7 is the button
Seat 1: RamiroAgujis ($230.57 in chips) 
Seat 2: bananajoe001 ($18.87 in chips) 
Seat 3: matiko09 ($213.16 in chips) 
Seat 4: erfk1958 ($95.78 in chips) 
Seat 5: chaps1988 ($401.28 in chips) 
Seat 7: morosun ($254.26 in chips) 
Seat 8: IseeUcards ($200.05 in chips) 
Seat 9: PacPacBum ($200.27 in chips) 
IseeUcards: posts small blind $1
PacPacBum: posts big blind $2
*** HOLE CARDS ***
Dealt to matiko09 [3c 7d]
RamiroAgujis: folds 
bananajoe001: folds 
matiko09: folds 
erfk1958: folds 
chaps1988: folds 
morosun: raises $4 to $6
IseeUcards: raises $16 to $22
PacPacBum: folds 
morosun: calls $16
*** FLOP *** [9s 7h Qd]
IseeUcards: bets $24
morosun: calls $24
*** TURN *** [9s 7h Qd] [7c]
IseeUcards: checks 
morosun: bets $10
IseeUcards: calls $10
*** RIVER *** [9s 7h Qd 7c] [9c]
IseeUcards: checks 
morosun: bets $55.60
IseeUcards: calls $55.60
*** SHOW DOWN ***
morosun: shows [8c Jc] (two pair, Nines and Sevens)
IseeUcards: shows [Ks Qh] (two pair, Queens and Nines)
IseeUcards collected $222.40 from pot
*** SUMMARY ***
Total pot $225.20 | Rake $2.80 
Board [9s 7h Qd 7c 9c]
Seat 1: RamiroAgujis folded before Flop (didn't bet)
Seat 2: bananajoe001 folded before Flop (didn't bet)
Seat 3: matiko09 folded before Flop (didn't bet)
Seat 4: erfk1958 folded before Flop (didn't bet)
Seat 5: chaps1988 folded before Flop (didn't bet)
Seat 7: morosun (button) showed [8c Jc] and lost with two pair, Nines and Sevens
Seat 8: IseeUcards (small blind) showed [Ks Qh] and won ($222.40) with two pair, Queens and Nines
Seat 9: PacPacBum (big blind) folded before Flop





PokerStars Hand #150802789981:  Hold'em No Limit (€0.50/€1.00 EUR) - 2016/03/23 15:15:40 CET [2016/03/23 10:15:40 ET]
Table 'Mercury III' 9-max Seat #8 is the button
Seat 1: matiko09 (€113.58 in chips) 
Seat 2: o.miro (€122.67 in chips) 
Seat 3: PacPacBum (€100.83 in chips) 
Seat 4: Muinmyheart (€101.50 in chips) 
Seat 5: DUkalisUA (€100 in chips) 
Seat 6: mycka86 (€103.89 in chips) 
Seat 7: STrakDD (€100 in chips) 
Seat 8: gfxed (€34.34 in chips) 
Seat 9: Indr3k (€100.91 in chips) 
Indr3k: posts small blind €0.50
matiko09: posts big blind €1
*** HOLE CARDS ***
Dealt to matiko09 [Jh 5c]
o.miro: folds 
o.miro leaves the table
PacPacBum: folds 
Muinmyheart: raises €2 to €3
DUkalisUA: folds 
mycka86: folds 
jahwe joins the table at seat #2 
STrakDD: folds 
gfxed: folds 
Indr3k: folds 
matiko09: folds 
Uncalled bet (€2) returned to Muinmyheart
Muinmyheart collected €2.50 from pot
Muinmyheart: doesn't show hand 
*** SUMMARY ***
Total pot €2.50 | Rake €0 
Seat 1: matiko09 (big blind) folded before Flop
Seat 2: o.miro folded before Flop (didn't bet)
Seat 3: PacPacBum folded before Flop (didn't bet)
Seat 4: Muinmyheart collected (€2.50)
Seat 5: DUkalisUA folded before Flop (didn't bet)
Seat 6: mycka86 folded before Flop (didn't bet)
Seat 7: STrakDD folded before Flop (didn't bet)
Seat 8: gfxed (button) folded before Flop (didn't bet)
Seat 9: Indr3k (small blind) folded before Flop





PokerStars Hand #150802791740:  Hold'em No Limit ($0.50/$1.00 USD) - 2016/03/23 15:15:45 CET [2016/03/23 10:15:45 ET]
Table 'Smiley' 9-max Seat #8 is the button
Seat 1: xHourglass ($100.50 in chips) 
Seat 2: Jimy Tiltman ($121.74 in chips) 
Seat 3: Robert201202 ($121.68 in chips) 
Seat 4: CAJUN890 ($93.21 in chips) 
Seat 6: blackmont111 ($152.54 in chips) 
Seat 8: matiko09 ($106.30 in chips) 
xHourglass: posts small blind $0.50
Jimy Tiltman: posts big blind $1
blackmont111: posts small & big blinds $1.50
bennetb77: sits out 
*** HOLE CARDS ***
Dealt to matiko09 [9c Js]
Robert201202: raises $2 to $3
PacPacBum joins the table at seat #9 
CAJUN890: folds 
blackmont111: calls $2
matiko09: folds 
xHourglass: calls $2.50
Jimy Tiltman: calls $2
*** FLOP *** [7d Tc 7h]
xHourglass: checks 
Jimy Tiltman: checks 
Robert201202: checks 
blackmont111: checks 
*** TURN *** [7d Tc 7h] [2h]
xHourglass: bets $7.50
Jimy Tiltman: folds 
Robert201202: folds 
blackmont111: folds 
Uncalled bet ($7.50) returned to xHourglass
xHourglass collected $11.94 from pot
xHourglass: doesn't show hand 
*** SUMMARY ***
Total pot $12.50 | Rake $0.56 
Board [7d Tc 7h 2h]
Seat 1: xHourglass (small blind) collected ($11.94)
Seat 2: Jimy Tiltman (big blind) folded on the Turn
Seat 3: Robert201202 folded on the Turn
Seat 4: CAJUN890 folded before Flop (didn't bet)
Seat 6: blackmont111 folded on the Turn
Seat 8: matiko09 (button) folded before Flop (didn't bet)





PokerStars Hand #150802791839:  Hold'em No Limit ($0.50/$1.00 USD) - 2016/03/23 15:15:46 CET [2016/03/23 10:15:46 ET]
Table 'Sylvia III' 9-max Seat #2 is the button
Seat 1: mycka86 ($106.80 in chips) 
Seat 2: Dantist1122 ($103.50 in chips) 
Seat 3: se7en_$tars ($127.64 in chips) 
Seat 4: lombardo11 ($62.52 in chips) 
Seat 5: matiko09 ($100.19 in chips) 
Seat 6: PacPacBum ($102.70 in chips) 
Seat 7: easytalk777 ($93.43 in chips) 
Seat 8: nickreason17 ($105.94 in chips) 
Seat 9: Blanky-Bad ($90.87 in chips) 
se7en_$tars: posts small blind $0.50
lombardo11: posts big blind $1
mycka86: posts the ante $0.20
Dantist1122: posts the ante $0.20
se7en_$tars: posts the ante $0.20
lombardo11: posts the ante $0.20
matiko09: posts the ante $0.20
PacPacBum: posts the ante $0.20
easytalk777: posts the ante $0.20
nickreason17: posts the ante $0.20
Blanky-Bad: posts the ante $0.20
*** HOLE CARDS ***
Dealt to matiko09 [Qs 5d]
matiko09: folds 
PacPacBum: folds 
easytalk777: folds 
nickreason17: folds 
Blanky-Bad: raises $2 to $3
mycka86: folds 
Dantist1122: folds 
se7en_$tars: calls $2.50
lombardo11: calls $2
*** FLOP *** [Kd 3h 4h]
se7en_$tars: checks 
lombardo11: checks 
Blanky-Bad: bets $7.21
se7en_$tars: folds 
lombardo11: folds 
Uncalled bet ($7.21) returned to Blanky-Bad
Blanky-Bad collected $10.31 from pot
Blanky-Bad: doesn't show hand 
*** SUMMARY ***
Total pot $10.80 | Rake $0.49 
Board [Kd 3h 4h]
Seat 1: mycka86 folded before Flop (didn't bet)
Seat 2: Dantist1122 (button) folded before Flop (didn't bet)
Seat 3: se7en_$tars (small blind) folded on the Flop
Seat 4: lombardo11 (big blind) folded on the Flop
Seat 5: matiko09 folded before Flop (didn't bet)
Seat 6: PacPacBum folded before Flop (didn't bet)
Seat 7: easytalk777 folded before Flop (didn't bet)
Seat 8: nickreason17 folded before Flop (didn't bet)
Seat 9: Blanky-Bad collected ($10.31)





PokerStars Hand #150802793633:  Hold'em No Limit ($0.50/$1.00 USD) - 2016/03/23 15:15:50 CET [2016/03/23 10:15:50 ET]
Table 'Swings' 9-max Seat #9 is the button
Seat 1: lumen21 ($100 in chips) 
Seat 2: tomver0809 ($90.52 in chips) 
Seat 4: chaps1988 ($103 in chips) 
Seat 5: chautinhtri9 ($113.45 in chips) 
Seat 6: matiko09 ($145.42 in chips) 
Seat 7: PacPacBum ($109.72 in chips) 
Seat 8: RICKA16 ($98.96 in chips) 
Seat 9: Effort92 ($100 in chips) 
lumen21: posts small blind $0.50
tomver0809: posts big blind $1
maxxmeister: sits out 
*** HOLE CARDS ***
Dealt to matiko09 [7s 2c]
chaps1988: folds 
chautinhtri9: folds 
matiko09: folds 
PacPacBum: folds 
RICKA16: folds 
Effort92: raises $1 to $2
lumen21: folds 
tomver0809: calls $1
*** FLOP *** [6d Ts Qh]
tomver0809: bets $4
Effort92: folds 
Uncalled bet ($4) returned to tomver0809
tomver0809 collected $4.30 from pot
tomver0809: doesn't show hand 
*** SUMMARY ***
Total pot $4.50 | Rake $0.20 
Board [6d Ts Qh]
Seat 1: lumen21 (small blind) folded before Flop
Seat 2: tomver0809 (big blind) collected ($4.30)
Seat 4: chaps1988 folded before Flop (didn't bet)
Seat 5: chautinhtri9 folded before Flop (didn't bet)
Seat 6: matiko09 folded before Flop (didn't bet)
Seat 7: PacPacBum folded before Flop (didn't bet)
Seat 8: RICKA16 folded before Flop (didn't bet)
Seat 9: Effort92 (button) folded on the Flop





PokerStars Hand #150802795343:  Hold'em No Limit ($0.50/$1.00 USD) - 2016/03/23 15:15:55 CET [2016/03/23 10:15:55 ET]
Table 'Drakonia II' 9-max Seat #8 is the button
Seat 1: chautinhtri9 ($129.10 in chips) 
Seat 2: carrsseis ($103 in chips) 
Seat 3: dunga119 ($151.69 in chips) 
Seat 6: Dantist1122 ($110.26 in chips) 
Seat 7: YuriiSolodya ($26.40 in chips) 
Seat 8: matiko09 ($100 in chips) 
Seat 9: mycka86 ($100 in chips) 
mycka86: posts small blind $0.50
chautinhtri9: posts big blind $1
lumen21: sits out 
Muinmyheart: sits out 
*** HOLE CARDS ***
Dealt to matiko09 [5d Jc]
carrsseis: folds 
dunga119: calls $1
Dantist1122: folds 
YuriiSolodya: folds 
matiko09: folds 
mycka86: calls $0.50
chautinhtri9: checks 
*** FLOP *** [5h 2d 2h]
mycka86: checks 
chautinhtri9: checks 
dunga119: checks 
*** TURN *** [5h 2d 2h] [4c]
mycka86: checks 
chautinhtri9: checks 
dunga119: checks 
*** RIVER *** [5h 2d 2h 4c] [3h]
mycka86: bets $4
chautinhtri9: folds 
dunga119: folds 
Uncalled bet ($4) returned to mycka86
mycka86 collected $2.86 from pot
*** SUMMARY ***
Total pot $3 | Rake $0.14 
Board [5h 2d 2h 4c 3h]
Seat 1: chautinhtri9 (big blind) folded on the River
Seat 2: carrsseis folded before Flop (didn't bet)
Seat 3: dunga119 folded on the River
Seat 6: Dantist1122 folded before Flop (didn't bet)
Seat 7: YuriiSolodya folded before Flop (didn't bet)
Seat 8: matiko09 (button) folded before Flop (didn't bet)
Seat 9: mycka86 (small blind) collected ($2.86)





PokerStars Hand #150802800719:  Hold'em No Limit ($0.50/$1.00 USD) - 2016/03/23 15:16:10 CET [2016/03/23 10:16:10 ET]
Table 'Asmodeus' 9-max Seat #6 is the button
Seat 1: Jimy Tiltman ($139.76 in chips) 
Seat 2: PacPacBum ($100 in chips) 
Seat 4: Effort92 ($104.54 in chips) 
Seat 5: Muinmyheart ($100 in chips) 
Seat 6: fuppeee ($85.91 in chips) 
Seat 7: mycka86 ($137.75 in chips) 
Seat 8: bonifacioppl ($58.05 in chips) 
Seat 9: matiko09 ($100 in chips) 
mycka86: posts small blind $0.50
bonifacioppl: posts big blind $1
jahwe: sits out 
Jimy Tiltman: posts the ante $0.20
PacPacBum: posts the ante $0.20
Effort92: posts the ante $0.20
Muinmyheart: posts the ante $0.20
fuppeee: posts the ante $0.20
mycka86: posts the ante $0.20
bonifacioppl: posts the ante $0.20
matiko09: posts the ante $0.20
*** HOLE CARDS ***
Dealt to matiko09 [4h 2h]
matiko09: folds 
Jimy Tiltman: folds 
PacPacBum: folds 
Effort92: folds 
Muinmyheart: raises $2 to $3
fuppeee: calls $3
mycka86: folds 
bonifacioppl: calls $2
*** FLOP *** [4c Ts Qs]
bonifacioppl: checks 
Muinmyheart: checks 
fuppeee: bets $5.30
bonifacioppl: folds 
Muinmyheart: folds 
Uncalled bet ($5.30) returned to fuppeee
fuppeee collected $10.60 from pot
*** SUMMARY ***
Total pot $11.10 | Rake $0.50 
Board [4c Ts Qs]
Seat 1: Jimy Tiltman folded before Flop (didn't bet)
Seat 2: PacPacBum folded before Flop (didn't bet)
Seat 4: Effort92 folded before Flop (didn't bet)
Seat 5: Muinmyheart folded on the Flop
Seat 6: fuppeee (button) collected ($10.60)
Seat 7: mycka86 (small blind) folded before Flop
Seat 8: bonifacioppl (big blind) folded on the Flop
Seat 9: matiko09 folded before Flop (didn't bet)





PokerStars Hand #150802802618:  Hold'em No Limit (€0.50/€1.00 EUR) - 2016/03/23 15:16:15 CET [2016/03/23 10:16:15 ET]
Table 'Mercury III' 9-max Seat #9 is the button
Seat 1: matiko09 (€112.58 in chips) 
Seat 2: jahwe (€100 in chips) 
Seat 3: PacPacBum (€100.83 in chips) 
Seat 4: Muinmyheart (€103 in chips) 
Seat 5: DUkalisUA (€100 in chips) 
Seat 6: mycka86 (€103.89 in chips) 
Seat 7: STrakDD (€100 in chips) 
Seat 8: gfxed (€34.34 in chips) 
Seat 9: Indr3k (€100.41 in chips) 
matiko09: posts small blind €0.50
jahwe: posts big blind €1
*** HOLE CARDS ***
Dealt to matiko09 [Th Ts]
PacPacBum: folds 
Muinmyheart: folds 
DUkalisUA: folds 
mycka86: folds 
STrakDD: folds 
gfxed: folds 
Indr3k: raises €1.50 to €2.50
matiko09: raises €6.50 to €9
jahwe: folds 
Indr3k: folds 
Uncalled bet (€6.50) returned to matiko09
matiko09 collected €6 from pot
matiko09: doesn't show hand 
*** SUMMARY ***
Total pot €6 | Rake €0 
Seat 1: matiko09 (small blind) collected (€6)
Seat 2: jahwe (big blind) folded before Flop
Seat 3: PacPacBum folded before Flop (didn't bet)
Seat 4: Muinmyheart folded before Flop (didn't bet)
Seat 5: DUkalisUA folded before Flop (didn't bet)
Seat 6: mycka86 folded before Flop (didn't bet)
Seat 7: STrakDD folded before Flop (didn't bet)
Seat 8: gfxed folded before Flop (didn't bet)
Seat 9: Indr3k (button) folded before Flop





PokerStars Hand #150802802928:  Hold'em No Limit ($1/$2 USD) - 2016/03/23 15:16:16 CET [2016/03/23 10:16:16 ET]
Table 'Clarissa II' 9-max Seat #3 is the button
Seat 2: Igoriah ($220.40 in chips) 
Seat 3: PtizaXXX ($173.60 in chips) 
Seat 4: sanrs57 ($193 in chips) 
Seat 5: Red4erT ($86 in chips) 
Seat 6: matiko09 ($200 in chips) 
Seat 7: PacPacBum ($207.92 in chips) 
Seat 8: chaps1988 ($208.32 in chips) 
Seat 9: RamiroAgujis ($200 in chips) 
sanrs57: posts small blind $1
Red4erT: posts big blind $2
IseeUcards: sits out 
*** HOLE CARDS ***
Dealt to matiko09 [2h 8s]
matiko09: folds 
PacPacBum: folds 
chaps1988: folds 
RamiroAgujis: folds 
Igoriah: folds 
PtizaXXX: raises $4 to $6
sanrs57: folds 
Red4erT: calls $4
*** FLOP *** [8d 3h Th]
Red4erT: checks 
PtizaXXX: checks 
*** TURN *** [8d 3h Th] [9d]
Red4erT: checks 
PtizaXXX: bets $6.21
Red4erT: calls $6.21
*** RIVER *** [8d 3h Th 9d] [6h]
Red4erT: checks 
PtizaXXX: checks 
*** SHOW DOWN ***
Red4erT: shows [Jd 9s] (a pair of Nines)
PtizaXXX: mucks hand 
Red4erT collected $24.28 from pot
*** SUMMARY ***
Total pot $25.42 | Rake $1.14 
Board [8d 3h Th 9d 6h]
Seat 2: Igoriah folded before Flop (didn't bet)
Seat 3: PtizaXXX (button) mucked [6s Ac]
Seat 4: sanrs57 (small blind) folded before Flop
Seat 5: Red4erT (big blind) showed [Jd 9s] and won ($24.28) with a pair of Nines
Seat 6: matiko09 folded before Flop (didn't bet)
Seat 7: PacPacBum folded before Flop (didn't bet)
Seat 8: chaps1988 folded before Flop (didn't bet)
Seat 9: RamiroAgujis folded before Flop (didn't bet)





PokerStars Hand #150802805390:  Hold'em No Limit ($0.50/$1.00 USD) - 2016/03/23 15:16:23 CET [2016/03/23 10:16:23 ET]
Table 'Swings' 9-max Seat #1 is the button
Seat 1: lumen21 ($100 in chips) 
Seat 2: tomver0809 ($92.82 in chips) 
Seat 3: maxxmeister ($135.53 in chips) 
Seat 4: chaps1988 ($103 in chips) 
Seat 5: chautinhtri9 ($113.45 in chips) 
Seat 6: matiko09 ($145.42 in chips) 
Seat 7: PacPacBum ($109.72 in chips) 
Seat 8: RICKA16 ($98.96 in chips) 
Seat 9: Effort92 ($100 in chips) 
tomver0809: posts small blind $0.50
maxxmeister: posts big blind $1
*** HOLE CARDS ***
Dealt to matiko09 [9s 4s]
chaps1988: folds 
chautinhtri9: folds 
matiko09: folds 
PacPacBum: folds 
RICKA16: folds 
Effort92: folds 
lumen21: raises $2 to $3
tomver0809: folds 
maxxmeister: folds 
Uncalled bet ($2) returned to lumen21
lumen21 collected $2.50 from pot
lumen21: doesn't show hand 
*** SUMMARY ***
Total pot $2.50 | Rake $0 
Seat 1: lumen21 (button) collected ($2.50)
Seat 2: tomver0809 (small blind) folded before Flop
Seat 3: maxxmeister (big blind) folded before Flop
Seat 4: chaps1988 folded before Flop (didn't bet)
Seat 5: chautinhtri9 folded before Flop (didn't bet)
Seat 6: matiko09 folded before Flop (didn't bet)
Seat 7: PacPacBum folded before Flop (didn't bet)
Seat 8: RICKA16 folded before Flop (didn't bet)
Seat 9: Effort92 folded before Flop (didn't bet)





PokerStars Hand #150802807221:  Hold'em No Limit ($1/$2 USD) - 2016/03/23 15:16:28 CET [2016/03/23 10:16:28 ET]
Table 'Kiess' 9-max Seat #8 is the button
Seat 1: Cirilico ($238.02 in chips) 
Seat 2: DUkalisUA ($726.98 in chips) 
Seat 3: Red4erT ($106.29 in chips) 
Seat 4: Igoriah ($200 in chips) 
Seat 6: matiko09 ($259.28 in chips) 
Seat 7: chaps1988 ($200 in chips) 
Seat 8: erfk1958 ($121.21 in chips) 
Seat 9: PacPacBum ($200 in chips) 
PacPacBum: posts small blind $1
Cirilico: posts big blind $2
*** HOLE CARDS ***
Dealt to matiko09 [6c 9s]
DUkalisUA: raises $4 to $6
Red4erT: folds 
Igoriah: folds 
matiko09: folds 
chaps1988: folds 
erfk1958: folds 
PacPacBum: folds 
Cirilico: folds 
Uncalled bet ($4) returned to DUkalisUA
DUkalisUA collected $5 from pot
DUkalisUA: doesn't show hand 
*** SUMMARY ***
Total pot $5 | Rake $0 
Seat 1: Cirilico (big blind) folded before Flop
Seat 2: DUkalisUA collected ($5)
Seat 3: Red4erT folded before Flop (didn't bet)
Seat 4: Igoriah folded before Flop (didn't bet)
Seat 6: matiko09 folded before Flop (didn't bet)
Seat 7: chaps1988 folded before Flop (didn't bet)
Seat 8: erfk1958 (button) folded before Flop (didn't bet)
Seat 9: PacPacBum (small blind) folded before Flop





PokerStars Hand #150802807809:  Hold'em No Limit ($0.50/$1.00 USD) - 2016/03/23 15:16:29 CET [2016/03/23 10:16:29 ET]
Table 'Smiley' 9-max Seat #1 is the button
Seat 1: xHourglass ($109.44 in chips) 
Seat 2: Jimy Tiltman ($118.74 in chips) 
Seat 3: Robert201202 ($118.68 in chips) 
Seat 4: CAJUN890 ($93.21 in chips) 
Seat 6: blackmont111 ($149.04 in chips) 
Seat 8: matiko09 ($106.30 in chips) 
Jimy Tiltman: posts small blind $0.50
Robert201202: posts big blind $1
bennetb77: sits out 
PacPacBum: sits out 
*** HOLE CARDS ***
Dealt to matiko09 [8h 2s]
CAJUN890: calls $1
blackmont111: folds 
matiko09: folds 
xHourglass: folds 
Jimy Tiltman: calls $0.50
Robert201202: checks 
*** FLOP *** [Kd Kh 7h]
Jimy Tiltman: checks 
Robert201202: checks 
CAJUN890: bets $3
Jimy Tiltman: folds 
Robert201202: folds 
Uncalled bet ($3) returned to CAJUN890
CAJUN890 collected $2.86 from pot
CAJUN890: doesn't show hand 
*** SUMMARY ***
Total pot $3 | Rake $0.14 
Board [Kd Kh 7h]
Seat 1: xHourglass (button) folded before Flop (didn't bet)
Seat 2: Jimy Tiltman (small blind) folded on the Flop
Seat 3: Robert201202 (big blind) folded on the Flop
Seat 4: CAJUN890 collected ($2.86)
Seat 6: blackmont111 folded before Flop (didn't bet)
Seat 8: matiko09 folded before Flop (didn't bet)





PokerStars Hand #150802810462:  Hold'em No Limit ($1/$2 USD) - 2016/03/23 15:16:37 CET [2016/03/23 10:16:37 ET]
Table 'Achaia' 9-max Seat #8 is the button
Seat 1: RamiroAgujis ($230.57 in chips) 
Seat 2: bananajoe001 ($18.87 in chips) 
Seat 3: matiko09 ($213.16 in chips) 
Seat 4: erfk1958 ($95.78 in chips) 
Seat 5: chaps1988 ($401.28 in chips) 
Seat 7: morosun ($142.66 in chips) 
Seat 8: IseeUcards ($310.85 in chips) 
Seat 9: PacPacBum ($200 in chips) 
PacPacBum: posts small blind $1
RamiroAgujis: posts big blind $2
*** HOLE CARDS ***
Dealt to matiko09 [5c Qs]
bananajoe001: folds 
matiko09: folds 
erfk1958: folds 
chaps1988: folds 
morosun: raises $6 to $8
IseeUcards: raises $14 to $22
PacPacBum: folds 
RamiroAgujis: folds 
morosun: raises $14 to $36
IseeUcards: raises $274.85 to $310.85 and is all-in
morosun: calls $106.66 and is all-in
Uncalled bet ($168.19) returned to IseeUcards
*** FLOP *** [4s Kh 2h]
*** TURN *** [4s Kh 2h] [Ks]
*** RIVER *** [4s Kh 2h Ks] [Js]
*** SHOW DOWN ***
morosun: shows [Qc Ah] (a pair of Kings)
IseeUcards: shows [Kd Kc] (four of a kind, Kings)
IseeUcards collected $285.52 from pot
*** SUMMARY ***
Total pot $288.32 | Rake $2.80 
Board [4s Kh 2h Ks Js]
Seat 1: RamiroAgujis (big blind) folded before Flop
Seat 2: bananajoe001 folded before Flop (didn't bet)
Seat 3: matiko09 folded before Flop (didn't bet)
Seat 4: erfk1958 folded before Flop (didn't bet)
Seat 5: chaps1988 folded before Flop (didn't bet)
Seat 7: morosun showed [Qc Ah] and lost with a pair of Kings
Seat 8: IseeUcards (button) showed [Kd Kc] and won ($285.52) with four of a kind, Kings
Seat 9: PacPacBum (small blind) folded before Flop





PokerStars Hand #150802814648:  Hold'em No Limit ($0.50/$1.00 USD) - 2016/03/23 15:16:48 CET [2016/03/23 10:16:48 ET]
Table 'Swings' 9-max Seat #2 is the button
Seat 1: lumen21 ($101.50 in chips) 
Seat 2: tomver0809 ($92.32 in chips) 
Seat 3: maxxmeister ($134.53 in chips) 
Seat 5: chautinhtri9 ($113.45 in chips) 
Seat 6: matiko09 ($145.42 in chips) 
Seat 7: PacPacBum ($109.72 in chips) 
Seat 8: RICKA16 ($98.96 in chips) 
Seat 9: Effort92 ($100 in chips) 
maxxmeister: posts small blind $0.50
chaps1988: is sitting out 
chautinhtri9: posts big blind $1
*** HOLE CARDS ***
Dealt to matiko09 [7s Kc]
matiko09: folds 
PacPacBum: folds 
RICKA16: folds 
Effort92: raises $1.50 to $2.50
lumen21: folds 
tomver0809: folds 
maxxmeister: folds 
chaps1988 leaves the table
chautinhtri9: folds 
Uncalled bet ($1.50) returned to Effort92
Effort92 collected $2.50 from pot
Effort92: doesn't show hand 
*** SUMMARY ***
Total pot $2.50 | Rake $0 
Seat 1: lumen21 folded before Flop (didn't bet)
Seat 2: tomver0809 (button) folded before Flop (didn't bet)
Seat 3: maxxmeister (small blind) folded before Flop
Seat 5: chautinhtri9 (big blind) folded before Flop
Seat 6: matiko09 folded before Flop (didn't bet)
Seat 7: PacPacBum folded before Flop (didn't bet)
Seat 8: RICKA16 folded before Flop (didn't bet)
Seat 9: Effort92 collected ($2.50)





PokerStars Hand #150802815058:  Hold'em No Limit ($0.50/$1.00 USD) - 2016/03/23 15:16:49 CET [2016/03/23 10:16:49 ET]
Table 'Sylvia III' 9-max Seat #3 is the button
Seat 1: mycka86 ($106.60 in chips) 
Seat 2: Dantist1122 ($103.30 in chips) 
Seat 3: se7en_$tars ($124.44 in chips) 
Seat 4: lombardo11 ($59.32 in chips) 
Seat 5: matiko09 ($100 in chips) 
Seat 6: PacPacBum ($102.50 in chips) 
Seat 7: easytalk777 ($93.23 in chips) 
Seat 8: nickreason17 ($105.74 in chips) 
Seat 9: Blanky-Bad ($97.98 in chips) 
lombardo11: posts small blind $0.50
matiko09: posts big blind $1
mycka86: posts the ante $0.20
Dantist1122: posts the ante $0.20
se7en_$tars: posts the ante $0.20
lombardo11: posts the ante $0.20
matiko09: posts the ante $0.20
PacPacBum: posts the ante $0.20
easytalk777: posts the ante $0.20
nickreason17: posts the ante $0.20
Blanky-Bad: posts the ante $0.20
*** HOLE CARDS ***
Dealt to matiko09 [Kc Jh]
PacPacBum: folds 
easytalk777: folds 
nickreason17: folds 
Blanky-Bad: folds 
mycka86: folds 
Dantist1122: raises $1.70 to $2.70
se7en_$tars: folds 
lombardo11: folds 
matiko09: folds 
Uncalled bet ($1.70) returned to Dantist1122
Dantist1122 collected $4.30 from pot
Dantist1122: doesn't show hand 
*** SUMMARY ***
Total pot $4.30 | Rake $0 
Seat 1: mycka86 folded before Flop (didn't bet)
Seat 2: Dantist1122 collected ($4.30)
Seat 3: se7en_$tars (button) folded before Flop (didn't bet)
Seat 4: lombardo11 (small blind) folded before Flop
Seat 5: matiko09 (big blind) folded before Flop
Seat 6: PacPacBum folded before Flop (didn't bet)
Seat 7: easytalk777 folded before Flop (didn't bet)
Seat 8: nickreason17 folded before Flop (didn't bet)
Seat 9: Blanky-Bad folded before Flop (didn't bet)





PokerStars Hand #150802819214:  Hold'em No Limit ($1/$2 USD) - 2016/03/23 15:17:01 CET [2016/03/23 10:17:01 ET]
Table 'Kiess' 9-max Seat #9 is the button
Seat 1: Cirilico ($236.02 in chips) 
Seat 3: Red4erT ($106.29 in chips) 
Seat 4: Igoriah ($200 in chips) 
Seat 6: matiko09 ($259.28 in chips) 
Seat 7: chaps1988 ($200 in chips) 
Seat 8: erfk1958 ($121.21 in chips) 
Seat 9: PacPacBum ($200 in chips) 
Cirilico: posts small blind $1
DUkalisUA: is sitting out 
Red4erT: posts big blind $2
*** HOLE CARDS ***
Dealt to matiko09 [6d 8d]
DUkalisUA leaves the table
Igoriah: raises $3 to $5
matiko09: folds 
chaps1988: folds 
XKTTBOBV11 joins the table at seat #2 
erfk1958: folds 
PacPacBum: folds 
Cirilico: folds 
Red4erT: folds 
Uncalled bet ($3) returned to Igoriah
Igoriah collected $5 from pot
Igoriah: doesn't show hand 
*** SUMMARY ***
Total pot $5 | Rake $0 
Seat 1: Cirilico (small blind) folded before Flop
Seat 3: Red4erT (big blind) folded before Flop
Seat 4: Igoriah collected ($5)
Seat 6: matiko09 folded before Flop (didn't bet)
Seat 7: chaps1988 folded before Flop (didn't bet)
Seat 8: erfk1958 folded before Flop (didn't bet)
Seat 9: PacPacBum (button) folded before Flop (didn't bet)





PokerStars Hand #150802821968:  Hold'em No Limit ($0.50/$1.00 USD) - 2016/03/23 15:17:08 CET [2016/03/23 10:17:08 ET]
Table 'Swings' 9-max Seat #3 is the button
Seat 1: lumen21 ($101.50 in chips) 
Seat 2: tomver0809 ($92.32 in chips) 
Seat 3: maxxmeister ($134.03 in chips) 
Seat 5: chautinhtri9 ($112.45 in chips) 
Seat 6: matiko09 ($145.42 in chips) 
Seat 7: PacPacBum ($109.72 in chips) 
Seat 8: RICKA16 ($98.96 in chips) 
Seat 9: Effort92 ($101.50 in chips) 
chautinhtri9: posts small blind $0.50
matiko09: posts big blind $1
*** HOLE CARDS ***
Dealt to matiko09 [Jc 3h]
PacPacBum: folds 
RICKA16: folds 
Effort92: folds 
lumen21: raises $2 to $3
YuriiSolodya joins the table at seat #4 
tomver0809: folds 
maxxmeister: folds 
chautinhtri9: folds 
matiko09: folds 
Uncalled bet ($2) returned to lumen21
lumen21 collected $2.50 from pot
lumen21: doesn't show hand 
*** SUMMARY ***
Total pot $2.50 | Rake $0 
Seat 1: lumen21 collected ($2.50)
Seat 2: tomver0809 folded before Flop (didn't bet)
Seat 3: maxxmeister (button) folded before Flop (didn't bet)
Seat 5: chautinhtri9 (small blind) folded before Flop
Seat 6: matiko09 (big blind) folded before Flop
Seat 7: PacPacBum folded before Flop (didn't bet)
Seat 8: RICKA16 folded before Flop (didn't bet)
Seat 9: Effort92 folded before Flop (didn't bet)





PokerStars Hand #150802822630:  Hold'em No Limit ($0.50/$1.00 USD) - 2016/03/23 15:17:10 CET [2016/03/23 10:17:10 ET]
Table 'Sylvia III' 9-max Seat #4 is the button
Seat 1: mycka86 ($106.40 in chips) 
Seat 2: Dantist1122 ($106.40 in chips) 
Seat 3: se7en_$tars ($124.24 in chips) 
Seat 4: lombardo11 ($58.62 in chips) 
Seat 5: matiko09 ($100 in chips) 
Seat 6: PacPacBum ($102.30 in chips) 
Seat 7: easytalk777 ($93.03 in chips) 
Seat 8: nickreason17 ($105.54 in chips) 
Seat 9: Blanky-Bad ($97.78 in chips) 
matiko09: posts small blind $0.50
PacPacBum: posts big blind $1
mycka86: posts the ante $0.20
Dantist1122: posts the ante $0.20
se7en_$tars: posts the ante $0.20
lombardo11: posts the ante $0.20
matiko09: posts the ante $0.20
PacPacBum: posts the ante $0.20
easytalk777: posts the ante $0.20
nickreason17: posts the ante $0.20
Blanky-Bad: posts the ante $0.20
*** HOLE CARDS ***
Dealt to matiko09 [Jc Qc]
easytalk777: folds 
nickreason17: folds 
Blanky-Bad: folds 
mycka86: folds 
Dantist1122: folds 
se7en_$tars: raises $2 to $3
lombardo11: folds 
matiko09: raises $6 to $9
PacPacBum: calls $8
se7en_$tars: calls $6
*** FLOP *** [5s 9h 9s]
matiko09: checks 
PacPacBum: checks 
se7en_$tars: checks 
*** TURN *** [5s 9h 9s] [Kc]
matiko09: checks 
PacPacBum: checks 
se7en_$tars: bets $14
matiko09: folds 
PacPacBum: folds 
Uncalled bet ($14) returned to se7en_$tars
se7en_$tars collected $27.50 from pot
se7en_$tars: doesn't show hand 
*** SUMMARY ***
Total pot $28.80 | Rake $1.30 
Board [5s 9h 9s Kc]
Seat 1: mycka86 folded before Flop (didn't bet)
Seat 2: Dantist1122 folded before Flop (didn't bet)
Seat 3: se7en_$tars collected ($27.50)
Seat 4: lombardo11 (button) folded before Flop (didn't bet)
Seat 5: matiko09 (small blind) folded on the Turn
Seat 6: PacPacBum (big blind) folded on the Turn
Seat 7: easytalk777 folded before Flop (didn't bet)
Seat 8: nickreason17 folded before Flop (didn't bet)
Seat 9: Blanky-Bad folded before Flop (didn't bet)





PokerStars Hand #150802823277:  Hold'em No Limit ($0.50/$1.00 USD) - 2016/03/23 15:17:12 CET [2016/03/23 10:17:12 ET]
Table 'Smiley' 9-max Seat #2 is the button
Seat 1: xHourglass ($109.44 in chips) 
Seat 2: Jimy Tiltman ($117.74 in chips) 
Seat 3: Robert201202 ($117.68 in chips) 
Seat 4: CAJUN890 ($95.07 in chips) 
Seat 6: blackmont111 ($149.04 in chips) 
Seat 8: matiko09 ($106.30 in chips) 
Robert201202: posts small blind $0.50
CAJUN890: posts big blind $1
Szevasztopol: sits out 
bennetb77: sits out 
PacPacBum: sits out 
*** HOLE CARDS ***
Dealt to matiko09 [3d 9s]
blackmont111: raises $1 to $2
matiko09: folds 
xHourglass: folds 
Jimy Tiltman: folds 
Robert201202: folds 
CAJUN890: folds 
Uncalled bet ($1) returned to blackmont111
blackmont111 collected $2.50 from pot
blackmont111: doesn't show hand 
*** SUMMARY ***
Total pot $2.50 | Rake $0 
Seat 1: xHourglass folded before Flop (didn't bet)
Seat 2: Jimy Tiltman (button) folded before Flop (didn't bet)
Seat 3: Robert201202 (small blind) folded before Flop
Seat 4: CAJUN890 (big blind) folded before Flop
Seat 6: blackmont111 collected ($2.50)
Seat 8: matiko09 folded before Flop (didn't bet)





PokerStars Hand #150802825931:  Hold'em No Limit (€0.50/€1.00 EUR) - 2016/03/23 15:17:19 CET [2016/03/23 10:17:19 ET]
Table 'Mercury III' 9-max Seat #1 is the button
Seat 1: matiko09 (€116.08 in chips) 
Seat 2: jahwe (€100 in chips) 
Seat 3: PacPacBum (€100.83 in chips) 
Seat 4: Muinmyheart (€103 in chips) 
Seat 5: DUkalisUA (€100 in chips) 
Seat 6: mycka86 (€103.89 in chips) 
Seat 7: STrakDD (€100 in chips) 
Seat 8: gfxed (€34.34 in chips) 
Seat 9: Indr3k (€100 in chips) 
jahwe: posts small blind €0.50
PacPacBum: posts big blind €1
*** HOLE CARDS ***
Dealt to matiko09 [Ad 8h]
Muinmyheart: folds 
DUkalisUA: folds 
mycka86: folds 
STrakDD: folds 
gfxed: raises €1.01 to €2.01
Indr3k: folds 
matiko09: folds 
jahwe: folds 
PacPacBum: folds 
Uncalled bet (€1.01) returned to gfxed
gfxed collected €2.50 from pot
*** SUMMARY ***
Total pot €2.50 | Rake €0 
Seat 1: matiko09 (button) folded before Flop (didn't bet)
Seat 2: jahwe (small blind) folded before Flop
Seat 3: PacPacBum (big blind) folded before Flop
Seat 4: Muinmyheart folded before Flop (didn't bet)
Seat 5: DUkalisUA folded before Flop (didn't bet)
Seat 6: mycka86 folded before Flop (didn't bet)
Seat 7: STrakDD folded before Flop (didn't bet)
Seat 8: gfxed collected (€2.50)
Seat 9: Indr3k folded before Flop (didn't bet)





PokerStars Hand #150802828025:  Hold'em No Limit ($1/$2 USD) - 2016/03/23 15:17:25 CET [2016/03/23 10:17:25 ET]
Table 'Clarissa II' 9-max Seat #4 is the button
Seat 2: Igoriah ($220.40 in chips) 
Seat 3: PtizaXXX ($161.39 in chips) 
Seat 4: sanrs57 ($192 in chips) 
Seat 5: Red4erT ($98.07 in chips) 
Seat 6: matiko09 ($200 in chips) 
Seat 7: PacPacBum ($207.92 in chips) 
Seat 8: chaps1988 ($208.32 in chips) 
Seat 9: RamiroAgujis ($200 in chips) 
Red4erT: posts small blind $1
matiko09: posts big blind $2
IseeUcards: sits out 
*** HOLE CARDS ***
Dealt to matiko09 [4c 4s]
PacPacBum: raises $2.08 to $4.08
chaps1988: folds 
RamiroAgujis: folds 
Igoriah: folds 
PtizaXXX: folds 
sanrs57: folds 
Red4erT: folds 
matiko09: calls $2.08
*** FLOP *** [3s Ah 4h]
matiko09: checks 
PacPacBum: bets $3.06
matiko09: calls $3.06
*** TURN *** [3s Ah 4h] [7d]
matiko09: checks 
PacPacBum: bets $7.87
matiko09: raises $16.13 to $24
PacPacBum: folds 
Uncalled bet ($16.13) returned to matiko09
matiko09 collected $29.62 from pot
matiko09: doesn't show hand 
*** SUMMARY ***
Total pot $31.02 | Rake $1.40 
Board [3s Ah 4h 7d]
Seat 2: Igoriah folded before Flop (didn't bet)
Seat 3: PtizaXXX folded before Flop (didn't bet)
Seat 4: sanrs57 (button) folded before Flop (didn't bet)
Seat 5: Red4erT (small blind) folded before Flop
Seat 6: matiko09 (big blind) collected ($29.62)
Seat 7: PacPacBum folded on the Turn
Seat 8: chaps1988 folded before Flop (didn't bet)
Seat 9: RamiroAgujis folded before Flop (didn't bet)





PokerStars Hand #150802828620:  Hold'em No Limit ($1/$2 USD) - 2016/03/23 15:17:27 CET [2016/03/23 10:17:27 ET]
Table 'Kiess' 9-max Seat #1 is the button
Seat 1: Cirilico ($235.02 in chips) 
Seat 3: Red4erT ($104.29 in chips) 
Seat 6: matiko09 ($259.28 in chips) 
Seat 7: chaps1988 ($200 in chips) 
Seat 8: erfk1958 ($121.21 in chips) 
Seat 9: PacPacBum ($200 in chips) 
XKTTBOBV11 will be allowed to play after the button
Red4erT: posts small blind $1
Igoriah: is sitting out 
matiko09: posts big blind $2
*** HOLE CARDS ***
Dealt to matiko09 [Kd 3d]
chaps1988: raises $3 to $5
Igoriah leaves the table
erfk1958: calls $5
RamiroAgujis joins the table at seat #4 
PacPacBum: folds 
Cirilico: folds 
Red4erT: folds 
matiko09: folds 
*** FLOP *** [9d 9c 6s]
chaps1988: checks 
erfk1958: checks 
*** TURN *** [9d 9c 6s] [5s]
chaps1988: checks 
erfk1958: checks 
*** RIVER *** [9d 9c 6s 5s] [Qh]
chaps1988: checks 
erfk1958: checks 
*** SHOW DOWN ***
chaps1988: shows [Ad Jc] (a pair of Nines)
erfk1958: mucks hand 
chaps1988 collected $12.42 from pot
*** SUMMARY ***
Total pot $13 | Rake $0.58 
Board [9d 9c 6s 5s Qh]
Seat 1: Cirilico (button) folded before Flop (didn't bet)
Seat 3: Red4erT (small blind) folded before Flop
Seat 6: matiko09 (big blind) folded before Flop
Seat 7: chaps1988 showed [Ad Jc] and won ($12.42) with a pair of Nines
Seat 8: erfk1958 mucked [8h Ah]
Seat 9: PacPacBum folded before Flop (didn't bet)





PokerStars Hand #150802829527:  Hold'em No Limit ($0.50/$1.00 USD) - 2016/03/23 15:17:29 CET [2016/03/23 10:17:29 ET]
Table 'Asmodeus' 9-max Seat #7 is the button
Seat 1: Jimy Tiltman ($139.56 in chips) 
Seat 2: PacPacBum ($100 in chips) 
Seat 4: Effort92 ($104.34 in chips) 
Seat 5: Muinmyheart ($100 in chips) 
Seat 6: fuppeee ($93.31 in chips) 
Seat 7: mycka86 ($137.05 in chips) 
Seat 8: bonifacioppl ($54.85 in chips) 
Seat 9: matiko09 ($100 in chips) 
bonifacioppl: posts small blind $0.50
matiko09: posts big blind $1
jahwe: sits out 
Jimy Tiltman: posts the ante $0.20
PacPacBum: posts the ante $0.20
Effort92: posts the ante $0.20
Muinmyheart: posts the ante $0.20
fuppeee: posts the ante $0.20
mycka86: posts the ante $0.20
bonifacioppl: posts the ante $0.20
matiko09: posts the ante $0.20
*** HOLE CARDS ***
Dealt to matiko09 [8d 8c]
Jimy Tiltman: raises $2 to $3
PacPacBum: folds 
Effort92: folds 
Muinmyheart: folds 
fuppeee: folds 
mycka86: calls $3
bonifacioppl: calls $2.50
matiko09: calls $2
*** FLOP *** [7d 7h 6s]
bonifacioppl: checks 
matiko09: checks 
Jimy Tiltman: checks 
mycka86: checks 
*** TURN *** [7d 7h 6s] [Tc]
bonifacioppl: checks 
matiko09: checks 
Jimy Tiltman: checks 
mycka86: checks 
*** RIVER *** [7d 7h 6s Tc] [Js]
bonifacioppl: checks 
matiko09: checks 
Jimy Tiltman: bets $6.49
mycka86: folds 
bonifacioppl: folds 
matiko09: folds 
Uncalled bet ($6.49) returned to Jimy Tiltman
Jimy Tiltman collected $12.99 from pot
Jimy Tiltman: doesn't show hand 
*** SUMMARY ***
Total pot $13.60 | Rake $0.61 
Board [7d 7h 6s Tc Js]
Seat 1: Jimy Tiltman collected ($12.99)
Seat 2: PacPacBum folded before Flop (didn't bet)
Seat 4: Effort92 folded before Flop (didn't bet)
Seat 5: Muinmyheart folded before Flop (didn't bet)
Seat 6: fuppeee folded before Flop (didn't bet)
Seat 7: mycka86 (button) folded on the River
Seat 8: bonifacioppl (small blind) folded on the River
Seat 9: matiko09 (big blind) folded on the River





PokerStars Hand #150802830726:  Hold'em No Limit ($0.50/$1.00 USD) - 2016/03/23 15:17:33 CET [2016/03/23 10:17:33 ET]
Table 'Smiley' 9-max Seat #3 is the button
Seat 1: xHourglass ($109.44 in chips) 
Seat 2: Jimy Tiltman ($117.74 in chips) 
Seat 3: Robert201202 ($117.18 in chips) 
Seat 4: CAJUN890 ($94.07 in chips) 
Seat 5: Szevasztopol ($100 in chips) 
Seat 6: blackmont111 ($150.54 in chips) 
Seat 8: matiko09 ($106.30 in chips) 
CAJUN890: posts small blind $0.50
Szevasztopol: posts big blind $1
bennetb77: sits out 
PacPacBum: sits out 
*** HOLE CARDS ***
Dealt to matiko09 [7c Qh]
blackmont111: folds 
matiko09: folds 
xHourglass: folds 
Jimy Tiltman: raises $2 to $3
Robert201202: calls $3
CAJUN890: folds 
Szevasztopol: calls $2
*** FLOP *** [9d 8d Kc]
Szevasztopol: checks 
Jimy Tiltman: checks 
Robert201202: checks 
*** TURN *** [9d 8d Kc] [6s]
Szevasztopol: bets $7.07
Jimy Tiltman: folds 
Robert201202: folds 
Uncalled bet ($7.07) returned to Szevasztopol
Szevasztopol collected $9.07 from pot
Szevasztopol: doesn't show hand 
*** SUMMARY ***
Total pot $9.50 | Rake $0.43 
Board [9d 8d Kc 6s]
Seat 1: xHourglass folded before Flop (didn't bet)
Seat 2: Jimy Tiltman folded on the Turn
Seat 3: Robert201202 (button) folded on the Turn
Seat 4: CAJUN890 (small blind) folded before Flop
Seat 5: Szevasztopol (big blind) collected ($9.07)
Seat 6: blackmont111 folded before Flop (didn't bet)
Seat 8: matiko09 folded before Flop (didn't bet)





PokerStars Hand #150802833937:  Hold'em No Limit ($0.50/$1.00 USD) - 2016/03/23 15:17:41 CET [2016/03/23 10:17:41 ET]
Table 'Drakonia II' 9-max Seat #9 is the button
Seat 1: chautinhtri9 ($128.10 in chips) 
Seat 2: carrsseis ($103 in chips) 
Seat 3: dunga119 ($150.69 in chips) 
Seat 6: Dantist1122 ($110.26 in chips) 
Seat 7: YuriiSolodya ($26.40 in chips) 
Seat 8: matiko09 ($100 in chips) 
Seat 9: mycka86 ($101.86 in chips) 
chautinhtri9: posts small blind $0.50
carrsseis: posts big blind $1
lumen21: sits out 
Muinmyheart: sits out 
*** HOLE CARDS ***
Dealt to matiko09 [7h Qc]
dunga119: folds 
Dantist1122: raises $2 to $3
YuriiSolodya: folds 
matiko09: folds 
mycka86: folds 
chautinhtri9: folds 
carrsseis: folds 
Uncalled bet ($2) returned to Dantist1122
Dantist1122 collected $2.50 from pot
Dantist1122: doesn't show hand 
*** SUMMARY ***
Total pot $2.50 | Rake $0 
Seat 1: chautinhtri9 (small blind) folded before Flop
Seat 2: carrsseis (big blind) folded before Flop
Seat 3: dunga119 folded before Flop (didn't bet)
Seat 6: Dantist1122 collected ($2.50)
Seat 7: YuriiSolodya folded before Flop (didn't bet)
Seat 8: matiko09 folded before Flop (didn't bet)
Seat 9: mycka86 (button) folded before Flop (didn't bet)





PokerStars Hand #150802835546:  Hold'em No Limit ($0.50/$1.00 USD) - 2016/03/23 15:17:46 CET [2016/03/23 10:17:46 ET]
Table 'Swings' 9-max Seat #5 is the button
Seat 1: lumen21 ($103 in chips) 
Seat 2: tomver0809 ($92.32 in chips) 
Seat 3: maxxmeister ($134.03 in chips) 
Seat 5: chautinhtri9 ($111.95 in chips) 
Seat 6: matiko09 ($144.42 in chips) 
Seat 7: PacPacBum ($109.72 in chips) 
Seat 8: RICKA16 ($98.96 in chips) 
Seat 9: Effort92 ($101.50 in chips) 
matiko09: posts small blind $0.50
PacPacBum: posts big blind $1
YuriiSolodya: sits out 
*** HOLE CARDS ***
Dealt to matiko09 [Jd Kd]
RICKA16: folds 
Effort92: folds 
lumen21: folds 
tomver0809: calls $1
maxxmeister: folds 
chautinhtri9: calls $1
matiko09: calls $0.50
PacPacBum: checks 
*** FLOP *** [Ks 3c Ad]
matiko09: checks 
PacPacBum: checks 
tomver0809: bets $3
chautinhtri9: calls $3
matiko09: folds 
PacPacBum: folds 
*** TURN *** [Ks 3c Ad] [4s]
tomver0809: checks 
chautinhtri9: checks 
*** RIVER *** [Ks 3c Ad 4s] [4c]
tomver0809: bets $6
chautinhtri9: calls $6
*** SHOW DOWN ***
tomver0809: shows [8c Th] (a pair of Fours)
chautinhtri9: shows [Ah 7h] (two pair, Aces and Fours)
chautinhtri9 collected $21.01 from pot
*** SUMMARY ***
Total pot $22 | Rake $0.99 
Board [Ks 3c Ad 4s 4c]
Seat 1: lumen21 folded before Flop (didn't bet)
Seat 2: tomver0809 showed [8c Th] and lost with a pair of Fours
Seat 3: maxxmeister folded before Flop (didn't bet)
Seat 5: chautinhtri9 (button) showed [Ah 7h] and won ($21.01) with two pair, Aces and Fours
Seat 6: matiko09 (small blind) folded on the Flop
Seat 7: PacPacBum (big blind) folded on the Flop
Seat 8: RICKA16 folded before Flop (didn't bet)
Seat 9: Effort92 folded before Flop (didn't bet)





PokerStars Hand #150802837895:  Hold'em No Limit ($1/$2 USD) - 2016/03/23 15:17:52 CET [2016/03/23 10:17:52 ET]
Table 'Achaia' 9-max Seat #9 is the button
Seat 1: RamiroAgujis ($228.57 in chips) 
Seat 2: bananajoe001 ($18.87 in chips) 
Seat 3: matiko09 ($213.16 in chips) 
Seat 4: erfk1958 ($95.78 in chips) 
Seat 5: chaps1988 ($401.28 in chips) 
Seat 8: IseeUcards ($453.71 in chips) 
Seat 9: PacPacBum ($200 in chips) 
RamiroAgujis: posts small blind $1
bananajoe001: posts big blind $2
*** HOLE CARDS ***
Dealt to matiko09 [6s 2d]
matiko09: folds 
morosun leaves the table
erfk1958: folds 
chaps1988: raises $3 to $5
IseeUcards: folds 
PacPacBum: folds 
RamiroAgujis: folds 
bananajoe001: raises $13.87 to $18.87 and is all-in
chaps1988: calls $13.87
*** FLOP *** [Qs Qh Jc]
*** TURN *** [Qs Qh Jc] [Tc]
*** RIVER *** [Qs Qh Jc Tc] [7s]
*** SHOW DOWN ***
bananajoe001: shows [3c Ah] (a pair of Queens)
chaps1988: shows [8c 9c] (a straight, Eight to Queen)
chaps1988 collected $37 from pot
*** SUMMARY ***
Total pot $38.74 | Rake $1.74 
Board [Qs Qh Jc Tc 7s]
Seat 1: RamiroAgujis (small blind) folded before Flop
Seat 2: bananajoe001 (big blind) showed [3c Ah] and lost with a pair of Queens
Seat 3: matiko09 folded before Flop (didn't bet)
Seat 4: erfk1958 folded before Flop (didn't bet)
Seat 5: chaps1988 showed [8c 9c] and won ($37) with a straight, Eight to Queen
Seat 8: IseeUcards folded before Flop (didn't bet)
Seat 9: PacPacBum (button) folded before Flop (didn't bet)





PokerStars Hand #150802843365:  Hold'em No Limit (€0.50/€1.00 EUR) - 2016/03/23 15:18:07 CET [2016/03/23 10:18:07 ET]
Table 'Mercury III' 9-max Seat #2 is the button
Seat 1: matiko09 (€116.08 in chips) 
Seat 2: jahwe (€100 in chips) 
Seat 3: PacPacBum (€100 in chips) 
Seat 4: Muinmyheart (€103 in chips) 
Seat 5: DUkalisUA (€100 in chips) 
Seat 6: mycka86 (€103.89 in chips) 
Seat 7: STrakDD (€100 in chips) 
Seat 8: gfxed (€35.84 in chips) 
Seat 9: Indr3k (€100 in chips) 
PacPacBum: posts small blind €0.50
Muinmyheart: posts big blind €1
*** HOLE CARDS ***
Dealt to matiko09 [Qc Jh]
DUkalisUA: raises €2 to €3
mycka86: folds 
STrakDD: folds 
gfxed: folds 
Indr3k: folds 
matiko09: folds 
jahwe: calls €3
PacPacBum: folds 
Muinmyheart: folds 
*** FLOP *** [7h 3s 7d]
DUkalisUA: bets €4
jahwe: folds 
Uncalled bet (€4) returned to DUkalisUA
DUkalisUA collected €7.16 from pot
DUkalisUA: doesn't show hand 
*** SUMMARY ***
Total pot €7.50 | Rake €0.34 
Board [7h 3s 7d]
Seat 1: matiko09 folded before Flop (didn't bet)
Seat 2: jahwe (button) folded on the Flop
Seat 3: PacPacBum (small blind) folded before Flop
Seat 4: Muinmyheart (big blind) folded before Flop
Seat 5: DUkalisUA collected (€7.16)
Seat 6: mycka86 folded before Flop (didn't bet)
Seat 7: STrakDD folded before Flop (didn't bet)
Seat 8: gfxed folded before Flop (didn't bet)
Seat 9: Indr3k folded before Flop (didn't bet)





PokerStars Hand #150802844387:  Hold'em No Limit ($1/$2 USD) - 2016/03/23 15:18:10 CET [2016/03/23 10:18:10 ET]
Table 'Kiess' 9-max Seat #3 is the button
Seat 1: Cirilico ($235.02 in chips) 
Seat 3: Red4erT ($103.29 in chips) 
Seat 6: matiko09 ($257.28 in chips) 
Seat 7: chaps1988 ($207.42 in chips) 
Seat 8: erfk1958 ($116.21 in chips) 
Seat 9: PacPacBum ($200 in chips) 
RamiroAgujis will be allowed to play after the button
matiko09: posts small blind $1
chaps1988: posts big blind $2
XKTTBOBV11: sits out 
*** HOLE CARDS ***
Dealt to matiko09 [2s Ah]
erfk1958: folds 
PacPacBum: folds 
Cirilico: folds 
Red4erT: raises $3 to $5
matiko09: folds 
chaps1988: calls $3
*** FLOP *** [Ks 6c 2h]
chaps1988: checks 
Red4erT: bets $3.57
chaps1988: calls $3.57
*** TURN *** [Ks 6c 2h] [4s]
chaps1988: checks 
Red4erT: bets $25.98
chaps1988: folds 
Uncalled bet ($25.98) returned to Red4erT
Red4erT collected $17.32 from pot
Red4erT: doesn't show hand 
*** SUMMARY ***
Total pot $18.14 | Rake $0.82 
Board [Ks 6c 2h 4s]
Seat 1: Cirilico folded before Flop (didn't bet)
Seat 3: Red4erT (button) collected ($17.32)
Seat 6: matiko09 (small blind) folded before Flop
Seat 7: chaps1988 (big blind) folded on the Turn
Seat 8: erfk1958 folded before Flop (didn't bet)
Seat 9: PacPacBum folded before Flop (didn't bet)





PokerStars Hand #150802845646:  Hold'em No Limit ($0.50/$1.00 USD) - 2016/03/23 15:18:13 CET [2016/03/23 10:18:13 ET]
Table 'Drakonia II' 9-max Seat #1 is the button
Seat 1: chautinhtri9 ($127.60 in chips) 
Seat 2: carrsseis ($102 in chips) 
Seat 3: dunga119 ($150.69 in chips) 
Seat 6: Dantist1122 ($111.76 in chips) 
Seat 7: YuriiSolodya ($26.40 in chips) 
Seat 8: matiko09 ($100 in chips) 
Seat 9: mycka86 ($101.86 in chips) 
carrsseis: posts small blind $0.50
dunga119: posts big blind $1
lumen21: sits out 
Muinmyheart: sits out 
*** HOLE CARDS ***
Dealt to matiko09 [8c 5h]
Dantist1122: folds 
YuriiSolodya: folds 
matiko09: folds 
mycka86: folds 
chautinhtri9: folds 
carrsseis: folds 
Uncalled bet ($0.50) returned to dunga119
dunga119 collected $1 from pot
dunga119: doesn't show hand 
*** SUMMARY ***
Total pot $1 | Rake $0 
Seat 1: chautinhtri9 (button) folded before Flop (didn't bet)
Seat 2: carrsseis (small blind) folded before Flop
Seat 3: dunga119 (big blind) collected ($1)
Seat 6: Dantist1122 folded before Flop (didn't bet)
Seat 7: YuriiSolodya folded before Flop (didn't bet)
Seat 8: matiko09 folded before Flop (didn't bet)
Seat 9: mycka86 folded before Flop (didn't bet)





PokerStars Hand #150802847645:  Hold'em No Limit ($0.50/$1.00 USD) - 2016/03/23 15:18:19 CET [2016/03/23 10:18:19 ET]
Table 'Smiley' 9-max Seat #4 is the button
Seat 1: xHourglass ($109.44 in chips) 
Seat 2: Jimy Tiltman ($114.74 in chips) 
Seat 3: Robert201202 ($114.18 in chips) 
Seat 4: CAJUN890 ($93.57 in chips) 
Seat 5: Szevasztopol ($106.07 in chips) 
Seat 6: blackmont111 ($150.54 in chips) 
Seat 8: matiko09 ($106.30 in chips) 
Szevasztopol: posts small blind $0.50
blackmont111: posts big blind $1
bennetb77: sits out 
PacPacBum: sits out 
*** HOLE CARDS ***
Dealt to matiko09 [9s Ad]
matiko09: folds 
xHourglass: folds 
Jimy Tiltman: folds 
Robert201202: folds 
CAJUN890: raises $3 to $4
Szevasztopol: folds 
blackmont111: calls $3
*** FLOP *** [6s Js 5c]
blackmont111: checks 
CAJUN890: bets $5
blackmont111: folds 
Uncalled bet ($5) returned to CAJUN890
CAJUN890 collected $8.12 from pot
CAJUN890: doesn't show hand 
*** SUMMARY ***
Total pot $8.50 | Rake $0.38 
Board [6s Js 5c]
Seat 1: xHourglass folded before Flop (didn't bet)
Seat 2: Jimy Tiltman folded before Flop (didn't bet)
Seat 3: Robert201202 folded before Flop (didn't bet)
Seat 4: CAJUN890 (button) collected ($8.12)
Seat 5: Szevasztopol (small blind) folded before Flop
Seat 6: blackmont111 (big blind) folded on the Flop
Seat 8: matiko09 folded before Flop (didn't bet)





PokerStars Hand #150802853614:  Hold'em No Limit ($1/$2 USD) - 2016/03/23 15:18:35 CET [2016/03/23 10:18:35 ET]
Table 'Achaia' 9-max Seat #1 is the button
Seat 1: RamiroAgujis ($227.57 in chips) 
Seat 3: matiko09 ($213.16 in chips) 
Seat 4: erfk1958 ($95.78 in chips) 
Seat 5: chaps1988 ($419.41 in chips) 
Seat 8: IseeUcards ($453.71 in chips) 
Seat 9: PacPacBum ($200 in chips) 
matiko09: posts small blind $1
erfk1958: posts big blind $2
*** HOLE CARDS ***
Dealt to matiko09 [7d 5h]
chaps1988: folds 
IseeUcards: folds 
bananajoe001 leaves the table
PacPacBum: raises $2.08 to $4.08
RamiroAgujis: folds 
matiko09: folds 
XKTTBOBV11 leaves the table
erfk1958: folds 
Uncalled bet ($2.08) returned to PacPacBum
nairolf24 joins the table at seat #7 
PacPacBum collected $5 from pot
PacPacBum: doesn't show hand 
*** SUMMARY ***
Total pot $5 | Rake $0 
Seat 1: RamiroAgujis (button) folded before Flop (didn't bet)
Seat 3: matiko09 (small blind) folded before Flop
Seat 4: erfk1958 (big blind) folded before Flop
Seat 5: chaps1988 folded before Flop (didn't bet)
Seat 8: IseeUcards folded before Flop (didn't bet)
Seat 9: PacPacBum collected ($5)





PokerStars Hand #150802861267:  Hold'em No Limit ($0.50/$1.00 USD) - 2016/03/23 15:18:57 CET [2016/03/23 10:18:57 ET]
Table 'Drakonia II' 9-max Seat #2 is the button
Seat 1: chautinhtri9 ($127.60 in chips) 
Seat 2: carrsseis ($101.50 in chips) 
Seat 3: dunga119 ($151.19 in chips) 
Seat 4: lumen21 ($100 in chips) 
Seat 6: Dantist1122 ($111.76 in chips) 
Seat 7: YuriiSolodya ($26.40 in chips) 
Seat 8: matiko09 ($100 in chips) 
Seat 9: mycka86 ($101.86 in chips) 
dunga119: posts small blind $0.50
lumen21: posts big blind $1
Muinmyheart: sits out 
*** HOLE CARDS ***
Dealt to matiko09 [5s Kh]
Dantist1122: raises $2 to $3
YuriiSolodya: calls $3
matiko09: folds 
mycka86: folds 
chautinhtri9: folds 
carrsseis: folds 
dunga119: calls $2.50
lumen21: calls $2
*** FLOP *** [7c 5d 4s]
dunga119: bets $11.46
lumen21: folds 
Dantist1122: folds 
YuriiSolodya: folds 
Uncalled bet ($11.46) returned to dunga119
dunga119 collected $11.46 from pot
dunga119: doesn't show hand 
*** SUMMARY ***
Total pot $12 | Rake $0.54 
Board [7c 5d 4s]
Seat 1: chautinhtri9 folded before Flop (didn't bet)
Seat 2: carrsseis (button) folded before Flop (didn't bet)
Seat 3: dunga119 (small blind) collected ($11.46)
Seat 4: lumen21 (big blind) folded on the Flop
Seat 6: Dantist1122 folded on the Flop
Seat 7: YuriiSolodya folded on the Flop
Seat 8: matiko09 folded before Flop (didn't bet)
Seat 9: mycka86 folded before Flop (didn't bet)





PokerStars Hand #150802862157:  Hold'em No Limit ($0.50/$1.00 USD) - 2016/03/23 15:18:59 CET [2016/03/23 10:18:59 ET]
Table 'Sylvia III' 9-max Seat #5 is the button
Seat 1: mycka86 ($106.20 in chips) 
Seat 2: Dantist1122 ($106.20 in chips) 
Seat 3: se7en_$tars ($142.54 in chips) 
Seat 4: lombardo11 ($58.42 in chips) 
Seat 5: matiko09 ($100 in chips) 
Seat 6: PacPacBum ($100 in chips) 
Seat 7: easytalk777 ($99.27 in chips) 
Seat 8: nickreason17 ($105.34 in chips) 
Seat 9: Blanky-Bad ($97.58 in chips) 
PacPacBum: posts small blind $0.50
easytalk777: posts big blind $1
mycka86: posts the ante $0.20
Dantist1122: posts the ante $0.20
se7en_$tars: posts the ante $0.20
lombardo11: posts the ante $0.20
matiko09: posts the ante $0.20
PacPacBum: posts the ante $0.20
easytalk777: posts the ante $0.20
nickreason17: posts the ante $0.20
Blanky-Bad: posts the ante $0.20
*** HOLE CARDS ***
Dealt to matiko09 [6d Th]
nickreason17: folds 
nickreason17 leaves the table
Blanky-Bad: raises $2 to $3
mycka86: raises $7.50 to $10.50
Dantist1122: folds 
se7en_$tars: calls $10.50
lombardo11: folds 
matiko09: folds 
Muinmyheart joins the table at seat #8 
PacPacBum: folds 
easytalk777: folds 
Blanky-Bad: calls $7.50
*** FLOP *** [9d Qd 8s]
Blanky-Bad: checks 
mycka86: checks 
se7en_$tars: bets $17
Blanky-Bad: folds 
mycka86: raises $78.50 to $95.50 and is all-in
se7en_$tars: folds 
Uncalled bet ($78.50) returned to mycka86
mycka86 collected $66 from pot
*** SUMMARY ***
Total pot $68.80 | Rake $2.80 
Board [9d Qd 8s]
Seat 1: mycka86 collected ($66)
Seat 2: Dantist1122 folded before Flop (didn't bet)
Seat 3: se7en_$tars folded on the Flop
Seat 4: lombardo11 folded before Flop (didn't bet)
Seat 5: matiko09 (button) folded before Flop (didn't bet)
Seat 6: PacPacBum (small blind) folded before Flop
Seat 7: easytalk777 (big blind) folded before Flop
Seat 8: nickreason17 folded before Flop (didn't bet)
Seat 9: Blanky-Bad folded on the Flop





PokerStars Hand #150802863146:  Hold'em No Limit ($1/$2 USD) - 2016/03/23 15:19:02 CET [2016/03/23 10:19:02 ET]
Table 'Achaia' 9-max Seat #3 is the button
Seat 1: RamiroAgujis ($227.57 in chips) 
Seat 3: matiko09 ($212.16 in chips) 
Seat 4: erfk1958 ($93.78 in chips) 
Seat 5: chaps1988 ($419.41 in chips) 
Seat 8: IseeUcards ($453.71 in chips) 
Seat 9: PacPacBum ($203 in chips) 
erfk1958: posts small blind $1
chaps1988: posts big blind $2
nairolf24: sits out 
*** HOLE CARDS ***
Dealt to matiko09 [Qh Qd]
IseeUcards: folds 
PacPacBum: folds 
nairolf24 leaves the table
RamiroAgujis: folds 
matiko09: raises $2.54 to $4.54
erfk1958: calls $3.54
chaps1988: folds 
*** FLOP *** [5h 2h 7c]
erfk1958: checks 
matiko09: bets $6.88
erfk1958: calls $6.88
*** TURN *** [5h 2h 7c] [Ah]
erfk1958: checks 
matiko09: checks 
*** RIVER *** [5h 2h 7c Ah] [7s]
erfk1958: checks 
matiko09: checks 
*** SHOW DOWN ***
erfk1958: shows [Kd Kc] (two pair, Kings and Sevens)
matiko09: mucks hand 
erfk1958 collected $23.72 from pot
*** SUMMARY ***
Total pot $24.84 | Rake $1.12 
Board [5h 2h 7c Ah 7s]
Seat 1: RamiroAgujis folded before Flop (didn't bet)
Seat 3: matiko09 (button) mucked [Qh Qd]
Seat 4: erfk1958 (small blind) showed [Kd Kc] and won ($23.72) with two pair, Kings and Sevens
Seat 5: chaps1988 (big blind) folded before Flop
Seat 8: IseeUcards folded before Flop (didn't bet)
Seat 9: PacPacBum folded before Flop (didn't bet)





PokerStars Hand #150802865773:  Hold'em No Limit ($0.50/$1.00 USD) - 2016/03/23 15:19:09 CET [2016/03/23 10:19:09 ET]
Table 'Smiley' 9-max Seat #5 is the button
Seat 1: xHourglass ($109.44 in chips) 
Seat 2: Jimy Tiltman ($114.74 in chips) 
Seat 3: Robert201202 ($114.18 in chips) 
Seat 4: CAJUN890 ($97.69 in chips) 
Seat 5: Szevasztopol ($105.57 in chips) 
Seat 6: blackmont111 ($146.54 in chips) 
Seat 7: bennetb77 ($50 in chips) 
Seat 8: matiko09 ($106.30 in chips) 
blackmont111: posts small blind $0.50
bennetb77: posts big blind $1
PacPacBum: sits out 
*** HOLE CARDS ***
Dealt to matiko09 [4c 3h]
matiko09: folds 
xHourglass: folds 
Jimy Tiltman: folds 
Robert201202: raises $2 to $3
CAJUN890: folds 
Szevasztopol: raises $6 to $9
blackmont111: folds 
bennetb77: folds 
Robert201202: calls $6
*** FLOP *** [Qc 5d Qd]
Robert201202: checks 
Szevasztopol: bets $9.68
Robert201202: folds 
Uncalled bet ($9.68) returned to Szevasztopol
Szevasztopol collected $18.62 from pot
Szevasztopol: doesn't show hand 
*** SUMMARY ***
Total pot $19.50 | Rake $0.88 
Board [Qc 5d Qd]
Seat 1: xHourglass folded before Flop (didn't bet)
Seat 2: Jimy Tiltman folded before Flop (didn't bet)
Seat 3: Robert201202 folded on the Flop
Seat 4: CAJUN890 folded before Flop (didn't bet)
Seat 5: Szevasztopol (button) collected ($18.62)
Seat 6: blackmont111 (small blind) folded before Flop
Seat 7: bennetb77 (big blind) folded before Flop
Seat 8: matiko09 folded before Flop (didn't bet)





PokerStars Hand #150802869844:  Hold'em No Limit (€0.50/€1.00 EUR) - 2016/03/23 15:19:20 CET [2016/03/23 10:19:20 ET]
Table 'Mercury III' 9-max Seat #3 is the button
Seat 1: matiko09 (€116.08 in chips) 
Seat 2: jahwe (€100 in chips) 
Seat 3: PacPacBum (€100 in chips) 
Seat 4: Muinmyheart (€102 in chips) 
Seat 6: mycka86 (€103.89 in chips) 
Seat 7: STrakDD (€100 in chips) 
Seat 8: gfxed (€35.84 in chips) 
Seat 9: Indr3k (€100 in chips) 
Muinmyheart: posts small blind €0.50
DUkalisUA: is sitting out 
DUkalisUA leaves the table
mycka86: posts big blind €1
*** HOLE CARDS ***
Dealt to matiko09 [6h 3c]
ardo888 joins the table at seat #5 
STrakDD: folds 
gfxed: folds 
Indr3k: folds 
matiko09: folds 
jahwe: folds 
PacPacBum: folds 
Muinmyheart: raises €2 to €3
mycka86: calls €2
*** FLOP *** [Ts Jh 7s]
Muinmyheart: checks 
mycka86: checks 
*** TURN *** [Ts Jh 7s] [2d]
Muinmyheart: checks 
mycka86: bets €4.10
Muinmyheart: folds 
Uncalled bet (€4.10) returned to mycka86
mycka86 collected €5.73 from pot
*** SUMMARY ***
Total pot €6 | Rake €0.27 
Board [Ts Jh 7s 2d]
Seat 1: matiko09 folded before Flop (didn't bet)
Seat 2: jahwe folded before Flop (didn't bet)
Seat 3: PacPacBum (button) folded before Flop (didn't bet)
Seat 4: Muinmyheart (small blind) folded on the Turn
Seat 6: mycka86 (big blind) collected (€5.73)
Seat 7: STrakDD folded before Flop (didn't bet)
Seat 8: gfxed folded before Flop (didn't bet)
Seat 9: Indr3k folded before Flop (didn't bet)





PokerStars Hand #150802873356:  Hold'em No Limit ($1/$2 USD) - 2016/03/23 15:19:30 CET [2016/03/23 10:19:30 ET]
Table 'Clarissa II' 9-max Seat #5 is the button
Seat 2: Igoriah ($220.40 in chips) 
Seat 3: PtizaXXX ($161.39 in chips) 
Seat 4: sanrs57 ($192 in chips) 
Seat 5: Red4erT ($97.07 in chips) 
Seat 6: matiko09 ($214.61 in chips) 
Seat 7: PacPacBum ($200 in chips) 
Seat 8: chaps1988 ($208.32 in chips) 
Seat 9: RamiroAgujis ($200 in chips) 
matiko09: posts small blind $1
PacPacBum: posts big blind $2
IseeUcards: sits out 
*** HOLE CARDS ***
Dealt to matiko09 [Ad 6h]
chaps1988: folds 
RamiroAgujis: folds 
Igoriah is disconnected 
Igoriah has timed out while disconnected
Igoriah: folds 
PtizaXXX: raises $4 to $6
sanrs57: folds 
Red4erT: folds 
matiko09: folds 
PacPacBum: folds 
Uncalled bet ($4) returned to PtizaXXX
PtizaXXX collected $5 from pot
PtizaXXX: doesn't show hand 
*** SUMMARY ***
Total pot $5 | Rake $0 
Seat 2: Igoriah folded before Flop (didn't bet)
Seat 3: PtizaXXX collected ($5)
Seat 4: sanrs57 folded before Flop (didn't bet)
Seat 5: Red4erT (button) folded before Flop (didn't bet)
Seat 6: matiko09 (small blind) folded before Flop
Seat 7: PacPacBum (big blind) folded before Flop
Seat 8: chaps1988 folded before Flop (didn't bet)
Seat 9: RamiroAgujis folded before Flop (didn't bet)





PokerStars Hand #150802875820:  Hold'em No Limit ($1/$2 USD) - 2016/03/23 15:19:37 CET [2016/03/23 10:19:37 ET]
Table 'Kiess' 9-max Seat #6 is the button
Seat 1: Cirilico ($235.02 in chips) 
Seat 3: Red4erT ($112.04 in chips) 
Seat 6: matiko09 ($256.28 in chips) 
Seat 7: chaps1988 ($200 in chips) 
Seat 8: erfk1958 ($116.21 in chips) 
Seat 9: PacPacBum ($200 in chips) 
chaps1988: posts small blind $1
erfk1958: posts big blind $2
RamiroAgujis: sits out 
*** HOLE CARDS ***
Dealt to matiko09 [Ks 5s]
PacPacBum: folds 
Cirilico: folds 
Red4erT: folds 
matiko09: raises $2.54 to $4.54
chaps1988: folds 
erfk1958: folds 
Uncalled bet ($2.54) returned to matiko09
matiko09 collected $5 from pot
matiko09: doesn't show hand 
*** SUMMARY ***
Total pot $5 | Rake $0 
Seat 1: Cirilico folded before Flop (didn't bet)
Seat 3: Red4erT folded before Flop (didn't bet)
Seat 6: matiko09 (button) collected ($5)
Seat 7: chaps1988 (small blind) folded before Flop
Seat 8: erfk1958 (big blind) folded before Flop
Seat 9: PacPacBum folded before Flop (didn't bet)





PokerStars Hand #150802879533:  Hold'em No Limit ($1/$2 USD) - 2016/03/23 15:19:47 CET [2016/03/23 10:19:47 ET]
Table 'Achaia' 9-max Seat #4 is the button
Seat 1: RamiroAgujis ($227.57 in chips) 
Seat 3: matiko09 ($200.74 in chips) 
Seat 4: erfk1958 ($106.08 in chips) 
Seat 5: chaps1988 ($417.41 in chips) 
Seat 9: PacPacBum ($203 in chips) 
chaps1988: posts small blind $1
IseeUcards: is sitting out 
IseeUcards leaves the table
PacPacBum: posts big blind $2
*** HOLE CARDS ***
Dealt to matiko09 [Jc Ah]
RamiroAgujis: folds 
matiko09: raises $3 to $5
Flying_Lurri joins the table at seat #6 
erfk1958: folds 
chaps1988: folds 
PacPacBum: folds 
Uncalled bet ($3) returned to matiko09
matiko09 collected $5 from pot
matiko09: doesn't show hand 
*** SUMMARY ***
Total pot $5 | Rake $0 
Seat 1: RamiroAgujis folded before Flop (didn't bet)
Seat 3: matiko09 collected ($5)
Seat 4: erfk1958 (button) folded before Flop (didn't bet)
Seat 5: chaps1988 (small blind) folded before Flop
Seat 9: PacPacBum (big blind) folded before Flop





PokerStars Hand #150802880504:  Hold'em No Limit ($0.50/$1.00 USD) - 2016/03/23 15:19:50 CET [2016/03/23 10:19:50 ET]
Table 'Swings' 9-max Seat #6 is the button
Seat 1: lumen21 ($103 in chips) 
Seat 2: tomver0809 ($82.32 in chips) 
Seat 3: maxxmeister ($134.03 in chips) 
Seat 5: chautinhtri9 ($122.96 in chips) 
Seat 6: matiko09 ($143.42 in chips) 
Seat 7: PacPacBum ($108.72 in chips) 
Seat 8: RICKA16 ($98.96 in chips) 
Seat 9: Effort92 ($101.50 in chips) 
PacPacBum: posts small blind $0.50
RICKA16: posts big blind $1
YuriiSolodya: sits out 
*** HOLE CARDS ***
Dealt to matiko09 [5s Qh]
Effort92: folds 
lumen21: folds 
tomver0809: folds 
maxxmeister: folds 
chautinhtri9: folds 
matiko09: folds 
PacPacBum: folds 
Uncalled bet ($0.50) returned to RICKA16
RICKA16 collected $1 from pot
RICKA16: doesn't show hand 
*** SUMMARY ***
Total pot $1 | Rake $0 
Seat 1: lumen21 folded before Flop (didn't bet)
Seat 2: tomver0809 folded before Flop (didn't bet)
Seat 3: maxxmeister folded before Flop (didn't bet)
Seat 5: chautinhtri9 folded before Flop (didn't bet)
Seat 6: matiko09 (button) folded before Flop (didn't bet)
Seat 7: PacPacBum (small blind) folded before Flop
Seat 8: RICKA16 (big blind) collected ($1)
Seat 9: Effort92 folded before Flop (didn't bet)





PokerStars Hand #150802881558:  Hold'em No Limit ($0.50/$1.00 USD) - 2016/03/23 15:19:53 CET [2016/03/23 10:19:53 ET]
Table 'Drakonia II' 9-max Seat #3 is the button
Seat 1: chautinhtri9 ($127.60 in chips) 
Seat 2: carrsseis ($101.50 in chips) 
Seat 3: dunga119 ($159.65 in chips) 
Seat 4: lumen21 ($100 in chips) 
Seat 5: Muinmyheart ($100 in chips) 
Seat 6: Dantist1122 ($108.76 in chips) 
Seat 7: YuriiSolodya ($23.40 in chips) 
Seat 8: matiko09 ($100 in chips) 
Seat 9: mycka86 ($101.86 in chips) 
lumen21: posts small blind $0.50
Muinmyheart: posts big blind $1
*** HOLE CARDS ***
Dealt to matiko09 [7s Kh]
Dantist1122: folds 
YuriiSolodya: folds 
matiko09: folds 
mycka86: folds 
chautinhtri9: raises $1 to $2
carrsseis: folds 
dunga119: folds 
lumen21: folds 
Muinmyheart: folds 
Uncalled bet ($1) returned to chautinhtri9
chautinhtri9 collected $2.50 from pot
chautinhtri9: doesn't show hand 
*** SUMMARY ***
Total pot $2.50 | Rake $0 
Seat 1: chautinhtri9 collected ($2.50)
Seat 2: carrsseis folded before Flop (didn't bet)
Seat 3: dunga119 (button) folded before Flop (didn't bet)
Seat 4: lumen21 (small blind) folded before Flop
Seat 5: Muinmyheart (big blind) folded before Flop
Seat 6: Dantist1122 folded before Flop (didn't bet)
Seat 7: YuriiSolodya folded before Flop (didn't bet)
Seat 8: matiko09 folded before Flop (didn't bet)
Seat 9: mycka86 folded before Flop (didn't bet)





PokerStars Hand #150802883694:  Hold'em No Limit ($1/$2 USD) - 2016/03/23 15:19:59 CET [2016/03/23 10:19:59 ET]
Table 'Kiess' 9-max Seat #7 is the button
Seat 1: Cirilico ($235.02 in chips) 
Seat 3: Red4erT ($112.04 in chips) 
Seat 6: matiko09 ($259.28 in chips) 
Seat 7: chaps1988 ($200 in chips) 
Seat 8: erfk1958 ($114.21 in chips) 
Seat 9: PacPacBum ($200 in chips) 
erfk1958: posts small blind $1
PacPacBum: posts big blind $2
RamiroAgujis: sits out 
*** HOLE CARDS ***
Dealt to matiko09 [9s 8d]
Cirilico: folds 
Red4erT: folds 
matiko09: folds 
chaps1988: folds 
XKTTBOBV11 leaves the table
erfk1958: folds 
Uncalled bet ($1) returned to PacPacBum
IseeUcards joins the table at seat #2 
PacPacBum collected $2 from pot
PacPacBum: doesn't show hand 
*** SUMMARY ***
Total pot $2 | Rake $0 
Seat 1: Cirilico folded before Flop (didn't bet)
Seat 3: Red4erT folded before Flop (didn't bet)
Seat 6: matiko09 folded before Flop (didn't bet)
Seat 7: chaps1988 (button) folded before Flop (didn't bet)
Seat 8: erfk1958 (small blind) folded before Flop
Seat 9: PacPacBum (big blind) collected ($2)





PokerStars Hand #150802885782:  Hold'em No Limit ($0.50/$1.00 USD) - 2016/03/23 15:20:05 CET [2016/03/23 10:20:05 ET]
Table 'Asmodeus' 9-max Seat #8 is the button
Seat 1: Jimy Tiltman ($149.35 in chips) 
Seat 2: PacPacBum ($100 in chips) 
Seat 4: Effort92 ($104.14 in chips) 
Seat 5: Muinmyheart ($100 in chips) 
Seat 6: fuppeee ($93.11 in chips) 
Seat 7: mycka86 ($133.85 in chips) 
Seat 8: bonifacioppl ($51.65 in chips) 
Seat 9: matiko09 ($100 in chips) 
matiko09: posts small blind $0.50
Jimy Tiltman: posts big blind $1
jahwe: sits out 
Jimy Tiltman: posts the ante $0.20
PacPacBum: posts the ante $0.20
Effort92: posts the ante $0.20
Muinmyheart: posts the ante $0.20
fuppeee: posts the ante $0.20
mycka86: posts the ante $0.20
bonifacioppl: posts the ante $0.20
matiko09: posts the ante $0.20
*** HOLE CARDS ***
Dealt to matiko09 [2c Qs]
PacPacBum: folds 
Effort92: folds 
Muinmyheart: folds 
fuppeee: raises $1 to $2
mycka86: raises $5.50 to $7.50
bonifacioppl: raises $43.95 to $51.45 and is all-in
matiko09: folds 
Jimy Tiltman: folds 
fuppeee: folds 
mycka86: folds 
Uncalled bet ($43.95) returned to bonifacioppl
bonifacioppl collected $20.10 from pot
bonifacioppl: doesn't show hand 
*** SUMMARY ***
Total pot $20.10 | Rake $0 
Seat 1: Jimy Tiltman (big blind) folded before Flop
Seat 2: PacPacBum folded before Flop (didn't bet)
Seat 4: Effort92 folded before Flop (didn't bet)
Seat 5: Muinmyheart folded before Flop (didn't bet)
Seat 6: fuppeee folded before Flop
Seat 7: mycka86 folded before Flop
Seat 8: bonifacioppl (button) collected ($20.10)
Seat 9: matiko09 (small blind) folded before Flop





PokerStars Hand #150802887708:  Hold'em No Limit ($0.50/$1.00 USD) - 2016/03/23 15:20:10 CET [2016/03/23 10:20:10 ET]
Table 'Swings' 9-max Seat #7 is the button
Seat 1: lumen21 ($103 in chips) 
Seat 2: tomver0809 ($82.32 in chips) 
Seat 3: maxxmeister ($134.03 in chips) 
Seat 5: chautinhtri9 ($122.96 in chips) 
Seat 6: matiko09 ($143.42 in chips) 
Seat 7: PacPacBum ($108.22 in chips) 
Seat 8: RICKA16 ($100 in chips) 
Seat 9: Effort92 ($101.50 in chips) 
RICKA16: posts small blind $0.50
Effort92: posts big blind $1
YuriiSolodya: sits out 
*** HOLE CARDS ***
Dealt to matiko09 [Th Qs]
lumen21 has timed out
lumen21: folds 
tomver0809: folds 
maxxmeister: raises $2 to $3
chautinhtri9: folds 
matiko09: folds 
PacPacBum: folds 
RICKA16: folds 
Effort92: folds 
Uncalled bet ($2) returned to maxxmeister
maxxmeister collected $2.50 from pot
maxxmeister: doesn't show hand 
*** SUMMARY ***
Total pot $2.50 | Rake $0 
Seat 1: lumen21 folded before Flop (didn't bet)
Seat 2: tomver0809 folded before Flop (didn't bet)
Seat 3: maxxmeister collected ($2.50)
Seat 5: chautinhtri9 folded before Flop (didn't bet)
Seat 6: matiko09 folded before Flop (didn't bet)
Seat 7: PacPacBum (button) folded before Flop (didn't bet)
Seat 8: RICKA16 (small blind) folded before Flop
Seat 9: Effort92 (big blind) folded before Flop





PokerStars Hand #150802889528:  Hold'em No Limit ($1/$2 USD) - 2016/03/23 15:20:15 CET [2016/03/23 10:20:15 ET]
Table 'Kiess' 9-max Seat #8 is the button
Seat 1: Cirilico ($235.02 in chips) 
Seat 3: Red4erT ($112.04 in chips) 
Seat 6: matiko09 ($259.28 in chips) 
Seat 7: chaps1988 ($200 in chips) 
Seat 8: erfk1958 ($113.21 in chips) 
Seat 9: PacPacBum ($201 in chips) 
PacPacBum: posts small blind $1
Cirilico: posts big blind $2
IseeUcards: sits out 
RamiroAgujis: sits out 
*** HOLE CARDS ***
Dealt to matiko09 [Td Th]
Red4erT: folds 
IseeUcards leaves the table
matiko09: raises $3 to $5
chaps1988: folds 
erfk1958: folds 
PacPacBum: folds 
Cirilico: folds 
Uncalled bet ($3) returned to matiko09
matiko09 collected $5 from pot
matiko09: doesn't show hand 
*** SUMMARY ***
Total pot $5 | Rake $0 
Seat 1: Cirilico (big blind) folded before Flop
Seat 3: Red4erT folded before Flop (didn't bet)
Seat 6: matiko09 collected ($5)
Seat 7: chaps1988 folded before Flop (didn't bet)
Seat 8: erfk1958 (button) folded before Flop (didn't bet)
Seat 9: PacPacBum (small blind) folded before Flop





PokerStars Hand #150802890036:  Hold'em No Limit ($1/$2 USD) - 2016/03/23 15:20:16 CET [2016/03/23 10:20:16 ET]
Table 'Clarissa II' 9-max Seat #6 is the button
Seat 3: PtizaXXX ($164.39 in chips) 
Seat 4: sanrs57 ($192 in chips) 
Seat 5: Red4erT ($97.07 in chips) 
Seat 6: matiko09 ($213.61 in chips) 
Seat 7: PacPacBum ($200 in chips) 
Seat 8: chaps1988 ($208.32 in chips) 
Seat 9: RamiroAgujis ($200 in chips) 
PacPacBum: posts small blind $1
chaps1988: posts big blind $2
IseeUcards: sits out 
*** HOLE CARDS ***
Dealt to matiko09 [Jh 5s]
RamiroAgujis: folds 
PtizaXXX: calls $2
sanrs57: folds 
Red4erT: raises $4 to $6
matiko09: folds 
PacPacBum: folds 
chaps1988: folds 
PtizaXXX: calls $4
*** FLOP *** [Kh 5d 2h]
PtizaXXX: checks 
Red4erT: bets $7.44
PtizaXXX: folds 
Uncalled bet ($7.44) returned to Red4erT
Red4erT collected $14.32 from pot
Red4erT: doesn't show hand 
*** SUMMARY ***
Total pot $15 | Rake $0.68 
Board [Kh 5d 2h]
Seat 3: PtizaXXX folded on the Flop
Seat 4: sanrs57 folded before Flop (didn't bet)
Seat 5: Red4erT collected ($14.32)
Seat 6: matiko09 (button) folded before Flop (didn't bet)
Seat 7: PacPacBum (small blind) folded before Flop
Seat 8: chaps1988 (big blind) folded before Flop
Seat 9: RamiroAgujis folded before Flop (didn't bet)





PokerStars Hand #150802893640:  Hold'em No Limit ($0.50/$1.00 USD) - 2016/03/23 15:20:26 CET [2016/03/23 10:20:26 ET]
Table 'Smiley' 9-max Seat #6 is the button
Seat 1: xHourglass ($109.44 in chips) 
Seat 2: Jimy Tiltman ($114.74 in chips) 
Seat 3: Robert201202 ($105.18 in chips) 
Seat 4: CAJUN890 ($97.69 in chips) 
Seat 5: Szevasztopol ($115.19 in chips) 
Seat 6: blackmont111 ($146.04 in chips) 
Seat 7: bennetb77 ($49 in chips) 
Seat 8: matiko09 ($106.30 in chips) 
bennetb77: posts small blind $0.50
matiko09: posts big blind $1
PacPacBum: sits out 
*** HOLE CARDS ***
Dealt to matiko09 [Qd 5d]
xHourglass: folds 
Jimy Tiltman: folds 
Robert201202: raises $2 to $3
CAJUN890: folds 
Szevasztopol: folds 
blackmont111: folds 
bennetb77: folds 
matiko09: folds 
Uncalled bet ($2) returned to Robert201202
Robert201202 collected $2.50 from pot
*** SUMMARY ***
Total pot $2.50 | Rake $0 
Seat 1: xHourglass folded before Flop (didn't bet)
Seat 2: Jimy Tiltman folded before Flop (didn't bet)
Seat 3: Robert201202 collected ($2.50)
Seat 4: CAJUN890 folded before Flop (didn't bet)
Seat 5: Szevasztopol folded before Flop (didn't bet)
Seat 6: blackmont111 (button) folded before Flop (didn't bet)
Seat 7: bennetb77 (small blind) folded before Flop
Seat 8: matiko09 (big blind) folded before Flop





PokerStars Hand #150802896546:  Hold'em No Limit ($1/$2 USD) - 2016/03/23 15:20:34 CET [2016/03/23 10:20:34 ET]
Table 'Kiess' 9-max Seat #9 is the button
Seat 1: Cirilico ($233.02 in chips) 
Seat 3: Red4erT ($112.04 in chips) 
Seat 6: matiko09 ($262.28 in chips) 
Seat 7: chaps1988 ($200 in chips) 
Seat 8: erfk1958 ($113.21 in chips) 
Seat 9: PacPacBum ($200 in chips) 
Cirilico: posts small blind $1
Red4erT: posts big blind $2
RamiroAgujis: sits out 
*** HOLE CARDS ***
Dealt to matiko09 [2h 3c]
matiko09: folds 
chaps1988: folds 
erfk1958: raises $2 to $4
PacPacBum: folds 
Cirilico: folds 
Red4erT: calls $2
*** FLOP *** [Qd Ah Jd]
Red4erT: checks 
erfk1958: bets $6
Red4erT: calls $6
*** TURN *** [Qd Ah Jd] [8c]
Red4erT: checks 
erfk1958: bets $12
Red4erT: folds 
Uncalled bet ($12) returned to erfk1958
erfk1958 collected $20.06 from pot
erfk1958: doesn't show hand 
*** SUMMARY ***
Total pot $21 | Rake $0.94 
Board [Qd Ah Jd 8c]
Seat 1: Cirilico (small blind) folded before Flop
Seat 3: Red4erT (big blind) folded on the Turn
Seat 6: matiko09 folded before Flop (didn't bet)
Seat 7: chaps1988 folded before Flop (didn't bet)
Seat 8: erfk1958 collected ($20.06)
Seat 9: PacPacBum (button) folded before Flop (didn't bet)





PokerStars Hand #150802898371:  Hold'em No Limit (€0.50/€1.00 EUR) - 2016/03/23 15:20:40 CET [2016/03/23 10:20:40 ET]
Table 'Mercury III' 9-max Seat #4 is the button
Seat 1: matiko09 (€116.08 in chips) 
Seat 2: jahwe (€100 in chips) 
Seat 3: PacPacBum (€100 in chips) 
Seat 4: Muinmyheart (€100 in chips) 
Seat 6: mycka86 (€106.62 in chips) 
Seat 7: STrakDD (€100 in chips) 
Seat 8: gfxed (€35.84 in chips) 
Seat 9: Indr3k (€100 in chips) 
ardo888 will be allowed to play after the button
mycka86: posts small blind €0.50
STrakDD: posts big blind €1
*** HOLE CARDS ***
Dealt to matiko09 [Ks 7d]
gfxed: folds 
Indr3k: folds 
matiko09: folds 
jahwe: folds 
PacPacBum: folds 
Muinmyheart: raises €1.20 to €2.20
mycka86: raises €6.30 to €8.50
STrakDD: folds 
Muinmyheart: raises €10.50 to €19
mycka86: calls €10.50
*** FLOP *** [4c 2h 3s]
mycka86: checks 
Muinmyheart: bets €19
mycka86: folds 
Uncalled bet (€19) returned to Muinmyheart
Muinmyheart collected €37.24 from pot
Muinmyheart: doesn't show hand 
*** SUMMARY ***
Total pot €39 | Rake €1.76 
Board [4c 2h 3s]
Seat 1: matiko09 folded before Flop (didn't bet)
Seat 2: jahwe folded before Flop (didn't bet)
Seat 3: PacPacBum folded before Flop (didn't bet)
Seat 4: Muinmyheart (button) collected (€37.24)
Seat 6: mycka86 (small blind) folded on the Flop
Seat 7: STrakDD (big blind) folded before Flop
Seat 8: gfxed folded before Flop (didn't bet)
Seat 9: Indr3k folded before Flop (didn't bet)





PokerStars Hand #150802899608:  Hold'em No Limit ($0.50/$1.00 USD) - 2016/03/23 15:20:43 CET [2016/03/23 10:20:43 ET]
Table 'Drakonia II' 9-max Seat #4 is the button
Seat 1: chautinhtri9 ($129.10 in chips) 
Seat 2: carrsseis ($101.50 in chips) 
Seat 3: dunga119 ($159.65 in chips) 
Seat 4: lumen21 ($100 in chips) 
Seat 5: Muinmyheart ($100 in chips) 
Seat 6: Dantist1122 ($108.76 in chips) 
Seat 7: YuriiSolodya ($23.40 in chips) 
Seat 8: matiko09 ($100 in chips) 
Seat 9: mycka86 ($101.86 in chips) 
Muinmyheart: posts small blind $0.50
Dantist1122: posts big blind $1
*** HOLE CARDS ***
Dealt to matiko09 [5s 5h]
YuriiSolodya: folds 
matiko09: folds 
mycka86: folds 
chautinhtri9: folds 
carrsseis: folds 
dunga119: folds 
lumen21: raises $1.25 to $2.25
Muinmyheart: raises $6.25 to $8.50
Dantist1122: folds 
lumen21: folds 
Uncalled bet ($6.25) returned to Muinmyheart
Muinmyheart collected $5.50 from pot
Muinmyheart: doesn't show hand 
*** SUMMARY ***
Total pot $5.50 | Rake $0 
Seat 1: chautinhtri9 folded before Flop (didn't bet)
Seat 2: carrsseis folded before Flop (didn't bet)
Seat 3: dunga119 folded before Flop (didn't bet)
Seat 4: lumen21 (button) folded before Flop
Seat 5: Muinmyheart (small blind) collected ($5.50)
Seat 6: Dantist1122 (big blind) folded before Flop
Seat 7: YuriiSolodya folded before Flop (didn't bet)
Seat 8: matiko09 folded before Flop (didn't bet)
Seat 9: mycka86 folded before Flop (didn't bet)





PokerStars Hand #150802900463:  Hold'em No Limit ($0.50/$1.00 USD) - 2016/03/23 15:20:45 CET [2016/03/23 10:20:45 ET]
Table 'Asmodeus' 9-max Seat #9 is the button
Seat 1: Jimy Tiltman ($148.15 in chips) 
Seat 2: PacPacBum ($100 in chips) 
Seat 4: Effort92 ($103.94 in chips) 
Seat 5: Muinmyheart ($100 in chips) 
Seat 6: fuppeee ($90.91 in chips) 
Seat 7: mycka86 ($126.15 in chips) 
Seat 8: bonifacioppl ($64.05 in chips) 
Seat 9: matiko09 ($100 in chips) 
Jimy Tiltman: posts small blind $0.50
PacPacBum: posts big blind $1
jahwe: sits out 
Jimy Tiltman: posts the ante $0.20
PacPacBum: posts the ante $0.20
Effort92: posts the ante $0.20
Muinmyheart: posts the ante $0.20
fuppeee: posts the ante $0.20
mycka86: posts the ante $0.20
bonifacioppl: posts the ante $0.20
matiko09: posts the ante $0.20
*** HOLE CARDS ***
Dealt to matiko09 [8d 2s]
Effort92: folds 
Muinmyheart: raises $2.50 to $3.50
fuppeee: folds 
mycka86: folds 
bonifacioppl: folds 
matiko09: folds 
Jimy Tiltman: folds 
PacPacBum: calls $2.50
*** FLOP *** [8h Ks 6c]
PacPacBum: checks 
Muinmyheart: checks 
*** TURN *** [8h Ks 6c] [5d]
PacPacBum: checks 
Muinmyheart: checks 
*** RIVER *** [8h Ks 6c 5d] [Qh]
PacPacBum: checks 
Muinmyheart: checks 
*** SHOW DOWN ***
PacPacBum: shows [Jh Js] (a pair of Jacks)
Muinmyheart: mucks hand 
PacPacBum collected $8.69 from pot
*** SUMMARY ***
Total pot $9.10 | Rake $0.41 
Board [8h Ks 6c 5d Qh]
Seat 1: Jimy Tiltman (small blind) folded before Flop
Seat 2: PacPacBum (big blind) showed [Jh Js] and won ($8.69) with a pair of Jacks
Seat 4: Effort92 folded before Flop (didn't bet)
Seat 5: Muinmyheart mucked [As 4s]
Seat 6: fuppeee folded before Flop (didn't bet)
Seat 7: mycka86 folded before Flop (didn't bet)
Seat 8: bonifacioppl folded before Flop (didn't bet)
Seat 9: matiko09 (button) folded before Flop (didn't bet)





PokerStars Hand #150802902672:  Hold'em No Limit ($0.50/$1.00 USD) - 2016/03/23 15:20:51 CET [2016/03/23 10:20:51 ET]
Table 'Swings' 9-max Seat #8 is the button
Seat 1: lumen21 ($103 in chips) 
Seat 2: tomver0809 ($82.32 in chips) 
Seat 3: maxxmeister ($135.53 in chips) 
Seat 5: chautinhtri9 ($122.96 in chips) 
Seat 6: matiko09 ($143.42 in chips) 
Seat 7: PacPacBum ($108.22 in chips) 
Seat 8: RICKA16 ($99.50 in chips) 
Seat 9: Effort92 ($100.50 in chips) 
Effort92: posts small blind $0.50
lumen21: posts big blind $1
YuriiSolodya: sits out 
*** HOLE CARDS ***
Dealt to matiko09 [5s Ac]
tomver0809: calls $1
maxxmeister: folds 
chautinhtri9: folds 
matiko09: folds 
PacPacBum: folds 
RICKA16: folds 
Effort92: raises $2 to $3
lumen21: folds 
tomver0809: calls $2
*** FLOP *** [Qd 3c 2h]
Effort92: bets $3
tomver0809: folds 
Uncalled bet ($3) returned to Effort92
Effort92 collected $6.68 from pot
Effort92: doesn't show hand 
*** SUMMARY ***
Total pot $7 | Rake $0.32 
Board [Qd 3c 2h]
Seat 1: lumen21 (big blind) folded before Flop
Seat 2: tomver0809 folded on the Flop
Seat 3: maxxmeister folded before Flop (didn't bet)
Seat 5: chautinhtri9 folded before Flop (didn't bet)
Seat 6: matiko09 folded before Flop (didn't bet)
Seat 7: PacPacBum folded before Flop (didn't bet)
Seat 8: RICKA16 (button) folded before Flop (didn't bet)
Seat 9: Effort92 (small blind) collected ($6.68)





PokerStars Hand #150802902758:  Hold'em No Limit ($0.50/$1.00 USD) - 2016/03/23 15:20:52 CET [2016/03/23 10:20:52 ET]
Table 'Sylvia III' 9-max Seat #6 is the button
Seat 1: mycka86 ($144.50 in chips) 
Seat 2: Dantist1122 ($106 in chips) 
Seat 3: se7en_$tars ($114.84 in chips) 
Seat 4: lombardo11 ($58.22 in chips) 
Seat 5: matiko09 ($100 in chips) 
Seat 6: PacPacBum ($100 in chips) 
Seat 7: easytalk777 ($98.07 in chips) 
Seat 8: Muinmyheart ($100 in chips) 
Seat 9: Blanky-Bad ($86.88 in chips) 
easytalk777: posts small blind $0.50
Muinmyheart: posts big blind $1
mycka86: posts the ante $0.20
Dantist1122: posts the ante $0.20
se7en_$tars: posts the ante $0.20
lombardo11: posts the ante $0.20
matiko09: posts the ante $0.20
PacPacBum: posts the ante $0.20
easytalk777: posts the ante $0.20
Muinmyheart: posts the ante $0.20
Blanky-Bad: posts the ante $0.20
*** HOLE CARDS ***
Dealt to matiko09 [2h Ks]
Blanky-Bad: folds 
mycka86: folds 
Dantist1122: raises $2 to $3
se7en_$tars: folds 
lombardo11: folds 
matiko09: folds 
PacPacBum: folds 
easytalk777: folds 
Muinmyheart: folds 
Uncalled bet ($2) returned to Dantist1122
Dantist1122 collected $4.30 from pot
Dantist1122: doesn't show hand 
*** SUMMARY ***
Total pot $4.30 | Rake $0 
Seat 1: mycka86 folded before Flop (didn't bet)
Seat 2: Dantist1122 collected ($4.30)
Seat 3: se7en_$tars folded before Flop (didn't bet)
Seat 4: lombardo11 folded before Flop (didn't bet)
Seat 5: matiko09 folded before Flop (didn't bet)
Seat 6: PacPacBum (button) folded before Flop (didn't bet)
Seat 7: easytalk777 (small blind) folded before Flop
Seat 8: Muinmyheart (big blind) folded before Flop
Seat 9: Blanky-Bad folded before Flop (didn't bet)





PokerStars Hand #150802903287:  Hold'em No Limit ($0.50/$1.00 USD) - 2016/03/23 15:20:53 CET [2016/03/23 10:20:53 ET]
Table 'Smiley' 9-max Seat #7 is the button
Seat 1: xHourglass ($109.44 in chips) 
Seat 2: Jimy Tiltman ($114.74 in chips) 
Seat 3: Robert201202 ($106.68 in chips) 
Seat 4: CAJUN890 ($97.69 in chips) 
Seat 5: Szevasztopol ($115.19 in chips) 
Seat 6: blackmont111 ($146.04 in chips) 
Seat 7: bennetb77 ($48.50 in chips) 
Seat 8: matiko09 ($105.30 in chips) 
Seat 9: PacPacBum ($100 in chips) 
matiko09: posts small blind $0.50
PacPacBum: posts big blind $1
*** HOLE CARDS ***
Dealt to matiko09 [Qs Td]
xHourglass: folds 
Jimy Tiltman: raises $2 to $3
Robert201202: folds 
CAJUN890: folds 
Szevasztopol: folds 
blackmont111: folds 
bennetb77: folds 
matiko09: folds 
PacPacBum: folds 
Uncalled bet ($2) returned to Jimy Tiltman
Jimy Tiltman collected $2.50 from pot
Jimy Tiltman: doesn't show hand 
*** SUMMARY ***
Total pot $2.50 | Rake $0 
Seat 1: xHourglass folded before Flop (didn't bet)
Seat 2: Jimy Tiltman collected ($2.50)
Seat 3: Robert201202 folded before Flop (didn't bet)
Seat 4: CAJUN890 folded before Flop (didn't bet)
Seat 5: Szevasztopol folded before Flop (didn't bet)
Seat 6: blackmont111 folded before Flop (didn't bet)
Seat 7: bennetb77 (button) folded before Flop (didn't bet)
Seat 8: matiko09 (small blind) folded before Flop
Seat 9: PacPacBum (big blind) folded before Flop





PokerStars Hand #150802906459:  Hold'em No Limit ($1/$2 USD) - 2016/03/23 15:21:02 CET [2016/03/23 10:21:02 ET]
Table 'Clarissa II' 9-max Seat #7 is the button
Seat 3: PtizaXXX ($158.39 in chips) 
Seat 4: sanrs57 ($192 in chips) 
Seat 5: Red4erT ($105.39 in chips) 
Seat 6: matiko09 ($213.61 in chips) 
Seat 7: PacPacBum ($200 in chips) 
Seat 8: chaps1988 ($206.32 in chips) 
Seat 9: RamiroAgujis ($200 in chips) 
chaps1988: posts small blind $1
RamiroAgujis: posts big blind $2
IseeUcards: sits out 
*** HOLE CARDS ***
Dealt to matiko09 [Jd 5s]
PtizaXXX: folds 
sanrs57: raises $2 to $4
Red4erT: folds 
matiko09: folds 
PacPacBum: folds 
chaps1988: folds 
RamiroAgujis: folds 
Uncalled bet ($2) returned to sanrs57
sanrs57 collected $5 from pot
*** SUMMARY ***
Total pot $5 | Rake $0 
Seat 3: PtizaXXX folded before Flop (didn't bet)
Seat 4: sanrs57 collected ($5)
Seat 5: Red4erT folded before Flop (didn't bet)
Seat 6: matiko09 folded before Flop (didn't bet)
Seat 7: PacPacBum (button) folded before Flop (didn't bet)
Seat 8: chaps1988 (small blind) folded before Flop
Seat 9: RamiroAgujis (big blind) folded before Flop





PokerStars Hand #150802916080:  Hold'em No Limit ($0.50/$1.00 USD) - 2016/03/23 15:21:29 CET [2016/03/23 10:21:29 ET]
Table 'Swings' 9-max Seat #9 is the button
Seat 1: lumen21 ($102 in chips) 
Seat 2: tomver0809 ($79.32 in chips) 
Seat 3: maxxmeister ($135.53 in chips) 
Seat 5: chautinhtri9 ($122.96 in chips) 
Seat 6: matiko09 ($143.42 in chips) 
Seat 7: PacPacBum ($108.22 in chips) 
Seat 8: RICKA16 ($99.50 in chips) 
Seat 9: Effort92 ($104.18 in chips) 
lumen21: posts small blind $0.50
tomver0809: posts big blind $1
YuriiSolodya: sits out 
*** HOLE CARDS ***
Dealt to matiko09 [As Ts]
maxxmeister is disconnected 
maxxmeister has timed out while disconnected
maxxmeister: folds 
chautinhtri9: folds 
matiko09: raises $2 to $3
PacPacBum: folds 
RICKA16: raises $7 to $10
Effort92: folds 
lumen21: folds 
tomver0809: folds 
matiko09: folds 
Uncalled bet ($7) returned to RICKA16
RICKA16 collected $7.50 from pot
RICKA16: doesn't show hand 
*** SUMMARY ***
Total pot $7.50 | Rake $0 
Seat 1: lumen21 (small blind) folded before Flop
Seat 2: tomver0809 (big blind) folded before Flop
Seat 3: maxxmeister folded before Flop (didn't bet)
Seat 5: chautinhtri9 folded before Flop (didn't bet)
Seat 6: matiko09 folded before Flop
Seat 7: PacPacBum folded before Flop (didn't bet)
Seat 8: RICKA16 collected ($7.50)
Seat 9: Effort92 (button) folded before Flop (didn't bet)





PokerStars Hand #150802916296:  Hold'em No Limit ($0.50/$1.00 USD) - 2016/03/23 15:21:30 CET [2016/03/23 10:21:30 ET]
Table 'Smiley' 9-max Seat #8 is the button
Seat 1: xHourglass ($109.44 in chips) 
Seat 2: Jimy Tiltman ($116.24 in chips) 
Seat 3: Robert201202 ($106.68 in chips) 
Seat 4: CAJUN890 ($97.69 in chips) 
Seat 5: Szevasztopol ($115.19 in chips) 
Seat 6: blackmont111 ($146.04 in chips) 
Seat 7: bennetb77 ($48.50 in chips) 
Seat 8: matiko09 ($104.80 in chips) 
Seat 9: PacPacBum ($100 in chips) 
PacPacBum: posts small blind $0.50
xHourglass: posts big blind $1
*** HOLE CARDS ***
Dealt to matiko09 [Ad 9c]
Jimy Tiltman: folds 
Robert201202: raises $2 to $3
CAJUN890: folds 
Szevasztopol: folds 
blackmont111: folds 
bennetb77: folds 
matiko09: folds 
PacPacBum: folds 
xHourglass: folds 
Uncalled bet ($2) returned to Robert201202
Robert201202 collected $2.50 from pot
Robert201202: doesn't show hand 
*** SUMMARY ***
Total pot $2.50 | Rake $0 
Seat 1: xHourglass (big blind) folded before Flop
Seat 2: Jimy Tiltman folded before Flop (didn't bet)
Seat 3: Robert201202 collected ($2.50)
Seat 4: CAJUN890 folded before Flop (didn't bet)
Seat 5: Szevasztopol folded before Flop (didn't bet)
Seat 6: blackmont111 folded before Flop (didn't bet)
Seat 7: bennetb77 folded before Flop (didn't bet)
Seat 8: matiko09 (button) folded before Flop (didn't bet)
Seat 9: PacPacBum (small blind) folded before Flop





PokerStars Hand #150802916811:  Hold'em No Limit ($1/$2 USD) - 2016/03/23 15:21:31 CET [2016/03/23 10:21:31 ET]
Table 'Kiess' 9-max Seat #1 is the button
Seat 1: Cirilico ($232.02 in chips) 
Seat 3: Red4erT ($102.04 in chips) 
Seat 4: RamiroAgujis ($200 in chips) 
Seat 6: matiko09 ($262.28 in chips) 
Seat 7: chaps1988 ($200 in chips) 
Seat 8: erfk1958 ($123.27 in chips) 
Seat 9: PacPacBum ($200 in chips) 
Red4erT: posts small blind $1
RamiroAgujis: posts big blind $2
*** HOLE CARDS ***
Dealt to matiko09 [5d 7s]
matiko09: folds 
chaps1988: folds 
erfk1958: folds 
PacPacBum: raises $2.08 to $4.08
Cirilico: folds 
Red4erT: folds 
RamiroAgujis: folds 
Uncalled bet ($2.08) returned to PacPacBum
PacPacBum collected $5 from pot
PacPacBum: doesn't show hand 
*** SUMMARY ***
Total pot $5 | Rake $0 
Seat 1: Cirilico (button) folded before Flop (didn't bet)
Seat 3: Red4erT (small blind) folded before Flop
Seat 4: RamiroAgujis (big blind) folded before Flop
Seat 6: matiko09 folded before Flop (didn't bet)
Seat 7: chaps1988 folded before Flop (didn't bet)
Seat 8: erfk1958 folded before Flop (didn't bet)
Seat 9: PacPacBum collected ($5)





PokerStars Hand #150802916939:  Hold'em No Limit ($0.50/$1.00 USD) - 2016/03/23 15:21:32 CET [2016/03/23 10:21:32 ET]
Table 'Sylvia III' 9-max Seat #7 is the button
Seat 1: mycka86 ($144.30 in chips) 
Seat 2: Dantist1122 ($109.10 in chips) 
Seat 3: se7en_$tars ($114.64 in chips) 
Seat 4: lombardo11 ($58.02 in chips) 
Seat 5: matiko09 ($100 in chips) 
Seat 6: PacPacBum ($100 in chips) 
Seat 7: easytalk777 ($97.37 in chips) 
Seat 8: Muinmyheart ($100 in chips) 
Seat 9: Blanky-Bad ($86.68 in chips) 
Muinmyheart: posts small blind $0.50
Blanky-Bad: posts big blind $1
mycka86: posts the ante $0.20
Dantist1122: posts the ante $0.20
se7en_$tars: posts the ante $0.20
lombardo11: posts the ante $0.20
matiko09: posts the ante $0.20
PacPacBum: posts the ante $0.20
easytalk777: posts the ante $0.20
Muinmyheart: posts the ante $0.20
Blanky-Bad: posts the ante $0.20
*** HOLE CARDS ***
Dealt to matiko09 [3s 6d]
mycka86: folds 
Dantist1122: folds 
se7en_$tars: raises $4.30 to $5.30
lombardo11: folds 
matiko09: folds 
PacPacBum: folds 
easytalk777: folds 
Muinmyheart: folds 
Blanky-Bad: folds 
Uncalled bet ($4.30) returned to se7en_$tars
se7en_$tars collected $4.30 from pot
se7en_$tars: doesn't show hand 
*** SUMMARY ***
Total pot $4.30 | Rake $0 
Seat 1: mycka86 folded before Flop (didn't bet)
Seat 2: Dantist1122 folded before Flop (didn't bet)
Seat 3: se7en_$tars collected ($4.30)
Seat 4: lombardo11 folded before Flop (didn't bet)
Seat 5: matiko09 folded before Flop (didn't bet)
Seat 6: PacPacBum folded before Flop (didn't bet)
Seat 7: easytalk777 (button) folded before Flop (didn't bet)
Seat 8: Muinmyheart (small blind) folded before Flop
Seat 9: Blanky-Bad (big blind) folded before Flop





PokerStars Hand #150802917458:  Hold'em No Limit ($0.50/$1.00 USD) - 2016/03/23 15:21:33 CET [2016/03/23 10:21:33 ET]
Table 'Drakonia II' 9-max Seat #5 is the button
Seat 1: chautinhtri9 ($129.10 in chips) 
Seat 2: carrsseis ($101.50 in chips) 
Seat 3: dunga119 ($159.65 in chips) 
Seat 4: lumen21 ($100 in chips) 
Seat 5: Muinmyheart ($103.25 in chips) 
Seat 6: Dantist1122 ($107.76 in chips) 
Seat 7: YuriiSolodya ($23.40 in chips) 
Seat 8: matiko09 ($100 in chips) 
Seat 9: mycka86 ($101.86 in chips) 
Dantist1122: posts small blind $0.50
YuriiSolodya: posts big blind $1
*** HOLE CARDS ***
Dealt to matiko09 [Kd Ts]
matiko09: folds 
mycka86: folds 
chautinhtri9: folds 
carrsseis: folds 
dunga119: folds 
lumen21: folds 
Muinmyheart: folds 
Dantist1122: raises $1.05 to $2.05
YuriiSolodya: folds 
Uncalled bet ($1.05) returned to Dantist1122
Dantist1122 collected $2 from pot
Dantist1122: doesn't show hand 
*** SUMMARY ***
Total pot $2 | Rake $0 
Seat 1: chautinhtri9 folded before Flop (didn't bet)
Seat 2: carrsseis folded before Flop (didn't bet)
Seat 3: dunga119 folded before Flop (didn't bet)
Seat 4: lumen21 folded before Flop (didn't bet)
Seat 5: Muinmyheart (button) folded before Flop (didn't bet)
Seat 6: Dantist1122 (small blind) collected ($2)
Seat 7: YuriiSolodya (big blind) folded before Flop
Seat 8: matiko09 folded before Flop (didn't bet)
Seat 9: mycka86 folded before Flop (didn't bet)





PokerStars Hand #150802917748:  Hold'em No Limit ($1/$2 USD) - 2016/03/23 15:21:34 CET [2016/03/23 10:21:34 ET]
Table 'Clarissa II' 9-max Seat #8 is the button
Seat 1: IseeUcards ($200 in chips) 
Seat 2: Igoriah ($220.40 in chips) 
Seat 3: PtizaXXX ($158.39 in chips) 
Seat 4: sanrs57 ($195 in chips) 
Seat 5: Red4erT ($105.39 in chips) 
Seat 6: matiko09 ($213.61 in chips) 
Seat 7: PacPacBum ($200 in chips) 
Seat 8: chaps1988 ($205.32 in chips) 
Seat 9: RamiroAgujis ($200 in chips) 
RamiroAgujis: posts small blind $1
IseeUcards: posts big blind $2
*** HOLE CARDS ***
Dealt to matiko09 [4h 7c]
Igoriah: folds 
PtizaXXX: raises $4 to $6
sanrs57: folds 
Red4erT: folds 
matiko09: folds 
PacPacBum: calls $6
chaps1988: calls $6
RamiroAgujis: folds 
IseeUcards: calls $4
*** FLOP *** [Kh 5s Kc]
IseeUcards: checks 
PtizaXXX: checks 
PacPacBum: checks 
chaps1988: checks 
*** TURN *** [Kh 5s Kc] [Js]
IseeUcards: bets $16
PtizaXXX: folds 
PacPacBum: folds 
chaps1988: folds 
Uncalled bet ($16) returned to IseeUcards
IseeUcards collected $23.88 from pot
IseeUcards: doesn't show hand 
*** SUMMARY ***
Total pot $25 | Rake $1.12 
Board [Kh 5s Kc Js]
Seat 1: IseeUcards (big blind) collected ($23.88)
Seat 2: Igoriah folded before Flop (didn't bet)
Seat 3: PtizaXXX folded on the Turn
Seat 4: sanrs57 folded before Flop (didn't bet)
Seat 5: Red4erT folded before Flop (didn't bet)
Seat 6: matiko09 folded before Flop (didn't bet)
Seat 7: PacPacBum folded on the Turn
Seat 8: chaps1988 (button) folded on the Turn
Seat 9: RamiroAgujis (small blind) folded before Flop





PokerStars Hand #150802924038:  Hold'em No Limit ($1/$2 USD) - 2016/03/23 15:21:52 CET [2016/03/23 10:21:52 ET]
Table 'Kiess' 9-max Seat #3 is the button
Seat 1: Cirilico ($232.02 in chips) 
Seat 3: Red4erT ($101.04 in chips) 
Seat 4: RamiroAgujis ($200 in chips) 
Seat 6: matiko09 ($262.28 in chips) 
Seat 7: chaps1988 ($200 in chips) 
Seat 8: erfk1958 ($123.27 in chips) 
Seat 9: PacPacBum ($203 in chips) 
RamiroAgujis: posts small blind $1
matiko09: posts big blind $2
*** HOLE CARDS ***
Dealt to matiko09 [Ts 4h]
chaps1988: folds 
erfk1958: folds 
PacPacBum: folds 
Cirilico: folds 
Red4erT: folds 
RamiroAgujis: raises $3 to $5
matiko09: folds 
Uncalled bet ($3) returned to RamiroAgujis
RamiroAgujis collected $4 from pot
RamiroAgujis: doesn't show hand 
*** SUMMARY ***
Total pot $4 | Rake $0 
Seat 1: Cirilico folded before Flop (didn't bet)
Seat 3: Red4erT (button) folded before Flop (didn't bet)
Seat 4: RamiroAgujis (small blind) collected ($4)
Seat 6: matiko09 (big blind) folded before Flop
Seat 7: chaps1988 folded before Flop (didn't bet)
Seat 8: erfk1958 folded before Flop (didn't bet)
Seat 9: PacPacBum folded before Flop (didn't bet)





PokerStars Hand #150802928021:  Hold'em No Limit ($0.50/$1.00 USD) - 2016/03/23 15:22:03 CET [2016/03/23 10:22:03 ET]
Table 'Sylvia III' 9-max Seat #8 is the button
Seat 1: mycka86 ($144.10 in chips) 
Seat 2: Dantist1122 ($108.90 in chips) 
Seat 3: se7en_$tars ($117.74 in chips) 
Seat 4: lombardo11 ($57.82 in chips) 
Seat 5: matiko09 ($100 in chips) 
Seat 6: PacPacBum ($100 in chips) 
Seat 7: easytalk777 ($97.17 in chips) 
Seat 8: Muinmyheart ($100 in chips) 
Seat 9: Blanky-Bad ($85.48 in chips) 
Blanky-Bad: posts small blind $0.50
mycka86: posts big blind $1
mycka86: posts the ante $0.20
Dantist1122: posts the ante $0.20
se7en_$tars: posts the ante $0.20
lombardo11: posts the ante $0.20
matiko09: posts the ante $0.20
PacPacBum: posts the ante $0.20
easytalk777: posts the ante $0.20
Muinmyheart: posts the ante $0.20
Blanky-Bad: posts the ante $0.20
*** HOLE CARDS ***
Dealt to matiko09 [7d 9s]
Dantist1122: folds 
se7en_$tars: folds 
lombardo11: raises $2 to $3
matiko09: folds 
PacPacBum: folds 
easytalk777: folds 
Muinmyheart: folds 
Blanky-Bad: folds 
mycka86: folds 
Uncalled bet ($2) returned to lombardo11
lombardo11 collected $4.30 from pot
lombardo11: doesn't show hand 
*** SUMMARY ***
Total pot $4.30 | Rake $0 
Seat 1: mycka86 (big blind) folded before Flop
Seat 2: Dantist1122 folded before Flop (didn't bet)
Seat 3: se7en_$tars folded before Flop (didn't bet)
Seat 4: lombardo11 collected ($4.30)
Seat 5: matiko09 folded before Flop (didn't bet)
Seat 6: PacPacBum folded before Flop (didn't bet)
Seat 7: easytalk777 folded before Flop (didn't bet)
Seat 8: Muinmyheart (button) folded before Flop (didn't bet)
Seat 9: Blanky-Bad (small blind) folded before Flop





PokerStars Hand #150802927870:  Hold'em No Limit ($0.50/$1.00 USD) - 2016/03/23 15:22:03 CET [2016/03/23 10:22:03 ET]
Table 'Drakonia II' 9-max Seat #6 is the button
Seat 1: chautinhtri9 ($129.10 in chips) 
Seat 2: carrsseis ($101.50 in chips) 
Seat 3: dunga119 ($159.65 in chips) 
Seat 4: lumen21 ($100 in chips) 
Seat 5: Muinmyheart ($103.25 in chips) 
Seat 6: Dantist1122 ($108.76 in chips) 
Seat 7: YuriiSolodya ($22.40 in chips) 
Seat 8: matiko09 ($100 in chips) 
Seat 9: mycka86 ($101.86 in chips) 
YuriiSolodya: posts small blind $0.50
matiko09: posts big blind $1
*** HOLE CARDS ***
Dealt to matiko09 [Kh 4d]
mycka86: folds 
chautinhtri9: folds 
carrsseis: folds 
dunga119: calls $1
lumen21: folds 
Muinmyheart: folds 
Dantist1122: folds 
YuriiSolodya: raises $3 to $4
matiko09: folds 
dunga119: calls $3
*** FLOP *** [5d 4s 3d]
YuriiSolodya: bets $1
dunga119: raises $10.60 to $11.60
YuriiSolodya: raises $6.80 to $18.40 and is all-in
dunga119: calls $6.80
*** TURN *** [5d 4s 3d] [Th]
*** RIVER *** [5d 4s 3d Th] [Qh]
*** SHOW DOWN ***
YuriiSolodya: shows [Ac 2c] (a straight, Ace to Five)
dunga119: mucks hand 
YuriiSolodya collected $43.74 from pot
*** SUMMARY ***
Total pot $45.80 | Rake $2.06 
Board [5d 4s 3d Th Qh]
Seat 1: chautinhtri9 folded before Flop (didn't bet)
Seat 2: carrsseis folded before Flop (didn't bet)
Seat 3: dunga119 mucked [9d 7h]
Seat 4: lumen21 folded before Flop (didn't bet)
Seat 5: Muinmyheart folded before Flop (didn't bet)
Seat 6: Dantist1122 (button) folded before Flop (didn't bet)
Seat 7: YuriiSolodya (small blind) showed [Ac 2c] and won ($43.74) with a straight, Ace to Five
Seat 8: matiko09 (big blind) folded before Flop
Seat 9: mycka86 folded before Flop (didn't bet)





PokerStars Hand #150802928599:  Hold'em No Limit ($0.50/$1.00 USD) - 2016/03/23 15:22:05 CET [2016/03/23 10:22:05 ET]
Table 'Smiley' 9-max Seat #9 is the button
Seat 1: xHourglass ($108.44 in chips) 
Seat 2: Jimy Tiltman ($116.24 in chips) 
Seat 3: Robert201202 ($108.18 in chips) 
Seat 4: CAJUN890 ($97.69 in chips) 
Seat 5: Szevasztopol ($115.19 in chips) 
Seat 6: blackmont111 ($146.04 in chips) 
Seat 7: bennetb77 ($48.50 in chips) 
Seat 8: matiko09 ($104.80 in chips) 
Seat 9: PacPacBum ($100 in chips) 
xHourglass: posts small blind $0.50
Jimy Tiltman: posts big blind $1
*** HOLE CARDS ***
Dealt to matiko09 [4h 8d]
Robert201202: folds 
CAJUN890: folds 
Szevasztopol: folds 
blackmont111: folds 
bennetb77: folds 
matiko09: folds 
PacPacBum: folds 
xHourglass: folds 
Uncalled bet ($0.50) returned to Jimy Tiltman
Jimy Tiltman collected $1 from pot
Jimy Tiltman: doesn't show hand 
*** SUMMARY ***
Total pot $1 | Rake $0 
Seat 1: xHourglass (small blind) folded before Flop
Seat 2: Jimy Tiltman (big blind) collected ($1)
Seat 3: Robert201202 folded before Flop (didn't bet)
Seat 4: CAJUN890 folded before Flop (didn't bet)
Seat 5: Szevasztopol folded before Flop (didn't bet)
Seat 6: blackmont111 folded before Flop (didn't bet)
Seat 7: bennetb77 folded before Flop (didn't bet)
Seat 8: matiko09 folded before Flop (didn't bet)
Seat 9: PacPacBum (button) folded before Flop (didn't bet)





PokerStars Hand #150802932504:  Hold'em No Limit ($1/$2 USD) - 2016/03/23 15:22:16 CET [2016/03/23 10:22:16 ET]
Table 'Kiess' 9-max Seat #4 is the button
Seat 1: Cirilico ($232.02 in chips) 
Seat 3: Red4erT ($101.04 in chips) 
Seat 4: RamiroAgujis ($202 in chips) 
Seat 6: matiko09 ($260.28 in chips) 
Seat 7: chaps1988 ($200 in chips) 
Seat 8: erfk1958 ($123.27 in chips) 
Seat 9: PacPacBum ($203 in chips) 
matiko09: posts small blind $1
chaps1988: posts big blind $2
*** HOLE CARDS ***
Dealt to matiko09 [Kc 6c]
erfk1958: folds 
PacPacBum: folds 
Cirilico: raises $4 to $6
Red4erT: folds 
jahwe joins the table at seat #2 
RamiroAgujis: raises $13 to $19
matiko09: folds 
chaps1988: folds 
Cirilico: calls $13
*** FLOP *** [Th Tc Kd]
Cirilico: checks 
RamiroAgujis: bets $13
Cirilico: calls $13
*** TURN *** [Th Tc Kd] [As]
Cirilico: checks 
RamiroAgujis: checks 
*** RIVER *** [Th Tc Kd As] [8s]
Cirilico: checks 
RamiroAgujis: checks 
*** SHOW DOWN ***
Cirilico: shows [Ad Jd] (two pair, Aces and Tens)
RamiroAgujis: mucks hand 
Cirilico collected $64.20 from pot
*** SUMMARY ***
Total pot $67 | Rake $2.80 
Board [Th Tc Kd As 8s]
Seat 1: Cirilico showed [Ad Jd] and won ($64.20) with two pair, Aces and Tens
Seat 3: Red4erT folded before Flop (didn't bet)
Seat 4: RamiroAgujis (button) mucked [9h 7h]
Seat 6: matiko09 (small blind) folded before Flop
Seat 7: chaps1988 (big blind) folded before Flop
Seat 8: erfk1958 folded before Flop (didn't bet)
Seat 9: PacPacBum folded before Flop (didn't bet)





PokerStars Hand #150802933414:  Hold'em No Limit ($0.50/$1.00 USD) - 2016/03/23 15:22:18 CET [2016/03/23 10:22:18 ET]
Table 'Asmodeus' 9-max Seat #1 is the button
Seat 1: Jimy Tiltman ($147.45 in chips) 
Seat 2: PacPacBum ($104.99 in chips) 
Seat 3: jahwe ($100 in chips) 
Seat 4: Effort92 ($103.74 in chips) 
Seat 5: Muinmyheart ($100 in chips) 
Seat 6: fuppeee ($90.71 in chips) 
Seat 7: mycka86 ($125.95 in chips) 
Seat 8: bonifacioppl ($63.85 in chips) 
Seat 9: matiko09 ($100 in chips) 
PacPacBum: posts small blind $0.50
jahwe: posts big blind $1
Jimy Tiltman: posts the ante $0.20
PacPacBum: posts the ante $0.20
jahwe: posts the ante $0.20
Effort92: posts the ante $0.20
Muinmyheart: posts the ante $0.20
fuppeee: posts the ante $0.20
mycka86: posts the ante $0.20
bonifacioppl: posts the ante $0.20
matiko09: posts the ante $0.20
*** HOLE CARDS ***
Dealt to matiko09 [3s 8c]
Effort92: folds 
Muinmyheart: folds 
fuppeee: raises $1 to $2
mycka86: folds 
bonifacioppl: calls $2
matiko09: folds 
Jimy Tiltman: folds 
PacPacBum: folds 
jahwe: folds 
*** FLOP *** [8d 9h 4d]
fuppeee: checks 
bonifacioppl: checks 
*** TURN *** [8d 9h 4d] [9d]
fuppeee: checks 
bonifacioppl: bets $3.90
fuppeee: calls $3.90
*** RIVER *** [8d 9h 4d 9d] [7c]
fuppeee: checks 
bonifacioppl: bets $11
fuppeee: folds 
Uncalled bet ($11) returned to bonifacioppl
bonifacioppl collected $14.42 from pot
bonifacioppl: doesn't show hand 
*** SUMMARY ***
Total pot $15.10 | Rake $0.68 
Board [8d 9h 4d 9d 7c]
Seat 1: Jimy Tiltman (button) folded before Flop (didn't bet)
Seat 2: PacPacBum (small blind) folded before Flop
Seat 3: jahwe (big blind) folded before Flop
Seat 4: Effort92 folded before Flop (didn't bet)
Seat 5: Muinmyheart folded before Flop (didn't bet)
Seat 6: fuppeee folded on the River
Seat 7: mycka86 folded before Flop (didn't bet)
Seat 8: bonifacioppl collected ($14.42)
Seat 9: matiko09 folded before Flop (didn't bet)





PokerStars Hand #150802935669:  Hold'em No Limit ($0.50/$1.00 USD) - 2016/03/23 15:22:24 CET [2016/03/23 10:22:24 ET]
Table 'Sylvia III' 9-max Seat #9 is the button
Seat 1: mycka86 ($142.90 in chips) 
Seat 2: Dantist1122 ($108.70 in chips) 
Seat 3: se7en_$tars ($117.54 in chips) 
Seat 4: lombardo11 ($60.92 in chips) 
Seat 5: matiko09 ($100 in chips) 
Seat 6: PacPacBum ($100 in chips) 
Seat 7: easytalk777 ($96.97 in chips) 
Seat 8: Muinmyheart ($100 in chips) 
Seat 9: Blanky-Bad ($84.78 in chips) 
mycka86: posts small blind $0.50
Dantist1122: posts big blind $1
mycka86: posts the ante $0.20
Dantist1122: posts the ante $0.20
se7en_$tars: posts the ante $0.20
lombardo11: posts the ante $0.20
matiko09: posts the ante $0.20
PacPacBum: posts the ante $0.20
easytalk777: posts the ante $0.20
Muinmyheart: posts the ante $0.20
Blanky-Bad: posts the ante $0.20
*** HOLE CARDS ***
Dealt to matiko09 [Ts 8h]
se7en_$tars: raises $2 to $3
lombardo11: calls $3
matiko09: folds 
PacPacBum: folds 
easytalk777: folds 
Muinmyheart: calls $3
Blanky-Bad: raises $15.30 to $18.30
mycka86: folds 
Dantist1122: folds 
se7en_$tars: calls $15.30
lombardo11: calls $15.30
Muinmyheart: folds 
*** FLOP *** [7s 2s Jd]
se7en_$tars: bets $58
lombardo11: folds 
Blanky-Bad: raises $8.28 to $66.28 and is all-in
se7en_$tars: calls $8.28
*** TURN *** [7s 2s Jd] [7h]
*** RIVER *** [7s 2s Jd 7h] [5c]
*** SHOW DOWN ***
se7en_$tars: shows [8d 8s] (two pair, Eights and Sevens)
Blanky-Bad: shows [Ac Qd] (a pair of Sevens)
se7en_$tars collected $190.96 from pot
*** SUMMARY ***
Total pot $193.76 | Rake $2.80 
Board [7s 2s Jd 7h 5c]
Seat 1: mycka86 (small blind) folded before Flop
Seat 2: Dantist1122 (big blind) folded before Flop
Seat 3: se7en_$tars showed [8d 8s] and won ($190.96) with two pair, Eights and Sevens
Seat 4: lombardo11 folded on the Flop
Seat 5: matiko09 folded before Flop (didn't bet)
Seat 6: PacPacBum folded before Flop (didn't bet)
Seat 7: easytalk777 folded before Flop (didn't bet)
Seat 8: Muinmyheart folded before Flop
Seat 9: Blanky-Bad (button) showed [Ac Qd] and lost with a pair of Sevens





PokerStars Hand #150802936857:  Hold'em No Limit ($0.50/$1.00 USD) - 2016/03/23 15:22:28 CET [2016/03/23 10:22:28 ET]
Table 'Smiley' 9-max Seat #1 is the button
Seat 1: xHourglass ($107.94 in chips) 
Seat 2: Jimy Tiltman ($116.74 in chips) 
Seat 3: Robert201202 ($108.18 in chips) 
Seat 4: CAJUN890 ($97.69 in chips) 
Seat 5: Szevasztopol ($115.19 in chips) 
Seat 6: blackmont111 ($146.04 in chips) 
Seat 7: bennetb77 ($48.50 in chips) 
Seat 8: matiko09 ($104.80 in chips) 
Seat 9: PacPacBum ($100 in chips) 
Jimy Tiltman: posts small blind $0.50
Robert201202: posts big blind $1
*** HOLE CARDS ***
Dealt to matiko09 [3h 9s]
CAJUN890: calls $1
Szevasztopol: raises $3 to $4
blackmont111: folds 
bennetb77: folds 
matiko09: folds 
PacPacBum: folds 
xHourglass: calls $4
Jimy Tiltman: folds 
Robert201202: folds 
CAJUN890: calls $3
*** FLOP *** [8c 5c Ah]
CAJUN890: checks 
Szevasztopol: bets $8
xHourglass: calls $8
CAJUN890: folds 
*** TURN *** [8c 5c Ah] [4c]
Szevasztopol: checks 
xHourglass: bets $21.50
Szevasztopol: calls $21.50
*** RIVER *** [8c 5c Ah 4c] [8d]
Szevasztopol: checks 
xHourglass: checks 
*** SHOW DOWN ***
Szevasztopol: shows [Ks Ad] (two pair, Aces and Eights)
xHourglass: mucks hand 
Szevasztopol collected $69.70 from pot
*** SUMMARY ***
Total pot $72.50 | Rake $2.80 
Board [8c 5c Ah 4c 8d]
Seat 1: xHourglass (button) mucked [Jc As]
Seat 2: Jimy Tiltman (small blind) folded before Flop
Seat 3: Robert201202 (big blind) folded before Flop
Seat 4: CAJUN890 folded on the Flop
Seat 5: Szevasztopol showed [Ks Ad] and won ($69.70) with two pair, Aces and Eights
Seat 6: blackmont111 folded before Flop (didn't bet)
Seat 7: bennetb77 folded before Flop (didn't bet)
Seat 8: matiko09 folded before Flop (didn't bet)
Seat 9: PacPacBum folded before Flop (didn't bet)





PokerStars Hand #150802947022:  Hold'em No Limit (€0.50/€1.00 EUR) - 2016/03/23 15:22:56 CET [2016/03/23 10:22:56 ET]
Table 'Mercury III' 9-max Seat #6 is the button
Seat 1: matiko09 (€116.08 in chips) 
Seat 2: jahwe (€100 in chips) 
Seat 3: PacPacBum (€100 in chips) 
Seat 4: Muinmyheart (€118.24 in chips) 
Seat 6: mycka86 (€100 in chips) 
Seat 7: STrakDD (€100 in chips) 
Seat 8: gfxed (€35.84 in chips) 
Seat 9: Indr3k (€100 in chips) 
STrakDD: posts small blind €0.50
gfxed: posts big blind €1
ardo888: sits out 
*** HOLE CARDS ***
Dealt to matiko09 [Ks 5s]
Indr3k: folds 
matiko09: folds 
jahwe: folds 
PacPacBum: folds 
Muinmyheart: folds 
mycka86: raises €1.10 to €2.10
STrakDD: folds 
gfxed: folds 
Uncalled bet (€1.10) returned to mycka86
mycka86 collected €2.50 from pot
*** SUMMARY ***
Total pot €2.50 | Rake €0 
Seat 1: matiko09 folded before Flop (didn't bet)
Seat 2: jahwe folded before Flop (didn't bet)
Seat 3: PacPacBum folded before Flop (didn't bet)
Seat 4: Muinmyheart folded before Flop (didn't bet)
Seat 6: mycka86 (button) collected (€2.50)
Seat 7: STrakDD (small blind) folded before Flop
Seat 8: gfxed (big blind) folded before Flop
Seat 9: Indr3k folded before Flop (didn't bet)





PokerStars Hand #150802947296:  Hold'em No Limit ($1/$2 USD) - 2016/03/23 15:22:57 CET [2016/03/23 10:22:57 ET]
Table 'Clarissa II' 9-max Seat #9 is the button
Seat 1: IseeUcards ($217.88 in chips) 
Seat 2: Igoriah ($220.40 in chips) 
Seat 3: PtizaXXX ($152.39 in chips) 
Seat 4: sanrs57 ($195 in chips) 
Seat 5: Red4erT ($105.39 in chips) 
Seat 6: matiko09 ($213.61 in chips) 
Seat 7: PacPacBum ($200 in chips) 
Seat 8: chaps1988 ($200 in chips) 
Seat 9: RamiroAgujis ($200 in chips) 
IseeUcards: posts small blind $1
Igoriah: posts big blind $2
*** HOLE CARDS ***
Dealt to matiko09 [5h Ah]
PtizaXXX: folds 
sanrs57: folds 
Red4erT: raises $4 to $6
PtizaXXX leaves the table
matiko09: folds 
jahwe joins the table at seat #3 
PacPacBum: folds 
chaps1988: calls $6
RamiroAgujis: folds 
IseeUcards: folds 
Igoriah: folds 
*** FLOP *** [8c 6d 2h]
Red4erT: bets $7.44
chaps1988: raises $11.06 to $18.50
Red4erT: calls $11.06
*** TURN *** [8c 6d 2h] [Qs]
Red4erT: checks 
chaps1988: checks 
*** RIVER *** [8c 6d 2h Qs] [2s]
Red4erT: checks 
chaps1988: checks 
*** SHOW DOWN ***
Red4erT: shows [Ad Td] (a pair of Deuces)
chaps1988: mucks hand 
Red4erT collected $49.66 from pot
*** SUMMARY ***
Total pot $52 | Rake $2.34 
Board [8c 6d 2h Qs 2s]
Seat 1: IseeUcards (small blind) folded before Flop
Seat 2: Igoriah (big blind) folded before Flop
Seat 3: PtizaXXX folded before Flop (didn't bet)
Seat 4: sanrs57 folded before Flop (didn't bet)
Seat 5: Red4erT showed [Ad Td] and won ($49.66) with a pair of Deuces
Seat 6: matiko09 folded before Flop (didn't bet)
Seat 7: PacPacBum folded before Flop (didn't bet)
Seat 8: chaps1988 mucked [Th Kh]
Seat 9: RamiroAgujis (button) folded before Flop (didn't bet)





PokerStars Hand #150802949090:  Hold'em No Limit ($0.50/$1.00 USD) - 2016/03/23 15:23:02 CET [2016/03/23 10:23:02 ET]
Table 'Asmodeus' 9-max Seat #2 is the button
Seat 1: Jimy Tiltman ($147.25 in chips) 
Seat 2: PacPacBum ($104.29 in chips) 
Seat 3: jahwe ($100 in chips) 
Seat 4: Effort92 ($103.54 in chips) 
Seat 5: Muinmyheart ($100 in chips) 
Seat 6: fuppeee ($84.61 in chips) 
Seat 7: mycka86 ($125.75 in chips) 
Seat 8: bonifacioppl ($72.17 in chips) 
Seat 9: matiko09 ($100 in chips) 
jahwe: posts small blind $0.50
Effort92: posts big blind $1
Jimy Tiltman: posts the ante $0.20
PacPacBum: posts the ante $0.20
jahwe: posts the ante $0.20
Effort92: posts the ante $0.20
Muinmyheart: posts the ante $0.20
fuppeee: posts the ante $0.20
mycka86: posts the ante $0.20
bonifacioppl: posts the ante $0.20
matiko09: posts the ante $0.20
*** HOLE CARDS ***
Dealt to matiko09 [8d 9s]
Muinmyheart: folds 
fuppeee: raises $2 to $3
mycka86: folds 
bonifacioppl: calls $3
matiko09: folds 
Jimy Tiltman: folds 
PacPacBum: folds 
jahwe: folds 
Effort92: calls $2
*** FLOP *** [4d 4c Ts]
Effort92: checks 
fuppeee: bets $10.79
bonifacioppl: folds 
Effort92: folds 
Uncalled bet ($10.79) returned to fuppeee
fuppeee collected $10.79 from pot
*** SUMMARY ***
Total pot $11.30 | Rake $0.51 
Board [4d 4c Ts]
Seat 1: Jimy Tiltman folded before Flop (didn't bet)
Seat 2: PacPacBum (button) folded before Flop (didn't bet)
Seat 3: jahwe (small blind) folded before Flop
Seat 4: Effort92 (big blind) folded on the Flop
Seat 5: Muinmyheart folded before Flop (didn't bet)
Seat 6: fuppeee collected ($10.79)
Seat 7: mycka86 folded before Flop (didn't bet)
Seat 8: bonifacioppl folded on the Flop
Seat 9: matiko09 folded before Flop (didn't bet)





PokerStars Hand #150802949524:  Hold'em No Limit ($0.50/$1.00 USD) - 2016/03/23 15:23:03 CET [2016/03/23 10:23:03 ET]
Table 'Drakonia II' 9-max Seat #7 is the button
Seat 1: chautinhtri9 ($129.10 in chips) 
Seat 2: carrsseis ($101.50 in chips) 
Seat 3: dunga119 ($137.25 in chips) 
Seat 4: lumen21 ($100 in chips) 
Seat 5: Muinmyheart ($103.25 in chips) 
Seat 6: Dantist1122 ($108.76 in chips) 
Seat 7: YuriiSolodya ($43.74 in chips) 
Seat 8: matiko09 ($100 in chips) 
Seat 9: mycka86 ($101.86 in chips) 
matiko09: posts small blind $0.50
mycka86: posts big blind $1
*** HOLE CARDS ***
Dealt to matiko09 [Ad 8c]
chautinhtri9: folds 
carrsseis: folds 
dunga119: calls $1
lumen21: folds 
Muinmyheart: folds 
Dantist1122: folds 
YuriiSolodya: calls $1
matiko09: calls $0.50
mycka86: checks 
*** FLOP *** [4d 7s 4c]
matiko09: checks 
mycka86: checks 
dunga119: checks 
YuriiSolodya: checks 
*** TURN *** [4d 7s 4c] [Ah]
matiko09: checks 
mycka86: checks 
dunga119: checks 
YuriiSolodya: bets $1
matiko09: calls $1
mycka86: folds 
dunga119: folds 
*** RIVER *** [4d 7s 4c Ah] [2s]
matiko09: checks 
dunga119 leaves the table
edidaz joins the table at seat #3 
YuriiSolodya: checks 
edidaz leaves the table
*** SHOW DOWN ***
matiko09: shows [Ad 8c] (two pair, Aces and Fours)
YuriiSolodya: mucks hand 
matiko09 collected $5.73 from pot
*** SUMMARY ***
Total pot $6 | Rake $0.27 
Board [4d 7s 4c Ah 2s]
Seat 1: chautinhtri9 folded before Flop (didn't bet)
Seat 2: carrsseis folded before Flop (didn't bet)
Seat 3: dunga119 folded on the Turn
Seat 4: lumen21 folded before Flop (didn't bet)
Seat 5: Muinmyheart folded before Flop (didn't bet)
Seat 6: Dantist1122 folded before Flop (didn't bet)
Seat 7: YuriiSolodya (button) mucked [As 5d]
Seat 8: matiko09 (small blind) showed [Ad 8c] and won ($5.73) with two pair, Aces and Fours
Seat 9: mycka86 (big blind) folded on the Turn





PokerStars Hand #150802953871:  Hold'em No Limit ($0.50/$1.00 USD) - 2016/03/23 15:23:16 CET [2016/03/23 10:23:16 ET]
Table 'Swings' 9-max Seat #1 is the button
Seat 1: lumen21 ($101.50 in chips) 
Seat 2: tomver0809 ($78.32 in chips) 
Seat 4: YuriiSolodya ($40 in chips) 
Seat 5: chautinhtri9 ($122.96 in chips) 
Seat 6: matiko09 ($140.42 in chips) 
Seat 7: PacPacBum ($108.22 in chips) 
Seat 8: RICKA16 ($104 in chips) 
Seat 9: Effort92 ($104.18 in chips) 
tomver0809: posts small blind $0.50
YuriiSolodya: posts big blind $1
*** HOLE CARDS ***
Dealt to matiko09 [8c 5d]
chautinhtri9: folds 
matiko09: folds 
PacPacBum: raises $2 to $3
RICKA16: calls $3
Effort92: folds 
lumen21: folds 
tomver0809: folds 
YuriiSolodya: folds 
*** FLOP *** [9s 6c Td]
PacPacBum: bets $3.86
RICKA16: raises $8.14 to $12
PacPacBum: folds 
Uncalled bet ($8.14) returned to RICKA16
RICKA16 collected $14.54 from pot
RICKA16: doesn't show hand 
*** SUMMARY ***
Total pot $15.22 | Rake $0.68 
Board [9s 6c Td]
Seat 1: lumen21 (button) folded before Flop (didn't bet)
Seat 2: tomver0809 (small blind) folded before Flop
Seat 4: YuriiSolodya (big blind) folded before Flop
Seat 5: chautinhtri9 folded before Flop (didn't bet)
Seat 6: matiko09 folded before Flop (didn't bet)
Seat 7: PacPacBum folded on the Flop
Seat 8: RICKA16 collected ($14.54)
Seat 9: Effort92 folded before Flop (didn't bet)





PokerStars Hand #150802961699:  Hold'em No Limit (€0.50/€1.00 EUR) - 2016/03/23 15:23:37 CET [2016/03/23 10:23:37 ET]
Table 'Mercury III' 9-max Seat #7 is the button
Seat 1: matiko09 (€116.08 in chips) 
Seat 2: jahwe (€100 in chips) 
Seat 3: PacPacBum (€100 in chips) 
Seat 4: Muinmyheart (€118.24 in chips) 
Seat 6: mycka86 (€101.50 in chips) 
Seat 7: STrakDD (€100 in chips) 
Seat 8: gfxed (€34.84 in chips) 
Seat 9: Indr3k (€100 in chips) 
gfxed: posts small blind €0.50
Indr3k: posts big blind €1
ardo888: sits out 
*** HOLE CARDS ***
Dealt to matiko09 [5c Ad]
matiko09: folds 
jahwe: folds 
PacPacBum: folds 
Muinmyheart: folds 
mycka86: folds 
STrakDD: folds 
gfxed: raises €1.23 to €2.23
Indr3k: folds 
Uncalled bet (€1.23) returned to gfxed
gfxed collected €2 from pot
*** SUMMARY ***
Total pot €2 | Rake €0 
Seat 1: matiko09 folded before Flop (didn't bet)
Seat 2: jahwe folded before Flop (didn't bet)
Seat 3: PacPacBum folded before Flop (didn't bet)
Seat 4: Muinmyheart folded before Flop (didn't bet)
Seat 6: mycka86 folded before Flop (didn't bet)
Seat 7: STrakDD (button) folded before Flop (didn't bet)
Seat 8: gfxed (small blind) collected (€2)
Seat 9: Indr3k (big blind) folded before Flop





PokerStars Hand #150802963272:  Hold'em No Limit ($0.50/$1.00 USD) - 2016/03/23 15:23:42 CET [2016/03/23 10:23:42 ET]
Table 'Asmodeus' 9-max Seat #3 is the button
Seat 1: Jimy Tiltman ($147.05 in chips) 
Seat 2: PacPacBum ($104.09 in chips) 
Seat 3: jahwe ($100 in chips) 
Seat 4: Effort92 ($100.34 in chips) 
Seat 5: Muinmyheart ($100 in chips) 
Seat 6: fuppeee ($92.20 in chips) 
Seat 7: mycka86 ($125.55 in chips) 
Seat 8: bonifacioppl ($68.97 in chips) 
Seat 9: matiko09 ($100 in chips) 
Effort92: posts small blind $0.50
Muinmyheart: posts big blind $1
Jimy Tiltman: posts the ante $0.20
PacPacBum: posts the ante $0.20
jahwe: posts the ante $0.20
Effort92: posts the ante $0.20
Muinmyheart: posts the ante $0.20
fuppeee: posts the ante $0.20
mycka86: posts the ante $0.20
bonifacioppl: posts the ante $0.20
matiko09: posts the ante $0.20
*** HOLE CARDS ***
Dealt to matiko09 [Kc 5d]
fuppeee: folds 
mycka86: folds 
bonifacioppl: folds 
matiko09: folds 
Jimy Tiltman: folds 
PacPacBum: folds 
jahwe: raises $1 to $2
Effort92: folds 
Muinmyheart: calls $1
*** FLOP *** [8c 3c 3d]
Muinmyheart: checks 
jahwe: bets $3.50
Muinmyheart: folds 
Uncalled bet ($3.50) returned to jahwe
jahwe collected $6.02 from pot
jahwe: doesn't show hand 
*** SUMMARY ***
Total pot $6.30 | Rake $0.28 
Board [8c 3c 3d]
Seat 1: Jimy Tiltman folded before Flop (didn't bet)
Seat 2: PacPacBum folded before Flop (didn't bet)
Seat 3: jahwe (button) collected ($6.02)
Seat 4: Effort92 (small blind) folded before Flop
Seat 5: Muinmyheart (big blind) folded on the Flop
Seat 6: fuppeee folded before Flop (didn't bet)
Seat 7: mycka86 folded before Flop (didn't bet)
Seat 8: bonifacioppl folded before Flop (didn't bet)
Seat 9: matiko09 folded before Flop (didn't bet)





PokerStars Hand #150802972095:  Hold'em No Limit ($0.50/$1.00 USD) - 2016/03/23 15:24:07 CET [2016/03/23 10:24:07 ET]
Table 'Smiley' 9-max Seat #2 is the button
Seat 1: xHourglass ($100 in chips) 
Seat 2: Jimy Tiltman ($116.24 in chips) 
Seat 3: Robert201202 ($107.18 in chips) 
Seat 4: CAJUN890 ($93.69 in chips) 
Seat 5: Szevasztopol ($151.39 in chips) 
Seat 6: blackmont111 ($146.04 in chips) 
Seat 7: bennetb77 ($48.50 in chips) 
Seat 8: matiko09 ($104.80 in chips) 
Seat 9: PacPacBum ($100 in chips) 
Robert201202: posts small blind $0.50
CAJUN890: posts big blind $1
*** HOLE CARDS ***
Dealt to matiko09 [8c 8h]
Szevasztopol: folds 
blackmont111: folds 
bennetb77: folds 
matiko09: raises $2 to $3
PacPacBum: folds 
xHourglass: folds 
Jimy Tiltman: folds 
Robert201202: folds 
CAJUN890: folds 
Uncalled bet ($2) returned to matiko09
matiko09 collected $2.50 from pot
matiko09: doesn't show hand 
*** SUMMARY ***
Total pot $2.50 | Rake $0 
Seat 1: xHourglass folded before Flop (didn't bet)
Seat 2: Jimy Tiltman (button) folded before Flop (didn't bet)
Seat 3: Robert201202 (small blind) folded before Flop
Seat 4: CAJUN890 (big blind) folded before Flop
Seat 5: Szevasztopol folded before Flop (didn't bet)
Seat 6: blackmont111 folded before Flop (didn't bet)
Seat 7: bennetb77 folded before Flop (didn't bet)
Seat 8: matiko09 collected ($2.50)
Seat 9: PacPacBum folded before Flop (didn't bet)





PokerStars Hand #150802977559:  Hold'em No Limit ($0.50/$1.00 USD) - 2016/03/23 15:24:22 CET [2016/03/23 10:24:22 ET]
Table 'Asmodeus' 9-max Seat #4 is the button
Seat 1: Jimy Tiltman ($146.85 in chips) 
Seat 2: PacPacBum ($103.89 in chips) 
Seat 3: jahwe ($103.82 in chips) 
Seat 4: Effort92 ($100 in chips) 
Seat 5: Muinmyheart ($100 in chips) 
Seat 6: fuppeee ($92 in chips) 
Seat 7: mycka86 ($125.35 in chips) 
Seat 8: bonifacioppl ($68.77 in chips) 
Seat 9: matiko09 ($100 in chips) 
Muinmyheart: posts small blind $0.50
fuppeee: posts big blind $1
Jimy Tiltman: posts the ante $0.20
PacPacBum: posts the ante $0.20
jahwe: posts the ante $0.20
Effort92: posts the ante $0.20
Muinmyheart: posts the ante $0.20
fuppeee: posts the ante $0.20
mycka86: posts the ante $0.20
bonifacioppl: posts the ante $0.20
matiko09: posts the ante $0.20
*** HOLE CARDS ***
Dealt to matiko09 [6c 4d]
mycka86: raises $2.50 to $3.50
bonifacioppl: calls $3.50
matiko09: folds 
Jimy Tiltman: folds 
PacPacBum: folds 
jahwe: folds 
Effort92: calls $3.50
Muinmyheart: folds 
fuppeee: calls $2.50
*** FLOP *** [Ts 6s 7d]
fuppeee: checks 
mycka86: checks 
bonifacioppl: bets $8.71
Effort92: folds 
fuppeee: raises $8.71 to $17.42
mycka86: folds 
bonifacioppl: calls $8.71
*** TURN *** [Ts 6s 7d] [Qd]
fuppeee: bets $70.88 and is all-in
bonifacioppl: folds 
Uncalled bet ($70.88) returned to fuppeee
fuppeee collected $48.84 from pot
*** SUMMARY ***
Total pot $51.14 | Rake $2.30 
Board [Ts 6s 7d Qd]
Seat 1: Jimy Tiltman folded before Flop (didn't bet)
Seat 2: PacPacBum folded before Flop (didn't bet)
Seat 3: jahwe folded before Flop (didn't bet)
Seat 4: Effort92 (button) folded on the Flop
Seat 5: Muinmyheart (small blind) folded before Flop
Seat 6: fuppeee (big blind) collected ($48.84)
Seat 7: mycka86 folded on the Flop
Seat 8: bonifacioppl folded on the Turn
Seat 9: matiko09 folded before Flop (didn't bet)





PokerStars Hand #150802977977:  Hold'em No Limit ($0.50/$1.00 USD) - 2016/03/23 15:24:23 CET [2016/03/23 10:24:23 ET]
Table 'Swings' 9-max Seat #2 is the button
Seat 1: lumen21 ($101.50 in chips) 
Seat 2: tomver0809 ($77.82 in chips) 
Seat 4: YuriiSolodya ($39 in chips) 
Seat 5: chautinhtri9 ($122.96 in chips) 
Seat 6: matiko09 ($140.42 in chips) 
Seat 7: PacPacBum ($101.36 in chips) 
Seat 8: RICKA16 ($111.68 in chips) 
Seat 9: Effort92 ($104.18 in chips) 
YuriiSolodya: posts small blind $0.50
chautinhtri9: posts big blind $1
*** HOLE CARDS ***
Dealt to matiko09 [3s As]
matiko09: folds 
PacPacBum: folds 
RICKA16: folds 
Effort92: folds 
lumen21: folds 
tomver0809: folds 
YuriiSolodya: folds 
Uncalled bet ($0.50) returned to chautinhtri9
chautinhtri9 collected $1 from pot
*** SUMMARY ***
Total pot $1 | Rake $0 
Seat 1: lumen21 folded before Flop (didn't bet)
Seat 2: tomver0809 (button) folded before Flop (didn't bet)
Seat 4: YuriiSolodya (small blind) folded before Flop
Seat 5: chautinhtri9 (big blind) collected ($1)
Seat 6: matiko09 folded before Flop (didn't bet)
Seat 7: PacPacBum folded before Flop (didn't bet)
Seat 8: RICKA16 folded before Flop (didn't bet)
Seat 9: Effort92 folded before Flop (didn't bet)





PokerStars Hand #150802980295:  Hold'em No Limit (€0.50/€1.00 EUR) - 2016/03/23 15:24:30 CET [2016/03/23 10:24:30 ET]
Table 'Mercury III' 9-max Seat #8 is the button
Seat 1: matiko09 (€116.08 in chips) 
Seat 2: jahwe (€100 in chips) 
Seat 3: PacPacBum (€100 in chips) 
Seat 4: Muinmyheart (€118.24 in chips) 
Seat 6: mycka86 (€101.50 in chips) 
Seat 7: STrakDD (€100 in chips) 
Seat 8: gfxed (€35.84 in chips) 
Seat 9: Indr3k (€100 in chips) 
Indr3k: posts small blind €0.50
matiko09: posts big blind €1
ardo888: sits out 
*** HOLE CARDS ***
Dealt to matiko09 [4c 3c]
jahwe: folds 
PacPacBum: folds 
Muinmyheart: folds 
mycka86: raises €1.50 to €2.50
STrakDD: folds 
gfxed: calls €2.50
Indr3k: folds 
matiko09: folds 
*** FLOP *** [9c Tc 7s]
mycka86: bets €4.40
gfxed: calls €4.40
*** TURN *** [9c Tc 7s] [2h]
mycka86: bets €8.03
gfxed: calls €8.03
*** RIVER *** [9c Tc 7s 2h] [2s]
mycka86: checks 
gfxed: checks 
*** SHOW DOWN ***
mycka86: shows [Jc Ks] (a pair of Deuces)
gfxed: shows [8s 9s] (two pair, Nines and Deuces)
gfxed collected €29.95 from pot
*** SUMMARY ***
Total pot €31.36 | Rake €1.41 
Board [9c Tc 7s 2h 2s]
Seat 1: matiko09 (big blind) folded before Flop
Seat 2: jahwe folded before Flop (didn't bet)
Seat 3: PacPacBum folded before Flop (didn't bet)
Seat 4: Muinmyheart folded before Flop (didn't bet)
Seat 6: mycka86 showed [Jc Ks] and lost with a pair of Deuces
Seat 7: STrakDD folded before Flop (didn't bet)
Seat 8: gfxed (button) showed [8s 9s] and won (€29.95) with two pair, Nines and Deuces
Seat 9: Indr3k (small blind) folded before Flop





PokerStars Hand #150802982680:  Hold'em No Limit (€1/€2 EUR) - 2016/03/23 15:24:36 CET [2016/03/23 10:24:36 ET]
Table 'Malva II' 9-max Seat #1 is the button
Seat 1: PacPacBum (€246.63 in chips) 
Seat 2: IseeUcards (€200 in chips) 
Seat 3: matiko09 (€200 in chips) 
Seat 4: steff0777 (€206 in chips) 
Seat 5: o.miro (€356.35 in chips) 
Seat 6: volwebni4ek (€88.47 in chips) 
Seat 7: rivesald (€97.24 in chips) 
Seat 8: T0ny Adams (€82.20 in chips) 
Seat 9: RamiroAgujis (€216.23 in chips) 
IseeUcards: posts small blind €1
matiko09: posts big blind €2
*** HOLE CARDS ***
Dealt to matiko09 [Jh 6c]
steff0777: folds 
o.miro: folds 
volwebni4ek: folds 
rivesald: calls €2
T0ny Adams: folds 
RamiroAgujis: folds 
PacPacBum: folds 
IseeUcards: calls €1
matiko09: checks 
*** FLOP *** [6h Tc 5d]
IseeUcards: checks 
matiko09: checks 
rivesald: bets €6
IseeUcards: folds 
matiko09: calls €6
*** TURN *** [6h Tc 5d] [Ts]
matiko09: checks 
rivesald: checks 
*** RIVER *** [6h Tc 5d Ts] [Kc]
matiko09: checks 
rivesald: bets €17.19
matiko09: folds 
Uncalled bet (€17.19) returned to rivesald
rivesald collected €17.19 from pot
rivesald: doesn't show hand 
*** SUMMARY ***
Total pot €18 | Rake €0.81 
Board [6h Tc 5d Ts Kc]
Seat 1: PacPacBum (button) folded before Flop (didn't bet)
Seat 2: IseeUcards (small blind) folded on the Flop
Seat 3: matiko09 (big blind) folded on the River
Seat 4: steff0777 folded before Flop (didn't bet)
Seat 5: o.miro folded before Flop (didn't bet)
Seat 6: volwebni4ek folded before Flop (didn't bet)
Seat 7: rivesald collected (€17.19)
Seat 8: T0ny Adams folded before Flop (didn't bet)
Seat 9: RamiroAgujis folded before Flop (didn't bet)





PokerStars Hand #150802982761:  Hold'em No Limit ($0.50/$1.00 USD) - 2016/03/23 15:24:37 CET [2016/03/23 10:24:37 ET]
Table 'Smiley' 9-max Seat #3 is the button
Seat 1: xHourglass ($100 in chips) 
Seat 2: Jimy Tiltman ($116.24 in chips) 
Seat 3: Robert201202 ($106.68 in chips) 
Seat 4: CAJUN890 ($92.69 in chips) 
Seat 5: Szevasztopol ($151.39 in chips) 
Seat 6: blackmont111 ($146.04 in chips) 
Seat 7: bennetb77 ($48.50 in chips) 
Seat 8: matiko09 ($106.30 in chips) 
Seat 9: PacPacBum ($100 in chips) 
CAJUN890: posts small blind $0.50
Szevasztopol: posts big blind $1
*** HOLE CARDS ***
Dealt to matiko09 [Kh 4s]
blackmont111: folds 
bennetb77: folds 
matiko09: folds 
PacPacBum: raises $1.04 to $2.04
xHourglass: folds 
Jimy Tiltman: folds 
Robert201202: calls $2.04
CAJUN890: folds 
Szevasztopol: calls $1.04
*** FLOP *** [5c 9h Ac]
Szevasztopol: checks 
PacPacBum: bets $4.36
Robert201202: calls $4.36
Szevasztopol: folds 
*** TURN *** [5c 9h Ac] [Tc]
PacPacBum: checks 
Robert201202: bets $7
PacPacBum: calls $7
*** RIVER *** [5c 9h Ac Tc] [Ks]
PacPacBum: checks 
Robert201202: bets $14
PacPacBum: calls $14
*** SHOW DOWN ***
Robert201202: shows [5s 5h] (three of a kind, Fives)
PacPacBum: mucks hand 
Robert201202 collected $54.76 from pot
*** SUMMARY ***
Total pot $57.34 | Rake $2.58 
Board [5c 9h Ac Tc Ks]
Seat 1: xHourglass folded before Flop (didn't bet)
Seat 2: Jimy Tiltman folded before Flop (didn't bet)
Seat 3: Robert201202 (button) showed [5s 5h] and won ($54.76) with three of a kind, Fives
Seat 4: CAJUN890 (small blind) folded before Flop
Seat 5: Szevasztopol (big blind) folded on the Flop
Seat 6: blackmont111 folded before Flop (didn't bet)
Seat 7: bennetb77 folded before Flop (didn't bet)
Seat 8: matiko09 folded before Flop (didn't bet)
Seat 9: PacPacBum mucked [Qc Ah]





PokerStars Hand #150802984223:  Hold'em No Limit ($0.50/$1.00 USD) - 2016/03/23 15:24:41 CET [2016/03/23 10:24:41 ET]
Table 'Drakonia II' 9-max Seat #8 is the button
Seat 1: chautinhtri9 ($129.10 in chips) 
Seat 2: carrsseis ($101.50 in chips) 
Seat 4: lumen21 ($100 in chips) 
Seat 5: Muinmyheart ($103.25 in chips) 
Seat 6: Dantist1122 ($108.76 in chips) 
Seat 7: YuriiSolodya ($41.74 in chips) 
Seat 8: matiko09 ($103.73 in chips) 
Seat 9: mycka86 ($100.86 in chips) 
mycka86: posts small blind $0.50
chautinhtri9: posts big blind $1
*** HOLE CARDS ***
Dealt to matiko09 [9s 6h]
PacPacBum joins the table at seat #3 
carrsseis: folds 
lumen21: folds 
Muinmyheart: folds 
Dantist1122: raises $2 to $3
YuriiSolodya: folds 
matiko09: folds 
mycka86: folds 
chautinhtri9: folds 
Uncalled bet ($2) returned to Dantist1122
Dantist1122 collected $2.50 from pot
Dantist1122: doesn't show hand 
*** SUMMARY ***
Total pot $2.50 | Rake $0 
Seat 1: chautinhtri9 (big blind) folded before Flop
Seat 2: carrsseis folded before Flop (didn't bet)
Seat 4: lumen21 folded before Flop (didn't bet)
Seat 5: Muinmyheart folded before Flop (didn't bet)
Seat 6: Dantist1122 collected ($2.50)
Seat 7: YuriiSolodya folded before Flop (didn't bet)
Seat 8: matiko09 (button) folded before Flop (didn't bet)
Seat 9: mycka86 (small blind) folded before Flop





PokerStars Hand #150802985922:  Hold'em No Limit ($1/$2 USD) - 2016/03/23 15:24:46 CET [2016/03/23 10:24:46 ET]
Table 'Clarissa II' 9-max Seat #1 is the button
Seat 1: IseeUcards ($216.88 in chips) 
Seat 2: Igoriah ($218.40 in chips) 
Seat 3: jahwe ($200 in chips) 
Seat 4: sanrs57 ($195 in chips) 
Seat 5: Red4erT ($130.55 in chips) 
Seat 6: matiko09 ($213.61 in chips) 
Seat 7: PacPacBum ($200 in chips) 
Seat 8: chaps1988 ($200 in chips) 
Seat 9: RamiroAgujis ($200 in chips) 
Igoriah: posts small blind $1
jahwe: posts big blind $2
*** HOLE CARDS ***
Dealt to matiko09 [7c 5d]
sanrs57: folds 
Red4erT: folds 
matiko09: folds 
PacPacBum: raises $2.08 to $4.08
chaps1988: folds 
RamiroAgujis: folds 
IseeUcards: raises $11.92 to $16
Igoriah: folds 
jahwe: folds 
PacPacBum: folds 
Uncalled bet ($11.92) returned to IseeUcards
IseeUcards collected $11.16 from pot
*** SUMMARY ***
Total pot $11.16 | Rake $0 
Seat 1: IseeUcards (button) collected ($11.16)
Seat 2: Igoriah (small blind) folded before Flop
Seat 3: jahwe (big blind) folded before Flop
Seat 4: sanrs57 folded before Flop (didn't bet)
Seat 5: Red4erT folded before Flop (didn't bet)
Seat 6: matiko09 folded before Flop (didn't bet)
Seat 7: PacPacBum folded before Flop
Seat 8: chaps1988 folded before Flop (didn't bet)
Seat 9: RamiroAgujis folded before Flop (didn't bet)





PokerStars Hand #150802985882:  Hold'em No Limit ($0.50/$1.00 USD) - 2016/03/23 15:24:46 CET [2016/03/23 10:24:46 ET]
Table 'Swings' 9-max Seat #4 is the button
Seat 1: lumen21 ($101.50 in chips) 
Seat 2: tomver0809 ($77.82 in chips) 
Seat 4: YuriiSolodya ($38.50 in chips) 
Seat 5: chautinhtri9 ($123.46 in chips) 
Seat 6: matiko09 ($140.42 in chips) 
Seat 7: PacPacBum ($101.36 in chips) 
Seat 8: RICKA16 ($111.68 in chips) 
Seat 9: Effort92 ($104.18 in chips) 
chautinhtri9: posts small blind $0.50
matiko09: posts big blind $1
*** HOLE CARDS ***
Dealt to matiko09 [6s 3c]
PacPacBum: calls $1
RICKA16: raises $2 to $3
Effort92: folds 
lumen21: folds 
tomver0809: calls $3
YuriiSolodya: folds 
chautinhtri9: folds 
matiko09: folds 
PacPacBum: raises $10 to $13
RICKA16: folds 
tomver0809: calls $10
*** FLOP *** [2d Qd 4c]
PacPacBum: bets $15.73
tomver0809: folds 
Uncalled bet ($15.73) returned to PacPacBum
PacPacBum collected $29.13 from pot
PacPacBum: doesn't show hand 
*** SUMMARY ***
Total pot $30.50 | Rake $1.37 
Board [2d Qd 4c]
Seat 1: lumen21 folded before Flop (didn't bet)
Seat 2: tomver0809 folded on the Flop
Seat 4: YuriiSolodya (button) folded before Flop (didn't bet)
Seat 5: chautinhtri9 (small blind) folded before Flop
Seat 6: matiko09 (big blind) folded before Flop
Seat 7: PacPacBum collected ($29.13)
Seat 8: RICKA16 folded before Flop
Seat 9: Effort92 folded before Flop (didn't bet)





PokerStars Hand #150802987856:  Hold'em No Limit ($1/$2 USD) - 2016/03/23 15:24:51 CET [2016/03/23 10:24:51 ET]
Table 'Kiess' 9-max Seat #6 is the button
Seat 1: Cirilico ($264.22 in chips) 
Seat 3: Red4erT ($101.04 in chips) 
Seat 4: RamiroAgujis ($200 in chips) 
Seat 6: matiko09 ($259.28 in chips) 
Seat 7: chaps1988 ($200 in chips) 
Seat 8: erfk1958 ($123.27 in chips) 
Seat 9: PacPacBum ($203 in chips) 
chaps1988: posts small blind $1
erfk1958: posts big blind $2
jahwe: sits out 
chippo boy: sits out 
*** HOLE CARDS ***
Dealt to matiko09 [Jh 8h]
PacPacBum: folds 
Cirilico: folds 
Red4erT: folds 
RamiroAgujis: folds 
matiko09: raises $2.54 to $4.54
chaps1988: folds 
erfk1958: calls $2.54
*** FLOP *** [3c 9h 9d]
erfk1958: checks 
matiko09: bets $6.26
erfk1958: calls $6.26
*** TURN *** [3c 9h 9d] [8d]
erfk1958: checks 
matiko09: checks 
*** RIVER *** [3c 9h 9d 8d] [Ac]
erfk1958: checks 
matiko09: checks 
*** SHOW DOWN ***
erfk1958: shows [Ks Kh] (two pair, Kings and Nines)
matiko09: mucks hand 
erfk1958 collected $21.58 from pot
*** SUMMARY ***
Total pot $22.60 | Rake $1.02 
Board [3c 9h 9d 8d Ac]
Seat 1: Cirilico folded before Flop (didn't bet)
Seat 3: Red4erT folded before Flop (didn't bet)
Seat 4: RamiroAgujis folded before Flop (didn't bet)
Seat 6: matiko09 (button) mucked [Jh 8h]
Seat 7: chaps1988 (small blind) folded before Flop
Seat 8: erfk1958 (big blind) showed [Ks Kh] and won ($21.58) with two pair, Kings and Nines
Seat 9: PacPacBum folded before Flop (didn't bet)





PokerStars Hand #150802996313:  Hold'em No Limit ($0.50/$1.00 USD) - 2016/03/23 15:25:15 CET [2016/03/23 10:25:15 ET]
Table 'Sylvia III' 9-max Seat #1 is the button
Seat 1: mycka86 ($142.20 in chips) 
Seat 2: Dantist1122 ($107.50 in chips) 
Seat 3: se7en_$tars ($223.72 in chips) 
Seat 4: lombardo11 ($42.42 in chips) 
Seat 5: matiko09 ($100 in chips) 
Seat 6: PacPacBum ($100 in chips) 
Seat 7: easytalk777 ($96.77 in chips) 
Seat 8: Muinmyheart ($100 in chips) 
Dantist1122: posts small blind $0.50
se7en_$tars: posts big blind $1
mycka86: posts the ante $0.20
Dantist1122: posts the ante $0.20
se7en_$tars: posts the ante $0.20
lombardo11: posts the ante $0.20
matiko09: posts the ante $0.20
PacPacBum: posts the ante $0.20
easytalk777: posts the ante $0.20
Muinmyheart: posts the ante $0.20
*** HOLE CARDS ***
Dealt to matiko09 [Qd Kd]
lombardo11: folds 
matiko09: raises $2 to $3
PacPacBum: folds 
easytalk777: calls $3
Muinmyheart: calls $3
mycka86: folds 
Dantist1122: folds 
Blanky-Bad leaves the table
se7en_$tars: calls $2
*** FLOP *** [6h 5h 8s]
Jimy Tiltman joins the table at seat #9 
se7en_$tars: checks 
matiko09: checks 
easytalk777: checks 
Muinmyheart: checks 
*** TURN *** [6h 5h 8s] [Js]
se7en_$tars: checks 
matiko09: checks 
easytalk777: bets $11
Muinmyheart: calls $11
se7en_$tars: folds 
matiko09: folds 
*** RIVER *** [6h 5h 8s Js] [3d]
easytalk777: bets $17
Muinmyheart: calls $17
*** SHOW DOWN ***
easytalk777: shows [7s 5s] (a pair of Fives)
Muinmyheart: shows [Th Jh] (a pair of Jacks)
Muinmyheart collected $67.30 from pot
*** SUMMARY ***
Total pot $70.10 | Rake $2.80 
Board [6h 5h 8s Js 3d]
Seat 1: mycka86 (button) folded before Flop (didn't bet)
Seat 2: Dantist1122 (small blind) folded before Flop
Seat 3: se7en_$tars (big blind) folded on the Turn
Seat 4: lombardo11 folded before Flop (didn't bet)
Seat 5: matiko09 folded on the Turn
Seat 6: PacPacBum folded before Flop (didn't bet)
Seat 7: easytalk777 showed [7s 5s] and lost with a pair of Fives
Seat 8: Muinmyheart showed [Th Jh] and won ($67.30) with a pair of Jacks





PokerStars Hand #150802997361:  Hold'em No Limit ($0.50/$1.00 USD) - 2016/03/23 15:25:18 CET [2016/03/23 10:25:18 ET]
Table 'Drakonia II' 9-max Seat #9 is the button
Seat 1: chautinhtri9 ($128.10 in chips) 
Seat 2: carrsseis ($101.50 in chips) 
Seat 4: lumen21 ($100 in chips) 
Seat 5: Muinmyheart ($103.25 in chips) 
Seat 6: Dantist1122 ($110.26 in chips) 
Seat 7: YuriiSolodya ($41.74 in chips) 
Seat 8: matiko09 ($103.73 in chips) 
Seat 9: mycka86 ($100.36 in chips) 
chautinhtri9: posts small blind $0.50
carrsseis: posts big blind $1
PacPacBum: sits out 
*** HOLE CARDS ***
Dealt to matiko09 [7d 7h]
lumen21: folds 
Muinmyheart: folds 
Dantist1122: folds 
YuriiSolodya: raises $3 to $4
matiko09: calls $4
mycka86: folds 
chautinhtri9: folds 
carrsseis: calls $3
*** FLOP *** [6h 9c Ah]
carrsseis: checks 
YuriiSolodya: bets $5.97
matiko09: folds 
carrsseis: calls $5.97
*** TURN *** [6h 9c Ah] [4h]
carrsseis: checks 
YuriiSolodya: bets $11.67
carrsseis: folds 
Uncalled bet ($11.67) returned to YuriiSolodya
YuriiSolodya collected $23.34 from pot
YuriiSolodya: doesn't show hand 
*** SUMMARY ***
Total pot $24.44 | Rake $1.10 
Board [6h 9c Ah 4h]
Seat 1: chautinhtri9 (small blind) folded before Flop
Seat 2: carrsseis (big blind) folded on the Turn
Seat 4: lumen21 folded before Flop (didn't bet)
Seat 5: Muinmyheart folded before Flop (didn't bet)
Seat 6: Dantist1122 folded before Flop (didn't bet)
Seat 7: YuriiSolodya collected ($23.34)
Seat 8: matiko09 folded on the Flop
Seat 9: mycka86 (button) folded before Flop (didn't bet)





PokerStars Hand #150803000567:  Hold'em No Limit ($1/$2 USD) - 2016/03/23 15:25:28 CET [2016/03/23 10:25:28 ET]
Table 'Clarissa II' 9-max Seat #2 is the button
Seat 1: IseeUcards ($223.96 in chips) 
Seat 2: Igoriah ($217.40 in chips) 
Seat 3: jahwe ($200 in chips) 
Seat 4: sanrs57 ($195 in chips) 
Seat 5: Red4erT ($130.55 in chips) 
Seat 6: matiko09 ($213.61 in chips) 
Seat 7: PacPacBum ($200 in chips) 
Seat 8: chaps1988 ($200 in chips) 
Seat 9: RamiroAgujis ($200 in chips) 
jahwe: posts small blind $1
sanrs57: posts big blind $2
*** HOLE CARDS ***
Dealt to matiko09 [3d 4h]
Red4erT: raises $3 to $5
matiko09: folds 
PacPacBum: folds 
chaps1988: folds 
RamiroAgujis: folds 
IseeUcards: folds 
Igoriah: calls $5
jahwe: folds 
sanrs57: folds 
*** FLOP *** [3h Qc Kc]
Red4erT: checks 
Igoriah: bets $8.19
Red4erT: folds 
Uncalled bet ($8.19) returned to Igoriah
Igoriah collected $12.42 from pot
Igoriah: doesn't show hand 
*** SUMMARY ***
Total pot $13 | Rake $0.58 
Board [3h Qc Kc]
Seat 1: IseeUcards folded before Flop (didn't bet)
Seat 2: Igoriah (button) collected ($12.42)
Seat 3: jahwe (small blind) folded before Flop
Seat 4: sanrs57 (big blind) folded before Flop
Seat 5: Red4erT folded on the Flop
Seat 6: matiko09 folded before Flop (didn't bet)
Seat 7: PacPacBum folded before Flop (didn't bet)
Seat 8: chaps1988 folded before Flop (didn't bet)
Seat 9: RamiroAgujis folded before Flop (didn't bet)





PokerStars Hand #150803001624:  Hold'em No Limit (€0.50/€1.00 EUR) - 2016/03/23 15:25:30 CET [2016/03/23 10:25:30 ET]
Table 'Mercury III' 9-max Seat #9 is the button
Seat 1: matiko09 (€115.08 in chips) 
Seat 2: jahwe (€100 in chips) 
Seat 3: PacPacBum (€100 in chips) 
Seat 4: Muinmyheart (€118.24 in chips) 
Seat 6: mycka86 (€100 in chips) 
Seat 7: STrakDD (€100 in chips) 
Seat 8: gfxed (€50.86 in chips) 
Seat 9: Indr3k (€100 in chips) 
matiko09: posts small blind €0.50
jahwe: posts big blind €1
ardo888: sits out 
*** HOLE CARDS ***
Dealt to matiko09 [8s Tc]
PacPacBum: folds 
Muinmyheart: raises €2 to €3
mycka86: folds 
STrakDD: folds 
gfxed: calls €3
Indr3k: folds 
matiko09: folds 
jahwe: folds 
*** FLOP *** [Th 4c 9d]
Muinmyheart: checks 
gfxed: bets €3.25
Muinmyheart: folds 
Uncalled bet (€3.25) returned to gfxed
gfxed collected €7.16 from pot
*** SUMMARY ***
Total pot €7.50 | Rake €0.34 
Board [Th 4c 9d]
Seat 1: matiko09 (small blind) folded before Flop
Seat 2: jahwe (big blind) folded before Flop
Seat 3: PacPacBum folded before Flop (didn't bet)
Seat 4: Muinmyheart folded on the Flop
Seat 6: mycka86 folded before Flop (didn't bet)
Seat 7: STrakDD folded before Flop (didn't bet)
Seat 8: gfxed collected (€7.16)
Seat 9: Indr3k (button) folded before Flop (didn't bet)





PokerStars Hand #150803002706:  Hold'em No Limit ($0.50/$1.00 USD) - 2016/03/23 15:25:34 CET [2016/03/23 10:25:34 ET]
Table 'Asmodeus' 9-max Seat #5 is the button
Seat 1: Jimy Tiltman ($146.65 in chips) 
Seat 2: PacPacBum ($103.69 in chips) 
Seat 3: jahwe ($103.62 in chips) 
Seat 4: Effort92 ($100 in chips) 
Seat 5: Muinmyheart ($100 in chips) 
Seat 6: fuppeee ($119.72 in chips) 
Seat 7: mycka86 ($121.65 in chips) 
Seat 8: bonifacioppl ($47.65 in chips) 
Seat 9: matiko09 ($100 in chips) 
fuppeee: posts small blind $0.50
mycka86: posts big blind $1
Jimy Tiltman: posts the ante $0.20
PacPacBum: posts the ante $0.20
jahwe: posts the ante $0.20
Effort92: posts the ante $0.20
Muinmyheart: posts the ante $0.20
fuppeee: posts the ante $0.20
mycka86: posts the ante $0.20
bonifacioppl: posts the ante $0.20
matiko09: posts the ante $0.20
*** HOLE CARDS ***
Dealt to matiko09 [8h Ah]
bonifacioppl: folds 
matiko09: folds 
Jimy Tiltman: folds 
PacPacBum: folds 
jahwe: folds 
Effort92: folds 
Muinmyheart: raises $2 to $3
fuppeee: calls $2.50
mycka86: folds 
*** FLOP *** [Jc Ts Qd]
fuppeee: checks 
Muinmyheart: checks 
*** TURN *** [Jc Ts Qd] [3s]
fuppeee: bets $4.20
Muinmyheart: calls $4.20
*** RIVER *** [Jc Ts Qd 3s] [Th]
fuppeee: checks 
Muinmyheart: checks 
*** SHOW DOWN ***
fuppeee: shows [4d 4c] (two pair, Tens and Fours)
Muinmyheart: mucks hand 
fuppeee collected $16.43 from pot
*** SUMMARY ***
Total pot $17.20 | Rake $0.77 
Board [Jc Ts Qd 3s Th]
Seat 1: Jimy Tiltman folded before Flop (didn't bet)
Seat 2: PacPacBum folded before Flop (didn't bet)
Seat 3: jahwe folded before Flop (didn't bet)
Seat 4: Effort92 folded before Flop (didn't bet)
Seat 5: Muinmyheart (button) mucked [7s 9s]
Seat 6: fuppeee (small blind) showed [4d 4c] and won ($16.43) with two pair, Tens and Fours
Seat 7: mycka86 (big blind) folded before Flop
Seat 8: bonifacioppl folded before Flop (didn't bet)
Seat 9: matiko09 folded before Flop (didn't bet)





PokerStars Hand #150803007944:  Hold'em No Limit (€1/€2 EUR) - 2016/03/23 15:25:48 CET [2016/03/23 10:25:48 ET]
Table 'Malva II' 9-max Seat #2 is the button
Seat 1: PacPacBum (€246.63 in chips) 
Seat 2: IseeUcards (€200 in chips) 
Seat 3: matiko09 (€200 in chips) 
Seat 4: steff0777 (€206 in chips) 
Seat 5: o.miro (€356.35 in chips) 
Seat 6: volwebni4ek (€88.47 in chips) 
Seat 7: rivesald (€106.43 in chips) 
Seat 8: T0ny Adams (€82.20 in chips) 
Seat 9: RamiroAgujis (€216.23 in chips) 
matiko09: posts small blind €1
steff0777: posts big blind €2
*** HOLE CARDS ***
Dealt to matiko09 [Jc Jd]
o.miro: folds 
volwebni4ek: raises €4 to €6
rivesald: folds 
T0ny Adams: folds 
RamiroAgujis: folds 
PacPacBum: folds 
IseeUcards: folds 
matiko09: calls €5
steff0777: folds 
*** FLOP *** [Js Td 9c]
matiko09: checks 
volwebni4ek: checks 
*** TURN *** [Js Td 9c] [4c]
matiko09: checks 
volwebni4ek: checks 
*** RIVER *** [Js Td 9c 4c] [Tc]
matiko09: bets €6
volwebni4ek: raises €9 to €15
matiko09: raises €39 to €54
volwebni4ek: calls €39
*** SHOW DOWN ***
matiko09: shows [Jc Jd] (a full house, Jacks full of Tens)
volwebni4ek: mucks hand 
matiko09 collected €119.85 from pot
*** SUMMARY ***
Total pot €122 | Rake €2.15 
Board [Js Td 9c 4c Tc]
Seat 1: PacPacBum folded before Flop (didn't bet)
Seat 2: IseeUcards (button) folded before Flop (didn't bet)
Seat 3: matiko09 (small blind) showed [Jc Jd] and won (€119.85) with a full house, Jacks full of Tens
Seat 4: steff0777 (big blind) folded before Flop
Seat 5: o.miro folded before Flop (didn't bet)
Seat 6: volwebni4ek mucked [5c Ac]
Seat 7: rivesald folded before Flop (didn't bet)
Seat 8: T0ny Adams folded before Flop (didn't bet)
Seat 9: RamiroAgujis folded before Flop (didn't bet)





PokerStars Hand #150803009926:  Hold'em No Limit ($0.50/$1.00 USD) - 2016/03/23 15:25:54 CET [2016/03/23 10:25:54 ET]
Table 'Swings' 9-max Seat #5 is the button
Seat 1: lumen21 ($101.50 in chips) 
Seat 2: tomver0809 ($64.82 in chips) 
Seat 4: YuriiSolodya ($38.50 in chips) 
Seat 5: chautinhtri9 ($122.96 in chips) 
Seat 6: matiko09 ($139.42 in chips) 
Seat 8: RICKA16 ($108.68 in chips) 
Seat 9: Effort92 ($104.18 in chips) 
matiko09: posts small blind $0.50
PacPacBum: is sitting out 
RICKA16: posts big blind $1
*** HOLE CARDS ***
Dealt to matiko09 [4s 4c]
Effort92: folds 
lumen21: folds 
tomver0809: calls $1
YuriiSolodya: folds 
chautinhtri9: calls $1
matiko09: calls $0.50
RICKA16: checks 
*** FLOP *** [Qs 3s 2h]
matiko09: checks 
RICKA16: checks 
tomver0809: checks 
chautinhtri9: bets $1.91
matiko09: folds 
RICKA16: folds 
tomver0809: calls $1.91
*** TURN *** [Qs 3s 2h] [3d]
tomver0809: bets $5
chautinhtri9: folds 
Uncalled bet ($5) returned to tomver0809
tomver0809 collected $7.47 from pot
tomver0809: doesn't show hand 
*** SUMMARY ***
Total pot $7.82 | Rake $0.35 
Board [Qs 3s 2h 3d]
Seat 1: lumen21 folded before Flop (didn't bet)
Seat 2: tomver0809 collected ($7.47)
Seat 4: YuriiSolodya folded before Flop (didn't bet)
Seat 5: chautinhtri9 (button) folded on the Turn
Seat 6: matiko09 (small blind) folded on the Flop
Seat 8: RICKA16 (big blind) folded on the Flop
Seat 9: Effort92 folded before Flop (didn't bet)





PokerStars Hand #150803013835:  Hold'em No Limit ($1/$2 USD) - 2016/03/23 15:26:05 CET [2016/03/23 10:26:05 ET]
Table 'Kiess' 9-max Seat #7 is the button
Seat 1: Cirilico ($264.22 in chips) 
Seat 3: Red4erT ($101.04 in chips) 
Seat 4: RamiroAgujis ($200 in chips) 
Seat 5: chippo boy ($407.64 in chips) 
Seat 6: matiko09 ($248.48 in chips) 
Seat 7: chaps1988 ($200 in chips) 
Seat 8: erfk1958 ($134.05 in chips) 
erfk1958: posts small blind $1
PacPacBum: is sitting out 
Cirilico: posts big blind $2
jahwe: sits out 
chippo boy: posts small & big blinds $3
*** HOLE CARDS ***
Dealt to matiko09 [Js 2h]
Red4erT: folds 
RamiroAgujis: folds 
chippo boy: checks 
matiko09: folds 
chaps1988: folds 
erfk1958: folds 
Cirilico: checks 
*** FLOP *** [Kh 3c 4c]
Cirilico: checks 
chippo boy: checks 
*** TURN *** [Kh 3c 4c] [2d]
Cirilico: bets $4
chippo boy: folds 
Uncalled bet ($4) returned to Cirilico
Cirilico collected $5.73 from pot
Cirilico: doesn't show hand 
*** SUMMARY ***
Total pot $6 | Rake $0.27 
Board [Kh 3c 4c 2d]
Seat 1: Cirilico (big blind) collected ($5.73)
Seat 3: Red4erT folded before Flop (didn't bet)
Seat 4: RamiroAgujis folded before Flop (didn't bet)
Seat 5: chippo boy folded on the Turn
Seat 6: matiko09 folded before Flop (didn't bet)
Seat 7: chaps1988 (button) folded before Flop (didn't bet)
Seat 8: erfk1958 (small blind) folded before Flop





PokerStars Hand #150803013684:  Hold'em No Limit ($0.50/$1.00 USD) - 2016/03/23 15:26:05 CET [2016/03/23 10:26:05 ET]
Table 'Aetolia II' 9-max Seat #8 is the button
Seat 1: app1e_j@ck ($100 in chips) 
Seat 2: jahwe ($100 in chips) 
Seat 3: camilalope ($80 in chips) 
Seat 4: Pocketstud ($100 in chips) 
Seat 5: KingCastle77 ($82 in chips) 
Seat 6: Westpants ($100 in chips) 
Seat 7: matiko09 ($100 in chips) 
Seat 8: RICKA16 ($100 in chips) 
Seat 9: mmcardoulis ($60.73 in chips) 
mmcardoulis: posts small blind $0.50
app1e_j@ck: posts big blind $1
*** HOLE CARDS ***
Dealt to matiko09 [Kh 3c]
jahwe: folds 
camilalope: raises $1.50 to $2.50
Pocketstud: calls $2.50
KingCastle77: folds 
Westpants: folds 
matiko09: folds 
RICKA16: folds 
RICKA16 leaves the table
mmcardoulis: folds 
app1e_j@ck: calls $1.50
*** FLOP *** [6s 7h Js]
app1e_j@ck: checks 
camilalope: bets $2.75
Pocketstud: raises $2.75 to $5.50
app1e_j@ck: folds 
camilalope: calls $2.75
*** TURN *** [6s 7h Js] [2s]
camilalope: checks 
edidaz joins the table at seat #8 
Pocketstud: bets $10
edidaz leaves the table
camilalope: folds 
Uncalled bet ($10) returned to Pocketstud
Pocketstud collected $18.14 from pot
Pocketstud: doesn't show hand 
*** SUMMARY ***
Total pot $19 | Rake $0.86 
Board [6s 7h Js 2s]
Seat 1: app1e_j@ck (big blind) folded on the Flop
Seat 2: jahwe folded before Flop (didn't bet)
Seat 3: camilalope folded on the Turn
Seat 4: Pocketstud collected ($18.14)
Seat 5: KingCastle77 folded before Flop (didn't bet)
Seat 6: Westpants folded before Flop (didn't bet)
Seat 7: matiko09 folded before Flop (didn't bet)
Seat 8: RICKA16 (button) folded before Flop (didn't bet)
Seat 9: mmcardoulis (small blind) folded before Flop





PokerStars Hand #150803023063:  Hold'em No Limit ($0.50/$1.00 USD) - 2016/03/23 15:26:32 CET [2016/03/23 10:26:32 ET]
Table 'Smiley' 9-max Seat #4 is the button
Seat 1: xHourglass ($100 in chips) 
Seat 2: Jimy Tiltman ($116.24 in chips) 
Seat 3: Robert201202 ($134.04 in chips) 
Seat 4: CAJUN890 ($92.19 in chips) 
Seat 5: Szevasztopol ($149.35 in chips) 
Seat 6: blackmont111 ($146.04 in chips) 
Seat 7: bennetb77 ($48.50 in chips) 
Seat 8: matiko09 ($106.30 in chips) 
Seat 9: PacPacBum ($100 in chips) 
Szevasztopol: posts small blind $0.50
blackmont111: posts big blind $1
*** HOLE CARDS ***
Dealt to matiko09 [8h 3d]
bennetb77: folds 
matiko09: folds 
PacPacBum: folds 
xHourglass: folds 
Jimy Tiltman: folds 
Robert201202: raises $2 to $3
CAJUN890: folds 
Szevasztopol: raises $8 to $11
blackmont111: folds 
Robert201202: folds 
Uncalled bet ($8) returned to Szevasztopol
Szevasztopol collected $7 from pot
Szevasztopol: doesn't show hand 
*** SUMMARY ***
Total pot $7 | Rake $0 
Seat 1: xHourglass folded before Flop (didn't bet)
Seat 2: Jimy Tiltman folded before Flop (didn't bet)
Seat 3: Robert201202 folded before Flop
Seat 4: CAJUN890 (button) folded before Flop (didn't bet)
Seat 5: Szevasztopol (small blind) collected ($7)
Seat 6: blackmont111 (big blind) folded before Flop
Seat 7: bennetb77 folded before Flop (didn't bet)
Seat 8: matiko09 folded before Flop (didn't bet)
Seat 9: PacPacBum folded before Flop (didn't bet)





PokerStars Hand #150803032475:  Hold'em No Limit (€0.50/€1.00 EUR) - 2016/03/23 15:26:59 CET [2016/03/23 10:26:59 ET]
Table 'Mercury III' 9-max Seat #1 is the button
Seat 1: matiko09 (€114.58 in chips) 
Seat 2: jahwe (€100 in chips) 
Seat 4: Muinmyheart (€115.24 in chips) 
Seat 6: mycka86 (€100 in chips) 
Seat 7: STrakDD (€100 in chips) 
Seat 8: gfxed (€55.02 in chips) 
Seat 9: Indr3k (€100 in chips) 
jahwe: posts small blind €0.50
PacPacBum: is sitting out 
Muinmyheart: posts big blind €1
ardo888: sits out 
*** HOLE CARDS ***
Dealt to matiko09 [Kh Kd]
mycka86: folds 
STrakDD: folds 
gfxed: folds 
Indr3k: folds 
matiko09: raises €1.27 to €2.27
jahwe: folds 
Muinmyheart: calls €1.27
*** FLOP *** [Ks Ad 8h]
Muinmyheart: checks 
matiko09: bets €3.13
Muinmyheart: calls €3.13
*** TURN *** [Ks Ad 8h] [6s]
Muinmyheart: checks 
matiko09: bets €7.01
Muinmyheart: calls €7.01
*** RIVER *** [Ks Ad 8h 6s] [9s]
Muinmyheart: checks 
matiko09: bets €16
Muinmyheart: folds 
Uncalled bet (€16) returned to matiko09
matiko09 collected €24.18 from pot
matiko09: doesn't show hand 
*** SUMMARY ***
Total pot €25.32 | Rake €1.14 
Board [Ks Ad 8h 6s 9s]
Seat 1: matiko09 (button) collected (€24.18)
Seat 2: jahwe (small blind) folded before Flop
Seat 4: Muinmyheart (big blind) folded on the River
Seat 6: mycka86 folded before Flop (didn't bet)
Seat 7: STrakDD folded before Flop (didn't bet)
Seat 8: gfxed folded before Flop (didn't bet)
Seat 9: Indr3k folded before Flop (didn't bet)





PokerStars Hand #150803035045:  Hold'em No Limit ($0.50/$1.00 USD) - 2016/03/23 15:27:06 CET [2016/03/23 10:27:06 ET]
Table 'Smiley' 9-max Seat #5 is the button
Seat 1: xHourglass ($100 in chips) 
Seat 2: Jimy Tiltman ($116.24 in chips) 
Seat 3: Robert201202 ($131.04 in chips) 
Seat 4: CAJUN890 ($92.19 in chips) 
Seat 5: Szevasztopol ($153.35 in chips) 
Seat 6: blackmont111 ($145.04 in chips) 
Seat 7: bennetb77 ($48.50 in chips) 
Seat 8: matiko09 ($106.30 in chips) 
Seat 9: PacPacBum ($100 in chips) 
blackmont111: posts small blind $0.50
bennetb77: posts big blind $1
*** HOLE CARDS ***
Dealt to matiko09 [Td 4h]
matiko09: folds 
PacPacBum: folds 
xHourglass: folds 
Jimy Tiltman: folds 
Robert201202: folds 
CAJUN890: raises $3 to $4
Szevasztopol: folds 
blackmont111: calls $3.50
bennetb77: calls $3
*** FLOP *** [3c Kh 2d]
Robert201202 leaves the table
blackmont111: checks 
edidaz joins the table at seat #3 
bennetb77: checks 
edidaz leaves the table
CAJUN890: checks 
*** TURN *** [3c Kh 2d] [6h]
blackmont111: bets $6
bennetb77: calls $6
CAJUN890: folds 
*** RIVER *** [3c Kh 2d 6h] [6d]
blackmont111: bets $12
mycka86 joins the table at seat #3 
bennetb77: raises $18 to $30
blackmont111: folds 
Uncalled bet ($18) returned to bennetb77
bennetb77 collected $45.84 from pot
*** SUMMARY ***
Total pot $48 | Rake $2.16 
Board [3c Kh 2d 6h 6d]
Seat 1: xHourglass folded before Flop (didn't bet)
Seat 2: Jimy Tiltman folded before Flop (didn't bet)
Seat 3: Robert201202 folded before Flop (didn't bet)
Seat 4: CAJUN890 folded on the Turn
Seat 5: Szevasztopol (button) folded before Flop (didn't bet)
Seat 6: blackmont111 (small blind) folded on the River
Seat 7: bennetb77 (big blind) collected ($45.84)
Seat 8: matiko09 folded before Flop (didn't bet)
Seat 9: PacPacBum folded before Flop (didn't bet)





PokerStars Hand #150803034990:  Hold'em No Limit ($0.50/$1.00 USD) - 2016/03/23 15:27:06 CET [2016/03/23 10:27:06 ET]
Table 'Swings' 9-max Seat #6 is the button
Seat 1: lumen21 ($101.50 in chips) 
Seat 2: tomver0809 ($69.38 in chips) 
Seat 4: YuriiSolodya ($38.50 in chips) 
Seat 5: chautinhtri9 ($120.05 in chips) 
Seat 6: matiko09 ($138.42 in chips) 
Seat 8: RICKA16 ($107.68 in chips) 
Seat 9: Effort92 ($104.18 in chips) 
RICKA16: posts small blind $0.50
Effort92: posts big blind $1
*** HOLE CARDS ***
Dealt to matiko09 [9c 3h]
lumen21: folds 
tomver0809: calls $1
YuriiSolodya: folds 
chautinhtri9: calls $1
matiko09: folds 
RICKA16: folds 
Effort92: checks 
*** FLOP *** [Jc 8h Kh]
Effort92: checks 
tomver0809: bets $3
chautinhtri9: folds 
Effort92: folds 
Uncalled bet ($3) returned to tomver0809
tomver0809 collected $3.34 from pot
tomver0809: doesn't show hand 
*** SUMMARY ***
Total pot $3.50 | Rake $0.16 
Board [Jc 8h Kh]
Seat 1: lumen21 folded before Flop (didn't bet)
Seat 2: tomver0809 collected ($3.34)
Seat 4: YuriiSolodya folded before Flop (didn't bet)
Seat 5: chautinhtri9 folded on the Flop
Seat 6: matiko09 (button) folded before Flop (didn't bet)
Seat 8: RICKA16 (small blind) folded before Flop
Seat 9: Effort92 (big blind) folded on the Flop





PokerStars Hand #150803037504:  Hold'em No Limit ($0.50/$1.00 USD) - 2016/03/23 15:27:13 CET [2016/03/23 10:27:13 ET]
Table 'Drakonia II' 9-max Seat #1 is the button
Seat 1: chautinhtri9 ($127.60 in chips) 
Seat 2: carrsseis ($100 in chips) 
Seat 5: Muinmyheart ($103.25 in chips) 
Seat 6: Dantist1122 ($110.26 in chips) 
Seat 7: YuriiSolodya ($55.11 in chips) 
Seat 8: matiko09 ($100 in chips) 
Seat 9: mycka86 ($100.36 in chips) 
carrsseis: posts small blind $0.50
lumen21: is sitting out 
Muinmyheart: posts big blind $1
*** HOLE CARDS ***
Dealt to matiko09 [Ah Qc]
lumen21 leaves the table
Dantist1122: folds 
YuriiSolodya: folds 
matiko09: raises $2 to $3
Dantist1122 leaves the table
mycka86: folds 
Jimy Tiltman joins the table at seat #4 
chautinhtri9: folds 
carrsseis: folds 
PinkTrinta joins the table at seat #6 
Muinmyheart: folds 
Uncalled bet ($2) returned to matiko09
matiko09 collected $2.50 from pot
matiko09: doesn't show hand 
*** SUMMARY ***
Total pot $2.50 | Rake $0 
Seat 1: chautinhtri9 (button) folded before Flop (didn't bet)
Seat 2: carrsseis (small blind) folded before Flop
Seat 5: Muinmyheart (big blind) folded before Flop
Seat 6: Dantist1122 folded before Flop (didn't bet)
Seat 7: YuriiSolodya folded before Flop (didn't bet)
Seat 8: matiko09 collected ($2.50)
Seat 9: mycka86 folded before Flop (didn't bet)





PokerStars Hand #150803038007:  Hold'em No Limit ($0.50/$1.00 USD) - 2016/03/23 15:27:15 CET [2016/03/23 10:27:15 ET]
Table 'Sylvia III' 9-max Seat #2 is the button
Seat 1: mycka86 ($142 in chips) 
Seat 2: Dantist1122 ($106.80 in chips) 
Seat 3: se7en_$tars ($220.52 in chips) 
Seat 4: lombardo11 ($42.22 in chips) 
Seat 5: matiko09 ($100 in chips) 
Seat 6: PacPacBum ($100 in chips) 
Seat 7: easytalk777 ($65.57 in chips) 
Seat 8: Muinmyheart ($136.10 in chips) 
se7en_$tars: posts small blind $0.50
lombardo11: posts big blind $1
Jimy Tiltman: sits out 
mycka86: posts the ante $0.20
Dantist1122: posts the ante $0.20
se7en_$tars: posts the ante $0.20
lombardo11: posts the ante $0.20
matiko09: posts the ante $0.20
PacPacBum: posts the ante $0.20
easytalk777: posts the ante $0.20
Muinmyheart: posts the ante $0.20
*** HOLE CARDS ***
Dealt to matiko09 [4d As]
matiko09: folds 
PacPacBum: folds 
easytalk777: folds 
Muinmyheart: folds 
mycka86: raises $2 to $3
Dantist1122: raises $6 to $9
se7en_$tars: folds 
lombardo11: folds 
mycka86: folds 
Uncalled bet ($6) returned to Dantist1122
Dantist1122 collected $9.10 from pot
Dantist1122: doesn't show hand 
*** SUMMARY ***
Total pot $9.10 | Rake $0 
Seat 1: mycka86 folded before Flop
Seat 2: Dantist1122 (button) collected ($9.10)
Seat 3: se7en_$tars (small blind) folded before Flop
Seat 4: lombardo11 (big blind) folded before Flop
Seat 5: matiko09 folded before Flop (didn't bet)
Seat 6: PacPacBum folded before Flop (didn't bet)
Seat 7: easytalk777 folded before Flop (didn't bet)
Seat 8: Muinmyheart folded before Flop (didn't bet)





PokerStars Hand #150803040062:  Hold'em No Limit ($0.50/$1.00 USD) - 2016/03/23 15:27:20 CET [2016/03/23 10:27:20 ET]
Table 'Asmodeus' 9-max Seat #6 is the button
Seat 1: Jimy Tiltman ($146.45 in chips) 
Seat 2: PacPacBum ($103.49 in chips) 
Seat 3: jahwe ($103.42 in chips) 
Seat 4: Effort92 ($100 in chips) 
Seat 5: Muinmyheart ($100 in chips) 
Seat 6: fuppeee ($128.75 in chips) 
Seat 7: mycka86 ($120.45 in chips) 
Seat 9: matiko09 ($100 in chips) 
mycka86: posts small blind $0.50
bonifacioppl: is sitting out 
matiko09: posts big blind $1
Jimy Tiltman: posts the ante $0.20
PacPacBum: posts the ante $0.20
jahwe: posts the ante $0.20
Effort92: posts the ante $0.20
Muinmyheart: posts the ante $0.20
fuppeee: posts the ante $0.20
mycka86: posts the ante $0.20
matiko09: posts the ante $0.20
*** HOLE CARDS ***
Dealt to matiko09 [6c Qc]
bonifacioppl leaves the table
Jimy Tiltman: raises $2 to $3
PacPacBum: folds 
jahwe: folds 
Effort92: folds 
Muinmyheart: calls $3
fuppeee: folds 
mycka86: folds 
matiko09: folds 
*** FLOP *** [8s Qh 5s]
Jimy Tiltman: checks 
edidaz joins the table at seat #8 
Muinmyheart: checks 
*** TURN *** [8s Qh 5s] [2s]
edidaz leaves the table
Jimy Tiltman: checks 
app1e_j@ck joins the table at seat #8 
Muinmyheart: checks 
*** RIVER *** [8s Qh 5s 2s] [Jh]
Jimy Tiltman: checks 
Muinmyheart: checks 
*** SHOW DOWN ***
Jimy Tiltman: shows [Ks Ad] (high card Ace)
Muinmyheart: shows [3s 3d] (a pair of Threes)
Muinmyheart collected $8.69 from pot
*** SUMMARY ***
Total pot $9.10 | Rake $0.41 
Board [8s Qh 5s 2s Jh]
Seat 1: Jimy Tiltman showed [Ks Ad] and lost with high card Ace
Seat 2: PacPacBum folded before Flop (didn't bet)
Seat 3: jahwe folded before Flop (didn't bet)
Seat 4: Effort92 folded before Flop (didn't bet)
Seat 5: Muinmyheart showed [3s 3d] and won ($8.69) with a pair of Threes
Seat 6: fuppeee (button) folded before Flop (didn't bet)
Seat 7: mycka86 (small blind) folded before Flop
Seat 9: matiko09 (big blind) folded before Flop





PokerStars Hand #150803045743:  Hold'em No Limit ($1/$2 USD) - 2016/03/23 15:27:37 CET [2016/03/23 10:27:37 ET]
Table 'Kiess' 9-max Seat #8 is the button
Seat 1: Cirilico ($267.95 in chips) 
Seat 2: jahwe ($200 in chips) 
Seat 3: Red4erT ($101.04 in chips) 
Seat 4: RamiroAgujis ($200 in chips) 
Seat 5: chippo boy ($404.64 in chips) 
Seat 6: matiko09 ($248.48 in chips) 
Seat 7: chaps1988 ($200 in chips) 
Seat 8: erfk1958 ($133.05 in chips) 
Cirilico: posts small blind $1
jahwe: posts big blind $2
*** HOLE CARDS ***
Dealt to matiko09 [Td Js]
Red4erT: raises $3 to $5
RamiroAgujis: folds 
chippo boy: calls $5
matiko09: folds 
chaps1988: folds 
erfk1958: folds 
Cirilico: folds 
jahwe: folds 
*** FLOP *** [5s 3c Kd]
Red4erT: bets $6.45
chippo boy: calls $6.45
*** TURN *** [5s 3c Kd] [Ts]
Red4erT: bets $18.55
chippo boy: calls $18.55
*** RIVER *** [5s 3c Kd Ts] [5d]
Red4erT: checks 
chippo boy: checks 
*** SHOW DOWN ***
Red4erT: shows [Qs Ac] (a pair of Fives)
chippo boy: shows [Tc As] (two pair, Tens and Fives)
chippo boy collected $60.20 from pot
*** SUMMARY ***
Total pot $63 | Rake $2.80 
Board [5s 3c Kd Ts 5d]
Seat 1: Cirilico (small blind) folded before Flop
Seat 2: jahwe (big blind) folded before Flop
Seat 3: Red4erT showed [Qs Ac] and lost with a pair of Fives
Seat 4: RamiroAgujis folded before Flop (didn't bet)
Seat 5: chippo boy showed [Tc As] and won ($60.20) with two pair, Tens and Fives
Seat 6: matiko09 folded before Flop (didn't bet)
Seat 7: chaps1988 folded before Flop (didn't bet)
Seat 8: erfk1958 (button) folded before Flop (didn't bet)





PokerStars Hand #150803046079:  Hold'em No Limit ($0.50/$1.00 USD) - 2016/03/23 15:27:38 CET [2016/03/23 10:27:38 ET]
Table 'Drakonia II' 9-max Seat #2 is the button
Seat 1: chautinhtri9 ($127.60 in chips) 
Seat 2: carrsseis ($100 in chips) 
Seat 5: Muinmyheart ($102.25 in chips) 
Seat 6: PinkTrinta ($100 in chips) 
Seat 7: YuriiSolodya ($55.11 in chips) 
Seat 8: matiko09 ($101.50 in chips) 
Seat 9: mycka86 ($100.36 in chips) 
Jimy Tiltman will be allowed to play after the button
Muinmyheart: posts small blind $0.50
PinkTrinta: posts big blind $1
*** HOLE CARDS ***
Dealt to matiko09 [6h 8s]
YuriiSolodya: folds 
matiko09: folds 
mycka86: raises $1.50 to $2.50
chautinhtri9: folds 
carrsseis: folds 
Muinmyheart: folds 
PinkTrinta: folds 
Uncalled bet ($1.50) returned to mycka86
mycka86 collected $2.50 from pot
*** SUMMARY ***
Total pot $2.50 | Rake $0 
Seat 1: chautinhtri9 folded before Flop (didn't bet)
Seat 2: carrsseis (button) folded before Flop (didn't bet)
Seat 5: Muinmyheart (small blind) folded before Flop
Seat 6: PinkTrinta (big blind) folded before Flop
Seat 7: YuriiSolodya folded before Flop (didn't bet)
Seat 8: matiko09 folded before Flop (didn't bet)
Seat 9: mycka86 collected ($2.50)





PokerStars Hand #150803052003:  Hold'em No Limit ($0.50/$1.00 USD) - 2016/03/23 15:27:55 CET [2016/03/23 10:27:55 ET]
Table 'Drakonia II' 9-max Seat #5 is the button
Seat 1: chautinhtri9 ($127.60 in chips) 
Seat 2: carrsseis ($100 in chips) 
Seat 5: Muinmyheart ($101.75 in chips) 
Seat 6: PinkTrinta ($100 in chips) 
Seat 7: YuriiSolodya ($55.11 in chips) 
Seat 8: matiko09 ($101.50 in chips) 
Seat 9: mycka86 ($101.86 in chips) 
PinkTrinta: posts small blind $0.50
YuriiSolodya: posts big blind $1
Jimy Tiltman: sits out 
*** HOLE CARDS ***
Dealt to matiko09 [Kd 9c]
matiko09: folds 
mycka86: folds 
chautinhtri9: folds 
carrsseis: folds 
Muinmyheart: raises $1.50 to $2.50
PinkTrinta: folds 
YuriiSolodya: folds 
Uncalled bet ($1.50) returned to Muinmyheart
Muinmyheart collected $2.50 from pot
Muinmyheart: doesn't show hand 
*** SUMMARY ***
Total pot $2.50 | Rake $0 
Seat 1: chautinhtri9 folded before Flop (didn't bet)
Seat 2: carrsseis folded before Flop (didn't bet)
Seat 5: Muinmyheart (button) collected ($2.50)
Seat 6: PinkTrinta (small blind) folded before Flop
Seat 7: YuriiSolodya (big blind) folded before Flop
Seat 8: matiko09 folded before Flop (didn't bet)
Seat 9: mycka86 folded before Flop (didn't bet)





PokerStars Hand #150803053519:  Hold'em No Limit (€1/€2 EUR) - 2016/03/23 15:27:59 CET [2016/03/23 10:27:59 ET]
Table 'Malva II' 9-max Seat #3 is the button
Seat 1: PacPacBum (€246.63 in chips) 
Seat 2: IseeUcards (€200 in chips) 
Seat 3: matiko09 (€259.85 in chips) 
Seat 4: steff0777 (€204 in chips) 
Seat 5: o.miro (€356.35 in chips) 
Seat 6: volwebni4ek (€80 in chips) 
Seat 7: rivesald (€106.43 in chips) 
Seat 8: T0ny Adams (€82.20 in chips) 
Seat 9: RamiroAgujis (€216.23 in chips) 
steff0777: posts small blind €1
o.miro: posts big blind €2
*** HOLE CARDS ***
Dealt to matiko09 [5c Th]
volwebni4ek: folds 
rivesald: folds 
T0ny Adams: raises €3 to €5
RamiroAgujis: folds 
PacPacBum: folds 
IseeUcards: folds 
matiko09: folds 
rivesald leaves the table
steff0777: raises €11 to €16
nairolf24 joins the table at seat #7 
o.miro: folds 
T0ny Adams: folds 
Uncalled bet (€11) returned to steff0777
steff0777 collected €12 from pot
steff0777: doesn't show hand 
*** SUMMARY ***
Total pot €12 | Rake €0 
Seat 1: PacPacBum folded before Flop (didn't bet)
Seat 2: IseeUcards folded before Flop (didn't bet)
Seat 3: matiko09 (button) folded before Flop (didn't bet)
Seat 4: steff0777 (small blind) collected (€12)
Seat 5: o.miro (big blind) folded before Flop
Seat 6: volwebni4ek folded before Flop (didn't bet)
Seat 7: rivesald folded before Flop (didn't bet)
Seat 8: T0ny Adams folded before Flop
Seat 9: RamiroAgujis folded before Flop (didn't bet)





PokerStars Hand #150803058855:  Hold'em No Limit ($0.50/$1.00 USD) - 2016/03/23 15:28:14 CET [2016/03/23 10:28:14 ET]
Table 'Sylvia III' 9-max Seat #3 is the button
Seat 1: mycka86 ($138.80 in chips) 
Seat 2: Dantist1122 ($112.70 in chips) 
Seat 3: se7en_$tars ($219.82 in chips) 
Seat 4: lombardo11 ($41.02 in chips) 
Seat 5: matiko09 ($100 in chips) 
Seat 6: PacPacBum ($100 in chips) 
Seat 7: easytalk777 ($65.37 in chips) 
Seat 8: Muinmyheart ($135.90 in chips) 
lombardo11: posts small blind $0.50
matiko09: posts big blind $1
Jimy Tiltman: sits out 
mycka86: posts the ante $0.20
Dantist1122: posts the ante $0.20
se7en_$tars: posts the ante $0.20
lombardo11: posts the ante $0.20
matiko09: posts the ante $0.20
PacPacBum: posts the ante $0.20
easytalk777: posts the ante $0.20
Muinmyheart: posts the ante $0.20
*** HOLE CARDS ***
Dealt to matiko09 [Qs 5c]
PacPacBum: folds 
easytalk777: raises $1 to $2
Muinmyheart: folds 
mycka86: folds 
Dantist1122: folds 
se7en_$tars: calls $2
lombardo11: folds 
matiko09: folds 
*** FLOP *** [Th 3d Jd]
easytalk777: bets $5
se7en_$tars: folds 
Uncalled bet ($5) returned to easytalk777
easytalk777 collected $6.78 from pot
easytalk777: doesn't show hand 
*** SUMMARY ***
Total pot $7.10 | Rake $0.32 
Board [Th 3d Jd]
Seat 1: mycka86 folded before Flop (didn't bet)
Seat 2: Dantist1122 folded before Flop (didn't bet)
Seat 3: se7en_$tars (button) folded on the Flop
Seat 4: lombardo11 (small blind) folded before Flop
Seat 5: matiko09 (big blind) folded before Flop
Seat 6: PacPacBum folded before Flop (didn't bet)
Seat 7: easytalk777 collected ($6.78)
Seat 8: Muinmyheart folded before Flop (didn't bet)





PokerStars Hand #150803060042:  Hold'em No Limit ($0.50/$1.00 USD) - 2016/03/23 15:28:18 CET [2016/03/23 10:28:18 ET]
Table 'Aetolia II' 9-max Seat #9 is the button
Seat 1: app1e_j@ck ($100 in chips) 
Seat 2: jahwe ($100 in chips) 
Seat 3: camilalope ($72 in chips) 
Seat 4: Pocketstud ($110.14 in chips) 
Seat 5: KingCastle77 ($82 in chips) 
Seat 6: Westpants ($100 in chips) 
Seat 7: matiko09 ($100 in chips) 
Seat 9: mmcardoulis ($60.23 in chips) 
app1e_j@ck: posts small blind $0.50
jahwe: posts big blind $1
*** HOLE CARDS ***
Dealt to matiko09 [Ac Js]
PacPacBum joins the table at seat #8 
camilalope: folds 
camilalope leaves the table
Pocketstud: folds 
KingCastle77: calls $1
Westpants: folds 
matiko09: raises $3 to $4
mmcardoulis: folds 
app1e_j@ck: folds 
jahwe: folds 
KingCastle77: raises $3 to $7
matiko09: calls $3
*** FLOP *** [Qh 5s 8d]
KingCastle77: bets $9.86
matiko09: folds 
Uncalled bet ($9.86) returned to KingCastle77
KingCastle77 collected $14.80 from pot
KingCastle77: doesn't show hand 
*** SUMMARY ***
Total pot $15.50 | Rake $0.70 
Board [Qh 5s 8d]
Seat 1: app1e_j@ck (small blind) folded before Flop
Seat 2: jahwe (big blind) folded before Flop
Seat 3: camilalope folded before Flop (didn't bet)
Seat 4: Pocketstud folded before Flop (didn't bet)
Seat 5: KingCastle77 collected ($14.80)
Seat 6: Westpants folded before Flop (didn't bet)
Seat 7: matiko09 folded on the Flop
Seat 9: mmcardoulis (button) folded before Flop (didn't bet)





PokerStars Hand #150803062828:  Hold'em No Limit ($0.50/$1.00 USD) - 2016/03/23 15:28:26 CET [2016/03/23 10:28:26 ET]
Table 'Drakonia II' 9-max Seat #6 is the button
Seat 1: chautinhtri9 ($127.60 in chips) 
Seat 2: carrsseis ($100 in chips) 
Seat 5: Muinmyheart ($103.25 in chips) 
Seat 6: PinkTrinta ($100 in chips) 
Seat 7: YuriiSolodya ($54.11 in chips) 
Seat 8: matiko09 ($101.50 in chips) 
Seat 9: mycka86 ($101.86 in chips) 
YuriiSolodya: posts small blind $0.50
matiko09: posts big blind $1
Jimy Tiltman: sits out 
*** HOLE CARDS ***
Dealt to matiko09 [5h 9s]
mycka86: raises $2 to $3
chautinhtri9: folds 
carrsseis: folds 
Muinmyheart: folds 
PinkTrinta: folds 
YuriiSolodya: folds 
matiko09: folds 
Uncalled bet ($2) returned to mycka86
mycka86 collected $2.50 from pot
*** SUMMARY ***
Total pot $2.50 | Rake $0 
Seat 1: chautinhtri9 folded before Flop (didn't bet)
Seat 2: carrsseis folded before Flop (didn't bet)
Seat 5: Muinmyheart folded before Flop (didn't bet)
Seat 6: PinkTrinta (button) folded before Flop (didn't bet)
Seat 7: YuriiSolodya (small blind) folded before Flop
Seat 8: matiko09 (big blind) folded before Flop
Seat 9: mycka86 collected ($2.50)





PokerStars Hand #150803063172:  Hold'em No Limit ($0.50/$1.00 USD) - 2016/03/23 15:28:27 CET [2016/03/23 10:28:27 ET]
Table 'Swings' 9-max Seat #8 is the button
Seat 1: lumen21 ($101.50 in chips) 
Seat 2: tomver0809 ($71.72 in chips) 
Seat 4: YuriiSolodya ($38.50 in chips) 
Seat 5: chautinhtri9 ($119.05 in chips) 
Seat 6: matiko09 ($138.42 in chips) 
Seat 8: RICKA16 ($107.18 in chips) 
Seat 9: Effort92 ($103.18 in chips) 
Effort92: posts small blind $0.50
lumen21: posts big blind $1
*** HOLE CARDS ***
Dealt to matiko09 [4h Jd]
tomver0809: calls $1
YuriiSolodya: calls $1
chautinhtri9: folds 
matiko09: folds 
RICKA16: folds 
Effort92: calls $0.50
lumen21: checks 
*** FLOP *** [9h Ad 4d]
Effort92: checks 
lumen21: checks 
tomver0809: bets $4
YuriiSolodya: folds 
Effort92: folds 
lumen21: calls $4
*** TURN *** [9h Ad 4d] [9c]
lumen21: checks 
tomver0809: checks 
*** RIVER *** [9h Ad 4d 9c] [2h]
lumen21: checks 
tomver0809: bets $10
lumen21: calls $10
*** SHOW DOWN ***
tomver0809: shows [As 4s] (two pair, Aces and Nines)
lumen21: shows [Ac 2d] (two pair, Aces and Nines)
lumen21 collected $15.28 from pot
tomver0809 collected $15.28 from pot
*** SUMMARY ***
Total pot $32 | Rake $1.44 
Board [9h Ad 4d 9c 2h]
Seat 1: lumen21 (big blind) showed [Ac 2d] and won ($15.28) with two pair, Aces and Nines
Seat 2: tomver0809 showed [As 4s] and won ($15.28) with two pair, Aces and Nines
Seat 4: YuriiSolodya folded on the Flop
Seat 5: chautinhtri9 folded before Flop (didn't bet)
Seat 6: matiko09 folded before Flop (didn't bet)
Seat 8: RICKA16 (button) folded before Flop (didn't bet)
Seat 9: Effort92 (small blind) folded on the Flop





PokerStars Hand #150803064434:  Hold'em No Limit ($0.50/$1.00 USD) - 2016/03/23 15:28:30 CET [2016/03/23 10:28:30 ET]
Table 'Asmodeus' 9-max Seat #7 is the button
Seat 1: Jimy Tiltman ($143.25 in chips) 
Seat 2: PacPacBum ($103.29 in chips) 
Seat 3: jahwe ($103.22 in chips) 
Seat 4: Effort92 ($100 in chips) 
Seat 5: Muinmyheart ($105.49 in chips) 
Seat 6: fuppeee ($128.55 in chips) 
Seat 7: mycka86 ($119.75 in chips) 
Seat 9: matiko09 ($100 in chips) 
app1e_j@ck will be allowed to play after the button
matiko09: posts small blind $0.50
Jimy Tiltman: posts big blind $1
Jimy Tiltman: posts the ante $0.20
PacPacBum: posts the ante $0.20
jahwe: posts the ante $0.20
Effort92: posts the ante $0.20
Muinmyheart: posts the ante $0.20
fuppeee: posts the ante $0.20
mycka86: posts the ante $0.20
matiko09: posts the ante $0.20
*** HOLE CARDS ***
Dealt to matiko09 [3h 4d]
PacPacBum: folds 
jahwe: raises $1.50 to $2.50
Effort92: folds 
Muinmyheart: folds 
fuppeee: folds 
mycka86: folds 
matiko09: folds 
Jimy Tiltman: folds 
Uncalled bet ($1.50) returned to jahwe
jahwe collected $4.10 from pot
jahwe: doesn't show hand 
*** SUMMARY ***
Total pot $4.10 | Rake $0 
Seat 1: Jimy Tiltman (big blind) folded before Flop
Seat 2: PacPacBum folded before Flop (didn't bet)
Seat 3: jahwe collected ($4.10)
Seat 4: Effort92 folded before Flop (didn't bet)
Seat 5: Muinmyheart folded before Flop (didn't bet)
Seat 6: fuppeee folded before Flop (didn't bet)
Seat 7: mycka86 (button) folded before Flop (didn't bet)
Seat 9: matiko09 (small blind) folded before Flop





PokerStars Hand #150803066676:  Hold'em No Limit (€0.50/€1.00 EUR) - 2016/03/23 15:28:37 CET [2016/03/23 10:28:37 ET]
Table 'Mercury III' 9-max Seat #2 is the button
Seat 1: matiko09 (€126.35 in chips) 
Seat 2: jahwe (€100 in chips) 
Seat 4: Muinmyheart (€102.83 in chips) 
Seat 5: ardo888 (€100 in chips) 
Seat 6: mycka86 (€100 in chips) 
Seat 7: STrakDD (€100 in chips) 
Seat 8: gfxed (€55.02 in chips) 
Seat 9: Indr3k (€100 in chips) 
Muinmyheart: posts small blind €0.50
ardo888: posts big blind €1
*** HOLE CARDS ***
Dealt to matiko09 [Kh 8c]
mycka86: folds 
STrakDD: folds 
gfxed: folds 
Indr3k: folds 
matiko09: folds 
jahwe: folds 
Muinmyheart: raises €2 to €3
ardo888: raises €6 to €9
Muinmyheart: folds 
Uncalled bet (€6) returned to ardo888
ardo888 collected €6 from pot
ardo888: doesn't show hand 
*** SUMMARY ***
Total pot €6 | Rake €0 
Seat 1: matiko09 folded before Flop (didn't bet)
Seat 2: jahwe (button) folded before Flop (didn't bet)
Seat 4: Muinmyheart (small blind) folded before Flop
Seat 5: ardo888 (big blind) collected (€6)
Seat 6: mycka86 folded before Flop (didn't bet)
Seat 7: STrakDD folded before Flop (didn't bet)
Seat 8: gfxed folded before Flop (didn't bet)
Seat 9: Indr3k folded before Flop (didn't bet)





PokerStars Hand #150803069067:  Hold'em No Limit ($0.50/$1.00 USD) - 2016/03/23 15:28:44 CET [2016/03/23 10:28:44 ET]
Table 'Drakonia II' 9-max Seat #7 is the button
Seat 1: chautinhtri9 ($127.60 in chips) 
Seat 2: carrsseis ($100 in chips) 
Seat 5: Muinmyheart ($103.25 in chips) 
Seat 6: PinkTrinta ($100 in chips) 
Seat 7: YuriiSolodya ($53.61 in chips) 
Seat 8: matiko09 ($100.50 in chips) 
Seat 9: mycka86 ($103.36 in chips) 
matiko09: posts small blind $0.50
mycka86: posts big blind $1
Jimy Tiltman: sits out 
*** HOLE CARDS ***
Dealt to matiko09 [Qs 6s]
chautinhtri9: folds 
carrsseis: folds 
Muinmyheart: folds 
PinkTrinta: folds 
YuriiSolodya: raises $3 to $4
matiko09: folds 
mycka86: folds 
Uncalled bet ($3) returned to YuriiSolodya
YuriiSolodya collected $2.50 from pot
YuriiSolodya: doesn't show hand 
*** SUMMARY ***
Total pot $2.50 | Rake $0 
Seat 1: chautinhtri9 folded before Flop (didn't bet)
Seat 2: carrsseis folded before Flop (didn't bet)
Seat 5: Muinmyheart folded before Flop (didn't bet)
Seat 6: PinkTrinta folded before Flop (didn't bet)
Seat 7: YuriiSolodya (button) collected ($2.50)
Seat 8: matiko09 (small blind) folded before Flop
Seat 9: mycka86 (big blind) folded before Flop





PokerStars Hand #150803072181:  Hold'em No Limit (€1/€2 EUR) - 2016/03/23 15:28:53 CET [2016/03/23 10:28:53 ET]
Table 'Malva II' 9-max Seat #4 is the button
Seat 1: PacPacBum (€246.63 in chips) 
Seat 2: IseeUcards (€200 in chips) 
Seat 3: matiko09 (€259.85 in chips) 
Seat 4: steff0777 (€211 in chips) 
Seat 5: o.miro (€354.35 in chips) 
Seat 6: volwebni4ek (€80 in chips) 
Seat 8: T0ny Adams (€77.20 in chips) 
Seat 9: RamiroAgujis (€216.23 in chips) 
o.miro: posts small blind €1
volwebni4ek: posts big blind €2
nairolf24: sits out 
*** HOLE CARDS ***
Dealt to matiko09 [2c 3h]
T0ny Adams: folds 
RamiroAgujis: folds 
PacPacBum: folds 
IseeUcards: folds 
matiko09: folds 
steff0777: folds 
o.miro: folds 
Uncalled bet (€1) returned to volwebni4ek
volwebni4ek collected €2 from pot
volwebni4ek: doesn't show hand 
*** SUMMARY ***
Total pot €2 | Rake €0 
Seat 1: PacPacBum folded before Flop (didn't bet)
Seat 2: IseeUcards folded before Flop (didn't bet)
Seat 3: matiko09 folded before Flop (didn't bet)
Seat 4: steff0777 (button) folded before Flop (didn't bet)
Seat 5: o.miro (small blind) folded before Flop
Seat 6: volwebni4ek (big blind) collected (€2)
Seat 8: T0ny Adams folded before Flop (didn't bet)
Seat 9: RamiroAgujis folded before Flop (didn't bet)





PokerStars Hand #150803072146:  Hold'em No Limit ($0.50/$1.00 USD) - 2016/03/23 15:28:53 CET [2016/03/23 10:28:53 ET]
Table 'Sylvia III' 9-max Seat #4 is the button
Seat 1: mycka86 ($138.60 in chips) 
Seat 2: Dantist1122 ($112.50 in chips) 
Seat 3: se7en_$tars ($217.62 in chips) 
Seat 4: lombardo11 ($40.32 in chips) 
Seat 5: matiko09 ($100 in chips) 
Seat 8: Muinmyheart ($135.70 in chips) 
matiko09: posts small blind $0.50
PacPacBum: is sitting out 
Muinmyheart: posts big blind $1
Jimy Tiltman: sits out 
mycka86: posts the ante $0.20
Dantist1122: posts the ante $0.20
se7en_$tars: posts the ante $0.20
lombardo11: posts the ante $0.20
matiko09: posts the ante $0.20
Muinmyheart: posts the ante $0.20
*** HOLE CARDS ***
Dealt to matiko09 [5s 3c]
mycka86: folds 
easytalk777 leaves the table
Dantist1122: folds 
jahwe joins the table at seat #7 
se7en_$tars: calls $1
lombardo11: raises $2 to $3
matiko09: folds 
Muinmyheart: folds 
se7en_$tars: calls $2
*** FLOP *** [Ks Kh 2s]
se7en_$tars: checks 
lombardo11: checks 
*** TURN *** [Ks Kh 2s] [3h]
se7en_$tars: bets $4
lombardo11: calls $4
*** RIVER *** [Ks Kh 2s 3h] [Jh]
se7en_$tars: checks 
lombardo11: bets $7
se7en_$tars: folds 
Uncalled bet ($7) returned to lombardo11
lombardo11 collected $15.95 from pot
lombardo11: doesn't show hand 
*** SUMMARY ***
Total pot $16.70 | Rake $0.75 
Board [Ks Kh 2s 3h Jh]
Seat 1: mycka86 folded before Flop (didn't bet)
Seat 2: Dantist1122 folded before Flop (didn't bet)
Seat 3: se7en_$tars folded on the River
Seat 4: lombardo11 (button) collected ($15.95)
Seat 5: matiko09 (small blind) folded before Flop
Seat 8: Muinmyheart (big blind) folded before Flop





PokerStars Hand #150803073446:  Hold'em No Limit ($0.50/$1.00 USD) - 2016/03/23 15:28:56 CET [2016/03/23 10:28:56 ET]
Table 'Asmodeus' 9-max Seat #9 is the button
Seat 1: Jimy Tiltman ($142.05 in chips) 
Seat 3: jahwe ($106.12 in chips) 
Seat 4: Effort92 ($100 in chips) 
Seat 5: Muinmyheart ($105.29 in chips) 
Seat 6: fuppeee ($128.35 in chips) 
Seat 7: mycka86 ($119.55 in chips) 
Seat 9: matiko09 ($100 in chips) 
Jimy Tiltman: posts small blind $0.50
PacPacBum: is sitting out 
jahwe: posts big blind $1
app1e_j@ck: sits out 
Jimy Tiltman: posts the ante $0.20
jahwe: posts the ante $0.20
Effort92: posts the ante $0.20
Muinmyheart: posts the ante $0.20
fuppeee: posts the ante $0.20
mycka86: posts the ante $0.20
matiko09: posts the ante $0.20
*** HOLE CARDS ***
Dealt to matiko09 [Ah 4h]
Effort92: raises $2 to $3
Muinmyheart: folds 
fuppeee: raises $8.90 to $11.90
mycka86: folds 
matiko09: folds 
Jimy Tiltman: folds 
jahwe: folds 
Effort92: folds 
Uncalled bet ($8.90) returned to fuppeee
fuppeee collected $8.90 from pot
*** SUMMARY ***
Total pot $8.90 | Rake $0 
Seat 1: Jimy Tiltman (small blind) folded before Flop
Seat 3: jahwe (big blind) folded before Flop
Seat 4: Effort92 folded before Flop
Seat 5: Muinmyheart folded before Flop (didn't bet)
Seat 6: fuppeee collected ($8.90)
Seat 7: mycka86 folded before Flop (didn't bet)
Seat 9: matiko09 (button) folded before Flop (didn't bet)





PokerStars Hand #150803076682:  Hold'em No Limit ($1/$2 USD) - 2016/03/23 15:29:05 CET [2016/03/23 10:29:05 ET]
Table 'Kiess' 9-max Seat #1 is the button
Seat 1: Cirilico ($266.95 in chips) 
Seat 2: jahwe ($200 in chips) 
Seat 3: Red4erT ($80 in chips) 
Seat 4: RamiroAgujis ($200 in chips) 
Seat 5: chippo boy ($434.84 in chips) 
Seat 6: matiko09 ($248.48 in chips) 
Seat 7: chaps1988 ($200 in chips) 
Seat 8: erfk1958 ($133.05 in chips) 
jahwe: posts small blind $1
Red4erT: posts big blind $2
*** HOLE CARDS ***
Dealt to matiko09 [4d 9c]
RamiroAgujis: folds 
chippo boy: calls $2
matiko09: folds 
chaps1988: raises $5 to $7
erfk1958: folds 
Cirilico: folds 
jahwe: folds 
Red4erT: folds 
chippo boy: calls $5
*** FLOP *** [Qc 3c 4s]
chippo boy: checks 
chaps1988: bets $8.12
chippo boy: folds 
Uncalled bet ($8.12) returned to chaps1988
chaps1988 collected $16.24 from pot
chaps1988: doesn't show hand 
*** SUMMARY ***
Total pot $17 | Rake $0.76 
Board [Qc 3c 4s]
Seat 1: Cirilico (button) folded before Flop (didn't bet)
Seat 2: jahwe (small blind) folded before Flop
Seat 3: Red4erT (big blind) folded before Flop
Seat 4: RamiroAgujis folded before Flop (didn't bet)
Seat 5: chippo boy folded on the Flop
Seat 6: matiko09 folded before Flop (didn't bet)
Seat 7: chaps1988 collected ($16.24)
Seat 8: erfk1958 folded before Flop (didn't bet)





PokerStars Hand #150803077600:  Hold'em No Limit ($0.50/$1.00 USD) - 2016/03/23 15:29:08 CET [2016/03/23 10:29:08 ET]
Table 'Drakonia II' 9-max Seat #8 is the button
Seat 1: chautinhtri9 ($127.60 in chips) 
Seat 2: carrsseis ($100 in chips) 
Seat 5: Muinmyheart ($103.25 in chips) 
Seat 6: PinkTrinta ($100 in chips) 
Seat 7: YuriiSolodya ($55.11 in chips) 
Seat 8: matiko09 ($100 in chips) 
Seat 9: mycka86 ($102.36 in chips) 
mycka86: posts small blind $0.50
chautinhtri9: posts big blind $1
Jimy Tiltman: sits out 
*** HOLE CARDS ***
Dealt to matiko09 [6c 5s]
carrsseis: folds 
carrsseis leaves the table
Muinmyheart: folds 
PinkTrinta: folds 
YuriiSolodya: folds 
matiko09: folds 
RICKA16 joins the table at seat #2 
mycka86: folds 
Uncalled bet ($0.50) returned to chautinhtri9
chautinhtri9 collected $1 from pot
chautinhtri9: doesn't show hand 
*** SUMMARY ***
Total pot $1 | Rake $0 
Seat 1: chautinhtri9 (big blind) collected ($1)
Seat 2: carrsseis folded before Flop (didn't bet)
Seat 5: Muinmyheart folded before Flop (didn't bet)
Seat 6: PinkTrinta folded before Flop (didn't bet)
Seat 7: YuriiSolodya folded before Flop (didn't bet)
Seat 8: matiko09 (button) folded before Flop (didn't bet)
Seat 9: mycka86 (small blind) folded before Flop





PokerStars Hand #150803078610:  Hold'em No Limit ($0.50/$1.00 USD) - 2016/03/23 15:29:11 CET [2016/03/23 10:29:11 ET]
Table 'Smiley' 9-max Seat #6 is the button
Seat 1: xHourglass ($100 in chips) 
Seat 2: Jimy Tiltman ($116.24 in chips) 
Seat 4: CAJUN890 ($88.19 in chips) 
Seat 5: Szevasztopol ($153.35 in chips) 
Seat 6: blackmont111 ($123.04 in chips) 
Seat 7: bennetb77 ($72.34 in chips) 
Seat 8: matiko09 ($106.30 in chips) 
Seat 9: PacPacBum ($100 in chips) 
bennetb77: posts small blind $0.50
matiko09: posts big blind $1
mycka86: sits out 
*** HOLE CARDS ***
Dealt to matiko09 [Js Jc]
PacPacBum has timed out
PacPacBum: folds 
xHourglass: folds 
Jimy Tiltman: folds 
CAJUN890: folds 
Szevasztopol: raises $2 to $3
blackmont111: folds 
bennetb77: folds 
matiko09: calls $2
*** FLOP *** [9s Kc 9c]
matiko09: checks 
Szevasztopol: checks 
*** TURN *** [9s Kc 9c] [Qh]
matiko09: checks 
Szevasztopol: checks 
*** RIVER *** [9s Kc 9c Qh] [Qc]
matiko09: checks 
Szevasztopol: checks 
*** SHOW DOWN ***
matiko09: shows [Js Jc] (two pair, Queens and Jacks)
Szevasztopol: mucks hand 
matiko09 collected $6.21 from pot
*** SUMMARY ***
Total pot $6.50 | Rake $0.29 
Board [9s Kc 9c Qh Qc]
Seat 1: xHourglass folded before Flop (didn't bet)
Seat 2: Jimy Tiltman folded before Flop (didn't bet)
Seat 4: CAJUN890 folded before Flop (didn't bet)
Seat 5: Szevasztopol mucked [6s 6c]
Seat 6: blackmont111 (button) folded before Flop (didn't bet)
Seat 7: bennetb77 (small blind) folded before Flop
Seat 8: matiko09 (big blind) showed [Js Jc] and won ($6.21) with two pair, Queens and Jacks
Seat 9: PacPacBum folded before Flop (didn't bet)





PokerStars Hand #150803084987:  Hold'em No Limit ($0.50/$1.00 USD) - 2016/03/23 15:29:29 CET [2016/03/23 10:29:29 ET]
Table 'Aetolia II' 9-max Seat #1 is the button
Seat 1: app1e_j@ck ($100 in chips) 
Seat 2: jahwe ($100 in chips) 
Seat 4: Pocketstud ($110.14 in chips) 
Seat 5: KingCastle77 ($89.80 in chips) 
Seat 6: Westpants ($100 in chips) 
Seat 7: matiko09 ($100 in chips) 
Seat 9: mmcardoulis ($60.23 in chips) 
jahwe: posts small blind $0.50
Pocketstud: posts big blind $1
*** HOLE CARDS ***
Dealt to matiko09 [As 6h]
stds st joins the table at seat #3 
KingCastle77: raises $2 to $3
Westpants: folds 
matiko09: folds 
mmcardoulis: folds 
app1e_j@ck: folds 
jahwe: folds 
Pocketstud: folds 
Uncalled bet ($2) returned to KingCastle77
KingCastle77 collected $2.50 from pot
KingCastle77: doesn't show hand 
*** SUMMARY ***
Total pot $2.50 | Rake $0 
Seat 1: app1e_j@ck (button) folded before Flop (didn't bet)
Seat 2: jahwe (small blind) folded before Flop
Seat 4: Pocketstud (big blind) folded before Flop
Seat 5: KingCastle77 collected ($2.50)
Seat 6: Westpants folded before Flop (didn't bet)
Seat 7: matiko09 folded before Flop (didn't bet)
Seat 9: mmcardoulis folded before Flop (didn't bet)





PokerStars Hand #150803085316:  Hold'em No Limit ($0.50/$1.00 USD) - 2016/03/23 15:29:30 CET [2016/03/23 10:29:30 ET]
Table 'Drakonia II' 9-max Seat #9 is the button
Seat 1: chautinhtri9 ($128.10 in chips) 
Seat 2: RICKA16 ($100 in chips) 
Seat 5: Muinmyheart ($103.25 in chips) 
Seat 6: PinkTrinta ($100 in chips) 
Seat 7: YuriiSolodya ($55.11 in chips) 
Seat 8: matiko09 ($100 in chips) 
Seat 9: mycka86 ($101.86 in chips) 
chautinhtri9: posts small blind $0.50
RICKA16: posts big blind $1
Jimy Tiltman: sits out 
*** HOLE CARDS ***
Dealt to matiko09 [Kd 7c]
Muinmyheart: folds 
PinkTrinta: raises $2 to $3
YuriiSolodya: folds 
matiko09: folds 
mycka86: folds 
chautinhtri9: folds 
RICKA16: folds 
Uncalled bet ($2) returned to PinkTrinta
PinkTrinta collected $2.50 from pot
*** SUMMARY ***
Total pot $2.50 | Rake $0 
Seat 1: chautinhtri9 (small blind) folded before Flop
Seat 2: RICKA16 (big blind) folded before Flop
Seat 5: Muinmyheart folded before Flop (didn't bet)
Seat 6: PinkTrinta collected ($2.50)
Seat 7: YuriiSolodya folded before Flop (didn't bet)
Seat 8: matiko09 folded before Flop (didn't bet)
Seat 9: mycka86 (button) folded before Flop (didn't bet)





PokerStars Hand #150803088748:  Hold'em No Limit (€1/€2 EUR) - 2016/03/23 15:29:40 CET [2016/03/23 10:29:40 ET]
Table 'Malva II' 9-max Seat #5 is the button
Seat 1: PacPacBum (€246.63 in chips) 
Seat 2: IseeUcards (€200 in chips) 
Seat 3: matiko09 (€259.85 in chips) 
Seat 4: steff0777 (€211 in chips) 
Seat 5: o.miro (€353.35 in chips) 
Seat 6: volwebni4ek (€81 in chips) 
Seat 7: nairolf24 (€200 in chips) 
Seat 8: T0ny Adams (€77.20 in chips) 
Seat 9: RamiroAgujis (€216.23 in chips) 
volwebni4ek: posts small blind €1
nairolf24: posts big blind €2
*** HOLE CARDS ***
Dealt to matiko09 [8c Th]
T0ny Adams: folds 
RamiroAgujis: folds 
PacPacBum has timed out
PacPacBum: folds 
IseeUcards: raises €4 to €6
matiko09: folds 
steff0777: calls €6
o.miro: calls €6
volwebni4ek: folds 
nairolf24: calls €4
*** FLOP *** [2c 5s 9c]
nairolf24: checks 
IseeUcards: checks 
steff0777: checks 
o.miro: checks 
*** TURN *** [2c 5s 9c] [4c]
nairolf24: bets €18
IseeUcards: folds 
steff0777: folds 
o.miro: folds 
Uncalled bet (€18) returned to nairolf24
nairolf24 collected €23.88 from pot
*** SUMMARY ***
Total pot €25 | Rake €1.12 
Board [2c 5s 9c 4c]
Seat 1: PacPacBum folded before Flop (didn't bet)
Seat 2: IseeUcards folded on the Turn
Seat 3: matiko09 folded before Flop (didn't bet)
Seat 4: steff0777 folded on the Turn
Seat 5: o.miro (button) folded on the Turn
Seat 6: volwebni4ek (small blind) folded before Flop
Seat 7: nairolf24 (big blind) collected (€23.88)
Seat 8: T0ny Adams folded before Flop (didn't bet)
Seat 9: RamiroAgujis folded before Flop (didn't bet)





PokerStars Hand #150803089920:  Hold'em No Limit (€0.50/€1.00 EUR) - 2016/03/23 15:29:43 CET [2016/03/23 10:29:43 ET]
Table 'Mercury III' 9-max Seat #4 is the button
Seat 1: matiko09 (€126.35 in chips) 
Seat 2: jahwe (€100 in chips) 
Seat 4: Muinmyheart (€100 in chips) 
Seat 5: ardo888 (€103 in chips) 
Seat 6: mycka86 (€100 in chips) 
Seat 7: STrakDD (€100 in chips) 
Seat 8: gfxed (€55.02 in chips) 
Seat 9: Indr3k (€100 in chips) 
ardo888: posts small blind €0.50
mycka86: posts big blind €1
*** HOLE CARDS ***
Dealt to matiko09 [6d 9h]
STrakDD: folds 
gfxed: raises €1.23 to €2.23
Indr3k: folds 
matiko09: folds 
jahwe: folds 
Muinmyheart: folds 
ardo888: folds 
mycka86: folds 
Uncalled bet (€1.23) returned to gfxed
gfxed collected €2.50 from pot
*** SUMMARY ***
Total pot €2.50 | Rake €0 
Seat 1: matiko09 folded before Flop (didn't bet)
Seat 2: jahwe folded before Flop (didn't bet)
Seat 4: Muinmyheart (button) folded before Flop (didn't bet)
Seat 5: ardo888 (small blind) folded before Flop
Seat 6: mycka86 (big blind) folded before Flop
Seat 7: STrakDD folded before Flop (didn't bet)
Seat 8: gfxed collected (€2.50)
Seat 9: Indr3k folded before Flop (didn't bet)





PokerStars Hand #150803090456:  Hold'em No Limit ($0.50/$1.00 USD) - 2016/03/23 15:29:45 CET [2016/03/23 10:29:45 ET]
Table 'Swings' 9-max Seat #9 is the button
Seat 1: lumen21 ($101.78 in chips) 
Seat 2: tomver0809 ($72 in chips) 
Seat 4: YuriiSolodya ($37.50 in chips) 
Seat 5: chautinhtri9 ($119.05 in chips) 
Seat 6: matiko09 ($138.42 in chips) 
Seat 8: RICKA16 ($107.18 in chips) 
Seat 9: Effort92 ($102.18 in chips) 
lumen21: posts small blind $0.50
tomver0809: posts big blind $1
*** HOLE CARDS ***
Dealt to matiko09 [As Ah]
YuriiSolodya: folds 
chautinhtri9: folds 
matiko09: raises $2 to $3
RICKA16: folds 
Effort92: folds 
lumen21: folds 
tomver0809: folds 
Uncalled bet ($2) returned to matiko09
matiko09 collected $2.50 from pot
matiko09: doesn't show hand 
*** SUMMARY ***
Total pot $2.50 | Rake $0 
Seat 1: lumen21 (small blind) folded before Flop
Seat 2: tomver0809 (big blind) folded before Flop
Seat 4: YuriiSolodya folded before Flop (didn't bet)
Seat 5: chautinhtri9 folded before Flop (didn't bet)
Seat 6: matiko09 collected ($2.50)
Seat 8: RICKA16 folded before Flop (didn't bet)
Seat 9: Effort92 (button) folded before Flop (didn't bet)





PokerStars Hand #150803090445:  Hold'em No Limit ($0.50/$1.00 USD) - 2016/03/23 15:29:45 CET [2016/03/23 10:29:45 ET]
Table 'Aetolia II' 9-max Seat #2 is the button
Seat 1: app1e_j@ck ($100 in chips) 
Seat 2: jahwe ($100 in chips) 
Seat 4: Pocketstud ($109.14 in chips) 
Seat 5: KingCastle77 ($91.30 in chips) 
Seat 6: Westpants ($100 in chips) 
Seat 7: matiko09 ($100 in chips) 
Seat 9: mmcardoulis ($60.23 in chips) 
stds st will be allowed to play after the button
Pocketstud: posts small blind $0.50
KingCastle77: posts big blind $1
*** HOLE CARDS ***
Dealt to matiko09 [Ah Jd]
Westpants: folds 
matiko09: raises $2 to $3
mmcardoulis: folds 
app1e_j@ck: folds 
jahwe: folds 
Pocketstud: calls $2.50
KingCastle77: folds 
*** FLOP *** [Kc 8c Qs]
Pocketstud: bets $2
matiko09: calls $2
*** TURN *** [Kc 8c Qs] [3h]
Pocketstud: bets $2
matiko09: calls $2
*** RIVER *** [Kc 8c Qs 3h] [Ac]
Pocketstud: bets $5
matiko09: calls $5
*** SHOW DOWN ***
Pocketstud: shows [As Qd] (two pair, Aces and Queens)
matiko09: mucks hand 
Pocketstud collected $23.88 from pot
*** SUMMARY ***
Total pot $25 | Rake $1.12 
Board [Kc 8c Qs 3h Ac]
Seat 1: app1e_j@ck folded before Flop (didn't bet)
Seat 2: jahwe (button) folded before Flop (didn't bet)
Seat 4: Pocketstud (small blind) showed [As Qd] and won ($23.88) with two pair, Aces and Queens
Seat 5: KingCastle77 (big blind) folded before Flop
Seat 6: Westpants folded before Flop (didn't bet)
Seat 7: matiko09 mucked [Ah Jd]
Seat 9: mmcardoulis folded before Flop (didn't bet)





PokerStars Hand #150803093625:  Hold'em No Limit ($0.50/$1.00 USD) - 2016/03/23 15:29:54 CET [2016/03/23 10:29:54 ET]
Table 'Asmodeus' 9-max Seat #1 is the button
Seat 1: Jimy Tiltman ($141.35 in chips) 
Seat 3: jahwe ($104.92 in chips) 
Seat 4: Effort92 ($100 in chips) 
Seat 5: Muinmyheart ($105.09 in chips) 
Seat 6: fuppeee ($134.05 in chips) 
Seat 7: mycka86 ($119.35 in chips) 
Seat 9: matiko09 ($100 in chips) 
jahwe: posts small blind $0.50
Effort92: posts big blind $1
app1e_j@ck: sits out 
Jimy Tiltman: posts the ante $0.20
jahwe: posts the ante $0.20
Effort92: posts the ante $0.20
Muinmyheart: posts the ante $0.20
fuppeee: posts the ante $0.20
mycka86: posts the ante $0.20
matiko09: posts the ante $0.20
*** HOLE CARDS ***
Dealt to matiko09 [5h Ad]
Muinmyheart: folds 
fuppeee: folds 
mycka86: folds 
matiko09: folds 
Jimy Tiltman: folds 
jahwe: folds 
Uncalled bet ($0.50) returned to Effort92
Effort92 collected $2.40 from pot
Effort92: doesn't show hand 
*** SUMMARY ***
Total pot $2.40 | Rake $0 
Seat 1: Jimy Tiltman (button) folded before Flop (didn't bet)
Seat 3: jahwe (small blind) folded before Flop
Seat 4: Effort92 (big blind) collected ($2.40)
Seat 5: Muinmyheart folded before Flop (didn't bet)
Seat 6: fuppeee folded before Flop (didn't bet)
Seat 7: mycka86 folded before Flop (didn't bet)
Seat 9: matiko09 folded before Flop (didn't bet)





PokerStars Hand #150803098797:  Hold'em No Limit ($0.50/$1.00 USD) - 2016/03/23 15:30:09 CET [2016/03/23 10:30:09 ET]
Table 'Swings' 9-max Seat #1 is the button
Seat 1: lumen21 ($101.28 in chips) 
Seat 2: tomver0809 ($71 in chips) 
Seat 4: YuriiSolodya ($37.50 in chips) 
Seat 5: chautinhtri9 ($119.05 in chips) 
Seat 6: matiko09 ($139.92 in chips) 
Seat 8: RICKA16 ($107.18 in chips) 
Seat 9: Effort92 ($102.18 in chips) 
tomver0809: posts small blind $0.50
YuriiSolodya: posts big blind $1
*** HOLE CARDS ***
Dealt to matiko09 [Jd 9c]
chautinhtri9: folds 
matiko09: folds 
RICKA16: folds 
Effort92: raises $1.50 to $2.50
lumen21: folds 
tomver0809: calls $2
YuriiSolodya: calls $1.50
*** FLOP *** [8s Td 7d]
tomver0809: checks 
YuriiSolodya: bets $3
Effort92: calls $3
tomver0809: folds 
*** TURN *** [8s Td 7d] [4s]
YuriiSolodya: checks 
Effort92: bets $9
YuriiSolodya: folds 
Uncalled bet ($9) returned to Effort92
Effort92 collected $12.89 from pot
Effort92: doesn't show hand 
*** SUMMARY ***
Total pot $13.50 | Rake $0.61 
Board [8s Td 7d 4s]
Seat 1: lumen21 (button) folded before Flop (didn't bet)
Seat 2: tomver0809 (small blind) folded on the Flop
Seat 4: YuriiSolodya (big blind) folded on the Turn
Seat 5: chautinhtri9 folded before Flop (didn't bet)
Seat 6: matiko09 folded before Flop (didn't bet)
Seat 8: RICKA16 folded before Flop (didn't bet)
Seat 9: Effort92 collected ($12.89)





PokerStars Hand #150803099914:  Hold'em No Limit ($0.50/$1.00 USD) - 2016/03/23 15:30:12 CET [2016/03/23 10:30:12 ET]
Table 'Asmodeus' 9-max Seat #3 is the button
Seat 1: Jimy Tiltman ($141.15 in chips) 
Seat 3: jahwe ($104.22 in chips) 
Seat 4: Effort92 ($101.70 in chips) 
Seat 5: Muinmyheart ($104.89 in chips) 
Seat 6: fuppeee ($133.85 in chips) 
Seat 7: mycka86 ($119.15 in chips) 
Seat 9: matiko09 ($100 in chips) 
Effort92: posts small blind $0.50
Muinmyheart: posts big blind $1
app1e_j@ck: sits out 
Jimy Tiltman: posts the ante $0.20
jahwe: posts the ante $0.20
Effort92: posts the ante $0.20
Muinmyheart: posts the ante $0.20
fuppeee: posts the ante $0.20
mycka86: posts the ante $0.20
matiko09: posts the ante $0.20
*** HOLE CARDS ***
Dealt to matiko09 [Qc Ad]
fuppeee: folds 
mycka86: folds 
matiko09: raises $2 to $3
Jimy Tiltman: raises $6.34 to $9.34
jahwe: folds 
Effort92: folds 
Muinmyheart: folds 
matiko09: folds 
Uncalled bet ($6.34) returned to Jimy Tiltman
Jimy Tiltman collected $8.90 from pot
Jimy Tiltman: doesn't show hand 
*** SUMMARY ***
Total pot $8.90 | Rake $0 
Seat 1: Jimy Tiltman collected ($8.90)
Seat 3: jahwe (button) folded before Flop (didn't bet)
Seat 4: Effort92 (small blind) folded before Flop
Seat 5: Muinmyheart (big blind) folded before Flop
Seat 6: fuppeee folded before Flop (didn't bet)
Seat 7: mycka86 folded before Flop (didn't bet)
Seat 9: matiko09 folded before Flop





PokerStars Hand #150803101197:  Hold'em No Limit ($0.50/$1.00 USD) - 2016/03/23 15:30:16 CET [2016/03/23 10:30:16 ET]
Table 'Drakonia II' 9-max Seat #1 is the button
Seat 1: chautinhtri9 ($127.60 in chips) 
Seat 2: RICKA16 ($99 in chips) 
Seat 4: Jimy Tiltman ($100 in chips) 
Seat 5: Muinmyheart ($103.25 in chips) 
Seat 6: PinkTrinta ($101.50 in chips) 
Seat 7: YuriiSolodya ($55.11 in chips) 
Seat 8: matiko09 ($100 in chips) 
Seat 9: mycka86 ($101.86 in chips) 
RICKA16: posts small blind $0.50
Jimy Tiltman: posts big blind $1
*** HOLE CARDS ***
Dealt to matiko09 [Ad 5c]
Muinmyheart: folds 
PinkTrinta: folds 
YuriiSolodya: folds 
matiko09: folds 
mycka86: folds 
chautinhtri9: folds 
RICKA16: folds 
Uncalled bet ($0.50) returned to Jimy Tiltman
Jimy Tiltman collected $1 from pot
Jimy Tiltman: doesn't show hand 
*** SUMMARY ***
Total pot $1 | Rake $0 
Seat 1: chautinhtri9 (button) folded before Flop (didn't bet)
Seat 2: RICKA16 (small blind) folded before Flop
Seat 4: Jimy Tiltman (big blind) collected ($1)
Seat 5: Muinmyheart folded before Flop (didn't bet)
Seat 6: PinkTrinta folded before Flop (didn't bet)
Seat 7: YuriiSolodya folded before Flop (didn't bet)
Seat 8: matiko09 folded before Flop (didn't bet)
Seat 9: mycka86 folded before Flop (didn't bet)





PokerStars Hand #150803101063:  Hold'em No Limit (€0.50/€1.00 EUR) - 2016/03/23 15:30:16 CET [2016/03/23 10:30:16 ET]
Table 'Mercury III' 9-max Seat #5 is the button
Seat 1: matiko09 (€126.35 in chips) 
Seat 2: jahwe (€100 in chips) 
Seat 4: Muinmyheart (€100 in chips) 
Seat 5: ardo888 (€102.50 in chips) 
Seat 6: mycka86 (€100 in chips) 
Seat 7: STrakDD (€100 in chips) 
Seat 8: gfxed (€56.52 in chips) 
Seat 9: Indr3k (€100 in chips) 
mycka86: posts small blind €0.50
STrakDD: posts big blind €1
*** HOLE CARDS ***
Dealt to matiko09 [2d Ks]
gfxed: folds 
Indr3k: folds 
matiko09: folds 
jahwe: folds 
Muinmyheart: raises €1.50 to €2.50
ardo888: folds 
mycka86: folds 
STrakDD: folds 
Uncalled bet (€1.50) returned to Muinmyheart
Muinmyheart collected €2.50 from pot
Muinmyheart: doesn't show hand 
*** SUMMARY ***
Total pot €2.50 | Rake €0 
Seat 1: matiko09 folded before Flop (didn't bet)
Seat 2: jahwe folded before Flop (didn't bet)
Seat 4: Muinmyheart collected (€2.50)
Seat 5: ardo888 (button) folded before Flop (didn't bet)
Seat 6: mycka86 (small blind) folded before Flop
Seat 7: STrakDD (big blind) folded before Flop
Seat 8: gfxed folded before Flop (didn't bet)
Seat 9: Indr3k folded before Flop (didn't bet)





PokerStars Hand #150803104293:  Hold'em No Limit ($1/$2 USD) - 2016/03/23 15:30:25 CET [2016/03/23 10:30:25 ET]
Table 'Kiess' 9-max Seat #2 is the button
Seat 1: Cirilico ($266.95 in chips) 
Seat 2: jahwe ($200 in chips) 
Seat 3: Red4erT ($80 in chips) 
Seat 4: RamiroAgujis ($200 in chips) 
Seat 5: chippo boy ($427.84 in chips) 
Seat 6: matiko09 ($248.48 in chips) 
Seat 7: chaps1988 ($209.24 in chips) 
Seat 8: erfk1958 ($133.05 in chips) 
Red4erT: posts small blind $1
RamiroAgujis: posts big blind $2
PacPacBum: sits out 
*** HOLE CARDS ***
Dealt to matiko09 [Qs 9d]
chippo boy: folds 
matiko09: folds 
chaps1988: raises $4 to $6
erfk1958: folds 
Cirilico: folds 
jahwe: folds 
Red4erT: folds 
RamiroAgujis: folds 
Uncalled bet ($4) returned to chaps1988
chaps1988 collected $5 from pot
chaps1988: doesn't show hand 
*** SUMMARY ***
Total pot $5 | Rake $0 
Seat 1: Cirilico folded before Flop (didn't bet)
Seat 2: jahwe (button) folded before Flop (didn't bet)
Seat 3: Red4erT (small blind) folded before Flop
Seat 4: RamiroAgujis (big blind) folded before Flop
Seat 5: chippo boy folded before Flop (didn't bet)
Seat 6: matiko09 folded before Flop (didn't bet)
Seat 7: chaps1988 collected ($5)
Seat 8: erfk1958 folded before Flop (didn't bet)





PokerStars Hand #150803108873:  Hold'em No Limit ($0.50/$1.00 USD) - 2016/03/23 15:30:38 CET [2016/03/23 10:30:38 ET]
Table 'Smiley' 9-max Seat #7 is the button
Seat 1: xHourglass ($100 in chips) 
Seat 2: Jimy Tiltman ($116.24 in chips) 
Seat 4: CAJUN890 ($88.19 in chips) 
Seat 5: Szevasztopol ($150.35 in chips) 
Seat 6: blackmont111 ($123.04 in chips) 
Seat 7: bennetb77 ($71.84 in chips) 
Seat 8: matiko09 ($109.51 in chips) 
Seat 9: PacPacBum ($100 in chips) 
matiko09: posts small blind $0.50
PacPacBum: posts big blind $1
mycka86: sits out 
*** HOLE CARDS ***
Dealt to matiko09 [Kc 8s]
xHourglass: raises $2 to $3
Jimy Tiltman: folds 
CAJUN890: folds 
Szevasztopol: folds 
blackmont111: folds 
bennetb77: folds 
matiko09: folds 
PacPacBum: folds 
Uncalled bet ($2) returned to xHourglass
xHourglass collected $2.50 from pot
xHourglass: doesn't show hand 
*** SUMMARY ***
Total pot $2.50 | Rake $0 
Seat 1: xHourglass collected ($2.50)
Seat 2: Jimy Tiltman folded before Flop (didn't bet)
Seat 4: CAJUN890 folded before Flop (didn't bet)
Seat 5: Szevasztopol folded before Flop (didn't bet)
Seat 6: blackmont111 folded before Flop (didn't bet)
Seat 7: bennetb77 (button) folded before Flop (didn't bet)
Seat 8: matiko09 (small blind) folded before Flop
Seat 9: PacPacBum (big blind) folded before Flop





PokerStars Hand #150803109774:  Hold'em No Limit ($0.50/$1.00 USD) - 2016/03/23 15:30:41 CET [2016/03/23 10:30:41 ET]
Table 'Aetolia II' 9-max Seat #4 is the button
Seat 1: app1e_j@ck ($100 in chips) 
Seat 2: jahwe ($100 in chips) 
Seat 4: Pocketstud ($121.02 in chips) 
Seat 5: KingCastle77 ($90.30 in chips) 
Seat 6: Westpants ($100 in chips) 
Seat 7: matiko09 ($100 in chips) 
Seat 9: mmcardoulis ($60.23 in chips) 
KingCastle77: posts small blind $0.50
Westpants: posts big blind $1
PacPacBum: sits out 
*** HOLE CARDS ***
Dealt to matiko09 [6s Kc]
matiko09: folds 
mmcardoulis: folds 
app1e_j@ck: folds 
jahwe: folds 
Pocketstud: folds 
KingCastle77: folds 
Uncalled bet ($0.50) returned to Westpants
Westpants collected $1 from pot
*** SUMMARY ***
Total pot $1 | Rake $0 
Seat 1: app1e_j@ck folded before Flop (didn't bet)
Seat 2: jahwe folded before Flop (didn't bet)
Seat 4: Pocketstud (button) folded before Flop (didn't bet)
Seat 5: KingCastle77 (small blind) folded before Flop
Seat 6: Westpants (big blind) collected ($1)
Seat 7: matiko09 folded before Flop (didn't bet)
Seat 9: mmcardoulis folded before Flop (didn't bet)





PokerStars Hand #150803111430:  Hold'em No Limit ($0.50/$1.00 USD) - 2016/03/23 15:30:45 CET [2016/03/23 10:30:45 ET]
Table 'Drakonia II' 9-max Seat #2 is the button
Seat 1: chautinhtri9 ($127.60 in chips) 
Seat 2: RICKA16 ($98.50 in chips) 
Seat 4: Jimy Tiltman ($100.50 in chips) 
Seat 5: Muinmyheart ($103.25 in chips) 
Seat 6: PinkTrinta ($101.50 in chips) 
Seat 7: YuriiSolodya ($55.11 in chips) 
Seat 8: matiko09 ($100 in chips) 
Seat 9: mycka86 ($101.86 in chips) 
PacPacBum will be allowed to play after the button
Jimy Tiltman: posts small blind $0.50
Muinmyheart: posts big blind $1
*** HOLE CARDS ***
Dealt to matiko09 [5h 5d]
PinkTrinta: raises $2 to $3
YuriiSolodya: folds 
matiko09: folds 
mycka86: folds 
chautinhtri9: folds 
RICKA16: folds 
Jimy Tiltman: folds 
Muinmyheart: calls $2
*** FLOP *** [5c 7d 7c]
Muinmyheart: checks 
PinkTrinta: bets $4.22
Muinmyheart: folds 
Uncalled bet ($4.22) returned to PinkTrinta
PinkTrinta collected $6.21 from pot
*** SUMMARY ***
Total pot $6.50 | Rake $0.29 
Board [5c 7d 7c]
Seat 1: chautinhtri9 folded before Flop (didn't bet)
Seat 2: RICKA16 (button) folded before Flop (didn't bet)
Seat 4: Jimy Tiltman (small blind) folded before Flop
Seat 5: Muinmyheart (big blind) folded on the Flop
Seat 6: PinkTrinta collected ($6.21)
Seat 7: YuriiSolodya folded before Flop (didn't bet)
Seat 8: matiko09 folded before Flop (didn't bet)
Seat 9: mycka86 folded before Flop (didn't bet)





PokerStars Hand #150803113212:  Hold'em No Limit (€0.50/€1.00 EUR) - 2016/03/23 15:30:51 CET [2016/03/23 10:30:51 ET]
Table 'Mercury III' 9-max Seat #6 is the button
Seat 1: matiko09 (€126.35 in chips) 
Seat 2: jahwe (€100 in chips) 
Seat 4: Muinmyheart (€101.50 in chips) 
Seat 5: ardo888 (€102.50 in chips) 
Seat 6: mycka86 (€100 in chips) 
Seat 7: STrakDD (€100 in chips) 
Seat 8: gfxed (€56.52 in chips) 
Seat 9: Indr3k (€100 in chips) 
STrakDD: posts small blind €0.50
gfxed: posts big blind €1
PacPacBum: sits out 
*** HOLE CARDS ***
Dealt to matiko09 [4h 9d]
Indr3k: folds 
matiko09: folds 
jahwe: folds 
Muinmyheart: folds 
ardo888: folds 
mycka86: raises €1.10 to €2.10
STrakDD: raises €5.90 to €8
gfxed: folds 
mycka86: folds 
Uncalled bet (€5.90) returned to STrakDD
STrakDD collected €5.20 from pot
STrakDD: doesn't show hand 
*** SUMMARY ***
Total pot €5.20 | Rake €0 
Seat 1: matiko09 folded before Flop (didn't bet)
Seat 2: jahwe folded before Flop (didn't bet)
Seat 4: Muinmyheart folded before Flop (didn't bet)
Seat 5: ardo888 folded before Flop (didn't bet)
Seat 6: mycka86 (button) folded before Flop
Seat 7: STrakDD (small blind) collected (€5.20)
Seat 8: gfxed (big blind) folded before Flop
Seat 9: Indr3k folded before Flop (didn't bet)





PokerStars Hand #150803114363:  Hold'em No Limit ($0.50/$1.00 USD) - 2016/03/23 15:30:54 CET [2016/03/23 10:30:54 ET]
Table 'Sylvia III' 9-max Seat #5 is the button
Seat 1: mycka86 ($138.40 in chips) 
Seat 2: Dantist1122 ($112.30 in chips) 
Seat 3: se7en_$tars ($210.42 in chips) 
Seat 4: lombardo11 ($49.07 in chips) 
Seat 5: matiko09 ($100 in chips) 
Seat 8: Muinmyheart ($134.50 in chips) 
Seat 9: Jimy Tiltman ($100 in chips) 
PacPacBum will be allowed to play after the button
jahwe will be allowed to play after the button
Muinmyheart: posts small blind $0.50
Jimy Tiltman: posts big blind $1
mycka86: posts the ante $0.20
Dantist1122: posts the ante $0.20
se7en_$tars: posts the ante $0.20
lombardo11: posts the ante $0.20
matiko09: posts the ante $0.20
Muinmyheart: posts the ante $0.20
Jimy Tiltman: posts the ante $0.20
*** HOLE CARDS ***
Dealt to matiko09 [Th Kc]
mycka86: folds 
Dantist1122: folds 
se7en_$tars: folds 
lombardo11: folds 
matiko09: raises $1.50 to $2.50
Muinmyheart: raises $6.50 to $9
Jimy Tiltman: folds 
matiko09: folds 
Uncalled bet ($6.50) returned to Muinmyheart
Muinmyheart collected $7.40 from pot
Muinmyheart: doesn't show hand 
*** SUMMARY ***
Total pot $7.40 | Rake $0 
Seat 1: mycka86 folded before Flop (didn't bet)
Seat 2: Dantist1122 folded before Flop (didn't bet)
Seat 3: se7en_$tars folded before Flop (didn't bet)
Seat 4: lombardo11 folded before Flop (didn't bet)
Seat 5: matiko09 (button) folded before Flop
Seat 8: Muinmyheart (small blind) collected ($7.40)
Seat 9: Jimy Tiltman (big blind) folded before Flop





PokerStars Hand #150803114507:  Hold'em No Limit ($0.50/$1.00 USD) - 2016/03/23 15:30:54 CET [2016/03/23 10:30:54 ET]
Table 'Asmodeus' 9-max Seat #4 is the button
Seat 1: Jimy Tiltman ($146.85 in chips) 
Seat 3: jahwe ($104.02 in chips) 
Seat 4: Effort92 ($101 in chips) 
Seat 5: Muinmyheart ($103.69 in chips) 
Seat 6: fuppeee ($133.65 in chips) 
Seat 7: mycka86 ($118.95 in chips) 
Seat 9: matiko09 ($100 in chips) 
Muinmyheart: posts small blind $0.50
fuppeee: posts big blind $1
app1e_j@ck: sits out 
PacPacBum: sits out 
Jimy Tiltman: posts the ante $0.20
jahwe: posts the ante $0.20
Effort92: posts the ante $0.20
Muinmyheart: posts the ante $0.20
fuppeee: posts the ante $0.20
mycka86: posts the ante $0.20
matiko09: posts the ante $0.20
*** HOLE CARDS ***
Dealt to matiko09 [7h Jc]
mycka86: folds 
matiko09: folds 
Jimy Tiltman: folds 
jahwe: raises $1.50 to $2.50
Effort92: folds 
Muinmyheart: folds 
fuppeee: calls $1.50
*** FLOP *** [Tc 5h Qd]
fuppeee: checks 
jahwe: checks 
*** TURN *** [Tc 5h Qd] [2c]
fuppeee: checks 
jahwe: bets $4.55
fuppeee: folds 
Uncalled bet ($4.55) returned to jahwe
jahwe collected $6.59 from pot
jahwe: doesn't show hand 
*** SUMMARY ***
Total pot $6.90 | Rake $0.31 
Board [Tc 5h Qd 2c]
Seat 1: Jimy Tiltman folded before Flop (didn't bet)
Seat 3: jahwe collected ($6.59)
Seat 4: Effort92 (button) folded before Flop (didn't bet)
Seat 5: Muinmyheart (small blind) folded before Flop
Seat 6: fuppeee (big blind) folded on the Turn
Seat 7: mycka86 folded before Flop (didn't bet)
Seat 9: matiko09 folded before Flop (didn't bet)





PokerStars Hand #150803117367:  Hold'em No Limit ($0.50/$1.00 USD) - 2016/03/23 15:31:03 CET [2016/03/23 10:31:03 ET]
Table 'Smiley' 9-max Seat #8 is the button
Seat 1: xHourglass ($101.50 in chips) 
Seat 2: Jimy Tiltman ($116.24 in chips) 
Seat 4: CAJUN890 ($88.19 in chips) 
Seat 5: Szevasztopol ($150.35 in chips) 
Seat 6: blackmont111 ($123.04 in chips) 
Seat 7: bennetb77 ($71.84 in chips) 
Seat 8: matiko09 ($109.01 in chips) 
Seat 9: PacPacBum ($100 in chips) 
PacPacBum: posts small blind $0.50
xHourglass: posts big blind $1
mycka86: sits out 
*** HOLE CARDS ***
Dealt to matiko09 [Js Ts]
Jimy Tiltman: folds 
CAJUN890: calls $1
Szevasztopol: folds 
blackmont111: folds 
bennetb77: folds 
matiko09: raises $3 to $4
PacPacBum: folds 
xHourglass: folds 
CAJUN890: calls $3
*** FLOP *** [8c Ks 2s]
CAJUN890: checks 
matiko09: bets $5.90
CAJUN890: folds 
Uncalled bet ($5.90) returned to matiko09
matiko09 collected $9.07 from pot
matiko09: doesn't show hand 
*** SUMMARY ***
Total pot $9.50 | Rake $0.43 
Board [8c Ks 2s]
Seat 1: xHourglass (big blind) folded before Flop
Seat 2: Jimy Tiltman folded before Flop (didn't bet)
Seat 4: CAJUN890 folded on the Flop
Seat 5: Szevasztopol folded before Flop (didn't bet)
Seat 6: blackmont111 folded before Flop (didn't bet)
Seat 7: bennetb77 folded before Flop (didn't bet)
Seat 8: matiko09 (button) collected ($9.07)
Seat 9: PacPacBum (small blind) folded before Flop





PokerStars Hand #150803119892:  Hold'em No Limit ($1/$2 USD) - 2016/03/23 15:31:10 CET [2016/03/23 10:31:10 ET]
Table 'Kiess' 9-max Seat #3 is the button
Seat 1: Cirilico ($266.95 in chips) 
Seat 2: jahwe ($200 in chips) 
Seat 3: Red4erT ($80 in chips) 
Seat 4: RamiroAgujis ($200 in chips) 
Seat 5: chippo boy ($427.84 in chips) 
Seat 6: matiko09 ($248.48 in chips) 
Seat 7: chaps1988 ($212.24 in chips) 
Seat 8: erfk1958 ($133.05 in chips) 
RamiroAgujis: posts small blind $1
chippo boy: posts big blind $2
PacPacBum: sits out 
*** HOLE CARDS ***
Dealt to matiko09 [9h 3d]
matiko09: folds 
chaps1988: folds 
erfk1958: folds 
Cirilico: raises $4 to $6
jahwe: folds 
Red4erT: folds 
RamiroAgujis: folds 
chippo boy: folds 
Uncalled bet ($4) returned to Cirilico
Cirilico collected $5 from pot
Cirilico: doesn't show hand 
*** SUMMARY ***
Total pot $5 | Rake $0 
Seat 1: Cirilico collected ($5)
Seat 2: jahwe folded before Flop (didn't bet)
Seat 3: Red4erT (button) folded before Flop (didn't bet)
Seat 4: RamiroAgujis (small blind) folded before Flop
Seat 5: chippo boy (big blind) folded before Flop
Seat 6: matiko09 folded before Flop (didn't bet)
Seat 7: chaps1988 folded before Flop (didn't bet)
Seat 8: erfk1958 folded before Flop (didn't bet)





PokerStars Hand #150803124061:  Hold'em No Limit (€0.50/€1.00 EUR) - 2016/03/23 15:31:22 CET [2016/03/23 10:31:22 ET]
Table 'Mercury III' 9-max Seat #7 is the button
Seat 1: matiko09 (€126.35 in chips) 
Seat 2: jahwe (€100 in chips) 
Seat 4: Muinmyheart (€101.50 in chips) 
Seat 5: ardo888 (€102.50 in chips) 
Seat 6: mycka86 (€100 in chips) 
Seat 7: STrakDD (€103.10 in chips) 
Seat 8: gfxed (€55.52 in chips) 
Seat 9: Indr3k (€100 in chips) 
gfxed: posts small blind €0.50
Indr3k: posts big blind €1
PacPacBum: sits out 
*** HOLE CARDS ***
Dealt to matiko09 [2d Qs]
matiko09: folds 
jahwe: folds 
Muinmyheart: folds 
ardo888: folds 
mycka86: folds 
STrakDD: raises €1 to €2
gfxed: calls €1.50
Indr3k: folds 
*** FLOP *** [4d 4h 6s]
gfxed: checks 
STrakDD: checks 
*** TURN *** [4d 4h 6s] [As]
gfxed: bets €2
STrakDD: folds 
Uncalled bet (€2) returned to gfxed
gfxed collected €4.78 from pot
*** SUMMARY ***
Total pot €5 | Rake €0.22 
Board [4d 4h 6s As]
Seat 1: matiko09 folded before Flop (didn't bet)
Seat 2: jahwe folded before Flop (didn't bet)
Seat 4: Muinmyheart folded before Flop (didn't bet)
Seat 5: ardo888 folded before Flop (didn't bet)
Seat 6: mycka86 folded before Flop (didn't bet)
Seat 7: STrakDD (button) folded on the Turn
Seat 8: gfxed (small blind) collected (€4.78)
Seat 9: Indr3k (big blind) folded before Flop





PokerStars Hand #150803124490:  Hold'em No Limit ($0.50/$1.00 USD) - 2016/03/23 15:31:23 CET [2016/03/23 10:31:23 ET]
Table 'Swings' 9-max Seat #2 is the button
Seat 1: lumen21 ($101.28 in chips) 
Seat 2: tomver0809 ($68.50 in chips) 
Seat 4: YuriiSolodya ($32 in chips) 
Seat 5: chautinhtri9 ($119.05 in chips) 
Seat 6: matiko09 ($139.92 in chips) 
Seat 8: RICKA16 ($107.18 in chips) 
Seat 9: Effort92 ($109.57 in chips) 
YuriiSolodya: posts small blind $0.50
chautinhtri9: posts big blind $1
PacPacBum: sits out 
*** HOLE CARDS ***
Dealt to matiko09 [Kc Ad]
matiko09: raises $2 to $3
RICKA16: folds 
Effort92: folds 
lumen21: folds 
tomver0809: folds 
YuriiSolodya: folds 
chautinhtri9: folds 
Uncalled bet ($2) returned to matiko09
matiko09 collected $2.50 from pot
matiko09: doesn't show hand 
*** SUMMARY ***
Total pot $2.50 | Rake $0 
Seat 1: lumen21 folded before Flop (didn't bet)
Seat 2: tomver0809 (button) folded before Flop (didn't bet)
Seat 4: YuriiSolodya (small blind) folded before Flop
Seat 5: chautinhtri9 (big blind) folded before Flop
Seat 6: matiko09 collected ($2.50)
Seat 8: RICKA16 folded before Flop (didn't bet)
Seat 9: Effort92 folded before Flop (didn't bet)





PokerStars Hand #150803126992:  Hold'em No Limit ($0.50/$1.00 USD) - 2016/03/23 15:31:31 CET [2016/03/23 10:31:31 ET]
Table 'Aetolia II' 9-max Seat #5 is the button
Seat 1: app1e_j@ck ($100 in chips) 
Seat 2: jahwe ($100 in chips) 
Seat 4: Pocketstud ($121.02 in chips) 
Seat 5: KingCastle77 ($89.80 in chips) 
Seat 6: Westpants ($100.50 in chips) 
Seat 7: matiko09 ($100 in chips) 
Seat 9: mmcardoulis ($60.23 in chips) 
Westpants: posts small blind $0.50
matiko09: posts big blind $1
PacPacBum: sits out 
*** HOLE CARDS ***
Dealt to matiko09 [9d Kc]
mmcardoulis: folds 
app1e_j@ck: folds 
jahwe: folds 
Pocketstud: folds 
stds st leaves the table
KingCastle77: folds 
Westpants: calls $0.50
matiko09: raises $3 to $4
Westpants: folds 
Uncalled bet ($3) returned to matiko09
matiko09 collected $2 from pot
matiko09: doesn't show hand 
*** SUMMARY ***
Total pot $2 | Rake $0 
Seat 1: app1e_j@ck folded before Flop (didn't bet)
Seat 2: jahwe folded before Flop (didn't bet)
Seat 4: Pocketstud folded before Flop (didn't bet)
Seat 5: KingCastle77 (button) folded before Flop (didn't bet)
Seat 6: Westpants (small blind) folded before Flop
Seat 7: matiko09 (big blind) collected ($2)
Seat 9: mmcardoulis folded before Flop (didn't bet)





PokerStars Hand #150803129075:  Hold'em No Limit ($0.50/$1.00 USD) - 2016/03/23 15:31:37 CET [2016/03/23 10:31:37 ET]
Table 'Swings' 9-max Seat #4 is the button
Seat 1: lumen21 ($101.28 in chips) 
Seat 2: tomver0809 ($68.50 in chips) 
Seat 4: YuriiSolodya ($31.50 in chips) 
Seat 5: chautinhtri9 ($118.05 in chips) 
Seat 6: matiko09 ($141.42 in chips) 
Seat 8: RICKA16 ($107.18 in chips) 
Seat 9: Effort92 ($109.57 in chips) 
chautinhtri9: posts small blind $0.50
matiko09: posts big blind $1
PacPacBum: sits out 
*** HOLE CARDS ***
Dealt to matiko09 [2s 8s]
RICKA16: folds 
Effort92: raises $1.50 to $2.50
lumen21: folds 
tomver0809: calls $2.50
YuriiSolodya: calls $2.50
chautinhtri9: folds 
matiko09: folds 
*** FLOP *** [Ad 6s Tc]
Effort92: checks 
tomver0809: checks 
YuriiSolodya: checks 
*** TURN *** [Ad 6s Tc] [8h]
Effort92: bets $4.04
tomver0809: folds 
YuriiSolodya: calls $4.04
*** RIVER *** [Ad 6s Tc 8h] [As]
Effort92: checks 
YuriiSolodya: bets $8.15
Effort92: folds 
Uncalled bet ($8.15) returned to YuriiSolodya
YuriiSolodya collected $16.31 from pot
YuriiSolodya: doesn't show hand 
*** SUMMARY ***
Total pot $17.08 | Rake $0.77 
Board [Ad 6s Tc 8h As]
Seat 1: lumen21 folded before Flop (didn't bet)
Seat 2: tomver0809 folded on the Turn
Seat 4: YuriiSolodya (button) collected ($16.31)
Seat 5: chautinhtri9 (small blind) folded before Flop
Seat 6: matiko09 (big blind) folded before Flop
Seat 8: RICKA16 folded before Flop (didn't bet)
Seat 9: Effort92 folded on the River





PokerStars Hand #150803129861:  Hold'em No Limit ($0.50/$1.00 USD) - 2016/03/23 15:31:39 CET [2016/03/23 10:31:39 ET]
Table 'Smiley' 9-max Seat #9 is the button
Seat 1: xHourglass ($100.50 in chips) 
Seat 2: Jimy Tiltman ($116.24 in chips) 
Seat 4: CAJUN890 ($84.19 in chips) 
Seat 5: Szevasztopol ($150.35 in chips) 
Seat 6: blackmont111 ($123.04 in chips) 
Seat 7: bennetb77 ($71.84 in chips) 
Seat 8: matiko09 ($114.08 in chips) 
Seat 9: PacPacBum ($100 in chips) 
xHourglass: posts small blind $0.50
Jimy Tiltman: posts big blind $1
mycka86: sits out 
*** HOLE CARDS ***
Dealt to matiko09 [5d 4h]
CAJUN890: folds 
Szevasztopol: folds 
blackmont111: folds 
bennetb77: raises $3 to $4
matiko09: folds 
PacPacBum: folds 
xHourglass: calls $3.50
Jimy Tiltman: raises $10 to $14
bennetb77: raises $57.84 to $71.84 and is all-in
xHourglass: folds 
Jimy Tiltman: folds 
Uncalled bet ($57.84) returned to bennetb77
bennetb77 collected $32 from pot
bennetb77: doesn't show hand 
*** SUMMARY ***
Total pot $32 | Rake $0 
Seat 1: xHourglass (small blind) folded before Flop
Seat 2: Jimy Tiltman (big blind) folded before Flop
Seat 4: CAJUN890 folded before Flop (didn't bet)
Seat 5: Szevasztopol folded before Flop (didn't bet)
Seat 6: blackmont111 folded before Flop (didn't bet)
Seat 7: bennetb77 collected ($32)
Seat 8: matiko09 folded before Flop (didn't bet)
Seat 9: PacPacBum (button) folded before Flop (didn't bet)





PokerStars Hand #150803129897:  Hold'em No Limit ($1/$2 USD) - 2016/03/23 15:31:39 CET [2016/03/23 10:31:39 ET]
Table 'Kiess' 9-max Seat #4 is the button
Seat 1: Cirilico ($269.95 in chips) 
Seat 2: jahwe ($200 in chips) 
Seat 3: Red4erT ($80 in chips) 
Seat 4: RamiroAgujis ($200 in chips) 
Seat 5: chippo boy ($425.84 in chips) 
Seat 6: matiko09 ($248.48 in chips) 
Seat 7: chaps1988 ($212.24 in chips) 
Seat 8: erfk1958 ($133.05 in chips) 
chippo boy: posts small blind $1
matiko09: posts big blind $2
PacPacBum: sits out 
*** HOLE CARDS ***
Dealt to matiko09 [Th Ks]
chaps1988: folds 
erfk1958: folds 
Cirilico: folds 
jahwe: folds 
Red4erT: raises $4 to $6
RamiroAgujis: folds 
chippo boy: calls $5
matiko09: calls $4
*** FLOP *** [9s 4h Ts]
chippo boy: checks 
matiko09: bets $10
Red4erT: raises $24.55 to $34.55
chippo boy: folds 
matiko09: folds 
Uncalled bet ($24.55) returned to Red4erT
Red4erT collected $36.29 from pot
Red4erT: doesn't show hand 
*** SUMMARY ***
Total pot $38 | Rake $1.71 
Board [9s 4h Ts]
Seat 1: Cirilico folded before Flop (didn't bet)
Seat 2: jahwe folded before Flop (didn't bet)
Seat 3: Red4erT collected ($36.29)
Seat 4: RamiroAgujis (button) folded before Flop (didn't bet)
Seat 5: chippo boy (small blind) folded on the Flop
Seat 6: matiko09 (big blind) folded on the Flop
Seat 7: chaps1988 folded before Flop (didn't bet)
Seat 8: erfk1958 folded before Flop (didn't bet)





PokerStars Hand #150803130690:  Hold'em No Limit ($0.50/$1.00 USD) - 2016/03/23 15:31:42 CET [2016/03/23 10:31:42 ET]
Table 'Asmodeus' 9-max Seat #5 is the button
Seat 1: Jimy Tiltman ($146.65 in chips) 
Seat 3: jahwe ($107.91 in chips) 
Seat 4: Effort92 ($100.80 in chips) 
Seat 5: Muinmyheart ($102.99 in chips) 
Seat 6: fuppeee ($130.95 in chips) 
Seat 7: mycka86 ($118.75 in chips) 
Seat 9: matiko09 ($100 in chips) 
fuppeee: posts small blind $0.50
mycka86: posts big blind $1
app1e_j@ck: sits out 
PacPacBum: sits out 
Jimy Tiltman: posts the ante $0.20
jahwe: posts the ante $0.20
Effort92: posts the ante $0.20
Muinmyheart: posts the ante $0.20
fuppeee: posts the ante $0.20
mycka86: posts the ante $0.20
matiko09: posts the ante $0.20
*** HOLE CARDS ***
Dealt to matiko09 [9h Tc]
matiko09: folds 
Jimy Tiltman: folds 
jahwe: folds 
Effort92: folds 
Muinmyheart: raises $1.50 to $2.50
fuppeee: folds 
mycka86: folds 
Uncalled bet ($1.50) returned to Muinmyheart
Muinmyheart collected $3.90 from pot
Muinmyheart: doesn't show hand 
*** SUMMARY ***
Total pot $3.90 | Rake $0 
Seat 1: Jimy Tiltman folded before Flop (didn't bet)
Seat 3: jahwe folded before Flop (didn't bet)
Seat 4: Effort92 folded before Flop (didn't bet)
Seat 5: Muinmyheart (button) collected ($3.90)
Seat 6: fuppeee (small blind) folded before Flop
Seat 7: mycka86 (big blind) folded before Flop
Seat 9: matiko09 folded before Flop (didn't bet)





PokerStars Hand #150803131996:  Hold'em No Limit ($0.50/$1.00 USD) - 2016/03/23 15:31:45 CET [2016/03/23 10:31:45 ET]
Table 'Haug II' 9-max Seat #2 is the button
Seat 2: ardo888 ($100 in chips) 
Seat 3: camilalope ($90.81 in chips) 
Seat 4: matiko09 ($100 in chips) 
Seat 5: GlamDragon ($99.20 in chips) 
Seat 8: BRIGANTE49 ($79.52 in chips) 
camilalope: posts small blind $0.50
matiko09: posts big blind $1
jahwe: sits out 
PacPacBum: sits out 
ardo888: posts the ante $0.20
camilalope: posts the ante $0.20
matiko09: posts the ante $0.20
GlamDragon: posts the ante $0.20
BRIGANTE49: posts the ante $0.20
*** HOLE CARDS ***
Dealt to matiko09 [4h 5s]
GlamDragon: folds 
BRIGANTE49: folds 
ardo888: folds 
camilalope: raises $2 to $3
matiko09: folds 
Uncalled bet ($2) returned to camilalope
camilalope collected $3 from pot
*** SUMMARY ***
Total pot $3 | Rake $0 
Seat 2: ardo888 (button) folded before Flop (didn't bet)
Seat 3: camilalope (small blind) collected ($3)
Seat 4: matiko09 (big blind) folded before Flop
Seat 5: GlamDragon folded before Flop (didn't bet)
Seat 8: BRIGANTE49 folded before Flop (didn't bet)





PokerStars Hand #150803131842:  Hold'em No Limit ($0.50/$1.00 USD) - 2016/03/23 15:31:45 CET [2016/03/23 10:31:45 ET]
Table 'Sylvia III' 9-max Seat #8 is the button
Seat 1: mycka86 ($138.20 in chips) 
Seat 2: Dantist1122 ($112.10 in chips) 
Seat 3: se7en_$tars ($210.22 in chips) 
Seat 4: lombardo11 ($48.87 in chips) 
Seat 5: matiko09 ($100 in chips) 
Seat 8: Muinmyheart ($139.20 in chips) 
Seat 9: Jimy Tiltman ($100 in chips) 
Jimy Tiltman: posts small blind $0.50
mycka86: posts big blind $1
PacPacBum: sits out 
jahwe: sits out 
mycka86: posts the ante $0.20
Dantist1122: posts the ante $0.20
se7en_$tars: posts the ante $0.20
lombardo11: posts the ante $0.20
matiko09: posts the ante $0.20
Muinmyheart: posts the ante $0.20
Jimy Tiltman: posts the ante $0.20
*** HOLE CARDS ***
Dealt to matiko09 [9d 7h]
Dantist1122: folds 
se7en_$tars: folds 
lombardo11: raises $1 to $2
matiko09: folds 
Muinmyheart: folds 
Jimy Tiltman: folds 
mycka86: calls $1
*** FLOP *** [Td 8s 6d]
mycka86: checks 
lombardo11: checks 
*** TURN *** [Td 8s 6d] [Qh]
mycka86: bets $4.10
lombardo11: calls $4.10
*** RIVER *** [Td 8s 6d Qh] [5h]
mycka86: checks 
lombardo11: checks 
*** SHOW DOWN ***
mycka86: shows [Kc Js] (high card King)
lombardo11: shows [9h Th] (a pair of Tens)
lombardo11 collected $13.47 from pot
*** SUMMARY ***
Total pot $14.10 | Rake $0.63 
Board [Td 8s 6d Qh 5h]
Seat 1: mycka86 (big blind) showed [Kc Js] and lost with high card King
Seat 2: Dantist1122 folded before Flop (didn't bet)
Seat 3: se7en_$tars folded before Flop (didn't bet)
Seat 4: lombardo11 showed [9h Th] and won ($13.47) with a pair of Tens
Seat 5: matiko09 folded before Flop (didn't bet)
Seat 8: Muinmyheart (button) folded before Flop (didn't bet)
Seat 9: Jimy Tiltman (small blind) folded before Flop





PokerStars Hand #150803137303:  Hold'em No Limit ($0.50/$1.00 USD) - 2016/03/23 15:32:01 CET [2016/03/23 10:32:01 ET]
Table 'Aetolia II' 9-max Seat #6 is the button
Seat 1: app1e_j@ck ($100 in chips) 
Seat 2: jahwe ($100 in chips) 
Seat 4: Pocketstud ($121.02 in chips) 
Seat 5: KingCastle77 ($89.80 in chips) 
Seat 6: Westpants ($100 in chips) 
Seat 7: matiko09 ($101 in chips) 
Seat 8: PacPacBum ($100 in chips) 
Seat 9: mmcardoulis ($60.23 in chips) 
matiko09: posts small blind $0.50
PacPacBum: posts big blind $1
*** HOLE CARDS ***
Dealt to matiko09 [9h 9d]
mmcardoulis: raises $2 to $3
app1e_j@ck: folds 
jahwe: folds 
Pocketstud: folds 
KingCastle77: folds 
Westpants: folds 
lumen21 joins the table at seat #3 
matiko09: calls $2.50
PacPacBum: folds 
*** FLOP *** [Js 4h 6c]
matiko09: checks 
mmcardoulis: bets $4
matiko09: calls $4
*** TURN *** [Js 4h 6c] [Qh]
matiko09: checks 
mmcardoulis: bets $6
matiko09: folds 
Uncalled bet ($6) returned to mmcardoulis
mmcardoulis collected $14.32 from pot
mmcardoulis: doesn't show hand 
*** SUMMARY ***
Total pot $15 | Rake $0.68 
Board [Js 4h 6c Qh]
Seat 1: app1e_j@ck folded before Flop (didn't bet)
Seat 2: jahwe folded before Flop (didn't bet)
Seat 4: Pocketstud folded before Flop (didn't bet)
Seat 5: KingCastle77 folded before Flop (didn't bet)
Seat 6: Westpants (button) folded before Flop (didn't bet)
Seat 7: matiko09 (small blind) folded on the Turn
Seat 8: PacPacBum (big blind) folded before Flop
Seat 9: mmcardoulis collected ($14.32)





PokerStars Hand #150803137664:  Hold'em No Limit ($0.50/$1.00 USD) - 2016/03/23 15:32:02 CET [2016/03/23 10:32:02 ET]
Table 'Haug II' 9-max Seat #3 is the button
Seat 2: ardo888 ($100 in chips) 
Seat 3: camilalope ($92.61 in chips) 
Seat 4: matiko09 ($100 in chips) 
Seat 5: GlamDragon ($99 in chips) 
Seat 8: BRIGANTE49 ($79.32 in chips) 
matiko09: posts small blind $0.50
GlamDragon: posts big blind $1
jahwe: sits out 
PacPacBum: sits out 
ardo888: posts the ante $0.20
camilalope: posts the ante $0.20
matiko09: posts the ante $0.20
GlamDragon: posts the ante $0.20
BRIGANTE49: posts the ante $0.20
*** HOLE CARDS ***
Dealt to matiko09 [Kd 5d]
BRIGANTE49: calls $1
ardo888: folds 
camilalope: folds 
matiko09: calls $0.50
GlamDragon: checks 
*** FLOP *** [Kc 6h 4c]
matiko09: bets $2.48
GlamDragon: folds 
BRIGANTE49: folds 
Uncalled bet ($2.48) returned to matiko09
matiko09 collected $3.82 from pot
matiko09: doesn't show hand 
*** SUMMARY ***
Total pot $4 | Rake $0.18 
Board [Kc 6h 4c]
Seat 2: ardo888 folded before Flop (didn't bet)
Seat 3: camilalope (button) folded before Flop (didn't bet)
Seat 4: matiko09 (small blind) collected ($3.82)
Seat 5: GlamDragon (big blind) folded on the Flop
Seat 8: BRIGANTE49 folded on the Flop





PokerStars Hand #150803138575:  Hold'em No Limit ($0.50/$1.00 USD) - 2016/03/23 15:32:04 CET [2016/03/23 10:32:04 ET]
Table 'Asmodeus' 9-max Seat #6 is the button
Seat 1: Jimy Tiltman ($146.45 in chips) 
Seat 3: jahwe ($107.71 in chips) 
Seat 4: Effort92 ($100.60 in chips) 
Seat 5: Muinmyheart ($105.69 in chips) 
Seat 6: fuppeee ($130.25 in chips) 
Seat 7: mycka86 ($117.55 in chips) 
Seat 8: app1e_j@ck ($100 in chips) 
Seat 9: matiko09 ($100 in chips) 
mycka86: posts small blind $0.50
app1e_j@ck: posts big blind $1
PacPacBum: sits out 
Jimy Tiltman: posts the ante $0.20
jahwe: posts the ante $0.20
Effort92: posts the ante $0.20
Muinmyheart: posts the ante $0.20
fuppeee: posts the ante $0.20
mycka86: posts the ante $0.20
app1e_j@ck: posts the ante $0.20
matiko09: posts the ante $0.20
*** HOLE CARDS ***
Dealt to matiko09 [Kh 6c]
matiko09: folds 
Jimy Tiltman: folds 
jahwe: folds 
Effort92: folds 
Muinmyheart: folds 
fuppeee: raises $4.10 to $5.10
mycka86: folds 
app1e_j@ck: folds 
Uncalled bet ($4.10) returned to fuppeee
fuppeee collected $4.10 from pot
*** SUMMARY ***
Total pot $4.10 | Rake $0 
Seat 1: Jimy Tiltman folded before Flop (didn't bet)
Seat 3: jahwe folded before Flop (didn't bet)
Seat 4: Effort92 folded before Flop (didn't bet)
Seat 5: Muinmyheart folded before Flop (didn't bet)
Seat 6: fuppeee (button) collected ($4.10)
Seat 7: mycka86 (small blind) folded before Flop
Seat 8: app1e_j@ck (big blind) folded before Flop
Seat 9: matiko09 folded before Flop (didn't bet)





PokerStars Hand #150803139393:  Hold'em No Limit (€1/€2 EUR) - 2016/03/23 15:32:07 CET [2016/03/23 10:32:07 ET]
Table 'Malva II' 9-max Seat #6 is the button
Seat 1: PacPacBum (€246.63 in chips) 
Seat 2: IseeUcards (€200 in chips) 
Seat 3: matiko09 (€259.85 in chips) 
Seat 4: steff0777 (€205 in chips) 
Seat 5: o.miro (€347.35 in chips) 
Seat 6: volwebni4ek (€80 in chips) 
Seat 7: nairolf24 (€217.88 in chips) 
Seat 9: RamiroAgujis (€216.23 in chips) 
nairolf24: posts small blind €1
T0ny Adams: is sitting out 
RamiroAgujis: posts big blind €2
*** HOLE CARDS ***
Dealt to matiko09 [3c Qs]
T0ny Adams leaves the table
jahwe joins the table at seat #8 
PacPacBum: folds 
PacPacBum leaves the table
IseeUcards: folds 
matiko09: folds 
steff0777: folds 
o.miro: folds 
Red4erT joins the table at seat #1 
volwebni4ek: folds 
nairolf24: folds 
Uncalled bet (€1) returned to RamiroAgujis
RamiroAgujis collected €2 from pot
RamiroAgujis: doesn't show hand 
*** SUMMARY ***
Total pot €2 | Rake €0 
Seat 1: PacPacBum folded before Flop (didn't bet)
Seat 2: IseeUcards folded before Flop (didn't bet)
Seat 3: matiko09 folded before Flop (didn't bet)
Seat 4: steff0777 folded before Flop (didn't bet)
Seat 5: o.miro folded before Flop (didn't bet)
Seat 6: volwebni4ek (button) folded before Flop (didn't bet)
Seat 7: nairolf24 (small blind) folded before Flop
Seat 9: RamiroAgujis (big blind) collected (€2)





PokerStars Hand #150803140210:  Hold'em No Limit ($0.50/$1.00 USD) - 2016/03/23 15:32:09 CET [2016/03/23 10:32:09 ET]
Table 'Drakonia II' 9-max Seat #4 is the button
Seat 1: chautinhtri9 ($127.60 in chips) 
Seat 2: RICKA16 ($100 in chips) 
Seat 4: Jimy Tiltman ($100 in chips) 
Seat 5: Muinmyheart ($100.25 in chips) 
Seat 6: PinkTrinta ($104.71 in chips) 
Seat 7: YuriiSolodya ($55.11 in chips) 
Seat 8: matiko09 ($100 in chips) 
Seat 9: mycka86 ($101.86 in chips) 
Muinmyheart: posts small blind $0.50
PinkTrinta: posts big blind $1
PacPacBum: sits out 
*** HOLE CARDS ***
Dealt to matiko09 [9h 9c]
YuriiSolodya: raises $2 to $3
matiko09: calls $3
mycka86: folds 
chautinhtri9: folds 
RICKA16: folds 
Jimy Tiltman: folds 
Muinmyheart: folds 
PinkTrinta: folds 
*** FLOP *** [4d Qc 9d]
YuriiSolodya: checks 
matiko09: bets $4.65
YuriiSolodya: calls $4.65
*** TURN *** [4d Qc 9d] [4s]
YuriiSolodya: checks 
matiko09: bets $9
YuriiSolodya: folds 
Uncalled bet ($9) returned to matiko09
matiko09 collected $16.04 from pot
matiko09: doesn't show hand 
*** SUMMARY ***
Total pot $16.80 | Rake $0.76 
Board [4d Qc 9d 4s]
Seat 1: chautinhtri9 folded before Flop (didn't bet)
Seat 2: RICKA16 folded before Flop (didn't bet)
Seat 4: Jimy Tiltman (button) folded before Flop (didn't bet)
Seat 5: Muinmyheart (small blind) folded before Flop
Seat 6: PinkTrinta (big blind) folded before Flop
Seat 7: YuriiSolodya folded on the Turn
Seat 8: matiko09 collected ($16.04)
Seat 9: mycka86 folded before Flop (didn't bet)





PokerStars Hand #150803146021:  Hold'em No Limit ($0.50/$1.00 USD) - 2016/03/23 15:32:26 CET [2016/03/23 10:32:26 ET]
Table 'Haug II' 9-max Seat #4 is the button
Seat 2: ardo888 ($100 in chips) 
Seat 3: camilalope ($92.41 in chips) 
Seat 4: matiko09 ($102.62 in chips) 
Seat 5: GlamDragon ($97.80 in chips) 
Seat 7: jahwe ($100 in chips) 
Seat 8: BRIGANTE49 ($78.12 in chips) 
GlamDragon: posts small blind $0.50
jahwe: posts big blind $1
PacPacBum: sits out 
ardo888: posts the ante $0.20
camilalope: posts the ante $0.20
matiko09: posts the ante $0.20
GlamDragon: posts the ante $0.20
jahwe: posts the ante $0.20
BRIGANTE49: posts the ante $0.20
*** HOLE CARDS ***
Dealt to matiko09 [8h Kd]
BRIGANTE49: folds 
ardo888: folds 
camilalope: raises $2 to $3
maxxmeister was removed from the table for failing to post
matiko09: folds 
GlamDragon: folds 
o.miro joins the table at seat #9 
jahwe: calls $2
*** FLOP *** [As 7d Ah]
jahwe: checks 
o.miro leaves the table
camilalope: bets $3.08
jahwe: folds 
Uncalled bet ($3.08) returned to camilalope
camilalope collected $7.35 from pot
*** SUMMARY ***
Total pot $7.70 | Rake $0.35 
Board [As 7d Ah]
Seat 2: ardo888 folded before Flop (didn't bet)
Seat 3: camilalope collected ($7.35)
Seat 4: matiko09 (button) folded before Flop (didn't bet)
Seat 5: GlamDragon (small blind) folded before Flop
Seat 7: jahwe (big blind) folded on the Flop
Seat 8: BRIGANTE49 folded before Flop (didn't bet)





PokerStars Hand #150803147296:  Hold'em No Limit ($1/$2 USD) - 2016/03/23 15:32:30 CET [2016/03/23 10:32:30 ET]
Table 'Kiess' 9-max Seat #5 is the button
Seat 1: Cirilico ($269.95 in chips) 
Seat 2: jahwe ($200 in chips) 
Seat 3: Red4erT ($100.29 in chips) 
Seat 4: RamiroAgujis ($200 in chips) 
Seat 5: chippo boy ($419.84 in chips) 
Seat 6: matiko09 ($232.48 in chips) 
Seat 7: chaps1988 ($212.24 in chips) 
Seat 8: erfk1958 ($133.05 in chips) 
matiko09: posts small blind $1
chaps1988: posts big blind $2
PacPacBum: sits out 
*** HOLE CARDS ***
Dealt to matiko09 [6h Ks]
erfk1958: folds 
Cirilico: folds 
jahwe: folds 
Red4erT: folds 
RamiroAgujis: folds 
chippo boy: folds 
matiko09: folds 
Uncalled bet ($1) returned to chaps1988
chaps1988 collected $2 from pot
chaps1988: doesn't show hand 
*** SUMMARY ***
Total pot $2 | Rake $0 
Seat 1: Cirilico folded before Flop (didn't bet)
Seat 2: jahwe folded before Flop (didn't bet)
Seat 3: Red4erT folded before Flop (didn't bet)
Seat 4: RamiroAgujis folded before Flop (didn't bet)
Seat 5: chippo boy (button) folded before Flop (didn't bet)
Seat 6: matiko09 (small blind) folded before Flop
Seat 7: chaps1988 (big blind) collected ($2)
Seat 8: erfk1958 folded before Flop (didn't bet)





PokerStars Hand #150803148736:  Hold'em No Limit ($0.50/$1.00 USD) - 2016/03/23 15:32:34 CET [2016/03/23 10:32:34 ET]
Table 'Smiley' 9-max Seat #1 is the button
Seat 1: xHourglass ($100 in chips) 
Seat 2: Jimy Tiltman ($102.24 in chips) 
Seat 3: mycka86 ($100 in chips) 
Seat 4: CAJUN890 ($84.19 in chips) 
Seat 5: Szevasztopol ($150.35 in chips) 
Seat 6: blackmont111 ($123.04 in chips) 
Seat 7: bennetb77 ($89.84 in chips) 
Seat 8: matiko09 ($114.08 in chips) 
Seat 9: PacPacBum ($100 in chips) 
Jimy Tiltman: posts small blind $0.50
mycka86: posts big blind $1
*** HOLE CARDS ***
Dealt to matiko09 [7h Ts]
CAJUN890: folds 
Szevasztopol: folds 
blackmont111: folds 
bennetb77: folds 
matiko09: folds 
PacPacBum: raises $1.04 to $2.04
xHourglass: folds 
Jimy Tiltman: calls $1.54
mycka86: folds 
*** FLOP *** [6d 5c 6c]
Jimy Tiltman: checks 
PacPacBum: checks 
*** TURN *** [6d 5c 6c] [Js]
Jimy Tiltman: checks 
PacPacBum: bets $2.61
Jimy Tiltman: folds 
Uncalled bet ($2.61) returned to PacPacBum
PacPacBum collected $4.85 from pot
PacPacBum: doesn't show hand 
*** SUMMARY ***
Total pot $5.08 | Rake $0.23 
Board [6d 5c 6c Js]
Seat 1: xHourglass (button) folded before Flop (didn't bet)
Seat 2: Jimy Tiltman (small blind) folded on the Turn
Seat 3: mycka86 (big blind) folded before Flop
Seat 4: CAJUN890 folded before Flop (didn't bet)
Seat 5: Szevasztopol folded before Flop (didn't bet)
Seat 6: blackmont111 folded before Flop (didn't bet)
Seat 7: bennetb77 folded before Flop (didn't bet)
Seat 8: matiko09 folded before Flop (didn't bet)
Seat 9: PacPacBum collected ($4.85)





PokerStars Hand #150803149201:  Hold'em No Limit (€1/€2 EUR) - 2016/03/23 15:32:35 CET [2016/03/23 10:32:35 ET]
Table 'Malva II' 9-max Seat #7 is the button
Seat 2: IseeUcards (€200 in chips) 
Seat 3: matiko09 (€259.85 in chips) 
Seat 4: steff0777 (€205 in chips) 
Seat 5: o.miro (€347.35 in chips) 
Seat 6: volwebni4ek (€80 in chips) 
Seat 7: nairolf24 (€216.88 in chips) 
Seat 9: RamiroAgujis (€217.23 in chips) 
jahwe will be allowed to play after the button
RamiroAgujis: posts small blind €1
IseeUcards: posts big blind €2
*** HOLE CARDS ***
Dealt to matiko09 [Ks 6s]
matiko09: folds 
steff0777: folds 
o.miro: folds 
volwebni4ek: folds 
nairolf24: folds 
RamiroAgujis: folds 
Uncalled bet (€1) returned to IseeUcards
IseeUcards collected €2 from pot
IseeUcards: doesn't show hand 
*** SUMMARY ***
Total pot €2 | Rake €0 
Seat 2: IseeUcards (big blind) collected (€2)
Seat 3: matiko09 folded before Flop (didn't bet)
Seat 4: steff0777 folded before Flop (didn't bet)
Seat 5: o.miro folded before Flop (didn't bet)
Seat 6: volwebni4ek folded before Flop (didn't bet)
Seat 7: nairolf24 (button) folded before Flop (didn't bet)
Seat 9: RamiroAgujis (small blind) folded before Flop





PokerStars Hand #150803149765:  Hold'em No Limit ($0.50/$1.00 USD) - 2016/03/23 15:32:37 CET [2016/03/23 10:32:37 ET]
Table 'Swings' 9-max Seat #5 is the button
Seat 1: lumen21 ($101.28 in chips) 
Seat 2: tomver0809 ($66 in chips) 
Seat 4: YuriiSolodya ($41.27 in chips) 
Seat 5: chautinhtri9 ($117.55 in chips) 
Seat 6: matiko09 ($140.42 in chips) 
Seat 7: PacPacBum ($117.49 in chips) 
Seat 8: RICKA16 ($107.18 in chips) 
Seat 9: Effort92 ($103.03 in chips) 
matiko09: posts small blind $0.50
PacPacBum: posts big blind $1
*** HOLE CARDS ***
Dealt to matiko09 [8s 5h]
RICKA16: raises $2 to $3
Effort92: folds 
lumen21: folds 
maxxmeister was removed from the table for failing to post
tomver0809: folds 
YuriiSolodya: folds 
chautinhtri9: calls $3
matiko09: folds 
edidaz joins the table at seat #3 
PacPacBum: raises $9 to $12
RICKA16: folds 
chautinhtri9: folds 
Uncalled bet ($9) returned to PacPacBum
PacPacBum collected $9.50 from pot
PacPacBum: doesn't show hand 
*** SUMMARY ***
Total pot $9.50 | Rake $0 
Seat 1: lumen21 folded before Flop (didn't bet)
Seat 2: tomver0809 folded before Flop (didn't bet)
Seat 4: YuriiSolodya folded before Flop (didn't bet)
Seat 5: chautinhtri9 (button) folded before Flop
Seat 6: matiko09 (small blind) folded before Flop
Seat 7: PacPacBum (big blind) collected ($9.50)
Seat 8: RICKA16 folded before Flop
Seat 9: Effort92 folded before Flop (didn't bet)





PokerStars Hand #150803153335:  Hold'em No Limit ($0.50/$1.00 USD) - 2016/03/23 15:32:47 CET [2016/03/23 10:32:47 ET]
Table 'Asmodeus' 9-max Seat #7 is the button
Seat 1: Jimy Tiltman ($146.25 in chips) 
Seat 3: jahwe ($107.51 in chips) 
Seat 4: Effort92 ($100.40 in chips) 
Seat 5: Muinmyheart ($105.49 in chips) 
Seat 6: fuppeee ($133.15 in chips) 
Seat 7: mycka86 ($116.85 in chips) 
Seat 8: app1e_j@ck ($100 in chips) 
Seat 9: matiko09 ($100 in chips) 
app1e_j@ck: posts small blind $0.50
matiko09: posts big blind $1
PacPacBum: sits out 
Jimy Tiltman: posts the ante $0.20
jahwe: posts the ante $0.20
Effort92: posts the ante $0.20
Muinmyheart: posts the ante $0.20
fuppeee: posts the ante $0.20
mycka86: posts the ante $0.20
app1e_j@ck: posts the ante $0.20
matiko09: posts the ante $0.20
*** HOLE CARDS ***
Dealt to matiko09 [Qc 2s]
Jimy Tiltman: folds 
jahwe: raises $1.50 to $2.50
Effort92: folds 
Muinmyheart: folds 
fuppeee: folds 
mycka86: folds 
app1e_j@ck: folds 
matiko09: folds 
Uncalled bet ($1.50) returned to jahwe
jahwe collected $4.10 from pot
jahwe: doesn't show hand 
*** SUMMARY ***
Total pot $4.10 | Rake $0 
Seat 1: Jimy Tiltman folded before Flop (didn't bet)
Seat 3: jahwe collected ($4.10)
Seat 4: Effort92 folded before Flop (didn't bet)
Seat 5: Muinmyheart folded before Flop (didn't bet)
Seat 6: fuppeee folded before Flop (didn't bet)
Seat 7: mycka86 (button) folded before Flop (didn't bet)
Seat 8: app1e_j@ck (small blind) folded before Flop
Seat 9: matiko09 (big blind) folded before Flop





PokerStars Hand #150803156222:  Hold'em No Limit (€0.50/€1.00 EUR) - 2016/03/23 15:32:56 CET [2016/03/23 10:32:56 ET]
Table 'Volga III' 9-max Seat #1 is the button
Seat 1: Dantist1122 (€100 in chips) 
Seat 2: Scorpion5443 (€44.82 in chips) 
Seat 3: matiko09 (€100 in chips) 
Seat 4: bigacsiga (€109.60 in chips) 
Seat 5: omarr22 (€35.73 in chips) 
Seat 7: jahwe (€100 in chips) 
Seat 8: edidaz (€110.12 in chips) 
Scorpion5443: posts small blind €0.50
matiko09: posts big blind €1
PacPacBum: sits out 
ardo888: sits out 
*** HOLE CARDS ***
Dealt to matiko09 [9s Ah]
bigacsiga: folds 
omarr22: calls €1
jahwe: folds 
edidaz: folds 
Dantist1122: folds 
Scorpion5443: folds 
matiko09: checks 
*** FLOP *** [Qs Kh 8c]
matiko09: checks 
omarr22: bets €2
matiko09: folds 
Uncalled bet (€2) returned to omarr22
omarr22 collected €2.39 from pot
omarr22: doesn't show hand 
*** SUMMARY ***
Total pot €2.50 | Rake €0.11 
Board [Qs Kh 8c]
Seat 1: Dantist1122 (button) folded before Flop (didn't bet)
Seat 2: Scorpion5443 (small blind) folded before Flop
Seat 3: matiko09 (big blind) folded on the Flop
Seat 4: bigacsiga folded before Flop (didn't bet)
Seat 5: omarr22 collected (€2.39)
Seat 7: jahwe folded before Flop (didn't bet)
Seat 8: edidaz folded before Flop (didn't bet)





PokerStars Hand #150803158284:  Hold'em No Limit ($0.50/$1.00 USD) - 2016/03/23 15:33:02 CET [2016/03/23 10:33:02 ET]
Table 'Haug II' 9-max Seat #5 is the button
Seat 2: ardo888 ($100 in chips) 
Seat 3: camilalope ($96.56 in chips) 
Seat 4: matiko09 ($102.42 in chips) 
Seat 5: GlamDragon ($97.10 in chips) 
Seat 7: jahwe ($100 in chips) 
Seat 8: BRIGANTE49 ($77.92 in chips) 
jahwe: posts small blind $0.50
BRIGANTE49: posts big blind $1
PacPacBum: sits out 
ardo888: posts the ante $0.20
camilalope: posts the ante $0.20
matiko09: posts the ante $0.20
GlamDragon: posts the ante $0.20
jahwe: posts the ante $0.20
BRIGANTE49: posts the ante $0.20
*** HOLE CARDS ***
Dealt to matiko09 [3h Kc]
ardo888: folds 
camilalope: folds 
matiko09: folds 
GlamDragon: raises $1 to $2
jahwe: raises $5.50 to $7.50
BRIGANTE49: folds 
GlamDragon: folds 
Uncalled bet ($5.50) returned to jahwe
jahwe collected $6.20 from pot
jahwe: doesn't show hand 
*** SUMMARY ***
Total pot $6.20 | Rake $0 
Seat 2: ardo888 folded before Flop (didn't bet)
Seat 3: camilalope folded before Flop (didn't bet)
Seat 4: matiko09 folded before Flop (didn't bet)
Seat 5: GlamDragon (button) folded before Flop
Seat 7: jahwe (small blind) collected ($6.20)
Seat 8: BRIGANTE49 (big blind) folded before Flop





PokerStars Hand #150803159773:  Hold'em No Limit ($0.50/$1.00 USD) - 2016/03/23 15:33:06 CET [2016/03/23 10:33:06 ET]
Table 'Aetolia II' 9-max Seat #7 is the button
Seat 1: app1e_j@ck ($100 in chips) 
Seat 2: jahwe ($100 in chips) 
Seat 4: Pocketstud ($121.02 in chips) 
Seat 5: KingCastle77 ($89.80 in chips) 
Seat 6: Westpants ($100 in chips) 
Seat 7: matiko09 ($100 in chips) 
Seat 8: PacPacBum ($100 in chips) 
Seat 9: mmcardoulis ($67.55 in chips) 
PacPacBum: posts small blind $0.50
mmcardoulis: posts big blind $1
lumen21: sits out 
*** HOLE CARDS ***
Dealt to matiko09 [Td 3h]
app1e_j@ck: folds 
jahwe: folds 
Pocketstud: folds 
KingCastle77: folds 
Westpants: folds 
matiko09: folds 
PacPacBum: raises $1.50 to $2.50
mmcardoulis: folds 
Uncalled bet ($1.50) returned to PacPacBum
PacPacBum collected $2 from pot
PacPacBum: doesn't show hand 
*** SUMMARY ***
Total pot $2 | Rake $0 
Seat 1: app1e_j@ck folded before Flop (didn't bet)
Seat 2: jahwe folded before Flop (didn't bet)
Seat 4: Pocketstud folded before Flop (didn't bet)
Seat 5: KingCastle77 folded before Flop (didn't bet)
Seat 6: Westpants folded before Flop (didn't bet)
Seat 7: matiko09 (button) folded before Flop (didn't bet)
Seat 8: PacPacBum (small blind) collected ($2)
Seat 9: mmcardoulis (big blind) folded before Flop





PokerStars Hand #150803160111:  Hold'em No Limit ($1/$2 USD) - 2016/03/23 15:33:07 CET [2016/03/23 10:33:07 ET]
Table 'Kiess' 9-max Seat #6 is the button
Seat 1: Cirilico ($269.95 in chips) 
Seat 2: jahwe ($200 in chips) 
Seat 3: Red4erT ($100.29 in chips) 
Seat 4: RamiroAgujis ($200 in chips) 
Seat 5: chippo boy ($419.84 in chips) 
Seat 6: matiko09 ($231.48 in chips) 
Seat 7: chaps1988 ($213.24 in chips) 
Seat 8: erfk1958 ($133.05 in chips) 
chaps1988: posts small blind $1
erfk1958: posts big blind $2
PacPacBum: sits out 
*** HOLE CARDS ***
Dealt to matiko09 [9c 2h]
Cirilico: raises $4 to $6
jahwe: folds 
Red4erT: folds 
RamiroAgujis: folds 
chippo boy: folds 
matiko09: folds 
chaps1988: folds 
erfk1958: calls $4
*** FLOP *** [4d 3c 6h]
erfk1958: checks 
Cirilico: bets $8
erfk1958: folds 
Uncalled bet ($8) returned to Cirilico
Cirilico collected $12.42 from pot
Cirilico: doesn't show hand 
*** SUMMARY ***
Total pot $13 | Rake $0.58 
Board [4d 3c 6h]
Seat 1: Cirilico collected ($12.42)
Seat 2: jahwe folded before Flop (didn't bet)
Seat 3: Red4erT folded before Flop (didn't bet)
Seat 4: RamiroAgujis folded before Flop (didn't bet)
Seat 5: chippo boy folded before Flop (didn't bet)
Seat 6: matiko09 (button) folded before Flop (didn't bet)
Seat 7: chaps1988 (small blind) folded before Flop
Seat 8: erfk1958 (big blind) folded on the Flop





PokerStars Hand #150803160819:  Hold'em No Limit (€0.50/€1.00 EUR) - 2016/03/23 15:33:09 CET [2016/03/23 10:33:09 ET]
Table 'Mercury III' 9-max Seat #8 is the button
Seat 1: matiko09 (€126.35 in chips) 
Seat 2: jahwe (€100 in chips) 
Seat 4: Muinmyheart (€101.50 in chips) 
Seat 5: ardo888 (€102.50 in chips) 
Seat 6: mycka86 (€100 in chips) 
Seat 7: STrakDD (€101.10 in chips) 
Seat 8: gfxed (€58.30 in chips) 
Seat 9: Indr3k (€100 in chips) 
Indr3k: posts small blind €0.50
matiko09: posts big blind €1
PacPacBum: sits out 
*** HOLE CARDS ***
Dealt to matiko09 [Tc 4s]
jahwe: raises €2 to €3
Muinmyheart: folds 
ardo888: folds 
mycka86: folds 
STrakDD: folds 
gfxed: folds 
Indr3k: folds 
matiko09: folds 
Uncalled bet (€2) returned to jahwe
jahwe collected €2.50 from pot
jahwe: doesn't show hand 
*** SUMMARY ***
Total pot €2.50 | Rake €0 
Seat 1: matiko09 (big blind) folded before Flop
Seat 2: jahwe collected (€2.50)
Seat 4: Muinmyheart folded before Flop (didn't bet)
Seat 5: ardo888 folded before Flop (didn't bet)
Seat 6: mycka86 folded before Flop (didn't bet)
Seat 7: STrakDD folded before Flop (didn't bet)
Seat 8: gfxed (button) folded before Flop (didn't bet)
Seat 9: Indr3k (small blind) folded before Flop





PokerStars Hand #150803162643:  Hold'em No Limit ($0.50/$1.00 USD) - 2016/03/23 15:33:14 CET [2016/03/23 10:33:14 ET]
Table 'Swings' 9-max Seat #6 is the button
Seat 1: lumen21 ($101.28 in chips) 
Seat 2: tomver0809 ($66 in chips) 
Seat 4: YuriiSolodya ($41.27 in chips) 
Seat 5: chautinhtri9 ($114.55 in chips) 
Seat 6: matiko09 ($139.92 in chips) 
Seat 7: PacPacBum ($123.99 in chips) 
Seat 8: RICKA16 ($104.18 in chips) 
Seat 9: Effort92 ($103.03 in chips) 
PacPacBum: posts small blind $0.50
RICKA16: posts big blind $1
*** HOLE CARDS ***
Dealt to matiko09 [6d 8c]
Effort92: folds 
lumen21: folds 
tomver0809: folds 
YuriiSolodya: raises $1 to $2
chautinhtri9: folds 
matiko09: folds 
PacPacBum: folds 
RICKA16: folds 
Uncalled bet ($1) returned to YuriiSolodya
YuriiSolodya collected $2.50 from pot
YuriiSolodya: doesn't show hand 
*** SUMMARY ***
Total pot $2.50 | Rake $0 
Seat 1: lumen21 folded before Flop (didn't bet)
Seat 2: tomver0809 folded before Flop (didn't bet)
Seat 4: YuriiSolodya collected ($2.50)
Seat 5: chautinhtri9 folded before Flop (didn't bet)
Seat 6: matiko09 (button) folded before Flop (didn't bet)
Seat 7: PacPacBum (small blind) folded before Flop
Seat 8: RICKA16 (big blind) folded before Flop
Seat 9: Effort92 folded before Flop (didn't bet)





PokerStars Hand #150803164182:  Hold'em No Limit ($0.50/$1.00 USD) - 2016/03/23 15:33:19 CET [2016/03/23 10:33:19 ET]
Table 'Asmodeus' 9-max Seat #8 is the button
Seat 1: Jimy Tiltman ($146.05 in chips) 
Seat 3: jahwe ($110.41 in chips) 
Seat 4: Effort92 ($100.20 in chips) 
Seat 5: Muinmyheart ($105.29 in chips) 
Seat 6: fuppeee ($132.95 in chips) 
Seat 7: mycka86 ($116.65 in chips) 
Seat 8: app1e_j@ck ($100 in chips) 
Seat 9: matiko09 ($100 in chips) 
matiko09: posts small blind $0.50
Jimy Tiltman: posts big blind $1
PacPacBum: sits out 
Jimy Tiltman: posts the ante $0.20
jahwe: posts the ante $0.20
Effort92: posts the ante $0.20
Muinmyheart: posts the ante $0.20
fuppeee: posts the ante $0.20
mycka86: posts the ante $0.20
app1e_j@ck: posts the ante $0.20
matiko09: posts the ante $0.20
*** HOLE CARDS ***
Dealt to matiko09 [Ad 2d]
jahwe: folds 
Effort92: raises $2 to $3
Muinmyheart: folds 
fuppeee: folds 
mycka86: folds 
app1e_j@ck: folds 
matiko09: folds 
Jimy Tiltman: raises $6.44 to $9.44
Effort92: calls $6.44
*** FLOP *** [3h 4s Qs]
Jimy Tiltman: bets $12
Effort92: calls $12
*** TURN *** [3h 4s Qs] [Jd]
Jimy Tiltman: bets $21.48
Effort92: folds 
Uncalled bet ($21.48) returned to Jimy Tiltman
Jimy Tiltman collected $42.96 from pot
Jimy Tiltman: doesn't show hand 
*** SUMMARY ***
Total pot $44.98 | Rake $2.02 
Board [3h 4s Qs Jd]
Seat 1: Jimy Tiltman (big blind) collected ($42.96)
Seat 3: jahwe folded before Flop (didn't bet)
Seat 4: Effort92 folded on the Turn
Seat 5: Muinmyheart folded before Flop (didn't bet)
Seat 6: fuppeee folded before Flop (didn't bet)
Seat 7: mycka86 folded before Flop (didn't bet)
Seat 8: app1e_j@ck (button) folded before Flop (didn't bet)
Seat 9: matiko09 (small blind) folded before Flop





PokerStars Hand #150803164732:  Hold'em No Limit ($0.50/$1.00 USD) - 2016/03/23 15:33:21 CET [2016/03/23 10:33:21 ET]
Table 'Smiley' 9-max Seat #2 is the button
Seat 1: xHourglass ($100 in chips) 
Seat 2: Jimy Tiltman ($100.20 in chips) 
Seat 3: mycka86 ($100 in chips) 
Seat 4: CAJUN890 ($84.19 in chips) 
Seat 5: Szevasztopol ($150.35 in chips) 
Seat 6: blackmont111 ($123.04 in chips) 
Seat 7: bennetb77 ($89.84 in chips) 
Seat 8: matiko09 ($114.08 in chips) 
Seat 9: PacPacBum ($102.81 in chips) 
mycka86: posts small blind $0.50
CAJUN890: posts big blind $1
*** HOLE CARDS ***
Dealt to matiko09 [5s Ts]
Szevasztopol: folds 
blackmont111: folds 
bennetb77: folds 
matiko09: folds 
PacPacBum: folds 
xHourglass: raises $2 to $3
Jimy Tiltman: folds 
mycka86: folds 
CAJUN890: folds 
Uncalled bet ($2) returned to xHourglass
xHourglass collected $2.50 from pot
xHourglass: doesn't show hand 
*** SUMMARY ***
Total pot $2.50 | Rake $0 
Seat 1: xHourglass collected ($2.50)
Seat 2: Jimy Tiltman (button) folded before Flop (didn't bet)
Seat 3: mycka86 (small blind) folded before Flop
Seat 4: CAJUN890 (big blind) folded before Flop
Seat 5: Szevasztopol folded before Flop (didn't bet)
Seat 6: blackmont111 folded before Flop (didn't bet)
Seat 7: bennetb77 folded before Flop (didn't bet)
Seat 8: matiko09 folded before Flop (didn't bet)
Seat 9: PacPacBum folded before Flop (didn't bet)





PokerStars Hand #150803165297:  Hold'em No Limit ($0.50/$1.00 USD) - 2016/03/23 15:33:22 CET [2016/03/23 10:33:22 ET]
Table 'Haug II' 9-max Seat #7 is the button
Seat 1: PacPacBum ($105.67 in chips) 
Seat 2: ardo888 ($100 in chips) 
Seat 3: camilalope ($96.36 in chips) 
Seat 4: matiko09 ($102.22 in chips) 
Seat 5: GlamDragon ($94.90 in chips) 
Seat 7: jahwe ($104 in chips) 
Seat 8: BRIGANTE49 ($76.72 in chips) 
BRIGANTE49: posts small blind $0.50
PacPacBum: posts big blind $1
PacPacBum: posts the ante $0.20
ardo888: posts the ante $0.20
camilalope: posts the ante $0.20
matiko09: posts the ante $0.20
GlamDragon: posts the ante $0.20
jahwe: posts the ante $0.20
BRIGANTE49: posts the ante $0.20
*** HOLE CARDS ***
Dealt to matiko09 [2h 4d]
ardo888: folds 
camilalope: folds 
matiko09: folds 
GlamDragon: raises $1 to $2
jahwe: folds 
BRIGANTE49: calls $1.50
PacPacBum: folds 
*** FLOP *** [9d As 6s]
BRIGANTE49: checks 
GlamDragon: bets $4
Pocketstud joins the table at seat #6 
BRIGANTE49: folds 
Uncalled bet ($4) returned to GlamDragon
GlamDragon collected $6.11 from pot
GlamDragon: doesn't show hand 
*** SUMMARY ***
Total pot $6.40 | Rake $0.29 
Board [9d As 6s]
Seat 1: PacPacBum (big blind) folded before Flop
Seat 2: ardo888 folded before Flop (didn't bet)
Seat 3: camilalope folded before Flop (didn't bet)
Seat 4: matiko09 folded before Flop (didn't bet)
Seat 5: GlamDragon collected ($6.11)
Seat 7: jahwe (button) folded before Flop (didn't bet)
Seat 8: BRIGANTE49 (small blind) folded on the Flop





PokerStars Hand #150803168657:  Hold'em No Limit ($0.50/$1.00 USD) - 2016/03/23 15:33:32 CET [2016/03/23 10:33:32 ET]
Table 'Sylvia III' 9-max Seat #9 is the button
Seat 1: mycka86 ($131.90 in chips) 
Seat 2: Dantist1122 ($111.90 in chips) 
Seat 3: se7en_$tars ($210.02 in chips) 
Seat 4: lombardo11 ($56.04 in chips) 
Seat 5: matiko09 ($100 in chips) 
Seat 8: Muinmyheart ($139 in chips) 
Seat 9: Jimy Tiltman ($100 in chips) 
mycka86: posts small blind $0.50
Dantist1122: posts big blind $1
PacPacBum: sits out 
jahwe: sits out 
mycka86: posts the ante $0.20
Dantist1122: posts the ante $0.20
se7en_$tars: posts the ante $0.20
lombardo11: posts the ante $0.20
matiko09: posts the ante $0.20
Muinmyheart: posts the ante $0.20
Jimy Tiltman: posts the ante $0.20
*** HOLE CARDS ***
Dealt to matiko09 [6s 7h]
se7en_$tars: folds 
lombardo11: folds 
matiko09: folds 
Muinmyheart: folds 
Jimy Tiltman: raises $1 to $2
mycka86: folds 
Dantist1122: folds 
Uncalled bet ($1) returned to Jimy Tiltman
Jimy Tiltman collected $3.90 from pot
Jimy Tiltman: doesn't show hand 
*** SUMMARY ***
Total pot $3.90 | Rake $0 
Seat 1: mycka86 (small blind) folded before Flop
Seat 2: Dantist1122 (big blind) folded before Flop
Seat 3: se7en_$tars folded before Flop (didn't bet)
Seat 4: lombardo11 folded before Flop (didn't bet)
Seat 5: matiko09 folded before Flop (didn't bet)
Seat 8: Muinmyheart folded before Flop (didn't bet)
Seat 9: Jimy Tiltman (button) collected ($3.90)





PokerStars Hand #150803170318:  Hold'em No Limit (€0.50/€1.00 EUR) - 2016/03/23 15:33:37 CET [2016/03/23 10:33:37 ET]
Table 'Mercury III' 9-max Seat #9 is the button
Seat 1: matiko09 (€125.35 in chips) 
Seat 2: jahwe (€101.50 in chips) 
Seat 4: Muinmyheart (€101.50 in chips) 
Seat 5: ardo888 (€102.50 in chips) 
Seat 6: mycka86 (€100 in chips) 
Seat 7: STrakDD (€101.10 in chips) 
Seat 8: gfxed (€58.30 in chips) 
Seat 9: Indr3k (€100 in chips) 
matiko09: posts small blind €0.50
jahwe: posts big blind €1
PacPacBum: sits out 
*** HOLE CARDS ***
Dealt to matiko09 [Qc 5d]
Muinmyheart: folds 
ardo888: folds 
mycka86: raises €2 to €3
STrakDD: folds 
gfxed: folds 
Indr3k: folds 
matiko09: folds 
jahwe: folds 
Uncalled bet (€2) returned to mycka86
mycka86 collected €2.50 from pot
*** SUMMARY ***
Total pot €2.50 | Rake €0 
Seat 1: matiko09 (small blind) folded before Flop
Seat 2: jahwe (big blind) folded before Flop
Seat 4: Muinmyheart folded before Flop (didn't bet)
Seat 5: ardo888 folded before Flop (didn't bet)
Seat 6: mycka86 collected (€2.50)
Seat 7: STrakDD folded before Flop (didn't bet)
Seat 8: gfxed folded before Flop (didn't bet)
Seat 9: Indr3k (button) folded before Flop (didn't bet)





PokerStars Hand #150803170302:  Hold'em No Limit ($0.50/$1.00 USD) - 2016/03/23 15:33:37 CET [2016/03/23 10:33:37 ET]
Table 'Drakonia II' 9-max Seat #5 is the button
Seat 1: chautinhtri9 ($127.60 in chips) 
Seat 2: RICKA16 ($100 in chips) 
Seat 4: Jimy Tiltman ($100 in chips) 
Seat 5: Muinmyheart ($100 in chips) 
Seat 6: PinkTrinta ($103.71 in chips) 
Seat 7: YuriiSolodya ($47.46 in chips) 
Seat 8: matiko09 ($108.39 in chips) 
Seat 9: mycka86 ($101.86 in chips) 
PinkTrinta: posts small blind $0.50
YuriiSolodya: posts big blind $1
PacPacBum: sits out 
*** HOLE CARDS ***
Dealt to matiko09 [Tc Ad]
matiko09: folds 
mycka86: folds 
chautinhtri9: folds 
RICKA16: raises $2 to $3
Jimy Tiltman: folds 
Muinmyheart: folds 
PinkTrinta: raises $7.50 to $10.50
YuriiSolodya: folds 
chautinhtri9 is disconnected 
RICKA16: folds 
Uncalled bet ($7.50) returned to PinkTrinta
PinkTrinta collected $7 from pot
*** SUMMARY ***
Total pot $7 | Rake $0 
Seat 1: chautinhtri9 folded before Flop (didn't bet)
Seat 2: RICKA16 folded before Flop
Seat 4: Jimy Tiltman folded before Flop (didn't bet)
Seat 5: Muinmyheart (button) folded before Flop (didn't bet)
Seat 6: PinkTrinta (small blind) collected ($7)
Seat 7: YuriiSolodya (big blind) folded before Flop
Seat 8: matiko09 folded before Flop (didn't bet)
Seat 9: mycka86 folded before Flop (didn't bet)





PokerStars Hand #150803170655:  Hold'em No Limit ($0.50/$1.00 USD) - 2016/03/23 15:33:38 CET [2016/03/23 10:33:38 ET]
Table 'Swings' 9-max Seat #7 is the button
Seat 1: lumen21 ($101.28 in chips) 
Seat 2: tomver0809 ($66 in chips) 
Seat 4: YuriiSolodya ($42.77 in chips) 
Seat 5: chautinhtri9 ($114.55 in chips) 
Seat 6: matiko09 ($139.92 in chips) 
Seat 7: PacPacBum ($123.49 in chips) 
Seat 8: RICKA16 ($103.18 in chips) 
Seat 9: Effort92 ($103.03 in chips) 
RICKA16: posts small blind $0.50
Effort92: posts big blind $1
edidaz: sits out 
*** HOLE CARDS ***
Dealt to matiko09 [Ts Qh]
lumen21: folds 
tomver0809: folds 
YuriiSolodya: folds 
chautinhtri9: folds 
matiko09: raises $1.50 to $2.50
PacPacBum: folds 
RICKA16: folds 
Effort92: folds 
Uncalled bet ($1.50) returned to matiko09
matiko09 collected $2.50 from pot
matiko09: doesn't show hand 
*** SUMMARY ***
Total pot $2.50 | Rake $0 
Seat 1: lumen21 folded before Flop (didn't bet)
Seat 2: tomver0809 folded before Flop (didn't bet)
Seat 4: YuriiSolodya folded before Flop (didn't bet)
Seat 5: chautinhtri9 folded before Flop (didn't bet)
Seat 6: matiko09 collected ($2.50)
Seat 7: PacPacBum (button) folded before Flop (didn't bet)
Seat 8: RICKA16 (small blind) folded before Flop
Seat 9: Effort92 (big blind) folded before Flop





PokerStars Hand #150803170881:  Hold'em No Limit (€0.50/€1.00 EUR) - 2016/03/23 15:33:38 CET [2016/03/23 10:33:38 ET]
Table 'Volga III' 9-max Seat #2 is the button
Seat 1: Dantist1122 (€100 in chips) 
Seat 2: Scorpion5443 (€44.32 in chips) 
Seat 3: matiko09 (€100 in chips) 
Seat 4: bigacsiga (€109.60 in chips) 
Seat 5: omarr22 (€37.12 in chips) 
Seat 7: jahwe (€100 in chips) 
Seat 8: edidaz (€110.12 in chips) 
matiko09: posts small blind €0.50
bigacsiga: posts big blind €1
PacPacBum: sits out 
ardo888: sits out 
*** HOLE CARDS ***
Dealt to matiko09 [5c Tc]
omarr22: calls €1
jahwe: folds 
edidaz: folds 
Dantist1122: folds 
Scorpion5443: folds 
matiko09: folds 
bigacsiga: checks 
*** FLOP *** [3c Ac Th]
bigacsiga: checks 
omarr22: checks 
*** TURN *** [3c Ac Th] [8h]
bigacsiga: checks 
omarr22: bets €2
bigacsiga: folds 
Uncalled bet (€2) returned to omarr22
omarr22 collected €2.39 from pot
omarr22: doesn't show hand 
*** SUMMARY ***
Total pot €2.50 | Rake €0.11 
Board [3c Ac Th 8h]
Seat 1: Dantist1122 folded before Flop (didn't bet)
Seat 2: Scorpion5443 (button) folded before Flop (didn't bet)
Seat 3: matiko09 (small blind) folded before Flop
Seat 4: bigacsiga (big blind) folded on the Turn
Seat 5: omarr22 collected (€2.39)
Seat 7: jahwe folded before Flop (didn't bet)
Seat 8: edidaz folded before Flop (didn't bet)





PokerStars Hand #150803173938:  Hold'em No Limit ($0.50/$1.00 USD) - 2016/03/23 15:33:47 CET [2016/03/23 10:33:47 ET]
Table 'Aetolia II' 9-max Seat #8 is the button
Seat 2: jahwe ($100 in chips) 
Seat 4: Pocketstud ($121.02 in chips) 
Seat 5: KingCastle77 ($89.80 in chips) 
Seat 6: Westpants ($100 in chips) 
Seat 7: matiko09 ($100 in chips) 
Seat 8: PacPacBum ($101 in chips) 
Seat 9: mmcardoulis ($66.55 in chips) 
mmcardoulis: posts small blind $0.50
app1e_j@ck: is sitting out 
jahwe: posts big blind $1
lumen21: sits out 
*** HOLE CARDS ***
Dealt to matiko09 [6d 7s]
app1e_j@ck leaves the table
edidaz joins the table at seat #1 
Pocketstud: folds 
edidaz leaves the table
KingCastle77: folds 
Westpants: folds 
matiko09: folds 
PacPacBum: folds 
mmcardoulis: folds 
Uncalled bet ($0.50) returned to jahwe
jahwe collected $1 from pot
jahwe: doesn't show hand 
*** SUMMARY ***
Total pot $1 | Rake $0 
Seat 2: jahwe (big blind) collected ($1)
Seat 4: Pocketstud folded before Flop (didn't bet)
Seat 5: KingCastle77 folded before Flop (didn't bet)
Seat 6: Westpants folded before Flop (didn't bet)
Seat 7: matiko09 folded before Flop (didn't bet)
Seat 8: PacPacBum (button) folded before Flop (didn't bet)
Seat 9: mmcardoulis (small blind) folded before Flop





PokerStars Hand #150803175108:  Hold'em No Limit ($0.50/$1.00 USD) - 2016/03/23 15:33:51 CET [2016/03/23 10:33:51 ET]
Table 'Haug II' 9-max Seat #8 is the button
Seat 1: PacPacBum ($104.47 in chips) 
Seat 2: ardo888 ($100 in chips) 
Seat 3: camilalope ($96.16 in chips) 
Seat 4: matiko09 ($102.02 in chips) 
Seat 5: GlamDragon ($98.81 in chips) 
Seat 7: jahwe ($103.80 in chips) 
Seat 8: BRIGANTE49 ($74.52 in chips) 
PacPacBum: posts small blind $0.50
ardo888: posts big blind $1
Pocketstud: sits out 
PacPacBum: posts the ante $0.20
ardo888: posts the ante $0.20
camilalope: posts the ante $0.20
matiko09: posts the ante $0.20
GlamDragon: posts the ante $0.20
jahwe: posts the ante $0.20
BRIGANTE49: posts the ante $0.20
*** HOLE CARDS ***
Dealt to matiko09 [Ts 2c]
camilalope: folds 
ZOLOTOY766 joins the table at seat #9 
matiko09: folds 
GlamDragon: folds 
jahwe: raises $1.50 to $2.50
BRIGANTE49: folds 
PacPacBum: folds 
ardo888: calls $1.50
*** FLOP *** [3d Ad Td]
ardo888: checks 
jahwe: bets $3
ardo888: folds 
Uncalled bet ($3) returned to jahwe
jahwe collected $6.59 from pot
jahwe: doesn't show hand 
*** SUMMARY ***
Total pot $6.90 | Rake $0.31 
Board [3d Ad Td]
Seat 1: PacPacBum (small blind) folded before Flop
Seat 2: ardo888 (big blind) folded on the Flop
Seat 3: camilalope folded before Flop (didn't bet)
Seat 4: matiko09 folded before Flop (didn't bet)
Seat 5: GlamDragon folded before Flop (didn't bet)
Seat 7: jahwe collected ($6.59)
Seat 8: BRIGANTE49 (button) folded before Flop (didn't bet)





PokerStars Hand #150803181086:  Hold'em No Limit ($0.50/$1.00 USD) - 2016/03/23 15:34:08 CET [2016/03/23 10:34:08 ET]
Table 'Smiley' 9-max Seat #3 is the button
Seat 1: xHourglass ($101.50 in chips) 
Seat 2: Jimy Tiltman ($100.20 in chips) 
Seat 3: mycka86 ($100 in chips) 
Seat 4: CAJUN890 ($83.19 in chips) 
Seat 5: Szevasztopol ($150.35 in chips) 
Seat 6: blackmont111 ($123.04 in chips) 
Seat 7: bennetb77 ($89.84 in chips) 
Seat 8: matiko09 ($114.08 in chips) 
Seat 9: PacPacBum ($102.81 in chips) 
CAJUN890: posts small blind $0.50
Szevasztopol: posts big blind $1
*** HOLE CARDS ***
Dealt to matiko09 [Td 4h]
blackmont111: folds 
bennetb77: folds 
matiko09: folds 
PacPacBum: raises $2 to $3
xHourglass: folds 
Jimy Tiltman: folds 
mycka86: folds 
CAJUN890: folds 
Szevasztopol: folds 
Uncalled bet ($2) returned to PacPacBum
PacPacBum collected $2.50 from pot
PacPacBum: doesn't show hand 
*** SUMMARY ***
Total pot $2.50 | Rake $0 
Seat 1: xHourglass folded before Flop (didn't bet)
Seat 2: Jimy Tiltman folded before Flop (didn't bet)
Seat 3: mycka86 (button) folded before Flop (didn't bet)
Seat 4: CAJUN890 (small blind) folded before Flop
Seat 5: Szevasztopol (big blind) folded before Flop
Seat 6: blackmont111 folded before Flop (didn't bet)
Seat 7: bennetb77 folded before Flop (didn't bet)
Seat 8: matiko09 folded before Flop (didn't bet)
Seat 9: PacPacBum collected ($2.50)





PokerStars Hand #150803181676:  Hold'em No Limit ($0.50/$1.00 USD) - 2016/03/23 15:34:10 CET [2016/03/23 10:34:10 ET]
Table 'Atlantis' 9-max Seat #5 is the button
Seat 1: xHourglass ($156.96 in chips) 
Seat 2: Szevasztopol ($100 in chips) 
Seat 3: CAJUN890 ($70.01 in chips) 
Seat 4: mycka86 ($121.04 in chips) 
Seat 5: Durango-CO77 ($45.46 in chips) 
Seat 6: PacPacBum ($116.91 in chips) 
Seat 7: matiko09 ($142.61 in chips) 
Seat 8: jahwe ($100 in chips) 
Seat 9: RICKA16 ($127.32 in chips) 
PacPacBum: posts small blind $0.50
matiko09: posts big blind $1
*** HOLE CARDS ***
Dealt to matiko09 [7h 5d]
jahwe: folds 
RICKA16: raises $2 to $3
xHourglass: calls $3
Szevasztopol: folds 
CAJUN890: calls $3
mycka86: folds 
Durango-CO77: calls $3
PacPacBum: folds 
matiko09: folds 
*** FLOP *** [4c 7s Kh]
RICKA16: checks 
xHourglass: checks 
CAJUN890: checks 
Durango-CO77: checks 
*** TURN *** [4c 7s Kh] [Qh]
RICKA16: bets $8
xHourglass: folds 
CAJUN890: folds 
Durango-CO77: folds 
Uncalled bet ($8) returned to RICKA16
RICKA16 collected $12.89 from pot
RICKA16: doesn't show hand 
*** SUMMARY ***
Total pot $13.50 | Rake $0.61 
Board [4c 7s Kh Qh]
Seat 1: xHourglass folded on the Turn
Seat 2: Szevasztopol folded before Flop (didn't bet)
Seat 3: CAJUN890 folded on the Turn
Seat 4: mycka86 folded before Flop (didn't bet)
Seat 5: Durango-CO77 (button) folded on the Turn
Seat 6: PacPacBum (small blind) folded before Flop
Seat 7: matiko09 (big blind) folded before Flop
Seat 8: jahwe folded before Flop (didn't bet)
Seat 9: RICKA16 collected ($12.89)





PokerStars Hand #150803182290:  Hold'em No Limit (€0.50/€1.00 EUR) - 2016/03/23 15:34:12 CET [2016/03/23 10:34:12 ET]
Table 'Volga III' 9-max Seat #3 is the button
Seat 1: Dantist1122 (€100 in chips) 
Seat 2: Scorpion5443 (€44.32 in chips) 
Seat 3: matiko09 (€100 in chips) 
Seat 4: bigacsiga (€108.60 in chips) 
Seat 5: omarr22 (€38.51 in chips) 
Seat 7: jahwe (€100 in chips) 
Seat 8: edidaz (€110.12 in chips) 
bigacsiga: posts small blind €0.50
omarr22: posts big blind €1
PacPacBum: sits out 
ardo888: sits out 
*** HOLE CARDS ***
Dealt to matiko09 [6h 3c]
jahwe: folds 
edidaz: folds 
Dantist1122: raises €2 to €3
Scorpion5443: folds 
matiko09: folds 
bigacsiga: folds 
omarr22: folds 
Uncalled bet (€2) returned to Dantist1122
Dantist1122 collected €2.50 from pot
Dantist1122: doesn't show hand 
*** SUMMARY ***
Total pot €2.50 | Rake €0 
Seat 1: Dantist1122 collected (€2.50)
Seat 2: Scorpion5443 folded before Flop (didn't bet)
Seat 3: matiko09 (button) folded before Flop (didn't bet)
Seat 4: bigacsiga (small blind) folded before Flop
Seat 5: omarr22 (big blind) folded before Flop
Seat 7: jahwe folded before Flop (didn't bet)
Seat 8: edidaz folded before Flop (didn't bet)





PokerStars Hand #150803182266:  Hold'em No Limit ($0.50/$1.00 USD) - 2016/03/23 15:34:12 CET [2016/03/23 10:34:12 ET]
Table 'Swings' 9-max Seat #8 is the button
Seat 1: lumen21 ($101.28 in chips) 
Seat 2: tomver0809 ($66 in chips) 
Seat 4: YuriiSolodya ($42.77 in chips) 
Seat 5: chautinhtri9 ($114.55 in chips) 
Seat 6: matiko09 ($141.42 in chips) 
Seat 7: PacPacBum ($123.49 in chips) 
Seat 8: RICKA16 ($102.68 in chips) 
Seat 9: Effort92 ($102.03 in chips) 
Effort92: posts small blind $0.50
lumen21: posts big blind $1
edidaz: sits out 
*** HOLE CARDS ***
Dealt to matiko09 [6h Kc]
tomver0809: folds 
YuriiSolodya: folds 
chautinhtri9 is disconnected 
chautinhtri9 has timed out while disconnected
chautinhtri9: folds 
matiko09: folds 
PacPacBum: folds 
RICKA16: folds 
Effort92: raises $1.50 to $2.50
lumen21: folds 
Uncalled bet ($1.50) returned to Effort92
Effort92 collected $2 from pot
Effort92: doesn't show hand 
*** SUMMARY ***
Total pot $2 | Rake $0 
Seat 1: lumen21 (big blind) folded before Flop
Seat 2: tomver0809 folded before Flop (didn't bet)
Seat 4: YuriiSolodya folded before Flop (didn't bet)
Seat 5: chautinhtri9 folded before Flop (didn't bet)
Seat 6: matiko09 folded before Flop (didn't bet)
Seat 7: PacPacBum folded before Flop (didn't bet)
Seat 8: RICKA16 (button) folded before Flop (didn't bet)
Seat 9: Effort92 (small blind) collected ($2)





PokerStars Hand #150803182939:  Hold'em No Limit ($1/$2 USD) - 2016/03/23 15:34:13 CET [2016/03/23 10:34:13 ET]
Table 'Kiess' 9-max Seat #7 is the button
Seat 1: Cirilico ($276.37 in chips) 
Seat 2: jahwe ($200 in chips) 
Seat 3: Red4erT ($100.29 in chips) 
Seat 4: RamiroAgujis ($200 in chips) 
Seat 5: chippo boy ($419.84 in chips) 
Seat 6: matiko09 ($231.48 in chips) 
Seat 7: chaps1988 ($212.24 in chips) 
Seat 8: erfk1958 ($127.05 in chips) 
Seat 9: PacPacBum ($203 in chips) 
erfk1958: posts small blind $1
PacPacBum: posts big blind $2
*** HOLE CARDS ***
Dealt to matiko09 [8s 3s]
Cirilico: folds 
jahwe: folds 
Red4erT: folds 
RamiroAgujis: folds 
chippo boy: calls $2
matiko09: folds 
chaps1988: folds 
erfk1958: calls $1
PacPacBum: checks 
*** FLOP *** [4h Qs Jd]
erfk1958: checks 
PacPacBum: checks 
chippo boy: checks 
*** TURN *** [4h Qs Jd] [Ac]
erfk1958: bets $4
PacPacBum: folds 
chippo boy: folds 
Uncalled bet ($4) returned to erfk1958
erfk1958 collected $5.73 from pot
erfk1958: doesn't show hand 
*** SUMMARY ***
Total pot $6 | Rake $0.27 
Board [4h Qs Jd Ac]
Seat 1: Cirilico folded before Flop (didn't bet)
Seat 2: jahwe folded before Flop (didn't bet)
Seat 3: Red4erT folded before Flop (didn't bet)
Seat 4: RamiroAgujis folded before Flop (didn't bet)
Seat 5: chippo boy folded on the Turn
Seat 6: matiko09 folded before Flop (didn't bet)
Seat 7: chaps1988 (button) folded before Flop (didn't bet)
Seat 8: erfk1958 (small blind) collected ($5.73)
Seat 9: PacPacBum (big blind) folded on the Turn





PokerStars Hand #150803184293:  Hold'em No Limit ($0.50/$1.00 USD) - 2016/03/23 15:34:17 CET [2016/03/23 10:34:17 ET]
Table 'Aetolia II' 9-max Seat #9 is the button
Seat 2: jahwe ($100.50 in chips) 
Seat 3: lumen21 ($100 in chips) 
Seat 4: Pocketstud ($121.02 in chips) 
Seat 5: KingCastle77 ($89.80 in chips) 
Seat 6: Westpants ($100 in chips) 
Seat 7: matiko09 ($100 in chips) 
Seat 8: PacPacBum ($101 in chips) 
Seat 9: mmcardoulis ($66.05 in chips) 
jahwe: posts small blind $0.50
lumen21: posts big blind $1
*** HOLE CARDS ***
Dealt to matiko09 [7c 7d]
Pocketstud: folds 
edidaz joins the table at seat #1 
KingCastle77 has timed out
KingCastle77: folds 
Westpants: folds 
matiko09: raises $2 to $3
edidaz leaves the table
ganzhuang joins the table at seat #1 
PacPacBum: calls $3
mmcardoulis: folds 
jahwe: calls $2.50
lumen21: folds 
*** FLOP *** [Tc 2c Qh]
jahwe: checks 
matiko09: checks 
PacPacBum: checks 
*** TURN *** [Tc 2c Qh] [Jd]
jahwe: checks 
matiko09: checks 
PacPacBum: checks 
*** RIVER *** [Tc 2c Qh Jd] [8d]
jahwe: bets $4.50
matiko09: folds 
PacPacBum: calls $4.50
*** SHOW DOWN ***
jahwe: shows [Jc Jh] (three of a kind, Jacks)
PacPacBum: shows [9d 9s] (a straight, Eight to Queen)
PacPacBum collected $18.14 from pot
*** SUMMARY ***
Total pot $19 | Rake $0.86 
Board [Tc 2c Qh Jd 8d]
Seat 2: jahwe (small blind) showed [Jc Jh] and lost with three of a kind, Jacks
Seat 3: lumen21 (big blind) folded before Flop
Seat 4: Pocketstud folded before Flop (didn't bet)
Seat 5: KingCastle77 folded before Flop (didn't bet)
Seat 6: Westpants folded before Flop (didn't bet)
Seat 7: matiko09 folded on the River
Seat 8: PacPacBum showed [9d 9s] and won ($18.14) with a straight, Eight to Queen
Seat 9: mmcardoulis (button) folded before Flop (didn't bet)





PokerStars Hand #150803184446:  Hold'em No Limit ($0.50/$1.00 USD) - 2016/03/23 15:34:18 CET [2016/03/23 10:34:18 ET]
Table 'Sylvia III' 9-max Seat #1 is the button
Seat 1: mycka86 ($131.20 in chips) 
Seat 2: Dantist1122 ($110.70 in chips) 
Seat 3: se7en_$tars ($209.82 in chips) 
Seat 4: lombardo11 ($55.84 in chips) 
Seat 5: matiko09 ($100 in chips) 
Seat 8: Muinmyheart ($138.80 in chips) 
Seat 9: Jimy Tiltman ($102.70 in chips) 
Dantist1122: posts small blind $0.50
se7en_$tars: posts big blind $1
PacPacBum: sits out 
jahwe: sits out 
mycka86: posts the ante $0.20
Dantist1122: posts the ante $0.20
se7en_$tars: posts the ante $0.20
lombardo11: posts the ante $0.20
matiko09: posts the ante $0.20
Muinmyheart: posts the ante $0.20
Jimy Tiltman: posts the ante $0.20
*** HOLE CARDS ***
Dealt to matiko09 [2d 6h]
lombardo11: folds 
matiko09: folds 
Muinmyheart: folds 
Jimy Tiltman: raises $2 to $3
mycka86: folds 
Dantist1122: folds 
se7en_$tars: calls $2
*** FLOP *** [7d 8d Jd]
se7en_$tars: bets $6
Jimy Tiltman: folds 
Uncalled bet ($6) returned to se7en_$tars
se7en_$tars collected $7.54 from pot
*** SUMMARY ***
Total pot $7.90 | Rake $0.36 
Board [7d 8d Jd]
Seat 1: mycka86 (button) folded before Flop (didn't bet)
Seat 2: Dantist1122 (small blind) folded before Flop
Seat 3: se7en_$tars (big blind) collected ($7.54)
Seat 4: lombardo11 folded before Flop (didn't bet)
Seat 5: matiko09 folded before Flop (didn't bet)
Seat 8: Muinmyheart folded before Flop (didn't bet)
Seat 9: Jimy Tiltman folded on the Flop





PokerStars Hand #150803187015:  Hold'em No Limit ($0.50/$1.00 USD) - 2016/03/23 15:34:25 CET [2016/03/23 10:34:25 ET]
Table 'Haug II' 9-max Seat #1 is the button
Seat 1: PacPacBum ($103.77 in chips) 
Seat 2: ardo888 ($100 in chips) 
Seat 3: camilalope ($95.96 in chips) 
Seat 4: matiko09 ($101.82 in chips) 
Seat 5: GlamDragon ($98.61 in chips) 
Seat 7: jahwe ($107.69 in chips) 
Seat 8: BRIGANTE49 ($74.32 in chips) 
Seat 9: ZOLOTOY766 ($80 in chips) 
ardo888: posts small blind $0.50
camilalope: posts big blind $1
Pocketstud: sits out 
ZOLOTOY766: posts big blind $1
PacPacBum: posts the ante $0.20
ardo888: posts the ante $0.20
camilalope: posts the ante $0.20
matiko09: posts the ante $0.20
GlamDragon: posts the ante $0.20
jahwe: posts the ante $0.20
BRIGANTE49: posts the ante $0.20
ZOLOTOY766: posts the ante $0.20
*** HOLE CARDS ***
Dealt to matiko09 [6h 5s]
matiko09: folds 
GlamDragon: folds 
jahwe: folds 
BRIGANTE49: raises $1 to $2
ZOLOTOY766: calls $1
PacPacBum: calls $2
ardo888: folds 
camilalope: calls $1
*** FLOP *** [Qd 9h 6s]
camilalope: checks 
BRIGANTE49: bets $5
ZOLOTOY766: folds 
PacPacBum: folds 
camilalope: folds 
Uncalled bet ($5) returned to BRIGANTE49
BRIGANTE49 collected $9.65 from pot
BRIGANTE49: doesn't show hand 
*** SUMMARY ***
Total pot $10.10 | Rake $0.45 
Board [Qd 9h 6s]
Seat 1: PacPacBum (button) folded on the Flop
Seat 2: ardo888 (small blind) folded before Flop
Seat 3: camilalope (big blind) folded on the Flop
Seat 4: matiko09 folded before Flop (didn't bet)
Seat 5: GlamDragon folded before Flop (didn't bet)
Seat 7: jahwe folded before Flop (didn't bet)
Seat 8: BRIGANTE49 collected ($9.65)
Seat 9: ZOLOTOY766 folded on the Flop





PokerStars Hand #150803187034:  Hold'em No Limit ($0.50/$1.00 USD) - 2016/03/23 15:34:26 CET [2016/03/23 10:34:26 ET]
Table 'Asmodeus' 9-max Seat #9 is the button
Seat 1: Jimy Tiltman ($167.37 in chips) 
Seat 2: PacPacBum ($103.09 in chips) 
Seat 3: jahwe ($110.21 in chips) 
Seat 4: Effort92 ($100 in chips) 
Seat 5: Muinmyheart ($105.09 in chips) 
Seat 6: fuppeee ($132.75 in chips) 
Seat 7: mycka86 ($116.45 in chips) 
Seat 8: app1e_j@ck ($100 in chips) 
Seat 9: matiko09 ($100 in chips) 
Jimy Tiltman: posts small blind $0.50
PacPacBum: posts big blind $1
Jimy Tiltman: posts the ante $0.20
PacPacBum: posts the ante $0.20
jahwe: posts the ante $0.20
Effort92: posts the ante $0.20
Muinmyheart: posts the ante $0.20
fuppeee: posts the ante $0.20
mycka86: posts the ante $0.20
app1e_j@ck: posts the ante $0.20
matiko09: posts the ante $0.20
*** HOLE CARDS ***
Dealt to matiko09 [Jh 5c]
jahwe: raises $2 to $3
Effort92: folds 
Muinmyheart: folds 
fuppeee: folds 
mycka86: folds 
app1e_j@ck: folds 
matiko09: folds 
Jimy Tiltman: folds 
PacPacBum: folds 
Uncalled bet ($2) returned to jahwe
jahwe collected $4.30 from pot
jahwe: doesn't show hand 
*** SUMMARY ***
Total pot $4.30 | Rake $0 
Seat 1: Jimy Tiltman (small blind) folded before Flop
Seat 2: PacPacBum (big blind) folded before Flop
Seat 3: jahwe collected ($4.30)
Seat 4: Effort92 folded before Flop (didn't bet)
Seat 5: Muinmyheart folded before Flop (didn't bet)
Seat 6: fuppeee folded before Flop (didn't bet)
Seat 7: mycka86 folded before Flop (didn't bet)
Seat 8: app1e_j@ck folded before Flop (didn't bet)
Seat 9: matiko09 (button) folded before Flop (didn't bet)





PokerStars Hand #150803189549:  Hold'em No Limit (€0.50/€1.00 EUR) - 2016/03/23 15:34:33 CET [2016/03/23 10:34:33 ET]
Table 'Mercury III' 9-max Seat #1 is the button
Seat 1: matiko09 (€124.85 in chips) 
Seat 2: jahwe (€100.50 in chips) 
Seat 3: PacPacBum (€100 in chips) 
Seat 4: Muinmyheart (€101.50 in chips) 
Seat 5: ardo888 (€102.50 in chips) 
Seat 6: mycka86 (€101.50 in chips) 
Seat 7: STrakDD (€101.10 in chips) 
Seat 8: gfxed (€58.30 in chips) 
Seat 9: Indr3k (€100 in chips) 
jahwe: posts small blind €0.50
PacPacBum: posts big blind €1
*** HOLE CARDS ***
Dealt to matiko09 [Kh 5s]
Muinmyheart: folds 
ardo888: folds 
mycka86: folds 
STrakDD: folds 
gfxed has timed out
gfxed: folds 
Indr3k: raises €2 to €3
matiko09: folds 
jahwe: folds 
PacPacBum: folds 
Uncalled bet (€2) returned to Indr3k
Indr3k collected €2.50 from pot
Indr3k: doesn't show hand 
*** SUMMARY ***
Total pot €2.50 | Rake €0 
Seat 1: matiko09 (button) folded before Flop (didn't bet)
Seat 2: jahwe (small blind) folded before Flop
Seat 3: PacPacBum (big blind) folded before Flop
Seat 4: Muinmyheart folded before Flop (didn't bet)
Seat 5: ardo888 folded before Flop (didn't bet)
Seat 6: mycka86 folded before Flop (didn't bet)
Seat 7: STrakDD folded before Flop (didn't bet)
Seat 8: gfxed folded before Flop (didn't bet)
Seat 9: Indr3k collected (€2.50)





PokerStars Hand #150803190195:  Hold'em No Limit ($0.50/$1.00 USD) - 2016/03/23 15:34:35 CET [2016/03/23 10:34:35 ET]
Table 'Smiley' 9-max Seat #4 is the button
Seat 1: xHourglass ($101.50 in chips) 
Seat 2: Jimy Tiltman ($100.20 in chips) 
Seat 3: mycka86 ($100 in chips) 
Seat 4: CAJUN890 ($82.69 in chips) 
Seat 5: Szevasztopol ($149.35 in chips) 
Seat 6: blackmont111 ($123.04 in chips) 
Seat 7: bennetb77 ($89.84 in chips) 
Seat 8: matiko09 ($114.08 in chips) 
Seat 9: PacPacBum ($104.31 in chips) 
Szevasztopol: posts small blind $0.50
blackmont111: posts big blind $1
*** HOLE CARDS ***
Dealt to matiko09 [Kc As]
bennetb77: folds 
matiko09: raises $2 to $3
PacPacBum: folds 
xHourglass: raises $6 to $9
Jimy Tiltman: folds 
mycka86: folds 
CAJUN890: folds 
Szevasztopol: folds 
blackmont111: folds 
matiko09: calls $6
*** FLOP *** [Qs 9c 2h]
matiko09: checks 
xHourglass: bets $14
matiko09: folds 
Uncalled bet ($14) returned to xHourglass
xHourglass collected $18.62 from pot
xHourglass: doesn't show hand 
*** SUMMARY ***
Total pot $19.50 | Rake $0.88 
Board [Qs 9c 2h]
Seat 1: xHourglass collected ($18.62)
Seat 2: Jimy Tiltman folded before Flop (didn't bet)
Seat 3: mycka86 folded before Flop (didn't bet)
Seat 4: CAJUN890 (button) folded before Flop (didn't bet)
Seat 5: Szevasztopol (small blind) folded before Flop
Seat 6: blackmont111 (big blind) folded before Flop
Seat 7: bennetb77 folded before Flop (didn't bet)
Seat 8: matiko09 folded on the Flop
Seat 9: PacPacBum folded before Flop (didn't bet)





PokerStars Hand #150803191241:  Hold'em No Limit (€0.50/€1.00 EUR) - 2016/03/23 15:34:38 CET [2016/03/23 10:34:38 ET]
Table 'Volga III' 9-max Seat #4 is the button
Seat 1: Dantist1122 (€101.50 in chips) 
Seat 2: Scorpion5443 (€44.32 in chips) 
Seat 3: matiko09 (€100 in chips) 
Seat 4: bigacsiga (€108.10 in chips) 
Seat 5: omarr22 (€37.51 in chips) 
Seat 6: PacPacBum (€100 in chips) 
Seat 7: jahwe (€100 in chips) 
Seat 8: edidaz (€110.12 in chips) 
omarr22: posts small blind €0.50
PacPacBum: posts big blind €1
ardo888: sits out 
*** HOLE CARDS ***
Dealt to matiko09 [9c 8d]
jahwe: folds 
edidaz: folds 
Dantist1122: folds 
Scorpion5443: folds 
matiko09: folds 
bigacsiga: raises €1 to €2
omarr22: calls €1.50
PacPacBum: calls €1
*** FLOP *** [8h 4c 5c]
omarr22: checks 
PacPacBum: bets €3.95
bigacsiga: folds 
omarr22: folds 
Uncalled bet (€3.95) returned to PacPacBum
PacPacBum collected €5.73 from pot
PacPacBum: doesn't show hand 
*** SUMMARY ***
Total pot €6 | Rake €0.27 
Board [8h 4c 5c]
Seat 1: Dantist1122 folded before Flop (didn't bet)
Seat 2: Scorpion5443 folded before Flop (didn't bet)
Seat 3: matiko09 folded before Flop (didn't bet)
Seat 4: bigacsiga (button) folded on the Flop
Seat 5: omarr22 (small blind) folded on the Flop
Seat 6: PacPacBum (big blind) collected (€5.73)
Seat 7: jahwe folded before Flop (didn't bet)
Seat 8: edidaz folded before Flop (didn't bet)





PokerStars Hand #150803199552:  Hold'em No Limit ($0.50/$1.00 USD) - 2016/03/23 15:35:02 CET [2016/03/23 10:35:02 ET]
Table 'Haug II' 9-max Seat #2 is the button
Seat 1: PacPacBum ($101.57 in chips) 
Seat 2: ardo888 ($100 in chips) 
Seat 3: camilalope ($93.76 in chips) 
Seat 4: matiko09 ($101.62 in chips) 
Seat 5: GlamDragon ($98.41 in chips) 
Seat 7: jahwe ($107.49 in chips) 
Seat 8: BRIGANTE49 ($81.77 in chips) 
Seat 9: ZOLOTOY766 ($77.80 in chips) 
camilalope: posts small blind $0.50
matiko09: posts big blind $1
Pocketstud: sits out 
PacPacBum: posts the ante $0.20
ardo888: posts the ante $0.20
camilalope: posts the ante $0.20
matiko09: posts the ante $0.20
GlamDragon: posts the ante $0.20
jahwe: posts the ante $0.20
BRIGANTE49: posts the ante $0.20
ZOLOTOY766: posts the ante $0.20
*** HOLE CARDS ***
Dealt to matiko09 [8h 2c]
GlamDragon: folds 
jahwe: folds 
BRIGANTE49: calls $1
ZOLOTOY766: folds 
PacPacBum: raises $4 to $5
ardo888: calls $5
camilalope: folds 
matiko09: folds 
BRIGANTE49: folds 
*** FLOP *** [Kd Kh 5d]
PacPacBum: bets $4.71
ardo888: calls $4.71
*** TURN *** [Kd Kh 5d] [2h]
PacPacBum: checks 
ardo888: bets $15.50
PacPacBum: calls $15.50
*** RIVER *** [Kd Kh 5d 2h] [2s]
PacPacBum: checks 
ardo888: bets $28.50
PacPacBum: folds 
Uncalled bet ($28.50) returned to ardo888
ardo888 collected $52.07 from pot
ardo888: doesn't show hand 
*** SUMMARY ***
Total pot $54.52 | Rake $2.45 
Board [Kd Kh 5d 2h 2s]
Seat 1: PacPacBum folded on the River
Seat 2: ardo888 (button) collected ($52.07)
Seat 3: camilalope (small blind) folded before Flop
Seat 4: matiko09 (big blind) folded before Flop
Seat 5: GlamDragon folded before Flop (didn't bet)
Seat 7: jahwe folded before Flop (didn't bet)
Seat 8: BRIGANTE49 folded before Flop
Seat 9: ZOLOTOY766 folded before Flop (didn't bet)





PokerStars Hand #150803199937:  Hold'em No Limit ($1/$2 USD) - 2016/03/23 15:35:03 CET [2016/03/23 10:35:03 ET]
Table 'Kiess' 9-max Seat #8 is the button
Seat 1: Cirilico ($276.37 in chips) 
Seat 2: jahwe ($200 in chips) 
Seat 3: Red4erT ($100.29 in chips) 
Seat 4: RamiroAgujis ($200 in chips) 
Seat 5: chippo boy ($417.84 in chips) 
Seat 6: matiko09 ($231.48 in chips) 
Seat 7: chaps1988 ($212.24 in chips) 
Seat 8: erfk1958 ($130.78 in chips) 
Seat 9: PacPacBum ($201 in chips) 
PacPacBum: posts small blind $1
Cirilico: posts big blind $2
*** HOLE CARDS ***
Dealt to matiko09 [5s 8h]
jahwe: folds 
Red4erT: folds 
RamiroAgujis: folds 
chippo boy: raises $4 to $6
matiko09: folds 
chaps1988: calls $6
erfk1958: folds 
PacPacBum: folds 
Cirilico: folds 
*** FLOP *** [3d Jd Qs]
chippo boy: bets $8
chaps1988: folds 
Uncalled bet ($8) returned to chippo boy
chippo boy collected $14.32 from pot
*** SUMMARY ***
Total pot $15 | Rake $0.68 
Board [3d Jd Qs]
Seat 1: Cirilico (big blind) folded before Flop
Seat 2: jahwe folded before Flop (didn't bet)
Seat 3: Red4erT folded before Flop (didn't bet)
Seat 4: RamiroAgujis folded before Flop (didn't bet)
Seat 5: chippo boy collected ($14.32)
Seat 6: matiko09 folded before Flop (didn't bet)
Seat 7: chaps1988 folded on the Flop
Seat 8: erfk1958 (button) folded before Flop (didn't bet)
Seat 9: PacPacBum (small blind) folded before Flop





PokerStars Hand #150803200793:  Hold'em No Limit ($0.50/$1.00 USD) - 2016/03/23 15:35:06 CET [2016/03/23 10:35:06 ET]
Table 'Asmodeus' 9-max Seat #1 is the button
Seat 1: Jimy Tiltman ($166.67 in chips) 
Seat 2: PacPacBum ($101.89 in chips) 
Seat 3: jahwe ($113.31 in chips) 
Seat 4: Effort92 ($100 in chips) 
Seat 5: Muinmyheart ($104.89 in chips) 
Seat 6: fuppeee ($132.55 in chips) 
Seat 7: mycka86 ($116.25 in chips) 
Seat 8: app1e_j@ck ($100 in chips) 
Seat 9: matiko09 ($100 in chips) 
PacPacBum: posts small blind $0.50
jahwe: posts big blind $1
Jimy Tiltman: posts the ante $0.20
PacPacBum: posts the ante $0.20
jahwe: posts the ante $0.20
Effort92: posts the ante $0.20
Muinmyheart: posts the ante $0.20
fuppeee: posts the ante $0.20
mycka86: posts the ante $0.20
app1e_j@ck: posts the ante $0.20
matiko09: posts the ante $0.20
*** HOLE CARDS ***
Dealt to matiko09 [7c Th]
Effort92: folds 
Muinmyheart: folds 
fuppeee: folds 
mycka86: folds 
app1e_j@ck: folds 
matiko09: folds 
Jimy Tiltman: raises $1 to $2
PacPacBum: folds 
jahwe: folds 
Uncalled bet ($1) returned to Jimy Tiltman
Jimy Tiltman collected $4.30 from pot
Jimy Tiltman: doesn't show hand 
*** SUMMARY ***
Total pot $4.30 | Rake $0 
Seat 1: Jimy Tiltman (button) collected ($4.30)
Seat 2: PacPacBum (small blind) folded before Flop
Seat 3: jahwe (big blind) folded before Flop
Seat 4: Effort92 folded before Flop (didn't bet)
Seat 5: Muinmyheart folded before Flop (didn't bet)
Seat 6: fuppeee folded before Flop (didn't bet)
Seat 7: mycka86 folded before Flop (didn't bet)
Seat 8: app1e_j@ck folded before Flop (didn't bet)
Seat 9: matiko09 folded before Flop (didn't bet)





PokerStars Hand #150803201652:  Hold'em No Limit ($0.50/$1.00 USD) - 2016/03/23 15:35:08 CET [2016/03/23 10:35:08 ET]
Table 'Sylvia III' 9-max Seat #2 is the button
Seat 1: mycka86 ($131 in chips) 
Seat 2: Dantist1122 ($110 in chips) 
Seat 3: se7en_$tars ($214.16 in chips) 
Seat 4: lombardo11 ($55.64 in chips) 
Seat 5: matiko09 ($100 in chips) 
Seat 8: Muinmyheart ($138.60 in chips) 
Seat 9: Jimy Tiltman ($100 in chips) 
se7en_$tars: posts small blind $0.50
lombardo11: posts big blind $1
PacPacBum: sits out 
jahwe: sits out 
mycka86: posts the ante $0.20
Dantist1122: posts the ante $0.20
se7en_$tars: posts the ante $0.20
lombardo11: posts the ante $0.20
matiko09: posts the ante $0.20
Muinmyheart: posts the ante $0.20
Jimy Tiltman: posts the ante $0.20
*** HOLE CARDS ***
Dealt to matiko09 [Jh 2h]
matiko09: folds 
Muinmyheart: folds 
Jimy Tiltman: folds 
mycka86: raises $2 to $3
Dantist1122: calls $3
se7en_$tars: calls $2.50
lombardo11: calls $2
*** FLOP *** [Kc 7h 3h]
se7en_$tars: checks 
lombardo11: folds 
mycka86: checks 
Dantist1122: checks 
*** TURN *** [Kc 7h 3h] [8c]
se7en_$tars: bets $10
lombardo11 is disconnected 
mycka86: calls $10
Dantist1122: folds 
*** RIVER *** [Kc 7h 3h 8c] [Ad]
se7en_$tars: checks 
mycka86: checks 
*** SHOW DOWN ***
se7en_$tars: shows [4c 4h] (a pair of Fours)
mycka86: shows [9d Kh] (a pair of Kings)
mycka86 collected $31.90 from pot
*** SUMMARY ***
Total pot $33.40 | Rake $1.50 
Board [Kc 7h 3h 8c Ad]
Seat 1: mycka86 showed [9d Kh] and won ($31.90) with a pair of Kings
Seat 2: Dantist1122 (button) folded on the Turn
Seat 3: se7en_$tars (small blind) showed [4c 4h] and lost with a pair of Fours
Seat 4: lombardo11 (big blind) folded on the Flop
Seat 5: matiko09 folded before Flop (didn't bet)
Seat 8: Muinmyheart folded before Flop (didn't bet)
Seat 9: Jimy Tiltman folded before Flop (didn't bet)





PokerStars Hand #150803202498:  Hold'em No Limit ($0.50/$1.00 USD) - 2016/03/23 15:35:11 CET [2016/03/23 10:35:11 ET]
Table 'Drakonia II' 9-max Seat #6 is the button
Seat 1: chautinhtri9 ($127.60 in chips) 
Seat 2: RICKA16 ($97 in chips) 
Seat 4: Jimy Tiltman ($100 in chips) 
Seat 5: Muinmyheart ($100 in chips) 
Seat 6: PinkTrinta ($107.71 in chips) 
Seat 7: YuriiSolodya ($46.46 in chips) 
Seat 8: matiko09 ($108.39 in chips) 
Seat 9: mycka86 ($101.86 in chips) 
YuriiSolodya: posts small blind $0.50
matiko09: posts big blind $1
PacPacBum: sits out 
*** HOLE CARDS ***
Dealt to matiko09 [8d 8s]
mycka86: folds 
chautinhtri9: folds 
RICKA16: folds 
Jimy Tiltman: folds 
Muinmyheart: folds 
PinkTrinta: raises $1 to $2
YuriiSolodya: folds 
matiko09: calls $1
*** FLOP *** [2d 3c 4c]
matiko09: checks 
PinkTrinta: bets $2.92
matiko09: calls $2.92
*** TURN *** [2d 3c 4c] [Kh]
matiko09: checks 
PinkTrinta: bets $7.79
matiko09: calls $7.79
*** RIVER *** [2d 3c 4c Kh] [5s]
matiko09: checks 
PinkTrinta: checks 
*** SHOW DOWN ***
matiko09: shows [8d 8s] (a pair of Eights)
PinkTrinta: shows [Qs Kc] (a pair of Kings)
PinkTrinta collected $24.75 from pot
*** SUMMARY ***
Total pot $25.92 | Rake $1.17 
Board [2d 3c 4c Kh 5s]
Seat 1: chautinhtri9 folded before Flop (didn't bet)
Seat 2: RICKA16 folded before Flop (didn't bet)
Seat 4: Jimy Tiltman folded before Flop (didn't bet)
Seat 5: Muinmyheart folded before Flop (didn't bet)
Seat 6: PinkTrinta (button) showed [Qs Kc] and won ($24.75) with a pair of Kings
Seat 7: YuriiSolodya (small blind) folded before Flop
Seat 8: matiko09 (big blind) showed [8d 8s] and lost with a pair of Eights
Seat 9: mycka86 folded before Flop (didn't bet)





PokerStars Hand #150803203035:  Hold'em No Limit ($0.50/$1.00 USD) - 2016/03/23 15:35:12 CET [2016/03/23 10:35:12 ET]
Table 'Swings' 9-max Seat #9 is the button
Seat 1: lumen21 ($100.28 in chips) 
Seat 2: tomver0809 ($66 in chips) 
Seat 4: YuriiSolodya ($42.77 in chips) 
Seat 5: chautinhtri9 ($114.55 in chips) 
Seat 6: matiko09 ($141.42 in chips) 
Seat 7: PacPacBum ($123.49 in chips) 
Seat 8: RICKA16 ($102.68 in chips) 
Seat 9: Effort92 ($103.03 in chips) 
lumen21: posts small blind $0.50
tomver0809: posts big blind $1
edidaz: sits out 
*** HOLE CARDS ***
Dealt to matiko09 [6h 2h]
YuriiSolodya: folds 
chautinhtri9: folds 
matiko09: folds 
PacPacBum: folds 
RICKA16: folds 
Effort92: raises $1.50 to $2.50
lumen21: raises $6.50 to $9
tomver0809: folds 
Effort92: folds 
Uncalled bet ($6.50) returned to lumen21
lumen21 collected $6 from pot
lumen21: doesn't show hand 
*** SUMMARY ***
Total pot $6 | Rake $0 
Seat 1: lumen21 (small blind) collected ($6)
Seat 2: tomver0809 (big blind) folded before Flop
Seat 4: YuriiSolodya folded before Flop (didn't bet)
Seat 5: chautinhtri9 folded before Flop (didn't bet)
Seat 6: matiko09 folded before Flop (didn't bet)
Seat 7: PacPacBum folded before Flop (didn't bet)
Seat 8: RICKA16 folded before Flop (didn't bet)
Seat 9: Effort92 (button) folded before Flop





PokerStars Hand #150803204139:  Hold'em No Limit ($0.50/$1.00 USD) - 2016/03/23 15:35:16 CET [2016/03/23 10:35:16 ET]
Table 'Atlantis' 9-max Seat #6 is the button
Seat 1: xHourglass ($153.96 in chips) 
Seat 2: Szevasztopol ($100 in chips) 
Seat 3: CAJUN890 ($67.01 in chips) 
Seat 4: mycka86 ($121.04 in chips) 
Seat 5: Durango-CO77 ($42.46 in chips) 
Seat 6: PacPacBum ($116.41 in chips) 
Seat 7: matiko09 ($141.61 in chips) 
Seat 8: jahwe ($100 in chips) 
Seat 9: RICKA16 ($137.21 in chips) 
matiko09: posts small blind $0.50
jahwe: posts big blind $1
*** HOLE CARDS ***
Dealt to matiko09 [2d 2c]
RICKA16: folds 
xHourglass: folds 
Szevasztopol: folds 
CAJUN890: folds 
mycka86: folds 
Durango-CO77: folds 
PacPacBum: folds 
matiko09: raises $1.50 to $2.50
jahwe: raises $5 to $7.50
matiko09: folds 
Uncalled bet ($5) returned to jahwe
jahwe collected $5 from pot
jahwe: doesn't show hand 
*** SUMMARY ***
Total pot $5 | Rake $0 
Seat 1: xHourglass folded before Flop (didn't bet)
Seat 2: Szevasztopol folded before Flop (didn't bet)
Seat 3: CAJUN890 folded before Flop (didn't bet)
Seat 4: mycka86 folded before Flop (didn't bet)
Seat 5: Durango-CO77 folded before Flop (didn't bet)
Seat 6: PacPacBum (button) folded before Flop (didn't bet)
Seat 7: matiko09 (small blind) folded before Flop
Seat 8: jahwe (big blind) collected ($5)
Seat 9: RICKA16 folded before Flop (didn't bet)





PokerStars Hand #150803205091:  Hold'em No Limit ($0.50/$1.00 USD) - 2016/03/23 15:35:19 CET [2016/03/23 10:35:19 ET]
Table 'Smiley' 9-max Seat #5 is the button
Seat 1: xHourglass ($111.12 in chips) 
Seat 2: Jimy Tiltman ($100.20 in chips) 
Seat 3: mycka86 ($100 in chips) 
Seat 4: CAJUN890 ($82.69 in chips) 
Seat 5: Szevasztopol ($148.85 in chips) 
Seat 6: blackmont111 ($122.04 in chips) 
Seat 7: bennetb77 ($89.84 in chips) 
Seat 8: matiko09 ($105.08 in chips) 
Seat 9: PacPacBum ($104.31 in chips) 
blackmont111: posts small blind $0.50
bennetb77: posts big blind $1
*** HOLE CARDS ***
Dealt to matiko09 [2d 7d]
matiko09: folds 
PacPacBum: folds 
xHourglass: folds 
Jimy Tiltman: raises $1.50 to $2.50
mycka86: folds 
CAJUN890: folds 
Szevasztopol: folds 
blackmont111: folds 
bennetb77: folds 
Uncalled bet ($1.50) returned to Jimy Tiltman
Jimy Tiltman collected $2.50 from pot
Jimy Tiltman: doesn't show hand 
*** SUMMARY ***
Total pot $2.50 | Rake $0 
Seat 1: xHourglass folded before Flop (didn't bet)
Seat 2: Jimy Tiltman collected ($2.50)
Seat 3: mycka86 folded before Flop (didn't bet)
Seat 4: CAJUN890 folded before Flop (didn't bet)
Seat 5: Szevasztopol (button) folded before Flop (didn't bet)
Seat 6: blackmont111 (small blind) folded before Flop
Seat 7: bennetb77 (big blind) folded before Flop
Seat 8: matiko09 folded before Flop (didn't bet)
Seat 9: PacPacBum folded before Flop (didn't bet)





PokerStars Hand #150803207185:  Hold'em No Limit (€0.50/€1.00 EUR) - 2016/03/23 15:35:25 CET [2016/03/23 10:35:25 ET]
Table 'Mercury III' 9-max Seat #2 is the button
Seat 1: matiko09 (€124.85 in chips) 
Seat 2: jahwe (€100 in chips) 
Seat 3: PacPacBum (€100 in chips) 
Seat 4: Muinmyheart (€101.50 in chips) 
Seat 5: ardo888 (€102.50 in chips) 
Seat 6: mycka86 (€101.50 in chips) 
Seat 7: STrakDD (€101.10 in chips) 
Seat 9: Indr3k (€101.50 in chips) 
PacPacBum: posts small blind €0.50
Muinmyheart: posts big blind €1
*** HOLE CARDS ***
Dealt to matiko09 [4c Qd]
ardo888: folds 
mycka86: folds 
STrakDD: folds 
Indr3k: folds 
matiko09: folds 
jahwe: folds 
PacPacBum: folds 
Uncalled bet (€0.50) returned to Muinmyheart
Muinmyheart collected €1 from pot
Muinmyheart: doesn't show hand 
*** SUMMARY ***
Total pot €1 | Rake €0 
Seat 1: matiko09 folded before Flop (didn't bet)
Seat 2: jahwe (button) folded before Flop (didn't bet)
Seat 3: PacPacBum (small blind) folded before Flop
Seat 4: Muinmyheart (big blind) collected (€1)
Seat 5: ardo888 folded before Flop (didn't bet)
Seat 6: mycka86 folded before Flop (didn't bet)
Seat 7: STrakDD folded before Flop (didn't bet)
Seat 9: Indr3k folded before Flop (didn't bet)





PokerStars Hand #150803210442:  Hold'em No Limit (€0.50/€1.00 EUR) - 2016/03/23 15:35:34 CET [2016/03/23 10:35:34 ET]
Table 'Volga III' 9-max Seat #5 is the button
Seat 1: Dantist1122 (€101.50 in chips) 
Seat 2: Scorpion5443 (€44.32 in chips) 
Seat 3: matiko09 (€100 in chips) 
Seat 4: bigacsiga (€106.10 in chips) 
Seat 5: omarr22 (€35.51 in chips) 
Seat 6: PacPacBum (€103.73 in chips) 
Seat 7: jahwe (€100 in chips) 
Seat 8: edidaz (€110.12 in chips) 
PacPacBum: posts small blind €0.50
jahwe: posts big blind €1
ardo888: sits out 
*** HOLE CARDS ***
Dealt to matiko09 [As 2d]
edidaz: folds 
Dantist1122: folds 
Scorpion5443: folds 
matiko09: folds 
bigacsiga: raises €1.50 to €2.50
omarr22: folds 
PacPacBum: folds 
jahwe: folds 
Uncalled bet (€1.50) returned to bigacsiga
bigacsiga collected €2.50 from pot
bigacsiga: doesn't show hand 
*** SUMMARY ***
Total pot €2.50 | Rake €0 
Seat 1: Dantist1122 folded before Flop (didn't bet)
Seat 2: Scorpion5443 folded before Flop (didn't bet)
Seat 3: matiko09 folded before Flop (didn't bet)
Seat 4: bigacsiga collected (€2.50)
Seat 5: omarr22 (button) folded before Flop (didn't bet)
Seat 6: PacPacBum (small blind) folded before Flop
Seat 7: jahwe (big blind) folded before Flop
Seat 8: edidaz folded before Flop (didn't bet)





PokerStars Hand #150803212988:  Hold'em No Limit ($0.50/$1.00 USD) - 2016/03/23 15:35:42 CET [2016/03/23 10:35:42 ET]
Table 'Asmodeus' 9-max Seat #2 is the button
Seat 1: Jimy Tiltman ($169.77 in chips) 
Seat 2: PacPacBum ($101.19 in chips) 
Seat 3: jahwe ($112.11 in chips) 
Seat 4: Effort92 ($100 in chips) 
Seat 5: Muinmyheart ($104.69 in chips) 
Seat 6: fuppeee ($132.35 in chips) 
Seat 7: mycka86 ($116.05 in chips) 
Seat 8: app1e_j@ck ($100 in chips) 
Seat 9: matiko09 ($100 in chips) 
jahwe: posts small blind $0.50
Effort92: posts big blind $1
Jimy Tiltman: posts the ante $0.20
PacPacBum: posts the ante $0.20
jahwe: posts the ante $0.20
Effort92: posts the ante $0.20
Muinmyheart: posts the ante $0.20
fuppeee: posts the ante $0.20
mycka86: posts the ante $0.20
app1e_j@ck: posts the ante $0.20
matiko09: posts the ante $0.20
*** HOLE CARDS ***
Dealt to matiko09 [3c 7s]
Muinmyheart: folds 
fuppeee: folds 
mycka86: folds 
app1e_j@ck: folds 
matiko09: folds 
Jimy Tiltman: folds 
PacPacBum: folds 
jahwe: folds 
Uncalled bet ($0.50) returned to Effort92
Effort92 collected $2.80 from pot
Effort92: doesn't show hand 
*** SUMMARY ***
Total pot $2.80 | Rake $0 
Seat 1: Jimy Tiltman folded before Flop (didn't bet)
Seat 2: PacPacBum (button) folded before Flop (didn't bet)
Seat 3: jahwe (small blind) folded before Flop
Seat 4: Effort92 (big blind) collected ($2.80)
Seat 5: Muinmyheart folded before Flop (didn't bet)
Seat 6: fuppeee folded before Flop (didn't bet)
Seat 7: mycka86 folded before Flop (didn't bet)
Seat 8: app1e_j@ck folded before Flop (didn't bet)
Seat 9: matiko09 folded before Flop (didn't bet)





PokerStars Hand #150803213960:  Hold'em No Limit ($0.50/$1.00 USD) - 2016/03/23 15:35:44 CET [2016/03/23 10:35:44 ET]
Table 'Swings' 9-max Seat #1 is the button
Seat 1: lumen21 ($103.78 in chips) 
Seat 2: tomver0809 ($65 in chips) 
Seat 3: edidaz ($100 in chips) 
Seat 4: YuriiSolodya ($42.77 in chips) 
Seat 5: chautinhtri9 ($114.55 in chips) 
Seat 6: matiko09 ($141.42 in chips) 
Seat 7: PacPacBum ($123.49 in chips) 
Seat 8: RICKA16 ($102.68 in chips) 
Seat 9: Effort92 ($100.53 in chips) 
tomver0809: posts small blind $0.50
edidaz: posts big blind $1
*** HOLE CARDS ***
Dealt to matiko09 [7c 9c]
YuriiSolodya: folds 
chautinhtri9: folds 
matiko09: folds 
PacPacBum: folds 
RICKA16: folds 
Effort92: folds 
lumen21: folds 
tomver0809: folds 
Uncalled bet ($0.50) returned to edidaz
edidaz collected $1 from pot
edidaz: doesn't show hand 
*** SUMMARY ***
Total pot $1 | Rake $0 
Seat 1: lumen21 (button) folded before Flop (didn't bet)
Seat 2: tomver0809 (small blind) folded before Flop
Seat 3: edidaz (big blind) collected ($1)
Seat 4: YuriiSolodya folded before Flop (didn't bet)
Seat 5: chautinhtri9 folded before Flop (didn't bet)
Seat 6: matiko09 folded before Flop (didn't bet)
Seat 7: PacPacBum folded before Flop (didn't bet)
Seat 8: RICKA16 folded before Flop (didn't bet)
Seat 9: Effort92 folded before Flop (didn't bet)





PokerStars Hand #150803213802:  Hold'em No Limit ($0.50/$1.00 USD) - 2016/03/23 15:35:44 CET [2016/03/23 10:35:44 ET]
Table 'Smiley' 9-max Seat #6 is the button
Seat 1: xHourglass ($111.12 in chips) 
Seat 2: Jimy Tiltman ($101.70 in chips) 
Seat 3: mycka86 ($100 in chips) 
Seat 4: CAJUN890 ($82.69 in chips) 
Seat 5: Szevasztopol ($148.85 in chips) 
Seat 6: blackmont111 ($121.54 in chips) 
Seat 7: bennetb77 ($88.84 in chips) 
Seat 8: matiko09 ($105.08 in chips) 
Seat 9: PacPacBum ($104.31 in chips) 
bennetb77: posts small blind $0.50
matiko09: posts big blind $1
*** HOLE CARDS ***
Dealt to matiko09 [7d 2d]
PacPacBum: folds 
xHourglass: raises $2 to $3
Jimy Tiltman: folds 
mycka86: folds 
CAJUN890: folds 
Szevasztopol: folds 
blackmont111: folds 
bennetb77: calls $2.50
matiko09: folds 
*** FLOP *** [Kd 3d Kh]
bennetb77: checks 
xHourglass: bets $5.50
bennetb77: calls $5.50
*** TURN *** [Kd 3d Kh] [3h]
bennetb77: checks 
xHourglass: checks 
*** RIVER *** [Kd 3d Kh 3h] [9c]
bennetb77: bets $13
xHourglass: calls $13
*** SHOW DOWN ***
bennetb77: shows [Ah Ks] (a full house, Kings full of Threes)
xHourglass: mucks hand 
bennetb77 collected $42.02 from pot
*** SUMMARY ***
Total pot $44 | Rake $1.98 
Board [Kd 3d Kh 3h 9c]
Seat 1: xHourglass mucked [7s 7c]
Seat 2: Jimy Tiltman folded before Flop (didn't bet)
Seat 3: mycka86 folded before Flop (didn't bet)
Seat 4: CAJUN890 folded before Flop (didn't bet)
Seat 5: Szevasztopol folded before Flop (didn't bet)
Seat 6: blackmont111 (button) folded before Flop (didn't bet)
Seat 7: bennetb77 (small blind) showed [Ah Ks] and won ($42.02) with a full house, Kings full of Threes
Seat 8: matiko09 (big blind) folded before Flop
Seat 9: PacPacBum folded before Flop (didn't bet)





PokerStars Hand #150803216268:  Hold'em No Limit ($1/$2 USD) - 2016/03/23 15:35:51 CET [2016/03/23 10:35:51 ET]
Table 'Kiess' 9-max Seat #9 is the button
Seat 1: Cirilico ($274.37 in chips) 
Seat 2: jahwe ($200 in chips) 
Seat 3: Red4erT ($100.29 in chips) 
Seat 4: RamiroAgujis ($200 in chips) 
Seat 5: chippo boy ($426.16 in chips) 
Seat 6: matiko09 ($231.48 in chips) 
Seat 7: chaps1988 ($206.24 in chips) 
Seat 8: erfk1958 ($130.78 in chips) 
Seat 9: PacPacBum ($200 in chips) 
Cirilico: posts small blind $1
jahwe: posts big blind $2
*** HOLE CARDS ***
Dealt to matiko09 [Qs 5c]
Red4erT: folds 
RamiroAgujis: folds 
chippo boy: calls $2
matiko09: folds 
chaps1988: folds 
erfk1958: folds 
PacPacBum: folds 
Cirilico: raises $6 to $8
jahwe: folds 
chippo boy: calls $6
*** FLOP *** [Th 5s As]
Cirilico: checks 
chippo boy: checks 
*** TURN *** [Th 5s As] [Tc]
Cirilico: checks 
chippo boy: bets $8
Cirilico: calls $8
*** RIVER *** [Th 5s As Tc] [5d]
Cirilico: checks 
chippo boy: bets $14
Cirilico: calls $14
*** SHOW DOWN ***
chippo boy: shows [Ad 9h] (two pair, Aces and Tens)
Cirilico: mucks hand 
chippo boy collected $59.21 from pot
*** SUMMARY ***
Total pot $62 | Rake $2.79 
Board [Th 5s As Tc 5d]
Seat 1: Cirilico (small blind) mucked [Kh Kc]
Seat 2: jahwe (big blind) folded before Flop
Seat 3: Red4erT folded before Flop (didn't bet)
Seat 4: RamiroAgujis folded before Flop (didn't bet)
Seat 5: chippo boy showed [Ad 9h] and won ($59.21) with two pair, Aces and Tens
Seat 6: matiko09 folded before Flop (didn't bet)
Seat 7: chaps1988 folded before Flop (didn't bet)
Seat 8: erfk1958 folded before Flop (didn't bet)
Seat 9: PacPacBum (button) folded before Flop (didn't bet)





PokerStars Hand #150803219335:  Hold'em No Limit ($0.50/$1.00 USD) - 2016/03/23 15:36:00 CET [2016/03/23 10:36:00 ET]
Table 'Drakonia II' 9-max Seat #7 is the button
Seat 1: chautinhtri9 ($127.60 in chips) 
Seat 2: RICKA16 ($97 in chips) 
Seat 4: Jimy Tiltman ($100 in chips) 
Seat 5: Muinmyheart ($100 in chips) 
Seat 6: PinkTrinta ($119.75 in chips) 
Seat 7: YuriiSolodya ($45.96 in chips) 
Seat 8: matiko09 ($100 in chips) 
Seat 9: mycka86 ($101.86 in chips) 
matiko09: posts small blind $0.50
mycka86: posts big blind $1
PacPacBum: sits out 
*** HOLE CARDS ***
Dealt to matiko09 [Kc 3d]
chautinhtri9: folds 
RICKA16: folds 
Jimy Tiltman: folds 
Muinmyheart: folds 
PinkTrinta: raises $1.50 to $2.50
YuriiSolodya: folds 
matiko09: folds 
mycka86: folds 
Uncalled bet ($1.50) returned to PinkTrinta
PinkTrinta collected $2.50 from pot
*** SUMMARY ***
Total pot $2.50 | Rake $0 
Seat 1: chautinhtri9 folded before Flop (didn't bet)
Seat 2: RICKA16 folded before Flop (didn't bet)
Seat 4: Jimy Tiltman folded before Flop (didn't bet)
Seat 5: Muinmyheart folded before Flop (didn't bet)
Seat 6: PinkTrinta collected ($2.50)
Seat 7: YuriiSolodya (button) folded before Flop (didn't bet)
Seat 8: matiko09 (small blind) folded before Flop
Seat 9: mycka86 (big blind) folded before Flop





PokerStars Hand #150803221573:  Hold'em No Limit ($0.50/$1.00 USD) - 2016/03/23 15:36:07 CET [2016/03/23 10:36:07 ET]
Table 'Atlantis' 9-max Seat #7 is the button
Seat 1: xHourglass ($153.96 in chips) 
Seat 2: Szevasztopol ($100 in chips) 
Seat 3: CAJUN890 ($67.01 in chips) 
Seat 4: mycka86 ($121.04 in chips) 
Seat 5: Durango-CO77 ($42.46 in chips) 
Seat 6: PacPacBum ($116.41 in chips) 
Seat 7: matiko09 ($139.11 in chips) 
Seat 8: jahwe ($102.50 in chips) 
Seat 9: RICKA16 ($137.21 in chips) 
jahwe: posts small blind $0.50
RICKA16: posts big blind $1
*** HOLE CARDS ***
Dealt to matiko09 [9h Qs]
xHourglass: folds 
Szevasztopol: folds 
xHourglass leaves the table
CAJUN890: folds 
mycka86: raises $2 to $3
Durango-CO77: folds 
PacPacBum: calls $3
matiko09: folds 
Westpants joins the table at seat #1 
jahwe: folds 
RICKA16: raises $11 to $14
mycka86: folds 
PacPacBum: folds 
Uncalled bet ($11) returned to RICKA16
RICKA16 collected $9.50 from pot
RICKA16: doesn't show hand 
*** SUMMARY ***
Total pot $9.50 | Rake $0 
Seat 1: xHourglass folded before Flop (didn't bet)
Seat 2: Szevasztopol folded before Flop (didn't bet)
Seat 3: CAJUN890 folded before Flop (didn't bet)
Seat 4: mycka86 folded before Flop
Seat 5: Durango-CO77 folded before Flop (didn't bet)
Seat 6: PacPacBum folded before Flop
Seat 7: matiko09 (button) folded before Flop (didn't bet)
Seat 8: jahwe (small blind) folded before Flop
Seat 9: RICKA16 (big blind) collected ($9.50)





PokerStars Hand #150803222094:  Hold'em No Limit (€0.50/€1.00 EUR) - 2016/03/23 15:36:08 CET [2016/03/23 10:36:08 ET]
Table 'Volga III' 9-max Seat #6 is the button
Seat 1: Dantist1122 (€101.50 in chips) 
Seat 2: Scorpion5443 (€44.32 in chips) 
Seat 3: matiko09 (€100 in chips) 
Seat 4: bigacsiga (€107.60 in chips) 
Seat 5: omarr22 (€35.51 in chips) 
Seat 6: PacPacBum (€103.23 in chips) 
Seat 7: jahwe (€100 in chips) 
Seat 8: edidaz (€110.12 in chips) 
jahwe: posts small blind €0.50
edidaz: posts big blind €1
ardo888: sits out 
*** HOLE CARDS ***
Dealt to matiko09 [4s 9h]
Dantist1122: raises €2 to €3
Scorpion5443: calls €3
matiko09: folds 
bigacsiga: folds 
omarr22: folds 
PacPacBum: folds 
jahwe: folds 
edidaz: folds 
*** FLOP *** [Th Ac Kh]
Dantist1122: bets €3.93
Scorpion5443: calls €3.93
*** TURN *** [Th Ac Kh] [Qh]
Dantist1122: bets €8.50
Scorpion5443: folds 
Uncalled bet (€8.50) returned to Dantist1122
Dantist1122 collected €14.67 from pot
Dantist1122: doesn't show hand 
*** SUMMARY ***
Total pot €15.36 | Rake €0.69 
Board [Th Ac Kh Qh]
Seat 1: Dantist1122 collected (€14.67)
Seat 2: Scorpion5443 folded on the Turn
Seat 3: matiko09 folded before Flop (didn't bet)
Seat 4: bigacsiga folded before Flop (didn't bet)
Seat 5: omarr22 folded before Flop (didn't bet)
Seat 6: PacPacBum (button) folded before Flop (didn't bet)
Seat 7: jahwe (small blind) folded before Flop
Seat 8: edidaz (big blind) folded before Flop





PokerStars Hand #150803223064:  Hold'em No Limit ($0.50/$1.00 USD) - 2016/03/23 15:36:11 CET [2016/03/23 10:36:11 ET]
Table 'Aetolia II' 9-max Seat #2 is the button
Seat 1: ganzhuang ($53.65 in chips) 
Seat 2: jahwe ($100 in chips) 
Seat 3: lumen21 ($100 in chips) 
Seat 4: Pocketstud ($121.02 in chips) 
Seat 5: KingCastle77 ($89.80 in chips) 
Seat 6: Westpants ($100 in chips) 
Seat 7: matiko09 ($100 in chips) 
Seat 8: PacPacBum ($111.64 in chips) 
Seat 9: mmcardoulis ($66.05 in chips) 
lumen21: posts small blind $0.50
Pocketstud: posts big blind $1
ganzhuang: posts big blind $1
*** HOLE CARDS ***
Dealt to matiko09 [3d Qh]
KingCastle77: raises $2 to $3
Westpants: folds 
matiko09: folds 
PacPacBum: folds 
mmcardoulis: folds 
ganzhuang: calls $2
jahwe: folds 
lumen21: calls $2.50
Pocketstud: calls $2
*** FLOP *** [3h Ts 6c]
lumen21: checks 
Pocketstud: checks 
KingCastle77: bets $7.63
ganzhuang: folds 
lumen21: folds 
Pocketstud: folds 
Uncalled bet ($7.63) returned to KingCastle77
KingCastle77 collected $11.46 from pot
KingCastle77: doesn't show hand 
*** SUMMARY ***
Total pot $12 | Rake $0.54 
Board [3h Ts 6c]
Seat 1: ganzhuang folded on the Flop
Seat 2: jahwe (button) folded before Flop (didn't bet)
Seat 3: lumen21 (small blind) folded on the Flop
Seat 4: Pocketstud (big blind) folded on the Flop
Seat 5: KingCastle77 collected ($11.46)
Seat 6: Westpants folded before Flop (didn't bet)
Seat 7: matiko09 folded before Flop (didn't bet)
Seat 8: PacPacBum folded before Flop (didn't bet)
Seat 9: mmcardoulis folded before Flop (didn't bet)





PokerStars Hand #150803224717:  Hold'em No Limit (€0.50/€1.00 EUR) - 2016/03/23 15:36:16 CET [2016/03/23 10:36:16 ET]
Table 'Mercury III' 9-max Seat #3 is the button
Seat 1: matiko09 (€124.85 in chips) 
Seat 2: jahwe (€100 in chips) 
Seat 3: PacPacBum (€100 in chips) 
Seat 4: Muinmyheart (€102 in chips) 
Seat 5: ardo888 (€102.50 in chips) 
Seat 6: mycka86 (€101.50 in chips) 
Seat 7: STrakDD (€101.10 in chips) 
Seat 8: gfxed (€58.30 in chips) 
Seat 9: Indr3k (€101.50 in chips) 
Muinmyheart: posts small blind €0.50
ardo888: posts big blind €1
*** HOLE CARDS ***
Dealt to matiko09 [3c 8c]
mycka86: folds 
STrakDD: raises €2 to €3
gfxed: folds 
Indr3k: raises €7.50 to €10.50
matiko09: folds 
jahwe: folds 
PacPacBum: folds 
Muinmyheart: folds 
ardo888: folds 
STrakDD: calls €7.50
*** FLOP *** [7c 6h 7d]
STrakDD: checks 
Indr3k: bets €14
STrakDD: calls €14
*** TURN *** [7c 6h 7d] [Ad]
STrakDD: checks 
Indr3k: checks 
*** RIVER *** [7c 6h 7d Ad] [2d]
STrakDD: bets €36.26
Indr3k: calls €36.26
*** SHOW DOWN ***
STrakDD: shows [Kc Ac] (two pair, Aces and Sevens)
Indr3k: mucks hand 
STrakDD collected €120.87 from pot
*** SUMMARY ***
Total pot €123.02 | Rake €2.15 
Board [7c 6h 7d Ad 2d]
Seat 1: matiko09 folded before Flop (didn't bet)
Seat 2: jahwe folded before Flop (didn't bet)
Seat 3: PacPacBum (button) folded before Flop (didn't bet)
Seat 4: Muinmyheart (small blind) folded before Flop
Seat 5: ardo888 (big blind) folded before Flop
Seat 6: mycka86 folded before Flop (didn't bet)
Seat 7: STrakDD showed [Kc Ac] and won (€120.87) with two pair, Aces and Sevens
Seat 8: gfxed folded before Flop (didn't bet)
Seat 9: Indr3k mucked [Ah 5c]





PokerStars Hand #150803225689:  Hold'em No Limit ($0.50/$1.00 USD) - 2016/03/23 15:36:19 CET [2016/03/23 10:36:19 ET]
Table 'Asmodeus' 9-max Seat #3 is the button
Seat 1: Jimy Tiltman ($169.57 in chips) 
Seat 2: PacPacBum ($100.99 in chips) 
Seat 3: jahwe ($111.41 in chips) 
Seat 4: Effort92 ($102.10 in chips) 
Seat 5: Muinmyheart ($104.49 in chips) 
Seat 6: fuppeee ($132.15 in chips) 
Seat 7: mycka86 ($115.85 in chips) 
Seat 8: app1e_j@ck ($100 in chips) 
Seat 9: matiko09 ($100 in chips) 
Effort92: posts small blind $0.50
Muinmyheart: posts big blind $1
Jimy Tiltman: posts the ante $0.20
PacPacBum: posts the ante $0.20
jahwe: posts the ante $0.20
Effort92: posts the ante $0.20
Muinmyheart: posts the ante $0.20
fuppeee: posts the ante $0.20
mycka86: posts the ante $0.20
app1e_j@ck: posts the ante $0.20
matiko09: posts the ante $0.20
*** HOLE CARDS ***
Dealt to matiko09 [Kh Qd]
fuppeee: calls $1
mycka86: folds 
app1e_j@ck: raises $4 to $5
matiko09: folds 
Jimy Tiltman: folds 
PacPacBum: calls $5
jahwe: calls $5
Effort92: folds 
Muinmyheart: folds 
fuppeee: calls $4
*** FLOP *** [Tc 2c 2h]
fuppeee: checks 
app1e_j@ck: checks 
PacPacBum: checks 
jahwe: checks 
*** TURN *** [Tc 2c 2h] [Th]
fuppeee: checks 
app1e_j@ck: checks 
PacPacBum: bets $7.78
jahwe: folds 
fuppeee: calls $7.78
app1e_j@ck: folds 
*** RIVER *** [Tc 2c 2h Th] [9h]
fuppeee: bets $18.55
PacPacBum: folds 
Uncalled bet ($18.55) returned to fuppeee
fuppeee collected $37.11 from pot
*** SUMMARY ***
Total pot $38.86 | Rake $1.75 
Board [Tc 2c 2h Th 9h]
Seat 1: Jimy Tiltman folded before Flop (didn't bet)
Seat 2: PacPacBum folded on the River
Seat 3: jahwe (button) folded on the Turn
Seat 4: Effort92 (small blind) folded before Flop
Seat 5: Muinmyheart (big blind) folded before Flop
Seat 6: fuppeee collected ($37.11)
Seat 7: mycka86 folded before Flop (didn't bet)
Seat 8: app1e_j@ck folded on the Turn
Seat 9: matiko09 folded before Flop (didn't bet)





PokerStars Hand #150803226029:  Hold'em No Limit ($0.50/$1.00 USD) - 2016/03/23 15:36:20 CET [2016/03/23 10:36:20 ET]
Table 'Drakonia II' 9-max Seat #8 is the button
Seat 1: chautinhtri9 ($127.60 in chips) 
Seat 2: RICKA16 ($97 in chips) 
Seat 4: Jimy Tiltman ($100 in chips) 
Seat 5: Muinmyheart ($100 in chips) 
Seat 6: PinkTrinta ($121.25 in chips) 
Seat 7: YuriiSolodya ($45.96 in chips) 
Seat 8: matiko09 ($100 in chips) 
Seat 9: mycka86 ($100.86 in chips) 
mycka86: posts small blind $0.50
chautinhtri9: posts big blind $1
PacPacBum: sits out 
*** HOLE CARDS ***
Dealt to matiko09 [8c 3d]
RICKA16: folds 
Jimy Tiltman: folds 
Muinmyheart: folds 
PinkTrinta: folds 
YuriiSolodya: folds 
matiko09: folds 
mycka86: raises $1.75 to $2.75
chautinhtri9: calls $1.75
*** FLOP *** [4c 9h Qc]
mycka86: checks 
chautinhtri9: checks 
*** TURN *** [4c 9h Qc] [6h]
mycka86: checks 
chautinhtri9: bets $4
mycka86: folds 
Uncalled bet ($4) returned to chautinhtri9
chautinhtri9 collected $5.25 from pot
*** SUMMARY ***
Total pot $5.50 | Rake $0.25 
Board [4c 9h Qc 6h]
Seat 1: chautinhtri9 (big blind) collected ($5.25)
Seat 2: RICKA16 folded before Flop (didn't bet)
Seat 4: Jimy Tiltman folded before Flop (didn't bet)
Seat 5: Muinmyheart folded before Flop (didn't bet)
Seat 6: PinkTrinta folded before Flop (didn't bet)
Seat 7: YuriiSolodya folded before Flop (didn't bet)
Seat 8: matiko09 (button) folded before Flop (didn't bet)
Seat 9: mycka86 (small blind) folded on the Turn





PokerStars Hand #150803230275:  Hold'em No Limit ($0.50/$1.00 USD) - 2016/03/23 15:36:33 CET [2016/03/23 10:36:33 ET]
Table 'Swings' 9-max Seat #2 is the button
Seat 1: lumen21 ($103.78 in chips) 
Seat 2: tomver0809 ($64.50 in chips) 
Seat 3: edidaz ($100.50 in chips) 
Seat 4: YuriiSolodya ($42.77 in chips) 
Seat 5: chautinhtri9 ($114.55 in chips) 
Seat 6: matiko09 ($141.42 in chips) 
Seat 7: PacPacBum ($123.49 in chips) 
Seat 8: RICKA16 ($102.68 in chips) 
Seat 9: Effort92 ($100.53 in chips) 
edidaz: posts small blind $0.50
YuriiSolodya: posts big blind $1
*** HOLE CARDS ***
Dealt to matiko09 [8c 9h]
chautinhtri9: folds 
matiko09: folds 
PacPacBum: folds 
RICKA16: folds 
Effort92: folds 
lumen21: raises $1.50 to $2.50
tomver0809: folds 
edidaz: folds 
YuriiSolodya: folds 
Uncalled bet ($1.50) returned to lumen21
lumen21 collected $2.50 from pot
lumen21: doesn't show hand 
*** SUMMARY ***
Total pot $2.50 | Rake $0 
Seat 1: lumen21 collected ($2.50)
Seat 2: tomver0809 (button) folded before Flop (didn't bet)
Seat 3: edidaz (small blind) folded before Flop
Seat 4: YuriiSolodya (big blind) folded before Flop
Seat 5: chautinhtri9 folded before Flop (didn't bet)
Seat 6: matiko09 folded before Flop (didn't bet)
Seat 7: PacPacBum folded before Flop (didn't bet)
Seat 8: RICKA16 folded before Flop (didn't bet)
Seat 9: Effort92 folded before Flop (didn't bet)





PokerStars Hand #150803233569:  Hold'em No Limit ($0.50/$1.00 USD) - 2016/03/23 15:36:42 CET [2016/03/23 10:36:42 ET]
Table 'Sylvia III' 9-max Seat #3 is the button
Seat 1: mycka86 ($149.70 in chips) 
Seat 2: Dantist1122 ($106.80 in chips) 
Seat 3: se7en_$tars ($200.96 in chips) 
Seat 5: matiko09 ($100 in chips) 
Seat 6: PacPacBum ($100 in chips) 
Seat 8: Muinmyheart ($138.40 in chips) 
Seat 9: Jimy Tiltman ($100 in chips) 
lombardo11 has timed out while disconnected
lombardo11: is sitting out 
matiko09: posts small blind $0.50
PacPacBum: posts big blind $1
jahwe: sits out 
mycka86: posts the ante $0.20
Dantist1122: posts the ante $0.20
se7en_$tars: posts the ante $0.20
matiko09: posts the ante $0.20
PacPacBum: posts the ante $0.20
Muinmyheart: posts the ante $0.20
Jimy Tiltman: posts the ante $0.20
*** HOLE CARDS ***
Dealt to matiko09 [6c Ks]
Muinmyheart: raises $2 to $3
Jimy Tiltman: folds 
mycka86: folds 
Dantist1122: folds 
se7en_$tars: calls $3
matiko09: folds 
PacPacBum: folds 
*** FLOP *** [Kc 6s As]
Muinmyheart: bets $4.50
se7en_$tars: folds 
Uncalled bet ($4.50) returned to Muinmyheart
Muinmyheart collected $8.50 from pot
Muinmyheart: doesn't show hand 
*** SUMMARY ***
Total pot $8.90 | Rake $0.40 
Board [Kc 6s As]
Seat 1: mycka86 folded before Flop (didn't bet)
Seat 2: Dantist1122 folded before Flop (didn't bet)
Seat 3: se7en_$tars (button) folded on the Flop
Seat 5: matiko09 (small blind) folded before Flop
Seat 6: PacPacBum (big blind) folded before Flop
Seat 8: Muinmyheart collected ($8.50)
Seat 9: Jimy Tiltman folded before Flop (didn't bet)





PokerStars Hand #150803234500:  Hold'em No Limit ($0.50/$1.00 USD) - 2016/03/23 15:36:45 CET [2016/03/23 10:36:45 ET]
Table 'Haug II' 9-max Seat #3 is the button
Seat 1: PacPacBum ($100 in chips) 
Seat 2: ardo888 ($126.66 in chips) 
Seat 3: camilalope ($93.06 in chips) 
Seat 4: matiko09 ($100.42 in chips) 
Seat 5: GlamDragon ($98.21 in chips) 
Seat 7: jahwe ($107.29 in chips) 
Seat 8: BRIGANTE49 ($80.57 in chips) 
Seat 9: ZOLOTOY766 ($77.60 in chips) 
matiko09: posts small blind $0.50
GlamDragon: posts big blind $1
Pocketstud: sits out 
PacPacBum: posts the ante $0.20
ardo888: posts the ante $0.20
camilalope: posts the ante $0.20
matiko09: posts the ante $0.20
GlamDragon: posts the ante $0.20
jahwe: posts the ante $0.20
BRIGANTE49: posts the ante $0.20
ZOLOTOY766: posts the ante $0.20
*** HOLE CARDS ***
Dealt to matiko09 [8d 2h]
jahwe: folds 
BRIGANTE49: raises $1 to $2
ZOLOTOY766: folds 
PacPacBum: folds 
ardo888: folds 
camilalope: folds 
matiko09: folds 
GlamDragon: folds 
Uncalled bet ($1) returned to BRIGANTE49
BRIGANTE49 collected $4.10 from pot
BRIGANTE49: doesn't show hand 
*** SUMMARY ***
Total pot $4.10 | Rake $0 
Seat 1: PacPacBum folded before Flop (didn't bet)
Seat 2: ardo888 folded before Flop (didn't bet)
Seat 3: camilalope (button) folded before Flop (didn't bet)
Seat 4: matiko09 (small blind) folded before Flop
Seat 5: GlamDragon (big blind) folded before Flop
Seat 7: jahwe folded before Flop (didn't bet)
Seat 8: BRIGANTE49 collected ($4.10)
Seat 9: ZOLOTOY766 folded before Flop (didn't bet)





PokerStars Hand #150803239709:  Hold'em No Limit ($0.50/$1.00 USD) - 2016/03/23 15:37:00 CET [2016/03/23 10:37:00 ET]
Table 'Smiley' 9-max Seat #7 is the button
Seat 1: xHourglass ($100 in chips) 
Seat 2: Jimy Tiltman ($101.70 in chips) 
Seat 3: mycka86 ($100 in chips) 
Seat 4: CAJUN890 ($82.69 in chips) 
Seat 5: Szevasztopol ($148.85 in chips) 
Seat 6: blackmont111 ($121.54 in chips) 
Seat 7: bennetb77 ($109.36 in chips) 
Seat 8: matiko09 ($104.08 in chips) 
Seat 9: PacPacBum ($104.31 in chips) 
matiko09: posts small blind $0.50
PacPacBum: posts big blind $1
*** HOLE CARDS ***
Dealt to matiko09 [5d 5c]
xHourglass: folds 
xHourglass leaves the table
Jimy Tiltman: folds 
mycka86: folds 
CAJUN890: folds 
Szevasztopol: raises $2 to $3
blackmont111: folds 
bennetb77: calls $3
jahwe joins the table at seat #1 
matiko09: calls $2.50
PacPacBum: folds 
*** FLOP *** [3d 8s Kd]
matiko09: checks 
Szevasztopol: bets $6
bennetb77: folds 
matiko09: folds 
Uncalled bet ($6) returned to Szevasztopol
Szevasztopol collected $9.55 from pot
Szevasztopol: doesn't show hand 
*** SUMMARY ***
Total pot $10 | Rake $0.45 
Board [3d 8s Kd]
Seat 1: xHourglass folded before Flop (didn't bet)
Seat 2: Jimy Tiltman folded before Flop (didn't bet)
Seat 3: mycka86 folded before Flop (didn't bet)
Seat 4: CAJUN890 folded before Flop (didn't bet)
Seat 5: Szevasztopol collected ($9.55)
Seat 6: blackmont111 folded before Flop (didn't bet)
Seat 7: bennetb77 (button) folded on the Flop
Seat 8: matiko09 (small blind) folded on the Flop
Seat 9: PacPacBum (big blind) folded before Flop





PokerStars Hand #150803241112:  Hold'em No Limit ($0.50/$1.00 USD) - 2016/03/23 15:37:05 CET [2016/03/23 10:37:05 ET]
Table 'Atlantis' 9-max Seat #8 is the button
Seat 1: Westpants ($100 in chips) 
Seat 2: Szevasztopol ($100 in chips) 
Seat 3: CAJUN890 ($67.01 in chips) 
Seat 4: mycka86 ($118.04 in chips) 
Seat 5: Durango-CO77 ($42.46 in chips) 
Seat 6: PacPacBum ($113.41 in chips) 
Seat 7: matiko09 ($139.11 in chips) 
Seat 8: jahwe ($102 in chips) 
Seat 9: RICKA16 ($143.71 in chips) 
RICKA16: posts small blind $0.50
Westpants: posts big blind $1
*** HOLE CARDS ***
Dealt to matiko09 [7d 4d]
Szevasztopol: folds 
CAJUN890: folds 
mycka86: folds 
Durango-CO77: folds 
PacPacBum: folds 
matiko09: folds 
jahwe: folds 
RICKA16: folds 
Uncalled bet ($0.50) returned to Westpants
Westpants collected $1 from pot
*** SUMMARY ***
Total pot $1 | Rake $0 
Seat 1: Westpants (big blind) collected ($1)
Seat 2: Szevasztopol folded before Flop (didn't bet)
Seat 3: CAJUN890 folded before Flop (didn't bet)
Seat 4: mycka86 folded before Flop (didn't bet)
Seat 5: Durango-CO77 folded before Flop (didn't bet)
Seat 6: PacPacBum folded before Flop (didn't bet)
Seat 7: matiko09 folded before Flop (didn't bet)
Seat 8: jahwe (button) folded before Flop (didn't bet)
Seat 9: RICKA16 (small blind) folded before Flop





PokerStars Hand #150803243265:  Hold'em No Limit ($0.50/$1.00 USD) - 2016/03/23 15:37:11 CET [2016/03/23 10:37:11 ET]
Table 'Drakonia II' 9-max Seat #9 is the button
Seat 1: chautinhtri9 ($130.10 in chips) 
Seat 2: RICKA16 ($100 in chips) 
Seat 4: Jimy Tiltman ($100 in chips) 
Seat 5: Muinmyheart ($100 in chips) 
Seat 6: PinkTrinta ($121.25 in chips) 
Seat 7: YuriiSolodya ($45.96 in chips) 
Seat 8: matiko09 ($100 in chips) 
Seat 9: mycka86 ($100 in chips) 
chautinhtri9: posts small blind $0.50
RICKA16: posts big blind $1
PacPacBum: sits out 
*** HOLE CARDS ***
Dealt to matiko09 [5h Jd]
Jimy Tiltman: folds 
Muinmyheart: folds 
PinkTrinta: folds 
YuriiSolodya: folds 
matiko09: folds 
mycka86: raises $1.10 to $2.10
chautinhtri9: calls $1.60
RICKA16: folds 
*** FLOP *** [4c Js As]
chautinhtri9: checks 
mycka86: bets $3.50
chautinhtri9: folds 
Uncalled bet ($3.50) returned to mycka86
mycka86 collected $4.97 from pot
*** SUMMARY ***
Total pot $5.20 | Rake $0.23 
Board [4c Js As]
Seat 1: chautinhtri9 (small blind) folded on the Flop
Seat 2: RICKA16 (big blind) folded before Flop
Seat 4: Jimy Tiltman folded before Flop (didn't bet)
Seat 5: Muinmyheart folded before Flop (didn't bet)
Seat 6: PinkTrinta folded before Flop (didn't bet)
Seat 7: YuriiSolodya folded before Flop (didn't bet)
Seat 8: matiko09 folded before Flop (didn't bet)
Seat 9: mycka86 (button) collected ($4.97)





PokerStars Hand #150803246159:  Hold'em No Limit (€0.50/€1.00 EUR) - 2016/03/23 15:37:19 CET [2016/03/23 10:37:19 ET]
Table 'Volga III' 9-max Seat #7 is the button
Seat 1: Dantist1122 (€109.24 in chips) 
Seat 2: Scorpion5443 (€37.39 in chips) 
Seat 3: matiko09 (€100 in chips) 
Seat 4: bigacsiga (€107.60 in chips) 
Seat 5: omarr22 (€35.51 in chips) 
Seat 6: PacPacBum (€103.23 in chips) 
Seat 7: jahwe (€100 in chips) 
Seat 8: edidaz (€109.12 in chips) 
Seat 9: ardo888 (€100 in chips) 
edidaz: posts small blind €0.50
ardo888: posts big blind €1
*** HOLE CARDS ***
Dealt to matiko09 [Kd Qs]
Dantist1122: folds 
Scorpion5443 has timed out
Scorpion5443: folds 
matiko09: raises €2 to €3
bigacsiga: folds 
omarr22: calls €3
PacPacBum: folds 
jahwe: folds 
edidaz: folds 
ardo888: raises €9.50 to €12.50
matiko09: folds 
omarr22: calls €9.50
*** FLOP *** [3h 5d Jd]
ardo888: checks 
omarr22: checks 
*** TURN *** [3h 5d Jd] [Ts]
ardo888: checks 
omarr22: bets €14
Scorpion5443 leaves the table
ardo888: raises €14 to €28
omarr22: calls €9.01 and is all-in
Uncalled bet (€4.99) returned to ardo888
*** RIVER *** [3h 5d Jd Ts] [6h]
*** SHOW DOWN ***
ardo888: shows [Jh Jc] (three of a kind, Jacks)
omarr22: shows [9s Js] (a pair of Jacks)
ardo888 collected €72.37 from pot
*** SUMMARY ***
Total pot €74.52 | Rake €2.15 
Board [3h 5d Jd Ts 6h]
Seat 1: Dantist1122 folded before Flop (didn't bet)
Seat 2: Scorpion5443 folded before Flop (didn't bet)
Seat 3: matiko09 folded before Flop
Seat 4: bigacsiga folded before Flop (didn't bet)
Seat 5: omarr22 showed [9s Js] and lost with a pair of Jacks
Seat 6: PacPacBum folded before Flop (didn't bet)
Seat 7: jahwe (button) folded before Flop (didn't bet)
Seat 8: edidaz (small blind) folded before Flop
Seat 9: ardo888 (big blind) showed [Jh Jc] and won (€72.37) with three of a kind, Jacks





PokerStars Hand #150803246447:  Hold'em No Limit ($1/$2 USD) - 2016/03/23 15:37:20 CET [2016/03/23 10:37:20 ET]
Table 'Kiess' 9-max Seat #1 is the button
Seat 1: Cirilico ($244.37 in chips) 
Seat 2: jahwe ($200 in chips) 
Seat 3: Red4erT ($100.29 in chips) 
Seat 4: RamiroAgujis ($200 in chips) 
Seat 5: chippo boy ($455.37 in chips) 
Seat 6: matiko09 ($231.48 in chips) 
Seat 7: chaps1988 ($206.24 in chips) 
Seat 8: erfk1958 ($130.78 in chips) 
Seat 9: PacPacBum ($200 in chips) 
jahwe: posts small blind $1
Red4erT: posts big blind $2
*** HOLE CARDS ***
Dealt to matiko09 [Ah 4d]
RamiroAgujis: folds 
chippo boy: folds 
matiko09: folds 
chaps1988: raises $4 to $6
erfk1958: folds 
PacPacBum: folds 
Cirilico: folds 
jahwe: folds 
Red4erT: folds 
Uncalled bet ($4) returned to chaps1988
chaps1988 collected $5 from pot
chaps1988: doesn't show hand 
*** SUMMARY ***
Total pot $5 | Rake $0 
Seat 1: Cirilico (button) folded before Flop (didn't bet)
Seat 2: jahwe (small blind) folded before Flop
Seat 3: Red4erT (big blind) folded before Flop
Seat 4: RamiroAgujis folded before Flop (didn't bet)
Seat 5: chippo boy folded before Flop (didn't bet)
Seat 6: matiko09 folded before Flop (didn't bet)
Seat 7: chaps1988 collected ($5)
Seat 8: erfk1958 folded before Flop (didn't bet)
Seat 9: PacPacBum folded before Flop (didn't bet)





PokerStars Hand #150803246878:  Hold'em No Limit ($0.50/$1.00 USD) - 2016/03/23 15:37:22 CET [2016/03/23 10:37:22 ET]
Table 'Swings' 9-max Seat #3 is the button
Seat 1: lumen21 ($105.28 in chips) 
Seat 2: tomver0809 ($64.50 in chips) 
Seat 3: edidaz ($100 in chips) 
Seat 4: YuriiSolodya ($41.77 in chips) 
Seat 5: chautinhtri9 ($114.55 in chips) 
Seat 6: matiko09 ($141.42 in chips) 
Seat 7: PacPacBum ($123.49 in chips) 
Seat 8: RICKA16 ($102.68 in chips) 
Seat 9: Effort92 ($100.53 in chips) 
YuriiSolodya: posts small blind $0.50
chautinhtri9: posts big blind $1
*** HOLE CARDS ***
Dealt to matiko09 [Ks Jc]
matiko09: folds 
PacPacBum: folds 
RICKA16: folds 
Effort92: folds 
lumen21: folds 
tomver0809: folds 
edidaz: raises $1.04 to $2.04
YuriiSolodya: raises $5.08 to $7.12
chautinhtri9: folds 
edidaz: calls $5.08
*** FLOP *** [2c 5s 2h]
YuriiSolodya: bets $7
edidaz: raises $85.88 to $92.88 and is all-in
YuriiSolodya: folds 
Uncalled bet ($85.88) returned to edidaz
edidaz collected $27.92 from pot
edidaz: doesn't show hand 
*** SUMMARY ***
Total pot $29.24 | Rake $1.32 
Board [2c 5s 2h]
Seat 1: lumen21 folded before Flop (didn't bet)
Seat 2: tomver0809 folded before Flop (didn't bet)
Seat 3: edidaz (button) collected ($27.92)
Seat 4: YuriiSolodya (small blind) folded on the Flop
Seat 5: chautinhtri9 (big blind) folded before Flop
Seat 6: matiko09 folded before Flop (didn't bet)
Seat 7: PacPacBum folded before Flop (didn't bet)
Seat 8: RICKA16 folded before Flop (didn't bet)
Seat 9: Effort92 folded before Flop (didn't bet)





PokerStars Hand #150803247858:  Hold'em No Limit ($0.50/$1.00 USD) - 2016/03/23 15:37:25 CET [2016/03/23 10:37:25 ET]
Table 'Aetolia II' 9-max Seat #3 is the button
Seat 1: ganzhuang ($50.65 in chips) 
Seat 2: jahwe ($100 in chips) 
Seat 3: lumen21 ($100 in chips) 
Seat 4: Pocketstud ($118.02 in chips) 
Seat 5: KingCastle77 ($98.26 in chips) 
Seat 6: Westpants ($100 in chips) 
Seat 7: matiko09 ($100 in chips) 
Seat 8: PacPacBum ($111.64 in chips) 
Seat 9: mmcardoulis ($66.05 in chips) 
Pocketstud: posts small blind $0.50
KingCastle77: posts big blind $1
*** HOLE CARDS ***
Dealt to matiko09 [8s Ah]
Westpants: folds 
matiko09: folds 
PacPacBum: raises $1.04 to $2.04
mmcardoulis: folds 
ganzhuang: folds 
ganzhuang leaves the table
app1e_j@ck joins the table at seat #1 
jahwe: calls $2.04
lumen21: calls $2.04
Pocketstud: folds 
KingCastle77: folds 
*** FLOP *** [3c 6d Qd]
PacPacBum: checks 
jahwe: bets $4.50
lumen21: folds 
PacPacBum: folds 
Uncalled bet ($4.50) returned to jahwe
jahwe collected $7.28 from pot
jahwe: doesn't show hand 
*** SUMMARY ***
Total pot $7.62 | Rake $0.34 
Board [3c 6d Qd]
Seat 1: ganzhuang folded before Flop (didn't bet)
Seat 2: jahwe collected ($7.28)
Seat 3: lumen21 (button) folded on the Flop
Seat 4: Pocketstud (small blind) folded before Flop
Seat 5: KingCastle77 (big blind) folded before Flop
Seat 6: Westpants folded before Flop (didn't bet)
Seat 7: matiko09 folded before Flop (didn't bet)
Seat 8: PacPacBum folded on the Flop
Seat 9: mmcardoulis folded before Flop (didn't bet)





PokerStars Hand #150803248049:  Hold'em No Limit ($0.50/$1.00 USD) - 2016/03/23 15:37:25 CET [2016/03/23 10:37:25 ET]
Table 'Haug II' 9-max Seat #4 is the button
Seat 1: PacPacBum ($100 in chips) 
Seat 2: ardo888 ($126.46 in chips) 
Seat 3: camilalope ($92.86 in chips) 
Seat 4: matiko09 ($100 in chips) 
Seat 5: GlamDragon ($97.01 in chips) 
Seat 6: Pocketstud ($100 in chips) 
Seat 7: jahwe ($107.09 in chips) 
Seat 8: BRIGANTE49 ($83.47 in chips) 
Seat 9: ZOLOTOY766 ($77.40 in chips) 
GlamDragon: posts small blind $0.50
Pocketstud: posts big blind $1
PacPacBum: posts the ante $0.20
ardo888: posts the ante $0.20
camilalope: posts the ante $0.20
matiko09: posts the ante $0.20
GlamDragon: posts the ante $0.20
Pocketstud: posts the ante $0.20
jahwe: posts the ante $0.20
BRIGANTE49: posts the ante $0.20
ZOLOTOY766: posts the ante $0.20
*** HOLE CARDS ***
Dealt to matiko09 [5h Qs]
jahwe: folds 
BRIGANTE49: calls $1
ZOLOTOY766: folds 
PacPacBum: folds 
ardo888: folds 
camilalope: folds 
matiko09: folds 
GlamDragon: calls $0.50
Pocketstud: checks 
*** FLOP *** [5d 6c 8c]
GlamDragon: bets $1
Pocketstud: folds 
BRIGANTE49: calls $1
*** TURN *** [5d 6c 8c] [Ad]
GlamDragon: checks 
BRIGANTE49: bets $3
GlamDragon: folds 
Uncalled bet ($3) returned to BRIGANTE49
BRIGANTE49 collected $6.49 from pot
BRIGANTE49: doesn't show hand 
*** SUMMARY ***
Total pot $6.80 | Rake $0.31 
Board [5d 6c 8c Ad]
Seat 1: PacPacBum folded before Flop (didn't bet)
Seat 2: ardo888 folded before Flop (didn't bet)
Seat 3: camilalope folded before Flop (didn't bet)
Seat 4: matiko09 (button) folded before Flop (didn't bet)
Seat 5: GlamDragon (small blind) folded on the Turn
Seat 6: Pocketstud (big blind) folded on the Flop
Seat 7: jahwe folded before Flop (didn't bet)
Seat 8: BRIGANTE49 collected ($6.49)
Seat 9: ZOLOTOY766 folded before Flop (didn't bet)





PokerStars Hand #150803251971:  Hold'em No Limit ($0.50/$1.00 USD) - 2016/03/23 15:37:37 CET [2016/03/23 10:37:37 ET]
Table 'Atlantis' 9-max Seat #9 is the button
Seat 1: Westpants ($100.50 in chips) 
Seat 2: Szevasztopol ($100 in chips) 
Seat 3: CAJUN890 ($67.01 in chips) 
Seat 4: mycka86 ($118.04 in chips) 
Seat 5: Durango-CO77 ($42.46 in chips) 
Seat 6: PacPacBum ($113.41 in chips) 
Seat 7: matiko09 ($139.11 in chips) 
Seat 8: jahwe ($102 in chips) 
Seat 9: RICKA16 ($143.21 in chips) 
Westpants: posts small blind $0.50
Szevasztopol: posts big blind $1
*** HOLE CARDS ***
Dealt to matiko09 [3s Kh]
CAJUN890: folds 
mycka86: folds 
Durango-CO77: calls $1
PacPacBum: folds 
matiko09: folds 
jahwe: folds 
RICKA16: folds 
Westpants: folds 
Szevasztopol: checks 
*** FLOP *** [Td Ac 6s]
Szevasztopol: checks 
Durango-CO77: bets $3
Szevasztopol: calls $3
*** TURN *** [Td Ac 6s] [Ah]
Szevasztopol: checks 
Durango-CO77: bets $3
Szevasztopol: calls $3
*** RIVER *** [Td Ac 6s Ah] [As]
Szevasztopol: checks 
Durango-CO77: checks 
*** SHOW DOWN ***
Szevasztopol: shows [6d Jc] (a full house, Aces full of Sixes)
Durango-CO77: shows [7h 7s] (a full house, Aces full of Sevens)
Durango-CO77 collected $13.85 from pot
*** SUMMARY ***
Total pot $14.50 | Rake $0.65 
Board [Td Ac 6s Ah As]
Seat 1: Westpants (small blind) folded before Flop
Seat 2: Szevasztopol (big blind) showed [6d Jc] and lost with a full house, Aces full of Sixes
Seat 3: CAJUN890 folded before Flop (didn't bet)
Seat 4: mycka86 folded before Flop (didn't bet)
Seat 5: Durango-CO77 showed [7h 7s] and won ($13.85) with a full house, Aces full of Sevens
Seat 6: PacPacBum folded before Flop (didn't bet)
Seat 7: matiko09 folded before Flop (didn't bet)
Seat 8: jahwe folded before Flop (didn't bet)
Seat 9: RICKA16 (button) folded before Flop (didn't bet)





PokerStars Hand #150803256723:  Hold'em No Limit ($0.50/$1.00 USD) - 2016/03/23 15:37:51 CET [2016/03/23 10:37:51 ET]
Table 'Smiley' 9-max Seat #8 is the button
Seat 1: jahwe ($100 in chips) 
Seat 2: Jimy Tiltman ($101.70 in chips) 
Seat 3: mycka86 ($100 in chips) 
Seat 4: CAJUN890 ($82.69 in chips) 
Seat 5: Szevasztopol ($155.40 in chips) 
Seat 6: blackmont111 ($121.54 in chips) 
Seat 7: bennetb77 ($106.36 in chips) 
Seat 8: matiko09 ($101.08 in chips) 
Seat 9: PacPacBum ($103.31 in chips) 
PacPacBum: posts small blind $0.50
jahwe: posts big blind $1
*** HOLE CARDS ***
Dealt to matiko09 [5c Qh]
Jimy Tiltman: folds 
mycka86: folds 
CAJUN890: folds 
Szevasztopol: raises $2 to $3
blackmont111: folds 
bennetb77: folds 
matiko09: folds 
PacPacBum: folds 
jahwe: raises $6.50 to $9.50
Szevasztopol: calls $6.50
*** FLOP *** [Qs 8h 2d]
jahwe: bets $9
Szevasztopol: calls $9
*** TURN *** [Qs 8h 2d] [6h]
jahwe: bets $19
Szevasztopol: folds 
Uncalled bet ($19) returned to jahwe
jahwe collected $35.81 from pot
jahwe: doesn't show hand 
*** SUMMARY ***
Total pot $37.50 | Rake $1.69 
Board [Qs 8h 2d 6h]
Seat 1: jahwe (big blind) collected ($35.81)
Seat 2: Jimy Tiltman folded before Flop (didn't bet)
Seat 3: mycka86 folded before Flop (didn't bet)
Seat 4: CAJUN890 folded before Flop (didn't bet)
Seat 5: Szevasztopol folded on the Turn
Seat 6: blackmont111 folded before Flop (didn't bet)
Seat 7: bennetb77 folded before Flop (didn't bet)
Seat 8: matiko09 (button) folded before Flop (didn't bet)
Seat 9: PacPacBum (small blind) folded before Flop





PokerStars Hand #150803258539:  Hold'em No Limit ($0.50/$1.00 USD) - 2016/03/23 15:37:57 CET [2016/03/23 10:37:57 ET]
Table 'Drakonia II' 9-max Seat #1 is the button
Seat 1: chautinhtri9 ($128 in chips) 
Seat 2: RICKA16 ($99 in chips) 
Seat 3: PacPacBum ($100 in chips) 
Seat 4: Jimy Tiltman ($100 in chips) 
Seat 5: Muinmyheart ($100 in chips) 
Seat 6: PinkTrinta ($121.25 in chips) 
Seat 7: YuriiSolodya ($45.96 in chips) 
Seat 8: matiko09 ($100 in chips) 
Seat 9: mycka86 ($102.87 in chips) 
RICKA16: posts small blind $0.50
PacPacBum: posts big blind $1
*** HOLE CARDS ***
Dealt to matiko09 [Td 2s]
Jimy Tiltman: folds 
Muinmyheart: raises $2 to $3
PinkTrinta: folds 
YuriiSolodya: calls $3
matiko09: folds 
mycka86: folds 
chautinhtri9: folds 
RICKA16: folds 
PacPacBum: folds 
*** FLOP *** [4s 4h 9s]
Muinmyheart: checks 
YuriiSolodya: checks 
*** TURN *** [4s 4h 9s] [6d]
Muinmyheart: checks 
YuriiSolodya: bets $3
Muinmyheart: calls $3
*** RIVER *** [4s 4h 9s 6d] [8c]
Muinmyheart: checks 
YuriiSolodya: bets $4
Muinmyheart: folds 
Uncalled bet ($4) returned to YuriiSolodya
YuriiSolodya collected $12.89 from pot
YuriiSolodya: doesn't show hand 
*** SUMMARY ***
Total pot $13.50 | Rake $0.61 
Board [4s 4h 9s 6d 8c]
Seat 1: chautinhtri9 (button) folded before Flop (didn't bet)
Seat 2: RICKA16 (small blind) folded before Flop
Seat 3: PacPacBum (big blind) folded before Flop
Seat 4: Jimy Tiltman folded before Flop (didn't bet)
Seat 5: Muinmyheart folded on the River
Seat 6: PinkTrinta folded before Flop (didn't bet)
Seat 7: YuriiSolodya collected ($12.89)
Seat 8: matiko09 folded before Flop (didn't bet)
Seat 9: mycka86 folded before Flop (didn't bet)





PokerStars Hand #150803259387:  Hold'em No Limit (€0.50/€1.00 EUR) - 2016/03/23 15:37:59 CET [2016/03/23 10:37:59 ET]
Table 'Mercury III' 9-max Seat #4 is the button
Seat 1: matiko09 (€124.85 in chips) 
Seat 2: jahwe (€100 in chips) 
Seat 3: PacPacBum (€100 in chips) 
Seat 4: Muinmyheart (€101.50 in chips) 
Seat 5: ardo888 (€101.50 in chips) 
Seat 6: mycka86 (€101.50 in chips) 
Seat 7: STrakDD (€161.21 in chips) 
Seat 8: gfxed (€58.30 in chips) 
Seat 9: Indr3k (€100 in chips) 
ardo888: posts small blind €0.50
mycka86: posts big blind €1
*** HOLE CARDS ***
Dealt to matiko09 [Ad Ah]
STrakDD: folds 
gfxed: folds 
Indr3k: folds 
matiko09: raises €2 to €3
jahwe: folds 
PacPacBum: folds 
Muinmyheart: folds 
ardo888: folds 
mycka86: folds 
Uncalled bet (€2) returned to matiko09
matiko09 collected €2.50 from pot
matiko09: doesn't show hand 
*** SUMMARY ***
Total pot €2.50 | Rake €0 
Seat 1: matiko09 collected (€2.50)
Seat 2: jahwe folded before Flop (didn't bet)
Seat 3: PacPacBum folded before Flop (didn't bet)
Seat 4: Muinmyheart (button) folded before Flop (didn't bet)
Seat 5: ardo888 (small blind) folded before Flop
Seat 6: mycka86 (big blind) folded before Flop
Seat 7: STrakDD folded before Flop (didn't bet)
Seat 8: gfxed folded before Flop (didn't bet)
Seat 9: Indr3k folded before Flop (didn't bet)





PokerStars Hand #150803261397:  Hold'em No Limit ($1/$2 USD) - 2016/03/23 15:38:05 CET [2016/03/23 10:38:05 ET]
Table 'Kiess' 9-max Seat #2 is the button
Seat 1: Cirilico ($244.37 in chips) 
Seat 2: jahwe ($200 in chips) 
Seat 3: Red4erT ($98.29 in chips) 
Seat 4: RamiroAgujis ($200 in chips) 
Seat 5: chippo boy ($455.37 in chips) 
Seat 6: matiko09 ($231.48 in chips) 
Seat 7: chaps1988 ($209.24 in chips) 
Seat 8: erfk1958 ($130.78 in chips) 
Seat 9: PacPacBum ($200 in chips) 
Red4erT: posts small blind $1
RamiroAgujis: posts big blind $2
*** HOLE CARDS ***
Dealt to matiko09 [Jc 8s]
chippo boy: folds 
matiko09: folds 
chaps1988: folds 
erfk1958: folds 
PacPacBum: folds 
Cirilico: folds 
jahwe: raises $2 to $4
Red4erT: raises $9 to $13
RamiroAgujis: folds 
jahwe: folds 
Uncalled bet ($9) returned to Red4erT
Red4erT collected $10 from pot
Red4erT: doesn't show hand 
*** SUMMARY ***
Total pot $10 | Rake $0 
Seat 1: Cirilico folded before Flop (didn't bet)
Seat 2: jahwe (button) folded before Flop
Seat 3: Red4erT (small blind) collected ($10)
Seat 4: RamiroAgujis (big blind) folded before Flop
Seat 5: chippo boy folded before Flop (didn't bet)
Seat 6: matiko09 folded before Flop (didn't bet)
Seat 7: chaps1988 folded before Flop (didn't bet)
Seat 8: erfk1958 folded before Flop (didn't bet)
Seat 9: PacPacBum folded before Flop (didn't bet)





PokerStars Hand #150803261634:  Hold'em No Limit ($0.50/$1.00 USD) - 2016/03/23 15:38:06 CET [2016/03/23 10:38:06 ET]
Table 'Haug II' 9-max Seat #5 is the button
Seat 1: PacPacBum ($100 in chips) 
Seat 2: ardo888 ($126.26 in chips) 
Seat 3: camilalope ($92.66 in chips) 
Seat 4: matiko09 ($100 in chips) 
Seat 5: GlamDragon ($94.81 in chips) 
Seat 6: Pocketstud ($98.80 in chips) 
Seat 8: BRIGANTE49 ($87.76 in chips) 
Seat 9: ZOLOTOY766 ($77.20 in chips) 
Pocketstud: posts small blind $0.50
jahwe: is sitting out 
BRIGANTE49: posts big blind $1
PacPacBum: posts the ante $0.20
ardo888: posts the ante $0.20
camilalope: posts the ante $0.20
matiko09: posts the ante $0.20
GlamDragon: posts the ante $0.20
Pocketstud: posts the ante $0.20
BRIGANTE49: posts the ante $0.20
ZOLOTOY766: posts the ante $0.20
*** HOLE CARDS ***
Dealt to matiko09 [Ah Qh]
ZOLOTOY766: folds 
PacPacBum: raises $1.50 to $2.50
ardo888: folds 
camilalope: folds 
matiko09: calls $2.50
GlamDragon: calls $2.50
Pocketstud: folds 
BRIGANTE49: calls $1.50
*** FLOP *** [Jd 5s 5c]
BRIGANTE49: bets $6
PacPacBum: folds 
matiko09: folds 
GlamDragon: folds 
Uncalled bet ($6) returned to BRIGANTE49
BRIGANTE49 collected $11.56 from pot
BRIGANTE49: doesn't show hand 
*** SUMMARY ***
Total pot $12.10 | Rake $0.54 
Board [Jd 5s 5c]
Seat 1: PacPacBum folded on the Flop
Seat 2: ardo888 folded before Flop (didn't bet)
Seat 3: camilalope folded before Flop (didn't bet)
Seat 4: matiko09 folded on the Flop
Seat 5: GlamDragon (button) folded on the Flop
Seat 6: Pocketstud (small blind) folded before Flop
Seat 8: BRIGANTE49 (big blind) collected ($11.56)
Seat 9: ZOLOTOY766 folded before Flop (didn't bet)





PokerStars Hand #150803261541:  Hold'em No Limit ($0.50/$1.00 USD) - 2016/03/23 15:38:06 CET [2016/03/23 10:38:06 ET]
Table 'Sylvia III' 9-max Seat #5 is the button
Seat 1: mycka86 ($149.50 in chips) 
Seat 2: Dantist1122 ($106.60 in chips) 
Seat 3: se7en_$tars ($197.76 in chips) 
Seat 5: matiko09 ($100 in chips) 
Seat 6: PacPacBum ($100 in chips) 
Seat 7: jahwe ($100 in chips) 
Seat 8: Muinmyheart ($143.70 in chips) 
Seat 9: Jimy Tiltman ($100 in chips) 
PacPacBum: posts small blind $0.50
jahwe: posts big blind $1
mycka86: posts the ante $0.20
Dantist1122: posts the ante $0.20
se7en_$tars: posts the ante $0.20
matiko09: posts the ante $0.20
PacPacBum: posts the ante $0.20
jahwe: posts the ante $0.20
Muinmyheart: posts the ante $0.20
Jimy Tiltman: posts the ante $0.20
*** HOLE CARDS ***
Dealt to matiko09 [9d Ts]
Muinmyheart: folds 
Jimy Tiltman: folds 
mycka86: folds 
Dantist1122: folds 
se7en_$tars: folds 
matiko09: raises $1.50 to $2.50
se7en_$tars leaves the table
PacPacBum: raises $6.50 to $9
jahwe: folds 
matiko09: folds 
Uncalled bet ($6.50) returned to PacPacBum
PacPacBum collected $7.60 from pot
PacPacBum: doesn't show hand 
*** SUMMARY ***
Total pot $7.60 | Rake $0 
Seat 1: mycka86 folded before Flop (didn't bet)
Seat 2: Dantist1122 folded before Flop (didn't bet)
Seat 3: se7en_$tars folded before Flop (didn't bet)
Seat 5: matiko09 (button) folded before Flop
Seat 6: PacPacBum (small blind) collected ($7.60)
Seat 7: jahwe (big blind) folded before Flop
Seat 8: Muinmyheart folded before Flop (didn't bet)
Seat 9: Jimy Tiltman folded before Flop (didn't bet)





PokerStars Hand #150803269519:  Hold'em No Limit ($0.50/$1.00 USD) - 2016/03/23 15:38:30 CET [2016/03/23 10:38:30 ET]
Table 'Sylvia III' 9-max Seat #6 is the button
Seat 1: mycka86 ($149.30 in chips) 
Seat 2: Dantist1122 ($106.40 in chips) 
Seat 5: matiko09 ($100 in chips) 
Seat 6: PacPacBum ($104.90 in chips) 
Seat 7: jahwe ($100 in chips) 
Seat 8: Muinmyheart ($143.50 in chips) 
Seat 9: Jimy Tiltman ($100 in chips) 
jahwe: posts small blind $0.50
Muinmyheart: posts big blind $1
edidaz joins the table at seat #3 
edidaz leaves the table
lombardo11: sits out 
mycka86: posts the ante $0.20
Dantist1122: posts the ante $0.20
matiko09: posts the ante $0.20
PacPacBum: posts the ante $0.20
jahwe: posts the ante $0.20
Muinmyheart: posts the ante $0.20
Jimy Tiltman: posts the ante $0.20
*** HOLE CARDS ***
Dealt to matiko09 [8h Ah]
Jimy Tiltman: folds 
mycka86: folds 
Dantist1122: folds 
matiko09: raises $2 to $3
PacPacBum: folds 
bigacsiga joins the table at seat #3 
jahwe: calls $2.50
Muinmyheart: folds 
*** FLOP *** [Td 5s Th]
jahwe: checks 
matiko09: checks 
*** TURN *** [Td 5s Th] [7d]
jahwe: bets $5.53
matiko09: folds 
Uncalled bet ($5.53) returned to jahwe
jahwe collected $8.02 from pot
jahwe: doesn't show hand 
*** SUMMARY ***
Total pot $8.40 | Rake $0.38 
Board [Td 5s Th 7d]
Seat 1: mycka86 folded before Flop (didn't bet)
Seat 2: Dantist1122 folded before Flop (didn't bet)
Seat 5: matiko09 folded on the Turn
Seat 6: PacPacBum (button) folded before Flop (didn't bet)
Seat 7: jahwe (small blind) collected ($8.02)
Seat 8: Muinmyheart (big blind) folded before Flop
Seat 9: Jimy Tiltman folded before Flop (didn't bet)





PokerStars Hand #150803270203:  Hold'em No Limit (€0.50/€1.00 EUR) - 2016/03/23 15:38:32 CET [2016/03/23 10:38:32 ET]
Table 'Mercury III' 9-max Seat #5 is the button
Seat 1: matiko09 (€126.35 in chips) 
Seat 2: jahwe (€100 in chips) 
Seat 3: PacPacBum (€100 in chips) 
Seat 4: Muinmyheart (€101.50 in chips) 
Seat 5: ardo888 (€101 in chips) 
Seat 6: mycka86 (€100.50 in chips) 
Seat 7: STrakDD (€161.21 in chips) 
Seat 8: gfxed (€58.30 in chips) 
Seat 9: Indr3k (€100 in chips) 
mycka86: posts small blind €0.50
STrakDD: posts big blind €1
*** HOLE CARDS ***
Dealt to matiko09 [Qd 4s]
gfxed: raises €1.23 to €2.23
Indr3k: folds 
matiko09: folds 
jahwe: folds 
PacPacBum: folds 
Muinmyheart: folds 
ardo888: folds 
mycka86: folds 
STrakDD: folds 
Uncalled bet (€1.23) returned to gfxed
gfxed collected €2.50 from pot
*** SUMMARY ***
Total pot €2.50 | Rake €0 
Seat 1: matiko09 folded before Flop (didn't bet)
Seat 2: jahwe folded before Flop (didn't bet)
Seat 3: PacPacBum folded before Flop (didn't bet)
Seat 4: Muinmyheart folded before Flop (didn't bet)
Seat 5: ardo888 (button) folded before Flop (didn't bet)
Seat 6: mycka86 (small blind) folded before Flop
Seat 7: STrakDD (big blind) folded before Flop
Seat 8: gfxed collected (€2.50)
Seat 9: Indr3k folded before Flop (didn't bet)





PokerStars Hand #150803271872:  Hold'em No Limit (€0.50/€1.00 EUR) - 2016/03/23 15:38:37 CET [2016/03/23 10:38:37 ET]
Table 'Volga III' 9-max Seat #8 is the button
Seat 1: Dantist1122 (€109.24 in chips) 
Seat 3: matiko09 (€100 in chips) 
Seat 4: bigacsiga (€107.60 in chips) 
Seat 6: PacPacBum (€103.23 in chips) 
Seat 7: jahwe (€100 in chips) 
Seat 8: edidaz (€108.62 in chips) 
Seat 9: ardo888 (€136.86 in chips) 
ardo888: posts small blind €0.50
Dantist1122: posts big blind €1
*** HOLE CARDS ***
Dealt to matiko09 [6h Ad]
matiko09: folds 
omarr22 leaves the table
bigacsiga: folds 
PacPacBum: folds 
GW92RP joins the table at seat #2 
jahwe: folds 
edidaz: folds 
ardo888: folds 
Uncalled bet (€0.50) returned to Dantist1122
Dantist1122 collected €1 from pot
Dantist1122: doesn't show hand 
*** SUMMARY ***
Total pot €1 | Rake €0 
Seat 1: Dantist1122 (big blind) collected (€1)
Seat 3: matiko09 folded before Flop (didn't bet)
Seat 4: bigacsiga folded before Flop (didn't bet)
Seat 6: PacPacBum folded before Flop (didn't bet)
Seat 7: jahwe folded before Flop (didn't bet)
Seat 8: edidaz (button) folded before Flop (didn't bet)
Seat 9: ardo888 (small blind) folded before Flop





PokerStars Hand #150803274265:  Hold'em No Limit ($0.50/$1.00 USD) - 2016/03/23 15:38:44 CET [2016/03/23 10:38:44 ET]
Table 'Asmodeus' 9-max Seat #4 is the button
Seat 1: Jimy Tiltman ($169.37 in chips) 
Seat 2: PacPacBum ($100 in chips) 
Seat 3: jahwe ($106.21 in chips) 
Seat 4: Effort92 ($101.40 in chips) 
Seat 5: Muinmyheart ($103.29 in chips) 
Seat 6: fuppeee ($156.28 in chips) 
Seat 7: mycka86 ($115.65 in chips) 
Seat 8: app1e_j@ck ($100 in chips) 
Seat 9: matiko09 ($100 in chips) 
Muinmyheart: posts small blind $0.50
fuppeee: posts big blind $1
Jimy Tiltman: posts the ante $0.20
PacPacBum: posts the ante $0.20
jahwe: posts the ante $0.20
Effort92: posts the ante $0.20
Muinmyheart: posts the ante $0.20
fuppeee: posts the ante $0.20
mycka86: posts the ante $0.20
app1e_j@ck: posts the ante $0.20
matiko09: posts the ante $0.20
*** HOLE CARDS ***
Dealt to matiko09 [6s 9s]
mycka86: folds 
app1e_j@ck: folds 
matiko09: folds 
Jimy Tiltman: folds 
PacPacBum: raises $2 to $3
jahwe: folds 
Effort92: folds 
Muinmyheart: folds 
fuppeee: calls $2
*** FLOP *** [3h 8d 8s]
fuppeee: bets $3.96
PacPacBum: folds 
Uncalled bet ($3.96) returned to fuppeee
fuppeee collected $7.93 from pot
*** SUMMARY ***
Total pot $8.30 | Rake $0.37 
Board [3h 8d 8s]
Seat 1: Jimy Tiltman folded before Flop (didn't bet)
Seat 2: PacPacBum folded on the Flop
Seat 3: jahwe folded before Flop (didn't bet)
Seat 4: Effort92 (button) folded before Flop (didn't bet)
Seat 5: Muinmyheart (small blind) folded before Flop
Seat 6: fuppeee (big blind) collected ($7.93)
Seat 7: mycka86 folded before Flop (didn't bet)
Seat 8: app1e_j@ck folded before Flop (didn't bet)
Seat 9: matiko09 folded before Flop (didn't bet)





PokerStars Hand #150803274095:  Hold'em No Limit ($0.50/$1.00 USD) - 2016/03/23 15:38:44 CET [2016/03/23 10:38:44 ET]
Table 'Swings' 9-max Seat #4 is the button
Seat 1: lumen21 ($105.28 in chips) 
Seat 2: tomver0809 ($64.50 in chips) 
Seat 3: edidaz ($113.80 in chips) 
Seat 4: YuriiSolodya ($27.65 in chips) 
Seat 5: chautinhtri9 ($113.55 in chips) 
Seat 6: matiko09 ($141.42 in chips) 
Seat 7: PacPacBum ($123.49 in chips) 
Seat 8: RICKA16 ($102.68 in chips) 
Seat 9: Effort92 ($100.53 in chips) 
chautinhtri9: posts small blind $0.50
matiko09: posts big blind $1
*** HOLE CARDS ***
Dealt to matiko09 [Tc 5d]
PacPacBum: folds 
RICKA16: folds 
Effort92: folds 
lumen21: folds 
tomver0809: raises $1 to $2
edidaz: folds 
YuriiSolodya: folds 
chautinhtri9: calls $1.50
matiko09: folds 
*** FLOP *** [9d 7s 6c]
chautinhtri9: checks 
tomver0809: bets $4
chautinhtri9: folds 
Uncalled bet ($4) returned to tomver0809
tomver0809 collected $4.78 from pot
tomver0809: doesn't show hand 
*** SUMMARY ***
Total pot $5 | Rake $0.22 
Board [9d 7s 6c]
Seat 1: lumen21 folded before Flop (didn't bet)
Seat 2: tomver0809 collected ($4.78)
Seat 3: edidaz folded before Flop (didn't bet)
Seat 4: YuriiSolodya (button) folded before Flop (didn't bet)
Seat 5: chautinhtri9 (small blind) folded on the Flop
Seat 6: matiko09 (big blind) folded before Flop
Seat 7: PacPacBum folded before Flop (didn't bet)
Seat 8: RICKA16 folded before Flop (didn't bet)
Seat 9: Effort92 folded before Flop (didn't bet)





PokerStars Hand #150803278316:  Hold'em No Limit ($0.50/$1.00 USD) - 2016/03/23 15:38:56 CET [2016/03/23 10:38:56 ET]
Table 'Haug II' 9-max Seat #6 is the button
Seat 1: PacPacBum ($100 in chips) 
Seat 2: ardo888 ($126.06 in chips) 
Seat 3: camilalope ($92.46 in chips) 
Seat 4: matiko09 ($100 in chips) 
Seat 5: GlamDragon ($92.11 in chips) 
Seat 6: Pocketstud ($98.10 in chips) 
Seat 8: BRIGANTE49 ($96.62 in chips) 
Seat 9: ZOLOTOY766 ($77 in chips) 
BRIGANTE49: posts small blind $0.50
ZOLOTOY766: posts big blind $1
PacPacBum: posts the ante $0.20
ardo888: posts the ante $0.20
camilalope: posts the ante $0.20
matiko09: posts the ante $0.20
GlamDragon: posts the ante $0.20
Pocketstud: posts the ante $0.20
BRIGANTE49: posts the ante $0.20
ZOLOTOY766: posts the ante $0.20
*** HOLE CARDS ***
Dealt to matiko09 [3c 9c]
PacPacBum: folds 
ardo888: folds 
camilalope: folds 
matiko09: folds 
GlamDragon: folds 
Pocketstud: raises $1 to $2
BRIGANTE49: calls $1.50
ZOLOTOY766: calls $1
*** FLOP *** [Ts Qd 3h]
BRIGANTE49: bets $4
ZOLOTOY766: folds 
Pocketstud: calls $4
*** TURN *** [Ts Qd 3h] [6c]
BRIGANTE49: checks 
Pocketstud: bets $10
BRIGANTE49: calls $10
*** RIVER *** [Ts Qd 3h 6c] [Tc]
BRIGANTE49: bets $15
Pocketstud: folds 
Uncalled bet ($15) returned to BRIGANTE49
BRIGANTE49 collected $34 from pot
BRIGANTE49: doesn't show hand 
*** SUMMARY ***
Total pot $35.60 | Rake $1.60 
Board [Ts Qd 3h 6c Tc]
Seat 1: PacPacBum folded before Flop (didn't bet)
Seat 2: ardo888 folded before Flop (didn't bet)
Seat 3: camilalope folded before Flop (didn't bet)
Seat 4: matiko09 folded before Flop (didn't bet)
Seat 5: GlamDragon folded before Flop (didn't bet)
Seat 6: Pocketstud (button) folded on the River
Seat 8: BRIGANTE49 (small blind) collected ($34)
Seat 9: ZOLOTOY766 (big blind) folded on the Flop





PokerStars Hand #150803279193:  Hold'em No Limit ($1/$2 USD) - 2016/03/23 15:38:59 CET [2016/03/23 10:38:59 ET]
Table 'Kiess' 9-max Seat #3 is the button
Seat 1: Cirilico ($244.37 in chips) 
Seat 2: jahwe ($200 in chips) 
Seat 3: Red4erT ($104.29 in chips) 
Seat 4: RamiroAgujis ($200 in chips) 
Seat 5: chippo boy ($455.37 in chips) 
Seat 6: matiko09 ($231.48 in chips) 
Seat 7: chaps1988 ($209.24 in chips) 
Seat 8: erfk1958 ($130.78 in chips) 
Seat 9: PacPacBum ($200 in chips) 
RamiroAgujis: posts small blind $1
chippo boy: posts big blind $2
*** HOLE CARDS ***
Dealt to matiko09 [7d Jh]
matiko09: folds 
chaps1988: folds 
erfk1958: folds 
PacPacBum: folds 
Cirilico: raises $4 to $6
jahwe: folds 
Red4erT: calls $6
RamiroAgujis: folds 
chippo boy: calls $4
*** FLOP *** [5h Td 2s]
chippo boy: checks 
Cirilico: checks 
Red4erT: bets $9.43
chippo boy: folds 
Cirilico: folds 
Uncalled bet ($9.43) returned to Red4erT
Red4erT collected $18.14 from pot
Red4erT: doesn't show hand 
*** SUMMARY ***
Total pot $19 | Rake $0.86 
Board [5h Td 2s]
Seat 1: Cirilico folded on the Flop
Seat 2: jahwe folded before Flop (didn't bet)
Seat 3: Red4erT (button) collected ($18.14)
Seat 4: RamiroAgujis (small blind) folded before Flop
Seat 5: chippo boy (big blind) folded on the Flop
Seat 6: matiko09 folded before Flop (didn't bet)
Seat 7: chaps1988 folded before Flop (didn't bet)
Seat 8: erfk1958 folded before Flop (didn't bet)
Seat 9: PacPacBum folded before Flop (didn't bet)





PokerStars Hand #150803279839:  Hold'em No Limit ($0.50/$1.00 USD) - 2016/03/23 15:39:01 CET [2016/03/23 10:39:01 ET]
Table 'Atlantis' 9-max Seat #1 is the button
Seat 1: Westpants ($100 in chips) 
Seat 2: Szevasztopol ($100 in chips) 
Seat 3: CAJUN890 ($67.01 in chips) 
Seat 4: mycka86 ($118.04 in chips) 
Seat 5: Durango-CO77 ($49.31 in chips) 
Seat 6: PacPacBum ($113.41 in chips) 
Seat 7: matiko09 ($139.11 in chips) 
Seat 8: jahwe ($102 in chips) 
Seat 9: RICKA16 ($143.21 in chips) 
Szevasztopol: posts small blind $0.50
CAJUN890: posts big blind $1
*** HOLE CARDS ***
Dealt to matiko09 [3d 9d]
mycka86: folds 
Durango-CO77: folds 
PacPacBum: folds 
matiko09: folds 
jahwe: folds 
RICKA16: raises $2 to $3
Westpants: calls $3
Szevasztopol: folds 
CAJUN890: calls $2
*** FLOP *** [Ac 4d 9s]
CAJUN890: checks 
RICKA16: bets $6
Westpants: folds 
CAJUN890: folds 
Uncalled bet ($6) returned to RICKA16
RICKA16 collected $9.07 from pot
RICKA16: doesn't show hand 
*** SUMMARY ***
Total pot $9.50 | Rake $0.43 
Board [Ac 4d 9s]
Seat 1: Westpants (button) folded on the Flop
Seat 2: Szevasztopol (small blind) folded before Flop
Seat 3: CAJUN890 (big blind) folded on the Flop
Seat 4: mycka86 folded before Flop (didn't bet)
Seat 5: Durango-CO77 folded before Flop (didn't bet)
Seat 6: PacPacBum folded before Flop (didn't bet)
Seat 7: matiko09 folded before Flop (didn't bet)
Seat 8: jahwe folded before Flop (didn't bet)
Seat 9: RICKA16 collected ($9.07)





PokerStars Hand #150803280900:  Hold'em No Limit ($0.50/$1.00 USD) - 2016/03/23 15:39:04 CET [2016/03/23 10:39:04 ET]
Table 'Aetolia II' 9-max Seat #4 is the button
Seat 2: jahwe ($105.24 in chips) 
Seat 3: lumen21 ($100 in chips) 
Seat 4: Pocketstud ($117.52 in chips) 
Seat 5: KingCastle77 ($97.26 in chips) 
Seat 6: Westpants ($100 in chips) 
Seat 7: matiko09 ($100 in chips) 
Seat 8: PacPacBum ($109.60 in chips) 
Seat 9: mmcardoulis ($66.05 in chips) 
KingCastle77: posts small blind $0.50
Westpants: posts big blind $1
app1e_j@ck: sits out 
*** HOLE CARDS ***
Dealt to matiko09 [8d 6s]
matiko09: folds 
PacPacBum: raises $1.04 to $2.04
mmcardoulis: folds 
jahwe: calls $2.04
lumen21: folds 
Pocketstud: folds 
KingCastle77: folds 
Westpants: calls $1.04
*** FLOP *** [Td 3c 2c]
Westpants: checks 
PacPacBum: checks 
jahwe: bets $4.23
Westpants: calls $4.23
PacPacBum: folds 
*** TURN *** [Td 3c 2c] [2h]
Westpants: checks 
jahwe: bets $7.50
Westpants: calls $7.50
*** RIVER *** [Td 3c 2c 2h] [9s]
Westpants: checks 
jahwe: checks 
*** SHOW DOWN ***
Westpants: shows [Tc Ad] (two pair, Tens and Deuces)
jahwe: mucks hand 
Westpants collected $28.73 from pot
*** SUMMARY ***
Total pot $30.08 | Rake $1.35 
Board [Td 3c 2c 2h 9s]
Seat 2: jahwe mucked [Qh Th]
Seat 3: lumen21 folded before Flop (didn't bet)
Seat 4: Pocketstud (button) folded before Flop (didn't bet)
Seat 5: KingCastle77 (small blind) folded before Flop
Seat 6: Westpants (big blind) showed [Tc Ad] and won ($28.73) with two pair, Tens and Deuces
Seat 7: matiko09 folded before Flop (didn't bet)
Seat 8: PacPacBum folded on the Flop
Seat 9: mmcardoulis folded before Flop (didn't bet)





PokerStars Hand #150803281936:  Hold'em No Limit (€0.50/€1.00 EUR) - 2016/03/23 15:39:07 CET [2016/03/23 10:39:07 ET]
Table 'Volga III' 9-max Seat #9 is the button
Seat 1: Dantist1122 (€109.74 in chips) 
Seat 2: GW92RP (€100 in chips) 
Seat 3: matiko09 (€100 in chips) 
Seat 4: bigacsiga (€107.60 in chips) 
Seat 6: PacPacBum (€103.23 in chips) 
Seat 7: jahwe (€100 in chips) 
Seat 8: edidaz (€108.62 in chips) 
Seat 9: ardo888 (€136.36 in chips) 
Dantist1122: posts small blind €0.50
GW92RP: posts big blind €1
*** HOLE CARDS ***
Dealt to matiko09 [Js 7s]
matiko09: folds 
bigacsiga: folds 
PacPacBum: folds 
jahwe: folds 
edidaz: folds 
ardo888: folds 
Dantist1122: folds 
Uncalled bet (€0.50) returned to GW92RP
GW92RP collected €1 from pot
GW92RP: doesn't show hand 
*** SUMMARY ***
Total pot €1 | Rake €0 
Seat 1: Dantist1122 (small blind) folded before Flop
Seat 2: GW92RP (big blind) collected (€1)
Seat 3: matiko09 folded before Flop (didn't bet)
Seat 4: bigacsiga folded before Flop (didn't bet)
Seat 6: PacPacBum folded before Flop (didn't bet)
Seat 7: jahwe folded before Flop (didn't bet)
Seat 8: edidaz folded before Flop (didn't bet)
Seat 9: ardo888 (button) folded before Flop (didn't bet)





PokerStars Hand #150803282277:  Hold'em No Limit (€0.50/€1.00 EUR) - 2016/03/23 15:39:08 CET [2016/03/23 10:39:08 ET]
Table 'Mercury III' 9-max Seat #6 is the button
Seat 1: matiko09 (€126.35 in chips) 
Seat 2: jahwe (€100 in chips) 
Seat 3: PacPacBum (€100 in chips) 
Seat 4: Muinmyheart (€101.50 in chips) 
Seat 5: ardo888 (€101 in chips) 
Seat 6: mycka86 (€100 in chips) 
Seat 7: STrakDD (€160.21 in chips) 
Seat 8: gfxed (€59.80 in chips) 
Seat 9: Indr3k (€100 in chips) 
STrakDD: posts small blind €0.50
gfxed: posts big blind €1
*** HOLE CARDS ***
Dealt to matiko09 [Th 9d]
Indr3k: folds 
matiko09: folds 
jahwe: raises €1.50 to €2.50
PacPacBum: folds 
Muinmyheart: folds 
ardo888: calls €2.50
mycka86: calls €2.50
STrakDD: folds 
gfxed: calls €1.50
*** FLOP *** [2s Ks 5c]
gfxed: checks 
jahwe: bets €6.50
ardo888: folds 
mycka86: folds 
gfxed: calls €6.50
*** TURN *** [2s Ks 5c] [5s]
gfxed: checks 
jahwe: bets €13.50
gfxed: calls €13.50
*** RIVER *** [2s Ks 5c 5s] [7h]
gfxed: checks 
jahwe: bets €77.50 and is all-in
gfxed: folds [Kd]
Uncalled bet (€77.50) returned to jahwe
jahwe collected €48.35 from pot
jahwe: doesn't show hand 
*** SUMMARY ***
Total pot €50.50 | Rake €2.15 
Board [2s Ks 5c 5s 7h]
Seat 1: matiko09 folded before Flop (didn't bet)
Seat 2: jahwe collected (€48.35)
Seat 3: PacPacBum folded before Flop (didn't bet)
Seat 4: Muinmyheart folded before Flop (didn't bet)
Seat 5: ardo888 folded on the Flop
Seat 6: mycka86 (button) folded on the Flop
Seat 7: STrakDD (small blind) folded before Flop
Seat 8: gfxed (big blind) folded on the River
Seat 9: Indr3k folded before Flop (didn't bet)





PokerStars Hand #150803282834:  Hold'em No Limit ($0.50/$1.00 USD) - 2016/03/23 15:39:10 CET [2016/03/23 10:39:10 ET]
Table 'Smiley' 9-max Seat #9 is the button
Seat 1: jahwe ($117.31 in chips) 
Seat 2: Jimy Tiltman ($101.70 in chips) 
Seat 3: mycka86 ($100 in chips) 
Seat 4: CAJUN890 ($82.69 in chips) 
Seat 5: Szevasztopol ($136.90 in chips) 
Seat 6: blackmont111 ($121.54 in chips) 
Seat 7: bennetb77 ($106.36 in chips) 
Seat 8: matiko09 ($101.08 in chips) 
Seat 9: PacPacBum ($102.81 in chips) 
jahwe: posts small blind $0.50
Jimy Tiltman: posts big blind $1
*** HOLE CARDS ***
Dealt to matiko09 [3h 8s]
mycka86: folds 
CAJUN890: folds 
Szevasztopol: folds 
blackmont111: folds 
bennetb77: folds 
matiko09: folds 
PacPacBum: folds 
jahwe: folds 
Uncalled bet ($0.50) returned to Jimy Tiltman
Jimy Tiltman collected $1 from pot
Jimy Tiltman: doesn't show hand 
*** SUMMARY ***
Total pot $1 | Rake $0 
Seat 1: jahwe (small blind) folded before Flop
Seat 2: Jimy Tiltman (big blind) collected ($1)
Seat 3: mycka86 folded before Flop (didn't bet)
Seat 4: CAJUN890 folded before Flop (didn't bet)
Seat 5: Szevasztopol folded before Flop (didn't bet)
Seat 6: blackmont111 folded before Flop (didn't bet)
Seat 7: bennetb77 folded before Flop (didn't bet)
Seat 8: matiko09 folded before Flop (didn't bet)
Seat 9: PacPacBum (button) folded before Flop (didn't bet)





PokerStars Hand #150803289806:  Hold'em No Limit ($0.50/$1.00 USD) - 2016/03/23 15:39:31 CET [2016/03/23 10:39:31 ET]
Table 'Sylvia III' 9-max Seat #7 is the button
Seat 1: mycka86 ($149.10 in chips) 
Seat 2: Dantist1122 ($106.20 in chips) 
Seat 5: matiko09 ($100 in chips) 
Seat 6: PacPacBum ($104.70 in chips) 
Seat 7: jahwe ($104.82 in chips) 
Seat 8: Muinmyheart ($142.30 in chips) 
Seat 9: Jimy Tiltman ($100 in chips) 
Muinmyheart: posts small blind $0.50
Jimy Tiltman: posts big blind $1
bigacsiga: sits out 
lombardo11: sits out 
mycka86: posts the ante $0.20
Dantist1122: posts the ante $0.20
matiko09: posts the ante $0.20
PacPacBum: posts the ante $0.20
jahwe: posts the ante $0.20
Muinmyheart: posts the ante $0.20
Jimy Tiltman: posts the ante $0.20
*** HOLE CARDS ***
Dealt to matiko09 [Kd 6d]
mycka86: folds 
Dantist1122: folds 
matiko09: folds 
PacPacBum: folds 
jahwe: folds 
Muinmyheart: folds 
Uncalled bet ($0.50) returned to Jimy Tiltman
Jimy Tiltman collected $2.40 from pot
Jimy Tiltman: doesn't show hand 
*** SUMMARY ***
Total pot $2.40 | Rake $0 
Seat 1: mycka86 folded before Flop (didn't bet)
Seat 2: Dantist1122 folded before Flop (didn't bet)
Seat 5: matiko09 folded before Flop (didn't bet)
Seat 6: PacPacBum folded before Flop (didn't bet)
Seat 7: jahwe (button) folded before Flop (didn't bet)
Seat 8: Muinmyheart (small blind) folded before Flop
Seat 9: Jimy Tiltman (big blind) collected ($2.40)





PokerStars Hand #150803290106:  Hold'em No Limit ($0.50/$1.00 USD) - 2016/03/23 15:39:32 CET [2016/03/23 10:39:32 ET]
Table 'Swings' 9-max Seat #5 is the button
Seat 1: lumen21 ($105.28 in chips) 
Seat 2: tomver0809 ($67.28 in chips) 
Seat 3: edidaz ($113.80 in chips) 
Seat 4: YuriiSolodya ($27.65 in chips) 
Seat 5: chautinhtri9 ($111.55 in chips) 
Seat 6: matiko09 ($140.42 in chips) 
Seat 7: PacPacBum ($123.49 in chips) 
Seat 8: RICKA16 ($102.68 in chips) 
Seat 9: Effort92 ($100.53 in chips) 
matiko09: posts small blind $0.50
PacPacBum: posts big blind $1
*** HOLE CARDS ***
Dealt to matiko09 [8c Ts]
RICKA16: folds 
Effort92: folds 
lumen21: raises $2 to $3
tomver0809: folds 
edidaz: raises $6 to $9
YuriiSolodya: calls $9
chautinhtri9: folds 
matiko09: folds 
PacPacBum: folds 
lumen21: folds 
*** FLOP *** [Jd 8s 3h]
edidaz: checks 
YuriiSolodya: bets $1
edidaz: calls $1
*** TURN *** [Jd 8s 3h] [3c]
edidaz: checks 
YuriiSolodya: bets $3
edidaz: folds 
Uncalled bet ($3) returned to YuriiSolodya
YuriiSolodya collected $23.40 from pot
YuriiSolodya: doesn't show hand 
*** SUMMARY ***
Total pot $24.50 | Rake $1.10 
Board [Jd 8s 3h 3c]
Seat 1: lumen21 folded before Flop
Seat 2: tomver0809 folded before Flop (didn't bet)
Seat 3: edidaz folded on the Turn
Seat 4: YuriiSolodya collected ($23.40)
Seat 5: chautinhtri9 (button) folded before Flop (didn't bet)
Seat 6: matiko09 (small blind) folded before Flop
Seat 7: PacPacBum (big blind) folded before Flop
Seat 8: RICKA16 folded before Flop (didn't bet)
Seat 9: Effort92 folded before Flop (didn't bet)





PokerStars Hand #150803293812:  Hold'em No Limit ($0.50/$1.00 USD) - 2016/03/23 15:39:43 CET [2016/03/23 10:39:43 ET]
Table 'Smiley' 9-max Seat #1 is the button
Seat 1: jahwe ($116.81 in chips) 
Seat 2: Jimy Tiltman ($102.20 in chips) 
Seat 3: mycka86 ($100 in chips) 
Seat 4: CAJUN890 ($82.69 in chips) 
Seat 5: Szevasztopol ($136.90 in chips) 
Seat 6: blackmont111 ($121.54 in chips) 
Seat 7: bennetb77 ($106.36 in chips) 
Seat 8: matiko09 ($101.08 in chips) 
Seat 9: PacPacBum ($102.81 in chips) 
Jimy Tiltman: posts small blind $0.50
mycka86: posts big blind $1
*** HOLE CARDS ***
Dealt to matiko09 [7c Qs]
CAJUN890: calls $1
Szevasztopol: raises $4 to $5
blackmont111: calls $5
bennetb77: folds 
matiko09: folds 
PacPacBum: folds 
jahwe: folds 
Jimy Tiltman: calls $4.50
mycka86: raises $17.50 to $22.50
CAJUN890: folds 
Szevasztopol: folds 
blackmont111: folds 
Jimy Tiltman: folds 
Uncalled bet ($17.50) returned to mycka86
mycka86 collected $21 from pot
*** SUMMARY ***
Total pot $21 | Rake $0 
Seat 1: jahwe (button) folded before Flop (didn't bet)
Seat 2: Jimy Tiltman (small blind) folded before Flop
Seat 3: mycka86 (big blind) collected ($21)
Seat 4: CAJUN890 folded before Flop
Seat 5: Szevasztopol folded before Flop
Seat 6: blackmont111 folded before Flop
Seat 7: bennetb77 folded before Flop (didn't bet)
Seat 8: matiko09 folded before Flop (didn't bet)
Seat 9: PacPacBum folded before Flop (didn't bet)





PokerStars Hand #150803293991:  Hold'em No Limit ($0.50/$1.00 USD) - 2016/03/23 15:39:43 CET [2016/03/23 10:39:43 ET]
Table 'Drakonia II' 9-max Seat #2 is the button
Seat 1: chautinhtri9 ($128 in chips) 
Seat 2: RICKA16 ($98.50 in chips) 
Seat 3: PacPacBum ($100 in chips) 
Seat 4: Jimy Tiltman ($100 in chips) 
Seat 5: Muinmyheart ($100 in chips) 
Seat 6: PinkTrinta ($121.25 in chips) 
Seat 7: YuriiSolodya ($52.85 in chips) 
Seat 8: matiko09 ($100 in chips) 
Seat 9: mycka86 ($102.87 in chips) 
PacPacBum: posts small blind $0.50
Jimy Tiltman: posts big blind $1
*** HOLE CARDS ***
Dealt to matiko09 [5c Qh]
Muinmyheart: folds 
PinkTrinta: folds 
YuriiSolodya: raises $2 to $3
matiko09: folds 
mycka86: calls $3
chautinhtri9: folds 
RICKA16: calls $3
PacPacBum: folds 
Jimy Tiltman: folds 
*** FLOP *** [5d 4c Ac]
YuriiSolodya: checks 
mycka86: bets $6.50
RICKA16: raises $11.50 to $18
YuriiSolodya: folds 
mycka86: folds 
Uncalled bet ($11.50) returned to RICKA16
RICKA16 collected $22.44 from pot
RICKA16: doesn't show hand 
*** SUMMARY ***
Total pot $23.50 | Rake $1.06 
Board [5d 4c Ac]
Seat 1: chautinhtri9 folded before Flop (didn't bet)
Seat 2: RICKA16 (button) collected ($22.44)
Seat 3: PacPacBum (small blind) folded before Flop
Seat 4: Jimy Tiltman (big blind) folded before Flop
Seat 5: Muinmyheart folded before Flop (didn't bet)
Seat 6: PinkTrinta folded before Flop (didn't bet)
Seat 7: YuriiSolodya folded on the Flop
Seat 8: matiko09 folded before Flop (didn't bet)
Seat 9: mycka86 folded on the Flop





PokerStars Hand #150803294232:  Hold'em No Limit ($0.50/$1.00 USD) - 2016/03/23 15:39:44 CET [2016/03/23 10:39:44 ET]
Table 'Asmodeus' 9-max Seat #5 is the button
Seat 1: Jimy Tiltman ($169.17 in chips) 
Seat 2: PacPacBum ($100 in chips) 
Seat 3: jahwe ($106.01 in chips) 
Seat 4: Effort92 ($101.20 in chips) 
Seat 5: Muinmyheart ($102.59 in chips) 
Seat 6: fuppeee ($161.01 in chips) 
Seat 7: mycka86 ($115.45 in chips) 
Seat 8: app1e_j@ck ($100 in chips) 
Seat 9: matiko09 ($100 in chips) 
fuppeee: posts small blind $0.50
mycka86: posts big blind $1
Jimy Tiltman: posts the ante $0.20
PacPacBum: posts the ante $0.20
jahwe: posts the ante $0.20
Effort92: posts the ante $0.20
Muinmyheart: posts the ante $0.20
fuppeee: posts the ante $0.20
mycka86: posts the ante $0.20
app1e_j@ck: posts the ante $0.20
matiko09: posts the ante $0.20
*** HOLE CARDS ***
Dealt to matiko09 [7s Qs]
app1e_j@ck: folds 
matiko09: folds 
Jimy Tiltman: folds 
PacPacBum: folds 
jahwe: folds 
Effort92: raises $1.50 to $2.50
Muinmyheart: calls $2.50
fuppeee: raises $10.30 to $12.80
mycka86: folds 
Effort92: folds 
Muinmyheart: calls $10.30
*** FLOP *** [Qh As Kh]
fuppeee: checks 
Muinmyheart: checks 
*** TURN *** [Qh As Kh] [6h]
fuppeee: bets $14.75
Muinmyheart: folds 
Uncalled bet ($14.75) returned to fuppeee
fuppeee collected $29.51 from pot
*** SUMMARY ***
Total pot $30.90 | Rake $1.39 
Board [Qh As Kh 6h]
Seat 1: Jimy Tiltman folded before Flop (didn't bet)
Seat 2: PacPacBum folded before Flop (didn't bet)
Seat 3: jahwe folded before Flop (didn't bet)
Seat 4: Effort92 folded before Flop
Seat 5: Muinmyheart (button) folded on the Turn
Seat 6: fuppeee (small blind) collected ($29.51)
Seat 7: mycka86 (big blind) folded before Flop
Seat 8: app1e_j@ck folded before Flop (didn't bet)
Seat 9: matiko09 folded before Flop (didn't bet)





PokerStars Hand #150803295972:  Hold'em No Limit (€0.50/€1.00 EUR) - 2016/03/23 15:39:49 CET [2016/03/23 10:39:49 ET]
Table 'Volga III' 9-max Seat #1 is the button
Seat 1: Dantist1122 (€109.24 in chips) 
Seat 2: GW92RP (€100.50 in chips) 
Seat 3: matiko09 (€100 in chips) 
Seat 4: bigacsiga (€107.60 in chips) 
Seat 6: PacPacBum (€103.23 in chips) 
Seat 7: jahwe (€100 in chips) 
Seat 8: edidaz (€108.62 in chips) 
Seat 9: ardo888 (€136.36 in chips) 
GW92RP: posts small blind €0.50
matiko09: posts big blind €1
*** HOLE CARDS ***
Dealt to matiko09 [6h 5c]
bigacsiga: folds 
PacPacBum: raises €1.04 to €2.04
jahwe: folds 
edidaz: folds 
ardo888: folds 
Dantist1122: folds 
GW92RP: calls €1.54
matiko09: folds 
*** FLOP *** [2c 4c Tc]
GW92RP: bets €3
PacPacBum: folds 
Uncalled bet (€3) returned to GW92RP
GW92RP collected €4.85 from pot
GW92RP: doesn't show hand 
*** SUMMARY ***
Total pot €5.08 | Rake €0.23 
Board [2c 4c Tc]
Seat 1: Dantist1122 (button) folded before Flop (didn't bet)
Seat 2: GW92RP (small blind) collected (€4.85)
Seat 3: matiko09 (big blind) folded before Flop
Seat 4: bigacsiga folded before Flop (didn't bet)
Seat 6: PacPacBum folded on the Flop
Seat 7: jahwe folded before Flop (didn't bet)
Seat 8: edidaz folded before Flop (didn't bet)
Seat 9: ardo888 folded before Flop (didn't bet)





PokerStars Hand #150803297861:  Hold'em No Limit ($0.50/$1.00 USD) - 2016/03/23 15:39:55 CET [2016/03/23 10:39:55 ET]
Table 'Sylvia III' 9-max Seat #8 is the button
Seat 1: mycka86 ($148.90 in chips) 
Seat 2: Dantist1122 ($106 in chips) 
Seat 5: matiko09 ($100 in chips) 
Seat 6: PacPacBum ($104.50 in chips) 
Seat 7: jahwe ($104.62 in chips) 
Seat 8: Muinmyheart ($141.60 in chips) 
Seat 9: Jimy Tiltman ($101.70 in chips) 
Jimy Tiltman: posts small blind $0.50
mycka86: posts big blind $1
bigacsiga: sits out 
lombardo11: sits out 
mycka86: posts the ante $0.20
Dantist1122: posts the ante $0.20
matiko09: posts the ante $0.20
PacPacBum: posts the ante $0.20
jahwe: posts the ante $0.20
Muinmyheart: posts the ante $0.20
Jimy Tiltman: posts the ante $0.20
*** HOLE CARDS ***
Dealt to matiko09 [Td 3d]
Dantist1122: folds 
matiko09: folds 
PacPacBum: raises $1.50 to $2.50
jahwe: folds 
Muinmyheart: folds 
Jimy Tiltman: folds 
mycka86: folds 
Uncalled bet ($1.50) returned to PacPacBum
PacPacBum collected $3.90 from pot
PacPacBum: doesn't show hand 
*** SUMMARY ***
Total pot $3.90 | Rake $0 
Seat 1: mycka86 (big blind) folded before Flop
Seat 2: Dantist1122 folded before Flop (didn't bet)
Seat 5: matiko09 folded before Flop (didn't bet)
Seat 6: PacPacBum collected ($3.90)
Seat 7: jahwe folded before Flop (didn't bet)
Seat 8: Muinmyheart (button) folded before Flop (didn't bet)
Seat 9: Jimy Tiltman (small blind) folded before Flop





PokerStars Hand #150803298784:  Hold'em No Limit ($0.50/$1.00 USD) - 2016/03/23 15:39:58 CET [2016/03/23 10:39:58 ET]
Table 'Haug II' 9-max Seat #8 is the button
Seat 1: PacPacBum ($100 in chips) 
Seat 2: ardo888 ($125.86 in chips) 
Seat 3: camilalope ($92.26 in chips) 
Seat 4: matiko09 ($100 in chips) 
Seat 5: GlamDragon ($91.91 in chips) 
Seat 6: Pocketstud ($81.90 in chips) 
Seat 8: BRIGANTE49 ($114.42 in chips) 
Seat 9: ZOLOTOY766 ($74.80 in chips) 
ZOLOTOY766: posts small blind $0.50
PacPacBum: posts big blind $1
jahwe: sits out 
PacPacBum: posts the ante $0.20
ardo888: posts the ante $0.20
camilalope: posts the ante $0.20
matiko09: posts the ante $0.20
GlamDragon: posts the ante $0.20
Pocketstud: posts the ante $0.20
BRIGANTE49: posts the ante $0.20
ZOLOTOY766: posts the ante $0.20
*** HOLE CARDS ***
Dealt to matiko09 [8d Qh]
ardo888: folds 
camilalope: folds 
matiko09: folds 
GlamDragon: folds 
Pocketstud: folds 
BRIGANTE49: calls $1
ZOLOTOY766: raises $1 to $2
PacPacBum: folds 
BRIGANTE49: calls $1
*** FLOP *** [Jd Ad 2c]
ZOLOTOY766: bets $3
BRIGANTE49: calls $3
*** TURN *** [Jd Ad 2c] [4h]
ZOLOTOY766: bets $1
BRIGANTE49: calls $1
*** RIVER *** [Jd Ad 2c 4h] [7d]
ZOLOTOY766: checks 
BRIGANTE49: checks 
*** SHOW DOWN ***
ZOLOTOY766: shows [Kh Th] (high card Ace)
BRIGANTE49: shows [Ac 5s] (a pair of Aces)
BRIGANTE49 collected $13.94 from pot
*** SUMMARY ***
Total pot $14.60 | Rake $0.66 
Board [Jd Ad 2c 4h 7d]
Seat 1: PacPacBum (big blind) folded before Flop
Seat 2: ardo888 folded before Flop (didn't bet)
Seat 3: camilalope folded before Flop (didn't bet)
Seat 4: matiko09 folded before Flop (didn't bet)
Seat 5: GlamDragon folded before Flop (didn't bet)
Seat 6: Pocketstud folded before Flop (didn't bet)
Seat 8: BRIGANTE49 (button) showed [Ac 5s] and won ($13.94) with a pair of Aces
Seat 9: ZOLOTOY766 (small blind) showed [Kh Th] and lost with high card Ace





PokerStars Hand #150803300095:  Hold'em No Limit ($0.50/$1.00 USD) - 2016/03/23 15:40:02 CET [2016/03/23 10:40:02 ET]
Table 'Atlantis' 9-max Seat #2 is the button
Seat 1: Westpants ($100 in chips) 
Seat 2: Szevasztopol ($100 in chips) 
Seat 3: CAJUN890 ($64.01 in chips) 
Seat 4: mycka86 ($118.04 in chips) 
Seat 5: Durango-CO77 ($49.31 in chips) 
Seat 6: PacPacBum ($113.41 in chips) 
Seat 7: matiko09 ($139.11 in chips) 
Seat 8: jahwe ($102 in chips) 
Seat 9: RICKA16 ($149.28 in chips) 
CAJUN890: posts small blind $0.50
mycka86: posts big blind $1
*** HOLE CARDS ***
Dealt to matiko09 [4s Qd]
Durango-CO77: folds 
PacPacBum: folds 
matiko09: folds 
jahwe: folds 
RICKA16: folds 
Westpants: folds 
Szevasztopol: folds 
CAJUN890: folds 
Uncalled bet ($0.50) returned to mycka86
mycka86 collected $1 from pot
*** SUMMARY ***
Total pot $1 | Rake $0 
Seat 1: Westpants folded before Flop (didn't bet)
Seat 2: Szevasztopol (button) folded before Flop (didn't bet)
Seat 3: CAJUN890 (small blind) folded before Flop
Seat 4: mycka86 (big blind) collected ($1)
Seat 5: Durango-CO77 folded before Flop (didn't bet)
Seat 6: PacPacBum folded before Flop (didn't bet)
Seat 7: matiko09 folded before Flop (didn't bet)
Seat 8: jahwe folded before Flop (didn't bet)
Seat 9: RICKA16 folded before Flop (didn't bet)





PokerStars Hand #150803305289:  Hold'em No Limit ($1/$2 USD) - 2016/03/23 15:40:18 CET [2016/03/23 10:40:18 ET]
Table 'Kiess' 9-max Seat #4 is the button
Seat 1: Cirilico ($238.37 in chips) 
Seat 2: jahwe ($200 in chips) 
Seat 3: Red4erT ($116.43 in chips) 
Seat 4: RamiroAgujis ($200 in chips) 
Seat 5: chippo boy ($449.37 in chips) 
Seat 6: matiko09 ($231.48 in chips) 
Seat 7: chaps1988 ($209.24 in chips) 
Seat 8: erfk1958 ($130.78 in chips) 
Seat 9: PacPacBum ($200 in chips) 
chippo boy: posts small blind $1
matiko09: posts big blind $2
*** HOLE CARDS ***
Dealt to matiko09 [Ah Jd]
chaps1988: folds 
erfk1958: folds 
PacPacBum: folds 
Cirilico: folds 
jahwe: folds 
Red4erT: folds 
RamiroAgujis: raises $3 to $5
chippo boy: folds 
matiko09: calls $3
*** FLOP *** [Kc 3h 2s]
matiko09: checks 
RamiroAgujis: bets $6
matiko09: calls $6
*** TURN *** [Kc 3h 2s] [Qd]
matiko09: checks 
RamiroAgujis: checks 
*** RIVER *** [Kc 3h 2s Qd] [9h]
matiko09: checks 
RamiroAgujis: checks 
*** SHOW DOWN ***
matiko09: shows [Ah Jd] (high card Ace)
RamiroAgujis: shows [Ac 9s] (a pair of Nines)
RamiroAgujis collected $21.96 from pot
*** SUMMARY ***
Total pot $23 | Rake $1.04 
Board [Kc 3h 2s Qd 9h]
Seat 1: Cirilico folded before Flop (didn't bet)
Seat 2: jahwe folded before Flop (didn't bet)
Seat 3: Red4erT folded before Flop (didn't bet)
Seat 4: RamiroAgujis (button) showed [Ac 9s] and won ($21.96) with a pair of Nines
Seat 5: chippo boy (small blind) folded before Flop
Seat 6: matiko09 (big blind) showed [Ah Jd] and lost with high card Ace
Seat 7: chaps1988 folded before Flop (didn't bet)
Seat 8: erfk1958 folded before Flop (didn't bet)
Seat 9: PacPacBum folded before Flop (didn't bet)





PokerStars Hand #150803308258:  Hold'em No Limit ($0.50/$1.00 USD) - 2016/03/23 15:40:27 CET [2016/03/23 10:40:27 ET]
Table 'Sylvia III' 9-max Seat #9 is the button
Seat 1: mycka86 ($147.70 in chips) 
Seat 3: bigacsiga ($113.18 in chips) 
Seat 5: matiko09 ($100 in chips) 
Seat 6: PacPacBum ($107.20 in chips) 
Seat 7: jahwe ($104.42 in chips) 
Seat 8: Muinmyheart ($141.40 in chips) 
Seat 9: Jimy Tiltman ($101 in chips) 
mycka86: posts small blind $0.50
Dantist1122: is sitting out 
bigacsiga: posts big blind $1
Dantist1122 leaves the table
lombardo11: sits out 
mycka86: posts the ante $0.20
bigacsiga: posts the ante $0.20
matiko09: posts the ante $0.20
PacPacBum: posts the ante $0.20
jahwe: posts the ante $0.20
Muinmyheart: posts the ante $0.20
Jimy Tiltman: posts the ante $0.20
*** HOLE CARDS ***
Dealt to matiko09 [8s 3s]
matiko09: folds 
PacPacBum: folds 
jahwe: folds 
Muinmyheart: folds 
Jimy Tiltman: folds 
mycka86: raises $2 to $3
bigacsiga: calls $2
*** FLOP *** [8h 6s Kd]
mycka86: checks 
bigacsiga: checks 
*** TURN *** [8h 6s Kd] [9h]
mycka86: checks 
bigacsiga: bets $5
mycka86: folds 
Uncalled bet ($5) returned to bigacsiga
ellis005 joins the table at seat #2 
bigacsiga collected $7.07 from pot
bigacsiga: doesn't show hand 
*** SUMMARY ***
Total pot $7.40 | Rake $0.33 
Board [8h 6s Kd 9h]
Seat 1: mycka86 (small blind) folded on the Turn
Seat 3: bigacsiga (big blind) collected ($7.07)
Seat 5: matiko09 folded before Flop (didn't bet)
Seat 6: PacPacBum folded before Flop (didn't bet)
Seat 7: jahwe folded before Flop (didn't bet)
Seat 8: Muinmyheart folded before Flop (didn't bet)
Seat 9: Jimy Tiltman (button) folded before Flop (didn't bet)





PokerStars Hand #150803312106:  Hold'em No Limit ($0.50/$1.00 USD) - 2016/03/23 15:40:38 CET [2016/03/23 10:40:38 ET]
Table 'Haug II' 9-max Seat #9 is the button
Seat 1: PacPacBum ($100 in chips) 
Seat 2: ardo888 ($125.66 in chips) 
Seat 3: camilalope ($92.06 in chips) 
Seat 4: matiko09 ($100 in chips) 
Seat 5: GlamDragon ($91.71 in chips) 
Seat 6: Pocketstud ($81.70 in chips) 
Seat 8: BRIGANTE49 ($122.16 in chips) 
Seat 9: ZOLOTOY766 ($68.60 in chips) 
PacPacBum: posts small blind $0.50
ardo888: posts big blind $1
jahwe: sits out 
PacPacBum: posts the ante $0.20
ardo888: posts the ante $0.20
camilalope: posts the ante $0.20
matiko09: posts the ante $0.20
GlamDragon: posts the ante $0.20
Pocketstud: posts the ante $0.20
BRIGANTE49: posts the ante $0.20
ZOLOTOY766: posts the ante $0.20
*** HOLE CARDS ***
Dealt to matiko09 [Qs Kc]
camilalope: folds 
matiko09: raises $1 to $2
GlamDragon: folds 
Pocketstud: folds 
BRIGANTE49: calls $2
ZOLOTOY766: calls $2
PacPacBum: folds 
ardo888: calls $1
*** FLOP *** [Qc Tc Jh]
ardo888: checks 
matiko09: checks 
BRIGANTE49: checks 
ZOLOTOY766: checks 
*** TURN *** [Qc Tc Jh] [4h]
camilalope leaves the table
ardo888: checks 
matiko09: bets $7
BRIGANTE49: calls $7
ZOLOTOY766: folds 
ardo888: folds 
*** RIVER *** [Qc Tc Jh 4h] [Jd]
matiko09: bets $10
BRIGANTE49: calls $10
*** SHOW DOWN ***
matiko09: shows [Qs Kc] (two pair, Queens and Jacks)
BRIGANTE49: mucks hand 
matiko09 collected $42.12 from pot
*** SUMMARY ***
Total pot $44.10 | Rake $1.98 
Board [Qc Tc Jh 4h Jd]
Seat 1: PacPacBum (small blind) folded before Flop
Seat 2: ardo888 (big blind) folded on the Turn
Seat 3: camilalope folded before Flop (didn't bet)
Seat 4: matiko09 showed [Qs Kc] and won ($42.12) with two pair, Queens and Jacks
Seat 5: GlamDragon folded before Flop (didn't bet)
Seat 6: Pocketstud folded before Flop (didn't bet)
Seat 8: BRIGANTE49 mucked [5h Qh]
Seat 9: ZOLOTOY766 (button) folded on the Turn





PokerStars Hand #150803314085:  Hold'em No Limit ($0.50/$1.00 USD) - 2016/03/23 15:40:44 CET [2016/03/23 10:40:44 ET]
Table 'Atlantis' 9-max Seat #3 is the button
Seat 1: Westpants ($100 in chips) 
Seat 2: Szevasztopol ($100 in chips) 
Seat 3: CAJUN890 ($63.51 in chips) 
Seat 4: mycka86 ($118.54 in chips) 
Seat 5: Durango-CO77 ($49.31 in chips) 
Seat 6: PacPacBum ($113.41 in chips) 
Seat 7: matiko09 ($139.11 in chips) 
Seat 8: jahwe ($102 in chips) 
Seat 9: RICKA16 ($149.28 in chips) 
mycka86: posts small blind $0.50
Durango-CO77: posts big blind $1
*** HOLE CARDS ***
Dealt to matiko09 [5d Ts]
PacPacBum: raises $1.04 to $2.04
matiko09: folds 
jahwe: folds 
RICKA16: folds 
Westpants: folds 
Szevasztopol: folds 
CAJUN890: folds 
mycka86: folds 
Durango-CO77: folds 
Uncalled bet ($1.04) returned to PacPacBum
PacPacBum collected $2.50 from pot
PacPacBum: doesn't show hand 
*** SUMMARY ***
Total pot $2.50 | Rake $0 
Seat 1: Westpants folded before Flop (didn't bet)
Seat 2: Szevasztopol folded before Flop (didn't bet)
Seat 3: CAJUN890 (button) folded before Flop (didn't bet)
Seat 4: mycka86 (small blind) folded before Flop
Seat 5: Durango-CO77 (big blind) folded before Flop
Seat 6: PacPacBum collected ($2.50)
Seat 7: matiko09 folded before Flop (didn't bet)
Seat 8: jahwe folded before Flop (didn't bet)
Seat 9: RICKA16 folded before Flop (didn't bet)





PokerStars Hand #150803320119:  Hold'em No Limit ($0.50/$1.00 USD) - 2016/03/23 15:41:02 CET [2016/03/23 10:41:02 ET]
Table 'Swings' 9-max Seat #6 is the button
Seat 1: lumen21 ($102.28 in chips) 
Seat 2: tomver0809 ($67.28 in chips) 
Seat 3: edidaz ($103.80 in chips) 
Seat 4: YuriiSolodya ($41.05 in chips) 
Seat 5: chautinhtri9 ($111.55 in chips) 
Seat 6: matiko09 ($139.92 in chips) 
Seat 7: PacPacBum ($122.49 in chips) 
Seat 8: RICKA16 ($102.68 in chips) 
Seat 9: Effort92 ($100.53 in chips) 
PacPacBum: posts small blind $0.50
RICKA16: posts big blind $1
*** HOLE CARDS ***
Dealt to matiko09 [6d 4s]
Effort92: folds 
lumen21: folds 
tomver0809: folds 
edidaz: folds 
YuriiSolodya: folds 
chautinhtri9: folds 
matiko09: folds 
PacPacBum: folds 
Uncalled bet ($0.50) returned to RICKA16
RICKA16 collected $1 from pot
RICKA16: doesn't show hand 
*** SUMMARY ***
Total pot $1 | Rake $0 
Seat 1: lumen21 folded before Flop (didn't bet)
Seat 2: tomver0809 folded before Flop (didn't bet)
Seat 3: edidaz folded before Flop (didn't bet)
Seat 4: YuriiSolodya folded before Flop (didn't bet)
Seat 5: chautinhtri9 folded before Flop (didn't bet)
Seat 6: matiko09 (button) folded before Flop (didn't bet)
Seat 7: PacPacBum (small blind) folded before Flop
Seat 8: RICKA16 (big blind) collected ($1)
Seat 9: Effort92 folded before Flop (didn't bet)





PokerStars Hand #150803321841:  Hold'em No Limit ($0.50/$1.00 USD) - 2016/03/23 15:41:07 CET [2016/03/23 10:41:07 ET]
Table 'Smiley' 9-max Seat #2 is the button
Seat 1: jahwe ($116.81 in chips) 
Seat 2: Jimy Tiltman ($100 in chips) 
Seat 3: mycka86 ($116 in chips) 
Seat 4: CAJUN890 ($81.69 in chips) 
Seat 5: Szevasztopol ($131.90 in chips) 
Seat 6: blackmont111 ($116.54 in chips) 
Seat 7: bennetb77 ($106.36 in chips) 
Seat 8: matiko09 ($101.08 in chips) 
Seat 9: PacPacBum ($102.81 in chips) 
mycka86: posts small blind $0.50
CAJUN890: posts big blind $1
*** HOLE CARDS ***
Dealt to matiko09 [Kh 7c]
Szevasztopol: raises $2 to $3
blackmont111: folds 
bennetb77: calls $3
matiko09: folds 
PacPacBum: folds 
jahwe: folds 
Jimy Tiltman: folds 
mycka86: folds 
CAJUN890: folds 
*** FLOP *** [Js 3d Ah]
Szevasztopol: bets $4
bennetb77: calls $4
*** TURN *** [Js 3d Ah] [Ts]
Szevasztopol: checks 
bennetb77: bets $7
Szevasztopol: calls $7
*** RIVER *** [Js 3d Ah Ts] [Ac]
Szevasztopol: checks 
bennetb77: bets $14
Szevasztopol: folds 
Uncalled bet ($14) returned to bennetb77
bennetb77 collected $28.17 from pot
bennetb77: doesn't show hand 
*** SUMMARY ***
Total pot $29.50 | Rake $1.33 
Board [Js 3d Ah Ts Ac]
Seat 1: jahwe folded before Flop (didn't bet)
Seat 2: Jimy Tiltman (button) folded before Flop (didn't bet)
Seat 3: mycka86 (small blind) folded before Flop
Seat 4: CAJUN890 (big blind) folded before Flop
Seat 5: Szevasztopol folded on the River
Seat 6: blackmont111 folded before Flop (didn't bet)
Seat 7: bennetb77 collected ($28.17)
Seat 8: matiko09 folded before Flop (didn't bet)
Seat 9: PacPacBum folded before Flop (didn't bet)





PokerStars Hand #150803321782:  Hold'em No Limit (€0.50/€1.00 EUR) - 2016/03/23 15:41:07 CET [2016/03/23 10:41:07 ET]
Table 'Volga III' 9-max Seat #2 is the button
Seat 1: Dantist1122 (€109.24 in chips) 
Seat 2: GW92RP (€103.31 in chips) 
Seat 3: matiko09 (€100 in chips) 
Seat 4: bigacsiga (€107.60 in chips) 
Seat 6: PacPacBum (€101.19 in chips) 
Seat 7: jahwe (€100 in chips) 
Seat 8: edidaz (€108.62 in chips) 
Seat 9: ardo888 (€136.36 in chips) 
matiko09: posts small blind €0.50
bigacsiga: posts big blind €1
*** HOLE CARDS ***
Dealt to matiko09 [5d Js]
PacPacBum: folds 
jahwe: raises €1.50 to €2.50
edidaz: folds 
ardo888: folds 
Dantist1122: folds 
GW92RP: folds 
matiko09: folds 
bigacsiga: folds 
Uncalled bet (€1.50) returned to jahwe
jahwe collected €2.50 from pot
jahwe: doesn't show hand 
*** SUMMARY ***
Total pot €2.50 | Rake €0 
Seat 1: Dantist1122 folded before Flop (didn't bet)
Seat 2: GW92RP (button) folded before Flop (didn't bet)
Seat 3: matiko09 (small blind) folded before Flop
Seat 4: bigacsiga (big blind) folded before Flop
Seat 6: PacPacBum folded before Flop (didn't bet)
Seat 7: jahwe collected (€2.50)
Seat 8: edidaz folded before Flop (didn't bet)
Seat 9: ardo888 folded before Flop (didn't bet)





PokerStars Hand #150803322327:  Hold'em No Limit ($0.50/$1.00 USD) - 2016/03/23 15:41:09 CET [2016/03/23 10:41:09 ET]
Table 'Drakonia II' 9-max Seat #3 is the button
Seat 1: chautinhtri9 ($128 in chips) 
Seat 2: RICKA16 ($111.44 in chips) 
Seat 3: PacPacBum ($100 in chips) 
Seat 4: Jimy Tiltman ($100 in chips) 
Seat 5: Muinmyheart ($100 in chips) 
Seat 6: PinkTrinta ($121.25 in chips) 
Seat 7: YuriiSolodya ($49.85 in chips) 
Seat 8: matiko09 ($100 in chips) 
Seat 9: mycka86 ($100 in chips) 
Jimy Tiltman: posts small blind $0.50
Muinmyheart: posts big blind $1
*** HOLE CARDS ***
Dealt to matiko09 [3s 9d]
PinkTrinta: folds 
YuriiSolodya: raises $3 to $4
matiko09: folds 
mycka86: folds 
chautinhtri9: calls $4
RICKA16: folds 
PacPacBum: folds 
Jimy Tiltman: folds 
Muinmyheart: folds 
*** FLOP *** [4d 8s Qc]
YuriiSolodya: checks 
chautinhtri9: bets $6
YuriiSolodya: raises $6 to $12
chautinhtri9: folds 
Uncalled bet ($6) returned to YuriiSolodya
YuriiSolodya collected $20.53 from pot
YuriiSolodya: doesn't show hand 
*** SUMMARY ***
Total pot $21.50 | Rake $0.97 
Board [4d 8s Qc]
Seat 1: chautinhtri9 folded on the Flop
Seat 2: RICKA16 folded before Flop (didn't bet)
Seat 3: PacPacBum (button) folded before Flop (didn't bet)
Seat 4: Jimy Tiltman (small blind) folded before Flop
Seat 5: Muinmyheart (big blind) folded before Flop
Seat 6: PinkTrinta folded before Flop (didn't bet)
Seat 7: YuriiSolodya collected ($20.53)
Seat 8: matiko09 folded before Flop (didn't bet)
Seat 9: mycka86 folded before Flop (didn't bet)





PokerStars Hand #150803325925:  Hold'em No Limit ($0.50/$1.00 USD) - 2016/03/23 15:41:19 CET [2016/03/23 10:41:19 ET]
Table 'Aetolia II' 9-max Seat #5 is the button
Seat 2: jahwe ($100 in chips) 
Seat 3: lumen21 ($100 in chips) 
Seat 4: Pocketstud ($117.52 in chips) 
Seat 5: KingCastle77 ($96.76 in chips) 
Seat 6: Westpants ($114.96 in chips) 
Seat 7: matiko09 ($100 in chips) 
Seat 8: PacPacBum ($107.56 in chips) 
Seat 9: mmcardoulis ($66.05 in chips) 
Westpants: posts small blind $0.50
matiko09: posts big blind $1
app1e_j@ck: sits out 
*** HOLE CARDS ***
Dealt to matiko09 [5h Ks]
PacPacBum: folds 
mmcardoulis: folds 
jahwe: folds 
lumen21: folds 
Pocketstud: folds 
KingCastle77: folds 
Westpants: folds 
Uncalled bet ($0.50) returned to matiko09
matiko09 collected $1 from pot
matiko09: doesn't show hand 
*** SUMMARY ***
Total pot $1 | Rake $0 
Seat 2: jahwe folded before Flop (didn't bet)
Seat 3: lumen21 folded before Flop (didn't bet)
Seat 4: Pocketstud folded before Flop (didn't bet)
Seat 5: KingCastle77 (button) folded before Flop (didn't bet)
Seat 6: Westpants (small blind) folded before Flop
Seat 7: matiko09 (big blind) collected ($1)
Seat 8: PacPacBum folded before Flop (didn't bet)
Seat 9: mmcardoulis folded before Flop (didn't bet)





PokerStars Hand #150803325732:  Hold'em No Limit ($0.50/$1.00 USD) - 2016/03/23 15:41:19 CET [2016/03/23 10:41:19 ET]
Table 'Atlantis' 9-max Seat #4 is the button
Seat 1: Westpants ($100 in chips) 
Seat 2: Szevasztopol ($100 in chips) 
Seat 3: CAJUN890 ($63.51 in chips) 
Seat 4: mycka86 ($118.04 in chips) 
Seat 5: Durango-CO77 ($48.31 in chips) 
Seat 6: PacPacBum ($114.91 in chips) 
Seat 7: matiko09 ($139.11 in chips) 
Seat 8: jahwe ($102 in chips) 
Seat 9: RICKA16 ($149.28 in chips) 
Durango-CO77: posts small blind $0.50
PacPacBum: posts big blind $1
*** HOLE CARDS ***
Dealt to matiko09 [Kh 5h]
matiko09: folds 
jahwe: folds 
RICKA16: folds 
Westpants: raises $2 to $3
Szevasztopol: folds 
CAJUN890: folds 
mycka86: folds 
Durango-CO77: calls $2.50
PacPacBum: folds 
*** FLOP *** [2c 8h Th]
Durango-CO77: checks 
Westpants: bets $4.20
Durango-CO77: folds 
Uncalled bet ($4.20) returned to Westpants
Westpants collected $6.68 from pot
*** SUMMARY ***
Total pot $7 | Rake $0.32 
Board [2c 8h Th]
Seat 1: Westpants collected ($6.68)
Seat 2: Szevasztopol folded before Flop (didn't bet)
Seat 3: CAJUN890 folded before Flop (didn't bet)
Seat 4: mycka86 (button) folded before Flop (didn't bet)
Seat 5: Durango-CO77 (small blind) folded on the Flop
Seat 6: PacPacBum (big blind) folded before Flop
Seat 7: matiko09 folded before Flop (didn't bet)
Seat 8: jahwe folded before Flop (didn't bet)
Seat 9: RICKA16 folded before Flop (didn't bet)





PokerStars Hand #150803328559:  Hold'em No Limit ($0.50/$1.00 USD) - 2016/03/23 15:41:28 CET [2016/03/23 10:41:28 ET]
Table 'Swings' 9-max Seat #7 is the button
Seat 1: lumen21 ($102.28 in chips) 
Seat 2: tomver0809 ($67.28 in chips) 
Seat 3: edidaz ($103.80 in chips) 
Seat 4: YuriiSolodya ($41.05 in chips) 
Seat 5: chautinhtri9 ($111.55 in chips) 
Seat 6: matiko09 ($139.92 in chips) 
Seat 7: PacPacBum ($121.99 in chips) 
Seat 8: RICKA16 ($103.18 in chips) 
Seat 9: Effort92 ($100.53 in chips) 
RICKA16: posts small blind $0.50
Effort92: posts big blind $1
*** HOLE CARDS ***
Dealt to matiko09 [9s 2h]
lumen21: folds 
tomver0809: folds 
edidaz: folds 
YuriiSolodya: folds 
chautinhtri9: raises $1 to $2
matiko09: folds 
PacPacBum: folds 
RICKA16: calls $1.50
Effort92: folds 
*** FLOP *** [7c Th Js]
RICKA16: checks 
chautinhtri9: checks 
*** TURN *** [7c Th Js] [7s]
RICKA16: bets $4
chautinhtri9: folds 
Uncalled bet ($4) returned to RICKA16
RICKA16 collected $4.78 from pot
RICKA16: doesn't show hand 
*** SUMMARY ***
Total pot $5 | Rake $0.22 
Board [7c Th Js 7s]
Seat 1: lumen21 folded before Flop (didn't bet)
Seat 2: tomver0809 folded before Flop (didn't bet)
Seat 3: edidaz folded before Flop (didn't bet)
Seat 4: YuriiSolodya folded before Flop (didn't bet)
Seat 5: chautinhtri9 folded on the Turn
Seat 6: matiko09 folded before Flop (didn't bet)
Seat 7: PacPacBum (button) folded before Flop (didn't bet)
Seat 8: RICKA16 (small blind) collected ($4.78)
Seat 9: Effort92 (big blind) folded before Flop





PokerStars Hand #150803328647:  Hold'em No Limit ($1/$2 USD) - 2016/03/23 15:41:28 CET [2016/03/23 10:41:28 ET]
Table 'Kiess' 9-max Seat #5 is the button
Seat 1: Cirilico ($238.37 in chips) 
Seat 2: jahwe ($200 in chips) 
Seat 3: Red4erT ($116.43 in chips) 
Seat 4: RamiroAgujis ($210.96 in chips) 
Seat 5: chippo boy ($448.37 in chips) 
Seat 6: matiko09 ($220.48 in chips) 
Seat 7: chaps1988 ($209.24 in chips) 
Seat 8: erfk1958 ($130.78 in chips) 
Seat 9: PacPacBum ($200 in chips) 
matiko09: posts small blind $1
chaps1988: posts big blind $2
*** HOLE CARDS ***
Dealt to matiko09 [5d 4h]
erfk1958: folds 
PacPacBum: folds 
Cirilico: folds 
jahwe: folds 
Red4erT: raises $4 to $6
RamiroAgujis: folds 
chippo boy: folds 
matiko09: folds 
chaps1988: folds 
Uncalled bet ($4) returned to Red4erT
Red4erT collected $5 from pot
Red4erT: doesn't show hand 
*** SUMMARY ***
Total pot $5 | Rake $0 
Seat 1: Cirilico folded before Flop (didn't bet)
Seat 2: jahwe folded before Flop (didn't bet)
Seat 3: Red4erT collected ($5)
Seat 4: RamiroAgujis folded before Flop (didn't bet)
Seat 5: chippo boy (button) folded before Flop (didn't bet)
Seat 6: matiko09 (small blind) folded before Flop
Seat 7: chaps1988 (big blind) folded before Flop
Seat 8: erfk1958 folded before Flop (didn't bet)
Seat 9: PacPacBum folded before Flop (didn't bet)





PokerStars Hand #150803328655:  Hold'em No Limit (€0.50/€1.00 EUR) - 2016/03/23 15:41:28 CET [2016/03/23 10:41:28 ET]
Table 'Mercury III' 9-max Seat #7 is the button
Seat 1: matiko09 (€126.35 in chips) 
Seat 2: jahwe (€125.85 in chips) 
Seat 3: PacPacBum (€100 in chips) 
Seat 4: Muinmyheart (€101.50 in chips) 
Seat 5: ardo888 (€100 in chips) 
Seat 6: mycka86 (€100 in chips) 
Seat 7: STrakDD (€159.71 in chips) 
Seat 8: gfxed (€37.30 in chips) 
Seat 9: Indr3k (€100 in chips) 
gfxed: posts small blind €0.50
Indr3k: posts big blind €1
*** HOLE CARDS ***
Dealt to matiko09 [6s Tc]
matiko09: folds 
jahwe: folds 
PacPacBum: raises €1.04 to €2.04
Muinmyheart: folds 
ardo888: folds 
gfxed said, "AA?"
mycka86: folds 
STrakDD: calls €2.04
gfxed: calls €1.54
Indr3k: folds 
*** FLOP *** [3c 5d 4h]
gfxed: checks 
PacPacBum: checks 
STrakDD: bets €4.08
gfxed: calls €4.08
PacPacBum: folds 
*** TURN *** [3c 5d 4h] [2d]
gfxed: checks 
STrakDD: checks 
*** RIVER *** [3c 5d 4h 2d] [9c]
gfxed: bets €10
STrakDD: folds 
Uncalled bet (€10) returned to gfxed
gfxed collected €14.59 from pot
*** SUMMARY ***
Total pot €15.28 | Rake €0.69 
Board [3c 5d 4h 2d 9c]
Seat 1: matiko09 folded before Flop (didn't bet)
Seat 2: jahwe folded before Flop (didn't bet)
Seat 3: PacPacBum folded on the Flop
Seat 4: Muinmyheart folded before Flop (didn't bet)
Seat 5: ardo888 folded before Flop (didn't bet)
Seat 6: mycka86 folded before Flop (didn't bet)
Seat 7: STrakDD (button) folded on the River
Seat 8: gfxed (small blind) collected (€14.59)
Seat 9: Indr3k (big blind) folded before Flop





PokerStars Hand #150803329319:  Hold'em No Limit ($0.50/$1.00 USD) - 2016/03/23 15:41:30 CET [2016/03/23 10:41:30 ET]
Table 'Haug II' 9-max Seat #1 is the button
Seat 1: PacPacBum ($100 in chips) 
Seat 2: ardo888 ($123.46 in chips) 
Seat 4: matiko09 ($122.92 in chips) 
Seat 5: GlamDragon ($91.51 in chips) 
Seat 6: Pocketstud ($100 in chips) 
Seat 8: BRIGANTE49 ($102.96 in chips) 
Seat 9: ZOLOTOY766 ($66.40 in chips) 
ardo888: posts small blind $0.50
matiko09: posts big blind $1
jahwe: sits out 
PacPacBum: posts the ante $0.20
ardo888: posts the ante $0.20
matiko09: posts the ante $0.20
GlamDragon: posts the ante $0.20
Pocketstud: posts the ante $0.20
BRIGANTE49: posts the ante $0.20
ZOLOTOY766: posts the ante $0.20
*** HOLE CARDS ***
Dealt to matiko09 [Jh Td]
GlamDragon: raises $1 to $2
Pocketstud: folds 
BRIGANTE49: calls $2
ZOLOTOY766: folds 
ZOLOTOY766 leaves the table
PacPacBum: folds 
ardo888: folds 
matiko09: folds 
*** FLOP *** [Ks Js 5d]
GlamDragon: bets $4
BRIGANTE49: folds 
Uncalled bet ($4) returned to GlamDragon
GlamDragon collected $6.59 from pot
GlamDragon: doesn't show hand 
*** SUMMARY ***
Total pot $6.90 | Rake $0.31 
Board [Ks Js 5d]
Seat 1: PacPacBum (button) folded before Flop (didn't bet)
Seat 2: ardo888 (small blind) folded before Flop
Seat 4: matiko09 (big blind) folded before Flop
Seat 5: GlamDragon collected ($6.59)
Seat 6: Pocketstud folded before Flop (didn't bet)
Seat 8: BRIGANTE49 folded on the Flop
Seat 9: ZOLOTOY766 folded before Flop (didn't bet)





PokerStars Hand #150803329379:  Hold'em No Limit ($0.50/$1.00 USD) - 2016/03/23 15:41:30 CET [2016/03/23 10:41:30 ET]
Table 'Sylvia III' 9-max Seat #1 is the button
Seat 1: mycka86 ($144.50 in chips) 
Seat 3: bigacsiga ($117.05 in chips) 
Seat 4: lombardo11 ($52.44 in chips) 
Seat 5: matiko09 ($100 in chips) 
Seat 6: PacPacBum ($107 in chips) 
Seat 7: jahwe ($104.22 in chips) 
Seat 8: Muinmyheart ($141.20 in chips) 
Seat 9: Jimy Tiltman ($100.80 in chips) 
ellis005 will be allowed to play after the button
bigacsiga: posts small blind $0.50
lombardo11: posts big blind $1
mycka86: posts the ante $0.20
bigacsiga: posts the ante $0.20
lombardo11: posts the ante $0.20
matiko09: posts the ante $0.20
PacPacBum: posts the ante $0.20
jahwe: posts the ante $0.20
Muinmyheart: posts the ante $0.20
Jimy Tiltman: posts the ante $0.20
*** HOLE CARDS ***
Dealt to matiko09 [7d Jc]
matiko09: folds 
PacPacBum: raises $2 to $3
jahwe: folds 
Muinmyheart: calls $3
Jimy Tiltman: folds 
mycka86: calls $3
bigacsiga: folds 
lombardo11: folds 
*** FLOP *** [Ah Jd 4d]
PacPacBum: checks 
Muinmyheart: checks 
mycka86: bets $8
PacPacBum: raises $14.88 to $22.88
Muinmyheart: folds 
mycka86: folds 
Uncalled bet ($14.88) returned to PacPacBum
PacPacBum collected $26.84 from pot
PacPacBum: doesn't show hand 
*** SUMMARY ***
Total pot $28.10 | Rake $1.26 
Board [Ah Jd 4d]
Seat 1: mycka86 (button) folded on the Flop
Seat 3: bigacsiga (small blind) folded before Flop
Seat 4: lombardo11 (big blind) folded before Flop
Seat 5: matiko09 folded before Flop (didn't bet)
Seat 6: PacPacBum collected ($26.84)
Seat 7: jahwe folded before Flop (didn't bet)
Seat 8: Muinmyheart folded on the Flop
Seat 9: Jimy Tiltman folded before Flop (didn't bet)





PokerStars Hand #150803329928:  Hold'em No Limit ($0.50/$1.00 USD) - 2016/03/23 15:41:32 CET [2016/03/23 10:41:32 ET]
Table 'Asmodeus' 9-max Seat #6 is the button
Seat 1: Jimy Tiltman ($168.97 in chips) 
Seat 2: PacPacBum ($100 in chips) 
Seat 3: jahwe ($105.81 in chips) 
Seat 4: Effort92 ($100 in chips) 
Seat 5: Muinmyheart ($100 in chips) 
Seat 6: fuppeee ($177.52 in chips) 
Seat 7: mycka86 ($114.25 in chips) 
Seat 9: matiko09 ($100 in chips) 
mycka86: posts small blind $0.50
app1e_j@ck: is sitting out 
matiko09: posts big blind $1
Jimy Tiltman: posts the ante $0.20
PacPacBum: posts the ante $0.20
jahwe: posts the ante $0.20
Effort92: posts the ante $0.20
Muinmyheart: posts the ante $0.20
fuppeee: posts the ante $0.20
mycka86: posts the ante $0.20
matiko09: posts the ante $0.20
*** HOLE CARDS ***
Dealt to matiko09 [9c 9s]
app1e_j@ck leaves the table
Jimy Tiltman: folds 
Jimy Tiltman leaves the table
PacPacBum: folds 
jahwe: folds 
Effort92: folds 
Muinmyheart: raises $1.50 to $2.50
fuppeee: calls $2.50
mycka86: raises $9.50 to $12
matiko09: folds 
edidaz joins the table at seat #1 
edidaz leaves the table
Muinmyheart: folds 
fuppeee: folds 
Uncalled bet ($9.50) returned to mycka86
mycka86 collected $10.10 from pot
*** SUMMARY ***
Total pot $10.10 | Rake $0 
Seat 1: Jimy Tiltman folded before Flop (didn't bet)
Seat 2: PacPacBum folded before Flop (didn't bet)
Seat 3: jahwe folded before Flop (didn't bet)
Seat 4: Effort92 folded before Flop (didn't bet)
Seat 5: Muinmyheart folded before Flop
Seat 6: fuppeee (button) folded before Flop
Seat 7: mycka86 (small blind) collected ($10.10)
Seat 9: matiko09 (big blind) folded before Flop





PokerStars Hand #150803332431:  Hold'em No Limit (€0.50/€1.00 EUR) - 2016/03/23 15:41:39 CET [2016/03/23 10:41:39 ET]
Table 'Volga III' 9-max Seat #3 is the button
Seat 1: Dantist1122 (€109.24 in chips) 
Seat 2: GW92RP (€103.31 in chips) 
Seat 3: matiko09 (€100 in chips) 
Seat 4: bigacsiga (€106.60 in chips) 
Seat 6: PacPacBum (€101.19 in chips) 
Seat 7: jahwe (€101.50 in chips) 
Seat 8: edidaz (€108.62 in chips) 
Seat 9: ardo888 (€136.36 in chips) 
bigacsiga: posts small blind €0.50
PacPacBum: posts big blind €1
*** HOLE CARDS ***
Dealt to matiko09 [9d Th]
jahwe: raises €2 to €3
edidaz: folds 
ardo888: folds 
Dantist1122: folds 
GW92RP: folds 
matiko09: folds 
bigacsiga: folds 
PacPacBum: folds 
Uncalled bet (€2) returned to jahwe
jahwe collected €2.50 from pot
jahwe: doesn't show hand 
*** SUMMARY ***
Total pot €2.50 | Rake €0 
Seat 1: Dantist1122 folded before Flop (didn't bet)
Seat 2: GW92RP folded before Flop (didn't bet)
Seat 3: matiko09 (button) folded before Flop (didn't bet)
Seat 4: bigacsiga (small blind) folded before Flop
Seat 6: PacPacBum (big blind) folded before Flop
Seat 7: jahwe collected (€2.50)
Seat 8: edidaz folded before Flop (didn't bet)
Seat 9: ardo888 folded before Flop (didn't bet)





PokerStars Hand #150803334537:  Hold'em No Limit ($0.50/$1.00 USD) - 2016/03/23 15:41:46 CET [2016/03/23 10:41:46 ET]
Table 'Aetolia II' 9-max Seat #6 is the button
Seat 2: jahwe ($100 in chips) 
Seat 3: lumen21 ($100 in chips) 
Seat 4: Pocketstud ($117.52 in chips) 
Seat 5: KingCastle77 ($96.76 in chips) 
Seat 6: Westpants ($114.46 in chips) 
Seat 7: matiko09 ($100.50 in chips) 
Seat 8: PacPacBum ($107.56 in chips) 
Seat 9: mmcardoulis ($66.05 in chips) 
matiko09: posts small blind $0.50
PacPacBum: posts big blind $1
app1e_j@ck: sits out 
*** HOLE CARDS ***
Dealt to matiko09 [4d 7c]
mmcardoulis: folds 
mmcardoulis leaves the table
edidaz joins the table at seat #9 
edidaz leaves the table
jahwe: folds 
lumen21: folds 
Pocketstud: folds 
lumen21 leaves the table
KingCastle77: folds 
omorfadramou joins the table at seat #9 
Westpants: raises $1.46 to $2.46
matiko09: folds 
PacPacBum: calls $1.46
*** FLOP *** [Qs Ac 5c]
se7en_$tars joins the table at seat #3 
PacPacBum: checks 
Westpants: checks 
*** TURN *** [Qs Ac 5c] [3d]
PacPacBum: checks 
Westpants: bets $3.75
PacPacBum: folds 
Uncalled bet ($3.75) returned to Westpants
Westpants collected $5.18 from pot
*** SUMMARY ***
Total pot $5.42 | Rake $0.24 
Board [Qs Ac 5c 3d]
Seat 2: jahwe folded before Flop (didn't bet)
Seat 3: lumen21 folded before Flop (didn't bet)
Seat 4: Pocketstud folded before Flop (didn't bet)
Seat 5: KingCastle77 folded before Flop (didn't bet)
Seat 6: Westpants (button) collected ($5.18)
Seat 7: matiko09 (small blind) folded before Flop
Seat 8: PacPacBum (big blind) folded on the Turn
Seat 9: mmcardoulis folded before Flop (didn't bet)





PokerStars Hand #150803336666:  Hold'em No Limit ($0.50/$1.00 USD) - 2016/03/23 15:41:52 CET [2016/03/23 10:41:52 ET]
Table 'Haug II' 9-max Seat #2 is the button
Seat 1: PacPacBum ($100 in chips) 
Seat 2: ardo888 ($122.76 in chips) 
Seat 4: matiko09 ($121.72 in chips) 
Seat 5: GlamDragon ($95.90 in chips) 
Seat 6: Pocketstud ($99.80 in chips) 
Seat 8: BRIGANTE49 ($100.76 in chips) 
matiko09: posts small blind $0.50
GlamDragon: posts big blind $1
jahwe: sits out 
PacPacBum: posts the ante $0.20
ardo888: posts the ante $0.20
matiko09: posts the ante $0.20
GlamDragon: posts the ante $0.20
Pocketstud: posts the ante $0.20
BRIGANTE49: posts the ante $0.20
*** HOLE CARDS ***
Dealt to matiko09 [Ac 8c]
Pocketstud: folds 
BRIGANTE49: folds 
PacPacBum: raises $1.50 to $2.50
ardo888: folds 
matiko09: folds 
GlamDragon: calls $1.50
*** FLOP *** [7h 7c Js]
GlamDragon: checks 
PacPacBum: bets $3.45
GlamDragon: raises $6.65 to $10.10
PacPacBum: folds 
Uncalled bet ($6.65) returned to GlamDragon
GlamDragon collected $12.99 from pot
GlamDragon: doesn't show hand 
*** SUMMARY ***
Total pot $13.60 | Rake $0.61 
Board [7h 7c Js]
Seat 1: PacPacBum folded on the Flop
Seat 2: ardo888 (button) folded before Flop (didn't bet)
Seat 4: matiko09 (small blind) folded before Flop
Seat 5: GlamDragon (big blind) collected ($12.99)
Seat 6: Pocketstud folded before Flop (didn't bet)
Seat 8: BRIGANTE49 folded before Flop (didn't bet)





PokerStars Hand #150803341377:  Hold'em No Limit ($1/$2 USD) - 2016/03/23 15:42:06 CET [2016/03/23 10:42:06 ET]
Table 'Kiess' 9-max Seat #6 is the button
Seat 1: Cirilico ($238.37 in chips) 
Seat 2: jahwe ($200 in chips) 
Seat 3: Red4erT ($119.43 in chips) 
Seat 4: RamiroAgujis ($210.96 in chips) 
Seat 5: chippo boy ($448.37 in chips) 
Seat 6: matiko09 ($219.48 in chips) 
Seat 7: chaps1988 ($207.24 in chips) 
Seat 8: erfk1958 ($130.78 in chips) 
Seat 9: PacPacBum ($200 in chips) 
chaps1988: posts small blind $1
erfk1958: posts big blind $2
*** HOLE CARDS ***
Dealt to matiko09 [4s 4h]
PacPacBum: folds 
Cirilico: folds 
jahwe: folds 
Red4erT: raises $4 to $6
RamiroAgujis: folds 
chippo boy: calls $6
matiko09: calls $6
chaps1988: folds 
erfk1958: folds 
*** FLOP *** [Jd Qc 7s]
Red4erT: checks 
chippo boy: bets $10
matiko09: folds 
Red4erT: folds 
Uncalled bet ($10) returned to chippo boy
chippo boy collected $20.06 from pot
*** SUMMARY ***
Total pot $21 | Rake $0.94 
Board [Jd Qc 7s]
Seat 1: Cirilico folded before Flop (didn't bet)
Seat 2: jahwe folded before Flop (didn't bet)
Seat 3: Red4erT folded on the Flop
Seat 4: RamiroAgujis folded before Flop (didn't bet)
Seat 5: chippo boy collected ($20.06)
Seat 6: matiko09 (button) folded on the Flop
Seat 7: chaps1988 (small blind) folded before Flop
Seat 8: erfk1958 (big blind) folded before Flop
Seat 9: PacPacBum folded before Flop (didn't bet)





PokerStars Hand #150803343709:  Hold'em No Limit ($0.50/$1.00 USD) - 2016/03/23 15:42:14 CET [2016/03/23 10:42:14 ET]
Table 'Atlantis' 9-max Seat #5 is the button
Seat 1: Westpants ($103.68 in chips) 
Seat 2: Szevasztopol ($100 in chips) 
Seat 3: CAJUN890 ($63.51 in chips) 
Seat 4: mycka86 ($118.04 in chips) 
Seat 5: Durango-CO77 ($45.31 in chips) 
Seat 6: PacPacBum ($113.91 in chips) 
Seat 7: matiko09 ($139.11 in chips) 
Seat 8: jahwe ($102 in chips) 
Seat 9: RICKA16 ($149.28 in chips) 
PacPacBum: posts small blind $0.50
matiko09: posts big blind $1
*** HOLE CARDS ***
Dealt to matiko09 [Jh Ks]
jahwe: folds 
RICKA16: folds 
Westpants: raises $2 to $3
Szevasztopol: folds 
CAJUN890: calls $3
mycka86: folds 
Durango-CO77: folds 
PacPacBum: folds 
matiko09: folds 
*** FLOP *** [5d 9s Kd]
Westpants: bets $3.85
CAJUN890: calls $3.85
*** TURN *** [5d 9s Kd] [3s]
Westpants: bets $6.85
CAJUN890: calls $6.85
*** RIVER *** [5d 9s Kd 3s] [4h]
Westpants: checks 
CAJUN890: bets $16
Westpants: folds 
Uncalled bet ($16) returned to CAJUN890
CAJUN890 collected $27.60 from pot
CAJUN890: doesn't show hand 
*** SUMMARY ***
Total pot $28.90 | Rake $1.30 
Board [5d 9s Kd 3s 4h]
Seat 1: Westpants folded on the River
Seat 2: Szevasztopol folded before Flop (didn't bet)
Seat 3: CAJUN890 collected ($27.60)
Seat 4: mycka86 folded before Flop (didn't bet)
Seat 5: Durango-CO77 (button) folded before Flop (didn't bet)
Seat 6: PacPacBum (small blind) folded before Flop
Seat 7: matiko09 (big blind) folded before Flop
Seat 8: jahwe folded before Flop (didn't bet)
Seat 9: RICKA16 folded before Flop (didn't bet)





PokerStars Hand #150803344526:  Hold'em No Limit (€0.50/€1.00 EUR) - 2016/03/23 15:42:16 CET [2016/03/23 10:42:16 ET]
Table 'Volga III' 9-max Seat #4 is the button
Seat 1: Dantist1122 (€109.24 in chips) 
Seat 2: GW92RP (€103.31 in chips) 
Seat 3: matiko09 (€100 in chips) 
Seat 4: bigacsiga (€106.10 in chips) 
Seat 6: PacPacBum (€100.19 in chips) 
Seat 7: jahwe (€103 in chips) 
Seat 8: edidaz (€108.62 in chips) 
Seat 9: ardo888 (€136.36 in chips) 
PacPacBum: posts small blind €0.50
jahwe: posts big blind €1
*** HOLE CARDS ***
Dealt to matiko09 [7c 6s]
edidaz: folds 
ardo888: folds 
edidaz leaves the table
Dantist1122: raises €2 to €3
GW92RP: folds 
matiko09: folds 
bigacsiga: folds 
PacPacBum: folds 
jahwe: folds 
Uncalled bet (€2) returned to Dantist1122
Dantist1122 collected €2.50 from pot
Dantist1122: doesn't show hand 
*** SUMMARY ***
Total pot €2.50 | Rake €0 
Seat 1: Dantist1122 collected (€2.50)
Seat 2: GW92RP folded before Flop (didn't bet)
Seat 3: matiko09 folded before Flop (didn't bet)
Seat 4: bigacsiga (button) folded before Flop (didn't bet)
Seat 6: PacPacBum (small blind) folded before Flop
Seat 7: jahwe (big blind) folded before Flop
Seat 8: edidaz folded before Flop (didn't bet)
Seat 9: ardo888 folded before Flop (didn't bet)





PokerStars Hand #150803346467:  Hold'em No Limit ($0.50/$1.00 USD) - 2016/03/23 15:42:22 CET [2016/03/23 10:42:22 ET]
Table 'Swings' 9-max Seat #8 is the button
Seat 1: lumen21 ($102.28 in chips) 
Seat 2: tomver0809 ($67.28 in chips) 
Seat 3: edidaz ($103.80 in chips) 
Seat 4: YuriiSolodya ($41.05 in chips) 
Seat 5: chautinhtri9 ($109.55 in chips) 
Seat 6: matiko09 ($139.92 in chips) 
Seat 7: PacPacBum ($121.99 in chips) 
Seat 8: RICKA16 ($105.96 in chips) 
Seat 9: Effort92 ($100 in chips) 
Effort92: posts small blind $0.50
lumen21: posts big blind $1
*** HOLE CARDS ***
Dealt to matiko09 [7d Ad]
tomver0809: folds 
edidaz: folds 
YuriiSolodya: calls $1
chautinhtri9: folds 
matiko09: raises $3 to $4
PacPacBum: folds 
RICKA16 has timed out
RICKA16: folds 
Effort92: folds 
lumen21: folds 
YuriiSolodya: calls $3
*** FLOP *** [3d 8c 6c]
YuriiSolodya: checks 
matiko09: checks 
*** TURN *** [3d 8c 6c] [Qd]
YuriiSolodya: checks 
matiko09: bets $5
YuriiSolodya: folds 
Uncalled bet ($5) returned to matiko09
matiko09 collected $9.07 from pot
matiko09: doesn't show hand 
*** SUMMARY ***
Total pot $9.50 | Rake $0.43 
Board [3d 8c 6c Qd]
Seat 1: lumen21 (big blind) folded before Flop
Seat 2: tomver0809 folded before Flop (didn't bet)
Seat 3: edidaz folded before Flop (didn't bet)
Seat 4: YuriiSolodya folded on the Turn
Seat 5: chautinhtri9 folded before Flop (didn't bet)
Seat 6: matiko09 collected ($9.07)
Seat 7: PacPacBum folded before Flop (didn't bet)
Seat 8: RICKA16 (button) folded before Flop (didn't bet)
Seat 9: Effort92 (small blind) folded before Flop





PokerStars Hand #150803348991:  Hold'em No Limit ($0.50/$1.00 USD) - 2016/03/23 15:42:30 CET [2016/03/23 10:42:30 ET]
Table 'Drakonia II' 9-max Seat #4 is the button
Seat 1: chautinhtri9 ($118 in chips) 
Seat 2: RICKA16 ($111.44 in chips) 
Seat 3: PacPacBum ($100 in chips) 
Seat 4: Jimy Tiltman ($100 in chips) 
Seat 5: Muinmyheart ($100 in chips) 
Seat 7: YuriiSolodya ($60.38 in chips) 
Seat 8: matiko09 ($100 in chips) 
Seat 9: mycka86 ($100 in chips) 
Muinmyheart: posts small blind $0.50
PinkTrinta: is sitting out 
YuriiSolodya: posts big blind $1
*** HOLE CARDS ***
Dealt to matiko09 [4d 3c]
matiko09: folds 
mycka86: folds 
chautinhtri9: folds 
RICKA16: raises $2 to $3
PacPacBum: folds 
Jimy Tiltman: calls $3
Muinmyheart: folds 
YuriiSolodya: calls $2
*** FLOP *** [6d Qs Jc]
YuriiSolodya: checks 
RICKA16: bets $6
Jimy Tiltman: calls $6
YuriiSolodya: calls $6
*** TURN *** [6d Qs Jc] [5s]
YuriiSolodya: checks 
RICKA16: checks 
Jimy Tiltman: bets $20.64
YuriiSolodya: folds 
RICKA16: folds 
Uncalled bet ($20.64) returned to Jimy Tiltman
Jimy Tiltman collected $26.26 from pot
Jimy Tiltman: doesn't show hand 
*** SUMMARY ***
Total pot $27.50 | Rake $1.24 
Board [6d Qs Jc 5s]
Seat 1: chautinhtri9 folded before Flop (didn't bet)
Seat 2: RICKA16 folded on the Turn
Seat 3: PacPacBum folded before Flop (didn't bet)
Seat 4: Jimy Tiltman (button) collected ($26.26)
Seat 5: Muinmyheart (small blind) folded before Flop
Seat 7: YuriiSolodya (big blind) folded on the Turn
Seat 8: matiko09 folded before Flop (didn't bet)
Seat 9: mycka86 folded before Flop (didn't bet)





PokerStars Hand #150803348972:  Hold'em No Limit ($0.50/$1.00 USD) - 2016/03/23 15:42:30 CET [2016/03/23 10:42:30 ET]
Table 'Asmodeus' 9-max Seat #7 is the button
Seat 2: PacPacBum ($100 in chips) 
Seat 3: jahwe ($105.61 in chips) 
Seat 4: Effort92 ($100 in chips) 
Seat 5: Muinmyheart ($100 in chips) 
Seat 6: fuppeee ($174.82 in chips) 
Seat 7: mycka86 ($121.65 in chips) 
Seat 9: matiko09 ($100 in chips) 
matiko09: posts small blind $0.50
PacPacBum: posts big blind $1
PacPacBum: posts the ante $0.20
jahwe: posts the ante $0.20
Effort92: posts the ante $0.20
Muinmyheart: posts the ante $0.20
fuppeee: posts the ante $0.20
mycka86: posts the ante $0.20
matiko09: posts the ante $0.20
*** HOLE CARDS ***
Dealt to matiko09 [7s Th]
Pok3rKidd joins the table at seat #1 
ardo888 joins the table at seat #8 
jahwe: raises $1.50 to $2.50
Effort92: folds 
Muinmyheart: folds 
fuppeee: folds 
mycka86: folds 
matiko09: folds 
PacPacBum: folds 
Uncalled bet ($1.50) returned to jahwe
jahwe collected $3.90 from pot
jahwe: doesn't show hand 
*** SUMMARY ***
Total pot $3.90 | Rake $0 
Seat 2: PacPacBum (big blind) folded before Flop
Seat 3: jahwe collected ($3.90)
Seat 4: Effort92 folded before Flop (didn't bet)
Seat 5: Muinmyheart folded before Flop (didn't bet)
Seat 6: fuppeee folded before Flop (didn't bet)
Seat 7: mycka86 (button) folded before Flop (didn't bet)
Seat 9: matiko09 (small blind) folded before Flop





PokerStars Hand #150803350040:  Hold'em No Limit ($0.50/$1.00 USD) - 2016/03/23 15:42:33 CET [2016/03/23 10:42:33 ET]
Table 'Haug II' 9-max Seat #4 is the button
Seat 1: PacPacBum ($100 in chips) 
Seat 2: ardo888 ($122.56 in chips) 
Seat 4: matiko09 ($121.02 in chips) 
Seat 5: GlamDragon ($102.74 in chips) 
Seat 6: Pocketstud ($99.60 in chips) 
Seat 8: BRIGANTE49 ($100.56 in chips) 
GlamDragon: posts small blind $0.50
Pocketstud: posts big blind $1
jahwe: sits out 
PacPacBum: posts the ante $0.20
ardo888: posts the ante $0.20
matiko09: posts the ante $0.20
GlamDragon: posts the ante $0.20
Pocketstud: posts the ante $0.20
BRIGANTE49: posts the ante $0.20
*** HOLE CARDS ***
Dealt to matiko09 [4d 9c]
BRIGANTE49: raises $2 to $3
PacPacBum: folds 
ardo888: folds 
matiko09: folds 
GlamDragon: folds 
Pocketstud: calls $2
*** FLOP *** [Js Ah Kd]
Pocketstud: checks 
BRIGANTE49: checks 
*** TURN *** [Js Ah Kd] [Qc]
Pocketstud: checks 
BRIGANTE49: bets $4
Pocketstud: calls $4
*** RIVER *** [Js Ah Kd Qc] [5c]
Pocketstud: checks 
flk.Dasas joins the table at seat #9 
BRIGANTE49: checks 
*** SHOW DOWN ***
Pocketstud: shows [Jh Jc] (three of a kind, Jacks)
BRIGANTE49: mucks hand 
Pocketstud collected $14.99 from pot
*** SUMMARY ***
Total pot $15.70 | Rake $0.71 
Board [Js Ah Kd Qc 5c]
Seat 1: PacPacBum folded before Flop (didn't bet)
Seat 2: ardo888 folded before Flop (didn't bet)
Seat 4: matiko09 (button) folded before Flop (didn't bet)
Seat 5: GlamDragon (small blind) folded before Flop
Seat 6: Pocketstud (big blind) showed [Jh Jc] and won ($14.99) with three of a kind, Jacks
Seat 8: BRIGANTE49 mucked [9s 8s]





PokerStars Hand #150803355643:  Hold'em No Limit ($0.50/$1.00 USD) - 2016/03/23 15:42:50 CET [2016/03/23 10:42:50 ET]
Table 'Sylvia III' 9-max Seat #3 is the button
Seat 1: mycka86 ($133.30 in chips) 
Seat 2: ellis005 ($80 in chips) 
Seat 3: bigacsiga ($116.35 in chips) 
Seat 4: lombardo11 ($51.24 in chips) 
Seat 5: matiko09 ($100 in chips) 
Seat 6: PacPacBum ($122.64 in chips) 
Seat 7: jahwe ($104.02 in chips) 
Seat 8: Muinmyheart ($138 in chips) 
Seat 9: Jimy Tiltman ($100.60 in chips) 
lombardo11: posts small blind $0.50
matiko09: posts big blind $1
ellis005: posts big blind $1
mycka86: posts the ante $0.20
ellis005: posts the ante $0.20
bigacsiga: posts the ante $0.20
lombardo11: posts the ante $0.20
matiko09: posts the ante $0.20
PacPacBum: posts the ante $0.20
jahwe: posts the ante $0.20
Muinmyheart: posts the ante $0.20
Jimy Tiltman: posts the ante $0.20
*** HOLE CARDS ***
Dealt to matiko09 [As 3s]
PacPacBum: folds 
jahwe: folds 
Muinmyheart: folds 
Jimy Tiltman: folds 
mycka86: folds 
ellis005: checks 
bigacsiga: raises $3 to $4
lombardo11: folds 
matiko09: folds 
ellis005: calls $3
*** FLOP *** [Qd Td Qc]
ellis005: checks 
bigacsiga: bets $7
ellis005: calls $7
*** TURN *** [Qd Td Qc] [9d]
ellis005: checks 
bigacsiga: bets $17
ellis005: calls $17
*** RIVER *** [Qd Td Qc 9d] [7s]
ellis005: checks 
bigacsiga: bets $56.63
ellis005: folds 
Uncalled bet ($56.63) returned to bigacsiga
bigacsiga collected $56.63 from pot
bigacsiga: doesn't show hand 
*** SUMMARY ***
Total pot $59.30 | Rake $2.67 
Board [Qd Td Qc 9d 7s]
Seat 1: mycka86 folded before Flop (didn't bet)
Seat 2: ellis005 folded on the River
Seat 3: bigacsiga (button) collected ($56.63)
Seat 4: lombardo11 (small blind) folded before Flop
Seat 5: matiko09 (big blind) folded before Flop
Seat 6: PacPacBum folded before Flop (didn't bet)
Seat 7: jahwe folded before Flop (didn't bet)
Seat 8: Muinmyheart folded before Flop (didn't bet)
Seat 9: Jimy Tiltman folded before Flop (didn't bet)





PokerStars Hand #150803357024:  Hold'em No Limit ($0.50/$1.00 USD) - 2016/03/23 15:42:54 CET [2016/03/23 10:42:54 ET]
Table 'Asmodeus' 9-max Seat #9 is the button
Seat 2: PacPacBum ($100 in chips) 
Seat 4: Effort92 ($100 in chips) 
Seat 5: Muinmyheart ($100 in chips) 
Seat 6: fuppeee ($174.62 in chips) 
Seat 7: mycka86 ($121.45 in chips) 
Seat 9: matiko09 ($100 in chips) 
Pok3rKidd will be allowed to play after the button
PacPacBum: posts small blind $0.50
jahwe: is sitting out 
Effort92: posts big blind $1
ardo888: sits out 
PacPacBum: posts the ante $0.20
Effort92: posts the ante $0.20
Muinmyheart: posts the ante $0.20
fuppeee: posts the ante $0.20
mycka86: posts the ante $0.20
matiko09: posts the ante $0.20
*** HOLE CARDS ***
Dealt to matiko09 [Ks Kh]
Muinmyheart: folds 
fuppeee: calls $1
mycka86: folds 
matiko09: raises $3.50 to $4.50
PacPacBum: folds 
Effort92: folds 
fuppeee: folds 
Uncalled bet ($3.50) returned to matiko09
matiko09 collected $4.70 from pot
matiko09: doesn't show hand 
*** SUMMARY ***
Total pot $4.70 | Rake $0 
Seat 2: PacPacBum (small blind) folded before Flop
Seat 4: Effort92 (big blind) folded before Flop
Seat 5: Muinmyheart folded before Flop (didn't bet)
Seat 6: fuppeee folded before Flop
Seat 7: mycka86 folded before Flop (didn't bet)
Seat 9: matiko09 (button) collected ($4.70)





PokerStars Hand #150803357344:  Hold'em No Limit (€0.50/€1.00 EUR) - 2016/03/23 15:42:55 CET [2016/03/23 10:42:55 ET]
Table 'Volga III' 9-max Seat #6 is the button
Seat 1: Dantist1122 (€110.74 in chips) 
Seat 2: GW92RP (€103.31 in chips) 
Seat 3: matiko09 (€100 in chips) 
Seat 4: bigacsiga (€106.10 in chips) 
Seat 6: PacPacBum (€100 in chips) 
Seat 7: jahwe (€102 in chips) 
Seat 9: ardo888 (€136.36 in chips) 
jahwe: posts small blind €0.50
ardo888: posts big blind €1
*** HOLE CARDS ***
Dealt to matiko09 [6c 6d]
Dantist1122: folds 
GW92RP: folds 
Dantist1122 leaves the table
matiko09: raises €2 to €3
bigacsiga: calls €3
PacPacBum: folds 
jahwe: folds 
ardo888: folds 
*** FLOP *** [Js 8c Qh]
matiko09: checks 
bigacsiga: bets €4.50
matiko09: folds 
Uncalled bet (€4.50) returned to bigacsiga
bigacsiga collected €7.16 from pot
bigacsiga: doesn't show hand 
*** SUMMARY ***
Total pot €7.50 | Rake €0.34 
Board [Js 8c Qh]
Seat 1: Dantist1122 folded before Flop (didn't bet)
Seat 2: GW92RP folded before Flop (didn't bet)
Seat 3: matiko09 folded on the Flop
Seat 4: bigacsiga collected (€7.16)
Seat 6: PacPacBum (button) folded before Flop (didn't bet)
Seat 7: jahwe (small blind) folded before Flop
Seat 9: ardo888 (big blind) folded before Flop





PokerStars Hand #150803358035:  Hold'em No Limit ($0.50/$1.00 USD) - 2016/03/23 15:42:57 CET [2016/03/23 10:42:57 ET]
Table 'Smiley' 9-max Seat #3 is the button
Seat 1: jahwe ($116.81 in chips) 
Seat 2: Jimy Tiltman ($100 in chips) 
Seat 3: mycka86 ($115.50 in chips) 
Seat 4: CAJUN890 ($80.69 in chips) 
Seat 5: Szevasztopol ($117.90 in chips) 
Seat 6: blackmont111 ($116.54 in chips) 
Seat 7: bennetb77 ($120.53 in chips) 
Seat 8: matiko09 ($101.08 in chips) 
Seat 9: PacPacBum ($102.81 in chips) 
CAJUN890: posts small blind $0.50
Szevasztopol: posts big blind $1
*** HOLE CARDS ***
Dealt to matiko09 [9c 8h]
blackmont111: folds 
bennetb77: folds 
matiko09: folds 
PacPacBum: folds 
jahwe: folds 
Jimy Tiltman: folds 
mycka86: raises $1.10 to $2.10
CAJUN890: folds 
Szevasztopol: folds 
Uncalled bet ($1.10) returned to mycka86
mycka86 collected $2.50 from pot
*** SUMMARY ***
Total pot $2.50 | Rake $0 
Seat 1: jahwe folded before Flop (didn't bet)
Seat 2: Jimy Tiltman folded before Flop (didn't bet)
Seat 3: mycka86 (button) collected ($2.50)
Seat 4: CAJUN890 (small blind) folded before Flop
Seat 5: Szevasztopol (big blind) folded before Flop
Seat 6: blackmont111 folded before Flop (didn't bet)
Seat 7: bennetb77 folded before Flop (didn't bet)
Seat 8: matiko09 folded before Flop (didn't bet)
Seat 9: PacPacBum folded before Flop (didn't bet)





PokerStars Hand #150803360551:  Hold'em No Limit ($0.50/$1.00 USD) - 2016/03/23 15:43:05 CET [2016/03/23 10:43:05 ET]
Table 'Haug II' 9-max Seat #5 is the button
Seat 1: PacPacBum ($100 in chips) 
Seat 2: ardo888 ($122.36 in chips) 
Seat 4: matiko09 ($120.82 in chips) 
Seat 5: GlamDragon ($102.04 in chips) 
Seat 6: Pocketstud ($107.39 in chips) 
Seat 7: jahwe ($106.89 in chips) 
Seat 8: BRIGANTE49 ($93.36 in chips) 
Pocketstud: posts small blind $0.50
jahwe: posts big blind $1
PacPacBum: posts the ante $0.20
ardo888: posts the ante $0.20
matiko09: posts the ante $0.20
GlamDragon: posts the ante $0.20
Pocketstud: posts the ante $0.20
jahwe: posts the ante $0.20
BRIGANTE49: posts the ante $0.20
*** HOLE CARDS ***
Dealt to matiko09 [Ac 8c]
BRIGANTE49: raises $2 to $3
PacPacBum: folds 
ardo888: raises $5.50 to $8.50
matiko09: folds 
GlamDragon: folds 
Pocketstud: folds 
jahwe: folds 
BRIGANTE49: calls $5.50
*** FLOP *** [Jc Jd Qs]
BRIGANTE49: bets $9
ardo888: calls $9
*** TURN *** [Jc Jd Qs] [Js]
BRIGANTE49: bets $18
Do-Man22 joins the table at seat #3 
ardo888: calls $18
*** RIVER *** [Jc Jd Qs Js] [Qd]
BRIGANTE49: bets $57.66 and is all-in
ardo888: folds 
Uncalled bet ($57.66) returned to BRIGANTE49
BRIGANTE49 collected $71.10 from pot
BRIGANTE49: doesn't show hand 
*** SUMMARY ***
Total pot $73.90 | Rake $2.80 
Board [Jc Jd Qs Js Qd]
Seat 1: PacPacBum folded before Flop (didn't bet)
Seat 2: ardo888 folded on the River
Seat 4: matiko09 folded before Flop (didn't bet)
Seat 5: GlamDragon (button) folded before Flop (didn't bet)
Seat 6: Pocketstud (small blind) folded before Flop
Seat 7: jahwe (big blind) folded before Flop
Seat 8: BRIGANTE49 collected ($71.10)





PokerStars Hand #150803361189:  Hold'em No Limit ($0.50/$1.00 USD) - 2016/03/23 15:43:07 CET [2016/03/23 10:43:07 ET]
Table 'Aetolia II' 9-max Seat #7 is the button
Seat 2: jahwe ($100 in chips) 
Seat 3: se7en_$tars ($80 in chips) 
Seat 4: Pocketstud ($117.52 in chips) 
Seat 5: KingCastle77 ($96.76 in chips) 
Seat 6: Westpants ($117.18 in chips) 
Seat 7: matiko09 ($100 in chips) 
Seat 8: PacPacBum ($105.10 in chips) 
Seat 9: omorfadramou ($100 in chips) 
PacPacBum: posts small blind $0.50
omorfadramou: posts big blind $1
app1e_j@ck: sits out 
se7en_$tars: posts big blind $1
*** HOLE CARDS ***
Dealt to matiko09 [7h 3h]
jahwe: folds 
se7en_$tars: raises $2 to $3
Pocketstud: folds 
KingCastle77: folds 
Westpants: folds 
matiko09: folds 
PacPacBum: folds 
omorfadramou: folds 
Uncalled bet ($2) returned to se7en_$tars
se7en_$tars collected $2.50 from pot
se7en_$tars: doesn't show hand 
*** SUMMARY ***
Total pot $2.50 | Rake $0 
Seat 2: jahwe folded before Flop (didn't bet)
Seat 3: se7en_$tars collected ($2.50)
Seat 4: Pocketstud folded before Flop (didn't bet)
Seat 5: KingCastle77 folded before Flop (didn't bet)
Seat 6: Westpants folded before Flop (didn't bet)
Seat 7: matiko09 (button) folded before Flop (didn't bet)
Seat 8: PacPacBum (small blind) folded before Flop
Seat 9: omorfadramou (big blind) folded before Flop





PokerStars Hand #150803363195:  Hold'em No Limit ($1/$2 USD) - 2016/03/23 15:43:13 CET [2016/03/23 10:43:13 ET]
Table 'Kiess' 9-max Seat #7 is the button
Seat 1: Cirilico ($238.37 in chips) 
Seat 2: jahwe ($200 in chips) 
Seat 3: Red4erT ($113.43 in chips) 
Seat 4: RamiroAgujis ($210.96 in chips) 
Seat 5: chippo boy ($462.43 in chips) 
Seat 6: matiko09 ($213.48 in chips) 
Seat 7: chaps1988 ($206.24 in chips) 
Seat 8: erfk1958 ($128.78 in chips) 
Seat 9: PacPacBum ($200 in chips) 
erfk1958: posts small blind $1
PacPacBum: posts big blind $2
*** HOLE CARDS ***
Dealt to matiko09 [7d Qc]
Cirilico: raises $4 to $6
jahwe: folds 
Red4erT: folds 
RamiroAgujis: folds 
chippo boy: folds 
matiko09: folds 
chaps1988: folds 
erfk1958: folds 
PacPacBum: folds 
Uncalled bet ($4) returned to Cirilico
Cirilico collected $5 from pot
Cirilico: doesn't show hand 
*** SUMMARY ***
Total pot $5 | Rake $0 
Seat 1: Cirilico collected ($5)
Seat 2: jahwe folded before Flop (didn't bet)
Seat 3: Red4erT folded before Flop (didn't bet)
Seat 4: RamiroAgujis folded before Flop (didn't bet)
Seat 5: chippo boy folded before Flop (didn't bet)
Seat 6: matiko09 folded before Flop (didn't bet)
Seat 7: chaps1988 (button) folded before Flop (didn't bet)
Seat 8: erfk1958 (small blind) folded before Flop
Seat 9: PacPacBum (big blind) folded before Flop





PokerStars Hand #150803367874:  Hold'em No Limit ($0.50/$1.00 USD) - 2016/03/23 15:43:27 CET [2016/03/23 10:43:27 ET]
Table 'Atlantis' 9-max Seat #6 is the button
Seat 1: Westpants ($100 in chips) 
Seat 2: Szevasztopol ($100 in chips) 
Seat 3: CAJUN890 ($77.41 in chips) 
Seat 4: mycka86 ($118.04 in chips) 
Seat 5: Durango-CO77 ($45.31 in chips) 
Seat 6: PacPacBum ($113.41 in chips) 
Seat 7: matiko09 ($138.11 in chips) 
Seat 9: RICKA16 ($149.28 in chips) 
matiko09: posts small blind $0.50
jahwe: is sitting out 
RICKA16: posts big blind $1
*** HOLE CARDS ***
Dealt to matiko09 [4h Tc]
Westpants: folds 
Szevasztopol: folds 
CAJUN890: raises $2 to $3
mycka86: folds 
Durango-CO77: folds 
PacPacBum: folds 
matiko09: folds 
RICKA16: folds 
Uncalled bet ($2) returned to CAJUN890
CAJUN890 collected $2.50 from pot
CAJUN890: doesn't show hand 
*** SUMMARY ***
Total pot $2.50 | Rake $0 
Seat 1: Westpants folded before Flop (didn't bet)
Seat 2: Szevasztopol folded before Flop (didn't bet)
Seat 3: CAJUN890 collected ($2.50)
Seat 4: mycka86 folded before Flop (didn't bet)
Seat 5: Durango-CO77 folded before Flop (didn't bet)
Seat 6: PacPacBum (button) folded before Flop (didn't bet)
Seat 7: matiko09 (small blind) folded before Flop
Seat 9: RICKA16 (big blind) folded before Flop





PokerStars Hand #150803369243:  Hold'em No Limit ($0.50/$1.00 USD) - 2016/03/23 15:43:31 CET [2016/03/23 10:43:31 ET]
Table 'Smiley' 9-max Seat #4 is the button
Seat 1: jahwe ($116.81 in chips) 
Seat 2: Jimy Tiltman ($100 in chips) 
Seat 3: mycka86 ($117 in chips) 
Seat 4: CAJUN890 ($80.19 in chips) 
Seat 5: Szevasztopol ($116.90 in chips) 
Seat 6: blackmont111 ($116.54 in chips) 
Seat 7: bennetb77 ($120.53 in chips) 
Seat 8: matiko09 ($101.08 in chips) 
Seat 9: PacPacBum ($102.81 in chips) 
Szevasztopol: posts small blind $0.50
blackmont111: posts big blind $1
*** HOLE CARDS ***
Dealt to matiko09 [4d 3h]
bennetb77: folds 
matiko09: folds 
PacPacBum: folds 
jahwe: folds 
Jimy Tiltman: folds 
mycka86: folds 
CAJUN890: folds 
Szevasztopol: folds 
Uncalled bet ($0.50) returned to blackmont111
blackmont111 collected $1 from pot
*** SUMMARY ***
Total pot $1 | Rake $0 
Seat 1: jahwe folded before Flop (didn't bet)
Seat 2: Jimy Tiltman folded before Flop (didn't bet)
Seat 3: mycka86 folded before Flop (didn't bet)
Seat 4: CAJUN890 (button) folded before Flop (didn't bet)
Seat 5: Szevasztopol (small blind) folded before Flop
Seat 6: blackmont111 (big blind) collected ($1)
Seat 7: bennetb77 folded before Flop (didn't bet)
Seat 8: matiko09 folded before Flop (didn't bet)
Seat 9: PacPacBum folded before Flop (didn't bet)





PokerStars Hand #150803372406:  Hold'em No Limit (€0.50/€1.00 EUR) - 2016/03/23 15:43:41 CET [2016/03/23 10:43:41 ET]
Table 'Volga III' 9-max Seat #7 is the button
Seat 2: GW92RP (€103.31 in chips) 
Seat 3: matiko09 (€100 in chips) 
Seat 4: bigacsiga (€110.26 in chips) 
Seat 6: PacPacBum (€100 in chips) 
Seat 7: jahwe (€101.50 in chips) 
Seat 9: ardo888 (€135.36 in chips) 
ardo888: posts small blind €0.50
GW92RP: posts big blind €1
*** HOLE CARDS ***
Dealt to matiko09 [Jc Qd]
matiko09: folds 
bigacsiga: folds 
PacPacBum: folds 
jahwe: raises €1 to €2
ardo888: folds 
GW92RP: calls €1
*** FLOP *** [3h 2d 5h]
finchaplin joins the table at seat #5 
GW92RP: bets €4
jahwe: raises €6 to €10
app1e_j@ck joins the table at seat #8 
GW92RP: raises €20 to €30
jahwe: calls €20
*** TURN *** [3h 2d 5h] [Tc]
GW92RP: bets €71.31 and is all-in
jahwe: folds 
Uncalled bet (€71.31) returned to GW92RP
GW92RP collected €62.35 from pot
GW92RP: doesn't show hand 
*** SUMMARY ***
Total pot €64.50 | Rake €2.15 
Board [3h 2d 5h Tc]
Seat 2: GW92RP (big blind) collected (€62.35)
Seat 3: matiko09 folded before Flop (didn't bet)
Seat 4: bigacsiga folded before Flop (didn't bet)
Seat 6: PacPacBum folded before Flop (didn't bet)
Seat 7: jahwe (button) folded on the Turn
Seat 9: ardo888 (small blind) folded before Flop





PokerStars Hand #150803372936:  Hold'em No Limit ($0.50/$1.00 USD) - 2016/03/23 15:43:43 CET [2016/03/23 10:43:43 ET]
Table 'Aetolia II' 9-max Seat #8 is the button
Seat 1: app1e_j@ck ($100 in chips) 
Seat 2: jahwe ($100 in chips) 
Seat 3: se7en_$tars ($81.50 in chips) 
Seat 4: Pocketstud ($117.52 in chips) 
Seat 5: KingCastle77 ($96.76 in chips) 
Seat 6: Westpants ($117.18 in chips) 
Seat 7: matiko09 ($100 in chips) 
Seat 8: PacPacBum ($104.60 in chips) 
Seat 9: omorfadramou ($100 in chips) 
omorfadramou: posts small blind $0.50
app1e_j@ck: posts big blind $1
*** HOLE CARDS ***
Dealt to matiko09 [Td Kc]
jahwe: folds 
se7en_$tars: calls $1
Pocketstud: calls $1
KingCastle77: folds 
Westpants: raises $3.25 to $4.25
matiko09: folds 
PacPacBum: folds 
omorfadramou: raises $9.75 to $14
app1e_j@ck: folds 
se7en_$tars: folds 
Pocketstud: folds 
Westpants: calls $9.75
*** FLOP *** [3s Js 9d]
omorfadramou: checks 
Westpants: bets $14
omorfadramou: folds 
Uncalled bet ($14) returned to Westpants
Westpants collected $29.60 from pot
*** SUMMARY ***
Total pot $31 | Rake $1.40 
Board [3s Js 9d]
Seat 1: app1e_j@ck (big blind) folded before Flop
Seat 2: jahwe folded before Flop (didn't bet)
Seat 3: se7en_$tars folded before Flop
Seat 4: Pocketstud folded before Flop
Seat 5: KingCastle77 folded before Flop (didn't bet)
Seat 6: Westpants collected ($29.60)
Seat 7: matiko09 folded before Flop (didn't bet)
Seat 8: PacPacBum (button) folded before Flop (didn't bet)
Seat 9: omorfadramou (small blind) folded on the Flop





PokerStars Hand #150803374257:  Hold'em No Limit ($0.50/$1.00 USD) - 2016/03/23 15:43:47 CET [2016/03/23 10:43:47 ET]
Table 'Asmodeus' 9-max Seat #2 is the button
Seat 1: Pok3rKidd ($80 in chips) 
Seat 2: PacPacBum ($100 in chips) 
Seat 4: Effort92 ($100 in chips) 
Seat 6: fuppeee ($173.42 in chips) 
Seat 7: mycka86 ($121.25 in chips) 
Seat 9: matiko09 ($103.50 in chips) 
Effort92: posts small blind $0.50
Muinmyheart: is sitting out 
fuppeee: posts big blind $1
ardo888: sits out 
Pok3rKidd: posts big blind $1
Pok3rKidd: posts the ante $0.20
PacPacBum: posts the ante $0.20
Effort92: posts the ante $0.20
fuppeee: posts the ante $0.20
mycka86: posts the ante $0.20
matiko09: posts the ante $0.20
*** HOLE CARDS ***
Dealt to matiko09 [8c 9c]
Muinmyheart leaves the table
edidaz joins the table at seat #5 
mycka86: raises $3 to $4
matiko09: folds 
edidaz leaves the table
Pok3rKidd: folds 
PacPacBum: folds 
Effort92: folds 
fuppeee: calls $3
*** FLOP *** [Js Jh Th]
fuppeee: checks 
mycka86: bets $5.62
fuppeee: calls $5.62
*** TURN *** [Js Jh Th] [4s]
fuppeee: checks 
mycka86: checks 
*** RIVER *** [Js Jh Th 4s] [Jd]
fuppeee: checks 
mycka86: checks 
*** SHOW DOWN ***
fuppeee: shows [Qs 8d] (three of a kind, Jacks)
mycka86: shows [2c Ac] (three of a kind, Jacks - Ace kicker)
mycka86 collected $20.95 from pot
*** SUMMARY ***
Total pot $21.94 | Rake $0.99 
Board [Js Jh Th 4s Jd]
Seat 1: Pok3rKidd folded before Flop
Seat 2: PacPacBum (button) folded before Flop (didn't bet)
Seat 4: Effort92 (small blind) folded before Flop
Seat 6: fuppeee (big blind) showed [Qs 8d] and lost with three of a kind, Jacks
Seat 7: mycka86 showed [2c Ac] and won ($20.95) with three of a kind, Jacks
Seat 9: matiko09 folded before Flop (didn't bet)





PokerStars Hand #150803374452:  Hold'em No Limit ($0.50/$1.00 USD) - 2016/03/23 15:43:47 CET [2016/03/23 10:43:47 ET]
Table 'Swings' 9-max Seat #9 is the button
Seat 1: lumen21 ($101.28 in chips) 
Seat 2: tomver0809 ($67.28 in chips) 
Seat 3: edidaz ($103.80 in chips) 
Seat 4: YuriiSolodya ($37.05 in chips) 
Seat 5: chautinhtri9 ($109.55 in chips) 
Seat 6: matiko09 ($144.99 in chips) 
Seat 7: PacPacBum ($121.99 in chips) 
Seat 8: RICKA16 ($105.96 in chips) 
Seat 9: Effort92 ($100 in chips) 
lumen21: posts small blind $0.50
tomver0809: posts big blind $1
*** HOLE CARDS ***
Dealt to matiko09 [8c 3d]
edidaz: folds 
YuriiSolodya: folds 
chautinhtri9: folds 
matiko09: folds 
PacPacBum: folds 
RICKA16: folds 
Effort92: folds 
lumen21: folds 
Uncalled bet ($0.50) returned to tomver0809
tomver0809 collected $1 from pot
tomver0809: doesn't show hand 
*** SUMMARY ***
Total pot $1 | Rake $0 
Seat 1: lumen21 (small blind) folded before Flop
Seat 2: tomver0809 (big blind) collected ($1)
Seat 3: edidaz folded before Flop (didn't bet)
Seat 4: YuriiSolodya folded before Flop (didn't bet)
Seat 5: chautinhtri9 folded before Flop (didn't bet)
Seat 6: matiko09 folded before Flop (didn't bet)
Seat 7: PacPacBum folded before Flop (didn't bet)
Seat 8: RICKA16 folded before Flop (didn't bet)
Seat 9: Effort92 (button) folded before Flop (didn't bet)





PokerStars Hand #150803377136:  Hold'em No Limit ($0.50/$1.00 USD) - 2016/03/23 15:43:56 CET [2016/03/23 10:43:56 ET]
Table 'Atlantis' 9-max Seat #7 is the button
Seat 1: Westpants ($100 in chips) 
Seat 2: Szevasztopol ($100 in chips) 
Seat 3: CAJUN890 ($78.91 in chips) 
Seat 4: mycka86 ($118.04 in chips) 
Seat 5: Durango-CO77 ($45.31 in chips) 
Seat 6: PacPacBum ($113.41 in chips) 
Seat 7: matiko09 ($137.61 in chips) 
Seat 9: RICKA16 ($148.28 in chips) 
RICKA16: posts small blind $0.50
Westpants: posts big blind $1
*** HOLE CARDS ***
Dealt to matiko09 [Th Ad]
Szevasztopol: folds 
CAJUN890: folds 
mycka86: folds 
Durango-CO77: folds 
PacPacBum: folds 
matiko09: raises $1.27 to $2.27
RICKA16: folds 
Westpants: folds 
Uncalled bet ($1.27) returned to matiko09
matiko09 collected $2.50 from pot
matiko09: doesn't show hand 
*** SUMMARY ***
Total pot $2.50 | Rake $0 
Seat 1: Westpants (big blind) folded before Flop
Seat 2: Szevasztopol folded before Flop (didn't bet)
Seat 3: CAJUN890 folded before Flop (didn't bet)
Seat 4: mycka86 folded before Flop (didn't bet)
Seat 5: Durango-CO77 folded before Flop (didn't bet)
Seat 6: PacPacBum folded before Flop (didn't bet)
Seat 7: matiko09 (button) collected ($2.50)
Seat 9: RICKA16 (small blind) folded before Flop





PokerStars Hand #150803378202:  Hold'em No Limit ($1/$2 USD) - 2016/03/23 15:43:59 CET [2016/03/23 10:43:59 ET]
Table 'Kiess' 9-max Seat #8 is the button
Seat 1: Cirilico ($241.37 in chips) 
Seat 2: jahwe ($200 in chips) 
Seat 3: Red4erT ($113.43 in chips) 
Seat 4: RamiroAgujis ($210.96 in chips) 
Seat 5: chippo boy ($462.43 in chips) 
Seat 6: matiko09 ($213.48 in chips) 
Seat 7: chaps1988 ($206.24 in chips) 
Seat 8: erfk1958 ($127.78 in chips) 
Seat 9: PacPacBum ($200 in chips) 
PacPacBum: posts small blind $1
Cirilico: posts big blind $2
*** HOLE CARDS ***
Dealt to matiko09 [Ts 8d]
jahwe: folds 
Red4erT: folds 
RamiroAgujis: raises $4 to $6
chippo boy: folds 
matiko09: folds 
chaps1988: folds 
erfk1958: folds 
PacPacBum: folds 
Cirilico: folds 
Uncalled bet ($4) returned to RamiroAgujis
RamiroAgujis collected $5 from pot
RamiroAgujis: doesn't show hand 
*** SUMMARY ***
Total pot $5 | Rake $0 
Seat 1: Cirilico (big blind) folded before Flop
Seat 2: jahwe folded before Flop (didn't bet)
Seat 3: Red4erT folded before Flop (didn't bet)
Seat 4: RamiroAgujis collected ($5)
Seat 5: chippo boy folded before Flop (didn't bet)
Seat 6: matiko09 folded before Flop (didn't bet)
Seat 7: chaps1988 folded before Flop (didn't bet)
Seat 8: erfk1958 (button) folded before Flop (didn't bet)
Seat 9: PacPacBum (small blind) folded before Flop





PokerStars Hand #150803378855:  Hold'em No Limit ($0.50/$1.00 USD) - 2016/03/23 15:44:01 CET [2016/03/23 10:44:01 ET]
Table 'Smiley' 9-max Seat #5 is the button
Seat 1: jahwe ($116.81 in chips) 
Seat 2: Jimy Tiltman ($100 in chips) 
Seat 3: mycka86 ($117 in chips) 
Seat 4: CAJUN890 ($80.19 in chips) 
Seat 5: Szevasztopol ($116.40 in chips) 
Seat 6: blackmont111 ($117.04 in chips) 
Seat 7: bennetb77 ($120.53 in chips) 
Seat 8: matiko09 ($101.08 in chips) 
Seat 9: PacPacBum ($102.81 in chips) 
blackmont111: posts small blind $0.50
bennetb77: posts big blind $1
*** HOLE CARDS ***
Dealt to matiko09 [Qh 2d]
matiko09: folds 
PacPacBum: folds 
jahwe: raises $1.50 to $2.50
Jimy Tiltman: folds 
mycka86: calls $2.50
CAJUN890: folds 
Szevasztopol: folds 
blackmont111: folds 
bennetb77: calls $1.50
*** FLOP *** [9c Ks 3s]
bennetb77: checks 
jahwe: bets $4.50
mycka86: calls $4.50
bennetb77: folds 
*** TURN *** [9c Ks 3s] [Th]
jahwe: checks 
mycka86: bets $11.70
jahwe: folds 
Uncalled bet ($11.70) returned to mycka86
mycka86 collected $16.24 from pot
*** SUMMARY ***
Total pot $17 | Rake $0.76 
Board [9c Ks 3s Th]
Seat 1: jahwe folded on the Turn
Seat 2: Jimy Tiltman folded before Flop (didn't bet)
Seat 3: mycka86 collected ($16.24)
Seat 4: CAJUN890 folded before Flop (didn't bet)
Seat 5: Szevasztopol (button) folded before Flop (didn't bet)
Seat 6: blackmont111 (small blind) folded before Flop
Seat 7: bennetb77 (big blind) folded on the Flop
Seat 8: matiko09 folded before Flop (didn't bet)
Seat 9: PacPacBum folded before Flop (didn't bet)





PokerStars Hand #150803379847:  Hold'em No Limit ($0.50/$1.00 USD) - 2016/03/23 15:44:04 CET [2016/03/23 10:44:04 ET]
Table 'Sylvia III' 9-max Seat #4 is the button
Seat 1: mycka86 ($133.10 in chips) 
Seat 2: ellis005 ($51.80 in chips) 
Seat 3: bigacsiga ($144.78 in chips) 
Seat 4: lombardo11 ($50.54 in chips) 
Seat 5: matiko09 ($100 in chips) 
Seat 6: PacPacBum ($122.44 in chips) 
Seat 7: jahwe ($103.82 in chips) 
Seat 8: Muinmyheart ($137.80 in chips) 
Seat 9: Jimy Tiltman ($100.40 in chips) 
matiko09: posts small blind $0.50
PacPacBum: posts big blind $1
mycka86: posts the ante $0.20
ellis005: posts the ante $0.20
bigacsiga: posts the ante $0.20
lombardo11: posts the ante $0.20
matiko09: posts the ante $0.20
PacPacBum: posts the ante $0.20
jahwe: posts the ante $0.20
Muinmyheart: posts the ante $0.20
Jimy Tiltman: posts the ante $0.20
*** HOLE CARDS ***
Dealt to matiko09 [4c 3d]
jahwe: folds 
Muinmyheart: raises $2 to $3
Jimy Tiltman: folds 
mycka86: folds 
ellis005: folds 
bigacsiga: folds 
lombardo11: folds 
matiko09: folds 
PacPacBum: folds 
Uncalled bet ($2) returned to Muinmyheart
Muinmyheart collected $4.30 from pot
Muinmyheart: doesn't show hand 
*** SUMMARY ***
Total pot $4.30 | Rake $0 
Seat 1: mycka86 folded before Flop (didn't bet)
Seat 2: ellis005 folded before Flop (didn't bet)
Seat 3: bigacsiga folded before Flop (didn't bet)
Seat 4: lombardo11 (button) folded before Flop (didn't bet)
Seat 5: matiko09 (small blind) folded before Flop
Seat 6: PacPacBum (big blind) folded before Flop
Seat 7: jahwe folded before Flop (didn't bet)
Seat 8: Muinmyheart collected ($4.30)
Seat 9: Jimy Tiltman folded before Flop (didn't bet)





PokerStars Hand #150803382762:  Hold'em No Limit (€0.50/€1.00 EUR) - 2016/03/23 15:44:13 CET [2016/03/23 10:44:13 ET]
Table 'Mercury III' 9-max Seat #8 is the button
Seat 1: matiko09 (€126.35 in chips) 
Seat 2: jahwe (€125.85 in chips) 
Seat 3: PacPacBum (€100 in chips) 
Seat 4: Muinmyheart (€101.50 in chips) 
Seat 5: ardo888 (€100 in chips) 
Seat 6: mycka86 (€100 in chips) 
Seat 7: STrakDD (€153.59 in chips) 
Seat 8: gfxed (€45.77 in chips) 
Seat 9: Indr3k (€100 in chips) 
Indr3k: posts small blind €0.50
matiko09: posts big blind €1
*** HOLE CARDS ***
Dealt to matiko09 [Ac 4h]
jahwe: folds 
PacPacBum: folds 
Muinmyheart: folds 
ardo888: raises €2 to €3
mycka86: folds 
STrakDD: folds 
gfxed: folds 
Indr3k: folds 
matiko09: folds 
Uncalled bet (€2) returned to ardo888
ardo888 collected €2.50 from pot
ardo888: doesn't show hand 
*** SUMMARY ***
Total pot €2.50 | Rake €0 
Seat 1: matiko09 (big blind) folded before Flop
Seat 2: jahwe folded before Flop (didn't bet)
Seat 3: PacPacBum folded before Flop (didn't bet)
Seat 4: Muinmyheart folded before Flop (didn't bet)
Seat 5: ardo888 collected (€2.50)
Seat 6: mycka86 folded before Flop (didn't bet)
Seat 7: STrakDD folded before Flop (didn't bet)
Seat 8: gfxed (button) folded before Flop (didn't bet)
Seat 9: Indr3k (small blind) folded before Flop





PokerStars Hand #150803385088:  Hold'em No Limit ($0.50/$1.00 USD) - 2016/03/23 15:44:20 CET [2016/03/23 10:44:20 ET]
Table 'Haug II' 9-max Seat #6 is the button
Seat 1: PacPacBum ($100 in chips) 
Seat 2: ardo888 ($100 in chips) 
Seat 3: Do-Man22 ($100 in chips) 
Seat 4: matiko09 ($120.62 in chips) 
Seat 5: GlamDragon ($101.84 in chips) 
Seat 6: Pocketstud ($106.69 in chips) 
Seat 7: jahwe ($105.69 in chips) 
Seat 8: BRIGANTE49 ($128.76 in chips) 
jahwe: posts small blind $0.50
BRIGANTE49: posts big blind $1
flk.Dasas: sits out 
Do-Man22: posts big blind $1
PacPacBum: posts the ante $0.20
ardo888: posts the ante $0.20
Do-Man22: posts the ante $0.20
matiko09: posts the ante $0.20
GlamDragon: posts the ante $0.20
Pocketstud: posts the ante $0.20
jahwe: posts the ante $0.20
BRIGANTE49: posts the ante $0.20
*** HOLE CARDS ***
Dealt to matiko09 [Jh 9s]
PacPacBum: folds 
ardo888: folds 
Do-Man22: checks 
matiko09: folds 
GlamDragon: folds 
Pocketstud: folds 
jahwe: raises $3 to $4
BRIGANTE49: calls $3
Do-Man22: folds 
*** FLOP *** [8s 5d Ad]
jahwe: bets $6.78
BRIGANTE49: raises $12.22 to $19
jahwe: calls $12.22
*** TURN *** [8s 5d Ad] [7c]
jahwe: checks 
BRIGANTE49: bets $23
jahwe: calls $23
*** RIVER *** [8s 5d Ad 7c] [8c]
jahwe: checks 
BRIGANTE49: checks 
*** SHOW DOWN ***
jahwe: shows [7d Td] (two pair, Eights and Sevens)
BRIGANTE49: shows [5s Ac] (two pair, Aces and Eights)
BRIGANTE49 collected $91.80 from pot
*** SUMMARY ***
Total pot $94.60 | Rake $2.80 
Board [8s 5d Ad 7c 8c]
Seat 1: PacPacBum folded before Flop (didn't bet)
Seat 2: ardo888 folded before Flop (didn't bet)
Seat 3: Do-Man22 folded before Flop
Seat 4: matiko09 folded before Flop (didn't bet)
Seat 5: GlamDragon folded before Flop (didn't bet)
Seat 6: Pocketstud (button) folded before Flop (didn't bet)
Seat 7: jahwe (small blind) showed [7d Td] and lost with two pair, Eights and Sevens
Seat 8: BRIGANTE49 (big blind) showed [5s Ac] and won ($91.80) with two pair, Aces and Eights





PokerStars Hand #150803385421:  Hold'em No Limit ($0.50/$1.00 USD) - 2016/03/23 15:44:21 CET [2016/03/23 10:44:21 ET]
Table 'Atlantis' 9-max Seat #9 is the button
Seat 1: Westpants ($100 in chips) 
Seat 2: Szevasztopol ($100 in chips) 
Seat 3: CAJUN890 ($78.91 in chips) 
Seat 4: mycka86 ($118.04 in chips) 
Seat 5: Durango-CO77 ($45.31 in chips) 
Seat 6: PacPacBum ($113.41 in chips) 
Seat 7: matiko09 ($139.11 in chips) 
Seat 9: RICKA16 ($147.78 in chips) 
Westpants: posts small blind $0.50
Szevasztopol: posts big blind $1
*** HOLE CARDS ***
Dealt to matiko09 [Tc 3h]
CAJUN890: calls $1
mycka86: folds 
Durango-CO77: folds 
PacPacBum: folds 
matiko09: folds 
RICKA16: raises $2 to $3
Westpants: folds 
Szevasztopol: folds 
CAJUN890: calls $2
*** FLOP *** [As 5d 5h]
CAJUN890: checks 
RICKA16: bets $5
CAJUN890: raises $6 to $11
RICKA16: calls $6
*** TURN *** [As 5d 5h] [6s]
CAJUN890: checks 
RICKA16: checks 
*** RIVER *** [As 5d 5h 6s] [Kh]
CAJUN890: bets $17
RICKA16: calls $17
*** SHOW DOWN ***
CAJUN890: shows [8d 7d] (a pair of Fives)
RICKA16: shows [Ac 8c] (two pair, Aces and Fives)
RICKA16 collected $60.70 from pot
*** SUMMARY ***
Total pot $63.50 | Rake $2.80 
Board [As 5d 5h 6s Kh]
Seat 1: Westpants (small blind) folded before Flop
Seat 2: Szevasztopol (big blind) folded before Flop
Seat 3: CAJUN890 showed [8d 7d] and lost with a pair of Fives
Seat 4: mycka86 folded before Flop (didn't bet)
Seat 5: Durango-CO77 folded before Flop (didn't bet)
Seat 6: PacPacBum folded before Flop (didn't bet)
Seat 7: matiko09 folded before Flop (didn't bet)
Seat 9: RICKA16 (button) showed [Ac 8c] and won ($60.70) with two pair, Aces and Fives





PokerStars Hand #150803386938:  Hold'em No Limit ($0.50/$1.00 USD) - 2016/03/23 15:44:26 CET [2016/03/23 10:44:26 ET]
Table 'Swings' 9-max Seat #1 is the button
Seat 1: lumen21 ($100.78 in chips) 
Seat 2: tomver0809 ($67.78 in chips) 
Seat 3: edidaz ($103.80 in chips) 
Seat 4: YuriiSolodya ($37.05 in chips) 
Seat 5: chautinhtri9 ($109.55 in chips) 
Seat 6: matiko09 ($144.99 in chips) 
Seat 7: PacPacBum ($121.99 in chips) 
Seat 8: RICKA16 ($105.96 in chips) 
Seat 9: Effort92 ($100 in chips) 
tomver0809: posts small blind $0.50
edidaz: posts big blind $1
*** HOLE CARDS ***
Dealt to matiko09 [7d 4s]
YuriiSolodya: raises $1 to $2
chautinhtri9: folds 
matiko09: folds 
PacPacBum: folds 
RICKA16: folds 
Effort92: folds 
lumen21: folds 
tomver0809: calls $1.50
edidaz: folds 
*** FLOP *** [Ad 6c 8h]
tomver0809: checks 
YuriiSolodya: bets $4.78
tomver0809: folds 
Uncalled bet ($4.78) returned to YuriiSolodya
YuriiSolodya collected $4.78 from pot
YuriiSolodya: doesn't show hand 
*** SUMMARY ***
Total pot $5 | Rake $0.22 
Board [Ad 6c 8h]
Seat 1: lumen21 (button) folded before Flop (didn't bet)
Seat 2: tomver0809 (small blind) folded on the Flop
Seat 3: edidaz (big blind) folded before Flop
Seat 4: YuriiSolodya collected ($4.78)
Seat 5: chautinhtri9 folded before Flop (didn't bet)
Seat 6: matiko09 folded before Flop (didn't bet)
Seat 7: PacPacBum folded before Flop (didn't bet)
Seat 8: RICKA16 folded before Flop (didn't bet)
Seat 9: Effort92 folded before Flop (didn't bet)





PokerStars Hand #150803388444:  Hold'em No Limit ($0.50/$1.00 USD) - 2016/03/23 15:44:30 CET [2016/03/23 10:44:30 ET]
Table 'Sylvia III' 9-max Seat #5 is the button
Seat 1: mycka86 ($132.90 in chips) 
Seat 2: ellis005 ($51.60 in chips) 
Seat 3: bigacsiga ($144.58 in chips) 
Seat 4: lombardo11 ($50.34 in chips) 
Seat 5: matiko09 ($100 in chips) 
Seat 6: PacPacBum ($121.24 in chips) 
PacPacBum: posts small blind $0.50
Muinmyheart: is sitting out 
Jimy Tiltman: is sitting out 
mycka86: posts big blind $1
mycka86: posts the ante $0.20
ellis005: posts the ante $0.20
bigacsiga: posts the ante $0.20
lombardo11: posts the ante $0.20
matiko09: posts the ante $0.20
PacPacBum: posts the ante $0.20
*** HOLE CARDS ***
Dealt to matiko09 [4h 3d]
Jimy Tiltman leaves the table
Muinmyheart leaves the table
edidaz joins the table at seat #8 
ellis005: folds 
bigacsiga: folds 
edidaz leaves the table
lombardo11: raises $2 to $3
matiko09: folds 
PacPacBum: folds 
mycka86: folds 
Uncalled bet ($2) returned to lombardo11
lombardo11 collected $3.70 from pot
lombardo11: doesn't show hand 
*** SUMMARY ***
Total pot $3.70 | Rake $0 
Seat 1: mycka86 (big blind) folded before Flop
Seat 2: ellis005 folded before Flop (didn't bet)
Seat 3: bigacsiga folded before Flop (didn't bet)
Seat 4: lombardo11 collected ($3.70)
Seat 5: matiko09 (button) folded before Flop (didn't bet)
Seat 6: PacPacBum (small blind) folded before Flop





PokerStars Hand #150803391518:  Hold'em No Limit ($1/$2 USD) - 2016/03/23 15:44:40 CET [2016/03/23 10:44:40 ET]
Table 'Kiess' 9-max Seat #9 is the button
Seat 1: Cirilico ($239.37 in chips) 
Seat 3: Red4erT ($113.43 in chips) 
Seat 4: RamiroAgujis ($213.96 in chips) 
Seat 5: chippo boy ($462.43 in chips) 
Seat 6: matiko09 ($213.48 in chips) 
Seat 7: chaps1988 ($206.24 in chips) 
Seat 8: erfk1958 ($127.78 in chips) 
Seat 9: PacPacBum ($200 in chips) 
Cirilico: posts small blind $1
Red4erT: posts big blind $2
*** HOLE CARDS ***
Dealt to matiko09 [2c 3c]
RamiroAgujis: folds 
chippo boy: folds 
matiko09: folds 
chaps1988: raises $3 to $5
erfk1958: folds 
PacPacBum: folds 
Cirilico: folds 
Red4erT: calls $3
*** FLOP *** [Jc Ac 4s]
Red4erT: checks 
chaps1988: checks 
*** TURN *** [Jc Ac 4s] [6s]
Red4erT: bets $7.88
chaps1988: raises $14.12 to $22
Red4erT: folds 
Uncalled bet ($14.12) returned to chaps1988
chaps1988 collected $25.56 from pot
chaps1988: doesn't show hand 
*** SUMMARY ***
Total pot $26.76 | Rake $1.20 
Board [Jc Ac 4s 6s]
Seat 1: Cirilico (small blind) folded before Flop
Seat 3: Red4erT (big blind) folded on the Turn
Seat 4: RamiroAgujis folded before Flop (didn't bet)
Seat 5: chippo boy folded before Flop (didn't bet)
Seat 6: matiko09 folded before Flop (didn't bet)
Seat 7: chaps1988 collected ($25.56)
Seat 8: erfk1958 folded before Flop (didn't bet)
Seat 9: PacPacBum (button) folded before Flop (didn't bet)





PokerStars Hand #150803394331:  Hold'em No Limit (€0.50/€1.00 EUR) - 2016/03/23 15:44:48 CET [2016/03/23 10:44:48 ET]
Table 'Mercury III' 9-max Seat #9 is the button
Seat 1: matiko09 (€125.35 in chips) 
Seat 3: PacPacBum (€100 in chips) 
Seat 4: Muinmyheart (€101.50 in chips) 
Seat 5: ardo888 (€101.50 in chips) 
Seat 6: mycka86 (€100 in chips) 
Seat 7: STrakDD (€153.59 in chips) 
Seat 8: gfxed (€45.77 in chips) 
Seat 9: Indr3k (€100 in chips) 
matiko09: posts small blind €0.50
PacPacBum: posts big blind €1
*** HOLE CARDS ***
Dealt to matiko09 [2h Qs]
Muinmyheart: folds 
ardo888: folds 
mycka86: folds 
STrakDD: raises €2 to €3
gfxed: folds 
Indr3k: folds 
matiko09: folds 
PacPacBum: folds 
Uncalled bet (€2) returned to STrakDD
STrakDD collected €2.50 from pot
STrakDD: doesn't show hand 
*** SUMMARY ***
Total pot €2.50 | Rake €0 
Seat 1: matiko09 (small blind) folded before Flop
Seat 3: PacPacBum (big blind) folded before Flop
Seat 4: Muinmyheart folded before Flop (didn't bet)
Seat 5: ardo888 folded before Flop (didn't bet)
Seat 6: mycka86 folded before Flop (didn't bet)
Seat 7: STrakDD collected (€2.50)
Seat 8: gfxed folded before Flop (didn't bet)
Seat 9: Indr3k (button) folded before Flop (didn't bet)





PokerStars Hand #150803394171:  Hold'em No Limit ($0.50/$1.00 USD) - 2016/03/23 15:44:48 CET [2016/03/23 10:44:48 ET]
Table 'Asmodeus' 9-max Seat #4 is the button
Seat 1: Pok3rKidd ($78.80 in chips) 
Seat 2: PacPacBum ($100 in chips) 
Seat 4: Effort92 ($100 in chips) 
Seat 6: fuppeee ($163.60 in chips) 
Seat 7: mycka86 ($132.38 in chips) 
Seat 9: matiko09 ($103.30 in chips) 
fuppeee: posts small blind $0.50
mycka86: posts big blind $1
ardo888: sits out 
Pok3rKidd: posts the ante $0.20
PacPacBum: posts the ante $0.20
Effort92: posts the ante $0.20
fuppeee: posts the ante $0.20
mycka86: posts the ante $0.20
matiko09: posts the ante $0.20
*** HOLE CARDS ***
Dealt to matiko09 [Qc Jh]
matiko09: folds 
Pok3rKidd: folds 
PacPacBum: folds 
Effort92: raises $2 to $3
Pok3rKidd leaves the table
fuppeee: folds 
edidaz joins the table at seat #1 
mycka86: calls $2
*** FLOP *** [6h 9s 8d]
edidaz leaves the table
mycka86: checks 
Effort92: checks 
*** TURN *** [6h 9s 8d] [Kh]
mycka86: bets $5.30
Muinmyheart joins the table at seat #1 
Effort92: calls $5.30
*** RIVER *** [6h 9s 8d Kh] [Tc]
DrunkPatrik joins the table at seat #5 
mycka86: bets $12.20
Effort92: calls $12.20
*** SHOW DOWN ***
mycka86: shows [Ks Ts] (two pair, Kings and Tens)
Effort92: shows [6s 7s] (a straight, Six to Ten)
Effort92 collected $40.78 from pot
*** SUMMARY ***
Total pot $42.70 | Rake $1.92 
Board [6h 9s 8d Kh Tc]
Seat 1: Pok3rKidd folded before Flop (didn't bet)
Seat 2: PacPacBum folded before Flop (didn't bet)
Seat 4: Effort92 (button) showed [6s 7s] and won ($40.78) with a straight, Six to Ten
Seat 6: fuppeee (small blind) folded before Flop
Seat 7: mycka86 (big blind) showed [Ks Ts] and lost with two pair, Kings and Tens
Seat 9: matiko09 folded before Flop (didn't bet)





PokerStars Hand #150803400537:  Hold'em No Limit ($0.50/$1.00 USD) - 2016/03/23 15:45:08 CET [2016/03/23 10:45:08 ET]
Table 'Aetolia II' 9-max Seat #9 is the button
Seat 1: app1e_j@ck ($100 in chips) 
Seat 3: se7en_$tars ($80.50 in chips) 
Seat 4: Pocketstud ($116.52 in chips) 
Seat 5: KingCastle77 ($96.76 in chips) 
Seat 6: Westpants ($132.78 in chips) 
Seat 7: matiko09 ($100 in chips) 
Seat 8: PacPacBum ($104.60 in chips) 
Seat 9: omorfadramou ($100 in chips) 
app1e_j@ck: posts small blind $0.50
se7en_$tars: posts big blind $1
*** HOLE CARDS ***
Dealt to matiko09 [As 4d]
Pocketstud: raises $2 to $3
KingCastle77: folds 
Westpants: folds 
matiko09: folds 
PacPacBum: folds 
omorfadramou: folds 
app1e_j@ck: folds 
se7en_$tars: calls $2
*** FLOP *** [4s Td 6d]
se7en_$tars: bets $3
Pocketstud: raises $3 to $6
se7en_$tars: calls $3
*** TURN *** [4s Td 6d] [3d]
se7en_$tars: checks 
Pocketstud: bets $7
se7en_$tars: calls $7
*** RIVER *** [4s Td 6d 3d] [6s]
se7en_$tars: checks 
Pocketstud: checks 
*** SHOW DOWN ***
se7en_$tars: shows [Tc Jd] (two pair, Tens and Sixes)
Pocketstud: shows [Kh Kc] (two pair, Kings and Sixes)
Pocketstud collected $31.04 from pot
*** SUMMARY ***
Total pot $32.50 | Rake $1.46 
Board [4s Td 6d 3d 6s]
Seat 1: app1e_j@ck (small blind) folded before Flop
Seat 3: se7en_$tars (big blind) showed [Tc Jd] and lost with two pair, Tens and Sixes
Seat 4: Pocketstud showed [Kh Kc] and won ($31.04) with two pair, Kings and Sixes
Seat 5: KingCastle77 folded before Flop (didn't bet)
Seat 6: Westpants folded before Flop (didn't bet)
Seat 7: matiko09 folded before Flop (didn't bet)
Seat 8: PacPacBum folded before Flop (didn't bet)
Seat 9: omorfadramou (button) folded before Flop (didn't bet)





PokerStars Hand #150803402999:  Hold'em No Limit ($0.50/$1.00 USD) - 2016/03/23 15:45:15 CET [2016/03/23 10:45:15 ET]
Table 'Sylvia III' 9-max Seat #6 is the button
Seat 1: mycka86 ($131.70 in chips) 
Seat 2: ellis005 ($99.80 in chips) 
Seat 3: bigacsiga ($144.38 in chips) 
Seat 4: lombardo11 ($52.84 in chips) 
Seat 5: matiko09 ($100 in chips) 
Seat 6: PacPacBum ($120.54 in chips) 
mycka86: posts small blind $0.50
ellis005: posts big blind $1
mycka86: posts the ante $0.20
ellis005: posts the ante $0.20
bigacsiga: posts the ante $0.20
lombardo11: posts the ante $0.20
matiko09: posts the ante $0.20
PacPacBum: posts the ante $0.20
*** HOLE CARDS ***
Dealt to matiko09 [Qh 7s]
bigacsiga: folds 
lombardo11: raises $1 to $2
matiko09: folds 
PacPacBum: folds 
mycka86: folds 
ellis005: calls $1
*** FLOP *** [4s Kd Ks]
ardo888 joins the table at seat #8 
ellis005: checks 
lombardo11: checks 
*** TURN *** [4s Kd Ks] [6s]
ellis005: checks 
lombardo11: checks 
*** RIVER *** [4s Kd Ks 6s] [8s]
ellis005: checks 
lombardo11: checks 
*** SHOW DOWN ***
ellis005: shows [3s 6h] (a flush, King high)
lombardo11: mucks hand 
ellis005 collected $5.44 from pot
*** SUMMARY ***
Total pot $5.70 | Rake $0.26 
Board [4s Kd Ks 6s 8s]
Seat 1: mycka86 (small blind) folded before Flop
Seat 2: ellis005 (big blind) showed [3s 6h] and won ($5.44) with a flush, King high
Seat 3: bigacsiga folded before Flop (didn't bet)
Seat 4: lombardo11 mucked [Th Ac]
Seat 5: matiko09 folded before Flop (didn't bet)
Seat 6: PacPacBum (button) folded before Flop (didn't bet)





PokerStars Hand #150803404886:  Hold'em No Limit ($0.50/$1.00 USD) - 2016/03/23 15:45:21 CET [2016/03/23 10:45:21 ET]
Table 'Swings' 9-max Seat #2 is the button
Seat 1: lumen21 ($100.78 in chips) 
Seat 2: tomver0809 ($65.78 in chips) 
Seat 3: edidaz ($102.80 in chips) 
Seat 4: YuriiSolodya ($39.83 in chips) 
Seat 5: chautinhtri9 ($109.55 in chips) 
Seat 6: matiko09 ($144.99 in chips) 
Seat 7: PacPacBum ($121.99 in chips) 
Seat 8: RICKA16 ($105.96 in chips) 
Seat 9: Effort92 ($100 in chips) 
edidaz: posts small blind $0.50
YuriiSolodya: posts big blind $1
*** HOLE CARDS ***
Dealt to matiko09 [7h 2h]
chautinhtri9: folds 
matiko09: folds 
PacPacBum: folds 
RICKA16: folds 
Effort92: folds 
lumen21: folds 
tomver0809: calls $1
edidaz: calls $0.50
YuriiSolodya: checks 
*** FLOP *** [Jd 5d 8d]
edidaz: bets $2.28
YuriiSolodya: folds 
tomver0809: calls $2.28
*** TURN *** [Jd 5d 8d] [Ac]
edidaz: checks 
tomver0809: bets $3
edidaz: calls $3
*** RIVER *** [Jd 5d 8d Ac] [As]
edidaz: checks 
tomver0809: bets $3
edidaz: folds 
Uncalled bet ($3) returned to tomver0809
tomver0809 collected $12.95 from pot
tomver0809: doesn't show hand 
*** SUMMARY ***
Total pot $13.56 | Rake $0.61 
Board [Jd 5d 8d Ac As]
Seat 1: lumen21 folded before Flop (didn't bet)
Seat 2: tomver0809 (button) collected ($12.95)
Seat 3: edidaz (small blind) folded on the River
Seat 4: YuriiSolodya (big blind) folded on the Flop
Seat 5: chautinhtri9 folded before Flop (didn't bet)
Seat 6: matiko09 folded before Flop (didn't bet)
Seat 7: PacPacBum folded before Flop (didn't bet)
Seat 8: RICKA16 folded before Flop (didn't bet)
Seat 9: Effort92 folded before Flop (didn't bet)





PokerStars Hand #150803405018:  Hold'em No Limit (€0.50/€1.00 EUR) - 2016/03/23 15:45:21 CET [2016/03/23 10:45:21 ET]
Table 'Mercury III' 9-max Seat #1 is the button
Seat 1: matiko09 (€124.85 in chips) 
Seat 3: PacPacBum (€100 in chips) 
Seat 4: Muinmyheart (€101.50 in chips) 
Seat 5: ardo888 (€101.50 in chips) 
Seat 6: mycka86 (€100 in chips) 
Seat 7: STrakDD (€155.09 in chips) 
Seat 8: gfxed (€45.77 in chips) 
Seat 9: Indr3k (€100 in chips) 
PacPacBum: posts small blind €0.50
Muinmyheart: posts big blind €1
*** HOLE CARDS ***
Dealt to matiko09 [9c Qs]
ardo888: raises €2 to €3
mycka86: folds 
STrakDD: folds 
gfxed: calls €3
Indr3k: folds 
matiko09: folds 
PacPacBum: folds 
Muinmyheart: calls €2
*** FLOP *** [3d Ts Kd]
Muinmyheart: checks 
ardo888: bets €5.50
gfxed: folds 
Muinmyheart: raises €10 to €15.50
ardo888: calls €10
*** TURN *** [3d Ts Kd] [4c]
Muinmyheart: bets €19.50
ardo888: folds 
Uncalled bet (€19.50) returned to Muinmyheart
Muinmyheart collected €38.68 from pot
Muinmyheart: doesn't show hand 
*** SUMMARY ***
Total pot €40.50 | Rake €1.82 
Board [3d Ts Kd 4c]
Seat 1: matiko09 (button) folded before Flop (didn't bet)
Seat 3: PacPacBum (small blind) folded before Flop
Seat 4: Muinmyheart (big blind) collected (€38.68)
Seat 5: ardo888 folded on the Turn
Seat 6: mycka86 folded before Flop (didn't bet)
Seat 7: STrakDD folded before Flop (didn't bet)
Seat 8: gfxed folded on the Flop
Seat 9: Indr3k folded before Flop (didn't bet)





PokerStars Hand #150803409105:  Hold'em No Limit ($0.50/$1.00 USD) - 2016/03/23 15:45:34 CET [2016/03/23 10:45:34 ET]
Table 'Smiley' 9-max Seat #6 is the button
Seat 1: jahwe ($109.81 in chips) 
Seat 2: Jimy Tiltman ($100 in chips) 
Seat 3: mycka86 ($126.24 in chips) 
Seat 4: CAJUN890 ($80.19 in chips) 
Seat 5: Szevasztopol ($116.40 in chips) 
Seat 6: blackmont111 ($116.54 in chips) 
Seat 7: bennetb77 ($118.03 in chips) 
Seat 8: matiko09 ($101.08 in chips) 
Seat 9: PacPacBum ($102.81 in chips) 
bennetb77: posts small blind $0.50
matiko09: posts big blind $1
*** HOLE CARDS ***
Dealt to matiko09 [6h Jd]
PacPacBum: folds 
jahwe: folds 
Jimy Tiltman: folds 
mycka86: raises $2 to $3
CAJUN890: folds 
Szevasztopol: folds 
blackmont111: folds 
bennetb77: folds 
matiko09: folds 
Uncalled bet ($2) returned to mycka86
mycka86 collected $2.50 from pot
*** SUMMARY ***
Total pot $2.50 | Rake $0 
Seat 1: jahwe folded before Flop (didn't bet)
Seat 2: Jimy Tiltman folded before Flop (didn't bet)
Seat 3: mycka86 collected ($2.50)
Seat 4: CAJUN890 folded before Flop (didn't bet)
Seat 5: Szevasztopol folded before Flop (didn't bet)
Seat 6: blackmont111 (button) folded before Flop (didn't bet)
Seat 7: bennetb77 (small blind) folded before Flop
Seat 8: matiko09 (big blind) folded before Flop
Seat 9: PacPacBum folded before Flop (didn't bet)





PokerStars Hand #150803410304:  Hold'em No Limit ($0.50/$1.00 USD) - 2016/03/23 15:45:38 CET [2016/03/23 10:45:38 ET]
Table 'Drakonia II' 9-max Seat #5 is the button
Seat 1: chautinhtri9 ($118 in chips) 
Seat 2: RICKA16 ($102.44 in chips) 
Seat 3: PacPacBum ($100 in chips) 
Seat 4: Jimy Tiltman ($117.26 in chips) 
Seat 5: Muinmyheart ($100 in chips) 
Seat 7: YuriiSolodya ($51.38 in chips) 
Seat 8: matiko09 ($100 in chips) 
Seat 9: mycka86 ($100 in chips) 
YuriiSolodya: posts small blind $0.50
matiko09: posts big blind $1
*** HOLE CARDS ***
Dealt to matiko09 [Th 7c]
mycka86: folds 
chautinhtri9: folds 
RICKA16: folds 
PacPacBum: folds 
Jimy Tiltman: raises $2 to $3
Muinmyheart: folds 
YuriiSolodya: folds 
matiko09: folds 
Uncalled bet ($2) returned to Jimy Tiltman
Jimy Tiltman collected $2.50 from pot
Jimy Tiltman: doesn't show hand 
*** SUMMARY ***
Total pot $2.50 | Rake $0 
Seat 1: chautinhtri9 folded before Flop (didn't bet)
Seat 2: RICKA16 folded before Flop (didn't bet)
Seat 3: PacPacBum folded before Flop (didn't bet)
Seat 4: Jimy Tiltman collected ($2.50)
Seat 5: Muinmyheart (button) folded before Flop (didn't bet)
Seat 7: YuriiSolodya (small blind) folded before Flop
Seat 8: matiko09 (big blind) folded before Flop
Seat 9: mycka86 folded before Flop (didn't bet)





PokerStars Hand #150803411599:  Hold'em No Limit (€0.50/€1.00 EUR) - 2016/03/23 15:45:42 CET [2016/03/23 10:45:42 ET]
Table 'Volga III' 9-max Seat #9 is the button
Seat 2: GW92RP (€133.66 in chips) 
Seat 3: matiko09 (€100 in chips) 
Seat 4: bigacsiga (€110.26 in chips) 
Seat 6: PacPacBum (€100 in chips) 
Seat 7: jahwe (€100 in chips) 
Seat 9: ardo888 (€134.86 in chips) 
GW92RP: posts small blind €0.50
matiko09: posts big blind €1
finchaplin: sits out 
app1e_j@ck: sits out 
*** HOLE CARDS ***
Dealt to matiko09 [5d 9h]
bigacsiga: folds 
PacPacBum: folds 
jahwe: folds 
ardo888: folds 
GW92RP: folds 
Uncalled bet (€0.50) returned to matiko09
matiko09 collected €1 from pot
matiko09: doesn't show hand 
*** SUMMARY ***
Total pot €1 | Rake €0 
Seat 2: GW92RP (small blind) folded before Flop
Seat 3: matiko09 (big blind) collected (€1)
Seat 4: bigacsiga folded before Flop (didn't bet)
Seat 6: PacPacBum folded before Flop (didn't bet)
Seat 7: jahwe folded before Flop (didn't bet)
Seat 9: ardo888 (button) folded before Flop (didn't bet)





PokerStars Hand #150803414682:  Hold'em No Limit ($0.50/$1.00 USD) - 2016/03/23 15:45:52 CET [2016/03/23 10:45:52 ET]
Table 'Atlantis' 9-max Seat #1 is the button
Seat 1: Westpants ($100 in chips) 
Seat 2: Szevasztopol ($100 in chips) 
Seat 3: CAJUN890 ($47.91 in chips) 
Seat 4: mycka86 ($118.04 in chips) 
Seat 5: Durango-CO77 ($45.31 in chips) 
Seat 6: PacPacBum ($113.41 in chips) 
Seat 7: matiko09 ($139.11 in chips) 
Seat 9: RICKA16 ($177.48 in chips) 
Szevasztopol: posts small blind $0.50
CAJUN890: posts big blind $1
*** HOLE CARDS ***
Dealt to matiko09 [5c 6d]
mycka86: folds 
Durango-CO77: folds 
PacPacBum: folds 
matiko09: folds 
RICKA16: raises $2 to $3
Westpants: folds 
Szevasztopol: folds 
CAJUN890: folds 
Uncalled bet ($2) returned to RICKA16
RICKA16 collected $2.50 from pot
RICKA16: doesn't show hand 
*** SUMMARY ***
Total pot $2.50 | Rake $0 
Seat 1: Westpants (button) folded before Flop (didn't bet)
Seat 2: Szevasztopol (small blind) folded before Flop
Seat 3: CAJUN890 (big blind) folded before Flop
Seat 4: mycka86 folded before Flop (didn't bet)
Seat 5: Durango-CO77 folded before Flop (didn't bet)
Seat 6: PacPacBum folded before Flop (didn't bet)
Seat 7: matiko09 folded before Flop (didn't bet)
Seat 9: RICKA16 collected ($2.50)





PokerStars Hand #150803416916:  Hold'em No Limit (€0.50/€1.00 EUR) - 2016/03/23 15:45:58 CET [2016/03/23 10:45:58 ET]
Table 'Volga III' 9-max Seat #2 is the button
Seat 2: GW92RP (€133.16 in chips) 
Seat 3: matiko09 (€100.50 in chips) 
Seat 4: bigacsiga (€110.26 in chips) 
Seat 6: PacPacBum (€100 in chips) 
Seat 7: jahwe (€100 in chips) 
Seat 9: ardo888 (€134.86 in chips) 
matiko09: posts small blind €0.50
bigacsiga: posts big blind €1
finchaplin: sits out 
app1e_j@ck: sits out 
*** HOLE CARDS ***
Dealt to matiko09 [8s 6h]
PacPacBum: folds 
jahwe: folds 
ardo888: folds 
GW92RP: folds 
matiko09: folds 
Uncalled bet (€0.50) returned to bigacsiga
bigacsiga collected €1 from pot
bigacsiga: doesn't show hand 
*** SUMMARY ***
Total pot €1 | Rake €0 
Seat 2: GW92RP (button) folded before Flop (didn't bet)
Seat 3: matiko09 (small blind) folded before Flop
Seat 4: bigacsiga (big blind) collected (€1)
Seat 6: PacPacBum folded before Flop (didn't bet)
Seat 7: jahwe folded before Flop (didn't bet)
Seat 9: ardo888 folded before Flop (didn't bet)





PokerStars Hand #150803417122:  Hold'em No Limit ($0.50/$1.00 USD) - 2016/03/23 15:45:59 CET [2016/03/23 10:45:59 ET]
Table 'Drakonia II' 9-max Seat #7 is the button
Seat 1: chautinhtri9 ($118 in chips) 
Seat 2: RICKA16 ($102.44 in chips) 
Seat 3: PacPacBum ($100 in chips) 
Seat 4: Jimy Tiltman ($118.76 in chips) 
Seat 5: Muinmyheart ($100 in chips) 
Seat 7: YuriiSolodya ($50.88 in chips) 
Seat 8: matiko09 ($100 in chips) 
Seat 9: mycka86 ($100 in chips) 
matiko09: posts small blind $0.50
mycka86: posts big blind $1
*** HOLE CARDS ***
Dealt to matiko09 [8s 4s]
chautinhtri9: folds 
RICKA16: folds 
PacPacBum: folds 
Jimy Tiltman: raises $2 to $3
Muinmyheart: folds 
YuriiSolodya: folds 
matiko09: folds 
mycka86: folds 
Uncalled bet ($2) returned to Jimy Tiltman
Jimy Tiltman collected $2.50 from pot
Jimy Tiltman: doesn't show hand 
*** SUMMARY ***
Total pot $2.50 | Rake $0 
Seat 1: chautinhtri9 folded before Flop (didn't bet)
Seat 2: RICKA16 folded before Flop (didn't bet)
Seat 3: PacPacBum folded before Flop (didn't bet)
Seat 4: Jimy Tiltman collected ($2.50)
Seat 5: Muinmyheart folded before Flop (didn't bet)
Seat 7: YuriiSolodya (button) folded before Flop (didn't bet)
Seat 8: matiko09 (small blind) folded before Flop
Seat 9: mycka86 (big blind) folded before Flop





PokerStars Hand #150803419045:  Hold'em No Limit ($0.50/$1.00 USD) - 2016/03/23 15:46:05 CET [2016/03/23 10:46:05 ET]
Table 'Atlantis' 9-max Seat #2 is the button
Seat 1: Westpants ($100 in chips) 
Seat 2: Szevasztopol ($100 in chips) 
Seat 3: CAJUN890 ($46.91 in chips) 
Seat 4: mycka86 ($118.04 in chips) 
Seat 5: Durango-CO77 ($45.31 in chips) 
Seat 6: PacPacBum ($113.41 in chips) 
Seat 7: matiko09 ($139.11 in chips) 
Seat 9: RICKA16 ($178.98 in chips) 
CAJUN890: posts small blind $0.50
mycka86: posts big blind $1
*** HOLE CARDS ***
Dealt to matiko09 [3c 4h]
Durango-CO77: calls $1
PacPacBum: folds 
matiko09: folds 
RICKA16: folds 
Westpants: folds 
Szevasztopol: raises $4 to $5
CAJUN890: folds 
mycka86: folds 
Durango-CO77: calls $4
*** FLOP *** [Tc Ad Ah]
Durango-CO77: checks 
Szevasztopol: bets $5.70
Durango-CO77: folds 
Uncalled bet ($5.70) returned to Szevasztopol
Szevasztopol collected $10.98 from pot
Szevasztopol: doesn't show hand 
*** SUMMARY ***
Total pot $11.50 | Rake $0.52 
Board [Tc Ad Ah]
Seat 1: Westpants folded before Flop (didn't bet)
Seat 2: Szevasztopol (button) collected ($10.98)
Seat 3: CAJUN890 (small blind) folded before Flop
Seat 4: mycka86 (big blind) folded before Flop
Seat 5: Durango-CO77 folded on the Flop
Seat 6: PacPacBum folded before Flop (didn't bet)
Seat 7: matiko09 folded before Flop (didn't bet)
Seat 9: RICKA16 folded before Flop (didn't bet)





PokerStars Hand #150803419136:  Hold'em No Limit ($0.50/$1.00 USD) - 2016/03/23 15:46:06 CET [2016/03/23 10:46:06 ET]
Table 'Sylvia III' 9-max Seat #1 is the button
Seat 1: mycka86 ($131 in chips) 
Seat 2: ellis005 ($103.04 in chips) 
Seat 4: lombardo11 ($50.64 in chips) 
Seat 5: matiko09 ($100 in chips) 
Seat 6: PacPacBum ($120.34 in chips) 
ellis005: posts small blind $0.50
bigacsiga: is sitting out 
lombardo11: posts big blind $1
ardo888: sits out 
mycka86: posts the ante $0.20
ellis005: posts the ante $0.20
lombardo11: posts the ante $0.20
matiko09: posts the ante $0.20
PacPacBum: posts the ante $0.20
*** HOLE CARDS ***
Dealt to matiko09 [Js 6s]
matiko09: folds 
GlamDragon joins the table at seat #9 
PacPacBum: folds 
mycka86: raises $2 to $3
ellis005: raises $5 to $8
lombardo11: folds 
mycka86: folds 
Uncalled bet ($5) returned to ellis005
ellis005 collected $8 from pot
ellis005: doesn't show hand 
*** SUMMARY ***
Total pot $8 | Rake $0 
Seat 1: mycka86 (button) folded before Flop
Seat 2: ellis005 (small blind) collected ($8)
Seat 4: lombardo11 (big blind) folded before Flop
Seat 5: matiko09 folded before Flop (didn't bet)
Seat 6: PacPacBum folded before Flop (didn't bet)





PokerStars Hand #150803419468:  Hold'em No Limit ($0.50/$1.00 USD) - 2016/03/23 15:46:07 CET [2016/03/23 10:46:07 ET]
Table 'Asmodeus' 9-max Seat #6 is the button
Seat 2: PacPacBum ($100 in chips) 
Seat 4: Effort92 ($120.08 in chips) 
Seat 5: DrunkPatrik ($100 in chips) 
Seat 6: fuppeee ($162.90 in chips) 
Seat 7: mycka86 ($111.68 in chips) 
Seat 8: ardo888 ($100 in chips) 
Seat 9: matiko09 ($103.10 in chips) 
mycka86: posts small blind $0.50
ardo888: posts big blind $1
Muinmyheart: sits out 
DrunkPatrik: posts big blind $1
PacPacBum: posts the ante $0.20
Effort92: posts the ante $0.20
DrunkPatrik: posts the ante $0.20
fuppeee: posts the ante $0.20
mycka86: posts the ante $0.20
ardo888: posts the ante $0.20
matiko09: posts the ante $0.20
*** HOLE CARDS ***
Dealt to matiko09 [6d Kc]
matiko09: folds 
PacPacBum: folds 
Effort92: folds 
DrunkPatrik: checks 
fuppeee: raises $4.90 to $5.90
mycka86: folds 
ardo888: folds 
DrunkPatrik: calls $4.90
*** FLOP *** [Jd 4d Th]
DrunkPatrik: checks 
fuppeee: bets $7.02
DrunkPatrik: folds 
Uncalled bet ($7.02) returned to fuppeee
fuppeee collected $14.04 from pot
*** SUMMARY ***
Total pot $14.70 | Rake $0.66 
Board [Jd 4d Th]
Seat 2: PacPacBum folded before Flop (didn't bet)
Seat 4: Effort92 folded before Flop (didn't bet)
Seat 5: DrunkPatrik folded on the Flop
Seat 6: fuppeee (button) collected ($14.04)
Seat 7: mycka86 (small blind) folded before Flop
Seat 8: ardo888 (big blind) folded before Flop
Seat 9: matiko09 folded before Flop (didn't bet)





PokerStars Hand #150803420627:  Hold'em No Limit ($0.50/$1.00 USD) - 2016/03/23 15:46:10 CET [2016/03/23 10:46:10 ET]
Table 'Aetolia II' 9-max Seat #1 is the button
Seat 1: app1e_j@ck ($100 in chips) 
Seat 3: se7en_$tars ($64.50 in chips) 
Seat 4: Pocketstud ($131.56 in chips) 
Seat 5: KingCastle77 ($96.76 in chips) 
Seat 6: Westpants ($132.78 in chips) 
Seat 7: matiko09 ($100 in chips) 
Seat 8: PacPacBum ($104.60 in chips) 
Seat 9: omorfadramou ($100 in chips) 
se7en_$tars: posts small blind $0.50
Pocketstud: posts big blind $1
*** HOLE CARDS ***
Dealt to matiko09 [3h 9s]
KingCastle77: folds 
Westpants: folds 
matiko09: folds 
PacPacBum: folds 
omorfadramou: raises $2 to $3
app1e_j@ck: folds 
se7en_$tars: folds 
Pocketstud: calls $2
*** FLOP *** [8h 5h 7h]
Pocketstud: bets $2
omorfadramou: folds 
Uncalled bet ($2) returned to Pocketstud
Pocketstud collected $6.21 from pot
Pocketstud: doesn't show hand 
*** SUMMARY ***
Total pot $6.50 | Rake $0.29 
Board [8h 5h 7h]
Seat 1: app1e_j@ck (button) folded before Flop (didn't bet)
Seat 3: se7en_$tars (small blind) folded before Flop
Seat 4: Pocketstud (big blind) collected ($6.21)
Seat 5: KingCastle77 folded before Flop (didn't bet)
Seat 6: Westpants folded before Flop (didn't bet)
Seat 7: matiko09 folded before Flop (didn't bet)
Seat 8: PacPacBum folded before Flop (didn't bet)
Seat 9: omorfadramou folded on the Flop





PokerStars Hand #150803421418:  Hold'em No Limit ($0.50/$1.00 USD) - 2016/03/23 15:46:13 CET [2016/03/23 10:46:13 ET]
Table 'Haug II' 9-max Seat #7 is the button
Seat 1: PacPacBum ($100 in chips) 
Seat 2: ardo888 ($100 in chips) 
Seat 3: Do-Man22 ($98.80 in chips) 
Seat 4: matiko09 ($120.42 in chips) 
Seat 5: GlamDragon ($101.64 in chips) 
Seat 6: Pocketstud ($106.49 in chips) 
Seat 7: jahwe ($100 in chips) 
Seat 8: BRIGANTE49 ($174.36 in chips) 
BRIGANTE49: posts small blind $0.50
PacPacBum: posts big blind $1
PacPacBum: posts the ante $0.20
ardo888: posts the ante $0.20
Do-Man22: posts the ante $0.20
matiko09: posts the ante $0.20
GlamDragon: posts the ante $0.20
Pocketstud: posts the ante $0.20
jahwe: posts the ante $0.20
BRIGANTE49: posts the ante $0.20
*** HOLE CARDS ***
Dealt to matiko09 [Qc Tc]
ardo888: folds 
Do-Man22: folds 
matiko09: raises $2 to $3
GlamDragon: folds 
Pocketstud: folds 
jahwe: folds 
BRIGANTE49: folds 
PacPacBum: folds 
Uncalled bet ($2) returned to matiko09
matiko09 collected $4.10 from pot
matiko09: doesn't show hand 
*** SUMMARY ***
Total pot $4.10 | Rake $0 
Seat 1: PacPacBum (big blind) folded before Flop
Seat 2: ardo888 folded before Flop (didn't bet)
Seat 3: Do-Man22 folded before Flop (didn't bet)
Seat 4: matiko09 collected ($4.10)
Seat 5: GlamDragon folded before Flop (didn't bet)
Seat 6: Pocketstud folded before Flop (didn't bet)
Seat 7: jahwe (button) folded before Flop (didn't bet)
Seat 8: BRIGANTE49 (small blind) folded before Flop





PokerStars Hand #150803421665:  Hold'em No Limit (€0.50/€1.00 EUR) - 2016/03/23 15:46:14 CET [2016/03/23 10:46:14 ET]
Table 'Volga III' 9-max Seat #3 is the button
Seat 2: GW92RP (€133.16 in chips) 
Seat 3: matiko09 (€100 in chips) 
Seat 4: bigacsiga (€110.76 in chips) 
Seat 5: finchaplin (€100 in chips) 
Seat 6: PacPacBum (€100 in chips) 
Seat 7: jahwe (€100 in chips) 
Seat 9: ardo888 (€134.86 in chips) 
bigacsiga: posts small blind €0.50
finchaplin: posts big blind €1
app1e_j@ck: sits out 
*** HOLE CARDS ***
Dealt to matiko09 [Ah Kh]
PacPacBum: folds 
jahwe: folds 
ardo888: raises €2 to €3
GW92RP: folds 
matiko09: calls €3
bigacsiga: folds 
finchaplin: folds 
*** FLOP *** [7c 2c 4s]
GW92RP leaves the table
ardo888: checks 
matiko09: checks 
*** TURN *** [7c 2c 4s] [2s]
ardo888: checks 
matiko09: bets €3.72
ardo888: folds 
Uncalled bet (€3.72) returned to matiko09
matiko09 collected €7.16 from pot
matiko09: doesn't show hand 
*** SUMMARY ***
Total pot €7.50 | Rake €0.34 
Board [7c 2c 4s 2s]
Seat 2: GW92RP folded before Flop (didn't bet)
Seat 3: matiko09 (button) collected (€7.16)
Seat 4: bigacsiga (small blind) folded before Flop
Seat 5: finchaplin (big blind) folded before Flop
Seat 6: PacPacBum folded before Flop (didn't bet)
Seat 7: jahwe folded before Flop (didn't bet)
Seat 9: ardo888 folded on the Turn





PokerStars Hand #150803424327:  Hold'em No Limit ($1/$2 USD) - 2016/03/23 15:46:22 CET [2016/03/23 10:46:22 ET]
Table 'Kiess' 9-max Seat #1 is the button
Seat 1: Cirilico ($238.37 in chips) 
Seat 3: Red4erT ($100.55 in chips) 
Seat 4: RamiroAgujis ($213.96 in chips) 
Seat 5: chippo boy ($462.43 in chips) 
Seat 6: matiko09 ($213.48 in chips) 
Seat 7: chaps1988 ($218.92 in chips) 
Seat 8: erfk1958 ($127.78 in chips) 
Seat 9: PacPacBum ($200 in chips) 
Red4erT: posts small blind $1
RamiroAgujis: posts big blind $2
*** HOLE CARDS ***
Dealt to matiko09 [2s 3c]
chippo boy: folds 
matiko09: folds 
chaps1988: folds 
erfk1958: folds 
PacPacBum: folds 
Cirilico: raises $3 to $5
Red4erT: folds 
RamiroAgujis: calls $3
*** FLOP *** [Ad 9s 9d]
RamiroAgujis: checks 
Cirilico: bets $5.25
RamiroAgujis: folds 
Uncalled bet ($5.25) returned to Cirilico
Cirilico collected $10.50 from pot
Cirilico: doesn't show hand 
*** SUMMARY ***
Total pot $11 | Rake $0.50 
Board [Ad 9s 9d]
Seat 1: Cirilico (button) collected ($10.50)
Seat 3: Red4erT (small blind) folded before Flop
Seat 4: RamiroAgujis (big blind) folded on the Flop
Seat 5: chippo boy folded before Flop (didn't bet)
Seat 6: matiko09 folded before Flop (didn't bet)
Seat 7: chaps1988 folded before Flop (didn't bet)
Seat 8: erfk1958 folded before Flop (didn't bet)
Seat 9: PacPacBum folded before Flop (didn't bet)





PokerStars Hand #150803425629:  Hold'em No Limit ($0.50/$1.00 USD) - 2016/03/23 15:46:26 CET [2016/03/23 10:46:26 ET]
Table 'Drakonia II' 9-max Seat #8 is the button
Seat 1: chautinhtri9 ($118 in chips) 
Seat 2: RICKA16 ($102.44 in chips) 
Seat 3: PacPacBum ($100 in chips) 
Seat 4: Jimy Tiltman ($120.26 in chips) 
Seat 5: Muinmyheart ($100 in chips) 
Seat 7: YuriiSolodya ($50.88 in chips) 
Seat 8: matiko09 ($100 in chips) 
Seat 9: mycka86 ($100 in chips) 
mycka86: posts small blind $0.50
chautinhtri9: posts big blind $1
*** HOLE CARDS ***
Dealt to matiko09 [6h 6d]
RICKA16: raises $2 to $3
PacPacBum: folds 
Jimy Tiltman: folds 
Muinmyheart: folds 
YuriiSolodya: calls $3
matiko09: calls $3
mycka86: folds 
chautinhtri9: folds 
*** FLOP *** [Qc 3s 6s]
RICKA16: bets $7
YuriiSolodya: folds 
matiko09: calls $7
*** TURN *** [Qc 3s 6s] [Ah]
RICKA16: bets $14
matiko09: calls $14
*** RIVER *** [Qc 3s 6s Ah] [2d]
RICKA16: checks 
matiko09: bets $32
RICKA16: calls $32
*** SHOW DOWN ***
matiko09: shows [6h 6d] (three of a kind, Sixes)
RICKA16: mucks hand 
matiko09 collected $113.70 from pot
*** SUMMARY ***
Total pot $116.50 | Rake $2.80 
Board [Qc 3s 6s Ah 2d]
Seat 1: chautinhtri9 (big blind) folded before Flop
Seat 2: RICKA16 mucked [Ac Jd]
Seat 3: PacPacBum folded before Flop (didn't bet)
Seat 4: Jimy Tiltman folded before Flop (didn't bet)
Seat 5: Muinmyheart folded before Flop (didn't bet)
Seat 7: YuriiSolodya folded on the Flop
Seat 8: matiko09 (button) showed [6h 6d] and won ($113.70) with three of a kind, Sixes
Seat 9: mycka86 (small blind) folded before Flop





PokerStars Hand #150803425567:  Hold'em No Limit ($0.50/$1.00 USD) - 2016/03/23 15:46:26 CET [2016/03/23 10:46:26 ET]
Table 'Smiley' 9-max Seat #7 is the button
Seat 1: jahwe ($109.81 in chips) 
Seat 2: Jimy Tiltman ($100 in chips) 
Seat 3: mycka86 ($127.74 in chips) 
Seat 4: CAJUN890 ($80.19 in chips) 
Seat 5: Szevasztopol ($116.40 in chips) 
Seat 6: blackmont111 ($116.54 in chips) 
Seat 7: bennetb77 ($117.53 in chips) 
Seat 8: matiko09 ($100.08 in chips) 
Seat 9: PacPacBum ($102.81 in chips) 
matiko09: posts small blind $0.50
PacPacBum: posts big blind $1
*** HOLE CARDS ***
Dealt to matiko09 [Tc 8h]
jahwe has timed out
jahwe: folds 
Jimy Tiltman: folds 
mycka86: folds 
CAJUN890: calls $1
Szevasztopol: folds 
blackmont111: raises $3 to $4
bennetb77: folds 
matiko09: folds 
PacPacBum: folds 
CAJUN890: calls $3
*** FLOP *** [8c Ts 7d]
CAJUN890: bets $4.53
blackmont111: folds 
Uncalled bet ($4.53) returned to CAJUN890
CAJUN890 collected $9.07 from pot
CAJUN890: doesn't show hand 
*** SUMMARY ***
Total pot $9.50 | Rake $0.43 
Board [8c Ts 7d]
Seat 1: jahwe folded before Flop (didn't bet)
Seat 2: Jimy Tiltman folded before Flop (didn't bet)
Seat 3: mycka86 folded before Flop (didn't bet)
Seat 4: CAJUN890 collected ($9.07)
Seat 5: Szevasztopol folded before Flop (didn't bet)
Seat 6: blackmont111 folded on the Flop
Seat 7: bennetb77 (button) folded before Flop (didn't bet)
Seat 8: matiko09 (small blind) folded before Flop
Seat 9: PacPacBum (big blind) folded before Flop





PokerStars Hand #150803427554:  Hold'em No Limit ($0.50/$1.00 USD) - 2016/03/23 15:46:32 CET [2016/03/23 10:46:32 ET]
Table 'Haug II' 9-max Seat #1 is the button
Seat 1: PacPacBum ($100 in chips) 
Seat 2: ardo888 ($100 in chips) 
Seat 3: Do-Man22 ($98.60 in chips) 
Seat 4: matiko09 ($123.32 in chips) 
Seat 5: GlamDragon ($101.44 in chips) 
Seat 6: Pocketstud ($106.29 in chips) 
Seat 7: jahwe ($100 in chips) 
ardo888: posts small blind $0.50
Do-Man22: posts big blind $1
PacPacBum: posts the ante $0.20
ardo888: posts the ante $0.20
Do-Man22: posts the ante $0.20
matiko09: posts the ante $0.20
GlamDragon: posts the ante $0.20
Pocketstud: posts the ante $0.20
jahwe: posts the ante $0.20
*** HOLE CARDS ***
Dealt to matiko09 [Jh 7c]
matiko09: folds 
GlamDragon: folds 
Pocketstud: folds 
BRIGANTE49 leaves the table
Dantist1122 joins the table at seat #8 
flk.Dasas leaves the table
jahwe: folds 
PacPacBum: folds 
ardo888: raises $2 to $3
Do-Man22: calls $2
*** FLOP *** [Jc Ks Js]
Dantist1122 leaves the table
edidaz joins the table at seat #8 
ardo888: bets $3.74
Do-Man22: folds 
Uncalled bet ($3.74) returned to ardo888
ardo888 collected $7.07 from pot
ardo888: doesn't show hand 
*** SUMMARY ***
Total pot $7.40 | Rake $0.33 
Board [Jc Ks Js]
Seat 1: PacPacBum (button) folded before Flop (didn't bet)
Seat 2: ardo888 (small blind) collected ($7.07)
Seat 3: Do-Man22 (big blind) folded on the Flop
Seat 4: matiko09 folded before Flop (didn't bet)
Seat 5: GlamDragon folded before Flop (didn't bet)
Seat 6: Pocketstud folded before Flop (didn't bet)
Seat 7: jahwe folded before Flop (didn't bet)





PokerStars Hand #150803432652:  Hold'em No Limit ($0.50/$1.00 USD) - 2016/03/23 15:46:48 CET [2016/03/23 10:46:48 ET]
Table 'Asmodeus' 9-max Seat #7 is the button
Seat 2: PacPacBum ($100 in chips) 
Seat 4: Effort92 ($119.88 in chips) 
Seat 5: DrunkPatrik ($93.90 in chips) 
Seat 6: fuppeee ($170.84 in chips) 
Seat 7: mycka86 ($110.98 in chips) 
Seat 8: ardo888 ($100 in chips) 
Seat 9: matiko09 ($102.90 in chips) 
ardo888: posts small blind $0.50
matiko09: posts big blind $1
Muinmyheart: sits out 
PacPacBum: posts the ante $0.20
Effort92: posts the ante $0.20
DrunkPatrik: posts the ante $0.20
fuppeee: posts the ante $0.20
mycka86: posts the ante $0.20
ardo888: posts the ante $0.20
matiko09: posts the ante $0.20
*** HOLE CARDS ***
Dealt to matiko09 [7d 3d]
PacPacBum: folds 
Effort92: folds 
DrunkPatrik: calls $1
fuppeee: folds 
mycka86: folds 
ardo888: folds 
matiko09: checks 
*** FLOP *** [8s 4d Td]
matiko09: bets $2.42
DrunkPatrik: calls $2.42
*** TURN *** [8s 4d Td] [6d]
matiko09: bets $5.43
DrunkPatrik: calls $5.43
*** RIVER *** [8s 4d Td 6d] [8d]
matiko09: checks 
DrunkPatrik: checks 
*** SHOW DOWN ***
matiko09: shows [7d 3d] (a flush, Ten high)
DrunkPatrik: mucks hand 
matiko09 collected $18.72 from pot
*** SUMMARY ***
Total pot $19.60 | Rake $0.88 
Board [8s 4d Td 6d 8d]
Seat 2: PacPacBum folded before Flop (didn't bet)
Seat 4: Effort92 folded before Flop (didn't bet)
Seat 5: DrunkPatrik mucked [Kh Kc]
Seat 6: fuppeee folded before Flop (didn't bet)
Seat 7: mycka86 (button) folded before Flop (didn't bet)
Seat 8: ardo888 (small blind) folded before Flop
Seat 9: matiko09 (big blind) showed [7d 3d] and won ($18.72) with a flush, Ten high





PokerStars Hand #150803433481:  Hold'em No Limit ($0.50/$1.00 USD) - 2016/03/23 15:46:51 CET [2016/03/23 10:46:51 ET]
Table 'Sylvia III' 9-max Seat #2 is the button
Seat 1: mycka86 ($127.80 in chips) 
Seat 2: ellis005 ($107.84 in chips) 
Seat 4: lombardo11 ($49.44 in chips) 
Seat 5: matiko09 ($100 in chips) 
Seat 6: PacPacBum ($120.14 in chips) 
bigacsiga will be allowed to play after the button
lombardo11: posts small blind $0.50
matiko09: posts big blind $1
ardo888: sits out 
GlamDragon: sits out 
mycka86: posts the ante $0.20
ellis005: posts the ante $0.20
lombardo11: posts the ante $0.20
matiko09: posts the ante $0.20
PacPacBum: posts the ante $0.20
*** HOLE CARDS ***
Dealt to matiko09 [7d 9d]
PacPacBum: folds 
mycka86: folds 
ellis005: folds 
lombardo11: raises $2 to $3
matiko09: calls $2
*** FLOP *** [Tc 9c Ks]
lombardo11: bets $3
matiko09: calls $3
*** TURN *** [Tc 9c Ks] [5h]
lombardo11: checks 
matiko09: checks 
*** RIVER *** [Tc 9c Ks 5h] [2c]
lombardo11: checks 
matiko09: checks 
*** SHOW DOWN ***
lombardo11: shows [Jd Ts] (a pair of Tens)
matiko09: mucks hand 
lombardo11 collected $12.42 from pot
*** SUMMARY ***
Total pot $13 | Rake $0.58 
Board [Tc 9c Ks 5h 2c]
Seat 1: mycka86 folded before Flop (didn't bet)
Seat 2: ellis005 (button) folded before Flop (didn't bet)
Seat 4: lombardo11 (small blind) showed [Jd Ts] and won ($12.42) with a pair of Tens
Seat 5: matiko09 (big blind) mucked [7d 9d]
Seat 6: PacPacBum folded before Flop (didn't bet)





PokerStars Hand #150803436224:  Hold'em No Limit (€0.50/€1.00 EUR) - 2016/03/23 15:47:00 CET [2016/03/23 10:47:00 ET]
Table 'Volga III' 9-max Seat #4 is the button
Seat 3: matiko09 (€104.16 in chips) 
Seat 4: bigacsiga (€110.26 in chips) 
Seat 5: finchaplin (€99 in chips) 
Seat 6: PacPacBum (€100 in chips) 
Seat 7: jahwe (€100 in chips) 
Seat 9: ardo888 (€131.86 in chips) 
finchaplin: posts small blind €0.50
PacPacBum: posts big blind €1
app1e_j@ck: sits out 
*** HOLE CARDS ***
Dealt to matiko09 [Qh Kh]
jahwe: folds 
jahwe leaves the table
ardo888: folds 
matiko09: raises €1.50 to €2.50
bigacsiga: folds 
finchaplin: folds 
app1e_j@ck leaves the table
bigacsiga leaves the table
PacPacBum: folds 
Uncalled bet (€1.50) returned to matiko09
matiko09 collected €2.50 from pot
matiko09: doesn't show hand 
*** SUMMARY ***
Total pot €2.50 | Rake €0 
Seat 3: matiko09 collected (€2.50)
Seat 4: bigacsiga (button) folded before Flop (didn't bet)
Seat 5: finchaplin (small blind) folded before Flop
Seat 6: PacPacBum (big blind) folded before Flop
Seat 7: jahwe folded before Flop (didn't bet)
Seat 9: ardo888 folded before Flop (didn't bet)





PokerStars Hand #150803438303:  Hold'em No Limit ($0.50/$1.00 USD) - 2016/03/23 15:47:06 CET [2016/03/23 10:47:06 ET]
Table 'Swings' 9-max Seat #3 is the button
Seat 1: lumen21 ($100.78 in chips) 
Seat 2: tomver0809 ($72.45 in chips) 
Seat 3: edidaz ($100 in chips) 
Seat 4: YuriiSolodya ($38.83 in chips) 
Seat 5: chautinhtri9 ($109.55 in chips) 
Seat 6: matiko09 ($144.99 in chips) 
Seat 7: PacPacBum ($121.99 in chips) 
Seat 8: RICKA16 ($105.96 in chips) 
Seat 9: Effort92 ($100 in chips) 
YuriiSolodya: posts small blind $0.50
chautinhtri9: posts big blind $1
*** HOLE CARDS ***
Dealt to matiko09 [7h 5s]
matiko09: folds 
PacPacBum: folds 
RICKA16 has timed out
RICKA16: folds 
Effort92: raises $1.50 to $2.50
lumen21: folds 
tomver0809: calls $2.50
edidaz: folds 
YuriiSolodya: folds 
chautinhtri9: calls $1.50
*** FLOP *** [Qc 5c 9d]
chautinhtri9: checks 
Effort92: checks 
tomver0809: checks 
*** TURN *** [Qc 5c 9d] [3h]
chautinhtri9: checks 
Effort92: bets $4
tomver0809: folds 
chautinhtri9: folds 
Uncalled bet ($4) returned to Effort92
Effort92 collected $7.64 from pot
Effort92: doesn't show hand 
*** SUMMARY ***
Total pot $8 | Rake $0.36 
Board [Qc 5c 9d 3h]
Seat 1: lumen21 folded before Flop (didn't bet)
Seat 2: tomver0809 folded on the Turn
Seat 3: edidaz (button) folded before Flop (didn't bet)
Seat 4: YuriiSolodya (small blind) folded before Flop
Seat 5: chautinhtri9 (big blind) folded on the Turn
Seat 6: matiko09 folded before Flop (didn't bet)
Seat 7: PacPacBum folded before Flop (didn't bet)
Seat 8: RICKA16 folded before Flop (didn't bet)
Seat 9: Effort92 collected ($7.64)





PokerStars Hand #150803440947:  Hold'em No Limit (€0.50/€1.00 EUR) - 2016/03/23 15:47:14 CET [2016/03/23 10:47:14 ET]
Table 'Mercury III' 9-max Seat #3 is the button
Seat 1: matiko09 (€124.85 in chips) 
Seat 3: PacPacBum (€100 in chips) 
Seat 4: Muinmyheart (€121.68 in chips) 
Seat 5: ardo888 (€100 in chips) 
Seat 6: mycka86 (€100 in chips) 
Seat 7: STrakDD (€155.09 in chips) 
Seat 8: gfxed (€42.77 in chips) 
Seat 9: Indr3k (€100 in chips) 
Muinmyheart: posts small blind €0.50
ardo888: posts big blind €1
*** HOLE CARDS ***
Dealt to matiko09 [9c 2d]
mycka86: folds 
STrakDD: folds 
gfxed: calls €1
Indr3k: folds 
matiko09: folds 
PacPacBum: folds 
Muinmyheart: folds 
ardo888: checks 
*** FLOP *** [3c Jh 3d]
ardo888: checks 
gfxed: checks 
*** TURN *** [3c Jh 3d] [4s]
ardo888: checks 
gfxed: bets €1
ardo888: folds 
Uncalled bet (€1) returned to gfxed
gfxed collected €2.39 from pot
*** SUMMARY ***
Total pot €2.50 | Rake €0.11 
Board [3c Jh 3d 4s]
Seat 1: matiko09 folded before Flop (didn't bet)
Seat 3: PacPacBum (button) folded before Flop (didn't bet)
Seat 4: Muinmyheart (small blind) folded before Flop
Seat 5: ardo888 (big blind) folded on the Turn
Seat 6: mycka86 folded before Flop (didn't bet)
Seat 7: STrakDD folded before Flop (didn't bet)
Seat 8: gfxed collected (€2.39)
Seat 9: Indr3k folded before Flop (didn't bet)





PokerStars Hand #150803441315:  Hold'em No Limit ($0.50/$1.00 USD) - 2016/03/23 15:47:15 CET [2016/03/23 10:47:15 ET]
Table 'Aetolia II' 9-max Seat #3 is the button
Seat 1: app1e_j@ck ($100 in chips) 
Seat 3: se7en_$tars ($64 in chips) 
Seat 4: Pocketstud ($134.77 in chips) 
Seat 5: KingCastle77 ($96.76 in chips) 
Seat 6: Westpants ($132.78 in chips) 
Seat 7: matiko09 ($100 in chips) 
Seat 8: PacPacBum ($104.60 in chips) 
Seat 9: omorfadramou ($100 in chips) 
Pocketstud: posts small blind $0.50
KingCastle77: posts big blind $1
*** HOLE CARDS ***
Dealt to matiko09 [3d 4h]
Westpants: raises $2 to $3
matiko09: folds 
PacPacBum: folds 
omorfadramou: folds 
app1e_j@ck: folds 
se7en_$tars: calls $3
Pocketstud: folds 
KingCastle77: calls $2
*** FLOP *** [6s 4c 8s]
KingCastle77: checks 
Westpants: bets $5.35
se7en_$tars: raises $10.35 to $15.70
KingCastle77: folds 
Westpants: folds 
Uncalled bet ($10.35) returned to se7en_$tars
se7en_$tars collected $19.29 from pot
se7en_$tars: doesn't show hand 
*** SUMMARY ***
Total pot $20.20 | Rake $0.91 
Board [6s 4c 8s]
Seat 1: app1e_j@ck folded before Flop (didn't bet)
Seat 3: se7en_$tars (button) collected ($19.29)
Seat 4: Pocketstud (small blind) folded before Flop
Seat 5: KingCastle77 (big blind) folded on the Flop
Seat 6: Westpants folded on the Flop
Seat 7: matiko09 folded before Flop (didn't bet)
Seat 8: PacPacBum folded before Flop (didn't bet)
Seat 9: omorfadramou folded before Flop (didn't bet)





PokerStars Hand #150803445765:  Hold'em No Limit (€0.50/€1.00 EUR) - 2016/03/23 15:47:30 CET [2016/03/23 10:47:30 ET]
Table 'Volga III' 9-max Seat #5 is the button
Seat 3: matiko09 (€105.66 in chips) 
Seat 5: finchaplin (€98.50 in chips) 
Seat 6: PacPacBum (€100 in chips) 
Seat 9: ardo888 (€131.86 in chips) 
PacPacBum: posts small blind €0.50
ardo888: posts big blind €1
*** HOLE CARDS ***
Dealt to matiko09 [Jc Td]
matiko09: folds 
finchaplin: raises €2 to €3
PacPacBum: folds 
bigacsiga joins the table at seat #7 
Sreshta222 joins the table at seat #8 
ardo888: folds 
Uncalled bet (€2) returned to finchaplin
Sreshta222 leaves the table
finchaplin collected €2.50 from pot
finchaplin: doesn't show hand 
*** SUMMARY ***
Total pot €2.50 | Rake €0 
Seat 3: matiko09 folded before Flop (didn't bet)
Seat 5: finchaplin (button) collected (€2.50)
Seat 6: PacPacBum (small blind) folded before Flop
Seat 9: ardo888 (big blind) folded before Flop





PokerStars Hand #150803447224:  Hold'em No Limit ($1/$2 USD) - 2016/03/23 15:47:34 CET [2016/03/23 10:47:34 ET]
Table 'Kiess' 9-max Seat #3 is the button
Seat 1: Cirilico ($243.87 in chips) 
Seat 3: Red4erT ($99.55 in chips) 
Seat 4: RamiroAgujis ($208.96 in chips) 
Seat 5: chippo boy ($462.43 in chips) 
Seat 6: matiko09 ($213.48 in chips) 
Seat 7: chaps1988 ($218.92 in chips) 
Seat 8: erfk1958 ($127.78 in chips) 
Seat 9: PacPacBum ($200 in chips) 
RamiroAgujis: posts small blind $1
chippo boy: posts big blind $2
*** HOLE CARDS ***
Dealt to matiko09 [2h 4h]
matiko09: folds 
chaps1988: folds 
erfk1958: folds 
PacPacBum: raises $2.08 to $4.08
Cirilico: folds 
Red4erT: folds 
RamiroAgujis: folds 
chippo boy: calls $2.08
*** FLOP *** [Ah Jc Jd]
chippo boy: checks 
PacPacBum: checks 
*** TURN *** [Ah Jc Jd] [Ad]
chippo boy: checks 
PacPacBum: bets $3.06
chippo boy: calls $3.06
*** RIVER *** [Ah Jc Jd Ad] [3s]
chippo boy: bets $6
PacPacBum: folds 
Uncalled bet ($6) returned to chippo boy
chippo boy collected $14.59 from pot
*** SUMMARY ***
Total pot $15.28 | Rake $0.69 
Board [Ah Jc Jd Ad 3s]
Seat 1: Cirilico folded before Flop (didn't bet)
Seat 3: Red4erT (button) folded before Flop (didn't bet)
Seat 4: RamiroAgujis (small blind) folded before Flop
Seat 5: chippo boy (big blind) collected ($14.59)
Seat 6: matiko09 folded before Flop (didn't bet)
Seat 7: chaps1988 folded before Flop (didn't bet)
Seat 8: erfk1958 folded before Flop (didn't bet)
Seat 9: PacPacBum folded on the River





PokerStars Hand #150803447610:  Hold'em No Limit ($0.50/$1.00 USD) - 2016/03/23 15:47:36 CET [2016/03/23 10:47:36 ET]
Table 'Smiley' 9-max Seat #8 is the button
Seat 3: mycka86 ($127.74 in chips) 
Seat 4: CAJUN890 ($85.26 in chips) 
Seat 5: Szevasztopol ($116.40 in chips) 
Seat 6: blackmont111 ($112.54 in chips) 
Seat 7: bennetb77 ($117.53 in chips) 
Seat 8: matiko09 ($100 in chips) 
Seat 9: PacPacBum ($101.81 in chips) 
PacPacBum: posts small blind $0.50
Jimy Tiltman: is sitting out 
mycka86: posts big blind $1
*** HOLE CARDS ***
Dealt to matiko09 [Js Qs]
CAJUN890: calls $1
Szevasztopol: folds 
blackmont111: folds 
bennetb77: calls $1
matiko09: raises $4 to $5
Jimy Tiltman leaves the table
PacPacBum: folds 
mycka86: folds 
CAJUN890: calls $4
bennetb77: calls $4
*** FLOP *** [7h 6c Ks]
CAJUN890: checks 
bennetb77: checks 
GlamDragon joins the table at seat #2 
matiko09: bets $8.19
CAJUN890: folds 
bennetb77: folds 
Uncalled bet ($8.19) returned to matiko09
matiko09 collected $15.76 from pot
matiko09: doesn't show hand 
*** SUMMARY ***
Total pot $16.50 | Rake $0.74 
Board [7h 6c Ks]
Seat 3: mycka86 (big blind) folded before Flop
Seat 4: CAJUN890 folded on the Flop
Seat 5: Szevasztopol folded before Flop (didn't bet)
Seat 6: blackmont111 folded before Flop (didn't bet)
Seat 7: bennetb77 folded on the Flop
Seat 8: matiko09 (button) collected ($15.76)
Seat 9: PacPacBum (small blind) folded before Flop





PokerStars Hand #150803448246:  Hold'em No Limit ($0.50/$1.00 USD) - 2016/03/23 15:47:38 CET [2016/03/23 10:47:38 ET]
Table 'Haug II' 9-max Seat #2 is the button
Seat 1: PacPacBum ($100 in chips) 
Seat 2: ardo888 ($103.87 in chips) 
Seat 3: Do-Man22 ($95.40 in chips) 
Seat 4: matiko09 ($123.12 in chips) 
Seat 5: GlamDragon ($101.24 in chips) 
Seat 6: Pocketstud ($106.09 in chips) 
Seat 7: jahwe ($100 in chips) 
Do-Man22: posts small blind $0.50
matiko09: posts big blind $1
PacPacBum: posts the ante $0.20
ardo888: posts the ante $0.20
Do-Man22: posts the ante $0.20
matiko09: posts the ante $0.20
GlamDragon: posts the ante $0.20
Pocketstud: posts the ante $0.20
jahwe: posts the ante $0.20
*** HOLE CARDS ***
Dealt to matiko09 [7h 5d]
GlamDragon: folds 
Pocketstud: folds 
jahwe: folds 
PacPacBum: raises $2 to $3
edidaz leaves the table
ardo888: folds 
Do-Man22: calls $2.50
matiko09: folds 
*** FLOP *** [Kd 2s 4h]
Dantist1122 joins the table at seat #9 
Dantist1122 leaves the table
Do-Man22: bets $4
PacPacBum: calls $4
*** TURN *** [Kd 2s 4h] [8s]
Do-Man22: checks 
PacPacBum: checks 
*** RIVER *** [Kd 2s 4h 8s] [7d]
Do-Man22: checks 
PacPacBum: checks 
*** SHOW DOWN ***
Do-Man22: shows [Th Ad] (high card Ace)
PacPacBum: shows [Qc Qh] (a pair of Queens)
PacPacBum collected $15.66 from pot
*** SUMMARY ***
Total pot $16.40 | Rake $0.74 
Board [Kd 2s 4h 8s 7d]
Seat 1: PacPacBum showed [Qc Qh] and won ($15.66) with a pair of Queens
Seat 2: ardo888 (button) folded before Flop (didn't bet)
Seat 3: Do-Man22 (small blind) showed [Th Ad] and lost with high card Ace
Seat 4: matiko09 (big blind) folded before Flop
Seat 5: GlamDragon folded before Flop (didn't bet)
Seat 6: Pocketstud folded before Flop (didn't bet)
Seat 7: jahwe folded before Flop (didn't bet)





PokerStars Hand #150803450291:  Hold'em No Limit (€0.50/€1.00 EUR) - 2016/03/23 15:47:44 CET [2016/03/23 10:47:44 ET]
Table 'Volga III' 9-max Seat #6 is the button
Seat 3: matiko09 (€105.66 in chips) 
Seat 5: finchaplin (€100 in chips) 
Seat 6: PacPacBum (€100 in chips) 
Seat 9: ardo888 (€130.86 in chips) 
bigacsiga will be allowed to play after the button
ardo888: posts small blind €0.50
matiko09: posts big blind €1
*** HOLE CARDS ***
Dealt to matiko09 [5h Th]
finchaplin: folds 
PacPacBum: raises €1.04 to €2.04
ardo888: folds 
matiko09: folds 
Uncalled bet (€1.04) returned to PacPacBum
PacPacBum collected €2.50 from pot
PacPacBum: doesn't show hand 
*** SUMMARY ***
Total pot €2.50 | Rake €0 
Seat 3: matiko09 (big blind) folded before Flop
Seat 5: finchaplin folded before Flop (didn't bet)
Seat 6: PacPacBum (button) collected (€2.50)
Seat 9: ardo888 (small blind) folded before Flop





PokerStars Hand #150803453611:  Hold'em No Limit ($0.50/$1.00 USD) - 2016/03/23 15:47:55 CET [2016/03/23 10:47:55 ET]
Table 'Sylvia III' 9-max Seat #4 is the button
Seat 1: mycka86 ($127.60 in chips) 
Seat 2: ellis005 ($107.64 in chips) 
Seat 4: lombardo11 ($55.66 in chips) 
Seat 5: matiko09 ($100 in chips) 
Seat 6: PacPacBum ($119.94 in chips) 
matiko09: posts small blind $0.50
PacPacBum: posts big blind $1
ardo888: sits out 
GlamDragon: sits out 
bigacsiga: sits out 
mycka86: posts the ante $0.20
ellis005: posts the ante $0.20
lombardo11: posts the ante $0.20
matiko09: posts the ante $0.20
PacPacBum: posts the ante $0.20
*** HOLE CARDS ***
Dealt to matiko09 [6s 7c]
mycka86: folds 
ellis005: raises $1.75 to $2.75
lombardo11: folds 
matiko09: folds 
PacPacBum: raises $6.25 to $9
ellis005: calls $6.25
*** FLOP *** [7s Tc 8c]
PacPacBum: bets $10.05
ellis005: folds 
Uncalled bet ($10.05) returned to PacPacBum
PacPacBum collected $18.62 from pot
PacPacBum: doesn't show hand 
*** SUMMARY ***
Total pot $19.50 | Rake $0.88 
Board [7s Tc 8c]
Seat 1: mycka86 folded before Flop (didn't bet)
Seat 2: ellis005 folded on the Flop
Seat 4: lombardo11 (button) folded before Flop (didn't bet)
Seat 5: matiko09 (small blind) folded before Flop
Seat 6: PacPacBum (big blind) collected ($18.62)





PokerStars Hand #150803453884:  Hold'em No Limit ($0.50/$1.00 USD) - 2016/03/23 15:47:56 CET [2016/03/23 10:47:56 ET]
Table 'Asmodeus' 9-max Seat #8 is the button
Seat 1: Muinmyheart ($100 in chips) 
Seat 2: PacPacBum ($100 in chips) 
Seat 4: Effort92 ($119.68 in chips) 
Seat 5: DrunkPatrik ($84.85 in chips) 
Seat 6: fuppeee ($170.64 in chips) 
Seat 7: mycka86 ($110.78 in chips) 
Seat 8: ardo888 ($100 in chips) 
Seat 9: matiko09 ($112.57 in chips) 
matiko09: posts small blind $0.50
Muinmyheart: posts big blind $1
Muinmyheart: posts the ante $0.20
PacPacBum: posts the ante $0.20
Effort92: posts the ante $0.20
DrunkPatrik: posts the ante $0.20
fuppeee: posts the ante $0.20
mycka86: posts the ante $0.20
ardo888: posts the ante $0.20
matiko09: posts the ante $0.20
*** HOLE CARDS ***
Dealt to matiko09 [8s 7d]
PacPacBum: folds 
Effort92: folds 
DrunkPatrik: calls $1
fuppeee: raises $2 to $3
mycka86: folds 
ardo888: calls $3
matiko09: folds 
Muinmyheart: folds 
DrunkPatrik: calls $2
*** FLOP *** [9s Kd 3h]
DrunkPatrik: checks 
fuppeee: checks 
ardo888: checks 
*** TURN *** [9s Kd 3h] [8h]
DrunkPatrik: checks 
fuppeee: bets $11.56
ardo888: folds 
DrunkPatrik: folds 
Uncalled bet ($11.56) returned to fuppeee
fuppeee collected $11.56 from pot
*** SUMMARY ***
Total pot $12.10 | Rake $0.54 
Board [9s Kd 3h 8h]
Seat 1: Muinmyheart (big blind) folded before Flop
Seat 2: PacPacBum folded before Flop (didn't bet)
Seat 4: Effort92 folded before Flop (didn't bet)
Seat 5: DrunkPatrik folded on the Turn
Seat 6: fuppeee collected ($11.56)
Seat 7: mycka86 folded before Flop (didn't bet)
Seat 8: ardo888 (button) folded on the Turn
Seat 9: matiko09 (small blind) folded before Flop





PokerStars Hand #150803455439:  Hold'em No Limit (€0.50/€1.00 EUR) - 2016/03/23 15:48:00 CET [2016/03/23 10:48:00 ET]
Table 'Volga III' 9-max Seat #9 is the button
Seat 3: matiko09 (€104.66 in chips) 
Seat 5: finchaplin (€100 in chips) 
Seat 6: PacPacBum (€101.50 in chips) 
Seat 9: ardo888 (€130.36 in chips) 
matiko09: posts small blind €0.50
finchaplin: posts big blind €1
bigacsiga: sits out 
*** HOLE CARDS ***
Dealt to matiko09 [Kd 3h]
PacPacBum: folds 
ardo888: folds 
matiko09: folds 
Uncalled bet (€0.50) returned to finchaplin
finchaplin collected €1 from pot
finchaplin: doesn't show hand 
*** SUMMARY ***
Total pot €1 | Rake €0 
Seat 3: matiko09 (small blind) folded before Flop
Seat 5: finchaplin (big blind) collected (€1)
Seat 6: PacPacBum folded before Flop (didn't bet)
Seat 9: ardo888 (button) folded before Flop (didn't bet)





PokerStars Hand #150803459973:  Hold'em No Limit (€0.50/€1.00 EUR) - 2016/03/23 15:48:15 CET [2016/03/23 10:48:15 ET]
Table 'Volga III' 9-max Seat #3 is the button
Seat 3: matiko09 (€104.16 in chips) 
Seat 5: finchaplin (€100.50 in chips) 
Seat 6: PacPacBum (€101.50 in chips) 
Seat 9: ardo888 (€130.36 in chips) 
finchaplin: posts small blind €0.50
PacPacBum: posts big blind €1
bigacsiga: sits out 
*** HOLE CARDS ***
Dealt to matiko09 [7c Ad]
ardo888: raises €1.50 to €2.50
matiko09: folds 
finchaplin: folds 
PacPacBum: folds 
Uncalled bet (€1.50) returned to ardo888
Sreshta222 joins the table at seat #1 
ardo888 collected €2.50 from pot
ardo888: doesn't show hand 
*** SUMMARY ***
Total pot €2.50 | Rake €0 
Seat 3: matiko09 (button) folded before Flop (didn't bet)
Seat 5: finchaplin (small blind) folded before Flop
Seat 6: PacPacBum (big blind) folded before Flop
Seat 9: ardo888 collected (€2.50)





PokerStars Hand #150803461076:  Hold'em No Limit ($0.50/$1.00 USD) - 2016/03/23 15:48:18 CET [2016/03/23 10:48:18 ET]
Table 'Drakonia II' 9-max Seat #9 is the button
Seat 1: chautinhtri9 ($117 in chips) 
Seat 2: RICKA16 ($54 in chips) 
Seat 3: PacPacBum ($100 in chips) 
Seat 4: Jimy Tiltman ($120.26 in chips) 
Seat 5: Muinmyheart ($100 in chips) 
Seat 7: YuriiSolodya ($47.88 in chips) 
Seat 8: matiko09 ($157.70 in chips) 
Seat 9: mycka86 ($100 in chips) 
chautinhtri9: posts small blind $0.50
RICKA16: posts big blind $1
*** HOLE CARDS ***
Dealt to matiko09 [3d As]
PacPacBum: folds 
Jimy Tiltman: raises $2 to $3
Muinmyheart: folds 
YuriiSolodya: folds 
matiko09: folds 
mycka86: folds 
chautinhtri9: calls $2.50
RICKA16: folds 
*** FLOP *** [9s 8s 5h]
chautinhtri9: checks 
Jimy Tiltman: bets $5.01
chautinhtri9: folds 
Uncalled bet ($5.01) returned to Jimy Tiltman
Jimy Tiltman collected $6.68 from pot
Jimy Tiltman: doesn't show hand 
*** SUMMARY ***
Total pot $7 | Rake $0.32 
Board [9s 8s 5h]
Seat 1: chautinhtri9 (small blind) folded on the Flop
Seat 2: RICKA16 (big blind) folded before Flop
Seat 3: PacPacBum folded before Flop (didn't bet)
Seat 4: Jimy Tiltman collected ($6.68)
Seat 5: Muinmyheart folded before Flop (didn't bet)
Seat 7: YuriiSolodya folded before Flop (didn't bet)
Seat 8: matiko09 folded before Flop (didn't bet)
Seat 9: mycka86 (button) folded before Flop (didn't bet)





PokerStars Hand #150803462896:  Hold'em No Limit ($0.50/$1.00 USD) - 2016/03/23 15:48:24 CET [2016/03/23 10:48:24 ET]
Table 'Haug II' 9-max Seat #3 is the button
Seat 1: PacPacBum ($108.46 in chips) 
Seat 2: ardo888 ($103.67 in chips) 
Seat 3: Do-Man22 ($88.20 in chips) 
Seat 4: matiko09 ($121.92 in chips) 
Seat 5: GlamDragon ($101.04 in chips) 
Seat 6: Pocketstud ($105.89 in chips) 
Seat 7: jahwe ($100 in chips) 
matiko09: posts small blind $0.50
GlamDragon: posts big blind $1
PacPacBum: posts the ante $0.20
ardo888: posts the ante $0.20
Do-Man22: posts the ante $0.20
matiko09: posts the ante $0.20
GlamDragon: posts the ante $0.20
Pocketstud: posts the ante $0.20
jahwe: posts the ante $0.20
*** HOLE CARDS ***
Dealt to matiko09 [Kc 8h]
Olddogtom888 joins the table at seat #8 
Pocketstud: raises $1 to $2
jahwe: folds 
PacPacBum: folds 
ardo888: calls $2
Do-Man22: calls $2
matiko09: folds 
GlamDragon: calls $1
*** FLOP *** [5h 9c 5d]
GlamDragon: checks 
Pocketstud: checks 
ardo888: checks 
Do-Man22: checks 
*** TURN *** [5h 9c 5d] [2c]
GlamDragon: bets $4.72
Pocketstud: folds 
Dantist1122 joins the table at seat #9 
ardo888: calls $4.72
Dantist1122 leaves the table
Do-Man22: folds 
*** RIVER *** [5h 9c 5d 2c] [9d]
GlamDragon: bets $9.23
ardo888: calls $9.23
*** SHOW DOWN ***
GlamDragon: shows [8d 3c] (two pair, Nines and Fives)
ardo888: shows [2s 2d] (a full house, Deuces full of Nines)
ardo888 collected $36.10 from pot
*** SUMMARY ***
Total pot $37.80 | Rake $1.70 
Board [5h 9c 5d 2c 9d]
Seat 1: PacPacBum folded before Flop (didn't bet)
Seat 2: ardo888 showed [2s 2d] and won ($36.10) with a full house, Deuces full of Nines
Seat 3: Do-Man22 (button) folded on the Turn
Seat 4: matiko09 (small blind) folded before Flop
Seat 5: GlamDragon (big blind) showed [8d 3c] and lost with two pair, Nines and Fives
Seat 6: Pocketstud folded on the Turn
Seat 7: jahwe folded before Flop (didn't bet)





PokerStars Hand #150803463940:  Hold'em No Limit (€0.50/€1.00 EUR) - 2016/03/23 15:48:27 CET [2016/03/23 10:48:27 ET]
Table 'Volga III' 9-max Seat #5 is the button
Seat 3: matiko09 (€104.16 in chips) 
Seat 5: finchaplin (€100 in chips) 
Seat 6: PacPacBum (€100.50 in chips) 
Seat 7: bigacsiga (€110.26 in chips) 
Seat 9: ardo888 (€131.86 in chips) 
PacPacBum: posts small blind €0.50
bigacsiga: posts big blind €1
*** HOLE CARDS ***
Dealt to matiko09 [3s 8s]
Sreshta222 leaves the table
ardo888: raises €2 to €3
matiko09: folds 
finchaplin: folds 
PacPacBum: folds 
bigacsiga: folds 
Uncalled bet (€2) returned to ardo888
ardo888 collected €2.50 from pot
ardo888: doesn't show hand 
*** SUMMARY ***
Total pot €2.50 | Rake €0 
Seat 3: matiko09 folded before Flop (didn't bet)
Seat 5: finchaplin (button) folded before Flop (didn't bet)
Seat 6: PacPacBum (small blind) folded before Flop
Seat 7: bigacsiga (big blind) folded before Flop
Seat 9: ardo888 collected (€2.50)





PokerStars Hand #150803463816:  Hold'em No Limit (€0.50/€1.00 EUR) - 2016/03/23 15:48:27 CET [2016/03/23 10:48:27 ET]
Table 'Mercury III' 9-max Seat #4 is the button
Seat 1: matiko09 (€124.85 in chips) 
Seat 3: PacPacBum (€100 in chips) 
Seat 4: Muinmyheart (€121.18 in chips) 
Seat 5: ardo888 (€100 in chips) 
Seat 6: mycka86 (€100 in chips) 
Seat 7: STrakDD (€155.09 in chips) 
Seat 8: gfxed (€44.16 in chips) 
Seat 9: Indr3k (€100 in chips) 
ardo888: posts small blind €0.50
mycka86: posts big blind €1
*** HOLE CARDS ***
Dealt to matiko09 [8h Td]
STrakDD: folds 
gfxed: folds 
Indr3k: folds 
matiko09: folds 
PacPacBum: raises €1.04 to €2.04
Muinmyheart: folds 
ardo888: folds 
mycka86: folds 
Uncalled bet (€1.04) returned to PacPacBum
PacPacBum collected €2.50 from pot
PacPacBum: doesn't show hand 
*** SUMMARY ***
Total pot €2.50 | Rake €0 
Seat 1: matiko09 folded before Flop (didn't bet)
Seat 3: PacPacBum collected (€2.50)
Seat 4: Muinmyheart (button) folded before Flop (didn't bet)
Seat 5: ardo888 (small blind) folded before Flop
Seat 6: mycka86 (big blind) folded before Flop
Seat 7: STrakDD folded before Flop (didn't bet)
Seat 8: gfxed folded before Flop (didn't bet)
Seat 9: Indr3k folded before Flop (didn't bet)





PokerStars Hand #150803465436:  Hold'em No Limit ($0.50/$1.00 USD) - 2016/03/23 15:48:32 CET [2016/03/23 10:48:32 ET]
Table 'Aetolia II' 9-max Seat #4 is the button
Seat 1: app1e_j@ck ($100 in chips) 
Seat 3: se7en_$tars ($74.94 in chips) 
Seat 4: Pocketstud ($134.27 in chips) 
Seat 5: KingCastle77 ($93.76 in chips) 
Seat 6: Westpants ($124.43 in chips) 
Seat 7: matiko09 ($100 in chips) 
Seat 8: PacPacBum ($104.60 in chips) 
Seat 9: omorfadramou ($100 in chips) 
KingCastle77: posts small blind $0.50
Westpants: posts big blind $1
*** HOLE CARDS ***
Dealt to matiko09 [7c Jh]
matiko09: folds 
PacPacBum: raises $1.04 to $2.04
omorfadramou: folds 
app1e_j@ck: folds 
se7en_$tars: folds 
Pocketstud: folds 
KingCastle77: folds 
Westpants: raises $4.96 to $7
PacPacBum: folds 
Uncalled bet ($4.96) returned to Westpants
Westpants collected $4.58 from pot
*** SUMMARY ***
Total pot $4.58 | Rake $0 
Seat 1: app1e_j@ck folded before Flop (didn't bet)
Seat 3: se7en_$tars folded before Flop (didn't bet)
Seat 4: Pocketstud (button) folded before Flop (didn't bet)
Seat 5: KingCastle77 (small blind) folded before Flop
Seat 6: Westpants (big blind) collected ($4.58)
Seat 7: matiko09 folded before Flop (didn't bet)
Seat 8: PacPacBum folded before Flop
Seat 9: omorfadramou folded before Flop (didn't bet)





PokerStars Hand #150803467031:  Hold'em No Limit ($1/$2 USD) - 2016/03/23 15:48:37 CET [2016/03/23 10:48:37 ET]
Table 'Kiess' 9-max Seat #4 is the button
Seat 1: Cirilico ($243.87 in chips) 
Seat 3: Red4erT ($99.55 in chips) 
Seat 4: RamiroAgujis ($207.96 in chips) 
Seat 5: chippo boy ($469.88 in chips) 
Seat 6: matiko09 ($213.48 in chips) 
Seat 7: chaps1988 ($218.92 in chips) 
Seat 8: erfk1958 ($127.78 in chips) 
Seat 9: PacPacBum ($200 in chips) 
chippo boy: posts small blind $1
matiko09: posts big blind $2
*** HOLE CARDS ***
Dealt to matiko09 [Qs 6d]
chaps1988: folds 
erfk1958: folds 
PacPacBum: folds 
Cirilico: folds 
Red4erT: raises $4 to $6
RamiroAgujis: calls $6
chippo boy: calls $5
matiko09: folds 
*** FLOP *** [3c Js 3s]
chippo boy: checks 
Red4erT: bets $9.93
RamiroAgujis: calls $9.93
chippo boy: folds 
*** TURN *** [3c Js 3s] [3d]
Red4erT: checks 
RamiroAgujis: checks 
*** RIVER *** [3c Js 3s 3d] [Kh]
Red4erT: checks 
RamiroAgujis: bets $30
Red4erT: folds 
Uncalled bet ($30) returned to RamiroAgujis
RamiroAgujis collected $38.07 from pot
RamiroAgujis: doesn't show hand 
*** SUMMARY ***
Total pot $39.86 | Rake $1.79 
Board [3c Js 3s 3d Kh]
Seat 1: Cirilico folded before Flop (didn't bet)
Seat 3: Red4erT folded on the River
Seat 4: RamiroAgujis (button) collected ($38.07)
Seat 5: chippo boy (small blind) folded on the Flop
Seat 6: matiko09 (big blind) folded before Flop
Seat 7: chaps1988 folded before Flop (didn't bet)
Seat 8: erfk1958 folded before Flop (didn't bet)
Seat 9: PacPacBum folded before Flop (didn't bet)





PokerStars Hand #150803466891:  Hold'em No Limit ($0.50/$1.00 USD) - 2016/03/23 15:48:37 CET [2016/03/23 10:48:37 ET]
Table 'Smiley' 9-max Seat #9 is the button
Seat 3: mycka86 ($126.74 in chips) 
Seat 4: CAJUN890 ($80.26 in chips) 
Seat 5: Szevasztopol ($116.40 in chips) 
Seat 6: blackmont111 ($112.54 in chips) 
Seat 7: bennetb77 ($112.53 in chips) 
Seat 8: matiko09 ($110.76 in chips) 
Seat 9: PacPacBum ($101.31 in chips) 
GlamDragon will be allowed to play after the button
mycka86: posts small blind $0.50
CAJUN890: posts big blind $1
*** HOLE CARDS ***
Dealt to matiko09 [7h 2d]
Szevasztopol: folds 
blackmont111: folds 
bennetb77: folds 
matiko09: folds 
PacPacBum: folds 
mycka86: folds 
Uncalled bet ($0.50) returned to CAJUN890
CAJUN890 collected $1 from pot
CAJUN890: doesn't show hand 
*** SUMMARY ***
Total pot $1 | Rake $0 
Seat 3: mycka86 (small blind) folded before Flop
Seat 4: CAJUN890 (big blind) collected ($1)
Seat 5: Szevasztopol folded before Flop (didn't bet)
Seat 6: blackmont111 folded before Flop (didn't bet)
Seat 7: bennetb77 folded before Flop (didn't bet)
Seat 8: matiko09 folded before Flop (didn't bet)
Seat 9: PacPacBum (button) folded before Flop (didn't bet)





PokerStars Hand #150803470766:  Hold'em No Limit ($0.50/$1.00 USD) - 2016/03/23 15:48:49 CET [2016/03/23 10:48:49 ET]
Table 'Sylvia III' 9-max Seat #5 is the button
Seat 1: mycka86 ($127.40 in chips) 
Seat 2: ellis005 ($98.44 in chips) 
Seat 4: lombardo11 ($55.46 in chips) 
Seat 5: matiko09 ($100 in chips) 
Seat 6: PacPacBum ($129.36 in chips) 
Seat 8: ardo888 ($100 in chips) 
PacPacBum: posts small blind $0.50
ardo888: posts big blind $1
GlamDragon: sits out 
bigacsiga: sits out 
mycka86: posts the ante $0.20
ellis005: posts the ante $0.20
lombardo11: posts the ante $0.20
matiko09: posts the ante $0.20
PacPacBum: posts the ante $0.20
ardo888: posts the ante $0.20
*** HOLE CARDS ***
Dealt to matiko09 [3s Qc]
mycka86: folds 
ellis005: calls $1
lombardo11: folds 
matiko09: folds 
PacPacBum: folds 
ardo888: raises $3 to $4
ellis005: raises $10 to $14
ardo888: folds 
Uncalled bet ($10) returned to ellis005
ellis005 collected $9.70 from pot
ellis005: doesn't show hand 
*** SUMMARY ***
Total pot $9.70 | Rake $0 
Seat 1: mycka86 folded before Flop (didn't bet)
Seat 2: ellis005 collected ($9.70)
Seat 4: lombardo11 folded before Flop (didn't bet)
Seat 5: matiko09 (button) folded before Flop (didn't bet)
Seat 6: PacPacBum (small blind) folded before Flop
Seat 8: ardo888 (big blind) folded before Flop





PokerStars Hand #150803472701:  Hold'em No Limit ($0.50/$1.00 USD) - 2016/03/23 15:48:55 CET [2016/03/23 10:48:55 ET]
Table 'Swings' 9-max Seat #4 is the button
Seat 1: lumen21 ($100.78 in chips) 
Seat 2: tomver0809 ($69.95 in chips) 
Seat 3: edidaz ($100 in chips) 
Seat 4: YuriiSolodya ($38.33 in chips) 
Seat 5: chautinhtri9 ($107.05 in chips) 
Seat 6: matiko09 ($144.99 in chips) 
Seat 7: PacPacBum ($121.99 in chips) 
Seat 8: RICKA16 ($105.96 in chips) 
Seat 9: Effort92 ($105.14 in chips) 
chautinhtri9: posts small blind $0.50
matiko09: posts big blind $1
*** HOLE CARDS ***
Dealt to matiko09 [Qh 7d]
PacPacBum: folds 
RICKA16: folds 
Effort92: folds 
lumen21: folds 
tomver0809: calls $1
edidaz: folds 
YuriiSolodya: folds 
chautinhtri9: raises $2 to $3
matiko09: folds 
tomver0809: calls $2
*** FLOP *** [5c Jh 4c]
chautinhtri9: checks 
tomver0809: checks 
*** TURN *** [5c Jh 4c] [2h]
chautinhtri9: checks 
tomver0809: checks 
*** RIVER *** [5c Jh 4c 2h] [5s]
chautinhtri9: checks 
tomver0809: checks 
*** SHOW DOWN ***
chautinhtri9: shows [Qc Ah] (a pair of Fives)
tomver0809: shows [3d 4d] (two pair, Fives and Fours)
tomver0809 collected $6.68 from pot
*** SUMMARY ***
Total pot $7 | Rake $0.32 
Board [5c Jh 4c 2h 5s]
Seat 1: lumen21 folded before Flop (didn't bet)
Seat 2: tomver0809 showed [3d 4d] and won ($6.68) with two pair, Fives and Fours
Seat 3: edidaz folded before Flop (didn't bet)
Seat 4: YuriiSolodya (button) folded before Flop (didn't bet)
Seat 5: chautinhtri9 (small blind) showed [Qc Ah] and lost with a pair of Fives
Seat 6: matiko09 (big blind) folded before Flop
Seat 7: PacPacBum folded before Flop (didn't bet)
Seat 8: RICKA16 folded before Flop (didn't bet)
Seat 9: Effort92 folded before Flop (didn't bet)





PokerStars Hand #150803473879:  Hold'em No Limit ($0.50/$1.00 USD) - 2016/03/23 15:48:59 CET [2016/03/23 10:48:59 ET]
Table 'Aetolia II' 9-max Seat #5 is the button
Seat 1: app1e_j@ck ($100 in chips) 
Seat 3: se7en_$tars ($74.94 in chips) 
Seat 4: Pocketstud ($134.27 in chips) 
Seat 5: KingCastle77 ($93.26 in chips) 
Seat 6: Westpants ($126.97 in chips) 
Seat 7: matiko09 ($100 in chips) 
Seat 8: PacPacBum ($102.56 in chips) 
Seat 9: omorfadramou ($100 in chips) 
Westpants: posts small blind $0.50
matiko09: posts big blind $1
*** HOLE CARDS ***
Dealt to matiko09 [Kh 7s]
PacPacBum: folds 
omorfadramou: folds 
app1e_j@ck: folds 
se7en_$tars: calls $1
Pocketstud: folds 
KingCastle77: folds 
Westpants: calls $0.50
matiko09: checks 
*** FLOP *** [6c Ks 4s]
Westpants: checks 
matiko09: bets $1.86
se7en_$tars: folds 
Westpants: folds 
Uncalled bet ($1.86) returned to matiko09
matiko09 collected $2.86 from pot
matiko09: doesn't show hand 
*** SUMMARY ***
Total pot $3 | Rake $0.14 
Board [6c Ks 4s]
Seat 1: app1e_j@ck folded before Flop (didn't bet)
Seat 3: se7en_$tars folded on the Flop
Seat 4: Pocketstud folded before Flop (didn't bet)
Seat 5: KingCastle77 (button) folded before Flop (didn't bet)
Seat 6: Westpants (small blind) folded on the Flop
Seat 7: matiko09 (big blind) collected ($2.86)
Seat 8: PacPacBum folded before Flop (didn't bet)
Seat 9: omorfadramou folded before Flop (didn't bet)





PokerStars Hand #150803474386:  Hold'em No Limit ($0.50/$1.00 USD) - 2016/03/23 15:49:01 CET [2016/03/23 10:49:01 ET]
Table 'Smiley' 9-max Seat #3 is the button
Seat 3: mycka86 ($126.24 in chips) 
Seat 4: CAJUN890 ($80.76 in chips) 
Seat 5: Szevasztopol ($116.40 in chips) 
Seat 6: blackmont111 ($112.54 in chips) 
Seat 7: bennetb77 ($112.53 in chips) 
Seat 8: matiko09 ($110.76 in chips) 
Seat 9: PacPacBum ($101.31 in chips) 
CAJUN890: posts small blind $0.50
Szevasztopol: posts big blind $1
GlamDragon: sits out 
*** HOLE CARDS ***
Dealt to matiko09 [Th 4d]
blackmont111: folds 
bennetb77: folds 
matiko09: folds 
PacPacBum: folds 
mycka86: raises $1.10 to $2.10
CAJUN890: calls $1.60
Szevasztopol: folds 
*** FLOP *** [2h 6s Qs]
CAJUN890: checks 
mycka86: bets $2.73
CAJUN890: calls $2.73
*** TURN *** [2h 6s Qs] [2d]
CAJUN890: checks 
GlamDragon leaves the table
mycka86: checks 
*** RIVER *** [2h 6s Qs 2d] [3s]
omorfadramou joins the table at seat #2 
CAJUN890: bets $22
mycka86: folds 
Uncalled bet ($22) returned to CAJUN890
CAJUN890 collected $10.18 from pot
CAJUN890: doesn't show hand 
*** SUMMARY ***
Total pot $10.66 | Rake $0.48 
Board [2h 6s Qs 2d 3s]
Seat 3: mycka86 (button) folded on the River
Seat 4: CAJUN890 (small blind) collected ($10.18)
Seat 5: Szevasztopol (big blind) folded before Flop
Seat 6: blackmont111 folded before Flop (didn't bet)
Seat 7: bennetb77 folded before Flop (didn't bet)
Seat 8: matiko09 folded before Flop (didn't bet)
Seat 9: PacPacBum folded before Flop (didn't bet)





PokerStars Hand #150803474636:  Hold'em No Limit ($0.50/$1.00 USD) - 2016/03/23 15:49:01 CET [2016/03/23 10:49:01 ET]
Table 'Asmodeus' 9-max Seat #9 is the button
Seat 1: Muinmyheart ($100 in chips) 
Seat 2: PacPacBum ($100 in chips) 
Seat 4: Effort92 ($119.48 in chips) 
Seat 5: DrunkPatrik ($81.65 in chips) 
Seat 6: fuppeee ($179 in chips) 
Seat 7: mycka86 ($110.58 in chips) 
Seat 8: ardo888 ($100 in chips) 
Seat 9: matiko09 ($111.87 in chips) 
Muinmyheart: posts small blind $0.50
PacPacBum: posts big blind $1
Muinmyheart: posts the ante $0.20
PacPacBum: posts the ante $0.20
Effort92: posts the ante $0.20
DrunkPatrik: posts the ante $0.20
fuppeee: posts the ante $0.20
mycka86: posts the ante $0.20
ardo888: posts the ante $0.20
matiko09: posts the ante $0.20
*** HOLE CARDS ***
Dealt to matiko09 [5h Kh]
Effort92: folds 
DrunkPatrik: folds 
fuppeee: folds 
mycka86: folds 
ardo888: raises $1.50 to $2.50
matiko09: folds 
Muinmyheart: folds 
PacPacBum: folds 
Uncalled bet ($1.50) returned to ardo888
ardo888 collected $4.10 from pot
ardo888: doesn't show hand 
*** SUMMARY ***
Total pot $4.10 | Rake $0 
Seat 1: Muinmyheart (small blind) folded before Flop
Seat 2: PacPacBum (big blind) folded before Flop
Seat 4: Effort92 folded before Flop (didn't bet)
Seat 5: DrunkPatrik folded before Flop (didn't bet)
Seat 6: fuppeee folded before Flop (didn't bet)
Seat 7: mycka86 folded before Flop (didn't bet)
Seat 8: ardo888 collected ($4.10)
Seat 9: matiko09 (button) folded before Flop (didn't bet)





PokerStars Hand #150803475915:  Hold'em No Limit (€0.50/€1.00 EUR) - 2016/03/23 15:49:05 CET [2016/03/23 10:49:05 ET]
Table 'Mercury III' 9-max Seat #5 is the button
Seat 1: matiko09 (€124.85 in chips) 
Seat 3: PacPacBum (€101.50 in chips) 
Seat 4: Muinmyheart (€121.18 in chips) 
Seat 5: ardo888 (€100 in chips) 
Seat 6: mycka86 (€100 in chips) 
Seat 7: STrakDD (€155.09 in chips) 
Seat 8: gfxed (€44.16 in chips) 
Seat 9: Indr3k (€100 in chips) 
mycka86: posts small blind €0.50
STrakDD: posts big blind €1
*** HOLE CARDS ***
Dealt to matiko09 [7s 5s]
gfxed: folds 
Indr3k: folds 
matiko09: folds 
PacPacBum: folds 
Muinmyheart: folds 
ardo888: raises €1.50 to €2.50
mycka86: raises €5.50 to €8
STrakDD: folds 
ardo888: folds 
Uncalled bet (€5.50) returned to mycka86
mycka86 collected €6 from pot
*** SUMMARY ***
Total pot €6 | Rake €0 
Seat 1: matiko09 folded before Flop (didn't bet)
Seat 3: PacPacBum folded before Flop (didn't bet)
Seat 4: Muinmyheart folded before Flop (didn't bet)
Seat 5: ardo888 (button) folded before Flop
Seat 6: mycka86 (small blind) collected (€6)
Seat 7: STrakDD (big blind) folded before Flop
Seat 8: gfxed folded before Flop (didn't bet)
Seat 9: Indr3k folded before Flop (didn't bet)





PokerStars Hand #150803478611:  Hold'em No Limit ($0.50/$1.00 USD) - 2016/03/23 15:49:14 CET [2016/03/23 10:49:14 ET]
Table 'Drakonia II' 9-max Seat #1 is the button
Seat 1: chautinhtri9 ($114 in chips) 
Seat 2: RICKA16 ($100 in chips) 
Seat 3: PacPacBum ($100 in chips) 
Seat 4: Jimy Tiltman ($123.94 in chips) 
Seat 5: Muinmyheart ($100 in chips) 
Seat 7: YuriiSolodya ($47.88 in chips) 
Seat 8: matiko09 ($157.70 in chips) 
Seat 9: mycka86 ($100 in chips) 
RICKA16: posts small blind $0.50
PacPacBum: posts big blind $1
*** HOLE CARDS ***
Dealt to matiko09 [Js Kh]
Jimy Tiltman: folds 
Jimy Tiltman leaves the table
Muinmyheart: folds 
YuriiSolodya: raises $1 to $2
matiko09: folds 
mycka86: folds 
chautinhtri9: folds 
RICKA16: folds 
PacPacBum: folds 
Uncalled bet ($1) returned to YuriiSolodya
YuriiSolodya collected $2.50 from pot
YuriiSolodya: doesn't show hand 
*** SUMMARY ***
Total pot $2.50 | Rake $0 
Seat 1: chautinhtri9 (button) folded before Flop (didn't bet)
Seat 2: RICKA16 (small blind) folded before Flop
Seat 3: PacPacBum (big blind) folded before Flop
Seat 4: Jimy Tiltman folded before Flop (didn't bet)
Seat 5: Muinmyheart folded before Flop (didn't bet)
Seat 7: YuriiSolodya collected ($2.50)
Seat 8: matiko09 folded before Flop (didn't bet)
Seat 9: mycka86 folded before Flop (didn't bet)





PokerStars Hand #150803480708:  Hold'em No Limit ($0.50/$1.00 USD) - 2016/03/23 15:49:21 CET [2016/03/23 10:49:21 ET]
Table 'Haug II' 9-max Seat #4 is the button
Seat 1: PacPacBum ($108.26 in chips) 
Seat 2: ardo888 ($123.62 in chips) 
Seat 3: Do-Man22 ($86 in chips) 
Seat 4: matiko09 ($121.22 in chips) 
Seat 5: GlamDragon ($84.89 in chips) 
Seat 6: Pocketstud ($103.69 in chips) 
Seat 7: jahwe ($100 in chips) 
Seat 8: Olddogtom888 ($100 in chips) 
GlamDragon: posts small blind $0.50
Pocketstud: posts big blind $1
Olddogtom888: posts big blind $1
PacPacBum: posts the ante $0.20
ardo888: posts the ante $0.20
Do-Man22: posts the ante $0.20
matiko09: posts the ante $0.20
GlamDragon: posts the ante $0.20
Pocketstud: posts the ante $0.20
jahwe: posts the ante $0.20
Olddogtom888: posts the ante $0.20
*** HOLE CARDS ***
Dealt to matiko09 [9h Ad]
jahwe: folds 
Olddogtom888: checks 
parforthecse joins the table at seat #9 
PacPacBum: folds 
ardo888: folds 
Do-Man22: folds 
matiko09: raises $3 to $4
GlamDragon: folds 
Pocketstud: folds 
Olddogtom888: calls $3
*** FLOP *** [Td 9s Jc]
GlamDragon leaves the table
Olddogtom888: checks 
matiko09: checks 
*** TURN *** [Td 9s Jc] [Qh]
Olddogtom888: checks 
matiko09: checks 
*** RIVER *** [Td 9s Jc Qh] [7c]
Olddogtom888: checks 
matiko09: checks 
*** SHOW DOWN ***
Olddogtom888: shows [6s 6d] (a pair of Sixes)
matiko09: shows [9h Ad] (a pair of Nines)
matiko09 collected $10.60 from pot
*** SUMMARY ***
Total pot $11.10 | Rake $0.50 
Board [Td 9s Jc Qh 7c]
Seat 1: PacPacBum folded before Flop (didn't bet)
Seat 2: ardo888 folded before Flop (didn't bet)
Seat 3: Do-Man22 folded before Flop (didn't bet)
Seat 4: matiko09 (button) showed [9h Ad] and won ($10.60) with a pair of Nines
Seat 5: GlamDragon (small blind) folded before Flop
Seat 6: Pocketstud (big blind) folded before Flop
Seat 7: jahwe folded before Flop (didn't bet)
Seat 8: Olddogtom888 showed [6s 6d] and lost with a pair of Sixes





PokerStars Hand #150803481781:  Hold'em No Limit ($0.50/$1.00 USD) - 2016/03/23 15:49:24 CET [2016/03/23 10:49:24 ET]
Table 'Sylvia III' 9-max Seat #6 is the button
Seat 1: mycka86 ($127.20 in chips) 
Seat 2: ellis005 ($103.94 in chips) 
Seat 4: lombardo11 ($55.26 in chips) 
Seat 5: matiko09 ($100 in chips) 
Seat 6: PacPacBum ($128.66 in chips) 
Seat 8: ardo888 ($100 in chips) 
Seat 9: GlamDragon ($100 in chips) 
ardo888: posts small blind $0.50
GlamDragon: posts big blind $1
bigacsiga: sits out 
mycka86: posts the ante $0.20
ellis005: posts the ante $0.20
lombardo11: posts the ante $0.20
matiko09: posts the ante $0.20
PacPacBum: posts the ante $0.20
ardo888: posts the ante $0.20
GlamDragon: posts the ante $0.20
*** HOLE CARDS ***
Dealt to matiko09 [5d 3c]
mycka86: folds 
ellis005: folds 
lombardo11: folds 
matiko09: folds 
PacPacBum: raises $1.50 to $2.50
ardo888: raises $7 to $9.50
GlamDragon: folds 
PacPacBum: calls $7
*** FLOP *** [Ah Qs 4h]
GlamDragon leaves the table
omorfadramou joins the table at seat #9 
ardo888: bets $10.83
PacPacBum: folds 
Uncalled bet ($10.83) returned to ardo888
ardo888 collected $20.44 from pot
ardo888: doesn't show hand 
omorfadramou leaves the table
*** SUMMARY ***
Total pot $21.40 | Rake $0.96 
Board [Ah Qs 4h]
Seat 1: mycka86 folded before Flop (didn't bet)
Seat 2: ellis005 folded before Flop (didn't bet)
Seat 4: lombardo11 folded before Flop (didn't bet)
Seat 5: matiko09 folded before Flop (didn't bet)
Seat 6: PacPacBum (button) folded on the Flop
Seat 8: ardo888 (small blind) collected ($20.44)
Seat 9: GlamDragon (big blind) folded before Flop





PokerStars Hand #150803485644:  Hold'em No Limit (€0.50/€1.00 EUR) - 2016/03/23 15:49:36 CET [2016/03/23 10:49:36 ET]
Table 'Mercury III' 9-max Seat #6 is the button
Seat 1: matiko09 (€124.85 in chips) 
Seat 3: PacPacBum (€101.50 in chips) 
Seat 4: Muinmyheart (€121.18 in chips) 
Seat 5: ardo888 (€100 in chips) 
Seat 6: mycka86 (€103.50 in chips) 
Seat 7: STrakDD (€154.09 in chips) 
Seat 8: gfxed (€44.16 in chips) 
Seat 9: Indr3k (€100 in chips) 
STrakDD: posts small blind €0.50
gfxed: posts big blind €1
*** HOLE CARDS ***
Dealt to matiko09 [Ks 8d]
Indr3k: folds 
matiko09: folds 
PacPacBum: folds 
Muinmyheart: folds 
ardo888: folds 
mycka86: folds 
STrakDD: raises €1 to €2
gfxed: calls €1
*** FLOP *** [2h 5s 3d]
STrakDD: bets €2
gfxed: calls €2
*** TURN *** [2h 5s 3d] [3h]
STrakDD: bets €3.82
gfxed: calls €3.82
*** RIVER *** [2h 5s 3d 3h] [2c]
STrakDD: checks 
gfxed: bets €6
STrakDD: calls €6
*** SHOW DOWN ***
gfxed: shows [Kh 6d] (two pair, Threes and Deuces)
STrakDD: shows [Tc As] (two pair, Threes and Deuces - Ace kicker)
STrakDD collected €26.40 from pot
*** SUMMARY ***
Total pot €27.64 | Rake €1.24 
Board [2h 5s 3d 3h 2c]
Seat 1: matiko09 folded before Flop (didn't bet)
Seat 3: PacPacBum folded before Flop (didn't bet)
Seat 4: Muinmyheart folded before Flop (didn't bet)
Seat 5: ardo888 folded before Flop (didn't bet)
Seat 6: mycka86 (button) folded before Flop (didn't bet)
Seat 7: STrakDD (small blind) showed [Tc As] and won (€26.40) with two pair, Threes and Deuces
Seat 8: gfxed (big blind) showed [Kh 6d] and lost with two pair, Threes and Deuces
Seat 9: Indr3k folded before Flop (didn't bet)





PokerStars Hand #150803485958:  Hold'em No Limit ($0.50/$1.00 USD) - 2016/03/23 15:49:37 CET [2016/03/23 10:49:37 ET]
Table 'Asmodeus' 9-max Seat #1 is the button
Seat 1: Muinmyheart ($100 in chips) 
Seat 2: PacPacBum ($100 in chips) 
Seat 5: DrunkPatrik ($81.45 in chips) 
Seat 6: fuppeee ($178.80 in chips) 
Seat 7: mycka86 ($110.38 in chips) 
Seat 8: ardo888 ($102.90 in chips) 
Seat 9: matiko09 ($111.67 in chips) 
PacPacBum: posts small blind $0.50
Effort92: is sitting out 
Effort92 leaves the table
DrunkPatrik: posts big blind $1
Muinmyheart: posts the ante $0.20
PacPacBum: posts the ante $0.20
DrunkPatrik: posts the ante $0.20
fuppeee: posts the ante $0.20
mycka86: posts the ante $0.20
ardo888: posts the ante $0.20
matiko09: posts the ante $0.20
*** HOLE CARDS ***
Dealt to matiko09 [7d 9d]
fuppeee: folds 
mycka86: raises $2 to $3
ardo888: folds 
matiko09: folds 
Muinmyheart: raises $6 to $9
PacPacBum: folds 
DrunkPatrik: folds 
edidaz joins the table at seat #4 
mycka86: folds 
Uncalled bet ($6) returned to Muinmyheart
Muinmyheart collected $8.90 from pot
Muinmyheart: doesn't show hand 
*** SUMMARY ***
Total pot $8.90 | Rake $0 
Seat 1: Muinmyheart (button) collected ($8.90)
Seat 2: PacPacBum (small blind) folded before Flop
Seat 5: DrunkPatrik (big blind) folded before Flop
Seat 6: fuppeee folded before Flop (didn't bet)
Seat 7: mycka86 folded before Flop
Seat 8: ardo888 folded before Flop (didn't bet)
Seat 9: matiko09 folded before Flop (didn't bet)





PokerStars Hand #150803486184:  Hold'em No Limit ($0.50/$1.00 USD) - 2016/03/23 15:49:38 CET [2016/03/23 10:49:38 ET]
Table 'Drakonia II' 9-max Seat #2 is the button
Seat 1: chautinhtri9 ($114 in chips) 
Seat 2: RICKA16 ($99.50 in chips) 
Seat 3: PacPacBum ($100 in chips) 
Seat 5: Muinmyheart ($100 in chips) 
Seat 7: YuriiSolodya ($49.38 in chips) 
Seat 8: matiko09 ($157.70 in chips) 
Seat 9: mycka86 ($100 in chips) 
PacPacBum: posts small blind $0.50
Muinmyheart: posts big blind $1
*** HOLE CARDS ***
Dealt to matiko09 [Td 9c]
YuriiSolodya: raises $1 to $2
matiko09: folds 
mycka86: folds 
chautinhtri9: folds 
RICKA16: folds 
PacPacBum: folds 
Muinmyheart: folds 
Uncalled bet ($1) returned to YuriiSolodya
bigacsiga joins the table at seat #4 
YuriiSolodya collected $2.50 from pot
YuriiSolodya: doesn't show hand 
*** SUMMARY ***
Total pot $2.50 | Rake $0 
Seat 1: chautinhtri9 folded before Flop (didn't bet)
Seat 2: RICKA16 (button) folded before Flop (didn't bet)
Seat 3: PacPacBum (small blind) folded before Flop
Seat 5: Muinmyheart (big blind) folded before Flop
Seat 7: YuriiSolodya collected ($2.50)
Seat 8: matiko09 folded before Flop (didn't bet)
Seat 9: mycka86 folded before Flop (didn't bet)





PokerStars Hand #150803487922:  Hold'em No Limit ($0.50/$1.00 USD) - 2016/03/23 15:49:43 CET [2016/03/23 10:49:43 ET]
Table 'Aetolia II' 9-max Seat #6 is the button
Seat 1: app1e_j@ck ($100 in chips) 
Seat 3: se7en_$tars ($73.94 in chips) 
Seat 4: Pocketstud ($134.27 in chips) 
Seat 5: KingCastle77 ($93.26 in chips) 
Seat 6: Westpants ($125.97 in chips) 
Seat 7: matiko09 ($101.86 in chips) 
Seat 8: PacPacBum ($102.56 in chips) 
Seat 9: omorfadramou ($100 in chips) 
matiko09: posts small blind $0.50
PacPacBum: posts big blind $1
*** HOLE CARDS ***
Dealt to matiko09 [Kc 9c]
omorfadramou: folds 
app1e_j@ck: raises $2 to $3
se7en_$tars: folds 
Pocketstud: folds 
KingCastle77: calls $3
Westpants: folds 
matiko09: folds 
PacPacBum: folds 
*** FLOP *** [7d 8s 3d]
app1e_j@ck: bets $5.37
KingCastle77: folds 
Uncalled bet ($5.37) returned to app1e_j@ck
app1e_j@ck collected $7.16 from pot
app1e_j@ck: doesn't show hand 
*** SUMMARY ***
Total pot $7.50 | Rake $0.34 
Board [7d 8s 3d]
Seat 1: app1e_j@ck collected ($7.16)
Seat 3: se7en_$tars folded before Flop (didn't bet)
Seat 4: Pocketstud folded before Flop (didn't bet)
Seat 5: KingCastle77 folded on the Flop
Seat 6: Westpants (button) folded before Flop (didn't bet)
Seat 7: matiko09 (small blind) folded before Flop
Seat 8: PacPacBum (big blind) folded before Flop
Seat 9: omorfadramou folded before Flop (didn't bet)





PokerStars Hand #150803490357:  Hold'em No Limit ($0.50/$1.00 USD) - 2016/03/23 15:49:51 CET [2016/03/23 10:49:51 ET]
Table 'Drakonia II' 9-max Seat #3 is the button
Seat 1: chautinhtri9 ($114 in chips) 
Seat 2: RICKA16 ($99.50 in chips) 
Seat 3: PacPacBum ($100 in chips) 
Seat 5: Muinmyheart ($100 in chips) 
Seat 7: YuriiSolodya ($50.88 in chips) 
Seat 8: matiko09 ($157.70 in chips) 
Seat 9: mycka86 ($100 in chips) 
bigacsiga will be allowed to play after the button
Muinmyheart: posts small blind $0.50
YuriiSolodya: posts big blind $1
*** HOLE CARDS ***
Dealt to matiko09 [8c Kc]
matiko09: folds 
mycka86: folds 
chautinhtri9: folds 
RICKA16: folds 
PacPacBum: folds 
Muinmyheart: folds 
Uncalled bet ($0.50) returned to YuriiSolodya
YuriiSolodya collected $1 from pot
YuriiSolodya: doesn't show hand 
*** SUMMARY ***
Total pot $1 | Rake $0 
Seat 1: chautinhtri9 folded before Flop (didn't bet)
Seat 2: RICKA16 folded before Flop (didn't bet)
Seat 3: PacPacBum (button) folded before Flop (didn't bet)
Seat 5: Muinmyheart (small blind) folded before Flop
Seat 7: YuriiSolodya (big blind) collected ($1)
Seat 8: matiko09 folded before Flop (didn't bet)
Seat 9: mycka86 folded before Flop (didn't bet)





PokerStars Hand #150803493202:  Hold'em No Limit ($0.50/$1.00 USD) - 2016/03/23 15:50:00 CET [2016/03/23 10:50:00 ET]
Table 'Swings' 9-max Seat #5 is the button
Seat 1: lumen21 ($100.78 in chips) 
Seat 2: tomver0809 ($73.63 in chips) 
Seat 3: edidaz ($100 in chips) 
Seat 4: YuriiSolodya ($38.33 in chips) 
Seat 5: chautinhtri9 ($104.05 in chips) 
Seat 6: matiko09 ($143.99 in chips) 
Seat 7: PacPacBum ($121.99 in chips) 
Seat 8: RICKA16 ($105.96 in chips) 
Seat 9: Effort92 ($105.14 in chips) 
matiko09: posts small blind $0.50
PacPacBum: posts big blind $1
*** HOLE CARDS ***
Dealt to matiko09 [7d 5d]
RICKA16: folds 
Effort92: raises $1.50 to $2.50
lumen21: folds 
tomver0809: folds 
edidaz: folds 
YuriiSolodya: folds 
chautinhtri9: folds 
matiko09: folds 
PacPacBum: folds 
Uncalled bet ($1.50) returned to Effort92
Effort92 collected $2.50 from pot
Effort92: doesn't show hand 
*** SUMMARY ***
Total pot $2.50 | Rake $0 
Seat 1: lumen21 folded before Flop (didn't bet)
Seat 2: tomver0809 folded before Flop (didn't bet)
Seat 3: edidaz folded before Flop (didn't bet)
Seat 4: YuriiSolodya folded before Flop (didn't bet)
Seat 5: chautinhtri9 (button) folded before Flop (didn't bet)
Seat 6: matiko09 (small blind) folded before Flop
Seat 7: PacPacBum (big blind) folded before Flop
Seat 8: RICKA16 folded before Flop (didn't bet)
Seat 9: Effort92 collected ($2.50)





PokerStars Hand #150803497949:  Hold'em No Limit ($0.50/$1.00 USD) - 2016/03/23 15:50:16 CET [2016/03/23 10:50:16 ET]
Table 'Drakonia II' 9-max Seat #5 is the button
Seat 1: chautinhtri9 ($114 in chips) 
Seat 2: RICKA16 ($99.50 in chips) 
Seat 3: PacPacBum ($100 in chips) 
Seat 5: Muinmyheart ($100 in chips) 
Seat 7: YuriiSolodya ($51.38 in chips) 
Seat 8: matiko09 ($157.70 in chips) 
Seat 9: mycka86 ($100 in chips) 
YuriiSolodya: posts small blind $0.50
matiko09: posts big blind $1
bigacsiga: sits out 
*** HOLE CARDS ***
Dealt to matiko09 [6d Kc]
mycka86: folds 
chautinhtri9: folds 
RICKA16: folds 
PacPacBum: folds 
Muinmyheart: folds 
YuriiSolodya: folds 
Uncalled bet ($0.50) returned to matiko09
matiko09 collected $1 from pot
matiko09: doesn't show hand 
*** SUMMARY ***
Total pot $1 | Rake $0 
Seat 1: chautinhtri9 folded before Flop (didn't bet)
Seat 2: RICKA16 folded before Flop (didn't bet)
Seat 3: PacPacBum folded before Flop (didn't bet)
Seat 5: Muinmyheart (button) folded before Flop (didn't bet)
Seat 7: YuriiSolodya (small blind) folded before Flop
Seat 8: matiko09 (big blind) collected ($1)
Seat 9: mycka86 folded before Flop (didn't bet)





PokerStars Hand #150803498640:  Hold'em No Limit ($0.50/$1.00 USD) - 2016/03/23 15:50:18 CET [2016/03/23 10:50:18 ET]
Table 'Sylvia III' 9-max Seat #8 is the button
Seat 1: mycka86 ($127 in chips) 
Seat 2: ellis005 ($103.74 in chips) 
Seat 4: lombardo11 ($55.06 in chips) 
Seat 5: matiko09 ($100 in chips) 
Seat 6: PacPacBum ($118.96 in chips) 
Seat 8: ardo888 ($110.74 in chips) 
mycka86: posts small blind $0.50
ellis005: posts big blind $1
bigacsiga: sits out 
mycka86: posts the ante $0.20
ellis005: posts the ante $0.20
lombardo11: posts the ante $0.20
matiko09: posts the ante $0.20
PacPacBum: posts the ante $0.20
ardo888: posts the ante $0.20
*** HOLE CARDS ***
Dealt to matiko09 [9c 3d]
edidaz joins the table at seat #9 
lombardo11: raises $1 to $2
edidaz leaves the table
matiko09: folds 
PacPacBum: folds 
ardo888: folds 
mycka86: calls $1.50
ellis005: folds 
*** FLOP *** [Qc 2h 4s]
mycka86: checks 
lombardo11: checks 
*** TURN *** [Qc 2h 4s] [Td]
mycka86: checks 
lombardo11: checks 
*** RIVER *** [Qc 2h 4s Td] [Th]
mycka86: checks 
lombardo11: checks 
*** SHOW DOWN ***
mycka86: shows [6h 6d] (two pair, Tens and Sixes)
lombardo11: mucks hand 
mycka86 collected $5.92 from pot
*** SUMMARY ***
Total pot $6.20 | Rake $0.28 
Board [Qc 2h 4s Td Th]
Seat 1: mycka86 (small blind) showed [6h 6d] and won ($5.92) with two pair, Tens and Sixes
Seat 2: ellis005 (big blind) folded before Flop
Seat 4: lombardo11 mucked [Ah 7h]
Seat 5: matiko09 folded before Flop (didn't bet)
Seat 6: PacPacBum folded before Flop (didn't bet)
Seat 8: ardo888 (button) folded before Flop (didn't bet)





PokerStars Hand #150803499392:  Hold'em No Limit ($0.50/$1.00 USD) - 2016/03/23 15:50:20 CET [2016/03/23 10:50:20 ET]
Table 'Smiley' 9-max Seat #4 is the button
Seat 3: mycka86 ($121.41 in chips) 
Seat 4: CAJUN890 ($86.11 in chips) 
Seat 5: Szevasztopol ($115.40 in chips) 
Seat 7: bennetb77 ($112.53 in chips) 
Seat 8: matiko09 ($110.76 in chips) 
Seat 9: PacPacBum ($101.31 in chips) 
Szevasztopol: posts small blind $0.50
blackmont111: is sitting out 
bennetb77: posts big blind $1
omorfadramou: sits out 
*** HOLE CARDS ***
Dealt to matiko09 [5s 5c]
matiko09: folds 
PacPacBum: folds 
mycka86: raises $1.10 to $2.10
CAJUN890: folds 
Szevasztopol: folds 
bennetb77: calls $1.10
*** FLOP *** [Qd 6h 4d]
bennetb77: checks 
mycka86: bets $2.46
bennetb77: raises $2.54 to $5
mycka86: calls $2.54
*** TURN *** [Qd 6h 4d] [Td]
bennetb77: bets $7.16
mycka86: folds 
Uncalled bet ($7.16) returned to bennetb77
bennetb77 collected $14.04 from pot
bennetb77: doesn't show hand 
*** SUMMARY ***
Total pot $14.70 | Rake $0.66 
Board [Qd 6h 4d Td]
Seat 3: mycka86 folded on the Turn
Seat 4: CAJUN890 (button) folded before Flop (didn't bet)
Seat 5: Szevasztopol (small blind) folded before Flop
Seat 7: bennetb77 (big blind) collected ($14.04)
Seat 8: matiko09 folded before Flop (didn't bet)
Seat 9: PacPacBum folded before Flop (didn't bet)





PokerStars Hand #150803502876:  Hold'em No Limit ($0.50/$1.00 USD) - 2016/03/23 15:50:31 CET [2016/03/23 10:50:31 ET]
Table 'Drakonia II' 9-max Seat #7 is the button
Seat 1: chautinhtri9 ($114 in chips) 
Seat 2: RICKA16 ($99.50 in chips) 
Seat 3: PacPacBum ($100 in chips) 
Seat 5: Muinmyheart ($100 in chips) 
Seat 7: YuriiSolodya ($50.88 in chips) 
Seat 8: matiko09 ($158.20 in chips) 
matiko09: posts small blind $0.50
mycka86: is sitting out 
chautinhtri9: posts big blind $1
bigacsiga: sits out 
*** HOLE CARDS ***
Dealt to matiko09 [9c Ts]
RICKA16: folds 
PacPacBum: folds 
Muinmyheart: folds 
YuriiSolodya: folds 
matiko09: raises $1.50 to $2.50
chautinhtri9: calls $1.50
*** FLOP *** [Ks 6s Qd]
matiko09: bets $3
chautinhtri9: folds 
Uncalled bet ($3) returned to matiko09
matiko09 collected $4.78 from pot
matiko09: doesn't show hand 
*** SUMMARY ***
Total pot $5 | Rake $0.22 
Board [Ks 6s Qd]
Seat 1: chautinhtri9 (big blind) folded on the Flop
Seat 2: RICKA16 folded before Flop (didn't bet)
Seat 3: PacPacBum folded before Flop (didn't bet)
Seat 5: Muinmyheart folded before Flop (didn't bet)
Seat 7: YuriiSolodya (button) folded before Flop (didn't bet)
Seat 8: matiko09 (small blind) collected ($4.78)





PokerStars Hand #150803503430:  Hold'em No Limit ($0.50/$1.00 USD) - 2016/03/23 15:50:33 CET [2016/03/23 10:50:33 ET]
Table 'Haug II' 9-max Seat #6 is the button
Seat 1: PacPacBum ($108.06 in chips) 
Seat 2: ardo888 ($123.42 in chips) 
Seat 3: Do-Man22 ($85.80 in chips) 
Seat 4: matiko09 ($127.62 in chips) 
Seat 6: Pocketstud ($102.49 in chips) 
Seat 8: Olddogtom888 ($95.80 in chips) 
Seat 9: parforthecse ($80 in chips) 
Olddogtom888: posts small blind $0.50
parforthecse: posts big blind $1
PacPacBum: posts the ante $0.20
ardo888: posts the ante $0.20
Do-Man22: posts the ante $0.20
matiko09: posts the ante $0.20
Pocketstud: posts the ante $0.20
Olddogtom888: posts the ante $0.20
parforthecse: posts the ante $0.20
*** HOLE CARDS ***
Dealt to matiko09 [3s 9h]
PacPacBum: folds 
ardo888: folds 
Do-Man22: calls $1
Dantist1122 joins the table at seat #5 
matiko09: folds 
Pocketstud: folds 
Olddogtom888: calls $0.50
parforthecse: checks 
*** FLOP *** [5h 3c Ac]
Olddogtom888: checks 
parforthecse: checks 
Do-Man22: checks 
*** TURN *** [5h 3c Ac] [Th]
Olddogtom888: checks 
parforthecse: checks 
Do-Man22: checks 
*** RIVER *** [5h 3c Ac Th] [Kh]
Olddogtom888: checks 
parforthecse: checks 
Do-Man22: checks 
*** SHOW DOWN ***
Olddogtom888: shows [5d Kd] (two pair, Kings and Fives)
parforthecse: mucks hand 
Do-Man22: mucks hand 
Olddogtom888 collected $4.20 from pot
*** SUMMARY ***
Total pot $4.40 | Rake $0.20 
Board [5h 3c Ac Th Kh]
Seat 1: PacPacBum folded before Flop (didn't bet)
Seat 2: ardo888 folded before Flop (didn't bet)
Seat 3: Do-Man22 mucked [8s 8h]
Seat 4: matiko09 folded before Flop (didn't bet)
Seat 6: Pocketstud (button) folded before Flop (didn't bet)
Seat 8: Olddogtom888 (small blind) showed [5d Kd] and won ($4.20) with two pair, Kings and Fives
Seat 9: parforthecse (big blind) mucked [Jd 4s]





PokerStars Hand #150803504218:  Hold'em No Limit ($0.50/$1.00 USD) - 2016/03/23 15:50:36 CET [2016/03/23 10:50:36 ET]
Table 'Swings' 9-max Seat #6 is the button
Seat 1: lumen21 ($100.78 in chips) 
Seat 2: tomver0809 ($73.63 in chips) 
Seat 3: edidaz ($100 in chips) 
Seat 4: YuriiSolodya ($38.33 in chips) 
Seat 5: chautinhtri9 ($104.05 in chips) 
Seat 6: matiko09 ($143.49 in chips) 
Seat 7: PacPacBum ($120.99 in chips) 
Seat 8: RICKA16 ($105.96 in chips) 
Seat 9: Effort92 ($106.64 in chips) 
PacPacBum: posts small blind $0.50
RICKA16: posts big blind $1
*** HOLE CARDS ***
Dealt to matiko09 [Qc 7c]
Effort92: folds 
lumen21: folds 
tomver0809: raises $1 to $2
edidaz: folds 
YuriiSolodya: folds 
chautinhtri9: folds 
matiko09: folds 
PacPacBum: folds 
RICKA16: folds 
Uncalled bet ($1) returned to tomver0809
tomver0809 collected $2.50 from pot
tomver0809: doesn't show hand 
*** SUMMARY ***
Total pot $2.50 | Rake $0 
Seat 1: lumen21 folded before Flop (didn't bet)
Seat 2: tomver0809 collected ($2.50)
Seat 3: edidaz folded before Flop (didn't bet)
Seat 4: YuriiSolodya folded before Flop (didn't bet)
Seat 5: chautinhtri9 folded before Flop (didn't bet)
Seat 6: matiko09 (button) folded before Flop (didn't bet)
Seat 7: PacPacBum (small blind) folded before Flop
Seat 8: RICKA16 (big blind) folded before Flop
Seat 9: Effort92 folded before Flop (didn't bet)





PokerStars Hand #150803507658:  Hold'em No Limit ($0.50/$1.00 USD) - 2016/03/23 15:50:47 CET [2016/03/23 10:50:47 ET]
Table 'Asmodeus' 9-max Seat #2 is the button
Seat 1: Muinmyheart ($105.70 in chips) 
Seat 2: PacPacBum ($100 in chips) 
Seat 5: DrunkPatrik ($80.25 in chips) 
Seat 6: fuppeee ($178.60 in chips) 
Seat 7: mycka86 ($107.18 in chips) 
Seat 8: ardo888 ($102.70 in chips) 
Seat 9: matiko09 ($111.47 in chips) 
DrunkPatrik: posts small blind $0.50
fuppeee: posts big blind $1
Muinmyheart: posts the ante $0.20
PacPacBum: posts the ante $0.20
DrunkPatrik: posts the ante $0.20
fuppeee: posts the ante $0.20
mycka86: posts the ante $0.20
ardo888: posts the ante $0.20
matiko09: posts the ante $0.20
*** HOLE CARDS ***
Dealt to matiko09 [5c 7h]
mycka86: raises $2 to $3
ardo888: folds 
matiko09: folds 
Muinmyheart: folds 
PacPacBum: folds 
DrunkPatrik: calls $2.50
fuppeee: folds 
*** FLOP *** [As Ah 3c]
DrunkPatrik: bets $3
edidaz leaves the table
mycka86: calls $3
*** TURN *** [As Ah 3c] [3s]
DrunkPatrik: bets $5
mycka86: calls $5
*** RIVER *** [As Ah 3c 3s] [9s]
DrunkPatrik: bets $7
mycka86: raises $20.51 to $27.51
DrunkPatrik: calls $20.51
*** SHOW DOWN ***
mycka86: shows [Qc Ad] (a full house, Aces full of Threes)
DrunkPatrik: mucks hand 
mycka86 collected $76.62 from pot
*** SUMMARY ***
Total pot $79.42 | Rake $2.80 
Board [As Ah 3c 3s 9s]
Seat 1: Muinmyheart folded before Flop (didn't bet)
Seat 2: PacPacBum (button) folded before Flop (didn't bet)
Seat 5: DrunkPatrik (small blind) mucked [8s 8d]
Seat 6: fuppeee (big blind) folded before Flop
Seat 7: mycka86 showed [Qc Ad] and won ($76.62) with a full house, Aces full of Threes
Seat 8: ardo888 folded before Flop (didn't bet)
Seat 9: matiko09 folded before Flop (didn't bet)





PokerStars Hand #150803511521:  Hold'em No Limit ($0.50/$1.00 USD) - 2016/03/23 15:50:59 CET [2016/03/23 10:50:59 ET]
Table 'Aetolia II' 9-max Seat #7 is the button
Seat 1: app1e_j@ck ($104.16 in chips) 
Seat 3: se7en_$tars ($73.94 in chips) 
Seat 4: Pocketstud ($134.27 in chips) 
Seat 5: KingCastle77 ($90.26 in chips) 
Seat 6: Westpants ($125.97 in chips) 
Seat 7: matiko09 ($101.36 in chips) 
Seat 8: PacPacBum ($101.56 in chips) 
Seat 9: omorfadramou ($100 in chips) 
PacPacBum: posts small blind $0.50
omorfadramou: posts big blind $1
*** HOLE CARDS ***
Dealt to matiko09 [8c 6c]
app1e_j@ck: raises $2 to $3
se7en_$tars: folds 
Pocketstud: folds 
KingCastle77: calls $3
Westpants: raises $8 to $11
matiko09: folds 
PacPacBum: folds 
omorfadramou: folds 
app1e_j@ck: raises $12 to $23
KingCastle77: folds 
Westpants: calls $12
*** FLOP *** [Qs 8h Kh]
app1e_j@ck: bets $19
Westpants: calls $19
*** TURN *** [Qs 8h Kh] [As]
app1e_j@ck: checks 
Westpants: bets $83.97 and is all-in
app1e_j@ck: folds 
Uncalled bet ($83.97) returned to Westpants
Westpants collected $85.70 from pot
*** SUMMARY ***
Total pot $88.50 | Rake $2.80 
Board [Qs 8h Kh As]
Seat 1: app1e_j@ck folded on the Turn
Seat 3: se7en_$tars folded before Flop (didn't bet)
Seat 4: Pocketstud folded before Flop (didn't bet)
Seat 5: KingCastle77 folded before Flop
Seat 6: Westpants collected ($85.70)
Seat 7: matiko09 (button) folded before Flop (didn't bet)
Seat 8: PacPacBum (small blind) folded before Flop
Seat 9: omorfadramou (big blind) folded before Flop





PokerStars Hand #150803513720:  Hold'em No Limit ($0.50/$1.00 USD) - 2016/03/23 15:51:06 CET [2016/03/23 10:51:06 ET]
Table 'Drakonia II' 9-max Seat #8 is the button
Seat 1: chautinhtri9 ($111.50 in chips) 
Seat 2: RICKA16 ($99.50 in chips) 
Seat 3: PacPacBum ($100 in chips) 
Seat 5: Muinmyheart ($100 in chips) 
Seat 7: YuriiSolodya ($50.88 in chips) 
Seat 8: matiko09 ($160.48 in chips) 
chautinhtri9: posts small blind $0.50
RICKA16: posts big blind $1
bigacsiga: sits out 
*** HOLE CARDS ***
Dealt to matiko09 [7s 9s]
PacPacBum: folds 
Muinmyheart: folds 
YuriiSolodya: folds 
matiko09: raises $1.27 to $2.27
chautinhtri9: folds 
mycka86 leaves the table
RICKA16: folds 
Uncalled bet ($1.27) returned to matiko09
matiko09 collected $2.50 from pot
matiko09: doesn't show hand 
*** SUMMARY ***
Total pot $2.50 | Rake $0 
Seat 1: chautinhtri9 (small blind) folded before Flop
Seat 2: RICKA16 (big blind) folded before Flop
Seat 3: PacPacBum folded before Flop (didn't bet)
Seat 5: Muinmyheart folded before Flop (didn't bet)
Seat 7: YuriiSolodya folded before Flop (didn't bet)
Seat 8: matiko09 (button) collected ($2.50)





PokerStars Hand #150803514339:  Hold'em No Limit ($0.50/$1.00 USD) - 2016/03/23 15:51:08 CET [2016/03/23 10:51:08 ET]
Table 'Sylvia III' 9-max Seat #1 is the button
Seat 1: mycka86 ($130.72 in chips) 
Seat 2: ellis005 ($102.54 in chips) 
Seat 3: bigacsiga ($144.18 in chips) 
Seat 4: lombardo11 ($52.86 in chips) 
Seat 5: matiko09 ($100 in chips) 
Seat 6: PacPacBum ($118.76 in chips) 
Seat 8: ardo888 ($110.54 in chips) 
ellis005: posts small blind $0.50
bigacsiga: posts big blind $1
mycka86: posts the ante $0.20
ellis005: posts the ante $0.20
bigacsiga: posts the ante $0.20
lombardo11: posts the ante $0.20
matiko09: posts the ante $0.20
PacPacBum: posts the ante $0.20
ardo888: posts the ante $0.20
*** HOLE CARDS ***
Dealt to matiko09 [2c Ks]
lombardo11: raises $2 to $3
omorfadramou joins the table at seat #9 
matiko09: folds 
PacPacBum: folds 
ardo888: folds 
mycka86: folds 
ellis005: folds 
bigacsiga: folds 
Uncalled bet ($2) returned to lombardo11
lombardo11 collected $3.90 from pot
lombardo11: doesn't show hand 
*** SUMMARY ***
Total pot $3.90 | Rake $0 
Seat 1: mycka86 (button) folded before Flop (didn't bet)
Seat 2: ellis005 (small blind) folded before Flop
Seat 3: bigacsiga (big blind) folded before Flop
Seat 4: lombardo11 collected ($3.90)
Seat 5: matiko09 folded before Flop (didn't bet)
Seat 6: PacPacBum folded before Flop (didn't bet)
Seat 8: ardo888 folded before Flop (didn't bet)





PokerStars Hand #150803516827:  Hold'em No Limit (€0.50/€1.00 EUR) - 2016/03/23 15:51:16 CET [2016/03/23 10:51:16 ET]
Table 'Mercury III' 9-max Seat #7 is the button
Seat 1: matiko09 (€124.85 in chips) 
Seat 3: PacPacBum (€101.50 in chips) 
Seat 4: Muinmyheart (€121.18 in chips) 
Seat 5: ardo888 (€100 in chips) 
Seat 6: mycka86 (€103.50 in chips) 
Seat 7: STrakDD (€166.67 in chips) 
Seat 8: gfxed (€30.34 in chips) 
Seat 9: Indr3k (€100 in chips) 
gfxed: posts small blind €0.50
Indr3k: posts big blind €1
*** HOLE CARDS ***
Dealt to matiko09 [5s 2c]
matiko09: folds 
PacPacBum: folds 
Muinmyheart: raises €2 to €3
ardo888: folds 
mycka86: folds 
STrakDD: folds 
gfxed: folds 
Indr3k: calls €2
*** FLOP *** [Ks 9d Qh]
Indr3k: checks 
Muinmyheart: checks 
*** TURN *** [Ks 9d Qh] [7s]
Indr3k: checks 
Muinmyheart: checks 
*** RIVER *** [Ks 9d Qh 7s] [Tc]
Indr3k: bets €4
Muinmyheart: folds 
Uncalled bet (€4) returned to Indr3k
Indr3k collected €6.21 from pot
Indr3k: doesn't show hand 
*** SUMMARY ***
Total pot €6.50 | Rake €0.29 
Board [Ks 9d Qh 7s Tc]
Seat 1: matiko09 folded before Flop (didn't bet)
Seat 3: PacPacBum folded before Flop (didn't bet)
Seat 4: Muinmyheart folded on the River
Seat 5: ardo888 folded before Flop (didn't bet)
Seat 6: mycka86 folded before Flop (didn't bet)
Seat 7: STrakDD (button) folded before Flop (didn't bet)
Seat 8: gfxed (small blind) folded before Flop
Seat 9: Indr3k (big blind) collected (€6.21)





PokerStars Hand #150803516857:  Hold'em No Limit ($0.50/$1.00 USD) - 2016/03/23 15:51:16 CET [2016/03/23 10:51:16 ET]
Table 'Swings' 9-max Seat #7 is the button
Seat 1: lumen21 ($100.78 in chips) 
Seat 2: tomver0809 ($75.13 in chips) 
Seat 3: edidaz ($100 in chips) 
Seat 4: YuriiSolodya ($38.33 in chips) 
Seat 5: chautinhtri9 ($104.05 in chips) 
Seat 6: matiko09 ($143.49 in chips) 
Seat 7: PacPacBum ($120.49 in chips) 
Seat 8: RICKA16 ($104.96 in chips) 
RICKA16: posts small blind $0.50
Effort92: is sitting out 
lumen21: posts big blind $1
*** HOLE CARDS ***
Dealt to matiko09 [8c Ad]
Effort92 leaves the table
tomver0809: calls $1
edidaz: folds 
YuriiSolodya: calls $1
chautinhtri9: folds 
matiko09: folds 
PacPacBum: folds 
RICKA16: calls $0.50
lumen21: checks 
*** FLOP *** [7h 6s Ts]
RICKA16: checks 
lumen21: checks 
tomver0809: checks 
YuriiSolodya: bets $3.82
RICKA16: folds 
lumen21: folds 
tomver0809: folds 
Uncalled bet ($3.82) returned to YuriiSolodya
YuriiSolodya collected $3.82 from pot
YuriiSolodya: doesn't show hand 
*** SUMMARY ***
Total pot $4 | Rake $0.18 
Board [7h 6s Ts]
Seat 1: lumen21 (big blind) folded on the Flop
Seat 2: tomver0809 folded on the Flop
Seat 3: edidaz folded before Flop (didn't bet)
Seat 4: YuriiSolodya collected ($3.82)
Seat 5: chautinhtri9 folded before Flop (didn't bet)
Seat 6: matiko09 folded before Flop (didn't bet)
Seat 7: PacPacBum (button) folded before Flop (didn't bet)
Seat 8: RICKA16 (small blind) folded on the Flop





PokerStars Hand #150803517385:  Hold'em No Limit ($0.50/$1.00 USD) - 2016/03/23 15:51:18 CET [2016/03/23 10:51:18 ET]
Table 'Smiley' 9-max Seat #5 is the button
Seat 3: mycka86 ($114.31 in chips) 
Seat 4: CAJUN890 ($86.11 in chips) 
Seat 5: Szevasztopol ($114.90 in chips) 
Seat 7: bennetb77 ($119.47 in chips) 
Seat 8: matiko09 ($110.76 in chips) 
Seat 9: PacPacBum ($101.31 in chips) 
bennetb77: posts small blind $0.50
matiko09: posts big blind $1
omorfadramou: sits out 
*** HOLE CARDS ***
Dealt to matiko09 [Qs 2h]
PacPacBum: folds 
mycka86: folds 
CAJUN890: folds 
Szevasztopol: folds 
bennetb77: raises $1 to $2
matiko09: folds 
Uncalled bet ($1) returned to bennetb77
bennetb77 collected $2 from pot
bennetb77: doesn't show hand 
*** SUMMARY ***
Total pot $2 | Rake $0 
Seat 3: mycka86 folded before Flop (didn't bet)
Seat 4: CAJUN890 folded before Flop (didn't bet)
Seat 5: Szevasztopol (button) folded before Flop (didn't bet)
Seat 7: bennetb77 (small blind) collected ($2)
Seat 8: matiko09 (big blind) folded before Flop
Seat 9: PacPacBum folded before Flop (didn't bet)





PokerStars Hand #150803519630:  Hold'em No Limit ($1/$2 USD) - 2016/03/23 15:51:25 CET [2016/03/23 10:51:25 ET]
Table 'Kiess' 9-max Seat #5 is the button
Seat 1: Cirilico ($243.87 in chips) 
Seat 3: Red4erT ($83.62 in chips) 
Seat 4: RamiroAgujis ($230.10 in chips) 
Seat 5: chippo boy ($463.88 in chips) 
Seat 6: matiko09 ($211.48 in chips) 
Seat 7: chaps1988 ($218.92 in chips) 
Seat 8: erfk1958 ($127.78 in chips) 
Seat 9: PacPacBum ($200 in chips) 
matiko09: posts small blind $1
chaps1988: posts big blind $2
*** HOLE CARDS ***
Dealt to matiko09 [8h Qd]
erfk1958: folds 
PacPacBum: folds 
Cirilico: raises $4 to $6
Red4erT: folds 
RamiroAgujis: folds 
chippo boy: calls $6
matiko09: folds 
chaps1988: folds 
*** FLOP *** [Ah Ts 3c]
Cirilico: bets $7.16
chippo boy: calls $7.16
*** TURN *** [Ah Ts 3c] [Th]
Cirilico: checks 
chippo boy: checks 
*** RIVER *** [Ah Ts 3c Th] [Kh]
Cirilico: checks 
chippo boy: bets $10
Cirilico: folds 
Uncalled bet ($10) returned to chippo boy
chippo boy collected $28 from pot
*** SUMMARY ***
Total pot $29.32 | Rake $1.32 
Board [Ah Ts 3c Th Kh]
Seat 1: Cirilico folded on the River
Seat 3: Red4erT folded before Flop (didn't bet)
Seat 4: RamiroAgujis folded before Flop (didn't bet)
Seat 5: chippo boy (button) collected ($28)
Seat 6: matiko09 (small blind) folded before Flop
Seat 7: chaps1988 (big blind) folded before Flop
Seat 8: erfk1958 folded before Flop (didn't bet)
Seat 9: PacPacBum folded before Flop (didn't bet)





PokerStars Hand #150803520232:  Hold'em No Limit ($0.50/$1.00 USD) - 2016/03/23 15:51:27 CET [2016/03/23 10:51:27 ET]
Table 'Drakonia II' 9-max Seat #1 is the button
Seat 1: chautinhtri9 ($111 in chips) 
Seat 2: RICKA16 ($98.50 in chips) 
Seat 3: PacPacBum ($100 in chips) 
Seat 5: Muinmyheart ($100 in chips) 
Seat 7: YuriiSolodya ($50.88 in chips) 
Seat 8: matiko09 ($161.98 in chips) 
RICKA16: posts small blind $0.50
PacPacBum: posts big blind $1
bigacsiga: sits out 
*** HOLE CARDS ***
Dealt to matiko09 [9c 7d]
Muinmyheart: folds 
YuriiSolodya: folds 
matiko09: folds 
chautinhtri9: raises $1 to $2
RICKA16: calls $1.50
PacPacBum: calls $1
*** FLOP *** [Kd 6s 4c]
RICKA16: checks 
PacPacBum: checks 
chautinhtri9: bets $2.86
RICKA16: folds 
PacPacBum: folds 
Uncalled bet ($2.86) returned to chautinhtri9
chautinhtri9 collected $5.73 from pot
chautinhtri9: doesn't show hand 
*** SUMMARY ***
Total pot $6 | Rake $0.27 
Board [Kd 6s 4c]
Seat 1: chautinhtri9 (button) collected ($5.73)
Seat 2: RICKA16 (small blind) folded on the Flop
Seat 3: PacPacBum (big blind) folded on the Flop
Seat 5: Muinmyheart folded before Flop (didn't bet)
Seat 7: YuriiSolodya folded before Flop (didn't bet)
Seat 8: matiko09 folded before Flop (didn't bet)





PokerStars Hand #150803521319:  Hold'em No Limit ($0.50/$1.00 USD) - 2016/03/23 15:51:30 CET [2016/03/23 10:51:30 ET]
Table 'Sylvia III' 9-max Seat #2 is the button
Seat 1: mycka86 ($130.52 in chips) 
Seat 2: ellis005 ($101.84 in chips) 
Seat 3: bigacsiga ($142.98 in chips) 
Seat 4: lombardo11 ($55.56 in chips) 
Seat 5: matiko09 ($100 in chips) 
Seat 6: PacPacBum ($118.56 in chips) 
Seat 8: ardo888 ($110.34 in chips) 
bigacsiga: posts small blind $0.50
lombardo11: posts big blind $1
omorfadramou: sits out 
mycka86: posts the ante $0.20
ellis005: posts the ante $0.20
bigacsiga: posts the ante $0.20
lombardo11: posts the ante $0.20
matiko09: posts the ante $0.20
PacPacBum: posts the ante $0.20
ardo888: posts the ante $0.20
*** HOLE CARDS ***
Dealt to matiko09 [4h As]
matiko09: folds 
PacPacBum: raises $1.50 to $2.50
ardo888: folds 
mycka86: folds 
ellis005: folds 
bigacsiga: folds 
lombardo11: calls $1.50
*** FLOP *** [Jh 5s 5d]
lombardo11: checks 
PacPacBum: checks 
*** TURN *** [Jh 5s 5d] [3h]
lombardo11: bets $4
PacPacBum: calls $4
*** RIVER *** [Jh 5s 5d 3h] [Js]
lombardo11: checks 
PacPacBum: bets $4.98
lombardo11: raises $14.02 to $19
PacPacBum: folds 
Uncalled bet ($14.02) returned to lombardo11
lombardo11 collected $23.74 from pot
lombardo11: doesn't show hand 
*** SUMMARY ***
Total pot $24.86 | Rake $1.12 
Board [Jh 5s 5d 3h Js]
Seat 1: mycka86 folded before Flop (didn't bet)
Seat 2: ellis005 (button) folded before Flop (didn't bet)
Seat 3: bigacsiga (small blind) folded before Flop
Seat 4: lombardo11 (big blind) collected ($23.74)
Seat 5: matiko09 folded before Flop (didn't bet)
Seat 6: PacPacBum folded on the River
Seat 8: ardo888 folded before Flop (didn't bet)





PokerStars Hand #150803523004:  Hold'em No Limit (€1/€2 EUR) - 2016/03/23 15:51:36 CET [2016/03/23 10:51:36 ET]
Table 'Pluto II' 9-max Seat #6 is the button
Seat 5: aliwunder (€94.92 in chips) 
Seat 6: PacPacBum (€200 in chips) 
Seat 7: bigacsiga (€200 in chips) 
Seat 9: matiko09 (€200 in chips) 
bigacsiga: posts small blind €1
matiko09: posts big blind €2
*** HOLE CARDS ***
Dealt to matiko09 [2c Ts]
aliwunder: folds 
PacPacBum: raises €2.08 to €4.08
bigacsiga: folds 
matiko09: folds 
Uncalled bet (€2.08) returned to PacPacBum
PacPacBum collected €5 from pot
PacPacBum: doesn't show hand 
*** SUMMARY ***
Total pot €5 | Rake €0 
Seat 5: aliwunder folded before Flop (didn't bet)
Seat 6: PacPacBum (button) collected (€5)
Seat 7: bigacsiga (small blind) folded before Flop
Seat 9: matiko09 (big blind) folded before Flop





PokerStars Hand #150803524535:  Hold'em No Limit ($0.50/$1.00 USD) - 2016/03/23 15:51:41 CET [2016/03/23 10:51:41 ET]
Table 'Smiley' 9-max Seat #7 is the button
Seat 3: mycka86 ($114.31 in chips) 
Seat 4: CAJUN890 ($86.11 in chips) 
Seat 5: Szevasztopol ($114.90 in chips) 
Seat 7: bennetb77 ($120.47 in chips) 
Seat 8: matiko09 ($109.76 in chips) 
Seat 9: PacPacBum ($101.31 in chips) 
matiko09: posts small blind $0.50
PacPacBum: posts big blind $1
omorfadramou: sits out 
*** HOLE CARDS ***
Dealt to matiko09 [8d 3s]
mycka86: raises $2 to $3
CAJUN890: folds 
Szevasztopol: folds 
bennetb77: folds 
matiko09: folds 
PacPacBum: calls $2
*** FLOP *** [4s Th Js]
PacPacBum: checks 
mycka86: bets $4.60
PacPacBum: folds 
Uncalled bet ($4.60) returned to mycka86
mycka86 collected $6.21 from pot
*** SUMMARY ***
Total pot $6.50 | Rake $0.29 
Board [4s Th Js]
Seat 3: mycka86 collected ($6.21)
Seat 4: CAJUN890 folded before Flop (didn't bet)
Seat 5: Szevasztopol folded before Flop (didn't bet)
Seat 7: bennetb77 (button) folded before Flop (didn't bet)
Seat 8: matiko09 (small blind) folded before Flop
Seat 9: PacPacBum (big blind) folded on the Flop





PokerStars Hand #150803526206:  Hold'em No Limit ($0.50/$1.00 USD) - 2016/03/23 15:51:46 CET [2016/03/23 10:51:46 ET]
Table 'Haug II' 9-max Seat #8 is the button
Seat 1: PacPacBum ($107.86 in chips) 
Seat 2: ardo888 ($123.22 in chips) 
Seat 3: Do-Man22 ($84.60 in chips) 
Seat 4: matiko09 ($127.42 in chips) 
Seat 6: Pocketstud ($102.29 in chips) 
Seat 8: Olddogtom888 ($98.80 in chips) 
Seat 9: parforthecse ($78.80 in chips) 
parforthecse: posts small blind $0.50
PacPacBum: posts big blind $1
PacPacBum: posts the ante $0.20
ardo888: posts the ante $0.20
Do-Man22: posts the ante $0.20
matiko09: posts the ante $0.20
Pocketstud: posts the ante $0.20
Olddogtom888: posts the ante $0.20
parforthecse: posts the ante $0.20
*** HOLE CARDS ***
Dealt to matiko09 [8h 5d]
ardo888: folds 
Do-Man22: folds 
matiko09: folds 
Pocketstud: folds 
Olddogtom888: folds 
parforthecse: raises $1 to $2
PacPacBum: calls $1
*** FLOP *** [8d Kc 9h]
parforthecse: bets $2
PacPacBum: folds 
Uncalled bet ($2) returned to parforthecse
parforthecse collected $5.16 from pot
parforthecse: doesn't show hand 
*** SUMMARY ***
Total pot $5.40 | Rake $0.24 
Board [8d Kc 9h]
Seat 1: PacPacBum (big blind) folded on the Flop
Seat 2: ardo888 folded before Flop (didn't bet)
Seat 3: Do-Man22 folded before Flop (didn't bet)
Seat 4: matiko09 folded before Flop (didn't bet)
Seat 6: Pocketstud folded before Flop (didn't bet)
Seat 8: Olddogtom888 (button) folded before Flop (didn't bet)
Seat 9: parforthecse (small blind) collected ($5.16)





PokerStars Hand #150803527405:  Hold'em No Limit ($0.50/$1.00 USD) - 2016/03/23 15:51:50 CET [2016/03/23 10:51:50 ET]
Table 'Asmodeus' 9-max Seat #5 is the button
Seat 1: Muinmyheart ($105.50 in chips) 
Seat 2: PacPacBum ($100 in chips) 
Seat 5: DrunkPatrik ($41.54 in chips) 
Seat 6: fuppeee ($177.40 in chips) 
Seat 8: ardo888 ($102.50 in chips) 
Seat 9: matiko09 ($111.27 in chips) 
fuppeee: posts small blind $0.50
mycka86: is sitting out 
ardo888: posts big blind $1
Muinmyheart: posts the ante $0.20
PacPacBum: posts the ante $0.20
DrunkPatrik: posts the ante $0.20
fuppeee: posts the ante $0.20
ardo888: posts the ante $0.20
matiko09: posts the ante $0.20
*** HOLE CARDS ***
Dealt to matiko09 [4c 3c]
mycka86 leaves the table
matiko09: folds 
Muinmyheart: folds 
PacPacBum: folds 
DrunkPatrik: folds 
fuppeee: calls $0.50
ardo888: checks 
*** FLOP *** [Qs 4h Jh]
edidaz joins the table at seat #4 
edidaz leaves the table
fuppeee: bets $1.53
ardo888: folds 
Uncalled bet ($1.53) returned to fuppeee
fuppeee collected $3.06 from pot
*** SUMMARY ***
Total pot $3.20 | Rake $0.14 
Board [Qs 4h Jh]
Seat 1: Muinmyheart folded before Flop (didn't bet)
Seat 2: PacPacBum folded before Flop (didn't bet)
Seat 5: DrunkPatrik (button) folded before Flop (didn't bet)
Seat 6: fuppeee (small blind) collected ($3.06)
Seat 8: ardo888 (big blind) folded on the Flop
Seat 9: matiko09 folded before Flop (didn't bet)





PokerStars Hand #150803527785:  Hold'em No Limit (€1/€2 EUR) - 2016/03/23 15:51:51 CET [2016/03/23 10:51:51 ET]
Table 'Pluto II' 9-max Seat #7 is the button
Seat 5: aliwunder (€94.92 in chips) 
Seat 6: PacPacBum (€203 in chips) 
Seat 7: bigacsiga (€200 in chips) 
Seat 9: matiko09 (€200 in chips) 
matiko09: posts small blind €1
aliwunder: posts big blind €2
*** HOLE CARDS ***
Dealt to matiko09 [Qh Jh]
PacPacBum: raises €2.08 to €4.08
bigacsiga: folds 
matiko09: calls €3.08
aliwunder: calls €2.08
*** FLOP *** [6c 2s 9d]
matiko09: checks 
aliwunder: bets €4
PacPacBum: folds 
matiko09: folds 
Uncalled bet (€4) returned to aliwunder
aliwunder collected €11.69 from pot
aliwunder: doesn't show hand 
*** SUMMARY ***
Total pot €12.24 | Rake €0.55 
Board [6c 2s 9d]
Seat 5: aliwunder (big blind) collected (€11.69)
Seat 6: PacPacBum folded on the Flop
Seat 7: bigacsiga (button) folded before Flop (didn't bet)
Seat 9: matiko09 (small blind) folded on the Flop





PokerStars Hand #150803534437:  Hold'em No Limit ($0.50/$1.00 USD) - 2016/03/23 15:52:12 CET [2016/03/23 10:52:12 ET]
Table 'Haug II' 9-max Seat #9 is the button
Seat 1: PacPacBum ($105.66 in chips) 
Seat 2: ardo888 ($123.02 in chips) 
Seat 3: Do-Man22 ($84.40 in chips) 
Seat 4: matiko09 ($127.22 in chips) 
Seat 6: Pocketstud ($102.09 in chips) 
Seat 8: Olddogtom888 ($98.60 in chips) 
Seat 9: parforthecse ($81.76 in chips) 
PacPacBum: posts small blind $0.50
ardo888: posts big blind $1
Dantist1122: sits out 
PacPacBum: posts the ante $0.20
ardo888: posts the ante $0.20
Do-Man22: posts the ante $0.20
matiko09: posts the ante $0.20
Pocketstud: posts the ante $0.20
Olddogtom888: posts the ante $0.20
parforthecse: posts the ante $0.20
*** HOLE CARDS ***
Dealt to matiko09 [Td Tc]
Do-Man22: folds 
matiko09: raises $2 to $3
Pocketstud: folds 
Olddogtom888: folds 
parforthecse: folds 
PacPacBum: folds 
ardo888: folds 
Uncalled bet ($2) returned to matiko09
matiko09 collected $3.90 from pot
matiko09: doesn't show hand 
*** SUMMARY ***
Total pot $3.90 | Rake $0 
Seat 1: PacPacBum (small blind) folded before Flop
Seat 2: ardo888 (big blind) folded before Flop
Seat 3: Do-Man22 folded before Flop (didn't bet)
Seat 4: matiko09 collected ($3.90)
Seat 6: Pocketstud folded before Flop (didn't bet)
Seat 8: Olddogtom888 folded before Flop (didn't bet)
Seat 9: parforthecse (button) folded before Flop (didn't bet)





PokerStars Hand #150803535003:  Hold'em No Limit ($0.50/$1.00 USD) - 2016/03/23 15:52:14 CET [2016/03/23 10:52:14 ET]
Table 'Drakonia II' 9-max Seat #2 is the button
Seat 1: chautinhtri9 ($114.73 in chips) 
Seat 2: RICKA16 ($100 in chips) 
Seat 3: PacPacBum ($100 in chips) 
Seat 4: bigacsiga ($100 in chips) 
Seat 5: Muinmyheart ($100 in chips) 
Seat 7: YuriiSolodya ($50.88 in chips) 
Seat 8: matiko09 ($161.98 in chips) 
PacPacBum: posts small blind $0.50
bigacsiga: posts big blind $1
*** HOLE CARDS ***
Dealt to matiko09 [6s 4c]
Muinmyheart: folds 
YuriiSolodya: raises $1 to $2
omorfadramou joins the table at seat #9 
matiko09: folds 
chautinhtri9: calls $2
RICKA16: calls $2
PacPacBum: folds 
bigacsiga: folds 
*** FLOP *** [4s Qs 9s]
YuriiSolodya: checks 
chautinhtri9: checks 
RICKA16: checks 
*** TURN *** [4s Qs 9s] [6h]
YuriiSolodya: checks 
chautinhtri9: bets $5
RICKA16: folds 
YuriiSolodya: folds 
Uncalled bet ($5) returned to chautinhtri9
chautinhtri9 collected $7.16 from pot
chautinhtri9: doesn't show hand 
*** SUMMARY ***
Total pot $7.50 | Rake $0.34 
Board [4s Qs 9s 6h]
Seat 1: chautinhtri9 collected ($7.16)
Seat 2: RICKA16 (button) folded on the Turn
Seat 3: PacPacBum (small blind) folded before Flop
Seat 4: bigacsiga (big blind) folded before Flop
Seat 5: Muinmyheart folded before Flop (didn't bet)
Seat 7: YuriiSolodya folded on the Turn
Seat 8: matiko09 folded before Flop (didn't bet)





PokerStars Hand #150803535452:  Hold'em No Limit ($0.50/$1.00 USD) - 2016/03/23 15:52:16 CET [2016/03/23 10:52:16 ET]
Table 'Oljato' 9-max Seat #2 is the button
Seat 1: lumen21 ($101.71 in chips) 
Seat 2: CAJUN890 ($86.14 in chips) 
Seat 3: bigacsiga ($100 in chips) 
Seat 4: matiko09 ($154.09 in chips) 
Seat 5: Szevasztopol ($100 in chips) 
Seat 6: Muinmyheart ($108.69 in chips) 
Seat 8: PacPacBum ($113.41 in chips) 
Seat 9: leongts ($47.32 in chips) 
bigacsiga: posts small blind $0.50
matiko09: posts big blind $1
caesarzju: sits out 
*** HOLE CARDS ***
Dealt to matiko09 [7h 7c]
Szevasztopol: folds 
Muinmyheart: folds 
PacPacBum: folds 
leongts: calls $1
lumen21: folds 
CAJUN890: raises $4 to $5
bigacsiga: folds 
matiko09: calls $4
leongts: folds 
*** FLOP *** [6h 4s Ad]
matiko09: checks 
CAJUN890: bets $5.49
matiko09: calls $5.49
*** TURN *** [6h 4s Ad] [Tc]
matiko09: checks 
CAJUN890: checks 
*** RIVER *** [6h 4s Ad Tc] [5s]
matiko09: checks 
CAJUN890: bets $5
matiko09: folds 
Uncalled bet ($5) returned to CAJUN890
CAJUN890 collected $21.47 from pot
CAJUN890: doesn't show hand 
*** SUMMARY ***
Total pot $22.48 | Rake $1.01 
Board [6h 4s Ad Tc 5s]
Seat 1: lumen21 folded before Flop (didn't bet)
Seat 2: CAJUN890 (button) collected ($21.47)
Seat 3: bigacsiga (small blind) folded before Flop
Seat 4: matiko09 (big blind) folded on the River
Seat 5: Szevasztopol folded before Flop (didn't bet)
Seat 6: Muinmyheart folded before Flop (didn't bet)
Seat 8: PacPacBum folded before Flop (didn't bet)
Seat 9: leongts folded before Flop





PokerStars Hand #150803536606:  Hold'em No Limit ($0.50/$1.00 USD) - 2016/03/23 15:52:19 CET [2016/03/23 10:52:19 ET]
Table 'Swings' 9-max Seat #8 is the button
Seat 1: lumen21 ($100 in chips) 
Seat 2: tomver0809 ($74.13 in chips) 
Seat 3: edidaz ($100 in chips) 
Seat 4: YuriiSolodya ($41.15 in chips) 
Seat 5: chautinhtri9 ($104.05 in chips) 
Seat 6: matiko09 ($143.49 in chips) 
Seat 7: PacPacBum ($120.49 in chips) 
Seat 8: RICKA16 ($103.96 in chips) 
lumen21: posts small blind $0.50
tomver0809: posts big blind $1
*** HOLE CARDS ***
Dealt to matiko09 [Qs Th]
edidaz: raises $2 to $3
YuriiSolodya: folds 
chautinhtri9: folds 
matiko09: folds 
PacPacBum: raises $6 to $9
RICKA16: folds 
lumen21: folds 
tomver0809: folds 
edidaz: calls $6
*** FLOP *** [2c Td Ah]
edidaz: checks 
PacPacBum: checks 
*** TURN *** [2c Td Ah] [Ks]
edidaz: checks 
PacPacBum: bets $10.05
Muinmyheart joins the table at seat #9 
edidaz: folds 
Uncalled bet ($10.05) returned to PacPacBum
PacPacBum collected $18.62 from pot
PacPacBum: doesn't show hand 
*** SUMMARY ***
Total pot $19.50 | Rake $0.88 
Board [2c Td Ah Ks]
Seat 1: lumen21 (small blind) folded before Flop
Seat 2: tomver0809 (big blind) folded before Flop
Seat 3: edidaz folded on the Turn
Seat 4: YuriiSolodya folded before Flop (didn't bet)
Seat 5: chautinhtri9 folded before Flop (didn't bet)
Seat 6: matiko09 folded before Flop (didn't bet)
Seat 7: PacPacBum collected ($18.62)
Seat 8: RICKA16 (button) folded before Flop (didn't bet)





PokerStars Hand #150803538430:  Hold'em No Limit (€1/€2 EUR) - 2016/03/23 15:52:25 CET [2016/03/23 10:52:25 ET]
Table 'Pluto II' 9-max Seat #9 is the button
Seat 5: aliwunder (€102.53 in chips) 
Seat 6: PacPacBum (€200 in chips) 
Seat 7: bigacsiga (€200 in chips) 
Seat 9: matiko09 (€200 in chips) 
aliwunder: posts small blind €1
PacPacBum: posts big blind €2
*** HOLE CARDS ***
Dealt to matiko09 [Ad 2h]
bigacsiga: raises €3 to €5
KovIFish89 joins the table at seat #8 
matiko09: folds 
Sreshta222 joins the table at seat #1 
aliwunder: folds 
PacPacBum: folds 
Uncalled bet (€3) returned to bigacsiga
Sreshta222 leaves the table
bigacsiga collected €5 from pot
bigacsiga: doesn't show hand 
*** SUMMARY ***
Total pot €5 | Rake €0 
Seat 5: aliwunder (small blind) folded before Flop
Seat 6: PacPacBum (big blind) folded before Flop
Seat 7: bigacsiga collected (€5)
Seat 9: matiko09 (button) folded before Flop (didn't bet)





PokerStars Hand #150803538646:  Hold'em No Limit ($0.50/$1.00 USD) - 2016/03/23 15:52:26 CET [2016/03/23 10:52:26 ET]
Table 'Smiley' 9-max Seat #8 is the button
Seat 2: omorfadramou ($100 in chips) 
Seat 3: mycka86 ($117.52 in chips) 
Seat 4: CAJUN890 ($86.11 in chips) 
Seat 5: Szevasztopol ($114.90 in chips) 
Seat 7: bennetb77 ($120.47 in chips) 
Seat 8: matiko09 ($109.26 in chips) 
Seat 9: PacPacBum ($100 in chips) 
PacPacBum: posts small blind $0.50
omorfadramou: posts big blind $1
*** HOLE CARDS ***
Dealt to matiko09 [2s 7h]
mycka86: folds 
CAJUN890: folds 
Szevasztopol: folds 
bennetb77: folds 
matiko09: folds 
PacPacBum: folds 
Uncalled bet ($0.50) returned to omorfadramou
omorfadramou collected $1 from pot
omorfadramou: doesn't show hand 
*** SUMMARY ***
Total pot $1 | Rake $0 
Seat 2: omorfadramou (big blind) collected ($1)
Seat 3: mycka86 folded before Flop (didn't bet)
Seat 4: CAJUN890 folded before Flop (didn't bet)
Seat 5: Szevasztopol folded before Flop (didn't bet)
Seat 7: bennetb77 folded before Flop (didn't bet)
Seat 8: matiko09 (button) folded before Flop (didn't bet)
Seat 9: PacPacBum (small blind) folded before Flop





PokerStars Hand #150803539790:  Hold'em No Limit ($0.50/$1.00 USD) - 2016/03/23 15:52:30 CET [2016/03/23 10:52:30 ET]
Table 'Asmodeus' 9-max Seat #6 is the button
Seat 1: Muinmyheart ($105.30 in chips) 
Seat 2: PacPacBum ($100 in chips) 
Seat 5: DrunkPatrik ($100 in chips) 
Seat 6: fuppeee ($179.26 in chips) 
Seat 8: ardo888 ($101.30 in chips) 
Seat 9: matiko09 ($111.07 in chips) 
ardo888: posts small blind $0.50
matiko09: posts big blind $1
Muinmyheart: posts the ante $0.20
PacPacBum: posts the ante $0.20
DrunkPatrik: posts the ante $0.20
fuppeee: posts the ante $0.20
ardo888: posts the ante $0.20
matiko09: posts the ante $0.20
*** HOLE CARDS ***
Dealt to matiko09 [8c Qd]
Muinmyheart: folds 
PacPacBum: folds 
DrunkPatrik: folds 
fuppeee: raises $2 to $3
ardo888: folds 
matiko09: folds 
Uncalled bet ($2) returned to fuppeee
app1e_j@ck joins the table at seat #7 
fuppeee collected $3.70 from pot
*** SUMMARY ***
Total pot $3.70 | Rake $0 
Seat 1: Muinmyheart folded before Flop (didn't bet)
Seat 2: PacPacBum folded before Flop (didn't bet)
Seat 5: DrunkPatrik folded before Flop (didn't bet)
Seat 6: fuppeee (button) collected ($3.70)
Seat 8: ardo888 (small blind) folded before Flop
Seat 9: matiko09 (big blind) folded before Flop





PokerStars Hand #150803541133:  Hold'em No Limit (€1/€2 EUR) - 2016/03/23 15:52:34 CET [2016/03/23 10:52:34 ET]
Table 'Pluto II' 9-max Seat #5 is the button
Seat 5: aliwunder (€101.53 in chips) 
Seat 6: PacPacBum (€200 in chips) 
Seat 7: bigacsiga (€203 in chips) 
Seat 9: matiko09 (€200 in chips) 
PacPacBum: posts small blind €1
bigacsiga: posts big blind €2
KovIFish89: sits out 
*** HOLE CARDS ***
Dealt to matiko09 [Kh Ks]
matiko09: raises €3 to €5
aliwunder: folds 
PacPacBum: folds 
bigacsiga: folds 
Uncalled bet (€3) returned to matiko09
matiko09 collected €5 from pot
matiko09: doesn't show hand 
*** SUMMARY ***
Total pot €5 | Rake €0 
Seat 5: aliwunder (button) folded before Flop (didn't bet)
Seat 6: PacPacBum (small blind) folded before Flop
Seat 7: bigacsiga (big blind) folded before Flop
Seat 9: matiko09 collected (€5)





PokerStars Hand #150803541529:  Hold'em No Limit (€0.50/€1.00 EUR) - 2016/03/23 15:52:35 CET [2016/03/23 10:52:35 ET]
Table 'Mercury III' 9-max Seat #8 is the button
Seat 1: matiko09 (€124.85 in chips) 
Seat 3: PacPacBum (€101.50 in chips) 
Seat 4: Muinmyheart (€118.18 in chips) 
Seat 5: ardo888 (€100 in chips) 
Seat 6: mycka86 (€103.50 in chips) 
Seat 7: STrakDD (€166.67 in chips) 
Seat 8: gfxed (€29.84 in chips) 
Seat 9: Indr3k (€103.21 in chips) 
Indr3k: posts small blind €0.50
matiko09: posts big blind €1
*** HOLE CARDS ***
Dealt to matiko09 [Qs 2d]
PacPacBum: folds 
Muinmyheart: folds 
ardo888: folds 
mycka86: folds 
STrakDD: folds 
gfxed: raises €1.70 to €2.70
Indr3k: folds 
matiko09: folds 
Uncalled bet (€1.70) returned to gfxed
gfxed collected €2.50 from pot
*** SUMMARY ***
Total pot €2.50 | Rake €0 
Seat 1: matiko09 (big blind) folded before Flop
Seat 3: PacPacBum folded before Flop (didn't bet)
Seat 4: Muinmyheart folded before Flop (didn't bet)
Seat 5: ardo888 folded before Flop (didn't bet)
Seat 6: mycka86 folded before Flop (didn't bet)
Seat 7: STrakDD folded before Flop (didn't bet)
Seat 8: gfxed (button) collected (€2.50)
Seat 9: Indr3k (small blind) folded before Flop





PokerStars Hand #150803543949:  Hold'em No Limit ($0.50/$1.00 USD) - 2016/03/23 15:52:43 CET [2016/03/23 10:52:43 ET]
Table 'Sylvia III' 9-max Seat #3 is the button
Seat 1: mycka86 ($130.32 in chips) 
Seat 2: ellis005 ($101.64 in chips) 
Seat 3: bigacsiga ($142.28 in chips) 
Seat 4: lombardo11 ($67.62 in chips) 
Seat 5: matiko09 ($100 in chips) 
Seat 6: PacPacBum ($106.88 in chips) 
Seat 8: ardo888 ($110.14 in chips) 
lombardo11: posts small blind $0.50
matiko09: posts big blind $1
omorfadramou: sits out 
mycka86: posts the ante $0.20
ellis005: posts the ante $0.20
bigacsiga: posts the ante $0.20
lombardo11: posts the ante $0.20
matiko09: posts the ante $0.20
PacPacBum: posts the ante $0.20
ardo888: posts the ante $0.20
*** HOLE CARDS ***
Dealt to matiko09 [Kh 8c]
PacPacBum: folds 
ardo888: folds 
mycka86: raises $2 to $3
ellis005: folds 
bigacsiga: folds 
lombardo11: raises $5 to $8
matiko09: folds 
mycka86: calls $5
*** FLOP *** [Td Kd Jd]
lombardo11: bets $9
mycka86: calls $9
*** TURN *** [Td Kd Jd] [9s]
lombardo11: checks 
mycka86: bets $19.11
lombardo11: folds 
Uncalled bet ($19.11) returned to mycka86
mycka86 collected $34.76 from pot
*** SUMMARY ***
Total pot $36.40 | Rake $1.64 
Board [Td Kd Jd 9s]
Seat 1: mycka86 collected ($34.76)
Seat 2: ellis005 folded before Flop (didn't bet)
Seat 3: bigacsiga (button) folded before Flop (didn't bet)
Seat 4: lombardo11 (small blind) folded on the Turn
Seat 5: matiko09 (big blind) folded before Flop
Seat 6: PacPacBum folded before Flop (didn't bet)
Seat 8: ardo888 folded before Flop (didn't bet)





PokerStars Hand #150803544932:  Hold'em No Limit (€1/€2 EUR) - 2016/03/23 15:52:46 CET [2016/03/23 10:52:46 ET]
Table 'Pluto II' 9-max Seat #6 is the button
Seat 5: aliwunder (€101.53 in chips) 
Seat 6: PacPacBum (€200 in chips) 
Seat 7: bigacsiga (€201 in chips) 
Seat 8: KovIFish89 (€200 in chips) 
Seat 9: matiko09 (€203 in chips) 
bigacsiga: posts small blind €1
KovIFish89: posts big blind €2
*** HOLE CARDS ***
Dealt to matiko09 [6s Th]
matiko09: folds 
aliwunder: folds 
PacPacBum: raises €3 to €5
bigacsiga: folds 
KovIFish89: calls €3
*** FLOP *** [5s 2d Ts]
KovIFish89: checks 
Ouga Buga joins the table at seat #4 
PacPacBum: bets €5.67
KovIFish89: calls €5.67
*** TURN *** [5s 2d Ts] [9c]
KovIFish89: checks 
PacPacBum: checks 
*** RIVER *** [5s 2d Ts 9c] [5h]
KovIFish89: bets €14.21
PacPacBum: folds 
Uncalled bet (€14.21) returned to KovIFish89
KovIFish89 collected €21.33 from pot
KovIFish89: doesn't show hand 
*** SUMMARY ***
Total pot €22.34 | Rake €1.01 
Board [5s 2d Ts 9c 5h]
Seat 5: aliwunder folded before Flop (didn't bet)
Seat 6: PacPacBum (button) folded on the River
Seat 7: bigacsiga (small blind) folded before Flop
Seat 8: KovIFish89 (big blind) collected (€21.33)
Seat 9: matiko09 folded before Flop (didn't bet)





PokerStars Hand #150803547140:  Hold'em No Limit ($0.50/$1.00 USD) - 2016/03/23 15:52:53 CET [2016/03/23 10:52:53 ET]
Table 'Haug II' 9-max Seat #1 is the button
Seat 1: PacPacBum ($104.96 in chips) 
Seat 2: ardo888 ($121.82 in chips) 
Seat 3: Do-Man22 ($84.20 in chips) 
Seat 4: matiko09 ($129.92 in chips) 
Seat 6: Pocketstud ($101.89 in chips) 
Seat 8: Olddogtom888 ($98.40 in chips) 
Seat 9: parforthecse ($81.56 in chips) 
ardo888: posts small blind $0.50
Do-Man22: posts big blind $1
Dantist1122: sits out 
PacPacBum: posts the ante $0.20
ardo888: posts the ante $0.20
Do-Man22: posts the ante $0.20
matiko09: posts the ante $0.20
Pocketstud: posts the ante $0.20
Olddogtom888: posts the ante $0.20
parforthecse: posts the ante $0.20
*** HOLE CARDS ***
Dealt to matiko09 [Kd Qh]
matiko09: raises $2 to $3
Pocketstud: calls $3
Olddogtom888: folds 
parforthecse: folds 
PacPacBum: folds 
ardo888: folds 
Do-Man22: folds 
*** FLOP *** [7s 7h Tc]
matiko09: checks 
Pocketstud: bets $3
matiko09: folds 
Uncalled bet ($3) returned to Pocketstud
Pocketstud collected $8.50 from pot
Pocketstud: doesn't show hand 
*** SUMMARY ***
Total pot $8.90 | Rake $0.40 
Board [7s 7h Tc]
Seat 1: PacPacBum (button) folded before Flop (didn't bet)
Seat 2: ardo888 (small blind) folded before Flop
Seat 3: Do-Man22 (big blind) folded before Flop
Seat 4: matiko09 folded on the Flop
Seat 6: Pocketstud collected ($8.50)
Seat 8: Olddogtom888 folded before Flop (didn't bet)
Seat 9: parforthecse folded before Flop (didn't bet)





PokerStars Hand #150803548803:  Hold'em No Limit ($0.50/$1.00 USD) - 2016/03/23 15:52:58 CET [2016/03/23 10:52:58 ET]
Table 'Smiley' 9-max Seat #9 is the button
Seat 2: omorfadramou ($100.50 in chips) 
Seat 4: CAJUN890 ($86.11 in chips) 
Seat 5: Szevasztopol ($114.90 in chips) 
Seat 7: bennetb77 ($120.47 in chips) 
Seat 8: matiko09 ($109.26 in chips) 
Seat 9: PacPacBum ($100 in chips) 
omorfadramou: posts small blind $0.50
mycka86: is sitting out 
CAJUN890: posts big blind $1
*** HOLE CARDS ***
Dealt to matiko09 [3h Jc]
mycka86 leaves the table
Szevasztopol: folds 
bennetb77: folds 
matiko09: folds 
PacPacBum: folds 
omorfadramou: raises $2 to $3
CAJUN890: calls $2
*** FLOP *** [8c Js 2d]
omorfadramou: bets $4.46
CAJUN890: folds 
Uncalled bet ($4.46) returned to omorfadramou
omorfadramou collected $5.73 from pot
omorfadramou: doesn't show hand 
*** SUMMARY ***
Total pot $6 | Rake $0.27 
Board [8c Js 2d]
Seat 2: omorfadramou (small blind) collected ($5.73)
Seat 4: CAJUN890 (big blind) folded on the Flop
Seat 5: Szevasztopol folded before Flop (didn't bet)
Seat 7: bennetb77 folded before Flop (didn't bet)
Seat 8: matiko09 folded before Flop (didn't bet)
Seat 9: PacPacBum (button) folded before Flop (didn't bet)





PokerStars Hand #150803549257:  Hold'em No Limit ($0.50/$1.00 USD) - 2016/03/23 15:53:00 CET [2016/03/23 10:53:00 ET]
Table 'Asmodeus' 9-max Seat #8 is the button
Seat 1: Muinmyheart ($105.10 in chips) 
Seat 2: PacPacBum ($100 in chips) 
Seat 5: DrunkPatrik ($99.80 in chips) 
Seat 6: fuppeee ($181.76 in chips) 
Seat 8: ardo888 ($100.60 in chips) 
Seat 9: matiko09 ($109.87 in chips) 
matiko09: posts small blind $0.50
Muinmyheart: posts big blind $1
app1e_j@ck: is sitting out 
app1e_j@ck leaves the table
Muinmyheart: posts the ante $0.20
PacPacBum: posts the ante $0.20
DrunkPatrik: posts the ante $0.20
fuppeee: posts the ante $0.20
ardo888: posts the ante $0.20
matiko09: posts the ante $0.20
*** HOLE CARDS ***
Dealt to matiko09 [2d 4h]
PacPacBum: folds 
DrunkPatrik: calls $1
fuppeee: calls $1
ardo888: folds 
matiko09: folds 
Muinmyheart: checks 
*** FLOP *** [Ks 5d 9d]
Muinmyheart: checks 
DrunkPatrik: checks 
fuppeee: bets $2.24
Muinmyheart: folds 
DrunkPatrik: folds 
Uncalled bet ($2.24) returned to fuppeee
fuppeee collected $4.49 from pot
*** SUMMARY ***
Total pot $4.70 | Rake $0.21 
Board [Ks 5d 9d]
Seat 1: Muinmyheart (big blind) folded on the Flop
Seat 2: PacPacBum folded before Flop (didn't bet)
Seat 5: DrunkPatrik folded on the Flop
Seat 6: fuppeee collected ($4.49)
Seat 8: ardo888 (button) folded before Flop (didn't bet)
Seat 9: matiko09 (small blind) folded before Flop





PokerStars Hand #150803551291:  Hold'em No Limit ($0.50/$1.00 USD) - 2016/03/23 15:53:07 CET [2016/03/23 10:53:07 ET]
Table 'Oljato' 9-max Seat #3 is the button
Seat 1: lumen21 ($101.71 in chips) 
Seat 2: CAJUN890 ($97.12 in chips) 
Seat 3: bigacsiga ($100 in chips) 
Seat 4: matiko09 ($143.60 in chips) 
Seat 5: Szevasztopol ($100 in chips) 
Seat 6: Muinmyheart ($108.69 in chips) 
Seat 8: PacPacBum ($113.41 in chips) 
Seat 9: leongts ($46.32 in chips) 
matiko09: posts small blind $0.50
Szevasztopol: posts big blind $1
caesarzju: sits out 
*** HOLE CARDS ***
Dealt to matiko09 [8h Td]
Muinmyheart: folds 
PacPacBum: raises $1.04 to $2.04
leongts: calls $2.04
lumen21: calls $2.04
CAJUN890: folds 
bigacsiga: folds 
matiko09: folds 
Szevasztopol: folds 
*** FLOP *** [Qh Qd 7s]
PacPacBum: checks 
leongts: checks 
lumen21: checks 
*** TURN *** [Qh Qd 7s] [8d]
PacPacBum: checks 
leongts: checks 
lumen21: checks 
*** RIVER *** [Qh Qd 7s 8d] [6s]
PacPacBum: checks 
leongts: checks 
lumen21: checks 
*** SHOW DOWN ***
PacPacBum: shows [Jh Ac] (a pair of Queens)
leongts: shows [5s 5d] (two pair, Queens and Fives)
lumen21: mucks hand 
leongts collected $7.28 from pot
*** SUMMARY ***
Total pot $7.62 | Rake $0.34 
Board [Qh Qd 7s 8d 6s]
Seat 1: lumen21 mucked [Ts Ks]
Seat 2: CAJUN890 folded before Flop (didn't bet)
Seat 3: bigacsiga (button) folded before Flop (didn't bet)
Seat 4: matiko09 (small blind) folded before Flop
Seat 5: Szevasztopol (big blind) folded before Flop
Seat 6: Muinmyheart folded before Flop (didn't bet)
Seat 8: PacPacBum showed [Jh Ac] and lost with a pair of Queens
Seat 9: leongts showed [5s 5d] and won ($7.28) with two pair, Queens and Fives





PokerStars Hand #150803556687:  Hold'em No Limit ($0.50/$1.00 USD) - 2016/03/23 15:53:24 CET [2016/03/23 10:53:24 ET]
Table 'Aetolia II' 9-max Seat #8 is the button
Seat 3: se7en_$tars ($73.94 in chips) 
Seat 4: Pocketstud ($134.27 in chips) 
Seat 5: KingCastle77 ($87.26 in chips) 
Seat 6: Westpants ($169.67 in chips) 
Seat 7: matiko09 ($101.36 in chips) 
Seat 8: PacPacBum ($101.06 in chips) 
Seat 9: omorfadramou ($100 in chips) 
omorfadramou: posts small blind $0.50
app1e_j@ck: is sitting out 
app1e_j@ck leaves the table
se7en_$tars: posts big blind $1
*** HOLE CARDS ***
Dealt to matiko09 [2c Ts]
edidaz joins the table at seat #1 
edidaz leaves the table
Pocketstud: folds 
Dantist1122 joins the table at seat #1 
KingCastle77: folds 
Westpants: folds 
matiko09: folds 
PacPacBum: folds 
omorfadramou: folds 
Uncalled bet ($0.50) returned to se7en_$tars
se7en_$tars collected $1 from pot
se7en_$tars: doesn't show hand 
*** SUMMARY ***
Total pot $1 | Rake $0 
Seat 3: se7en_$tars (big blind) collected ($1)
Seat 4: Pocketstud folded before Flop (didn't bet)
Seat 5: KingCastle77 folded before Flop (didn't bet)
Seat 6: Westpants folded before Flop (didn't bet)
Seat 7: matiko09 folded before Flop (didn't bet)
Seat 8: PacPacBum (button) folded before Flop (didn't bet)
Seat 9: omorfadramou (small blind) folded before Flop





PokerStars Hand #150803557163:  Hold'em No Limit ($1/$2 USD) - 2016/03/23 15:53:26 CET [2016/03/23 10:53:26 ET]
Table 'Kiess' 9-max Seat #6 is the button
Seat 1: Cirilico ($230.71 in chips) 
Seat 3: Red4erT ($83.62 in chips) 
Seat 4: RamiroAgujis ($230.10 in chips) 
Seat 5: chippo boy ($478.72 in chips) 
Seat 6: matiko09 ($210.48 in chips) 
Seat 7: chaps1988 ($216.92 in chips) 
Seat 8: erfk1958 ($127.78 in chips) 
Seat 9: PacPacBum ($200 in chips) 
chaps1988: posts small blind $1
erfk1958: posts big blind $2
*** HOLE CARDS ***
Dealt to matiko09 [Jc Ad]
PacPacBum: folds 
Cirilico: folds 
Red4erT: folds 
RamiroAgujis: folds 
chippo boy: calls $2
matiko09: raises $6 to $8
chaps1988: folds 
erfk1958: folds 
chippo boy: calls $6
*** FLOP *** [2d 2s Qh]
chippo boy: checks 
matiko09: checks 
*** TURN *** [2d 2s Qh] [7c]
chippo boy: checks 
matiko09: checks 
*** RIVER *** [2d 2s Qh 7c] [5c]
chippo boy: bets $12
matiko09: folds 
Uncalled bet ($12) returned to chippo boy
chippo boy collected $18.14 from pot
*** SUMMARY ***
Total pot $19 | Rake $0.86 
Board [2d 2s Qh 7c 5c]
Seat 1: Cirilico folded before Flop (didn't bet)
Seat 3: Red4erT folded before Flop (didn't bet)
Seat 4: RamiroAgujis folded before Flop (didn't bet)
Seat 5: chippo boy collected ($18.14)
Seat 6: matiko09 (button) folded on the River
Seat 7: chaps1988 (small blind) folded before Flop
Seat 8: erfk1958 (big blind) folded before Flop
Seat 9: PacPacBum folded before Flop (didn't bet)





PokerStars Hand #150803559689:  Hold'em No Limit ($0.50/$1.00 USD) - 2016/03/23 15:53:34 CET [2016/03/23 10:53:34 ET]
Table 'Asmodeus' 9-max Seat #9 is the button
Seat 1: Muinmyheart ($103.90 in chips) 
Seat 2: PacPacBum ($100 in chips) 
Seat 5: DrunkPatrik ($98.60 in chips) 
Seat 6: fuppeee ($185.05 in chips) 
Seat 8: ardo888 ($100.40 in chips) 
Seat 9: matiko09 ($109.17 in chips) 
Muinmyheart: posts small blind $0.50
PacPacBum: posts big blind $1
Muinmyheart: posts the ante $0.20
PacPacBum: posts the ante $0.20
DrunkPatrik: posts the ante $0.20
fuppeee: posts the ante $0.20
ardo888: posts the ante $0.20
matiko09: posts the ante $0.20
*** HOLE CARDS ***
Dealt to matiko09 [Qd 6h]
DrunkPatrik: folds 
fuppeee: folds 
ardo888: raises $1.50 to $2.50
matiko09: folds 
Muinmyheart: folds 
PacPacBum: folds 
Uncalled bet ($1.50) returned to ardo888
ardo888 collected $3.70 from pot
ardo888: doesn't show hand 
*** SUMMARY ***
Total pot $3.70 | Rake $0 
Seat 1: Muinmyheart (small blind) folded before Flop
Seat 2: PacPacBum (big blind) folded before Flop
Seat 5: DrunkPatrik folded before Flop (didn't bet)
Seat 6: fuppeee folded before Flop (didn't bet)
Seat 8: ardo888 collected ($3.70)
Seat 9: matiko09 (button) folded before Flop (didn't bet)





PokerStars Hand #150803560098:  Hold'em No Limit (€0.50/€1.00 EUR) - 2016/03/23 15:53:35 CET [2016/03/23 10:53:35 ET]
Table 'Mercury III' 9-max Seat #9 is the button
Seat 1: matiko09 (€123.85 in chips) 
Seat 3: PacPacBum (€101.50 in chips) 
Seat 4: Muinmyheart (€118.18 in chips) 
Seat 5: ardo888 (€100 in chips) 
Seat 6: mycka86 (€103.50 in chips) 
Seat 7: STrakDD (€166.67 in chips) 
Seat 8: gfxed (€31.34 in chips) 
Seat 9: Indr3k (€102.71 in chips) 
matiko09: posts small blind €0.50
PacPacBum: posts big blind €1
*** HOLE CARDS ***
Dealt to matiko09 [5c 3d]
Muinmyheart: folds 
ardo888: folds 
mycka86: folds 
STrakDD: folds 
gfxed: folds 
Indr3k: folds 
matiko09: folds 
Uncalled bet (€0.50) returned to PacPacBum
PacPacBum collected €1 from pot
PacPacBum: doesn't show hand 
*** SUMMARY ***
Total pot €1 | Rake €0 
Seat 1: matiko09 (small blind) folded before Flop
Seat 3: PacPacBum (big blind) collected (€1)
Seat 4: Muinmyheart folded before Flop (didn't bet)
Seat 5: ardo888 folded before Flop (didn't bet)
Seat 6: mycka86 folded before Flop (didn't bet)
Seat 7: STrakDD folded before Flop (didn't bet)
Seat 8: gfxed folded before Flop (didn't bet)
Seat 9: Indr3k (button) folded before Flop (didn't bet)





PokerStars Hand #150803561041:  Hold'em No Limit ($0.50/$1.00 USD) - 2016/03/23 15:53:38 CET [2016/03/23 10:53:38 ET]
Table 'Drakonia II' 9-max Seat #3 is the button
Seat 1: chautinhtri9 ($119.89 in chips) 
Seat 2: RICKA16 ($98 in chips) 
Seat 3: PacPacBum ($100 in chips) 
Seat 4: bigacsiga ($100 in chips) 
Seat 5: Muinmyheart ($100 in chips) 
Seat 7: YuriiSolodya ($48.88 in chips) 
Seat 8: matiko09 ($161.98 in chips) 
bigacsiga: posts small blind $0.50
Muinmyheart: posts big blind $1
omorfadramou: sits out 
*** HOLE CARDS ***
Dealt to matiko09 [2h 6s]
YuriiSolodya: calls $1
matiko09: folds 
chautinhtri9: folds 
RICKA16: folds 
PacPacBum: folds 
bigacsiga: folds 
Muinmyheart: checks 
*** FLOP *** [6h Kh Ks]
Muinmyheart: checks 
YuriiSolodya: bets $4
Muinmyheart: folds 
Uncalled bet ($4) returned to YuriiSolodya
YuriiSolodya collected $2.39 from pot
YuriiSolodya: doesn't show hand 
*** SUMMARY ***
Total pot $2.50 | Rake $0.11 
Board [6h Kh Ks]
Seat 1: chautinhtri9 folded before Flop (didn't bet)
Seat 2: RICKA16 folded before Flop (didn't bet)
Seat 3: PacPacBum (button) folded before Flop (didn't bet)
Seat 4: bigacsiga (small blind) folded before Flop
Seat 5: Muinmyheart (big blind) folded on the Flop
Seat 7: YuriiSolodya collected ($2.39)
Seat 8: matiko09 folded before Flop (didn't bet)





PokerStars Hand #150803561310:  Hold'em No Limit ($0.50/$1.00 USD) - 2016/03/23 15:53:39 CET [2016/03/23 10:53:39 ET]
Table 'Haug II' 9-max Seat #2 is the button
Seat 1: PacPacBum ($104.76 in chips) 
Seat 2: ardo888 ($121.12 in chips) 
Seat 3: Do-Man22 ($83 in chips) 
Seat 4: matiko09 ($126.72 in chips) 
Seat 6: Pocketstud ($107.19 in chips) 
Seat 8: Olddogtom888 ($98.20 in chips) 
Seat 9: parforthecse ($81.36 in chips) 
Do-Man22: posts small blind $0.50
matiko09: posts big blind $1
Dantist1122: sits out 
PacPacBum: posts the ante $0.20
ardo888: posts the ante $0.20
Do-Man22: posts the ante $0.20
matiko09: posts the ante $0.20
Pocketstud: posts the ante $0.20
Olddogtom888: posts the ante $0.20
parforthecse: posts the ante $0.20
*** HOLE CARDS ***
Dealt to matiko09 [9s 9h]
Pocketstud: raises $1 to $2
Olddogtom888: folds 
parforthecse: folds 
PacPacBum: folds 
ardo888: folds 
Do-Man22: folds 
matiko09: calls $1
*** FLOP *** [Ts 2d 8s]
matiko09: checks 
Pocketstud: checks 
*** TURN *** [Ts 2d 8s] [Qh]
matiko09: checks 
Pocketstud: checks 
*** RIVER *** [Ts 2d 8s Qh] [Tc]
matiko09: checks 
Pocketstud: checks 
*** SHOW DOWN ***
matiko09: shows [9s 9h] (two pair, Tens and Nines)
Pocketstud: mucks hand 
matiko09 collected $5.63 from pot
*** SUMMARY ***
Total pot $5.90 | Rake $0.27 
Board [Ts 2d 8s Qh Tc]
Seat 1: PacPacBum folded before Flop (didn't bet)
Seat 2: ardo888 (button) folded before Flop (didn't bet)
Seat 3: Do-Man22 (small blind) folded before Flop
Seat 4: matiko09 (big blind) showed [9s 9h] and won ($5.63) with two pair, Tens and Nines
Seat 6: Pocketstud mucked [2h Ah]
Seat 8: Olddogtom888 folded before Flop (didn't bet)
Seat 9: parforthecse folded before Flop (didn't bet)





