PokerStars Hand #148832112869:  Hold'em No Limit ($0.25/$0.50 USD) - 2016/02/15 10:27:36 CET [2016/02/15 4:27:36 ET]
Table 'Juliet' 9-max Seat #3 is the button
Seat 1: i L00K great ($97.60 in chips) 
Seat 2: Nabulasun ($20 in chips) 
Seat 3: arctur17 ($54.08 in chips) 
Seat 4: pandalapa ($55.80 in chips) 
Seat 5: dndngod ($50 in chips) 
Seat 6: r4mz3s ($62.57 in chips) 
Seat 7: goldpiggy ($30.81 in chips) 
Seat 8: matiko09 ($50 in chips) 
pandalapa: posts small blind $0.25
dndngod: posts big blind $0.50
*** HOLE CARDS ***
Dealt to matiko09 [4h 2h]
r4mz3s: folds 
goldpiggy: folds 
matiko09: folds 
i L00K great: folds 
Nabulasun: folds 
arctur17: folds 
pandalapa: folds 
Uncalled bet ($0.25) returned to dndngod
dndngod collected $0.50 from pot
dndngod: doesn't show hand 
*** SUMMARY ***
Total pot $0.50 | Rake $0 
Seat 1: i L00K great folded before Flop (didn't bet)
Seat 2: Nabulasun folded before Flop (didn't bet)
Seat 3: arctur17 (button) folded before Flop (didn't bet)
Seat 4: pandalapa (small blind) folded before Flop
Seat 5: dndngod (big blind) collected ($0.50)
Seat 6: r4mz3s folded before Flop (didn't bet)
Seat 7: goldpiggy folded before Flop (didn't bet)
Seat 8: matiko09 folded before Flop (didn't bet)





PokerStars Hand #148832113448:  Hold'em No Limit ($0.25/$0.50 USD) - 2016/02/15 10:27:37 CET [2016/02/15 4:27:37 ET]
Table 'Margot II' 9-max Seat #9 is the button
Seat 1: i L00K great ($50 in chips) 
Seat 2: matiko09 ($73.97 in chips) 
Seat 4: r4mz3s ($51.86 in chips) 
Seat 6: OskarR89 ($50 in chips) 
Seat 7: o0o•°•°•o0oo ($27.38 in chips) 
Seat 8: Aoki42 ($99.81 in chips) 
Seat 9: chijingxiu1 ($55.10 in chips) 
i L00K great: posts small blind $0.25
matiko09: posts big blind $0.50
50CandyJoe: sits out 
*** HOLE CARDS ***
Dealt to matiko09 [As 3c]
r4mz3s: folds 
OskarR89: folds 
o0o•°•°•o0oo: folds 
Aoki42: folds 
chijingxiu1: folds 
i L00K great: raises $1 to $1.50
matiko09: folds 
Uncalled bet ($1) returned to i L00K great
i L00K great collected $1 from pot
i L00K great: doesn't show hand 
*** SUMMARY ***
Total pot $1 | Rake $0 
Seat 1: i L00K great (small blind) collected ($1)
Seat 2: matiko09 (big blind) folded before Flop
Seat 4: r4mz3s folded before Flop (didn't bet)
Seat 6: OskarR89 folded before Flop (didn't bet)
Seat 7: o0o•°•°•o0oo folded before Flop (didn't bet)
Seat 8: Aoki42 folded before Flop (didn't bet)
Seat 9: chijingxiu1 (button) folded before Flop (didn't bet)





PokerStars Hand #148832113405:  Hold'em No Limit ($0.50/$1.00 USD) - 2016/02/15 10:27:37 CET [2016/02/15 4:27:37 ET]
Table 'Gemma II' 9-max Seat #3 is the button
Seat 1: Igor DoUrden ($165.05 in chips) 
Seat 2: WDW3 ($145.27 in chips) 
Seat 3: Venomous100% ($147.09 in chips) 
Seat 4: nickreason17 ($107.79 in chips) 
Seat 5: PokerSash201 ($70.39 in chips) 
Seat 6: fanmtZ ($46.83 in chips) 
Seat 7: AlKatrone ($100 in chips) 
Seat 8: vrnMike ($139.14 in chips) 
Seat 9: matiko09 ($112.67 in chips) 
nickreason17: posts small blind $0.50
PokerSash201: posts big blind $1
*** HOLE CARDS ***
Dealt to matiko09 [Tc 8d]
fanmtZ: folds 
AlKatrone: folds 
vrnMike: folds 
matiko09: folds 
Igor DoUrden: folds 
WDW3: folds 
Venomous100%: raises $1 to $2
nickreason17: folds 
PokerSash201: calls $1
*** FLOP *** [Kh 4s 8c]
PokerSash201: checks 
Venomous100%: bets $2.15
PokerSash201: calls $2.15
*** TURN *** [Kh 4s 8c] [Td]
PokerSash201: checks 
Venomous100%: checks 
*** RIVER *** [Kh 4s 8c Td] [4c]
PokerSash201: bets $2
Venomous100%: folds 
Uncalled bet ($2) returned to PokerSash201
PokerSash201 collected $8.40 from pot
PokerSash201: doesn't show hand 
*** SUMMARY ***
Total pot $8.80 | Rake $0.40 
Board [Kh 4s 8c Td 4c]
Seat 1: Igor DoUrden folded before Flop (didn't bet)
Seat 2: WDW3 folded before Flop (didn't bet)
Seat 3: Venomous100% (button) folded on the River
Seat 4: nickreason17 (small blind) folded before Flop
Seat 5: PokerSash201 (big blind) collected ($8.40)
Seat 6: fanmtZ folded before Flop (didn't bet)
Seat 7: AlKatrone folded before Flop (didn't bet)
Seat 8: vrnMike folded before Flop (didn't bet)
Seat 9: matiko09 folded before Flop (didn't bet)





PokerStars Hand #148832115945:  Hold'em No Limit ($0.50/$1.00 USD) - 2016/02/15 10:27:43 CET [2016/02/15 4:27:43 ET]
Table 'Saldanha' 9-max Seat #6 is the button
Seat 1: AlKatrone ($100 in chips) 
Seat 4: WDW3 ($100 in chips) 
Seat 5: Priidix ($134.18 in chips) 
Seat 6: huffwag ($42.66 in chips) 
Seat 7: Venomous100% ($104.80 in chips) 
Seat 8: matiko09 ($103 in chips) 
Seat 9: pompaskillad ($46.71 in chips) 
Venomous100%: posts small blind $0.50
matiko09: posts big blind $1
maxxmeister: sits out 
*** HOLE CARDS ***
Dealt to matiko09 [Tc 7s]
pompaskillad: folds 
AlKatrone: raises $2 to $3
WDW3: folds 
Priidix: folds 
huffwag: folds 
Venomous100%: folds 
matiko09: folds 
Uncalled bet ($2) returned to AlKatrone
AlKatrone collected $2.50 from pot
AlKatrone: doesn't show hand 
*** SUMMARY ***
Total pot $2.50 | Rake $0 
Seat 1: AlKatrone collected ($2.50)
Seat 4: WDW3 folded before Flop (didn't bet)
Seat 5: Priidix folded before Flop (didn't bet)
Seat 6: huffwag (button) folded before Flop (didn't bet)
Seat 7: Venomous100% (small blind) folded before Flop
Seat 8: matiko09 (big blind) folded before Flop
Seat 9: pompaskillad folded before Flop (didn't bet)





PokerStars Hand #148832117584:  Hold'em No Limit ($0.50/$1.00 USD) - 2016/02/15 10:27:47 CET [2016/02/15 4:27:47 ET]
Table 'Anteros' 9-max Seat #5 is the button
Seat 5: Hujiafeng ($98.50 in chips) 
Seat 8: matiko09 ($100 in chips) 
Seat 9: WDW3 ($101.50 in chips) 
matiko09: posts small blind $0.50
WDW3: posts big blind $1
*** HOLE CARDS ***
Dealt to matiko09 [Jd 7h]
Hujiafeng: raises $2 to $3
matiko09: folds 
WDW3: folds 
Uncalled bet ($2) returned to Hujiafeng
Hujiafeng collected $2.50 from pot
Hujiafeng: doesn't show hand 
*** SUMMARY ***
Total pot $2.50 | Rake $0 
Seat 5: Hujiafeng (button) collected ($2.50)
Seat 8: matiko09 (small blind) folded before Flop
Seat 9: WDW3 (big blind) folded before Flop





PokerStars Hand #148832119373:  Hold'em No Limit ($0.50/$1.00 USD) - 2016/02/15 10:27:52 CET [2016/02/15 4:27:52 ET]
Table 'Vibeke' 9-max Seat #5 is the button
Seat 1: Venomous100% ($200.41 in chips) 
Seat 2: Priidix ($143.91 in chips) 
Seat 3: matiko09 ($100 in chips) 
Seat 4: fanmtZ ($43.42 in chips) 
Seat 5: vrnMike ($202.14 in chips) 
Seat 7: lixiangli ($82.72 in chips) 
Seat 8: nickreason17 ($127.62 in chips) 
Seat 9: Sashey2708 ($96.78 in chips) 
lixiangli: posts small blind $0.50
nickreason17: posts big blind $1
*** HOLE CARDS ***
Dealt to matiko09 [Js 4h]
Sashey2708: raises $2 to $3
Venomous100%: folds 
Priidix: folds 
matiko09: folds 
fanmtZ: folds 
vrnMike: folds 
lixiangli: folds 
nickreason17: calls $2
*** FLOP *** [3d 2h Th]
nickreason17: checks 
Sashey2708: bets $3
nickreason17: calls $3
*** TURN *** [3d 2h Th] [4c]
nickreason17: checks 
Sashey2708: checks 
*** RIVER *** [3d 2h Th 4c] [8s]
nickreason17: checks 
Sashey2708: bets $7
nickreason17: folds 
Uncalled bet ($7) returned to Sashey2708
Sashey2708 collected $11.94 from pot
Sashey2708: doesn't show hand 
*** SUMMARY ***
Total pot $12.50 | Rake $0.56 
Board [3d 2h Th 4c 8s]
Seat 1: Venomous100% folded before Flop (didn't bet)
Seat 2: Priidix folded before Flop (didn't bet)
Seat 3: matiko09 folded before Flop (didn't bet)
Seat 4: fanmtZ folded before Flop (didn't bet)
Seat 5: vrnMike (button) folded before Flop (didn't bet)
Seat 7: lixiangli (small blind) folded before Flop
Seat 8: nickreason17 (big blind) folded on the River
Seat 9: Sashey2708 collected ($11.94)





PokerStars Hand #148832119761:  Hold'em No Limit ($0.25/$0.50 USD) - 2016/02/15 10:27:53 CET [2016/02/15 4:27:53 ET]
Table 'Vesta II' 9-max Seat #1 is the button
Seat 1: Ahangama ($56.65 in chips) 
Seat 2: i L00K great ($54 in chips) 
Seat 3: matiko09 ($70.15 in chips) 
Seat 4: HJdream ($49.61 in chips) 
Seat 5: dndngod ($68.29 in chips) 
Seat 6: pandalapa ($50 in chips) 
Seat 7: OskarR89 ($82.81 in chips) 
Seat 8: Arystan ($78.33 in chips) 
Seat 9: Aoki42 ($80.94 in chips) 
i L00K great: posts small blind $0.25
matiko09: posts big blind $0.50
*** HOLE CARDS ***
Dealt to matiko09 [2d 8c]
HJdream: folds 
dndngod: raises $1 to $1.50
pandalapa: folds 
OskarR89: folds 
Arystan: folds 
Aoki42: folds 
Ahangama: folds 
i L00K great: folds 
matiko09: folds 
Uncalled bet ($1) returned to dndngod
dndngod collected $1.25 from pot
dndngod: doesn't show hand 
*** SUMMARY ***
Total pot $1.25 | Rake $0 
Seat 1: Ahangama (button) folded before Flop (didn't bet)
Seat 2: i L00K great (small blind) folded before Flop
Seat 3: matiko09 (big blind) folded before Flop
Seat 4: HJdream folded before Flop (didn't bet)
Seat 5: dndngod collected ($1.25)
Seat 6: pandalapa folded before Flop (didn't bet)
Seat 7: OskarR89 folded before Flop (didn't bet)
Seat 8: Arystan folded before Flop (didn't bet)
Seat 9: Aoki42 folded before Flop (didn't bet)





PokerStars Hand #148832121168:  Hold'em No Limit ($0.25/$0.50 USD) - 2016/02/15 10:27:56 CET [2016/02/15 4:27:56 ET]
Table 'Margot II' 9-max Seat #1 is the button
Seat 1: i L00K great ($50.50 in chips) 
Seat 2: matiko09 ($73.47 in chips) 
Seat 3: 50CandyJoe ($50 in chips) 
Seat 4: r4mz3s ($51.86 in chips) 
Seat 6: OskarR89 ($50 in chips) 
Seat 7: o0o•°•°•o0oo ($27.38 in chips) 
Seat 8: Aoki42 ($99.81 in chips) 
Seat 9: chijingxiu1 ($55.10 in chips) 
matiko09: posts small blind $0.25
50CandyJoe: posts big blind $0.50
*** HOLE CARDS ***
Dealt to matiko09 [8h 3d]
r4mz3s: folds 
OskarR89: raises $0.75 to $1.25
o0o•°•°•o0oo: folds 
Aoki42: folds 
chijingxiu1: calls $1.25
i L00K great: folds 
matiko09: folds 
50CandyJoe: folds 
*** FLOP *** [5s Tc 9s]
OskarR89: bets $2.32
chijingxiu1: calls $2.32
*** TURN *** [5s Tc 9s] [4c]
OskarR89: checks 
chijingxiu1: checks 
*** RIVER *** [5s Tc 9s 4c] [6d]
OskarR89: checks 
chijingxiu1: checks 
*** SHOW DOWN ***
OskarR89: shows [Kc Jc] (high card King)
chijingxiu1: shows [Ac 7s] (high card Ace)
chijingxiu1 collected $7.53 from pot
*** SUMMARY ***
Total pot $7.89 | Rake $0.36 
Board [5s Tc 9s 4c 6d]
Seat 1: i L00K great (button) folded before Flop (didn't bet)
Seat 2: matiko09 (small blind) folded before Flop
Seat 3: 50CandyJoe (big blind) folded before Flop
Seat 4: r4mz3s folded before Flop (didn't bet)
Seat 6: OskarR89 showed [Kc Jc] and lost with high card King
Seat 7: o0o•°•°•o0oo folded before Flop (didn't bet)
Seat 8: Aoki42 folded before Flop (didn't bet)
Seat 9: chijingxiu1 showed [Ac 7s] and won ($7.53) with high card Ace





PokerStars Hand #148832122123:  Hold'em No Limit ($0.25/$0.50 USD) - 2016/02/15 10:27:59 CET [2016/02/15 4:27:59 ET]
Table 'Juliet' 9-max Seat #4 is the button
Seat 1: i L00K great ($97.60 in chips) 
Seat 2: Nabulasun ($20 in chips) 
Seat 3: arctur17 ($54.08 in chips) 
Seat 4: pandalapa ($55.55 in chips) 
Seat 5: dndngod ($50.25 in chips) 
Seat 6: r4mz3s ($62.57 in chips) 
Seat 7: goldpiggy ($30.81 in chips) 
Seat 8: matiko09 ($50 in chips) 
dndngod: posts small blind $0.25
r4mz3s: posts big blind $0.50
*** HOLE CARDS ***
Dealt to matiko09 [4h Th]
goldpiggy: folds 
matiko09: folds 
i L00K great: folds 
Nabulasun: folds 
arctur17: raises $1 to $1.50
pandalapa: calls $1.50
dndngod: folds 
r4mz3s: calls $1
*** FLOP *** [3s Qd Qh]
r4mz3s: checks 
arctur17: checks 
pandalapa: checks 
*** TURN *** [3s Qd Qh] [Qs]
r4mz3s: checks 
arctur17: checks 
pandalapa: checks 
*** RIVER *** [3s Qd Qh Qs] [9c]
r4mz3s: checks 
arctur17: checks 
pandalapa: checks 
*** SHOW DOWN ***
r4mz3s: shows [Jd Kc] (three of a kind, Queens)
arctur17: shows [9s As] (a full house, Queens full of Nines)
pandalapa: mucks hand 
arctur17 collected $4.54 from pot
*** SUMMARY ***
Total pot $4.75 | Rake $0.21 
Board [3s Qd Qh Qs 9c]
Seat 1: i L00K great folded before Flop (didn't bet)
Seat 2: Nabulasun folded before Flop (didn't bet)
Seat 3: arctur17 showed [9s As] and won ($4.54) with a full house, Queens full of Nines
Seat 4: pandalapa (button) mucked [Jc Ad]
Seat 5: dndngod (small blind) folded before Flop
Seat 6: r4mz3s (big blind) showed [Jd Kc] and lost with three of a kind, Queens
Seat 7: goldpiggy folded before Flop (didn't bet)
Seat 8: matiko09 folded before Flop (didn't bet)





PokerStars Hand #148832125364:  Hold'em No Limit ($0.50/$1.00 USD) - 2016/02/15 10:28:07 CET [2016/02/15 4:28:07 ET]
Table 'Urania' 9-max Seat #4 is the button
Seat 1: matiko09 ($100 in chips) 
Seat 2: maxxmeister ($149.20 in chips) 
Seat 3: Priidix ($127.48 in chips) 
Seat 4: nickreason17 ($100.37 in chips) 
Seat 5: maxonplay ($161.93 in chips) 
Seat 6: vrnMike ($175.61 in chips) 
Seat 7: darren1031 ($168.26 in chips) 
Seat 8: Venomous100% ($130.20 in chips) 
Seat 9: lixiangli ($94.90 in chips) 
maxonplay: posts small blind $0.50
vrnMike: posts big blind $1
*** HOLE CARDS ***
Dealt to matiko09 [Jh 8c]
darren1031: folds 
Venomous100%: folds 
lixiangli: folds 
matiko09: folds 
maxxmeister: raises $2.50 to $3.50
Priidix: folds 
nickreason17: folds 
maxonplay: calls $3
vrnMike: calls $2.50
*** FLOP *** [Ac Qh 9d]
maxonplay: checks 
vrnMike: checks 
maxxmeister: checks 
*** TURN *** [Ac Qh 9d] [Tc]
maxonplay: bets $10.03
vrnMike: folds 
maxxmeister: calls $10.03
*** RIVER *** [Ac Qh 9d Tc] [4d]
maxonplay: bets $14.59
maxxmeister: folds 
Uncalled bet ($14.59) returned to maxonplay
maxonplay collected $29.18 from pot
maxonplay: doesn't show hand 
*** SUMMARY ***
Total pot $30.56 | Rake $1.38 
Board [Ac Qh 9d Tc 4d]
Seat 1: matiko09 folded before Flop (didn't bet)
Seat 2: maxxmeister folded on the River
Seat 3: Priidix folded before Flop (didn't bet)
Seat 4: nickreason17 (button) folded before Flop (didn't bet)
Seat 5: maxonplay (small blind) collected ($29.18)
Seat 6: vrnMike (big blind) folded on the Turn
Seat 7: darren1031 folded before Flop (didn't bet)
Seat 8: Venomous100% folded before Flop (didn't bet)
Seat 9: lixiangli folded before Flop (didn't bet)





PokerStars Hand #148832125716:  Hold'em No Limit ($0.50/$1.00 USD) - 2016/02/15 10:28:08 CET [2016/02/15 4:28:08 ET]
Table 'Anteros' 9-max Seat #8 is the button
Seat 5: Hujiafeng ($100 in chips) 
Seat 8: matiko09 ($100 in chips) 
Seat 9: WDW3 ($100.50 in chips) 
WDW3: posts small blind $0.50
Hujiafeng: posts big blind $1
*** HOLE CARDS ***
Dealt to matiko09 [Ah 7d]
matiko09: raises $1.27 to $2.27
OskarR89 joins the table at seat #1 
WDW3: folds 
Hujiafeng: calls $1.27
*** FLOP *** [Jc 3c 7s]
Hujiafeng: checks 
matiko09: bets $3.13
Hujiafeng: calls $3.13
*** TURN *** [Jc 3c 7s] [Js]
Hujiafeng: bets $6
matiko09: calls $6
*** RIVER *** [Jc 3c 7s Js] [Ks]
Hujiafeng: bets $11
matiko09: folds 
Uncalled bet ($11) returned to Hujiafeng
Hujiafeng collected $22.25 from pot
Hujiafeng: doesn't show hand 
*** SUMMARY ***
Total pot $23.30 | Rake $1.05 
Board [Jc 3c 7s Js Ks]
Seat 5: Hujiafeng (big blind) collected ($22.25)
Seat 8: matiko09 (button) folded on the River
Seat 9: WDW3 (small blind) folded before Flop





PokerStars Hand #148832130869:  Hold'em No Limit ($0.50/$1.00 USD) - 2016/02/15 10:28:21 CET [2016/02/15 4:28:21 ET]
Table 'Saldanha' 9-max Seat #7 is the button
Seat 1: AlKatrone ($101.50 in chips) 
Seat 4: WDW3 ($100 in chips) 
Seat 5: Priidix ($134.18 in chips) 
Seat 6: huffwag ($42.66 in chips) 
Seat 7: Venomous100% ($104.30 in chips) 
Seat 8: matiko09 ($102 in chips) 
Seat 9: pompaskillad ($46.71 in chips) 
matiko09: posts small blind $0.50
pompaskillad: posts big blind $1
maxxmeister: sits out 
*** HOLE CARDS ***
Dealt to matiko09 [2c 4h]
AlKatrone: folds 
WDW3: folds 
Priidix: folds 
huffwag: raises $2 to $3
Venomous100%: folds 
matiko09: folds 
pompaskillad: calls $2
*** FLOP *** [6c 8h Js]
pompaskillad: checks 
huffwag: checks 
*** TURN *** [6c 8h Js] [7s]
pompaskillad: bets $3.10
huffwag: folds 
Uncalled bet ($3.10) returned to pompaskillad
pompaskillad collected $6.21 from pot
pompaskillad: doesn't show hand 
*** SUMMARY ***
Total pot $6.50 | Rake $0.29 
Board [6c 8h Js 7s]
Seat 1: AlKatrone folded before Flop (didn't bet)
Seat 4: WDW3 folded before Flop (didn't bet)
Seat 5: Priidix folded before Flop (didn't bet)
Seat 6: huffwag folded on the Turn
Seat 7: Venomous100% (button) folded before Flop (didn't bet)
Seat 8: matiko09 (small blind) folded before Flop
Seat 9: pompaskillad (big blind) collected ($6.21)





PokerStars Hand #148832131204:  Hold'em No Limit ($0.25/$0.50 USD) - 2016/02/15 10:28:22 CET [2016/02/15 4:28:22 ET]
Table 'Vesta II' 9-max Seat #2 is the button
Seat 1: Ahangama ($56.65 in chips) 
Seat 2: i L00K great ($53.75 in chips) 
Seat 3: matiko09 ($69.65 in chips) 
Seat 4: HJdream ($49.61 in chips) 
Seat 5: dndngod ($69.04 in chips) 
Seat 6: pandalapa ($50 in chips) 
Seat 7: OskarR89 ($82.81 in chips) 
Seat 8: Arystan ($78.33 in chips) 
Seat 9: Aoki42 ($80.94 in chips) 
matiko09: posts small blind $0.25
HJdream: posts big blind $0.50
*** HOLE CARDS ***
Dealt to matiko09 [6s 4d]
dndngod: folds 
pandalapa: folds 
OskarR89: folds 
Arystan: folds 
Aoki42: folds 
Ahangama: folds 
i L00K great: raises $0.50 to $1
matiko09: folds 
HJdream: folds 
Uncalled bet ($0.50) returned to i L00K great
i L00K great collected $1.25 from pot
i L00K great: doesn't show hand 
*** SUMMARY ***
Total pot $1.25 | Rake $0 
Seat 1: Ahangama folded before Flop (didn't bet)
Seat 2: i L00K great (button) collected ($1.25)
Seat 3: matiko09 (small blind) folded before Flop
Seat 4: HJdream (big blind) folded before Flop
Seat 5: dndngod folded before Flop (didn't bet)
Seat 6: pandalapa folded before Flop (didn't bet)
Seat 7: OskarR89 folded before Flop (didn't bet)
Seat 8: Arystan folded before Flop (didn't bet)
Seat 9: Aoki42 folded before Flop (didn't bet)





PokerStars Hand #148832136776:  Hold'em No Limit ($0.50/$1.00 USD) - 2016/02/15 10:28:35 CET [2016/02/15 4:28:35 ET]
Table 'Praecipua' 9-max Seat #9 is the button
Seat 1: matiko09 ($108.26 in chips) 
Seat 2: vrnMike ($134.17 in chips) 
Seat 3: Venomous100% ($101.50 in chips) 
Seat 4: Priidix ($100 in chips) 
Seat 5: huffwag ($61.50 in chips) 
Seat 6: WDW3 ($150.61 in chips) 
Seat 7: maxxmeister ($192.41 in chips) 
Seat 8: Kalesmash08 ($71.59 in chips) 
Seat 9: AlKatrone ($111.52 in chips) 
matiko09: posts small blind $0.50
vrnMike: posts big blind $1
*** HOLE CARDS ***
Dealt to matiko09 [2c 6c]
Venomous100%: folds 
Priidix: folds 
huffwag: folds 
WDW3: folds 
maxxmeister: folds 
Kalesmash08: folds 
AlKatrone: raises $1 to $2
matiko09: folds 
vrnMike: raises $5.50 to $7.50
AlKatrone: folds 
Uncalled bet ($5.50) returned to vrnMike
vrnMike collected $4.50 from pot
*** SUMMARY ***
Total pot $4.50 | Rake $0 
Seat 1: matiko09 (small blind) folded before Flop
Seat 2: vrnMike (big blind) collected ($4.50)
Seat 3: Venomous100% folded before Flop (didn't bet)
Seat 4: Priidix folded before Flop (didn't bet)
Seat 5: huffwag folded before Flop (didn't bet)
Seat 6: WDW3 folded before Flop (didn't bet)
Seat 7: maxxmeister folded before Flop (didn't bet)
Seat 8: Kalesmash08 folded before Flop (didn't bet)
Seat 9: AlKatrone (button) folded before Flop





PokerStars Hand #148832137522:  Hold'em No Limit ($0.25/$0.50 USD) - 2016/02/15 10:28:37 CET [2016/02/15 4:28:37 ET]
Table 'Laertes II' 9-max Seat #1 is the button
Seat 1: dade33 ($50 in chips) 
Seat 3: ljryviltj ($56.41 in chips) 
Seat 4: rgar93 ($40 in chips) 
Seat 6: moshiko29 ($19.50 in chips) 
Seat 7: OskarR89 ($90.31 in chips) 
Seat 8: Trent444 ($47.48 in chips) 
Seat 9: matiko09 ($50 in chips) 
ljryviltj: posts small blind $0.25
rgar93: posts big blind $0.50
vlad11122007: sits out 
*** HOLE CARDS ***
Dealt to matiko09 [7s 3s]
moshiko29: calls $0.50
OskarR89: folds 
Trent444: folds 
matiko09: folds 
beluccix joins the table at seat #2 
dade33: folds 
ljryviltj: folds 
rgar93: checks 
*** FLOP *** [Kd Ah Qc]
rgar93: bets $0.50
moshiko29: calls $0.50
*** TURN *** [Kd Ah Qc] [2s]
rgar93: bets $1.07
moshiko29: calls $1.07
*** RIVER *** [Kd Ah Qc 2s] [7d]
rgar93: checks 
moshiko29: checks 
*** SHOW DOWN ***
rgar93: shows [5d 5h] (a pair of Fives)
moshiko29: shows [8h 8s] (a pair of Eights)
moshiko29 collected $4.19 from pot
*** SUMMARY ***
Total pot $4.39 | Rake $0.20 
Board [Kd Ah Qc 2s 7d]
Seat 1: dade33 (button) folded before Flop (didn't bet)
Seat 3: ljryviltj (small blind) folded before Flop
Seat 4: rgar93 (big blind) showed [5d 5h] and lost with a pair of Fives
Seat 6: moshiko29 showed [8h 8s] and won ($4.19) with a pair of Eights
Seat 7: OskarR89 folded before Flop (didn't bet)
Seat 8: Trent444 folded before Flop (didn't bet)
Seat 9: matiko09 folded before Flop (didn't bet)





PokerStars Hand #148832137445:  Hold'em No Limit ($0.50/$1.00 USD) - 2016/02/15 10:28:37 CET [2016/02/15 4:28:37 ET]
Table 'Vibeke' 9-max Seat #7 is the button
Seat 1: Venomous100% ($200.41 in chips) 
Seat 2: Priidix ($143.91 in chips) 
Seat 3: matiko09 ($100 in chips) 
Seat 4: fanmtZ ($43.42 in chips) 
Seat 5: vrnMike ($202.14 in chips) 
Seat 7: lixiangli ($82.22 in chips) 
Seat 8: nickreason17 ($121.62 in chips) 
Seat 9: Sashey2708 ($102.72 in chips) 
nickreason17: posts small blind $0.50
Sashey2708: posts big blind $1
*** HOLE CARDS ***
Dealt to matiko09 [2s 8c]
Venomous100%: folds 
Priidix: folds 
matiko09: folds 
fanmtZ: folds 
vrnMike: folds 
lixiangli: folds 
nickreason17: calls $0.50
Sashey2708: checks 
*** FLOP *** [Kh 3d Tc]
nickreason17: checks 
Sashey2708: bets $1
nickreason17: folds 
Uncalled bet ($1) returned to Sashey2708
Sashey2708 collected $1.91 from pot
Sashey2708: doesn't show hand 
*** SUMMARY ***
Total pot $2 | Rake $0.09 
Board [Kh 3d Tc]
Seat 1: Venomous100% folded before Flop (didn't bet)
Seat 2: Priidix folded before Flop (didn't bet)
Seat 3: matiko09 folded before Flop (didn't bet)
Seat 4: fanmtZ folded before Flop (didn't bet)
Seat 5: vrnMike folded before Flop (didn't bet)
Seat 7: lixiangli (button) folded before Flop (didn't bet)
Seat 8: nickreason17 (small blind) folded on the Flop
Seat 9: Sashey2708 (big blind) collected ($1.91)





PokerStars Hand #148832142768:  Hold'em No Limit ($0.50/$1.00 USD) - 2016/02/15 10:28:50 CET [2016/02/15 4:28:50 ET]
Table 'Gemma II' 9-max Seat #4 is the button
Seat 1: Igor DoUrden ($165.05 in chips) 
Seat 2: WDW3 ($145.27 in chips) 
Seat 3: Venomous100% ($142.94 in chips) 
Seat 4: nickreason17 ($107.29 in chips) 
Seat 5: PokerSash201 ($74.64 in chips) 
Seat 6: fanmtZ ($46.83 in chips) 
Seat 7: AlKatrone ($100 in chips) 
Seat 8: vrnMike ($139.14 in chips) 
Seat 9: matiko09 ($112.67 in chips) 
PokerSash201: posts small blind $0.50
fanmtZ: posts big blind $1
*** HOLE CARDS ***
Dealt to matiko09 [4h 7s]
AlKatrone has timed out
AlKatrone: folds 
vrnMike: folds 
matiko09: folds 
Igor DoUrden: folds 
WDW3: folds 
Venomous100%: folds 
nickreason17: folds 
PokerSash201: folds 
Uncalled bet ($0.50) returned to fanmtZ
fanmtZ collected $1 from pot
fanmtZ: doesn't show hand 
*** SUMMARY ***
Total pot $1 | Rake $0 
Seat 1: Igor DoUrden folded before Flop (didn't bet)
Seat 2: WDW3 folded before Flop (didn't bet)
Seat 3: Venomous100% folded before Flop (didn't bet)
Seat 4: nickreason17 (button) folded before Flop (didn't bet)
Seat 5: PokerSash201 (small blind) folded before Flop
Seat 6: fanmtZ (big blind) collected ($1)
Seat 7: AlKatrone folded before Flop (didn't bet)
Seat 8: vrnMike folded before Flop (didn't bet)
Seat 9: matiko09 folded before Flop (didn't bet)





PokerStars Hand #148832143445:  Hold'em No Limit ($0.50/$1.00 USD) - 2016/02/15 10:28:52 CET [2016/02/15 4:28:52 ET]
Table 'Saldanha' 9-max Seat #8 is the button
Seat 1: AlKatrone ($101.50 in chips) 
Seat 4: WDW3 ($100 in chips) 
Seat 5: Priidix ($134.18 in chips) 
Seat 6: huffwag ($39.66 in chips) 
Seat 7: Venomous100% ($104.30 in chips) 
Seat 8: matiko09 ($101.50 in chips) 
Seat 9: pompaskillad ($49.92 in chips) 
pompaskillad: posts small blind $0.50
AlKatrone: posts big blind $1
maxxmeister: sits out 
*** HOLE CARDS ***
Dealt to matiko09 [Ks 2h]
WDW3: folds 
Priidix: folds 
huffwag: folds 
Venomous100%: folds 
matiko09: folds 
pompaskillad: folds 
Uncalled bet ($0.50) returned to AlKatrone
AlKatrone collected $1 from pot
AlKatrone: doesn't show hand 
*** SUMMARY ***
Total pot $1 | Rake $0 
Seat 1: AlKatrone (big blind) collected ($1)
Seat 4: WDW3 folded before Flop (didn't bet)
Seat 5: Priidix folded before Flop (didn't bet)
Seat 6: huffwag folded before Flop (didn't bet)
Seat 7: Venomous100% folded before Flop (didn't bet)
Seat 8: matiko09 (button) folded before Flop (didn't bet)
Seat 9: pompaskillad (small blind) folded before Flop





PokerStars Hand #148832146506:  Hold'em No Limit ($0.50/$1.00 USD) - 2016/02/15 10:29:00 CET [2016/02/15 4:29:00 ET]
Table 'Anteros' 9-max Seat #9 is the button
Seat 5: Hujiafeng ($110.85 in chips) 
Seat 8: matiko09 ($100 in chips) 
Seat 9: WDW3 ($100 in chips) 
OskarR89 will be allowed to play after the button
Hujiafeng: posts small blind $0.50
matiko09: posts big blind $1
*** HOLE CARDS ***
Dealt to matiko09 [Ac Jh]
WDW3: folds 
Hujiafeng: folds 
Uncalled bet ($0.50) returned to matiko09
matiko09 collected $1 from pot
matiko09: doesn't show hand 
*** SUMMARY ***
Total pot $1 | Rake $0 
Seat 5: Hujiafeng (small blind) folded before Flop
Seat 8: matiko09 (big blind) collected ($1)
Seat 9: WDW3 (button) folded before Flop (didn't bet)





PokerStars Hand #148832147674:  Hold'em No Limit ($0.25/$0.50 USD) - 2016/02/15 10:29:03 CET [2016/02/15 4:29:03 ET]
Table 'Juliet' 9-max Seat #5 is the button
Seat 1: i L00K great ($97.60 in chips) 
Seat 2: Nabulasun ($20 in chips) 
Seat 3: arctur17 ($57.12 in chips) 
Seat 4: pandalapa ($54.05 in chips) 
Seat 5: dndngod ($50 in chips) 
Seat 6: r4mz3s ($61.07 in chips) 
Seat 7: goldpiggy ($30.81 in chips) 
Seat 8: matiko09 ($50 in chips) 
r4mz3s: posts small blind $0.25
goldpiggy: posts big blind $0.50
*** HOLE CARDS ***
Dealt to matiko09 [5c Kh]
matiko09: folds 
i L00K great: folds 
Nabulasun: folds 
arctur17: folds 
pandalapa: folds 
dndngod: raises $0.50 to $1
r4mz3s: folds 
goldpiggy: calls $0.50
*** FLOP *** [7h 2s Tc]
goldpiggy: checks 
dndngod: checks 
*** TURN *** [7h 2s Tc] [6c]
goldpiggy: checks 
dndngod: bets $2.15
goldpiggy: calls $2.15
*** RIVER *** [7h 2s Tc 6c] [8s]
goldpiggy: checks 
dndngod: bets $3
goldpiggy: calls $3
*** SHOW DOWN ***
dndngod: shows [6d 7d] (two pair, Sevens and Sixes)
goldpiggy: shows [7c 8d] (two pair, Eights and Sevens)
goldpiggy collected $11.99 from pot
*** SUMMARY ***
Total pot $12.55 | Rake $0.56 
Board [7h 2s Tc 6c 8s]
Seat 1: i L00K great folded before Flop (didn't bet)
Seat 2: Nabulasun folded before Flop (didn't bet)
Seat 3: arctur17 folded before Flop (didn't bet)
Seat 4: pandalapa folded before Flop (didn't bet)
Seat 5: dndngod (button) showed [6d 7d] and lost with two pair, Sevens and Sixes
Seat 6: r4mz3s (small blind) folded before Flop
Seat 7: goldpiggy (big blind) showed [7c 8d] and won ($11.99) with two pair, Eights and Sevens
Seat 8: matiko09 folded before Flop (didn't bet)





PokerStars Hand #148832148616:  Hold'em No Limit ($0.25/$0.50 USD) - 2016/02/15 10:29:05 CET [2016/02/15 4:29:05 ET]
Table 'Vesta II' 9-max Seat #3 is the button
Seat 1: Ahangama ($56.65 in chips) 
Seat 2: i L00K great ($54.50 in chips) 
Seat 3: matiko09 ($69.40 in chips) 
Seat 4: HJdream ($49.11 in chips) 
Seat 5: dndngod ($69.04 in chips) 
Seat 6: pandalapa ($50 in chips) 
Seat 7: OskarR89 ($82.81 in chips) 
Seat 8: Arystan ($78.33 in chips) 
Seat 9: Aoki42 ($80.94 in chips) 
HJdream: posts small blind $0.25
dndngod: posts big blind $0.50
*** HOLE CARDS ***
Dealt to matiko09 [Ad Js]
pandalapa: folds 
OskarR89: raises $0.75 to $1.25
Arystan: raises $1.75 to $3
Aoki42: folds 
Ahangama: folds 
i L00K great: folds 
matiko09: folds 
HJdream: folds 
dndngod: folds 
OskarR89: calls $1.75
*** FLOP *** [3h 2s 8c]
OskarR89: checks 
Arystan: bets $3.22
OskarR89: calls $3.22
*** TURN *** [3h 2s 8c] [Th]
OskarR89: checks 
Arystan: checks 
*** RIVER *** [3h 2s 8c Th] [6s]
OskarR89: checks 
Arystan: checks 
*** SHOW DOWN ***
OskarR89: shows [9c 9d] (a pair of Nines)
Arystan: mucks hand 
OskarR89 collected $12.60 from pot
*** SUMMARY ***
Total pot $13.19 | Rake $0.59 
Board [3h 2s 8c Th 6s]
Seat 1: Ahangama folded before Flop (didn't bet)
Seat 2: i L00K great folded before Flop (didn't bet)
Seat 3: matiko09 (button) folded before Flop (didn't bet)
Seat 4: HJdream (small blind) folded before Flop
Seat 5: dndngod (big blind) folded before Flop
Seat 6: pandalapa folded before Flop (didn't bet)
Seat 7: OskarR89 showed [9c 9d] and won ($12.60) with a pair of Nines
Seat 8: Arystan mucked [8h Ac]
Seat 9: Aoki42 folded before Flop (didn't bet)





PokerStars Hand #148832149151:  Hold'em No Limit ($0.50/$1.00 USD) - 2016/02/15 10:29:06 CET [2016/02/15 4:29:06 ET]
Table 'Anteros' 9-max Seat #5 is the button
Seat 5: Hujiafeng ($110.35 in chips) 
Seat 8: matiko09 ($100.50 in chips) 
Seat 9: WDW3 ($100 in chips) 
matiko09: posts small blind $0.50
WDW3: posts big blind $1
OskarR89: sits out 
*** HOLE CARDS ***
Dealt to matiko09 [6s Th]
Hujiafeng: folds 
Hujiafeng leaves the table
matiko09: folds 
Uncalled bet ($0.50) returned to WDW3
WDW3 collected $1 from pot
WDW3: doesn't show hand 
*** SUMMARY ***
Total pot $1 | Rake $0 
Seat 5: Hujiafeng (button) folded before Flop (didn't bet)
Seat 8: matiko09 (small blind) folded before Flop
Seat 9: WDW3 (big blind) collected ($1)





PokerStars Hand #148832149939:  Hold'em No Limit ($0.50/$1.00 USD) - 2016/02/15 10:29:08 CET [2016/02/15 4:29:08 ET]
Table 'Saldanha' 9-max Seat #9 is the button
Seat 1: AlKatrone ($102 in chips) 
Seat 3: maxxmeister ($100 in chips) 
Seat 4: WDW3 ($100 in chips) 
Seat 5: Priidix ($134.18 in chips) 
Seat 6: huffwag ($39.66 in chips) 
Seat 7: Venomous100% ($104.30 in chips) 
Seat 8: matiko09 ($101.50 in chips) 
Seat 9: pompaskillad ($49.42 in chips) 
AlKatrone: posts small blind $0.50
maxxmeister: posts big blind $1
*** HOLE CARDS ***
Dealt to matiko09 [6h 5s]
WDW3: folds 
Priidix: raises $2 to $3
huffwag: folds 
Venomous100%: folds 
matiko09: folds 
pompaskillad: folds 
AlKatrone: folds 
maxxmeister: folds 
Uncalled bet ($2) returned to Priidix
Priidix collected $2.50 from pot
Priidix: doesn't show hand 
*** SUMMARY ***
Total pot $2.50 | Rake $0 
Seat 1: AlKatrone (small blind) folded before Flop
Seat 3: maxxmeister (big blind) folded before Flop
Seat 4: WDW3 folded before Flop (didn't bet)
Seat 5: Priidix collected ($2.50)
Seat 6: huffwag folded before Flop (didn't bet)
Seat 7: Venomous100% folded before Flop (didn't bet)
Seat 8: matiko09 folded before Flop (didn't bet)
Seat 9: pompaskillad (button) folded before Flop (didn't bet)





PokerStars Hand #148832150386:  Hold'em No Limit ($0.50/$1.00 USD) - 2016/02/15 10:29:09 CET [2016/02/15 4:29:09 ET]
Table 'Vibeke' 9-max Seat #8 is the button
Seat 1: Venomous100% ($200.41 in chips) 
Seat 2: Priidix ($143.91 in chips) 
Seat 3: matiko09 ($100 in chips) 
Seat 4: fanmtZ ($43.42 in chips) 
Seat 5: vrnMike ($202.14 in chips) 
Seat 7: lixiangli ($82.22 in chips) 
Seat 8: nickreason17 ($120.62 in chips) 
Seat 9: Sashey2708 ($103.63 in chips) 
Sashey2708: posts small blind $0.50
Venomous100%: posts big blind $1
*** HOLE CARDS ***
Dealt to matiko09 [3c Ac]
Priidix: folds 
matiko09: folds 
fanmtZ: folds 
vrnMike: folds 
lixiangli: folds 
AlKatrone joins the table at seat #6 
nickreason17: raises $1.04 to $2.04
Sashey2708: folds 
Venomous100%: folds 
Uncalled bet ($1.04) returned to nickreason17
nickreason17 collected $2.50 from pot
*** SUMMARY ***
Total pot $2.50 | Rake $0 
Seat 1: Venomous100% (big blind) folded before Flop
Seat 2: Priidix folded before Flop (didn't bet)
Seat 3: matiko09 folded before Flop (didn't bet)
Seat 4: fanmtZ folded before Flop (didn't bet)
Seat 5: vrnMike folded before Flop (didn't bet)
Seat 7: lixiangli folded before Flop (didn't bet)
Seat 8: nickreason17 (button) collected ($2.50)
Seat 9: Sashey2708 (small blind) folded before Flop





PokerStars Hand #148832153474:  Hold'em No Limit ($0.25/$0.50 USD) - 2016/02/15 10:29:17 CET [2016/02/15 4:29:17 ET]
Table 'Margot II' 9-max Seat #2 is the button
Seat 1: i L00K great ($50.50 in chips) 
Seat 2: matiko09 ($73.22 in chips) 
Seat 3: 50CandyJoe ($50 in chips) 
Seat 4: r4mz3s ($51.86 in chips) 
Seat 6: OskarR89 ($50 in chips) 
Seat 7: o0o•°•°•o0oo ($27.38 in chips) 
Seat 8: Aoki42 ($99.81 in chips) 
Seat 9: chijingxiu1 ($59.06 in chips) 
50CandyJoe: posts small blind $0.25
r4mz3s: posts big blind $0.50
*** HOLE CARDS ***
Dealt to matiko09 [Ks 4d]
OskarR89: folds 
o0o•°•°•o0oo: folds 
Aoki42: folds 
chijingxiu1: folds 
i L00K great: folds 
o0o•°•°•o0oo leaves the table
vlad11122007 joins the table at seat #7 
matiko09: folds 
50CandyJoe: raises $0.50 to $1
r4mz3s: folds 
Uncalled bet ($0.50) returned to 50CandyJoe
50CandyJoe collected $1 from pot
50CandyJoe: doesn't show hand 
*** SUMMARY ***
Total pot $1 | Rake $0 
Seat 1: i L00K great folded before Flop (didn't bet)
Seat 2: matiko09 (button) folded before Flop (didn't bet)
Seat 3: 50CandyJoe (small blind) collected ($1)
Seat 4: r4mz3s (big blind) folded before Flop
Seat 6: OskarR89 folded before Flop (didn't bet)
Seat 7: o0o•°•°•o0oo folded before Flop (didn't bet)
Seat 8: Aoki42 folded before Flop (didn't bet)
Seat 9: chijingxiu1 folded before Flop (didn't bet)





PokerStars Hand #148832156002:  Hold'em No Limit ($0.50/$1.00 USD) - 2016/02/15 10:29:23 CET [2016/02/15 4:29:23 ET]
Table 'Anteros' 9-max Seat #8 is the button
Seat 1: OskarR89 ($100 in chips) 
Seat 8: matiko09 ($100 in chips) 
Seat 9: WDW3 ($100.50 in chips) 
WDW3: posts small blind $0.50
OskarR89: posts big blind $1
*** HOLE CARDS ***
Dealt to matiko09 [Jc 2c]
matiko09: folds 
WDW3: folds 
Uncalled bet ($0.50) returned to OskarR89
OskarR89 collected $1 from pot
OskarR89: doesn't show hand 
*** SUMMARY ***
Total pot $1 | Rake $0 
Seat 1: OskarR89 (big blind) collected ($1)
Seat 8: matiko09 (button) folded before Flop (didn't bet)
Seat 9: WDW3 (small blind) folded before Flop





PokerStars Hand #148832158145:  Hold'em No Limit ($0.50/$1.00 USD) - 2016/02/15 10:29:29 CET [2016/02/15 4:29:29 ET]
Table 'Gemma II' 9-max Seat #5 is the button
Seat 1: Igor DoUrden ($165.05 in chips) 
Seat 2: WDW3 ($145.27 in chips) 
Seat 3: Venomous100% ($142.94 in chips) 
Seat 4: nickreason17 ($107.29 in chips) 
Seat 5: PokerSash201 ($74.14 in chips) 
Seat 6: fanmtZ ($47.33 in chips) 
Seat 7: AlKatrone ($100 in chips) 
Seat 8: vrnMike ($139.14 in chips) 
Seat 9: matiko09 ($112.67 in chips) 
fanmtZ: posts small blind $0.50
AlKatrone: posts big blind $1
*** HOLE CARDS ***
Dealt to matiko09 [9s Qh]
vrnMike: folds 
matiko09: folds 
Igor DoUrden: folds 
WDW3: raises $2 to $3
Venomous100%: folds 
nickreason17: folds 
PokerSash201: folds 
fanmtZ: raises $6 to $9
AlKatrone: folds 
WDW3: folds 
Uncalled bet ($6) returned to fanmtZ
fanmtZ collected $7 from pot
fanmtZ: doesn't show hand 
*** SUMMARY ***
Total pot $7 | Rake $0 
Seat 1: Igor DoUrden folded before Flop (didn't bet)
Seat 2: WDW3 folded before Flop
Seat 3: Venomous100% folded before Flop (didn't bet)
Seat 4: nickreason17 folded before Flop (didn't bet)
Seat 5: PokerSash201 (button) folded before Flop (didn't bet)
Seat 6: fanmtZ (small blind) collected ($7)
Seat 7: AlKatrone (big blind) folded before Flop
Seat 8: vrnMike folded before Flop (didn't bet)
Seat 9: matiko09 folded before Flop (didn't bet)





PokerStars Hand #148832159184:  Hold'em No Limit ($0.50/$1.00 USD) - 2016/02/15 10:29:31 CET [2016/02/15 4:29:31 ET]
Table 'Urania' 9-max Seat #5 is the button
Seat 1: matiko09 ($100 in chips) 
Seat 2: maxxmeister ($135.67 in chips) 
Seat 3: Priidix ($127.48 in chips) 
Seat 4: nickreason17 ($100.37 in chips) 
Seat 5: maxonplay ($177.58 in chips) 
Seat 6: vrnMike ($172.11 in chips) 
Seat 7: darren1031 ($168.26 in chips) 
Seat 8: Venomous100% ($130.20 in chips) 
Seat 9: lixiangli ($94.90 in chips) 
vrnMike: posts small blind $0.50
darren1031: posts big blind $1
*** HOLE CARDS ***
Dealt to matiko09 [Js 7c]
Venomous100%: folds 
lixiangli: folds 
matiko09: folds 
maxxmeister: folds 
Priidix: folds 
nickreason17: folds 
maxonplay: folds 
vrnMike: folds 
Uncalled bet ($0.50) returned to darren1031
darren1031 collected $1 from pot
darren1031: doesn't show hand 
*** SUMMARY ***
Total pot $1 | Rake $0 
Seat 1: matiko09 folded before Flop (didn't bet)
Seat 2: maxxmeister folded before Flop (didn't bet)
Seat 3: Priidix folded before Flop (didn't bet)
Seat 4: nickreason17 folded before Flop (didn't bet)
Seat 5: maxonplay (button) folded before Flop (didn't bet)
Seat 6: vrnMike (small blind) folded before Flop
Seat 7: darren1031 (big blind) collected ($1)
Seat 8: Venomous100% folded before Flop (didn't bet)
Seat 9: lixiangli folded before Flop (didn't bet)





PokerStars Hand #148832160127:  Hold'em No Limit ($0.25/$0.50 USD) - 2016/02/15 10:29:33 CET [2016/02/15 4:29:33 ET]
Table 'Laertes II' 9-max Seat #3 is the button
Seat 1: dade33 ($50 in chips) 
Seat 3: ljryviltj ($56.16 in chips) 
Seat 4: rgar93 ($37.93 in chips) 
Seat 5: vlad11122007 ($50 in chips) 
Seat 6: moshiko29 ($21.62 in chips) 
Seat 7: OskarR89 ($90.31 in chips) 
Seat 8: Trent444 ($47.48 in chips) 
Seat 9: matiko09 ($50 in chips) 
rgar93: posts small blind $0.25
vlad11122007: posts big blind $0.50
*** HOLE CARDS ***
Dealt to matiko09 [8c 9c]
moshiko29: folds 
OskarR89: raises $0.75 to $1.25
Trent444: folds 
matiko09: folds 
dade33: raises $3.75 to $5
ljryviltj: folds 
rgar93: folds 
vlad11122007: folds 
OskarR89: raises $6 to $11
dade33: calls $6
*** FLOP *** [Qc Jh 4s]
OskarR89: checks 
dade33: checks 
*** TURN *** [Qc Jh 4s] [6c]
OskarR89: bets $7.50
dade33: calls $7.50
*** RIVER *** [Qc Jh 4s 6c] [2s]
OskarR89: checks 
dade33: checks 
*** SHOW DOWN ***
OskarR89: shows [7h 5h] (high card Queen)
dade33: shows [Td Th] (a pair of Tens)
dade33 collected $36.05 from pot
*** SUMMARY ***
Total pot $37.75 | Rake $1.70 
Board [Qc Jh 4s 6c 2s]
Seat 1: dade33 showed [Td Th] and won ($36.05) with a pair of Tens
Seat 3: ljryviltj (button) folded before Flop (didn't bet)
Seat 4: rgar93 (small blind) folded before Flop
Seat 5: vlad11122007 (big blind) folded before Flop
Seat 6: moshiko29 folded before Flop (didn't bet)
Seat 7: OskarR89 showed [7h 5h] and lost with high card Queen
Seat 8: Trent444 folded before Flop (didn't bet)
Seat 9: matiko09 folded before Flop (didn't bet)





PokerStars Hand #148832160591:  Hold'em No Limit ($0.50/$1.00 USD) - 2016/02/15 10:29:35 CET [2016/02/15 4:29:35 ET]
Table 'Anteros' 9-max Seat #9 is the button
Seat 1: OskarR89 ($100.50 in chips) 
Seat 8: matiko09 ($100 in chips) 
Seat 9: WDW3 ($100 in chips) 
OskarR89: posts small blind $0.50
maxxmeister leaves the table
matiko09: posts big blind $1
*** HOLE CARDS ***
Dealt to matiko09 [Ac 8h]
WDW3: raises $1.50 to $2.50
OskarR89: folds 
matiko09: calls $1.50
*** FLOP *** [3c Kc Kh]
matiko09: checks 
WDW3: checks 
*** TURN *** [3c Kc Kh] [Qh]
Zoubou1983 joins the table at seat #7 
matiko09: checks 
WDW3: checks 
*** RIVER *** [3c Kc Kh Qh] [3d]
matiko09: checks 
WDW3: checks 
*** SHOW DOWN ***
matiko09: shows [Ac 8h] (two pair, Kings and Threes)
WDW3: mucks hand 
matiko09 collected $5.25 from pot
IHouseMusic leaves the table
*** SUMMARY ***
Total pot $5.50 | Rake $0.25 
Board [3c Kc Kh Qh 3d]
Seat 1: OskarR89 (small blind) folded before Flop
Seat 8: matiko09 (big blind) showed [Ac 8h] and won ($5.25) with two pair, Kings and Threes
Seat 9: WDW3 (button) mucked [8d 5d]





PokerStars Hand #148832162104:  Hold'em No Limit ($0.50/$1.00 USD) - 2016/02/15 10:29:38 CET [2016/02/15 4:29:38 ET]
Table 'Saldanha' 9-max Seat #1 is the button
Seat 1: AlKatrone ($101.50 in chips) 
Seat 3: maxxmeister ($100 in chips) 
Seat 4: WDW3 ($100 in chips) 
Seat 5: Priidix ($135.68 in chips) 
Seat 6: huffwag ($39.66 in chips) 
Seat 7: Venomous100% ($104.30 in chips) 
Seat 8: matiko09 ($101.50 in chips) 
Seat 9: pompaskillad ($49.42 in chips) 
maxxmeister: posts small blind $0.50
WDW3: posts big blind $1
*** HOLE CARDS ***
Dealt to matiko09 [5s Kd]
Priidix: folds 
huffwag: folds 
Venomous100%: folds 
matiko09: folds 
pompaskillad: folds 
AlKatrone: folds 
maxxmeister: raises $3 to $4
WDW3: folds 
Uncalled bet ($3) returned to maxxmeister
maxxmeister collected $2 from pot
maxxmeister: doesn't show hand 
*** SUMMARY ***
Total pot $2 | Rake $0 
Seat 1: AlKatrone (button) folded before Flop (didn't bet)
Seat 3: maxxmeister (small blind) collected ($2)
Seat 4: WDW3 (big blind) folded before Flop
Seat 5: Priidix folded before Flop (didn't bet)
Seat 6: huffwag folded before Flop (didn't bet)
Seat 7: Venomous100% folded before Flop (didn't bet)
Seat 8: matiko09 folded before Flop (didn't bet)
Seat 9: pompaskillad folded before Flop (didn't bet)





PokerStars Hand #148832168800:  Hold'em No Limit ($0.25/$0.50 USD) - 2016/02/15 10:29:55 CET [2016/02/15 4:29:55 ET]
Table 'Margot II' 9-max Seat #3 is the button
Seat 1: i L00K great ($50.50 in chips) 
Seat 2: matiko09 ($73.22 in chips) 
Seat 3: 50CandyJoe ($50.50 in chips) 
Seat 4: r4mz3s ($51.36 in chips) 
Seat 6: OskarR89 ($50 in chips) 
Seat 8: Aoki42 ($99.81 in chips) 
Seat 9: chijingxiu1 ($59.06 in chips) 
r4mz3s: posts small blind $0.25
OskarR89: posts big blind $0.50
vlad11122007: is sitting out 
vlad11122007 leaves the table
*** HOLE CARDS ***
Dealt to matiko09 [4h 2c]
Aoki42: raises $1 to $1.50
chijingxiu1: folds 
i L00K great: calls $1.50
Vedpapa joins the table at seat #7 
matiko09: folds 
50CandyJoe: folds 
r4mz3s: folds 
OskarR89: folds 
*** FLOP *** [Ks Tc Ah]
Aoki42: checks 
i L00K great: bets $2.86
Aoki42: calls $2.86
*** TURN *** [Ks Tc Ah] [8s]
Aoki42: checks 
i L00K great: bets $7.23
Aoki42: folds 
Uncalled bet ($7.23) returned to i L00K great
i L00K great collected $9.04 from pot
i L00K great: doesn't show hand 
*** SUMMARY ***
Total pot $9.47 | Rake $0.43 
Board [Ks Tc Ah 8s]
Seat 1: i L00K great collected ($9.04)
Seat 2: matiko09 folded before Flop (didn't bet)
Seat 3: 50CandyJoe (button) folded before Flop (didn't bet)
Seat 4: r4mz3s (small blind) folded before Flop
Seat 6: OskarR89 (big blind) folded before Flop
Seat 8: Aoki42 folded on the Turn
Seat 9: chijingxiu1 folded before Flop (didn't bet)





PokerStars Hand #148832168773:  Hold'em No Limit ($0.50/$1.00 USD) - 2016/02/15 10:29:55 CET [2016/02/15 4:29:55 ET]
Table 'Praecipua' 9-max Seat #1 is the button
Seat 1: matiko09 ($107.76 in chips) 
Seat 2: vrnMike ($136.67 in chips) 
Seat 3: Venomous100% ($101.50 in chips) 
Seat 4: Priidix ($100 in chips) 
Seat 5: huffwag ($61.50 in chips) 
Seat 6: WDW3 ($150.61 in chips) 
Seat 7: maxxmeister ($192.41 in chips) 
Seat 8: Kalesmash08 ($71.59 in chips) 
Seat 9: AlKatrone ($109.52 in chips) 
vrnMike: posts small blind $0.50
Venomous100%: posts big blind $1
*** HOLE CARDS ***
Dealt to matiko09 [Ts 7d]
Priidix: folds 
huffwag: raises $2 to $3
WDW3: folds 
maxxmeister: raises $6 to $9
Kalesmash08: folds 
AlKatrone: folds 
matiko09: folds 
vrnMike: folds 
Venomous100%: folds 
huffwag: calls $6
*** FLOP *** [7s Ks 5h]
huffwag: checks 
maxxmeister: bets $9
huffwag: folds 
Uncalled bet ($9) returned to maxxmeister
maxxmeister collected $18.62 from pot
maxxmeister: doesn't show hand 
*** SUMMARY ***
Total pot $19.50 | Rake $0.88 
Board [7s Ks 5h]
Seat 1: matiko09 (button) folded before Flop (didn't bet)
Seat 2: vrnMike (small blind) folded before Flop
Seat 3: Venomous100% (big blind) folded before Flop
Seat 4: Priidix folded before Flop (didn't bet)
Seat 5: huffwag folded on the Flop
Seat 6: WDW3 folded before Flop (didn't bet)
Seat 7: maxxmeister collected ($18.62)
Seat 8: Kalesmash08 folded before Flop (didn't bet)
Seat 9: AlKatrone folded before Flop (didn't bet)





PokerStars Hand #148832170193:  Hold'em No Limit ($0.50/$1.00 USD) - 2016/02/15 10:29:59 CET [2016/02/15 4:29:59 ET]
Table 'Urania' 9-max Seat #6 is the button
Seat 1: matiko09 ($100 in chips) 
Seat 2: maxxmeister ($135.67 in chips) 
Seat 3: Priidix ($127.48 in chips) 
Seat 4: nickreason17 ($100.37 in chips) 
Seat 5: maxonplay ($177.58 in chips) 
Seat 6: vrnMike ($171.61 in chips) 
Seat 7: darren1031 ($168.76 in chips) 
Seat 8: Venomous100% ($130.20 in chips) 
Seat 9: lixiangli ($94.90 in chips) 
darren1031: posts small blind $0.50
Venomous100%: posts big blind $1
*** HOLE CARDS ***
Dealt to matiko09 [Js Th]
lixiangli: folds 
matiko09: folds 
maxxmeister: folds 
Priidix: raises $2 to $3
nickreason17: folds 
maxonplay: folds 
vrnMike: folds 
darren1031: folds 
Venomous100%: folds 
Uncalled bet ($2) returned to Priidix
Priidix collected $2.50 from pot
Priidix: doesn't show hand 
*** SUMMARY ***
Total pot $2.50 | Rake $0 
Seat 1: matiko09 folded before Flop (didn't bet)
Seat 2: maxxmeister folded before Flop (didn't bet)
Seat 3: Priidix collected ($2.50)
Seat 4: nickreason17 folded before Flop (didn't bet)
Seat 5: maxonplay folded before Flop (didn't bet)
Seat 6: vrnMike (button) folded before Flop (didn't bet)
Seat 7: darren1031 (small blind) folded before Flop
Seat 8: Venomous100% (big blind) folded before Flop
Seat 9: lixiangli folded before Flop (didn't bet)





PokerStars Hand #148832170775:  Hold'em No Limit ($0.50/$1.00 USD) - 2016/02/15 10:30:00 CET [2016/02/15 4:30:00 ET]
Table 'Vibeke' 9-max Seat #9 is the button
Seat 1: Venomous100% ($199.41 in chips) 
Seat 2: Priidix ($143.91 in chips) 
Seat 3: matiko09 ($100 in chips) 
Seat 4: fanmtZ ($43.42 in chips) 
Seat 5: vrnMike ($202.14 in chips) 
Seat 7: lixiangli ($82.22 in chips) 
Seat 8: nickreason17 ($122.12 in chips) 
Seat 9: Sashey2708 ($103.13 in chips) 
Venomous100%: posts small blind $0.50
Priidix: posts big blind $1
AlKatrone: sits out 
*** HOLE CARDS ***
Dealt to matiko09 [4d 5c]
matiko09: folds 
fanmtZ: folds 
vrnMike: raises $2 to $3
lixiangli: folds 
nickreason17: folds 
Sashey2708: calls $3
Venomous100%: folds 
Priidix: folds 
*** FLOP *** [8d 9s 6c]
vrnMike: checks 
Sashey2708: bets $3
vrnMike: folds 
Uncalled bet ($3) returned to Sashey2708
Sashey2708 collected $7.16 from pot
Sashey2708: doesn't show hand 
*** SUMMARY ***
Total pot $7.50 | Rake $0.34 
Board [8d 9s 6c]
Seat 1: Venomous100% (small blind) folded before Flop
Seat 2: Priidix (big blind) folded before Flop
Seat 3: matiko09 folded before Flop (didn't bet)
Seat 4: fanmtZ folded before Flop (didn't bet)
Seat 5: vrnMike folded on the Flop
Seat 7: lixiangli folded before Flop (didn't bet)
Seat 8: nickreason17 folded before Flop (didn't bet)
Seat 9: Sashey2708 (button) collected ($7.16)





PokerStars Hand #148832171966:  Hold'em No Limit ($0.25/$0.50 USD) - 2016/02/15 10:30:03 CET [2016/02/15 4:30:03 ET]
Table 'Juliet' 9-max Seat #6 is the button
Seat 1: i L00K great ($97.60 in chips) 
Seat 2: Nabulasun ($20 in chips) 
Seat 3: arctur17 ($57.12 in chips) 
Seat 4: pandalapa ($54.05 in chips) 
Seat 5: dndngod ($50 in chips) 
Seat 6: r4mz3s ($60.82 in chips) 
Seat 7: goldpiggy ($36.65 in chips) 
Seat 8: matiko09 ($50 in chips) 
goldpiggy: posts small blind $0.25
matiko09: posts big blind $0.50
*** HOLE CARDS ***
Dealt to matiko09 [9c 4c]
i L00K great: folds 
Nabulasun: folds 
arctur17: folds 
pandalapa: raises $1 to $1.50
dndngod: folds 
r4mz3s: folds 
goldpiggy: folds 
matiko09: folds 
Uncalled bet ($1) returned to pandalapa
pandalapa collected $1.25 from pot
pandalapa: doesn't show hand 
*** SUMMARY ***
Total pot $1.25 | Rake $0 
Seat 1: i L00K great folded before Flop (didn't bet)
Seat 2: Nabulasun folded before Flop (didn't bet)
Seat 3: arctur17 folded before Flop (didn't bet)
Seat 4: pandalapa collected ($1.25)
Seat 5: dndngod folded before Flop (didn't bet)
Seat 6: r4mz3s (button) folded before Flop (didn't bet)
Seat 7: goldpiggy (small blind) folded before Flop
Seat 8: matiko09 (big blind) folded before Flop





PokerStars Hand #148832174035:  Hold'em No Limit ($0.25/$0.50 USD) - 2016/02/15 10:30:08 CET [2016/02/15 4:30:08 ET]
Table 'Vesta II' 9-max Seat #4 is the button
Seat 1: Ahangama ($56.65 in chips) 
Seat 2: i L00K great ($54.50 in chips) 
Seat 3: matiko09 ($69.40 in chips) 
Seat 4: HJdream ($48.86 in chips) 
Seat 5: dndngod ($68.54 in chips) 
Seat 6: pandalapa ($50 in chips) 
Seat 7: OskarR89 ($89.19 in chips) 
Seat 8: Arystan ($72.11 in chips) 
Seat 9: Aoki42 ($80.94 in chips) 
dndngod: posts small blind $0.25
pandalapa: posts big blind $0.50
*** HOLE CARDS ***
Dealt to matiko09 [4c Kh]
OskarR89: folds 
Arystan: raises $1 to $1.50
Aoki42: calls $1.50
Ahangama: folds 
i L00K great: calls $1.50
matiko09: folds 
HJdream: folds 
dndngod: folds 
pandalapa: folds 
*** FLOP *** [5c Ac 3d]
Arystan: bets $2.50
Aoki42: calls $2.50
i L00K great: folds 
*** TURN *** [5c Ac 3d] [9s]
Arystan: bets $4.89
Aoki42: calls $4.89
*** RIVER *** [5c Ac 3d 9s] [8s]
Arystan: checks 
Aoki42: checks 
*** SHOW DOWN ***
Arystan: shows [Ah Th] (a pair of Aces)
Aoki42: mucks hand 
Arystan collected $19.13 from pot
*** SUMMARY ***
Total pot $20.03 | Rake $0.90 
Board [5c Ac 3d 9s 8s]
Seat 1: Ahangama folded before Flop (didn't bet)
Seat 2: i L00K great folded on the Flop
Seat 3: matiko09 folded before Flop (didn't bet)
Seat 4: HJdream (button) folded before Flop (didn't bet)
Seat 5: dndngod (small blind) folded before Flop
Seat 6: pandalapa (big blind) folded before Flop
Seat 7: OskarR89 folded before Flop (didn't bet)
Seat 8: Arystan showed [Ah Th] and won ($19.13) with a pair of Aces
Seat 9: Aoki42 mucked [Kc Tc]





PokerStars Hand #148832174936:  Hold'em No Limit ($0.50/$1.00 USD) - 2016/02/15 10:30:10 CET [2016/02/15 4:30:10 ET]
Table 'Anteros' 9-max Seat #1 is the button
Seat 1: OskarR89 ($100 in chips) 
Seat 8: matiko09 ($102.75 in chips) 
Seat 9: WDW3 ($100 in chips) 
Zoubou1983 will be allowed to play after the button
matiko09: posts small blind $0.50
WDW3: posts big blind $1
*** HOLE CARDS ***
Dealt to matiko09 [7s Jc]
IHouseMusic joins the table at seat #2 
OskarR89: raises $1 to $2
matiko09: folds 
WDW3: calls $1
*** FLOP *** [As 2c 6h]
WDW3: checks 
OskarR89: checks 
*** TURN *** [As 2c 6h] [Ad]
WDW3: checks 
OskarR89: checks 
*** RIVER *** [As 2c 6h Ad] [Td]
WDW3: checks 
OskarR89: checks 
*** SHOW DOWN ***
WDW3: shows [3s 3c] (two pair, Aces and Threes)
OskarR89: mucks hand 
WDW3 collected $4.30 from pot
*** SUMMARY ***
Total pot $4.50 | Rake $0.20 
Board [As 2c 6h Ad Td]
Seat 1: OskarR89 (button) mucked [Qc 9c]
Seat 8: matiko09 (small blind) folded before Flop
Seat 9: WDW3 (big blind) showed [3s 3c] and won ($4.30) with two pair, Aces and Threes





PokerStars Hand #148832179893:  Hold'em No Limit ($0.50/$1.00 USD) - 2016/02/15 10:30:23 CET [2016/02/15 4:30:23 ET]
Table 'Gemma II' 9-max Seat #6 is the button
Seat 1: Igor DoUrden ($165.05 in chips) 
Seat 2: WDW3 ($142.27 in chips) 
Seat 3: Venomous100% ($142.94 in chips) 
Seat 4: nickreason17 ($107.29 in chips) 
Seat 5: PokerSash201 ($74.14 in chips) 
Seat 6: fanmtZ ($51.33 in chips) 
Seat 7: AlKatrone ($100 in chips) 
Seat 8: vrnMike ($139.14 in chips) 
Seat 9: matiko09 ($112.67 in chips) 
AlKatrone: posts small blind $0.50
vrnMike: posts big blind $1
*** HOLE CARDS ***
Dealt to matiko09 [5s Ad]
matiko09: folds 
Igor DoUrden: folds 
WDW3: folds 
Venomous100%: folds 
nickreason17: folds 
PokerSash201: raises $1.02 to $2.02
fanmtZ: folds 
AlKatrone: raises $5.05 to $7.07
vrnMike: folds 
PokerSash201: calls $5.05
*** FLOP *** [2d 3s 7d]
AlKatrone: bets $8
PokerSash201: calls $8
*** TURN *** [2d 3s 7d] [6s]
AlKatrone: bets $75
PokerSash201: folds 
Uncalled bet ($75) returned to AlKatrone
AlKatrone collected $29.74 from pot
AlKatrone: doesn't show hand 
*** SUMMARY ***
Total pot $31.14 | Rake $1.40 
Board [2d 3s 7d 6s]
Seat 1: Igor DoUrden folded before Flop (didn't bet)
Seat 2: WDW3 folded before Flop (didn't bet)
Seat 3: Venomous100% folded before Flop (didn't bet)
Seat 4: nickreason17 folded before Flop (didn't bet)
Seat 5: PokerSash201 folded on the Turn
Seat 6: fanmtZ (button) folded before Flop (didn't bet)
Seat 7: AlKatrone (small blind) collected ($29.74)
Seat 8: vrnMike (big blind) folded before Flop
Seat 9: matiko09 folded before Flop (didn't bet)





PokerStars Hand #148832180323:  Hold'em No Limit ($0.50/$1.00 USD) - 2016/02/15 10:30:24 CET [2016/02/15 4:30:24 ET]
Table 'Urania' 9-max Seat #7 is the button
Seat 1: matiko09 ($100 in chips) 
Seat 2: maxxmeister ($135.67 in chips) 
Seat 3: Priidix ($128.98 in chips) 
Seat 4: nickreason17 ($100.37 in chips) 
Seat 5: maxonplay ($177.58 in chips) 
Seat 6: vrnMike ($171.61 in chips) 
Seat 7: darren1031 ($168.26 in chips) 
Seat 8: Venomous100% ($129.20 in chips) 
Seat 9: lixiangli ($94.90 in chips) 
Venomous100%: posts small blind $0.50
lixiangli: posts big blind $1
*** HOLE CARDS ***
Dealt to matiko09 [Js Qh]
matiko09: folds 
maxxmeister: folds 
Priidix: folds 
nickreason17: folds 
maxonplay: folds 
vrnMike: folds 
darren1031: folds 
Venomous100%: folds 
Uncalled bet ($0.50) returned to lixiangli
lixiangli collected $1 from pot
lixiangli: doesn't show hand 
*** SUMMARY ***
Total pot $1 | Rake $0 
Seat 1: matiko09 folded before Flop (didn't bet)
Seat 2: maxxmeister folded before Flop (didn't bet)
Seat 3: Priidix folded before Flop (didn't bet)
Seat 4: nickreason17 folded before Flop (didn't bet)
Seat 5: maxonplay folded before Flop (didn't bet)
Seat 6: vrnMike folded before Flop (didn't bet)
Seat 7: darren1031 (button) folded before Flop (didn't bet)
Seat 8: Venomous100% (small blind) folded before Flop
Seat 9: lixiangli (big blind) collected ($1)





PokerStars Hand #148832180821:  Hold'em No Limit ($0.50/$1.00 USD) - 2016/02/15 10:30:25 CET [2016/02/15 4:30:25 ET]
Table 'Saldanha' 9-max Seat #3 is the button
Seat 1: AlKatrone ($101.50 in chips) 
Seat 3: maxxmeister ($101 in chips) 
Seat 4: WDW3 ($100 in chips) 
Seat 5: Priidix ($135.68 in chips) 
Seat 6: huffwag ($39.66 in chips) 
Seat 7: Venomous100% ($104.30 in chips) 
Seat 8: matiko09 ($101.50 in chips) 
Seat 9: pompaskillad ($49.42 in chips) 
WDW3: posts small blind $0.50
Priidix: posts big blind $1
*** HOLE CARDS ***
Dealt to matiko09 [8h Qd]
huffwag: raises $2 to $3
Venomous100%: folds 
matiko09: folds 
pompaskillad: folds 
AlKatrone: folds 
maxxmeister: folds 
WDW3: folds 
Priidix: folds 
Uncalled bet ($2) returned to huffwag
huffwag collected $2.50 from pot
huffwag: doesn't show hand 
*** SUMMARY ***
Total pot $2.50 | Rake $0 
Seat 1: AlKatrone folded before Flop (didn't bet)
Seat 3: maxxmeister (button) folded before Flop (didn't bet)
Seat 4: WDW3 (small blind) folded before Flop
Seat 5: Priidix (big blind) folded before Flop
Seat 6: huffwag collected ($2.50)
Seat 7: Venomous100% folded before Flop (didn't bet)
Seat 8: matiko09 folded before Flop (didn't bet)
Seat 9: pompaskillad folded before Flop (didn't bet)





PokerStars Hand #148832183609:  Hold'em No Limit ($0.50/$1.00 USD) - 2016/02/15 10:30:32 CET [2016/02/15 4:30:32 ET]
Table 'Vibeke' 9-max Seat #1 is the button
Seat 1: Venomous100% ($198.91 in chips) 
Seat 2: Priidix ($142.91 in chips) 
Seat 3: matiko09 ($100 in chips) 
Seat 4: fanmtZ ($43.42 in chips) 
Seat 5: vrnMike ($199.14 in chips) 
Seat 7: lixiangli ($82.22 in chips) 
Seat 8: nickreason17 ($122.12 in chips) 
Seat 9: Sashey2708 ($107.29 in chips) 
Priidix: posts small blind $0.50
matiko09: posts big blind $1
AlKatrone: sits out 
*** HOLE CARDS ***
Dealt to matiko09 [4d 9s]
fanmtZ: folds 
vrnMike: folds 
lixiangli: raises $1.50 to $2.50
nickreason17: raises $5.50 to $8
Sashey2708: folds 
Venomous100%: folds 
Priidix: folds 
matiko09: folds 
lixiangli: folds 
Uncalled bet ($5.50) returned to nickreason17
nickreason17 collected $6.50 from pot
*** SUMMARY ***
Total pot $6.50 | Rake $0 
Seat 1: Venomous100% (button) folded before Flop (didn't bet)
Seat 2: Priidix (small blind) folded before Flop
Seat 3: matiko09 (big blind) folded before Flop
Seat 4: fanmtZ folded before Flop (didn't bet)
Seat 5: vrnMike folded before Flop (didn't bet)
Seat 7: lixiangli folded before Flop
Seat 8: nickreason17 collected ($6.50)
Seat 9: Sashey2708 folded before Flop (didn't bet)





PokerStars Hand #148832187175:  Hold'em No Limit ($0.50/$1.00 USD) - 2016/02/15 10:30:41 CET [2016/02/15 4:30:41 ET]
Table 'Anteros' 9-max Seat #8 is the button
Seat 1: OskarR89 ($100 in chips) 
Seat 7: Zoubou1983 ($80 in chips) 
Seat 8: matiko09 ($102.25 in chips) 
Seat 9: WDW3 ($102.30 in chips) 
WDW3: posts small blind $0.50
OskarR89: posts big blind $1
IHouseMusic: sits out 
Zoubou1983: posts big blind $1
*** HOLE CARDS ***
Dealt to matiko09 [Js Kd]
Zoubou1983: checks 
matiko09: raises $3 to $4
WDW3: folds 
OskarR89: folds 
Zoubou1983: calls $3
*** FLOP *** [Ah 6d 5s]
Zoubou1983: checks 
matiko09: checks 
*** TURN *** [Ah 6d 5s] [Th]
Zoubou1983: bets $5
matiko09: folds 
Uncalled bet ($5) returned to Zoubou1983
Zoubou1983 collected $9.07 from pot
Zoubou1983: doesn't show hand 
*** SUMMARY ***
Total pot $9.50 | Rake $0.43 
Board [Ah 6d 5s Th]
Seat 1: OskarR89 (big blind) folded before Flop
Seat 7: Zoubou1983 collected ($9.07)
Seat 8: matiko09 (button) folded on the Turn
Seat 9: WDW3 (small blind) folded before Flop





PokerStars Hand #148832192007:  Hold'em No Limit ($0.25/$0.50 USD) - 2016/02/15 10:30:53 CET [2016/02/15 4:30:53 ET]
Table 'Juliet' 9-max Seat #7 is the button
Seat 1: i L00K great ($97.60 in chips) 
Seat 2: Nabulasun ($20 in chips) 
Seat 3: arctur17 ($57.12 in chips) 
Seat 4: pandalapa ($54.80 in chips) 
Seat 5: dndngod ($50 in chips) 
Seat 6: r4mz3s ($60.82 in chips) 
Seat 7: goldpiggy ($36.40 in chips) 
Seat 8: matiko09 ($50 in chips) 
matiko09: posts small blind $0.25
i L00K great: posts big blind $0.50
*** HOLE CARDS ***
Dealt to matiko09 [7h 3s]
Nabulasun: folds 
arctur17: calls $0.50
pandalapa: folds 
dndngod: folds 
r4mz3s: raises $1.80 to $2.30
goldpiggy: folds 
matiko09: folds 
i L00K great: folds 
arctur17: calls $1.80
*** FLOP *** [5d 7s 8c]
arctur17: checks 
r4mz3s: checks 
*** TURN *** [5d 7s 8c] [3d]
arctur17: bets $3
r4mz3s: folds 
Uncalled bet ($3) returned to arctur17
arctur17 collected $5.11 from pot
arctur17: doesn't show hand 
*** SUMMARY ***
Total pot $5.35 | Rake $0.24 
Board [5d 7s 8c 3d]
Seat 1: i L00K great (big blind) folded before Flop
Seat 2: Nabulasun folded before Flop (didn't bet)
Seat 3: arctur17 collected ($5.11)
Seat 4: pandalapa folded before Flop (didn't bet)
Seat 5: dndngod folded before Flop (didn't bet)
Seat 6: r4mz3s folded on the Turn
Seat 7: goldpiggy (button) folded before Flop (didn't bet)
Seat 8: matiko09 (small blind) folded before Flop





PokerStars Hand #148832192495:  Hold'em No Limit ($0.50/$1.00 USD) - 2016/02/15 10:30:54 CET [2016/02/15 4:30:54 ET]
Table 'Urania' 9-max Seat #8 is the button
Seat 1: matiko09 ($100 in chips) 
Seat 2: maxxmeister ($135.67 in chips) 
Seat 3: Priidix ($128.98 in chips) 
Seat 4: nickreason17 ($100.37 in chips) 
Seat 5: maxonplay ($177.58 in chips) 
Seat 6: vrnMike ($171.61 in chips) 
Seat 7: darren1031 ($168.26 in chips) 
Seat 8: Venomous100% ($128.70 in chips) 
Seat 9: lixiangli ($95.40 in chips) 
lixiangli: posts small blind $0.50
matiko09: posts big blind $1
*** HOLE CARDS ***
Dealt to matiko09 [Ad 3s]
maxxmeister: folds 
Priidix: folds 
nickreason17: folds 
maxonplay: folds 
vrnMike: folds 
darren1031: calls $1
Venomous100%: raises $4 to $5
lixiangli: folds 
matiko09: folds 
darren1031: calls $4
*** FLOP *** [2d Jd 5s]
darren1031: checks 
Venomous100%: bets $5.49
darren1031: calls $5.49
*** TURN *** [2d Jd 5s] [3h]
darren1031: checks 
Venomous100%: checks 
*** RIVER *** [2d Jd 5s 3h] [5h]
darren1031: checks 
Venomous100%: checks 
*** SHOW DOWN ***
darren1031: shows [8d 8c] (two pair, Eights and Fives)
Venomous100%: mucks hand 
darren1031 collected $21.47 from pot
*** SUMMARY ***
Total pot $22.48 | Rake $1.01 
Board [2d Jd 5s 3h 5h]
Seat 1: matiko09 (big blind) folded before Flop
Seat 2: maxxmeister folded before Flop (didn't bet)
Seat 3: Priidix folded before Flop (didn't bet)
Seat 4: nickreason17 folded before Flop (didn't bet)
Seat 5: maxonplay folded before Flop (didn't bet)
Seat 6: vrnMike folded before Flop (didn't bet)
Seat 7: darren1031 showed [8d 8c] and won ($21.47) with two pair, Eights and Fives
Seat 8: Venomous100% (button) mucked [6c 9c]
Seat 9: lixiangli (small blind) folded before Flop





PokerStars Hand #148832198433:  Hold'em No Limit ($0.25/$0.50 USD) - 2016/02/15 10:31:09 CET [2016/02/15 4:31:09 ET]
Table 'Laertes II' 9-max Seat #4 is the button
Seat 1: dade33 ($67.55 in chips) 
Seat 3: ljryviltj ($56.16 in chips) 
Seat 4: rgar93 ($37.68 in chips) 
Seat 5: vlad11122007 ($49.50 in chips) 
Seat 6: moshiko29 ($21.62 in chips) 
Seat 7: OskarR89 ($71.81 in chips) 
Seat 8: Trent444 ($47.48 in chips) 
Seat 9: matiko09 ($50 in chips) 
vlad11122007: posts small blind $0.25
moshiko29: posts big blind $0.50
*** HOLE CARDS ***
Dealt to matiko09 [6h 3s]
OskarR89: folds 
Trent444: folds 
matiko09: folds 
dade33: folds 
ljryviltj: folds 
rgar93: folds 
vlad11122007: raises $1 to $1.50
moshiko29: calls $1
*** FLOP *** [7c 2d 9d]
vlad11122007: checks 
moshiko29: checks 
*** TURN *** [7c 2d 9d] [Jh]
vlad11122007: checks 
moshiko29: bets $0.50
vlad11122007: folds 
Uncalled bet ($0.50) returned to moshiko29
moshiko29 collected $2.86 from pot
*** SUMMARY ***
Total pot $3 | Rake $0.14 
Board [7c 2d 9d Jh]
Seat 1: dade33 folded before Flop (didn't bet)
Seat 3: ljryviltj folded before Flop (didn't bet)
Seat 4: rgar93 (button) folded before Flop (didn't bet)
Seat 5: vlad11122007 (small blind) folded on the Turn
Seat 6: moshiko29 (big blind) collected ($2.86)
Seat 7: OskarR89 folded before Flop (didn't bet)
Seat 8: Trent444 folded before Flop (didn't bet)
Seat 9: matiko09 folded before Flop (didn't bet)





PokerStars Hand #148832201954:  Hold'em No Limit ($0.50/$1.00 USD) - 2016/02/15 10:31:18 CET [2016/02/15 4:31:18 ET]
Table 'Vibeke' 9-max Seat #2 is the button
Seat 1: Venomous100% ($198.91 in chips) 
Seat 2: Priidix ($142.41 in chips) 
Seat 3: matiko09 ($100 in chips) 
Seat 4: fanmtZ ($43.42 in chips) 
Seat 5: vrnMike ($199.14 in chips) 
Seat 7: lixiangli ($79.72 in chips) 
Seat 8: nickreason17 ($126.12 in chips) 
Seat 9: Sashey2708 ($107.29 in chips) 
matiko09: posts small blind $0.50
fanmtZ: posts big blind $1
AlKatrone: sits out 
*** HOLE CARDS ***
Dealt to matiko09 [Kc Td]
vrnMike: folds 
lixiangli: folds 
nickreason17: folds 
Sashey2708: raises $2 to $3
Venomous100%: folds 
Priidix: folds 
matiko09: folds 
fanmtZ: folds 
Uncalled bet ($2) returned to Sashey2708
Sashey2708 collected $2.50 from pot
Sashey2708: doesn't show hand 
*** SUMMARY ***
Total pot $2.50 | Rake $0 
Seat 1: Venomous100% folded before Flop (didn't bet)
Seat 2: Priidix (button) folded before Flop (didn't bet)
Seat 3: matiko09 (small blind) folded before Flop
Seat 4: fanmtZ (big blind) folded before Flop
Seat 5: vrnMike folded before Flop (didn't bet)
Seat 7: lixiangli folded before Flop (didn't bet)
Seat 8: nickreason17 folded before Flop (didn't bet)
Seat 9: Sashey2708 collected ($2.50)





PokerStars Hand #148832202440:  Hold'em No Limit ($0.50/$1.00 USD) - 2016/02/15 10:31:19 CET [2016/02/15 4:31:19 ET]
Table 'Praecipua' 9-max Seat #2 is the button
Seat 1: matiko09 ($107.76 in chips) 
Seat 2: vrnMike ($136.17 in chips) 
Seat 3: Venomous100% ($100.50 in chips) 
Seat 4: Priidix ($100 in chips) 
Seat 5: huffwag ($52.50 in chips) 
Seat 6: WDW3 ($150.61 in chips) 
Seat 7: maxxmeister ($202.03 in chips) 
Seat 8: Kalesmash08 ($71.59 in chips) 
Seat 9: AlKatrone ($109.52 in chips) 
Venomous100%: posts small blind $0.50
Priidix: posts big blind $1
*** HOLE CARDS ***
Dealt to matiko09 [Ts Qs]
huffwag: folds 
WDW3: folds 
maxxmeister: folds 
Kalesmash08: folds 
AlKatrone: folds 
matiko09: raises $1.50 to $2.50
vrnMike: raises $5.50 to $8
Venomous100%: folds 
Priidix: folds 
matiko09: calls $5.50
*** FLOP *** [4c Qc 8d]
matiko09: checks 
vrnMike: bets $10
matiko09: calls $10
*** TURN *** [4c Qc 8d] [Kh]
matiko09: checks 
vrnMike: checks 
*** RIVER *** [4c Qc 8d Kh] [Tc]
matiko09: checks 
vrnMike: checks 
*** SHOW DOWN ***
matiko09: shows [Ts Qs] (two pair, Queens and Tens)
vrnMike: mucks hand 
matiko09 collected $35.81 from pot
*** SUMMARY ***
Total pot $37.50 | Rake $1.69 
Board [4c Qc 8d Kh Tc]
Seat 1: matiko09 showed [Ts Qs] and won ($35.81) with two pair, Queens and Tens
Seat 2: vrnMike (button) mucked [As Qd]
Seat 3: Venomous100% (small blind) folded before Flop
Seat 4: Priidix (big blind) folded before Flop
Seat 5: huffwag folded before Flop (didn't bet)
Seat 6: WDW3 folded before Flop (didn't bet)
Seat 7: maxxmeister folded before Flop (didn't bet)
Seat 8: Kalesmash08 folded before Flop (didn't bet)
Seat 9: AlKatrone folded before Flop (didn't bet)





PokerStars Hand #148832203754:  Hold'em No Limit ($0.50/$1.00 USD) - 2016/02/15 10:31:22 CET [2016/02/15 4:31:22 ET]
Table 'Saldanha' 9-max Seat #4 is the button
Seat 1: AlKatrone ($101.50 in chips) 
Seat 3: maxxmeister ($101 in chips) 
Seat 4: WDW3 ($100 in chips) 
Seat 5: Priidix ($134.68 in chips) 
Seat 6: huffwag ($41.16 in chips) 
Seat 7: Venomous100% ($104.30 in chips) 
Seat 8: matiko09 ($101.50 in chips) 
Seat 9: pompaskillad ($49.42 in chips) 
Priidix: posts small blind $0.50
huffwag: posts big blind $1
*** HOLE CARDS ***
Dealt to matiko09 [Td Jc]
Venomous100%: folds 
matiko09: folds 
pompaskillad: folds 
AlKatrone: raises $2 to $3
maxxmeister: folds 
WDW3: folds 
Priidix: folds 
huffwag: calls $2
*** FLOP *** [Ts 8s 6d]
huffwag: checks 
AlKatrone: checks 
*** TURN *** [Ts 8s 6d] [9c]
huffwag: bets $3.10
AlKatrone: calls $3.10
*** RIVER *** [Ts 8s 6d 9c] [6h]
huffwag: checks 
AlKatrone: bets $8
huffwag: folds 
Uncalled bet ($8) returned to AlKatrone
AlKatrone collected $12.13 from pot
AlKatrone: doesn't show hand 
*** SUMMARY ***
Total pot $12.70 | Rake $0.57 
Board [Ts 8s 6d 9c 6h]
Seat 1: AlKatrone collected ($12.13)
Seat 3: maxxmeister folded before Flop (didn't bet)
Seat 4: WDW3 (button) folded before Flop (didn't bet)
Seat 5: Priidix (small blind) folded before Flop
Seat 6: huffwag (big blind) folded on the River
Seat 7: Venomous100% folded before Flop (didn't bet)
Seat 8: matiko09 folded before Flop (didn't bet)
Seat 9: pompaskillad folded before Flop (didn't bet)





PokerStars Hand #148832206514:  Hold'em No Limit ($0.25/$0.50 USD) - 2016/02/15 10:31:29 CET [2016/02/15 4:31:29 ET]
Table 'Margot II' 9-max Seat #4 is the button
Seat 1: i L00K great ($55.18 in chips) 
Seat 2: matiko09 ($73.22 in chips) 
Seat 3: 50CandyJoe ($50.50 in chips) 
Seat 4: r4mz3s ($51.11 in chips) 
Seat 6: OskarR89 ($50 in chips) 
Seat 7: Vedpapa ($50 in chips) 
Seat 8: Aoki42 ($95.45 in chips) 
Seat 9: chijingxiu1 ($59.06 in chips) 
OskarR89: posts small blind $0.25
Vedpapa: posts big blind $0.50
*** HOLE CARDS ***
Dealt to matiko09 [5c Kh]
Aoki42: raises $1 to $1.50
chijingxiu1: folds 
i L00K great: folds 
matiko09: folds 
50CandyJoe: folds 
r4mz3s: folds 
OskarR89: folds 
Vedpapa: folds 
Uncalled bet ($1) returned to Aoki42
Aoki42 collected $1.25 from pot
Aoki42: doesn't show hand 
*** SUMMARY ***
Total pot $1.25 | Rake $0 
Seat 1: i L00K great folded before Flop (didn't bet)
Seat 2: matiko09 folded before Flop (didn't bet)
Seat 3: 50CandyJoe folded before Flop (didn't bet)
Seat 4: r4mz3s (button) folded before Flop (didn't bet)
Seat 6: OskarR89 (small blind) folded before Flop
Seat 7: Vedpapa (big blind) folded before Flop
Seat 8: Aoki42 collected ($1.25)
Seat 9: chijingxiu1 folded before Flop (didn't bet)





PokerStars Hand #148832207236:  Hold'em No Limit ($0.50/$1.00 USD) - 2016/02/15 10:31:31 CET [2016/02/15 4:31:31 ET]
Table 'Anteros' 9-max Seat #9 is the button
Seat 1: OskarR89 ($100 in chips) 
Seat 2: IHouseMusic ($100 in chips) 
Seat 7: Zoubou1983 ($85.07 in chips) 
Seat 8: matiko09 ($100 in chips) 
Seat 9: WDW3 ($101.80 in chips) 
OskarR89: posts small blind $0.50
IHouseMusic: posts big blind $1
*** HOLE CARDS ***
Dealt to matiko09 [4s 9h]
Zoubou1983: calls $1
matiko09: folds 
WDW3: folds 
OskarR89: folds 
IHouseMusic: checks 
*** FLOP *** [Ad 7d Qd]
IHouseMusic: checks 
Zoubou1983: checks 
*** TURN *** [Ad 7d Qd] [9c]
IHouseMusic: bets $1.68
Zoubou1983: calls $1.68
*** RIVER *** [Ad 7d Qd 9c] [6h]
IHouseMusic: checks 
Zoubou1983: checks 
*** SHOW DOWN ***
IHouseMusic: shows [3h Ts] (high card Ace)
Zoubou1983: shows [Ah 5d] (a pair of Aces)
Zoubou1983 collected $5.60 from pot
*** SUMMARY ***
Total pot $5.86 | Rake $0.26 
Board [Ad 7d Qd 9c 6h]
Seat 1: OskarR89 (small blind) folded before Flop
Seat 2: IHouseMusic (big blind) showed [3h Ts] and lost with high card Ace
Seat 7: Zoubou1983 showed [Ah 5d] and won ($5.60) with a pair of Aces
Seat 8: matiko09 folded before Flop (didn't bet)
Seat 9: WDW3 (button) folded before Flop (didn't bet)





PokerStars Hand #148832209643:  Hold'em No Limit ($0.25/$0.50 USD) - 2016/02/15 10:31:37 CET [2016/02/15 4:31:37 ET]
Table 'Vesta II' 9-max Seat #5 is the button
Seat 1: Ahangama ($56.65 in chips) 
Seat 2: i L00K great ($53 in chips) 
Seat 3: matiko09 ($69.40 in chips) 
Seat 4: HJdream ($48.86 in chips) 
Seat 5: dndngod ($68.29 in chips) 
Seat 6: pandalapa ($50 in chips) 
Seat 7: OskarR89 ($89.19 in chips) 
Seat 8: Arystan ($82.35 in chips) 
Seat 9: Aoki42 ($72.05 in chips) 
pandalapa: posts small blind $0.25
OskarR89: posts big blind $0.50
*** HOLE CARDS ***
Dealt to matiko09 [Tc 5c]
Arystan: folds 
Aoki42: folds 
Ahangama: folds 
i L00K great: raises $1 to $1.50
matiko09: folds 
HJdream: folds 
dndngod: folds 
pandalapa: raises $3 to $4.50
OskarR89: raises $4.50 to $9
i L00K great: folds 
pandalapa: folds 
Uncalled bet ($4.50) returned to OskarR89
OskarR89 collected $10.50 from pot
OskarR89: doesn't show hand 
*** SUMMARY ***
Total pot $10.50 | Rake $0 
Seat 1: Ahangama folded before Flop (didn't bet)
Seat 2: i L00K great folded before Flop
Seat 3: matiko09 folded before Flop (didn't bet)
Seat 4: HJdream folded before Flop (didn't bet)
Seat 5: dndngod (button) folded before Flop (didn't bet)
Seat 6: pandalapa (small blind) folded before Flop
Seat 7: OskarR89 (big blind) collected ($10.50)
Seat 8: Arystan folded before Flop (didn't bet)
Seat 9: Aoki42 folded before Flop (didn't bet)





PokerStars Hand #148832215643:  Hold'em No Limit ($0.25/$0.50 USD) - 2016/02/15 10:31:52 CET [2016/02/15 4:31:52 ET]
Table 'Laertes II' 9-max Seat #5 is the button
Seat 1: dade33 ($67.55 in chips) 
Seat 3: ljryviltj ($56.16 in chips) 
Seat 4: rgar93 ($37.68 in chips) 
Seat 5: vlad11122007 ($48 in chips) 
Seat 6: moshiko29 ($22.98 in chips) 
Seat 7: OskarR89 ($71.81 in chips) 
Seat 8: Trent444 ($47.48 in chips) 
Seat 9: matiko09 ($50 in chips) 
moshiko29: posts small blind $0.25
OskarR89: posts big blind $0.50
*** HOLE CARDS ***
Dealt to matiko09 [6d Jh]
Trent444: folds 
matiko09: folds 
dade33: raises $1 to $1.50
ljryviltj: folds 
rgar93: calls $1.50
vlad11122007: folds 
moshiko29: calls $1.25
OskarR89: folds 
*** FLOP *** [3d Ac Qd]
moshiko29: bets $2.50
dade33: folds 
rgar93: folds 
Uncalled bet ($2.50) returned to moshiko29
moshiko29 collected $4.78 from pot
*** SUMMARY ***
Total pot $5 | Rake $0.22 
Board [3d Ac Qd]
Seat 1: dade33 folded on the Flop
Seat 3: ljryviltj folded before Flop (didn't bet)
Seat 4: rgar93 folded on the Flop
Seat 5: vlad11122007 (button) folded before Flop (didn't bet)
Seat 6: moshiko29 (small blind) collected ($4.78)
Seat 7: OskarR89 (big blind) folded before Flop
Seat 8: Trent444 folded before Flop (didn't bet)
Seat 9: matiko09 folded before Flop (didn't bet)





PokerStars Hand #148832215963:  Hold'em No Limit ($0.50/$1.00 USD) - 2016/02/15 10:31:53 CET [2016/02/15 4:31:53 ET]
Table 'Vibeke' 9-max Seat #3 is the button
Seat 1: Venomous100% ($198.91 in chips) 
Seat 2: Priidix ($142.41 in chips) 
Seat 3: matiko09 ($100 in chips) 
Seat 4: fanmtZ ($42.42 in chips) 
Seat 5: vrnMike ($199.14 in chips) 
Seat 7: lixiangli ($79.72 in chips) 
Seat 8: nickreason17 ($126.12 in chips) 
Seat 9: Sashey2708 ($108.79 in chips) 
fanmtZ: posts small blind $0.50
vrnMike: posts big blind $1
AlKatrone: sits out 
*** HOLE CARDS ***
Dealt to matiko09 [Kc 2d]
lixiangli: folds 
nickreason17: folds 
Sashey2708: folds 
Venomous100%: folds 
Priidix: folds 
matiko09: folds 
fanmtZ: folds 
Uncalled bet ($0.50) returned to vrnMike
vrnMike collected $1 from pot
*** SUMMARY ***
Total pot $1 | Rake $0 
Seat 1: Venomous100% folded before Flop (didn't bet)
Seat 2: Priidix folded before Flop (didn't bet)
Seat 3: matiko09 (button) folded before Flop (didn't bet)
Seat 4: fanmtZ (small blind) folded before Flop
Seat 5: vrnMike (big blind) collected ($1)
Seat 7: lixiangli folded before Flop (didn't bet)
Seat 8: nickreason17 folded before Flop (didn't bet)
Seat 9: Sashey2708 folded before Flop (didn't bet)





PokerStars Hand #148832217368:  Hold'em No Limit ($0.25/$0.50 USD) - 2016/02/15 10:31:56 CET [2016/02/15 4:31:56 ET]
Table 'Margot II' 9-max Seat #6 is the button
Seat 1: i L00K great ($55.18 in chips) 
Seat 2: matiko09 ($73.22 in chips) 
Seat 3: 50CandyJoe ($50.50 in chips) 
Seat 4: r4mz3s ($51.11 in chips) 
Seat 6: OskarR89 ($50 in chips) 
Seat 7: Vedpapa ($50 in chips) 
Seat 8: Aoki42 ($96.20 in chips) 
Seat 9: chijingxiu1 ($59.06 in chips) 
Vedpapa: posts small blind $0.25
Aoki42: posts big blind $0.50
*** HOLE CARDS ***
Dealt to matiko09 [2s 5c]
chijingxiu1: folds 
chijingxiu1 leaves the table
Haporuu joins the table at seat #9 
i L00K great: folds 
matiko09: folds 
50CandyJoe: folds 
r4mz3s: raises $0.75 to $1.25
OskarR89: folds 
Vedpapa: folds 
Aoki42: folds 
Uncalled bet ($0.75) returned to r4mz3s
r4mz3s collected $1.25 from pot
r4mz3s: doesn't show hand 
*** SUMMARY ***
Total pot $1.25 | Rake $0 
Seat 1: i L00K great folded before Flop (didn't bet)
Seat 2: matiko09 folded before Flop (didn't bet)
Seat 3: 50CandyJoe folded before Flop (didn't bet)
Seat 4: r4mz3s collected ($1.25)
Seat 6: OskarR89 (button) folded before Flop (didn't bet)
Seat 7: Vedpapa (small blind) folded before Flop
Seat 8: Aoki42 (big blind) folded before Flop
Seat 9: chijingxiu1 folded before Flop (didn't bet)





PokerStars Hand #148832219747:  Hold'em No Limit ($0.50/$1.00 USD) - 2016/02/15 10:32:02 CET [2016/02/15 4:32:02 ET]
Table 'Anteros' 9-max Seat #1 is the button
Seat 1: OskarR89 ($100 in chips) 
Seat 2: IHouseMusic ($100 in chips) 
Seat 7: Zoubou1983 ($87.99 in chips) 
Seat 8: matiko09 ($100 in chips) 
Seat 9: WDW3 ($101.80 in chips) 
IHouseMusic: posts small blind $0.50
Zoubou1983: posts big blind $1
*** HOLE CARDS ***
Dealt to matiko09 [6h 9d]
matiko09: folds 
WDW3: folds 
OskarR89: raises $1 to $2
IHouseMusic: folds 
Zoubou1983: calls $1
*** FLOP *** [4h 2h Qh]
Zoubou1983: bets $3
OskarR89: calls $3
*** TURN *** [4h 2h Qh] [2c]
Zoubou1983: bets $5
OskarR89: folds 
Uncalled bet ($5) returned to Zoubou1983
Zoubou1983 collected $10.03 from pot
Zoubou1983: doesn't show hand 
*** SUMMARY ***
Total pot $10.50 | Rake $0.47 
Board [4h 2h Qh 2c]
Seat 1: OskarR89 (button) folded on the Turn
Seat 2: IHouseMusic (small blind) folded before Flop
Seat 7: Zoubou1983 (big blind) collected ($10.03)
Seat 8: matiko09 folded before Flop (didn't bet)
Seat 9: WDW3 folded before Flop (didn't bet)





PokerStars Hand #148832221894:  Hold'em No Limit ($0.25/$0.50 USD) - 2016/02/15 10:32:07 CET [2016/02/15 4:32:07 ET]
Table 'Juliet' 9-max Seat #8 is the button
Seat 1: i L00K great ($97.10 in chips) 
Seat 2: Nabulasun ($20 in chips) 
Seat 3: arctur17 ($59.93 in chips) 
Seat 4: pandalapa ($54.80 in chips) 
Seat 5: dndngod ($50 in chips) 
Seat 6: r4mz3s ($58.52 in chips) 
Seat 7: goldpiggy ($36.40 in chips) 
Seat 8: matiko09 ($50 in chips) 
i L00K great: posts small blind $0.25
Nabulasun: posts big blind $0.50
*** HOLE CARDS ***
Dealt to matiko09 [3s 4s]
arctur17: folds 
pandalapa: folds 
dndngod: folds 
r4mz3s: folds 
goldpiggy: folds 
matiko09: folds 
i L00K great: folds 
Uncalled bet ($0.25) returned to Nabulasun
Nabulasun collected $0.50 from pot
Nabulasun: doesn't show hand 
*** SUMMARY ***
Total pot $0.50 | Rake $0 
Seat 1: i L00K great (small blind) folded before Flop
Seat 2: Nabulasun (big blind) collected ($0.50)
Seat 3: arctur17 folded before Flop (didn't bet)
Seat 4: pandalapa folded before Flop (didn't bet)
Seat 5: dndngod folded before Flop (didn't bet)
Seat 6: r4mz3s folded before Flop (didn't bet)
Seat 7: goldpiggy folded before Flop (didn't bet)
Seat 8: matiko09 (button) folded before Flop (didn't bet)





PokerStars Hand #148832227699:  Hold'em No Limit ($0.50/$1.00 USD) - 2016/02/15 10:32:22 CET [2016/02/15 4:32:22 ET]
Table 'Vibeke' 9-max Seat #4 is the button
Seat 1: Venomous100% ($198.91 in chips) 
Seat 2: Priidix ($142.41 in chips) 
Seat 3: matiko09 ($100 in chips) 
Seat 4: fanmtZ ($41.92 in chips) 
Seat 5: vrnMike ($199.64 in chips) 
Seat 6: AlKatrone ($100 in chips) 
Seat 7: lixiangli ($79.72 in chips) 
Seat 8: nickreason17 ($126.12 in chips) 
Seat 9: Sashey2708 ($108.79 in chips) 
vrnMike: posts small blind $0.50
AlKatrone: posts big blind $1
*** HOLE CARDS ***
Dealt to matiko09 [Ks 7s]
lixiangli: folds 
nickreason17: folds 
Sashey2708: folds 
Venomous100%: folds 
Priidix: folds 
matiko09: folds 
fanmtZ: raises $1.50 to $2.50
vrnMike: calls $2
AlKatrone: raises $9.25 to $11.75
fanmtZ: folds 
vrnMike: raises $187.89 to $199.64 and is all-in
AlKatrone: folds 
Uncalled bet ($187.89) returned to vrnMike
vrnMike collected $26 from pot
*** SUMMARY ***
Total pot $26 | Rake $0 
Seat 1: Venomous100% folded before Flop (didn't bet)
Seat 2: Priidix folded before Flop (didn't bet)
Seat 3: matiko09 folded before Flop (didn't bet)
Seat 4: fanmtZ (button) folded before Flop
Seat 5: vrnMike (small blind) collected ($26)
Seat 6: AlKatrone (big blind) folded before Flop
Seat 7: lixiangli folded before Flop (didn't bet)
Seat 8: nickreason17 folded before Flop (didn't bet)
Seat 9: Sashey2708 folded before Flop (didn't bet)





PokerStars Hand #148832229962:  Hold'em No Limit ($0.50/$1.00 USD) - 2016/02/15 10:32:27 CET [2016/02/15 4:32:27 ET]
Table 'Gemma II' 9-max Seat #7 is the button
Seat 1: Igor DoUrden ($165.05 in chips) 
Seat 2: WDW3 ($142.27 in chips) 
Seat 3: Venomous100% ($142.94 in chips) 
Seat 4: nickreason17 ($107.29 in chips) 
Seat 5: PokerSash201 ($59.07 in chips) 
Seat 6: fanmtZ ($51.33 in chips) 
Seat 7: AlKatrone ($114.67 in chips) 
Seat 8: vrnMike ($138.14 in chips) 
Seat 9: matiko09 ($112.67 in chips) 
vrnMike: posts small blind $0.50
matiko09: posts big blind $1
*** HOLE CARDS ***
Dealt to matiko09 [5c 4d]
Igor DoUrden: folds 
WDW3: folds 
Venomous100%: folds 
nickreason17: folds 
PokerSash201: raises $1 to $2
fanmtZ: folds 
AlKatrone: folds 
vrnMike: folds 
matiko09: folds 
Uncalled bet ($1) returned to PokerSash201
PokerSash201 collected $2.50 from pot
PokerSash201: doesn't show hand 
*** SUMMARY ***
Total pot $2.50 | Rake $0 
Seat 1: Igor DoUrden folded before Flop (didn't bet)
Seat 2: WDW3 folded before Flop (didn't bet)
Seat 3: Venomous100% folded before Flop (didn't bet)
Seat 4: nickreason17 folded before Flop (didn't bet)
Seat 5: PokerSash201 collected ($2.50)
Seat 6: fanmtZ folded before Flop (didn't bet)
Seat 7: AlKatrone (button) folded before Flop (didn't bet)
Seat 8: vrnMike (small blind) folded before Flop
Seat 9: matiko09 (big blind) folded before Flop





PokerStars Hand #148832230023:  Hold'em No Limit ($0.25/$0.50 USD) - 2016/02/15 10:32:27 CET [2016/02/15 4:32:27 ET]
Table 'Juliet' 9-max Seat #1 is the button
Seat 1: i L00K great ($96.85 in chips) 
Seat 2: Nabulasun ($20.25 in chips) 
Seat 3: arctur17 ($59.93 in chips) 
Seat 4: pandalapa ($54.80 in chips) 
Seat 5: dndngod ($50 in chips) 
Seat 6: r4mz3s ($58.52 in chips) 
Seat 7: goldpiggy ($36.40 in chips) 
Seat 8: matiko09 ($50 in chips) 
Nabulasun: posts small blind $0.25
arctur17: posts big blind $0.50
*** HOLE CARDS ***
Dealt to matiko09 [6c 3h]
pandalapa: folds 
dndngod: folds 
r4mz3s: folds 
goldpiggy: folds 
matiko09: folds 
i L00K great: folds 
Nabulasun: folds 
Uncalled bet ($0.25) returned to arctur17
arctur17 collected $0.50 from pot
arctur17: doesn't show hand 
*** SUMMARY ***
Total pot $0.50 | Rake $0 
Seat 1: i L00K great (button) folded before Flop (didn't bet)
Seat 2: Nabulasun (small blind) folded before Flop
Seat 3: arctur17 (big blind) collected ($0.50)
Seat 4: pandalapa folded before Flop (didn't bet)
Seat 5: dndngod folded before Flop (didn't bet)
Seat 6: r4mz3s folded before Flop (didn't bet)
Seat 7: goldpiggy folded before Flop (didn't bet)
Seat 8: matiko09 folded before Flop (didn't bet)





PokerStars Hand #148832232271:  Hold'em No Limit ($0.25/$0.50 USD) - 2016/02/15 10:32:33 CET [2016/02/15 4:32:33 ET]
Table 'Margot II' 9-max Seat #7 is the button
Seat 1: i L00K great ($55.18 in chips) 
Seat 2: matiko09 ($73.22 in chips) 
Seat 3: 50CandyJoe ($50.50 in chips) 
Seat 4: r4mz3s ($51.86 in chips) 
Seat 6: OskarR89 ($50 in chips) 
Seat 7: Vedpapa ($50 in chips) 
Seat 8: Aoki42 ($95.70 in chips) 
Seat 9: Haporuu ($25 in chips) 
Aoki42: posts small blind $0.25
Haporuu: posts big blind $0.50
*** HOLE CARDS ***
Dealt to matiko09 [9d Qs]
i L00K great: raises $1 to $1.50
matiko09: folds 
50CandyJoe: folds 
r4mz3s: folds 
OskarR89: folds 
Vedpapa: folds 
Aoki42: folds 
Haporuu: folds 
Uncalled bet ($1) returned to i L00K great
i L00K great collected $1.25 from pot
i L00K great: doesn't show hand 
*** SUMMARY ***
Total pot $1.25 | Rake $0 
Seat 1: i L00K great collected ($1.25)
Seat 2: matiko09 folded before Flop (didn't bet)
Seat 3: 50CandyJoe folded before Flop (didn't bet)
Seat 4: r4mz3s folded before Flop (didn't bet)
Seat 6: OskarR89 folded before Flop (didn't bet)
Seat 7: Vedpapa (button) folded before Flop (didn't bet)
Seat 8: Aoki42 (small blind) folded before Flop
Seat 9: Haporuu (big blind) folded before Flop





PokerStars Hand #148832232831:  Hold'em No Limit ($0.25/$0.50 USD) - 2016/02/15 10:32:34 CET [2016/02/15 4:32:34 ET]
Table 'Vesta II' 9-max Seat #6 is the button
Seat 1: Ahangama ($56.65 in chips) 
Seat 2: i L00K great ($51.50 in chips) 
Seat 3: matiko09 ($69.40 in chips) 
Seat 4: HJdream ($48.86 in chips) 
Seat 5: dndngod ($68.29 in chips) 
Seat 6: pandalapa ($50 in chips) 
Seat 7: OskarR89 ($95.19 in chips) 
Seat 8: Arystan ($82.35 in chips) 
Seat 9: Aoki42 ($72.05 in chips) 
OskarR89: posts small blind $0.25
Arystan: posts big blind $0.50
*** HOLE CARDS ***
Dealt to matiko09 [5h Jd]
Aoki42: folds 
Ahangama: folds 
i L00K great: folds 
matiko09: folds 
HJdream: folds 
dndngod: raises $0.75 to $1.25
pandalapa: folds 
OskarR89: folds 
Arystan: raises $2.25 to $3.50
dndngod: calls $2.25
*** FLOP *** [Qc Ks As]
Arystan: checks 
dndngod: checks 
*** TURN *** [Qc Ks As] [4d]
Arystan: checks 
dndngod: bets $4
Arystan: raises $5 to $9
dndngod: calls $5
*** RIVER *** [Qc Ks As 4d] [3c]
Arystan: checks 
dndngod: checks 
*** SHOW DOWN ***
Arystan: shows [Js Jh] (a pair of Jacks)
dndngod: shows [Th Ad] (a pair of Aces)
dndngod collected $24.11 from pot
*** SUMMARY ***
Total pot $25.25 | Rake $1.14 
Board [Qc Ks As 4d 3c]
Seat 1: Ahangama folded before Flop (didn't bet)
Seat 2: i L00K great folded before Flop (didn't bet)
Seat 3: matiko09 folded before Flop (didn't bet)
Seat 4: HJdream folded before Flop (didn't bet)
Seat 5: dndngod showed [Th Ad] and won ($24.11) with a pair of Aces
Seat 6: pandalapa (button) folded before Flop (didn't bet)
Seat 7: OskarR89 (small blind) folded before Flop
Seat 8: Arystan (big blind) showed [Js Jh] and lost with a pair of Jacks
Seat 9: Aoki42 folded before Flop (didn't bet)





PokerStars Hand #148832234315:  Hold'em No Limit ($0.50/$1.00 USD) - 2016/02/15 10:32:38 CET [2016/02/15 4:32:38 ET]
Table 'Praecipua' 9-max Seat #3 is the button
Seat 1: matiko09 ($125.57 in chips) 
Seat 2: vrnMike ($118.17 in chips) 
Seat 3: Venomous100% ($100 in chips) 
Seat 4: Priidix ($100 in chips) 
Seat 5: huffwag ($52.50 in chips) 
Seat 6: WDW3 ($150.61 in chips) 
Seat 7: maxxmeister ($202.03 in chips) 
Seat 8: Kalesmash08 ($71.59 in chips) 
Seat 9: AlKatrone ($109.52 in chips) 
Priidix: posts small blind $0.50
huffwag: posts big blind $1
*** HOLE CARDS ***
Dealt to matiko09 [Ad 9c]
WDW3: folds 
maxxmeister: folds 
WDW3 leaves the table
nickreason17 joins the table at seat #6 
Kalesmash08: folds 
AlKatrone: raises $2 to $3
matiko09: folds 
vrnMike: calls $3
Venomous100%: raises $9 to $12
Priidix: folds 
huffwag: folds 
AlKatrone: folds 
vrnMike: folds 
Uncalled bet ($9) returned to Venomous100%
Venomous100% collected $10.50 from pot
Venomous100%: doesn't show hand 
*** SUMMARY ***
Total pot $10.50 | Rake $0 
Seat 1: matiko09 folded before Flop (didn't bet)
Seat 2: vrnMike folded before Flop
Seat 3: Venomous100% (button) collected ($10.50)
Seat 4: Priidix (small blind) folded before Flop
Seat 5: huffwag (big blind) folded before Flop
Seat 6: WDW3 folded before Flop (didn't bet)
Seat 7: maxxmeister folded before Flop (didn't bet)
Seat 8: Kalesmash08 folded before Flop (didn't bet)
Seat 9: AlKatrone folded before Flop





PokerStars Hand #148832236577:  Hold'em No Limit ($0.50/$1.00 USD) - 2016/02/15 10:32:44 CET [2016/02/15 4:32:44 ET]
Table 'Anteros' 9-max Seat #2 is the button
Seat 1: OskarR89 ($100 in chips) 
Seat 2: IHouseMusic ($100 in chips) 
Seat 7: Zoubou1983 ($93.02 in chips) 
Seat 8: matiko09 ($100 in chips) 
Seat 9: WDW3 ($101.80 in chips) 
Zoubou1983: posts small blind $0.50
matiko09: posts big blind $1
*** HOLE CARDS ***
Dealt to matiko09 [Ad 8h]
WDW3: folds 
OskarR89: folds 
IHouseMusic: raises $1 to $2
Zoubou1983: calls $1.50
matiko09: folds 
*** FLOP *** [9c Kc Ah]
Zoubou1983: checks 
IHouseMusic: bets $3.35
Zoubou1983: calls $3.35
*** TURN *** [9c Kc Ah] [4s]
Zoubou1983: checks 
IHouseMusic: bets $7.84
Zoubou1983: folds 
Uncalled bet ($7.84) returned to IHouseMusic
IHouseMusic collected $11.17 from pot
IHouseMusic: doesn't show hand 
*** SUMMARY ***
Total pot $11.70 | Rake $0.53 
Board [9c Kc Ah 4s]
Seat 1: OskarR89 folded before Flop (didn't bet)
Seat 2: IHouseMusic (button) collected ($11.17)
Seat 7: Zoubou1983 (small blind) folded on the Turn
Seat 8: matiko09 (big blind) folded before Flop
Seat 9: WDW3 folded before Flop (didn't bet)





PokerStars Hand #148832238314:  Hold'em No Limit ($0.25/$0.50 USD) - 2016/02/15 10:32:48 CET [2016/02/15 4:32:48 ET]
Table 'Laertes II' 9-max Seat #6 is the button
Seat 1: dade33 ($66.05 in chips) 
Seat 3: ljryviltj ($56.16 in chips) 
Seat 4: rgar93 ($36.18 in chips) 
Seat 5: vlad11122007 ($48 in chips) 
Seat 6: moshiko29 ($26.26 in chips) 
Seat 7: OskarR89 ($71.31 in chips) 
Seat 8: Trent444 ($47.48 in chips) 
Seat 9: matiko09 ($50 in chips) 
OskarR89: posts small blind $0.25
Trent444: posts big blind $0.50
*** HOLE CARDS ***
Dealt to matiko09 [Qd 3d]
matiko09: folds 
dade33: folds 
ljryviltj: folds 
rgar93 has timed out
rgar93: folds 
vlad11122007: folds 
moshiko29: folds 
OskarR89: raises $0.50 to $1
Trent444: folds 
Uncalled bet ($0.50) returned to OskarR89
OskarR89 collected $1 from pot
OskarR89: doesn't show hand 
*** SUMMARY ***
Total pot $1 | Rake $0 
Seat 1: dade33 folded before Flop (didn't bet)
Seat 3: ljryviltj folded before Flop (didn't bet)
Seat 4: rgar93 folded before Flop (didn't bet)
Seat 5: vlad11122007 folded before Flop (didn't bet)
Seat 6: moshiko29 (button) folded before Flop (didn't bet)
Seat 7: OskarR89 (small blind) collected ($1)
Seat 8: Trent444 (big blind) folded before Flop
Seat 9: matiko09 folded before Flop (didn't bet)





PokerStars Hand #148832239429:  Hold'em No Limit ($0.25/$0.50 USD) - 2016/02/15 10:32:51 CET [2016/02/15 4:32:51 ET]
Table 'Margot II' 9-max Seat #8 is the button
Seat 1: i L00K great ($55.93 in chips) 
Seat 2: matiko09 ($73.22 in chips) 
Seat 3: 50CandyJoe ($50.50 in chips) 
Seat 4: r4mz3s ($51.86 in chips) 
Seat 6: OskarR89 ($50 in chips) 
Seat 7: Vedpapa ($50 in chips) 
Seat 8: Aoki42 ($95.45 in chips) 
Seat 9: Haporuu ($24.50 in chips) 
Haporuu: posts small blind $0.25
i L00K great: posts big blind $0.50
*** HOLE CARDS ***
Dealt to matiko09 [Jc 2h]
matiko09: folds 
50CandyJoe: folds 
r4mz3s: folds 
OskarR89: raises $0.75 to $1.25
Vedpapa: folds 
Aoki42: folds 
Haporuu: calls $1
i L00K great: folds 
*** FLOP *** [Kd 3d Qc]
Haporuu: checks 
OskarR89: bets $2.14
Haporuu: folds 
Uncalled bet ($2.14) returned to OskarR89
OskarR89 collected $2.86 from pot
OskarR89: doesn't show hand 
*** SUMMARY ***
Total pot $3 | Rake $0.14 
Board [Kd 3d Qc]
Seat 1: i L00K great (big blind) folded before Flop
Seat 2: matiko09 folded before Flop (didn't bet)
Seat 3: 50CandyJoe folded before Flop (didn't bet)
Seat 4: r4mz3s folded before Flop (didn't bet)
Seat 6: OskarR89 collected ($2.86)
Seat 7: Vedpapa folded before Flop (didn't bet)
Seat 8: Aoki42 (button) folded before Flop (didn't bet)
Seat 9: Haporuu (small blind) folded on the Flop





PokerStars Hand #148832239838:  Hold'em No Limit ($0.50/$1.00 USD) - 2016/02/15 10:32:52 CET [2016/02/15 4:32:52 ET]
Table 'Urania' 9-max Seat #9 is the button
Seat 1: matiko09 ($100 in chips) 
Seat 2: maxxmeister ($135.67 in chips) 
Seat 3: Priidix ($128.98 in chips) 
Seat 4: nickreason17 ($100.37 in chips) 
Seat 5: maxonplay ($177.58 in chips) 
Seat 6: vrnMike ($171.61 in chips) 
Seat 7: darren1031 ($179.24 in chips) 
Seat 8: Venomous100% ($118.21 in chips) 
Seat 9: lixiangli ($94.90 in chips) 
matiko09: posts small blind $0.50
maxxmeister: posts big blind $1
*** HOLE CARDS ***
Dealt to matiko09 [Jd 2h]
Priidix: folds 
nickreason17: folds 
maxonplay: folds 
vrnMike: folds 
darren1031: folds 
Venomous100%: raises $1.50 to $2.50
lixiangli: folds 
matiko09: folds 
maxxmeister: calls $1.50
*** FLOP *** [Kc Qs Qh]
maxxmeister: checks 
Venomous100%: checks 
*** TURN *** [Kc Qs Qh] [8s]
maxxmeister: checks 
Venomous100%: checks 
*** RIVER *** [Kc Qs Qh 8s] [3d]
maxxmeister: bets $3.56
Venomous100%: folds 
Uncalled bet ($3.56) returned to maxxmeister
maxxmeister collected $5.25 from pot
maxxmeister: doesn't show hand 
*** SUMMARY ***
Total pot $5.50 | Rake $0.25 
Board [Kc Qs Qh 8s 3d]
Seat 1: matiko09 (small blind) folded before Flop
Seat 2: maxxmeister (big blind) collected ($5.25)
Seat 3: Priidix folded before Flop (didn't bet)
Seat 4: nickreason17 folded before Flop (didn't bet)
Seat 5: maxonplay folded before Flop (didn't bet)
Seat 6: vrnMike folded before Flop (didn't bet)
Seat 7: darren1031 folded before Flop (didn't bet)
Seat 8: Venomous100% folded on the River
Seat 9: lixiangli (button) folded before Flop (didn't bet)





PokerStars Hand #148832241199:  Hold'em No Limit ($0.25/$0.50 USD) - 2016/02/15 10:32:55 CET [2016/02/15 4:32:55 ET]
Table 'Juliet' 9-max Seat #2 is the button
Seat 1: i L00K great ($96.85 in chips) 
Seat 2: Nabulasun ($20 in chips) 
Seat 3: arctur17 ($60.18 in chips) 
Seat 4: pandalapa ($54.80 in chips) 
Seat 5: dndngod ($50 in chips) 
Seat 6: r4mz3s ($58.52 in chips) 
Seat 7: goldpiggy ($36.40 in chips) 
Seat 8: matiko09 ($50 in chips) 
arctur17: posts small blind $0.25
pandalapa: posts big blind $0.50
*** HOLE CARDS ***
Dealt to matiko09 [Ac Ts]
dndngod: folds 
r4mz3s: folds 
goldpiggy: folds 
matiko09: raises $1 to $1.50
i L00K great: raises $3 to $4.50
Nabulasun: folds 
arctur17: folds 
pandalapa: folds 
matiko09: folds 
Uncalled bet ($3) returned to i L00K great
i L00K great collected $3.75 from pot
i L00K great: doesn't show hand 
*** SUMMARY ***
Total pot $3.75 | Rake $0 
Seat 1: i L00K great collected ($3.75)
Seat 2: Nabulasun (button) folded before Flop (didn't bet)
Seat 3: arctur17 (small blind) folded before Flop
Seat 4: pandalapa (big blind) folded before Flop
Seat 5: dndngod folded before Flop (didn't bet)
Seat 6: r4mz3s folded before Flop (didn't bet)
Seat 7: goldpiggy folded before Flop (didn't bet)
Seat 8: matiko09 folded before Flop





PokerStars Hand #148832243359:  Hold'em No Limit ($0.50/$1.00 USD) - 2016/02/15 10:33:00 CET [2016/02/15 4:33:00 ET]
Table 'Saldanha' 9-max Seat #5 is the button
Seat 1: AlKatrone ($107.53 in chips) 
Seat 3: maxxmeister ($101 in chips) 
Seat 4: WDW3 ($100 in chips) 
Seat 5: Priidix ($134.18 in chips) 
Seat 6: huffwag ($35.06 in chips) 
Seat 7: Venomous100% ($104.30 in chips) 
Seat 8: matiko09 ($101.50 in chips) 
Seat 9: pompaskillad ($49.42 in chips) 
huffwag: posts small blind $0.50
Venomous100%: posts big blind $1
*** HOLE CARDS ***
Dealt to matiko09 [8s Jd]
matiko09: folds 
pompaskillad: folds 
AlKatrone: folds 
maxxmeister: folds 
WDW3: folds 
Priidix: raises $1.60 to $2.60
huffwag: folds 
Venomous100%: calls $1.60
*** FLOP *** [2s Ac Kd]
Venomous100%: checks 
Priidix: checks 
*** TURN *** [2s Ac Kd] [6s]
Venomous100%: checks 
Priidix: bets $4.08
Venomous100%: folds 
Uncalled bet ($4.08) returned to Priidix
Priidix collected $5.44 from pot
Priidix: doesn't show hand 
*** SUMMARY ***
Total pot $5.70 | Rake $0.26 
Board [2s Ac Kd 6s]
Seat 1: AlKatrone folded before Flop (didn't bet)
Seat 3: maxxmeister folded before Flop (didn't bet)
Seat 4: WDW3 folded before Flop (didn't bet)
Seat 5: Priidix (button) collected ($5.44)
Seat 6: huffwag (small blind) folded before Flop
Seat 7: Venomous100% (big blind) folded on the Turn
Seat 8: matiko09 folded before Flop (didn't bet)
Seat 9: pompaskillad folded before Flop (didn't bet)





PokerStars Hand #148832247444:  Hold'em No Limit ($0.50/$1.00 USD) - 2016/02/15 10:33:11 CET [2016/02/15 4:33:11 ET]
Table 'Gemma II' 9-max Seat #8 is the button
Seat 1: Igor DoUrden ($165.05 in chips) 
Seat 2: WDW3 ($142.27 in chips) 
Seat 3: Venomous100% ($142.94 in chips) 
Seat 4: nickreason17 ($107.29 in chips) 
Seat 5: PokerSash201 ($60.57 in chips) 
Seat 6: fanmtZ ($51.33 in chips) 
Seat 7: AlKatrone ($114.67 in chips) 
Seat 8: vrnMike ($137.64 in chips) 
Seat 9: matiko09 ($111.67 in chips) 
matiko09: posts small blind $0.50
Igor DoUrden: posts big blind $1
*** HOLE CARDS ***
Dealt to matiko09 [Qc 6s]
WDW3: folds 
Venomous100%: folds 
nickreason17: folds 
PokerSash201: folds 
fanmtZ: folds 
AlKatrone: folds 
vrnMike: raises $2 to $3
matiko09: folds 
Igor DoUrden: folds 
Uncalled bet ($2) returned to vrnMike
vrnMike collected $2.50 from pot
*** SUMMARY ***
Total pot $2.50 | Rake $0 
Seat 1: Igor DoUrden (big blind) folded before Flop
Seat 2: WDW3 folded before Flop (didn't bet)
Seat 3: Venomous100% folded before Flop (didn't bet)
Seat 4: nickreason17 folded before Flop (didn't bet)
Seat 5: PokerSash201 folded before Flop (didn't bet)
Seat 6: fanmtZ folded before Flop (didn't bet)
Seat 7: AlKatrone folded before Flop (didn't bet)
Seat 8: vrnMike (button) collected ($2.50)
Seat 9: matiko09 (small blind) folded before Flop





PokerStars Hand #148832247539:  Hold'em No Limit (€0.25/€0.50 EUR) - 2016/02/15 10:33:11 CET [2016/02/15 4:33:11 ET]
Table 'Walinskia II' 9-max Seat #5 is the button
Seat 1: ljryviltj (€53.25 in chips) 
Seat 4: Otsime (€26.36 in chips) 
Seat 5: vano7777 (€50 in chips) 
Seat 6: 50CandyJoe (€50.25 in chips) 
Seat 8: matiko09 (€50 in chips) 
50CandyJoe: posts small blind €0.25
matiko09: posts big blind €0.50
*** HOLE CARDS ***
Dealt to matiko09 [Jh 2s]
ljryviltj: folds 
Otsime: folds 
vano7777: folds 
50CandyJoe: raises €0.50 to €1
matiko09: folds 
Uncalled bet (€0.50) returned to 50CandyJoe
50CandyJoe collected €1 from pot
50CandyJoe: doesn't show hand 
*** SUMMARY ***
Total pot €1 | Rake €0 
Seat 1: ljryviltj folded before Flop (didn't bet)
Seat 4: Otsime folded before Flop (didn't bet)
Seat 5: vano7777 (button) folded before Flop (didn't bet)
Seat 6: 50CandyJoe (small blind) collected (€1)
Seat 8: matiko09 (big blind) folded before Flop





PokerStars Hand #148832250037:  Hold'em No Limit ($0.25/$0.50 USD) - 2016/02/15 10:33:17 CET [2016/02/15 4:33:17 ET]
Table 'Margot II' 9-max Seat #9 is the button
Seat 1: i L00K great ($55.43 in chips) 
Seat 2: matiko09 ($73.22 in chips) 
Seat 3: 50CandyJoe ($50.50 in chips) 
Seat 4: r4mz3s ($51.86 in chips) 
Seat 6: OskarR89 ($51.61 in chips) 
Seat 7: Vedpapa ($50 in chips) 
Seat 8: Aoki42 ($95.45 in chips) 
Seat 9: Haporuu ($23.25 in chips) 
i L00K great: posts small blind $0.25
matiko09: posts big blind $0.50
*** HOLE CARDS ***
Dealt to matiko09 [5c Tc]
50CandyJoe: folds 
50CandyJoe leaves the table
r4mz3s: folds 
OskarR89: folds 
Vedpapa: folds 
Aoki42: folds 
Haporuu: raises $0.75 to $1.25
i L00K great: folds 
matiko09: folds 
Uncalled bet ($0.75) returned to Haporuu
Haporuu collected $1.25 from pot
Haporuu: doesn't show hand 
*** SUMMARY ***
Total pot $1.25 | Rake $0 
Seat 1: i L00K great (small blind) folded before Flop
Seat 2: matiko09 (big blind) folded before Flop
Seat 3: 50CandyJoe folded before Flop (didn't bet)
Seat 4: r4mz3s folded before Flop (didn't bet)
Seat 6: OskarR89 folded before Flop (didn't bet)
Seat 7: Vedpapa folded before Flop (didn't bet)
Seat 8: Aoki42 folded before Flop (didn't bet)
Seat 9: Haporuu (button) collected ($1.25)





PokerStars Hand #148832252549:  Hold'em No Limit ($0.25/$0.50 USD) - 2016/02/15 10:33:23 CET [2016/02/15 4:33:23 ET]
Table 'Laertes II' 9-max Seat #7 is the button
Seat 1: dade33 ($66.05 in chips) 
Seat 3: ljryviltj ($56.16 in chips) 
Seat 4: rgar93 ($36.18 in chips) 
Seat 5: vlad11122007 ($48 in chips) 
Seat 6: moshiko29 ($26.26 in chips) 
Seat 7: OskarR89 ($71.81 in chips) 
Seat 8: Trent444 ($46.98 in chips) 
Seat 9: matiko09 ($50 in chips) 
Trent444: posts small blind $0.25
matiko09: posts big blind $0.50
beluccix: sits out 
*** HOLE CARDS ***
Dealt to matiko09 [Jh 8h]
dade33: folds 
ljryviltj: folds 
rgar93: folds 
vlad11122007: folds 
moshiko29: calls $0.50
OskarR89: raises $1 to $1.50
Trent444: folds 
matiko09: folds 
moshiko29: calls $1
*** FLOP *** [Td As Kh]
moshiko29: checks 
OskarR89: bets $1.79
moshiko29: calls $1.79
*** TURN *** [Td As Kh] [9h]
moshiko29: checks 
OskarR89: checks 
*** RIVER *** [Td As Kh 9h] [3c]
moshiko29: bets $3.50
OskarR89: folds 
Uncalled bet ($3.50) returned to moshiko29
moshiko29 collected $7 from pot
*** SUMMARY ***
Total pot $7.33 | Rake $0.33 
Board [Td As Kh 9h 3c]
Seat 1: dade33 folded before Flop (didn't bet)
Seat 3: ljryviltj folded before Flop (didn't bet)
Seat 4: rgar93 folded before Flop (didn't bet)
Seat 5: vlad11122007 folded before Flop (didn't bet)
Seat 6: moshiko29 collected ($7)
Seat 7: OskarR89 (button) folded on the River
Seat 8: Trent444 (small blind) folded before Flop
Seat 9: matiko09 (big blind) folded before Flop





PokerStars Hand #148832253381:  Hold'em No Limit ($0.50/$1.00 USD) - 2016/02/15 10:33:25 CET [2016/02/15 4:33:25 ET]
Table 'Anteros' 9-max Seat #7 is the button
Seat 1: OskarR89 ($100 in chips) 
Seat 2: IHouseMusic ($105.82 in chips) 
Seat 7: Zoubou1983 ($87.67 in chips) 
Seat 8: matiko09 ($100 in chips) 
Seat 9: WDW3 ($101.80 in chips) 
matiko09: posts small blind $0.50
WDW3: posts big blind $1
*** HOLE CARDS ***
Dealt to matiko09 [5d Ac]
OskarR89: folds 
IHouseMusic: folds 
Zoubou1983: calls $1
matiko09: raises $4 to $5
WDW3: folds 
Zoubou1983: calls $4
*** FLOP *** [Qh 8d 3s]
matiko09: bets $5.46
Zoubou1983: raises $5.46 to $10.92
matiko09: folds 
Uncalled bet ($5.46) returned to Zoubou1983
Zoubou1983 collected $20.93 from pot
Zoubou1983: doesn't show hand 
*** SUMMARY ***
Total pot $21.92 | Rake $0.99 
Board [Qh 8d 3s]
Seat 1: OskarR89 folded before Flop (didn't bet)
Seat 2: IHouseMusic folded before Flop (didn't bet)
Seat 7: Zoubou1983 (button) collected ($20.93)
Seat 8: matiko09 (small blind) folded on the Flop
Seat 9: WDW3 (big blind) folded before Flop





PokerStars Hand #148832255291:  Hold'em No Limit ($0.25/$0.50 USD) - 2016/02/15 10:33:30 CET [2016/02/15 4:33:30 ET]
Table 'Vesta II' 9-max Seat #7 is the button
Seat 1: Ahangama ($56.65 in chips) 
Seat 2: i L00K great ($51.50 in chips) 
Seat 3: matiko09 ($69.40 in chips) 
Seat 4: HJdream ($48.86 in chips) 
Seat 5: dndngod ($79.90 in chips) 
Seat 6: pandalapa ($50 in chips) 
Seat 7: OskarR89 ($94.94 in chips) 
Seat 8: Arystan ($69.85 in chips) 
Seat 9: Aoki42 ($72.05 in chips) 
Arystan: posts small blind $0.25
Aoki42: posts big blind $0.50
*** HOLE CARDS ***
Dealt to matiko09 [9d Ts]
Ahangama: folds 
i L00K great: folds 
matiko09: folds 
HJdream: folds 
dndngod: folds 
pandalapa: folds 
OskarR89: raises $0.50 to $1
Arystan: calls $0.75
Aoki42: calls $0.50
*** FLOP *** [8c 2d Tc]
Arystan: bets $1.43
Aoki42: calls $1.43
OskarR89: folds 
*** TURN *** [8c 2d Tc] [Kh]
Arystan: checks 
Aoki42: checks 
*** RIVER *** [8c 2d Tc Kh] [5c]
Arystan: bets $2.80
Aoki42: folds 
Uncalled bet ($2.80) returned to Arystan
Arystan collected $5.60 from pot
Arystan: doesn't show hand 
*** SUMMARY ***
Total pot $5.86 | Rake $0.26 
Board [8c 2d Tc Kh 5c]
Seat 1: Ahangama folded before Flop (didn't bet)
Seat 2: i L00K great folded before Flop (didn't bet)
Seat 3: matiko09 folded before Flop (didn't bet)
Seat 4: HJdream folded before Flop (didn't bet)
Seat 5: dndngod folded before Flop (didn't bet)
Seat 6: pandalapa folded before Flop (didn't bet)
Seat 7: OskarR89 (button) folded on the Flop
Seat 8: Arystan (small blind) collected ($5.60)
Seat 9: Aoki42 (big blind) folded on the River





PokerStars Hand #148832257280:  Hold'em No Limit ($0.50/$1.00 USD) - 2016/02/15 10:33:35 CET [2016/02/15 4:33:35 ET]
Table 'Gemma II' 9-max Seat #9 is the button
Seat 1: Igor DoUrden ($164.05 in chips) 
Seat 2: WDW3 ($142.27 in chips) 
Seat 3: Venomous100% ($142.94 in chips) 
Seat 4: nickreason17 ($107.29 in chips) 
Seat 5: PokerSash201 ($60.57 in chips) 
Seat 6: fanmtZ ($51.33 in chips) 
Seat 7: AlKatrone ($114.67 in chips) 
Seat 8: vrnMike ($139.14 in chips) 
Seat 9: matiko09 ($111.17 in chips) 
Igor DoUrden: posts small blind $0.50
WDW3: posts big blind $1
*** HOLE CARDS ***
Dealt to matiko09 [9c 4c]
Venomous100% has timed out
Venomous100%: folds 
nickreason17: folds 
PokerSash201: folds 
fanmtZ: folds 
AlKatrone: folds 
vrnMike: folds 
matiko09: folds 
Igor DoUrden: raises $1.50 to $2.50
WDW3: calls $1.50
*** FLOP *** [Kc 6h 3s]
Igor DoUrden: bets $2.96
WDW3: calls $2.96
*** TURN *** [Kc 6h 3s] [4h]
Igor DoUrden: bets $6.88
WDW3: calls $6.88
*** RIVER *** [Kc 6h 3s 4h] [Jd]
Igor DoUrden: checks 
WDW3: checks 
*** SHOW DOWN ***
Igor DoUrden: shows [Ks Ah] (a pair of Kings)
WDW3: mucks hand 
Igor DoUrden collected $23.57 from pot
*** SUMMARY ***
Total pot $24.68 | Rake $1.11 
Board [Kc 6h 3s 4h Jd]
Seat 1: Igor DoUrden (small blind) showed [Ks Ah] and won ($23.57) with a pair of Kings
Seat 2: WDW3 (big blind) mucked [9h 9s]
Seat 3: Venomous100% folded before Flop (didn't bet)
Seat 4: nickreason17 folded before Flop (didn't bet)
Seat 5: PokerSash201 folded before Flop (didn't bet)
Seat 6: fanmtZ folded before Flop (didn't bet)
Seat 7: AlKatrone folded before Flop (didn't bet)
Seat 8: vrnMike folded before Flop (didn't bet)
Seat 9: matiko09 (button) folded before Flop (didn't bet)





PokerStars Hand #148832257411:  Hold'em No Limit ($0.25/$0.50 USD) - 2016/02/15 10:33:35 CET [2016/02/15 4:33:35 ET]
Table 'Juliet' 9-max Seat #3 is the button
Seat 1: i L00K great ($99.10 in chips) 
Seat 2: Nabulasun ($20 in chips) 
Seat 3: arctur17 ($59.93 in chips) 
Seat 4: pandalapa ($54.30 in chips) 
Seat 5: dndngod ($50 in chips) 
Seat 6: r4mz3s ($58.52 in chips) 
Seat 7: goldpiggy ($36.40 in chips) 
Seat 8: matiko09 ($50 in chips) 
pandalapa: posts small blind $0.25
dndngod: posts big blind $0.50
*** HOLE CARDS ***
Dealt to matiko09 [8c 5s]
r4mz3s: folds 
goldpiggy has timed out
goldpiggy: folds 
matiko09: folds 
i L00K great: raises $1 to $1.50
Nabulasun: folds 
arctur17: calls $1.50
pandalapa: folds 
dndngod: folds 
*** FLOP *** [Jh 8s 2d]
i L00K great: checks 
arctur17: bets $2
i L00K great: folds 
Uncalled bet ($2) returned to arctur17
arctur17 collected $3.58 from pot
arctur17: doesn't show hand 
*** SUMMARY ***
Total pot $3.75 | Rake $0.17 
Board [Jh 8s 2d]
Seat 1: i L00K great folded on the Flop
Seat 2: Nabulasun folded before Flop (didn't bet)
Seat 3: arctur17 (button) collected ($3.58)
Seat 4: pandalapa (small blind) folded before Flop
Seat 5: dndngod (big blind) folded before Flop
Seat 6: r4mz3s folded before Flop (didn't bet)
Seat 7: goldpiggy folded before Flop (didn't bet)
Seat 8: matiko09 folded before Flop (didn't bet)





PokerStars Hand #148832258147:  Hold'em No Limit (€0.25/€0.50 EUR) - 2016/02/15 10:33:37 CET [2016/02/15 4:33:37 ET]
Table 'Walinskia II' 9-max Seat #6 is the button
Seat 1: ljryviltj (€53.25 in chips) 
Seat 4: Otsime (€26.36 in chips) 
Seat 5: vano7777 (€50 in chips) 
Seat 6: 50CandyJoe (€50.75 in chips) 
Seat 8: matiko09 (€50 in chips) 
matiko09: posts small blind €0.25
ljryviltj: posts big blind €0.50
*** HOLE CARDS ***
Dealt to matiko09 [5s 5c]
Otsime: folds 
vano7777: folds 
50CandyJoe: folds 
matiko09: raises €1 to €1.50
ljryviltj: folds 
Uncalled bet (€1) returned to matiko09
matiko09 collected €1 from pot
matiko09: doesn't show hand 
*** SUMMARY ***
Total pot €1 | Rake €0 
Seat 1: ljryviltj (big blind) folded before Flop
Seat 4: Otsime folded before Flop (didn't bet)
Seat 5: vano7777 folded before Flop (didn't bet)
Seat 6: 50CandyJoe (button) folded before Flop (didn't bet)
Seat 8: matiko09 (small blind) collected (€1)





PokerStars Hand #148832259945:  Hold'em No Limit ($0.50/$1.00 USD) - 2016/02/15 10:33:41 CET [2016/02/15 4:33:41 ET]
Table 'Praecipua' 9-max Seat #4 is the button
Seat 1: matiko09 ($125.57 in chips) 
Seat 2: vrnMike ($115.17 in chips) 
Seat 3: Venomous100% ($107.50 in chips) 
Seat 4: Priidix ($100 in chips) 
Seat 5: huffwag ($51.50 in chips) 
Seat 7: maxxmeister ($202.03 in chips) 
Seat 8: Kalesmash08 ($71.59 in chips) 
Seat 9: AlKatrone ($106.52 in chips) 
huffwag: posts small blind $0.50
maxxmeister: posts big blind $1
*** HOLE CARDS ***
Dealt to matiko09 [6c Kc]
Kalesmash08: folds 
AlKatrone: folds 
matiko09: folds 
vrnMike: folds 
Venomous100%: folds 
Priidix: raises $1.60 to $2.60
huffwag: calls $2.10
maxxmeister: calls $1.60
*** FLOP *** [6d Tc 5c]
nickreason17 leaves the table
huffwag: checks 
maxxmeister: checks 
Priidix: bets $5.58
huffwag: folds 
maxxmeister: calls $5.58
*** TURN *** [6d Tc 5c] [2d]
maxxmeister: checks 
Priidix: bets $13.58
maxxmeister: calls $13.58
*** RIVER *** [6d Tc 5c 2d] [7h]
mycka86 joins the table at seat #6 
maxxmeister: checks 
Priidix: bets $33.03
maxxmeister: folds 
Uncalled bet ($33.03) returned to Priidix
Priidix collected $44.04 from pot
Priidix: doesn't show hand 
*** SUMMARY ***
Total pot $46.12 | Rake $2.08 
Board [6d Tc 5c 2d 7h]
Seat 1: matiko09 folded before Flop (didn't bet)
Seat 2: vrnMike folded before Flop (didn't bet)
Seat 3: Venomous100% folded before Flop (didn't bet)
Seat 4: Priidix (button) collected ($44.04)
Seat 5: huffwag (small blind) folded on the Flop
Seat 7: maxxmeister (big blind) folded on the River
Seat 8: Kalesmash08 folded before Flop (didn't bet)
Seat 9: AlKatrone folded before Flop (didn't bet)





PokerStars Hand #148832263961:  Hold'em No Limit ($0.25/$0.50 USD) - 2016/02/15 10:33:51 CET [2016/02/15 4:33:51 ET]
Table 'Margot II' 9-max Seat #1 is the button
Seat 1: i L00K great ($55.18 in chips) 
Seat 2: matiko09 ($72.72 in chips) 
Seat 4: r4mz3s ($51.86 in chips) 
Seat 6: OskarR89 ($51.61 in chips) 
Seat 7: Vedpapa ($50 in chips) 
Seat 8: Aoki42 ($95.45 in chips) 
Seat 9: Haporuu ($24 in chips) 
matiko09: posts small blind $0.25
r4mz3s: posts big blind $0.50
*** HOLE CARDS ***
Dealt to matiko09 [3s Qh]
OskarR89: folds 
Vedpapa: folds 
Aoki42: folds 
Haporuu: folds 
i L00K great: folds 
matiko09: folds 
Uncalled bet ($0.25) returned to r4mz3s
r4mz3s collected $0.50 from pot
r4mz3s: doesn't show hand 
*** SUMMARY ***
Total pot $0.50 | Rake $0 
Seat 1: i L00K great (button) folded before Flop (didn't bet)
Seat 2: matiko09 (small blind) folded before Flop
Seat 4: r4mz3s (big blind) collected ($0.50)
Seat 6: OskarR89 folded before Flop (didn't bet)
Seat 7: Vedpapa folded before Flop (didn't bet)
Seat 8: Aoki42 folded before Flop (didn't bet)
Seat 9: Haporuu folded before Flop (didn't bet)





PokerStars Hand #148832264972:  Hold'em No Limit (€0.25/€0.50 EUR) - 2016/02/15 10:33:54 CET [2016/02/15 4:33:54 ET]
Table 'Walinskia II' 9-max Seat #8 is the button
Seat 1: ljryviltj (€52.75 in chips) 
Seat 4: Otsime (€26.36 in chips) 
Seat 5: vano7777 (€50 in chips) 
Seat 6: 50CandyJoe (€50.75 in chips) 
Seat 8: matiko09 (€50.50 in chips) 
ljryviltj: posts small blind €0.25
Otsime: posts big blind €0.50
*** HOLE CARDS ***
Dealt to matiko09 [As Ah]
vano7777: folds 
50CandyJoe: folds 
beluccix joins the table at seat #3 
matiko09: raises €0.75 to €1.25
stevevg84 joins the table at seat #9 
ljryviltj: folds 
Otsime: calls €0.75
*** FLOP *** [4h 7c Tc]
Otsime: checks 
matiko09: bets €1.71
Otsime: calls €1.71
*** TURN *** [4h 7c Tc] [Jd]
Otsime: bets €0.50
yats87 joins the table at seat #2 
matiko09: raises €3.50 to €4
Otsime: calls €3.50
*** RIVER *** [4h 7c Tc Jd] [3h]
Otsime: checks 
matiko09: bets €9.50
Otsime: raises €9.90 to €19.40 and is all-in
matiko09: folds 
Uncalled bet (€9.90) returned to Otsime
Otsime collected €31.68 from pot
Otsime: doesn't show hand 
*** SUMMARY ***
Total pot €33.17 | Rake €1.49 
Board [4h 7c Tc Jd 3h]
Seat 1: ljryviltj (small blind) folded before Flop
Seat 4: Otsime (big blind) collected (€31.68)
Seat 5: vano7777 folded before Flop (didn't bet)
Seat 6: 50CandyJoe folded before Flop (didn't bet)
Seat 8: matiko09 (button) folded on the River





PokerStars Hand #148832270873:  Hold'em No Limit ($0.25/$0.50 USD) - 2016/02/15 10:34:08 CET [2016/02/15 4:34:08 ET]
Table 'Laertes II' 9-max Seat #8 is the button
Seat 1: dade33 ($66.05 in chips) 
Seat 3: ljryviltj ($56.16 in chips) 
Seat 4: rgar93 ($36.18 in chips) 
Seat 5: vlad11122007 ($48 in chips) 
Seat 6: moshiko29 ($29.97 in chips) 
Seat 7: OskarR89 ($68.52 in chips) 
Seat 8: Trent444 ($46.73 in chips) 
Seat 9: matiko09 ($50 in chips) 
matiko09: posts small blind $0.25
dade33: posts big blind $0.50
beluccix: sits out 
*** HOLE CARDS ***
Dealt to matiko09 [9h 8c]
ljryviltj: folds 
rgar93: folds 
vlad11122007: folds 
moshiko29: calls $0.50
OskarR89: folds 
Trent444: calls $0.50
matiko09: folds 
dade33: raises $2 to $2.50
moshiko29: calls $2
Trent444: folds 
*** FLOP *** [Kh Kc 2h]
dade33: checks 
moshiko29: bets $2.50
dade33: calls $2.50
*** TURN *** [Kh Kc 2h] [3h]
dade33: checks 
moshiko29: bets $10
dade33: folds [Qc Qs]
Uncalled bet ($10) returned to moshiko29
moshiko29 collected $10.27 from pot
*** SUMMARY ***
Total pot $10.75 | Rake $0.48 
Board [Kh Kc 2h 3h]
Seat 1: dade33 (big blind) folded on the Turn
Seat 3: ljryviltj folded before Flop (didn't bet)
Seat 4: rgar93 folded before Flop (didn't bet)
Seat 5: vlad11122007 folded before Flop (didn't bet)
Seat 6: moshiko29 collected ($10.27)
Seat 7: OskarR89 folded before Flop (didn't bet)
Seat 8: Trent444 (button) folded before Flop
Seat 9: matiko09 (small blind) folded before Flop





PokerStars Hand #148832271750:  Hold'em No Limit ($0.50/$1.00 USD) - 2016/02/15 10:34:11 CET [2016/02/15 4:34:11 ET]
Table 'Corvus III' 9-max Seat #5 is the button
Seat 5: koib88 ($34.64 in chips) 
Seat 6: WDW3 ($166.30 in chips) 
Seat 7: matiko09 ($100 in chips) 
Seat 9: maxxmeister ($250.59 in chips) 
WDW3: posts small blind $0.50
matiko09: posts big blind $1
koib88: posts the ante $0.20
WDW3: posts the ante $0.20
matiko09: posts the ante $0.20
maxxmeister: posts the ante $0.20
*** HOLE CARDS ***
Dealt to matiko09 [Qs 3h]
maxxmeister: raises $2 to $3
koib88: calls $3
WDW3: folds 
matiko09: folds 
*** FLOP *** [7s 5s Qc]
maxxmeister: checks 
koib88: checks 
*** TURN *** [7s 5s Qc] [4c]
maxxmeister: checks 
koib88: checks 
*** RIVER *** [7s 5s Qc 4c] [Th]
maxxmeister: checks 
koib88: checks 
*** SHOW DOWN ***
maxxmeister: shows [2d 2s] (a pair of Deuces)
koib88: mucks hand 
maxxmeister collected $7.93 from pot
*** SUMMARY ***
Total pot $8.30 | Rake $0.37 
Board [7s 5s Qc 4c Th]
Seat 5: koib88 (button) mucked [Jc 2c]
Seat 6: WDW3 (small blind) folded before Flop
Seat 7: matiko09 (big blind) folded before Flop
Seat 9: maxxmeister showed [2d 2s] and won ($7.93) with a pair of Deuces





PokerStars Hand #148832273248:  Hold'em No Limit ($0.50/$1.00 USD) - 2016/02/15 10:34:14 CET [2016/02/15 4:34:14 ET]
Table 'Anteros' 9-max Seat #8 is the button
Seat 1: OskarR89 ($100 in chips) 
Seat 2: IHouseMusic ($105.82 in chips) 
Seat 7: Zoubou1983 ($98.14 in chips) 
Seat 8: matiko09 ($100 in chips) 
Seat 9: WDW3 ($100.80 in chips) 
WDW3: posts small blind $0.50
OskarR89: posts big blind $1
*** HOLE CARDS ***
Dealt to matiko09 [Ks Ah]
IHouseMusic: folds 
Zoubou1983: folds 
matiko09: raises $1.27 to $2.27
WDW3: folds 
OskarR89: raises $7.73 to $10
matiko09: raises $12 to $22
OskarR89: folds 
Uncalled bet ($12) returned to matiko09
matiko09 collected $20.50 from pot
matiko09: doesn't show hand 
*** SUMMARY ***
Total pot $20.50 | Rake $0 
Seat 1: OskarR89 (big blind) folded before Flop
Seat 2: IHouseMusic folded before Flop (didn't bet)
Seat 7: Zoubou1983 folded before Flop (didn't bet)
Seat 8: matiko09 (button) collected ($20.50)
Seat 9: WDW3 (small blind) folded before Flop





PokerStars Hand #148832273598:  Hold'em No Limit ($0.50/$1.00 USD) - 2016/02/15 10:34:15 CET [2016/02/15 4:34:15 ET]
Table 'Vibeke' 9-max Seat #5 is the button
Seat 1: Venomous100% ($198.91 in chips) 
Seat 2: Priidix ($142.41 in chips) 
Seat 3: matiko09 ($100 in chips) 
Seat 4: fanmtZ ($40 in chips) 
Seat 5: vrnMike ($213.89 in chips) 
Seat 6: AlKatrone ($100 in chips) 
Seat 9: Sashey2708 ($108.79 in chips) 
AlKatrone: posts small blind $0.50
lixiangli: is sitting out 
nickreason17: is sitting out 
Sashey2708: posts big blind $1
*** HOLE CARDS ***
Dealt to matiko09 [Th Ac]
lixiangli leaves the table
nickreason17 leaves the table
Venomous100%: folds 
Priidix: folds 
matiko09: raises $2 to $3
fanmtZ: folds 
vrnMike: folds 
ackle1 joins the table at seat #7 
AlKatrone: folds 
IHouseMusic joins the table at seat #8 
Sashey2708: calls $2
*** FLOP *** [9c Jd 8s]
Sashey2708: bets $3
matiko09: calls $3
*** TURN *** [9c Jd 8s] [6c]
Sashey2708: checks 
matiko09: checks 
*** RIVER *** [9c Jd 8s 6c] [As]
Sashey2708: bets $6.75
matiko09: calls $6.75
*** SHOW DOWN ***
Sashey2708: shows [3c 5h] (high card Ace)
matiko09: shows [Th Ac] (a pair of Aces)
matiko09 collected $24.83 from pot
*** SUMMARY ***
Total pot $26 | Rake $1.17 
Board [9c Jd 8s 6c As]
Seat 1: Venomous100% folded before Flop (didn't bet)
Seat 2: Priidix folded before Flop (didn't bet)
Seat 3: matiko09 showed [Th Ac] and won ($24.83) with a pair of Aces
Seat 4: fanmtZ folded before Flop (didn't bet)
Seat 5: vrnMike (button) folded before Flop (didn't bet)
Seat 6: AlKatrone (small blind) folded before Flop
Seat 9: Sashey2708 (big blind) showed [3c 5h] and lost with high card Ace





PokerStars Hand #148832274193:  Hold'em No Limit ($0.25/$0.50 USD) - 2016/02/15 10:34:17 CET [2016/02/15 4:34:17 ET]
Table 'Margot II' 9-max Seat #2 is the button
Seat 1: i L00K great ($55.18 in chips) 
Seat 2: matiko09 ($72.47 in chips) 
Seat 4: r4mz3s ($52.11 in chips) 
Seat 6: OskarR89 ($51.61 in chips) 
Seat 7: Vedpapa ($50 in chips) 
Seat 8: Aoki42 ($95.45 in chips) 
Seat 9: Haporuu ($24 in chips) 
r4mz3s: posts small blind $0.25
OskarR89: posts big blind $0.50
*** HOLE CARDS ***
Dealt to matiko09 [Qd Ah]
Vedpapa: folds 
Aoki42: folds 
Haporuu: folds 
i L00K great: raises $0.75 to $1.25
matiko09: calls $1.25
beluccix joins the table at seat #3 
r4mz3s: folds 
OskarR89: folds 
*** FLOP *** [4c Kd Ts]
i L00K great: checks 
matiko09: bets $2.02
i L00K great: folds 
Uncalled bet ($2.02) returned to matiko09
matiko09 collected $3.10 from pot
matiko09: doesn't show hand 
*** SUMMARY ***
Total pot $3.25 | Rake $0.15 
Board [4c Kd Ts]
Seat 1: i L00K great folded on the Flop
Seat 2: matiko09 (button) collected ($3.10)
Seat 4: r4mz3s (small blind) folded before Flop
Seat 6: OskarR89 (big blind) folded before Flop
Seat 7: Vedpapa folded before Flop (didn't bet)
Seat 8: Aoki42 folded before Flop (didn't bet)
Seat 9: Haporuu folded before Flop (didn't bet)





PokerStars Hand #148832277670:  Hold'em No Limit ($0.50/$1.00 USD) - 2016/02/15 10:34:25 CET [2016/02/15 4:34:25 ET]
Table 'Urania' 9-max Seat #1 is the button
Seat 1: matiko09 ($100 in chips) 
Seat 2: maxxmeister ($138.42 in chips) 
Seat 3: Priidix ($128.98 in chips) 
Seat 4: nickreason17 ($100.37 in chips) 
Seat 5: maxonplay ($177.58 in chips) 
Seat 6: vrnMike ($171.61 in chips) 
Seat 7: darren1031 ($179.24 in chips) 
Seat 8: Venomous100% ($115.71 in chips) 
Seat 9: lixiangli ($94.90 in chips) 
maxxmeister: posts small blind $0.50
Priidix: posts big blind $1
*** HOLE CARDS ***
Dealt to matiko09 [3c 8d]
nickreason17: folds 
maxonplay: folds 
vrnMike: folds 
darren1031: calls $1
Venomous100%: folds 
lixiangli: folds 
matiko09: folds 
maxxmeister: raises $1 to $2
Priidix: raises $5 to $7
darren1031: folds 
maxxmeister: folds 
Uncalled bet ($5) returned to Priidix
Priidix collected $5 from pot
Priidix: doesn't show hand 
*** SUMMARY ***
Total pot $5 | Rake $0 
Seat 1: matiko09 (button) folded before Flop (didn't bet)
Seat 2: maxxmeister (small blind) folded before Flop
Seat 3: Priidix (big blind) collected ($5)
Seat 4: nickreason17 folded before Flop (didn't bet)
Seat 5: maxonplay folded before Flop (didn't bet)
Seat 6: vrnMike folded before Flop (didn't bet)
Seat 7: darren1031 folded before Flop
Seat 8: Venomous100% folded before Flop (didn't bet)
Seat 9: lixiangli folded before Flop (didn't bet)





PokerStars Hand #148832279461:  Hold'em No Limit ($0.50/$1.00 USD) - 2016/02/15 10:34:30 CET [2016/02/15 4:34:30 ET]
Table 'Saldanha' 9-max Seat #6 is the button
Seat 1: AlKatrone ($107.53 in chips) 
Seat 3: maxxmeister ($101 in chips) 
Seat 4: WDW3 ($100 in chips) 
Seat 5: Priidix ($137.02 in chips) 
Seat 6: huffwag ($34.56 in chips) 
Seat 7: Venomous100% ($101.70 in chips) 
Seat 8: matiko09 ($101.50 in chips) 
Seat 9: pompaskillad ($49.42 in chips) 
Venomous100%: posts small blind $0.50
matiko09: posts big blind $1
*** HOLE CARDS ***
Dealt to matiko09 [Jh 4h]
pompaskillad: folds 
AlKatrone: folds 
maxxmeister: folds 
WDW3: folds 
Priidix: folds 
huffwag: folds 
Venomous100%: folds 
Uncalled bet ($0.50) returned to matiko09
matiko09 collected $1 from pot
matiko09: doesn't show hand 
*** SUMMARY ***
Total pot $1 | Rake $0 
Seat 1: AlKatrone folded before Flop (didn't bet)
Seat 3: maxxmeister folded before Flop (didn't bet)
Seat 4: WDW3 folded before Flop (didn't bet)
Seat 5: Priidix folded before Flop (didn't bet)
Seat 6: huffwag (button) folded before Flop (didn't bet)
Seat 7: Venomous100% (small blind) folded before Flop
Seat 8: matiko09 (big blind) collected ($1)
Seat 9: pompaskillad folded before Flop (didn't bet)





PokerStars Hand #148832281930:  Hold'em No Limit ($0.25/$0.50 USD) - 2016/02/15 10:34:36 CET [2016/02/15 4:34:36 ET]
Table 'Juliet' 9-max Seat #4 is the button
Seat 1: i L00K great ($97.60 in chips) 
Seat 2: Nabulasun ($20 in chips) 
Seat 3: arctur17 ($62.01 in chips) 
Seat 4: pandalapa ($54.05 in chips) 
Seat 5: dndngod ($50 in chips) 
Seat 6: r4mz3s ($58.52 in chips) 
Seat 7: goldpiggy ($36.40 in chips) 
Seat 8: matiko09 ($50 in chips) 
dndngod: posts small blind $0.25
r4mz3s: posts big blind $0.50
*** HOLE CARDS ***
Dealt to matiko09 [9s 4c]
goldpiggy: folds 
matiko09: folds 
i L00K great: folds 
Nabulasun: folds 
arctur17: folds 
pandalapa: raises $0.50 to $1
dndngod: folds 
r4mz3s: calls $0.50
*** FLOP *** [Ah 6d 2s]
r4mz3s: checks 
pandalapa: checks 
*** TURN *** [Ah 6d 2s] [6s]
r4mz3s: checks 
pandalapa: checks 
*** RIVER *** [Ah 6d 2s 6s] [3h]
r4mz3s: checks 
pandalapa: bets $1.43
r4mz3s: folds 
Uncalled bet ($1.43) returned to pandalapa
pandalapa collected $2.15 from pot
pandalapa: doesn't show hand 
*** SUMMARY ***
Total pot $2.25 | Rake $0.10 
Board [Ah 6d 2s 6s 3h]
Seat 1: i L00K great folded before Flop (didn't bet)
Seat 2: Nabulasun folded before Flop (didn't bet)
Seat 3: arctur17 folded before Flop (didn't bet)
Seat 4: pandalapa (button) collected ($2.15)
Seat 5: dndngod (small blind) folded before Flop
Seat 6: r4mz3s (big blind) folded on the River
Seat 7: goldpiggy folded before Flop (didn't bet)
Seat 8: matiko09 folded before Flop (didn't bet)





PokerStars Hand #148832281872:  Hold'em No Limit ($0.50/$1.00 USD) - 2016/02/15 10:34:36 CET [2016/02/15 4:34:36 ET]
Table 'Gemma II' 9-max Seat #1 is the button
Seat 1: Igor DoUrden ($175.28 in chips) 
Seat 2: WDW3 ($129.93 in chips) 
Seat 3: Venomous100% ($142.94 in chips) 
Seat 4: nickreason17 ($107.29 in chips) 
Seat 5: PokerSash201 ($60.57 in chips) 
Seat 6: fanmtZ ($51.33 in chips) 
Seat 7: AlKatrone ($114.67 in chips) 
Seat 8: vrnMike ($139.14 in chips) 
Seat 9: matiko09 ($111.17 in chips) 
WDW3: posts small blind $0.50
Venomous100%: posts big blind $1
*** HOLE CARDS ***
Dealt to matiko09 [9d Ad]
nickreason17: folds 
PokerSash201: folds 
nickreason17 leaves the table
fanmtZ: raises $1.38 to $2.38
mycka86 joins the table at seat #4 
AlKatrone: folds 
vrnMike: folds 
matiko09: folds 
Igor DoUrden: folds 
WDW3: folds 
Venomous100%: folds 
Uncalled bet ($1.38) returned to fanmtZ
fanmtZ collected $2.50 from pot
fanmtZ: doesn't show hand 
*** SUMMARY ***
Total pot $2.50 | Rake $0 
Seat 1: Igor DoUrden (button) folded before Flop (didn't bet)
Seat 2: WDW3 (small blind) folded before Flop
Seat 3: Venomous100% (big blind) folded before Flop
Seat 4: nickreason17 folded before Flop (didn't bet)
Seat 5: PokerSash201 folded before Flop (didn't bet)
Seat 6: fanmtZ collected ($2.50)
Seat 7: AlKatrone folded before Flop (didn't bet)
Seat 8: vrnMike folded before Flop (didn't bet)
Seat 9: matiko09 folded before Flop (didn't bet)





PokerStars Hand #148832288744:  Hold'em No Limit ($0.25/$0.50 USD) - 2016/02/15 10:34:53 CET [2016/02/15 4:34:53 ET]
Table 'Vesta II' 9-max Seat #8 is the button
Seat 1: Ahangama ($56.65 in chips) 
Seat 2: i L00K great ($51.50 in chips) 
Seat 3: matiko09 ($69.40 in chips) 
Seat 4: HJdream ($48.86 in chips) 
Seat 5: dndngod ($79.90 in chips) 
Seat 6: pandalapa ($50 in chips) 
Seat 7: OskarR89 ($93.94 in chips) 
Seat 8: Arystan ($73.02 in chips) 
Seat 9: Aoki42 ($69.62 in chips) 
Aoki42: posts small blind $0.25
Ahangama: posts big blind $0.50
*** HOLE CARDS ***
Dealt to matiko09 [4h 9s]
i L00K great: folds 
matiko09: folds 
HJdream: folds 
dndngod: folds 
pandalapa: raises $0.75 to $1.25
OskarR89: folds 
Arystan: raises $2.25 to $3.50
Aoki42: folds 
Ahangama: folds 
pandalapa: calls $2.25
*** FLOP *** [8c 9c 5s]
pandalapa: checks 
Arystan: bets $3.70
pandalapa: raises $7.40 to $11.10
Arystan: calls $7.40
*** TURN *** [8c 9c 5s] [5d]
pandalapa: checks 
Arystan: checks 
*** RIVER *** [8c 9c 5s 5d] [Qs]
pandalapa: bets $35.40 and is all-in
Arystan: folds 
Uncalled bet ($35.40) returned to pandalapa
pandalapa collected $28.60 from pot
pandalapa: doesn't show hand 
*** SUMMARY ***
Total pot $29.95 | Rake $1.35 
Board [8c 9c 5s 5d Qs]
Seat 1: Ahangama (big blind) folded before Flop
Seat 2: i L00K great folded before Flop (didn't bet)
Seat 3: matiko09 folded before Flop (didn't bet)
Seat 4: HJdream folded before Flop (didn't bet)
Seat 5: dndngod folded before Flop (didn't bet)
Seat 6: pandalapa collected ($28.60)
Seat 7: OskarR89 folded before Flop (didn't bet)
Seat 8: Arystan (button) folded on the River
Seat 9: Aoki42 (small blind) folded before Flop





PokerStars Hand #148832290157:  Hold'em No Limit ($0.50/$1.00 USD) - 2016/02/15 10:34:56 CET [2016/02/15 4:34:56 ET]
Table 'Anteros' 9-max Seat #9 is the button
Seat 1: OskarR89 ($100 in chips) 
Seat 2: IHouseMusic ($105.82 in chips) 
Seat 7: Zoubou1983 ($98.14 in chips) 
Seat 8: matiko09 ($110.50 in chips) 
Seat 9: WDW3 ($100.30 in chips) 
OskarR89: posts small blind $0.50
IHouseMusic: posts big blind $1
*** HOLE CARDS ***
Dealt to matiko09 [8s Ah]
Zoubou1983: calls $1
matiko09: folds 
WDW3: folds 
OskarR89: raises $3 to $4
IHouseMusic: folds 
Zoubou1983: folds 
Uncalled bet ($3) returned to OskarR89
OskarR89 collected $3 from pot
OskarR89: doesn't show hand 
*** SUMMARY ***
Total pot $3 | Rake $0 
Seat 1: OskarR89 (small blind) collected ($3)
Seat 2: IHouseMusic (big blind) folded before Flop
Seat 7: Zoubou1983 folded before Flop
Seat 8: matiko09 folded before Flop (didn't bet)
Seat 9: WDW3 (button) folded before Flop (didn't bet)





PokerStars Hand #148832290734:  Hold'em No Limit ($0.50/$1.00 USD) - 2016/02/15 10:34:57 CET [2016/02/15 4:34:57 ET]
Table 'Saldanha' 9-max Seat #7 is the button
Seat 1: AlKatrone ($107.53 in chips) 
Seat 3: maxxmeister ($101 in chips) 
Seat 4: WDW3 ($100 in chips) 
Seat 5: Priidix ($137.02 in chips) 
Seat 6: huffwag ($34.56 in chips) 
Seat 7: Venomous100% ($101.20 in chips) 
Seat 8: matiko09 ($102 in chips) 
Seat 9: pompaskillad ($49.42 in chips) 
matiko09: posts small blind $0.50
pompaskillad: posts big blind $1
*** HOLE CARDS ***
Dealt to matiko09 [9c 7h]
AlKatrone: raises $2 to $3
maxxmeister: folds 
WDW3: folds 
Priidix: folds 
huffwag: calls $3
Venomous100%: raises $11 to $14
matiko09: folds 
pompaskillad: folds 
AlKatrone: calls $11
huffwag: folds 
*** FLOP *** [Jd 9h 5s]
AlKatrone: checks 
Venomous100%: checks 
*** TURN *** [Jd 9h 5s] [Jh]
AlKatrone: bets $21
Venomous100%: calls $21
*** RIVER *** [Jd 9h 5s Jh] [2h]
AlKatrone: bets $72.53 and is all-in
Venomous100%: calls $66.20 and is all-in
Uncalled bet ($6.33) returned to AlKatrone
*** SHOW DOWN ***
AlKatrone: shows [9d 9s] (a full house, Nines full of Jacks)
Venomous100%: mucks hand 
AlKatrone collected $204.10 from pot
*** SUMMARY ***
Total pot $206.90 | Rake $2.80 
Board [Jd 9h 5s Jh 2h]
Seat 1: AlKatrone showed [9d 9s] and won ($204.10) with a full house, Nines full of Jacks
Seat 3: maxxmeister folded before Flop (didn't bet)
Seat 4: WDW3 folded before Flop (didn't bet)
Seat 5: Priidix folded before Flop (didn't bet)
Seat 6: huffwag folded before Flop
Seat 7: Venomous100% (button) mucked [Kh Ks]
Seat 8: matiko09 (small blind) folded before Flop
Seat 9: pompaskillad (big blind) folded before Flop





PokerStars Hand #148832292366:  Hold'em No Limit ($0.25/$0.50 USD) - 2016/02/15 10:35:01 CET [2016/02/15 4:35:01 ET]
Table 'Margot II' 9-max Seat #4 is the button
Seat 1: i L00K great ($53.93 in chips) 
Seat 2: matiko09 ($74.32 in chips) 
Seat 4: r4mz3s ($51.86 in chips) 
Seat 6: OskarR89 ($51.11 in chips) 
Seat 7: Vedpapa ($50 in chips) 
Seat 8: Aoki42 ($95.45 in chips) 
Seat 9: Haporuu ($24 in chips) 
OskarR89: posts small blind $0.25
Vedpapa: posts big blind $0.50
beluccix: sits out 
*** HOLE CARDS ***
Dealt to matiko09 [Ks Kc]
Aoki42: raises $1 to $1.50
Haporuu: calls $1.50
i L00K great: folds 
matiko09: raises $3 to $4.50
r4mz3s: folds 
OskarR89: folds 
Vedpapa: raises $7 to $11.50
Aoki42: folds 
Haporuu: folds 
matiko09: raises $62.82 to $74.32 and is all-in
Vedpapa: calls $38.50 and is all-in
Uncalled bet ($24.32) returned to matiko09
*** FLOP *** [3c Qh Qc]
*** TURN *** [3c Qh Qc] [Tc]
*** RIVER *** [3c Qh Qc Tc] [3d]
*** SHOW DOWN ***
Vedpapa: shows [Ac Ah] (two pair, Aces and Queens)
matiko09: mucks hand 
Vedpapa collected $100.75 from pot
*** SUMMARY ***
Total pot $103.25 | Rake $2.50 
Board [3c Qh Qc Tc 3d]
Seat 1: i L00K great folded before Flop (didn't bet)
Seat 2: matiko09 mucked [Ks Kc]
Seat 4: r4mz3s (button) folded before Flop (didn't bet)
Seat 6: OskarR89 (small blind) folded before Flop
Seat 7: Vedpapa (big blind) showed [Ac Ah] and won ($100.75) with two pair, Aces and Queens
Seat 8: Aoki42 folded before Flop
Seat 9: Haporuu folded before Flop





PokerStars Hand #148832293957:  Hold'em No Limit ($0.50/$1.00 USD) - 2016/02/15 10:35:05 CET [2016/02/15 4:35:05 ET]
Table 'Corvus III' 9-max Seat #6 is the button
Seat 5: koib88 ($31.44 in chips) 
Seat 6: WDW3 ($165.60 in chips) 
Seat 7: matiko09 ($100 in chips) 
matiko09: posts small blind $0.50
maxxmeister: is sitting out 
koib88: posts big blind $1
koib88: posts the ante $0.20
WDW3: posts the ante $0.20
matiko09: posts the ante $0.20
*** HOLE CARDS ***
Dealt to matiko09 [2h Ac]
WDW3: folds 
maxxmeister leaves the table
matiko09: folds 
Uncalled bet ($0.50) returned to koib88
koib88 collected $1.60 from pot
koib88: doesn't show hand 
*** SUMMARY ***
Total pot $1.60 | Rake $0 
Seat 5: koib88 (big blind) collected ($1.60)
Seat 6: WDW3 (button) folded before Flop (didn't bet)
Seat 7: matiko09 (small blind) folded before Flop





PokerStars Hand #148832296624:  Hold'em No Limit ($0.50/$1.00 USD) - 2016/02/15 10:35:12 CET [2016/02/15 4:35:12 ET]
Table 'Urania' 9-max Seat #2 is the button
Seat 1: matiko09 ($100 in chips) 
Seat 2: maxxmeister ($136.42 in chips) 
Seat 3: Priidix ($131.98 in chips) 
Seat 4: nickreason17 ($100.37 in chips) 
Seat 5: maxonplay ($177.58 in chips) 
Seat 6: vrnMike ($171.61 in chips) 
Seat 7: darren1031 ($178.24 in chips) 
Seat 8: Venomous100% ($115.71 in chips) 
Seat 9: lixiangli ($94.90 in chips) 
Priidix: posts small blind $0.50
nickreason17: posts big blind $1
*** HOLE CARDS ***
Dealt to matiko09 [7s 9s]
maxonplay: folds 
vrnMike: raises $2 to $3
darren1031: folds 
Venomous100%: folds 
lixiangli: folds 
matiko09: folds 
maxxmeister: folds 
Priidix: folds 
nickreason17: folds 
Uncalled bet ($2) returned to vrnMike
vrnMike collected $2.50 from pot
*** SUMMARY ***
Total pot $2.50 | Rake $0 
Seat 1: matiko09 folded before Flop (didn't bet)
Seat 2: maxxmeister (button) folded before Flop (didn't bet)
Seat 3: Priidix (small blind) folded before Flop
Seat 4: nickreason17 (big blind) folded before Flop
Seat 5: maxonplay folded before Flop (didn't bet)
Seat 6: vrnMike collected ($2.50)
Seat 7: darren1031 folded before Flop (didn't bet)
Seat 8: Venomous100% folded before Flop (didn't bet)
Seat 9: lixiangli folded before Flop (didn't bet)





PokerStars Hand #148832299082:  Hold'em No Limit ($0.50/$1.00 USD) - 2016/02/15 10:35:18 CET [2016/02/15 4:35:18 ET]
Table 'Gemma II' 9-max Seat #2 is the button
Seat 1: Igor DoUrden ($175.28 in chips) 
Seat 2: WDW3 ($129.43 in chips) 
Seat 3: Venomous100% ($141.94 in chips) 
Seat 4: mycka86 ($100 in chips) 
Seat 5: PokerSash201 ($60.57 in chips) 
Seat 6: fanmtZ ($52.83 in chips) 
Seat 7: AlKatrone ($114.67 in chips) 
Seat 8: vrnMike ($139.14 in chips) 
Seat 9: matiko09 ($111.17 in chips) 
Venomous100%: posts small blind $0.50
mycka86: posts big blind $1
*** HOLE CARDS ***
Dealt to matiko09 [Js 7d]
PokerSash201: folds 
fanmtZ: folds 
AlKatrone: folds 
vrnMike: raises $2 to $3
matiko09: folds 
Igor DoUrden: folds 
WDW3: folds 
Venomous100%: folds 
mycka86: folds 
Uncalled bet ($2) returned to vrnMike
vrnMike collected $2.50 from pot
*** SUMMARY ***
Total pot $2.50 | Rake $0 
Seat 1: Igor DoUrden folded before Flop (didn't bet)
Seat 2: WDW3 (button) folded before Flop (didn't bet)
Seat 3: Venomous100% (small blind) folded before Flop
Seat 4: mycka86 (big blind) folded before Flop
Seat 5: PokerSash201 folded before Flop (didn't bet)
Seat 6: fanmtZ folded before Flop (didn't bet)
Seat 7: AlKatrone folded before Flop (didn't bet)
Seat 8: vrnMike collected ($2.50)
Seat 9: matiko09 folded before Flop (didn't bet)





PokerStars Hand #148832302036:  Hold'em No Limit ($0.50/$1.00 USD) - 2016/02/15 10:35:25 CET [2016/02/15 4:35:25 ET]
Table 'Corvus III' 9-max Seat #7 is the button
Seat 5: koib88 ($32.34 in chips) 
Seat 6: WDW3 ($165.40 in chips) 
Seat 7: matiko09 ($100 in chips) 
koib88: posts small blind $0.50
WDW3: posts big blind $1
koib88: posts the ante $0.20
WDW3: posts the ante $0.20
matiko09: posts the ante $0.20
*** HOLE CARDS ***
Dealt to matiko09 [Ad Kc]
matiko09: raises $1.50 to $2.50
koib88: folds 
WDW3: raises $6 to $8.50
matiko09: raises $10 to $18.50
WDW3: raises $146.70 to $165.20 and is all-in
matiko09: calls $81.30 and is all-in
Uncalled bet ($65.40) returned to WDW3
*** FLOP *** [Qd 9h 4h]
*** TURN *** [Qd 9h 4h] [Jc]
*** RIVER *** [Qd 9h 4h Jc] [Kd]
*** SHOW DOWN ***
WDW3: shows [Kh Ks] (three of a kind, Kings)
matiko09: mucks hand 
WDW3 collected $199.20 from pot
*** SUMMARY ***
Total pot $200.70 | Rake $1.50 
Board [Qd 9h 4h Jc Kd]
Seat 5: koib88 (small blind) folded before Flop
Seat 6: WDW3 (big blind) showed [Kh Ks] and won ($199.20) with three of a kind, Kings
Seat 7: matiko09 (button) mucked [Ad Kc]





PokerStars Hand #148832302732:  Hold'em No Limit ($0.50/$1.00 USD) - 2016/02/15 10:35:27 CET [2016/02/15 4:35:27 ET]
Table 'Vibeke' 9-max Seat #6 is the button
Seat 1: Venomous100% ($198.91 in chips) 
Seat 2: Priidix ($142.41 in chips) 
Seat 3: matiko09 ($112.08 in chips) 
Seat 4: fanmtZ ($40 in chips) 
Seat 5: vrnMike ($213.89 in chips) 
Seat 6: AlKatrone ($100 in chips) 
Seat 9: Sashey2708 ($96.04 in chips) 
ackle1 will be allowed to play after the button
IHouseMusic will be allowed to play after the button
Sashey2708: posts small blind $0.50
Venomous100%: posts big blind $1
*** HOLE CARDS ***
Dealt to matiko09 [Ad 9c]
Priidix: folds 
matiko09: folds 
fanmtZ: folds 
vrnMike: folds 
AlKatrone: raises $1 to $2
Sashey2708: folds 
Venomous100%: folds 
Uncalled bet ($1) returned to AlKatrone
Sashey2708 leaves the table
AlKatrone collected $2.50 from pot
AlKatrone: doesn't show hand 
*** SUMMARY ***
Total pot $2.50 | Rake $0 
Seat 1: Venomous100% (big blind) folded before Flop
Seat 2: Priidix folded before Flop (didn't bet)
Seat 3: matiko09 folded before Flop (didn't bet)
Seat 4: fanmtZ folded before Flop (didn't bet)
Seat 5: vrnMike folded before Flop (didn't bet)
Seat 6: AlKatrone (button) collected ($2.50)
Seat 9: Sashey2708 (small blind) folded before Flop





PokerStars Hand #148832302668:  Hold'em No Limit ($0.25/$0.50 USD) - 2016/02/15 10:35:27 CET [2016/02/15 4:35:27 ET]
Table 'Juliet' 9-max Seat #5 is the button
Seat 1: i L00K great ($97.60 in chips) 
Seat 2: Nabulasun ($20 in chips) 
Seat 3: arctur17 ($62.01 in chips) 
Seat 4: pandalapa ($55.20 in chips) 
Seat 5: dndngod ($50 in chips) 
Seat 6: r4mz3s ($57.52 in chips) 
Seat 7: goldpiggy ($36.40 in chips) 
Seat 8: matiko09 ($50 in chips) 
r4mz3s: posts small blind $0.25
goldpiggy: posts big blind $0.50
*** HOLE CARDS ***
Dealt to matiko09 [Qh 6c]
matiko09: folds 
i L00K great: folds 
Nabulasun: folds 
arctur17: folds 
pandalapa: folds 
dndngod: folds 
r4mz3s: raises $0.75 to $1.25
goldpiggy: folds 
Uncalled bet ($0.75) returned to r4mz3s
r4mz3s collected $1 from pot
r4mz3s: doesn't show hand 
*** SUMMARY ***
Total pot $1 | Rake $0 
Seat 1: i L00K great folded before Flop (didn't bet)
Seat 2: Nabulasun folded before Flop (didn't bet)
Seat 3: arctur17 folded before Flop (didn't bet)
Seat 4: pandalapa folded before Flop (didn't bet)
Seat 5: dndngod (button) folded before Flop (didn't bet)
Seat 6: r4mz3s (small blind) collected ($1)
Seat 7: goldpiggy (big blind) folded before Flop
Seat 8: matiko09 folded before Flop (didn't bet)





PokerStars Hand #148832305413:  Hold'em No Limit ($0.50/$1.00 USD) - 2016/02/15 10:35:33 CET [2016/02/15 4:35:33 ET]
Table 'Anteros' 9-max Seat #1 is the button
Seat 1: OskarR89 ($102 in chips) 
Seat 2: IHouseMusic ($104.82 in chips) 
Seat 7: Zoubou1983 ($97.14 in chips) 
Seat 8: matiko09 ($110.50 in chips) 
Seat 9: WDW3 ($100.30 in chips) 
IHouseMusic: posts small blind $0.50
Zoubou1983: posts big blind $1
*** HOLE CARDS ***
Dealt to matiko09 [5h Ah]
matiko09: raises $2 to $3
WDW3: folds 
nickreason17 joins the table at seat #3 
OskarR89: folds 
IHouseMusic: folds 
Zoubou1983: folds 
Uncalled bet ($2) returned to matiko09
matiko09 collected $2.50 from pot
matiko09: doesn't show hand 
*** SUMMARY ***
Total pot $2.50 | Rake $0 
Seat 1: OskarR89 (button) folded before Flop (didn't bet)
Seat 2: IHouseMusic (small blind) folded before Flop
Seat 7: Zoubou1983 (big blind) folded before Flop
Seat 8: matiko09 collected ($2.50)
Seat 9: WDW3 folded before Flop (didn't bet)





PokerStars Hand #148832305973:  Hold'em No Limit ($0.25/$0.50 USD) - 2016/02/15 10:35:35 CET [2016/02/15 4:35:35 ET]
Table 'Laertes II' 9-max Seat #9 is the button
Seat 1: dade33 ($61.05 in chips) 
Seat 2: beluccix ($24.21 in chips) 
Seat 3: ljryviltj ($56.16 in chips) 
Seat 4: rgar93 ($36.18 in chips) 
Seat 5: vlad11122007 ($48 in chips) 
Seat 6: moshiko29 ($35.24 in chips) 
Seat 7: OskarR89 ($68.52 in chips) 
Seat 8: Trent444 ($46.23 in chips) 
Seat 9: matiko09 ($50 in chips) 
dade33: posts small blind $0.25
beluccix: posts big blind $0.50
*** HOLE CARDS ***
Dealt to matiko09 [2s Jh]
ljryviltj: folds 
rgar93: raises $0.50 to $1
vlad11122007: folds 
moshiko29: folds 
OskarR89: folds 
Trent444: calls $1
matiko09: folds 
dade33: calls $0.75
beluccix: calls $0.50
*** FLOP *** [Ac Js 9c]
dade33: checks 
beluccix: checks 
rgar93: checks 
Trent444: bets $2.50
dade33: folds 
beluccix: folds 
rgar93: raises $9 to $11.50
Trent444: folds [Ah]
Uncalled bet ($9) returned to rgar93
rgar93 collected $8.60 from pot
rgar93: doesn't show hand 
*** SUMMARY ***
Total pot $9 | Rake $0.40 
Board [Ac Js 9c]
Seat 1: dade33 (small blind) folded on the Flop
Seat 2: beluccix (big blind) folded on the Flop
Seat 3: ljryviltj folded before Flop (didn't bet)
Seat 4: rgar93 collected ($8.60)
Seat 5: vlad11122007 folded before Flop (didn't bet)
Seat 6: moshiko29 folded before Flop (didn't bet)
Seat 7: OskarR89 folded before Flop (didn't bet)
Seat 8: Trent444 folded on the Flop
Seat 9: matiko09 (button) folded before Flop (didn't bet)





PokerStars Hand #148832307771:  Hold'em No Limit ($0.50/$1.00 USD) - 2016/02/15 10:35:39 CET [2016/02/15 4:35:39 ET]
Table 'Praecipua' 9-max Seat #5 is the button
Seat 1: matiko09 ($125.57 in chips) 
Seat 2: vrnMike ($115.17 in chips) 
Seat 3: Venomous100% ($107.50 in chips) 
Seat 4: Priidix ($122.28 in chips) 
Seat 5: huffwag ($48.90 in chips) 
Seat 7: maxxmeister ($180.27 in chips) 
Seat 8: Kalesmash08 ($71.59 in chips) 
Seat 9: AlKatrone ($106.52 in chips) 
mycka86 will be allowed to play after the button
maxxmeister: posts small blind $0.50
Kalesmash08: posts big blind $1
*** HOLE CARDS ***
Dealt to matiko09 [4h Kh]
AlKatrone: folds 
matiko09: folds 
vrnMike: folds 
Venomous100%: folds 
Priidix: raises $1.60 to $2.60
huffwag: folds 
maxxmeister: folds 
Kalesmash08: folds 
Uncalled bet ($1.60) returned to Priidix
Priidix collected $2.50 from pot
Priidix: doesn't show hand 
*** SUMMARY ***
Total pot $2.50 | Rake $0 
Seat 1: matiko09 folded before Flop (didn't bet)
Seat 2: vrnMike folded before Flop (didn't bet)
Seat 3: Venomous100% folded before Flop (didn't bet)
Seat 4: Priidix collected ($2.50)
Seat 5: huffwag (button) folded before Flop (didn't bet)
Seat 7: maxxmeister (small blind) folded before Flop
Seat 8: Kalesmash08 (big blind) folded before Flop
Seat 9: AlKatrone folded before Flop (didn't bet)





PokerStars Hand #148832310842:  Hold'em No Limit ($0.50/$1.00 USD) - 2016/02/15 10:35:47 CET [2016/02/15 4:35:47 ET]
Table 'Urania' 9-max Seat #3 is the button
Seat 1: matiko09 ($100 in chips) 
Seat 2: maxxmeister ($136.42 in chips) 
Seat 3: Priidix ($131.48 in chips) 
Seat 4: nickreason17 ($100 in chips) 
Seat 5: maxonplay ($177.58 in chips) 
Seat 6: vrnMike ($173.11 in chips) 
Seat 7: darren1031 ($178.24 in chips) 
Seat 8: Venomous100% ($115.71 in chips) 
Seat 9: lixiangli ($94.90 in chips) 
nickreason17: posts small blind $0.50
maxonplay: posts big blind $1
*** HOLE CARDS ***
Dealt to matiko09 [6h Ac]
vrnMike: folds 
darren1031: folds 
Venomous100%: folds 
lixiangli: folds 
matiko09: folds 
maxxmeister: raises $2 to $3
Priidix: folds 
nickreason17: folds 
maxonplay: folds 
Uncalled bet ($2) returned to maxxmeister
maxxmeister collected $2.50 from pot
maxxmeister: doesn't show hand 
*** SUMMARY ***
Total pot $2.50 | Rake $0 
Seat 1: matiko09 folded before Flop (didn't bet)
Seat 2: maxxmeister collected ($2.50)
Seat 3: Priidix (button) folded before Flop (didn't bet)
Seat 4: nickreason17 (small blind) folded before Flop
Seat 5: maxonplay (big blind) folded before Flop
Seat 6: vrnMike folded before Flop (didn't bet)
Seat 7: darren1031 folded before Flop (didn't bet)
Seat 8: Venomous100% folded before Flop (didn't bet)
Seat 9: lixiangli folded before Flop (didn't bet)





PokerStars Hand #148832312852:  Hold'em No Limit ($0.50/$1.00 USD) - 2016/02/15 10:35:51 CET [2016/02/15 4:35:51 ET]
Table 'Vibeke' 9-max Seat #1 is the button
Seat 1: Venomous100% ($197.91 in chips) 
Seat 2: Priidix ($142.41 in chips) 
Seat 3: matiko09 ($112.08 in chips) 
Seat 4: fanmtZ ($40 in chips) 
Seat 5: vrnMike ($213.89 in chips) 
Seat 6: AlKatrone ($101.50 in chips) 
Priidix: posts small blind $0.50
matiko09: posts big blind $1
ackle1: sits out 
IHouseMusic: sits out 
*** HOLE CARDS ***
Dealt to matiko09 [9c 7c]
WDW3 joins the table at seat #9 
fanmtZ: folds 
vrnMike: folds 
AlKatrone: folds 
Venomous100%: raises $1 to $2
Priidix: folds 
matiko09: calls $1
*** FLOP *** [Jc 7d Ac]
matiko09: checks 
Venomous100%: checks 
*** TURN *** [Jc 7d Ac] [4d]
matiko09: bets $3
Venomous100%: folds 
Uncalled bet ($3) returned to matiko09
matiko09 collected $4.30 from pot
matiko09: doesn't show hand 
*** SUMMARY ***
Total pot $4.50 | Rake $0.20 
Board [Jc 7d Ac 4d]
Seat 1: Venomous100% (button) folded on the Turn
Seat 2: Priidix (small blind) folded before Flop
Seat 3: matiko09 (big blind) collected ($4.30)
Seat 4: fanmtZ folded before Flop (didn't bet)
Seat 5: vrnMike folded before Flop (didn't bet)
Seat 6: AlKatrone folded before Flop (didn't bet)





PokerStars Hand #148832315350:  Hold'em No Limit ($0.50/$1.00 USD) - 2016/02/15 10:35:58 CET [2016/02/15 4:35:58 ET]
Table 'Anteros' 9-max Seat #2 is the button
Seat 1: OskarR89 ($102 in chips) 
Seat 2: IHouseMusic ($104.32 in chips) 
Seat 7: Zoubou1983 ($96.14 in chips) 
Seat 8: matiko09 ($112 in chips) 
Seat 9: WDW3 ($100.30 in chips) 
nickreason17 will be allowed to play after the button
Zoubou1983: posts small blind $0.50
matiko09: posts big blind $1
*** HOLE CARDS ***
Dealt to matiko09 [3s 9h]
WDW3: folds 
OskarR89: folds 
IHouseMusic: raises $1 to $2
Zoubou1983: folds 
matiko09: folds 
Uncalled bet ($1) returned to IHouseMusic
IHouseMusic collected $2.50 from pot
IHouseMusic: doesn't show hand 
*** SUMMARY ***
Total pot $2.50 | Rake $0 
Seat 1: OskarR89 folded before Flop (didn't bet)
Seat 2: IHouseMusic (button) collected ($2.50)
Seat 7: Zoubou1983 (small blind) folded before Flop
Seat 8: matiko09 (big blind) folded before Flop
Seat 9: WDW3 folded before Flop (didn't bet)





PokerStars Hand #148832318040:  Hold'em No Limit ($0.50/$1.00 USD) - 2016/02/15 10:36:04 CET [2016/02/15 4:36:04 ET]
Table 'Gemma II' 9-max Seat #3 is the button
Seat 1: Igor DoUrden ($175.28 in chips) 
Seat 2: WDW3 ($129.43 in chips) 
Seat 3: Venomous100% ($141.44 in chips) 
Seat 4: mycka86 ($100 in chips) 
Seat 5: PokerSash201 ($60.57 in chips) 
Seat 6: fanmtZ ($52.83 in chips) 
Seat 7: AlKatrone ($114.67 in chips) 
Seat 8: vrnMike ($140.64 in chips) 
Seat 9: matiko09 ($111.17 in chips) 
mycka86: posts small blind $0.50
PokerSash201: posts big blind $1
*** HOLE CARDS ***
Dealt to matiko09 [7h 2s]
fanmtZ: folds 
AlKatrone: folds 
vrnMike: folds 
matiko09: folds 
Igor DoUrden: folds 
WDW3: folds 
Venomous100%: raises $1 to $2
mycka86: folds 
PokerSash201: calls $1
*** FLOP *** [Jc 3h 2c]
PokerSash201: checks 
Venomous100%: bets $2.84
PokerSash201: folds 
Uncalled bet ($2.84) returned to Venomous100%
Venomous100% collected $4.30 from pot
Venomous100%: doesn't show hand 
*** SUMMARY ***
Total pot $4.50 | Rake $0.20 
Board [Jc 3h 2c]
Seat 1: Igor DoUrden folded before Flop (didn't bet)
Seat 2: WDW3 folded before Flop (didn't bet)
Seat 3: Venomous100% (button) collected ($4.30)
Seat 4: mycka86 (small blind) folded before Flop
Seat 5: PokerSash201 (big blind) folded on the Flop
Seat 6: fanmtZ folded before Flop (didn't bet)
Seat 7: AlKatrone folded before Flop (didn't bet)
Seat 8: vrnMike folded before Flop (didn't bet)
Seat 9: matiko09 folded before Flop (didn't bet)





PokerStars Hand #148832318455:  Hold'em No Limit ($0.25/$0.50 USD) - 2016/02/15 10:36:05 CET [2016/02/15 4:36:05 ET]
Table 'Juliet' 9-max Seat #6 is the button
Seat 1: i L00K great ($97.60 in chips) 
Seat 2: Nabulasun ($20 in chips) 
Seat 3: arctur17 ($62.01 in chips) 
Seat 4: pandalapa ($55.20 in chips) 
Seat 5: dndngod ($50 in chips) 
Seat 6: r4mz3s ($58.02 in chips) 
Seat 7: goldpiggy ($35.90 in chips) 
Seat 8: matiko09 ($50 in chips) 
goldpiggy: posts small blind $0.25
matiko09: posts big blind $0.50
*** HOLE CARDS ***
Dealt to matiko09 [6s 5d]
i L00K great: folds 
Nabulasun: folds 
arctur17: folds 
pandalapa: raises $1 to $1.50
dndngod: folds 
r4mz3s: folds 
goldpiggy: folds 
matiko09: folds 
Uncalled bet ($1) returned to pandalapa
pandalapa collected $1.25 from pot
pandalapa: doesn't show hand 
*** SUMMARY ***
Total pot $1.25 | Rake $0 
Seat 1: i L00K great folded before Flop (didn't bet)
Seat 2: Nabulasun folded before Flop (didn't bet)
Seat 3: arctur17 folded before Flop (didn't bet)
Seat 4: pandalapa collected ($1.25)
Seat 5: dndngod folded before Flop (didn't bet)
Seat 6: r4mz3s (button) folded before Flop (didn't bet)
Seat 7: goldpiggy (small blind) folded before Flop
Seat 8: matiko09 (big blind) folded before Flop





PokerStars Hand #148832320587:  Hold'em No Limit (€0.25/€0.50 EUR) - 2016/02/15 10:36:10 CET [2016/02/15 4:36:10 ET]
Table 'Walinskia II' 9-max Seat #1 is the button
Seat 1: ljryviltj (€52.50 in chips) 
Seat 4: Otsime (€41.58 in chips) 
Seat 5: vano7777 (€50 in chips) 
Seat 6: 50CandyJoe (€50.75 in chips) 
Seat 8: matiko09 (€50 in chips) 
Seat 9: stevevg84 (€33.37 in chips) 
yats87 will be allowed to play after the button
beluccix will be allowed to play after the button
Otsime: posts small blind €0.25
vano7777: posts big blind €0.50
stevevg84: posts big blind €0.50
*** HOLE CARDS ***
Dealt to matiko09 [Kc 4s]
50CandyJoe: folds 
matiko09: folds 
stevevg84: checks 
ljryviltj: raises €2 to €2.50
Otsime: folds 
vano7777: raises €5.50 to €8
stevevg84: folds 
ljryviltj: folds 
Uncalled bet (€5.50) returned to vano7777
vano7777 collected €5.75 from pot
*** SUMMARY ***
Total pot €5.75 | Rake €0 
Seat 1: ljryviltj (button) folded before Flop
Seat 4: Otsime (small blind) folded before Flop
Seat 5: vano7777 (big blind) collected (€5.75)
Seat 6: 50CandyJoe folded before Flop (didn't bet)
Seat 8: matiko09 folded before Flop (didn't bet)
Seat 9: stevevg84 folded before Flop





PokerStars Hand #148832324646:  Hold'em No Limit ($0.50/$1.00 USD) - 2016/02/15 10:36:20 CET [2016/02/15 4:36:20 ET]
Table 'Anteros' 9-max Seat #7 is the button
Seat 1: OskarR89 ($102 in chips) 
Seat 2: IHouseMusic ($105.82 in chips) 
Seat 7: Zoubou1983 ($95.64 in chips) 
Seat 8: matiko09 ($111 in chips) 
Seat 9: WDW3 ($100.30 in chips) 
matiko09: posts small blind $0.50
WDW3: posts big blind $1
nickreason17: sits out 
*** HOLE CARDS ***
Dealt to matiko09 [Ac 7d]
OskarR89: folds 
IHouseMusic: folds 
Zoubou1983: folds 
matiko09: raises $1.50 to $2.50
WDW3: folds 
Uncalled bet ($1.50) returned to matiko09
matiko09 collected $2 from pot
matiko09: doesn't show hand 
*** SUMMARY ***
Total pot $2 | Rake $0 
Seat 1: OskarR89 folded before Flop (didn't bet)
Seat 2: IHouseMusic folded before Flop (didn't bet)
Seat 7: Zoubou1983 (button) folded before Flop (didn't bet)
Seat 8: matiko09 (small blind) collected ($2)
Seat 9: WDW3 (big blind) folded before Flop





PokerStars Hand #148832325667:  Hold'em No Limit ($0.25/$0.50 USD) - 2016/02/15 10:36:23 CET [2016/02/15 4:36:23 ET]
Table 'Margot II' 9-max Seat #6 is the button
Seat 1: i L00K great ($53.93 in chips) 
Seat 2: matiko09 ($50 in chips) 
Seat 4: r4mz3s ($51.86 in chips) 
Seat 6: OskarR89 ($50.86 in chips) 
Seat 7: Vedpapa ($100.75 in chips) 
Seat 8: Aoki42 ($93.95 in chips) 
Seat 9: Haporuu ($22.50 in chips) 
Vedpapa: posts small blind $0.25
Aoki42: posts big blind $0.50
beluccix: sits out 
*** HOLE CARDS ***
Dealt to matiko09 [9h 3h]
Haporuu: folds 
i L00K great: folds 
matiko09: folds 
r4mz3s: folds 
OskarR89: raises $0.50 to $1
Vedpapa: calls $0.75
Aoki42: folds 
*** FLOP *** [2d Ad 4d]
Vedpapa: checks 
OskarR89: checks 
*** TURN *** [2d Ad 4d] [5d]
Vedpapa: checks 
OskarR89: checks 
*** RIVER *** [2d Ad 4d 5d] [5s]
Vedpapa: bets $1.19
OskarR89: folds 
Uncalled bet ($1.19) returned to Vedpapa
Vedpapa collected $2.39 from pot
Vedpapa: doesn't show hand 
*** SUMMARY ***
Total pot $2.50 | Rake $0.11 
Board [2d Ad 4d 5d 5s]
Seat 1: i L00K great folded before Flop (didn't bet)
Seat 2: matiko09 folded before Flop (didn't bet)
Seat 4: r4mz3s folded before Flop (didn't bet)
Seat 6: OskarR89 (button) folded on the River
Seat 7: Vedpapa (small blind) collected ($2.39)
Seat 8: Aoki42 (big blind) folded before Flop
Seat 9: Haporuu folded before Flop (didn't bet)





PokerStars Hand #148832325935:  Hold'em No Limit ($0.50/$1.00 USD) - 2016/02/15 10:36:24 CET [2016/02/15 4:36:24 ET]
Table 'Praecipua' 9-max Seat #7 is the button
Seat 1: matiko09 ($125.57 in chips) 
Seat 2: vrnMike ($115.17 in chips) 
Seat 3: Venomous100% ($107.50 in chips) 
Seat 4: Priidix ($123.78 in chips) 
Seat 5: huffwag ($48.90 in chips) 
Seat 7: maxxmeister ($179.77 in chips) 
Seat 8: Kalesmash08 ($70.59 in chips) 
Seat 9: AlKatrone ($106.52 in chips) 
Kalesmash08: posts small blind $0.50
AlKatrone: posts big blind $1
mycka86: sits out 
*** HOLE CARDS ***
Dealt to matiko09 [9s 5c]
matiko09: folds 
vrnMike: folds 
Venomous100%: folds 
Priidix: folds 
huffwag: raises $2 to $3
maxxmeister: folds 
Kalesmash08: calls $2.50
AlKatrone: folds 
*** FLOP *** [7d 2c Jd]
Kalesmash08: checks 
huffwag: checks 
*** TURN *** [7d 2c Jd] [Ad]
Kalesmash08: checks 
huffwag: bets $3.34
Kalesmash08: calls $3.34
*** RIVER *** [7d 2c Jd Ad] [5d]
Kalesmash08: checks 
huffwag: checks 
*** SHOW DOWN ***
Kalesmash08: shows [9d Kd] (a flush, Ace high)
huffwag: mucks hand 
Kalesmash08 collected $13.06 from pot
*** SUMMARY ***
Total pot $13.68 | Rake $0.62 
Board [7d 2c Jd Ad 5d]
Seat 1: matiko09 folded before Flop (didn't bet)
Seat 2: vrnMike folded before Flop (didn't bet)
Seat 3: Venomous100% folded before Flop (didn't bet)
Seat 4: Priidix folded before Flop (didn't bet)
Seat 5: huffwag mucked [Kh Ts]
Seat 7: maxxmeister (button) folded before Flop (didn't bet)
Seat 8: Kalesmash08 (small blind) showed [9d Kd] and won ($13.06) with a flush, Ace high
Seat 9: AlKatrone (big blind) folded before Flop





PokerStars Hand #148832327124:  Hold'em No Limit ($0.25/$0.50 USD) - 2016/02/15 10:36:27 CET [2016/02/15 4:36:27 ET]
Table 'Juliet' 9-max Seat #7 is the button
Seat 1: i L00K great ($97.60 in chips) 
Seat 2: Nabulasun ($20 in chips) 
Seat 3: arctur17 ($62.01 in chips) 
Seat 4: pandalapa ($55.95 in chips) 
Seat 5: dndngod ($50 in chips) 
Seat 6: r4mz3s ($58.02 in chips) 
Seat 7: goldpiggy ($35.65 in chips) 
Seat 8: matiko09 ($50 in chips) 
matiko09: posts small blind $0.25
i L00K great: posts big blind $0.50
*** HOLE CARDS ***
Dealt to matiko09 [7d 4s]
Nabulasun: folds 
arctur17: folds 
pandalapa: folds 
dndngod: folds 
r4mz3s: folds 
goldpiggy: folds 
matiko09: folds 
Uncalled bet ($0.25) returned to i L00K great
i L00K great collected $0.50 from pot
i L00K great: doesn't show hand 
*** SUMMARY ***
Total pot $0.50 | Rake $0 
Seat 1: i L00K great (big blind) collected ($0.50)
Seat 2: Nabulasun folded before Flop (didn't bet)
Seat 3: arctur17 folded before Flop (didn't bet)
Seat 4: pandalapa folded before Flop (didn't bet)
Seat 5: dndngod folded before Flop (didn't bet)
Seat 6: r4mz3s folded before Flop (didn't bet)
Seat 7: goldpiggy (button) folded before Flop (didn't bet)
Seat 8: matiko09 (small blind) folded before Flop





PokerStars Hand #148832328403:  Hold'em No Limit ($0.50/$1.00 USD) - 2016/02/15 10:36:30 CET [2016/02/15 4:36:30 ET]
Table 'Urania' 9-max Seat #4 is the button
Seat 1: matiko09 ($100 in chips) 
Seat 2: maxxmeister ($137.92 in chips) 
Seat 3: Priidix ($131.48 in chips) 
Seat 4: nickreason17 ($100 in chips) 
Seat 5: maxonplay ($176.58 in chips) 
Seat 6: vrnMike ($173.11 in chips) 
Seat 7: darren1031 ($178.24 in chips) 
Seat 8: Venomous100% ($115.71 in chips) 
Seat 9: lixiangli ($94.90 in chips) 
maxonplay: posts small blind $0.50
vrnMike: posts big blind $1
*** HOLE CARDS ***
Dealt to matiko09 [2c 2h]
darren1031: calls $1
Venomous100% has timed out
Venomous100%: folds 
lixiangli: folds 
matiko09: raises $2 to $3
maxxmeister: folds 
Priidix: folds 
nickreason17: raises $7 to $10
maxonplay: folds 
vrnMike: folds 
darren1031: calls $9
matiko09: calls $7
*** FLOP *** [3c Tc Ac]
darren1031: checks 
matiko09: checks 
nickreason17: checks 
*** TURN *** [3c Tc Ac] [3d]
darren1031: checks 
matiko09: checks 
nickreason17: checks 
*** RIVER *** [3c Tc Ac 3d] [Kd]
darren1031: checks 
matiko09: checks 
nickreason17: checks 
*** SHOW DOWN ***
darren1031: shows [Qs Qh] (two pair, Queens and Threes)
matiko09: mucks hand 
nickreason17: shows [6h Ah] (two pair, Aces and Threes)
nickreason17 collected $30.08 from pot
*** SUMMARY ***
Total pot $31.50 | Rake $1.42 
Board [3c Tc Ac 3d Kd]
Seat 1: matiko09 mucked [2c 2h]
Seat 2: maxxmeister folded before Flop (didn't bet)
Seat 3: Priidix folded before Flop (didn't bet)
Seat 4: nickreason17 (button) showed [6h Ah] and won ($30.08) with two pair, Aces and Threes
Seat 5: maxonplay (small blind) folded before Flop
Seat 6: vrnMike (big blind) folded before Flop
Seat 7: darren1031 showed [Qs Qh] and lost with two pair, Queens and Threes
Seat 8: Venomous100% folded before Flop (didn't bet)
Seat 9: lixiangli folded before Flop (didn't bet)





PokerStars Hand #148832328406:  Hold'em No Limit ($0.50/$1.00 USD) - 2016/02/15 10:36:30 CET [2016/02/15 4:36:30 ET]
Table 'Corvus III' 9-max Seat #5 is the button
Seat 5: koib88 ($31.64 in chips) 
Seat 6: WDW3 ($264.60 in chips) 
Seat 7: matiko09 ($100 in chips) 
WDW3: posts small blind $0.50
matiko09: posts big blind $1
koib88: posts the ante $0.20
WDW3: posts the ante $0.20
matiko09: posts the ante $0.20
*** HOLE CARDS ***
Dealt to matiko09 [Js 8h]
koib88: folds 
WDW3: calls $0.50
matiko09: raises $3 to $4
WDW3: calls $3
*** FLOP *** [Kd 7s 4d]
WDW3: checks 
matiko09: bets $5
WDW3: folds 
Uncalled bet ($5) returned to matiko09
matiko09 collected $8.21 from pot
matiko09: doesn't show hand 
*** SUMMARY ***
Total pot $8.60 | Rake $0.39 
Board [Kd 7s 4d]
Seat 5: koib88 (button) folded before Flop (didn't bet)
Seat 6: WDW3 (small blind) folded on the Flop
Seat 7: matiko09 (big blind) collected ($8.21)





PokerStars Hand #148832329500:  Hold'em No Limit ($0.25/$0.50 USD) - 2016/02/15 10:36:32 CET [2016/02/15 4:36:32 ET]
Table 'Vesta II' 9-max Seat #9 is the button
Seat 1: Ahangama ($56.15 in chips) 
Seat 2: i L00K great ($51.50 in chips) 
Seat 3: matiko09 ($69.40 in chips) 
Seat 4: HJdream ($48.86 in chips) 
Seat 5: dndngod ($79.90 in chips) 
Seat 6: pandalapa ($64 in chips) 
Seat 7: OskarR89 ($93.94 in chips) 
Seat 8: Arystan ($58.42 in chips) 
Seat 9: Aoki42 ($69.37 in chips) 
Ahangama: posts small blind $0.25
i L00K great: posts big blind $0.50
*** HOLE CARDS ***
Dealt to matiko09 [6c Ts]
matiko09: folds 
HJdream: folds 
dndngod: folds 
pandalapa: folds 
OskarR89: folds 
Arystan: raises $0.50 to $1
Aoki42: folds 
Ahangama: folds 
i L00K great: calls $0.50
*** FLOP *** [9h 8d 4s]
i L00K great: checks 
Arystan: bets $1.07
i L00K great: calls $1.07
*** TURN *** [9h 8d 4s] [5h]
i L00K great: checks 
Arystan: checks 
*** RIVER *** [9h 8d 4s 5h] [6d]
i L00K great: bets $3.35
Arystan: folds 
Uncalled bet ($3.35) returned to i L00K great
i L00K great collected $4.19 from pot
i L00K great: doesn't show hand 
*** SUMMARY ***
Total pot $4.39 | Rake $0.20 
Board [9h 8d 4s 5h 6d]
Seat 1: Ahangama (small blind) folded before Flop
Seat 2: i L00K great (big blind) collected ($4.19)
Seat 3: matiko09 folded before Flop (didn't bet)
Seat 4: HJdream folded before Flop (didn't bet)
Seat 5: dndngod folded before Flop (didn't bet)
Seat 6: pandalapa folded before Flop (didn't bet)
Seat 7: OskarR89 folded before Flop (didn't bet)
Seat 8: Arystan folded on the River
Seat 9: Aoki42 (button) folded before Flop (didn't bet)





PokerStars Hand #148832331059:  Hold'em No Limit ($0.50/$1.00 USD) - 2016/02/15 10:36:36 CET [2016/02/15 4:36:36 ET]
Table 'Anteros' 9-max Seat #8 is the button
Seat 1: OskarR89 ($102 in chips) 
Seat 2: IHouseMusic ($105.82 in chips) 
Seat 7: Zoubou1983 ($95.64 in chips) 
Seat 8: matiko09 ($112 in chips) 
Seat 9: WDW3 ($100 in chips) 
WDW3: posts small blind $0.50
OskarR89: posts big blind $1
nickreason17: sits out 
*** HOLE CARDS ***
Dealt to matiko09 [Jd 4d]
IHouseMusic: folds 
Zoubou1983: folds 
matiko09: folds 
WDW3: folds 
Uncalled bet ($0.50) returned to OskarR89
OskarR89 collected $1 from pot
OskarR89: doesn't show hand 
*** SUMMARY ***
Total pot $1 | Rake $0 
Seat 1: OskarR89 (big blind) collected ($1)
Seat 2: IHouseMusic folded before Flop (didn't bet)
Seat 7: Zoubou1983 folded before Flop (didn't bet)
Seat 8: matiko09 (button) folded before Flop (didn't bet)
Seat 9: WDW3 (small blind) folded before Flop





PokerStars Hand #148832336586:  Hold'em No Limit (€0.25/€0.50 EUR) - 2016/02/15 10:36:50 CET [2016/02/15 4:36:50 ET]
Table 'Walinskia II' 9-max Seat #4 is the button
Seat 1: ljryviltj (€50 in chips) 
Seat 4: Otsime (€41.33 in chips) 
Seat 5: vano7777 (€53.25 in chips) 
Seat 6: 50CandyJoe (€50.75 in chips) 
Seat 8: matiko09 (€50 in chips) 
Seat 9: stevevg84 (€32.87 in chips) 
vano7777: posts small blind €0.25
50CandyJoe: posts big blind €0.50
yats87: sits out 
beluccix: sits out 
*** HOLE CARDS ***
Dealt to matiko09 [Qd 5h]
matiko09: folds 
stevevg84: folds 
ljryviltj: folds 
Otsime: calls €0.50
vano7777: calls €0.25
50CandyJoe: raises €2 to €2.50
Otsime: calls €2
vano7777: calls €2
*** FLOP *** [5s 2h 7d]
vano7777: checks 
50CandyJoe: checks 
Otsime: checks 
*** TURN *** [5s 2h 7d] [Kd]
vano7777: checks 
50CandyJoe: bets €4.50
Otsime: calls €4.50
vano7777: folds 
*** RIVER *** [5s 2h 7d Kd] [7c]
50CandyJoe: checks 
Otsime: bets €1
50CandyJoe: folds 
Uncalled bet (€1) returned to Otsime
Otsime collected €15.76 from pot
Otsime: doesn't show hand 
*** SUMMARY ***
Total pot €16.50 | Rake €0.74 
Board [5s 2h 7d Kd 7c]
Seat 1: ljryviltj folded before Flop (didn't bet)
Seat 4: Otsime (button) collected (€15.76)
Seat 5: vano7777 (small blind) folded on the Turn
Seat 6: 50CandyJoe (big blind) folded on the River
Seat 8: matiko09 folded before Flop (didn't bet)
Seat 9: stevevg84 folded before Flop (didn't bet)





PokerStars Hand #148832337005:  Hold'em No Limit ($0.25/$0.50 USD) - 2016/02/15 10:36:51 CET [2016/02/15 4:36:51 ET]
Table 'Juliet' 9-max Seat #8 is the button
Seat 1: i L00K great ($97.85 in chips) 
Seat 2: Nabulasun ($20 in chips) 
Seat 3: arctur17 ($62.01 in chips) 
Seat 4: pandalapa ($55.95 in chips) 
Seat 5: dndngod ($50 in chips) 
Seat 6: r4mz3s ($58.02 in chips) 
Seat 7: goldpiggy ($35.65 in chips) 
Seat 8: matiko09 ($50 in chips) 
carlosq1986 will be allowed to play after the button
i L00K great: posts small blind $0.25
Nabulasun: posts big blind $0.50
*** HOLE CARDS ***
Dealt to matiko09 [6c Jh]
arctur17: folds 
pandalapa: folds 
dndngod: raises $1 to $1.50
r4mz3s: folds 
goldpiggy: calls $1.50
matiko09: folds 
i L00K great: folds 
Nabulasun: folds 
*** FLOP *** [Ac 5s 8d]
dndngod: checks 
goldpiggy: checks 
*** TURN *** [Ac 5s 8d] [3h]
dndngod: checks 
goldpiggy: checks 
*** RIVER *** [Ac 5s 8d 3h] [5d]
dndngod: bets $1.79
goldpiggy: folds 
Uncalled bet ($1.79) returned to dndngod
dndngod collected $3.58 from pot
dndngod: doesn't show hand 
*** SUMMARY ***
Total pot $3.75 | Rake $0.17 
Board [Ac 5s 8d 3h 5d]
Seat 1: i L00K great (small blind) folded before Flop
Seat 2: Nabulasun (big blind) folded before Flop
Seat 3: arctur17 folded before Flop (didn't bet)
Seat 4: pandalapa folded before Flop (didn't bet)
Seat 5: dndngod collected ($3.58)
Seat 6: r4mz3s folded before Flop (didn't bet)
Seat 7: goldpiggy folded on the River
Seat 8: matiko09 (button) folded before Flop (didn't bet)





PokerStars Hand #148832337882:  Hold'em No Limit ($0.50/$1.00 USD) - 2016/02/15 10:36:53 CET [2016/02/15 4:36:53 ET]
Table 'Anteros' 9-max Seat #9 is the button
Seat 1: OskarR89 ($102.50 in chips) 
Seat 2: IHouseMusic ($105.82 in chips) 
Seat 7: Zoubou1983 ($95.64 in chips) 
Seat 8: matiko09 ($112 in chips) 
Seat 9: WDW3 ($100 in chips) 
OskarR89: posts small blind $0.50
IHouseMusic: posts big blind $1
nickreason17: sits out 
*** HOLE CARDS ***
Dealt to matiko09 [2s Td]
Zoubou1983: folds 
matiko09: folds 
WDW3: folds 
OskarR89: folds 
Uncalled bet ($0.50) returned to IHouseMusic
IHouseMusic collected $1 from pot
IHouseMusic: doesn't show hand 
*** SUMMARY ***
Total pot $1 | Rake $0 
Seat 1: OskarR89 (small blind) folded before Flop
Seat 2: IHouseMusic (big blind) collected ($1)
Seat 7: Zoubou1983 folded before Flop (didn't bet)
Seat 8: matiko09 folded before Flop (didn't bet)
Seat 9: WDW3 (button) folded before Flop (didn't bet)





PokerStars Hand #148832339345:  Hold'em No Limit ($0.50/$1.00 USD) - 2016/02/15 10:36:57 CET [2016/02/15 4:36:57 ET]
Table 'Corvus III' 9-max Seat #6 is the button
Seat 5: koib88 ($31.44 in chips) 
Seat 6: WDW3 ($260.40 in chips) 
Seat 7: matiko09 ($104.01 in chips) 
matiko09: posts small blind $0.50
koib88: posts big blind $1
koib88: posts the ante $0.20
WDW3: posts the ante $0.20
matiko09: posts the ante $0.20
*** HOLE CARDS ***
Dealt to matiko09 [8h 5s]
WDW3: raises $1.50 to $2.50
matiko09: folds 
koib88: calls $1.50
*** FLOP *** [Ac Qc Kd]
koib88: checks 
WDW3: bets $5
koib88: calls $5
*** TURN *** [Ac Qc Kd] [Qh]
koib88: checks 
WDW3: bets $7
koib88: calls $7
*** RIVER *** [Ac Qc Kd Qh] [Qs]
koib88: bets $9
WDW3: raises $9 to $18
koib88: calls $7.74 and is all-in
Uncalled bet ($1.26) returned to WDW3
*** SHOW DOWN ***
WDW3: shows [Kc Ad] (a full house, Queens full of Aces)
koib88: shows [Qd Ks] (four of a kind, Queens)
koib88 collected $62.08 from pot
*** SUMMARY ***
Total pot $63.58 | Rake $1.50 
Board [Ac Qc Kd Qh Qs]
Seat 5: koib88 (big blind) showed [Qd Ks] and won ($62.08) with four of a kind, Queens
Seat 6: WDW3 (button) showed [Kc Ad] and lost with a full house, Queens full of Aces
Seat 7: matiko09 (small blind) folded before Flop





PokerStars Hand #148832340922:  Hold'em No Limit ($0.50/$1.00 USD) - 2016/02/15 10:37:00 CET [2016/02/15 4:37:00 ET]
Table 'Saldanha' 9-max Seat #8 is the button
Seat 1: AlKatrone ($210.43 in chips) 
Seat 3: maxxmeister ($101 in chips) 
Seat 4: WDW3 ($100 in chips) 
Seat 5: Priidix ($137.02 in chips) 
Seat 6: huffwag ($31.56 in chips) 
Seat 7: Venomous100% ($100 in chips) 
Seat 8: matiko09 ($101.50 in chips) 
Seat 9: pompaskillad ($48.42 in chips) 
pompaskillad: posts small blind $0.50
AlKatrone: posts big blind $1
*** HOLE CARDS ***
Dealt to matiko09 [4h Ad]
maxxmeister: folds 
WDW3: folds 
Priidix: folds 
huffwag: raises $2 to $3
Venomous100%: raises $3 to $6
matiko09: folds 
pompaskillad: folds 
AlKatrone: folds 
huffwag: raises $9 to $15
Venomous100%: folds 
Uncalled bet ($9) returned to huffwag
huffwag collected $13.50 from pot
huffwag: doesn't show hand 
*** SUMMARY ***
Total pot $13.50 | Rake $0 
Seat 1: AlKatrone (big blind) folded before Flop
Seat 3: maxxmeister folded before Flop (didn't bet)
Seat 4: WDW3 folded before Flop (didn't bet)
Seat 5: Priidix folded before Flop (didn't bet)
Seat 6: huffwag collected ($13.50)
Seat 7: Venomous100% folded before Flop
Seat 8: matiko09 (button) folded before Flop (didn't bet)
Seat 9: pompaskillad (small blind) folded before Flop





PokerStars Hand #148832342134:  Hold'em No Limit ($0.50/$1.00 USD) - 2016/02/15 10:37:03 CET [2016/02/15 4:37:03 ET]
Table 'Vibeke' 9-max Seat #2 is the button
Seat 1: Venomous100% ($195.91 in chips) 
Seat 2: Priidix ($141.91 in chips) 
Seat 3: matiko09 ($114.38 in chips) 
Seat 4: fanmtZ ($40 in chips) 
Seat 5: vrnMike ($213.89 in chips) 
Seat 6: AlKatrone ($101.50 in chips) 
matiko09: posts small blind $0.50
fanmtZ: posts big blind $1
ackle1: sits out 
IHouseMusic: sits out 
WDW3: sits out 
*** HOLE CARDS ***
Dealt to matiko09 [2h 5h]
vrnMike: folds 
AlKatrone: folds 
Venomous100% has timed out
Venomous100%: folds 
Priidix: folds 
matiko09: folds 
Uncalled bet ($0.50) returned to fanmtZ
fanmtZ collected $1 from pot
fanmtZ: doesn't show hand 
*** SUMMARY ***
Total pot $1 | Rake $0 
Seat 1: Venomous100% folded before Flop (didn't bet)
Seat 2: Priidix (button) folded before Flop (didn't bet)
Seat 3: matiko09 (small blind) folded before Flop
Seat 4: fanmtZ (big blind) collected ($1)
Seat 5: vrnMike folded before Flop (didn't bet)
Seat 6: AlKatrone folded before Flop (didn't bet)





PokerStars Hand #148832343391:  Hold'em No Limit ($0.25/$0.50 USD) - 2016/02/15 10:37:07 CET [2016/02/15 4:37:07 ET]
Table 'Margot II' 9-max Seat #7 is the button
Seat 1: i L00K great ($53.93 in chips) 
Seat 2: matiko09 ($50 in chips) 
Seat 4: r4mz3s ($51.86 in chips) 
Seat 6: OskarR89 ($50 in chips) 
Seat 7: Vedpapa ($102.14 in chips) 
Seat 8: Aoki42 ($93.45 in chips) 
Seat 9: Haporuu ($22.50 in chips) 
Aoki42: posts small blind $0.25
Haporuu: posts big blind $0.50
beluccix: sits out 
carlosq1986: sits out 
*** HOLE CARDS ***
Dealt to matiko09 [Kh Th]
i L00K great: folds 
matiko09: raises $1 to $1.50
r4mz3s: folds 
OskarR89: folds 
Vedpapa: folds 
Aoki42: folds 
Haporuu: folds 
Uncalled bet ($1) returned to matiko09
matiko09 collected $1.25 from pot
matiko09: doesn't show hand 
*** SUMMARY ***
Total pot $1.25 | Rake $0 
Seat 1: i L00K great folded before Flop (didn't bet)
Seat 2: matiko09 collected ($1.25)
Seat 4: r4mz3s folded before Flop (didn't bet)
Seat 6: OskarR89 folded before Flop (didn't bet)
Seat 7: Vedpapa (button) folded before Flop (didn't bet)
Seat 8: Aoki42 (small blind) folded before Flop
Seat 9: Haporuu (big blind) folded before Flop





PokerStars Hand #148832344861:  Hold'em No Limit ($0.50/$1.00 USD) - 2016/02/15 10:37:10 CET [2016/02/15 4:37:10 ET]
Table 'Gemma II' 9-max Seat #4 is the button
Seat 1: Igor DoUrden ($175.28 in chips) 
Seat 2: WDW3 ($129.43 in chips) 
Seat 3: Venomous100% ($143.74 in chips) 
Seat 4: mycka86 ($100 in chips) 
Seat 5: PokerSash201 ($58.57 in chips) 
Seat 6: fanmtZ ($52.83 in chips) 
Seat 7: AlKatrone ($114.67 in chips) 
Seat 8: vrnMike ($140.64 in chips) 
Seat 9: matiko09 ($111.17 in chips) 
PokerSash201: posts small blind $0.50
fanmtZ: posts big blind $1
*** HOLE CARDS ***
Dealt to matiko09 [Jh 9s]
AlKatrone: raises $2 to $3
vrnMike: folds 
matiko09: folds 
Igor DoUrden: folds 
WDW3: folds 
Venomous100%: folds 
mycka86: folds 
PokerSash201: folds 
fanmtZ: calls $2
*** FLOP *** [5c Td 4d]
fanmtZ: checks 
AlKatrone: checks 
*** TURN *** [5c Td 4d] [7s]
fanmtZ: bets $4.16
AlKatrone: calls $4.16
*** RIVER *** [5c Td 4d 7s] [Qs]
fanmtZ: bets $8.13
AlKatrone: folds 
Uncalled bet ($8.13) returned to fanmtZ
fanmtZ collected $14.15 from pot
fanmtZ: doesn't show hand 
*** SUMMARY ***
Total pot $14.82 | Rake $0.67 
Board [5c Td 4d 7s Qs]
Seat 1: Igor DoUrden folded before Flop (didn't bet)
Seat 2: WDW3 folded before Flop (didn't bet)
Seat 3: Venomous100% folded before Flop (didn't bet)
Seat 4: mycka86 (button) folded before Flop (didn't bet)
Seat 5: PokerSash201 (small blind) folded before Flop
Seat 6: fanmtZ (big blind) collected ($14.15)
Seat 7: AlKatrone folded on the River
Seat 8: vrnMike folded before Flop (didn't bet)
Seat 9: matiko09 folded before Flop (didn't bet)





PokerStars Hand #148832345955:  Hold'em No Limit ($0.50/$1.00 USD) - 2016/02/15 10:37:13 CET [2016/02/15 4:37:13 ET]
Table 'Anteros' 9-max Seat #1 is the button
Seat 1: OskarR89 ($102 in chips) 
Seat 2: IHouseMusic ($106.32 in chips) 
Seat 3: nickreason17 ($100 in chips) 
Seat 7: Zoubou1983 ($95.64 in chips) 
Seat 8: matiko09 ($112 in chips) 
Seat 9: WDW3 ($100 in chips) 
IHouseMusic: posts small blind $0.50
nickreason17: posts big blind $1
*** HOLE CARDS ***
Dealt to matiko09 [5c Jc]
Holm1991 joins the table at seat #5 
Zoubou1983: folds 
matiko09: folds 
WDW3: folds 
OskarR89: folds 
IHouseMusic: raises $2 to $3
nickreason17: folds 
Uncalled bet ($2) returned to IHouseMusic
IHouseMusic collected $2 from pot
IHouseMusic: doesn't show hand 
*** SUMMARY ***
Total pot $2 | Rake $0 
Seat 1: OskarR89 (button) folded before Flop (didn't bet)
Seat 2: IHouseMusic (small blind) collected ($2)
Seat 3: nickreason17 (big blind) folded before Flop
Seat 7: Zoubou1983 folded before Flop (didn't bet)
Seat 8: matiko09 folded before Flop (didn't bet)
Seat 9: WDW3 folded before Flop (didn't bet)





PokerStars Hand #148832346987:  Hold'em No Limit ($0.25/$0.50 USD) - 2016/02/15 10:37:16 CET [2016/02/15 4:37:16 ET]
Table 'Vesta II' 9-max Seat #1 is the button
Seat 1: Ahangama ($55.90 in chips) 
Seat 2: i L00K great ($53.62 in chips) 
Seat 3: matiko09 ($69.40 in chips) 
Seat 4: HJdream ($48.86 in chips) 
Seat 5: dndngod ($79.90 in chips) 
Seat 6: pandalapa ($64 in chips) 
Seat 7: OskarR89 ($93.94 in chips) 
Seat 8: Arystan ($56.35 in chips) 
Seat 9: Aoki42 ($69.37 in chips) 
i L00K great: posts small blind $0.25
matiko09: posts big blind $0.50
*** HOLE CARDS ***
Dealt to matiko09 [2s 7h]
HJdream: folds 
dndngod: folds 
pandalapa: folds 
OskarR89: folds 
Arystan: folds 
Aoki42: folds 
Ahangama: raises $0.50 to $1
i L00K great: folds 
matiko09: folds 
Uncalled bet ($0.50) returned to Ahangama
Ahangama collected $1.25 from pot
Ahangama: doesn't show hand 
*** SUMMARY ***
Total pot $1.25 | Rake $0 
Seat 1: Ahangama (button) collected ($1.25)
Seat 2: i L00K great (small blind) folded before Flop
Seat 3: matiko09 (big blind) folded before Flop
Seat 4: HJdream folded before Flop (didn't bet)
Seat 5: dndngod folded before Flop (didn't bet)
Seat 6: pandalapa folded before Flop (didn't bet)
Seat 7: OskarR89 folded before Flop (didn't bet)
Seat 8: Arystan folded before Flop (didn't bet)
Seat 9: Aoki42 folded before Flop (didn't bet)





PokerStars Hand #148832348998:  Hold'em No Limit ($0.25/$0.50 USD) - 2016/02/15 10:37:20 CET [2016/02/15 4:37:20 ET]
Table 'Laertes II' 9-max Seat #1 is the button
Seat 1: dade33 ($60.05 in chips) 
Seat 2: beluccix ($24.21 in chips) 
Seat 3: ljryviltj ($56.16 in chips) 
Seat 4: rgar93 ($41.28 in chips) 
Seat 5: vlad11122007 ($48 in chips) 
Seat 6: moshiko29 ($35.24 in chips) 
Seat 7: OskarR89 ($68.52 in chips) 
Seat 8: Trent444 ($42.73 in chips) 
Seat 9: matiko09 ($50 in chips) 
beluccix: posts small blind $0.25
ljryviltj: posts big blind $0.50
*** HOLE CARDS ***
Dealt to matiko09 [6d 9s]
rgar93: folds 
vlad11122007: folds 
moshiko29: raises $1 to $1.50
OskarR89: folds 
Trent444: folds 
matiko09: folds 
dade33: calls $1.50
beluccix: folds 
ljryviltj: folds 
*** FLOP *** [6c Qc 2s]
moshiko29: bets $7
dade33: raises $51.55 to $58.55 and is all-in
moshiko29: calls $26.74 and is all-in
Uncalled bet ($24.81) returned to dade33
*** TURN *** [6c Qc 2s] [Kh]
*** RIVER *** [6c Qc 2s Kh] [5d]
*** SHOW DOWN ***
moshiko29: shows [Ac Ad] (a pair of Aces)
dade33: shows [5c Kc] (two pair, Kings and Fives)
dade33 collected $68.73 from pot
*** SUMMARY ***
Total pot $71.23 | Rake $2.50 
Board [6c Qc 2s Kh 5d]
Seat 1: dade33 (button) showed [5c Kc] and won ($68.73) with two pair, Kings and Fives
Seat 2: beluccix (small blind) folded before Flop
Seat 3: ljryviltj (big blind) folded before Flop
Seat 4: rgar93 folded before Flop (didn't bet)
Seat 5: vlad11122007 folded before Flop (didn't bet)
Seat 6: moshiko29 showed [Ac Ad] and lost with a pair of Aces
Seat 7: OskarR89 folded before Flop (didn't bet)
Seat 8: Trent444 folded before Flop (didn't bet)
Seat 9: matiko09 folded before Flop (didn't bet)





PokerStars Hand #148832351257:  Hold'em No Limit ($0.25/$0.50 USD) - 2016/02/15 10:37:26 CET [2016/02/15 4:37:26 ET]
Table 'Margot II' 9-max Seat #8 is the button
Seat 1: i L00K great ($53.93 in chips) 
Seat 2: matiko09 ($50.75 in chips) 
Seat 4: r4mz3s ($51.86 in chips) 
Seat 6: OskarR89 ($50 in chips) 
Seat 7: Vedpapa ($102.14 in chips) 
Seat 8: Aoki42 ($93.20 in chips) 
Seat 9: Haporuu ($22 in chips) 
Haporuu: posts small blind $0.25
i L00K great: posts big blind $0.50
beluccix: sits out 
carlosq1986: sits out 
*** HOLE CARDS ***
Dealt to matiko09 [Ah 3h]
matiko09: folds 
r4mz3s: folds 
OskarR89: raises $0.50 to $1
Vedpapa: folds 
Aoki42: folds 
Haporuu: folds 
i L00K great: calls $0.50
*** FLOP *** [Qc 9h 5d]
i L00K great: checks 
OskarR89: checks 
*** TURN *** [Qc 9h 5d] [6s]
i L00K great: checks 
OskarR89: checks 
*** RIVER *** [Qc 9h 5d 6s] [6d]
i L00K great: checks 
OskarR89: bets $2
i L00K great: folds 
Uncalled bet ($2) returned to OskarR89
OskarR89 collected $2.15 from pot
OskarR89: doesn't show hand 
*** SUMMARY ***
Total pot $2.25 | Rake $0.10 
Board [Qc 9h 5d 6s 6d]
Seat 1: i L00K great (big blind) folded on the River
Seat 2: matiko09 folded before Flop (didn't bet)
Seat 4: r4mz3s folded before Flop (didn't bet)
Seat 6: OskarR89 collected ($2.15)
Seat 7: Vedpapa folded before Flop (didn't bet)
Seat 8: Aoki42 (button) folded before Flop (didn't bet)
Seat 9: Haporuu (small blind) folded before Flop





PokerStars Hand #148832356763:  Hold'em No Limit ($0.50/$1.00 USD) - 2016/02/15 10:37:39 CET [2016/02/15 4:37:39 ET]
Table 'Anteros' 9-max Seat #2 is the button
Seat 1: OskarR89 ($102 in chips) 
Seat 2: IHouseMusic ($107.32 in chips) 
Seat 3: nickreason17 ($100 in chips) 
Seat 5: Holm1991 ($80 in chips) 
Seat 7: Zoubou1983 ($95.64 in chips) 
Seat 8: matiko09 ($112 in chips) 
Seat 9: WDW3 ($100 in chips) 
nickreason17: posts small blind $0.50
Holm1991: posts big blind $1
*** HOLE CARDS ***
Dealt to matiko09 [2h As]
SerAlGog joins the table at seat #6 
Zoubou1983: folds 
matiko09: folds 
WDW3: folds 
OskarR89: folds 
IHouseMusic: folds 
nickreason17: raises $1.04 to $2.04
Holm1991: calls $1.04
*** FLOP *** [3d 3c 2s]
nickreason17: checks 
Holm1991: bets $4
nickreason17: folds 
Uncalled bet ($4) returned to Holm1991
Holm1991 collected $3.90 from pot
Holm1991: doesn't show hand 
*** SUMMARY ***
Total pot $4.08 | Rake $0.18 
Board [3d 3c 2s]
Seat 1: OskarR89 folded before Flop (didn't bet)
Seat 2: IHouseMusic (button) folded before Flop (didn't bet)
Seat 3: nickreason17 (small blind) folded on the Flop
Seat 5: Holm1991 (big blind) collected ($3.90)
Seat 7: Zoubou1983 folded before Flop (didn't bet)
Seat 8: matiko09 folded before Flop (didn't bet)
Seat 9: WDW3 folded before Flop (didn't bet)





PokerStars Hand #148832359705:  Hold'em No Limit ($0.50/$1.00 USD) - 2016/02/15 10:37:47 CET [2016/02/15 4:37:47 ET]
Table 'Praecipua' 9-max Seat #8 is the button
Seat 1: matiko09 ($125.57 in chips) 
Seat 2: vrnMike ($115.17 in chips) 
Seat 3: Venomous100% ($107.50 in chips) 
Seat 4: Priidix ($123.78 in chips) 
Seat 5: huffwag ($42.56 in chips) 
Seat 7: maxxmeister ($179.77 in chips) 
Seat 8: Kalesmash08 ($77.31 in chips) 
Seat 9: AlKatrone ($105.52 in chips) 
AlKatrone: posts small blind $0.50
matiko09: posts big blind $1
mycka86: sits out 
*** HOLE CARDS ***
Dealt to matiko09 [Jc 5d]
vrnMike: folds 
Venomous100%: raises $2 to $3
Priidix: calls $3
huffwag: folds 
maxxmeister: folds 
Kalesmash08: calls $3
AlKatrone: folds 
matiko09: folds 
*** FLOP *** [3d 6s Qs]
Venomous100%: bets $6.62
Priidix: folds 
Kalesmash08: folds 
Uncalled bet ($6.62) returned to Venomous100%
Venomous100% collected $10.03 from pot
Venomous100%: doesn't show hand 
*** SUMMARY ***
Total pot $10.50 | Rake $0.47 
Board [3d 6s Qs]
Seat 1: matiko09 (big blind) folded before Flop
Seat 2: vrnMike folded before Flop (didn't bet)
Seat 3: Venomous100% collected ($10.03)
Seat 4: Priidix folded on the Flop
Seat 5: huffwag folded before Flop (didn't bet)
Seat 7: maxxmeister folded before Flop (didn't bet)
Seat 8: Kalesmash08 (button) folded on the Flop
Seat 9: AlKatrone (small blind) folded before Flop





PokerStars Hand #148832361370:  Hold'em No Limit ($0.50/$1.00 USD) - 2016/02/15 10:37:51 CET [2016/02/15 4:37:51 ET]
Table 'Saldanha' 9-max Seat #9 is the button
Seat 1: AlKatrone ($209.43 in chips) 
Seat 3: maxxmeister ($101 in chips) 
Seat 4: WDW3 ($100 in chips) 
Seat 5: Priidix ($137.02 in chips) 
Seat 6: huffwag ($39.06 in chips) 
Seat 7: Venomous100% ($100 in chips) 
Seat 8: matiko09 ($101.50 in chips) 
Seat 9: pompaskillad ($47.92 in chips) 
AlKatrone: posts small blind $0.50
maxxmeister: posts big blind $1
*** HOLE CARDS ***
Dealt to matiko09 [4d 7h]
WDW3: folds 
Priidix: raises $2 to $3
huffwag: folds 
Venomous100%: folds 
matiko09: folds 
pompaskillad: folds 
AlKatrone: folds 
maxxmeister: folds 
Uncalled bet ($2) returned to Priidix
Priidix collected $2.50 from pot
*** SUMMARY ***
Total pot $2.50 | Rake $0 
Seat 1: AlKatrone (small blind) folded before Flop
Seat 3: maxxmeister (big blind) folded before Flop
Seat 4: WDW3 folded before Flop (didn't bet)
Seat 5: Priidix collected ($2.50)
Seat 6: huffwag folded before Flop (didn't bet)
Seat 7: Venomous100% folded before Flop (didn't bet)
Seat 8: matiko09 folded before Flop (didn't bet)
Seat 9: pompaskillad (button) folded before Flop (didn't bet)





PokerStars Hand #148832361396:  Hold'em No Limit ($0.50/$1.00 USD) - 2016/02/15 10:37:51 CET [2016/02/15 4:37:51 ET]
Table 'Vibeke' 9-max Seat #3 is the button
Seat 2: Priidix ($141.91 in chips) 
Seat 3: matiko09 ($113.88 in chips) 
Seat 4: fanmtZ ($40.50 in chips) 
Seat 5: vrnMike ($213.89 in chips) 
Seat 6: AlKatrone ($101.50 in chips) 
fanmtZ: posts small blind $0.50
vrnMike: posts big blind $1
ackle1: sits out 
IHouseMusic: sits out 
WDW3: sits out 
*** HOLE CARDS ***
Dealt to matiko09 [7c 5h]
AlKatrone: folds 
Priidix: raises $1.60 to $2.60
matiko09: folds 
fanmtZ: folds 
vrnMike: folds 
Uncalled bet ($1.60) returned to Priidix
Priidix collected $2.50 from pot
Priidix: doesn't show hand 
*** SUMMARY ***
Total pot $2.50 | Rake $0 
Seat 2: Priidix collected ($2.50)
Seat 3: matiko09 (button) folded before Flop (didn't bet)
Seat 4: fanmtZ (small blind) folded before Flop
Seat 5: vrnMike (big blind) folded before Flop
Seat 6: AlKatrone folded before Flop (didn't bet)





PokerStars Hand #148832361938:  Hold'em No Limit ($0.25/$0.50 USD) - 2016/02/15 10:37:52 CET [2016/02/15 4:37:52 ET]
Table 'Juliet' 9-max Seat #1 is the button
Seat 1: i L00K great ($97.60 in chips) 
Seat 2: Nabulasun ($20 in chips) 
Seat 3: arctur17 ($62.01 in chips) 
Seat 4: pandalapa ($55.95 in chips) 
Seat 5: dndngod ($52.08 in chips) 
Seat 6: r4mz3s ($58.02 in chips) 
Seat 7: goldpiggy ($34.15 in chips) 
Seat 8: matiko09 ($50 in chips) 
Nabulasun: posts small blind $0.25
arctur17: posts big blind $0.50
carlosq1986: sits out 
*** HOLE CARDS ***
Dealt to matiko09 [Ah 2h]
pandalapa: folds 
dndngod: folds 
r4mz3s: folds 
goldpiggy: raises $1 to $1.50
matiko09: folds 
i L00K great: folds 
Nabulasun: folds 
arctur17: folds 
Uncalled bet ($1) returned to goldpiggy
goldpiggy collected $1.25 from pot
goldpiggy: doesn't show hand 
*** SUMMARY ***
Total pot $1.25 | Rake $0 
Seat 1: i L00K great (button) folded before Flop (didn't bet)
Seat 2: Nabulasun (small blind) folded before Flop
Seat 3: arctur17 (big blind) folded before Flop
Seat 4: pandalapa folded before Flop (didn't bet)
Seat 5: dndngod folded before Flop (didn't bet)
Seat 6: r4mz3s folded before Flop (didn't bet)
Seat 7: goldpiggy collected ($1.25)
Seat 8: matiko09 folded before Flop (didn't bet)





PokerStars Hand #148832362510:  Hold'em No Limit ($0.25/$0.50 USD) - 2016/02/15 10:37:53 CET [2016/02/15 4:37:53 ET]
Table 'Vesta II' 9-max Seat #2 is the button
Seat 1: Ahangama ($56.65 in chips) 
Seat 2: i L00K great ($53.37 in chips) 
Seat 3: matiko09 ($68.90 in chips) 
Seat 4: HJdream ($48.86 in chips) 
Seat 5: dndngod ($79.90 in chips) 
Seat 6: pandalapa ($64 in chips) 
Seat 7: OskarR89 ($93.94 in chips) 
Seat 8: Arystan ($56.35 in chips) 
Seat 9: Aoki42 ($69.37 in chips) 
matiko09: posts small blind $0.25
HJdream: posts big blind $0.50
*** HOLE CARDS ***
Dealt to matiko09 [2c Th]
dndngod has timed out
dndngod: folds 
pandalapa: raises $1 to $1.50
OskarR89: folds 
Arystan: calls $1.50
Aoki42: folds 
Ahangama: folds 
i L00K great: folds 
matiko09: folds 
HJdream: folds 
*** FLOP *** [6s Jh Td]
pandalapa: checks 
Arystan: bets $1.79
pandalapa: folds 
Uncalled bet ($1.79) returned to Arystan
Arystan collected $3.58 from pot
Arystan: doesn't show hand 
*** SUMMARY ***
Total pot $3.75 | Rake $0.17 
Board [6s Jh Td]
Seat 1: Ahangama folded before Flop (didn't bet)
Seat 2: i L00K great (button) folded before Flop (didn't bet)
Seat 3: matiko09 (small blind) folded before Flop
Seat 4: HJdream (big blind) folded before Flop
Seat 5: dndngod folded before Flop (didn't bet)
Seat 6: pandalapa folded on the Flop
Seat 7: OskarR89 folded before Flop (didn't bet)
Seat 8: Arystan collected ($3.58)
Seat 9: Aoki42 folded before Flop (didn't bet)





PokerStars Hand #148832366219:  Hold'em No Limit (€0.25/€0.50 EUR) - 2016/02/15 10:38:02 CET [2016/02/15 4:38:02 ET]
Table 'Walinskia II' 9-max Seat #5 is the button
Seat 1: ljryviltj (€50 in chips) 
Seat 4: Otsime (€50.09 in chips) 
Seat 5: vano7777 (€50.75 in chips) 
Seat 6: 50CandyJoe (€50 in chips) 
Seat 8: matiko09 (€50 in chips) 
Seat 9: stevevg84 (€32.87 in chips) 
50CandyJoe: posts small blind €0.25
matiko09: posts big blind €0.50
yats87: sits out 
beluccix: sits out 
*** HOLE CARDS ***
Dealt to matiko09 [4h 7s]
stevevg84: calls €0.50
ljryviltj: folds 
Otsime: calls €0.50
vano7777: calls €0.50
50CandyJoe: folds 
matiko09: checks 
*** FLOP *** [4c Qh 6s]
matiko09: checks 
stevevg84: checks 
Otsime: checks 
vano7777: bets €1.50
matiko09: folds 
stevevg84: folds 
Otsime: calls €1.50
*** TURN *** [4c Qh 6s] [7h]
Otsime: checks 
vano7777: bets €2.50
Otsime: calls €2.50
*** RIVER *** [4c Qh 6s 7h] [Ks]
Otsime: checks 
vano7777: checks 
*** SHOW DOWN ***
Otsime: shows [5d 7d] (a pair of Sevens)
vano7777: shows [9c Qc] (a pair of Queens)
vano7777 collected €9.79 from pot
*** SUMMARY ***
Total pot €10.25 | Rake €0.46 
Board [4c Qh 6s 7h Ks]
Seat 1: ljryviltj folded before Flop (didn't bet)
Seat 4: Otsime showed [5d 7d] and lost with a pair of Sevens
Seat 5: vano7777 (button) showed [9c Qc] and won (€9.79) with a pair of Queens
Seat 6: 50CandyJoe (small blind) folded before Flop
Seat 8: matiko09 (big blind) folded on the Flop
Seat 9: stevevg84 folded on the Flop





PokerStars Hand #148832369908:  Hold'em No Limit ($0.50/$1.00 USD) - 2016/02/15 10:38:11 CET [2016/02/15 4:38:11 ET]
Table 'Vibeke' 9-max Seat #4 is the button
Seat 2: Priidix ($143.41 in chips) 
Seat 3: matiko09 ($113.88 in chips) 
Seat 4: fanmtZ ($40 in chips) 
Seat 5: vrnMike ($212.89 in chips) 
Seat 6: AlKatrone ($101.50 in chips) 
vrnMike: posts small blind $0.50
AlKatrone: posts big blind $1
ackle1: sits out 
IHouseMusic: sits out 
WDW3: sits out 
*** HOLE CARDS ***
Dealt to matiko09 [4c Qd]
Priidix: folds 
matiko09: folds 
fanmtZ: raises $1.02 to $2.02
vrnMike: folds 
AlKatrone: calls $1.02
*** FLOP *** [6h Ac Kd]
AlKatrone: checks 
fanmtZ: bets $2.91
AlKatrone: folds 
Uncalled bet ($2.91) returned to fanmtZ
fanmtZ collected $4.34 from pot
fanmtZ: doesn't show hand 
*** SUMMARY ***
Total pot $4.54 | Rake $0.20 
Board [6h Ac Kd]
Seat 2: Priidix folded before Flop (didn't bet)
Seat 3: matiko09 folded before Flop (didn't bet)
Seat 4: fanmtZ (button) collected ($4.34)
Seat 5: vrnMike (small blind) folded before Flop
Seat 6: AlKatrone (big blind) folded on the Flop





PokerStars Hand #148832369699:  Hold'em No Limit ($0.25/$0.50 USD) - 2016/02/15 10:38:11 CET [2016/02/15 4:38:11 ET]
Table 'Margot II' 9-max Seat #9 is the button
Seat 1: i L00K great ($52.93 in chips) 
Seat 2: matiko09 ($50.75 in chips) 
Seat 4: r4mz3s ($51.86 in chips) 
Seat 6: OskarR89 ($51.15 in chips) 
Seat 7: Vedpapa ($102.14 in chips) 
Seat 8: Aoki42 ($93.20 in chips) 
Seat 9: Haporuu ($21.75 in chips) 
i L00K great: posts small blind $0.25
matiko09: posts big blind $0.50
beluccix: sits out 
carlosq1986: sits out 
*** HOLE CARDS ***
Dealt to matiko09 [Qs 9h]
r4mz3s: folds 
OskarR89: folds 
Vedpapa: folds 
Aoki42: raises $0.75 to $1.25
Haporuu: folds 
i L00K great: folds 
matiko09: folds 
Uncalled bet ($0.75) returned to Aoki42
Aoki42 collected $1.25 from pot
Aoki42: doesn't show hand 
*** SUMMARY ***
Total pot $1.25 | Rake $0 
Seat 1: i L00K great (small blind) folded before Flop
Seat 2: matiko09 (big blind) folded before Flop
Seat 4: r4mz3s folded before Flop (didn't bet)
Seat 6: OskarR89 folded before Flop (didn't bet)
Seat 7: Vedpapa folded before Flop (didn't bet)
Seat 8: Aoki42 collected ($1.25)
Seat 9: Haporuu (button) folded before Flop (didn't bet)





PokerStars Hand #148832370576:  Hold'em No Limit ($0.50/$1.00 USD) - 2016/02/15 10:38:13 CET [2016/02/15 4:38:13 ET]
Table 'Anteros' 9-max Seat #3 is the button
Seat 1: OskarR89 ($102 in chips) 
Seat 2: IHouseMusic ($107.32 in chips) 
Seat 3: nickreason17 ($100 in chips) 
Seat 5: Holm1991 ($81.86 in chips) 
Seat 7: Zoubou1983 ($95.64 in chips) 
Seat 8: matiko09 ($112 in chips) 
Seat 9: WDW3 ($100 in chips) 
Holm1991: posts small blind $0.50
Zoubou1983: posts big blind $1
*** HOLE CARDS ***
Dealt to matiko09 [Js Ah]
misherei joins the table at seat #4 
matiko09: raises $2 to $3
WDW3: folds 
OskarR89: folds 
IHouseMusic: folds 
nickreason17: folds 
Holm1991: raises $2 to $5
Zoubou1983: folds 
matiko09: calls $2
*** FLOP *** [8d Td Jh]
Holm1991: bets $6
matiko09: calls $6
*** TURN *** [8d Td Jh] [Qh]
Holm1991: bets $11
matiko09: folds 
Uncalled bet ($11) returned to Holm1991
Holm1991 collected $21.96 from pot
Holm1991: doesn't show hand 
*** SUMMARY ***
Total pot $23 | Rake $1.04 
Board [8d Td Jh Qh]
Seat 1: OskarR89 folded before Flop (didn't bet)
Seat 2: IHouseMusic folded before Flop (didn't bet)
Seat 3: nickreason17 (button) folded before Flop (didn't bet)
Seat 5: Holm1991 (small blind) collected ($21.96)
Seat 7: Zoubou1983 (big blind) folded before Flop
Seat 8: matiko09 folded on the Turn
Seat 9: WDW3 folded before Flop (didn't bet)





PokerStars Hand #148832371743:  Hold'em No Limit ($0.50/$1.00 USD) - 2016/02/15 10:38:16 CET [2016/02/15 4:38:16 ET]
Table 'Corvus III' 9-max Seat #7 is the button
Seat 5: koib88 ($62.08 in chips) 
Seat 6: WDW3 ($228.96 in chips) 
Seat 7: matiko09 ($103.31 in chips) 
koib88: posts small blind $0.50
WDW3: posts big blind $1
koib88: posts the ante $0.20
WDW3: posts the ante $0.20
matiko09: posts the ante $0.20
*** HOLE CARDS ***
Dealt to matiko09 [7h 7s]
matiko09: raises $1.50 to $2.50
koib88: calls $2
WDW3: raises $9 to $11.50
matiko09: calls $9
koib88: folds 
*** FLOP *** [8h 4s Kc]
WDW3: bets $10
matiko09: folds 
Uncalled bet ($10) returned to WDW3
WDW3 collected $24.93 from pot
WDW3: doesn't show hand 
*** SUMMARY ***
Total pot $26.10 | Rake $1.17 
Board [8h 4s Kc]
Seat 5: koib88 (small blind) folded before Flop
Seat 6: WDW3 (big blind) collected ($24.93)
Seat 7: matiko09 (button) folded on the Flop





PokerStars Hand #148832372006:  Hold'em No Limit ($0.50/$1.00 USD) - 2016/02/15 10:38:17 CET [2016/02/15 4:38:17 ET]
Table 'Saldanha' 9-max Seat #1 is the button
Seat 1: AlKatrone ($208.93 in chips) 
Seat 3: maxxmeister ($100 in chips) 
Seat 4: WDW3 ($100 in chips) 
Seat 5: Priidix ($138.52 in chips) 
Seat 6: huffwag ($39.06 in chips) 
Seat 7: Venomous100% ($100 in chips) 
Seat 8: matiko09 ($101.50 in chips) 
Seat 9: pompaskillad ($47.92 in chips) 
maxxmeister: posts small blind $0.50
WDW3: posts big blind $1
*** HOLE CARDS ***
Dealt to matiko09 [9d Ts]
Priidix: folds 
huffwag: folds 
Venomous100%: folds 
matiko09: folds 
pompaskillad: folds 
AlKatrone: raises $1 to $2
maxxmeister: folds 
WDW3: folds 
Uncalled bet ($1) returned to AlKatrone
AlKatrone collected $2.50 from pot
AlKatrone: doesn't show hand 
*** SUMMARY ***
Total pot $2.50 | Rake $0 
Seat 1: AlKatrone (button) collected ($2.50)
Seat 3: maxxmeister (small blind) folded before Flop
Seat 4: WDW3 (big blind) folded before Flop
Seat 5: Priidix folded before Flop (didn't bet)
Seat 6: huffwag folded before Flop (didn't bet)
Seat 7: Venomous100% folded before Flop (didn't bet)
Seat 8: matiko09 folded before Flop (didn't bet)
Seat 9: pompaskillad folded before Flop (didn't bet)





PokerStars Hand #148832372126:  Hold'em No Limit ($0.25/$0.50 USD) - 2016/02/15 10:38:17 CET [2016/02/15 4:38:17 ET]
Table 'Laertes II' 9-max Seat #2 is the button
Seat 1: dade33 ($93.54 in chips) 
Seat 2: beluccix ($24.21 in chips) 
Seat 3: ljryviltj ($55.66 in chips) 
Seat 4: rgar93 ($41.28 in chips) 
Seat 5: vlad11122007 ($48 in chips) 
Seat 7: OskarR89 ($68.52 in chips) 
Seat 8: Trent444 ($42.73 in chips) 
Seat 9: matiko09 ($50 in chips) 
ljryviltj: posts small blind $0.25
rgar93: posts big blind $0.50
*** HOLE CARDS ***
Dealt to matiko09 [Qd Kh]
vlad11122007: folds 
OskarR89: raises $0.75 to $1.25
Trent444: folds 
matiko09: raises $2.75 to $4
dade33: folds 
beluccix: folds 
ljryviltj: folds 
rgar93: folds 
OskarR89: raises $5 to $9
matiko09: folds 
Uncalled bet ($5) returned to OskarR89
OskarR89 collected $8.75 from pot
OskarR89: doesn't show hand 
*** SUMMARY ***
Total pot $8.75 | Rake $0 
Seat 1: dade33 folded before Flop (didn't bet)
Seat 2: beluccix (button) folded before Flop (didn't bet)
Seat 3: ljryviltj (small blind) folded before Flop
Seat 4: rgar93 (big blind) folded before Flop
Seat 5: vlad11122007 folded before Flop (didn't bet)
Seat 7: OskarR89 collected ($8.75)
Seat 8: Trent444 folded before Flop (didn't bet)
Seat 9: matiko09 folded before Flop





PokerStars Hand #148832375785:  Hold'em No Limit ($0.25/$0.50 USD) - 2016/02/15 10:38:26 CET [2016/02/15 4:38:26 ET]
Table 'Juliet' 9-max Seat #2 is the button
Seat 1: i L00K great ($97.60 in chips) 
Seat 2: Nabulasun ($20 in chips) 
Seat 3: arctur17 ($61.51 in chips) 
Seat 4: pandalapa ($55.95 in chips) 
Seat 5: dndngod ($52.08 in chips) 
Seat 6: r4mz3s ($58.02 in chips) 
Seat 7: goldpiggy ($34.90 in chips) 
Seat 8: matiko09 ($50 in chips) 
arctur17: posts small blind $0.25
pandalapa: posts big blind $0.50
carlosq1986: sits out 
*** HOLE CARDS ***
Dealt to matiko09 [Td Jd]
dndngod: folds 
r4mz3s: folds 
goldpiggy: folds 
matiko09: raises $1 to $1.50
i L00K great: calls $1.50
Nabulasun: folds 
arctur17: calls $1.25
pandalapa: folds 
*** FLOP *** [6h Ac 8s]
arctur17: checks 
matiko09: checks 
i L00K great: checks 
*** TURN *** [6h Ac 8s] [5c]
arctur17: bets $2.50
matiko09: folds 
i L00K great: folds 
Uncalled bet ($2.50) returned to arctur17
arctur17 collected $4.78 from pot
arctur17: doesn't show hand 
*** SUMMARY ***
Total pot $5 | Rake $0.22 
Board [6h Ac 8s 5c]
Seat 1: i L00K great folded on the Turn
Seat 2: Nabulasun (button) folded before Flop (didn't bet)
Seat 3: arctur17 (small blind) collected ($4.78)
Seat 4: pandalapa (big blind) folded before Flop
Seat 5: dndngod folded before Flop (didn't bet)
Seat 6: r4mz3s folded before Flop (didn't bet)
Seat 7: goldpiggy folded before Flop (didn't bet)
Seat 8: matiko09 folded on the Turn





PokerStars Hand #148832376349:  Hold'em No Limit ($0.50/$1.00 USD) - 2016/02/15 10:38:27 CET [2016/02/15 4:38:27 ET]
Table 'Praecipua' 9-max Seat #9 is the button
Seat 1: matiko09 ($124.57 in chips) 
Seat 2: vrnMike ($115.17 in chips) 
Seat 3: Venomous100% ($114.53 in chips) 
Seat 4: Priidix ($120.78 in chips) 
Seat 5: huffwag ($42.56 in chips) 
Seat 7: maxxmeister ($179.77 in chips) 
Seat 8: Kalesmash08 ($74.31 in chips) 
Seat 9: AlKatrone ($105.02 in chips) 
matiko09: posts small blind $0.50
vrnMike: posts big blind $1
mycka86: sits out 
*** HOLE CARDS ***
Dealt to matiko09 [9d 7h]
Venomous100%: folds 
Priidix: folds 
huffwag: folds 
maxxmeister: folds 
Kalesmash08: folds 
AlKatrone: raises $1 to $2
matiko09: folds 
vrnMike: folds 
Uncalled bet ($1) returned to AlKatrone
AlKatrone collected $2.50 from pot
AlKatrone: doesn't show hand 
*** SUMMARY ***
Total pot $2.50 | Rake $0 
Seat 1: matiko09 (small blind) folded before Flop
Seat 2: vrnMike (big blind) folded before Flop
Seat 3: Venomous100% folded before Flop (didn't bet)
Seat 4: Priidix folded before Flop (didn't bet)
Seat 5: huffwag folded before Flop (didn't bet)
Seat 7: maxxmeister folded before Flop (didn't bet)
Seat 8: Kalesmash08 folded before Flop (didn't bet)
Seat 9: AlKatrone (button) collected ($2.50)





PokerStars Hand #148832376582:  Hold'em No Limit ($0.25/$0.50 USD) - 2016/02/15 10:38:28 CET [2016/02/15 4:38:28 ET]
Table 'Margot II' 9-max Seat #1 is the button
Seat 1: i L00K great ($52.68 in chips) 
Seat 2: matiko09 ($50.25 in chips) 
Seat 3: beluccix ($28.55 in chips) 
Seat 4: r4mz3s ($51.86 in chips) 
Seat 6: OskarR89 ($51.15 in chips) 
Seat 7: Vedpapa ($102.14 in chips) 
Seat 8: Aoki42 ($93.95 in chips) 
Seat 9: Haporuu ($21.75 in chips) 
matiko09: posts small blind $0.25
beluccix: posts big blind $0.50
carlosq1986: sits out 
*** HOLE CARDS ***
Dealt to matiko09 [As Qd]
r4mz3s: raises $1 to $1.50
OskarR89: folds 
Vedpapa: folds 
Aoki42: folds 
Haporuu: folds 
i L00K great: folds 
matiko09: raises $3.50 to $5
beluccix: raises $23.55 to $28.55 and is all-in
r4mz3s: folds 
matiko09: folds 
Uncalled bet ($23.55) returned to beluccix
beluccix collected $11.50 from pot
beluccix: doesn't show hand 
*** SUMMARY ***
Total pot $11.50 | Rake $0 
Seat 1: i L00K great (button) folded before Flop (didn't bet)
Seat 2: matiko09 (small blind) folded before Flop
Seat 3: beluccix (big blind) collected ($11.50)
Seat 4: r4mz3s folded before Flop
Seat 6: OskarR89 folded before Flop (didn't bet)
Seat 7: Vedpapa folded before Flop (didn't bet)
Seat 8: Aoki42 folded before Flop (didn't bet)
Seat 9: Haporuu folded before Flop (didn't bet)





PokerStars Hand #148832382257:  Hold'em No Limit ($0.25/$0.50 USD) - 2016/02/15 10:38:42 CET [2016/02/15 4:38:42 ET]
Table 'Vesta II' 9-max Seat #3 is the button
Seat 1: Ahangama ($56.65 in chips) 
Seat 2: i L00K great ($53.37 in chips) 
Seat 3: matiko09 ($68.65 in chips) 
Seat 4: HJdream ($48.36 in chips) 
Seat 5: dndngod ($79.90 in chips) 
Seat 6: pandalapa ($62.50 in chips) 
Seat 7: OskarR89 ($93.94 in chips) 
Seat 8: Arystan ($58.43 in chips) 
Seat 9: Aoki42 ($69.37 in chips) 
HJdream: posts small blind $0.25
dndngod: posts big blind $0.50
*** HOLE CARDS ***
Dealt to matiko09 [5h 9c]
pandalapa: folds 
OskarR89: folds 
Arystan: folds 
Aoki42: folds 
Ahangama: folds 
i L00K great: raises $0.75 to $1.25
matiko09: folds 
HJdream: folds 
dndngod: folds 
Uncalled bet ($0.75) returned to i L00K great
i L00K great collected $1.25 from pot
i L00K great: doesn't show hand 
*** SUMMARY ***
Total pot $1.25 | Rake $0 
Seat 1: Ahangama folded before Flop (didn't bet)
Seat 2: i L00K great collected ($1.25)
Seat 3: matiko09 (button) folded before Flop (didn't bet)
Seat 4: HJdream (small blind) folded before Flop
Seat 5: dndngod (big blind) folded before Flop
Seat 6: pandalapa folded before Flop (didn't bet)
Seat 7: OskarR89 folded before Flop (didn't bet)
Seat 8: Arystan folded before Flop (didn't bet)
Seat 9: Aoki42 folded before Flop (didn't bet)





PokerStars Hand #148832382775:  Hold'em No Limit (€0.25/€0.50 EUR) - 2016/02/15 10:38:43 CET [2016/02/15 4:38:43 ET]
Table 'Walinskia II' 9-max Seat #6 is the button
Seat 1: ljryviltj (€50 in chips) 
Seat 4: Otsime (€45.59 in chips) 
Seat 5: vano7777 (€56.04 in chips) 
Seat 6: 50CandyJoe (€50 in chips) 
Seat 8: matiko09 (€50 in chips) 
Seat 9: stevevg84 (€32.37 in chips) 
matiko09: posts small blind €0.25
stevevg84: posts big blind €0.50
yats87: sits out 
beluccix: sits out 
*** HOLE CARDS ***
Dealt to matiko09 [Kh 9c]
ljryviltj: folds 
Otsime: folds 
vano7777: folds 
50CandyJoe: raises €0.50 to €1
matiko09: folds 
stevevg84: calls €0.50
*** FLOP *** [8d 8h As]
stevevg84: checks 
50CandyJoe: bets €1.25
stevevg84: calls €1.25
*** TURN *** [8d 8h As] [7s]
stevevg84: checks 
50CandyJoe: checks 
*** RIVER *** [8d 8h As 7s] [Td]
stevevg84: checks 
50CandyJoe: checks 
*** SHOW DOWN ***
stevevg84: shows [6d 6c] (two pair, Eights and Sixes)
50CandyJoe: mucks hand 
stevevg84 collected €4.54 from pot
*** SUMMARY ***
Total pot €4.75 | Rake €0.21 
Board [8d 8h As 7s Td]
Seat 1: ljryviltj folded before Flop (didn't bet)
Seat 4: Otsime folded before Flop (didn't bet)
Seat 5: vano7777 folded before Flop (didn't bet)
Seat 6: 50CandyJoe (button) mucked [Qh 2h]
Seat 8: matiko09 (small blind) folded before Flop
Seat 9: stevevg84 (big blind) showed [6d 6c] and won (€4.54) with two pair, Eights and Sixes





PokerStars Hand #148832384704:  Hold'em No Limit ($0.50/$1.00 USD) - 2016/02/15 10:38:48 CET [2016/02/15 4:38:48 ET]
Table 'Urania' 9-max Seat #5 is the button
Seat 1: matiko09 ($100 in chips) 
Seat 2: maxxmeister ($137.92 in chips) 
Seat 3: Priidix ($131.48 in chips) 
Seat 4: nickreason17 ($120.08 in chips) 
Seat 5: maxonplay ($176.08 in chips) 
Seat 6: vrnMike ($172.11 in chips) 
Seat 7: darren1031 ($168.24 in chips) 
Seat 9: lixiangli ($94.90 in chips) 
vrnMike: posts small blind $0.50
darren1031: posts big blind $1
*** HOLE CARDS ***
Dealt to matiko09 [4s Ah]
lixiangli: folds 
matiko09: folds 
maxxmeister: folds 
Priidix: folds 
nickreason17: folds 
maxonplay: folds 
vrnMike: folds 
Uncalled bet ($0.50) returned to darren1031
darren1031 collected $1 from pot
darren1031: doesn't show hand 
*** SUMMARY ***
Total pot $1 | Rake $0 
Seat 1: matiko09 folded before Flop (didn't bet)
Seat 2: maxxmeister folded before Flop (didn't bet)
Seat 3: Priidix folded before Flop (didn't bet)
Seat 4: nickreason17 folded before Flop (didn't bet)
Seat 5: maxonplay (button) folded before Flop (didn't bet)
Seat 6: vrnMike (small blind) folded before Flop
Seat 7: darren1031 (big blind) collected ($1)
Seat 9: lixiangli folded before Flop (didn't bet)





PokerStars Hand #148832387882:  Hold'em No Limit ($0.50/$1.00 USD) - 2016/02/15 10:38:56 CET [2016/02/15 4:38:56 ET]
Table 'Corvus III' 9-max Seat #5 is the button
Seat 5: koib88 ($59.38 in chips) 
Seat 6: WDW3 ($242.19 in chips) 
Seat 7: matiko09 ($100 in chips) 
WDW3: posts small blind $0.50
matiko09: posts big blind $1
koib88: posts the ante $0.20
WDW3: posts the ante $0.20
matiko09: posts the ante $0.20
*** HOLE CARDS ***
Dealt to matiko09 [Ks 6c]
koib88: calls $1
WDW3: folds 
matiko09: checks 
*** FLOP *** [8s Td 5d]
redacesfull joins the table at seat #8 
matiko09: checks 
koib88: checks 
*** TURN *** [8s Td 5d] [3d]
goransyruvka joins the table at seat #4 
matiko09: checks 
koib88: checks 
*** RIVER *** [8s Td 5d 3d] [Ts]
matiko09: checks 
koib88: checks 
*** SHOW DOWN ***
matiko09: shows [Ks 6c] (a pair of Tens)
koib88: shows [As 3h] (two pair, Tens and Threes)
koib88 collected $2.96 from pot
*** SUMMARY ***
Total pot $3.10 | Rake $0.14 
Board [8s Td 5d 3d Ts]
Seat 5: koib88 (button) showed [As 3h] and won ($2.96) with two pair, Tens and Threes
Seat 6: WDW3 (small blind) folded before Flop
Seat 7: matiko09 (big blind) showed [Ks 6c] and lost with a pair of Tens





PokerStars Hand #148832388480:  Hold'em No Limit ($0.50/$1.00 USD) - 2016/02/15 10:38:57 CET [2016/02/15 4:38:57 ET]
Table 'Saldanha' 9-max Seat #3 is the button
Seat 1: AlKatrone ($210.43 in chips) 
Seat 3: maxxmeister ($100 in chips) 
Seat 4: WDW3 ($100 in chips) 
Seat 5: Priidix ($138.52 in chips) 
Seat 6: huffwag ($39.06 in chips) 
Seat 7: Venomous100% ($100 in chips) 
Seat 8: matiko09 ($101.50 in chips) 
Seat 9: pompaskillad ($47.92 in chips) 
WDW3: posts small blind $0.50
Priidix: posts big blind $1
*** HOLE CARDS ***
Dealt to matiko09 [5s Td]
huffwag: folds 
Venomous100%: raises $2 to $3
matiko09: folds 
pompaskillad: folds 
AlKatrone has timed out
AlKatrone: folds 
maxxmeister: calls $3
WDW3: folds 
Priidix: folds 
*** FLOP *** [Qh 5c 4c]
Venomous100%: checks 
maxxmeister: bets $5
Venomous100%: folds 
Uncalled bet ($5) returned to maxxmeister
maxxmeister collected $7.16 from pot
maxxmeister: doesn't show hand 
*** SUMMARY ***
Total pot $7.50 | Rake $0.34 
Board [Qh 5c 4c]
Seat 1: AlKatrone folded before Flop (didn't bet)
Seat 3: maxxmeister (button) collected ($7.16)
Seat 4: WDW3 (small blind) folded before Flop
Seat 5: Priidix (big blind) folded before Flop
Seat 6: huffwag folded before Flop (didn't bet)
Seat 7: Venomous100% folded on the Flop
Seat 8: matiko09 folded before Flop (didn't bet)
Seat 9: pompaskillad folded before Flop (didn't bet)





PokerStars Hand #148832389505:  Hold'em No Limit ($0.50/$1.00 USD) - 2016/02/15 10:39:00 CET [2016/02/15 4:39:00 ET]
Table 'Praecipua' 9-max Seat #1 is the button
Seat 1: matiko09 ($124.07 in chips) 
Seat 2: vrnMike ($114.17 in chips) 
Seat 3: Venomous100% ($114.53 in chips) 
Seat 4: Priidix ($120.78 in chips) 
Seat 5: huffwag ($42.56 in chips) 
Seat 7: maxxmeister ($179.77 in chips) 
Seat 8: Kalesmash08 ($74.31 in chips) 
Seat 9: AlKatrone ($106.52 in chips) 
vrnMike: posts small blind $0.50
Venomous100%: posts big blind $1
mycka86: sits out 
*** HOLE CARDS ***
Dealt to matiko09 [6s Kh]
Priidix: folds 
huffwag: raises $2 to $3
maxxmeister: folds 
Kalesmash08: folds 
AlKatrone: folds 
matiko09: folds 
vrnMike: folds 
Venomous100%: folds 
Uncalled bet ($2) returned to huffwag
huffwag collected $2.50 from pot
huffwag: doesn't show hand 
*** SUMMARY ***
Total pot $2.50 | Rake $0 
Seat 1: matiko09 (button) folded before Flop (didn't bet)
Seat 2: vrnMike (small blind) folded before Flop
Seat 3: Venomous100% (big blind) folded before Flop
Seat 4: Priidix folded before Flop (didn't bet)
Seat 5: huffwag collected ($2.50)
Seat 7: maxxmeister folded before Flop (didn't bet)
Seat 8: Kalesmash08 folded before Flop (didn't bet)
Seat 9: AlKatrone folded before Flop (didn't bet)





PokerStars Hand #148832391071:  Hold'em No Limit ($0.25/$0.50 USD) - 2016/02/15 10:39:03 CET [2016/02/15 4:39:03 ET]
Table 'Laertes II' 9-max Seat #3 is the button
Seat 1: dade33 ($93.54 in chips) 
Seat 2: beluccix ($24.21 in chips) 
Seat 3: ljryviltj ($55.41 in chips) 
Seat 4: rgar93 ($40.78 in chips) 
Seat 5: vlad11122007 ($48 in chips) 
Seat 7: OskarR89 ($73.27 in chips) 
Seat 8: Trent444 ($42.73 in chips) 
Seat 9: matiko09 ($50 in chips) 
rgar93: posts small blind $0.25
vlad11122007: posts big blind $0.50
*** HOLE CARDS ***
Dealt to matiko09 [3c Jc]
OskarR89: folds 
Trent444: folds 
moshiko29 leaves the table
matiko09: folds 
yats87 joins the table at seat #6 
dade33: raises $1 to $1.50
beluccix: folds 
ljryviltj: folds 
rgar93: folds 
vlad11122007: folds 
Uncalled bet ($1) returned to dade33
dade33 collected $1.25 from pot
*** SUMMARY ***
Total pot $1.25 | Rake $0 
Seat 1: dade33 collected ($1.25)
Seat 2: beluccix folded before Flop (didn't bet)
Seat 3: ljryviltj (button) folded before Flop (didn't bet)
Seat 4: rgar93 (small blind) folded before Flop
Seat 5: vlad11122007 (big blind) folded before Flop
Seat 7: OskarR89 folded before Flop (didn't bet)
Seat 8: Trent444 folded before Flop (didn't bet)
Seat 9: matiko09 folded before Flop (didn't bet)





PokerStars Hand #148832393772:  Hold'em No Limit ($0.50/$1.00 USD) - 2016/02/15 10:39:10 CET [2016/02/15 4:39:10 ET]
Table 'Urania' 9-max Seat #6 is the button
Seat 1: matiko09 ($100 in chips) 
Seat 2: maxxmeister ($137.92 in chips) 
Seat 3: Priidix ($131.48 in chips) 
Seat 4: nickreason17 ($120.08 in chips) 
Seat 5: maxonplay ($176.08 in chips) 
Seat 6: vrnMike ($171.61 in chips) 
Seat 7: darren1031 ($168.74 in chips) 
Seat 8: Venomous100% ($115.71 in chips) 
Seat 9: lixiangli ($94.90 in chips) 
darren1031: posts small blind $0.50
Venomous100%: posts big blind $1
*** HOLE CARDS ***
Dealt to matiko09 [2s 7d]
lixiangli: folds 
lixiangli leaves the table
matiko09: folds 
mycka86 joins the table at seat #9 
maxxmeister: folds 
Priidix: raises $2 to $3
nickreason17: folds 
maxonplay: folds 
vrnMike: folds 
darren1031: folds 
Venomous100%: folds 
Uncalled bet ($2) returned to Priidix
Priidix collected $2.50 from pot
Priidix: doesn't show hand 
*** SUMMARY ***
Total pot $2.50 | Rake $0 
Seat 1: matiko09 folded before Flop (didn't bet)
Seat 2: maxxmeister folded before Flop (didn't bet)
Seat 3: Priidix collected ($2.50)
Seat 4: nickreason17 folded before Flop (didn't bet)
Seat 5: maxonplay folded before Flop (didn't bet)
Seat 6: vrnMike (button) folded before Flop (didn't bet)
Seat 7: darren1031 (small blind) folded before Flop
Seat 8: Venomous100% (big blind) folded before Flop
Seat 9: lixiangli folded before Flop (didn't bet)





PokerStars Hand #148832394407:  Hold'em No Limit ($0.50/$1.00 USD) - 2016/02/15 10:39:11 CET [2016/02/15 4:39:11 ET]
Table 'Anteros' 9-max Seat #5 is the button
Seat 1: OskarR89 ($102 in chips) 
Seat 2: IHouseMusic ($107.32 in chips) 
Seat 3: nickreason17 ($100 in chips) 
Seat 5: Holm1991 ($92.82 in chips) 
Seat 7: Zoubou1983 ($94.64 in chips) 
Seat 8: matiko09 ($101 in chips) 
Seat 9: WDW3 ($100 in chips) 
Zoubou1983: posts small blind $0.50
matiko09: posts big blind $1
misherei: sits out 
*** HOLE CARDS ***
Dealt to matiko09 [2d Js]
WDW3: folds 
OskarR89: folds 
IHouseMusic: folds 
nickreason17: folds 
Holm1991: folds 
Zoubou1983: calls $0.50
matiko09: checks 
*** FLOP *** [7c 2h Qc]
Zoubou1983: checks 
matiko09: checks 
*** TURN *** [7c 2h Qc] [7s]
Zoubou1983: checks 
matiko09: bets $1
Zoubou1983: folds 
Uncalled bet ($1) returned to matiko09
matiko09 collected $1.91 from pot
matiko09: doesn't show hand 
*** SUMMARY ***
Total pot $2 | Rake $0.09 
Board [7c 2h Qc 7s]
Seat 1: OskarR89 folded before Flop (didn't bet)
Seat 2: IHouseMusic folded before Flop (didn't bet)
Seat 3: nickreason17 folded before Flop (didn't bet)
Seat 5: Holm1991 (button) folded before Flop (didn't bet)
Seat 7: Zoubou1983 (small blind) folded on the Turn
Seat 8: matiko09 (big blind) collected ($1.91)
Seat 9: WDW3 folded before Flop (didn't bet)





PokerStars Hand #148832394276:  Hold'em No Limit ($0.25/$0.50 USD) - 2016/02/15 10:39:11 CET [2016/02/15 4:39:11 ET]
Table 'Vesta II' 9-max Seat #4 is the button
Seat 1: Ahangama ($56.65 in chips) 
Seat 2: i L00K great ($54.12 in chips) 
Seat 3: matiko09 ($68.65 in chips) 
Seat 4: HJdream ($48.11 in chips) 
Seat 5: dndngod ($79.40 in chips) 
Seat 6: pandalapa ($62.50 in chips) 
Seat 7: OskarR89 ($93.94 in chips) 
Seat 8: Arystan ($58.43 in chips) 
Seat 9: Aoki42 ($69.37 in chips) 
dndngod: posts small blind $0.25
pandalapa: posts big blind $0.50
*** HOLE CARDS ***
Dealt to matiko09 [Jd 8c]
OskarR89: folds 
Arystan: raises $1 to $1.50
Aoki42: folds 
Ahangama: folds 
i L00K great: folds 
matiko09: folds 
HJdream: folds 
dndngod: folds 
pandalapa: folds 
Uncalled bet ($1) returned to Arystan
Arystan collected $1.25 from pot
Arystan: doesn't show hand 
*** SUMMARY ***
Total pot $1.25 | Rake $0 
Seat 1: Ahangama folded before Flop (didn't bet)
Seat 2: i L00K great folded before Flop (didn't bet)
Seat 3: matiko09 folded before Flop (didn't bet)
Seat 4: HJdream (button) folded before Flop (didn't bet)
Seat 5: dndngod (small blind) folded before Flop
Seat 6: pandalapa (big blind) folded before Flop
Seat 7: OskarR89 folded before Flop (didn't bet)
Seat 8: Arystan collected ($1.25)
Seat 9: Aoki42 folded before Flop (didn't bet)





PokerStars Hand #148832399706:  Hold'em No Limit (€0.25/€0.50 EUR) - 2016/02/15 10:39:24 CET [2016/02/15 4:39:24 ET]
Table 'Walinskia II' 9-max Seat #8 is the button
Seat 1: ljryviltj (€50 in chips) 
Seat 4: Otsime (€45.59 in chips) 
Seat 5: vano7777 (€56.04 in chips) 
Seat 6: 50CandyJoe (€50 in chips) 
Seat 8: matiko09 (€50 in chips) 
Seat 9: stevevg84 (€34.66 in chips) 
stevevg84: posts small blind €0.25
ljryviltj: posts big blind €0.50
yats87: sits out 
beluccix: sits out 
*** HOLE CARDS ***
Dealt to matiko09 [6h Tc]
Otsime: folds 
vano7777: folds 
50CandyJoe: raises €0.50 to €1
matiko09: folds 
stevevg84: folds 
ljryviltj: folds 
Uncalled bet (€0.50) returned to 50CandyJoe
50CandyJoe collected €1.25 from pot
50CandyJoe: doesn't show hand 
*** SUMMARY ***
Total pot €1.25 | Rake €0 
Seat 1: ljryviltj (big blind) folded before Flop
Seat 4: Otsime folded before Flop (didn't bet)
Seat 5: vano7777 folded before Flop (didn't bet)
Seat 6: 50CandyJoe collected (€1.25)
Seat 8: matiko09 (button) folded before Flop (didn't bet)
Seat 9: stevevg84 (small blind) folded before Flop





PokerStars Hand #148832402146:  Hold'em No Limit ($0.25/$0.50 USD) - 2016/02/15 10:39:30 CET [2016/02/15 4:39:30 ET]
Table 'Margot II' 9-max Seat #2 is the button
Seat 1: i L00K great ($52.68 in chips) 
Seat 2: matiko09 ($50 in chips) 
Seat 3: beluccix ($35.05 in chips) 
Seat 4: r4mz3s ($50.36 in chips) 
Seat 6: OskarR89 ($51.15 in chips) 
Seat 7: Vedpapa ($102.14 in chips) 
Seat 8: Aoki42 ($93.95 in chips) 
Seat 9: Haporuu ($21.75 in chips) 
beluccix: posts small blind $0.25
r4mz3s: posts big blind $0.50
carlosq1986: sits out 
*** HOLE CARDS ***
Dealt to matiko09 [2h 7h]
OskarR89: folds 
Vedpapa: raises $1 to $1.50
Aoki42: folds 
Haporuu: folds 
i L00K great: folds 
matiko09: folds 
beluccix: folds 
r4mz3s: folds 
Uncalled bet ($1) returned to Vedpapa
Vedpapa collected $1.25 from pot
Vedpapa: doesn't show hand 
*** SUMMARY ***
Total pot $1.25 | Rake $0 
Seat 1: i L00K great folded before Flop (didn't bet)
Seat 2: matiko09 (button) folded before Flop (didn't bet)
Seat 3: beluccix (small blind) folded before Flop
Seat 4: r4mz3s (big blind) folded before Flop
Seat 6: OskarR89 folded before Flop (didn't bet)
Seat 7: Vedpapa collected ($1.25)
Seat 8: Aoki42 folded before Flop (didn't bet)
Seat 9: Haporuu folded before Flop (didn't bet)





PokerStars Hand #148832402281:  Hold'em No Limit ($0.50/$1.00 USD) - 2016/02/15 10:39:31 CET [2016/02/15 4:39:31 ET]
Table 'Vibeke' 9-max Seat #5 is the button
Seat 1: Venomous100% ($195.91 in chips) 
Seat 2: Priidix ($143.41 in chips) 
Seat 3: matiko09 ($113.88 in chips) 
Seat 4: fanmtZ ($42.32 in chips) 
Seat 5: vrnMike ($212.39 in chips) 
Seat 6: AlKatrone ($100 in chips) 
Seat 7: ackle1 ($73.15 in chips) 
AlKatrone: posts small blind $0.50
ackle1: posts big blind $1
IHouseMusic: sits out 
WDW3: sits out 
*** HOLE CARDS ***
Dealt to matiko09 [8c Jc]
Venomous100%: folds 
Priidix: folds 
matiko09: folds 
fanmtZ: folds 
vrnMike: raises $2 to $3
AlKatrone: folds 
ackle1: calls $2
*** FLOP *** [Kc 8d Td]
ackle1: checks 
vrnMike: bets $3.50
ackle1: calls $3.50
*** TURN *** [Kc 8d Td] [8h]
ackle1: checks 
vrnMike: checks 
*** RIVER *** [Kc 8d Td 8h] [7d]
ackle1: bets $10
vrnMike: folds 
Uncalled bet ($10) returned to ackle1
ackle1 collected $12.89 from pot
*** SUMMARY ***
Total pot $13.50 | Rake $0.61 
Board [Kc 8d Td 8h 7d]
Seat 1: Venomous100% folded before Flop (didn't bet)
Seat 2: Priidix folded before Flop (didn't bet)
Seat 3: matiko09 folded before Flop (didn't bet)
Seat 4: fanmtZ folded before Flop (didn't bet)
Seat 5: vrnMike (button) folded on the River
Seat 6: AlKatrone (small blind) folded before Flop
Seat 7: ackle1 (big blind) collected ($12.89)





PokerStars Hand #148832405466:  Hold'em No Limit ($0.50/$1.00 USD) - 2016/02/15 10:39:38 CET [2016/02/15 4:39:38 ET]
Table 'Praecipua' 9-max Seat #2 is the button
Seat 1: matiko09 ($124.07 in chips) 
Seat 2: vrnMike ($113.67 in chips) 
Seat 3: Venomous100% ($113.53 in chips) 
Seat 4: Priidix ($120.78 in chips) 
Seat 5: huffwag ($44.06 in chips) 
Seat 7: maxxmeister ($179.77 in chips) 
Seat 8: Kalesmash08 ($74.31 in chips) 
Seat 9: AlKatrone ($106.52 in chips) 
Venomous100%: posts small blind $0.50
Priidix: posts big blind $1
mycka86: sits out 
*** HOLE CARDS ***
Dealt to matiko09 [5s 8d]
huffwag: folds 
maxxmeister: raises $2.50 to $3.50
Kalesmash08: folds 
AlKatrone: folds 
matiko09: folds 
vrnMike: folds 
Venomous100%: folds 
Priidix: folds 
Uncalled bet ($2.50) returned to maxxmeister
maxxmeister collected $2.50 from pot
maxxmeister: doesn't show hand 
*** SUMMARY ***
Total pot $2.50 | Rake $0 
Seat 1: matiko09 folded before Flop (didn't bet)
Seat 2: vrnMike (button) folded before Flop (didn't bet)
Seat 3: Venomous100% (small blind) folded before Flop
Seat 4: Priidix (big blind) folded before Flop
Seat 5: huffwag folded before Flop (didn't bet)
Seat 7: maxxmeister collected ($2.50)
Seat 8: Kalesmash08 folded before Flop (didn't bet)
Seat 9: AlKatrone folded before Flop (didn't bet)





PokerStars Hand #148832405857:  Hold'em No Limit ($0.25/$0.50 USD) - 2016/02/15 10:39:39 CET [2016/02/15 4:39:39 ET]
Table 'Vesta II' 9-max Seat #5 is the button
Seat 1: Ahangama ($56.65 in chips) 
Seat 2: i L00K great ($54.12 in chips) 
Seat 3: matiko09 ($68.65 in chips) 
Seat 4: HJdream ($48.11 in chips) 
Seat 5: dndngod ($79.15 in chips) 
Seat 6: pandalapa ($62 in chips) 
Seat 7: OskarR89 ($93.94 in chips) 
Seat 8: Arystan ($59.18 in chips) 
Seat 9: Aoki42 ($69.37 in chips) 
pandalapa: posts small blind $0.25
OskarR89: posts big blind $0.50
*** HOLE CARDS ***
Dealt to matiko09 [2h Qd]
Arystan: raises $1 to $1.50
Aoki42: folds 
Ahangama: folds 
i L00K great: folds 
matiko09: folds 
HJdream: folds 
dndngod: folds 
pandalapa: folds 
OskarR89: calls $1
*** FLOP *** [6h 7s 7h]
OskarR89: checks 
Arystan: checks 
*** TURN *** [6h 7s 7h] [9c]
OskarR89: checks 
Arystan: bets $1
OskarR89: calls $1
*** RIVER *** [6h 7s 7h 9c] [Qc]
OskarR89: checks 
Arystan: bets $56.68 and is all-in
OskarR89: folds 
Uncalled bet ($56.68) returned to Arystan
Arystan collected $5.01 from pot
Arystan: doesn't show hand 
*** SUMMARY ***
Total pot $5.25 | Rake $0.24 
Board [6h 7s 7h 9c Qc]
Seat 1: Ahangama folded before Flop (didn't bet)
Seat 2: i L00K great folded before Flop (didn't bet)
Seat 3: matiko09 folded before Flop (didn't bet)
Seat 4: HJdream folded before Flop (didn't bet)
Seat 5: dndngod (button) folded before Flop (didn't bet)
Seat 6: pandalapa (small blind) folded before Flop
Seat 7: OskarR89 (big blind) folded on the River
Seat 8: Arystan collected ($5.01)
Seat 9: Aoki42 folded before Flop (didn't bet)





PokerStars Hand #148832406777:  Hold'em No Limit ($0.50/$1.00 USD) - 2016/02/15 10:39:42 CET [2016/02/15 4:39:42 ET]
Table 'Gemma II' 9-max Seat #5 is the button
Seat 1: Igor DoUrden ($175.28 in chips) 
Seat 2: WDW3 ($129.43 in chips) 
Seat 3: Venomous100% ($143.74 in chips) 
Seat 4: mycka86 ($100 in chips) 
Seat 5: PokerSash201 ($58.07 in chips) 
Seat 6: fanmtZ ($59.82 in chips) 
Seat 7: AlKatrone ($107.51 in chips) 
Seat 8: vrnMike ($140.64 in chips) 
Seat 9: matiko09 ($111.17 in chips) 
fanmtZ: posts small blind $0.50
AlKatrone: posts big blind $1
*** HOLE CARDS ***
Dealt to matiko09 [6c 5s]
vrnMike: folds 
matiko09: folds 
Igor DoUrden: folds 
WDW3: folds 
Venomous100%: folds 
mycka86: raises $1.10 to $2.10
PokerSash201: calls $2.10
fanmtZ: folds 
AlKatrone: folds 
*** FLOP *** [6d 7s 7h]
mycka86: checks 
PokerSash201: checks 
*** TURN *** [6d 7s 7h] [2d]
mycka86: checks 
PokerSash201: checks 
*** RIVER *** [6d 7s 7h 2d] [Qh]
mycka86: checks 
PokerSash201: bets $2.72
mycka86: folds 
Uncalled bet ($2.72) returned to PokerSash201
PokerSash201 collected $5.44 from pot
PokerSash201: doesn't show hand 
*** SUMMARY ***
Total pot $5.70 | Rake $0.26 
Board [6d 7s 7h 2d Qh]
Seat 1: Igor DoUrden folded before Flop (didn't bet)
Seat 2: WDW3 folded before Flop (didn't bet)
Seat 3: Venomous100% folded before Flop (didn't bet)
Seat 4: mycka86 folded on the River
Seat 5: PokerSash201 (button) collected ($5.44)
Seat 6: fanmtZ (small blind) folded before Flop
Seat 7: AlKatrone (big blind) folded before Flop
Seat 8: vrnMike folded before Flop (didn't bet)
Seat 9: matiko09 folded before Flop (didn't bet)





PokerStars Hand #148832408889:  Hold'em No Limit ($0.25/$0.50 USD) - 2016/02/15 10:39:47 CET [2016/02/15 4:39:47 ET]
Table 'Laertes II' 9-max Seat #4 is the button
Seat 1: dade33 ($94.29 in chips) 
Seat 2: beluccix ($24.21 in chips) 
Seat 3: ljryviltj ($55.41 in chips) 
Seat 4: rgar93 ($40.53 in chips) 
Seat 5: vlad11122007 ($47.50 in chips) 
Seat 6: yats87 ($50 in chips) 
Seat 7: OskarR89 ($73.27 in chips) 
Seat 8: Trent444 ($42.73 in chips) 
Seat 9: matiko09 ($50 in chips) 
vlad11122007: posts small blind $0.25
yats87: posts big blind $0.50
*** HOLE CARDS ***
Dealt to matiko09 [7s Kc]
OskarR89: folds 
Trent444: folds 
matiko09: folds 
dade33: folds 
beluccix: folds 
ljryviltj: raises $0.61 to $1.11
rgar93: folds 
vlad11122007: folds 
yats87: folds 
Uncalled bet ($0.61) returned to ljryviltj
ljryviltj collected $1.25 from pot
ljryviltj: doesn't show hand 
*** SUMMARY ***
Total pot $1.25 | Rake $0 
Seat 1: dade33 folded before Flop (didn't bet)
Seat 2: beluccix folded before Flop (didn't bet)
Seat 3: ljryviltj collected ($1.25)
Seat 4: rgar93 (button) folded before Flop (didn't bet)
Seat 5: vlad11122007 (small blind) folded before Flop
Seat 6: yats87 (big blind) folded before Flop
Seat 7: OskarR89 folded before Flop (didn't bet)
Seat 8: Trent444 folded before Flop (didn't bet)
Seat 9: matiko09 folded before Flop (didn't bet)





PokerStars Hand #148832409053:  Hold'em No Limit ($0.50/$1.00 USD) - 2016/02/15 10:39:47 CET [2016/02/15 4:39:47 ET]
Table 'Corvus III' 9-max Seat #6 is the button
Seat 5: koib88 ($61.14 in chips) 
Seat 6: WDW3 ($241.49 in chips) 
Seat 7: matiko09 ($250 in chips) 
Seat 8: redacesfull ($100 in chips) 
matiko09: posts small blind $0.50
redacesfull: posts big blind $1
goransyruvka: sits out 
koib88: posts the ante $0.20
WDW3: posts the ante $0.20
matiko09: posts the ante $0.20
redacesfull: posts the ante $0.20
*** HOLE CARDS ***
Dealt to matiko09 [7s Js]
koib88: raises $2 to $3
WDW3: folds 
matiko09: folds 
redacesfull: calls $2
*** FLOP *** [3h 2c Qc]
redacesfull: checks 
koib88: bets $6.97
redacesfull: calls $6.97
*** TURN *** [3h 2c Qc] [3c]
redacesfull: checks 
koib88: checks 
*** RIVER *** [3h 2c Qc 3c] [9s]
redacesfull: checks 
koib88: bets $10.14
redacesfull: calls $10.14
*** SHOW DOWN ***
koib88: shows [Qd Ks] (two pair, Queens and Threes)
redacesfull: mucks hand 
koib88 collected $40.02 from pot
*** SUMMARY ***
Total pot $41.52 | Rake $1.50 
Board [3h 2c Qc 3c 9s]
Seat 5: koib88 showed [Qd Ks] and won ($40.02) with two pair, Queens and Threes
Seat 6: WDW3 (button) folded before Flop (didn't bet)
Seat 7: matiko09 (small blind) folded before Flop
Seat 8: redacesfull (big blind) mucked [Jh Qh]





PokerStars Hand #148832409639:  Hold'em No Limit ($0.25/$0.50 USD) - 2016/02/15 10:39:48 CET [2016/02/15 4:39:48 ET]
Table 'Juliet' 9-max Seat #3 is the button
Seat 1: i L00K great ($96.10 in chips) 
Seat 2: Nabulasun ($20 in chips) 
Seat 3: arctur17 ($64.79 in chips) 
Seat 4: pandalapa ($55.45 in chips) 
Seat 5: dndngod ($52.08 in chips) 
Seat 6: r4mz3s ($58.02 in chips) 
Seat 7: goldpiggy ($34.90 in chips) 
Seat 8: matiko09 ($50 in chips) 
pandalapa: posts small blind $0.25
dndngod: posts big blind $0.50
carlosq1986: sits out 
*** HOLE CARDS ***
Dealt to matiko09 [5h 8d]
r4mz3s: folds 
goldpiggy: folds 
matiko09: folds 
i L00K great: folds 
Nabulasun: folds 
arctur17: folds 
pandalapa: folds 
Uncalled bet ($0.25) returned to dndngod
dndngod collected $0.50 from pot
*** SUMMARY ***
Total pot $0.50 | Rake $0 
Seat 1: i L00K great folded before Flop (didn't bet)
Seat 2: Nabulasun folded before Flop (didn't bet)
Seat 3: arctur17 (button) folded before Flop (didn't bet)
Seat 4: pandalapa (small blind) folded before Flop
Seat 5: dndngod (big blind) collected ($0.50)
Seat 6: r4mz3s folded before Flop (didn't bet)
Seat 7: goldpiggy folded before Flop (didn't bet)
Seat 8: matiko09 folded before Flop (didn't bet)





PokerStars Hand #148832412545:  Hold'em No Limit ($0.50/$1.00 USD) - 2016/02/15 10:39:56 CET [2016/02/15 4:39:56 ET]
Table 'Urania' 9-max Seat #7 is the button
Seat 1: matiko09 ($100 in chips) 
Seat 2: maxxmeister ($137.92 in chips) 
Seat 3: Priidix ($132.98 in chips) 
Seat 4: nickreason17 ($120.08 in chips) 
Seat 5: maxonplay ($176.08 in chips) 
Seat 6: vrnMike ($171.61 in chips) 
Seat 7: darren1031 ($168.24 in chips) 
Seat 8: Venomous100% ($114.71 in chips) 
Seat 9: mycka86 ($100 in chips) 
Venomous100%: posts small blind $0.50
mycka86: posts big blind $1
*** HOLE CARDS ***
Dealt to matiko09 [6d 6c]
matiko09: folds 
maxxmeister: folds 
Priidix: folds 
nickreason17: folds 
maxonplay: folds 
vrnMike: folds 
darren1031: folds 
Venomous100%: raises $2 to $3
mycka86: calls $2
*** FLOP *** [2h Ad 7d]
Venomous100%: checks 
mycka86: bets $3.50
Venomous100%: raises $7.50 to $11
mycka86: folds 
Uncalled bet ($7.50) returned to Venomous100%
Venomous100% collected $12.42 from pot
Venomous100%: doesn't show hand 
*** SUMMARY ***
Total pot $13 | Rake $0.58 
Board [2h Ad 7d]
Seat 1: matiko09 folded before Flop (didn't bet)
Seat 2: maxxmeister folded before Flop (didn't bet)
Seat 3: Priidix folded before Flop (didn't bet)
Seat 4: nickreason17 folded before Flop (didn't bet)
Seat 5: maxonplay folded before Flop (didn't bet)
Seat 6: vrnMike folded before Flop (didn't bet)
Seat 7: darren1031 (button) folded before Flop (didn't bet)
Seat 8: Venomous100% (small blind) collected ($12.42)
Seat 9: mycka86 (big blind) folded on the Flop





PokerStars Hand #148832414679:  Hold'em No Limit ($0.50/$1.00 USD) - 2016/02/15 10:40:01 CET [2016/02/15 4:40:01 ET]
Table 'Anteros' 9-max Seat #7 is the button
Seat 1: OskarR89 ($102 in chips) 
Seat 2: IHouseMusic ($107.32 in chips) 
Seat 3: nickreason17 ($100 in chips) 
Seat 5: Holm1991 ($92.82 in chips) 
Seat 7: Zoubou1983 ($93.64 in chips) 
Seat 8: matiko09 ($101.91 in chips) 
Seat 9: WDW3 ($100 in chips) 
matiko09: posts small blind $0.50
WDW3: posts big blind $1
misherei: sits out 
*** HOLE CARDS ***
Dealt to matiko09 [Qc 4h]
OskarR89: folds 
IHouseMusic: folds 
nickreason17: raises $2 to $3
Holm1991: folds 
Zoubou1983: folds 
matiko09: folds 
WDW3: folds 
Uncalled bet ($2) returned to nickreason17
nickreason17 collected $2.50 from pot
*** SUMMARY ***
Total pot $2.50 | Rake $0 
Seat 1: OskarR89 folded before Flop (didn't bet)
Seat 2: IHouseMusic folded before Flop (didn't bet)
Seat 3: nickreason17 collected ($2.50)
Seat 5: Holm1991 folded before Flop (didn't bet)
Seat 7: Zoubou1983 (button) folded before Flop (didn't bet)
Seat 8: matiko09 (small blind) folded before Flop
Seat 9: WDW3 (big blind) folded before Flop





PokerStars Hand #148832416128:  Hold'em No Limit ($0.50/$1.00 USD) - 2016/02/15 10:40:04 CET [2016/02/15 4:40:04 ET]
Table 'Saldanha' 9-max Seat #4 is the button
Seat 1: AlKatrone ($210.43 in chips) 
Seat 3: maxxmeister ($104.16 in chips) 
Seat 4: WDW3 ($100 in chips) 
Seat 5: Priidix ($137.52 in chips) 
Seat 6: huffwag ($39.06 in chips) 
Seat 7: Venomous100% ($100 in chips) 
Seat 8: matiko09 ($101.50 in chips) 
Seat 9: pompaskillad ($47.92 in chips) 
Priidix: posts small blind $0.50
huffwag: posts big blind $1
*** HOLE CARDS ***
Dealt to matiko09 [8d 9h]
Venomous100%: folds 
matiko09: folds 
pompaskillad: raises $3 to $4
AlKatrone: folds 
maxxmeister: folds 
WDW3: folds 
Priidix: folds 
huffwag: folds 
Uncalled bet ($3) returned to pompaskillad
pompaskillad collected $2.50 from pot
pompaskillad: doesn't show hand 
*** SUMMARY ***
Total pot $2.50 | Rake $0 
Seat 1: AlKatrone folded before Flop (didn't bet)
Seat 3: maxxmeister folded before Flop (didn't bet)
Seat 4: WDW3 (button) folded before Flop (didn't bet)
Seat 5: Priidix (small blind) folded before Flop
Seat 6: huffwag (big blind) folded before Flop
Seat 7: Venomous100% folded before Flop (didn't bet)
Seat 8: matiko09 folded before Flop (didn't bet)
Seat 9: pompaskillad collected ($2.50)





PokerStars Hand #148832418146:  Hold'em No Limit (€0.25/€0.50 EUR) - 2016/02/15 10:40:09 CET [2016/02/15 4:40:09 ET]
Table 'Walinskia II' 9-max Seat #9 is the button
Seat 1: ljryviltj (€49.50 in chips) 
Seat 2: yats87 (€50 in chips) 
Seat 4: Otsime (€45.59 in chips) 
Seat 5: vano7777 (€56.04 in chips) 
Seat 6: 50CandyJoe (€50.75 in chips) 
Seat 8: matiko09 (€50 in chips) 
Seat 9: stevevg84 (€34.41 in chips) 
ljryviltj: posts small blind €0.25
yats87: posts big blind €0.50
beluccix: sits out 
*** HOLE CARDS ***
Dealt to matiko09 [3s 8d]
Otsime: calls €0.50
vano7777: calls €0.50
50CandyJoe: raises €2 to €2.50
matiko09: folds 
stevevg84: folds 
ljryviltj: folds 
yats87: folds 
Otsime: calls €2
vano7777: calls €2
*** FLOP *** [Qc Jc 4h]
Otsime: bets €0.50
vano7777: calls €0.50
50CandyJoe: raises €6 to €6.50
Otsime: folds 
vano7777: calls €6
*** TURN *** [Qc Jc 4h] [2d]
vano7777: checks 
50CandyJoe: bets €13
vano7777: folds 
Uncalled bet (€13) returned to 50CandyJoe
50CandyJoe collected €20.77 from pot
50CandyJoe: doesn't show hand 
*** SUMMARY ***
Total pot €21.75 | Rake €0.98 
Board [Qc Jc 4h 2d]
Seat 1: ljryviltj (small blind) folded before Flop
Seat 2: yats87 (big blind) folded before Flop
Seat 4: Otsime folded on the Flop
Seat 5: vano7777 folded on the Turn
Seat 6: 50CandyJoe collected (€20.77)
Seat 8: matiko09 folded before Flop (didn't bet)
Seat 9: stevevg84 (button) folded before Flop (didn't bet)





PokerStars Hand #148832418780:  Hold'em No Limit ($0.50/$1.00 USD) - 2016/02/15 10:40:11 CET [2016/02/15 4:40:11 ET]
Table 'Praecipua' 9-max Seat #3 is the button
Seat 1: matiko09 ($124.07 in chips) 
Seat 2: vrnMike ($113.67 in chips) 
Seat 3: Venomous100% ($113.03 in chips) 
Seat 4: Priidix ($119.78 in chips) 
Seat 5: huffwag ($44.06 in chips) 
Seat 7: maxxmeister ($181.27 in chips) 
Seat 8: Kalesmash08 ($74.31 in chips) 
Seat 9: AlKatrone ($106.52 in chips) 
Priidix: posts small blind $0.50
huffwag: posts big blind $1
mycka86: sits out 
*** HOLE CARDS ***
Dealt to matiko09 [6d Qh]
maxxmeister: folds 
Kalesmash08: folds 
AlKatrone: folds 
matiko09: folds 
vrnMike: folds 
Venomous100%: folds 
Priidix: raises $1.60 to $2.60
huffwag: folds 
Uncalled bet ($1.60) returned to Priidix
Priidix collected $2 from pot
Priidix: doesn't show hand 
*** SUMMARY ***
Total pot $2 | Rake $0 
Seat 1: matiko09 folded before Flop (didn't bet)
Seat 2: vrnMike folded before Flop (didn't bet)
Seat 3: Venomous100% (button) folded before Flop (didn't bet)
Seat 4: Priidix (small blind) collected ($2)
Seat 5: huffwag (big blind) folded before Flop
Seat 7: maxxmeister folded before Flop (didn't bet)
Seat 8: Kalesmash08 folded before Flop (didn't bet)
Seat 9: AlKatrone folded before Flop (didn't bet)





PokerStars Hand #148832420458:  Hold'em No Limit ($0.25/$0.50 USD) - 2016/02/15 10:40:15 CET [2016/02/15 4:40:15 ET]
Table 'Margot II' 9-max Seat #3 is the button
Seat 1: i L00K great ($52.68 in chips) 
Seat 2: matiko09 ($50 in chips) 
Seat 3: beluccix ($34.80 in chips) 
Seat 4: r4mz3s ($50 in chips) 
Seat 5: carlosq1986 ($63.38 in chips) 
Seat 6: OskarR89 ($51.15 in chips) 
Seat 7: Vedpapa ($102.89 in chips) 
Seat 8: Aoki42 ($93.95 in chips) 
Seat 9: Haporuu ($21.75 in chips) 
r4mz3s: posts small blind $0.25
carlosq1986: posts big blind $0.50
*** HOLE CARDS ***
Dealt to matiko09 [2c 8d]
OskarR89: folds 
Vedpapa: folds 
Aoki42: folds 
Haporuu: folds 
i L00K great: raises $1 to $1.50
matiko09: folds 
beluccix: folds 
r4mz3s: folds 
carlosq1986: folds 
Uncalled bet ($1) returned to i L00K great
i L00K great collected $1.25 from pot
i L00K great: doesn't show hand 
*** SUMMARY ***
Total pot $1.25 | Rake $0 
Seat 1: i L00K great collected ($1.25)
Seat 2: matiko09 folded before Flop (didn't bet)
Seat 3: beluccix (button) folded before Flop (didn't bet)
Seat 4: r4mz3s (small blind) folded before Flop
Seat 5: carlosq1986 (big blind) folded before Flop
Seat 6: OskarR89 folded before Flop (didn't bet)
Seat 7: Vedpapa folded before Flop (didn't bet)
Seat 8: Aoki42 folded before Flop (didn't bet)
Seat 9: Haporuu folded before Flop (didn't bet)





PokerStars Hand #148832421088:  Hold'em No Limit ($0.25/$0.50 USD) - 2016/02/15 10:40:17 CET [2016/02/15 4:40:17 ET]
Table 'Juliet' 9-max Seat #4 is the button
Seat 1: i L00K great ($96.10 in chips) 
Seat 2: Nabulasun ($20 in chips) 
Seat 3: arctur17 ($64.79 in chips) 
Seat 4: pandalapa ($55.20 in chips) 
Seat 5: dndngod ($52.33 in chips) 
Seat 6: r4mz3s ($58.02 in chips) 
Seat 7: goldpiggy ($34.90 in chips) 
Seat 8: matiko09 ($50 in chips) 
dndngod: posts small blind $0.25
r4mz3s: posts big blind $0.50
carlosq1986: sits out 
*** HOLE CARDS ***
Dealt to matiko09 [9d Kc]
goldpiggy: folds 
matiko09: folds 
i L00K great: raises $1 to $1.50
Nabulasun: folds 
arctur17: folds 
pandalapa: folds 
dndngod: folds 
r4mz3s: folds 
Uncalled bet ($1) returned to i L00K great
i L00K great collected $1.25 from pot
i L00K great: doesn't show hand 
*** SUMMARY ***
Total pot $1.25 | Rake $0 
Seat 1: i L00K great collected ($1.25)
Seat 2: Nabulasun folded before Flop (didn't bet)
Seat 3: arctur17 folded before Flop (didn't bet)
Seat 4: pandalapa (button) folded before Flop (didn't bet)
Seat 5: dndngod (small blind) folded before Flop
Seat 6: r4mz3s (big blind) folded before Flop
Seat 7: goldpiggy folded before Flop (didn't bet)
Seat 8: matiko09 folded before Flop (didn't bet)





PokerStars Hand #148832422595:  Hold'em No Limit ($0.25/$0.50 USD) - 2016/02/15 10:40:20 CET [2016/02/15 4:40:20 ET]
Table 'Vesta II' 9-max Seat #6 is the button
Seat 1: Ahangama ($56.65 in chips) 
Seat 2: i L00K great ($54.12 in chips) 
Seat 3: matiko09 ($68.65 in chips) 
Seat 4: HJdream ($48.11 in chips) 
Seat 5: dndngod ($79.15 in chips) 
Seat 6: pandalapa ($61.75 in chips) 
Seat 7: OskarR89 ($91.44 in chips) 
Seat 8: Arystan ($61.69 in chips) 
Seat 9: Aoki42 ($69.37 in chips) 
OskarR89: posts small blind $0.25
Arystan: posts big blind $0.50
*** HOLE CARDS ***
Dealt to matiko09 [Ks Tc]
Aoki42: folds 
Ahangama: folds 
i L00K great: folds 
matiko09: raises $1 to $1.50
HJdream: folds 
dndngod: folds 
pandalapa: calls $1.50
OskarR89: folds 
Arystan: calls $1
*** FLOP *** [6s 9h Js]
Arystan: checks 
matiko09: checks 
pandalapa: bets $3.02
Arystan: raises $5.98 to $9
matiko09: folds 
pandalapa: folds 
Uncalled bet ($5.98) returned to Arystan
Arystan collected $10.30 from pot
Arystan: doesn't show hand 
*** SUMMARY ***
Total pot $10.79 | Rake $0.49 
Board [6s 9h Js]
Seat 1: Ahangama folded before Flop (didn't bet)
Seat 2: i L00K great folded before Flop (didn't bet)
Seat 3: matiko09 folded on the Flop
Seat 4: HJdream folded before Flop (didn't bet)
Seat 5: dndngod folded before Flop (didn't bet)
Seat 6: pandalapa (button) folded on the Flop
Seat 7: OskarR89 (small blind) folded before Flop
Seat 8: Arystan (big blind) collected ($10.30)
Seat 9: Aoki42 folded before Flop (didn't bet)





PokerStars Hand #148832422995:  Hold'em No Limit ($0.25/$0.50 USD) - 2016/02/15 10:40:21 CET [2016/02/15 4:40:21 ET]
Table 'Laertes II' 9-max Seat #5 is the button
Seat 1: dade33 ($94.29 in chips) 
Seat 2: beluccix ($24.21 in chips) 
Seat 3: ljryviltj ($56.16 in chips) 
Seat 4: rgar93 ($40.53 in chips) 
Seat 5: vlad11122007 ($50 in chips) 
Seat 6: yats87 ($50 in chips) 
Seat 7: OskarR89 ($73.27 in chips) 
Seat 8: Trent444 ($42.73 in chips) 
Seat 9: matiko09 ($50 in chips) 
yats87: posts small blind $0.25
OskarR89: posts big blind $0.50
*** HOLE CARDS ***
Dealt to matiko09 [9c Tc]
Trent444: folds 
matiko09: raises $1 to $1.50
dade33: folds 
beluccix: raises $2.38 to $3.88
ljryviltj: folds 
rgar93: folds 
vlad11122007: folds 
yats87: folds 
OskarR89: folds 
matiko09: folds 
Uncalled bet ($2.38) returned to beluccix
beluccix collected $3.75 from pot
beluccix: doesn't show hand 
*** SUMMARY ***
Total pot $3.75 | Rake $0 
Seat 1: dade33 folded before Flop (didn't bet)
Seat 2: beluccix collected ($3.75)
Seat 3: ljryviltj folded before Flop (didn't bet)
Seat 4: rgar93 folded before Flop (didn't bet)
Seat 5: vlad11122007 (button) folded before Flop (didn't bet)
Seat 6: yats87 (small blind) folded before Flop
Seat 7: OskarR89 (big blind) folded before Flop
Seat 8: Trent444 folded before Flop (didn't bet)
Seat 9: matiko09 folded before Flop





PokerStars Hand #148832424009:  Hold'em No Limit ($0.50/$1.00 USD) - 2016/02/15 10:40:23 CET [2016/02/15 4:40:23 ET]
Table 'Corvus III' 9-max Seat #7 is the button
Seat 4: goransyruvka ($200 in chips) 
Seat 5: koib88 ($80.85 in chips) 
Seat 6: WDW3 ($241.29 in chips) 
Seat 7: matiko09 ($249.30 in chips) 
Seat 8: redacesfull ($100 in chips) 
redacesfull: posts small blind $0.50
goransyruvka: posts big blind $1
goransyruvka: posts the ante $0.20
koib88: posts the ante $0.20
WDW3: posts the ante $0.20
matiko09: posts the ante $0.20
redacesfull: posts the ante $0.20
*** HOLE CARDS ***
Dealt to matiko09 [Ks Ah]
koib88: folds 
WDW3: folds 
matiko09: raises $2 to $3
redacesfull: raises $8 to $11
goransyruvka: folds 
matiko09: raises $12 to $23
redacesfull: folds 
Uncalled bet ($12) returned to matiko09
matiko09 collected $24 from pot
matiko09: doesn't show hand 
*** SUMMARY ***
Total pot $24 | Rake $0 
Seat 4: goransyruvka (big blind) folded before Flop
Seat 5: koib88 folded before Flop (didn't bet)
Seat 6: WDW3 folded before Flop (didn't bet)
Seat 7: matiko09 (button) collected ($24)
Seat 8: redacesfull (small blind) folded before Flop





PokerStars Hand #148832425502:  Hold'em No Limit ($0.50/$1.00 USD) - 2016/02/15 10:40:27 CET [2016/02/15 4:40:27 ET]
Table 'Anteros' 9-max Seat #8 is the button
Seat 1: OskarR89 ($102 in chips) 
Seat 2: IHouseMusic ($107.32 in chips) 
Seat 3: nickreason17 ($101.50 in chips) 
Seat 5: Holm1991 ($92.82 in chips) 
Seat 7: Zoubou1983 ($93.64 in chips) 
Seat 8: matiko09 ($101.41 in chips) 
Seat 9: WDW3 ($100 in chips) 
WDW3: posts small blind $0.50
OskarR89: posts big blind $1
misherei: sits out 
*** HOLE CARDS ***
Dealt to matiko09 [8c Jd]
IHouseMusic: folds 
nickreason17: folds 
Holm1991: folds 
Zoubou1983: folds 
matiko09: folds 
WDW3: folds 
Uncalled bet ($0.50) returned to OskarR89
OskarR89 collected $1 from pot
OskarR89: doesn't show hand 
*** SUMMARY ***
Total pot $1 | Rake $0 
Seat 1: OskarR89 (big blind) collected ($1)
Seat 2: IHouseMusic folded before Flop (didn't bet)
Seat 3: nickreason17 folded before Flop (didn't bet)
Seat 5: Holm1991 folded before Flop (didn't bet)
Seat 7: Zoubou1983 folded before Flop (didn't bet)
Seat 8: matiko09 (button) folded before Flop (didn't bet)
Seat 9: WDW3 (small blind) folded before Flop





PokerStars Hand #148832430733:  Hold'em No Limit ($0.50/$1.00 USD) - 2016/02/15 10:40:40 CET [2016/02/15 4:40:40 ET]
Table 'Praecipua' 9-max Seat #4 is the button
Seat 1: matiko09 ($124.07 in chips) 
Seat 2: vrnMike ($113.67 in chips) 
Seat 3: Venomous100% ($113.03 in chips) 
Seat 4: Priidix ($120.78 in chips) 
Seat 5: huffwag ($43.06 in chips) 
Seat 6: mycka86 ($100 in chips) 
Seat 7: maxxmeister ($181.27 in chips) 
Seat 8: Kalesmash08 ($74.31 in chips) 
Seat 9: AlKatrone ($106.52 in chips) 
huffwag: posts small blind $0.50
mycka86: posts big blind $1
*** HOLE CARDS ***
Dealt to matiko09 [2c 3d]
maxxmeister: raises $2.50 to $3.50
Kalesmash08: folds 
AlKatrone: folds 
matiko09: folds 
vrnMike: folds 
Venomous100%: folds 
Priidix: folds 
huffwag: folds 
mycka86: folds 
Uncalled bet ($2.50) returned to maxxmeister
maxxmeister collected $2.50 from pot
maxxmeister: doesn't show hand 
*** SUMMARY ***
Total pot $2.50 | Rake $0 
Seat 1: matiko09 folded before Flop (didn't bet)
Seat 2: vrnMike folded before Flop (didn't bet)
Seat 3: Venomous100% folded before Flop (didn't bet)
Seat 4: Priidix (button) folded before Flop (didn't bet)
Seat 5: huffwag (small blind) folded before Flop
Seat 6: mycka86 (big blind) folded before Flop
Seat 7: maxxmeister collected ($2.50)
Seat 8: Kalesmash08 folded before Flop (didn't bet)
Seat 9: AlKatrone folded before Flop (didn't bet)





PokerStars Hand #148832433108:  Hold'em No Limit ($0.25/$0.50 USD) - 2016/02/15 10:40:46 CET [2016/02/15 4:40:46 ET]
Table 'Margot II' 9-max Seat #4 is the button
Seat 1: i L00K great ($53.43 in chips) 
Seat 2: matiko09 ($50 in chips) 
Seat 3: beluccix ($34.80 in chips) 
Seat 4: r4mz3s ($50 in chips) 
Seat 5: carlosq1986 ($62.88 in chips) 
Seat 6: OskarR89 ($51.15 in chips) 
Seat 7: Vedpapa ($102.89 in chips) 
Seat 8: Aoki42 ($93.95 in chips) 
Seat 9: Haporuu ($21.75 in chips) 
carlosq1986: posts small blind $0.25
OskarR89: posts big blind $0.50
*** HOLE CARDS ***
Dealt to matiko09 [Kd 9c]
Vedpapa has timed out
Vedpapa: folds 
Aoki42: folds 
Haporuu: folds 
i L00K great: folds 
matiko09: folds 
beluccix: folds 
r4mz3s: folds 
carlosq1986: folds 
Uncalled bet ($0.25) returned to OskarR89
OskarR89 collected $0.50 from pot
OskarR89: doesn't show hand 
*** SUMMARY ***
Total pot $0.50 | Rake $0 
Seat 1: i L00K great folded before Flop (didn't bet)
Seat 2: matiko09 folded before Flop (didn't bet)
Seat 3: beluccix folded before Flop (didn't bet)
Seat 4: r4mz3s (button) folded before Flop (didn't bet)
Seat 5: carlosq1986 (small blind) folded before Flop
Seat 6: OskarR89 (big blind) collected ($0.50)
Seat 7: Vedpapa folded before Flop (didn't bet)
Seat 8: Aoki42 folded before Flop (didn't bet)
Seat 9: Haporuu folded before Flop (didn't bet)





PokerStars Hand #148832433487:  Hold'em No Limit ($0.50/$1.00 USD) - 2016/02/15 10:40:46 CET [2016/02/15 4:40:46 ET]
Table 'Vibeke' 9-max Seat #6 is the button
Seat 1: Venomous100% ($195.91 in chips) 
Seat 2: Priidix ($143.41 in chips) 
Seat 3: matiko09 ($113.88 in chips) 
Seat 4: fanmtZ ($42.32 in chips) 
Seat 5: vrnMike ($205.89 in chips) 
Seat 6: AlKatrone ($100 in chips) 
Seat 7: ackle1 ($79.54 in chips) 
Seat 8: IHouseMusic ($100 in chips) 
ackle1: posts small blind $0.50
IHouseMusic: posts big blind $1
WDW3: sits out 
*** HOLE CARDS ***
Dealt to matiko09 [5h Ks]
Venomous100%: folds 
Priidix: folds 
matiko09: folds 
fanmtZ: raises $1.38 to $2.38
vrnMike: folds 
AlKatrone: folds 
ackle1: folds 
IHouseMusic: folds 
Uncalled bet ($1.38) returned to fanmtZ
fanmtZ collected $2.50 from pot
fanmtZ: doesn't show hand 
*** SUMMARY ***
Total pot $2.50 | Rake $0 
Seat 1: Venomous100% folded before Flop (didn't bet)
Seat 2: Priidix folded before Flop (didn't bet)
Seat 3: matiko09 folded before Flop (didn't bet)
Seat 4: fanmtZ collected ($2.50)
Seat 5: vrnMike folded before Flop (didn't bet)
Seat 6: AlKatrone (button) folded before Flop (didn't bet)
Seat 7: ackle1 (small blind) folded before Flop
Seat 8: IHouseMusic (big blind) folded before Flop





PokerStars Hand #148832436380:  Hold'em No Limit ($0.50/$1.00 USD) - 2016/02/15 10:40:53 CET [2016/02/15 4:40:53 ET]
Table 'Anteros' 9-max Seat #9 is the button
Seat 1: OskarR89 ($102.50 in chips) 
Seat 2: IHouseMusic ($107.32 in chips) 
Seat 3: nickreason17 ($101.50 in chips) 
Seat 5: Holm1991 ($92.82 in chips) 
Seat 7: Zoubou1983 ($93.64 in chips) 
Seat 8: matiko09 ($101.41 in chips) 
Seat 9: WDW3 ($100 in chips) 
OskarR89: posts small blind $0.50
IHouseMusic: posts big blind $1
misherei: sits out 
*** HOLE CARDS ***
Dealt to matiko09 [Jc 7d]
nickreason17: folds 
Holm1991: folds 
Zoubou1983: folds 
matiko09: folds 
WDW3: folds 
OskarR89: raises $1 to $2
IHouseMusic: calls $1
*** FLOP *** [6c Kd Js]
OskarR89: checks 
IHouseMusic: bets $2.68
OskarR89: folds 
Uncalled bet ($2.68) returned to IHouseMusic
IHouseMusic collected $3.82 from pot
IHouseMusic: doesn't show hand 
*** SUMMARY ***
Total pot $4 | Rake $0.18 
Board [6c Kd Js]
Seat 1: OskarR89 (small blind) folded on the Flop
Seat 2: IHouseMusic (big blind) collected ($3.82)
Seat 3: nickreason17 folded before Flop (didn't bet)
Seat 5: Holm1991 folded before Flop (didn't bet)
Seat 7: Zoubou1983 folded before Flop (didn't bet)
Seat 8: matiko09 folded before Flop (didn't bet)
Seat 9: WDW3 (button) folded before Flop (didn't bet)





PokerStars Hand #148832437353:  Hold'em No Limit ($0.50/$1.00 USD) - 2016/02/15 10:40:56 CET [2016/02/15 4:40:56 ET]
Table 'Urania' 9-max Seat #8 is the button
Seat 1: matiko09 ($100 in chips) 
Seat 2: maxxmeister ($137.92 in chips) 
Seat 3: Priidix ($132.98 in chips) 
Seat 4: nickreason17 ($120.08 in chips) 
Seat 5: maxonplay ($176.08 in chips) 
Seat 6: vrnMike ($171.61 in chips) 
Seat 7: darren1031 ($168.24 in chips) 
Seat 8: Venomous100% ($120.63 in chips) 
Seat 9: mycka86 ($100 in chips) 
mycka86: posts small blind $0.50
matiko09: posts big blind $1
*** HOLE CARDS ***
Dealt to matiko09 [2s 9d]
maxxmeister: raises $2.50 to $3.50
Priidix: folds 
nickreason17: folds 
maxonplay: folds 
vrnMike: folds 
darren1031: folds 
Venomous100%: folds 
mycka86: folds 
matiko09: folds 
Uncalled bet ($2.50) returned to maxxmeister
maxxmeister collected $2.50 from pot
maxxmeister: doesn't show hand 
*** SUMMARY ***
Total pot $2.50 | Rake $0 
Seat 1: matiko09 (big blind) folded before Flop
Seat 2: maxxmeister collected ($2.50)
Seat 3: Priidix folded before Flop (didn't bet)
Seat 4: nickreason17 folded before Flop (didn't bet)
Seat 5: maxonplay folded before Flop (didn't bet)
Seat 6: vrnMike folded before Flop (didn't bet)
Seat 7: darren1031 folded before Flop (didn't bet)
Seat 8: Venomous100% (button) folded before Flop (didn't bet)
Seat 9: mycka86 (small blind) folded before Flop





PokerStars Hand #148832441792:  Hold'em No Limit ($0.50/$1.00 USD) - 2016/02/15 10:41:06 CET [2016/02/15 4:41:06 ET]
Table 'Corvus III' 9-max Seat #8 is the button
Seat 4: goransyruvka ($198.80 in chips) 
Seat 6: WDW3 ($241.09 in chips) 
Seat 7: matiko09 ($262.10 in chips) 
Seat 8: redacesfull ($100 in chips) 
goransyruvka: posts small blind $0.50
WDW3: posts big blind $1
goransyruvka: posts the ante $0.20
WDW3: posts the ante $0.20
matiko09: posts the ante $0.20
redacesfull: posts the ante $0.20
*** HOLE CARDS ***
Dealt to matiko09 [Kd 7d]
matiko09: folds 
redacesfull: raises $1.12 to $2.12
goransyruvka: calls $1.62
WDW3: folds 
*** FLOP *** [Th 2h 8h]
goransyruvka: bets $2.88
redacesfull: folds 
Uncalled bet ($2.88) returned to goransyruvka
goransyruvka collected $5.77 from pot
goransyruvka: doesn't show hand 
*** SUMMARY ***
Total pot $6.04 | Rake $0.27 
Board [Th 2h 8h]
Seat 4: goransyruvka (small blind) collected ($5.77)
Seat 6: WDW3 (big blind) folded before Flop
Seat 7: matiko09 folded before Flop (didn't bet)
Seat 8: redacesfull (button) folded on the Flop





PokerStars Hand #148832441557:  Hold'em No Limit ($0.50/$1.00 USD) - 2016/02/15 10:41:06 CET [2016/02/15 4:41:06 ET]
Table 'Gemma II' 9-max Seat #6 is the button
Seat 1: Igor DoUrden ($175.28 in chips) 
Seat 2: WDW3 ($129.43 in chips) 
Seat 3: Venomous100% ($143.74 in chips) 
Seat 4: mycka86 ($100 in chips) 
Seat 5: PokerSash201 ($61.41 in chips) 
Seat 6: fanmtZ ($59.32 in chips) 
Seat 7: AlKatrone ($106.51 in chips) 
Seat 8: vrnMike ($140.64 in chips) 
Seat 9: matiko09 ($111.17 in chips) 
AlKatrone: posts small blind $0.50
vrnMike: posts big blind $1
*** HOLE CARDS ***
Dealt to matiko09 [6h 7c]
matiko09: folds 
Igor DoUrden: folds 
WDW3: folds 
Venomous100%: folds 
mycka86: folds 
PokerSash201: folds 
fanmtZ: raises $1.02 to $2.02
AlKatrone: folds 
vrnMike: raises $3.98 to $6
fanmtZ: calls $3.98
*** FLOP *** [5c 2d 9s]
vrnMike: checks 
fanmtZ: checks 
*** TURN *** [5c 2d 9s] [Jd]
vrnMike: bets $8
fanmtZ: calls $8
*** RIVER *** [5c 2d 9s Jd] [8h]
vrnMike: bets $16
fanmtZ: calls $16
*** SHOW DOWN ***
vrnMike: shows [Ah Js] (a pair of Jacks)
fanmtZ: mucks hand 
vrnMike collected $57.78 from pot
*** SUMMARY ***
Total pot $60.50 | Rake $2.72 
Board [5c 2d 9s Jd 8h]
Seat 1: Igor DoUrden folded before Flop (didn't bet)
Seat 2: WDW3 folded before Flop (didn't bet)
Seat 3: Venomous100% folded before Flop (didn't bet)
Seat 4: mycka86 folded before Flop (didn't bet)
Seat 5: PokerSash201 folded before Flop (didn't bet)
Seat 6: fanmtZ (button) mucked [Jh Qh]
Seat 7: AlKatrone (small blind) folded before Flop
Seat 8: vrnMike (big blind) showed [Ah Js] and won ($57.78) with a pair of Jacks
Seat 9: matiko09 folded before Flop (didn't bet)





PokerStars Hand #148832443170:  Hold'em No Limit ($0.25/$0.50 USD) - 2016/02/15 10:41:10 CET [2016/02/15 4:41:10 ET]
Table 'Vesta II' 9-max Seat #7 is the button
Seat 1: Ahangama ($56.65 in chips) 
Seat 2: i L00K great ($54.12 in chips) 
Seat 3: matiko09 ($67.15 in chips) 
Seat 4: HJdream ($48.11 in chips) 
Seat 5: dndngod ($79.15 in chips) 
Seat 6: pandalapa ($57.23 in chips) 
Seat 7: OskarR89 ($91.19 in chips) 
Seat 8: Arystan ($67.47 in chips) 
Seat 9: Aoki42 ($69.37 in chips) 
Arystan: posts small blind $0.25
Aoki42: posts big blind $0.50
*** HOLE CARDS ***
Dealt to matiko09 [2c 3h]
Ahangama: folds 
i L00K great: folds 
matiko09: folds 
HJdream: folds 
dndngod: folds 
pandalapa: folds 
OskarR89: raises $0.50 to $1
Arystan: calls $0.75
Aoki42: calls $0.50
*** FLOP *** [Tc Kc Qc]
Arystan: bets $1.43
Aoki42: folds 
OskarR89: calls $1.43
*** TURN *** [Tc Kc Qc] [3c]
Arystan: bets $2.80
OskarR89: calls $2.80
*** RIVER *** [Tc Kc Qc 3c] [8s]
Arystan: bets $7.50
OskarR89: calls $7.50
*** SHOW DOWN ***
Arystan: shows [5s 6c] (a flush, King high)
OskarR89: shows [Kd 9c] (a flush, King high - Nine higher)
OskarR89 collected $25.27 from pot
*** SUMMARY ***
Total pot $26.46 | Rake $1.19 
Board [Tc Kc Qc 3c 8s]
Seat 1: Ahangama folded before Flop (didn't bet)
Seat 2: i L00K great folded before Flop (didn't bet)
Seat 3: matiko09 folded before Flop (didn't bet)
Seat 4: HJdream folded before Flop (didn't bet)
Seat 5: dndngod folded before Flop (didn't bet)
Seat 6: pandalapa folded before Flop (didn't bet)
Seat 7: OskarR89 (button) showed [Kd 9c] and won ($25.27) with a flush, King high
Seat 8: Arystan (small blind) showed [5s 6c] and lost with a flush, King high
Seat 9: Aoki42 (big blind) folded on the Flop





PokerStars Hand #148832446558:  Hold'em No Limit ($0.25/$0.50 USD) - 2016/02/15 10:41:18 CET [2016/02/15 4:41:18 ET]
Table 'Laertes II' 9-max Seat #6 is the button
Seat 1: dade33 ($94.29 in chips) 
Seat 2: beluccix ($26.46 in chips) 
Seat 3: ljryviltj ($56.16 in chips) 
Seat 4: rgar93 ($40.53 in chips) 
Seat 5: vlad11122007 ($50 in chips) 
Seat 6: yats87 ($50 in chips) 
Seat 7: OskarR89 ($72.77 in chips) 
Seat 8: Trent444 ($42.73 in chips) 
Seat 9: matiko09 ($50 in chips) 
OskarR89: posts small blind $0.25
Trent444: posts big blind $0.50
*** HOLE CARDS ***
Dealt to matiko09 [2h 2d]
matiko09: raises $1 to $1.50
dade33: folds 
beluccix: raises $2.38 to $3.88
ljryviltj: folds 
rgar93: folds 
vlad11122007: raises $2.62 to $6.50
yats87: folds 
OskarR89: folds 
Trent444: folds 
matiko09: folds 
beluccix: folds 
Uncalled bet ($2.62) returned to vlad11122007
vlad11122007 collected $10.01 from pot
vlad11122007: doesn't show hand 
*** SUMMARY ***
Total pot $10.01 | Rake $0 
Seat 1: dade33 folded before Flop (didn't bet)
Seat 2: beluccix folded before Flop
Seat 3: ljryviltj folded before Flop (didn't bet)
Seat 4: rgar93 folded before Flop (didn't bet)
Seat 5: vlad11122007 collected ($10.01)
Seat 6: yats87 (button) folded before Flop (didn't bet)
Seat 7: OskarR89 (small blind) folded before Flop
Seat 8: Trent444 (big blind) folded before Flop
Seat 9: matiko09 folded before Flop





PokerStars Hand #148832449770:  Hold'em No Limit ($0.50/$1.00 USD) - 2016/02/15 10:41:26 CET [2016/02/15 4:41:26 ET]
Table 'Vibeke' 9-max Seat #7 is the button
Seat 1: Venomous100% ($195.91 in chips) 
Seat 2: Priidix ($143.41 in chips) 
Seat 3: matiko09 ($113.88 in chips) 
Seat 4: fanmtZ ($43.82 in chips) 
Seat 5: vrnMike ($205.89 in chips) 
Seat 6: AlKatrone ($100 in chips) 
Seat 7: ackle1 ($79.04 in chips) 
Seat 8: IHouseMusic ($100 in chips) 
Seat 9: WDW3 ($100 in chips) 
IHouseMusic: posts small blind $0.50
WDW3: posts big blind $1
*** HOLE CARDS ***
Dealt to matiko09 [7d 5d]
Venomous100%: folds 
Priidix: folds 
matiko09: folds 
fanmtZ: folds 
vrnMike: raises $2 to $3
AlKatrone: folds 
ackle1: folds 
IHouseMusic: raises $6 to $9
WDW3: folds 
vrnMike: folds 
Uncalled bet ($6) returned to IHouseMusic
IHouseMusic collected $7 from pot
IHouseMusic: doesn't show hand 
*** SUMMARY ***
Total pot $7 | Rake $0 
Seat 1: Venomous100% folded before Flop (didn't bet)
Seat 2: Priidix folded before Flop (didn't bet)
Seat 3: matiko09 folded before Flop (didn't bet)
Seat 4: fanmtZ folded before Flop (didn't bet)
Seat 5: vrnMike folded before Flop
Seat 6: AlKatrone folded before Flop (didn't bet)
Seat 7: ackle1 (button) folded before Flop (didn't bet)
Seat 8: IHouseMusic (small blind) collected ($7)
Seat 9: WDW3 (big blind) folded before Flop





PokerStars Hand #148832450537:  Hold'em No Limit ($0.50/$1.00 USD) - 2016/02/15 10:41:28 CET [2016/02/15 4:41:28 ET]
Table 'Praecipua' 9-max Seat #5 is the button
Seat 1: matiko09 ($124.07 in chips) 
Seat 2: vrnMike ($113.67 in chips) 
Seat 3: Venomous100% ($113.03 in chips) 
Seat 4: Priidix ($120.78 in chips) 
Seat 5: huffwag ($42.56 in chips) 
Seat 6: mycka86 ($100 in chips) 
Seat 7: maxxmeister ($182.77 in chips) 
Seat 8: Kalesmash08 ($74.31 in chips) 
Seat 9: AlKatrone ($106.52 in chips) 
mycka86: posts small blind $0.50
maxxmeister: posts big blind $1
*** HOLE CARDS ***
Dealt to matiko09 [8d 4d]
Kalesmash08: raises $1 to $2
AlKatrone: folds 
matiko09: folds 
vrnMike: folds 
Venomous100%: folds 
Priidix: folds 
huffwag: folds 
mycka86: folds 
maxxmeister: folds 
Uncalled bet ($1) returned to Kalesmash08
Kalesmash08 collected $2.50 from pot
*** SUMMARY ***
Total pot $2.50 | Rake $0 
Seat 1: matiko09 folded before Flop (didn't bet)
Seat 2: vrnMike folded before Flop (didn't bet)
Seat 3: Venomous100% folded before Flop (didn't bet)
Seat 4: Priidix folded before Flop (didn't bet)
Seat 5: huffwag (button) folded before Flop (didn't bet)
Seat 6: mycka86 (small blind) folded before Flop
Seat 7: maxxmeister (big blind) folded before Flop
Seat 8: Kalesmash08 collected ($2.50)
Seat 9: AlKatrone folded before Flop (didn't bet)





PokerStars Hand #148832450672:  Hold'em No Limit ($0.50/$1.00 USD) - 2016/02/15 10:41:28 CET [2016/02/15 4:41:28 ET]
Table 'Anteros' 9-max Seat #1 is the button
Seat 1: OskarR89 ($100.50 in chips) 
Seat 2: IHouseMusic ($109.14 in chips) 
Seat 4: misherei ($100 in chips) 
Seat 5: Holm1991 ($92.82 in chips) 
Seat 7: Zoubou1983 ($93.64 in chips) 
Seat 8: matiko09 ($101.41 in chips) 
Seat 9: WDW3 ($100 in chips) 
IHouseMusic: posts small blind $0.50
nickreason17: is sitting out 
nickreason17 leaves the table
misherei: posts big blind $1
*** HOLE CARDS ***
Dealt to matiko09 [9c 3d]
fanmtZ joins the table at seat #3 
Holm1991: folds 
Zoubou1983: calls $1
matiko09: folds 
WDW3: folds 
OskarR89: calls $1
IHouseMusic: raises $4 to $5
misherei: calls $4
Zoubou1983: calls $4
OskarR89: folds 
*** FLOP *** [Ah Jh Jd]
IHouseMusic: checks 
misherei: checks 
Zoubou1983: bets $8
IHouseMusic: folds 
misherei: calls $8
*** TURN *** [Ah Jh Jd] [Kd]
misherei: checks 
Zoubou1983: bets $15
misherei: calls $15
*** RIVER *** [Ah Jh Jd Kd] [8c]
misherei: checks 
Zoubou1983: bets $21
misherei: raises $51 to $72 and is all-in
Zoubou1983: calls $44.64 and is all-in
Uncalled bet ($6.36) returned to misherei
*** SHOW DOWN ***
misherei: shows [Ad Js] (a full house, Jacks full of Aces)
Zoubou1983: shows [As 4s] (two pair, Aces and Jacks)
misherei collected $190.48 from pot
*** SUMMARY ***
Total pot $193.28 | Rake $2.80 
Board [Ah Jh Jd Kd 8c]
Seat 1: OskarR89 (button) folded before Flop
Seat 2: IHouseMusic (small blind) folded on the Flop
Seat 4: misherei (big blind) showed [Ad Js] and won ($190.48) with a full house, Jacks full of Aces
Seat 5: Holm1991 folded before Flop (didn't bet)
Seat 7: Zoubou1983 showed [As 4s] and lost with two pair, Aces and Jacks
Seat 8: matiko09 folded before Flop (didn't bet)
Seat 9: WDW3 folded before Flop (didn't bet)





PokerStars Hand #148832451879:  Hold'em No Limit ($0.25/$0.50 USD) - 2016/02/15 10:41:31 CET [2016/02/15 4:41:31 ET]
Table 'Margot II' 9-max Seat #5 is the button
Seat 1: i L00K great ($53.43 in chips) 
Seat 2: matiko09 ($50 in chips) 
Seat 3: beluccix ($34.80 in chips) 
Seat 4: r4mz3s ($50 in chips) 
Seat 5: carlosq1986 ($62.63 in chips) 
Seat 6: OskarR89 ($51.40 in chips) 
Seat 7: Vedpapa ($102.89 in chips) 
Seat 8: Aoki42 ($93.95 in chips) 
Seat 9: Haporuu ($21.75 in chips) 
OskarR89: posts small blind $0.25
Vedpapa: posts big blind $0.50
*** HOLE CARDS ***
Dealt to matiko09 [Ks Ts]
Aoki42: folds 
Haporuu: folds 
i L00K great: folds 
matiko09: raises $1 to $1.50
beluccix: folds 
r4mz3s: folds 
carlosq1986: folds 
OskarR89: folds 
Vedpapa: folds 
Uncalled bet ($1) returned to matiko09
matiko09 collected $1.25 from pot
matiko09: doesn't show hand 
*** SUMMARY ***
Total pot $1.25 | Rake $0 
Seat 1: i L00K great folded before Flop (didn't bet)
Seat 2: matiko09 collected ($1.25)
Seat 3: beluccix folded before Flop (didn't bet)
Seat 4: r4mz3s folded before Flop (didn't bet)
Seat 5: carlosq1986 (button) folded before Flop (didn't bet)
Seat 6: OskarR89 (small blind) folded before Flop
Seat 7: Vedpapa (big blind) folded before Flop
Seat 8: Aoki42 folded before Flop (didn't bet)
Seat 9: Haporuu folded before Flop (didn't bet)





PokerStars Hand #148832452228:  Hold'em No Limit ($0.50/$1.00 USD) - 2016/02/15 10:41:32 CET [2016/02/15 4:41:32 ET]
Table 'Urania' 9-max Seat #9 is the button
Seat 1: matiko09 ($100 in chips) 
Seat 2: maxxmeister ($139.42 in chips) 
Seat 3: Priidix ($132.98 in chips) 
Seat 4: nickreason17 ($120.08 in chips) 
Seat 5: maxonplay ($176.08 in chips) 
Seat 6: vrnMike ($171.61 in chips) 
Seat 7: darren1031 ($168.24 in chips) 
Seat 8: Venomous100% ($120.63 in chips) 
Seat 9: mycka86 ($100 in chips) 
matiko09: posts small blind $0.50
maxxmeister: posts big blind $1
*** HOLE CARDS ***
Dealt to matiko09 [9s Qh]
Priidix: folds 
nickreason17: folds 
maxonplay: folds 
Priidix leaves the table
vrnMike: raises $2 to $3
WDW3 joins the table at seat #3 
darren1031: calls $3
Venomous100%: folds 
mycka86: folds 
matiko09: folds 
maxxmeister: calls $2
*** FLOP *** [4c 5c Ad]
maxxmeister: bets $5.17
vrnMike: calls $5.17
darren1031: folds 
*** TURN *** [4c 5c Ad] [6h]
maxxmeister: bets $14.67
vrnMike: calls $14.67
*** RIVER *** [4c 5c Ad 6h] [Qc]
maxxmeister: checks 
vrnMike: checks 
*** SHOW DOWN ***
maxxmeister: shows [3h Kh] (high card Ace)
vrnMike: shows [Kc Kd] (a pair of Kings)
vrnMike collected $46.97 from pot
*** SUMMARY ***
Total pot $49.18 | Rake $2.21 
Board [4c 5c Ad 6h Qc]
Seat 1: matiko09 (small blind) folded before Flop
Seat 2: maxxmeister (big blind) showed [3h Kh] and lost with high card Ace
Seat 3: Priidix folded before Flop (didn't bet)
Seat 4: nickreason17 folded before Flop (didn't bet)
Seat 5: maxonplay folded before Flop (didn't bet)
Seat 6: vrnMike showed [Kc Kd] and won ($46.97) with a pair of Kings
Seat 7: darren1031 folded on the Flop
Seat 8: Venomous100% folded before Flop (didn't bet)
Seat 9: mycka86 (button) folded before Flop (didn't bet)





PokerStars Hand #148832453027:  Hold'em No Limit ($0.50/$1.00 USD) - 2016/02/15 10:41:34 CET [2016/02/15 4:41:34 ET]
Table 'Corvus III' 9-max Seat #4 is the button
Seat 4: goransyruvka ($202.25 in chips) 
Seat 6: WDW3 ($239.89 in chips) 
Seat 7: matiko09 ($261.90 in chips) 
Seat 8: redacesfull ($100 in chips) 
WDW3: posts small blind $0.50
matiko09: posts big blind $1
goransyruvka: posts the ante $0.20
WDW3: posts the ante $0.20
matiko09: posts the ante $0.20
redacesfull: posts the ante $0.20
*** HOLE CARDS ***
Dealt to matiko09 [4d Kd]
redacesfull: raises $1.12 to $2.12
goransyruvka: folds 
WDW3: folds 
matiko09: folds 
Uncalled bet ($1.12) returned to redacesfull
redacesfull collected $3.30 from pot
redacesfull: doesn't show hand 
*** SUMMARY ***
Total pot $3.30 | Rake $0 
Seat 4: goransyruvka (button) folded before Flop (didn't bet)
Seat 6: WDW3 (small blind) folded before Flop
Seat 7: matiko09 (big blind) folded before Flop
Seat 8: redacesfull collected ($3.30)





PokerStars Hand #148832458817:  Hold'em No Limit ($0.50/$1.00 USD) - 2016/02/15 10:41:48 CET [2016/02/15 4:41:48 ET]
Table 'Corvus III' 9-max Seat #6 is the button
Seat 4: goransyruvka ($202.05 in chips) 
Seat 5: koib88 ($80.65 in chips) 
Seat 6: WDW3 ($239.19 in chips) 
Seat 7: matiko09 ($260.70 in chips) 
Seat 8: redacesfull ($102.10 in chips) 
matiko09: posts small blind $0.50
redacesfull: posts big blind $1
koib88: posts small & big blinds $1.50
goransyruvka: posts the ante $0.20
koib88: posts the ante $0.20
WDW3: posts the ante $0.20
matiko09: posts the ante $0.20
redacesfull: posts the ante $0.20
*** HOLE CARDS ***
Dealt to matiko09 [2c 4s]
goransyruvka: folds 
koib88: checks 
WDW3: folds 
matiko09: folds 
redacesfull: checks 
*** FLOP *** [Kd 7d 6c]
redacesfull: checks 
koib88: checks 
*** TURN *** [Kd 7d 6c] [Jd]
redacesfull: checks 
koib88: checks 
*** RIVER *** [Kd 7d 6c Jd] [9c]
redacesfull: checks 
koib88: checks 
*** SHOW DOWN ***
redacesfull: shows [Ah 8s] (high card Ace)
koib88: mucks hand 
redacesfull collected $3.82 from pot
*** SUMMARY ***
Total pot $4 | Rake $0.18 
Board [Kd 7d 6c Jd 9c]
Seat 4: goransyruvka folded before Flop (didn't bet)
Seat 5: koib88 mucked [4d Th]
Seat 6: WDW3 (button) folded before Flop (didn't bet)
Seat 7: matiko09 (small blind) folded before Flop
Seat 8: redacesfull (big blind) showed [Ah 8s] and won ($3.82) with high card Ace





PokerStars Hand #148832462720:  Hold'em No Limit ($0.50/$1.00 USD) - 2016/02/15 10:41:57 CET [2016/02/15 4:41:57 ET]
Table 'Praecipua' 9-max Seat #6 is the button
Seat 1: matiko09 ($124.07 in chips) 
Seat 2: vrnMike ($113.67 in chips) 
Seat 3: Venomous100% ($113.03 in chips) 
Seat 4: Priidix ($120.78 in chips) 
Seat 5: huffwag ($42.56 in chips) 
Seat 6: mycka86 ($100 in chips) 
Seat 7: maxxmeister ($181.77 in chips) 
Seat 8: Kalesmash08 ($75.81 in chips) 
Seat 9: AlKatrone ($106.52 in chips) 
maxxmeister: posts small blind $0.50
Kalesmash08: posts big blind $1
*** HOLE CARDS ***
Dealt to matiko09 [5d Kd]
AlKatrone: raises $2 to $3
matiko09: folds 
vrnMike: folds 
Venomous100%: folds 
Priidix: calls $3
huffwag: folds 
mycka86: calls $3
maxxmeister: folds 
Kalesmash08: calls $2
*** FLOP *** [Qh 9s 9h]
Kalesmash08: checks 
AlKatrone: checks 
Priidix: checks 
mycka86: bets $8
Kalesmash08: folds 
AlKatrone: folds 
Priidix: folds 
Uncalled bet ($8) returned to mycka86
mycka86 collected $11.94 from pot
*** SUMMARY ***
Total pot $12.50 | Rake $0.56 
Board [Qh 9s 9h]
Seat 1: matiko09 folded before Flop (didn't bet)
Seat 2: vrnMike folded before Flop (didn't bet)
Seat 3: Venomous100% folded before Flop (didn't bet)
Seat 4: Priidix folded on the Flop
Seat 5: huffwag folded before Flop (didn't bet)
Seat 6: mycka86 (button) collected ($11.94)
Seat 7: maxxmeister (small blind) folded before Flop
Seat 8: Kalesmash08 (big blind) folded on the Flop
Seat 9: AlKatrone folded on the Flop





PokerStars Hand #148832462509:  Hold'em No Limit (€0.25/€0.50 EUR) - 2016/02/15 10:41:57 CET [2016/02/15 4:41:57 ET]
Table 'Walinskia II' 9-max Seat #1 is the button
Seat 1: ljryviltj (€49.25 in chips) 
Seat 2: yats87 (€50 in chips) 
Seat 3: beluccix (€24.91 in chips) 
Seat 4: Otsime (€42.59 in chips) 
Seat 5: vano7777 (€50 in chips) 
Seat 6: 50CandyJoe (€62.52 in chips) 
Seat 8: matiko09 (€50 in chips) 
Seat 9: stevevg84 (€34.41 in chips) 
yats87: posts small blind €0.25
beluccix: posts big blind €0.50
*** HOLE CARDS ***
Dealt to matiko09 [Ks 2h]
Otsime: calls €0.50
vano7777: folds 
50CandyJoe: folds 
matiko09: folds 
stevevg84: calls €0.50
ljryviltj: folds 
yats87: calls €0.25
beluccix: raises €2 to €2.50
Otsime: calls €2
stevevg84: folds 
yats87: folds 
*** FLOP *** [9d 4d As]
beluccix: bets €4
Otsime: folds 
Uncalled bet (€4) returned to beluccix
beluccix collected €5.73 from pot
beluccix: doesn't show hand 
*** SUMMARY ***
Total pot €6 | Rake €0.27 
Board [9d 4d As]
Seat 1: ljryviltj (button) folded before Flop (didn't bet)
Seat 2: yats87 (small blind) folded before Flop
Seat 3: beluccix (big blind) collected (€5.73)
Seat 4: Otsime folded on the Flop
Seat 5: vano7777 folded before Flop (didn't bet)
Seat 6: 50CandyJoe folded before Flop (didn't bet)
Seat 8: matiko09 folded before Flop (didn't bet)
Seat 9: stevevg84 folded before Flop





PokerStars Hand #148832463257:  Hold'em No Limit ($0.25/$0.50 USD) - 2016/02/15 10:41:59 CET [2016/02/15 4:41:59 ET]
Table 'Margot II' 9-max Seat #6 is the button
Seat 2: matiko09 ($50.75 in chips) 
Seat 3: beluccix ($34.80 in chips) 
Seat 4: r4mz3s ($50 in chips) 
Seat 5: carlosq1986 ($62.63 in chips) 
Seat 6: OskarR89 ($51.15 in chips) 
Seat 7: Vedpapa ($102.39 in chips) 
Seat 8: Aoki42 ($93.95 in chips) 
Seat 9: Haporuu ($21.75 in chips) 
Vedpapa: posts small blind $0.25
Aoki42: posts big blind $0.50
*** HOLE CARDS ***
Dealt to matiko09 [2h 5s]
Haporuu: folds 
matiko09: folds 
beluccix: folds 
r4mz3s: raises $0.75 to $1.25
carlosq1986: folds 
OskarR89: folds 
Vedpapa: folds 
Aoki42: folds 
Uncalled bet ($0.75) returned to r4mz3s
r4mz3s collected $1.25 from pot
r4mz3s: doesn't show hand 
*** SUMMARY ***
Total pot $1.25 | Rake $0 
Seat 2: matiko09 folded before Flop (didn't bet)
Seat 3: beluccix folded before Flop (didn't bet)
Seat 4: r4mz3s collected ($1.25)
Seat 5: carlosq1986 folded before Flop (didn't bet)
Seat 6: OskarR89 (button) folded before Flop (didn't bet)
Seat 7: Vedpapa (small blind) folded before Flop
Seat 8: Aoki42 (big blind) folded before Flop
Seat 9: Haporuu folded before Flop (didn't bet)





PokerStars Hand #148832467347:  Hold'em No Limit ($0.50/$1.00 USD) - 2016/02/15 10:42:08 CET [2016/02/15 4:42:08 ET]
Table 'Vibeke' 9-max Seat #8 is the button
Seat 1: Venomous100% ($195.91 in chips) 
Seat 2: Priidix ($143.41 in chips) 
Seat 3: matiko09 ($113.88 in chips) 
Seat 4: fanmtZ ($43.82 in chips) 
Seat 5: vrnMike ($202.89 in chips) 
Seat 6: AlKatrone ($100 in chips) 
Seat 7: ackle1 ($79.04 in chips) 
Seat 8: IHouseMusic ($104 in chips) 
Seat 9: WDW3 ($100 in chips) 
WDW3: posts small blind $0.50
Venomous100%: posts big blind $1
*** HOLE CARDS ***
Dealt to matiko09 [6c 9h]
Priidix: folds 
matiko09: folds 
fanmtZ: raises $1.38 to $2.38
vrnMike: folds 
AlKatrone: folds 
ackle1: folds 
IHouseMusic: folds 
WDW3: folds 
Venomous100%: folds 
Uncalled bet ($1.38) returned to fanmtZ
fanmtZ collected $2.50 from pot
fanmtZ: doesn't show hand 
*** SUMMARY ***
Total pot $2.50 | Rake $0 
Seat 1: Venomous100% (big blind) folded before Flop
Seat 2: Priidix folded before Flop (didn't bet)
Seat 3: matiko09 folded before Flop (didn't bet)
Seat 4: fanmtZ collected ($2.50)
Seat 5: vrnMike folded before Flop (didn't bet)
Seat 6: AlKatrone folded before Flop (didn't bet)
Seat 7: ackle1 folded before Flop (didn't bet)
Seat 8: IHouseMusic (button) folded before Flop (didn't bet)
Seat 9: WDW3 (small blind) folded before Flop





PokerStars Hand #148832472065:  Hold'em No Limit ($0.50/$1.00 USD) - 2016/02/15 10:42:20 CET [2016/02/15 4:42:20 ET]
Table 'Corvus III' 9-max Seat #7 is the button
Seat 4: goransyruvka ($201.85 in chips) 
Seat 5: koib88 ($78.95 in chips) 
Seat 6: WDW3 ($238.99 in chips) 
Seat 7: matiko09 ($260 in chips) 
Seat 8: redacesfull ($104.72 in chips) 
redacesfull: posts small blind $0.50
goransyruvka: posts big blind $1
goransyruvka: posts the ante $0.20
koib88: posts the ante $0.20
WDW3: posts the ante $0.20
matiko09: posts the ante $0.20
redacesfull: posts the ante $0.20
*** HOLE CARDS ***
Dealt to matiko09 [Td As]
koib88: raises $1 to $2
WDW3: folds 
matiko09: calls $2
redacesfull: raises $10 to $12
goransyruvka: folds 
koib88: calls $10
matiko09: folds 
*** FLOP *** [5c 3s 6c]
redacesfull: bets $22
koib88: calls $22
*** TURN *** [5c 3s 6c] [Qs]
redacesfull: bets $69.20
koib88: calls $44.75 and is all-in
Uncalled bet ($24.45) returned to redacesfull
*** RIVER *** [5c 3s 6c Qs] [2c]
*** SHOW DOWN ***
redacesfull: shows [9c 9h] (a pair of Nines)
koib88: shows [6h 5h] (two pair, Sixes and Fives)
koib88 collected $158.70 from pot
*** SUMMARY ***
Total pot $161.50 | Rake $2.80 
Board [5c 3s 6c Qs 2c]
Seat 4: goransyruvka (big blind) folded before Flop
Seat 5: koib88 showed [6h 5h] and won ($158.70) with two pair, Sixes and Fives
Seat 6: WDW3 folded before Flop (didn't bet)
Seat 7: matiko09 (button) folded before Flop
Seat 8: redacesfull (small blind) showed [9c 9h] and lost with a pair of Nines





PokerStars Hand #148832473667:  Hold'em No Limit ($0.25/$0.50 USD) - 2016/02/15 10:42:23 CET [2016/02/15 4:42:23 ET]
Table 'Vesta II' 9-max Seat #8 is the button
Seat 1: Ahangama ($56.65 in chips) 
Seat 3: matiko09 ($67.15 in chips) 
Seat 4: HJdream ($48.11 in chips) 
Seat 5: dndngod ($79.15 in chips) 
Seat 6: pandalapa ($57.23 in chips) 
Seat 7: OskarR89 ($103.73 in chips) 
Seat 8: Arystan ($54.74 in chips) 
Seat 9: Aoki42 ($68.37 in chips) 
Aoki42: posts small blind $0.25
Ahangama: posts big blind $0.50
*** HOLE CARDS ***
Dealt to matiko09 [Js 2d]
matiko09: folds 
HJdream: raises $1 to $1.50
dndngod: folds 
pandalapa: calls $1.50
OskarR89: folds 
Arystan: raises $2.50 to $4
Aoki42: folds 
Ahangama: folds 
HJdream: calls $2.50
pandalapa: calls $2.50
*** FLOP *** [Ac 4h Qc]
HJdream: checks 
pandalapa: checks 
Arystan: bets $6.09
HJdream: folds 
pandalapa: folds 
Uncalled bet ($6.09) returned to Arystan
Arystan collected $12.18 from pot
Arystan: doesn't show hand 
*** SUMMARY ***
Total pot $12.75 | Rake $0.57 
Board [Ac 4h Qc]
Seat 1: Ahangama (big blind) folded before Flop
Seat 3: matiko09 folded before Flop (didn't bet)
Seat 4: HJdream folded on the Flop
Seat 5: dndngod folded before Flop (didn't bet)
Seat 6: pandalapa folded on the Flop
Seat 7: OskarR89 folded before Flop (didn't bet)
Seat 8: Arystan (button) collected ($12.18)
Seat 9: Aoki42 (small blind) folded before Flop





PokerStars Hand #148832476099:  Hold'em No Limit ($0.25/$0.50 USD) - 2016/02/15 10:42:29 CET [2016/02/15 4:42:29 ET]
Table 'Margot II' 9-max Seat #7 is the button
Seat 2: matiko09 ($50.75 in chips) 
Seat 3: beluccix ($34.80 in chips) 
Seat 4: r4mz3s ($50.75 in chips) 
Seat 5: carlosq1986 ($62.63 in chips) 
Seat 6: OskarR89 ($51.15 in chips) 
Seat 7: Vedpapa ($102.14 in chips) 
Seat 8: Aoki42 ($93.45 in chips) 
Seat 9: Haporuu ($21.75 in chips) 
Aoki42: posts small blind $0.25
Haporuu: posts big blind $0.50
*** HOLE CARDS ***
Dealt to matiko09 [Ks Qc]
matiko09: folds 
beluccix: folds 
r4mz3s: raises $0.75 to $1.25
carlosq1986: folds 
OskarR89: folds 
Vedpapa: folds 
Aoki42: folds 
Haporuu: folds 
Uncalled bet ($0.75) returned to r4mz3s
r4mz3s collected $1.25 from pot
r4mz3s: doesn't show hand 
*** SUMMARY ***
Total pot $1.25 | Rake $0 
Seat 2: matiko09 folded before Flop (didn't bet)
Seat 3: beluccix folded before Flop (didn't bet)
Seat 4: r4mz3s collected ($1.25)
Seat 5: carlosq1986 folded before Flop (didn't bet)
Seat 6: OskarR89 folded before Flop (didn't bet)
Seat 7: Vedpapa (button) folded before Flop (didn't bet)
Seat 8: Aoki42 (small blind) folded before Flop
Seat 9: Haporuu (big blind) folded before Flop





PokerStars Hand #148832478602:  Hold'em No Limit ($0.50/$1.00 USD) - 2016/02/15 10:42:35 CET [2016/02/15 4:42:35 ET]
Table 'Vibeke' 9-max Seat #9 is the button
Seat 1: Venomous100% ($194.91 in chips) 
Seat 2: Priidix ($143.41 in chips) 
Seat 3: matiko09 ($113.88 in chips) 
Seat 4: fanmtZ ($45.32 in chips) 
Seat 5: vrnMike ($202.89 in chips) 
Seat 6: AlKatrone ($100 in chips) 
Seat 7: ackle1 ($79.04 in chips) 
Seat 8: IHouseMusic ($104 in chips) 
Seat 9: WDW3 ($100 in chips) 
Venomous100%: posts small blind $0.50
Priidix: posts big blind $1
*** HOLE CARDS ***
Dealt to matiko09 [7s 2s]
matiko09: folds 
fanmtZ: folds 
vrnMike: folds 
AlKatrone: folds 
ackle1: folds 
IHouseMusic: folds 
WDW3: folds 
Venomous100%: raises $2 to $3
Priidix: folds 
Uncalled bet ($2) returned to Venomous100%
Venomous100% collected $2 from pot
Venomous100%: doesn't show hand 
*** SUMMARY ***
Total pot $2 | Rake $0 
Seat 1: Venomous100% (small blind) collected ($2)
Seat 2: Priidix (big blind) folded before Flop
Seat 3: matiko09 folded before Flop (didn't bet)
Seat 4: fanmtZ folded before Flop (didn't bet)
Seat 5: vrnMike folded before Flop (didn't bet)
Seat 6: AlKatrone folded before Flop (didn't bet)
Seat 7: ackle1 folded before Flop (didn't bet)
Seat 8: IHouseMusic folded before Flop (didn't bet)
Seat 9: WDW3 (button) folded before Flop (didn't bet)





PokerStars Hand #148832478857:  Hold'em No Limit ($0.50/$1.00 USD) - 2016/02/15 10:42:36 CET [2016/02/15 4:42:36 ET]
Table 'Euanthe II' 9-max Seat #6 is the button
Seat 1: maxxmeister ($167.78 in chips) 
Seat 2: mycka86 ($188.84 in chips) 
Seat 3: fanmtZ ($64.28 in chips) 
Seat 4: thevibes ($135.74 in chips) 
Seat 5: vrnMike ($111.61 in chips) 
Seat 6: grugz33 ($32.14 in chips) 
Seat 7: vinniesmol ($217.94 in chips) 
Seat 8: matiko09 ($116.58 in chips) 
Seat 9: Venomous100% ($100 in chips) 
vinniesmol: posts small blind $0.50
matiko09: posts big blind $1
*** HOLE CARDS ***
Dealt to matiko09 [Jh 6h]
Venomous100%: folds 
maxxmeister: raises $2 to $3
mycka86: calls $3
fanmtZ: folds 
thevibes: folds 
vrnMike: folds 
grugz33: calls $3
vinniesmol: folds 
matiko09: folds 
*** FLOP *** [2d 2h Qc]
maxxmeister: bets $7
mycka86: folds 
grugz33: raises $22.14 to $29.14 and is all-in
maxxmeister: folds 
Uncalled bet ($22.14) returned to grugz33
grugz33 collected $23.40 from pot
grugz33: doesn't show hand 
*** SUMMARY ***
Total pot $24.50 | Rake $1.10 
Board [2d 2h Qc]
Seat 1: maxxmeister folded on the Flop
Seat 2: mycka86 folded on the Flop
Seat 3: fanmtZ folded before Flop (didn't bet)
Seat 4: thevibes folded before Flop (didn't bet)
Seat 5: vrnMike folded before Flop (didn't bet)
Seat 6: grugz33 (button) collected ($23.40)
Seat 7: vinniesmol (small blind) folded before Flop
Seat 8: matiko09 (big blind) folded before Flop
Seat 9: Venomous100% folded before Flop (didn't bet)





PokerStars Hand #148832484990:  Hold'em No Limit ($0.50/$1.00 USD) - 2016/02/15 10:42:51 CET [2016/02/15 4:42:51 ET]
Table 'Urania' 9-max Seat #1 is the button
Seat 1: matiko09 ($100 in chips) 
Seat 2: maxxmeister ($116.58 in chips) 
Seat 3: WDW3 ($100 in chips) 
Seat 4: nickreason17 ($120.08 in chips) 
Seat 5: maxonplay ($176.08 in chips) 
Seat 6: vrnMike ($195.74 in chips) 
Seat 8: Venomous100% ($120.63 in chips) 
Seat 9: mycka86 ($100 in chips) 
maxxmeister: posts small blind $0.50
WDW3: posts big blind $1
*** HOLE CARDS ***
Dealt to matiko09 [Ad 6h]
nickreason17: folds 
nickreason17 leaves the table
AlKatrone joins the table at seat #4 
maxonplay: folds 
vrnMike: folds 
Venomous100%: folds 
mycka86: folds 
matiko09: raises $1.27 to $2.27
maxxmeister: folds 
WDW3: folds 
Uncalled bet ($1.27) returned to matiko09
matiko09 collected $2.50 from pot
matiko09: doesn't show hand 
*** SUMMARY ***
Total pot $2.50 | Rake $0 
Seat 1: matiko09 (button) collected ($2.50)
Seat 2: maxxmeister (small blind) folded before Flop
Seat 3: WDW3 (big blind) folded before Flop
Seat 4: nickreason17 folded before Flop (didn't bet)
Seat 5: maxonplay folded before Flop (didn't bet)
Seat 6: vrnMike folded before Flop (didn't bet)
Seat 8: Venomous100% folded before Flop (didn't bet)
Seat 9: mycka86 folded before Flop (didn't bet)





PokerStars Hand #148832485544:  Hold'em No Limit ($0.25/$0.50 USD) - 2016/02/15 10:42:52 CET [2016/02/15 4:42:52 ET]
Table 'Laertes II' 9-max Seat #7 is the button
Seat 1: dade33 ($94.29 in chips) 
Seat 2: beluccix ($24.21 in chips) 
Seat 3: ljryviltj ($56.16 in chips) 
Seat 4: rgar93 ($40.53 in chips) 
Seat 5: vlad11122007 ($56.13 in chips) 
Seat 6: yats87 ($50 in chips) 
Seat 7: OskarR89 ($72.52 in chips) 
Seat 8: Trent444 ($42.23 in chips) 
Seat 9: matiko09 ($50 in chips) 
Trent444: posts small blind $0.25
matiko09: posts big blind $0.50
*** HOLE CARDS ***
Dealt to matiko09 [4s Ad]
dade33: folds 
beluccix: folds 
ljryviltj: folds 
rgar93: folds 
vlad11122007: folds 
yats87: folds 
OskarR89: raises $0.50 to $1
Trent444: folds 
matiko09: calls $0.50
*** FLOP *** [Js Tc 2h]
matiko09: checks 
OskarR89: bets $1.61
matiko09: folds 
Uncalled bet ($1.61) returned to OskarR89
OskarR89 collected $2.15 from pot
OskarR89: doesn't show hand 
*** SUMMARY ***
Total pot $2.25 | Rake $0.10 
Board [Js Tc 2h]
Seat 1: dade33 folded before Flop (didn't bet)
Seat 2: beluccix folded before Flop (didn't bet)
Seat 3: ljryviltj folded before Flop (didn't bet)
Seat 4: rgar93 folded before Flop (didn't bet)
Seat 5: vlad11122007 folded before Flop (didn't bet)
Seat 6: yats87 folded before Flop (didn't bet)
Seat 7: OskarR89 (button) collected ($2.15)
Seat 8: Trent444 (small blind) folded before Flop
Seat 9: matiko09 (big blind) folded on the Flop





PokerStars Hand #148832489131:  Hold'em No Limit ($0.50/$1.00 USD) - 2016/02/15 10:43:01 CET [2016/02/15 4:43:01 ET]
Table 'Corvus III' 9-max Seat #8 is the button
Seat 4: goransyruvka ($200.65 in chips) 
Seat 5: koib88 ($158.70 in chips) 
Seat 6: WDW3 ($238.79 in chips) 
Seat 7: matiko09 ($257.80 in chips) 
Seat 8: redacesfull ($100 in chips) 
goransyruvka: posts small blind $0.50
koib88: posts big blind $1
goransyruvka: posts the ante $0.20
koib88: posts the ante $0.20
WDW3: posts the ante $0.20
matiko09: posts the ante $0.20
redacesfull: posts the ante $0.20
*** HOLE CARDS ***
Dealt to matiko09 [Qc Jc]
WDW3: raises $2 to $3
matiko09: calls $3
redacesfull: folds 
goransyruvka: calls $2.50
koib88: calls $2
*** FLOP *** [As 3s 9s]
goransyruvka: checks 
koib88: checks 
WDW3: checks 
matiko09: checks 
*** TURN *** [As 3s 9s] [7s]
goransyruvka: checks 
koib88: checks 
WDW3: checks 
matiko09: checks 
*** RIVER *** [As 3s 9s 7s] [3h]
goransyruvka: bets $6.21
koib88: folds 
WDW3: folds 
matiko09: folds 
Uncalled bet ($6.21) returned to goransyruvka
goransyruvka collected $12.42 from pot
goransyruvka: doesn't show hand 
*** SUMMARY ***
Total pot $13 | Rake $0.58 
Board [As 3s 9s 7s 3h]
Seat 4: goransyruvka (small blind) collected ($12.42)
Seat 5: koib88 (big blind) folded on the River
Seat 6: WDW3 folded on the River
Seat 7: matiko09 folded on the River
Seat 8: redacesfull (button) folded before Flop (didn't bet)





PokerStars Hand #148832491638:  Hold'em No Limit (€0.25/€0.50 EUR) - 2016/02/15 10:43:07 CET [2016/02/15 4:43:07 ET]
Table 'Walinskia II' 9-max Seat #2 is the button
Seat 1: ljryviltj (€49.25 in chips) 
Seat 2: yats87 (€50 in chips) 
Seat 3: beluccix (€28.14 in chips) 
Seat 4: Otsime (€40.09 in chips) 
Seat 5: vano7777 (€50 in chips) 
Seat 6: 50CandyJoe (€62.52 in chips) 
Seat 8: matiko09 (€50 in chips) 
Seat 9: stevevg84 (€33.91 in chips) 
beluccix: posts small blind €0.25
Otsime: posts big blind €0.50
*** HOLE CARDS ***
Dealt to matiko09 [8c 9c]
vano7777: raises €1.25 to €1.75
50CandyJoe: folds 
matiko09: calls €1.75
stevevg84: folds 
ljryviltj: folds 
yats87: folds 
beluccix: folds 
Otsime: calls €1.25
*** FLOP *** [Jh Ks 4c]
Otsime: bets €0.50
vano7777: calls €0.50
matiko09: folds 
*** TURN *** [Jh Ks 4c] [Ac]
Otsime: checks 
vano7777: bets €3.75
Otsime: folds 
Uncalled bet (€3.75) returned to vano7777
vano7777 collected €6.21 from pot
*** SUMMARY ***
Total pot €6.50 | Rake €0.29 
Board [Jh Ks 4c Ac]
Seat 1: ljryviltj folded before Flop (didn't bet)
Seat 2: yats87 (button) folded before Flop (didn't bet)
Seat 3: beluccix (small blind) folded before Flop
Seat 4: Otsime (big blind) folded on the Turn
Seat 5: vano7777 collected (€6.21)
Seat 6: 50CandyJoe folded before Flop (didn't bet)
Seat 8: matiko09 folded on the Flop
Seat 9: stevevg84 folded before Flop (didn't bet)





PokerStars Hand #148832494405:  Hold'em No Limit ($0.50/$1.00 USD) - 2016/02/15 10:43:13 CET [2016/02/15 4:43:13 ET]
Table 'Urania' 9-max Seat #2 is the button
Seat 1: matiko09 ($101.50 in chips) 
Seat 2: maxxmeister ($116.08 in chips) 
Seat 3: WDW3 ($100 in chips) 
Seat 4: AlKatrone ($100 in chips) 
Seat 5: maxonplay ($176.08 in chips) 
Seat 6: vrnMike ($195.74 in chips) 
Seat 8: Venomous100% ($120.63 in chips) 
Seat 9: mycka86 ($100 in chips) 
WDW3: posts small blind $0.50
AlKatrone: posts big blind $1
*** HOLE CARDS ***
Dealt to matiko09 [Jd Jh]
maxonplay: folds 
vrnMike: folds 
Venomous100%: folds 
mycka86: folds 
matiko09: raises $1.50 to $2.50
maxxmeister: folds 
WDW3: raises $6 to $8.50
AlKatrone: folds 
matiko09: calls $6
*** FLOP *** [Qs 4s 2s]
WDW3: checks 
matiko09: checks 
*** TURN *** [Qs 4s 2s] [6s]
WDW3: checks 
matiko09: checks 
*** RIVER *** [Qs 4s 2s 6s] [4d]
WDW3: checks 
matiko09: checks 
*** SHOW DOWN ***
WDW3: shows [6d 6h] (a full house, Sixes full of Fours)
matiko09: mucks hand 
WDW3 collected $17.19 from pot
*** SUMMARY ***
Total pot $18 | Rake $0.81 
Board [Qs 4s 2s 6s 4d]
Seat 1: matiko09 mucked [Jd Jh]
Seat 2: maxxmeister (button) folded before Flop (didn't bet)
Seat 3: WDW3 (small blind) showed [6d 6h] and won ($17.19) with a full house, Sixes full of Fours
Seat 4: AlKatrone (big blind) folded before Flop
Seat 5: maxonplay folded before Flop (didn't bet)
Seat 6: vrnMike folded before Flop (didn't bet)
Seat 8: Venomous100% folded before Flop (didn't bet)
Seat 9: mycka86 folded before Flop (didn't bet)





PokerStars Hand #148832494547:  Hold'em No Limit ($0.25/$0.50 USD) - 2016/02/15 10:43:14 CET [2016/02/15 4:43:14 ET]
Table 'Vesta II' 9-max Seat #9 is the button
Seat 1: Ahangama ($56.15 in chips) 
Seat 3: matiko09 ($67.15 in chips) 
Seat 4: HJdream ($44.11 in chips) 
Seat 5: dndngod ($79.15 in chips) 
Seat 6: pandalapa ($53.23 in chips) 
Seat 7: OskarR89 ($103.73 in chips) 
Seat 8: Arystan ($62.92 in chips) 
Seat 9: Aoki42 ($68.12 in chips) 
Ahangama: posts small blind $0.25
matiko09: posts big blind $0.50
*** HOLE CARDS ***
Dealt to matiko09 [Th Ad]
HJdream: folds 
dndngod: folds 
pandalapa: folds 
OskarR89: folds 
Arystan: raises $1 to $1.50
Aoki42: folds 
Ahangama: folds 
matiko09: calls $1
*** FLOP *** [3c Ah 4d]
matiko09: checks 
Arystan: bets $1.55
matiko09: calls $1.55
*** TURN *** [3c Ah 4d] [5c]
matiko09: checks 
Arystan: bets $3.03
matiko09: calls $3.03
*** RIVER *** [3c Ah 4d 5c] [5h]
matiko09: checks 
Arystan: checks 
*** SHOW DOWN ***
matiko09: shows [Th Ad] (two pair, Aces and Fives)
Arystan: mucks hand 
matiko09 collected $11.85 from pot
*** SUMMARY ***
Total pot $12.41 | Rake $0.56 
Board [3c Ah 4d 5c 5h]
Seat 1: Ahangama (small blind) folded before Flop
Seat 3: matiko09 (big blind) showed [Th Ad] and won ($11.85) with two pair, Aces and Fives
Seat 4: HJdream folded before Flop (didn't bet)
Seat 5: dndngod folded before Flop (didn't bet)
Seat 6: pandalapa folded before Flop (didn't bet)
Seat 7: OskarR89 folded before Flop (didn't bet)
Seat 8: Arystan mucked [Ts Qd]
Seat 9: Aoki42 (button) folded before Flop (didn't bet)





PokerStars Hand #148832498852:  Hold'em No Limit ($0.50/$1.00 USD) - 2016/02/15 10:43:24 CET [2016/02/15 4:43:24 ET]
Table 'Gemma II' 9-max Seat #7 is the button
Seat 1: Igor DoUrden ($175.28 in chips) 
Seat 2: WDW3 ($129.43 in chips) 
Seat 3: Venomous100% ($143.74 in chips) 
Seat 4: mycka86 ($100 in chips) 
Seat 5: PokerSash201 ($61.41 in chips) 
Seat 6: fanmtZ ($40 in chips) 
Seat 7: AlKatrone ($106.01 in chips) 
Seat 8: vrnMike ($168.42 in chips) 
Seat 9: matiko09 ($111.17 in chips) 
vrnMike: posts small blind $0.50
matiko09: posts big blind $1
*** HOLE CARDS ***
Dealt to matiko09 [3s Ac]
Igor DoUrden: folds 
WDW3: folds 
Venomous100%: folds 
mycka86: folds 
PokerSash201: raises $1.02 to $2.02
fanmtZ: folds 
AlKatrone: folds 
vrnMike: raises $4.48 to $6.50
matiko09: folds 
PokerSash201: calls $4.48
*** FLOP *** [Qc 4d 8c]
vrnMike: bets $8.50
PokerSash201: folds 
Uncalled bet ($8.50) returned to vrnMike
vrnMike collected $13.37 from pot
*** SUMMARY ***
Total pot $14 | Rake $0.63 
Board [Qc 4d 8c]
Seat 1: Igor DoUrden folded before Flop (didn't bet)
Seat 2: WDW3 folded before Flop (didn't bet)
Seat 3: Venomous100% folded before Flop (didn't bet)
Seat 4: mycka86 folded before Flop (didn't bet)
Seat 5: PokerSash201 folded on the Flop
Seat 6: fanmtZ folded before Flop (didn't bet)
Seat 7: AlKatrone (button) folded before Flop (didn't bet)
Seat 8: vrnMike (small blind) collected ($13.37)
Seat 9: matiko09 (big blind) folded before Flop





PokerStars Hand #148832502492:  Hold'em No Limit ($0.50/$1.00 USD) - 2016/02/15 10:43:33 CET [2016/02/15 4:43:33 ET]
Table 'Praecipua' 9-max Seat #7 is the button
Seat 1: matiko09 ($124.07 in chips) 
Seat 2: vrnMike ($113.67 in chips) 
Seat 3: Venomous100% ($113.03 in chips) 
Seat 4: Priidix ($117.78 in chips) 
Seat 5: huffwag ($42.56 in chips) 
Seat 6: mycka86 ($108.94 in chips) 
Seat 7: maxxmeister ($181.27 in chips) 
Seat 8: Kalesmash08 ($72.81 in chips) 
Seat 9: AlKatrone ($103.52 in chips) 
Kalesmash08: posts small blind $0.50
AlKatrone: posts big blind $1
*** HOLE CARDS ***
Dealt to matiko09 [5s Ac]
matiko09: folds 
vrnMike: folds 
Venomous100%: folds 
Priidix: folds 
huffwag: folds 
mycka86: raises $1.10 to $2.10
maxxmeister: raises $5.25 to $7.35
Kalesmash08: folds 
AlKatrone: folds 
mycka86: folds 
Uncalled bet ($5.25) returned to maxxmeister
maxxmeister collected $5.70 from pot
maxxmeister: doesn't show hand 
*** SUMMARY ***
Total pot $5.70 | Rake $0 
Seat 1: matiko09 folded before Flop (didn't bet)
Seat 2: vrnMike folded before Flop (didn't bet)
Seat 3: Venomous100% folded before Flop (didn't bet)
Seat 4: Priidix folded before Flop (didn't bet)
Seat 5: huffwag folded before Flop (didn't bet)
Seat 6: mycka86 folded before Flop
Seat 7: maxxmeister (button) collected ($5.70)
Seat 8: Kalesmash08 (small blind) folded before Flop
Seat 9: AlKatrone (big blind) folded before Flop





PokerStars Hand #148832504136:  Hold'em No Limit ($0.50/$1.00 USD) - 2016/02/15 10:43:37 CET [2016/02/15 4:43:37 ET]
Table 'Euanthe II' 9-max Seat #7 is the button
Seat 1: maxxmeister ($157.78 in chips) 
Seat 2: mycka86 ($185.84 in chips) 
Seat 3: fanmtZ ($64.28 in chips) 
Seat 4: thevibes ($135.74 in chips) 
Seat 5: vrnMike ($111.61 in chips) 
Seat 6: grugz33 ($45.54 in chips) 
Seat 7: vinniesmol ($217.44 in chips) 
Seat 8: matiko09 ($115.58 in chips) 
Seat 9: Venomous100% ($100 in chips) 
matiko09: posts small blind $0.50
Venomous100%: posts big blind $1
*** HOLE CARDS ***
Dealt to matiko09 [6d 3d]
maxxmeister: raises $1 to $2
mycka86: folds 
fanmtZ: folds 
thevibes: folds 
vrnMike: calls $2
grugz33: calls $2
vinniesmol: folds 
matiko09: folds 
Venomous100%: calls $1
*** FLOP *** [6h 5h 5s]
Venomous100%: checks 
maxxmeister: checks 
vrnMike: bets $6
grugz33: calls $6
Venomous100%: folds 
maxxmeister: folds 
*** TURN *** [6h 5h 5s] [2c]
vrnMike: checks 
grugz33: checks 
*** RIVER *** [6h 5h 5s 2c] [Ah]
vrnMike: bets $15
grugz33: folds 
Uncalled bet ($15) returned to vrnMike
vrnMike collected $19.58 from pot
*** SUMMARY ***
Total pot $20.50 | Rake $0.92 
Board [6h 5h 5s 2c Ah]
Seat 1: maxxmeister folded on the Flop
Seat 2: mycka86 folded before Flop (didn't bet)
Seat 3: fanmtZ folded before Flop (didn't bet)
Seat 4: thevibes folded before Flop (didn't bet)
Seat 5: vrnMike collected ($19.58)
Seat 6: grugz33 folded on the River
Seat 7: vinniesmol (button) folded before Flop (didn't bet)
Seat 8: matiko09 (small blind) folded before Flop
Seat 9: Venomous100% (big blind) folded on the Flop





PokerStars Hand #148832505770:  Hold'em No Limit ($0.25/$0.50 USD) - 2016/02/15 10:43:41 CET [2016/02/15 4:43:41 ET]
Table 'Laertes II' 9-max Seat #8 is the button
Seat 1: dade33 ($94.29 in chips) 
Seat 2: beluccix ($24.21 in chips) 
Seat 3: ljryviltj ($56.16 in chips) 
Seat 4: rgar93 ($40.53 in chips) 
Seat 5: vlad11122007 ($56.13 in chips) 
Seat 6: yats87 ($50 in chips) 
Seat 7: OskarR89 ($73.67 in chips) 
Seat 8: Trent444 ($41.98 in chips) 
Seat 9: matiko09 ($50 in chips) 
matiko09: posts small blind $0.25
dade33: posts big blind $0.50
*** HOLE CARDS ***
Dealt to matiko09 [9h Ah]
beluccix: folds 
ljryviltj: folds 
rgar93: folds 
vlad11122007: folds 
yats87: folds 
OskarR89: folds 
Trent444: raises $1 to $1.50
matiko09: folds 
dade33: folds 
Uncalled bet ($1) returned to Trent444
Trent444 collected $1.25 from pot
Trent444: doesn't show hand 
*** SUMMARY ***
Total pot $1.25 | Rake $0 
Seat 1: dade33 (big blind) folded before Flop
Seat 2: beluccix folded before Flop (didn't bet)
Seat 3: ljryviltj folded before Flop (didn't bet)
Seat 4: rgar93 folded before Flop (didn't bet)
Seat 5: vlad11122007 folded before Flop (didn't bet)
Seat 6: yats87 folded before Flop (didn't bet)
Seat 7: OskarR89 folded before Flop (didn't bet)
Seat 8: Trent444 (button) collected ($1.25)
Seat 9: matiko09 (small blind) folded before Flop





PokerStars Hand #148832511675:  Hold'em No Limit ($0.50/$1.00 USD) - 2016/02/15 10:43:55 CET [2016/02/15 4:43:55 ET]
Table 'Corvus III' 9-max Seat #4 is the button
Seat 4: goransyruvka ($209.87 in chips) 
Seat 5: koib88 ($155.50 in chips) 
Seat 6: WDW3 ($235.59 in chips) 
Seat 7: matiko09 ($254.60 in chips) 
Seat 8: redacesfull ($100 in chips) 
koib88: posts small blind $0.50
WDW3: posts big blind $1
goransyruvka: posts the ante $0.20
koib88: posts the ante $0.20
WDW3: posts the ante $0.20
matiko09: posts the ante $0.20
redacesfull: posts the ante $0.20
*** HOLE CARDS ***
Dealt to matiko09 [4d 6d]
matiko09: folds 
redacesfull: raises $1.12 to $2.12
goransyruvka: calls $2.12
koib88: folds 
WDW3: folds 
*** FLOP *** [Jd 8s 5c]
redacesfull: bets $4
goransyruvka: folds 
Uncalled bet ($4) returned to redacesfull
redacesfull collected $6.44 from pot
redacesfull: doesn't show hand 
*** SUMMARY ***
Total pot $6.74 | Rake $0.30 
Board [Jd 8s 5c]
Seat 4: goransyruvka (button) folded on the Flop
Seat 5: koib88 (small blind) folded before Flop
Seat 6: WDW3 (big blind) folded before Flop
Seat 7: matiko09 folded before Flop (didn't bet)
Seat 8: redacesfull collected ($6.44)





PokerStars Hand #148832513480:  Hold'em No Limit ($0.50/$1.00 USD) - 2016/02/15 10:44:00 CET [2016/02/15 4:44:00 ET]
Table 'Anteros' 9-max Seat #2 is the button
Seat 1: OskarR89 ($100 in chips) 
Seat 2: IHouseMusic ($104.14 in chips) 
Seat 4: misherei ($196.84 in chips) 
Seat 5: Holm1991 ($92.82 in chips) 
Seat 8: matiko09 ($101.41 in chips) 
Seat 9: WDW3 ($100 in chips) 
fanmtZ will be allowed to play after the button
misherei: posts small blind $0.50
Holm1991: posts big blind $1
*** HOLE CARDS ***
Dealt to matiko09 [7d Qs]
matiko09: folds 
WDW3: raises $2 to $3
OskarR89: folds 
IHouseMusic: folds 
misherei: folds 
Holm1991: folds 
Uncalled bet ($2) returned to WDW3
WDW3 collected $2.50 from pot
WDW3: doesn't show hand 
*** SUMMARY ***
Total pot $2.50 | Rake $0 
Seat 1: OskarR89 folded before Flop (didn't bet)
Seat 2: IHouseMusic (button) folded before Flop (didn't bet)
Seat 4: misherei (small blind) folded before Flop
Seat 5: Holm1991 (big blind) folded before Flop
Seat 8: matiko09 folded before Flop (didn't bet)
Seat 9: WDW3 collected ($2.50)





PokerStars Hand #148832519392:  Hold'em No Limit (€0.25/€0.50 EUR) - 2016/02/15 10:44:14 CET [2016/02/15 4:44:14 ET]
Table 'Walinskia II' 9-max Seat #3 is the button
Seat 1: ljryviltj (€49.25 in chips) 
Seat 2: yats87 (€50 in chips) 
Seat 3: beluccix (€27.89 in chips) 
Seat 4: Otsime (€37.84 in chips) 
Seat 5: vano7777 (€53.96 in chips) 
Seat 6: 50CandyJoe (€62.52 in chips) 
Seat 8: matiko09 (€50 in chips) 
Seat 9: stevevg84 (€33.91 in chips) 
Otsime: posts small blind €0.25
vano7777: posts big blind €0.50
*** HOLE CARDS ***
Dealt to matiko09 [9d 6h]
50CandyJoe: folds 
matiko09: folds 
stevevg84: calls €0.50
ljryviltj: folds 
yats87: folds 
beluccix: folds 
Otsime: folds 
vano7777: checks 
*** FLOP *** [Qh Ts 8s]
vano7777: checks 
stevevg84: checks 
*** TURN *** [Qh Ts 8s] [5d]
vano7777: checks 
stevevg84: checks 
*** RIVER *** [Qh Ts 8s 5d] [5h]
vano7777: checks 
stevevg84: checks 
*** SHOW DOWN ***
vano7777: shows [Ah 7s] (a pair of Fives)
stevevg84: shows [9h Td] (two pair, Tens and Fives)
stevevg84 collected €1.19 from pot
*** SUMMARY ***
Total pot €1.25 | Rake €0.06 
Board [Qh Ts 8s 5d 5h]
Seat 1: ljryviltj folded before Flop (didn't bet)
Seat 2: yats87 folded before Flop (didn't bet)
Seat 3: beluccix (button) folded before Flop (didn't bet)
Seat 4: Otsime (small blind) folded before Flop
Seat 5: vano7777 (big blind) showed [Ah 7s] and lost with a pair of Fives
Seat 6: 50CandyJoe folded before Flop (didn't bet)
Seat 8: matiko09 folded before Flop (didn't bet)
Seat 9: stevevg84 showed [9h Td] and won (€1.19) with two pair, Tens and Fives





PokerStars Hand #148832519422:  Hold'em No Limit ($0.25/$0.50 USD) - 2016/02/15 10:44:14 CET [2016/02/15 4:44:14 ET]
Table 'Vesta II' 9-max Seat #1 is the button
Seat 1: Ahangama ($55.90 in chips) 
Seat 3: matiko09 ($72.92 in chips) 
Seat 4: HJdream ($50 in chips) 
Seat 5: dndngod ($79.15 in chips) 
Seat 6: pandalapa ($53.23 in chips) 
Seat 7: OskarR89 ($103.73 in chips) 
Seat 8: Arystan ($56.84 in chips) 
Seat 9: Aoki42 ($68.12 in chips) 
matiko09: posts small blind $0.25
HJdream: posts big blind $0.50
*** HOLE CARDS ***
Dealt to matiko09 [Jh 8h]
dndngod: folds 
pandalapa: folds 
OskarR89: folds 
Arystan: raises $1 to $1.50
Aoki42: folds 
Ahangama: folds 
matiko09: folds 
HJdream: folds 
Uncalled bet ($1) returned to Arystan
Arystan collected $1.25 from pot
Arystan: doesn't show hand 
*** SUMMARY ***
Total pot $1.25 | Rake $0 
Seat 1: Ahangama (button) folded before Flop (didn't bet)
Seat 3: matiko09 (small blind) folded before Flop
Seat 4: HJdream (big blind) folded before Flop
Seat 5: dndngod folded before Flop (didn't bet)
Seat 6: pandalapa folded before Flop (didn't bet)
Seat 7: OskarR89 folded before Flop (didn't bet)
Seat 8: Arystan collected ($1.25)
Seat 9: Aoki42 folded before Flop (didn't bet)





PokerStars Hand #148832523122:  Hold'em No Limit ($0.50/$1.00 USD) - 2016/02/15 10:44:23 CET [2016/02/15 4:44:23 ET]
Table 'Corvus III' 9-max Seat #5 is the button
Seat 4: goransyruvka ($207.55 in chips) 
Seat 5: koib88 ($154.80 in chips) 
Seat 6: WDW3 ($234.39 in chips) 
Seat 7: matiko09 ($254.40 in chips) 
Seat 8: redacesfull ($104.12 in chips) 
WDW3: posts small blind $0.50
matiko09: posts big blind $1
goransyruvka: posts the ante $0.20
koib88: posts the ante $0.20
WDW3: posts the ante $0.20
matiko09: posts the ante $0.20
redacesfull: posts the ante $0.20
*** HOLE CARDS ***
Dealt to matiko09 [2d Ad]
redacesfull: raises $1.12 to $2.12
goransyruvka: folds 
koib88: calls $2.12
kurushka joins the table at seat #9 
WDW3: folds 
matiko09: calls $1.12
*** FLOP *** [9h 6d 8s]
matiko09: checks 
kurushka leaves the table
redacesfull: bets $6
koib88: folds 
matiko09: folds 
Uncalled bet ($6) returned to redacesfull
redacesfull collected $7.51 from pot
redacesfull: doesn't show hand 
*** SUMMARY ***
Total pot $7.86 | Rake $0.35 
Board [9h 6d 8s]
Seat 4: goransyruvka folded before Flop (didn't bet)
Seat 5: koib88 (button) folded on the Flop
Seat 6: WDW3 (small blind) folded before Flop
Seat 7: matiko09 (big blind) folded on the Flop
Seat 8: redacesfull collected ($7.51)





PokerStars Hand #148832523307:  Hold'em No Limit ($0.50/$1.00 USD) - 2016/02/15 10:44:23 CET [2016/02/15 4:44:23 ET]
Table 'Gemma II' 9-max Seat #8 is the button
Seat 1: Igor DoUrden ($175.28 in chips) 
Seat 2: WDW3 ($129.43 in chips) 
Seat 3: Venomous100% ($143.74 in chips) 
Seat 4: mycka86 ($100 in chips) 
Seat 5: PokerSash201 ($54.91 in chips) 
Seat 6: fanmtZ ($40 in chips) 
Seat 7: AlKatrone ($106.01 in chips) 
Seat 8: vrnMike ($175.29 in chips) 
Seat 9: matiko09 ($110.17 in chips) 
matiko09: posts small blind $0.50
Igor DoUrden: posts big blind $1
*** HOLE CARDS ***
Dealt to matiko09 [Qd Qs]
WDW3: folds 
Venomous100%: folds 
mycka86: folds 
PokerSash201: folds 
fanmtZ: folds 
AlKatrone: folds 
vrnMike: folds 
matiko09: raises $1.50 to $2.50
Igor DoUrden: folds 
Uncalled bet ($1.50) returned to matiko09
matiko09 collected $2 from pot
matiko09: doesn't show hand 
*** SUMMARY ***
Total pot $2 | Rake $0 
Seat 1: Igor DoUrden (big blind) folded before Flop
Seat 2: WDW3 folded before Flop (didn't bet)
Seat 3: Venomous100% folded before Flop (didn't bet)
Seat 4: mycka86 folded before Flop (didn't bet)
Seat 5: PokerSash201 folded before Flop (didn't bet)
Seat 6: fanmtZ folded before Flop (didn't bet)
Seat 7: AlKatrone folded before Flop (didn't bet)
Seat 8: vrnMike (button) folded before Flop (didn't bet)
Seat 9: matiko09 (small blind) collected ($2)





PokerStars Hand #148832523866:  Hold'em No Limit ($0.50/$1.00 USD) - 2016/02/15 10:44:25 CET [2016/02/15 4:44:25 ET]
Table 'Urania' 9-max Seat #3 is the button
Seat 1: matiko09 ($100 in chips) 
Seat 2: maxxmeister ($116.08 in chips) 
Seat 3: WDW3 ($108.69 in chips) 
Seat 4: AlKatrone ($100 in chips) 
Seat 5: maxonplay ($176.08 in chips) 
Seat 6: vrnMike ($195.74 in chips) 
Seat 8: Venomous100% ($120.63 in chips) 
Seat 9: mycka86 ($100 in chips) 
AlKatrone: posts small blind $0.50
maxonplay: posts big blind $1
*** HOLE CARDS ***
Dealt to matiko09 [3c 8s]
vrnMike: folds 
Venomous100%: folds 
mycka86: folds 
matiko09: folds 
maxxmeister: raises $2 to $3
WDW3: folds 
AlKatrone: folds 
maxonplay: folds 
Uncalled bet ($2) returned to maxxmeister
maxxmeister collected $2.50 from pot
maxxmeister: doesn't show hand 
*** SUMMARY ***
Total pot $2.50 | Rake $0 
Seat 1: matiko09 folded before Flop (didn't bet)
Seat 2: maxxmeister collected ($2.50)
Seat 3: WDW3 (button) folded before Flop (didn't bet)
Seat 4: AlKatrone (small blind) folded before Flop
Seat 5: maxonplay (big blind) folded before Flop
Seat 6: vrnMike folded before Flop (didn't bet)
Seat 8: Venomous100% folded before Flop (didn't bet)
Seat 9: mycka86 folded before Flop (didn't bet)





PokerStars Hand #148832529521:  Hold'em No Limit ($0.25/$0.50 USD) - 2016/02/15 10:44:38 CET [2016/02/15 4:44:38 ET]
Table 'Vesta II' 9-max Seat #3 is the button
Seat 1: Ahangama ($55.90 in chips) 
Seat 3: matiko09 ($72.67 in chips) 
Seat 4: HJdream ($49.50 in chips) 
Seat 5: dndngod ($79.15 in chips) 
Seat 6: pandalapa ($53.23 in chips) 
Seat 7: OskarR89 ($103.73 in chips) 
Seat 8: Arystan ($57.59 in chips) 
Seat 9: Aoki42 ($68.12 in chips) 
HJdream: posts small blind $0.25
dndngod: posts big blind $0.50
*** HOLE CARDS ***
Dealt to matiko09 [4h Js]
pandalapa: folds 
OskarR89: folds 
Arystan: folds 
Aoki42: folds 
Ahangama: folds 
matiko09: folds 
HJdream: folds 
Uncalled bet ($0.25) returned to dndngod
dndngod collected $0.50 from pot
*** SUMMARY ***
Total pot $0.50 | Rake $0 
Seat 1: Ahangama folded before Flop (didn't bet)
Seat 3: matiko09 (button) folded before Flop (didn't bet)
Seat 4: HJdream (small blind) folded before Flop
Seat 5: dndngod (big blind) collected ($0.50)
Seat 6: pandalapa folded before Flop (didn't bet)
Seat 7: OskarR89 folded before Flop (didn't bet)
Seat 8: Arystan folded before Flop (didn't bet)
Seat 9: Aoki42 folded before Flop (didn't bet)





PokerStars Hand #148832529456:  Hold'em No Limit ($0.50/$1.00 USD) - 2016/02/15 10:44:38 CET [2016/02/15 4:44:38 ET]
Table 'Praecipua' 9-max Seat #8 is the button
Seat 1: matiko09 ($124.07 in chips) 
Seat 2: vrnMike ($113.67 in chips) 
Seat 3: Venomous100% ($113.03 in chips) 
Seat 4: Priidix ($117.78 in chips) 
Seat 5: huffwag ($42.56 in chips) 
Seat 6: mycka86 ($106.84 in chips) 
Seat 7: maxxmeister ($184.87 in chips) 
Seat 8: Kalesmash08 ($72.31 in chips) 
Seat 9: AlKatrone ($102.52 in chips) 
AlKatrone: posts small blind $0.50
matiko09: posts big blind $1
*** HOLE CARDS ***
Dealt to matiko09 [4h 7s]
vrnMike: folds 
Venomous100%: folds 
Priidix: folds 
huffwag: raises $2 to $3
mycka86: folds 
maxxmeister: raises $6 to $9
Kalesmash08: folds 
AlKatrone: folds 
matiko09: folds 
huffwag: calls $6
*** FLOP *** [4c 8s 4s]
huffwag: checks 
maxxmeister: bets $9
huffwag: folds 
Uncalled bet ($9) returned to maxxmeister
maxxmeister collected $18.62 from pot
maxxmeister: doesn't show hand 
*** SUMMARY ***
Total pot $19.50 | Rake $0.88 
Board [4c 8s 4s]
Seat 1: matiko09 (big blind) folded before Flop
Seat 2: vrnMike folded before Flop (didn't bet)
Seat 3: Venomous100% folded before Flop (didn't bet)
Seat 4: Priidix folded before Flop (didn't bet)
Seat 5: huffwag folded on the Flop
Seat 6: mycka86 folded before Flop (didn't bet)
Seat 7: maxxmeister collected ($18.62)
Seat 8: Kalesmash08 (button) folded before Flop (didn't bet)
Seat 9: AlKatrone (small blind) folded before Flop





PokerStars Hand #148832529351:  Hold'em No Limit ($0.50/$1.00 USD) - 2016/02/15 10:44:38 CET [2016/02/15 4:44:38 ET]
Table 'Anteros' 9-max Seat #4 is the button
Seat 1: OskarR89 ($100 in chips) 
Seat 2: IHouseMusic ($104.14 in chips) 
Seat 4: misherei ($196.34 in chips) 
Seat 5: Holm1991 ($91.82 in chips) 
Seat 7: Zoubou1983 ($81.84 in chips) 
Seat 8: matiko09 ($101.41 in chips) 
Seat 9: WDW3 ($101.50 in chips) 
Holm1991: posts small blind $0.50
Zoubou1983: posts big blind $1
fanmtZ: sits out 
*** HOLE CARDS ***
Dealt to matiko09 [Ah 8d]
matiko09: folds 
WDW3: folds 
OskarR89: folds 
IHouseMusic: folds 
misherei: raises $2 to $3
Holm1991: calls $2.50
Zoubou1983: calls $2
*** FLOP *** [8h 3h 4c]
Holm1991: checks 
Zoubou1983: checks 
misherei: bets $4
Holm1991: folds 
Zoubou1983: folds 
Uncalled bet ($4) returned to misherei
misherei collected $8.60 from pot
misherei: doesn't show hand 
*** SUMMARY ***
Total pot $9 | Rake $0.40 
Board [8h 3h 4c]
Seat 1: OskarR89 folded before Flop (didn't bet)
Seat 2: IHouseMusic folded before Flop (didn't bet)
Seat 4: misherei (button) collected ($8.60)
Seat 5: Holm1991 (small blind) folded on the Flop
Seat 7: Zoubou1983 (big blind) folded on the Flop
Seat 8: matiko09 folded before Flop (didn't bet)
Seat 9: WDW3 folded before Flop (didn't bet)





PokerStars Hand #148832531131:  Hold'em No Limit ($0.25/$0.50 USD) - 2016/02/15 10:44:42 CET [2016/02/15 4:44:42 ET]
Table 'Laertes II' 9-max Seat #9 is the button
Seat 1: dade33 ($93.79 in chips) 
Seat 2: beluccix ($24.21 in chips) 
Seat 3: ljryviltj ($56.16 in chips) 
Seat 4: rgar93 ($40.53 in chips) 
Seat 5: vlad11122007 ($56.13 in chips) 
Seat 6: yats87 ($50 in chips) 
Seat 7: OskarR89 ($73.67 in chips) 
Seat 8: Trent444 ($42.73 in chips) 
Seat 9: matiko09 ($50 in chips) 
dade33: posts small blind $0.25
beluccix: posts big blind $0.50
*** HOLE CARDS ***
Dealt to matiko09 [As 4c]
ljryviltj: folds 
rgar93: folds 
vlad11122007: folds 
yats87: folds 
OskarR89: folds 
Trent444: raises $1 to $1.50
matiko09: folds 
dade33: folds 
beluccix: folds 
Uncalled bet ($1) returned to Trent444
Trent444 collected $1.25 from pot
Trent444: doesn't show hand 
*** SUMMARY ***
Total pot $1.25 | Rake $0 
Seat 1: dade33 (small blind) folded before Flop
Seat 2: beluccix (big blind) folded before Flop
Seat 3: ljryviltj folded before Flop (didn't bet)
Seat 4: rgar93 folded before Flop (didn't bet)
Seat 5: vlad11122007 folded before Flop (didn't bet)
Seat 6: yats87 folded before Flop (didn't bet)
Seat 7: OskarR89 folded before Flop (didn't bet)
Seat 8: Trent444 collected ($1.25)
Seat 9: matiko09 (button) folded before Flop (didn't bet)





PokerStars Hand #148832537008:  Hold'em No Limit ($0.50/$1.00 USD) - 2016/02/15 10:44:56 CET [2016/02/15 4:44:56 ET]
Table 'Urania' 9-max Seat #4 is the button
Seat 1: matiko09 ($100 in chips) 
Seat 2: maxxmeister ($117.58 in chips) 
Seat 3: WDW3 ($108.69 in chips) 
Seat 4: AlKatrone ($100 in chips) 
Seat 5: maxonplay ($175.08 in chips) 
Seat 6: vrnMike ($195.74 in chips) 
Seat 8: Venomous100% ($120.63 in chips) 
Seat 9: mycka86 ($100 in chips) 
maxonplay: posts small blind $0.50
vrnMike: posts big blind $1
*** HOLE CARDS ***
Dealt to matiko09 [Qc 8d]
Venomous100%: folds 
mycka86: folds 
matiko09: folds 
maxxmeister: folds 
WDW3: folds 
AlKatrone: raises $1 to $2
maxonplay: raises $20 to $22
vrnMike: folds 
AlKatrone: folds 
Uncalled bet ($20) returned to maxonplay
maxonplay collected $5 from pot
maxonplay: doesn't show hand 
*** SUMMARY ***
Total pot $5 | Rake $0 
Seat 1: matiko09 folded before Flop (didn't bet)
Seat 2: maxxmeister folded before Flop (didn't bet)
Seat 3: WDW3 folded before Flop (didn't bet)
Seat 4: AlKatrone (button) folded before Flop
Seat 5: maxonplay (small blind) collected ($5)
Seat 6: vrnMike (big blind) folded before Flop
Seat 8: Venomous100% folded before Flop (didn't bet)
Seat 9: mycka86 folded before Flop (didn't bet)





PokerStars Hand #148832536996:  Hold'em No Limit ($0.25/$0.50 USD) - 2016/02/15 10:44:56 CET [2016/02/15 4:44:56 ET]
Table 'Vesta II' 9-max Seat #4 is the button
Seat 1: Ahangama ($55.90 in chips) 
Seat 3: matiko09 ($72.67 in chips) 
Seat 4: HJdream ($49.25 in chips) 
Seat 5: dndngod ($79.40 in chips) 
Seat 6: pandalapa ($53.23 in chips) 
Seat 7: OskarR89 ($103.73 in chips) 
Seat 8: Arystan ($57.59 in chips) 
Seat 9: Aoki42 ($68.12 in chips) 
dndngod: posts small blind $0.25
pandalapa: posts big blind $0.50
*** HOLE CARDS ***
Dealt to matiko09 [6h Kd]
OskarR89: folds 
Arystan: raises $1 to $1.50
Aoki42: folds 
Ahangama: raises $3 to $4.50
matiko09: folds 
HJdream: folds 
dndngod: folds 
pandalapa: folds 
Arystan: calls $3
*** FLOP *** [8d Th 8c]
Arystan: checks 
Ahangama: bets $5
Arystan: folds 
Uncalled bet ($5) returned to Ahangama
Ahangama collected $9.31 from pot
Ahangama: doesn't show hand 
*** SUMMARY ***
Total pot $9.75 | Rake $0.44 
Board [8d Th 8c]
Seat 1: Ahangama collected ($9.31)
Seat 3: matiko09 folded before Flop (didn't bet)
Seat 4: HJdream (button) folded before Flop (didn't bet)
Seat 5: dndngod (small blind) folded before Flop
Seat 6: pandalapa (big blind) folded before Flop
Seat 7: OskarR89 folded before Flop (didn't bet)
Seat 8: Arystan folded on the Flop
Seat 9: Aoki42 folded before Flop (didn't bet)





PokerStars Hand #148832537671:  Hold'em No Limit ($0.50/$1.00 USD) - 2016/02/15 10:44:57 CET [2016/02/15 4:44:57 ET]
Table 'Gemma II' 9-max Seat #9 is the button
Seat 1: Igor DoUrden ($174.28 in chips) 
Seat 2: WDW3 ($129.43 in chips) 
Seat 3: Venomous100% ($143.74 in chips) 
Seat 4: mycka86 ($100 in chips) 
Seat 5: PokerSash201 ($54.91 in chips) 
Seat 6: fanmtZ ($40 in chips) 
Seat 7: AlKatrone ($106.01 in chips) 
Seat 8: vrnMike ($175.29 in chips) 
Seat 9: matiko09 ($111.17 in chips) 
Igor DoUrden: posts small blind $0.50
WDW3: posts big blind $1
*** HOLE CARDS ***
Dealt to matiko09 [7s 7d]
Venomous100%: folds 
mycka86: folds 
PokerSash201: folds 
fanmtZ: folds 
AlKatrone: folds 
vrnMike: folds 
matiko09: raises $1.27 to $2.27
Igor DoUrden: raises $5.54 to $7.81
WDW3: folds 
matiko09: calls $5.54
*** FLOP *** [Jd Ad 8c]
Igor DoUrden: checks 
matiko09: checks 
*** TURN *** [Jd Ad 8c] [Kc]
Igor DoUrden: checks 
matiko09: checks 
*** RIVER *** [Jd Ad 8c Kc] [4h]
Igor DoUrden: checks 
matiko09: checks 
*** SHOW DOWN ***
Igor DoUrden: shows [Th Ts] (a pair of Tens)
matiko09: mucks hand 
Igor DoUrden collected $15.87 from pot
*** SUMMARY ***
Total pot $16.62 | Rake $0.75 
Board [Jd Ad 8c Kc 4h]
Seat 1: Igor DoUrden (small blind) showed [Th Ts] and won ($15.87) with a pair of Tens
Seat 2: WDW3 (big blind) folded before Flop
Seat 3: Venomous100% folded before Flop (didn't bet)
Seat 4: mycka86 folded before Flop (didn't bet)
Seat 5: PokerSash201 folded before Flop (didn't bet)
Seat 6: fanmtZ folded before Flop (didn't bet)
Seat 7: AlKatrone folded before Flop (didn't bet)
Seat 8: vrnMike folded before Flop (didn't bet)
Seat 9: matiko09 (button) mucked [7s 7d]





PokerStars Hand #148832537398:  Hold'em No Limit ($0.50/$1.00 USD) - 2016/02/15 10:44:57 CET [2016/02/15 4:44:57 ET]
Table 'Corvus III' 9-max Seat #6 is the button
Seat 4: goransyruvka ($207.35 in chips) 
Seat 5: koib88 ($152.48 in chips) 
Seat 6: WDW3 ($233.69 in chips) 
Seat 7: matiko09 ($252.08 in chips) 
Seat 8: redacesfull ($109.31 in chips) 
matiko09: posts small blind $0.50
redacesfull: posts big blind $1
goransyruvka: posts the ante $0.20
koib88: posts the ante $0.20
WDW3: posts the ante $0.20
matiko09: posts the ante $0.20
redacesfull: posts the ante $0.20
*** HOLE CARDS ***
Dealt to matiko09 [8d 6h]
er13to joins the table at seat #9 
goransyruvka: calls $1
koib88: folds 
WDW3: calls $1
matiko09: folds 
redacesfull: checks 
*** FLOP *** [9h 9s Ah]
redacesfull: checks 
goransyruvka: checks 
WDW3: checks 
*** TURN *** [9h 9s Ah] [8h]
redacesfull: bets $4
goransyruvka: folds 
WDW3: folds 
Uncalled bet ($4) returned to redacesfull
redacesfull collected $4.30 from pot
redacesfull: doesn't show hand 
*** SUMMARY ***
Total pot $4.50 | Rake $0.20 
Board [9h 9s Ah 8h]
Seat 4: goransyruvka folded on the Turn
Seat 5: koib88 folded before Flop (didn't bet)
Seat 6: WDW3 (button) folded on the Turn
Seat 7: matiko09 (small blind) folded before Flop
Seat 8: redacesfull (big blind) collected ($4.30)





PokerStars Hand #148832537816:  Hold'em No Limit ($0.50/$1.00 USD) - 2016/02/15 10:44:58 CET [2016/02/15 4:44:58 ET]
Table 'Euanthe II' 9-max Seat #8 is the button
Seat 1: maxxmeister ($155.78 in chips) 
Seat 2: mycka86 ($185.84 in chips) 
Seat 3: fanmtZ ($64.28 in chips) 
Seat 4: thevibes ($135.74 in chips) 
Seat 5: vrnMike ($123.19 in chips) 
Seat 6: grugz33 ($37.54 in chips) 
Seat 7: vinniesmol ($217.44 in chips) 
Seat 8: matiko09 ($115.08 in chips) 
Seat 9: Venomous100% ($100 in chips) 
Venomous100%: posts small blind $0.50
maxxmeister: posts big blind $1
*** HOLE CARDS ***
Dealt to matiko09 [2h 3h]
mycka86: folds 
fanmtZ: folds 
thevibes: folds 
vrnMike: raises $2 to $3
grugz33: folds 
vinniesmol: folds 
matiko09: folds 
Venomous100%: folds 
maxxmeister: folds 
Uncalled bet ($2) returned to vrnMike
vrnMike collected $2.50 from pot
*** SUMMARY ***
Total pot $2.50 | Rake $0 
Seat 1: maxxmeister (big blind) folded before Flop
Seat 2: mycka86 folded before Flop (didn't bet)
Seat 3: fanmtZ folded before Flop (didn't bet)
Seat 4: thevibes folded before Flop (didn't bet)
Seat 5: vrnMike collected ($2.50)
Seat 6: grugz33 folded before Flop (didn't bet)
Seat 7: vinniesmol folded before Flop (didn't bet)
Seat 8: matiko09 (button) folded before Flop (didn't bet)
Seat 9: Venomous100% (small blind) folded before Flop





PokerStars Hand #148832541272:  Hold'em No Limit (€0.25/€0.50 EUR) - 2016/02/15 10:45:06 CET [2016/02/15 4:45:06 ET]
Table 'Walinskia II' 9-max Seat #4 is the button
Seat 1: ljryviltj (€49.25 in chips) 
Seat 2: yats87 (€50 in chips) 
Seat 3: beluccix (€27.89 in chips) 
Seat 4: Otsime (€37.59 in chips) 
Seat 5: vano7777 (€53.46 in chips) 
Seat 6: 50CandyJoe (€62.52 in chips) 
Seat 8: matiko09 (€50 in chips) 
Seat 9: stevevg84 (€34.60 in chips) 
vano7777: posts small blind €0.25
50CandyJoe: posts big blind €0.50
*** HOLE CARDS ***
Dealt to matiko09 [4s Qc]
matiko09: folds 
stevevg84: calls €0.50
ljryviltj: folds 
yats87: folds 
beluccix: folds 
Otsime: folds 
vano7777: folds 
50CandyJoe: raises €1.50 to €2
stevevg84: folds 
Uncalled bet (€1.50) returned to 50CandyJoe
50CandyJoe collected €1.25 from pot
50CandyJoe: doesn't show hand 
*** SUMMARY ***
Total pot €1.25 | Rake €0 
Seat 1: ljryviltj folded before Flop (didn't bet)
Seat 2: yats87 folded before Flop (didn't bet)
Seat 3: beluccix folded before Flop (didn't bet)
Seat 4: Otsime (button) folded before Flop (didn't bet)
Seat 5: vano7777 (small blind) folded before Flop
Seat 6: 50CandyJoe (big blind) collected (€1.25)
Seat 8: matiko09 folded before Flop (didn't bet)
Seat 9: stevevg84 folded before Flop





PokerStars Hand #148832545521:  Hold'em No Limit ($0.50/$1.00 USD) - 2016/02/15 10:45:16 CET [2016/02/15 4:45:16 ET]
Table 'Euanthe II' 9-max Seat #9 is the button
Seat 1: maxxmeister ($154.78 in chips) 
Seat 2: mycka86 ($185.84 in chips) 
Seat 3: fanmtZ ($64.28 in chips) 
Seat 4: thevibes ($135.74 in chips) 
Seat 5: vrnMike ($124.69 in chips) 
Seat 6: grugz33 ($37.54 in chips) 
Seat 7: vinniesmol ($217.44 in chips) 
Seat 8: matiko09 ($115.08 in chips) 
Seat 9: Venomous100% ($100 in chips) 
maxxmeister: posts small blind $0.50
mycka86: posts big blind $1
*** HOLE CARDS ***
Dealt to matiko09 [Ah As]
fanmtZ: folds 
thevibes: raises $2 to $3
vrnMike: folds 
grugz33: folds 
vinniesmol: folds 
matiko09: raises $6.50 to $9.50
Venomous100%: folds 
maxxmeister: folds 
mycka86: folds 
thevibes: folds 
Uncalled bet ($6.50) returned to matiko09
matiko09 collected $7.50 from pot
matiko09: doesn't show hand 
*** SUMMARY ***
Total pot $7.50 | Rake $0 
Seat 1: maxxmeister (small blind) folded before Flop
Seat 2: mycka86 (big blind) folded before Flop
Seat 3: fanmtZ folded before Flop (didn't bet)
Seat 4: thevibes folded before Flop
Seat 5: vrnMike folded before Flop (didn't bet)
Seat 6: grugz33 folded before Flop (didn't bet)
Seat 7: vinniesmol folded before Flop (didn't bet)
Seat 8: matiko09 collected ($7.50)
Seat 9: Venomous100% (button) folded before Flop (didn't bet)





PokerStars Hand #148832550045:  Hold'em No Limit ($0.25/$0.50 USD) - 2016/02/15 10:45:27 CET [2016/02/15 4:45:27 ET]
Table 'Laertes II' 9-max Seat #1 is the button
Seat 1: dade33 ($93.54 in chips) 
Seat 2: beluccix ($24.21 in chips) 
Seat 3: ljryviltj ($56.16 in chips) 
Seat 4: rgar93 ($40.53 in chips) 
Seat 5: vlad11122007 ($56.13 in chips) 
Seat 6: yats87 ($50 in chips) 
Seat 7: OskarR89 ($73.67 in chips) 
Seat 8: Trent444 ($43.48 in chips) 
Seat 9: matiko09 ($50 in chips) 
beluccix: posts small blind $0.25
ljryviltj: posts big blind $0.50
*** HOLE CARDS ***
Dealt to matiko09 [6d Jh]
rgar93: folds 
vlad11122007: raises $1 to $1.50
yats87: folds 
OskarR89: folds 
Trent444: folds 
matiko09: folds 
dade33: folds 
beluccix: folds 
ljryviltj: folds 
Uncalled bet ($1) returned to vlad11122007
vlad11122007 collected $1.25 from pot
vlad11122007: doesn't show hand 
*** SUMMARY ***
Total pot $1.25 | Rake $0 
Seat 1: dade33 (button) folded before Flop (didn't bet)
Seat 2: beluccix (small blind) folded before Flop
Seat 3: ljryviltj (big blind) folded before Flop
Seat 4: rgar93 folded before Flop (didn't bet)
Seat 5: vlad11122007 collected ($1.25)
Seat 6: yats87 folded before Flop (didn't bet)
Seat 7: OskarR89 folded before Flop (didn't bet)
Seat 8: Trent444 folded before Flop (didn't bet)
Seat 9: matiko09 folded before Flop (didn't bet)





PokerStars Hand #148832551629:  Hold'em No Limit ($0.50/$1.00 USD) - 2016/02/15 10:45:31 CET [2016/02/15 4:45:31 ET]
Table 'Corvus III' 9-max Seat #7 is the button
Seat 4: goransyruvka ($206.15 in chips) 
Seat 5: koib88 ($152.28 in chips) 
Seat 6: WDW3 ($232.49 in chips) 
Seat 7: matiko09 ($251.38 in chips) 
Seat 8: redacesfull ($112.41 in chips) 
Seat 9: er13to ($100 in chips) 
redacesfull: posts small blind $0.50
er13to: posts big blind $1
goransyruvka: posts the ante $0.20
koib88: posts the ante $0.20
WDW3: posts the ante $0.20
matiko09: posts the ante $0.20
redacesfull: posts the ante $0.20
er13to: posts the ante $0.20
*** HOLE CARDS ***
Dealt to matiko09 [8c Th]
goransyruvka: calls $1
koib88: folds 
WDW3: raises $3.50 to $4.50
matiko09: folds 
redacesfull: folds 
er13to: folds 
goransyruvka: calls $3.50
*** FLOP *** [2d 5d 9s]
goransyruvka: checks 
WDW3: checks 
*** TURN *** [2d 5d 9s] [As]
goransyruvka: bets $5.58
WDW3: folds 
Uncalled bet ($5.58) returned to goransyruvka
goransyruvka collected $11.17 from pot
goransyruvka: doesn't show hand 
*** SUMMARY ***
Total pot $11.70 | Rake $0.53 
Board [2d 5d 9s As]
Seat 4: goransyruvka collected ($11.17)
Seat 5: koib88 folded before Flop (didn't bet)
Seat 6: WDW3 folded on the Turn
Seat 7: matiko09 (button) folded before Flop (didn't bet)
Seat 8: redacesfull (small blind) folded before Flop
Seat 9: er13to (big blind) folded before Flop





PokerStars Hand #148832555364:  Hold'em No Limit ($0.50/$1.00 USD) - 2016/02/15 10:45:40 CET [2016/02/15 4:45:40 ET]
Table 'Urania' 9-max Seat #5 is the button
Seat 1: matiko09 ($100 in chips) 
Seat 2: maxxmeister ($117.58 in chips) 
Seat 3: WDW3 ($108.69 in chips) 
Seat 4: AlKatrone ($100 in chips) 
Seat 5: maxonplay ($178.08 in chips) 
Seat 6: vrnMike ($194.74 in chips) 
Seat 7: darren1031 ($165.24 in chips) 
Seat 8: Venomous100% ($120.63 in chips) 
Seat 9: mycka86 ($100 in chips) 
vrnMike: posts small blind $0.50
darren1031 is disconnected 
darren1031 is connected 
darren1031: posts big blind $1
*** HOLE CARDS ***
Dealt to matiko09 [As 2c]
Venomous100%: raises $2 to $3
mycka86: folds 
matiko09: folds 
maxxmeister: folds 
WDW3: folds 
AlKatrone: folds 
maxonplay: folds 
vrnMike: folds 
darren1031: folds 
Uncalled bet ($2) returned to Venomous100%
Venomous100% collected $2.50 from pot
Venomous100%: doesn't show hand 
*** SUMMARY ***
Total pot $2.50 | Rake $0 
Seat 1: matiko09 folded before Flop (didn't bet)
Seat 2: maxxmeister folded before Flop (didn't bet)
Seat 3: WDW3 folded before Flop (didn't bet)
Seat 4: AlKatrone folded before Flop (didn't bet)
Seat 5: maxonplay (button) folded before Flop (didn't bet)
Seat 6: vrnMike (small blind) folded before Flop
Seat 7: darren1031 (big blind) folded before Flop
Seat 8: Venomous100% collected ($2.50)
Seat 9: mycka86 folded before Flop (didn't bet)





PokerStars Hand #148832556580:  Hold'em No Limit ($0.25/$0.50 USD) - 2016/02/15 10:45:43 CET [2016/02/15 4:45:43 ET]
Table 'Vesta II' 9-max Seat #5 is the button
Seat 1: Ahangama ($60.71 in chips) 
Seat 3: matiko09 ($72.67 in chips) 
Seat 4: HJdream ($49.25 in chips) 
Seat 5: dndngod ($79.15 in chips) 
Seat 6: pandalapa ($52.73 in chips) 
Seat 7: OskarR89 ($103.73 in chips) 
Seat 8: Arystan ($53.09 in chips) 
Seat 9: Aoki42 ($68.12 in chips) 
pandalapa: posts small blind $0.25
OskarR89: posts big blind $0.50
*** HOLE CARDS ***
Dealt to matiko09 [9c 9s]
Arystan: folds 
Aoki42: folds 
Ahangama: folds 
matiko09: raises $1 to $1.50
HJdream: folds 
dndngod: folds 
pandalapa: folds 
OskarR89: calls $1
*** FLOP *** [5h 2d Ad]
OskarR89: checks 
matiko09: bets $2
OskarR89: calls $2
*** TURN *** [5h 2d Ad] [8d]
OskarR89: checks 
matiko09: checks 
*** RIVER *** [5h 2d Ad 8d] [8h]
OskarR89: checks 
matiko09: checks 
*** SHOW DOWN ***
OskarR89: shows [3h 3c] (two pair, Eights and Threes)
matiko09: shows [9c 9s] (two pair, Nines and Eights)
matiko09 collected $6.92 from pot
*** SUMMARY ***
Total pot $7.25 | Rake $0.33 
Board [5h 2d Ad 8d 8h]
Seat 1: Ahangama folded before Flop (didn't bet)
Seat 3: matiko09 showed [9c 9s] and won ($6.92) with two pair, Nines and Eights
Seat 4: HJdream folded before Flop (didn't bet)
Seat 5: dndngod (button) folded before Flop (didn't bet)
Seat 6: pandalapa (small blind) folded before Flop
Seat 7: OskarR89 (big blind) showed [3h 3c] and lost with two pair, Eights and Threes
Seat 8: Arystan folded before Flop (didn't bet)
Seat 9: Aoki42 folded before Flop (didn't bet)





PokerStars Hand #148832557964:  Hold'em No Limit ($0.50/$1.00 USD) - 2016/02/15 10:45:46 CET [2016/02/15 4:45:46 ET]
Table 'Praecipua' 9-max Seat #9 is the button
Seat 1: matiko09 ($123.07 in chips) 
Seat 2: vrnMike ($113.67 in chips) 
Seat 3: Venomous100% ($113.03 in chips) 
Seat 4: Priidix ($117.78 in chips) 
Seat 5: huffwag ($33.56 in chips) 
Seat 6: mycka86 ($106.84 in chips) 
Seat 7: maxxmeister ($194.49 in chips) 
Seat 8: Kalesmash08 ($72.31 in chips) 
Seat 9: AlKatrone ($102.02 in chips) 
matiko09: posts small blind $0.50
vrnMike: posts big blind $1
*** HOLE CARDS ***
Dealt to matiko09 [9c 8h]
Venomous100%: folds 
Priidix: raises $2 to $3
huffwag: raises $7.50 to $10.50
mycka86: folds 
maxxmeister: folds 
Kalesmash08: folds 
AlKatrone: folds 
matiko09: folds 
vrnMike: folds 
Priidix: folds 
Uncalled bet ($7.50) returned to huffwag
huffwag collected $7.50 from pot
huffwag: doesn't show hand 
*** SUMMARY ***
Total pot $7.50 | Rake $0 
Seat 1: matiko09 (small blind) folded before Flop
Seat 2: vrnMike (big blind) folded before Flop
Seat 3: Venomous100% folded before Flop (didn't bet)
Seat 4: Priidix folded before Flop
Seat 5: huffwag collected ($7.50)
Seat 6: mycka86 folded before Flop (didn't bet)
Seat 7: maxxmeister folded before Flop (didn't bet)
Seat 8: Kalesmash08 folded before Flop (didn't bet)
Seat 9: AlKatrone (button) folded before Flop (didn't bet)





PokerStars Hand #148832560623:  Hold'em No Limit ($0.50/$1.00 USD) - 2016/02/15 10:45:52 CET [2016/02/15 4:45:52 ET]
Table 'Euanthe II' 9-max Seat #1 is the button
Seat 1: maxxmeister ($154.28 in chips) 
Seat 2: mycka86 ($184.84 in chips) 
Seat 3: fanmtZ ($64.28 in chips) 
Seat 4: thevibes ($132.74 in chips) 
Seat 5: vrnMike ($124.69 in chips) 
Seat 6: grugz33 ($37.54 in chips) 
Seat 7: vinniesmol ($217.44 in chips) 
Seat 8: matiko09 ($119.58 in chips) 
Seat 9: Venomous100% ($100 in chips) 
mycka86: posts small blind $0.50
fanmtZ: posts big blind $1
*** HOLE CARDS ***
Dealt to matiko09 [Qs Ks]
thevibes: folds 
vrnMike: folds 
thevibes leaves the table
grugz33: folds 
vinniesmol: folds 
matiko09: raises $2 to $3
Venomous100%: folds 
maxxmeister: folds 
mycka86: folds 
fanmtZ: folds 
Uncalled bet ($2) returned to matiko09
matiko09 collected $2.50 from pot
matiko09: doesn't show hand 
*** SUMMARY ***
Total pot $2.50 | Rake $0 
Seat 1: maxxmeister (button) folded before Flop (didn't bet)
Seat 2: mycka86 (small blind) folded before Flop
Seat 3: fanmtZ (big blind) folded before Flop
Seat 4: thevibes folded before Flop (didn't bet)
Seat 5: vrnMike folded before Flop (didn't bet)
Seat 6: grugz33 folded before Flop (didn't bet)
Seat 7: vinniesmol folded before Flop (didn't bet)
Seat 8: matiko09 collected ($2.50)
Seat 9: Venomous100% folded before Flop (didn't bet)





PokerStars Hand #148832562617:  Hold'em No Limit ($0.50/$1.00 USD) - 2016/02/15 10:45:57 CET [2016/02/15 4:45:57 ET]
Table 'Anteros' 9-max Seat #5 is the button
Seat 1: OskarR89 ($100 in chips) 
Seat 2: IHouseMusic ($104.14 in chips) 
Seat 4: misherei ($201.94 in chips) 
Seat 5: Holm1991 ($88.82 in chips) 
Seat 7: Zoubou1983 ($78.84 in chips) 
Seat 8: matiko09 ($101.41 in chips) 
Seat 9: WDW3 ($101.50 in chips) 
Zoubou1983: posts small blind $0.50
matiko09: posts big blind $1
fanmtZ: sits out 
*** HOLE CARDS ***
Dealt to matiko09 [8c Kd]
WDW3: folds 
OskarR89: folds 
IHouseMusic: folds 
misherei: folds 
Holm1991: folds 
Zoubou1983: calls $0.50
matiko09: raises $3 to $4
Zoubou1983: calls $3
*** FLOP *** [Jd Ks As]
Zoubou1983: bets $4
matiko09: calls $4
*** TURN *** [Jd Ks As] [4s]
Zoubou1983: bets $8
matiko09: folds 
Uncalled bet ($8) returned to Zoubou1983
Zoubou1983 collected $15.28 from pot
Zoubou1983: doesn't show hand 
*** SUMMARY ***
Total pot $16 | Rake $0.72 
Board [Jd Ks As 4s]
Seat 1: OskarR89 folded before Flop (didn't bet)
Seat 2: IHouseMusic folded before Flop (didn't bet)
Seat 4: misherei folded before Flop (didn't bet)
Seat 5: Holm1991 (button) folded before Flop (didn't bet)
Seat 7: Zoubou1983 (small blind) collected ($15.28)
Seat 8: matiko09 (big blind) folded on the Turn
Seat 9: WDW3 folded before Flop (didn't bet)





PokerStars Hand #148832563935:  Hold'em No Limit ($0.50/$1.00 USD) - 2016/02/15 10:46:00 CET [2016/02/15 4:46:00 ET]
Table 'Gemma II' 9-max Seat #1 is the button
Seat 1: Igor DoUrden ($182.34 in chips) 
Seat 2: WDW3 ($128.43 in chips) 
Seat 3: Venomous100% ($143.74 in chips) 
Seat 4: mycka86 ($100 in chips) 
Seat 5: PokerSash201 ($54.91 in chips) 
Seat 6: fanmtZ ($40 in chips) 
Seat 7: AlKatrone ($106.01 in chips) 
Seat 8: vrnMike ($175.29 in chips) 
Seat 9: matiko09 ($103.36 in chips) 
WDW3: posts small blind $0.50
Venomous100%: posts big blind $1
*** HOLE CARDS ***
Dealt to matiko09 [5s 4s]
mycka86: folds 
PokerSash201: calls $1
fanmtZ: folds 
AlKatrone: folds 
vrnMike: folds 
matiko09: raises $3 to $4
Igor DoUrden: folds 
WDW3: folds 
Venomous100%: calls $3
PokerSash201: calls $3
*** FLOP *** [4h Kc Td]
Venomous100%: checks 
PokerSash201: checks 
matiko09: checks 
*** TURN *** [4h Kc Td] [9d]
Venomous100%: bets $8.95
PokerSash201: folds 
matiko09: folds 
Uncalled bet ($8.95) returned to Venomous100%
Venomous100% collected $11.94 from pot
Venomous100%: doesn't show hand 
*** SUMMARY ***
Total pot $12.50 | Rake $0.56 
Board [4h Kc Td 9d]
Seat 1: Igor DoUrden (button) folded before Flop (didn't bet)
Seat 2: WDW3 (small blind) folded before Flop
Seat 3: Venomous100% (big blind) collected ($11.94)
Seat 4: mycka86 folded before Flop (didn't bet)
Seat 5: PokerSash201 folded on the Turn
Seat 6: fanmtZ folded before Flop (didn't bet)
Seat 7: AlKatrone folded before Flop (didn't bet)
Seat 8: vrnMike folded before Flop (didn't bet)
Seat 9: matiko09 folded on the Turn





PokerStars Hand #148832566172:  Hold'em No Limit ($0.25/$0.50 USD) - 2016/02/15 10:46:06 CET [2016/02/15 4:46:06 ET]
Table 'Eltigen II' 9-max Seat #9 is the button
Seat 1: ljryviltj ($51 in chips) 
Seat 2: matiko09 ($50 in chips) 
Seat 9: DarkNinja8 ($39 in chips) 
ljryviltj: posts small blind $0.25
matiko09: posts big blind $0.50
*** HOLE CARDS ***
Dealt to matiko09 [8c 2d]
DarkNinja8: raises $1 to $1.50
ljryviltj: folds 
matiko09: folds 
Uncalled bet ($1) returned to DarkNinja8
DarkNinja8 collected $1.25 from pot
DarkNinja8: doesn't show hand 
*** SUMMARY ***
Total pot $1.25 | Rake $0 
Seat 1: ljryviltj (small blind) folded before Flop
Seat 2: matiko09 (big blind) folded before Flop
Seat 9: DarkNinja8 (button) collected ($1.25)





PokerStars Hand #148832568493:  Hold'em No Limit ($0.50/$1.00 USD) - 2016/02/15 10:46:11 CET [2016/02/15 4:46:11 ET]
Table 'Corvus III' 9-max Seat #8 is the button
Seat 4: goransyruvka ($212.62 in chips) 
Seat 5: koib88 ($152.08 in chips) 
Seat 6: WDW3 ($227.79 in chips) 
Seat 7: matiko09 ($251.18 in chips) 
Seat 8: redacesfull ($111.71 in chips) 
Seat 9: er13to ($100 in chips) 
er13to: posts small blind $0.50
goransyruvka: posts big blind $1
goransyruvka: posts the ante $0.20
koib88: posts the ante $0.20
WDW3: posts the ante $0.20
matiko09: posts the ante $0.20
redacesfull: posts the ante $0.20
er13to: posts the ante $0.20
*** HOLE CARDS ***
Dealt to matiko09 [9s 8d]
koib88: calls $1
WDW3: folds 
matiko09: folds 
redacesfull: folds 
er13to: folds 
goransyruvka: checks 
*** FLOP *** [2h 5d 8c]
goransyruvka: checks 
koib88: checks 
*** TURN *** [2h 5d 8c] [4c]
goransyruvka: bets $1
koib88: raises $1 to $2
goransyruvka: raises $1 to $3
koib88: calls $1
*** RIVER *** [2h 5d 8c 4c] [5s]
goransyruvka: bets $4.63
koib88: calls $4.63
*** SHOW DOWN ***
goransyruvka: shows [4s 2d] (two pair, Fives and Fours)
koib88: shows [Th 5h] (three of a kind, Fives)
koib88 collected $18.11 from pot
*** SUMMARY ***
Total pot $18.96 | Rake $0.85 
Board [2h 5d 8c 4c 5s]
Seat 4: goransyruvka (big blind) showed [4s 2d] and lost with two pair, Fives and Fours
Seat 5: koib88 showed [Th 5h] and won ($18.11) with three of a kind, Fives
Seat 6: WDW3 folded before Flop (didn't bet)
Seat 7: matiko09 folded before Flop (didn't bet)
Seat 8: redacesfull (button) folded before Flop (didn't bet)
Seat 9: er13to (small blind) folded before Flop





PokerStars Hand #148832570043:  Hold'em No Limit ($0.50/$1.00 USD) - 2016/02/15 10:46:15 CET [2016/02/15 4:46:15 ET]
Table 'Urania' 9-max Seat #6 is the button
Seat 1: matiko09 ($100 in chips) 
Seat 2: maxxmeister ($117.58 in chips) 
Seat 3: WDW3 ($108.69 in chips) 
Seat 4: AlKatrone ($100 in chips) 
Seat 5: maxonplay ($178.08 in chips) 
Seat 6: vrnMike ($194.24 in chips) 
Seat 7: darren1031 ($164.24 in chips) 
Seat 8: Venomous100% ($122.13 in chips) 
Seat 9: mycka86 ($100 in chips) 
darren1031: posts small blind $0.50
Venomous100%: posts big blind $1
*** HOLE CARDS ***
Dealt to matiko09 [Qc Qs]
mycka86: raises $2 to $3
matiko09: calls $3
maxxmeister: folds 
WDW3: folds 
AlKatrone: folds 
maxonplay: folds 
vrnMike: calls $3
darren1031: calls $2.50
Venomous100%: folds 
*** FLOP *** [6s Kh 9h]
darren1031: checks 
mycka86: bets $8.50
matiko09: folds 
vrnMike: folds 
darren1031: folds 
Uncalled bet ($8.50) returned to mycka86
mycka86 collected $12.42 from pot
*** SUMMARY ***
Total pot $13 | Rake $0.58 
Board [6s Kh 9h]
Seat 1: matiko09 folded on the Flop
Seat 2: maxxmeister folded before Flop (didn't bet)
Seat 3: WDW3 folded before Flop (didn't bet)
Seat 4: AlKatrone folded before Flop (didn't bet)
Seat 5: maxonplay folded before Flop (didn't bet)
Seat 6: vrnMike (button) folded on the Flop
Seat 7: darren1031 (small blind) folded on the Flop
Seat 8: Venomous100% (big blind) folded before Flop
Seat 9: mycka86 collected ($12.42)





PokerStars Hand #148832571533:  Hold'em No Limit ($0.50/$1.00 USD) - 2016/02/15 10:46:18 CET [2016/02/15 4:46:18 ET]
Table 'Euanthe II' 9-max Seat #2 is the button
Seat 1: maxxmeister ($154.28 in chips) 
Seat 2: mycka86 ($184.34 in chips) 
Seat 3: fanmtZ ($63.28 in chips) 
Seat 5: vrnMike ($124.69 in chips) 
Seat 6: grugz33 ($37.54 in chips) 
Seat 7: vinniesmol ($217.44 in chips) 
Seat 8: matiko09 ($121.08 in chips) 
Seat 9: Venomous100% ($100 in chips) 
fanmtZ: posts small blind $0.50
vrnMike: posts big blind $1
*** HOLE CARDS ***
Dealt to matiko09 [Th 3d]
grugz33: folds 
vinniesmol: folds 
matiko09: folds 
AlKatrone joins the table at seat #4 
Venomous100%: folds 
AlKatrone leaves the table
er13to joins the table at seat #4 
maxxmeister: raises $2 to $3
mycka86: raises $7 to $10
fanmtZ: folds 
vrnMike: folds 
maxxmeister: folds 
Uncalled bet ($7) returned to mycka86
mycka86 collected $7.50 from pot
*** SUMMARY ***
Total pot $7.50 | Rake $0 
Seat 1: maxxmeister folded before Flop
Seat 2: mycka86 (button) collected ($7.50)
Seat 3: fanmtZ (small blind) folded before Flop
Seat 5: vrnMike (big blind) folded before Flop
Seat 6: grugz33 folded before Flop (didn't bet)
Seat 7: vinniesmol folded before Flop (didn't bet)
Seat 8: matiko09 folded before Flop (didn't bet)
Seat 9: Venomous100% folded before Flop (didn't bet)





PokerStars Hand #148832571935:  Hold'em No Limit ($0.50/$1.00 USD) - 2016/02/15 10:46:19 CET [2016/02/15 4:46:19 ET]
Table 'Praecipua' 9-max Seat #1 is the button
Seat 1: matiko09 ($122.57 in chips) 
Seat 2: vrnMike ($112.67 in chips) 
Seat 3: Venomous100% ($113.03 in chips) 
Seat 4: Priidix ($114.78 in chips) 
Seat 5: huffwag ($38.06 in chips) 
Seat 6: mycka86 ($106.84 in chips) 
Seat 7: maxxmeister ($194.49 in chips) 
Seat 8: Kalesmash08 ($72.31 in chips) 
Seat 9: AlKatrone ($102.02 in chips) 
vrnMike: posts small blind $0.50
Venomous100%: posts big blind $1
*** HOLE CARDS ***
Dealt to matiko09 [8s 5s]
Priidix: folds 
huffwag: folds 
mycka86: raises $2 to $3
maxxmeister: folds 
Kalesmash08: folds 
AlKatrone: calls $3
matiko09: folds 
vrnMike: folds 
Venomous100%: folds 
*** FLOP *** [Ks Kh Th]
mycka86: bets $4.50
AlKatrone: calls $4.50
*** TURN *** [Ks Kh Th] [7c]
mycka86: bets $10.50
AlKatrone: folds 
Uncalled bet ($10.50) returned to mycka86
mycka86 collected $15.76 from pot
*** SUMMARY ***
Total pot $16.50 | Rake $0.74 
Board [Ks Kh Th 7c]
Seat 1: matiko09 (button) folded before Flop (didn't bet)
Seat 2: vrnMike (small blind) folded before Flop
Seat 3: Venomous100% (big blind) folded before Flop
Seat 4: Priidix folded before Flop (didn't bet)
Seat 5: huffwag folded before Flop (didn't bet)
Seat 6: mycka86 collected ($15.76)
Seat 7: maxxmeister folded before Flop (didn't bet)
Seat 8: Kalesmash08 folded before Flop (didn't bet)
Seat 9: AlKatrone folded on the Turn





PokerStars Hand #148832573695:  Hold'em No Limit ($0.25/$0.50 USD) - 2016/02/15 10:46:24 CET [2016/02/15 4:46:24 ET]
Table 'Laertes II' 9-max Seat #2 is the button
Seat 1: dade33 ($93.54 in chips) 
Seat 2: beluccix ($24.21 in chips) 
Seat 3: ljryviltj ($55.66 in chips) 
Seat 4: rgar93 ($40.53 in chips) 
Seat 5: vlad11122007 ($56.88 in chips) 
Seat 6: yats87 ($50 in chips) 
Seat 7: OskarR89 ($73.67 in chips) 
Seat 8: Trent444 ($43.48 in chips) 
Seat 9: matiko09 ($50 in chips) 
ljryviltj: posts small blind $0.25
rgar93: posts big blind $0.50
*** HOLE CARDS ***
Dealt to matiko09 [2s 6s]
vlad11122007: folds 
yats87: raises $1 to $1.50
OskarR89: folds 
Trent444: folds 
matiko09: folds 
dade33: folds 
beluccix: folds 
ljryviltj: folds 
rgar93: calls $1
*** FLOP *** [Qc Kd Ac]
rgar93: checks 
yats87: checks 
*** TURN *** [Qc Kd Ac] [3d]
rgar93: checks 
yats87: checks 
*** RIVER *** [Qc Kd Ac 3d] [Ks]
rgar93: checks 
yats87: checks 
*** SHOW DOWN ***
rgar93: shows [9d 9c] (two pair, Kings and Nines)
yats87: mucks hand 
rgar93 collected $3.10 from pot
*** SUMMARY ***
Total pot $3.25 | Rake $0.15 
Board [Qc Kd Ac 3d Ks]
Seat 1: dade33 folded before Flop (didn't bet)
Seat 2: beluccix (button) folded before Flop (didn't bet)
Seat 3: ljryviltj (small blind) folded before Flop
Seat 4: rgar93 (big blind) showed [9d 9c] and won ($3.10) with two pair, Kings and Nines
Seat 5: vlad11122007 folded before Flop (didn't bet)
Seat 6: yats87 mucked [8h 8c]
Seat 7: OskarR89 folded before Flop (didn't bet)
Seat 8: Trent444 folded before Flop (didn't bet)
Seat 9: matiko09 folded before Flop (didn't bet)





PokerStars Hand #148832574641:  Hold'em No Limit ($0.25/$0.50 USD) - 2016/02/15 10:46:26 CET [2016/02/15 4:46:26 ET]
Table 'Eltigen II' 9-max Seat #1 is the button
Seat 1: ljryviltj ($50.75 in chips) 
Seat 2: matiko09 ($50 in chips) 
Seat 9: DarkNinja8 ($39.75 in chips) 
matiko09: posts small blind $0.25
DarkNinja8: posts big blind $0.50
*** HOLE CARDS ***
Dealt to matiko09 [Kh 7h]
ljryviltj: raises $0.56 to $1.06
matiko09: folds 
DarkNinja8: calls $0.56
*** FLOP *** [As 5h 6h]
DarkNinja8: checks 
ljryviltj: bets $1.50
DarkNinja8: folds 
Uncalled bet ($1.50) returned to ljryviltj
ljryviltj collected $2.26 from pot
ljryviltj: doesn't show hand 
*** SUMMARY ***
Total pot $2.37 | Rake $0.11 
Board [As 5h 6h]
Seat 1: ljryviltj (button) collected ($2.26)
Seat 2: matiko09 (small blind) folded before Flop
Seat 9: DarkNinja8 (big blind) folded on the Flop





PokerStars Hand #148832577000:  Hold'em No Limit ($0.25/$0.50 USD) - 2016/02/15 10:46:31 CET [2016/02/15 4:46:31 ET]
Table 'Vesta II' 9-max Seat #6 is the button
Seat 1: Ahangama ($60.71 in chips) 
Seat 3: matiko09 ($76.09 in chips) 
Seat 4: HJdream ($49.25 in chips) 
Seat 5: dndngod ($79.15 in chips) 
Seat 6: pandalapa ($52.48 in chips) 
Seat 7: OskarR89 ($100.23 in chips) 
Seat 8: Arystan ($53.09 in chips) 
Seat 9: Aoki42 ($68.12 in chips) 
OskarR89: posts small blind $0.25
Arystan: posts big blind $0.50
i L00K great: sits out 
*** HOLE CARDS ***
Dealt to matiko09 [4d Qs]
Aoki42: folds 
Ahangama: folds 
matiko09: folds 
HJdream: folds 
dndngod: folds 
pandalapa: raises $0.50 to $1
OskarR89: folds 
Arystan: calls $0.50
*** FLOP *** [7c 7h 5h]
Arystan: bets $1.07
pandalapa: calls $1.07
*** TURN *** [7c 7h 5h] [2c]
Arystan: bets $2.09
pandalapa: calls $2.09
*** RIVER *** [7c 7h 5h 2c] [Ks]
Arystan: checks 
pandalapa: bets $8.18
Arystan: calls $8.18
*** SHOW DOWN ***
pandalapa: shows [Ad 9s] (a pair of Sevens)
Arystan: shows [5s 2s] (two pair, Sevens and Fives)
Arystan collected $23.81 from pot
*** SUMMARY ***
Total pot $24.93 | Rake $1.12 
Board [7c 7h 5h 2c Ks]
Seat 1: Ahangama folded before Flop (didn't bet)
Seat 3: matiko09 folded before Flop (didn't bet)
Seat 4: HJdream folded before Flop (didn't bet)
Seat 5: dndngod folded before Flop (didn't bet)
Seat 6: pandalapa (button) showed [Ad 9s] and lost with a pair of Sevens
Seat 7: OskarR89 (small blind) folded before Flop
Seat 8: Arystan (big blind) showed [5s 2s] and won ($23.81) with two pair, Sevens and Fives
Seat 9: Aoki42 folded before Flop (didn't bet)





PokerStars Hand #148832579093:  Hold'em No Limit (€0.25/€0.50 EUR) - 2016/02/15 10:46:36 CET [2016/02/15 4:46:36 ET]
Table 'Walinskia II' 9-max Seat #5 is the button
Seat 1: ljryviltj (€49.25 in chips) 
Seat 2: yats87 (€50 in chips) 
Seat 3: beluccix (€27.89 in chips) 
Seat 4: Otsime (€37.59 in chips) 
Seat 5: vano7777 (€53.21 in chips) 
Seat 6: 50CandyJoe (€63.27 in chips) 
Seat 8: matiko09 (€50 in chips) 
Seat 9: stevevg84 (€34.10 in chips) 
50CandyJoe: posts small blind €0.25
OskarR89 was removed from the table for failing to post
matiko09: posts big blind €0.50
*** HOLE CARDS ***
Dealt to matiko09 [5h 2c]
etny99 joins the table at seat #7 
stevevg84: calls €0.50
ljryviltj: folds 
yats87: folds 
beluccix: folds 
Otsime: calls €0.50
vano7777: folds 
50CandyJoe: folds 
matiko09: checks 
*** FLOP *** [5d 8d Kd]
matiko09: checks 
stevevg84: checks 
Otsime: checks 
*** TURN *** [5d 8d Kd] [4c]
matiko09: checks 
stevevg84: bets €0.50
Otsime: folds 
matiko09: folds 
Uncalled bet (€0.50) returned to stevevg84
stevevg84 collected €1.67 from pot
stevevg84: doesn't show hand 
*** SUMMARY ***
Total pot €1.75 | Rake €0.08 
Board [5d 8d Kd 4c]
Seat 1: ljryviltj folded before Flop (didn't bet)
Seat 2: yats87 folded before Flop (didn't bet)
Seat 3: beluccix folded before Flop (didn't bet)
Seat 4: Otsime folded on the Turn
Seat 5: vano7777 (button) folded before Flop (didn't bet)
Seat 6: 50CandyJoe (small blind) folded before Flop
Seat 8: matiko09 (big blind) folded on the Turn
Seat 9: stevevg84 collected (€1.67)





PokerStars Hand #148832589057:  Hold'em No Limit ($0.50/$1.00 USD) - 2016/02/15 10:46:59 CET [2016/02/15 4:46:59 ET]
Table 'Anteros' 9-max Seat #7 is the button
Seat 1: OskarR89 ($100 in chips) 
Seat 2: IHouseMusic ($104.14 in chips) 
Seat 4: misherei ($201.94 in chips) 
Seat 5: Holm1991 ($88.82 in chips) 
Seat 7: Zoubou1983 ($86.12 in chips) 
Seat 8: matiko09 ($100 in chips) 
matiko09: posts small blind $0.50
WDW3: is sitting out 
OskarR89: posts big blind $1
WDW3 leaves the table
fanmtZ: sits out 
SerAlGog: sits out 
*** HOLE CARDS ***
Dealt to matiko09 [3s 4s]
IHouseMusic: folds 
vrnMike joins the table at seat #9 
misherei: folds 
Holm1991: folds 
Zoubou1983: calls $1
matiko09: folds 
OskarR89: checks 
*** FLOP *** [Th Kh Qc]
OskarR89: checks 
Zoubou1983: checks 
*** TURN *** [Th Kh Qc] [9h]
OskarR89: checks 
Zoubou1983: bets $2
OskarR89: folds 
Uncalled bet ($2) returned to Zoubou1983
Zoubou1983 collected $2.39 from pot
Zoubou1983: doesn't show hand 
*** SUMMARY ***
Total pot $2.50 | Rake $0.11 
Board [Th Kh Qc 9h]
Seat 1: OskarR89 (big blind) folded on the Turn
Seat 2: IHouseMusic folded before Flop (didn't bet)
Seat 4: misherei folded before Flop (didn't bet)
Seat 5: Holm1991 folded before Flop (didn't bet)
Seat 7: Zoubou1983 (button) collected ($2.39)
Seat 8: matiko09 (small blind) folded before Flop





PokerStars Hand #148832591418:  Hold'em No Limit ($0.25/$0.50 USD) - 2016/02/15 10:47:05 CET [2016/02/15 4:47:05 ET]
Table 'Eltigen II' 9-max Seat #2 is the button
Seat 1: ljryviltj ($51.95 in chips) 
Seat 2: matiko09 ($50 in chips) 
Seat 9: DarkNinja8 ($38.69 in chips) 
DarkNinja8: posts small blind $0.25
ljryviltj: posts big blind $0.50
*** HOLE CARDS ***
Dealt to matiko09 [Jd Kh]
matiko09: raises $0.75 to $1.25
DarkNinja8: folds 
R@/\//\/Y305 joins the table at seat #5 
ljryviltj: raises $3.25 to $4.50
matiko09: calls $3.25
*** FLOP *** [2c Qd 8h]
ljryviltj: checks 
Prettyspitz joins the table at seat #6 
matiko09: checks 
*** TURN *** [2c Qd 8h] [Tc]
beluccix joins the table at seat #4 
ljryviltj: checks 
matiko09: bets $4.59
injener joins the table at seat #3 
ljryviltj: calls $4.59
*** RIVER *** [2c Qd 8h Tc] [9d]
Aoki42 joins the table at seat #8 
ljryviltj: checks 
matiko09: bets $13.50
DarkNinja8 said, "there they are"
ljryviltj: folds 
Uncalled bet ($13.50) returned to matiko09
matiko09 collected $17.60 from pot
matiko09: doesn't show hand 
*** SUMMARY ***
Total pot $18.43 | Rake $0.83 
Board [2c Qd 8h Tc 9d]
Seat 1: ljryviltj (big blind) folded on the River
Seat 2: matiko09 (button) collected ($17.60)
Seat 9: DarkNinja8 (small blind) folded before Flop





PokerStars Hand #148832591663:  Hold'em No Limit ($0.50/$1.00 USD) - 2016/02/15 10:47:06 CET [2016/02/15 4:47:06 ET]
Table 'Corvus III' 9-max Seat #9 is the button
Seat 4: goransyruvka ($203.79 in chips) 
Seat 5: koib88 ($161.36 in chips) 
Seat 6: WDW3 ($227.59 in chips) 
Seat 7: matiko09 ($250.98 in chips) 
Seat 8: redacesfull ($111.51 in chips) 
Seat 9: er13to ($100 in chips) 
goransyruvka: posts small blind $0.50
koib88: posts big blind $1
goransyruvka: posts the ante $0.20
koib88: posts the ante $0.20
WDW3: posts the ante $0.20
matiko09: posts the ante $0.20
redacesfull: posts the ante $0.20
er13to: posts the ante $0.20
*** HOLE CARDS ***
Dealt to matiko09 [Jc 4c]
WDW3: folds 
matiko09: folds 
redacesfull: raises $2 to $3
er13to: folds 
goransyruvka: calls $2.50
koib88: calls $2
*** FLOP *** [2s Ah 4h]
goransyruvka: checks 
koib88: checks 
redacesfull: bets $7
goransyruvka: calls $7
koib88: calls $7
*** TURN *** [2s Ah 4h] [Js]
goransyruvka: checks 
koib88: checks 
redacesfull: bets $22
goransyruvka: folds 
koib88: folds 
Uncalled bet ($22) returned to redacesfull
redacesfull collected $29.80 from pot
redacesfull: doesn't show hand 
*** SUMMARY ***
Total pot $31.20 | Rake $1.40 
Board [2s Ah 4h Js]
Seat 4: goransyruvka (small blind) folded on the Turn
Seat 5: koib88 (big blind) folded on the Turn
Seat 6: WDW3 folded before Flop (didn't bet)
Seat 7: matiko09 folded before Flop (didn't bet)
Seat 8: redacesfull collected ($29.80)
Seat 9: er13to (button) folded before Flop (didn't bet)





PokerStars Hand #148832594089:  Hold'em No Limit ($0.50/$1.00 USD) - 2016/02/15 10:47:11 CET [2016/02/15 4:47:11 ET]
Table 'Euanthe II' 9-max Seat #3 is the button
Seat 1: maxxmeister ($151.28 in chips) 
Seat 2: mycka86 ($188.84 in chips) 
Seat 3: fanmtZ ($62.78 in chips) 
Seat 5: vrnMike ($123.69 in chips) 
Seat 6: grugz33 ($37.54 in chips) 
Seat 7: vinniesmol ($217.44 in chips) 
Seat 8: matiko09 ($121.08 in chips) 
Seat 9: Venomous100% ($100 in chips) 
er13to will be allowed to play after the button
vrnMike: posts small blind $0.50
grugz33: posts big blind $1
*** HOLE CARDS ***
Dealt to matiko09 [Kh 6h]
vinniesmol: folds 
matiko09: folds 
Venomous100%: folds 
maxxmeister: raises $2 to $3
mycka86: folds 
fanmtZ: folds 
vrnMike: raises $8 to $11
grugz33: calls $10
maxxmeister: folds 
*** FLOP *** [2d 7s As]
vrnMike: checks 
grugz33: bets $26.54 and is all-in
vrnMike: calls $26.54
*** TURN *** [2d 7s As] [5c]
*** RIVER *** [2d 7s As 5c] [Td]
*** SHOW DOWN ***
vrnMike: shows [Js Jh] (a pair of Jacks)
grugz33: shows [7d 5d] (two pair, Sevens and Fives)
grugz33 collected $75.28 from pot
*** SUMMARY ***
Total pot $78.08 | Rake $2.80 
Board [2d 7s As 5c Td]
Seat 1: maxxmeister folded before Flop
Seat 2: mycka86 folded before Flop (didn't bet)
Seat 3: fanmtZ (button) folded before Flop (didn't bet)
Seat 5: vrnMike (small blind) showed [Js Jh] and lost with a pair of Jacks
Seat 6: grugz33 (big blind) showed [7d 5d] and won ($75.28) with two pair, Sevens and Fives
Seat 7: vinniesmol folded before Flop (didn't bet)
Seat 8: matiko09 folded before Flop (didn't bet)
Seat 9: Venomous100% folded before Flop (didn't bet)





PokerStars Hand #148832597908:  Hold'em No Limit ($0.50/$1.00 USD) - 2016/02/15 10:47:20 CET [2016/02/15 4:47:20 ET]
Table 'Gemma II' 9-max Seat #2 is the button
Seat 1: Igor DoUrden ($182.34 in chips) 
Seat 2: WDW3 ($127.93 in chips) 
Seat 3: Venomous100% ($151.68 in chips) 
Seat 4: mycka86 ($100 in chips) 
Seat 5: PokerSash201 ($50.91 in chips) 
Seat 6: fanmtZ ($40 in chips) 
Seat 7: AlKatrone ($106.01 in chips) 
Seat 8: vrnMike ($175.29 in chips) 
Seat 9: matiko09 ($100 in chips) 
Venomous100%: posts small blind $0.50
mycka86: posts big blind $1
*** HOLE CARDS ***
Dealt to matiko09 [2d 8h]
PokerSash201: folds 
fanmtZ: folds 
AlKatrone: folds 
vrnMike: raises $2 to $3
matiko09: folds 
Igor DoUrden: calls $3
WDW3: folds 
Venomous100%: folds 
mycka86: folds 
*** FLOP *** [Kc 3c Jd]
vrnMike: bets $5.50
Igor DoUrden: folds 
Uncalled bet ($5.50) returned to vrnMike
vrnMike collected $7.16 from pot
*** SUMMARY ***
Total pot $7.50 | Rake $0.34 
Board [Kc 3c Jd]
Seat 1: Igor DoUrden folded on the Flop
Seat 2: WDW3 (button) folded before Flop (didn't bet)
Seat 3: Venomous100% (small blind) folded before Flop
Seat 4: mycka86 (big blind) folded before Flop
Seat 5: PokerSash201 folded before Flop (didn't bet)
Seat 6: fanmtZ folded before Flop (didn't bet)
Seat 7: AlKatrone folded before Flop (didn't bet)
Seat 8: vrnMike collected ($7.16)
Seat 9: matiko09 folded before Flop (didn't bet)





PokerStars Hand #148832602081:  Hold'em No Limit (€0.25/€0.50 EUR) - 2016/02/15 10:47:30 CET [2016/02/15 4:47:30 ET]
Table 'Walinskia II' 9-max Seat #6 is the button
Seat 1: ljryviltj (€49.25 in chips) 
Seat 2: yats87 (€50 in chips) 
Seat 3: beluccix (€27.89 in chips) 
Seat 4: Otsime (€37.09 in chips) 
Seat 5: vano7777 (€53.21 in chips) 
Seat 6: 50CandyJoe (€63.02 in chips) 
Seat 8: matiko09 (€50 in chips) 
Seat 9: stevevg84 (€35.27 in chips) 
etny99 will be allowed to play after the button
matiko09: posts small blind €0.25
stevevg84: posts big blind €0.50
*** HOLE CARDS ***
Dealt to matiko09 [9s 5c]
ljryviltj: folds 
yats87: folds 
beluccix: folds 
Otsime: calls €0.50
vano7777: folds 
50CandyJoe: folds 
matiko09: folds 
stevevg84: checks 
*** FLOP *** [3h 3d Qh]
stevevg84: checks 
Otsime: checks 
*** TURN *** [3h 3d Qh] [Qc]
stevevg84: checks 
Otsime: checks 
*** RIVER *** [3h 3d Qh Qc] [5d]
stevevg84: bets €0.50
Otsime: calls €0.50
*** SHOW DOWN ***
stevevg84: shows [8c 3c] (a full house, Threes full of Queens)
Otsime: mucks hand 
stevevg84 collected €2.15 from pot
*** SUMMARY ***
Total pot €2.25 | Rake €0.10 
Board [3h 3d Qh Qc 5d]
Seat 1: ljryviltj folded before Flop (didn't bet)
Seat 2: yats87 folded before Flop (didn't bet)
Seat 3: beluccix folded before Flop (didn't bet)
Seat 4: Otsime mucked [Th Td]
Seat 5: vano7777 folded before Flop (didn't bet)
Seat 6: 50CandyJoe (button) folded before Flop (didn't bet)
Seat 8: matiko09 (small blind) folded before Flop
Seat 9: stevevg84 (big blind) showed [8c 3c] and won (€2.15) with a full house, Threes full of Queens





PokerStars Hand #148832603920:  Hold'em No Limit ($0.50/$1.00 USD) - 2016/02/15 10:47:35 CET [2016/02/15 4:47:35 ET]
Table 'Urania' 9-max Seat #7 is the button
Seat 1: matiko09 ($100 in chips) 
Seat 2: maxxmeister ($117.58 in chips) 
Seat 3: WDW3 ($108.69 in chips) 
Seat 4: AlKatrone ($100 in chips) 
Seat 5: maxonplay ($178.08 in chips) 
Seat 6: vrnMike ($191.24 in chips) 
Seat 7: darren1031 ($161.24 in chips) 
Seat 8: Venomous100% ($121.13 in chips) 
Seat 9: mycka86 ($109.42 in chips) 
Venomous100%: posts small blind $0.50
mycka86: posts big blind $1
*** HOLE CARDS ***
Dealt to matiko09 [3h 5h]
matiko09: folds 
maxxmeister: folds 
WDW3: folds 
AlKatrone: folds 
maxonplay: folds 
vrnMike: raises $2 to $3
darren1031: folds 
darren1031 leaves the table
Venomous100%: folds 
mycka86: folds 
Uncalled bet ($2) returned to vrnMike
vrnMike collected $2.50 from pot
*** SUMMARY ***
Total pot $2.50 | Rake $0 
Seat 1: matiko09 folded before Flop (didn't bet)
Seat 2: maxxmeister folded before Flop (didn't bet)
Seat 3: WDW3 folded before Flop (didn't bet)
Seat 4: AlKatrone folded before Flop (didn't bet)
Seat 5: maxonplay folded before Flop (didn't bet)
Seat 6: vrnMike collected ($2.50)
Seat 7: darren1031 (button) folded before Flop (didn't bet)
Seat 8: Venomous100% (small blind) folded before Flop
Seat 9: mycka86 (big blind) folded before Flop





PokerStars Hand #148832604071:  Hold'em No Limit ($0.50/$1.00 USD) - 2016/02/15 10:47:35 CET [2016/02/15 4:47:35 ET]
Table 'Anteros' 9-max Seat #8 is the button
Seat 1: OskarR89 ($100 in chips) 
Seat 2: IHouseMusic ($104.14 in chips) 
Seat 4: misherei ($201.94 in chips) 
Seat 5: Holm1991 ($88.82 in chips) 
Seat 7: Zoubou1983 ($87.51 in chips) 
Seat 8: matiko09 ($100 in chips) 
vrnMike will be allowed to play after the button
OskarR89: posts small blind $0.50
IHouseMusic: posts big blind $1
fanmtZ: sits out 
SerAlGog: sits out 
*** HOLE CARDS ***
Dealt to matiko09 [Js Th]
misherei: folds 
Holm1991: raises $1 to $2
Zoubou1983: folds 
matiko09: folds 
OskarR89: raises $5 to $7
IHouseMusic: folds 
Holm1991: calls $5
*** FLOP *** [Qd 7h 5s]
OskarR89: checks 
Holm1991: bets $9
OskarR89: calls $9
*** TURN *** [Qd 7h 5s] [2h]
OskarR89: checks 
Holm1991: checks 
*** RIVER *** [Qd 7h 5s 2h] [5d]
OskarR89: checks 
Holm1991: checks 
*** SHOW DOWN ***
OskarR89: shows [Qs Kd] (two pair, Queens and Fives)
Holm1991: mucks hand 
OskarR89 collected $31.52 from pot
*** SUMMARY ***
Total pot $33 | Rake $1.48 
Board [Qd 7h 5s 2h 5d]
Seat 1: OskarR89 (small blind) showed [Qs Kd] and won ($31.52) with two pair, Queens and Fives
Seat 2: IHouseMusic (big blind) folded before Flop
Seat 4: misherei folded before Flop (didn't bet)
Seat 5: Holm1991 mucked [9c Ac]
Seat 7: Zoubou1983 folded before Flop (didn't bet)
Seat 8: matiko09 (button) folded before Flop (didn't bet)





PokerStars Hand #148832606853:  Hold'em No Limit ($0.25/$0.50 USD) - 2016/02/15 10:47:42 CET [2016/02/15 4:47:42 ET]
Table 'Laertes II' 9-max Seat #3 is the button
Seat 1: dade33 ($93.54 in chips) 
Seat 2: beluccix ($24.21 in chips) 
Seat 3: ljryviltj ($55.41 in chips) 
Seat 4: rgar93 ($42.13 in chips) 
Seat 5: vlad11122007 ($56.88 in chips) 
Seat 6: yats87 ($50 in chips) 
Seat 7: OskarR89 ($73.67 in chips) 
Seat 8: Trent444 ($43.48 in chips) 
Seat 9: matiko09 ($50 in chips) 
rgar93: posts small blind $0.25
vlad11122007: posts big blind $0.50
*** HOLE CARDS ***
Dealt to matiko09 [4c 9h]
yats87: folds 
OskarR89: folds 
Trent444: folds 
matiko09: folds 
dade33: raises $1 to $1.50
beluccix: folds 
ljryviltj: folds 
rgar93: folds 
vlad11122007: folds 
Uncalled bet ($1) returned to dade33
dade33 collected $1.25 from pot
*** SUMMARY ***
Total pot $1.25 | Rake $0 
Seat 1: dade33 collected ($1.25)
Seat 2: beluccix folded before Flop (didn't bet)
Seat 3: ljryviltj (button) folded before Flop (didn't bet)
Seat 4: rgar93 (small blind) folded before Flop
Seat 5: vlad11122007 (big blind) folded before Flop
Seat 6: yats87 folded before Flop (didn't bet)
Seat 7: OskarR89 folded before Flop (didn't bet)
Seat 8: Trent444 folded before Flop (didn't bet)
Seat 9: matiko09 folded before Flop (didn't bet)





PokerStars Hand #148832609452:  Hold'em No Limit ($0.50/$1.00 USD) - 2016/02/15 10:47:48 CET [2016/02/15 4:47:48 ET]
Table 'Praecipua' 9-max Seat #2 is the button
Seat 1: matiko09 ($122.57 in chips) 
Seat 2: vrnMike ($112.17 in chips) 
Seat 3: Venomous100% ($112.03 in chips) 
Seat 5: huffwag ($38.06 in chips) 
Seat 6: mycka86 ($115.10 in chips) 
Seat 7: maxxmeister ($194.49 in chips) 
Seat 8: Kalesmash08 ($72.31 in chips) 
Seat 9: AlKatrone ($100 in chips) 
Venomous100%: posts small blind $0.50
Priidix: is sitting out 
huffwag: posts big blind $1
*** HOLE CARDS ***
Dealt to matiko09 [2d 7s]
mycka86: folds 
maxxmeister: folds 
Kalesmash08: folds 
AlKatrone: folds 
matiko09: folds 
vrnMike: folds 
Venomous100%: raises $3 to $4
huffwag: folds 
Uncalled bet ($3) returned to Venomous100%
Venomous100% collected $2 from pot
Venomous100%: doesn't show hand 
*** SUMMARY ***
Total pot $2 | Rake $0 
Seat 1: matiko09 folded before Flop (didn't bet)
Seat 2: vrnMike (button) folded before Flop (didn't bet)
Seat 3: Venomous100% (small blind) collected ($2)
Seat 5: huffwag (big blind) folded before Flop
Seat 6: mycka86 folded before Flop (didn't bet)
Seat 7: maxxmeister folded before Flop (didn't bet)
Seat 8: Kalesmash08 folded before Flop (didn't bet)
Seat 9: AlKatrone folded before Flop (didn't bet)





PokerStars Hand #148832610428:  Hold'em No Limit ($0.25/$0.50 USD) - 2016/02/15 10:47:50 CET [2016/02/15 4:47:50 ET]
Table 'Vesta II' 9-max Seat #7 is the button
Seat 1: Ahangama ($60.71 in chips) 
Seat 3: matiko09 ($76.09 in chips) 
Seat 4: HJdream ($49.25 in chips) 
Seat 5: dndngod ($79.15 in chips) 
Seat 6: pandalapa ($50 in chips) 
Seat 7: OskarR89 ($99.98 in chips) 
Seat 8: Arystan ($64.56 in chips) 
Seat 9: Aoki42 ($68.12 in chips) 
Arystan: posts small blind $0.25
Aoki42: posts big blind $0.50
i L00K great: sits out 
*** HOLE CARDS ***
Dealt to matiko09 [3h 7h]
Ahangama: folds 
matiko09: folds 
HJdream: folds 
dndngod: folds 
pandalapa: folds 
OskarR89: folds 
Arystan: raises $1 to $1.50
Aoki42: folds 
Uncalled bet ($1) returned to Arystan
Arystan collected $1 from pot
Arystan: doesn't show hand 
*** SUMMARY ***
Total pot $1 | Rake $0 
Seat 1: Ahangama folded before Flop (didn't bet)
Seat 3: matiko09 folded before Flop (didn't bet)
Seat 4: HJdream folded before Flop (didn't bet)
Seat 5: dndngod folded before Flop (didn't bet)
Seat 6: pandalapa folded before Flop (didn't bet)
Seat 7: OskarR89 (button) folded before Flop (didn't bet)
Seat 8: Arystan (small blind) collected ($1)
Seat 9: Aoki42 (big blind) folded before Flop





PokerStars Hand #148832612763:  Hold'em No Limit ($0.50/$1.00 USD) - 2016/02/15 10:47:55 CET [2016/02/15 4:47:55 ET]
Table 'Corvus III' 9-max Seat #4 is the button
Seat 4: goransyruvka ($193.59 in chips) 
Seat 5: koib88 ($151.16 in chips) 
Seat 7: matiko09 ($250.78 in chips) 
Seat 8: redacesfull ($131.11 in chips) 
Seat 9: er13to ($100 in chips) 
koib88: posts small blind $0.50
WDW3: is sitting out 
WDW3 leaves the table
matiko09: posts big blind $1
goransyruvka: posts the ante $0.20
koib88: posts the ante $0.20
matiko09: posts the ante $0.20
redacesfull: posts the ante $0.20
er13to: posts the ante $0.20
*** HOLE CARDS ***
Dealt to matiko09 [2c Td]
redacesfull: folds 
er13to: raises $2 to $3
goransyruvka: calls $3
koib88: raises $6 to $9
matiko09: folds 
er13to: calls $6
goransyruvka: calls $6
*** FLOP *** [Kc 4c 7d]
koib88: checks 
er13to: checks 
goransyruvka: bets $13.85
koib88: calls $13.85
er13to: calls $13.85
*** TURN *** [Kc 4c 7d] [4s]
koib88: checks 
er13to: checks 
goransyruvka: bets $33.87
koib88: calls $33.87
er13to: folds 
*** RIVER *** [Kc 4c 7d 4s] [Qs]
koib88: checks 
goransyruvka: checks 
*** SHOW DOWN ***
koib88: shows [Ac Kd] (two pair, Kings and Fours)
goransyruvka: mucks hand 
koib88 collected $135.49 from pot
*** SUMMARY ***
Total pot $138.29 | Rake $2.80 
Board [Kc 4c 7d 4s Qs]
Seat 4: goransyruvka (button) mucked [Tc As]
Seat 5: koib88 (small blind) showed [Ac Kd] and won ($135.49) with two pair, Kings and Fours
Seat 7: matiko09 (big blind) folded before Flop
Seat 8: redacesfull folded before Flop (didn't bet)
Seat 9: er13to folded on the Turn





PokerStars Hand #148832619377:  Hold'em No Limit (€0.25/€0.50 EUR) - 2016/02/15 10:48:11 CET [2016/02/15 4:48:11 ET]
Table 'Walinskia II' 9-max Seat #8 is the button
Seat 1: ljryviltj (€49.25 in chips) 
Seat 2: yats87 (€50 in chips) 
Seat 3: beluccix (€27.89 in chips) 
Seat 4: Otsime (€36.09 in chips) 
Seat 5: vano7777 (€53.21 in chips) 
Seat 6: 50CandyJoe (€63.02 in chips) 
Seat 8: matiko09 (€50 in chips) 
Seat 9: stevevg84 (€36.42 in chips) 
stevevg84: posts small blind €0.25
ljryviltj: posts big blind €0.50
etny99: sits out 
*** HOLE CARDS ***
Dealt to matiko09 [Jc 3h]
yats87: folds 
beluccix: folds 
Otsime: calls €0.50
vano7777: raises €1.75 to €2.25
50CandyJoe: folds 
matiko09: folds 
stevevg84: calls €2
ljryviltj: calls €1.75
Otsime: calls €1.75
*** FLOP *** [5d Td 7c]
stevevg84: checks 
ljryviltj: checks 
Otsime: bets €0.50
vano7777: raises €4.75 to €5.25
stevevg84: calls €5.25
ljryviltj: folds 
Otsime: folds 
*** TURN *** [5d Td 7c] [Ac]
stevevg84: checks 
vano7777: bets €45.71 and is all-in
stevevg84: calls €28.92 and is all-in
Uncalled bet (€16.79) returned to vano7777
*** RIVER *** [5d Td 7c Ac] [Ah]
*** SHOW DOWN ***
stevevg84: shows [Qc Qh] (two pair, Aces and Queens)
vano7777: shows [As Th] (a full house, Aces full of Tens)
vano7777 collected €75.84 from pot
*** SUMMARY ***
Total pot €77.84 | Rake €2 
Board [5d Td 7c Ac Ah]
Seat 1: ljryviltj (big blind) folded on the Flop
Seat 2: yats87 folded before Flop (didn't bet)
Seat 3: beluccix folded before Flop (didn't bet)
Seat 4: Otsime folded on the Flop
Seat 5: vano7777 showed [As Th] and won (€75.84) with a full house, Aces full of Tens
Seat 6: 50CandyJoe folded before Flop (didn't bet)
Seat 8: matiko09 (button) folded before Flop (didn't bet)
Seat 9: stevevg84 (small blind) showed [Qc Qh] and lost with two pair, Aces and Queens





PokerStars Hand #148832621745:  Hold'em No Limit ($0.50/$1.00 USD) - 2016/02/15 10:48:16 CET [2016/02/15 4:48:16 ET]
Table 'Urania' 9-max Seat #8 is the button
Seat 1: matiko09 ($100 in chips) 
Seat 2: maxxmeister ($117.58 in chips) 
Seat 3: WDW3 ($108.69 in chips) 
Seat 5: maxonplay ($178.08 in chips) 
Seat 6: vrnMike ($192.74 in chips) 
Seat 8: Venomous100% ($120.63 in chips) 
Seat 9: mycka86 ($108.42 in chips) 
mycka86: posts small blind $0.50
matiko09: posts big blind $1
*** HOLE CARDS ***
Dealt to matiko09 [3s 9s]
er13to joins the table at seat #7 
maxxmeister: folds 
WDW3: folds 
maxonplay: raises $2 to $3
vrnMike: folds 
Venomous100%: folds 
mycka86: folds 
matiko09: folds 
Uncalled bet ($2) returned to maxonplay
maxonplay collected $2.50 from pot
maxonplay: doesn't show hand 
*** SUMMARY ***
Total pot $2.50 | Rake $0 
Seat 1: matiko09 (big blind) folded before Flop
Seat 2: maxxmeister folded before Flop (didn't bet)
Seat 3: WDW3 folded before Flop (didn't bet)
Seat 5: maxonplay collected ($2.50)
Seat 6: vrnMike folded before Flop (didn't bet)
Seat 8: Venomous100% (button) folded before Flop (didn't bet)
Seat 9: mycka86 (small blind) folded before Flop





PokerStars Hand #148832622812:  Hold'em No Limit ($0.50/$1.00 USD) - 2016/02/15 10:48:19 CET [2016/02/15 4:48:19 ET]
Table 'Gemma II' 9-max Seat #3 is the button
Seat 1: Igor DoUrden ($179.34 in chips) 
Seat 2: WDW3 ($127.93 in chips) 
Seat 3: Venomous100% ($151.18 in chips) 
Seat 4: mycka86 ($100 in chips) 
Seat 5: PokerSash201 ($50.91 in chips) 
Seat 6: fanmtZ ($40 in chips) 
Seat 8: vrnMike ($179.45 in chips) 
Seat 9: matiko09 ($100 in chips) 
mycka86: posts small blind $0.50
PokerSash201: posts big blind $1
*** HOLE CARDS ***
Dealt to matiko09 [2h Kd]
fanmtZ: folds 
vrnMike: raises $2 to $3
matiko09: folds 
Igor DoUrden: folds 
WDW3: folds 
Venomous100%: folds 
mycka86: folds 
PokerSash201: folds 
Uncalled bet ($2) returned to vrnMike
vrnMike collected $2.50 from pot
*** SUMMARY ***
Total pot $2.50 | Rake $0 
Seat 1: Igor DoUrden folded before Flop (didn't bet)
Seat 2: WDW3 folded before Flop (didn't bet)
Seat 3: Venomous100% (button) folded before Flop (didn't bet)
Seat 4: mycka86 (small blind) folded before Flop
Seat 5: PokerSash201 (big blind) folded before Flop
Seat 6: fanmtZ folded before Flop (didn't bet)
Seat 8: vrnMike collected ($2.50)
Seat 9: matiko09 folded before Flop (didn't bet)





PokerStars Hand #148832623671:  Hold'em No Limit ($0.25/$0.50 USD) - 2016/02/15 10:48:21 CET [2016/02/15 4:48:21 ET]
Table 'Vesta II' 9-max Seat #8 is the button
Seat 1: Ahangama ($60.71 in chips) 
Seat 3: matiko09 ($76.09 in chips) 
Seat 4: HJdream ($49.25 in chips) 
Seat 5: dndngod ($79.15 in chips) 
Seat 6: pandalapa ($50 in chips) 
Seat 7: OskarR89 ($99.98 in chips) 
Seat 8: Arystan ($65.06 in chips) 
Seat 9: Aoki42 ($67.62 in chips) 
Aoki42: posts small blind $0.25
Ahangama: posts big blind $0.50
i L00K great: sits out 
*** HOLE CARDS ***
Dealt to matiko09 [8s Jc]
matiko09: folds 
HJdream: folds 
dndngod: folds 
pandalapa: folds 
OskarR89: folds 
Arystan: raises $1 to $1.50
Aoki42: raises $3 to $4.50
Ahangama: folds 
Arystan: calls $3
*** FLOP *** [7c 4s 7h]
Aoki42: bets $4.71
Arystan: folds 
Uncalled bet ($4.71) returned to Aoki42
Aoki42 collected $9.07 from pot
Aoki42: doesn't show hand 
*** SUMMARY ***
Total pot $9.50 | Rake $0.43 
Board [7c 4s 7h]
Seat 1: Ahangama (big blind) folded before Flop
Seat 3: matiko09 folded before Flop (didn't bet)
Seat 4: HJdream folded before Flop (didn't bet)
Seat 5: dndngod folded before Flop (didn't bet)
Seat 6: pandalapa folded before Flop (didn't bet)
Seat 7: OskarR89 folded before Flop (didn't bet)
Seat 8: Arystan (button) folded on the Flop
Seat 9: Aoki42 (small blind) collected ($9.07)





PokerStars Hand #148832624291:  Hold'em No Limit ($0.50/$1.00 USD) - 2016/02/15 10:48:22 CET [2016/02/15 4:48:22 ET]
Table 'Euanthe II' 9-max Seat #5 is the button
Seat 1: maxxmeister ($148.28 in chips) 
Seat 2: mycka86 ($188.84 in chips) 
Seat 3: fanmtZ ($62.78 in chips) 
Seat 5: vrnMike ($100 in chips) 
Seat 6: grugz33 ($75.28 in chips) 
Seat 7: vinniesmol ($217.44 in chips) 
Seat 8: matiko09 ($121.08 in chips) 
Seat 9: Venomous100% ($100 in chips) 
grugz33: posts small blind $0.50
vinniesmol: posts big blind $1
er13to: sits out 
*** HOLE CARDS ***
Dealt to matiko09 [Qd Qh]
matiko09: raises $2 to $3
Venomous100%: folds 
maxxmeister: folds 
mycka86: folds 
fanmtZ: folds 
vrnMike: folds 
grugz33: folds 
vinniesmol: calls $2
*** FLOP *** [4s Ts Th]
vinniesmol: checks 
matiko09: bets $4.04
vinniesmol: folds 
Uncalled bet ($4.04) returned to matiko09
matiko09 collected $6.21 from pot
matiko09: doesn't show hand 
*** SUMMARY ***
Total pot $6.50 | Rake $0.29 
Board [4s Ts Th]
Seat 1: maxxmeister folded before Flop (didn't bet)
Seat 2: mycka86 folded before Flop (didn't bet)
Seat 3: fanmtZ folded before Flop (didn't bet)
Seat 5: vrnMike (button) folded before Flop (didn't bet)
Seat 6: grugz33 (small blind) folded before Flop
Seat 7: vinniesmol (big blind) folded on the Flop
Seat 8: matiko09 collected ($6.21)
Seat 9: Venomous100% folded before Flop (didn't bet)





PokerStars Hand #148832623876:  Hold'em No Limit ($0.50/$1.00 USD) - 2016/02/15 10:48:22 CET [2016/02/15 4:48:22 ET]
Table 'Anteros' 9-max Seat #1 is the button
Seat 1: OskarR89 ($115.52 in chips) 
Seat 2: IHouseMusic ($103.14 in chips) 
Seat 3: fanmtZ ($50.43 in chips) 
Seat 4: misherei ($201.94 in chips) 
Seat 5: Holm1991 ($72.82 in chips) 
Seat 7: Zoubou1983 ($87.51 in chips) 
Seat 8: matiko09 ($100 in chips) 
IHouseMusic: posts small blind $0.50
fanmtZ: posts big blind $1
SerAlGog: sits out 
vrnMike: sits out 
*** HOLE CARDS ***
Dealt to matiko09 [Th As]
misherei: folds 
Holm1991: folds 
Zoubou1983: calls $1
matiko09: raises $3 to $4
OskarR89: folds 
IHouseMusic: folds 
fanmtZ: raises $8 to $12
Zoubou1983: folds 
matiko09: folds 
Uncalled bet ($8) returned to fanmtZ
fanmtZ collected $9.50 from pot
fanmtZ: doesn't show hand 
*** SUMMARY ***
Total pot $9.50 | Rake $0 
Seat 1: OskarR89 (button) folded before Flop (didn't bet)
Seat 2: IHouseMusic (small blind) folded before Flop
Seat 3: fanmtZ (big blind) collected ($9.50)
Seat 4: misherei folded before Flop (didn't bet)
Seat 5: Holm1991 folded before Flop (didn't bet)
Seat 7: Zoubou1983 folded before Flop
Seat 8: matiko09 folded before Flop





PokerStars Hand #148832627590:  Hold'em No Limit ($0.50/$1.00 USD) - 2016/02/15 10:48:30 CET [2016/02/15 4:48:30 ET]
Table 'Praecipua' 9-max Seat #3 is the button
Seat 1: matiko09 ($122.57 in chips) 
Seat 2: vrnMike ($112.17 in chips) 
Seat 3: Venomous100% ($113.03 in chips) 
Seat 5: huffwag ($37.06 in chips) 
Seat 6: mycka86 ($115.10 in chips) 
Seat 7: maxxmeister ($194.49 in chips) 
Seat 8: Kalesmash08 ($72.31 in chips) 
huffwag: posts small blind $0.50
mycka86: posts big blind $1
*** HOLE CARDS ***
Dealt to matiko09 [Jh Ac]
maxxmeister: folds 
Kalesmash08: raises $2 to $3
matiko09: folds 
vrnMike: folds 
Venomous100%: folds 
huffwag: folds 
mycka86: folds 
Uncalled bet ($2) returned to Kalesmash08
Kalesmash08 collected $2.50 from pot
Kalesmash08: doesn't show hand 
*** SUMMARY ***
Total pot $2.50 | Rake $0 
Seat 1: matiko09 folded before Flop (didn't bet)
Seat 2: vrnMike folded before Flop (didn't bet)
Seat 3: Venomous100% (button) folded before Flop (didn't bet)
Seat 5: huffwag (small blind) folded before Flop
Seat 6: mycka86 (big blind) folded before Flop
Seat 7: maxxmeister folded before Flop (didn't bet)
Seat 8: Kalesmash08 collected ($2.50)





PokerStars Hand #148832630884:  Hold'em No Limit ($0.50/$1.00 USD) - 2016/02/15 10:48:38 CET [2016/02/15 4:48:38 ET]
Table 'Gemma II' 9-max Seat #4 is the button
Seat 1: Igor DoUrden ($179.34 in chips) 
Seat 2: WDW3 ($127.93 in chips) 
Seat 3: Venomous100% ($151.18 in chips) 
Seat 4: mycka86 ($100 in chips) 
Seat 5: PokerSash201 ($49.91 in chips) 
Seat 6: fanmtZ ($40 in chips) 
Seat 8: vrnMike ($180.95 in chips) 
Seat 9: matiko09 ($100 in chips) 
PokerSash201: posts small blind $0.50
fanmtZ: posts big blind $1
*** HOLE CARDS ***
Dealt to matiko09 [Qs Jc]
vrnMike: folds 
matiko09: folds 
Igor DoUrden: folds 
WDW3: folds 
Venomous100%: raises $2 to $3
mycka86: folds 
PokerSash201: folds 
fanmtZ: folds 
Uncalled bet ($2) returned to Venomous100%
Venomous100% collected $2.50 from pot
Venomous100%: doesn't show hand 
*** SUMMARY ***
Total pot $2.50 | Rake $0 
Seat 1: Igor DoUrden folded before Flop (didn't bet)
Seat 2: WDW3 folded before Flop (didn't bet)
Seat 3: Venomous100% collected ($2.50)
Seat 4: mycka86 (button) folded before Flop (didn't bet)
Seat 5: PokerSash201 (small blind) folded before Flop
Seat 6: fanmtZ (big blind) folded before Flop
Seat 8: vrnMike folded before Flop (didn't bet)
Seat 9: matiko09 folded before Flop (didn't bet)





PokerStars Hand #148832633524:  Hold'em No Limit ($0.25/$0.50 USD) - 2016/02/15 10:48:44 CET [2016/02/15 4:48:44 ET]
Table 'Eltigen II' 9-max Seat #9 is the button
Seat 1: ljryviltj ($50 in chips) 
Seat 2: matiko09 ($58.51 in chips) 
Seat 5: R@/\//\/Y305 ($20 in chips) 
Seat 9: DarkNinja8 ($38.44 in chips) 
ljryviltj: posts small blind $0.25
matiko09: posts big blind $0.50
injener: sits out 
beluccix: sits out 
R@/\//\/Y305: posts big blind $0.50
OskarR89 leaves the table
Prettyspitz: sits out 
Aoki42: sits out 
*** HOLE CARDS ***
Dealt to matiko09 [Tc 4h]
R@/\//\/Y305: checks 
DarkNinja8: folds 
ljryviltj: folds 
matiko09: checks 
*** FLOP *** [6s 6c 2h]
SerAlGog joins the table at seat #7 
matiko09: checks 
R@/\//\/Y305: checks 
*** TURN *** [6s 6c 2h] [9c]
matiko09: checks 
R@/\//\/Y305: bets $2
matiko09: folds 
Uncalled bet ($2) returned to R@/\//\/Y305
R@/\//\/Y305 collected $1.19 from pot
*** SUMMARY ***
Total pot $1.25 | Rake $0.06 
Board [6s 6c 2h 9c]
Seat 1: ljryviltj (small blind) folded before Flop
Seat 2: matiko09 (big blind) folded on the Turn
Seat 5: R@/\//\/Y305 collected ($1.19)
Seat 9: DarkNinja8 (button) folded before Flop (didn't bet)





PokerStars Hand #148832633693:  Hold'em No Limit ($0.25/$0.50 USD) - 2016/02/15 10:48:45 CET [2016/02/15 4:48:45 ET]
Table 'Laertes II' 9-max Seat #4 is the button
Seat 1: dade33 ($94.29 in chips) 
Seat 2: beluccix ($24.21 in chips) 
Seat 3: ljryviltj ($55.41 in chips) 
Seat 4: rgar93 ($41.88 in chips) 
Seat 5: vlad11122007 ($56.38 in chips) 
Seat 6: yats87 ($50 in chips) 
Seat 7: OskarR89 ($73.67 in chips) 
Seat 8: Trent444 ($43.48 in chips) 
Seat 9: matiko09 ($50 in chips) 
vlad11122007: posts small blind $0.25
yats87: posts big blind $0.50
*** HOLE CARDS ***
Dealt to matiko09 [8s Ks]
OskarR89: folds 
Trent444: folds 
matiko09: folds 
dade33: raises $1 to $1.50
beluccix: folds 
ljryviltj: folds 
rgar93: folds 
vlad11122007: folds 
yats87: calls $1
*** FLOP *** [3c 5d Js]
yats87: checks 
dade33: bets $2
yats87: folds 
Uncalled bet ($2) returned to dade33
dade33 collected $3.10 from pot
*** SUMMARY ***
Total pot $3.25 | Rake $0.15 
Board [3c 5d Js]
Seat 1: dade33 collected ($3.10)
Seat 2: beluccix folded before Flop (didn't bet)
Seat 3: ljryviltj folded before Flop (didn't bet)
Seat 4: rgar93 (button) folded before Flop (didn't bet)
Seat 5: vlad11122007 (small blind) folded before Flop
Seat 6: yats87 (big blind) folded on the Flop
Seat 7: OskarR89 folded before Flop (didn't bet)
Seat 8: Trent444 folded before Flop (didn't bet)
Seat 9: matiko09 folded before Flop (didn't bet)





PokerStars Hand #148832637387:  Hold'em No Limit ($0.50/$1.00 USD) - 2016/02/15 10:48:54 CET [2016/02/15 4:48:54 ET]
Table 'Euanthe II' 9-max Seat #6 is the button
Seat 1: maxxmeister ($148.28 in chips) 
Seat 2: mycka86 ($188.84 in chips) 
Seat 3: fanmtZ ($62.78 in chips) 
Seat 5: vrnMike ($100 in chips) 
Seat 6: grugz33 ($74.78 in chips) 
Seat 7: vinniesmol ($214.44 in chips) 
Seat 8: matiko09 ($124.29 in chips) 
Seat 9: Venomous100% ($100 in chips) 
vinniesmol: posts small blind $0.50
matiko09: posts big blind $1
er13to: sits out 
*** HOLE CARDS ***
Dealt to matiko09 [6h Ks]
Venomous100%: folds 
maxxmeister: folds 
mycka86: folds 
fanmtZ: folds 
vrnMike: raises $2 to $3
grugz33: calls $3
vinniesmol: calls $2.50
matiko09: folds 
*** FLOP *** [4d 5d 4c]
vinniesmol: checks 
vrnMike: bets $8.50
grugz33: calls $8.50
vinniesmol: folds 
*** TURN *** [4d 5d 4c] [8c]
vrnMike: bets $21.50
grugz33: raises $41.78 to $63.28 and is all-in
vrnMike: calls $41.78
*** RIVER *** [4d 5d 4c 8c] [Tc]
*** SHOW DOWN ***
vrnMike: shows [Kd Kc] (two pair, Kings and Fours)
grugz33: shows [7c 8s] (two pair, Eights and Fours)
vrnMike collected $150.76 from pot
*** SUMMARY ***
Total pot $153.56 | Rake $2.80 
Board [4d 5d 4c 8c Tc]
Seat 1: maxxmeister folded before Flop (didn't bet)
Seat 2: mycka86 folded before Flop (didn't bet)
Seat 3: fanmtZ folded before Flop (didn't bet)
Seat 5: vrnMike showed [Kd Kc] and won ($150.76) with two pair, Kings and Fours
Seat 6: grugz33 (button) showed [7c 8s] and lost with two pair, Eights and Fours
Seat 7: vinniesmol (small blind) folded on the Flop
Seat 8: matiko09 (big blind) folded before Flop
Seat 9: Venomous100% folded before Flop (didn't bet)





PokerStars Hand #148832638161:  Hold'em No Limit ($0.50/$1.00 USD) - 2016/02/15 10:48:55 CET [2016/02/15 4:48:55 ET]
Table 'Urania' 9-max Seat #9 is the button
Seat 1: matiko09 ($100 in chips) 
Seat 2: maxxmeister ($117.58 in chips) 
Seat 3: WDW3 ($108.69 in chips) 
Seat 5: maxonplay ($179.58 in chips) 
Seat 6: vrnMike ($192.74 in chips) 
Seat 8: Venomous100% ($120.63 in chips) 
Seat 9: mycka86 ($107.92 in chips) 
matiko09: posts small blind $0.50
maxxmeister: posts big blind $1
er13to: sits out 
*** HOLE CARDS ***
Dealt to matiko09 [6s Jc]
WDW3: folds 
maxonplay: folds 
vrnMike: folds 
Venomous100%: folds 
mycka86: folds 
matiko09: folds 
Uncalled bet ($0.50) returned to maxxmeister
maxxmeister collected $1 from pot
maxxmeister: doesn't show hand 
*** SUMMARY ***
Total pot $1 | Rake $0 
Seat 1: matiko09 (small blind) folded before Flop
Seat 2: maxxmeister (big blind) collected ($1)
Seat 3: WDW3 folded before Flop (didn't bet)
Seat 5: maxonplay folded before Flop (didn't bet)
Seat 6: vrnMike folded before Flop (didn't bet)
Seat 8: Venomous100% folded before Flop (didn't bet)
Seat 9: mycka86 (button) folded before Flop (didn't bet)





PokerStars Hand #148832642756:  Hold'em No Limit ($0.50/$1.00 USD) - 2016/02/15 10:49:06 CET [2016/02/15 4:49:06 ET]
Table 'Praecipua' 9-max Seat #5 is the button
Seat 1: matiko09 ($122.57 in chips) 
Seat 2: vrnMike ($112.17 in chips) 
Seat 3: Venomous100% ($113.03 in chips) 
Seat 5: huffwag ($36.56 in chips) 
Seat 6: mycka86 ($114.10 in chips) 
Seat 7: maxxmeister ($194.49 in chips) 
Seat 8: Kalesmash08 ($73.81 in chips) 
mycka86: posts small blind $0.50
maxxmeister: posts big blind $1
*** HOLE CARDS ***
Dealt to matiko09 [Td 7d]
Kalesmash08: folds 
matiko09: folds 
vrnMike: folds 
Venomous100%: raises $1.50 to $2.50
huffwag: folds 
mycka86: folds 
maxxmeister: folds 
Uncalled bet ($1.50) returned to Venomous100%
Venomous100% collected $2.50 from pot
Venomous100%: doesn't show hand 
*** SUMMARY ***
Total pot $2.50 | Rake $0 
Seat 1: matiko09 folded before Flop (didn't bet)
Seat 2: vrnMike folded before Flop (didn't bet)
Seat 3: Venomous100% collected ($2.50)
Seat 5: huffwag (button) folded before Flop (didn't bet)
Seat 6: mycka86 (small blind) folded before Flop
Seat 7: maxxmeister (big blind) folded before Flop
Seat 8: Kalesmash08 folded before Flop (didn't bet)





PokerStars Hand #148832643437:  Hold'em No Limit ($0.50/$1.00 USD) - 2016/02/15 10:49:08 CET [2016/02/15 4:49:08 ET]
Table 'Anteros' 9-max Seat #2 is the button
Seat 1: OskarR89 ($115.52 in chips) 
Seat 2: IHouseMusic ($102.64 in chips) 
Seat 3: fanmtZ ($55.93 in chips) 
Seat 4: misherei ($201.94 in chips) 
Seat 5: Holm1991 ($72.82 in chips) 
Seat 7: Zoubou1983 ($86.51 in chips) 
Seat 8: matiko09 ($100 in chips) 
fanmtZ: posts small blind $0.50
misherei: posts big blind $1
SerAlGog: sits out 
vrnMike: sits out 
*** HOLE CARDS ***
Dealt to matiko09 [5d 3d]
Holm1991: calls $1
Zoubou1983: folds 
matiko09: folds 
OskarR89: raises $2 to $3
IHouseMusic: folds 
fanmtZ: folds 
misherei: folds 
Holm1991: calls $2
*** FLOP *** [5h Qs 4s]
Holm1991: checks 
OskarR89: checks 
*** TURN *** [5h Qs 4s] [5c]
Holm1991: checks 
OskarR89: checks 
*** RIVER *** [5h Qs 4s 5c] [As]
Holm1991: checks 
OskarR89: checks 
*** SHOW DOWN ***
Holm1991: shows [2s Ad] (two pair, Aces and Fives)
OskarR89: mucks hand 
Holm1991 collected $7.16 from pot
*** SUMMARY ***
Total pot $7.50 | Rake $0.34 
Board [5h Qs 4s 5c As]
Seat 1: OskarR89 mucked [Kd Jc]
Seat 2: IHouseMusic (button) folded before Flop (didn't bet)
Seat 3: fanmtZ (small blind) folded before Flop
Seat 4: misherei (big blind) folded before Flop
Seat 5: Holm1991 showed [2s Ad] and won ($7.16) with two pair, Aces and Fives
Seat 7: Zoubou1983 folded before Flop (didn't bet)
Seat 8: matiko09 folded before Flop (didn't bet)





PokerStars Hand #148832647165:  Hold'em No Limit ($0.50/$1.00 USD) - 2016/02/15 10:49:17 CET [2016/02/15 4:49:17 ET]
Table 'Corvus III' 9-max Seat #5 is the button
Seat 4: goransyruvka ($136.67 in chips) 
Seat 5: koib88 ($229.73 in chips) 
Seat 7: matiko09 ($249.58 in chips) 
Seat 8: redacesfull ($130.91 in chips) 
Seat 9: er13to ($100 in chips) 
matiko09: posts small blind $0.50
redacesfull: posts big blind $1
goransyruvka: posts the ante $0.20
koib88: posts the ante $0.20
matiko09: posts the ante $0.20
redacesfull: posts the ante $0.20
er13to: posts the ante $0.20
*** HOLE CARDS ***
Dealt to matiko09 [2h 8s]
er13to: raises $1.50 to $2.50
goransyruvka: calls $2.50
koib88: calls $2.50
matiko09: folds 
redacesfull: folds 
*** FLOP *** [Ad Ks 6d]
er13to: checks 
goransyruvka: bets $9.55
koib88: folds 
er13to: folds 
Uncalled bet ($9.55) returned to goransyruvka
goransyruvka collected $9.55 from pot
goransyruvka: doesn't show hand 
*** SUMMARY ***
Total pot $10 | Rake $0.45 
Board [Ad Ks 6d]
Seat 4: goransyruvka collected ($9.55)
Seat 5: koib88 (button) folded on the Flop
Seat 7: matiko09 (small blind) folded before Flop
Seat 8: redacesfull (big blind) folded before Flop
Seat 9: er13to folded on the Flop





PokerStars Hand #148832648115:  Hold'em No Limit ($0.25/$0.50 USD) - 2016/02/15 10:49:19 CET [2016/02/15 4:49:19 ET]
Table 'Vesta II' 9-max Seat #9 is the button
Seat 1: Ahangama ($60.21 in chips) 
Seat 2: i L00K great ($54.12 in chips) 
Seat 3: matiko09 ($76.09 in chips) 
Seat 4: HJdream ($49.25 in chips) 
Seat 5: dndngod ($79.15 in chips) 
Seat 6: pandalapa ($50 in chips) 
Seat 7: OskarR89 ($99.98 in chips) 
Seat 8: Arystan ($60.56 in chips) 
Seat 9: Aoki42 ($72.19 in chips) 
Ahangama: posts small blind $0.25
i L00K great: posts big blind $0.50
*** HOLE CARDS ***
Dealt to matiko09 [As 9d]
matiko09: folds 
HJdream: folds 
dndngod: folds 
pandalapa: folds 
OskarR89: folds 
Arystan: raises $1 to $1.50
Aoki42: folds 
Ahangama: raises $3.50 to $5
i L00K great: folds 
Arystan: calls $3.50
*** FLOP *** [Kc 5d 2s]
Ahangama: bets $5
Arystan: calls $5
*** TURN *** [Kc 5d 2s] [2h]
Ahangama: bets $12
Arystan: calls $12
*** RIVER *** [Kc 5d 2s 2h] [Ad]
Ahangama: bets $38.21 and is all-in
Arystan: calls $38.21
*** SHOW DOWN ***
Ahangama: shows [Ks Ac] (two pair, Aces and Kings)
Arystan: shows [5s 5h] (a full house, Fives full of Deuces)
Arystan collected $118.42 from pot
*** SUMMARY ***
Total pot $120.92 | Rake $2.50 
Board [Kc 5d 2s 2h Ad]
Seat 1: Ahangama (small blind) showed [Ks Ac] and lost with two pair, Aces and Kings
Seat 2: i L00K great (big blind) folded before Flop
Seat 3: matiko09 folded before Flop (didn't bet)
Seat 4: HJdream folded before Flop (didn't bet)
Seat 5: dndngod folded before Flop (didn't bet)
Seat 6: pandalapa folded before Flop (didn't bet)
Seat 7: OskarR89 folded before Flop (didn't bet)
Seat 8: Arystan showed [5s 5h] and won ($118.42) with a full house, Fives full of Deuces
Seat 9: Aoki42 (button) folded before Flop (didn't bet)





PokerStars Hand #148832649030:  Hold'em No Limit ($0.25/$0.50 USD) - 2016/02/15 10:49:21 CET [2016/02/15 4:49:21 ET]
Table 'Eltigen II' 9-max Seat #1 is the button
Seat 1: ljryviltj ($49.75 in chips) 
Seat 2: matiko09 ($58.01 in chips) 
Seat 3: injener ($40 in chips) 
Seat 5: R@/\//\/Y305 ($20.69 in chips) 
Seat 9: DarkNinja8 ($38.44 in chips) 
matiko09: posts small blind $0.25
injener: posts big blind $0.50
beluccix: sits out 
Prettyspitz: sits out 
SerAlGog: sits out 
Aoki42: sits out 
*** HOLE CARDS ***
Dealt to matiko09 [4h 2d]
R@/\//\/Y305: folds 
DarkNinja8: folds 
ljryviltj: folds 
matiko09: folds 
Uncalled bet ($0.25) returned to injener
injener collected $0.50 from pot
*** SUMMARY ***
Total pot $0.50 | Rake $0 
Seat 1: ljryviltj (button) folded before Flop (didn't bet)
Seat 2: matiko09 (small blind) folded before Flop
Seat 3: injener (big blind) collected ($0.50)
Seat 5: R@/\//\/Y305 folded before Flop (didn't bet)
Seat 9: DarkNinja8 folded before Flop (didn't bet)





PokerStars Hand #148832651145:  Hold'em No Limit ($0.50/$1.00 USD) - 2016/02/15 10:49:26 CET [2016/02/15 4:49:26 ET]
Table 'Gemma II' 9-max Seat #5 is the button
Seat 1: Igor DoUrden ($179.34 in chips) 
Seat 2: WDW3 ($127.93 in chips) 
Seat 3: Venomous100% ($152.68 in chips) 
Seat 4: mycka86 ($100 in chips) 
Seat 5: PokerSash201 ($49.41 in chips) 
Seat 6: fanmtZ ($40 in chips) 
Seat 8: vrnMike ($180.95 in chips) 
Seat 9: matiko09 ($100 in chips) 
fanmtZ: posts small blind $0.50
vrnMike: posts big blind $1
*** HOLE CARDS ***
Dealt to matiko09 [7h 9h]
matiko09: folds 
Igor DoUrden: folds 
WDW3: folds 
Venomous100%: raises $2 to $3
mycka86: folds 
PokerSash201: calls $3
fanmtZ: folds 
vrnMike: folds 
*** FLOP *** [Jh Kc 6s]
Venomous100%: bets $4.73
PokerSash201: calls $4.73
*** TURN *** [Jh Kc 6s] [Td]
Venomous100%: checks 
PokerSash201: checks 
*** RIVER *** [Jh Kc 6s Td] [7d]
Venomous100%: bets $8.10
PokerSash201: raises $8.10 to $16.20
Venomous100%: folds 
Uncalled bet ($8.10) returned to PokerSash201
PokerSash201 collected $31.67 from pot
PokerSash201: doesn't show hand 
*** SUMMARY ***
Total pot $33.16 | Rake $1.49 
Board [Jh Kc 6s Td 7d]
Seat 1: Igor DoUrden folded before Flop (didn't bet)
Seat 2: WDW3 folded before Flop (didn't bet)
Seat 3: Venomous100% folded on the River
Seat 4: mycka86 folded before Flop (didn't bet)
Seat 5: PokerSash201 (button) collected ($31.67)
Seat 6: fanmtZ (small blind) folded before Flop
Seat 8: vrnMike (big blind) folded before Flop
Seat 9: matiko09 folded before Flop (didn't bet)





PokerStars Hand #148832651897:  Hold'em No Limit ($0.50/$1.00 USD) - 2016/02/15 10:49:28 CET [2016/02/15 4:49:28 ET]
Table 'Praecipua' 9-max Seat #6 is the button
Seat 1: matiko09 ($122.57 in chips) 
Seat 2: vrnMike ($112.17 in chips) 
Seat 3: Venomous100% ($114.53 in chips) 
Seat 5: huffwag ($36.56 in chips) 
Seat 6: mycka86 ($113.60 in chips) 
Seat 7: maxxmeister ($193.49 in chips) 
maxxmeister: posts small blind $0.50
Kalesmash08 is disconnected 
Kalesmash08 has timed out while disconnected
Kalesmash08: is sitting out 
matiko09: posts big blind $1
*** HOLE CARDS ***
Dealt to matiko09 [5d 4d]
vrnMike: raises $2 to $3
Venomous100%: folds 
huffwag: folds 
mycka86: folds 
maxxmeister: folds 
matiko09: folds 
Uncalled bet ($2) returned to vrnMike
vrnMike collected $2.50 from pot
*** SUMMARY ***
Total pot $2.50 | Rake $0 
Seat 1: matiko09 (big blind) folded before Flop
Seat 2: vrnMike collected ($2.50)
Seat 3: Venomous100% folded before Flop (didn't bet)
Seat 5: huffwag folded before Flop (didn't bet)
Seat 6: mycka86 (button) folded before Flop (didn't bet)
Seat 7: maxxmeister (small blind) folded before Flop





PokerStars Hand #148832652315:  Hold'em No Limit ($0.50/$1.00 USD) - 2016/02/15 10:49:29 CET [2016/02/15 4:49:29 ET]
Table 'Urania' 9-max Seat #1 is the button
Seat 1: matiko09 ($100 in chips) 
Seat 2: maxxmeister ($118.08 in chips) 
Seat 5: maxonplay ($179.58 in chips) 
Seat 6: vrnMike ($192.74 in chips) 
Seat 8: Venomous100% ($120.63 in chips) 
Seat 9: mycka86 ($107.92 in chips) 
maxxmeister: posts small blind $0.50
WDW3: is sitting out 
maxonplay: posts big blind $1
er13to: sits out 
*** HOLE CARDS ***
Dealt to matiko09 [Js 4d]
WDW3 leaves the table
vrnMike: folds 
Venomous100%: folds 
mycka86: folds 
matiko09: folds 
gumeji215 joins the table at seat #3 
maxxmeister: raises $3 to $4
maxonplay: calls $3
*** FLOP *** [3h 9c Ts]
maxxmeister: checks 
maxonplay: bets $4
maxxmeister: folds 
Uncalled bet ($4) returned to maxonplay
maxonplay collected $7.64 from pot
maxonplay: doesn't show hand 
*** SUMMARY ***
Total pot $8 | Rake $0.36 
Board [3h 9c Ts]
Seat 1: matiko09 (button) folded before Flop (didn't bet)
Seat 2: maxxmeister (small blind) folded on the Flop
Seat 5: maxonplay (big blind) collected ($7.64)
Seat 6: vrnMike folded before Flop (didn't bet)
Seat 8: Venomous100% folded before Flop (didn't bet)
Seat 9: mycka86 folded before Flop (didn't bet)





PokerStars Hand #148832655762:  Hold'em No Limit ($0.25/$0.50 USD) - 2016/02/15 10:49:37 CET [2016/02/15 4:49:37 ET]
Table 'Eltigen II' 9-max Seat #2 is the button
Seat 1: ljryviltj ($49.75 in chips) 
Seat 2: matiko09 ($57.76 in chips) 
Seat 3: injener ($40.25 in chips) 
Seat 4: beluccix ($50 in chips) 
Seat 5: R@/\//\/Y305 ($20.69 in chips) 
Seat 9: DarkNinja8 ($38.44 in chips) 
injener: posts small blind $0.25
beluccix: posts big blind $0.50
Prettyspitz: sits out 
SerAlGog: sits out 
Aoki42: sits out 
*** HOLE CARDS ***
Dealt to matiko09 [Jd 3d]
R@/\//\/Y305: calls $0.50
DarkNinja8: raises $1.25 to $1.75
ljryviltj: calls $1.75
matiko09: folds 
injener: folds 
beluccix: folds 
R@/\//\/Y305: calls $1.25
*** FLOP *** [Qs 4s 7d]
R@/\//\/Y305: checks 
DarkNinja8: bets $2.50
ljryviltj: calls $2.50
R@/\//\/Y305: folds 
*** TURN *** [Qs 4s 7d] [Ad]
DarkNinja8: bets $5.25
ljryviltj: calls $5.25
*** RIVER *** [Qs 4s 7d Ad] [2s]
DarkNinja8: checks 
ljryviltj: bets $17.50
DarkNinja8: folds 
Uncalled bet ($17.50) returned to ljryviltj
ljryviltj collected $20.53 from pot
ljryviltj: doesn't show hand 
*** SUMMARY ***
Total pot $21.50 | Rake $0.97 
Board [Qs 4s 7d Ad 2s]
Seat 1: ljryviltj collected ($20.53)
Seat 2: matiko09 (button) folded before Flop (didn't bet)
Seat 3: injener (small blind) folded before Flop
Seat 4: beluccix (big blind) folded before Flop
Seat 5: R@/\//\/Y305 folded on the Flop
Seat 9: DarkNinja8 folded on the River





PokerStars Hand #148832657617:  Hold'em No Limit ($0.50/$1.00 USD) - 2016/02/15 10:49:41 CET [2016/02/15 4:49:41 ET]
Table 'Corvus III' 9-max Seat #7 is the button
Seat 4: goransyruvka ($143.52 in chips) 
Seat 5: koib88 ($227.03 in chips) 
Seat 7: matiko09 ($248.88 in chips) 
Seat 8: redacesfull ($129.71 in chips) 
Seat 9: er13to ($100 in chips) 
redacesfull: posts small blind $0.50
er13to: posts big blind $1
goransyruvka: posts the ante $0.20
koib88: posts the ante $0.20
matiko09: posts the ante $0.20
redacesfull: posts the ante $0.20
er13to: posts the ante $0.20
*** HOLE CARDS ***
Dealt to matiko09 [Qs 4s]
goransyruvka: folds 
koib88: folds 
matiko09: raises $1.50 to $2.50
redacesfull: folds 
er13to: folds 
Uncalled bet ($1.50) returned to matiko09
matiko09 collected $3.50 from pot
matiko09: doesn't show hand 
*** SUMMARY ***
Total pot $3.50 | Rake $0 
Seat 4: goransyruvka folded before Flop (didn't bet)
Seat 5: koib88 folded before Flop (didn't bet)
Seat 7: matiko09 (button) collected ($3.50)
Seat 8: redacesfull (small blind) folded before Flop
Seat 9: er13to (big blind) folded before Flop





PokerStars Hand #148832661675:  Hold'em No Limit ($0.25/$0.50 USD) - 2016/02/15 10:49:51 CET [2016/02/15 4:49:51 ET]
Table 'Laertes II' 9-max Seat #5 is the button
Seat 1: dade33 ($95.89 in chips) 
Seat 2: beluccix ($24.21 in chips) 
Seat 3: ljryviltj ($55.41 in chips) 
Seat 4: rgar93 ($41.88 in chips) 
Seat 5: vlad11122007 ($56.13 in chips) 
Seat 6: yats87 ($50 in chips) 
Seat 8: Trent444 ($43.48 in chips) 
Seat 9: matiko09 ($50 in chips) 
yats87: posts small blind $0.25
OskarR89: is sitting out 
OskarR89 leaves the table
Trent444: posts big blind $0.50
*** HOLE CARDS ***
Dealt to matiko09 [2d 6c]
matiko09: folds 
dade33: folds 
beluccix: folds 
ljryviltj: folds 
rgar93: folds 
vlad11122007: raises $0.50 to $1
Vedpapa joins the table at seat #7 
yats87: raises $2.50 to $3.50
Trent444: folds 
vlad11122007: calls $2.50
*** FLOP *** [8d 3h Ah]
yats87: checks 
vlad11122007: checks 
*** TURN *** [8d 3h Ah] [2s]
yats87: bets $4
vlad11122007: calls $4
*** RIVER *** [8d 3h Ah 2s] [3d]
yats87: bets $11.25
vlad11122007: folds 
Uncalled bet ($11.25) returned to yats87
yats87 collected $14.80 from pot
yats87: doesn't show hand 
*** SUMMARY ***
Total pot $15.50 | Rake $0.70 
Board [8d 3h Ah 2s 3d]
Seat 1: dade33 folded before Flop (didn't bet)
Seat 2: beluccix folded before Flop (didn't bet)
Seat 3: ljryviltj folded before Flop (didn't bet)
Seat 4: rgar93 folded before Flop (didn't bet)
Seat 5: vlad11122007 (button) folded on the River
Seat 6: yats87 (small blind) collected ($14.80)
Seat 8: Trent444 (big blind) folded before Flop
Seat 9: matiko09 folded before Flop (didn't bet)





PokerStars Hand #148832662356:  Hold'em No Limit (€0.25/€0.50 EUR) - 2016/02/15 10:49:52 CET [2016/02/15 4:49:52 ET]
Table 'Walinskia II' 9-max Seat #1 is the button
Seat 1: ljryviltj (€50 in chips) 
Seat 2: yats87 (€50 in chips) 
Seat 3: beluccix (€27.89 in chips) 
Seat 4: Otsime (€33.34 in chips) 
Seat 5: vano7777 (€92.63 in chips) 
Seat 6: 50CandyJoe (€63.02 in chips) 
Seat 8: matiko09 (€50 in chips) 
yats87: posts small blind €0.25
beluccix: posts big blind €0.50
etny99: sits out 
*** HOLE CARDS ***
Dealt to matiko09 [4d 8c]
Otsime: calls €0.50
vano7777: folds 
50CandyJoe: raises €1.50 to €2
matiko09: folds 
ljryviltj: folds 
yats87: folds 
stevevg84 leaves the table
Ahangama joins the table at seat #9 
beluccix: folds 
Otsime: calls €1.50
*** FLOP *** [7h 2c 5s]
Otsime: bets €0.50
50CandyJoe: raises €2 to €2.50
Otsime: calls €2
*** TURN *** [7h 2c 5s] [Th]
Otsime: bets €0.50
50CandyJoe: raises €8 to €8.50
Otsime: folds 
Uncalled bet (€8) returned to 50CandyJoe
50CandyJoe collected €10.27 from pot
50CandyJoe: doesn't show hand 
*** SUMMARY ***
Total pot €10.75 | Rake €0.48 
Board [7h 2c 5s Th]
Seat 1: ljryviltj (button) folded before Flop (didn't bet)
Seat 2: yats87 (small blind) folded before Flop
Seat 3: beluccix (big blind) folded before Flop
Seat 4: Otsime folded on the Turn
Seat 5: vano7777 folded before Flop (didn't bet)
Seat 6: 50CandyJoe collected (€10.27)
Seat 8: matiko09 folded before Flop (didn't bet)





PokerStars Hand #148832665084:  Hold'em No Limit ($0.50/$1.00 USD) - 2016/02/15 10:49:59 CET [2016/02/15 4:49:59 ET]
Table 'Euanthe II' 9-max Seat #7 is the button
Seat 1: maxxmeister ($148.28 in chips) 
Seat 2: mycka86 ($188.84 in chips) 
Seat 3: fanmtZ ($62.78 in chips) 
Seat 5: vrnMike ($175.98 in chips) 
Seat 7: vinniesmol ($211.44 in chips) 
Seat 8: matiko09 ($123.29 in chips) 
Seat 9: Venomous100% ($100 in chips) 
matiko09: posts small blind $0.50
Venomous100%: posts big blind $1
er13to: sits out 
*** HOLE CARDS ***
Dealt to matiko09 [4d 8h]
grugz33 leaves the table
maxxmeister: raises $2 to $3
mycka86: folds 
fanmtZ: folds 
vrnMike: folds 
vinniesmol: folds 
matiko09: folds 
Venomous100%: folds 
Uncalled bet ($2) returned to maxxmeister
maxxmeister collected $2.50 from pot
maxxmeister: doesn't show hand 
*** SUMMARY ***
Total pot $2.50 | Rake $0 
Seat 1: maxxmeister collected ($2.50)
Seat 2: mycka86 folded before Flop (didn't bet)
Seat 3: fanmtZ folded before Flop (didn't bet)
Seat 5: vrnMike folded before Flop (didn't bet)
Seat 7: vinniesmol (button) folded before Flop (didn't bet)
Seat 8: matiko09 (small blind) folded before Flop
Seat 9: Venomous100% (big blind) folded before Flop





PokerStars Hand #148832666809:  Hold'em No Limit ($0.50/$1.00 USD) - 2016/02/15 10:50:03 CET [2016/02/15 4:50:03 ET]
Table 'Corvus III' 9-max Seat #8 is the button
Seat 4: goransyruvka ($143.32 in chips) 
Seat 7: matiko09 ($251.18 in chips) 
Seat 8: redacesfull ($129.01 in chips) 
Seat 9: er13to ($100 in chips) 
er13to: posts small blind $0.50
goransyruvka: posts big blind $1
goransyruvka: posts the ante $0.20
matiko09: posts the ante $0.20
redacesfull: posts the ante $0.20
er13to: posts the ante $0.20
*** HOLE CARDS ***
Dealt to matiko09 [Td 5c]
matiko09: folds 
redacesfull: folds 
er13to: raises $3 to $4
goransyruvka: folds 
Uncalled bet ($3) returned to er13to
er13to collected $2.80 from pot
*** SUMMARY ***
Total pot $2.80 | Rake $0 
Seat 4: goransyruvka (big blind) folded before Flop
Seat 7: matiko09 folded before Flop (didn't bet)
Seat 8: redacesfull (button) folded before Flop (didn't bet)
Seat 9: er13to (small blind) collected ($2.80)





PokerStars Hand #148832668064:  Hold'em No Limit ($0.50/$1.00 USD) - 2016/02/15 10:50:06 CET [2016/02/15 4:50:06 ET]
Table 'Praecipua' 9-max Seat #7 is the button
Seat 1: matiko09 ($121.57 in chips) 
Seat 2: vrnMike ($113.67 in chips) 
Seat 3: Venomous100% ($114.53 in chips) 
Seat 5: huffwag ($36.56 in chips) 
Seat 6: mycka86 ($113.60 in chips) 
Seat 7: maxxmeister ($192.99 in chips) 
matiko09: posts small blind $0.50
vrnMike: posts big blind $1
*** HOLE CARDS ***
Dealt to matiko09 [4d 2h]
Venomous100%: folds 
huffwag: folds 
mycka86: folds 
maxxmeister: raises $2 to $3
matiko09: folds 
vrnMike: raises $8 to $11
maxxmeister: folds 
Uncalled bet ($8) returned to vrnMike
vrnMike collected $6.50 from pot
*** SUMMARY ***
Total pot $6.50 | Rake $0 
Seat 1: matiko09 (small blind) folded before Flop
Seat 2: vrnMike (big blind) collected ($6.50)
Seat 3: Venomous100% folded before Flop (didn't bet)
Seat 5: huffwag folded before Flop (didn't bet)
Seat 6: mycka86 folded before Flop (didn't bet)
Seat 7: maxxmeister (button) folded before Flop





PokerStars Hand #148832672840:  Hold'em No Limit ($0.50/$1.00 USD) - 2016/02/15 10:50:17 CET [2016/02/15 4:50:17 ET]
Table 'Corvus III' 9-max Seat #9 is the button
Seat 4: goransyruvka ($142.12 in chips) 
Seat 7: matiko09 ($250.98 in chips) 
Seat 8: redacesfull ($128.81 in chips) 
Seat 9: er13to ($101.60 in chips) 
goransyruvka: posts small blind $0.50
matiko09: posts big blind $1
goransyruvka: posts the ante $0.20
matiko09: posts the ante $0.20
redacesfull: posts the ante $0.20
er13to: posts the ante $0.20
*** HOLE CARDS ***
Dealt to matiko09 [4s Qd]
redacesfull: folds 
er13to: raises $2 to $3
goransyruvka: raises $7.80 to $10.80
matiko09: folds 
er13to: calls $7.80
*** FLOP *** [7c 4d 5s]
goransyruvka: bets $22.35
er13to: folds 
Uncalled bet ($22.35) returned to goransyruvka
goransyruvka collected $22.35 from pot
goransyruvka: doesn't show hand 
*** SUMMARY ***
Total pot $23.40 | Rake $1.05 
Board [7c 4d 5s]
Seat 4: goransyruvka (small blind) collected ($22.35)
Seat 7: matiko09 (big blind) folded before Flop
Seat 8: redacesfull folded before Flop (didn't bet)
Seat 9: er13to (button) folded on the Flop





PokerStars Hand #148832673638:  Hold'em No Limit ($0.50/$1.00 USD) - 2016/02/15 10:50:19 CET [2016/02/15 4:50:19 ET]
Table 'Gemma II' 9-max Seat #6 is the button
Seat 1: Igor DoUrden ($179.34 in chips) 
Seat 2: WDW3 ($127.93 in chips) 
Seat 3: Venomous100% ($136.85 in chips) 
Seat 4: mycka86 ($100 in chips) 
Seat 5: PokerSash201 ($65.25 in chips) 
Seat 6: fanmtZ ($40 in chips) 
Seat 8: vrnMike ($179.95 in chips) 
Seat 9: matiko09 ($100 in chips) 
vrnMike: posts small blind $0.50
matiko09: posts big blind $1
*** HOLE CARDS ***
Dealt to matiko09 [8c 8s]
Igor DoUrden: folds 
WDW3: folds 
Venomous100%: folds 
mycka86: folds 
PokerSash201: folds 
fanmtZ: folds 
vrnMike: folds 
Uncalled bet ($0.50) returned to matiko09
matiko09 collected $1 from pot
matiko09: doesn't show hand 
*** SUMMARY ***
Total pot $1 | Rake $0 
Seat 1: Igor DoUrden folded before Flop (didn't bet)
Seat 2: WDW3 folded before Flop (didn't bet)
Seat 3: Venomous100% folded before Flop (didn't bet)
Seat 4: mycka86 folded before Flop (didn't bet)
Seat 5: PokerSash201 folded before Flop (didn't bet)
Seat 6: fanmtZ (button) folded before Flop (didn't bet)
Seat 8: vrnMike (small blind) folded before Flop
Seat 9: matiko09 (big blind) collected ($1)





PokerStars Hand #148832677494:  Hold'em No Limit ($0.50/$1.00 USD) - 2016/02/15 10:50:28 CET [2016/02/15 4:50:28 ET]
Table 'Urania' 9-max Seat #2 is the button
Seat 1: matiko09 ($100 in chips) 
Seat 2: maxxmeister ($114.08 in chips) 
Seat 5: maxonplay ($183.22 in chips) 
Seat 6: vrnMike ($192.74 in chips) 
Seat 8: Venomous100% ($120.63 in chips) 
Seat 9: mycka86 ($107.92 in chips) 
gumeji215 will be allowed to play after the button
maxonplay: posts small blind $0.50
vrnMike: posts big blind $1
er13to: sits out 
*** HOLE CARDS ***
Dealt to matiko09 [2s 6c]
Venomous100%: folds 
mycka86: folds 
matiko09: folds 
maxxmeister: raises $2 to $3
maxonplay: raises $9 to $12
vrnMike: folds 
maxxmeister: folds 
Uncalled bet ($9) returned to maxonplay
maxonplay collected $7 from pot
maxonplay: doesn't show hand 
*** SUMMARY ***
Total pot $7 | Rake $0 
Seat 1: matiko09 folded before Flop (didn't bet)
Seat 2: maxxmeister (button) folded before Flop
Seat 5: maxonplay (small blind) collected ($7)
Seat 6: vrnMike (big blind) folded before Flop
Seat 8: Venomous100% folded before Flop (didn't bet)
Seat 9: mycka86 folded before Flop (didn't bet)





PokerStars Hand #148832678151:  Hold'em No Limit ($0.50/$1.00 USD) - 2016/02/15 10:50:30 CET [2016/02/15 4:50:30 ET]
Table 'Euanthe II' 9-max Seat #8 is the button
Seat 1: maxxmeister ($149.78 in chips) 
Seat 2: mycka86 ($188.84 in chips) 
Seat 3: fanmtZ ($62.78 in chips) 
Seat 5: vrnMike ($175.98 in chips) 
Seat 7: vinniesmol ($211.44 in chips) 
Seat 8: matiko09 ($122.79 in chips) 
Seat 9: Venomous100% ($100 in chips) 
Venomous100%: posts small blind $0.50
maxxmeister: posts big blind $1
er13to: sits out 
*** HOLE CARDS ***
Dealt to matiko09 [Qc 5s]
mycka86: folds 
fanmtZ: folds 
vrnMike: folds 
vinniesmol: raises $2 to $3
matiko09: folds 
Venomous100%: folds 
maxxmeister: calls $2
*** FLOP *** [6c 4s 8h]
maxxmeister: checks 
AlKatrone joins the table at seat #6 
vinniesmol: bets $4
AlKatrone leaves the table
maxxmeister: calls $4
*** TURN *** [6c 4s 8h] [Kh]
maxxmeister: checks 
vinniesmol: bets $8
maxxmeister: folds 
Uncalled bet ($8) returned to vinniesmol
vinniesmol collected $13.85 from pot
*** SUMMARY ***
Total pot $14.50 | Rake $0.65 
Board [6c 4s 8h Kh]
Seat 1: maxxmeister (big blind) folded on the Turn
Seat 2: mycka86 folded before Flop (didn't bet)
Seat 3: fanmtZ folded before Flop (didn't bet)
Seat 5: vrnMike folded before Flop (didn't bet)
Seat 7: vinniesmol collected ($13.85)
Seat 8: matiko09 (button) folded before Flop (didn't bet)
Seat 9: Venomous100% (small blind) folded before Flop





PokerStars Hand #148832680459:  Hold'em No Limit ($0.25/$0.50 USD) - 2016/02/15 10:50:35 CET [2016/02/15 4:50:35 ET]
Table 'Vesta II' 9-max Seat #1 is the button
Seat 1: Ahangama ($50 in chips) 
Seat 2: i L00K great ($53.62 in chips) 
Seat 3: matiko09 ($76.09 in chips) 
Seat 4: HJdream ($49.25 in chips) 
Seat 5: dndngod ($79.15 in chips) 
Seat 6: pandalapa ($50 in chips) 
Seat 7: OskarR89 ($99.98 in chips) 
Seat 8: Arystan ($118.77 in chips) 
Seat 9: Aoki42 ($72.19 in chips) 
i L00K great: posts small blind $0.25
matiko09: posts big blind $0.50
*** HOLE CARDS ***
Dealt to matiko09 [Kd 9h]
HJdream: folds 
dndngod: folds 
pandalapa: folds 
OskarR89: folds 
Arystan: folds 
Aoki42: raises $0.75 to $1.25
Ahangama: folds 
i L00K great: raises $3.75 to $5
matiko09: folds 
Aoki42: folds 
Uncalled bet ($3.75) returned to i L00K great
i L00K great collected $3 from pot
i L00K great: doesn't show hand 
*** SUMMARY ***
Total pot $3 | Rake $0 
Seat 1: Ahangama (button) folded before Flop (didn't bet)
Seat 2: i L00K great (small blind) collected ($3)
Seat 3: matiko09 (big blind) folded before Flop
Seat 4: HJdream folded before Flop (didn't bet)
Seat 5: dndngod folded before Flop (didn't bet)
Seat 6: pandalapa folded before Flop (didn't bet)
Seat 7: OskarR89 folded before Flop (didn't bet)
Seat 8: Arystan folded before Flop (didn't bet)
Seat 9: Aoki42 folded before Flop





PokerStars Hand #148832680689:  Hold'em No Limit ($0.50/$1.00 USD) - 2016/02/15 10:50:36 CET [2016/02/15 4:50:36 ET]
Table 'Gemma II' 9-max Seat #8 is the button
Seat 1: Igor DoUrden ($179.34 in chips) 
Seat 2: WDW3 ($127.93 in chips) 
Seat 3: Venomous100% ($136.85 in chips) 
Seat 4: mycka86 ($100 in chips) 
Seat 5: PokerSash201 ($65.25 in chips) 
Seat 6: fanmtZ ($40 in chips) 
Seat 8: vrnMike ($179.45 in chips) 
Seat 9: matiko09 ($100.50 in chips) 
matiko09: posts small blind $0.50
Igor DoUrden: posts big blind $1
*** HOLE CARDS ***
Dealt to matiko09 [4d 7d]
WDW3: folds 
Venomous100%: folds 
mycka86: folds 
PokerSash201: raises $1 to $2
fanmtZ: folds 
vrnMike: folds 
matiko09: folds 
Igor DoUrden: folds 
Uncalled bet ($1) returned to PokerSash201
PokerSash201 collected $2.50 from pot
PokerSash201: doesn't show hand 
*** SUMMARY ***
Total pot $2.50 | Rake $0 
Seat 1: Igor DoUrden (big blind) folded before Flop
Seat 2: WDW3 folded before Flop (didn't bet)
Seat 3: Venomous100% folded before Flop (didn't bet)
Seat 4: mycka86 folded before Flop (didn't bet)
Seat 5: PokerSash201 collected ($2.50)
Seat 6: fanmtZ folded before Flop (didn't bet)
Seat 8: vrnMike (button) folded before Flop (didn't bet)
Seat 9: matiko09 (small blind) folded before Flop





PokerStars Hand #148832681710:  Hold'em No Limit ($0.50/$1.00 USD) - 2016/02/15 10:50:39 CET [2016/02/15 4:50:39 ET]
Table 'Praecipua' 9-max Seat #1 is the button
Seat 1: matiko09 ($121.07 in chips) 
Seat 2: vrnMike ($117.17 in chips) 
Seat 3: Venomous100% ($114.53 in chips) 
Seat 5: huffwag ($36.56 in chips) 
Seat 6: mycka86 ($113.60 in chips) 
Seat 7: maxxmeister ($189.99 in chips) 
vrnMike: posts small blind $0.50
Venomous100%: posts big blind $1
*** HOLE CARDS ***
Dealt to matiko09 [8d 2s]
huffwag: raises $2 to $3
mycka86: folds 
maxxmeister: folds 
matiko09: folds 
vrnMike: folds 
Venomous100%: folds 
Uncalled bet ($2) returned to huffwag
huffwag collected $2.50 from pot
*** SUMMARY ***
Total pot $2.50 | Rake $0 
Seat 1: matiko09 (button) folded before Flop (didn't bet)
Seat 2: vrnMike (small blind) folded before Flop
Seat 3: Venomous100% (big blind) folded before Flop
Seat 5: huffwag collected ($2.50)
Seat 6: mycka86 folded before Flop (didn't bet)
Seat 7: maxxmeister folded before Flop (didn't bet)





PokerStars Hand #148832682473:  Hold'em No Limit ($0.50/$1.00 USD) - 2016/02/15 10:50:40 CET [2016/02/15 4:50:40 ET]
Table 'Corvus III' 9-max Seat #4 is the button
Seat 4: goransyruvka ($153.47 in chips) 
Seat 7: matiko09 ($249.78 in chips) 
Seat 8: redacesfull ($128.61 in chips) 
Seat 9: er13to ($100 in chips) 
matiko09: posts small blind $0.50
redacesfull: posts big blind $1
goransyruvka: posts the ante $0.20
matiko09: posts the ante $0.20
redacesfull: posts the ante $0.20
er13to: posts the ante $0.20
*** HOLE CARDS ***
Dealt to matiko09 [Th 6s]
er13to: folds 
goransyruvka: calls $1
matiko09: folds 
redacesfull: checks 
*** FLOP *** [Jc Ad Ah]
redacesfull: checks 
goransyruvka: checks 
*** TURN *** [Jc Ad Ah] [5s]
redacesfull: checks 
goransyruvka: bets $1.57
redacesfull: folds 
Uncalled bet ($1.57) returned to goransyruvka
goransyruvka collected $3.15 from pot
goransyruvka: doesn't show hand 
*** SUMMARY ***
Total pot $3.30 | Rake $0.15 
Board [Jc Ad Ah 5s]
Seat 4: goransyruvka (button) collected ($3.15)
Seat 7: matiko09 (small blind) folded before Flop
Seat 8: redacesfull (big blind) folded on the Turn
Seat 9: er13to folded before Flop (didn't bet)





PokerStars Hand #148832683682:  Hold'em No Limit ($0.50/$1.00 USD) - 2016/02/15 10:50:43 CET [2016/02/15 4:50:43 ET]
Table 'Anteros' 9-max Seat #3 is the button
Seat 1: OskarR89 ($112.52 in chips) 
Seat 2: IHouseMusic ($102.64 in chips) 
Seat 3: fanmtZ ($55.43 in chips) 
Seat 4: misherei ($200.94 in chips) 
Seat 6: SerAlGog ($100 in chips) 
Seat 7: Zoubou1983 ($86.51 in chips) 
Seat 8: matiko09 ($100 in chips) 
misherei: posts small blind $0.50
SerAlGog: posts big blind $1
vrnMike: sits out 
*** HOLE CARDS ***
Dealt to matiko09 [Ad 7c]
Zoubou1983: folds 
matiko09: folds 
OskarR89: folds 
IHouseMusic: raises $1 to $2
fanmtZ: calls $2
misherei: folds 
SerAlGog: folds 
*** FLOP *** [9s 3c Kd]
IHouseMusic: bets $3.68
fanmtZ: raises $5.29 to $8.97
IHouseMusic: calls $5.29
*** TURN *** [9s 3c Kd] [Js]
IHouseMusic: checks 
fanmtZ: checks 
*** RIVER *** [9s 3c Kd Js] [Qh]
IHouseMusic: checks 
fanmtZ: checks 
*** SHOW DOWN ***
IHouseMusic: shows [Jh Qc] (two pair, Queens and Jacks)
fanmtZ: mucks hand 
IHouseMusic collected $22.39 from pot
*** SUMMARY ***
Total pot $23.44 | Rake $1.05 
Board [9s 3c Kd Js Qh]
Seat 1: OskarR89 folded before Flop (didn't bet)
Seat 2: IHouseMusic showed [Jh Qc] and won ($22.39) with two pair, Queens and Jacks
Seat 3: fanmtZ (button) mucked [Kh 8h]
Seat 4: misherei (small blind) folded before Flop
Seat 6: SerAlGog (big blind) folded before Flop
Seat 7: Zoubou1983 folded before Flop (didn't bet)
Seat 8: matiko09 folded before Flop (didn't bet)





PokerStars Hand #148832685527:  Hold'em No Limit (€0.25/€0.50 EUR) - 2016/02/15 10:50:48 CET [2016/02/15 4:50:48 ET]
Table 'Walinskia II' 9-max Seat #2 is the button
Seat 1: ljryviltj (€50 in chips) 
Seat 2: yats87 (€50 in chips) 
Seat 3: beluccix (€27.39 in chips) 
Seat 4: Otsime (€28.34 in chips) 
Seat 5: vano7777 (€92.63 in chips) 
Seat 6: 50CandyJoe (€68.29 in chips) 
Seat 8: matiko09 (€50 in chips) 
beluccix: posts small blind €0.25
Otsime: posts big blind €0.50
etny99: sits out 
Ahangama: sits out 
*** HOLE CARDS ***
Dealt to matiko09 [5c Ad]
vano7777: raises €1.25 to €1.75
50CandyJoe: folds 
matiko09: folds 
ljryviltj: folds 
yats87: folds 
beluccix: folds 
Otsime: calls €1.25
*** FLOP *** [3c 6d 7d]
Otsime: checks 
vano7777: bets €2.50
Otsime: calls €2.50
*** TURN *** [3c 6d 7d] [Ac]
Otsime: checks 
vano7777: bets €5.50
Otsime: raises €5.50 to €11
vano7777: raises €37.25 to €48.25
Otsime: calls €13.09 and is all-in
Uncalled bet (€24.16) returned to vano7777
*** RIVER *** [3c 6d 7d Ac] [5d]
*** SHOW DOWN ***
Otsime: shows [8d 9s] (a straight, Five to Nine)
vano7777: shows [As Ah] (three of a kind, Aces)
Otsime collected €54.93 from pot
*** SUMMARY ***
Total pot €56.93 | Rake €2 
Board [3c 6d 7d Ac 5d]
Seat 1: ljryviltj folded before Flop (didn't bet)
Seat 2: yats87 (button) folded before Flop (didn't bet)
Seat 3: beluccix (small blind) folded before Flop
Seat 4: Otsime (big blind) showed [8d 9s] and won (€54.93) with a straight, Five to Nine
Seat 5: vano7777 showed [As Ah] and lost with three of a kind, Aces
Seat 6: 50CandyJoe folded before Flop (didn't bet)
Seat 8: matiko09 folded before Flop (didn't bet)





PokerStars Hand #148832690947:  Hold'em No Limit ($0.50/$1.00 USD) - 2016/02/15 10:51:00 CET [2016/02/15 4:51:00 ET]
Table 'Praecipua' 9-max Seat #2 is the button
Seat 1: matiko09 ($121.07 in chips) 
Seat 2: vrnMike ($116.67 in chips) 
Seat 3: Venomous100% ($113.53 in chips) 
Seat 5: huffwag ($38.06 in chips) 
Seat 6: mycka86 ($113.60 in chips) 
Seat 7: maxxmeister ($189.99 in chips) 
Venomous100%: posts small blind $0.50
huffwag: posts big blind $1
*** HOLE CARDS ***
Dealt to matiko09 [Kh 4c]
mycka86: folds 
maxxmeister: folds 
matiko09: folds 
vrnMike: raises $2 to $3
Venomous100%: calls $2.50
huffwag: folds 
*** FLOP *** [Ah 8d 9h]
Venomous100%: bets $4.41
vrnMike: calls $4.41
*** TURN *** [Ah 8d 9h] [8s]
Venomous100%: checks 
vrnMike: bets $12
Venomous100%: folds 
Uncalled bet ($12) returned to vrnMike
vrnMike collected $15.11 from pot
*** SUMMARY ***
Total pot $15.82 | Rake $0.71 
Board [Ah 8d 9h 8s]
Seat 1: matiko09 folded before Flop (didn't bet)
Seat 2: vrnMike (button) collected ($15.11)
Seat 3: Venomous100% (small blind) folded on the Turn
Seat 5: huffwag (big blind) folded before Flop
Seat 6: mycka86 folded before Flop (didn't bet)
Seat 7: maxxmeister folded before Flop (didn't bet)





PokerStars Hand #148832691509:  Hold'em No Limit ($0.50/$1.00 USD) - 2016/02/15 10:51:02 CET [2016/02/15 4:51:02 ET]
Table 'Urania' 9-max Seat #5 is the button
Seat 1: matiko09 ($100 in chips) 
Seat 2: maxxmeister ($111.08 in chips) 
Seat 5: maxonplay ($187.22 in chips) 
Seat 6: vrnMike ($191.74 in chips) 
Seat 7: er13to ($100 in chips) 
Seat 8: Venomous100% ($120.63 in chips) 
Seat 9: mycka86 ($107.92 in chips) 
vrnMike: posts small blind $0.50
er13to: posts big blind $1
gumeji215: sits out 
*** HOLE CARDS ***
Dealt to matiko09 [9c Js]
Venomous100%: folds 
mycka86: folds 
matiko09: folds 
maxxmeister: raises $2.50 to $3.50
maxonplay: folds 
vrnMike: calls $3
er13to: folds 
*** FLOP *** [7h 8s 3h]
vrnMike: checks 
maxxmeister: bets $6
vrnMike: folds 
Uncalled bet ($6) returned to maxxmeister
maxxmeister collected $7.64 from pot
maxxmeister: doesn't show hand 
*** SUMMARY ***
Total pot $8 | Rake $0.36 
Board [7h 8s 3h]
Seat 1: matiko09 folded before Flop (didn't bet)
Seat 2: maxxmeister collected ($7.64)
Seat 5: maxonplay (button) folded before Flop (didn't bet)
Seat 6: vrnMike (small blind) folded on the Flop
Seat 7: er13to (big blind) folded before Flop
Seat 8: Venomous100% folded before Flop (didn't bet)
Seat 9: mycka86 folded before Flop (didn't bet)





PokerStars Hand #148832692475:  Hold'em No Limit ($0.50/$1.00 USD) - 2016/02/15 10:51:04 CET [2016/02/15 4:51:04 ET]
Table 'Corvus III' 9-max Seat #7 is the button
Seat 4: goransyruvka ($155.42 in chips) 
Seat 7: matiko09 ($249.08 in chips) 
Seat 8: redacesfull ($127.41 in chips) 
Seat 9: er13to ($100 in chips) 
redacesfull: posts small blind $0.50
er13to: posts big blind $1
goransyruvka: posts the ante $0.20
matiko09: posts the ante $0.20
redacesfull: posts the ante $0.20
er13to: posts the ante $0.20
*** HOLE CARDS ***
Dealt to matiko09 [Ad 4d]
goransyruvka: folds 
matiko09: raises $1.50 to $2.50
redacesfull: folds 
er13to: raises $7 to $9.50
matiko09: calls $7
*** FLOP *** [Kd 6d 6s]
er13to: bets $10.08
matiko09: calls $10.08
*** TURN *** [Kd 6d 6s] [3c]
er13to: checks 
matiko09: checks 
*** RIVER *** [Kd 6d 6s 3c] [9s]
er13to: checks 
matiko09: bets $19
er13to: folds 
Uncalled bet ($19) returned to matiko09
matiko09 collected $38.96 from pot
matiko09: doesn't show hand 
*** SUMMARY ***
Total pot $40.46 | Rake $1.50 
Board [Kd 6d 6s 3c 9s]
Seat 4: goransyruvka folded before Flop (didn't bet)
Seat 7: matiko09 (button) collected ($38.96)
Seat 8: redacesfull (small blind) folded before Flop
Seat 9: er13to (big blind) folded on the River





PokerStars Hand #148832696834:  Hold'em No Limit ($0.50/$1.00 USD) - 2016/02/15 10:51:14 CET [2016/02/15 4:51:14 ET]
Table 'Gemma II' 9-max Seat #9 is the button
Seat 1: Igor DoUrden ($178.34 in chips) 
Seat 3: Venomous100% ($136.85 in chips) 
Seat 4: mycka86 ($100 in chips) 
Seat 5: PokerSash201 ($66.75 in chips) 
Seat 6: fanmtZ ($40 in chips) 
Seat 8: vrnMike ($179.45 in chips) 
Seat 9: matiko09 ($100 in chips) 
Igor DoUrden: posts small blind $0.50
WDW3: is sitting out 
WDW3 leaves the table
Venomous100%: posts big blind $1
*** HOLE CARDS ***
Dealt to matiko09 [5c Qs]
mycka86: folds 
PokerSash201: folds 
fanmtZ: folds 
vrnMike: raises $2 to $3
matiko09: folds 
Igor DoUrden: folds 
er13to joins the table at seat #2 
Venomous100%: calls $2
*** FLOP *** [9s 9d 5h]
Venomous100%: checks 
vrnMike: bets $3.50
Venomous100%: calls $3.50
*** TURN *** [9s 9d 5h] [2d]
Venomous100%: bets $9
vrnMike: folds 
Uncalled bet ($9) returned to Venomous100%
Venomous100% collected $12.89 from pot
Venomous100%: doesn't show hand 
*** SUMMARY ***
Total pot $13.50 | Rake $0.61 
Board [9s 9d 5h 2d]
Seat 1: Igor DoUrden (small blind) folded before Flop
Seat 3: Venomous100% (big blind) collected ($12.89)
Seat 4: mycka86 folded before Flop (didn't bet)
Seat 5: PokerSash201 folded before Flop (didn't bet)
Seat 6: fanmtZ folded before Flop (didn't bet)
Seat 8: vrnMike folded on the Turn
Seat 9: matiko09 (button) folded before Flop (didn't bet)





PokerStars Hand #148832697585:  Hold'em No Limit ($0.25/$0.50 USD) - 2016/02/15 10:51:16 CET [2016/02/15 4:51:16 ET]
Table 'Eltigen II' 9-max Seat #3 is the button
Seat 1: ljryviltj ($60.78 in chips) 
Seat 2: matiko09 ($57.76 in chips) 
Seat 3: injener ($40 in chips) 
Seat 4: beluccix ($50 in chips) 
Seat 5: R@/\//\/Y305 ($18.94 in chips) 
beluccix: posts small blind $0.25
DarkNinja8 leaves the table
R@/\//\/Y305: posts big blind $0.50
Prettyspitz: sits out 
SerAlGog: sits out 
Aoki42: sits out 
*** HOLE CARDS ***
Dealt to matiko09 [7h 2d]
etny99 joins the table at seat #9 
ljryviltj: folds 
etny99 leaves the table
matiko09: folds 
injener: folds 
beluccix: raises $0.75 to $1.25
R@/\//\/Y305: folds 
Uncalled bet ($0.75) returned to beluccix
beluccix collected $1 from pot
beluccix: doesn't show hand 
*** SUMMARY ***
Total pot $1 | Rake $0 
Seat 1: ljryviltj folded before Flop (didn't bet)
Seat 2: matiko09 folded before Flop (didn't bet)
Seat 3: injener (button) folded before Flop (didn't bet)
Seat 4: beluccix (small blind) collected ($1)
Seat 5: R@/\//\/Y305 (big blind) folded before Flop





PokerStars Hand #148832701283:  Hold'em No Limit ($0.25/$0.50 USD) - 2016/02/15 10:51:25 CET [2016/02/15 4:51:25 ET]
Table 'Vesta II' 9-max Seat #2 is the button
Seat 1: Ahangama ($50 in chips) 
Seat 2: i L00K great ($55.37 in chips) 
Seat 3: matiko09 ($75.59 in chips) 
Seat 4: HJdream ($49.25 in chips) 
Seat 5: dndngod ($79.15 in chips) 
Seat 6: pandalapa ($50 in chips) 
Seat 7: OskarR89 ($99.98 in chips) 
Seat 8: Arystan ($118.77 in chips) 
Seat 9: Aoki42 ($70.94 in chips) 
matiko09: posts small blind $0.25
HJdream: posts big blind $0.50
*** HOLE CARDS ***
Dealt to matiko09 [2s Ts]
dndngod: raises $1 to $1.50
pandalapa: folds 
OskarR89: folds 
Arystan: calls $1.50
Aoki42: calls $1.50
Ahangama: folds 
i L00K great: folds 
matiko09: folds 
HJdream: folds 
*** FLOP *** [7h Qc 4d]
dndngod: checks 
Arystan: checks 
Aoki42: checks 
*** TURN *** [7h Qc 4d] [Qd]
dndngod: checks 
Arystan: bets $2.50
Aoki42: folds 
dndngod: folds 
Uncalled bet ($2.50) returned to Arystan
Arystan collected $5.01 from pot
Arystan: doesn't show hand 
*** SUMMARY ***
Total pot $5.25 | Rake $0.24 
Board [7h Qc 4d Qd]
Seat 1: Ahangama folded before Flop (didn't bet)
Seat 2: i L00K great (button) folded before Flop (didn't bet)
Seat 3: matiko09 (small blind) folded before Flop
Seat 4: HJdream (big blind) folded before Flop
Seat 5: dndngod folded on the Turn
Seat 6: pandalapa folded before Flop (didn't bet)
Seat 7: OskarR89 folded before Flop (didn't bet)
Seat 8: Arystan collected ($5.01)
Seat 9: Aoki42 folded on the Turn





PokerStars Hand #148832703632:  Hold'em No Limit ($0.50/$1.00 USD) - 2016/02/15 10:51:31 CET [2016/02/15 4:51:31 ET]
Table 'Nata II' 9-max Seat #6 is the button
Seat 6: Arhistrareg ($42.80 in chips) 
Seat 8: Igor DoUrden ($100 in chips) 
Seat 9: matiko09 ($100 in chips) 
Igor DoUrden: posts small blind $0.50
matiko09: posts big blind $1
*** HOLE CARDS ***
Dealt to matiko09 [Qc 9d]
Arhistrareg: folds 
Igor DoUrden: raises $1.50 to $2.50
matiko09: calls $1.50
*** FLOP *** [Ks 2s 3d]
Igor DoUrden: bets $2.50
matiko09: folds 
Uncalled bet ($2.50) returned to Igor DoUrden
Igor DoUrden collected $4.78 from pot
Igor DoUrden: doesn't show hand 
*** SUMMARY ***
Total pot $5 | Rake $0.22 
Board [Ks 2s 3d]
Seat 6: Arhistrareg (button) folded before Flop (didn't bet)
Seat 8: Igor DoUrden (small blind) collected ($4.78)
Seat 9: matiko09 (big blind) folded on the Flop





PokerStars Hand #148832705002:  Hold'em No Limit ($0.50/$1.00 USD) - 2016/02/15 10:51:34 CET [2016/02/15 4:51:34 ET]
Table 'Euanthe II' 9-max Seat #9 is the button
Seat 1: maxxmeister ($142.78 in chips) 
Seat 2: mycka86 ($188.84 in chips) 
Seat 3: fanmtZ ($62.78 in chips) 
Seat 5: vrnMike ($175.98 in chips) 
Seat 7: vinniesmol ($218.29 in chips) 
Seat 8: matiko09 ($122.79 in chips) 
Seat 9: Venomous100% ($100 in chips) 
maxxmeister: posts small blind $0.50
mycka86: posts big blind $1
er13to: sits out 
*** HOLE CARDS ***
Dealt to matiko09 [6c Qd]
fanmtZ: folds 
vrnMike: folds 
vinniesmol: folds 
matiko09: folds 
Venomous100%: raises $1 to $2
ChefCatalin joins the table at seat #6 
maxxmeister: folds 
mycka86: folds 
Uncalled bet ($1) returned to Venomous100%
Venomous100% collected $2.50 from pot
Venomous100%: doesn't show hand 
*** SUMMARY ***
Total pot $2.50 | Rake $0 
Seat 1: maxxmeister (small blind) folded before Flop
Seat 2: mycka86 (big blind) folded before Flop
Seat 3: fanmtZ folded before Flop (didn't bet)
Seat 5: vrnMike folded before Flop (didn't bet)
Seat 7: vinniesmol folded before Flop (didn't bet)
Seat 8: matiko09 folded before Flop (didn't bet)
Seat 9: Venomous100% (button) collected ($2.50)





PokerStars Hand #148832706091:  Hold'em No Limit (€0.25/€0.50 EUR) - 2016/02/15 10:51:37 CET [2016/02/15 4:51:37 ET]
Table 'Walinskia II' 9-max Seat #3 is the button
Seat 1: ljryviltj (€50 in chips) 
Seat 2: yats87 (€50 in chips) 
Seat 3: beluccix (€27.14 in chips) 
Seat 4: Otsime (€54.93 in chips) 
Seat 5: vano7777 (€64.29 in chips) 
Seat 6: 50CandyJoe (€68.29 in chips) 
Seat 8: matiko09 (€50 in chips) 
Otsime: posts small blind €0.25
vano7777: posts big blind €0.50
etny99: sits out 
Ahangama: sits out 
*** HOLE CARDS ***
Dealt to matiko09 [5s As]
50CandyJoe: folds 
matiko09: raises €1 to €1.50
ljryviltj: folds 
yats87: folds 
beluccix: folds 
Otsime: calls €1.25
vano7777: folds 
*** FLOP *** [5h 9c 3c]
Otsime: checks 
matiko09: bets €2
Otsime: calls €2
*** TURN *** [5h 9c 3c] [Ac]
Otsime: checks 
matiko09: checks 
*** RIVER *** [5h 9c 3c Ac] [6h]
Otsime: checks 
matiko09: bets €4.65
Otsime: folds 
Uncalled bet (€4.65) returned to matiko09
matiko09 collected €7.16 from pot
matiko09: doesn't show hand 
*** SUMMARY ***
Total pot €7.50 | Rake €0.34 
Board [5h 9c 3c Ac 6h]
Seat 1: ljryviltj folded before Flop (didn't bet)
Seat 2: yats87 folded before Flop (didn't bet)
Seat 3: beluccix (button) folded before Flop (didn't bet)
Seat 4: Otsime (small blind) folded on the River
Seat 5: vano7777 (big blind) folded before Flop
Seat 6: 50CandyJoe folded before Flop (didn't bet)
Seat 8: matiko09 collected (€7.16)





PokerStars Hand #148832706778:  Hold'em No Limit ($0.50/$1.00 USD) - 2016/02/15 10:51:38 CET [2016/02/15 4:51:38 ET]
Table 'Ristenpart' 9-max Seat #8 is the button
Seat 1: matiko09 ($100 in chips) 
Seat 3: vrnMike ($101.50 in chips) 
Seat 5: Lünemann ($263.61 in chips) 
Seat 6: Venomous100% ($114.47 in chips) 
Seat 7: OskarR89 ($155.45 in chips) 
Seat 8: SWAYZE999 ($38.50 in chips) 
Seat 9: Sashey2708 ($67.30 in chips) 
Sashey2708: posts small blind $0.50
matiko09: posts big blind $1
*** HOLE CARDS ***
Dealt to matiko09 [Kc Tc]
vrnMike: folds 
Lünemann: folds 
Venomous100%: folds 
OskarR89: folds 
SWAYZE999: raises $1.50 to $2.50
Sashey2708: calls $2
matiko09: calls $1.50
*** FLOP *** [Th 7s 4c]
Sashey2708: bets $2
matiko09: raises $5 to $7
SWAYZE999: folds 
Sashey2708: calls $5
*** TURN *** [Th 7s 4c] [Qs]
Sashey2708: checks 
matiko09: bets $10
Sashey2708: calls $10
*** RIVER *** [Th 7s 4c Qs] [Ah]
Sashey2708: bets $19.81
matiko09: folds 
Uncalled bet ($19.81) returned to Sashey2708
Sashey2708 collected $39.63 from pot
Sashey2708: doesn't show hand 
*** SUMMARY ***
Total pot $41.50 | Rake $1.87 
Board [Th 7s 4c Qs Ah]
Seat 1: matiko09 (big blind) folded on the River
Seat 3: vrnMike folded before Flop (didn't bet)
Seat 5: Lünemann folded before Flop (didn't bet)
Seat 6: Venomous100% folded before Flop (didn't bet)
Seat 7: OskarR89 folded before Flop (didn't bet)
Seat 8: SWAYZE999 (button) folded on the Flop
Seat 9: Sashey2708 (small blind) collected ($39.63)





PokerStars Hand #148832708343:  Hold'em No Limit ($0.25/$0.50 USD) - 2016/02/15 10:51:42 CET [2016/02/15 4:51:42 ET]
Table 'Eltigen II' 9-max Seat #4 is the button
Seat 1: ljryviltj ($60.78 in chips) 
Seat 2: matiko09 ($57.76 in chips) 
Seat 3: injener ($40 in chips) 
Seat 4: beluccix ($50.50 in chips) 
Seat 5: R@/\//\/Y305 ($18.44 in chips) 
Seat 6: Prettyspitz ($50 in chips) 
R@/\//\/Y305: posts small blind $0.25
Prettyspitz: posts big blind $0.50
Aoki42: sits out 
*** HOLE CARDS ***
Dealt to matiko09 [9s 8h]
ljryviltj: folds 
Deepak.D joins the table at seat #9 
matiko09: folds 
injener: folds 
beluccix: raises $0.50 to $1
R@/\//\/Y305 is disconnected 
R@/\//\/Y305 has timed out while disconnected
R@/\//\/Y305: folds 
Prettyspitz: folds 
Uncalled bet ($0.50) returned to beluccix
beluccix collected $1.25 from pot
beluccix: doesn't show hand 
*** SUMMARY ***
Total pot $1.25 | Rake $0 
Seat 1: ljryviltj folded before Flop (didn't bet)
Seat 2: matiko09 folded before Flop (didn't bet)
Seat 3: injener folded before Flop (didn't bet)
Seat 4: beluccix (button) collected ($1.25)
Seat 5: R@/\//\/Y305 (small blind) folded before Flop
Seat 6: Prettyspitz (big blind) folded before Flop





PokerStars Hand #148832710370:  Hold'em No Limit ($0.25/$0.50 USD) - 2016/02/15 10:51:47 CET [2016/02/15 4:51:47 ET]
Table 'Laertes II' 9-max Seat #6 is the button
Seat 1: dade33 ($95.89 in chips) 
Seat 2: beluccix ($24.21 in chips) 
Seat 3: ljryviltj ($55.41 in chips) 
Seat 4: rgar93 ($41.88 in chips) 
Seat 5: vlad11122007 ($48.63 in chips) 
Seat 6: yats87 ($57.30 in chips) 
Seat 8: Trent444 ($42.98 in chips) 
Seat 9: matiko09 ($50 in chips) 
Vedpapa will be allowed to play after the button
Trent444: posts small blind $0.25
matiko09: posts big blind $0.50
*** HOLE CARDS ***
Dealt to matiko09 [Ts 8h]
dade33: raises $1 to $1.50
beluccix: folds 
ljryviltj: folds 
rgar93: folds 
vlad11122007: folds 
yats87: folds 
Trent444: folds 
matiko09: folds 
Uncalled bet ($1) returned to dade33
dade33 collected $1.25 from pot
*** SUMMARY ***
Total pot $1.25 | Rake $0 
Seat 1: dade33 collected ($1.25)
Seat 2: beluccix folded before Flop (didn't bet)
Seat 3: ljryviltj folded before Flop (didn't bet)
Seat 4: rgar93 folded before Flop (didn't bet)
Seat 5: vlad11122007 folded before Flop (didn't bet)
Seat 6: yats87 (button) folded before Flop (didn't bet)
Seat 8: Trent444 (small blind) folded before Flop
Seat 9: matiko09 (big blind) folded before Flop





PokerStars Hand #148832713019:  Hold'em No Limit ($0.50/$1.00 USD) - 2016/02/15 10:51:53 CET [2016/02/15 4:51:53 ET]
Table 'Praecipua' 9-max Seat #3 is the button
Seat 1: matiko09 ($121.07 in chips) 
Seat 2: vrnMike ($124.37 in chips) 
Seat 3: Venomous100% ($106.12 in chips) 
Seat 5: huffwag ($37.06 in chips) 
Seat 6: mycka86 ($113.60 in chips) 
Seat 7: maxxmeister ($189.99 in chips) 
Seat 8: Kalesmash08 ($73.81 in chips) 
huffwag: posts small blind $0.50
mycka86: posts big blind $1
Kalesmash08: posts small & big blinds $1.50
*** HOLE CARDS ***
Dealt to matiko09 [5h Tc]
maxxmeister: folds 
Kalesmash08: raises $2 to $3
matiko09: folds 
vrnMike: folds 
Venomous100%: folds 
huffwag: calls $2.50
mycka86: folds 
*** FLOP *** [8d 6h 7s]
huffwag: checks 
Kalesmash08: bets $4
huffwag: calls $4
*** TURN *** [8d 6h 7s] [6c]
huffwag: checks 
Kalesmash08: checks 
*** RIVER *** [8d 6h 7s 6c] [5s]
huffwag: bets $7.40
Kalesmash08: folds 
Uncalled bet ($7.40) returned to huffwag
huffwag collected $14.80 from pot
huffwag: doesn't show hand 
*** SUMMARY ***
Total pot $15.50 | Rake $0.70 
Board [8d 6h 7s 6c 5s]
Seat 1: matiko09 folded before Flop (didn't bet)
Seat 2: vrnMike folded before Flop (didn't bet)
Seat 3: Venomous100% (button) folded before Flop (didn't bet)
Seat 5: huffwag (small blind) collected ($14.80)
Seat 6: mycka86 (big blind) folded before Flop
Seat 7: maxxmeister folded before Flop (didn't bet)
Seat 8: Kalesmash08 folded on the River





PokerStars Hand #148832715158:  Hold'em No Limit ($0.50/$1.00 USD) - 2016/02/15 10:51:58 CET [2016/02/15 4:51:58 ET]
Table 'Nata II' 9-max Seat #8 is the button
Seat 6: Arhistrareg ($42.80 in chips) 
Seat 8: Igor DoUrden ($102.28 in chips) 
Seat 9: matiko09 ($100 in chips) 
matiko09: posts small blind $0.50
Arhistrareg: posts big blind $1
*** HOLE CARDS ***
Dealt to matiko09 [Ks 7d]
Igor DoUrden: folds 
er13to joins the table at seat #7 
matiko09: folds 
Uncalled bet ($0.50) returned to Arhistrareg
Arhistrareg collected $1 from pot
Arhistrareg: doesn't show hand 
*** SUMMARY ***
Total pot $1 | Rake $0 
Seat 6: Arhistrareg (big blind) collected ($1)
Seat 8: Igor DoUrden (button) folded before Flop (didn't bet)
Seat 9: matiko09 (small blind) folded before Flop





PokerStars Hand #148832717146:  Hold'em No Limit ($0.50/$1.00 USD) - 2016/02/15 10:52:03 CET [2016/02/15 4:52:03 ET]
Table 'Corvus III' 9-max Seat #8 is the button
Seat 4: goransyruvka ($155.22 in chips) 
Seat 5: koib88 ($226.83 in chips) 
Seat 7: matiko09 ($268.26 in chips) 
Seat 8: redacesfull ($126.71 in chips) 
Seat 9: er13to ($100 in chips) 
er13to: posts small blind $0.50
goransyruvka: posts big blind $1
koib88: posts small & big blinds $1.50
goransyruvka: posts the ante $0.20
koib88: posts the ante $0.20
matiko09: posts the ante $0.20
redacesfull: posts the ante $0.20
er13to: posts the ante $0.20
*** HOLE CARDS ***
Dealt to matiko09 [Td Ah]
koib88: checks 
matiko09: raises $4 to $5
redacesfull: folds 
er13to: folds 
goransyruvka: calls $4
koib88: folds 
*** FLOP *** [6h 8c Kc]
goransyruvka: bets $6.21
matiko09: folds 
Uncalled bet ($6.21) returned to goransyruvka
goransyruvka collected $12.42 from pot
goransyruvka: doesn't show hand 
*** SUMMARY ***
Total pot $13 | Rake $0.58 
Board [6h 8c Kc]
Seat 4: goransyruvka (big blind) collected ($12.42)
Seat 5: koib88 folded before Flop
Seat 7: matiko09 folded on the Flop
Seat 8: redacesfull (button) folded before Flop (didn't bet)
Seat 9: er13to (small blind) folded before Flop





PokerStars Hand #148832717758:  Hold'em No Limit ($0.50/$1.00 USD) - 2016/02/15 10:52:04 CET [2016/02/15 4:52:04 ET]
Table 'Urania' 9-max Seat #6 is the button
Seat 1: matiko09 ($100 in chips) 
Seat 2: maxxmeister ($115.22 in chips) 
Seat 5: maxonplay ($187.22 in chips) 
Seat 6: vrnMike ($188.24 in chips) 
Seat 7: er13to ($100 in chips) 
Seat 8: Venomous100% ($120.63 in chips) 
Seat 9: mycka86 ($107.92 in chips) 
er13to: posts small blind $0.50
Venomous100%: posts big blind $1
gumeji215: sits out 
*** HOLE CARDS ***
Dealt to matiko09 [2s 6h]
mycka86: raises $2 to $3
matiko09: folds 
maxxmeister: folds 
maxonplay: folds 
vrnMike: calls $3
er13to: folds 
Venomous100%: folds 
*** FLOP *** [Qs Ah As]
mycka86: checks 
vrnMike: bets $2.50
mycka86: calls $2.50
*** TURN *** [Qs Ah As] [Tc]
mycka86: checks 
vrnMike: checks 
*** RIVER *** [Qs Ah As Tc] [Qh]
mycka86: bets $6.56
vrnMike: folds 
Uncalled bet ($6.56) returned to mycka86
mycka86 collected $11.94 from pot
*** SUMMARY ***
Total pot $12.50 | Rake $0.56 
Board [Qs Ah As Tc Qh]
Seat 1: matiko09 folded before Flop (didn't bet)
Seat 2: maxxmeister folded before Flop (didn't bet)
Seat 5: maxonplay folded before Flop (didn't bet)
Seat 6: vrnMike (button) folded on the River
Seat 7: er13to (small blind) folded before Flop
Seat 8: Venomous100% (big blind) folded before Flop
Seat 9: mycka86 collected ($11.94)





PokerStars Hand #148832719928:  Hold'em No Limit ($0.50/$1.00 USD) - 2016/02/15 10:52:10 CET [2016/02/15 4:52:10 ET]
Table 'Euanthe II' 9-max Seat #1 is the button
Seat 1: maxxmeister ($142.28 in chips) 
Seat 2: mycka86 ($187.84 in chips) 
Seat 4: er13to ($100 in chips) 
Seat 5: vrnMike ($175.98 in chips) 
Seat 7: vinniesmol ($218.29 in chips) 
Seat 8: matiko09 ($122.79 in chips) 
Seat 9: Venomous100% ($101.50 in chips) 
mycka86: posts small blind $0.50
fanmtZ: is sitting out 
er13to: posts big blind $1
fanmtZ leaves the table
ChefCatalin: sits out 
*** HOLE CARDS ***
Dealt to matiko09 [5h 2h]
Sreshta222 joins the table at seat #3 
vrnMike: folds 
vinniesmol: folds 
matiko09: folds 
Venomous100%: folds 
maxxmeister: raises $2 to $3
mycka86: folds 
er13to: calls $2
*** FLOP *** [9c As Kd]
er13to: checks 
maxxmeister: bets $3.96
er13to: calls $3.96
*** TURN *** [9c As Kd] [6c]
er13to: checks 
maxxmeister: checks 
*** RIVER *** [9c As Kd 6c] [Ad]
er13to: checks 
maxxmeister: bets $9.09
er13to: calls $9.09
*** SHOW DOWN ***
maxxmeister: shows [8d Jc] (a pair of Aces)
er13to: shows [7s Ah] (three of a kind, Aces)
er13to collected $31.13 from pot
*** SUMMARY ***
Total pot $32.60 | Rake $1.47 
Board [9c As Kd 6c Ad]
Seat 1: maxxmeister (button) showed [8d Jc] and lost with a pair of Aces
Seat 2: mycka86 (small blind) folded before Flop
Seat 4: er13to (big blind) showed [7s Ah] and won ($31.13) with three of a kind, Aces
Seat 5: vrnMike folded before Flop (didn't bet)
Seat 7: vinniesmol folded before Flop (didn't bet)
Seat 8: matiko09 folded before Flop (didn't bet)
Seat 9: Venomous100% folded before Flop (didn't bet)





PokerStars Hand #148832721380:  Hold'em No Limit ($0.50/$1.00 USD) - 2016/02/15 10:52:13 CET [2016/02/15 4:52:13 ET]
Table 'Anteros' 9-max Seat #4 is the button
Seat 1: OskarR89 ($112.52 in chips) 
Seat 2: IHouseMusic ($114.06 in chips) 
Seat 3: fanmtZ ($44.46 in chips) 
Seat 4: misherei ($200.44 in chips) 
Seat 6: SerAlGog ($100 in chips) 
Seat 7: Zoubou1983 ($86.51 in chips) 
Seat 8: matiko09 ($100 in chips) 
SerAlGog: posts small blind $0.50
Zoubou1983: posts big blind $1
vrnMike: sits out 
*** HOLE CARDS ***
Dealt to matiko09 [2d 7h]
matiko09: folds 
OskarR89: folds 
IHouseMusic said, "pffff"
IHouseMusic: folds 
fanmtZ: folds 
misherei: folds 
SerAlGog: raises $1.50 to $2.50
Zoubou1983: calls $1.50
*** FLOP *** [2s 7d 4c]
SerAlGog: bets $2.67
Zoubou1983: raises $2.67 to $5.34
SerAlGog: calls $2.67
*** TURN *** [2s 7d 4c] [Kc]
SerAlGog: checks 
Zoubou1983: checks 
*** RIVER *** [2s 7d 4c Kc] [8d]
SerAlGog: bets $11.37
Zoubou1983: folds 
Uncalled bet ($11.37) returned to SerAlGog
SerAlGog collected $14.97 from pot
SerAlGog: doesn't show hand 
*** SUMMARY ***
Total pot $15.68 | Rake $0.71 
Board [2s 7d 4c Kc 8d]
Seat 1: OskarR89 folded before Flop (didn't bet)
Seat 2: IHouseMusic folded before Flop (didn't bet)
Seat 3: fanmtZ folded before Flop (didn't bet)
Seat 4: misherei (button) folded before Flop (didn't bet)
Seat 6: SerAlGog (small blind) collected ($14.97)
Seat 7: Zoubou1983 (big blind) folded on the River
Seat 8: matiko09 folded before Flop (didn't bet)





PokerStars Hand #148832721619:  Hold'em No Limit ($0.50/$1.00 USD) - 2016/02/15 10:52:14 CET [2016/02/15 4:52:14 ET]
Table 'Gemma II' 9-max Seat #1 is the button
Seat 1: Igor DoUrden ($177.84 in chips) 
Seat 3: Venomous100% ($143.24 in chips) 
Seat 4: mycka86 ($100 in chips) 
Seat 5: PokerSash201 ($66.75 in chips) 
Seat 6: fanmtZ ($40 in chips) 
Seat 8: vrnMike ($172.95 in chips) 
Seat 9: matiko09 ($100 in chips) 
er13to will be allowed to play after the button
Venomous100%: posts small blind $0.50
mycka86: posts big blind $1
*** HOLE CARDS ***
Dealt to matiko09 [Th 7h]
PokerSash201: raises $1 to $2
fanmtZ: folds 
vrnMike: folds 
matiko09: folds 
Igor DoUrden: folds 
Venomous100%: folds 
mycka86: folds 
Uncalled bet ($1) returned to PokerSash201
PokerSash201 collected $2.50 from pot
PokerSash201: doesn't show hand 
*** SUMMARY ***
Total pot $2.50 | Rake $0 
Seat 1: Igor DoUrden (button) folded before Flop (didn't bet)
Seat 3: Venomous100% (small blind) folded before Flop
Seat 4: mycka86 (big blind) folded before Flop
Seat 5: PokerSash201 collected ($2.50)
Seat 6: fanmtZ folded before Flop (didn't bet)
Seat 8: vrnMike folded before Flop (didn't bet)
Seat 9: matiko09 folded before Flop (didn't bet)





PokerStars Hand #148832723615:  Hold'em No Limit ($0.50/$1.00 USD) - 2016/02/15 10:52:19 CET [2016/02/15 4:52:19 ET]
Table 'Nata II' 9-max Seat #9 is the button
Seat 6: Arhistrareg ($43.30 in chips) 
Seat 7: er13to ($100 in chips) 
Seat 8: Igor DoUrden ($102.28 in chips) 
Seat 9: matiko09 ($100 in chips) 
Arhistrareg: posts small blind $0.50
er13to: posts big blind $1
*** HOLE CARDS ***
Dealt to matiko09 [8s 4s]
Igor DoUrden: folds 
matiko09: folds 
Arhistrareg: raises $2 to $3
er13to: folds 
Uncalled bet ($2) returned to Arhistrareg
Arhistrareg collected $2 from pot
Arhistrareg: doesn't show hand 
*** SUMMARY ***
Total pot $2 | Rake $0 
Seat 6: Arhistrareg (small blind) collected ($2)
Seat 7: er13to (big blind) folded before Flop
Seat 8: Igor DoUrden folded before Flop (didn't bet)
Seat 9: matiko09 (button) folded before Flop (didn't bet)





PokerStars Hand #148832730722:  Hold'em No Limit ($0.25/$0.50 USD) - 2016/02/15 10:52:35 CET [2016/02/15 4:52:35 ET]
Table 'Vesta II' 9-max Seat #3 is the button
Seat 1: Ahangama ($50 in chips) 
Seat 2: i L00K great ($55.37 in chips) 
Seat 3: matiko09 ($75.34 in chips) 
Seat 4: HJdream ($48.75 in chips) 
Seat 5: dndngod ($77.65 in chips) 
Seat 6: pandalapa ($50 in chips) 
Seat 7: OskarR89 ($99.98 in chips) 
Seat 8: Arystan ($122.28 in chips) 
Seat 9: Aoki42 ($69.44 in chips) 
HJdream: posts small blind $0.25
dndngod: posts big blind $0.50
*** HOLE CARDS ***
Dealt to matiko09 [3d 3s]
pandalapa: folds 
OskarR89: folds 
Arystan: raises $1 to $1.50
Aoki42: folds 
Ahangama: folds 
i L00K great: folds 
matiko09: calls $1.50
HJdream: folds 
dndngod: folds 
*** FLOP *** [Ac 8h Jc]
Arystan: bets $1.79
matiko09: folds 
Uncalled bet ($1.79) returned to Arystan
Arystan collected $3.58 from pot
Arystan: doesn't show hand 
*** SUMMARY ***
Total pot $3.75 | Rake $0.17 
Board [Ac 8h Jc]
Seat 1: Ahangama folded before Flop (didn't bet)
Seat 2: i L00K great folded before Flop (didn't bet)
Seat 3: matiko09 (button) folded on the Flop
Seat 4: HJdream (small blind) folded before Flop
Seat 5: dndngod (big blind) folded before Flop
Seat 6: pandalapa folded before Flop (didn't bet)
Seat 7: OskarR89 folded before Flop (didn't bet)
Seat 8: Arystan collected ($3.58)
Seat 9: Aoki42 folded before Flop (didn't bet)





PokerStars Hand #148832731633:  Hold'em No Limit ($0.50/$1.00 USD) - 2016/02/15 10:52:38 CET [2016/02/15 4:52:38 ET]
Table 'Nata II' 9-max Seat #6 is the button
Seat 6: Arhistrareg ($44.30 in chips) 
Seat 7: er13to ($100 in chips) 
Seat 8: Igor DoUrden ($102.28 in chips) 
Seat 9: matiko09 ($100 in chips) 
er13to: posts small blind $0.50
Igor DoUrden: posts big blind $1
*** HOLE CARDS ***
Dealt to matiko09 [4c 5d]
matiko09: folds 
Arhistrareg: folds 
er13to: raises $1.50 to $2.50
Igor DoUrden: folds 
Uncalled bet ($1.50) returned to er13to
er13to collected $2 from pot
*** SUMMARY ***
Total pot $2 | Rake $0 
Seat 6: Arhistrareg (button) folded before Flop (didn't bet)
Seat 7: er13to (small blind) collected ($2)
Seat 8: Igor DoUrden (big blind) folded before Flop
Seat 9: matiko09 folded before Flop (didn't bet)





PokerStars Hand #148832733482:  Hold'em No Limit ($0.25/$0.50 USD) - 2016/02/15 10:52:42 CET [2016/02/15 4:52:42 ET]
Table 'Laertes II' 9-max Seat #8 is the button
Seat 1: dade33 ($96.64 in chips) 
Seat 2: beluccix ($24.21 in chips) 
Seat 3: ljryviltj ($55.41 in chips) 
Seat 4: rgar93 ($41.88 in chips) 
Seat 5: vlad11122007 ($48.63 in chips) 
Seat 6: yats87 ($57.30 in chips) 
Seat 8: Trent444 ($42.73 in chips) 
Seat 9: matiko09 ($50 in chips) 
matiko09: posts small blind $0.25
dade33: posts big blind $0.50
Vedpapa: sits out 
*** HOLE CARDS ***
Dealt to matiko09 [8c Jh]
beluccix: folds 
ljryviltj: raises $1 to $1.50
rgar93: folds 
vlad11122007: folds 
yats87: folds 
Trent444: folds 
matiko09: folds 
dade33: folds 
Uncalled bet ($1) returned to ljryviltj
ljryviltj collected $1.25 from pot
ljryviltj: doesn't show hand 
*** SUMMARY ***
Total pot $1.25 | Rake $0 
Seat 1: dade33 (big blind) folded before Flop
Seat 2: beluccix folded before Flop (didn't bet)
Seat 3: ljryviltj collected ($1.25)
Seat 4: rgar93 folded before Flop (didn't bet)
Seat 5: vlad11122007 folded before Flop (didn't bet)
Seat 6: yats87 folded before Flop (didn't bet)
Seat 8: Trent444 (button) folded before Flop (didn't bet)
Seat 9: matiko09 (small blind) folded before Flop





PokerStars Hand #148832735062:  Hold'em No Limit ($0.50/$1.00 USD) - 2016/02/15 10:52:46 CET [2016/02/15 4:52:46 ET]
Table 'Corvus III' 9-max Seat #9 is the button
Seat 4: goransyruvka ($162.44 in chips) 
Seat 5: koib88 ($225.13 in chips) 
Seat 7: matiko09 ($263.06 in chips) 
Seat 8: redacesfull ($126.51 in chips) 
Seat 9: er13to ($100 in chips) 
goransyruvka: posts small blind $0.50
koib88: posts big blind $1
goransyruvka: posts the ante $0.20
koib88: posts the ante $0.20
matiko09: posts the ante $0.20
redacesfull: posts the ante $0.20
er13to: posts the ante $0.20
*** HOLE CARDS ***
Dealt to matiko09 [Ah 6s]
matiko09: folds 
redacesfull: raises $1.12 to $2.12
er13to: raises $7.38 to $9.50
goransyruvka: calls $9
koib88: folds 
redacesfull: folds 
*** FLOP *** [3d Js Kc]
goransyruvka: checks 
er13to: checks 
*** TURN *** [3d Js Kc] [Ts]
goransyruvka: checks 
er13to: bets $25
goransyruvka: folds 
Uncalled bet ($25) returned to er13to
er13to collected $22.08 from pot
*** SUMMARY ***
Total pot $23.12 | Rake $1.04 
Board [3d Js Kc Ts]
Seat 4: goransyruvka (small blind) folded on the Turn
Seat 5: koib88 (big blind) folded before Flop
Seat 7: matiko09 folded before Flop (didn't bet)
Seat 8: redacesfull folded before Flop
Seat 9: er13to (button) collected ($22.08)





PokerStars Hand #148832737240:  Hold'em No Limit ($0.50/$1.00 USD) - 2016/02/15 10:52:51 CET [2016/02/15 4:52:51 ET]
Table 'Gemma II' 9-max Seat #3 is the button
Seat 1: Igor DoUrden ($177.84 in chips) 
Seat 3: Venomous100% ($142.74 in chips) 
Seat 4: mycka86 ($100 in chips) 
Seat 5: PokerSash201 ($68.25 in chips) 
Seat 6: fanmtZ ($40 in chips) 
Seat 8: vrnMike ($172.95 in chips) 
Seat 9: matiko09 ($100 in chips) 
mycka86: posts small blind $0.50
PokerSash201: posts big blind $1
er13to: sits out 
*** HOLE CARDS ***
Dealt to matiko09 [2d As]
fanmtZ: folds 
vrnMike: folds 
matiko09: folds 
Igor DoUrden: folds 
Venomous100%: raises $1 to $2
mycka86: folds 
PokerSash201: folds 
Uncalled bet ($1) returned to Venomous100%
Venomous100% collected $2.50 from pot
Venomous100%: doesn't show hand 
*** SUMMARY ***
Total pot $2.50 | Rake $0 
Seat 1: Igor DoUrden folded before Flop (didn't bet)
Seat 3: Venomous100% (button) collected ($2.50)
Seat 4: mycka86 (small blind) folded before Flop
Seat 5: PokerSash201 (big blind) folded before Flop
Seat 6: fanmtZ folded before Flop (didn't bet)
Seat 8: vrnMike folded before Flop (didn't bet)
Seat 9: matiko09 folded before Flop (didn't bet)





PokerStars Hand #148832738584:  Hold'em No Limit (€0.25/€0.50 EUR) - 2016/02/15 10:52:54 CET [2016/02/15 4:52:54 ET]
Table 'Walinskia II' 9-max Seat #4 is the button
Seat 1: ljryviltj (€50 in chips) 
Seat 2: yats87 (€50 in chips) 
Seat 3: beluccix (€27.14 in chips) 
Seat 4: Otsime (€51.43 in chips) 
Seat 5: vano7777 (€63.79 in chips) 
Seat 6: 50CandyJoe (€68.29 in chips) 
Seat 8: matiko09 (€53.66 in chips) 
vano7777: posts small blind €0.25
50CandyJoe: posts big blind €0.50
etny99: sits out 
Ahangama: sits out 
*** HOLE CARDS ***
Dealt to matiko09 [Tc 2s]
matiko09: folds 
ljryviltj: raises €1 to €1.50
yats87: folds 
beluccix: folds 
Otsime: folds 
vano7777: folds 
50CandyJoe: folds 
Uncalled bet (€1) returned to ljryviltj
ljryviltj collected €1.25 from pot
ljryviltj: doesn't show hand 
*** SUMMARY ***
Total pot €1.25 | Rake €0 
Seat 1: ljryviltj collected (€1.25)
Seat 2: yats87 folded before Flop (didn't bet)
Seat 3: beluccix folded before Flop (didn't bet)
Seat 4: Otsime (button) folded before Flop (didn't bet)
Seat 5: vano7777 (small blind) folded before Flop
Seat 6: 50CandyJoe (big blind) folded before Flop
Seat 8: matiko09 folded before Flop (didn't bet)





PokerStars Hand #148832740610:  Hold'em No Limit ($0.50/$1.00 USD) - 2016/02/15 10:52:59 CET [2016/02/15 4:52:59 ET]
Table 'Praecipua' 9-max Seat #5 is the button
Seat 1: matiko09 ($121.07 in chips) 
Seat 2: vrnMike ($124.37 in chips) 
Seat 3: Venomous100% ($106.12 in chips) 
Seat 5: huffwag ($44.86 in chips) 
Seat 6: mycka86 ($112.60 in chips) 
Seat 7: maxxmeister ($189.99 in chips) 
Seat 8: Kalesmash08 ($66.31 in chips) 
mycka86: posts small blind $0.50
maxxmeister: posts big blind $1
Priidix: sits out 
*** HOLE CARDS ***
Dealt to matiko09 [Tc 5h]
Kalesmash08: folds 
matiko09: folds 
vrnMike: folds 
Venomous100%: folds 
huffwag: folds 
mycka86: folds 
Uncalled bet ($0.50) returned to maxxmeister
maxxmeister collected $1 from pot
maxxmeister: doesn't show hand 
*** SUMMARY ***
Total pot $1 | Rake $0 
Seat 1: matiko09 folded before Flop (didn't bet)
Seat 2: vrnMike folded before Flop (didn't bet)
Seat 3: Venomous100% folded before Flop (didn't bet)
Seat 5: huffwag (button) folded before Flop (didn't bet)
Seat 6: mycka86 (small blind) folded before Flop
Seat 7: maxxmeister (big blind) collected ($1)
Seat 8: Kalesmash08 folded before Flop (didn't bet)





PokerStars Hand #148832741921:  Hold'em No Limit ($0.50/$1.00 USD) - 2016/02/15 10:53:02 CET [2016/02/15 4:53:02 ET]
Table 'Ristenpart' 9-max Seat #9 is the button
Seat 1: matiko09 ($100 in chips) 
Seat 3: vrnMike ($101.50 in chips) 
Seat 4: Priidix ($164.14 in chips) 
Seat 5: Lünemann ($263.61 in chips) 
Seat 6: Venomous100% ($114.47 in chips) 
Seat 7: OskarR89 ($155.45 in chips) 
Seat 8: SWAYZE999 ($36 in chips) 
Seat 9: Sashey2708 ($87.43 in chips) 
matiko09: posts small blind $0.50
vrnMike: posts big blind $1
*** HOLE CARDS ***
Dealt to matiko09 [9s 5c]
Priidix: folds 
Lünemann: raises $1.50 to $2.50
Venomous100%: folds 
OskarR89: folds 
SWAYZE999: calls $2.50
Sashey2708: folds 
Sashey2708 leaves the table
matiko09: folds 
vrnMike: folds 
*** FLOP *** [7c 2c 6d]
er13to joins the table at seat #9 
Lünemann: bets $3.10
SWAYZE999: calls $3.10
*** TURN *** [7c 2c 6d] [Ad]
Lünemann: bets $6.06
SWAYZE999: calls $6.06
*** RIVER *** [7c 2c 6d Ad] [Td]
Lünemann: bets $24.34
SWAYZE999: calls $24.34 and is all-in
*** SHOW DOWN ***
Lünemann: shows [Qh Th] (a pair of Tens)
SWAYZE999: shows [Qs Ah] (a pair of Aces)
SWAYZE999 collected $70.70 from pot
*** SUMMARY ***
Total pot $73.50 | Rake $2.80 
Board [7c 2c 6d Ad Td]
Seat 1: matiko09 (small blind) folded before Flop
Seat 3: vrnMike (big blind) folded before Flop
Seat 4: Priidix folded before Flop (didn't bet)
Seat 5: Lünemann showed [Qh Th] and lost with a pair of Tens
Seat 6: Venomous100% folded before Flop (didn't bet)
Seat 7: OskarR89 folded before Flop (didn't bet)
Seat 8: SWAYZE999 showed [Qs Ah] and won ($70.70) with a pair of Aces
Seat 9: Sashey2708 (button) folded before Flop (didn't bet)





PokerStars Hand #148832744746:  Hold'em No Limit ($0.50/$1.00 USD) - 2016/02/15 10:53:09 CET [2016/02/15 4:53:09 ET]
Table 'Nata II' 9-max Seat #7 is the button
Seat 6: Arhistrareg ($44.30 in chips) 
Seat 7: er13to ($101 in chips) 
Seat 8: Igor DoUrden ($101.28 in chips) 
Seat 9: matiko09 ($100 in chips) 
Igor DoUrden: posts small blind $0.50
matiko09: posts big blind $1
*** HOLE CARDS ***
Dealt to matiko09 [6s Td]
Arhistrareg: raises $2 to $3
er13to: folds 
Igor DoUrden: folds 
matiko09: folds 
Uncalled bet ($2) returned to Arhistrareg
Arhistrareg collected $2.50 from pot
Arhistrareg: doesn't show hand 
*** SUMMARY ***
Total pot $2.50 | Rake $0 
Seat 6: Arhistrareg collected ($2.50)
Seat 7: er13to (button) folded before Flop (didn't bet)
Seat 8: Igor DoUrden (small blind) folded before Flop
Seat 9: matiko09 (big blind) folded before Flop





PokerStars Hand #148832745570:  Hold'em No Limit ($0.25/$0.50 USD) - 2016/02/15 10:53:11 CET [2016/02/15 4:53:11 ET]
Table 'Eltigen II' 9-max Seat #6 is the button
Seat 1: ljryviltj ($60.78 in chips) 
Seat 2: matiko09 ($57.76 in chips) 
Seat 3: injener ($40 in chips) 
Seat 4: beluccix ($51.25 in chips) 
Seat 6: Prettyspitz ($50 in chips) 
SerAlGog will be allowed to play after the button
Aoki42 will be allowed to play after the button
Deepak.D will be allowed to play after the button
ljryviltj: posts small blind $0.25
matiko09: posts big blind $0.50
*** HOLE CARDS ***
Dealt to matiko09 [Jc Ks]
injener: folds 
beluccix: folds 
Prettyspitz: raises $0.52 to $1.02
ljryviltj: folds 
matiko09: calls $0.52
*** FLOP *** [4c 4d 8s]
matiko09: checks 
Prettyspitz: bets $1.50
matiko09: folds 
Uncalled bet ($1.50) returned to Prettyspitz
Prettyspitz collected $2.19 from pot
Prettyspitz: doesn't show hand 
*** SUMMARY ***
Total pot $2.29 | Rake $0.10 
Board [4c 4d 8s]
Seat 1: ljryviltj (small blind) folded before Flop
Seat 2: matiko09 (big blind) folded on the Flop
Seat 3: injener folded before Flop (didn't bet)
Seat 4: beluccix folded before Flop (didn't bet)
Seat 6: Prettyspitz (button) collected ($2.19)





PokerStars Hand #148832746265:  Hold'em No Limit ($0.25/$0.50 USD) - 2016/02/15 10:53:12 CET [2016/02/15 4:53:12 ET]
Table 'Vesta II' 9-max Seat #4 is the button
Seat 1: Ahangama ($50 in chips) 
Seat 2: i L00K great ($55.37 in chips) 
Seat 3: matiko09 ($73.84 in chips) 
Seat 4: HJdream ($48.50 in chips) 
Seat 5: dndngod ($77.15 in chips) 
Seat 8: Arystan ($124.36 in chips) 
Seat 9: Aoki42 ($69.44 in chips) 
dndngod: posts small blind $0.25
pandalapa: is sitting out 
OskarR89: is sitting out 
OskarR89 leaves the table
Arystan: posts big blind $0.50
*** HOLE CARDS ***
Dealt to matiko09 [4d Ts]
Aoki42: folds 
Ahangama: folds 
Nabulasun joins the table at seat #7 
i L00K great: folds 
matiko09: folds 
HJdream: folds 
dndngod: folds 
Uncalled bet ($0.25) returned to Arystan
Arystan collected $0.50 from pot
*** SUMMARY ***
Total pot $0.50 | Rake $0 
Seat 1: Ahangama folded before Flop (didn't bet)
Seat 2: i L00K great folded before Flop (didn't bet)
Seat 3: matiko09 folded before Flop (didn't bet)
Seat 4: HJdream (button) folded before Flop (didn't bet)
Seat 5: dndngod (small blind) folded before Flop
Seat 8: Arystan (big blind) collected ($0.50)
Seat 9: Aoki42 folded before Flop (didn't bet)





PokerStars Hand #148832746523:  Hold'em No Limit ($0.50/$1.00 USD) - 2016/02/15 10:53:13 CET [2016/02/15 4:53:13 ET]
Table 'Praecipua' 9-max Seat #6 is the button
Seat 1: matiko09 ($121.07 in chips) 
Seat 2: vrnMike ($124.37 in chips) 
Seat 3: Venomous100% ($106.12 in chips) 
Seat 5: huffwag ($44.86 in chips) 
Seat 6: mycka86 ($112.10 in chips) 
Seat 7: maxxmeister ($190.49 in chips) 
Seat 8: Kalesmash08 ($66.31 in chips) 
maxxmeister: posts small blind $0.50
Kalesmash08: posts big blind $1
AlKatrone: sits out 
Priidix: sits out 
*** HOLE CARDS ***
Dealt to matiko09 [6h Jd]
matiko09: folds 
vrnMike: folds 
Venomous100%: folds 
huffwag: folds 
mycka86: folds 
maxxmeister: raises $2.50 to $3.50
Kalesmash08: folds 
Uncalled bet ($2.50) returned to maxxmeister
maxxmeister collected $2 from pot
maxxmeister: doesn't show hand 
*** SUMMARY ***
Total pot $2 | Rake $0 
Seat 1: matiko09 folded before Flop (didn't bet)
Seat 2: vrnMike folded before Flop (didn't bet)
Seat 3: Venomous100% folded before Flop (didn't bet)
Seat 5: huffwag folded before Flop (didn't bet)
Seat 6: mycka86 (button) folded before Flop (didn't bet)
Seat 7: maxxmeister (small blind) collected ($2)
Seat 8: Kalesmash08 (big blind) folded before Flop





PokerStars Hand #148832746780:  Hold'em No Limit ($0.50/$1.00 USD) - 2016/02/15 10:53:13 CET [2016/02/15 4:53:13 ET]
Table 'Urania' 9-max Seat #7 is the button
Seat 1: matiko09 ($100 in chips) 
Seat 2: maxxmeister ($115.22 in chips) 
Seat 5: maxonplay ($187.22 in chips) 
Seat 6: vrnMike ($182.74 in chips) 
Seat 7: er13to ($100 in chips) 
Seat 8: Venomous100% ($119.63 in chips) 
Seat 9: mycka86 ($114.36 in chips) 
Venomous100%: posts small blind $0.50
mycka86: posts big blind $1
gumeji215: sits out 
AlKatrone: sits out 
*** HOLE CARDS ***
Dealt to matiko09 [Ks Ac]
matiko09: raises $2 to $3
maxxmeister: calls $3
maxonplay: folds 
vrnMike: folds 
er13to: folds 
Venomous100%: folds 
mycka86: folds 
*** FLOP *** [3d Th 9d]
matiko09: checks 
maxxmeister: checks 
*** TURN *** [3d Th 9d] [7c]
matiko09: checks 
maxxmeister: bets $4.47
matiko09: folds 
Uncalled bet ($4.47) returned to maxxmeister
maxxmeister collected $7.16 from pot
maxxmeister: doesn't show hand 
*** SUMMARY ***
Total pot $7.50 | Rake $0.34 
Board [3d Th 9d 7c]
Seat 1: matiko09 folded on the Turn
Seat 2: maxxmeister collected ($7.16)
Seat 5: maxonplay folded before Flop (didn't bet)
Seat 6: vrnMike folded before Flop (didn't bet)
Seat 7: er13to (button) folded before Flop (didn't bet)
Seat 8: Venomous100% (small blind) folded before Flop
Seat 9: mycka86 (big blind) folded before Flop





PokerStars Hand #148832748128:  Hold'em No Limit ($0.50/$1.00 USD) - 2016/02/15 10:53:17 CET [2016/02/15 4:53:17 ET]
Table 'Anteros' 9-max Seat #6 is the button
Seat 1: OskarR89 ($112.52 in chips) 
Seat 2: IHouseMusic ($114.06 in chips) 
Seat 3: fanmtZ ($44.46 in chips) 
Seat 4: misherei ($200.44 in chips) 
Seat 6: SerAlGog ($107.13 in chips) 
Seat 7: Zoubou1983 ($78.67 in chips) 
Seat 8: matiko09 ($100 in chips) 
Zoubou1983: posts small blind $0.50
matiko09: posts big blind $1
vrnMike: sits out 
*** HOLE CARDS ***
Dealt to matiko09 [Qh Jh]
OskarR89: folds 
IHouseMusic: folds 
fanmtZ: folds 
misherei: folds 
SerAlGog: raises $1 to $2
Zoubou1983: calls $1.50
matiko09: raises $6 to $8
SerAlGog: raises $12 to $20
Zoubou1983: folds 
matiko09: folds 
Uncalled bet ($12) returned to SerAlGog
SerAlGog collected $18 from pot
SerAlGog: doesn't show hand 
*** SUMMARY ***
Total pot $18 | Rake $0 
Seat 1: OskarR89 folded before Flop (didn't bet)
Seat 2: IHouseMusic folded before Flop (didn't bet)
Seat 3: fanmtZ folded before Flop (didn't bet)
Seat 4: misherei folded before Flop (didn't bet)
Seat 6: SerAlGog (button) collected ($18)
Seat 7: Zoubou1983 (small blind) folded before Flop
Seat 8: matiko09 (big blind) folded before Flop





PokerStars Hand #148832750896:  Hold'em No Limit ($0.25/$0.50 USD) - 2016/02/15 10:53:23 CET [2016/02/15 4:53:23 ET]
Table 'Laertes II' 9-max Seat #9 is the button
Seat 1: dade33 ($96.14 in chips) 
Seat 2: beluccix ($24.21 in chips) 
Seat 3: ljryviltj ($56.16 in chips) 
Seat 4: rgar93 ($41.88 in chips) 
Seat 5: vlad11122007 ($48.63 in chips) 
Seat 6: yats87 ($57.30 in chips) 
Seat 8: Trent444 ($42.73 in chips) 
Seat 9: matiko09 ($50 in chips) 
dade33: posts small blind $0.25
beluccix: posts big blind $0.50
Vedpapa: sits out 
*** HOLE CARDS ***
Dealt to matiko09 [7c As]
ljryviltj: folds 
rgar93: calls $0.50
vlad11122007: folds 
yats87: raises $1.75 to $2.25
Trent444: folds 
matiko09: folds 
dade33: folds 
beluccix: folds 
rgar93: folds 
Uncalled bet ($1.75) returned to yats87
yats87 collected $1.75 from pot
yats87: doesn't show hand 
*** SUMMARY ***
Total pot $1.75 | Rake $0 
Seat 1: dade33 (small blind) folded before Flop
Seat 2: beluccix (big blind) folded before Flop
Seat 3: ljryviltj folded before Flop (didn't bet)
Seat 4: rgar93 folded before Flop
Seat 5: vlad11122007 folded before Flop (didn't bet)
Seat 6: yats87 collected ($1.75)
Seat 8: Trent444 folded before Flop (didn't bet)
Seat 9: matiko09 (button) folded before Flop (didn't bet)





PokerStars Hand #148832754125:  Hold'em No Limit (€0.25/€0.50 EUR) - 2016/02/15 10:53:31 CET [2016/02/15 4:53:31 ET]
Table 'Walinskia II' 9-max Seat #5 is the button
Seat 1: ljryviltj (€50.75 in chips) 
Seat 2: yats87 (€50 in chips) 
Seat 3: beluccix (€27.14 in chips) 
Seat 4: Otsime (€51.43 in chips) 
Seat 5: vano7777 (€63.54 in chips) 
Seat 8: matiko09 (€53.66 in chips) 
Seat 9: Ahangama (€50 in chips) 
etny99 will be allowed to play after the button
matiko09: posts small blind €0.25
Ahangama: posts big blind €0.50
*** HOLE CARDS ***
Dealt to matiko09 [3h Ts]
ljryviltj: folds 
yats87: folds 
beluccix: folds 
Otsime: folds 
vano7777: folds 
matiko09: folds 
Uncalled bet (€0.25) returned to Ahangama
Ahangama collected €0.50 from pot
Ahangama: doesn't show hand 
*** SUMMARY ***
Total pot €0.50 | Rake €0 
Seat 1: ljryviltj folded before Flop (didn't bet)
Seat 2: yats87 folded before Flop (didn't bet)
Seat 3: beluccix folded before Flop (didn't bet)
Seat 4: Otsime folded before Flop (didn't bet)
Seat 5: vano7777 (button) folded before Flop (didn't bet)
Seat 8: matiko09 (small blind) folded before Flop
Seat 9: Ahangama (big blind) collected (€0.50)





PokerStars Hand #148832754572:  Hold'em No Limit ($0.50/$1.00 USD) - 2016/02/15 10:53:32 CET [2016/02/15 4:53:32 ET]
Table 'Corvus III' 9-max Seat #4 is the button
Seat 4: goransyruvka ($152.74 in chips) 
Seat 5: koib88 ($223.93 in chips) 
Seat 7: matiko09 ($262.86 in chips) 
Seat 8: redacesfull ($124.19 in chips) 
Seat 9: er13to ($112.38 in chips) 
koib88: posts small blind $0.50
matiko09: posts big blind $1
goransyruvka: posts the ante $0.20
koib88: posts the ante $0.20
matiko09: posts the ante $0.20
redacesfull: posts the ante $0.20
er13to: posts the ante $0.20
*** HOLE CARDS ***
Dealt to matiko09 [9c 8s]
redacesfull: raises $2 to $3
er13to: folds 
goransyruvka: calls $3
koib88: calls $2.50
matiko09: folds 
*** FLOP *** [As 4s 9s]
koib88: checks 
redacesfull: checks 
goransyruvka: checks 
*** TURN *** [As 4s 9s] [9h]
koib88: bets $1
redacesfull: calls $1
goransyruvka: raises $6.75 to $7.75
koib88: calls $6.75
redacesfull: folds 
*** RIVER *** [As 4s 9s 9h] [2h]
koib88: checks 
goransyruvka: folds 
koib88 collected $26.26 from pot
koib88: doesn't show hand 
*** SUMMARY ***
Total pot $27.50 | Rake $1.24 
Board [As 4s 9s 9h 2h]
Seat 4: goransyruvka (button) folded on the River
Seat 5: koib88 (small blind) collected ($26.26)
Seat 7: matiko09 (big blind) folded before Flop
Seat 8: redacesfull folded on the Turn
Seat 9: er13to folded before Flop (didn't bet)





PokerStars Hand #148832754926:  Hold'em No Limit ($0.50/$1.00 USD) - 2016/02/15 10:53:33 CET [2016/02/15 4:53:33 ET]
Table 'Nata II' 9-max Seat #8 is the button
Seat 6: Arhistrareg ($45.80 in chips) 
Seat 7: er13to ($101 in chips) 
Seat 8: Igor DoUrden ($100.78 in chips) 
Seat 9: matiko09 ($100 in chips) 
matiko09: posts small blind $0.50
Arhistrareg: posts big blind $1
*** HOLE CARDS ***
Dealt to matiko09 [2c 6c]
er13to: raises $3.20 to $4.20
Igor DoUrden: calls $4.20
matiko09: folds 
Arhistrareg: folds 
*** FLOP *** [Jc 4h 2d]
er13to: checks 
Igor DoUrden: checks 
*** TURN *** [Jc 4h 2d] [3c]
er13to: bets $7.27
Igor DoUrden: folds 
Uncalled bet ($7.27) returned to er13to
er13to collected $9.45 from pot
er13to: doesn't show hand 
*** SUMMARY ***
Total pot $9.90 | Rake $0.45 
Board [Jc 4h 2d 3c]
Seat 6: Arhistrareg (big blind) folded before Flop
Seat 7: er13to collected ($9.45)
Seat 8: Igor DoUrden (button) folded on the Turn
Seat 9: matiko09 (small blind) folded before Flop





PokerStars Hand #148832756137:  Hold'em No Limit ($0.25/$0.50 USD) - 2016/02/15 10:53:36 CET [2016/02/15 4:53:36 ET]
Table 'Vesta II' 9-max Seat #5 is the button
Seat 1: Ahangama ($50 in chips) 
Seat 2: i L00K great ($55.37 in chips) 
Seat 3: matiko09 ($73.84 in chips) 
Seat 4: HJdream ($48.50 in chips) 
Seat 5: dndngod ($76.90 in chips) 
Seat 8: Arystan ($124.61 in chips) 
Seat 9: Aoki42 ($69.44 in chips) 
Nabulasun will be allowed to play after the button
Nabulasun leaves the table
Arystan: posts small blind $0.25
Aoki42: posts big blind $0.50
*** HOLE CARDS ***
Dealt to matiko09 [Ah Qs]
Ahangama: folds 
ruyingren joins the table at seat #7 
i L00K great: folds 
matiko09: raises $1 to $1.50
HJdream: folds 
dndngod: folds 
Arystan: calls $1.25
Aoki42: folds 
*** FLOP *** [3h Qd Ac]
Arystan: bets $1.67
matiko09: raises $3.47 to $5.14
Arystan: folds 
Uncalled bet ($3.47) returned to matiko09
matiko09 collected $6.53 from pot
matiko09: doesn't show hand 
*** SUMMARY ***
Total pot $6.84 | Rake $0.31 
Board [3h Qd Ac]
Seat 1: Ahangama folded before Flop (didn't bet)
Seat 2: i L00K great folded before Flop (didn't bet)
Seat 3: matiko09 collected ($6.53)
Seat 4: HJdream folded before Flop (didn't bet)
Seat 5: dndngod (button) folded before Flop (didn't bet)
Seat 8: Arystan (small blind) folded on the Flop
Seat 9: Aoki42 (big blind) folded before Flop





PokerStars Hand #148832756169:  Hold'em No Limit ($0.50/$1.00 USD) - 2016/02/15 10:53:36 CET [2016/02/15 4:53:36 ET]
Table 'Gemma II' 9-max Seat #4 is the button
Seat 1: Igor DoUrden ($177.84 in chips) 
Seat 3: Venomous100% ($144.24 in chips) 
Seat 4: mycka86 ($100 in chips) 
Seat 5: PokerSash201 ($67.25 in chips) 
Seat 7: AlKatrone ($106.01 in chips) 
Seat 8: vrnMike ($172.95 in chips) 
Seat 9: matiko09 ($100 in chips) 
PokerSash201: posts small blind $0.50
fanmtZ: is sitting out 
AlKatrone: posts big blind $1
fanmtZ leaves the table
er13to: sits out 
*** HOLE CARDS ***
Dealt to matiko09 [4s 4h]
vrnMike: folds 
IHouseMusic joins the table at seat #6 
matiko09: raises $2 to $3
Igor DoUrden: folds 
Venomous100%: calls $3
mycka86: folds 
PokerSash201: folds 
AlKatrone: raises $9 to $12
matiko09: folds 
Venomous100%: calls $9
*** FLOP *** [Qd 9h Ah]
AlKatrone: bets $8.92
Venomous100%: folds 
Uncalled bet ($8.92) returned to AlKatrone
AlKatrone collected $26.26 from pot
AlKatrone: doesn't show hand 
*** SUMMARY ***
Total pot $27.50 | Rake $1.24 
Board [Qd 9h Ah]
Seat 1: Igor DoUrden folded before Flop (didn't bet)
Seat 3: Venomous100% folded on the Flop
Seat 4: mycka86 (button) folded before Flop (didn't bet)
Seat 5: PokerSash201 (small blind) folded before Flop
Seat 7: AlKatrone (big blind) collected ($26.26)
Seat 8: vrnMike folded before Flop (didn't bet)
Seat 9: matiko09 folded before Flop





PokerStars Hand #148832760007:  Hold'em No Limit ($0.25/$0.50 USD) - 2016/02/15 10:53:45 CET [2016/02/15 4:53:45 ET]
Table 'Eltigen II' 9-max Seat #1 is the button
Seat 1: ljryviltj ($60.53 in chips) 
Seat 2: matiko09 ($56.74 in chips) 
Seat 3: injener ($40 in chips) 
Seat 4: beluccix ($51.25 in chips) 
Seat 5: R@/\//\/Y305 ($18.19 in chips) 
Seat 6: Prettyspitz ($51.17 in chips) 
Seat 9: Deepak.D ($50 in chips) 
matiko09: posts small blind $0.25
injener: posts big blind $0.50
SerAlGog: sits out 
Aoki42: sits out 
Deepak.D: posts big blind $0.50
*** HOLE CARDS ***
Dealt to matiko09 [Kh 4d]
beluccix: folds 
R@/\//\/Y305: folds 
Prettyspitz: raises $1.25 to $1.75
Deepak.D: calls $1.25
ljryviltj: raises $4.25 to $6
matiko09: folds 
injener is disconnected 
injener is connected 
injener: folds 
Prettyspitz: folds 
Deepak.D: calls $4.25
*** FLOP *** [8d 6d 9c]
Deepak.D: checks 
ljryviltj: checks 
*** TURN *** [8d 6d 9c] [6s]
Deepak.D: bets $9.25
ljryviltj: folds 
Uncalled bet ($9.25) returned to Deepak.D
Deepak.D collected $13.85 from pot
Deepak.D: doesn't show hand 
*** SUMMARY ***
Total pot $14.50 | Rake $0.65 
Board [8d 6d 9c 6s]
Seat 1: ljryviltj (button) folded on the Turn
Seat 2: matiko09 (small blind) folded before Flop
Seat 3: injener (big blind) folded before Flop
Seat 4: beluccix folded before Flop (didn't bet)
Seat 5: R@/\//\/Y305 folded before Flop (didn't bet)
Seat 6: Prettyspitz folded before Flop
Seat 9: Deepak.D collected ($13.85)





PokerStars Hand #148832760436:  Hold'em No Limit ($0.50/$1.00 USD) - 2016/02/15 10:53:46 CET [2016/02/15 4:53:46 ET]
Table 'Euanthe II' 9-max Seat #2 is the button
Seat 1: maxxmeister ($126.23 in chips) 
Seat 2: mycka86 ($187.34 in chips) 
Seat 4: er13to ($115.08 in chips) 
Seat 5: vrnMike ($175.98 in chips) 
Seat 7: vinniesmol ($218.29 in chips) 
Seat 8: matiko09 ($122.79 in chips) 
Seat 9: Venomous100% ($101.50 in chips) 
Sreshta222 will be allowed to play after the button
er13to: posts small blind $0.50
vrnMike: posts big blind $1
ChefCatalin: sits out 
*** HOLE CARDS ***
Dealt to matiko09 [6s Jd]
vinniesmol: folds 
matiko09: folds 
Venomous100%: folds 
maxxmeister: raises $2 to $3
mycka86: folds 
er13to: folds 
vrnMike: folds 
Uncalled bet ($2) returned to maxxmeister
maxxmeister collected $2.50 from pot
maxxmeister: doesn't show hand 
*** SUMMARY ***
Total pot $2.50 | Rake $0 
Seat 1: maxxmeister collected ($2.50)
Seat 2: mycka86 (button) folded before Flop (didn't bet)
Seat 4: er13to (small blind) folded before Flop
Seat 5: vrnMike (big blind) folded before Flop
Seat 7: vinniesmol folded before Flop (didn't bet)
Seat 8: matiko09 folded before Flop (didn't bet)
Seat 9: Venomous100% folded before Flop (didn't bet)





PokerStars Hand #148832760401:  Hold'em No Limit (€0.25/€0.50 EUR) - 2016/02/15 10:53:46 CET [2016/02/15 4:53:46 ET]
Table 'Walinskia II' 9-max Seat #8 is the button
Seat 1: ljryviltj (€50.75 in chips) 
Seat 2: yats87 (€50 in chips) 
Seat 3: beluccix (€27.14 in chips) 
Seat 4: Otsime (€51.43 in chips) 
Seat 5: vano7777 (€63.54 in chips) 
Seat 8: matiko09 (€53.41 in chips) 
Seat 9: Ahangama (€50.25 in chips) 
Ahangama: posts small blind €0.25
ljryviltj: posts big blind €0.50
etny99: sits out 
*** HOLE CARDS ***
Dealt to matiko09 [5h 9c]
yats87: folds 
beluccix: folds 
Otsime: calls €0.50
vano7777: folds 
matiko09: folds 
Ahangama: calls €0.25
ljryviltj: checks 
*** FLOP *** [2c 6s Kc]
Ahangama: checks 
ljryviltj: checks 
Otsime: bets €0.50
Ahangama: folds 
ljryviltj: folds 
Uncalled bet (€0.50) returned to Otsime
Otsime collected €1.43 from pot
Otsime: doesn't show hand 
*** SUMMARY ***
Total pot €1.50 | Rake €0.07 
Board [2c 6s Kc]
Seat 1: ljryviltj (big blind) folded on the Flop
Seat 2: yats87 folded before Flop (didn't bet)
Seat 3: beluccix folded before Flop (didn't bet)
Seat 4: Otsime collected (€1.43)
Seat 5: vano7777 folded before Flop (didn't bet)
Seat 8: matiko09 (button) folded before Flop (didn't bet)
Seat 9: Ahangama (small blind) folded on the Flop





PokerStars Hand #148832773008:  Hold'em No Limit ($0.25/$0.50 USD) - 2016/02/15 10:54:16 CET [2016/02/15 4:54:16 ET]
Table 'Laertes II' 9-max Seat #1 is the button
Seat 1: dade33 ($95.89 in chips) 
Seat 2: beluccix ($24.21 in chips) 
Seat 3: ljryviltj ($56.16 in chips) 
Seat 4: rgar93 ($41.38 in chips) 
Seat 5: vlad11122007 ($48.63 in chips) 
Seat 6: yats87 ($58.55 in chips) 
Seat 8: Trent444 ($42.73 in chips) 
Seat 9: matiko09 ($50 in chips) 
beluccix: posts small blind $0.25
ljryviltj: posts big blind $0.50
Vedpapa: sits out 
*** HOLE CARDS ***
Dealt to matiko09 [7d 8c]
rgar93: folds 
vlad11122007: folds 
yats87: folds 
Trent444: folds 
matiko09: folds 
dade33: raises $1 to $1.50
beluccix: folds 
ljryviltj: folds 
Uncalled bet ($1) returned to dade33
dade33 collected $1.25 from pot
*** SUMMARY ***
Total pot $1.25 | Rake $0 
Seat 1: dade33 (button) collected ($1.25)
Seat 2: beluccix (small blind) folded before Flop
Seat 3: ljryviltj (big blind) folded before Flop
Seat 4: rgar93 folded before Flop (didn't bet)
Seat 5: vlad11122007 folded before Flop (didn't bet)
Seat 6: yats87 folded before Flop (didn't bet)
Seat 8: Trent444 folded before Flop (didn't bet)
Seat 9: matiko09 folded before Flop (didn't bet)





PokerStars Hand #148832775434:  Hold'em No Limit ($0.50/$1.00 USD) - 2016/02/15 10:54:22 CET [2016/02/15 4:54:22 ET]
Table 'Nata II' 9-max Seat #9 is the button
Seat 6: Arhistrareg ($44.80 in chips) 
Seat 7: er13to ($106.25 in chips) 
Seat 8: Igor DoUrden ($100 in chips) 
Seat 9: matiko09 ($100 in chips) 
Arhistrareg: posts small blind $0.50
er13to: posts big blind $1
*** HOLE CARDS ***
Dealt to matiko09 [2s As]
Igor DoUrden: folds 
matiko09: raises $1.50 to $2.50
Arhistrareg: raises $6 to $8.50
er13to: folds 
matiko09: folds 
Uncalled bet ($6) returned to Arhistrareg
Arhistrareg collected $6 from pot
Arhistrareg: doesn't show hand 
*** SUMMARY ***
Total pot $6 | Rake $0 
Seat 6: Arhistrareg (small blind) collected ($6)
Seat 7: er13to (big blind) folded before Flop
Seat 8: Igor DoUrden folded before Flop (didn't bet)
Seat 9: matiko09 (button) folded before Flop





PokerStars Hand #148832776325:  Hold'em No Limit ($0.25/$0.50 USD) - 2016/02/15 10:54:24 CET [2016/02/15 4:54:24 ET]
Table 'Vesta II' 9-max Seat #8 is the button
Seat 1: Ahangama ($50 in chips) 
Seat 2: i L00K great ($55.37 in chips) 
Seat 3: matiko09 ($77.20 in chips) 
Seat 4: HJdream ($48.50 in chips) 
Seat 5: dndngod ($76.90 in chips) 
Seat 8: Arystan ($121.44 in chips) 
Seat 9: Aoki42 ($68.94 in chips) 
Aoki42: posts small blind $0.25
Ahangama: posts big blind $0.50
ruyingren: sits out 
*** HOLE CARDS ***
Dealt to matiko09 [Kc Th]
i L00K great: folds 
matiko09: folds 
HJdream: folds 
dndngod: folds 
Arystan: raises $1 to $1.50
Aoki42: raises $3 to $4.50
Ahangama: folds 
Arystan: calls $3
*** FLOP *** [Ks 5d Js]
Aoki42: bets $6.34
Arystan: folds 
Uncalled bet ($6.34) returned to Aoki42
Aoki42 collected $9.07 from pot
Aoki42: doesn't show hand 
*** SUMMARY ***
Total pot $9.50 | Rake $0.43 
Board [Ks 5d Js]
Seat 1: Ahangama (big blind) folded before Flop
Seat 2: i L00K great folded before Flop (didn't bet)
Seat 3: matiko09 folded before Flop (didn't bet)
Seat 4: HJdream folded before Flop (didn't bet)
Seat 5: dndngod folded before Flop (didn't bet)
Seat 8: Arystan (button) folded on the Flop
Seat 9: Aoki42 (small blind) collected ($9.07)





PokerStars Hand #148832776430:  Hold'em No Limit ($0.50/$1.00 USD) - 2016/02/15 10:54:24 CET [2016/02/15 4:54:24 ET]
Table 'Corvus III' 9-max Seat #5 is the button
Seat 4: goransyruvka ($141.79 in chips) 
Seat 5: koib88 ($239.24 in chips) 
Seat 7: matiko09 ($261.66 in chips) 
Seat 8: redacesfull ($119.99 in chips) 
Seat 9: er13to ($112.18 in chips) 
matiko09: posts small blind $0.50
redacesfull: posts big blind $1
goransyruvka: posts the ante $0.20
koib88: posts the ante $0.20
matiko09: posts the ante $0.20
redacesfull: posts the ante $0.20
er13to: posts the ante $0.20
*** HOLE CARDS ***
Dealt to matiko09 [Qd 2h]
er13to: folds 
goransyruvka: folds 
koib88: calls $1
matiko09: folds 
redacesfull: checks 
*** FLOP *** [Ts 9s 3s]
redacesfull: checks 
koib88: checks 
*** TURN *** [Ts 9s 3s] [4c]
redacesfull: checks 
koib88: checks 
*** RIVER *** [Ts 9s 3s 4c] [5d]
redacesfull: checks 
koib88: bets $1
redacesfull: folds 
Uncalled bet ($1) returned to koib88
koib88 collected $3.34 from pot
koib88: doesn't show hand 
*** SUMMARY ***
Total pot $3.50 | Rake $0.16 
Board [Ts 9s 3s 4c 5d]
Seat 4: goransyruvka folded before Flop (didn't bet)
Seat 5: koib88 (button) collected ($3.34)
Seat 7: matiko09 (small blind) folded before Flop
Seat 8: redacesfull (big blind) folded on the River
Seat 9: er13to folded before Flop (didn't bet)





PokerStars Hand #148832780027:  Hold'em No Limit ($0.50/$1.00 USD) - 2016/02/15 10:54:33 CET [2016/02/15 4:54:33 ET]
Table 'Anteros' 9-max Seat #7 is the button
Seat 1: OskarR89 ($112.52 in chips) 
Seat 2: IHouseMusic ($114.06 in chips) 
Seat 3: fanmtZ ($44.46 in chips) 
Seat 4: misherei ($200.44 in chips) 
Seat 6: SerAlGog ($117.13 in chips) 
Seat 7: Zoubou1983 ($76.67 in chips) 
Seat 8: matiko09 ($100 in chips) 
Seat 9: vrnMike ($100 in chips) 
matiko09: posts small blind $0.50
vrnMike: posts big blind $1
Holm1991: sits out 
*** HOLE CARDS ***
Dealt to matiko09 [Kd Jc]
OskarR89: folds 
IHouseMusic: folds 
fanmtZ: raises $1.38 to $2.38
misherei: folds 
SerAlGog: folds 
Zoubou1983: folds 
matiko09: folds 
vrnMike: folds 
Uncalled bet ($1.38) returned to fanmtZ
fanmtZ collected $2.50 from pot
fanmtZ: doesn't show hand 
*** SUMMARY ***
Total pot $2.50 | Rake $0 
Seat 1: OskarR89 folded before Flop (didn't bet)
Seat 2: IHouseMusic folded before Flop (didn't bet)
Seat 3: fanmtZ collected ($2.50)
Seat 4: misherei folded before Flop (didn't bet)
Seat 6: SerAlGog folded before Flop (didn't bet)
Seat 7: Zoubou1983 (button) folded before Flop (didn't bet)
Seat 8: matiko09 (small blind) folded before Flop
Seat 9: vrnMike (big blind) folded before Flop





PokerStars Hand #148832780789:  Hold'em No Limit (€0.25/€0.50 EUR) - 2016/02/15 10:54:34 CET [2016/02/15 4:54:34 ET]
Table 'Walinskia II' 9-max Seat #9 is the button
Seat 1: ljryviltj (€50.25 in chips) 
Seat 2: yats87 (€50 in chips) 
Seat 3: beluccix (€27.14 in chips) 
Seat 4: Otsime (€52.36 in chips) 
Seat 5: vano7777 (€63.54 in chips) 
Seat 8: matiko09 (€53.41 in chips) 
Seat 9: Ahangama (€50 in chips) 
ljryviltj: posts small blind €0.25
yats87: posts big blind €0.50
etny99: sits out 
*** HOLE CARDS ***
Dealt to matiko09 [7s Qh]
beluccix: folds 
Otsime: folds 
vano7777: folds 
matiko09: folds 
Ahangama: folds 
ljryviltj: raises €0.61 to €1.11
yats87: calls €0.61
*** FLOP *** [4c 7c 4s]
ljryviltj: bets €1.50
yats87: calls €1.50
*** TURN *** [4c 7c 4s] [6d]
ljryviltj: bets €4.75
yats87: calls €4.75
*** RIVER *** [4c 7c 4s 6d] [3h]
ljryviltj: checks 
yats87: checks 
*** SHOW DOWN ***
ljryviltj: shows [8c 9c] (a pair of Fours)
yats87: shows [7h 6s] (two pair, Sevens and Sixes)
yats87 collected €14.06 from pot
*** SUMMARY ***
Total pot €14.72 | Rake €0.66 
Board [4c 7c 4s 6d 3h]
Seat 1: ljryviltj (small blind) showed [8c 9c] and lost with a pair of Fours
Seat 2: yats87 (big blind) showed [7h 6s] and won (€14.06) with two pair, Sevens and Sixes
Seat 3: beluccix folded before Flop (didn't bet)
Seat 4: Otsime folded before Flop (didn't bet)
Seat 5: vano7777 folded before Flop (didn't bet)
Seat 8: matiko09 folded before Flop (didn't bet)
Seat 9: Ahangama (button) folded before Flop (didn't bet)





PokerStars Hand #148832780558:  Hold'em No Limit ($0.50/$1.00 USD) - 2016/02/15 10:54:34 CET [2016/02/15 4:54:34 ET]
Table 'Euanthe II' 9-max Seat #4 is the button
Seat 1: maxxmeister ($127.73 in chips) 
Seat 2: mycka86 ($187.34 in chips) 
Seat 4: er13to ($114.58 in chips) 
Seat 5: vrnMike ($174.98 in chips) 
Seat 6: ChefCatalin ($80 in chips) 
Seat 7: vinniesmol ($218.29 in chips) 
Seat 8: matiko09 ($122.79 in chips) 
Seat 9: Venomous100% ($101.50 in chips) 
vrnMike: posts small blind $0.50
ChefCatalin: posts big blind $1
Sreshta222: sits out 
*** HOLE CARDS ***
Dealt to matiko09 [2d 3s]
vinniesmol: folds 
matiko09: folds 
Venomous100%: folds 
maxxmeister: raises $2 to $3
mycka86: folds 
er13to: folds 
vrnMike: folds 
ChefCatalin: calls $2
*** FLOP *** [3d Qs Kc]
ChefCatalin: checks 
maxxmeister: checks 
*** TURN *** [3d Qs Kc] [Kd]
ChefCatalin: checks 
maxxmeister: checks 
*** RIVER *** [3d Qs Kc Kd] [Qc]
ChefCatalin: checks 
maxxmeister: bets $4.51
ChefCatalin: folds 
Uncalled bet ($4.51) returned to maxxmeister
maxxmeister collected $6.21 from pot
maxxmeister: doesn't show hand 
*** SUMMARY ***
Total pot $6.50 | Rake $0.29 
Board [3d Qs Kc Kd Qc]
Seat 1: maxxmeister collected ($6.21)
Seat 2: mycka86 folded before Flop (didn't bet)
Seat 4: er13to (button) folded before Flop (didn't bet)
Seat 5: vrnMike (small blind) folded before Flop
Seat 6: ChefCatalin (big blind) folded on the River
Seat 7: vinniesmol folded before Flop (didn't bet)
Seat 8: matiko09 folded before Flop (didn't bet)
Seat 9: Venomous100% folded before Flop (didn't bet)





PokerStars Hand #148832781810:  Hold'em No Limit ($0.50/$1.00 USD) - 2016/02/15 10:54:37 CET [2016/02/15 4:54:37 ET]
Table 'Nata II' 9-max Seat #6 is the button
Seat 6: Arhistrareg ($48.30 in chips) 
Seat 7: er13to ($105.25 in chips) 
Seat 8: Igor DoUrden ($100 in chips) 
Seat 9: matiko09 ($100 in chips) 
er13to: posts small blind $0.50
Igor DoUrden: posts big blind $1
*** HOLE CARDS ***
Dealt to matiko09 [2d 5c]
matiko09: folds 
Arhistrareg: raises $2 to $3
er13to: folds 
Igor DoUrden: calls $2
*** FLOP *** [8h 6d 3s]
Igor DoUrden: checks 
Arhistrareg: bets $3.10
Igor DoUrden: folds 
Uncalled bet ($3.10) returned to Arhistrareg
Arhistrareg collected $6.21 from pot
Arhistrareg: doesn't show hand 
*** SUMMARY ***
Total pot $6.50 | Rake $0.29 
Board [8h 6d 3s]
Seat 6: Arhistrareg (button) collected ($6.21)
Seat 7: er13to (small blind) folded before Flop
Seat 8: Igor DoUrden (big blind) folded on the Flop
Seat 9: matiko09 folded before Flop (didn't bet)





PokerStars Hand #148832784706:  Hold'em No Limit ($0.50/$1.00 USD) - 2016/02/15 10:54:44 CET [2016/02/15 4:54:44 ET]
Table 'Gemma II' 9-max Seat #5 is the button
Seat 1: Igor DoUrden ($177.84 in chips) 
Seat 3: Venomous100% ($132.24 in chips) 
Seat 4: mycka86 ($100 in chips) 
Seat 5: PokerSash201 ($66.75 in chips) 
Seat 7: AlKatrone ($120.27 in chips) 
Seat 8: vrnMike ($172.95 in chips) 
Seat 9: matiko09 ($100 in chips) 
IHouseMusic will be allowed to play after the button
AlKatrone: posts small blind $0.50
vrnMike: posts big blind $1
er13to: sits out 
*** HOLE CARDS ***
Dealt to matiko09 [2d 5s]
matiko09: folds 
Igor DoUrden: raises $1.25 to $2.25
Venomous100%: folds 
mycka86: folds 
PokerSash201: folds 
AlKatrone: folds 
vrnMike: folds 
Uncalled bet ($1.25) returned to Igor DoUrden
Igor DoUrden collected $2.50 from pot
Igor DoUrden: doesn't show hand 
*** SUMMARY ***
Total pot $2.50 | Rake $0 
Seat 1: Igor DoUrden collected ($2.50)
Seat 3: Venomous100% folded before Flop (didn't bet)
Seat 4: mycka86 folded before Flop (didn't bet)
Seat 5: PokerSash201 (button) folded before Flop (didn't bet)
Seat 7: AlKatrone (small blind) folded before Flop
Seat 8: vrnMike (big blind) folded before Flop
Seat 9: matiko09 folded before Flop (didn't bet)





PokerStars Hand #148832787664:  Hold'em No Limit ($0.50/$1.00 USD) - 2016/02/15 10:54:51 CET [2016/02/15 4:54:51 ET]
Table 'Corvus III' 9-max Seat #7 is the button
Seat 4: goransyruvka ($141.59 in chips) 
Seat 5: koib88 ($241.38 in chips) 
Seat 7: matiko09 ($260.96 in chips) 
Seat 8: redacesfull ($118.79 in chips) 
Seat 9: er13to ($111.98 in chips) 
redacesfull: posts small blind $0.50
er13to: posts big blind $1
goransyruvka: posts the ante $0.20
koib88: posts the ante $0.20
matiko09: posts the ante $0.20
redacesfull: posts the ante $0.20
er13to: posts the ante $0.20
*** HOLE CARDS ***
Dealt to matiko09 [8s 5s]
goransyruvka: raises $3.50 to $4.50
koib88: folds 
matiko09: folds 
redacesfull: folds 
er13to: folds 
Uncalled bet ($3.50) returned to goransyruvka
goransyruvka collected $3.50 from pot
goransyruvka: doesn't show hand 
*** SUMMARY ***
Total pot $3.50 | Rake $0 
Seat 4: goransyruvka collected ($3.50)
Seat 5: koib88 folded before Flop (didn't bet)
Seat 7: matiko09 (button) folded before Flop (didn't bet)
Seat 8: redacesfull (small blind) folded before Flop
Seat 9: er13to (big blind) folded before Flop





PokerStars Hand #148832787817:  Hold'em No Limit ($0.50/$1.00 USD) - 2016/02/15 10:54:51 CET [2016/02/15 4:54:51 ET]
Table 'Ristenpart' 9-max Seat #1 is the button
Seat 1: matiko09 ($100 in chips) 
Seat 3: vrnMike ($100.50 in chips) 
Seat 4: Priidix ($164.14 in chips) 
Seat 5: Lünemann ($227.61 in chips) 
Seat 6: Venomous100% ($114.47 in chips) 
Seat 7: OskarR89 ($155.45 in chips) 
Seat 8: SWAYZE999 ($70.70 in chips) 
AlKatrone will be allowed to play after the button
vrnMike: posts small blind $0.50
Priidix: posts big blind $1
er13to: sits out 
*** HOLE CARDS ***
Dealt to matiko09 [6c 4d]
Lünemann: folds 
Venomous100%: folds 
OskarR89: raises $1.50 to $2.50
SWAYZE999: calls $2.50
matiko09: folds 
vrnMike: folds 
Lünemann leaves the table
Priidix: folds 
*** FLOP *** [2d 9d 5h]
OskarR89: bets $4.96
SWAYZE999: calls $4.96
*** TURN *** [2d 9d 5h] [Th]
OskarR89: bets $12.54
SWAYZE999: raises $12.54 to $25.08
OskarR89: calls $12.54
*** RIVER *** [2d 9d 5h Th] [2h]
OskarR89: checks 
SWAYZE999: bets $31.89
OskarR89: calls $31.89
*** SHOW DOWN ***
SWAYZE999: shows [9h 9c] (a full house, Nines full of Deuces)
OskarR89: mucks hand 
SWAYZE999 collected $127.56 from pot
*** SUMMARY ***
Total pot $130.36 | Rake $2.80 
Board [2d 9d 5h Th 2h]
Seat 1: matiko09 (button) folded before Flop (didn't bet)
Seat 3: vrnMike (small blind) folded before Flop
Seat 4: Priidix (big blind) folded before Flop
Seat 5: Lünemann folded before Flop (didn't bet)
Seat 6: Venomous100% folded before Flop (didn't bet)
Seat 7: OskarR89 mucked [Qd Qs]
Seat 8: SWAYZE999 showed [9h 9c] and won ($127.56) with a full house, Nines full of Deuces





PokerStars Hand #148832789576:  Hold'em No Limit ($0.25/$0.50 USD) - 2016/02/15 10:54:55 CET [2016/02/15 4:54:55 ET]
Table 'Laertes II' 9-max Seat #2 is the button
Seat 1: dade33 ($96.64 in chips) 
Seat 2: beluccix ($24.21 in chips) 
Seat 3: ljryviltj ($55.66 in chips) 
Seat 4: rgar93 ($41.38 in chips) 
Seat 5: vlad11122007 ($48.63 in chips) 
Seat 6: yats87 ($58.55 in chips) 
Seat 8: Trent444 ($42.73 in chips) 
Seat 9: matiko09 ($50 in chips) 
ljryviltj: posts small blind $0.25
rgar93: posts big blind $0.50
Vedpapa: sits out 
*** HOLE CARDS ***
Dealt to matiko09 [4h 7h]
vlad11122007: raises $1 to $1.50
yats87: folds 
Trent444: folds 
matiko09: folds 
dade33: raises $3.50 to $5
beluccix: folds 
ljryviltj: folds 
rgar93: folds 
vlad11122007: folds 
Uncalled bet ($3.50) returned to dade33
dade33 collected $3.75 from pot
*** SUMMARY ***
Total pot $3.75 | Rake $0 
Seat 1: dade33 collected ($3.75)
Seat 2: beluccix (button) folded before Flop (didn't bet)
Seat 3: ljryviltj (small blind) folded before Flop
Seat 4: rgar93 (big blind) folded before Flop
Seat 5: vlad11122007 folded before Flop
Seat 6: yats87 folded before Flop (didn't bet)
Seat 8: Trent444 folded before Flop (didn't bet)
Seat 9: matiko09 folded before Flop (didn't bet)





PokerStars Hand #148832791724:  Hold'em No Limit ($0.50/$1.00 USD) - 2016/02/15 10:55:00 CET [2016/02/15 4:55:00 ET]
Table 'Anteros' 9-max Seat #8 is the button
Seat 2: IHouseMusic ($114.06 in chips) 
Seat 3: fanmtZ ($45.96 in chips) 
Seat 4: misherei ($200.44 in chips) 
Seat 5: Holm1991 ($76.98 in chips) 
Seat 6: SerAlGog ($117.13 in chips) 
Seat 7: Zoubou1983 ($76.67 in chips) 
Seat 8: matiko09 ($100 in chips) 
Seat 9: vrnMike ($100 in chips) 
vrnMike: posts small blind $0.50
OskarR89: is sitting out 
IHouseMusic: posts big blind $1
Holm1991: posts small & big blinds $1.50
*** HOLE CARDS ***
Dealt to matiko09 [Jd 4c]
OskarR89 leaves the table
fanmtZ: folds 
redacesfull joins the table at seat #1 
misherei: calls $1
Holm1991: checks 
SerAlGog: raises $3.50 to $4.50
Zoubou1983: raises $7.50 to $12
matiko09: folds 
vrnMike: raises $13 to $25
IHouseMusic: folds 
misherei: folds 
Holm1991: folds 
SerAlGog: folds 
Zoubou1983: raises $51.67 to $76.67 and is all-in
vrnMike: calls $51.67
*** FLOP *** [Ts 2d 9s]
*** TURN *** [Ts 2d 9s] [9h]
*** RIVER *** [Ts 2d 9s 9h] [9c]
*** SHOW DOWN ***
vrnMike: shows [Qd Qc] (a full house, Nines full of Queens)
Zoubou1983: shows [Ks Kc] (a full house, Nines full of Kings)
Zoubou1983 collected $158.54 from pot
*** SUMMARY ***
Total pot $161.34 | Rake $2.80 
Board [Ts 2d 9s 9h 9c]
Seat 2: IHouseMusic (big blind) folded before Flop
Seat 3: fanmtZ folded before Flop (didn't bet)
Seat 4: misherei folded before Flop
Seat 5: Holm1991 folded before Flop
Seat 6: SerAlGog folded before Flop
Seat 7: Zoubou1983 showed [Ks Kc] and won ($158.54) with a full house, Nines full of Kings
Seat 8: matiko09 (button) folded before Flop (didn't bet)
Seat 9: vrnMike (small blind) showed [Qd Qc] and lost with a full house, Nines full of Queens





PokerStars Hand #148832794786:  Hold'em No Limit ($0.50/$1.00 USD) - 2016/02/15 10:55:08 CET [2016/02/15 4:55:08 ET]
Table 'Gemma II' 9-max Seat #7 is the button
Seat 1: Igor DoUrden ($179.34 in chips) 
Seat 3: Venomous100% ($132.24 in chips) 
Seat 4: mycka86 ($100 in chips) 
Seat 5: PokerSash201 ($66.75 in chips) 
Seat 7: AlKatrone ($119.77 in chips) 
Seat 8: vrnMike ($171.95 in chips) 
Seat 9: matiko09 ($100 in chips) 
vrnMike: posts small blind $0.50
matiko09: posts big blind $1
er13to: sits out 
IHouseMusic: sits out 
*** HOLE CARDS ***
Dealt to matiko09 [6s Ks]
Igor DoUrden: folds 
Venomous100%: raises $2 to $3
mycka86: folds 
PokerSash201: folds 
AlKatrone: folds 
vrnMike: folds 
matiko09: folds 
Uncalled bet ($2) returned to Venomous100%
Venomous100% collected $2.50 from pot
Venomous100%: doesn't show hand 
*** SUMMARY ***
Total pot $2.50 | Rake $0 
Seat 1: Igor DoUrden folded before Flop (didn't bet)
Seat 3: Venomous100% collected ($2.50)
Seat 4: mycka86 folded before Flop (didn't bet)
Seat 5: PokerSash201 folded before Flop (didn't bet)
Seat 7: AlKatrone (button) folded before Flop (didn't bet)
Seat 8: vrnMike (small blind) folded before Flop
Seat 9: matiko09 (big blind) folded before Flop





PokerStars Hand #148832795247:  Hold'em No Limit ($0.25/$0.50 USD) - 2016/02/15 10:55:09 CET [2016/02/15 4:55:09 ET]
Table 'Eltigen II' 9-max Seat #2 is the button
Seat 1: ljryviltj ($54.53 in chips) 
Seat 2: matiko09 ($56.49 in chips) 
Seat 3: injener ($39.50 in chips) 
Seat 4: beluccix ($51.25 in chips) 
Seat 5: R@/\//\/Y305 ($18.19 in chips) 
Seat 6: Prettyspitz ($50 in chips) 
Seat 9: Deepak.D ($57.85 in chips) 
injener: posts small blind $0.25
beluccix: posts big blind $0.50
SerAlGog: sits out 
Aoki42: sits out 
*** HOLE CARDS ***
Dealt to matiko09 [Qd 5s]
R@/\//\/Y305: folds 
Prettyspitz: folds 
Deepak.D: folds 
ljryviltj: folds 
matiko09: folds 
injener: folds 
Uncalled bet ($0.25) returned to beluccix
beluccix collected $0.50 from pot
beluccix: doesn't show hand 
*** SUMMARY ***
Total pot $0.50 | Rake $0 
Seat 1: ljryviltj folded before Flop (didn't bet)
Seat 2: matiko09 (button) folded before Flop (didn't bet)
Seat 3: injener (small blind) folded before Flop
Seat 4: beluccix (big blind) collected ($0.50)
Seat 5: R@/\//\/Y305 folded before Flop (didn't bet)
Seat 6: Prettyspitz folded before Flop (didn't bet)
Seat 9: Deepak.D folded before Flop (didn't bet)





PokerStars Hand #148832796388:  Hold'em No Limit ($0.25/$0.50 USD) - 2016/02/15 10:55:12 CET [2016/02/15 4:55:12 ET]
Table 'Vesta II' 9-max Seat #9 is the button
Seat 1: Ahangama ($50 in chips) 
Seat 2: i L00K great ($55.37 in chips) 
Seat 3: matiko09 ($77.20 in chips) 
Seat 4: HJdream ($48.50 in chips) 
Seat 5: dndngod ($76.90 in chips) 
Seat 8: Arystan ($116.94 in chips) 
Seat 9: Aoki42 ($73.51 in chips) 
Ahangama: posts small blind $0.25
i L00K great: posts big blind $0.50
ruyingren: sits out 
*** HOLE CARDS ***
Dealt to matiko09 [Qd 7s]
matiko09: folds 
HJdream: folds 
dndngod: folds 
Arystan: raises $1 to $1.50
Aoki42: folds 
Ahangama: raises $3.50 to $5
i L00K great: folds 
Arystan: calls $3.50
*** FLOP *** [Kd 9h 8h]
Ahangama: bets $6.50
Arystan: raises $8.50 to $15
Ahangama: raises $30 to $45 and is all-in
Arystan: calls $30
*** TURN *** [Kd 9h 8h] [4h]
*** RIVER *** [Kd 9h 8h 4h] [Td]
*** SHOW DOWN ***
Ahangama: shows [Ks Qs] (a pair of Kings)
Arystan: shows [Jh Jc] (a pair of Jacks)
Ahangama collected $98 from pot
*** SUMMARY ***
Total pot $100.50 | Rake $2.50 
Board [Kd 9h 8h 4h Td]
Seat 1: Ahangama (small blind) showed [Ks Qs] and won ($98) with a pair of Kings
Seat 2: i L00K great (big blind) folded before Flop
Seat 3: matiko09 folded before Flop (didn't bet)
Seat 4: HJdream folded before Flop (didn't bet)
Seat 5: dndngod folded before Flop (didn't bet)
Seat 8: Arystan showed [Jh Jc] and lost with a pair of Jacks
Seat 9: Aoki42 (button) folded before Flop (didn't bet)





PokerStars Hand #148832797114:  Hold'em No Limit ($0.50/$1.00 USD) - 2016/02/15 10:55:13 CET [2016/02/15 4:55:13 ET]
Table 'Corvus III' 9-max Seat #8 is the button
Seat 4: goransyruvka ($143.89 in chips) 
Seat 5: koib88 ($241.18 in chips) 
Seat 7: matiko09 ($260.76 in chips) 
Seat 8: redacesfull ($118.09 in chips) 
Seat 9: er13to ($110.78 in chips) 
er13to: posts small blind $0.50
goransyruvka: posts big blind $1
goransyruvka: posts the ante $0.20
koib88: posts the ante $0.20
matiko09: posts the ante $0.20
redacesfull: posts the ante $0.20
er13to: posts the ante $0.20
*** HOLE CARDS ***
Dealt to matiko09 [Ts Kh]
koib88: raises $1 to $2
matiko09: folds 
redacesfull: raises $7 to $9
er13to: folds 
goransyruvka: calls $8
koib88: calls $7
*** FLOP *** [4s Kc Ad]
goransyruvka: bets $13.61
koib88: folds 
redacesfull: calls $13.61
*** TURN *** [4s Kc Ad] [Ks]
goransyruvka: bets $26.60
redacesfull: calls $26.60
*** RIVER *** [4s Kc Ad Ks] [5d]
goransyruvka: checks 
redacesfull: checks 
*** SHOW DOWN ***
goransyruvka: shows [Ah 8h] (two pair, Aces and Kings)
redacesfull: shows [Jd As] (two pair, Aces and Kings - Jack kicker)
redacesfull collected $106.12 from pot
*** SUMMARY ***
Total pot $108.92 | Rake $2.80 
Board [4s Kc Ad Ks 5d]
Seat 4: goransyruvka (big blind) showed [Ah 8h] and lost with two pair, Aces and Kings
Seat 5: koib88 folded on the Flop
Seat 7: matiko09 folded before Flop (didn't bet)
Seat 8: redacesfull (button) showed [Jd As] and won ($106.12) with two pair, Aces and Kings
Seat 9: er13to (small blind) folded before Flop





PokerStars Hand #148832796955:  Hold'em No Limit (€0.50/€1.00 EUR) - 2016/02/15 10:55:13 CET [2016/02/15 4:55:13 ET]
Table 'Ganesa II' 9-max Seat #4 is the button
Seat 2: maxxmeister (€109.22 in chips) 
Seat 3: BuBu 0187 (€70.19 in chips) 
Seat 4: Sreshta222 (€100 in chips) 
Seat 5: vano7777 (€74.24 in chips) 
Seat 6: matiko09 (€100 in chips) 
Seat 7: er13to (€110.03 in chips) 
vano7777: posts small blind €0.50
matiko09: posts big blind €1
*** HOLE CARDS ***
Dealt to matiko09 [6s Ks]
er13to: folds 
maxxmeister: folds 
BuBu 0187: calls €1
Sreshta222: folds 
vano7777: folds 
matiko09: checks 
*** FLOP *** [3d 2d 8c]
matiko09: checks 
BuBu 0187: checks 
*** TURN *** [3d 2d 8c] [7s]
matiko09: checks 
BuBu 0187: checks 
*** RIVER *** [3d 2d 8c 7s] [Th]
matiko09: checks 
BuBu 0187: checks 
*** SHOW DOWN ***
matiko09: shows [6s Ks] (high card King)
BuBu 0187: mucks hand 
matiko09 collected €2.39 from pot
*** SUMMARY ***
Total pot €2.50 | Rake €0.11 
Board [3d 2d 8c 7s Th]
Seat 2: maxxmeister folded before Flop (didn't bet)
Seat 3: BuBu 0187 mucked [Jh 6h]
Seat 4: Sreshta222 (button) folded before Flop (didn't bet)
Seat 5: vano7777 (small blind) folded before Flop
Seat 6: matiko09 (big blind) showed [6s Ks] and won (€2.39) with high card King
Seat 7: er13to folded before Flop (didn't bet)





PokerStars Hand #148832803783:  Hold'em No Limit ($0.25/$0.50 USD) - 2016/02/15 10:55:31 CET [2016/02/15 4:55:31 ET]
Table 'Laertes II' 9-max Seat #3 is the button
Seat 1: dade33 ($98.89 in chips) 
Seat 2: beluccix ($24.21 in chips) 
Seat 3: ljryviltj ($55.41 in chips) 
Seat 4: rgar93 ($40.88 in chips) 
Seat 5: vlad11122007 ($50 in chips) 
Seat 6: yats87 ($58.55 in chips) 
Seat 8: Trent444 ($42.73 in chips) 
Seat 9: matiko09 ($50 in chips) 
rgar93: posts small blind $0.25
vlad11122007: posts big blind $0.50
Vedpapa: sits out 
*** HOLE CARDS ***
Dealt to matiko09 [5s Ac]
yats87: folds 
Trent444: folds 
matiko09: folds 
dade33: folds 
beluccix: folds 
ljryviltj: raises $0.56 to $1.06
rgar93: folds 
vlad11122007: calls $0.56
*** FLOP *** [4h Tc Ts]
vlad11122007: checks 
ljryviltj: bets $1.50
vlad11122007: calls $1.50
*** TURN *** [4h Tc Ts] [4c]
vlad11122007: checks 
ljryviltj: bets $2.50
vlad11122007: folds 
Uncalled bet ($2.50) returned to ljryviltj
ljryviltj collected $5.13 from pot
ljryviltj: doesn't show hand 
*** SUMMARY ***
Total pot $5.37 | Rake $0.24 
Board [4h Tc Ts 4c]
Seat 1: dade33 folded before Flop (didn't bet)
Seat 2: beluccix folded before Flop (didn't bet)
Seat 3: ljryviltj (button) collected ($5.13)
Seat 4: rgar93 (small blind) folded before Flop
Seat 5: vlad11122007 (big blind) folded on the Turn
Seat 6: yats87 folded before Flop (didn't bet)
Seat 8: Trent444 folded before Flop (didn't bet)
Seat 9: matiko09 folded before Flop (didn't bet)





PokerStars Hand #148832804310:  Hold'em No Limit ($0.50/$1.00 USD) - 2016/02/15 10:55:32 CET [2016/02/15 4:55:32 ET]
Table 'Nata II' 9-max Seat #7 is the button
Seat 6: Arhistrareg ($51.51 in chips) 
Seat 7: er13to ($104.75 in chips) 
Seat 8: Igor DoUrden ($100 in chips) 
Seat 9: matiko09 ($100 in chips) 
Igor DoUrden: posts small blind $0.50
matiko09: posts big blind $1
*** HOLE CARDS ***
Dealt to matiko09 [Qc 2h]
Arhistrareg: raises $2 to $3
er13to: folds 
Igor DoUrden: calls $2.50
matiko09: folds 
*** FLOP *** [4c 3s Td]
Igor DoUrden: checks 
Arhistrareg: checks 
*** TURN *** [4c 3s Td] [2s]
Igor DoUrden: bets $4.41
Arhistrareg: folds 
Uncalled bet ($4.41) returned to Igor DoUrden
Igor DoUrden collected $6.68 from pot
Igor DoUrden: doesn't show hand 
*** SUMMARY ***
Total pot $7 | Rake $0.32 
Board [4c 3s Td 2s]
Seat 6: Arhistrareg folded on the Turn
Seat 7: er13to (button) folded before Flop (didn't bet)
Seat 8: Igor DoUrden (small blind) collected ($6.68)
Seat 9: matiko09 (big blind) folded before Flop





PokerStars Hand #148832807311:  Hold'em No Limit ($0.25/$0.50 USD) - 2016/02/15 10:55:40 CET [2016/02/15 4:55:40 ET]
Table 'Eltigen II' 9-max Seat #3 is the button
Seat 1: ljryviltj ($54.53 in chips) 
Seat 2: matiko09 ($56.49 in chips) 
Seat 3: injener ($39.25 in chips) 
Seat 4: beluccix ($51.50 in chips) 
Seat 5: R@/\//\/Y305 ($18.19 in chips) 
Seat 6: Prettyspitz ($50 in chips) 
Seat 9: Deepak.D ($57.85 in chips) 
beluccix: posts small blind $0.25
R@/\//\/Y305: posts big blind $0.50
SerAlGog: sits out 
Aoki42: sits out 
*** HOLE CARDS ***
Dealt to matiko09 [7s 9d]
Prettyspitz: folds 
Deepak.D: raises $0.75 to $1.25
ljryviltj: raises $3.25 to $4.50
matiko09: folds 
injener: raises $11 to $15.50
beluccix: folds 
R@/\//\/Y305: folds 
Deepak.D: folds 
ljryviltj: folds 
Uncalled bet ($11) returned to injener
injener collected $11 from pot
*** SUMMARY ***
Total pot $11 | Rake $0 
Seat 1: ljryviltj folded before Flop
Seat 2: matiko09 folded before Flop (didn't bet)
Seat 3: injener (button) collected ($11)
Seat 4: beluccix (small blind) folded before Flop
Seat 5: R@/\//\/Y305 (big blind) folded before Flop
Seat 6: Prettyspitz folded before Flop (didn't bet)
Seat 9: Deepak.D folded before Flop





PokerStars Hand #148832808201:  Hold'em No Limit ($0.50/$1.00 USD) - 2016/02/15 10:55:42 CET [2016/02/15 4:55:42 ET]
Table 'Gemma II' 9-max Seat #8 is the button
Seat 1: Igor DoUrden ($179.34 in chips) 
Seat 3: Venomous100% ($133.74 in chips) 
Seat 4: mycka86 ($100 in chips) 
Seat 5: PokerSash201 ($66.75 in chips) 
Seat 7: AlKatrone ($119.77 in chips) 
Seat 8: vrnMike ($171.45 in chips) 
Seat 9: matiko09 ($100 in chips) 
matiko09: posts small blind $0.50
Igor DoUrden: posts big blind $1
er13to: sits out 
IHouseMusic: sits out 
*** HOLE CARDS ***
Dealt to matiko09 [5s 6s]
Venomous100%: folds 
mycka86: folds 
PokerSash201 has timed out
PokerSash201: folds 
AlKatrone: folds 
vrnMike: raises $2.50 to $3.50
matiko09: folds 
Igor DoUrden: folds 
Uncalled bet ($2.50) returned to vrnMike
vrnMike collected $2.50 from pot
*** SUMMARY ***
Total pot $2.50 | Rake $0 
Seat 1: Igor DoUrden (big blind) folded before Flop
Seat 3: Venomous100% folded before Flop (didn't bet)
Seat 4: mycka86 folded before Flop (didn't bet)
Seat 5: PokerSash201 folded before Flop (didn't bet)
Seat 7: AlKatrone folded before Flop (didn't bet)
Seat 8: vrnMike (button) collected ($2.50)
Seat 9: matiko09 (small blind) folded before Flop





PokerStars Hand #148832813088:  Hold'em No Limit ($0.50/$1.00 USD) - 2016/02/15 10:55:55 CET [2016/02/15 4:55:55 ET]
Table 'Corvus III' 9-max Seat #9 is the button
Seat 4: goransyruvka ($94.48 in chips) 
Seat 5: koib88 ($231.98 in chips) 
Seat 7: matiko09 ($260.56 in chips) 
Seat 8: redacesfull ($174.80 in chips) 
Seat 9: er13to ($110.08 in chips) 
goransyruvka: posts small blind $0.50
koib88: posts big blind $1
goransyruvka: posts the ante $0.20
koib88: posts the ante $0.20
matiko09: posts the ante $0.20
redacesfull: posts the ante $0.20
er13to: posts the ante $0.20
*** HOLE CARDS ***
Dealt to matiko09 [Ah 6d]
matiko09: folds 
redacesfull: raises $1.12 to $2.12
er13to: calls $2.12
goransyruvka: calls $1.62
koib88: calls $1.12
*** FLOP *** [8c Qc 2d]
goransyruvka: checks 
koib88: checks 
redacesfull: bets $7
er13to: folds 
goransyruvka: folds 
koib88: folds 
Uncalled bet ($7) returned to redacesfull
redacesfull collected $9.05 from pot
redacesfull: doesn't show hand 
*** SUMMARY ***
Total pot $9.48 | Rake $0.43 
Board [8c Qc 2d]
Seat 4: goransyruvka (small blind) folded on the Flop
Seat 5: koib88 (big blind) folded on the Flop
Seat 7: matiko09 folded before Flop (didn't bet)
Seat 8: redacesfull collected ($9.05)
Seat 9: er13to (button) folded on the Flop





PokerStars Hand #148832814056:  Hold'em No Limit (€0.50/€1.00 EUR) - 2016/02/15 10:55:58 CET [2016/02/15 4:55:58 ET]
Table 'Ganesa II' 9-max Seat #5 is the button
Seat 2: maxxmeister (€109.22 in chips) 
Seat 3: BuBu 0187 (€69.19 in chips) 
Seat 4: Sreshta222 (€100 in chips) 
Seat 5: vano7777 (€73.74 in chips) 
Seat 6: matiko09 (€101.39 in chips) 
Seat 7: er13to (€110.03 in chips) 
matiko09: posts small blind €0.50
er13to: posts big blind €1
*** HOLE CARDS ***
Dealt to matiko09 [6h 9d]
maxxmeister: folds 
BuBu 0187: folds 
Sreshta222: folds 
vano7777: raises €1 to €2
matiko09: folds 
er13to: folds 
Uncalled bet (€1) returned to vano7777
vano7777 collected €2.50 from pot
*** SUMMARY ***
Total pot €2.50 | Rake €0 
Seat 2: maxxmeister folded before Flop (didn't bet)
Seat 3: BuBu 0187 folded before Flop (didn't bet)
Seat 4: Sreshta222 folded before Flop (didn't bet)
Seat 5: vano7777 (button) collected (€2.50)
Seat 6: matiko09 (small blind) folded before Flop
Seat 7: er13to (big blind) folded before Flop





PokerStars Hand #148832817627:  Hold'em No Limit ($0.50/$1.00 USD) - 2016/02/15 10:56:07 CET [2016/02/15 4:56:07 ET]
Table 'Ristenpart' 9-max Seat #3 is the button
Seat 1: matiko09 ($100 in chips) 
Seat 3: vrnMike ($100 in chips) 
Seat 4: Priidix ($163.14 in chips) 
Seat 8: SWAYZE999 ($133.83 in chips) 
Priidix: posts small blind $0.50
Venomous100%: is sitting out 
OskarR89: is sitting out 
SWAYZE999: posts big blind $1
OskarR89 leaves the table
er13to: sits out 
AlKatrone: sits out 
*** HOLE CARDS ***
Dealt to matiko09 [3c 7d]
matiko09: folds 
vrnMike: raises $2 to $3
Priidix: folds 
SWAYZE999: folds 
Uncalled bet ($2) returned to vrnMike
vrnMike collected $2.50 from pot
*** SUMMARY ***
Total pot $2.50 | Rake $0 
Seat 1: matiko09 folded before Flop (didn't bet)
Seat 3: vrnMike (button) collected ($2.50)
Seat 4: Priidix (small blind) folded before Flop
Seat 8: SWAYZE999 (big blind) folded before Flop





PokerStars Hand #148832818291:  Hold'em No Limit ($0.50/$1.00 USD) - 2016/02/15 10:56:09 CET [2016/02/15 4:56:09 ET]
Table 'Nata II' 9-max Seat #8 is the button
Seat 6: Arhistrareg ($48.51 in chips) 
Seat 7: er13to ($104.75 in chips) 
Seat 8: Igor DoUrden ($103.68 in chips) 
Seat 9: matiko09 ($100 in chips) 
matiko09: posts small blind $0.50
Arhistrareg: posts big blind $1
*** HOLE CARDS ***
Dealt to matiko09 [8c 4d]
er13to: raises $2 to $3
Igor DoUrden: raises $2 to $5
matiko09: folds 
Arhistrareg: raises $13.50 to $18.50
er13to: folds 
Igor DoUrden: folds 
Uncalled bet ($13.50) returned to Arhistrareg
Arhistrareg collected $13.50 from pot
Arhistrareg: doesn't show hand 
*** SUMMARY ***
Total pot $13.50 | Rake $0 
Seat 6: Arhistrareg (big blind) collected ($13.50)
Seat 7: er13to folded before Flop
Seat 8: Igor DoUrden (button) folded before Flop
Seat 9: matiko09 (small blind) folded before Flop





PokerStars Hand #148832819604:  Hold'em No Limit ($0.50/$1.00 USD) - 2016/02/15 10:56:12 CET [2016/02/15 4:56:12 ET]
Table 'Euanthe II' 9-max Seat #5 is the button
Seat 1: maxxmeister ($130.94 in chips) 
Seat 2: mycka86 ($187.34 in chips) 
Seat 4: er13to ($114.58 in chips) 
Seat 5: vrnMike ($174.48 in chips) 
Seat 6: ChefCatalin ($77 in chips) 
Seat 7: vinniesmol ($218.29 in chips) 
Seat 8: matiko09 ($122.79 in chips) 
Seat 9: Venomous100% ($101.50 in chips) 
ChefCatalin: posts small blind $0.50
vinniesmol: posts big blind $1
Sreshta222: sits out 
*** HOLE CARDS ***
Dealt to matiko09 [4h 8s]
matiko09: folds 
Venomous100%: folds 
maxxmeister: folds 
mycka86: folds 
er13to: folds 
vrnMike: folds 
ChefCatalin: folds 
Uncalled bet ($0.50) returned to vinniesmol
vinniesmol collected $1 from pot
*** SUMMARY ***
Total pot $1 | Rake $0 
Seat 1: maxxmeister folded before Flop (didn't bet)
Seat 2: mycka86 folded before Flop (didn't bet)
Seat 4: er13to folded before Flop (didn't bet)
Seat 5: vrnMike (button) folded before Flop (didn't bet)
Seat 6: ChefCatalin (small blind) folded before Flop
Seat 7: vinniesmol (big blind) collected ($1)
Seat 8: matiko09 folded before Flop (didn't bet)
Seat 9: Venomous100% folded before Flop (didn't bet)





PokerStars Hand #148832822179:  Hold'em No Limit (€0.25/€0.50 EUR) - 2016/02/15 10:56:19 CET [2016/02/15 4:56:19 ET]
Table 'Walinskia II' 9-max Seat #1 is the button
Seat 1: ljryviltj (€50 in chips) 
Seat 2: yats87 (€56.70 in chips) 
Seat 3: beluccix (€27.14 in chips) 
Seat 4: Otsime (€52.36 in chips) 
Seat 5: vano7777 (€63.54 in chips) 
Seat 8: matiko09 (€53.41 in chips) 
Seat 9: Ahangama (€50 in chips) 
yats87: posts small blind €0.25
beluccix: posts big blind €0.50
etny99: sits out 
*** HOLE CARDS ***
Dealt to matiko09 [9h 6c]
Otsime: calls €0.50
vano7777: folds 
matiko09: folds 
Ahangama: raises €1.50 to €2
ljryviltj: folds 
yats87: folds 
beluccix: folds 
Otsime: calls €1.50
*** FLOP *** [8h 5h 4d]
Otsime: checks 
Ahangama: bets €3.50
Otsime: folds 
Uncalled bet (€3.50) returned to Ahangama
Ahangama collected €4.54 from pot
Ahangama: doesn't show hand 
*** SUMMARY ***
Total pot €4.75 | Rake €0.21 
Board [8h 5h 4d]
Seat 1: ljryviltj (button) folded before Flop (didn't bet)
Seat 2: yats87 (small blind) folded before Flop
Seat 3: beluccix (big blind) folded before Flop
Seat 4: Otsime folded on the Flop
Seat 5: vano7777 folded before Flop (didn't bet)
Seat 8: matiko09 folded before Flop (didn't bet)
Seat 9: Ahangama collected (€4.54)





PokerStars Hand #148832822795:  Hold'em No Limit ($0.50/$1.00 USD) - 2016/02/15 10:56:21 CET [2016/02/15 4:56:21 ET]
Table 'Anteros' 9-max Seat #9 is the button
Seat 2: IHouseMusic ($113.06 in chips) 
Seat 4: misherei ($199.44 in chips) 
Seat 5: Holm1991 ($75.48 in chips) 
Seat 6: SerAlGog ($112.63 in chips) 
Seat 7: Zoubou1983 ($158.54 in chips) 
Seat 8: matiko09 ($100 in chips) 
Seat 9: vrnMike ($100 in chips) 
redacesfull will be allowed to play after the button
IHouseMusic: posts small blind $0.50
fanmtZ: is sitting out 
fanmtZ leaves the table
misherei: posts big blind $1
*** HOLE CARDS ***
Dealt to matiko09 [5d Ad]
Holm1991: folds 
SerAlGog: folds 
AlKatrone joins the table at seat #3 
Zoubou1983: folds 
AlKatrone leaves the table
matiko09: raises $1.50 to $2.50
er13to joins the table at seat #3 
vrnMike: calls $2.50
IHouseMusic: folds 
misherei: calls $1.50
*** FLOP *** [7c 3d 6s]
misherei: checks 
matiko09: bets $4.97
vrnMike: folds 
misherei: folds 
Uncalled bet ($4.97) returned to matiko09
matiko09 collected $7.64 from pot
matiko09: doesn't show hand 
*** SUMMARY ***
Total pot $8 | Rake $0.36 
Board [7c 3d 6s]
Seat 2: IHouseMusic (small blind) folded before Flop
Seat 4: misherei (big blind) folded on the Flop
Seat 5: Holm1991 folded before Flop (didn't bet)
Seat 6: SerAlGog folded before Flop (didn't bet)
Seat 7: Zoubou1983 folded before Flop (didn't bet)
Seat 8: matiko09 collected ($7.64)
Seat 9: vrnMike (button) folded on the Flop





PokerStars Hand #148832825167:  Hold'em No Limit ($0.50/$1.00 USD) - 2016/02/15 10:56:27 CET [2016/02/15 4:56:27 ET]
Table 'Ristenpart' 9-max Seat #4 is the button
Seat 1: matiko09 ($100 in chips) 
Seat 3: vrnMike ($101.50 in chips) 
Seat 4: Priidix ($162.64 in chips) 
Seat 8: SWAYZE999 ($132.83 in chips) 
Seat 9: er13to ($100 in chips) 
SWAYZE999: posts small blind $0.50
er13to: posts big blind $1
AlKatrone: sits out 
*** HOLE CARDS ***
Dealt to matiko09 [8d 4s]
matiko09: folds 
vrnMike: folds 
Priidix: raises $1.60 to $2.60
SWAYZE999: folds 
er13to: calls $1.60
*** FLOP *** [Ks 4d Tc]
er13to: checks 
Priidix: checks 
*** TURN *** [Ks 4d Tc] [9c]
er13to: checks 
Priidix: bets $4.08
er13to: calls $4.08
*** RIVER *** [Ks 4d Tc 9c] [8h]
er13to: checks 
Priidix: checks 
*** SHOW DOWN ***
er13to: shows [Ts Jd] (a pair of Tens)
Priidix: shows [Td Qs] (a pair of Tens - King+Queen kicker)
Priidix collected $13.24 from pot
*** SUMMARY ***
Total pot $13.86 | Rake $0.62 
Board [Ks 4d Tc 9c 8h]
Seat 1: matiko09 folded before Flop (didn't bet)
Seat 3: vrnMike folded before Flop (didn't bet)
Seat 4: Priidix (button) showed [Td Qs] and won ($13.24) with a pair of Tens
Seat 8: SWAYZE999 (small blind) folded before Flop
Seat 9: er13to (big blind) showed [Ts Jd] and lost with a pair of Tens





PokerStars Hand #148832826365:  Hold'em No Limit (€0.50/€1.00 EUR) - 2016/02/15 10:56:30 CET [2016/02/15 4:56:30 ET]
Table 'Ganesa II' 9-max Seat #6 is the button
Seat 2: maxxmeister (€109.22 in chips) 
Seat 3: BuBu 0187 (€69.19 in chips) 
Seat 4: Sreshta222 (€100 in chips) 
Seat 5: vano7777 (€75.24 in chips) 
Seat 6: matiko09 (€100.89 in chips) 
Seat 7: er13to (€109.03 in chips) 
er13to: posts small blind €0.50
maxxmeister: posts big blind €1
*** HOLE CARDS ***
Dealt to matiko09 [2h 7c]
BuBu 0187: calls €1
Sreshta222: folds 
vano7777: folds 
matiko09: folds 
er13to: folds 
maxxmeister: checks 
*** FLOP *** [Ad 8c 2d]
maxxmeister: checks 
BuBu 0187: checks 
*** TURN *** [Ad 8c 2d] [5c]
maxxmeister: checks 
BuBu 0187: checks 
*** RIVER *** [Ad 8c 2d 5c] [3s]
maxxmeister: bets €2.39
BuBu 0187: folds 
Uncalled bet (€2.39) returned to maxxmeister
maxxmeister collected €2.39 from pot
maxxmeister: doesn't show hand 
*** SUMMARY ***
Total pot €2.50 | Rake €0.11 
Board [Ad 8c 2d 5c 3s]
Seat 2: maxxmeister (big blind) collected (€2.39)
Seat 3: BuBu 0187 folded on the River
Seat 4: Sreshta222 folded before Flop (didn't bet)
Seat 5: vano7777 folded before Flop (didn't bet)
Seat 6: matiko09 (button) folded before Flop (didn't bet)
Seat 7: er13to (small blind) folded before Flop





PokerStars Hand #148832826781:  Hold'em No Limit ($0.50/$1.00 USD) - 2016/02/15 10:56:31 CET [2016/02/15 4:56:31 ET]
Table 'Corvus III' 9-max Seat #4 is the button
Seat 4: goransyruvka ($92.16 in chips) 
Seat 5: koib88 ($229.66 in chips) 
Seat 7: matiko09 ($260.36 in chips) 
Seat 8: redacesfull ($181.53 in chips) 
Seat 9: er13to ($107.76 in chips) 
koib88: posts small blind $0.50
matiko09: posts big blind $1
goransyruvka: posts the ante $0.20
koib88: posts the ante $0.20
matiko09: posts the ante $0.20
redacesfull: posts the ante $0.20
er13to: posts the ante $0.20
*** HOLE CARDS ***
Dealt to matiko09 [Qh 3d]
redacesfull: folds 
er13to: folds 
goransyruvka: calls $1
koib88: calls $0.50
matiko09: checks 
*** FLOP *** [2s Jc Jh]
koib88: checks 
matiko09: checks 
goransyruvka: bets $3.82
koib88: raises $5.98 to $9.80
matiko09: folds 
goransyruvka: folds 
Uncalled bet ($5.98) returned to koib88
koib88 collected $11.12 from pot
koib88: doesn't show hand 
*** SUMMARY ***
Total pot $11.64 | Rake $0.52 
Board [2s Jc Jh]
Seat 4: goransyruvka (button) folded on the Flop
Seat 5: koib88 (small blind) collected ($11.12)
Seat 7: matiko09 (big blind) folded on the Flop
Seat 8: redacesfull folded before Flop (didn't bet)
Seat 9: er13to folded before Flop (didn't bet)





PokerStars Hand #148832827780:  Hold'em No Limit ($0.50/$1.00 USD) - 2016/02/15 10:56:34 CET [2016/02/15 4:56:34 ET]
Table 'Gemma II' 9-max Seat #9 is the button
Seat 1: Igor DoUrden ($178.34 in chips) 
Seat 2: er13to ($100 in chips) 
Seat 3: Venomous100% ($133.74 in chips) 
Seat 4: mycka86 ($100 in chips) 
Seat 7: AlKatrone ($119.77 in chips) 
Seat 8: vrnMike ($172.95 in chips) 
Seat 9: matiko09 ($100 in chips) 
Igor DoUrden: posts small blind $0.50
er13to: posts big blind $1
IHouseMusic: sits out 
*** HOLE CARDS ***
Dealt to matiko09 [5h 6s]
Venomous100%: folds 
mycka86: folds 
AlKatrone: folds 
vrnMike: raises $2 to $3
matiko09: folds 
Igor DoUrden: folds 
er13to: calls $2
*** FLOP *** [6d 9c 4c]
er13to: checks 
vrnMike: bets $5
er13to: calls $5
*** TURN *** [6d 9c 4c] [Ad]
er13to: checks 
vrnMike: bets $12
er13to: calls $12
*** RIVER *** [6d 9c 4c Ad] [4d]
er13to: checks 
vrnMike: checks 
*** SHOW DOWN ***
er13to: shows [Ac Jc] (two pair, Aces and Fours)
vrnMike: mucks hand 
er13to collected $38.68 from pot
*** SUMMARY ***
Total pot $40.50 | Rake $1.82 
Board [6d 9c 4c Ad 4d]
Seat 1: Igor DoUrden (small blind) folded before Flop
Seat 2: er13to (big blind) showed [Ac Jc] and won ($38.68) with two pair, Aces and Fours
Seat 3: Venomous100% folded before Flop (didn't bet)
Seat 4: mycka86 folded before Flop (didn't bet)
Seat 7: AlKatrone folded before Flop (didn't bet)
Seat 8: vrnMike mucked [Jd Jh]
Seat 9: matiko09 (button) folded before Flop (didn't bet)





PokerStars Hand #148832828384:  Hold'em No Limit ($0.25/$0.50 USD) - 2016/02/15 10:56:35 CET [2016/02/15 4:56:35 ET]
Table 'Vesta II' 9-max Seat #1 is the button
Seat 1: Ahangama ($98 in chips) 
Seat 2: i L00K great ($54.87 in chips) 
Seat 3: matiko09 ($77.20 in chips) 
Seat 4: HJdream ($48.50 in chips) 
Seat 5: dndngod ($76.90 in chips) 
Seat 8: Arystan ($66.94 in chips) 
Seat 9: Aoki42 ($73.51 in chips) 
i L00K great: posts small blind $0.25
matiko09: posts big blind $0.50
ruyingren: sits out 
*** HOLE CARDS ***
Dealt to matiko09 [Th 5d]
HJdream: folds 
dndngod: raises $1 to $1.50
Arystan: folds 
Aoki42: folds 
Ahangama: folds 
i L00K great: folds 
matiko09: folds 
Uncalled bet ($1) returned to dndngod
dndngod collected $1.25 from pot
dndngod: doesn't show hand 
*** SUMMARY ***
Total pot $1.25 | Rake $0 
Seat 1: Ahangama (button) folded before Flop (didn't bet)
Seat 2: i L00K great (small blind) folded before Flop
Seat 3: matiko09 (big blind) folded before Flop
Seat 4: HJdream folded before Flop (didn't bet)
Seat 5: dndngod collected ($1.25)
Seat 8: Arystan folded before Flop (didn't bet)
Seat 9: Aoki42 folded before Flop (didn't bet)





PokerStars Hand #148832829529:  Hold'em No Limit ($0.25/$0.50 USD) - 2016/02/15 10:56:38 CET [2016/02/15 4:56:38 ET]
Table 'Eltigen II' 9-max Seat #4 is the button
Seat 1: ljryviltj ($50.03 in chips) 
Seat 2: matiko09 ($56.49 in chips) 
Seat 3: injener ($45.75 in chips) 
Seat 4: beluccix ($51.25 in chips) 
Seat 5: R@/\//\/Y305 ($17.69 in chips) 
Seat 6: Prettyspitz ($50 in chips) 
Seat 9: Deepak.D ($56.60 in chips) 
R@/\//\/Y305: posts small blind $0.25
Prettyspitz: posts big blind $0.50
SerAlGog: sits out 
Aoki42: sits out 
*** HOLE CARDS ***
Dealt to matiko09 [2h 6s]
Deepak.D: folds 
ljryviltj: raises $1 to $1.50
matiko09: folds 
injener: folds 
beluccix: folds 
R@/\//\/Y305: calls $1.25
Prettyspitz: calls $1
*** FLOP *** [Th 8s 3c]
R@/\//\/Y305: checks 
Prettyspitz: checks 
ljryviltj: bets $3
R@/\//\/Y305: folds 
Prettyspitz: folds 
Uncalled bet ($3) returned to ljryviltj
ljryviltj collected $4.30 from pot
ljryviltj: doesn't show hand 
*** SUMMARY ***
Total pot $4.50 | Rake $0.20 
Board [Th 8s 3c]
Seat 1: ljryviltj collected ($4.30)
Seat 2: matiko09 folded before Flop (didn't bet)
Seat 3: injener folded before Flop (didn't bet)
Seat 4: beluccix (button) folded before Flop (didn't bet)
Seat 5: R@/\//\/Y305 (small blind) folded on the Flop
Seat 6: Prettyspitz (big blind) folded on the Flop
Seat 9: Deepak.D folded before Flop (didn't bet)





PokerStars Hand #148832831854:  Hold'em No Limit ($0.50/$1.00 USD) - 2016/02/15 10:56:44 CET [2016/02/15 4:56:44 ET]
Table 'Euanthe II' 9-max Seat #6 is the button
Seat 1: maxxmeister ($130.94 in chips) 
Seat 2: mycka86 ($187.34 in chips) 
Seat 4: er13to ($114.58 in chips) 
Seat 5: vrnMike ($174.48 in chips) 
Seat 6: ChefCatalin ($76.50 in chips) 
Seat 7: vinniesmol ($218.79 in chips) 
Seat 8: matiko09 ($122.79 in chips) 
Seat 9: Venomous100% ($101.50 in chips) 
vinniesmol: posts small blind $0.50
matiko09: posts big blind $1
Sreshta222: sits out 
*** HOLE CARDS ***
Dealt to matiko09 [7d 7c]
Venomous100%: folds 
maxxmeister: folds 
mycka86: folds 
er13to: folds 
vrnMike: folds 
ChefCatalin: calls $1
vinniesmol: folds 
matiko09: raises $4 to $5
ChefCatalin: folds 
Uncalled bet ($4) returned to matiko09
matiko09 collected $2.50 from pot
matiko09: doesn't show hand 
*** SUMMARY ***
Total pot $2.50 | Rake $0 
Seat 1: maxxmeister folded before Flop (didn't bet)
Seat 2: mycka86 folded before Flop (didn't bet)
Seat 4: er13to folded before Flop (didn't bet)
Seat 5: vrnMike folded before Flop (didn't bet)
Seat 6: ChefCatalin (button) folded before Flop
Seat 7: vinniesmol (small blind) folded before Flop
Seat 8: matiko09 (big blind) collected ($2.50)
Seat 9: Venomous100% folded before Flop (didn't bet)





PokerStars Hand #148832838185:  Hold'em No Limit ($0.25/$0.50 USD) - 2016/02/15 10:57:01 CET [2016/02/15 4:57:01 ET]
Table 'Laertes II' 9-max Seat #4 is the button
Seat 2: beluccix ($24.21 in chips) 
Seat 3: ljryviltj ($57.98 in chips) 
Seat 4: rgar93 ($40.63 in chips) 
Seat 5: vlad11122007 ($50 in chips) 
Seat 6: yats87 ($58.55 in chips) 
Seat 8: Trent444 ($42.73 in chips) 
Seat 9: matiko09 ($50 in chips) 
vlad11122007: posts small blind $0.25
yats87: posts big blind $0.50
Vedpapa: sits out 
*** HOLE CARDS ***
Dealt to matiko09 [3h 7s]
Trent444: folds 
matiko09: folds 
beluccix: folds 
ljryviltj: raises $0.61 to $1.11
rgar93: folds 
vlad11122007: folds 
yats87: calls $0.61
*** FLOP *** [Js 8c Jh]
yats87: checks 
ljryviltj: bets $1.50
yats87: raises $2.50 to $4
ljryviltj: folds 
Uncalled bet ($2.50) returned to yats87
yats87 collected $5.22 from pot
yats87: doesn't show hand 
*** SUMMARY ***
Total pot $5.47 | Rake $0.25 
Board [Js 8c Jh]
Seat 2: beluccix folded before Flop (didn't bet)
Seat 3: ljryviltj folded on the Flop
Seat 4: rgar93 (button) folded before Flop (didn't bet)
Seat 5: vlad11122007 (small blind) folded before Flop
Seat 6: yats87 (big blind) collected ($5.22)
Seat 8: Trent444 folded before Flop (didn't bet)
Seat 9: matiko09 folded before Flop (didn't bet)





PokerStars Hand #148832840229:  Hold'em No Limit (€0.25/€0.50 EUR) - 2016/02/15 10:57:06 CET [2016/02/15 4:57:06 ET]
Table 'Walinskia II' 9-max Seat #2 is the button
Seat 1: ljryviltj (€50 in chips) 
Seat 2: yats87 (€56.45 in chips) 
Seat 3: beluccix (€26.64 in chips) 
Seat 4: Otsime (€50.36 in chips) 
Seat 5: vano7777 (€63.54 in chips) 
Seat 8: matiko09 (€53.41 in chips) 
Seat 9: Ahangama (€52.54 in chips) 
beluccix: posts small blind €0.25
Otsime: posts big blind €0.50
50CandyJoe: sits out 
etny99: sits out 
*** HOLE CARDS ***
Dealt to matiko09 [Ad Th]
vano7777: folds 
matiko09: raises €1 to €1.50
Ahangama: folds 
ljryviltj: folds 
yats87: folds 
beluccix: folds 
Otsime: calls €1
*** FLOP *** [6s Jc Qd]
Otsime: checks 
matiko09: bets €1.61
Otsime: folds 
Uncalled bet (€1.61) returned to matiko09
matiko09 collected €3.10 from pot
matiko09: doesn't show hand 
*** SUMMARY ***
Total pot €3.25 | Rake €0.15 
Board [6s Jc Qd]
Seat 1: ljryviltj folded before Flop (didn't bet)
Seat 2: yats87 (button) folded before Flop (didn't bet)
Seat 3: beluccix (small blind) folded before Flop
Seat 4: Otsime (big blind) folded on the Flop
Seat 5: vano7777 folded before Flop (didn't bet)
Seat 8: matiko09 collected (€3.10)
Seat 9: Ahangama folded before Flop (didn't bet)





PokerStars Hand #148832840657:  Hold'em No Limit ($0.50/$1.00 USD) - 2016/02/15 10:57:07 CET [2016/02/15 4:57:07 ET]
Table 'Nata II' 9-max Seat #9 is the button
Seat 6: Arhistrareg ($57.01 in chips) 
Seat 7: er13to ($101.75 in chips) 
Seat 8: Igor DoUrden ($100 in chips) 
Seat 9: matiko09 ($100 in chips) 
Arhistrareg: posts small blind $0.50
er13to: posts big blind $1
*** HOLE CARDS ***
Dealt to matiko09 [3d Ah]
Igor DoUrden: folds 
matiko09: raises $1.27 to $2.27
Arhistrareg: calls $1.77
er13to: calls $1.27
*** FLOP *** [6d 3h 5c]
Arhistrareg: checks 
er13to: checks 
matiko09: checks 
*** TURN *** [6d 3h 5c] [4d]
Arhistrareg: checks 
er13to: checks 
matiko09: checks 
*** RIVER *** [6d 3h 5c 4d] [Kd]
Arhistrareg: checks 
er13to: bets $3
matiko09: folds 
Arhistrareg: folds 
Uncalled bet ($3) returned to er13to
er13to collected $6.50 from pot
*** SUMMARY ***
Total pot $6.81 | Rake $0.31 
Board [6d 3h 5c 4d Kd]
Seat 6: Arhistrareg (small blind) folded on the River
Seat 7: er13to (big blind) collected ($6.50)
Seat 8: Igor DoUrden folded before Flop (didn't bet)
Seat 9: matiko09 (button) folded on the River





PokerStars Hand #148832840790:  Hold'em No Limit ($0.25/$0.50 USD) - 2016/02/15 10:57:08 CET [2016/02/15 4:57:08 ET]
Table 'Vesta II' 9-max Seat #2 is the button
Seat 1: Ahangama ($98 in chips) 
Seat 2: i L00K great ($54.62 in chips) 
Seat 3: matiko09 ($76.70 in chips) 
Seat 5: dndngod ($77.65 in chips) 
Seat 8: Arystan ($66.94 in chips) 
Seat 9: Aoki42 ($73.51 in chips) 
matiko09: posts small blind $0.25
HJdream: is sitting out 
dndngod: posts big blind $0.50
ruyingren: sits out 
*** HOLE CARDS ***
Dealt to matiko09 [As 5c]
Arystan: folds 
Aoki42: raises $1 to $1.50
Ahangama: folds 
HJdream leaves the table
i L00K great: folds 
vlad11122007 joins the table at seat #4 
matiko09: folds 
dndngod: folds 
Uncalled bet ($1) returned to Aoki42
Aoki42 collected $1.25 from pot
Aoki42: doesn't show hand 
*** SUMMARY ***
Total pot $1.25 | Rake $0 
Seat 1: Ahangama folded before Flop (didn't bet)
Seat 2: i L00K great (button) folded before Flop (didn't bet)
Seat 3: matiko09 (small blind) folded before Flop
Seat 5: dndngod (big blind) folded before Flop
Seat 8: Arystan folded before Flop (didn't bet)
Seat 9: Aoki42 collected ($1.25)





PokerStars Hand #148832841317:  Hold'em No Limit ($0.50/$1.00 USD) - 2016/02/15 10:57:09 CET [2016/02/15 4:57:09 ET]
Table 'Corvus III' 9-max Seat #5 is the button
Seat 4: goransyruvka ($87.14 in chips) 
Seat 5: koib88 ($235.76 in chips) 
Seat 7: matiko09 ($259.16 in chips) 
Seat 8: redacesfull ($181.33 in chips) 
Seat 9: er13to ($107.56 in chips) 
matiko09: posts small blind $0.50
redacesfull: posts big blind $1
goransyruvka: posts the ante $0.20
koib88: posts the ante $0.20
matiko09: posts the ante $0.20
redacesfull: posts the ante $0.20
er13to: posts the ante $0.20
*** HOLE CARDS ***
Dealt to matiko09 [Ah 3c]
er13to: folds 
goransyruvka: calls $1
koib88: raises $5 to $6
matiko09: folds 
redacesfull: folds 
goransyruvka: calls $5
*** FLOP *** [2s 4s 4h]
goransyruvka: checks 
koib88: bets $8
goransyruvka: folds 
Uncalled bet ($8) returned to koib88
koib88 collected $13.85 from pot
koib88: doesn't show hand 
*** SUMMARY ***
Total pot $14.50 | Rake $0.65 
Board [2s 4s 4h]
Seat 4: goransyruvka folded on the Flop
Seat 5: koib88 (button) collected ($13.85)
Seat 7: matiko09 (small blind) folded before Flop
Seat 8: redacesfull (big blind) folded before Flop
Seat 9: er13to folded before Flop (didn't bet)





PokerStars Hand #148832845085:  Hold'em No Limit (€0.50/€1.00 EUR) - 2016/02/15 10:57:19 CET [2016/02/15 4:57:19 ET]
Table 'Ganesa II' 9-max Seat #7 is the button
Seat 2: maxxmeister (€110.61 in chips) 
Seat 3: BuBu 0187 (€68.19 in chips) 
Seat 4: Sreshta222 (€100 in chips) 
Seat 5: vano7777 (€75.24 in chips) 
Seat 6: matiko09 (€100.89 in chips) 
Seat 7: er13to (€108.53 in chips) 
maxxmeister: posts small blind €0.50
BuBu 0187: posts big blind €1
*** HOLE CARDS ***
Dealt to matiko09 [4c Ks]
Sreshta222: folds 
vano7777: folds 
matiko09: folds 
er13to: folds 
maxxmeister: raises €2 to €3
BuBu 0187: calls €2
*** FLOP *** [8h Th Jd]
maxxmeister: checks 
BuBu 0187: bets €2
mycka86 joins the table at seat #8 
maxxmeister: calls €2
*** TURN *** [8h Th Jd] [2s]
maxxmeister: checks 
BuBu 0187: bets €3
maxxmeister: calls €3
*** RIVER *** [8h Th Jd 2s] [5d]
maxxmeister: checks 
BuBu 0187: bets €12
maxxmeister: folds 
Uncalled bet (€12) returned to BuBu 0187
BuBu 0187 collected €15.28 from pot
BuBu 0187: doesn't show hand 
*** SUMMARY ***
Total pot €16 | Rake €0.72 
Board [8h Th Jd 2s 5d]
Seat 2: maxxmeister (small blind) folded on the River
Seat 3: BuBu 0187 (big blind) collected (€15.28)
Seat 4: Sreshta222 folded before Flop (didn't bet)
Seat 5: vano7777 folded before Flop (didn't bet)
Seat 6: matiko09 folded before Flop (didn't bet)
Seat 7: er13to (button) folded before Flop (didn't bet)





PokerStars Hand #148832846631:  Hold'em No Limit ($0.50/$1.00 USD) - 2016/02/15 10:57:23 CET [2016/02/15 4:57:23 ET]
Table 'Gemma II' 9-max Seat #1 is the button
Seat 1: Igor DoUrden ($177.84 in chips) 
Seat 2: er13to ($118.68 in chips) 
Seat 3: Venomous100% ($133.74 in chips) 
Seat 4: mycka86 ($100 in chips) 
Seat 5: PokerSash201 ($66.75 in chips) 
Seat 7: AlKatrone ($119.77 in chips) 
Seat 8: vrnMike ($152.95 in chips) 
Seat 9: matiko09 ($100 in chips) 
er13to: posts small blind $0.50
Venomous100%: posts big blind $1
IHouseMusic: sits out 
*** HOLE CARDS ***
Dealt to matiko09 [5d 3s]
mycka86: folds 
PokerSash201: folds 
AlKatrone: raises $2 to $3
vrnMike: raises $6 to $9
matiko09: folds 
Igor DoUrden: folds 
er13to: folds 
Venomous100%: folds 
AlKatrone: folds 
Uncalled bet ($6) returned to vrnMike
vrnMike collected $7.50 from pot
*** SUMMARY ***
Total pot $7.50 | Rake $0 
Seat 1: Igor DoUrden (button) folded before Flop (didn't bet)
Seat 2: er13to (small blind) folded before Flop
Seat 3: Venomous100% (big blind) folded before Flop
Seat 4: mycka86 folded before Flop (didn't bet)
Seat 5: PokerSash201 folded before Flop (didn't bet)
Seat 7: AlKatrone folded before Flop
Seat 8: vrnMike collected ($7.50)
Seat 9: matiko09 folded before Flop (didn't bet)





PokerStars Hand #148832847106:  Hold'em No Limit ($0.25/$0.50 USD) - 2016/02/15 10:57:24 CET [2016/02/15 4:57:24 ET]
Table 'Vesta II' 9-max Seat #3 is the button
Seat 1: Ahangama ($98 in chips) 
Seat 2: i L00K great ($54.62 in chips) 
Seat 3: matiko09 ($76.45 in chips) 
Seat 5: dndngod ($77.15 in chips) 
Seat 7: ruyingren ($35.04 in chips) 
Seat 8: Arystan ($66.94 in chips) 
Seat 9: Aoki42 ($74.26 in chips) 
vlad11122007 will be allowed to play after the button
dndngod: posts small blind $0.25
ruyingren: posts big blind $0.50
*** HOLE CARDS ***
Dealt to matiko09 [Kd 6h]
Arystan: raises $1 to $1.50
Aoki42: folds 
Ahangama: raises $3 to $4.50
i L00K great: folds 
matiko09: folds 
dndngod: folds 
ruyingren: calls $4
Arystan: calls $3
*** FLOP *** [9h 5d Qc]
ruyingren: bets $5.50
Arystan: calls $5.50
Ahangama: calls $5.50
*** TURN *** [9h 5d Qc] [4d]
ruyingren: checks 
Arystan: bets $14.44
Ahangama: folds 
ruyingren: folds 
Uncalled bet ($14.44) returned to Arystan
Arystan collected $28.89 from pot
Arystan: doesn't show hand 
*** SUMMARY ***
Total pot $30.25 | Rake $1.36 
Board [9h 5d Qc 4d]
Seat 1: Ahangama folded on the Turn
Seat 2: i L00K great folded before Flop (didn't bet)
Seat 3: matiko09 (button) folded before Flop (didn't bet)
Seat 5: dndngod (small blind) folded before Flop
Seat 7: ruyingren (big blind) folded on the Turn
Seat 8: Arystan collected ($28.89)
Seat 9: Aoki42 folded before Flop (didn't bet)





PokerStars Hand #148832853980:  Hold'em No Limit ($0.50/$1.00 USD) - 2016/02/15 10:57:42 CET [2016/02/15 4:57:42 ET]
Table 'Anteros' 9-max Seat #2 is the button
Seat 2: IHouseMusic ($112.56 in chips) 
Seat 4: misherei ($196.94 in chips) 
Seat 5: Holm1991 ($75.48 in chips) 
Seat 6: SerAlGog ($112.63 in chips) 
Seat 7: Zoubou1983 ($158.54 in chips) 
Seat 8: matiko09 ($105.14 in chips) 
Seat 9: vrnMike ($100 in chips) 
er13to will be allowed to play after the button
misherei: posts small blind $0.50
Holm1991: posts big blind $1
redacesfull: sits out 
*** HOLE CARDS ***
Dealt to matiko09 [2d Js]
SerAlGog: raises $2 to $3
Zoubou1983: folds 
matiko09: folds 
vrnMike: folds 
IHouseMusic: folds 
misherei: folds 
Holm1991: folds 
Uncalled bet ($2) returned to SerAlGog
SerAlGog collected $2.50 from pot
SerAlGog: doesn't show hand 
*** SUMMARY ***
Total pot $2.50 | Rake $0 
Seat 2: IHouseMusic (button) folded before Flop (didn't bet)
Seat 4: misherei (small blind) folded before Flop
Seat 5: Holm1991 (big blind) folded before Flop
Seat 6: SerAlGog collected ($2.50)
Seat 7: Zoubou1983 folded before Flop (didn't bet)
Seat 8: matiko09 folded before Flop (didn't bet)
Seat 9: vrnMike folded before Flop (didn't bet)





PokerStars Hand #148832854965:  Hold'em No Limit ($0.25/$0.50 USD) - 2016/02/15 10:57:44 CET [2016/02/15 4:57:44 ET]
Table 'Eltigen II' 9-max Seat #5 is the button
Seat 1: ljryviltj ($52.83 in chips) 
Seat 2: matiko09 ($56.49 in chips) 
Seat 3: injener ($45.75 in chips) 
Seat 4: beluccix ($51.25 in chips) 
Seat 5: R@/\//\/Y305 ($16.19 in chips) 
Seat 6: Prettyspitz ($50 in chips) 
Seat 7: SerAlGog ($50 in chips) 
Seat 9: Deepak.D ($56.60 in chips) 
Prettyspitz: posts small blind $0.25
SerAlGog: posts big blind $0.50
Aoki42: sits out 
*** HOLE CARDS ***
Dealt to matiko09 [2d 3c]
Deepak.D: folds 
ljryviltj: folds 
matiko09: folds 
injener: raises $1 to $1.50
beluccix: folds 
R@/\//\/Y305: calls $1.50
Prettyspitz: folds 
SerAlGog: folds 
*** FLOP *** [Td 8h 4h]
injener: bets $3.58
R@/\//\/Y305: calls $3.58
*** TURN *** [Td 8h 4h] [2h]
injener: bets $10.42
R@/\//\/Y305: folds 
Uncalled bet ($10.42) returned to injener
injener collected $10.42 from pot
*** SUMMARY ***
Total pot $10.91 | Rake $0.49 
Board [Td 8h 4h 2h]
Seat 1: ljryviltj folded before Flop (didn't bet)
Seat 2: matiko09 folded before Flop (didn't bet)
Seat 3: injener collected ($10.42)
Seat 4: beluccix folded before Flop (didn't bet)
Seat 5: R@/\//\/Y305 (button) folded on the Turn
Seat 6: Prettyspitz (small blind) folded before Flop
Seat 7: SerAlGog (big blind) folded before Flop
Seat 9: Deepak.D folded before Flop (didn't bet)





PokerStars Hand #148832856047:  Hold'em No Limit (€0.25/€0.50 EUR) - 2016/02/15 10:57:47 CET [2016/02/15 4:57:47 ET]
Table 'Walinskia II' 9-max Seat #3 is the button
Seat 1: ljryviltj (€50 in chips) 
Seat 2: yats87 (€56.45 in chips) 
Seat 3: beluccix (€26.39 in chips) 
Seat 4: Otsime (€48.86 in chips) 
Seat 5: vano7777 (€63.54 in chips) 
Seat 8: matiko09 (€55.01 in chips) 
Seat 9: Ahangama (€52.54 in chips) 
Otsime: posts small blind €0.25
vano7777: posts big blind €0.50
50CandyJoe: sits out 
etny99: sits out 
*** HOLE CARDS ***
Dealt to matiko09 [6c 4c]
matiko09: folds 
Ahangama: folds 
ljryviltj: raises €1 to €1.50
yats87: folds 
beluccix: folds 
Otsime: calls €1.25
vano7777: folds 
*** FLOP *** [Qh Qd Ad]
Otsime: checks 
ljryviltj: bets €2.50
Otsime: folds 
Uncalled bet (€2.50) returned to ljryviltj
ljryviltj collected €3.34 from pot
ljryviltj: doesn't show hand 
*** SUMMARY ***
Total pot €3.50 | Rake €0.16 
Board [Qh Qd Ad]
Seat 1: ljryviltj collected (€3.34)
Seat 2: yats87 folded before Flop (didn't bet)
Seat 3: beluccix (button) folded before Flop (didn't bet)
Seat 4: Otsime (small blind) folded on the Flop
Seat 5: vano7777 (big blind) folded before Flop
Seat 8: matiko09 folded before Flop (didn't bet)
Seat 9: Ahangama folded before Flop (didn't bet)





PokerStars Hand #148832858425:  Hold'em No Limit ($0.50/$1.00 USD) - 2016/02/15 10:57:53 CET [2016/02/15 4:57:53 ET]
Table 'Ristenpart' 9-max Seat #8 is the button
Seat 1: matiko09 ($100 in chips) 
Seat 3: vrnMike ($101.50 in chips) 
Seat 4: Priidix ($169.20 in chips) 
Seat 8: SWAYZE999 ($132.33 in chips) 
Seat 9: er13to ($100 in chips) 
er13to: posts small blind $0.50
matiko09: posts big blind $1
AlKatrone: sits out 
*** HOLE CARDS ***
Dealt to matiko09 [Ad Td]
vrnMike: raises $2 to $3
Priidix: folds 
SWAYZE999: folds 
er13to: folds 
matiko09: raises $7 to $10
vrnMike: calls $7
*** FLOP *** [5s 7c Js]
matiko09: checks 
vrnMike: bets $10
matiko09: folds 
Uncalled bet ($10) returned to vrnMike
vrnMike collected $19.58 from pot
*** SUMMARY ***
Total pot $20.50 | Rake $0.92 
Board [5s 7c Js]
Seat 1: matiko09 (big blind) folded on the Flop
Seat 3: vrnMike collected ($19.58)
Seat 4: Priidix folded before Flop (didn't bet)
Seat 8: SWAYZE999 (button) folded before Flop (didn't bet)
Seat 9: er13to (small blind) folded before Flop





PokerStars Hand #148832859097:  Hold'em No Limit ($0.50/$1.00 USD) - 2016/02/15 10:57:55 CET [2016/02/15 4:57:55 ET]
Table 'Nata II' 9-max Seat #6 is the button
Seat 6: Arhistrareg ($54.74 in chips) 
Seat 7: er13to ($105.98 in chips) 
Seat 8: Igor DoUrden ($100 in chips) 
Seat 9: matiko09 ($100 in chips) 
er13to: posts small blind $0.50
Igor DoUrden: posts big blind $1
*** HOLE CARDS ***
Dealt to matiko09 [Jc Ac]
matiko09: raises $1.50 to $2.50
Arhistrareg: folds 
er13to: folds 
Igor DoUrden: folds 
Uncalled bet ($1.50) returned to matiko09
matiko09 collected $2.50 from pot
matiko09: doesn't show hand 
*** SUMMARY ***
Total pot $2.50 | Rake $0 
Seat 6: Arhistrareg (button) folded before Flop (didn't bet)
Seat 7: er13to (small blind) folded before Flop
Seat 8: Igor DoUrden (big blind) folded before Flop
Seat 9: matiko09 collected ($2.50)





PokerStars Hand #148832861022:  Hold'em No Limit ($0.50/$1.00 USD) - 2016/02/15 10:58:00 CET [2016/02/15 4:58:00 ET]
Table 'Corvus III' 9-max Seat #7 is the button
Seat 4: goransyruvka ($80.94 in chips) 
Seat 5: koib88 ($243.41 in chips) 
Seat 7: matiko09 ($258.46 in chips) 
Seat 8: redacesfull ($180.13 in chips) 
Seat 9: er13to ($107.36 in chips) 
redacesfull: posts small blind $0.50
er13to: posts big blind $1
goransyruvka: posts the ante $0.20
koib88: posts the ante $0.20
matiko09: posts the ante $0.20
redacesfull: posts the ante $0.20
er13to: posts the ante $0.20
*** HOLE CARDS ***
Dealt to matiko09 [Kd 5s]
agritom joins the table at seat #1 
goransyruvka: folds 
koib88: raises $1 to $2
matiko09: folds 
redacesfull: folds 
er13to: calls $1
*** FLOP *** [8d Qs 2c]
er13to: checks 
koib88: checks 
*** TURN *** [8d Qs 2c] [Js]
er13to: bets $3.41
koib88: raises $3.41 to $6.82
er13to: calls $3.41
*** RIVER *** [8d Qs 2c Js] [Kh]
er13to: checks 
koib88: bets $4
er13to: calls $4
*** SHOW DOWN ***
koib88: shows [8s Jc] (two pair, Jacks and Eights)
er13to: mucks hand 
koib88 collected $25.92 from pot
*** SUMMARY ***
Total pot $27.14 | Rake $1.22 
Board [8d Qs 2c Js Kh]
Seat 4: goransyruvka folded before Flop (didn't bet)
Seat 5: koib88 showed [8s Jc] and won ($25.92) with two pair, Jacks and Eights
Seat 7: matiko09 (button) folded before Flop (didn't bet)
Seat 8: redacesfull (small blind) folded before Flop
Seat 9: er13to (big blind) mucked [Qh Ts]





PokerStars Hand #148832866588:  Hold'em No Limit ($0.50/$1.00 USD) - 2016/02/15 10:58:04 CET [2016/02/15 4:58:04 ET]
Table 'Euanthe II' 9-max Seat #7 is the button
Seat 1: maxxmeister ($130.94 in chips) 
Seat 2: mycka86 ($187.34 in chips) 
Seat 4: er13to ($114.58 in chips) 
Seat 5: vrnMike ($174.48 in chips) 
Seat 6: ChefCatalin ($75.50 in chips) 
Seat 7: vinniesmol ($218.29 in chips) 
Seat 8: matiko09 ($124.29 in chips) 
Seat 9: Venomous100% ($101.50 in chips) 
matiko09: posts small blind $0.50
Venomous100%: posts big blind $1
Sreshta222: sits out 
*** HOLE CARDS ***
Dealt to matiko09 [7c 4s]
ChefCatalin is disconnected 
maxxmeister: raises $2 to $3
mycka86: folds 
er13to: folds 
vrnMike: calls $3
ChefCatalin has timed out while disconnected
ChefCatalin: folds 
vinniesmol: folds 
matiko09: folds 
Venomous100%: folds 
*** FLOP *** [Ad Jh 3s]
maxxmeister: checks 
vrnMike: bets $3.50
maxxmeister: folds 
Uncalled bet ($3.50) returned to vrnMike
vrnMike collected $7.16 from pot
*** SUMMARY ***
Total pot $7.50 | Rake $0.34 
Board [Ad Jh 3s]
Seat 1: maxxmeister folded on the Flop
Seat 2: mycka86 folded before Flop (didn't bet)
Seat 4: er13to folded before Flop (didn't bet)
Seat 5: vrnMike collected ($7.16)
Seat 6: ChefCatalin folded before Flop (didn't bet)
Seat 7: vinniesmol (button) folded before Flop (didn't bet)
Seat 8: matiko09 (small blind) folded before Flop
Seat 9: Venomous100% (big blind) folded before Flop





PokerStars Hand #148832868737:  Hold'em No Limit ($0.50/$1.00 USD) - 2016/02/15 10:58:10 CET [2016/02/15 4:58:10 ET]
Table 'Gemma II' 9-max Seat #2 is the button
Seat 1: Igor DoUrden ($177.84 in chips) 
Seat 2: er13to ($118.18 in chips) 
Seat 3: Venomous100% ($132.74 in chips) 
Seat 4: mycka86 ($100 in chips) 
Seat 5: PokerSash201 ($66.75 in chips) 
Seat 7: AlKatrone ($116.77 in chips) 
Seat 8: vrnMike ($157.45 in chips) 
Seat 9: matiko09 ($100 in chips) 
Venomous100%: posts small blind $0.50
mycka86: posts big blind $1
IHouseMusic: sits out 
*** HOLE CARDS ***
Dealt to matiko09 [3h 4s]
PokerSash201: folds 
AlKatrone: folds 
vrnMike: raises $2 to $3
matiko09: folds 
Igor DoUrden: folds 
er13to: raises $6 to $9
Venomous100%: folds 
mycka86: folds 
vrnMike: raises $14 to $23
er13to: raises $95.18 to $118.18 and is all-in
vrnMike: folds 
Uncalled bet ($95.18) returned to er13to
er13to collected $47.50 from pot
*** SUMMARY ***
Total pot $47.50 | Rake $0 
Seat 1: Igor DoUrden folded before Flop (didn't bet)
Seat 2: er13to (button) collected ($47.50)
Seat 3: Venomous100% (small blind) folded before Flop
Seat 4: mycka86 (big blind) folded before Flop
Seat 5: PokerSash201 folded before Flop (didn't bet)
Seat 7: AlKatrone folded before Flop (didn't bet)
Seat 8: vrnMike folded before Flop
Seat 9: matiko09 folded before Flop (didn't bet)





PokerStars Hand #148832869387:  Hold'em No Limit ($0.50/$1.00 USD) - 2016/02/15 10:58:11 CET [2016/02/15 4:58:11 ET]
Table 'Nata II' 9-max Seat #7 is the button
Seat 6: Arhistrareg ($54.74 in chips) 
Seat 7: er13to ($105.48 in chips) 
Seat 8: Igor DoUrden ($100 in chips) 
Seat 9: matiko09 ($101.50 in chips) 
Igor DoUrden: posts small blind $0.50
matiko09: posts big blind $1
*** HOLE CARDS ***
Dealt to matiko09 [5c 8c]
Arhistrareg: folds 
er13to: folds 
Igor DoUrden: folds 
Uncalled bet ($0.50) returned to matiko09
matiko09 collected $1 from pot
matiko09: doesn't show hand 
*** SUMMARY ***
Total pot $1 | Rake $0 
Seat 6: Arhistrareg folded before Flop (didn't bet)
Seat 7: er13to (button) folded before Flop (didn't bet)
Seat 8: Igor DoUrden (small blind) folded before Flop
Seat 9: matiko09 (big blind) collected ($1)





PokerStars Hand #148832870140:  Hold'em No Limit ($0.50/$1.00 USD) - 2016/02/15 10:58:14 CET [2016/02/15 4:58:14 ET]
Table 'Anteros' 9-max Seat #4 is the button
Seat 2: IHouseMusic ($112.56 in chips) 
Seat 4: misherei ($196.44 in chips) 
Seat 5: Holm1991 ($74.48 in chips) 
Seat 6: SerAlGog ($114.13 in chips) 
Seat 7: Zoubou1983 ($158.54 in chips) 
Seat 8: matiko09 ($105.14 in chips) 
Seat 9: vrnMike ($100 in chips) 
Holm1991: posts small blind $0.50
SerAlGog: posts big blind $1
redacesfull: sits out 
er13to: sits out 
*** HOLE CARDS ***
Dealt to matiko09 [5d Js]
Zoubou1983: folds 
matiko09: folds 
vrnMike: folds 
IHouseMusic: raises $2 to $3
misherei: folds 
Holm1991: folds 
SerAlGog: folds 
Uncalled bet ($2) returned to IHouseMusic
IHouseMusic collected $2.50 from pot
IHouseMusic: doesn't show hand 
*** SUMMARY ***
Total pot $2.50 | Rake $0 
Seat 2: IHouseMusic collected ($2.50)
Seat 4: misherei (button) folded before Flop (didn't bet)
Seat 5: Holm1991 (small blind) folded before Flop
Seat 6: SerAlGog (big blind) folded before Flop
Seat 7: Zoubou1983 folded before Flop (didn't bet)
Seat 8: matiko09 folded before Flop (didn't bet)
Seat 9: vrnMike folded before Flop (didn't bet)





PokerStars Hand #148832877054:  Hold'em No Limit ($0.25/$0.50 USD) - 2016/02/15 10:58:22 CET [2016/02/15 4:58:22 ET]
Table 'Laertes II' 9-max Seat #5 is the button
Seat 2: beluccix ($24.21 in chips) 
Seat 3: ljryviltj ($55.37 in chips) 
Seat 4: rgar93 ($40.63 in chips) 
Seat 5: vlad11122007 ($49.75 in chips) 
Seat 6: yats87 ($61.16 in chips) 
Seat 7: Vedpapa ($50 in chips) 
Seat 8: Trent444 ($42.73 in chips) 
Seat 9: matiko09 ($50 in chips) 
yats87: posts small blind $0.25
Vedpapa: posts big blind $0.50
*** HOLE CARDS ***
Dealt to matiko09 [8c Qd]
Trent444: folds 
matiko09: folds 
beluccix: folds 
ljryviltj: folds 
rgar93: folds 
vlad11122007: folds 
yats87: folds 
Uncalled bet ($0.25) returned to Vedpapa
Vedpapa collected $0.50 from pot
Vedpapa: doesn't show hand 
*** SUMMARY ***
Total pot $0.50 | Rake $0 
Seat 2: beluccix folded before Flop (didn't bet)
Seat 3: ljryviltj folded before Flop (didn't bet)
Seat 4: rgar93 folded before Flop (didn't bet)
Seat 5: vlad11122007 (button) folded before Flop (didn't bet)
Seat 6: yats87 (small blind) folded before Flop
Seat 7: Vedpapa (big blind) collected ($0.50)
Seat 8: Trent444 folded before Flop (didn't bet)
Seat 9: matiko09 folded before Flop (didn't bet)





PokerStars Hand #148832876798:  Hold'em No Limit ($0.50/$1.00 USD) - 2016/02/15 10:58:22 CET [2016/02/15 4:58:22 ET]
Table 'Nata II' 9-max Seat #8 is the button
Seat 6: Arhistrareg ($54.74 in chips) 
Seat 7: er13to ($105.48 in chips) 
Seat 8: Igor DoUrden ($100 in chips) 
Seat 9: matiko09 ($102 in chips) 
matiko09: posts small blind $0.50
Arhistrareg: posts big blind $1
*** HOLE CARDS ***
Dealt to matiko09 [6d 2c]
er13to: raises $2 to $3
Igor DoUrden: folds 
matiko09: folds 
Arhistrareg: calls $2
*** FLOP *** [7d 3d 8s]
Arhistrareg: checks 
er13to: bets $3.23
Arhistrareg: raises $12.67 to $15.90
er13to: folds 
Uncalled bet ($12.67) returned to Arhistrareg
Arhistrareg collected $12.38 from pot
Arhistrareg: doesn't show hand 
*** SUMMARY ***
Total pot $12.96 | Rake $0.58 
Board [7d 3d 8s]
Seat 6: Arhistrareg (big blind) collected ($12.38)
Seat 7: er13to folded on the Flop
Seat 8: Igor DoUrden (button) folded before Flop (didn't bet)
Seat 9: matiko09 (small blind) folded before Flop





PokerStars Hand #148832878722:  Hold'em No Limit ($0.25/$0.50 USD) - 2016/02/15 10:58:25 CET [2016/02/15 4:58:25 ET]
Table 'Vesta II' 9-max Seat #5 is the button
Seat 1: Ahangama ($88 in chips) 
Seat 2: i L00K great ($54.62 in chips) 
Seat 3: matiko09 ($76.45 in chips) 
Seat 5: dndngod ($76.90 in chips) 
Seat 7: ruyingren ($25.04 in chips) 
Seat 8: Arystan ($85.83 in chips) 
Seat 9: Aoki42 ($74.26 in chips) 
ruyingren: posts small blind $0.25
Arystan: posts big blind $0.50
vlad11122007: sits out 
*** HOLE CARDS ***
Dealt to matiko09 [4s Tc]
Aoki42: folds 
Ahangama: raises $0.75 to $1.25
i L00K great: folds 
matiko09: folds 
dndngod: folds 
ruyingren: folds 
Arystan: calls $0.75
*** FLOP *** [Ac 6d 2h]
Arystan: bets $1.31
Ahangama: calls $1.31
*** TURN *** [Ac 6d 2h] [Qd]
Arystan: bets $3
Ahangama: calls $3
*** RIVER *** [Ac 6d 2h Qd] [Qh]
Arystan: checks 
Ahangama: checks 
*** SHOW DOWN ***
Arystan: shows [Jc 7s] (a pair of Queens)
Ahangama: shows [Kh Ks] (two pair, Kings and Queens)
Ahangama collected $10.86 from pot
*** SUMMARY ***
Total pot $11.37 | Rake $0.51 
Board [Ac 6d 2h Qd Qh]
Seat 1: Ahangama showed [Kh Ks] and won ($10.86) with two pair, Kings and Queens
Seat 2: i L00K great folded before Flop (didn't bet)
Seat 3: matiko09 folded before Flop (didn't bet)
Seat 5: dndngod (button) folded before Flop (didn't bet)
Seat 7: ruyingren (small blind) folded before Flop
Seat 8: Arystan (big blind) showed [Jc 7s] and lost with a pair of Queens
Seat 9: Aoki42 folded before Flop (didn't bet)





PokerStars Hand #148832881506:  Hold'em No Limit ($0.50/$1.00 USD) - 2016/02/15 10:58:29 CET [2016/02/15 4:58:29 ET]
Table 'Ristenpart' 9-max Seat #9 is the button
Seat 1: matiko09 ($100 in chips) 
Seat 2: AlKatrone ($103 in chips) 
Seat 3: vrnMike ($111.08 in chips) 
Seat 4: Priidix ($169.20 in chips) 
Seat 8: SWAYZE999 ($132.33 in chips) 
Seat 9: er13to ($100 in chips) 
matiko09: posts small blind $0.50
AlKatrone: posts big blind $1
*** HOLE CARDS ***
Dealt to matiko09 [Jd 6h]
vrnMike: folds 
Priidix: raises $1.60 to $2.60
SWAYZE999: folds 
er13to: folds 
matiko09: folds 
AlKatrone: folds 
Uncalled bet ($1.60) returned to Priidix
Priidix collected $2.50 from pot
Priidix: doesn't show hand 
*** SUMMARY ***
Total pot $2.50 | Rake $0 
Seat 1: matiko09 (small blind) folded before Flop
Seat 2: AlKatrone (big blind) folded before Flop
Seat 3: vrnMike folded before Flop (didn't bet)
Seat 4: Priidix collected ($2.50)
Seat 8: SWAYZE999 folded before Flop (didn't bet)
Seat 9: er13to (button) folded before Flop (didn't bet)





PokerStars Hand #148832883113:  Hold'em No Limit ($0.25/$0.50 USD) - 2016/02/15 10:58:33 CET [2016/02/15 4:58:33 ET]
Table 'Eltigen II' 9-max Seat #6 is the button
Seat 1: ljryviltj ($52.83 in chips) 
Seat 2: matiko09 ($56.49 in chips) 
Seat 3: injener ($51.09 in chips) 
Seat 4: beluccix ($51.25 in chips) 
Seat 5: R@/\//\/Y305 ($11.11 in chips) 
Seat 6: Prettyspitz ($50 in chips) 
Seat 7: SerAlGog ($50 in chips) 
Seat 8: Aoki42 ($50 in chips) 
Seat 9: Deepak.D ($56.60 in chips) 
SerAlGog: posts small blind $0.25
Aoki42: posts big blind $0.50
*** HOLE CARDS ***
Dealt to matiko09 [Ah 8d]
Deepak.D: folds 
ljryviltj: folds 
matiko09: folds 
injener: folds 
beluccix: folds 
R@/\//\/Y305: calls $0.50
Prettyspitz: folds 
SerAlGog: folds 
Aoki42: checks 
*** FLOP *** [Qh 5c 3s]
Aoki42: checks 
R@/\//\/Y305: checks 
*** TURN *** [Qh 5c 3s] [Kc]
Aoki42: checks 
R@/\//\/Y305: checks 
*** RIVER *** [Qh 5c 3s Kc] [Ts]
Aoki42: checks 
R@/\//\/Y305: bets $2.50
Aoki42: folds 
Uncalled bet ($2.50) returned to R@/\//\/Y305
R@/\//\/Y305 collected $1.19 from pot
*** SUMMARY ***
Total pot $1.25 | Rake $0.06 
Board [Qh 5c 3s Kc Ts]
Seat 1: ljryviltj folded before Flop (didn't bet)
Seat 2: matiko09 folded before Flop (didn't bet)
Seat 3: injener folded before Flop (didn't bet)
Seat 4: beluccix folded before Flop (didn't bet)
Seat 5: R@/\//\/Y305 collected ($1.19)
Seat 6: Prettyspitz (button) folded before Flop (didn't bet)
Seat 7: SerAlGog (small blind) folded before Flop
Seat 8: Aoki42 (big blind) folded on the River
Seat 9: Deepak.D folded before Flop (didn't bet)





PokerStars Hand #148832883593:  Hold'em No Limit ($0.50/$1.00 USD) - 2016/02/15 10:58:34 CET [2016/02/15 4:58:34 ET]
Table 'Anteros' 9-max Seat #5 is the button
Seat 2: IHouseMusic ($114.06 in chips) 
Seat 4: misherei ($196.44 in chips) 
Seat 5: Holm1991 ($73.98 in chips) 
Seat 6: SerAlGog ($113.13 in chips) 
Seat 7: Zoubou1983 ($158.54 in chips) 
Seat 8: matiko09 ($105.14 in chips) 
Seat 9: vrnMike ($100 in chips) 
SerAlGog: posts small blind $0.50
Zoubou1983: posts big blind $1
redacesfull: sits out 
er13to: sits out 
*** HOLE CARDS ***
Dealt to matiko09 [Tc 4c]
matiko09: folds 
vrnMike: folds 
IHouseMusic: raises $2 to $3
misherei: calls $3
Holm1991: calls $3
SerAlGog: folds 
Zoubou1983: calls $2
*** FLOP *** [Jd 3d Kh]
Zoubou1983: checks 
IHouseMusic: checks 
misherei: checks 
Holm1991: checks 
*** TURN *** [Jd 3d Kh] [Kd]
Zoubou1983: bets $6
IHouseMusic has timed out
IHouseMusic: folds 
misherei: folds 
Holm1991: folds 
Uncalled bet ($6) returned to Zoubou1983
Zoubou1983 collected $11.94 from pot
Zoubou1983: doesn't show hand 
*** SUMMARY ***
Total pot $12.50 | Rake $0.56 
Board [Jd 3d Kh Kd]
Seat 2: IHouseMusic folded on the Turn
Seat 4: misherei folded on the Turn
Seat 5: Holm1991 (button) folded on the Turn
Seat 6: SerAlGog (small blind) folded before Flop
Seat 7: Zoubou1983 (big blind) collected ($11.94)
Seat 8: matiko09 folded before Flop (didn't bet)
Seat 9: vrnMike folded before Flop (didn't bet)





PokerStars Hand #148832886237:  Hold'em No Limit (€0.25/€0.50 EUR) - 2016/02/15 10:58:39 CET [2016/02/15 4:58:39 ET]
Table 'Walinskia II' 9-max Seat #4 is the button
Seat 1: ljryviltj (€51.84 in chips) 
Seat 2: yats87 (€56.45 in chips) 
Seat 3: beluccix (€26.39 in chips) 
Seat 4: Otsime (€47.36 in chips) 
Seat 5: vano7777 (€63.04 in chips) 
Seat 6: 50CandyJoe (€67.79 in chips) 
Seat 8: matiko09 (€55.01 in chips) 
Seat 9: Ahangama (€52.54 in chips) 
vano7777: posts small blind €0.25
50CandyJoe: posts big blind €0.50
etny99: sits out 
*** HOLE CARDS ***
Dealt to matiko09 [4s Jd]
matiko09: folds 
Ahangama: folds 
ljryviltj: folds 
yats87: folds 
beluccix: folds 
Otsime: folds 
vano7777: folds 
Uncalled bet (€0.25) returned to 50CandyJoe
50CandyJoe collected €0.50 from pot
50CandyJoe: doesn't show hand 
*** SUMMARY ***
Total pot €0.50 | Rake €0 
Seat 1: ljryviltj folded before Flop (didn't bet)
Seat 2: yats87 folded before Flop (didn't bet)
Seat 3: beluccix folded before Flop (didn't bet)
Seat 4: Otsime (button) folded before Flop (didn't bet)
Seat 5: vano7777 (small blind) folded before Flop
Seat 6: 50CandyJoe (big blind) collected (€0.50)
Seat 8: matiko09 folded before Flop (didn't bet)
Seat 9: Ahangama folded before Flop (didn't bet)





PokerStars Hand #148832891163:  Hold'em No Limit (€0.50/€1.00 EUR) - 2016/02/15 10:58:51 CET [2016/02/15 4:58:51 ET]
Table 'Ganesa II' 9-max Seat #2 is the button
Seat 2: maxxmeister (€102.61 in chips) 
Seat 3: BuBu 0187 (€75.47 in chips) 
Seat 4: Sreshta222 (€100 in chips) 
Seat 5: vano7777 (€75.24 in chips) 
Seat 6: matiko09 (€100.89 in chips) 
Seat 7: er13to (€108.53 in chips) 
BuBu 0187: posts small blind €0.50
Sreshta222: posts big blind €1
mycka86: sits out 
*** HOLE CARDS ***
Dealt to matiko09 [9s 6d]
vano7777: folds 
matiko09: folds 
er13to: raises €1.50 to €2.50
maxxmeister: folds 
BuBu 0187: calls €2
Sreshta222: folds 
*** FLOP *** [Qh Ad Jc]
BuBu 0187: bets €3
er13to: folds 
Uncalled bet (€3) returned to BuBu 0187
BuBu 0187 collected €5.73 from pot
BuBu 0187: doesn't show hand 
*** SUMMARY ***
Total pot €6 | Rake €0.27 
Board [Qh Ad Jc]
Seat 2: maxxmeister (button) folded before Flop (didn't bet)
Seat 3: BuBu 0187 (small blind) collected (€5.73)
Seat 4: Sreshta222 (big blind) folded before Flop
Seat 5: vano7777 folded before Flop (didn't bet)
Seat 6: matiko09 folded before Flop (didn't bet)
Seat 7: er13to folded on the Flop





PokerStars Hand #148832895229:  Hold'em No Limit ($0.25/$0.50 USD) - 2016/02/15 10:59:00 CET [2016/02/15 4:59:00 ET]
Table 'Laertes II' 9-max Seat #6 is the button
Seat 2: beluccix ($24.21 in chips) 
Seat 3: ljryviltj ($55.37 in chips) 
Seat 4: rgar93 ($40.63 in chips) 
Seat 5: vlad11122007 ($49.75 in chips) 
Seat 6: yats87 ($60.91 in chips) 
Seat 7: Vedpapa ($50.25 in chips) 
Seat 8: Trent444 ($42.73 in chips) 
Seat 9: matiko09 ($50 in chips) 
Vedpapa: posts small blind $0.25
Trent444: posts big blind $0.50
*** HOLE CARDS ***
Dealt to matiko09 [Ks 3d]
matiko09: folds 
beluccix: folds 
ljryviltj: folds 
rgar93: folds 
vlad11122007: raises $1 to $1.50
yats87: folds 
Vedpapa: calls $1.25
Trent444: calls $1
*** FLOP *** [6d 2h 9s]
Vedpapa: checks 
Trent444: bets $2.50
vlad11122007: folds 
Vedpapa: folds 
Uncalled bet ($2.50) returned to Trent444
Trent444 collected $4.30 from pot
Trent444: doesn't show hand 
*** SUMMARY ***
Total pot $4.50 | Rake $0.20 
Board [6d 2h 9s]
Seat 2: beluccix folded before Flop (didn't bet)
Seat 3: ljryviltj folded before Flop (didn't bet)
Seat 4: rgar93 folded before Flop (didn't bet)
Seat 5: vlad11122007 folded on the Flop
Seat 6: yats87 (button) folded before Flop (didn't bet)
Seat 7: Vedpapa (small blind) folded on the Flop
Seat 8: Trent444 (big blind) collected ($4.30)
Seat 9: matiko09 folded before Flop (didn't bet)





PokerStars Hand #148832896309:  Hold'em No Limit ($0.50/$1.00 USD) - 2016/02/15 10:59:03 CET [2016/02/15 4:59:03 ET]
Table 'Ristenpart' 9-max Seat #1 is the button
Seat 1: matiko09 ($100 in chips) 
Seat 2: AlKatrone ($102 in chips) 
Seat 9: er13to ($100 in chips) 
AlKatrone: posts small blind $0.50
vrnMike: is sitting out 
vrnMike leaves the table
Priidix: is sitting out 
SWAYZE999: is sitting out 
er13to: posts big blind $1
*** HOLE CARDS ***
Dealt to matiko09 [7s Td]
matiko09: folds 
SWAYZE999 leaves the table
matiko09 leaves the table
AlKatrone: raises $2 to $3
er13to: folds 
Uncalled bet ($2) returned to AlKatrone
AlKatrone collected $2 from pot
AlKatrone: doesn't show hand 
*** SUMMARY ***
Total pot $2 | Rake $0 
Seat 1: matiko09 (button) folded before Flop (didn't bet)
Seat 2: AlKatrone (small blind) collected ($2)
Seat 9: er13to (big blind) folded before Flop





PokerStars Hand #148832897075:  Hold'em No Limit ($0.50/$1.00 USD) - 2016/02/15 10:59:05 CET [2016/02/15 4:59:05 ET]
Table 'Corvus III' 9-max Seat #8 is the button
Seat 1: agritom ($250 in chips) 
Seat 4: goransyruvka ($80.74 in chips) 
Seat 5: koib88 ($256.31 in chips) 
Seat 7: matiko09 ($258.26 in chips) 
Seat 8: redacesfull ($179.43 in chips) 
Seat 9: er13to ($100 in chips) 
er13to: posts small blind $0.50
agritom: posts big blind $1
agritom: posts the ante $0.20
goransyruvka: posts the ante $0.20
koib88: posts the ante $0.20
matiko09: posts the ante $0.20
redacesfull: posts the ante $0.20
er13to: posts the ante $0.20
*** HOLE CARDS ***
Dealt to matiko09 [9c 5h]
goransyruvka: calls $1
koib88: calls $1
matiko09: folds 
redacesfull: calls $1
er13to: folds 
agritom: checks 
*** FLOP *** [9s 9h Qc]
agritom: checks 
goransyruvka: checks 
koib88: bets $2.72
redacesfull: folds 
agritom: folds 
goransyruvka: folds 
Uncalled bet ($2.72) returned to koib88
koib88 collected $5.44 from pot
koib88: doesn't show hand 
*** SUMMARY ***
Total pot $5.70 | Rake $0.26 
Board [9s 9h Qc]
Seat 1: agritom (big blind) folded on the Flop
Seat 4: goransyruvka folded on the Flop
Seat 5: koib88 collected ($5.44)
Seat 7: matiko09 folded before Flop (didn't bet)
Seat 8: redacesfull (button) folded on the Flop
Seat 9: er13to (small blind) folded before Flop





PokerStars Hand #148832900318:  Hold'em No Limit (€0.25/€0.50 EUR) - 2016/02/15 10:59:13 CET [2016/02/15 4:59:13 ET]
Table 'Walinskia II' 9-max Seat #5 is the button
Seat 1: ljryviltj (€51.84 in chips) 
Seat 2: yats87 (€56.45 in chips) 
Seat 3: beluccix (€26.39 in chips) 
Seat 4: Otsime (€47.36 in chips) 
Seat 5: vano7777 (€62.79 in chips) 
Seat 6: 50CandyJoe (€68.04 in chips) 
Seat 7: etny99 (€50 in chips) 
Seat 8: matiko09 (€55.01 in chips) 
Seat 9: Ahangama (€52.54 in chips) 
50CandyJoe: posts small blind €0.25
etny99: posts big blind €0.50
*** HOLE CARDS ***
Dealt to matiko09 [9c Jc]
matiko09: folds 
Ahangama: folds 
ljryviltj: raises €1 to €1.50
yats87: folds 
beluccix: folds 
Otsime: calls €1.50
vano7777: calls €1.50
50CandyJoe: folds 
etny99: folds 
*** FLOP *** [8c 4d Ah]
ljryviltj: checks 
Otsime: checks 
vano7777: checks 
*** TURN *** [8c 4d Ah] [5c]
ljryviltj: checks 
Otsime: checks 
vano7777: checks 
*** RIVER *** [8c 4d Ah 5c] [Td]
ljryviltj: checks 
Otsime: checks 
vano7777: checks 
*** SHOW DOWN ***
ljryviltj: shows [Kh Qh] (high card Ace)
Otsime: shows [9h 9s] (a pair of Nines)
vano7777: shows [Ts Jd] (a pair of Tens)
vano7777 collected €5.01 from pot
*** SUMMARY ***
Total pot €5.25 | Rake €0.24 
Board [8c 4d Ah 5c Td]
Seat 1: ljryviltj showed [Kh Qh] and lost with high card Ace
Seat 2: yats87 folded before Flop (didn't bet)
Seat 3: beluccix folded before Flop (didn't bet)
Seat 4: Otsime showed [9h 9s] and lost with a pair of Nines
Seat 5: vano7777 (button) showed [Ts Jd] and won (€5.01) with a pair of Tens
Seat 6: 50CandyJoe (small blind) folded before Flop
Seat 7: etny99 (big blind) folded before Flop
Seat 8: matiko09 folded before Flop (didn't bet)
Seat 9: Ahangama folded before Flop (didn't bet)





PokerStars Hand #148832901493:  Hold'em No Limit ($0.50/$1.00 USD) - 2016/02/15 10:59:16 CET [2016/02/15 4:59:16 ET]
Table 'Nata II' 9-max Seat #9 is the button
Seat 6: Arhistrareg ($60.89 in chips) 
Seat 7: er13to ($100 in chips) 
Seat 8: Igor DoUrden ($100 in chips) 
Seat 9: matiko09 ($101.50 in chips) 
Arhistrareg: posts small blind $0.50
er13to: posts big blind $1
*** HOLE CARDS ***
Dealt to matiko09 [4s 2s]
Igor DoUrden: folds 
matiko09: folds 
Arhistrareg: raises $2 to $3
er13to: folds 
Uncalled bet ($2) returned to Arhistrareg
Arhistrareg collected $2 from pot
Arhistrareg: doesn't show hand 
*** SUMMARY ***
Total pot $2 | Rake $0 
Seat 6: Arhistrareg (small blind) collected ($2)
Seat 7: er13to (big blind) folded before Flop
Seat 8: Igor DoUrden folded before Flop (didn't bet)
Seat 9: matiko09 (button) folded before Flop (didn't bet)





PokerStars Hand #148832902214:  Hold'em No Limit ($0.50/$1.00 USD) - 2016/02/15 10:59:18 CET [2016/02/15 4:59:18 ET]
Table 'Gemma II' 9-max Seat #3 is the button
Seat 1: Igor DoUrden ($177.84 in chips) 
Seat 2: er13to ($142.68 in chips) 
Seat 3: Venomous100% ($132.24 in chips) 
Seat 4: mycka86 ($100 in chips) 
Seat 5: PokerSash201 ($66.75 in chips) 
Seat 7: AlKatrone ($116.77 in chips) 
Seat 8: vrnMike ($134.45 in chips) 
Seat 9: matiko09 ($100 in chips) 
mycka86: posts small blind $0.50
PokerSash201: posts big blind $1
IHouseMusic: sits out 
*** HOLE CARDS ***
Dealt to matiko09 [Tc Th]
AlKatrone: folds 
vrnMike: folds 
matiko09: raises $2 to $3
Igor DoUrden: folds 
er13to: folds 
Venomous100%: calls $3
mycka86: folds 
PokerSash201: calls $2
*** FLOP *** [Qc 6d Td]
PokerSash201: checks 
matiko09: bets $7
Venomous100%: calls $7
PokerSash201: folds 
*** TURN *** [Qc 6d Td] [Jd]
matiko09: checks 
Venomous100%: bets $14.81
matiko09: calls $14.81
*** RIVER *** [Qc 6d Td Jd] [9h]
matiko09: checks 
Venomous100%: bets $25.36
matiko09: folds 
Uncalled bet ($25.36) returned to Venomous100%
Venomous100% collected $50.73 from pot
Venomous100%: doesn't show hand 
*** SUMMARY ***
Total pot $53.12 | Rake $2.39 
Board [Qc 6d Td Jd 9h]
Seat 1: Igor DoUrden folded before Flop (didn't bet)
Seat 2: er13to folded before Flop (didn't bet)
Seat 3: Venomous100% (button) collected ($50.73)
Seat 4: mycka86 (small blind) folded before Flop
Seat 5: PokerSash201 (big blind) folded on the Flop
Seat 7: AlKatrone folded before Flop (didn't bet)
Seat 8: vrnMike folded before Flop (didn't bet)
Seat 9: matiko09 folded on the River





PokerStars Hand #148832907050:  Hold'em No Limit ($0.50/$1.00 USD) - 2016/02/15 10:59:31 CET [2016/02/15 4:59:31 ET]
Table 'Nata II' 9-max Seat #6 is the button
Seat 6: Arhistrareg ($61.89 in chips) 
Seat 7: er13to ($100 in chips) 
Seat 8: Igor DoUrden ($100 in chips) 
Seat 9: matiko09 ($101.50 in chips) 
er13to: posts small blind $0.50
Igor DoUrden: posts big blind $1
*** HOLE CARDS ***
Dealt to matiko09 [Kh Td]
matiko09: raises $1.50 to $2.50
Arhistrareg: calls $2.50
er13to: folds 
Igor DoUrden: raises $9.50 to $12
matiko09: folds 
Arhistrareg: folds 
Uncalled bet ($9.50) returned to Igor DoUrden
Igor DoUrden collected $8 from pot
Igor DoUrden: doesn't show hand 
*** SUMMARY ***
Total pot $8 | Rake $0 
Seat 6: Arhistrareg (button) folded before Flop
Seat 7: er13to (small blind) folded before Flop
Seat 8: Igor DoUrden (big blind) collected ($8)
Seat 9: matiko09 folded before Flop





PokerStars Hand #148832907538:  Hold'em No Limit ($0.25/$0.50 USD) - 2016/02/15 10:59:32 CET [2016/02/15 4:59:32 ET]
Table 'Eltigen II' 9-max Seat #7 is the button
Seat 1: ljryviltj ($52.83 in chips) 
Seat 2: matiko09 ($56.49 in chips) 
Seat 3: injener ($51.09 in chips) 
Seat 4: beluccix ($51.25 in chips) 
Seat 5: R@/\//\/Y305 ($11.80 in chips) 
Seat 6: Prettyspitz ($50 in chips) 
Seat 7: SerAlGog ($50 in chips) 
Seat 8: Aoki42 ($50 in chips) 
Seat 9: Deepak.D ($56.60 in chips) 
Aoki42: posts small blind $0.25
Deepak.D: posts big blind $0.50
*** HOLE CARDS ***
Dealt to matiko09 [7s Qs]
ljryviltj: folds 
matiko09: folds 
injener: folds 
beluccix: folds 
R@/\//\/Y305: folds 
Prettyspitz: folds 
SerAlGog: raises $0.50 to $1
Aoki42: folds 
Deepak.D: calls $0.50
*** FLOP *** [5c Jc 6s]
Deepak.D: checks 
SerAlGog: checks 
*** TURN *** [5c Jc 6s] [Tc]
Deepak.D: checks 
SerAlGog: bets $1.31
Deepak.D: calls $1.31
*** RIVER *** [5c Jc 6s Tc] [Qh]
Deepak.D: checks 
SerAlGog: checks 
*** SHOW DOWN ***
Deepak.D: shows [7c 6d] (a pair of Sixes)
SerAlGog: mucks hand 
Deepak.D collected $4.65 from pot
*** SUMMARY ***
Total pot $4.87 | Rake $0.22 
Board [5c Jc 6s Tc Qh]
Seat 1: ljryviltj folded before Flop (didn't bet)
Seat 2: matiko09 folded before Flop (didn't bet)
Seat 3: injener folded before Flop (didn't bet)
Seat 4: beluccix folded before Flop (didn't bet)
Seat 5: R@/\//\/Y305 folded before Flop (didn't bet)
Seat 6: Prettyspitz folded before Flop (didn't bet)
Seat 7: SerAlGog (button) mucked [Ad 5s]
Seat 8: Aoki42 (small blind) folded before Flop
Seat 9: Deepak.D (big blind) showed [7c 6d] and won ($4.65) with a pair of Sixes





PokerStars Hand #148832910296:  Hold'em No Limit ($0.50/$1.00 USD) - 2016/02/15 10:59:40 CET [2016/02/15 4:59:40 ET]
Table 'Corvus III' 9-max Seat #9 is the button
Seat 1: agritom ($250 in chips) 
Seat 4: goransyruvka ($79.54 in chips) 
Seat 5: koib88 ($260.55 in chips) 
Seat 7: matiko09 ($258.06 in chips) 
Seat 8: redacesfull ($178.23 in chips) 
Seat 9: er13to ($100 in chips) 
agritom: posts small blind $0.50
goransyruvka: posts big blind $1
agritom: posts the ante $0.20
goransyruvka: posts the ante $0.20
koib88: posts the ante $0.20
matiko09: posts the ante $0.20
redacesfull: posts the ante $0.20
er13to: posts the ante $0.20
*** HOLE CARDS ***
Dealt to matiko09 [8c 4d]
koib88: folds 
matiko09: folds 
redacesfull: raises $1.12 to $2.12
er13to: folds 
agritom: raises $3.88 to $6
goransyruvka: folds 
redacesfull: folds 
Uncalled bet ($3.88) returned to agritom
agritom collected $6.44 from pot
agritom: doesn't show hand 
*** SUMMARY ***
Total pot $6.44 | Rake $0 
Seat 1: agritom (small blind) collected ($6.44)
Seat 4: goransyruvka (big blind) folded before Flop
Seat 5: koib88 folded before Flop (didn't bet)
Seat 7: matiko09 folded before Flop (didn't bet)
Seat 8: redacesfull folded before Flop
Seat 9: er13to (button) folded before Flop (didn't bet)





PokerStars Hand #148832911686:  Hold'em No Limit ($0.50/$1.00 USD) - 2016/02/15 10:59:43 CET [2016/02/15 4:59:43 ET]
Table 'Euanthe II' 9-max Seat #8 is the button
Seat 1: maxxmeister ($127.94 in chips) 
Seat 2: mycka86 ($187.34 in chips) 
Seat 4: er13to ($114.58 in chips) 
Seat 5: vrnMike ($178.64 in chips) 
Seat 7: vinniesmol ($218.29 in chips) 
Seat 8: matiko09 ($123.79 in chips) 
Seat 9: Venomous100% ($100.50 in chips) 
Venomous100%: posts small blind $0.50
maxxmeister: posts big blind $1
Sreshta222: sits out 
*** HOLE CARDS ***
Dealt to matiko09 [Jc 6d]
mycka86: folds 
er13to: folds 
vrnMike: folds 
vinniesmol: raises $1 to $2
matiko09: folds 
Venomous100%: folds 
maxxmeister: calls $1
*** FLOP *** [9s Kc Qs]
maxxmeister: checks 
vinniesmol: bets $3
maxxmeister: folds 
Uncalled bet ($3) returned to vinniesmol
vinniesmol collected $4.30 from pot
*** SUMMARY ***
Total pot $4.50 | Rake $0.20 
Board [9s Kc Qs]
Seat 1: maxxmeister (big blind) folded on the Flop
Seat 2: mycka86 folded before Flop (didn't bet)
Seat 4: er13to folded before Flop (didn't bet)
Seat 5: vrnMike folded before Flop (didn't bet)
Seat 7: vinniesmol collected ($4.30)
Seat 8: matiko09 (button) folded before Flop (didn't bet)
Seat 9: Venomous100% (small blind) folded before Flop





PokerStars Hand #148832914151:  Hold'em No Limit ($0.50/$1.00 USD) - 2016/02/15 10:59:49 CET [2016/02/15 4:59:49 ET]
Table 'Nata II' 9-max Seat #7 is the button
Seat 6: Arhistrareg ($59.39 in chips) 
Seat 7: er13to ($100 in chips) 
Seat 8: Igor DoUrden ($105.50 in chips) 
Seat 9: matiko09 ($100 in chips) 
Igor DoUrden: posts small blind $0.50
matiko09: posts big blind $1
*** HOLE CARDS ***
Dealt to matiko09 [8d Js]
Arhistrareg: folds 
er13to: raises $1.50 to $2.50
Igor DoUrden: folds 
matiko09: folds 
Uncalled bet ($1.50) returned to er13to
er13to collected $2.50 from pot
*** SUMMARY ***
Total pot $2.50 | Rake $0 
Seat 6: Arhistrareg folded before Flop (didn't bet)
Seat 7: er13to (button) collected ($2.50)
Seat 8: Igor DoUrden (small blind) folded before Flop
Seat 9: matiko09 (big blind) folded before Flop





PokerStars Hand #148832914244:  Hold'em No Limit ($0.25/$0.50 USD) - 2016/02/15 10:59:50 CET [2016/02/15 4:59:50 ET]
Table 'Vesta II' 9-max Seat #7 is the button
Seat 1: Ahangama ($93.30 in chips) 
Seat 2: i L00K great ($54.62 in chips) 
Seat 3: matiko09 ($76.45 in chips) 
Seat 5: dndngod ($76.90 in chips) 
Seat 7: ruyingren ($24.79 in chips) 
Seat 8: Arystan ($80.27 in chips) 
Seat 9: Aoki42 ($74.26 in chips) 
Arystan: posts small blind $0.25
Aoki42: posts big blind $0.50
vlad11122007: sits out 
pandalapa: sits out 
*** HOLE CARDS ***
Dealt to matiko09 [2s Th]
Ahangama: raises $0.75 to $1.25
i L00K great: folds 
matiko09: folds 
dndngod: folds 
ruyingren: folds 
Arystan: calls $1
Aoki42: folds 
*** FLOP *** [Ah 4h 4s]
Arystan: bets $1.43
Ahangama: folds 
Uncalled bet ($1.43) returned to Arystan
Arystan collected $2.86 from pot
Arystan: doesn't show hand 
*** SUMMARY ***
Total pot $3 | Rake $0.14 
Board [Ah 4h 4s]
Seat 1: Ahangama folded on the Flop
Seat 2: i L00K great folded before Flop (didn't bet)
Seat 3: matiko09 folded before Flop (didn't bet)
Seat 5: dndngod folded before Flop (didn't bet)
Seat 7: ruyingren (button) folded before Flop (didn't bet)
Seat 8: Arystan (small blind) collected ($2.86)
Seat 9: Aoki42 (big blind) folded before Flop





PokerStars Hand #148832915425:  Hold'em No Limit (€0.50/€1.00 EUR) - 2016/02/15 10:59:53 CET [2016/02/15 4:59:53 ET]
Table 'Ganesa II' 9-max Seat #3 is the button
Seat 2: maxxmeister (€102.61 in chips) 
Seat 3: BuBu 0187 (€78.70 in chips) 
Seat 4: Sreshta222 (€100 in chips) 
Seat 5: vano7777 (€75.24 in chips) 
Seat 6: matiko09 (€100.89 in chips) 
Seat 7: er13to (€106.03 in chips) 
Sreshta222: posts small blind €0.50
vano7777: posts big blind €1
mycka86: sits out 
*** HOLE CARDS ***
Dealt to matiko09 [Th 6c]
matiko09: folds 
er13to: folds 
maxxmeister: folds 
BuBu 0187: folds 
Sreshta222: folds 
Uncalled bet (€0.50) returned to vano7777
vano7777 collected €1 from pot
*** SUMMARY ***
Total pot €1 | Rake €0 
Seat 2: maxxmeister folded before Flop (didn't bet)
Seat 3: BuBu 0187 (button) folded before Flop (didn't bet)
Seat 4: Sreshta222 (small blind) folded before Flop
Seat 5: vano7777 (big blind) collected (€1)
Seat 6: matiko09 folded before Flop (didn't bet)
Seat 7: er13to folded before Flop (didn't bet)





PokerStars Hand #148832919691:  Hold'em No Limit ($0.50/$1.00 USD) - 2016/02/15 11:00:04 CET [2016/02/15 5:00:04 ET]
Table 'Nata II' 9-max Seat #8 is the button
Seat 6: Arhistrareg ($59.39 in chips) 
Seat 7: er13to ($101.50 in chips) 
Seat 8: Igor DoUrden ($105 in chips) 
Seat 9: matiko09 ($100 in chips) 
matiko09: posts small blind $0.50
Arhistrareg: posts big blind $1
*** HOLE CARDS ***
Dealt to matiko09 [3d 9s]
er13to: raises $2 to $3
Igor DoUrden: folds 
matiko09: folds 
Arhistrareg: calls $2
*** FLOP *** [Qh 8h Jh]
Arhistrareg: checks 
er13to: bets $5.50
Arhistrareg: calls $5.50
*** TURN *** [Qh 8h Jh] [Jc]
Arhistrareg: checks 
Priidix joins the table at seat #1 
er13to: bets $14.50
qqcom joins the table at seat #2 
Arhistrareg: folds 
Uncalled bet ($14.50) returned to er13to
er13to collected $16.71 from pot
er13to: doesn't show hand 
*** SUMMARY ***
Total pot $17.50 | Rake $0.79 
Board [Qh 8h Jh Jc]
Seat 6: Arhistrareg (big blind) folded on the Turn
Seat 7: er13to collected ($16.71)
Seat 8: Igor DoUrden (button) folded before Flop (didn't bet)
Seat 9: matiko09 (small blind) folded before Flop





PokerStars Hand #148832919851:  Hold'em No Limit ($0.50/$1.00 USD) - 2016/02/15 11:00:04 CET [2016/02/15 5:00:04 ET]
Table 'Corvus III' 9-max Seat #1 is the button
Seat 1: agritom ($254.12 in chips) 
Seat 4: goransyruvka ($78.34 in chips) 
Seat 5: koib88 ($260.35 in chips) 
Seat 7: matiko09 ($257.86 in chips) 
Seat 8: redacesfull ($175.91 in chips) 
Seat 9: er13to ($100 in chips) 
goransyruvka: posts small blind $0.50
koib88: posts big blind $1
agritom: posts the ante $0.20
goransyruvka: posts the ante $0.20
koib88: posts the ante $0.20
matiko09: posts the ante $0.20
redacesfull: posts the ante $0.20
er13to: posts the ante $0.20
*** HOLE CARDS ***
Dealt to matiko09 [5h Ah]
matiko09: raises $2 to $3
redacesfull: folds 
er13to: folds 
agritom: calls $3
goransyruvka: calls $2.50
koib88: calls $2
*** FLOP *** [9h 2s 3h]
goransyruvka: checks 
koib88: checks 
Priidix joins the table at seat #6 
matiko09: bets $8.20
agritom: folds 
goransyruvka: folds 
koib88: calls $8.20
*** TURN *** [9h 2s 3h] [Tc]
koib88: checks 
matiko09: bets $16
koib88: raises $16 to $32
matiko09: calls $16
*** RIVER *** [9h 2s 3h Tc] [Qc]
koib88: checks 
matiko09: checks 
*** SHOW DOWN ***
koib88: shows [Ts 2d] (two pair, Tens and Deuces)
matiko09: mucks hand 
koib88 collected $90.80 from pot
*** SUMMARY ***
Total pot $93.60 | Rake $2.80 
Board [9h 2s 3h Tc Qc]
Seat 1: agritom (button) folded on the Flop
Seat 4: goransyruvka (small blind) folded on the Flop
Seat 5: koib88 (big blind) showed [Ts 2d] and won ($90.80) with two pair, Tens and Deuces
Seat 7: matiko09 mucked [5h Ah]
Seat 8: redacesfull folded before Flop (didn't bet)
Seat 9: er13to folded before Flop (didn't bet)





PokerStars Hand #148832927132:  Hold'em No Limit (€0.50/€1.00 EUR) - 2016/02/15 11:00:22 CET [2016/02/15 5:00:22 ET]
Table 'Ganesa II' 9-max Seat #4 is the button
Seat 2: maxxmeister (€102.61 in chips) 
Seat 3: BuBu 0187 (€78.70 in chips) 
Seat 4: Sreshta222 (€100 in chips) 
Seat 5: vano7777 (€75.74 in chips) 
Seat 6: matiko09 (€100.89 in chips) 
Seat 7: er13to (€106.03 in chips) 
vano7777: posts small blind €0.50
matiko09: posts big blind €1
mycka86: sits out 
*** HOLE CARDS ***
Dealt to matiko09 [Td Tc]
er13to: folds 
maxxmeister: folds 
Priidix joins the table at seat #9 
BuBu 0187 has timed out
BuBu 0187: folds 
Sreshta222: folds 
vano7777: folds 
Uncalled bet (€0.50) returned to matiko09
matiko09 collected €1 from pot
matiko09: doesn't show hand 
*** SUMMARY ***
Total pot €1 | Rake €0 
Seat 2: maxxmeister folded before Flop (didn't bet)
Seat 3: BuBu 0187 folded before Flop (didn't bet)
Seat 4: Sreshta222 (button) folded before Flop (didn't bet)
Seat 5: vano7777 (small blind) folded before Flop
Seat 6: matiko09 (big blind) collected (€1)
Seat 7: er13to folded before Flop (didn't bet)





PokerStars Hand #148832926869:  Hold'em No Limit ($0.25/$0.50 USD) - 2016/02/15 11:00:22 CET [2016/02/15 5:00:22 ET]
Table 'Laertes II' 9-max Seat #7 is the button
Seat 2: beluccix ($24.21 in chips) 
Seat 3: ljryviltj ($55.37 in chips) 
Seat 4: rgar93 ($40.63 in chips) 
Seat 5: vlad11122007 ($48.25 in chips) 
Seat 6: yats87 ($60.91 in chips) 
Seat 7: Vedpapa ($50 in chips) 
Seat 8: Trent444 ($45.53 in chips) 
Seat 9: matiko09 ($50 in chips) 
Trent444: posts small blind $0.25
matiko09: posts big blind $0.50
*** HOLE CARDS ***
Dealt to matiko09 [2s As]
beluccix: folds 
ljryviltj: folds 
rgar93: folds 
vlad11122007: folds 
yats87: folds 
Vedpapa: raises $0.75 to $1.25
Trent444: calls $1
matiko09: calls $0.75
*** FLOP *** [9d Qh Td]
Trent444: checks 
matiko09: checks 
Vedpapa: bets $3
Trent444: folds 
matiko09: folds 
Uncalled bet ($3) returned to Vedpapa
Vedpapa collected $3.58 from pot
Vedpapa: doesn't show hand 
*** SUMMARY ***
Total pot $3.75 | Rake $0.17 
Board [9d Qh Td]
Seat 2: beluccix folded before Flop (didn't bet)
Seat 3: ljryviltj folded before Flop (didn't bet)
Seat 4: rgar93 folded before Flop (didn't bet)
Seat 5: vlad11122007 folded before Flop (didn't bet)
Seat 6: yats87 folded before Flop (didn't bet)
Seat 7: Vedpapa (button) collected ($3.58)
Seat 8: Trent444 (small blind) folded on the Flop
Seat 9: matiko09 (big blind) folded on the Flop





PokerStars Hand #148832927259:  Hold'em No Limit ($0.50/$1.00 USD) - 2016/02/15 11:00:23 CET [2016/02/15 5:00:23 ET]
Table 'Gemma II' 9-max Seat #4 is the button
Seat 1: Igor DoUrden ($177.84 in chips) 
Seat 2: er13to ($142.68 in chips) 
Seat 3: Venomous100% ($158.16 in chips) 
Seat 4: mycka86 ($100 in chips) 
Seat 5: PokerSash201 ($63.75 in chips) 
Seat 6: IHouseMusic ($100 in chips) 
Seat 7: AlKatrone ($116.77 in chips) 
Seat 8: vrnMike ($134.45 in chips) 
Seat 9: matiko09 ($100 in chips) 
PokerSash201: posts small blind $0.50
IHouseMusic: posts big blind $1
*** HOLE CARDS ***
Dealt to matiko09 [3d Kc]
AlKatrone: folds 
vrnMike: folds 
matiko09: folds 
Igor DoUrden: folds 
er13to: folds 
Venomous100%: raises $1.50 to $2.50
mycka86: folds 
PokerSash201: folds 
IHouseMusic: folds 
Uncalled bet ($1.50) returned to Venomous100%
Venomous100% collected $2.50 from pot
Venomous100%: doesn't show hand 
*** SUMMARY ***
Total pot $2.50 | Rake $0 
Seat 1: Igor DoUrden folded before Flop (didn't bet)
Seat 2: er13to folded before Flop (didn't bet)
Seat 3: Venomous100% collected ($2.50)
Seat 4: mycka86 (button) folded before Flop (didn't bet)
Seat 5: PokerSash201 (small blind) folded before Flop
Seat 6: IHouseMusic (big blind) folded before Flop
Seat 7: AlKatrone folded before Flop (didn't bet)
Seat 8: vrnMike folded before Flop (didn't bet)
Seat 9: matiko09 folded before Flop (didn't bet)





PokerStars Hand #148832928693:  Hold'em No Limit ($0.50/$1.00 USD) - 2016/02/15 11:00:27 CET [2016/02/15 5:00:27 ET]
Table 'Euanthe II' 9-max Seat #9 is the button
Seat 1: maxxmeister ($125.94 in chips) 
Seat 2: mycka86 ($187.34 in chips) 
Seat 4: er13to ($114.58 in chips) 
Seat 5: vrnMike ($178.64 in chips) 
Seat 7: vinniesmol ($220.59 in chips) 
Seat 8: matiko09 ($123.79 in chips) 
Seat 9: Venomous100% ($100 in chips) 
maxxmeister: posts small blind $0.50
mycka86: posts big blind $1
Sreshta222: sits out 
*** HOLE CARDS ***
Dealt to matiko09 [Js 5s]
er13to: folds 
vrnMike: folds 
vinniesmol: raises $2 to $3
matiko09: folds 
Venomous100%: folds 
maxxmeister: raises $12 to $15
mycka86: folds 
vinniesmol: folds 
Uncalled bet ($12) returned to maxxmeister
maxxmeister collected $7 from pot
maxxmeister: doesn't show hand 
*** SUMMARY ***
Total pot $7 | Rake $0 
Seat 1: maxxmeister (small blind) collected ($7)
Seat 2: mycka86 (big blind) folded before Flop
Seat 4: er13to folded before Flop (didn't bet)
Seat 5: vrnMike folded before Flop (didn't bet)
Seat 7: vinniesmol folded before Flop
Seat 8: matiko09 folded before Flop (didn't bet)
Seat 9: Venomous100% (button) folded before Flop (didn't bet)





PokerStars Hand #148832930225:  Hold'em No Limit ($0.50/$1.00 USD) - 2016/02/15 11:00:30 CET [2016/02/15 5:00:30 ET]
Table 'Anteros' 9-max Seat #6 is the button
Seat 2: IHouseMusic ($111.06 in chips) 
Seat 4: misherei ($193.44 in chips) 
Seat 5: Holm1991 ($70.98 in chips) 
Seat 6: SerAlGog ($112.63 in chips) 
Seat 7: Zoubou1983 ($167.48 in chips) 
Seat 8: matiko09 ($105.14 in chips) 
Seat 9: vrnMike ($100 in chips) 
Zoubou1983: posts small blind $0.50
matiko09: posts big blind $1
redacesfull: sits out 
er13to: sits out 
*** HOLE CARDS ***
Dealt to matiko09 [Jc Tc]
vrnMike: folds 
IHouseMusic has timed out
IHouseMusic: folds 
misherei: folds 
Holm1991: folds 
SerAlGog: raises $1 to $2
Zoubou1983: calls $1.50
matiko09: calls $1
*** FLOP *** [3c Qs Ad]
Zoubou1983: checks 
matiko09: checks 
SerAlGog: bets $2.63
Zoubou1983: folds 
matiko09: folds 
Uncalled bet ($2.63) returned to SerAlGog
SerAlGog collected $5.73 from pot
SerAlGog: doesn't show hand 
*** SUMMARY ***
Total pot $6 | Rake $0.27 
Board [3c Qs Ad]
Seat 2: IHouseMusic folded before Flop (didn't bet)
Seat 4: misherei folded before Flop (didn't bet)
Seat 5: Holm1991 folded before Flop (didn't bet)
Seat 6: SerAlGog (button) collected ($5.73)
Seat 7: Zoubou1983 (small blind) folded on the Flop
Seat 8: matiko09 (big blind) folded on the Flop
Seat 9: vrnMike folded before Flop (didn't bet)





PokerStars Hand #148832931213:  Hold'em No Limit ($0.25/$0.50 USD) - 2016/02/15 11:00:33 CET [2016/02/15 5:00:33 ET]
Table 'Vesta II' 9-max Seat #8 is the button
Seat 1: Ahangama ($92.05 in chips) 
Seat 2: i L00K great ($54.62 in chips) 
Seat 3: matiko09 ($76.45 in chips) 
Seat 5: dndngod ($76.90 in chips) 
Seat 7: ruyingren ($24.79 in chips) 
Seat 8: Arystan ($81.88 in chips) 
Seat 9: Aoki42 ($73.76 in chips) 
Aoki42: posts small blind $0.25
Ahangama: posts big blind $0.50
vlad11122007: sits out 
pandalapa: sits out 
*** HOLE CARDS ***
Dealt to matiko09 [Jd 2d]
i L00K great: raises $1 to $1.50
matiko09: folds 
dndngod: folds 
ruyingren: folds 
Arystan: folds 
Aoki42: folds 
Ahangama: calls $1
*** FLOP *** [3c 5d Ts]
Ahangama: checks 
i L00K great: bets $2.48
Ahangama: folds 
Uncalled bet ($2.48) returned to i L00K great
i L00K great collected $3.10 from pot
i L00K great: doesn't show hand 
*** SUMMARY ***
Total pot $3.25 | Rake $0.15 
Board [3c 5d Ts]
Seat 1: Ahangama (big blind) folded on the Flop
Seat 2: i L00K great collected ($3.10)
Seat 3: matiko09 folded before Flop (didn't bet)
Seat 5: dndngod folded before Flop (didn't bet)
Seat 7: ruyingren folded before Flop (didn't bet)
Seat 8: Arystan (button) folded before Flop (didn't bet)
Seat 9: Aoki42 (small blind) folded before Flop





PokerStars Hand #148832932379:  Hold'em No Limit (€0.25/€0.50 EUR) - 2016/02/15 11:00:36 CET [2016/02/15 5:00:36 ET]
Table 'Walinskia II' 9-max Seat #6 is the button
Seat 1: ljryviltj (€50.34 in chips) 
Seat 2: yats87 (€56.45 in chips) 
Seat 3: beluccix (€26.39 in chips) 
Seat 4: Otsime (€45.86 in chips) 
Seat 5: vano7777 (€66.30 in chips) 
Seat 6: 50CandyJoe (€67.79 in chips) 
Seat 7: etny99 (€50 in chips) 
Seat 8: matiko09 (€55.01 in chips) 
Seat 9: Ahangama (€52.54 in chips) 
etny99: posts small blind €0.25
matiko09: posts big blind €0.50
*** HOLE CARDS ***
Dealt to matiko09 [7c 8c]
Ahangama: folds 
ljryviltj: folds 
yats87: folds 
beluccix: folds 
Otsime: folds 
vano7777: folds 
50CandyJoe: folds 
etny99: folds 
Uncalled bet (€0.25) returned to matiko09
matiko09 collected €0.50 from pot
matiko09: doesn't show hand 
*** SUMMARY ***
Total pot €0.50 | Rake €0 
Seat 1: ljryviltj folded before Flop (didn't bet)
Seat 2: yats87 folded before Flop (didn't bet)
Seat 3: beluccix folded before Flop (didn't bet)
Seat 4: Otsime folded before Flop (didn't bet)
Seat 5: vano7777 folded before Flop (didn't bet)
Seat 6: 50CandyJoe (button) folded before Flop (didn't bet)
Seat 7: etny99 (small blind) folded before Flop
Seat 8: matiko09 (big blind) collected (€0.50)
Seat 9: Ahangama folded before Flop (didn't bet)





PokerStars Hand #148832936224:  Hold'em No Limit ($0.50/$1.00 USD) - 2016/02/15 11:00:45 CET [2016/02/15 5:00:45 ET]
Table 'Nata II' 9-max Seat #9 is the button
Seat 6: Arhistrareg ($50.89 in chips) 
Seat 7: er13to ($109.71 in chips) 
Seat 8: Igor DoUrden ($105 in chips) 
Seat 9: matiko09 ($100 in chips) 
Priidix will be allowed to play after the button
qqcom will be allowed to play after the button
Arhistrareg: posts small blind $0.50
er13to: posts big blind $1
*** HOLE CARDS ***
Dealt to matiko09 [5s 5h]
Igor DoUrden: raises $1.25 to $2.25
matiko09: calls $2.25
Arhistrareg: raises $7.75 to $10
er13to: folds 
Igor DoUrden: folds 
matiko09: folds 
Uncalled bet ($7.75) returned to Arhistrareg
Arhistrareg collected $7.75 from pot
Arhistrareg: doesn't show hand 
*** SUMMARY ***
Total pot $7.75 | Rake $0 
Seat 6: Arhistrareg (small blind) collected ($7.75)
Seat 7: er13to (big blind) folded before Flop
Seat 8: Igor DoUrden folded before Flop
Seat 9: matiko09 (button) folded before Flop





PokerStars Hand #148832937217:  Hold'em No Limit ($0.25/$0.50 USD) - 2016/02/15 11:00:48 CET [2016/02/15 5:00:48 ET]
Table 'Eltigen II' 9-max Seat #8 is the button
Seat 1: ljryviltj ($52.83 in chips) 
Seat 2: matiko09 ($56.49 in chips) 
Seat 3: injener ($51.09 in chips) 
Seat 4: beluccix ($51.25 in chips) 
Seat 5: R@/\//\/Y305 ($11.80 in chips) 
Seat 6: Prettyspitz ($50 in chips) 
Seat 7: SerAlGog ($50 in chips) 
Seat 8: Aoki42 ($50 in chips) 
Seat 9: Deepak.D ($58.94 in chips) 
Deepak.D: posts small blind $0.25
ljryviltj: posts big blind $0.50
*** HOLE CARDS ***
Dealt to matiko09 [Ah 7d]
matiko09: folds 
injener: folds 
beluccix: folds 
R@/\//\/Y305: folds 
Prettyspitz: folds 
SerAlGog: folds 
Aoki42: folds 
Deepak.D: raises $1 to $1.50
ljryviltj: folds 
Uncalled bet ($1) returned to Deepak.D
Deepak.D collected $1 from pot
Deepak.D: doesn't show hand 
*** SUMMARY ***
Total pot $1 | Rake $0 
Seat 1: ljryviltj (big blind) folded before Flop
Seat 2: matiko09 folded before Flop (didn't bet)
Seat 3: injener folded before Flop (didn't bet)
Seat 4: beluccix folded before Flop (didn't bet)
Seat 5: R@/\//\/Y305 folded before Flop (didn't bet)
Seat 6: Prettyspitz folded before Flop (didn't bet)
Seat 7: SerAlGog folded before Flop (didn't bet)
Seat 8: Aoki42 (button) folded before Flop (didn't bet)
Seat 9: Deepak.D (small blind) collected ($1)





PokerStars Hand #148832940680:  Hold'em No Limit (€0.50/€1.00 EUR) - 2016/02/15 11:00:56 CET [2016/02/15 5:00:56 ET]
Table 'Ganesa II' 9-max Seat #5 is the button
Seat 2: maxxmeister (€102.61 in chips) 
Seat 4: Sreshta222 (€100 in chips) 
Seat 5: vano7777 (€75.24 in chips) 
Seat 6: matiko09 (€101.39 in chips) 
Seat 7: er13to (€106.03 in chips) 
matiko09: posts small blind €0.50
er13to: posts big blind €1
mycka86: sits out 
Priidix: sits out 
*** HOLE CARDS ***
Dealt to matiko09 [Qc 6s]
maxxmeister: folds 
Sreshta222: folds 
vano7777: folds 
matiko09: folds 
Uncalled bet (€0.50) returned to er13to
er13to collected €1 from pot
*** SUMMARY ***
Total pot €1 | Rake €0 
Seat 2: maxxmeister folded before Flop (didn't bet)
Seat 4: Sreshta222 folded before Flop (didn't bet)
Seat 5: vano7777 (button) folded before Flop (didn't bet)
Seat 6: matiko09 (small blind) folded before Flop
Seat 7: er13to (big blind) collected (€1)





PokerStars Hand #148832947876:  Hold'em No Limit (€0.50/€1.00 EUR) - 2016/02/15 11:01:14 CET [2016/02/15 5:01:14 ET]
Table 'Ganesa II' 9-max Seat #6 is the button
Seat 2: maxxmeister (€102.61 in chips) 
Seat 3: BuBu 0187 (€78.70 in chips) 
Seat 4: Sreshta222 (€100 in chips) 
Seat 5: vano7777 (€75.24 in chips) 
Seat 6: matiko09 (€100.89 in chips) 
Seat 7: er13to (€106.53 in chips) 
Seat 8: mycka86 (€100 in chips) 
er13to: posts small blind €0.50
mycka86: posts big blind €1
Priidix: sits out 
*** HOLE CARDS ***
Dealt to matiko09 [5h Kh]
maxxmeister: raises €2 to €3
BuBu 0187: folds 
Sreshta222: folds 
vano7777: folds 
matiko09: folds 
er13to: folds 
mycka86: folds 
Uncalled bet (€2) returned to maxxmeister
maxxmeister collected €2.50 from pot
maxxmeister: doesn't show hand 
*** SUMMARY ***
Total pot €2.50 | Rake €0 
Seat 2: maxxmeister collected (€2.50)
Seat 3: BuBu 0187 folded before Flop (didn't bet)
Seat 4: Sreshta222 folded before Flop (didn't bet)
Seat 5: vano7777 folded before Flop (didn't bet)
Seat 6: matiko09 (button) folded before Flop (didn't bet)
Seat 7: er13to (small blind) folded before Flop
Seat 8: mycka86 (big blind) folded before Flop





PokerStars Hand #148832948580:  Hold'em No Limit (€0.25/€0.50 EUR) - 2016/02/15 11:01:16 CET [2016/02/15 5:01:16 ET]
Table 'Walinskia II' 9-max Seat #7 is the button
Seat 1: ljryviltj (€50.34 in chips) 
Seat 2: yats87 (€56.45 in chips) 
Seat 3: beluccix (€26.39 in chips) 
Seat 4: Otsime (€45.86 in chips) 
Seat 5: vano7777 (€66.30 in chips) 
Seat 6: 50CandyJoe (€67.79 in chips) 
Seat 7: etny99 (€50 in chips) 
Seat 8: matiko09 (€55.26 in chips) 
Seat 9: Ahangama (€52.54 in chips) 
matiko09: posts small blind €0.25
Ahangama: posts big blind €0.50
*** HOLE CARDS ***
Dealt to matiko09 [5h Jd]
ljryviltj: folds 
yats87: folds 
beluccix: folds 
Otsime: folds 
vano7777: folds 
50CandyJoe: folds 
etny99: raises €0.50 to €1
matiko09: folds 
Ahangama: raises €3.25 to €4.25
etny99: folds 
Uncalled bet (€3.25) returned to Ahangama
Ahangama collected €2.25 from pot
Ahangama: doesn't show hand 
*** SUMMARY ***
Total pot €2.25 | Rake €0 
Seat 1: ljryviltj folded before Flop (didn't bet)
Seat 2: yats87 folded before Flop (didn't bet)
Seat 3: beluccix folded before Flop (didn't bet)
Seat 4: Otsime folded before Flop (didn't bet)
Seat 5: vano7777 folded before Flop (didn't bet)
Seat 6: 50CandyJoe folded before Flop (didn't bet)
Seat 7: etny99 (button) folded before Flop
Seat 8: matiko09 (small blind) folded before Flop
Seat 9: Ahangama (big blind) collected (€2.25)





PokerStars Hand #148832948728:  Hold'em No Limit ($0.25/$0.50 USD) - 2016/02/15 11:01:16 CET [2016/02/15 5:01:16 ET]
Table 'Vesta II' 9-max Seat #9 is the button
Seat 1: Ahangama ($90.55 in chips) 
Seat 2: i L00K great ($56.22 in chips) 
Seat 3: matiko09 ($76.45 in chips) 
Seat 5: dndngod ($76.90 in chips) 
Seat 7: ruyingren ($24.79 in chips) 
Seat 8: Arystan ($81.88 in chips) 
Seat 9: Aoki42 ($73.51 in chips) 
Ahangama: posts small blind $0.25
i L00K great: posts big blind $0.50
vlad11122007: sits out 
pandalapa: sits out 
*** HOLE CARDS ***
Dealt to matiko09 [4c 9c]
matiko09: folds 
dndngod: folds 
ruyingren: raises $1 to $1.50
Arystan: raises $2 to $3.50
Aoki42: folds 
Ahangama: calls $3.25
i L00K great: folds 
ruyingren: calls $2
*** FLOP *** [Th Kh Ks]
Ahangama: checks 
ruyingren: bets $10.50
Arystan: folds 
Ahangama: folds 
Uncalled bet ($10.50) returned to ruyingren
ruyingren collected $10.50 from pot
ruyingren: doesn't show hand 
*** SUMMARY ***
Total pot $11 | Rake $0.50 
Board [Th Kh Ks]
Seat 1: Ahangama (small blind) folded on the Flop
Seat 2: i L00K great (big blind) folded before Flop
Seat 3: matiko09 folded before Flop (didn't bet)
Seat 5: dndngod folded before Flop (didn't bet)
Seat 7: ruyingren collected ($10.50)
Seat 8: Arystan folded on the Flop
Seat 9: Aoki42 (button) folded before Flop (didn't bet)





PokerStars Hand #148832949366:  Hold'em No Limit ($0.50/$1.00 USD) - 2016/02/15 11:01:18 CET [2016/02/15 5:01:18 ET]
Table 'Corvus III' 9-max Seat #4 is the button
Seat 1: agritom ($250.92 in chips) 
Seat 4: goransyruvka ($75.14 in chips) 
Seat 5: koib88 ($307.75 in chips) 
Seat 6: Priidix ($100 in chips) 
Seat 7: matiko09 ($214.46 in chips) 
Seat 8: redacesfull ($175.71 in chips) 
Seat 9: er13to ($100 in chips) 
koib88: posts small blind $0.50
Priidix: posts big blind $1
agritom: posts the ante $0.20
goransyruvka: posts the ante $0.20
koib88: posts the ante $0.20
Priidix: posts the ante $0.20
matiko09: posts the ante $0.20
redacesfull: posts the ante $0.20
er13to: posts the ante $0.20
*** HOLE CARDS ***
Dealt to matiko09 [6c 6d]
matiko09: raises $2 to $3
redacesfull: calls $3
er13to: folds 
agritom: calls $3
goransyruvka: calls $3
koib88: calls $2.50
Priidix: calls $2
*** FLOP *** [Qc Qs Ks]
koib88: checks 
Priidix: checks 
matiko09: checks 
redacesfull: bets $12
agritom: folds 
goransyruvka: folds 
koib88: folds 
Priidix: folds 
matiko09: folds 
Uncalled bet ($12) returned to redacesfull
redacesfull collected $18.53 from pot
*** SUMMARY ***
Total pot $19.40 | Rake $0.87 
Board [Qc Qs Ks]
Seat 1: agritom folded on the Flop
Seat 4: goransyruvka (button) folded on the Flop
Seat 5: koib88 (small blind) folded on the Flop
Seat 6: Priidix (big blind) folded on the Flop
Seat 7: matiko09 folded on the Flop
Seat 8: redacesfull collected ($18.53)
Seat 9: er13to folded before Flop (didn't bet)





PokerStars Hand #148832950159:  Hold'em No Limit ($0.50/$1.00 USD) - 2016/02/15 11:01:19 CET [2016/02/15 5:01:19 ET]
Table 'Nata II' 9-max Seat #6 is the button
Seat 2: qqcom ($100 in chips) 
Seat 6: Arhistrareg ($56.39 in chips) 
Seat 7: er13to ($108.71 in chips) 
Seat 8: Igor DoUrden ($102.75 in chips) 
Seat 9: matiko09 ($100 in chips) 
er13to: posts small blind $0.50
Igor DoUrden: posts big blind $1
Priidix: sits out 
qqcom: posts big blind $1
*** HOLE CARDS ***
Dealt to matiko09 [9s 2d]
matiko09: folds 
qqcom: raises $2.50 to $3.50
g00000se joins the table at seat #3 
Arhistrareg: calls $3.50
er13to: folds 
Igor DoUrden: folds 
*** FLOP *** [Tc Th 3s]
qqcom: bets $4.06
Arhistrareg: folds 
Uncalled bet ($4.06) returned to qqcom
qqcom collected $8.12 from pot
*** SUMMARY ***
Total pot $8.50 | Rake $0.38 
Board [Tc Th 3s]
Seat 2: qqcom collected ($8.12)
Seat 6: Arhistrareg (button) folded on the Flop
Seat 7: er13to (small blind) folded before Flop
Seat 8: Igor DoUrden (big blind) folded before Flop
Seat 9: matiko09 folded before Flop (didn't bet)





PokerStars Hand #148832951722:  Hold'em No Limit ($0.50/$1.00 USD) - 2016/02/15 11:01:23 CET [2016/02/15 5:01:23 ET]
Table 'Gemma II' 9-max Seat #5 is the button
Seat 1: Igor DoUrden ($177.84 in chips) 
Seat 2: er13to ($142.68 in chips) 
Seat 3: Venomous100% ($159.66 in chips) 
Seat 4: mycka86 ($100 in chips) 
Seat 5: PokerSash201 ($63.25 in chips) 
Seat 6: IHouseMusic ($100 in chips) 
Seat 7: AlKatrone ($116.77 in chips) 
Seat 8: vrnMike ($134.45 in chips) 
Seat 9: matiko09 ($100 in chips) 
IHouseMusic: posts small blind $0.50
AlKatrone: posts big blind $1
*** HOLE CARDS ***
Dealt to matiko09 [Kd Ts]
vrnMike: folds 
matiko09: folds 
Igor DoUrden: folds 
er13to: folds 
Venomous100%: folds 
mycka86: folds 
PokerSash201: folds 
IHouseMusic: folds 
Uncalled bet ($0.50) returned to AlKatrone
AlKatrone collected $1 from pot
AlKatrone: doesn't show hand 
*** SUMMARY ***
Total pot $1 | Rake $0 
Seat 1: Igor DoUrden folded before Flop (didn't bet)
Seat 2: er13to folded before Flop (didn't bet)
Seat 3: Venomous100% folded before Flop (didn't bet)
Seat 4: mycka86 folded before Flop (didn't bet)
Seat 5: PokerSash201 (button) folded before Flop (didn't bet)
Seat 6: IHouseMusic (small blind) folded before Flop
Seat 7: AlKatrone (big blind) collected ($1)
Seat 8: vrnMike folded before Flop (didn't bet)
Seat 9: matiko09 folded before Flop (didn't bet)





PokerStars Hand #148832953010:  Hold'em No Limit ($0.50/$1.00 USD) - 2016/02/15 11:01:26 CET [2016/02/15 5:01:26 ET]
Table 'Euanthe II' 9-max Seat #1 is the button
Seat 1: maxxmeister ($129.94 in chips) 
Seat 2: mycka86 ($186.34 in chips) 
Seat 3: Sreshta222 ($100 in chips) 
Seat 4: er13to ($114.58 in chips) 
Seat 5: vrnMike ($178.64 in chips) 
Seat 7: vinniesmol ($217.59 in chips) 
Seat 8: matiko09 ($123.79 in chips) 
Seat 9: Venomous100% ($100 in chips) 
mycka86: posts small blind $0.50
Sreshta222: posts big blind $1
*** HOLE CARDS ***
Dealt to matiko09 [4h Js]
er13to: folds 
vrnMike: folds 
vinniesmol: folds 
matiko09: folds 
Venomous100%: folds 
maxxmeister: raises $2 to $3
mycka86: raises $6.50 to $9.50
Sreshta222: folds 
maxxmeister: folds 
Uncalled bet ($6.50) returned to mycka86
mycka86 collected $7 from pot
*** SUMMARY ***
Total pot $7 | Rake $0 
Seat 1: maxxmeister (button) folded before Flop
Seat 2: mycka86 (small blind) collected ($7)
Seat 3: Sreshta222 (big blind) folded before Flop
Seat 4: er13to folded before Flop (didn't bet)
Seat 5: vrnMike folded before Flop (didn't bet)
Seat 7: vinniesmol folded before Flop (didn't bet)
Seat 8: matiko09 folded before Flop (didn't bet)
Seat 9: Venomous100% folded before Flop (didn't bet)





PokerStars Hand #148832954280:  Hold'em No Limit ($0.25/$0.50 USD) - 2016/02/15 11:01:29 CET [2016/02/15 5:01:29 ET]
Table 'Laertes II' 9-max Seat #8 is the button
Seat 1: dade33 ($98.89 in chips) 
Seat 2: beluccix ($24.21 in chips) 
Seat 3: ljryviltj ($55.37 in chips) 
Seat 4: rgar93 ($40.63 in chips) 
Seat 5: vlad11122007 ($48.25 in chips) 
Seat 6: yats87 ($60.91 in chips) 
Seat 7: Vedpapa ($52.33 in chips) 
Seat 8: Trent444 ($44.28 in chips) 
Seat 9: matiko09 ($50 in chips) 
matiko09: posts small blind $0.25
dade33: posts big blind $0.50
*** HOLE CARDS ***
Dealt to matiko09 [5c Td]
beluccix: folds 
ljryviltj: folds 
rgar93: calls $0.50
vlad11122007: folds 
yats87: folds 
Vedpapa: raises $1.75 to $2.25
Trent444: folds 
matiko09: folds 
dade33: folds 
rgar93: calls $1.75
*** FLOP *** [Ah Ad 5s]
rgar93: checks 
Vedpapa: checks 
*** TURN *** [Ah Ad 5s] [Kh]
rgar93: checks 
Vedpapa: bets $3.75
rgar93: calls $3.75
*** RIVER *** [Ah Ad 5s Kh] [5h]
rgar93: checks 
Vedpapa: checks 
*** SHOW DOWN ***
rgar93: shows [Ac 4c] (a full house, Aces full of Fives)
Vedpapa: shows [Qd As] (a full house, Aces full of Fives)
rgar93 collected $6.09 from pot
Vedpapa collected $6.09 from pot
*** SUMMARY ***
Total pot $12.75 | Rake $0.57 
Board [Ah Ad 5s Kh 5h]
Seat 1: dade33 (big blind) folded before Flop
Seat 2: beluccix folded before Flop (didn't bet)
Seat 3: ljryviltj folded before Flop (didn't bet)
Seat 4: rgar93 showed [Ac 4c] and won ($6.09) with a full house, Aces full of Fives
Seat 5: vlad11122007 folded before Flop (didn't bet)
Seat 6: yats87 folded before Flop (didn't bet)
Seat 7: Vedpapa showed [Qd As] and won ($6.09) with a full house, Aces full of Fives
Seat 8: Trent444 (button) folded before Flop (didn't bet)
Seat 9: matiko09 (small blind) folded before Flop





PokerStars Hand #148832960223:  Hold'em No Limit ($0.50/$1.00 USD) - 2016/02/15 11:01:43 CET [2016/02/15 5:01:43 ET]
Table 'Gemma II' 9-max Seat #6 is the button
Seat 1: Igor DoUrden ($177.84 in chips) 
Seat 2: er13to ($142.68 in chips) 
Seat 3: Venomous100% ($159.66 in chips) 
Seat 4: mycka86 ($100 in chips) 
Seat 5: PokerSash201 ($63.25 in chips) 
Seat 6: IHouseMusic ($100 in chips) 
Seat 7: AlKatrone ($117.27 in chips) 
Seat 9: matiko09 ($100 in chips) 
AlKatrone: posts small blind $0.50
vrnMike: is sitting out 
vrnMike leaves the table
matiko09: posts big blind $1
*** HOLE CARDS ***
Dealt to matiko09 [Ah Js]
Igor DoUrden: folds 
er13to: folds 
Venomous100%: folds 
Priidix joins the table at seat #8 
mycka86: folds 
PokerSash201: folds 
IHouseMusic: folds 
AlKatrone: raises $2 to $3
matiko09: calls $2
*** FLOP *** [3d 2h 9d]
AlKatrone: checks 
matiko09: checks 
*** TURN *** [3d 2h 9d] [7c]
AlKatrone: bets $5.09
matiko09: folds 
Uncalled bet ($5.09) returned to AlKatrone
AlKatrone collected $5.73 from pot
AlKatrone: doesn't show hand 
*** SUMMARY ***
Total pot $6 | Rake $0.27 
Board [3d 2h 9d 7c]
Seat 1: Igor DoUrden folded before Flop (didn't bet)
Seat 2: er13to folded before Flop (didn't bet)
Seat 3: Venomous100% folded before Flop (didn't bet)
Seat 4: mycka86 folded before Flop (didn't bet)
Seat 5: PokerSash201 folded before Flop (didn't bet)
Seat 6: IHouseMusic (button) folded before Flop (didn't bet)
Seat 7: AlKatrone (small blind) collected ($5.73)
Seat 9: matiko09 (big blind) folded on the Turn





PokerStars Hand #148832960590:  Hold'em No Limit ($0.50/$1.00 USD) - 2016/02/15 11:01:44 CET [2016/02/15 5:01:44 ET]
Table 'Anteros' 9-max Seat #7 is the button
Seat 1: redacesfull ($100 in chips) 
Seat 2: IHouseMusic ($111.06 in chips) 
Seat 4: misherei ($193.44 in chips) 
Seat 5: Holm1991 ($70.98 in chips) 
Seat 6: SerAlGog ($116.36 in chips) 
Seat 7: Zoubou1983 ($165.48 in chips) 
Seat 8: matiko09 ($103.14 in chips) 
matiko09: posts small blind $0.50
vrnMike: is sitting out 
redacesfull: posts big blind $1
vrnMike leaves the table
er13to: sits out 
*** HOLE CARDS ***
Dealt to matiko09 [7c 9c]
IHouseMusic: folds 
misherei: folds 
mycka86 joins the table at seat #9 
Holm1991: folds 
SerAlGog: folds 
Zoubou1983: calls $1
matiko09: raises $4 to $5
redacesfull: folds 
Zoubou1983: folds 
Uncalled bet ($4) returned to matiko09
matiko09 collected $3 from pot
matiko09: doesn't show hand 
*** SUMMARY ***
Total pot $3 | Rake $0 
Seat 1: redacesfull (big blind) folded before Flop
Seat 2: IHouseMusic folded before Flop (didn't bet)
Seat 4: misherei folded before Flop (didn't bet)
Seat 5: Holm1991 folded before Flop (didn't bet)
Seat 6: SerAlGog folded before Flop (didn't bet)
Seat 7: Zoubou1983 (button) folded before Flop
Seat 8: matiko09 (small blind) collected ($3)





PokerStars Hand #148832961177:  Hold'em No Limit ($0.50/$1.00 USD) - 2016/02/15 11:01:46 CET [2016/02/15 5:01:46 ET]
Table 'Nata II' 9-max Seat #7 is the button
Seat 2: qqcom ($104.62 in chips) 
Seat 6: Arhistrareg ($52.89 in chips) 
Seat 7: er13to ($108.21 in chips) 
Seat 8: Igor DoUrden ($101.75 in chips) 
Seat 9: matiko09 ($100 in chips) 
Igor DoUrden: posts small blind $0.50
matiko09: posts big blind $1
Priidix: sits out 
g00000se: sits out 
*** HOLE CARDS ***
Dealt to matiko09 [9d Th]
qqcom: folds 
Arhistrareg: folds 
er13to: raises $1.50 to $2.50
Igor DoUrden: folds 
matiko09: calls $1.50
*** FLOP *** [Tc 3s Jh]
matiko09: checks 
er13to: checks 
*** TURN *** [Tc 3s Jh] [4c]
AGoodFell4 joins the table at seat #5 
matiko09: checks 
er13to: bets $2.88
matiko09: calls $2.88
*** RIVER *** [Tc 3s Jh 4c] [3h]
matiko09: checks 
er13to: checks 
*** SHOW DOWN ***
matiko09: shows [9d Th] (two pair, Tens and Threes)
er13to: mucks hand 
matiko09 collected $10.75 from pot
*** SUMMARY ***
Total pot $11.26 | Rake $0.51 
Board [Tc 3s Jh 4c 3h]
Seat 2: qqcom folded before Flop (didn't bet)
Seat 6: Arhistrareg folded before Flop (didn't bet)
Seat 7: er13to (button) mucked [6d 6h]
Seat 8: Igor DoUrden (small blind) folded before Flop
Seat 9: matiko09 (big blind) showed [9d Th] and won ($10.75) with two pair, Tens and Threes





PokerStars Hand #148832966173:  Hold'em No Limit (€0.50/€1.00 EUR) - 2016/02/15 11:01:57 CET [2016/02/15 5:01:57 ET]
Table 'Ganesa II' 9-max Seat #7 is the button
Seat 2: maxxmeister (€104.11 in chips) 
Seat 3: BuBu 0187 (€78.70 in chips) 
Seat 4: Sreshta222 (€100 in chips) 
Seat 5: vano7777 (€75.24 in chips) 
Seat 6: matiko09 (€100.89 in chips) 
Seat 7: er13to (€106.03 in chips) 
Seat 8: mycka86 (€100 in chips) 
Seat 9: Priidix (€100 in chips) 
mycka86: posts small blind €0.50
Priidix: posts big blind €1
*** HOLE CARDS ***
Dealt to matiko09 [3h 5d]
maxxmeister: folds 
BuBu 0187: folds 
Sreshta222: raises €1.50 to €2.50
vano7777: folds 
matiko09: folds 
er13to: calls €2.50
mycka86: folds 
Priidix: folds 
*** FLOP *** [4c 6c Kd]
Sreshta222: bets €4.13
er13to: calls €4.13
*** TURN *** [4c 6c Kd] [8d]
Sreshta222: checks 
er13to: checks 
*** RIVER *** [4c 6c Kd 8d] [8s]
Sreshta222: checks 
er13to: checks 
*** SHOW DOWN ***
Sreshta222: shows [Js Ad] (a pair of Eights)
er13to: shows [9s 9c] (two pair, Nines and Eights)
er13to collected €14.10 from pot
*** SUMMARY ***
Total pot €14.76 | Rake €0.66 
Board [4c 6c Kd 8d 8s]
Seat 2: maxxmeister folded before Flop (didn't bet)
Seat 3: BuBu 0187 folded before Flop (didn't bet)
Seat 4: Sreshta222 showed [Js Ad] and lost with a pair of Eights
Seat 5: vano7777 folded before Flop (didn't bet)
Seat 6: matiko09 folded before Flop (didn't bet)
Seat 7: er13to (button) showed [9s 9c] and won (€14.10) with two pair, Nines and Eights
Seat 8: mycka86 (small blind) folded before Flop
Seat 9: Priidix (big blind) folded before Flop





PokerStars Hand #148832968369:  Hold'em No Limit ($0.50/$1.00 USD) - 2016/02/15 11:02:02 CET [2016/02/15 5:02:02 ET]
Table 'Euanthe II' 9-max Seat #2 is the button
Seat 1: maxxmeister ($126.94 in chips) 
Seat 2: mycka86 ($190.34 in chips) 
Seat 3: Sreshta222 ($100 in chips) 
Seat 4: er13to ($114.58 in chips) 
Seat 5: vrnMike ($178.64 in chips) 
Seat 7: vinniesmol ($217.59 in chips) 
Seat 8: matiko09 ($123.79 in chips) 
Seat 9: Venomous100% ($100 in chips) 
Sreshta222: posts small blind $0.50
er13to: posts big blind $1
*** HOLE CARDS ***
Dealt to matiko09 [2d 6c]
vrnMike: folds 
vinniesmol: folds 
matiko09: folds 
Venomous100%: folds 
maxxmeister: raises $2 to $3
mycka86: folds 
Sreshta222: folds 
er13to: folds 
Uncalled bet ($2) returned to maxxmeister
maxxmeister collected $2.50 from pot
maxxmeister: doesn't show hand 
*** SUMMARY ***
Total pot $2.50 | Rake $0 
Seat 1: maxxmeister collected ($2.50)
Seat 2: mycka86 (button) folded before Flop (didn't bet)
Seat 3: Sreshta222 (small blind) folded before Flop
Seat 4: er13to (big blind) folded before Flop
Seat 5: vrnMike folded before Flop (didn't bet)
Seat 7: vinniesmol folded before Flop (didn't bet)
Seat 8: matiko09 folded before Flop (didn't bet)
Seat 9: Venomous100% folded before Flop (didn't bet)





PokerStars Hand #148832972091:  Hold'em No Limit ($0.50/$1.00 USD) - 2016/02/15 11:02:11 CET [2016/02/15 5:02:11 ET]
Table 'Corvus III' 9-max Seat #5 is the button
Seat 1: agritom ($250 in chips) 
Seat 4: goransyruvka ($71.94 in chips) 
Seat 5: koib88 ($304.55 in chips) 
Seat 6: Priidix ($100 in chips) 
Seat 7: matiko09 ($211.26 in chips) 
Seat 8: redacesfull ($191.04 in chips) 
Seat 9: er13to ($100 in chips) 
Priidix: posts small blind $0.50
matiko09: posts big blind $1
agritom: posts the ante $0.20
goransyruvka: posts the ante $0.20
koib88: posts the ante $0.20
Priidix: posts the ante $0.20
matiko09: posts the ante $0.20
redacesfull: posts the ante $0.20
er13to: posts the ante $0.20
*** HOLE CARDS ***
Dealt to matiko09 [Ts 9h]
redacesfull: folds 
er13to: folds 
agritom: folds 
goransyruvka: folds 
koib88: calls $1
Priidix: raises $4.40 to $5.40
matiko09: folds 
koib88: folds 
Uncalled bet ($4.40) returned to Priidix
Priidix collected $4.40 from pot
Priidix: doesn't show hand 
*** SUMMARY ***
Total pot $4.40 | Rake $0 
Seat 1: agritom folded before Flop (didn't bet)
Seat 4: goransyruvka folded before Flop (didn't bet)
Seat 5: koib88 (button) folded before Flop
Seat 6: Priidix (small blind) collected ($4.40)
Seat 7: matiko09 (big blind) folded before Flop
Seat 8: redacesfull folded before Flop (didn't bet)
Seat 9: er13to folded before Flop (didn't bet)





PokerStars Hand #148832973952:  Hold'em No Limit (€0.25/€0.50 EUR) - 2016/02/15 11:02:15 CET [2016/02/15 5:02:15 ET]
Table 'Walinskia II' 9-max Seat #8 is the button
Seat 1: ljryviltj (€50.34 in chips) 
Seat 2: yats87 (€56.45 in chips) 
Seat 3: beluccix (€26.39 in chips) 
Seat 4: Otsime (€45.86 in chips) 
Seat 5: vano7777 (€66.30 in chips) 
Seat 6: 50CandyJoe (€67.79 in chips) 
Seat 7: etny99 (€50 in chips) 
Seat 8: matiko09 (€55.01 in chips) 
Seat 9: Ahangama (€53.79 in chips) 
Ahangama: posts small blind €0.25
ljryviltj: posts big blind €0.50
*** HOLE CARDS ***
Dealt to matiko09 [2s Ts]
yats87: folds 
beluccix: folds 
Otsime: folds 
vano7777: folds 
50CandyJoe: raises €1 to €1.50
etny99: folds 
matiko09: folds 
Ahangama: folds 
ljryviltj: folds 
Uncalled bet (€1) returned to 50CandyJoe
50CandyJoe collected €1.25 from pot
50CandyJoe: doesn't show hand 
*** SUMMARY ***
Total pot €1.25 | Rake €0 
Seat 1: ljryviltj (big blind) folded before Flop
Seat 2: yats87 folded before Flop (didn't bet)
Seat 3: beluccix folded before Flop (didn't bet)
Seat 4: Otsime folded before Flop (didn't bet)
Seat 5: vano7777 folded before Flop (didn't bet)
Seat 6: 50CandyJoe collected (€1.25)
Seat 7: etny99 folded before Flop (didn't bet)
Seat 8: matiko09 (button) folded before Flop (didn't bet)
Seat 9: Ahangama (small blind) folded before Flop





PokerStars Hand #148832976264:  Hold'em No Limit ($0.25/$0.50 USD) - 2016/02/15 11:02:21 CET [2016/02/15 5:02:21 ET]
Table 'Vesta II' 9-max Seat #1 is the button
Seat 1: Ahangama ($87.05 in chips) 
Seat 2: i L00K great ($55.72 in chips) 
Seat 3: matiko09 ($76.45 in chips) 
Seat 5: dndngod ($76.90 in chips) 
Seat 7: ruyingren ($31.79 in chips) 
Seat 8: Arystan ($78.38 in chips) 
Seat 9: Aoki42 ($73.51 in chips) 
i L00K great: posts small blind $0.25
matiko09: posts big blind $0.50
vlad11122007: sits out 
pandalapa: sits out 
*** HOLE CARDS ***
Dealt to matiko09 [Kh Tc]
dndngod: folds 
ruyingren: folds 
Arystan: folds 
Aoki42: folds 
Ahangama: raises $0.50 to $1
i L00K great: folds 
matiko09: calls $0.50
*** FLOP *** [Td 2s 5c]
matiko09: checks 
Ahangama: bets $1.25
matiko09: calls $1.25
*** TURN *** [Td 2s 5c] [Jd]
matiko09: checks 
Ahangama: checks 
*** RIVER *** [Td 2s 5c Jd] [Ah]
matiko09: checks 
Ahangama: checks 
*** SHOW DOWN ***
matiko09: shows [Kh Tc] (a pair of Tens)
Ahangama: shows [4h Ac] (a pair of Aces)
Ahangama collected $4.54 from pot
*** SUMMARY ***
Total pot $4.75 | Rake $0.21 
Board [Td 2s 5c Jd Ah]
Seat 1: Ahangama (button) showed [4h Ac] and won ($4.54) with a pair of Aces
Seat 2: i L00K great (small blind) folded before Flop
Seat 3: matiko09 (big blind) showed [Kh Tc] and lost with a pair of Tens
Seat 5: dndngod folded before Flop (didn't bet)
Seat 7: ruyingren folded before Flop (didn't bet)
Seat 8: Arystan folded before Flop (didn't bet)
Seat 9: Aoki42 folded before Flop (didn't bet)





PokerStars Hand #148832977436:  Hold'em No Limit ($0.50/$1.00 USD) - 2016/02/15 11:02:24 CET [2016/02/15 5:02:24 ET]
Table 'Anteros' 9-max Seat #8 is the button
Seat 1: redacesfull ($100 in chips) 
Seat 2: IHouseMusic ($111.06 in chips) 
Seat 4: misherei ($193.44 in chips) 
Seat 5: Holm1991 ($70.98 in chips) 
Seat 6: SerAlGog ($116.36 in chips) 
Seat 7: Zoubou1983 ($164.48 in chips) 
Seat 8: matiko09 ($105.14 in chips) 
mycka86 will be allowed to play after the button
redacesfull: posts small blind $0.50
IHouseMusic: posts big blind $1
er13to: sits out 
*** HOLE CARDS ***
Dealt to matiko09 [7c 3h]
misherei: folds 
Holm1991: folds 
SerAlGog: raises $1.50 to $2.50
Zoubou1983: folds 
matiko09: folds 
redacesfull: folds 
IHouseMusic: folds 
Uncalled bet ($1.50) returned to SerAlGog
SerAlGog collected $2.50 from pot
SerAlGog: doesn't show hand 
*** SUMMARY ***
Total pot $2.50 | Rake $0 
Seat 1: redacesfull (small blind) folded before Flop
Seat 2: IHouseMusic (big blind) folded before Flop
Seat 4: misherei folded before Flop (didn't bet)
Seat 5: Holm1991 folded before Flop (didn't bet)
Seat 6: SerAlGog collected ($2.50)
Seat 7: Zoubou1983 folded before Flop (didn't bet)
Seat 8: matiko09 (button) folded before Flop (didn't bet)





PokerStars Hand #148832982178:  Hold'em No Limit ($0.50/$1.00 USD) - 2016/02/15 11:02:35 CET [2016/02/15 5:02:35 ET]
Table 'Euanthe II' 9-max Seat #3 is the button
Seat 1: maxxmeister ($128.44 in chips) 
Seat 2: mycka86 ($190.34 in chips) 
Seat 3: Sreshta222 ($100 in chips) 
Seat 4: er13to ($113.58 in chips) 
Seat 7: vinniesmol ($217.59 in chips) 
Seat 8: matiko09 ($123.79 in chips) 
Seat 9: Venomous100% ($100 in chips) 
er13to: posts small blind $0.50
vrnMike: is sitting out 
vinniesmol: posts big blind $1
*** HOLE CARDS ***
Dealt to matiko09 [2c Ac]
vrnMike leaves the table
matiko09: folds 
Venomous100%: folds 
maxxmeister: folds 
mycka86: raises $1.10 to $2.10
Sreshta222: folds 
er13to: folds 
vinniesmol: folds 
Uncalled bet ($1.10) returned to mycka86
mycka86 collected $2.50 from pot
*** SUMMARY ***
Total pot $2.50 | Rake $0 
Seat 1: maxxmeister folded before Flop (didn't bet)
Seat 2: mycka86 collected ($2.50)
Seat 3: Sreshta222 (button) folded before Flop (didn't bet)
Seat 4: er13to (small blind) folded before Flop
Seat 7: vinniesmol (big blind) folded before Flop
Seat 8: matiko09 folded before Flop (didn't bet)
Seat 9: Venomous100% folded before Flop (didn't bet)





PokerStars Hand #148832983270:  Hold'em No Limit ($0.50/$1.00 USD) - 2016/02/15 11:02:38 CET [2016/02/15 5:02:38 ET]
Table 'Corvus III' 9-max Seat #6 is the button
Seat 1: agritom ($250 in chips) 
Seat 4: goransyruvka ($71.74 in chips) 
Seat 5: koib88 ($303.35 in chips) 
Seat 6: Priidix ($103.20 in chips) 
Seat 7: matiko09 ($210.06 in chips) 
Seat 8: redacesfull ($190.84 in chips) 
Seat 9: er13to ($100 in chips) 
matiko09: posts small blind $0.50
redacesfull: posts big blind $1
agritom: posts the ante $0.20
goransyruvka: posts the ante $0.20
koib88: posts the ante $0.20
Priidix: posts the ante $0.20
matiko09: posts the ante $0.20
redacesfull: posts the ante $0.20
er13to: posts the ante $0.20
*** HOLE CARDS ***
Dealt to matiko09 [6c 2d]
er13to: folds 
VanDobeln joins the table at seat #3 
agritom: folds 
goransyruvka: folds 
koib88: folds 
Priidix: folds 
matiko09: folds 
Uncalled bet ($0.50) returned to redacesfull
redacesfull collected $2.40 from pot
redacesfull: doesn't show hand 
*** SUMMARY ***
Total pot $2.40 | Rake $0 
Seat 1: agritom folded before Flop (didn't bet)
Seat 4: goransyruvka folded before Flop (didn't bet)
Seat 5: koib88 folded before Flop (didn't bet)
Seat 6: Priidix (button) folded before Flop (didn't bet)
Seat 7: matiko09 (small blind) folded before Flop
Seat 8: redacesfull (big blind) collected ($2.40)
Seat 9: er13to folded before Flop (didn't bet)





PokerStars Hand #148832984435:  Hold'em No Limit ($0.50/$1.00 USD) - 2016/02/15 11:02:40 CET [2016/02/15 5:02:40 ET]
Table 'Gemma II' 9-max Seat #7 is the button
Seat 1: Igor DoUrden ($177.84 in chips) 
Seat 2: er13to ($142.68 in chips) 
Seat 3: Venomous100% ($159.66 in chips) 
Seat 4: mycka86 ($100 in chips) 
Seat 5: PokerSash201 ($63.25 in chips) 
Seat 6: IHouseMusic ($100 in chips) 
Seat 7: AlKatrone ($120 in chips) 
Seat 9: matiko09 ($100 in chips) 
Priidix will be allowed to play after the button
matiko09: posts small blind $0.50
Igor DoUrden: posts big blind $1
*** HOLE CARDS ***
Dealt to matiko09 [7h 7d]
er13to: folds 
Venomous100%: raises $2 to $3
mycka86: folds 
PokerSash201: calls $3
IHouseMusic: folds 
AlKatrone: folds 
matiko09: calls $2.50
Igor DoUrden: folds 
*** FLOP *** [2s As 8h]
matiko09: checks 
Venomous100%: checks 
PokerSash201: checks 
*** TURN *** [2s As 8h] [Kd]
matiko09: checks 
Venomous100%: checks 
PokerSash201: checks 
*** RIVER *** [2s As 8h Kd] [4d]
matiko09: checks 
Venomous100%: checks 
PokerSash201: checks 
*** SHOW DOWN ***
matiko09: shows [7h 7d] (a pair of Sevens)
Venomous100%: mucks hand 
PokerSash201: mucks hand 
matiko09 collected $9.55 from pot
*** SUMMARY ***
Total pot $10 | Rake $0.45 
Board [2s As 8h Kd 4d]
Seat 1: Igor DoUrden (big blind) folded before Flop
Seat 2: er13to folded before Flop (didn't bet)
Seat 3: Venomous100% mucked [3d 3s]
Seat 4: mycka86 folded before Flop (didn't bet)
Seat 5: PokerSash201 mucked [6s 4s]
Seat 6: IHouseMusic folded before Flop (didn't bet)
Seat 7: AlKatrone (button) folded before Flop (didn't bet)
Seat 9: matiko09 (small blind) showed [7h 7d] and won ($9.55) with a pair of Sevens





PokerStars Hand #148832988949:  Hold'em No Limit ($0.50/$1.00 USD) - 2016/02/15 11:02:51 CET [2016/02/15 5:02:51 ET]
Table 'Nata II' 9-max Seat #8 is the button
Seat 1: Priidix ($100 in chips) 
Seat 2: qqcom ($104.62 in chips) 
Seat 5: AGoodFell4 ($70 in chips) 
Seat 6: Arhistrareg ($52.89 in chips) 
Seat 7: er13to ($102.83 in chips) 
Seat 8: Igor DoUrden ($101.25 in chips) 
Seat 9: matiko09 ($105.37 in chips) 
matiko09: posts small blind $0.50
Priidix: posts big blind $1
g00000se: sits out 
AGoodFell4: posts big blind $1
*** HOLE CARDS ***
Dealt to matiko09 [Th 9s]
qqcom: folds 
AGoodFell4: raises $1.50 to $2.50
Arhistrareg: folds 
er13to: folds 
Igor DoUrden: folds 
matiko09: folds 
Priidix: folds 
Uncalled bet ($1.50) returned to AGoodFell4
AGoodFell4 collected $2.50 from pot
AGoodFell4: doesn't show hand 
*** SUMMARY ***
Total pot $2.50 | Rake $0 
Seat 1: Priidix (big blind) folded before Flop
Seat 2: qqcom folded before Flop (didn't bet)
Seat 5: AGoodFell4 collected ($2.50)
Seat 6: Arhistrareg folded before Flop (didn't bet)
Seat 7: er13to folded before Flop (didn't bet)
Seat 8: Igor DoUrden (button) folded before Flop (didn't bet)
Seat 9: matiko09 (small blind) folded before Flop





PokerStars Hand #148832990945:  Hold'em No Limit ($0.50/$1.00 USD) - 2016/02/15 11:02:55 CET [2016/02/15 5:02:55 ET]
Table 'Anteros' 9-max Seat #1 is the button
Seat 1: redacesfull ($100 in chips) 
Seat 2: IHouseMusic ($110.06 in chips) 
Seat 3: er13to ($100 in chips) 
Seat 4: misherei ($193.44 in chips) 
Seat 5: Holm1991 ($70.98 in chips) 
Seat 6: SerAlGog ($117.86 in chips) 
Seat 7: Zoubou1983 ($164.48 in chips) 
Seat 8: matiko09 ($105.14 in chips) 
IHouseMusic: posts small blind $0.50
er13to: posts big blind $1
mycka86: sits out 
*** HOLE CARDS ***
Dealt to matiko09 [Ks Qs]
misherei: folds 
Holm1991: calls $1
SerAlGog: folds 
Zoubou1983: folds 
matiko09: raises $3 to $4
redacesfull: folds 
IHouseMusic: folds 
er13to: folds 
Holm1991: calls $3
*** FLOP *** [3d 7d Js]
Holm1991: checks 
matiko09: bets $5
Holm1991: folds 
Uncalled bet ($5) returned to matiko09
matiko09 collected $9.07 from pot
matiko09: doesn't show hand 
*** SUMMARY ***
Total pot $9.50 | Rake $0.43 
Board [3d 7d Js]
Seat 1: redacesfull (button) folded before Flop (didn't bet)
Seat 2: IHouseMusic (small blind) folded before Flop
Seat 3: er13to (big blind) folded before Flop
Seat 4: misherei folded before Flop (didn't bet)
Seat 5: Holm1991 folded on the Flop
Seat 6: SerAlGog folded before Flop (didn't bet)
Seat 7: Zoubou1983 folded before Flop (didn't bet)
Seat 8: matiko09 collected ($9.07)





PokerStars Hand #148832993228:  Hold'em No Limit ($0.50/$1.00 USD) - 2016/02/15 11:03:01 CET [2016/02/15 5:03:01 ET]
Table 'Euanthe II' 9-max Seat #4 is the button
Seat 1: maxxmeister ($128.44 in chips) 
Seat 2: mycka86 ($191.84 in chips) 
Seat 3: Sreshta222 ($100 in chips) 
Seat 4: er13to ($113.08 in chips) 
Seat 7: vinniesmol ($216.59 in chips) 
Seat 8: matiko09 ($123.79 in chips) 
Seat 9: Venomous100% ($100 in chips) 
vinniesmol: posts small blind $0.50
matiko09: posts big blind $1
*** HOLE CARDS ***
Dealt to matiko09 [8s Ks]
Venomous100%: folds 
maxxmeister: folds 
mycka86: folds 
Sreshta222: folds 
er13to: folds 
vinniesmol: folds 
Uncalled bet ($0.50) returned to matiko09
matiko09 collected $1 from pot
matiko09: doesn't show hand 
*** SUMMARY ***
Total pot $1 | Rake $0 
Seat 1: maxxmeister folded before Flop (didn't bet)
Seat 2: mycka86 folded before Flop (didn't bet)
Seat 3: Sreshta222 folded before Flop (didn't bet)
Seat 4: er13to (button) folded before Flop (didn't bet)
Seat 7: vinniesmol (small blind) folded before Flop
Seat 8: matiko09 (big blind) collected ($1)
Seat 9: Venomous100% folded before Flop (didn't bet)





PokerStars Hand #148832994286:  Hold'em No Limit (€0.25/€0.50 EUR) - 2016/02/15 11:03:03 CET [2016/02/15 5:03:03 ET]
Table 'Walinskia II' 9-max Seat #9 is the button
Seat 1: ljryviltj (€49.84 in chips) 
Seat 2: yats87 (€56.45 in chips) 
Seat 3: beluccix (€26.39 in chips) 
Seat 4: Otsime (€45.86 in chips) 
Seat 5: vano7777 (€66.30 in chips) 
Seat 6: 50CandyJoe (€68.54 in chips) 
Seat 7: etny99 (€50 in chips) 
Seat 8: matiko09 (€55.01 in chips) 
Seat 9: Ahangama (€53.54 in chips) 
ljryviltj: posts small blind €0.25
yats87: posts big blind €0.50
*** HOLE CARDS ***
Dealt to matiko09 [Ts As]
beluccix: folds 
Otsime: calls €0.50
vano7777: folds 
50CandyJoe: folds 
etny99: folds 
matiko09: raises €1.50 to €2
Ahangama: folds 
ljryviltj: folds 
yats87: folds 
Otsime: calls €1.50
*** FLOP *** [5s 7d 2s]
Otsime: checks 
matiko09: bets €2.95
Otsime: calls €2.95
*** TURN *** [5s 7d 2s] [Kc]
Otsime: bets €5
matiko09: calls €5
*** RIVER *** [5s 7d 2s Kc] [Ks]
Otsime: bets €10
matiko09: raises €26 to €36
Otsime: folds 
Uncalled bet (€26) returned to matiko09
matiko09 collected €38.82 from pot
matiko09: doesn't show hand 
*** SUMMARY ***
Total pot €40.65 | Rake €1.83 
Board [5s 7d 2s Kc Ks]
Seat 1: ljryviltj (small blind) folded before Flop
Seat 2: yats87 (big blind) folded before Flop
Seat 3: beluccix folded before Flop (didn't bet)
Seat 4: Otsime folded on the River
Seat 5: vano7777 folded before Flop (didn't bet)
Seat 6: 50CandyJoe folded before Flop (didn't bet)
Seat 7: etny99 folded before Flop (didn't bet)
Seat 8: matiko09 collected (€38.82)
Seat 9: Ahangama (button) folded before Flop (didn't bet)





PokerStars Hand #148832994162:  Hold'em No Limit ($0.25/$0.50 USD) - 2016/02/15 11:03:03 CET [2016/02/15 5:03:03 ET]
Table 'Laertes II' 9-max Seat #9 is the button
Seat 1: dade33 ($98.39 in chips) 
Seat 2: beluccix ($24.21 in chips) 
Seat 3: ljryviltj ($55.37 in chips) 
Seat 4: rgar93 ($40.72 in chips) 
Seat 5: vlad11122007 ($48.25 in chips) 
Seat 6: yats87 ($60.91 in chips) 
Seat 7: Vedpapa ($52.42 in chips) 
Seat 8: Trent444 ($44.28 in chips) 
Seat 9: matiko09 ($50 in chips) 
dade33: posts small blind $0.25
beluccix: posts big blind $0.50
*** HOLE CARDS ***
Dealt to matiko09 [Jc 7d]
ljryviltj: folds 
rgar93: folds 
vlad11122007: raises $1 to $1.50
yats87: folds 
Vedpapa: calls $1.50
Trent444: folds 
matiko09: folds 
dade33: calls $1.25
beluccix: folds 
*** FLOP *** [9s Qd Qh]
dade33: checks 
vlad11122007: checks 
Vedpapa: bets $2.39
dade33: folds 
vlad11122007: calls $2.39
*** TURN *** [9s Qd Qh] [8c]
vlad11122007: checks 
Trent444 is disconnected 
Vedpapa: checks 
*** RIVER *** [9s Qd Qh 8c] [5c]
vlad11122007: bets $5
Vedpapa: raises $9.67 to $14.67
vlad11122007: folds 
Uncalled bet ($9.67) returned to Vedpapa
Vedpapa collected $18.89 from pot
Vedpapa: doesn't show hand 
*** SUMMARY ***
Total pot $19.78 | Rake $0.89 
Board [9s Qd Qh 8c 5c]
Seat 1: dade33 (small blind) folded on the Flop
Seat 2: beluccix (big blind) folded before Flop
Seat 3: ljryviltj folded before Flop (didn't bet)
Seat 4: rgar93 folded before Flop (didn't bet)
Seat 5: vlad11122007 folded on the River
Seat 6: yats87 folded before Flop (didn't bet)
Seat 7: Vedpapa collected ($18.89)
Seat 8: Trent444 folded before Flop (didn't bet)
Seat 9: matiko09 (button) folded before Flop (didn't bet)





PokerStars Hand #148832994664:  Hold'em No Limit ($0.50/$1.00 USD) - 2016/02/15 11:03:04 CET [2016/02/15 5:03:04 ET]
Table 'Corvus III' 9-max Seat #7 is the button
Seat 1: agritom ($250 in chips) 
Seat 4: goransyruvka ($71.54 in chips) 
Seat 5: koib88 ($303.15 in chips) 
Seat 6: Priidix ($103 in chips) 
Seat 7: matiko09 ($209.36 in chips) 
Seat 8: redacesfull ($192.54 in chips) 
Seat 9: er13to ($100 in chips) 
redacesfull: posts small blind $0.50
er13to: posts big blind $1
VanDobeln: sits out 
agritom: posts the ante $0.20
goransyruvka: posts the ante $0.20
koib88: posts the ante $0.20
Priidix: posts the ante $0.20
matiko09: posts the ante $0.20
redacesfull: posts the ante $0.20
er13to: posts the ante $0.20
*** HOLE CARDS ***
Dealt to matiko09 [Qh 5h]
mzsportline joins the table at seat #2 
agritom: folds 
goransyruvka: calls $1
koib88: calls $1
Priidix: folds 
matiko09: folds 
redacesfull: folds 
er13to: checks 
*** FLOP *** [Qd 7c 4h]
er13to: checks 
goransyruvka: checks 
koib88: checks 
*** TURN *** [Qd 7c 4h] [Ks]
er13to: checks 
goransyruvka: checks 
koib88: bets $2.34
er13to: folds 
goransyruvka: folds 
Uncalled bet ($2.34) returned to koib88
koib88 collected $4.68 from pot
koib88: doesn't show hand 
*** SUMMARY ***
Total pot $4.90 | Rake $0.22 
Board [Qd 7c 4h Ks]
Seat 1: agritom folded before Flop (didn't bet)
Seat 4: goransyruvka folded on the Turn
Seat 5: koib88 collected ($4.68)
Seat 6: Priidix folded before Flop (didn't bet)
Seat 7: matiko09 (button) folded before Flop (didn't bet)
Seat 8: redacesfull (small blind) folded before Flop
Seat 9: er13to (big blind) folded on the Turn





PokerStars Hand #148832997598:  Hold'em No Limit ($0.25/$0.50 USD) - 2016/02/15 11:03:11 CET [2016/02/15 5:03:11 ET]
Table 'Vesta II' 9-max Seat #2 is the button
Seat 1: Ahangama ($89.34 in chips) 
Seat 2: i L00K great ($55.47 in chips) 
Seat 3: matiko09 ($74.20 in chips) 
Seat 4: vlad11122007 ($50 in chips) 
Seat 5: dndngod ($76.90 in chips) 
Seat 7: ruyingren ($31.79 in chips) 
Seat 8: Arystan ($78.38 in chips) 
Seat 9: Aoki42 ($73.51 in chips) 
matiko09: posts small blind $0.25
vlad11122007: posts big blind $0.50
pandalapa: sits out 
*** HOLE CARDS ***
Dealt to matiko09 [7s Kh]
dndngod: folds 
ruyingren: folds 
Arystan: raises $1 to $1.50
Aoki42: folds 
Ahangama: raises $3 to $4.50
i L00K great: folds 
matiko09: folds 
vlad11122007: folds 
Arystan: calls $3
*** FLOP *** [2d Qd Tc]
Arystan: checks 
Ahangama: bets $4.50
Arystan: calls $4.50
*** TURN *** [2d Qd Tc] [7c]
Arystan: checks 
Ahangama: checks 
*** RIVER *** [2d Qd Tc 7c] [Kc]
Arystan: checks 
Ahangama: bets $10
Arystan: folds 
Uncalled bet ($10) returned to Ahangama
Ahangama collected $17.91 from pot
Ahangama: doesn't show hand 
*** SUMMARY ***
Total pot $18.75 | Rake $0.84 
Board [2d Qd Tc 7c Kc]
Seat 1: Ahangama collected ($17.91)
Seat 2: i L00K great (button) folded before Flop (didn't bet)
Seat 3: matiko09 (small blind) folded before Flop
Seat 4: vlad11122007 (big blind) folded before Flop
Seat 5: dndngod folded before Flop (didn't bet)
Seat 7: ruyingren folded before Flop (didn't bet)
Seat 8: Arystan folded on the River
Seat 9: Aoki42 folded before Flop (didn't bet)





PokerStars Hand #148833000018:  Hold'em No Limit ($0.50/$1.00 USD) - 2016/02/15 11:03:17 CET [2016/02/15 5:03:17 ET]
Table 'Euanthe II' 9-max Seat #7 is the button
Seat 1: maxxmeister ($128.44 in chips) 
Seat 2: mycka86 ($191.84 in chips) 
Seat 3: Sreshta222 ($100 in chips) 
Seat 4: er13to ($113.08 in chips) 
Seat 7: vinniesmol ($216.09 in chips) 
Seat 8: matiko09 ($124.29 in chips) 
Seat 9: Venomous100% ($100 in chips) 
matiko09: posts small blind $0.50
Venomous100%: posts big blind $1
*** HOLE CARDS ***
Dealt to matiko09 [2h 5d]
maxxmeister: folds 
mycka86: folds 
Sreshta222: folds 
er13to: folds 
vinniesmol: folds 
AlKatrone joins the table at seat #5 
matiko09: folds 
Uncalled bet ($0.50) returned to Venomous100%
Venomous100% collected $1 from pot
AlKatrone leaves the table
Venomous100%: doesn't show hand 
*** SUMMARY ***
Total pot $1 | Rake $0 
Seat 1: maxxmeister folded before Flop (didn't bet)
Seat 2: mycka86 folded before Flop (didn't bet)
Seat 3: Sreshta222 folded before Flop (didn't bet)
Seat 4: er13to folded before Flop (didn't bet)
Seat 7: vinniesmol (button) folded before Flop (didn't bet)
Seat 8: matiko09 (small blind) folded before Flop
Seat 9: Venomous100% (big blind) collected ($1)





PokerStars Hand #148833002011:  Hold'em No Limit (€0.50/€1.00 EUR) - 2016/02/15 11:03:21 CET [2016/02/15 5:03:21 ET]
Table 'Ganesa II' 9-max Seat #8 is the button
Seat 2: maxxmeister (€104.11 in chips) 
Seat 3: BuBu 0187 (€78.70 in chips) 
Seat 4: Sreshta222 (€100 in chips) 
Seat 5: vano7777 (€75.24 in chips) 
Seat 6: matiko09 (€100.89 in chips) 
Seat 7: er13to (€113.50 in chips) 
Seat 8: mycka86 (€100 in chips) 
Seat 9: Priidix (€100 in chips) 
Priidix: posts small blind €0.50
maxxmeister: posts big blind €1
*** HOLE CARDS ***
Dealt to matiko09 [Qc 9h]
BuBu 0187: raises €2 to €3
Sreshta222: folds 
vano7777: folds 
matiko09: folds 
er13to: folds 
mycka86: folds 
Priidix: folds 
maxxmeister: folds 
Uncalled bet (€2) returned to BuBu 0187
BuBu 0187 collected €2.50 from pot
BuBu 0187: doesn't show hand 
*** SUMMARY ***
Total pot €2.50 | Rake €0 
Seat 2: maxxmeister (big blind) folded before Flop
Seat 3: BuBu 0187 collected (€2.50)
Seat 4: Sreshta222 folded before Flop (didn't bet)
Seat 5: vano7777 folded before Flop (didn't bet)
Seat 6: matiko09 folded before Flop (didn't bet)
Seat 7: er13to folded before Flop (didn't bet)
Seat 8: mycka86 (button) folded before Flop (didn't bet)
Seat 9: Priidix (small blind) folded before Flop





PokerStars Hand #148833005295:  Hold'em No Limit ($0.50/$1.00 USD) - 2016/02/15 11:03:29 CET [2016/02/15 5:03:29 ET]
Table 'Nata II' 9-max Seat #9 is the button
Seat 1: Priidix ($100 in chips) 
Seat 2: qqcom ($104.62 in chips) 
Seat 5: AGoodFell4 ($71.50 in chips) 
Seat 6: Arhistrareg ($52.89 in chips) 
Seat 7: er13to ($102.83 in chips) 
Seat 8: Igor DoUrden ($101.25 in chips) 
Seat 9: matiko09 ($104.87 in chips) 
Priidix: posts small blind $0.50
qqcom: posts big blind $1
g00000se: sits out 
*** HOLE CARDS ***
Dealt to matiko09 [2d 2h]
AGoodFell4: raises $1 to $2
Arhistrareg: raises $5.50 to $7.50
er13to: folds 
Igor DoUrden: folds 
matiko09: folds 
Priidix: folds 
qqcom: calls $6.50
Good Dentist joins the table at seat #4 
AGoodFell4: folds 
*** FLOP *** [Jd Qd 4d]
qqcom: checks 
Arhistrareg: bets $8.35
qqcom: folds 
Uncalled bet ($8.35) returned to Arhistrareg
Arhistrareg collected $16.71 from pot
Arhistrareg: doesn't show hand 
*** SUMMARY ***
Total pot $17.50 | Rake $0.79 
Board [Jd Qd 4d]
Seat 1: Priidix (small blind) folded before Flop
Seat 2: qqcom (big blind) folded on the Flop
Seat 5: AGoodFell4 folded before Flop
Seat 6: Arhistrareg collected ($16.71)
Seat 7: er13to folded before Flop (didn't bet)
Seat 8: Igor DoUrden folded before Flop (didn't bet)
Seat 9: matiko09 (button) folded before Flop (didn't bet)





PokerStars Hand #148833009235:  Hold'em No Limit ($0.50/$1.00 USD) - 2016/02/15 11:03:38 CET [2016/02/15 5:03:38 ET]
Table 'Euanthe II' 9-max Seat #8 is the button
Seat 1: maxxmeister ($128.44 in chips) 
Seat 2: mycka86 ($191.84 in chips) 
Seat 3: Sreshta222 ($100 in chips) 
Seat 4: er13to ($113.08 in chips) 
Seat 7: vinniesmol ($216.09 in chips) 
Seat 8: matiko09 ($123.79 in chips) 
Seat 9: Venomous100% ($100.50 in chips) 
Aalleekks joins the table at seat #5 
Venomous100%: posts small blind $0.50
maxxmeister: posts big blind $1
*** HOLE CARDS ***
Dealt to matiko09 [5d Jd]
Aalleekks leaves the table
mycka86: folds 
Sreshta222: folds 
er13to: folds 
vinniesmol: folds 
matiko09: folds 
Venomous100%: folds 
Uncalled bet ($0.50) returned to maxxmeister
maxxmeister collected $1 from pot
maxxmeister: doesn't show hand 
*** SUMMARY ***
Total pot $1 | Rake $0 
Seat 1: maxxmeister (big blind) collected ($1)
Seat 2: mycka86 folded before Flop (didn't bet)
Seat 3: Sreshta222 folded before Flop (didn't bet)
Seat 4: er13to folded before Flop (didn't bet)
Seat 7: vinniesmol folded before Flop (didn't bet)
Seat 8: matiko09 (button) folded before Flop (didn't bet)
Seat 9: Venomous100% (small blind) folded before Flop





PokerStars Hand #148833014609:  Hold'em No Limit ($0.50/$1.00 USD) - 2016/02/15 11:03:51 CET [2016/02/15 5:03:51 ET]
Table 'Corvus III' 9-max Seat #8 is the button
Seat 1: agritom ($250 in chips) 
Seat 4: goransyruvka ($70.34 in chips) 
Seat 5: koib88 ($306.63 in chips) 
Seat 6: Priidix ($102.80 in chips) 
Seat 7: matiko09 ($209.16 in chips) 
Seat 8: redacesfull ($191.84 in chips) 
Seat 9: er13to ($100 in chips) 
er13to: posts small blind $0.50
agritom: posts big blind $1
mzsportline: sits out 
VanDobeln: sits out 
agritom: posts the ante $0.20
goransyruvka: posts the ante $0.20
koib88: posts the ante $0.20
Priidix: posts the ante $0.20
matiko09: posts the ante $0.20
redacesfull: posts the ante $0.20
er13to: posts the ante $0.20
*** HOLE CARDS ***
Dealt to matiko09 [5c Th]
goransyruvka: calls $1
koib88: raises $4.90 to $5.90
Priidix: folds 
matiko09: folds 
redacesfull: calls $5.90
er13to: folds 
agritom: calls $4.90
goransyruvka: calls $4.90
*** FLOP *** [5h Tc Ks]
agritom: checks 
goransyruvka: checks 
koib88: bets $6.50
redacesfull: calls $6.50
agritom: calls $6.50
goransyruvka: folds 
*** TURN *** [5h Tc Ks] [Kc]
agritom: checks 
koib88: bets $14.90
redacesfull: calls $14.90
agritom: folds 
*** RIVER *** [5h Tc Ks Kc] [5d]
koib88: bets $32
redacesfull: folds 
Uncalled bet ($32) returned to koib88
koib88 collected $72 from pot
koib88: doesn't show hand 
*** SUMMARY ***
Total pot $74.80 | Rake $2.80 
Board [5h Tc Ks Kc 5d]
Seat 1: agritom (big blind) folded on the Turn
Seat 4: goransyruvka folded on the Flop
Seat 5: koib88 collected ($72)
Seat 6: Priidix folded before Flop (didn't bet)
Seat 7: matiko09 folded before Flop (didn't bet)
Seat 8: redacesfull (button) folded on the River
Seat 9: er13to (small blind) folded before Flop





PokerStars Hand #148833016448:  Hold'em No Limit ($0.50/$1.00 USD) - 2016/02/15 11:03:55 CET [2016/02/15 5:03:55 ET]
Table 'Anteros' 9-max Seat #2 is the button
Seat 1: redacesfull ($100 in chips) 
Seat 2: IHouseMusic ($109.56 in chips) 
Seat 3: er13to ($100 in chips) 
Seat 4: misherei ($193.44 in chips) 
Seat 5: Holm1991 ($66.98 in chips) 
Seat 6: SerAlGog ($117.86 in chips) 
Seat 7: Zoubou1983 ($164.48 in chips) 
Seat 8: matiko09 ($110.21 in chips) 
er13to: posts small blind $0.50
misherei: posts big blind $1
mycka86: sits out 
*** HOLE CARDS ***
Dealt to matiko09 [7c 9d]
Holm1991: folds 
SerAlGog: folds 
Zoubou1983: calls $1
matiko09: folds 
redacesfull: folds 
IHouseMusic: raises $2 to $3
er13to: folds 
misherei: calls $2
Zoubou1983: calls $2
*** FLOP *** [Qs 8c 2s]
misherei: checks 
Zoubou1983: checks 
IHouseMusic: checks 
*** TURN *** [Qs 8c 2s] [5c]
misherei: checks 
Zoubou1983: checks 
IHouseMusic: checks 
*** RIVER *** [Qs 8c 2s 5c] [Ks]
misherei: checks 
Zoubou1983: checks 
IHouseMusic: checks 
*** SHOW DOWN ***
misherei: shows [Js Kh] (a pair of Kings)
Zoubou1983: mucks hand 
IHouseMusic: mucks hand 
misherei collected $9.07 from pot
*** SUMMARY ***
Total pot $9.50 | Rake $0.43 
Board [Qs 8c 2s 5c Ks]
Seat 1: redacesfull folded before Flop (didn't bet)
Seat 2: IHouseMusic (button) mucked [7h 7s]
Seat 3: er13to (small blind) folded before Flop
Seat 4: misherei (big blind) showed [Js Kh] and won ($9.07) with a pair of Kings
Seat 5: Holm1991 folded before Flop (didn't bet)
Seat 6: SerAlGog folded before Flop (didn't bet)
Seat 7: Zoubou1983 mucked [Ah 8s]
Seat 8: matiko09 folded before Flop (didn't bet)





PokerStars Hand #148833019226:  Hold'em No Limit ($0.50/$1.00 USD) - 2016/02/15 11:04:01 CET [2016/02/15 5:04:01 ET]
Table 'Gemma II' 9-max Seat #9 is the button
Seat 1: Igor DoUrden ($176.84 in chips) 
Seat 2: er13to ($142.68 in chips) 
Seat 3: Venomous100% ($156.66 in chips) 
Seat 4: mycka86 ($100 in chips) 
Seat 5: PokerSash201 ($60.25 in chips) 
Seat 6: IHouseMusic ($100 in chips) 
Seat 7: AlKatrone ($120 in chips) 
Seat 9: matiko09 ($106.55 in chips) 
Igor DoUrden: posts small blind $0.50
er13to: posts big blind $1
Priidix: sits out 
*** HOLE CARDS ***
Dealt to matiko09 [Jc 9c]
Venomous100%: folds 
mycka86: folds 
PokerSash201: folds 
IHouseMusic: folds 
AlKatrone: raises $1.50 to $2.50
matiko09: folds 
Igor DoUrden: folds 
er13to: calls $1.50
*** FLOP *** [5s Kd 6d]
er13to: checks 
AlKatrone: bets $1.78
er13to: calls $1.78
*** TURN *** [5s Kd 6d] [7c]
er13to: bets $5.62
AlKatrone: raises $11.24 to $16.86
er13to: folds 
Uncalled bet ($11.24) returned to AlKatrone
AlKatrone collected $19.39 from pot
AlKatrone: doesn't show hand 
*** SUMMARY ***
Total pot $20.30 | Rake $0.91 
Board [5s Kd 6d 7c]
Seat 1: Igor DoUrden (small blind) folded before Flop
Seat 2: er13to (big blind) folded on the Turn
Seat 3: Venomous100% folded before Flop (didn't bet)
Seat 4: mycka86 folded before Flop (didn't bet)
Seat 5: PokerSash201 folded before Flop (didn't bet)
Seat 6: IHouseMusic folded before Flop (didn't bet)
Seat 7: AlKatrone collected ($19.39)
Seat 9: matiko09 (button) folded before Flop (didn't bet)





PokerStars Hand #148833026587:  Hold'em No Limit ($0.50/$1.00 USD) - 2016/02/15 11:04:18 CET [2016/02/15 5:04:18 ET]
Table 'Euanthe II' 9-max Seat #9 is the button
Seat 1: maxxmeister ($128.94 in chips) 
Seat 2: mycka86 ($191.84 in chips) 
Seat 3: Sreshta222 ($100 in chips) 
Seat 4: er13to ($113.08 in chips) 
Seat 7: vinniesmol ($216.09 in chips) 
Seat 8: matiko09 ($123.79 in chips) 
Seat 9: Venomous100% ($100 in chips) 
maxxmeister: posts small blind $0.50
mycka86: posts big blind $1
*** HOLE CARDS ***
Dealt to matiko09 [3h Jc]
Sreshta222: folds 
er13to: folds 
vinniesmol: raises $2 to $3
matiko09: folds 
Venomous100%: folds 
AlKatrone joins the table at seat #5 
AlKatrone leaves the table
Aalleekks joins the table at seat #5 
Aalleekks leaves the table
maxxmeister: folds 
mycka86: folds 
Uncalled bet ($2) returned to vinniesmol
vinniesmol collected $2.50 from pot
*** SUMMARY ***
Total pot $2.50 | Rake $0 
Seat 1: maxxmeister (small blind) folded before Flop
Seat 2: mycka86 (big blind) folded before Flop
Seat 3: Sreshta222 folded before Flop (didn't bet)
Seat 4: er13to folded before Flop (didn't bet)
Seat 7: vinniesmol collected ($2.50)
Seat 8: matiko09 folded before Flop (didn't bet)
Seat 9: Venomous100% (button) folded before Flop (didn't bet)





PokerStars Hand #148833027002:  Hold'em No Limit ($0.50/$1.00 USD) - 2016/02/15 11:04:19 CET [2016/02/15 5:04:19 ET]
Table 'Nata II' 9-max Seat #1 is the button
Seat 1: Priidix ($100 in chips) 
Seat 2: qqcom ($100 in chips) 
Seat 3: g00000se ($100 in chips) 
Seat 5: AGoodFell4 ($69.50 in chips) 
Seat 6: Arhistrareg ($62.10 in chips) 
Seat 7: er13to ($102.83 in chips) 
Seat 8: Igor DoUrden ($101.25 in chips) 
Seat 9: matiko09 ($104.87 in chips) 
qqcom: posts small blind $0.50
g00000se: posts big blind $1
Good Dentist: sits out 
*** HOLE CARDS ***
Dealt to matiko09 [5s Kc]
AGoodFell4: folds 
Arhistrareg: folds 
er13to: folds 
Igor DoUrden: folds 
matiko09: folds 
Priidix: folds 
qqcom: raises $1 to $2
g00000se: calls $1
*** FLOP *** [Js Th Ks]
qqcom: bets $3.82
g00000se: folds 
Uncalled bet ($3.82) returned to qqcom
qqcom collected $3.82 from pot
*** SUMMARY ***
Total pot $4 | Rake $0.18 
Board [Js Th Ks]
Seat 1: Priidix (button) folded before Flop (didn't bet)
Seat 2: qqcom (small blind) collected ($3.82)
Seat 3: g00000se (big blind) folded on the Flop
Seat 5: AGoodFell4 folded before Flop (didn't bet)
Seat 6: Arhistrareg folded before Flop (didn't bet)
Seat 7: er13to folded before Flop (didn't bet)
Seat 8: Igor DoUrden folded before Flop (didn't bet)
Seat 9: matiko09 folded before Flop (didn't bet)





PokerStars Hand #148833028615:  Hold'em No Limit (€0.50/€1.00 EUR) - 2016/02/15 11:04:23 CET [2016/02/15 5:04:23 ET]
Table 'Ganesa II' 9-max Seat #9 is the button
Seat 2: maxxmeister (€103.11 in chips) 
Seat 3: BuBu 0187 (€80.20 in chips) 
Seat 4: Sreshta222 (€100 in chips) 
Seat 5: vano7777 (€75.24 in chips) 
Seat 6: matiko09 (€100.89 in chips) 
Seat 7: er13to (€113.50 in chips) 
Seat 8: mycka86 (€100 in chips) 
Seat 9: Priidix (€100 in chips) 
maxxmeister: posts small blind €0.50
BuBu 0187: posts big blind €1
*** HOLE CARDS ***
Dealt to matiko09 [3h Ts]
Sreshta222: folds 
vano7777: folds 
matiko09: folds 
er13to: folds 
mycka86: folds 
Priidix: raises €1.60 to €2.60
maxxmeister: folds 
BuBu 0187: calls €1.60
*** FLOP *** [3c 6c Js]
BuBu 0187: bets €2
Priidix: calls €2
*** TURN *** [3c 6c Js] [Qh]
BuBu 0187: bets €5
Priidix: raises €14.44 to €19.44
BuBu 0187: folds 
Uncalled bet (€14.44) returned to Priidix
Priidix collected €18.81 from pot
Priidix: doesn't show hand 
*** SUMMARY ***
Total pot €19.70 | Rake €0.89 
Board [3c 6c Js Qh]
Seat 2: maxxmeister (small blind) folded before Flop
Seat 3: BuBu 0187 (big blind) folded on the Turn
Seat 4: Sreshta222 folded before Flop (didn't bet)
Seat 5: vano7777 folded before Flop (didn't bet)
Seat 6: matiko09 folded before Flop (didn't bet)
Seat 7: er13to folded before Flop (didn't bet)
Seat 8: mycka86 folded before Flop (didn't bet)
Seat 9: Priidix (button) collected (€18.81)





PokerStars Hand #148833033727:  Hold'em No Limit (€0.25/€0.50 EUR) - 2016/02/15 11:04:35 CET [2016/02/15 5:04:35 ET]
Table 'Walinskia II' 9-max Seat #1 is the button
Seat 1: ljryviltj (€49.59 in chips) 
Seat 2: yats87 (€55.95 in chips) 
Seat 3: beluccix (€26.39 in chips) 
Seat 4: Otsime (€25.91 in chips) 
Seat 5: vano7777 (€66.30 in chips) 
Seat 6: 50CandyJoe (€68.54 in chips) 
Seat 7: etny99 (€50 in chips) 
Seat 8: matiko09 (€73.88 in chips) 
Seat 9: Ahangama (€53.54 in chips) 
yats87: posts small blind €0.25
beluccix: posts big blind €0.50
*** HOLE CARDS ***
Dealt to matiko09 [Ah As]
Otsime: folds 
vano7777: folds 
50CandyJoe: folds 
etny99: folds 
matiko09: raises €1 to €1.50
Ahangama: folds 
ljryviltj: folds 
yats87: folds 
beluccix: folds 
Uncalled bet (€1) returned to matiko09
matiko09 collected €1.25 from pot
matiko09: doesn't show hand 
*** SUMMARY ***
Total pot €1.25 | Rake €0 
Seat 1: ljryviltj (button) folded before Flop (didn't bet)
Seat 2: yats87 (small blind) folded before Flop
Seat 3: beluccix (big blind) folded before Flop
Seat 4: Otsime folded before Flop (didn't bet)
Seat 5: vano7777 folded before Flop (didn't bet)
Seat 6: 50CandyJoe folded before Flop (didn't bet)
Seat 7: etny99 folded before Flop (didn't bet)
Seat 8: matiko09 collected (€1.25)
Seat 9: Ahangama folded before Flop (didn't bet)





PokerStars Hand #148833039775:  Hold'em No Limit ($0.25/$0.50 USD) - 2016/02/15 11:04:49 CET [2016/02/15 5:04:49 ET]
Table 'Vesta II' 9-max Seat #3 is the button
Seat 1: Ahangama ($98.25 in chips) 
Seat 2: i L00K great ($55.47 in chips) 
Seat 3: matiko09 ($73.95 in chips) 
Seat 4: vlad11122007 ($49.50 in chips) 
Seat 5: dndngod ($76.90 in chips) 
Seat 7: ruyingren ($31.79 in chips) 
Seat 8: Arystan ($69.38 in chips) 
Seat 9: Aoki42 ($73.51 in chips) 
vlad11122007: posts small blind $0.25
dndngod: posts big blind $0.50
pandalapa: sits out 
*** HOLE CARDS ***
Dealt to matiko09 [6s Js]
ruyingren: folds 
Arystan: raises $1 to $1.50
Aoki42: folds 
Ahangama: calls $1.50
i L00K great: folds 
matiko09: folds 
vlad11122007: folds 
dndngod: folds 
*** FLOP *** [4s Qc 5s]
Arystan: checks 
Ahangama: checks 
*** TURN *** [4s Qc 5s] [9s]
Arystan: checks 
Ahangama: checks 
*** RIVER *** [4s Qc 5s 9s] [4c]
Arystan: checks 
Ahangama: checks 
*** SHOW DOWN ***
Arystan: shows [6c Td] (a pair of Fours)
Ahangama: shows [2c 2s] (two pair, Fours and Deuces)
Ahangama collected $3.58 from pot
*** SUMMARY ***
Total pot $3.75 | Rake $0.17 
Board [4s Qc 5s 9s 4c]
Seat 1: Ahangama showed [2c 2s] and won ($3.58) with two pair, Fours and Deuces
Seat 2: i L00K great folded before Flop (didn't bet)
Seat 3: matiko09 (button) folded before Flop (didn't bet)
Seat 4: vlad11122007 (small blind) folded before Flop
Seat 5: dndngod (big blind) folded before Flop
Seat 7: ruyingren folded before Flop (didn't bet)
Seat 8: Arystan showed [6c Td] and lost with a pair of Fours
Seat 9: Aoki42 folded before Flop (didn't bet)





PokerStars Hand #148833043215:  Hold'em No Limit ($0.25/$0.50 USD) - 2016/02/15 11:04:57 CET [2016/02/15 5:04:57 ET]
Table 'Laertes II' 9-max Seat #1 is the button
Seat 1: dade33 ($96.89 in chips) 
Seat 2: beluccix ($24.21 in chips) 
Seat 3: ljryviltj ($55.37 in chips) 
Seat 4: rgar93 ($40.72 in chips) 
Seat 5: vlad11122007 ($50 in chips) 
Seat 6: yats87 ($60.91 in chips) 
Seat 7: Vedpapa ($62.42 in chips) 
Seat 8: Trent444 ($44.28 in chips) 
Seat 9: matiko09 ($50 in chips) 
beluccix: posts small blind $0.25
ljryviltj: posts big blind $0.50
*** HOLE CARDS ***
Dealt to matiko09 [7s Ts]
rgar93: folds 
vlad11122007: folds 
yats87: folds 
Vedpapa: folds 
Trent444: folds 
matiko09: folds 
dade33: folds 
beluccix: raises $1 to $1.50
ljryviltj: calls $1
*** FLOP *** [2c 8d 5d]
beluccix: bets $1.50
ljryviltj: raises $3.75 to $5.25
beluccix: folds 
Uncalled bet ($3.75) returned to ljryviltj
ljryviltj collected $5.73 from pot
ljryviltj: doesn't show hand 
*** SUMMARY ***
Total pot $6 | Rake $0.27 
Board [2c 8d 5d]
Seat 1: dade33 (button) folded before Flop (didn't bet)
Seat 2: beluccix (small blind) folded on the Flop
Seat 3: ljryviltj (big blind) collected ($5.73)
Seat 4: rgar93 folded before Flop (didn't bet)
Seat 5: vlad11122007 folded before Flop (didn't bet)
Seat 6: yats87 folded before Flop (didn't bet)
Seat 7: Vedpapa folded before Flop (didn't bet)
Seat 8: Trent444 folded before Flop (didn't bet)
Seat 9: matiko09 folded before Flop (didn't bet)





PokerStars Hand #148833045180:  Hold'em No Limit ($0.50/$1.00 USD) - 2016/02/15 11:05:02 CET [2016/02/15 5:05:02 ET]
Table 'Nata II' 9-max Seat #2 is the button
Seat 1: Priidix ($100 in chips) 
Seat 2: qqcom ($101.82 in chips) 
Seat 3: g00000se ($100 in chips) 
Seat 4: Good Dentist ($80 in chips) 
Seat 5: AGoodFell4 ($69.50 in chips) 
Seat 6: Arhistrareg ($62.10 in chips) 
Seat 7: er13to ($102.83 in chips) 
Seat 8: Igor DoUrden ($101.25 in chips) 
Seat 9: matiko09 ($104.87 in chips) 
g00000se: posts small blind $0.50
Good Dentist: posts big blind $1
*** HOLE CARDS ***
Dealt to matiko09 [5h 7s]
AGoodFell4: raises $2 to $3
Arhistrareg: calls $3
er13to: raises $16 to $19
Igor DoUrden: folds 
matiko09: folds 
Priidix: folds 
qqcom: calls $19
g00000se: folds 
Good Dentist: folds 
AGoodFell4: calls $16
Arhistrareg: folds 
*** FLOP *** [9d Ad 8h]
AGoodFell4: checks 
er13to: checks 
qqcom: checks 
*** TURN *** [9d Ad 8h] [Qs]
AGoodFell4: checks 
er13to: checks 
qqcom: bets $21
AGoodFell4: folds 
er13to: folds 
Uncalled bet ($21) returned to qqcom
qqcom collected $58.73 from pot
*** SUMMARY ***
Total pot $61.50 | Rake $2.77 
Board [9d Ad 8h Qs]
Seat 1: Priidix folded before Flop (didn't bet)
Seat 2: qqcom (button) collected ($58.73)
Seat 3: g00000se (small blind) folded before Flop
Seat 4: Good Dentist (big blind) folded before Flop
Seat 5: AGoodFell4 folded on the Turn
Seat 6: Arhistrareg folded before Flop
Seat 7: er13to folded on the Turn
Seat 8: Igor DoUrden folded before Flop (didn't bet)
Seat 9: matiko09 folded before Flop (didn't bet)





PokerStars Hand #148833049410:  Hold'em No Limit ($0.50/$1.00 USD) - 2016/02/15 11:05:10 CET [2016/02/15 5:05:10 ET]
Table 'Euanthe II' 9-max Seat #1 is the button
Seat 1: maxxmeister ($128.44 in chips) 
Seat 2: mycka86 ($190.84 in chips) 
Seat 3: Sreshta222 ($100 in chips) 
Seat 4: er13to ($113.08 in chips) 
Seat 7: vinniesmol ($217.59 in chips) 
Seat 8: matiko09 ($123.79 in chips) 
Seat 9: Venomous100% ($100 in chips) 
mycka86: posts small blind $0.50
Sreshta222: posts big blind $1
*** HOLE CARDS ***
Dealt to matiko09 [Qs 5s]
er13to: folds 
vinniesmol: folds 
matiko09: folds 
Venomous100%: raises $1.50 to $2.50
maxxmeister: folds 
mycka86: folds 
damienwilde joins the table at seat #5 
Sreshta222: folds 
Uncalled bet ($1.50) returned to Venomous100%
Venomous100% collected $2.50 from pot
Venomous100%: doesn't show hand 
*** SUMMARY ***
Total pot $2.50 | Rake $0 
Seat 1: maxxmeister (button) folded before Flop (didn't bet)
Seat 2: mycka86 (small blind) folded before Flop
Seat 3: Sreshta222 (big blind) folded before Flop
Seat 4: er13to folded before Flop (didn't bet)
Seat 7: vinniesmol folded before Flop (didn't bet)
Seat 8: matiko09 folded before Flop (didn't bet)
Seat 9: Venomous100% collected ($2.50)





PokerStars Hand #148833052091:  Hold'em No Limit ($0.50/$1.00 USD) - 2016/02/15 11:05:16 CET [2016/02/15 5:05:16 ET]
Table 'Anteros' 9-max Seat #3 is the button
Seat 1: redacesfull ($100 in chips) 
Seat 2: IHouseMusic ($106.56 in chips) 
Seat 3: er13to ($100 in chips) 
Seat 4: misherei ($199.51 in chips) 
Seat 5: Holm1991 ($66.98 in chips) 
Seat 6: SerAlGog ($117.86 in chips) 
Seat 7: Zoubou1983 ($161.48 in chips) 
Seat 8: matiko09 ($110.21 in chips) 
misherei: posts small blind $0.50
Holm1991: posts big blind $1
mycka86: sits out 
*** HOLE CARDS ***
Dealt to matiko09 [Jd Ah]
SerAlGog: raises $2 to $3
Zoubou1983: calls $3
matiko09: raises $8 to $11
redacesfull: folds 
IHouseMusic: folds 
Zoubou1983 is disconnected 
er13to: folds 
misherei: folds 
Holm1991: folds 
SerAlGog: calls $8
Zoubou1983: calls $8
*** FLOP *** [4d Qc 3c]
SerAlGog: checks 
Zoubou1983: checks 
matiko09: checks 
*** TURN *** [4d Qc 3c] [9d]
SerAlGog: bets $20.09
Zoubou1983: folds 
matiko09: folds 
Uncalled bet ($20.09) returned to SerAlGog
SerAlGog collected $32.95 from pot
SerAlGog: doesn't show hand 
*** SUMMARY ***
Total pot $34.50 | Rake $1.55 
Board [4d Qc 3c 9d]
Seat 1: redacesfull folded before Flop (didn't bet)
Seat 2: IHouseMusic folded before Flop (didn't bet)
Seat 3: er13to (button) folded before Flop (didn't bet)
Seat 4: misherei (small blind) folded before Flop
Seat 5: Holm1991 (big blind) folded before Flop
Seat 6: SerAlGog collected ($32.95)
Seat 7: Zoubou1983 folded on the Turn
Seat 8: matiko09 folded on the Turn





PokerStars Hand #148833053495:  Hold'em No Limit ($0.50/$1.00 USD) - 2016/02/15 11:05:19 CET [2016/02/15 5:05:19 ET]
Table 'Sekanina' 9-max Seat #1 is the button
Seat 1: LUTZ_11111 ($62.01 in chips) 
Seat 2: Priidix ($125.33 in chips) 
Seat 4: matiko09 ($100 in chips) 
Seat 5: IHouseMusic ($121.40 in chips) 
Seat 6: vinniesmol ($200.26 in chips) 
Seat 7: mycka86 ($100 in chips) 
Seat 8: Venomous100% ($100 in chips) 
Seat 9: er13to ($101 in chips) 
Priidix: posts small blind $0.50
matiko09: posts big blind $1
*** HOLE CARDS ***
Dealt to matiko09 [Js Ad]
IHouseMusic: folds 
vinniesmol: raises $2 to $3
mycka86: folds 
Venomous100%: calls $3
er13to: folds 
LUTZ_11111: folds 
Priidix: folds 
matiko09: folds 
*** FLOP *** [Kc Qd 9s]
vinniesmol: bets $4
Venomous100%: calls $4
*** TURN *** [Kc Qd 9s] [As]
vinniesmol: bets $10
Venomous100%: folds 
Uncalled bet ($10) returned to vinniesmol
vinniesmol collected $14.80 from pot
*** SUMMARY ***
Total pot $15.50 | Rake $0.70 
Board [Kc Qd 9s As]
Seat 1: LUTZ_11111 (button) folded before Flop (didn't bet)
Seat 2: Priidix (small blind) folded before Flop
Seat 4: matiko09 (big blind) folded before Flop
Seat 5: IHouseMusic folded before Flop (didn't bet)
Seat 6: vinniesmol collected ($14.80)
Seat 7: mycka86 folded before Flop (didn't bet)
Seat 8: Venomous100% folded on the Turn
Seat 9: er13to folded before Flop (didn't bet)





PokerStars Hand #148833062449:  Hold'em No Limit ($0.50/$1.00 USD) - 2016/02/15 11:05:39 CET [2016/02/15 5:05:39 ET]
Table 'Gemma II' 9-max Seat #1 is the button
Seat 1: Igor DoUrden ($176.34 in chips) 
Seat 2: er13to ($132.78 in chips) 
Seat 3: Venomous100% ($156.66 in chips) 
Seat 4: mycka86 ($100 in chips) 
Seat 5: PokerSash201 ($60.25 in chips) 
Seat 6: IHouseMusic ($100 in chips) 
Seat 7: AlKatrone ($129.49 in chips) 
Seat 9: matiko09 ($106.55 in chips) 
er13to: posts small blind $0.50
Venomous100%: posts big blind $1
Priidix: sits out 
*** HOLE CARDS ***
Dealt to matiko09 [8s 7c]
mycka86: folds 
PokerSash201: folds 
IHouseMusic: raises $2 to $3
AlKatrone: folds 
matiko09: folds 
Igor DoUrden: folds 
er13to: folds 
Venomous100%: folds 
Uncalled bet ($2) returned to IHouseMusic
IHouseMusic collected $2.50 from pot
IHouseMusic: doesn't show hand 
*** SUMMARY ***
Total pot $2.50 | Rake $0 
Seat 1: Igor DoUrden (button) folded before Flop (didn't bet)
Seat 2: er13to (small blind) folded before Flop
Seat 3: Venomous100% (big blind) folded before Flop
Seat 4: mycka86 folded before Flop (didn't bet)
Seat 5: PokerSash201 folded before Flop (didn't bet)
Seat 6: IHouseMusic collected ($2.50)
Seat 7: AlKatrone folded before Flop (didn't bet)
Seat 9: matiko09 folded before Flop (didn't bet)





PokerStars Hand #148833063918:  Hold'em No Limit ($0.50/$1.00 USD) - 2016/02/15 11:05:42 CET [2016/02/15 5:05:42 ET]
Table 'Corvus III' 9-max Seat #9 is the button
Seat 1: agritom ($250 in chips) 
Seat 2: mzsportline ($100 in chips) 
Seat 4: goransyruvka ($64.24 in chips) 
Seat 5: koib88 ($351.13 in chips) 
Seat 6: Priidix ($102.60 in chips) 
Seat 7: matiko09 ($208.96 in chips) 
Seat 8: redacesfull ($164.34 in chips) 
Seat 9: er13to ($100 in chips) 
agritom: posts small blind $0.50
mzsportline: posts big blind $1
VanDobeln: sits out 
agritom: posts the ante $0.20
mzsportline: posts the ante $0.20
goransyruvka: posts the ante $0.20
koib88: posts the ante $0.20
Priidix: posts the ante $0.20
matiko09: posts the ante $0.20
redacesfull: posts the ante $0.20
er13to: posts the ante $0.20
*** HOLE CARDS ***
Dealt to matiko09 [8s Ad]
goransyruvka: calls $1
koib88: raises $2 to $3
Priidix: folds 
matiko09: folds 
redacesfull: folds 
er13to: folds 
agritom: calls $2.50
mzsportline: folds 
goransyruvka: calls $2
*** FLOP *** [Tc 9d As]
agritom: checks 
goransyruvka: checks 
koib88: checks 
*** TURN *** [Tc 9d As] [Ac]
agritom: bets $6
goransyruvka: folds 
koib88: folds 
Uncalled bet ($6) returned to agritom
agritom collected $11.08 from pot
agritom: doesn't show hand 
*** SUMMARY ***
Total pot $11.60 | Rake $0.52 
Board [Tc 9d As Ac]
Seat 1: agritom (small blind) collected ($11.08)
Seat 2: mzsportline (big blind) folded before Flop
Seat 4: goransyruvka folded on the Turn
Seat 5: koib88 folded on the Turn
Seat 6: Priidix folded before Flop (didn't bet)
Seat 7: matiko09 folded before Flop (didn't bet)
Seat 8: redacesfull folded before Flop (didn't bet)
Seat 9: er13to (button) folded before Flop (didn't bet)





PokerStars Hand #148833064179:  Hold'em No Limit (€0.25/€0.50 EUR) - 2016/02/15 11:05:43 CET [2016/02/15 5:05:43 ET]
Table 'Walinskia II' 9-max Seat #2 is the button
Seat 1: ljryviltj (€49.59 in chips) 
Seat 2: yats87 (€55.70 in chips) 
Seat 3: beluccix (€25.89 in chips) 
Seat 4: Otsime (€25.91 in chips) 
Seat 5: vano7777 (€66.30 in chips) 
Seat 6: 50CandyJoe (€68.54 in chips) 
Seat 7: etny99 (€50 in chips) 
Seat 8: matiko09 (€74.63 in chips) 
Seat 9: Ahangama (€53.54 in chips) 
beluccix: posts small blind €0.25
Otsime: posts big blind €0.50
*** HOLE CARDS ***
Dealt to matiko09 [7d Kd]
vano7777: folds 
50CandyJoe: folds 
etny99: folds 
matiko09: folds 
Ahangama: folds 
ljryviltj: raises €0.61 to €1.11
yats87: folds 
beluccix: folds 
Otsime: calls €0.61
*** FLOP *** [As Qd 4s]
Otsime: checks 
ljryviltj: checks 
*** TURN *** [As Qd 4s] [3c]
Otsime: checks 
ljryviltj: checks 
*** RIVER *** [As Qd 4s 3c] [Jd]
Otsime: checks 
ljryviltj: bets €1.25
Otsime: folds 
Uncalled bet (€1.25) returned to ljryviltj
ljryviltj collected €2.36 from pot
ljryviltj: doesn't show hand 
*** SUMMARY ***
Total pot €2.47 | Rake €0.11 
Board [As Qd 4s 3c Jd]
Seat 1: ljryviltj collected (€2.36)
Seat 2: yats87 (button) folded before Flop (didn't bet)
Seat 3: beluccix (small blind) folded before Flop
Seat 4: Otsime (big blind) folded on the River
Seat 5: vano7777 folded before Flop (didn't bet)
Seat 6: 50CandyJoe folded before Flop (didn't bet)
Seat 7: etny99 folded before Flop (didn't bet)
Seat 8: matiko09 folded before Flop (didn't bet)
Seat 9: Ahangama folded before Flop (didn't bet)





PokerStars Hand #148833068769:  Hold'em No Limit (€0.50/€1.00 EUR) - 2016/02/15 11:05:53 CET [2016/02/15 5:05:53 ET]
Table 'Ganesa II' 9-max Seat #2 is the button
Seat 2: maxxmeister (€102.61 in chips) 
Seat 3: BuBu 0187 (€70.60 in chips) 
Seat 4: Sreshta222 (€100 in chips) 
Seat 5: vano7777 (€75.24 in chips) 
Seat 6: matiko09 (€100.89 in chips) 
Seat 7: er13to (€113.50 in chips) 
Seat 8: mycka86 (€100 in chips) 
Seat 9: Priidix (€109.21 in chips) 
BuBu 0187: posts small blind €0.50
Sreshta222: posts big blind €1
*** HOLE CARDS ***
Dealt to matiko09 [7s 7d]
vano7777: folds 
matiko09: raises €2 to €3
er13to: folds 
mycka86: folds 
Priidix: folds 
maxxmeister: folds 
BuBu 0187: calls €2.50
Sreshta222: calls €2
*** FLOP *** [Kc 5h Ac]
BuBu 0187: checks 
Sreshta222: checks 
matiko09: checks 
*** TURN *** [Kc 5h Ac] [Qh]
BuBu 0187: bets €4
Sreshta222: folds 
matiko09: folds 
Uncalled bet (€4) returned to BuBu 0187
BuBu 0187 collected €8.60 from pot
BuBu 0187: doesn't show hand 
*** SUMMARY ***
Total pot €9 | Rake €0.40 
Board [Kc 5h Ac Qh]
Seat 2: maxxmeister (button) folded before Flop (didn't bet)
Seat 3: BuBu 0187 (small blind) collected (€8.60)
Seat 4: Sreshta222 (big blind) folded on the Turn
Seat 5: vano7777 folded before Flop (didn't bet)
Seat 6: matiko09 folded on the Turn
Seat 7: er13to folded before Flop (didn't bet)
Seat 8: mycka86 folded before Flop (didn't bet)
Seat 9: Priidix folded before Flop (didn't bet)





PokerStars Hand #148833068770:  Hold'em No Limit ($0.50/$1.00 USD) - 2016/02/15 11:05:53 CET [2016/02/15 5:05:53 ET]
Table 'Euanthe II' 9-max Seat #2 is the button
Seat 1: maxxmeister ($128.44 in chips) 
Seat 2: mycka86 ($190.34 in chips) 
Seat 3: Sreshta222 ($100 in chips) 
Seat 4: er13to ($113.08 in chips) 
Seat 5: damienwilde ($80 in chips) 
Seat 7: vinniesmol ($217.59 in chips) 
Seat 8: matiko09 ($123.79 in chips) 
Seat 9: Venomous100% ($101.50 in chips) 
Sreshta222: posts small blind $0.50
er13to: posts big blind $1
damienwilde: posts big blind $1
*** HOLE CARDS ***
Dealt to matiko09 [Js 5d]
damienwilde: raises $2.50 to $3.50
vinniesmol: folds 
matiko09: folds 
Venomous100%: folds 
maxxmeister: folds 
mycka86: raises $6.50 to $10
Sreshta222: folds 
er13to: folds 
damienwilde: calls $6.50
*** FLOP *** [6d 2s 3h]
damienwilde: checks 
mycka86: bets $7.50
damienwilde: calls $7.50
*** TURN *** [6d 2s 3h] [6h]
damienwilde: checks 
mycka86: bets $18
damienwilde: raises $44.50 to $62.50 and is all-in
mycka86: calls $44.50
*** RIVER *** [6d 2s 3h 6h] [5h]
*** SHOW DOWN ***
damienwilde: shows [Qd Jh] (a pair of Sixes)
mycka86: shows [Kc Kd] (two pair, Kings and Sixes)
mycka86 collected $158.70 from pot
*** SUMMARY ***
Total pot $161.50 | Rake $2.80 
Board [6d 2s 3h 6h 5h]
Seat 1: maxxmeister folded before Flop (didn't bet)
Seat 2: mycka86 (button) showed [Kc Kd] and won ($158.70) with two pair, Kings and Sixes
Seat 3: Sreshta222 (small blind) folded before Flop
Seat 4: er13to (big blind) folded before Flop
Seat 5: damienwilde showed [Qd Jh] and lost with a pair of Sixes
Seat 7: vinniesmol folded before Flop (didn't bet)
Seat 8: matiko09 folded before Flop (didn't bet)
Seat 9: Venomous100% folded before Flop (didn't bet)





PokerStars Hand #148833069346:  Hold'em No Limit ($0.25/$0.50 USD) - 2016/02/15 11:05:55 CET [2016/02/15 5:05:55 ET]
Table 'Vesta II' 9-max Seat #4 is the button
Seat 1: Ahangama ($100.33 in chips) 
Seat 2: i L00K great ($55.47 in chips) 
Seat 3: matiko09 ($73.95 in chips) 
Seat 4: vlad11122007 ($49.25 in chips) 
Seat 5: dndngod ($76.40 in chips) 
Seat 6: pandalapa ($50 in chips) 
Seat 7: ruyingren ($31.79 in chips) 
Seat 8: Arystan ($67.88 in chips) 
Seat 9: Aoki42 ($73.51 in chips) 
dndngod: posts small blind $0.25
pandalapa: posts big blind $0.50
*** HOLE CARDS ***
Dealt to matiko09 [2s 4c]
ruyingren: folds 
Arystan: raises $1 to $1.50
Aoki42: folds 
Ahangama: folds 
i L00K great: raises $2.50 to $4
matiko09: folds 
vlad11122007: folds 
dndngod: folds 
pandalapa: folds 
Arystan: calls $2.50
*** FLOP *** [7h 3h 5s]
Arystan: bets $4.18
i L00K great: folds 
Uncalled bet ($4.18) returned to Arystan
Arystan collected $8.36 from pot
Arystan: doesn't show hand 
*** SUMMARY ***
Total pot $8.75 | Rake $0.39 
Board [7h 3h 5s]
Seat 1: Ahangama folded before Flop (didn't bet)
Seat 2: i L00K great folded on the Flop
Seat 3: matiko09 folded before Flop (didn't bet)
Seat 4: vlad11122007 (button) folded before Flop (didn't bet)
Seat 5: dndngod (small blind) folded before Flop
Seat 6: pandalapa (big blind) folded before Flop
Seat 7: ruyingren folded before Flop (didn't bet)
Seat 8: Arystan collected ($8.36)
Seat 9: Aoki42 folded before Flop (didn't bet)





PokerStars Hand #148833081934:  Hold'em No Limit ($0.50/$1.00 USD) - 2016/02/15 11:06:22 CET [2016/02/15 5:06:22 ET]
Table 'Gemma II' 9-max Seat #2 is the button
Seat 1: Igor DoUrden ($176.34 in chips) 
Seat 2: er13to ($132.28 in chips) 
Seat 3: Venomous100% ($155.66 in chips) 
Seat 4: mycka86 ($100 in chips) 
Seat 5: PokerSash201 ($60.25 in chips) 
Seat 6: IHouseMusic ($101.50 in chips) 
Seat 7: AlKatrone ($129.49 in chips) 
Seat 9: matiko09 ($106.55 in chips) 
Venomous100%: posts small blind $0.50
mycka86: posts big blind $1
Priidix: sits out 
*** HOLE CARDS ***
Dealt to matiko09 [Jc 7s]
PokerSash201: raises $1 to $2
IHouseMusic: folds 
AlKatrone: folds 
matiko09: folds 
Igor DoUrden: folds 
er13to: folds 
Venomous100%: folds 
mycka86: folds 
Uncalled bet ($1) returned to PokerSash201
PokerSash201 collected $2.50 from pot
PokerSash201: doesn't show hand 
*** SUMMARY ***
Total pot $2.50 | Rake $0 
Seat 1: Igor DoUrden folded before Flop (didn't bet)
Seat 2: er13to (button) folded before Flop (didn't bet)
Seat 3: Venomous100% (small blind) folded before Flop
Seat 4: mycka86 (big blind) folded before Flop
Seat 5: PokerSash201 collected ($2.50)
Seat 6: IHouseMusic folded before Flop (didn't bet)
Seat 7: AlKatrone folded before Flop (didn't bet)
Seat 9: matiko09 folded before Flop (didn't bet)





PokerStars Hand #148833084295:  Hold'em No Limit ($0.50/$1.00 USD) - 2016/02/15 11:06:28 CET [2016/02/15 5:06:28 ET]
Table 'Corvus III' 9-max Seat #1 is the button
Seat 1: agritom ($257.88 in chips) 
Seat 2: mzsportline ($98.80 in chips) 
Seat 3: VanDobeln ($250 in chips) 
Seat 4: goransyruvka ($61.04 in chips) 
Seat 6: Priidix ($102.40 in chips) 
Seat 7: matiko09 ($208.76 in chips) 
Seat 8: redacesfull ($164.14 in chips) 
Seat 9: er13to ($100 in chips) 
mzsportline: posts small blind $0.50
VanDobeln: posts big blind $1
agritom: posts the ante $0.20
mzsportline: posts the ante $0.20
VanDobeln: posts the ante $0.20
goransyruvka: posts the ante $0.20
Priidix: posts the ante $0.20
matiko09: posts the ante $0.20
redacesfull: posts the ante $0.20
er13to: posts the ante $0.20
*** HOLE CARDS ***
Dealt to matiko09 [7s As]
goransyruvka: calls $1
Priidix: raises $3 to $4
matiko09: folds 
redacesfull: folds 
er13to: folds 
agritom: calls $4
mzsportline: folds 
VanDobeln: folds 
goransyruvka: calls $3
*** FLOP *** [Jd 4d Kc]
goransyruvka: checks 
Priidix: bets $10.81
agritom: calls $10.81
goransyruvka: folds 
*** TURN *** [Jd 4d Kc] [Jh]
Priidix: checks 
agritom: bets $21
Priidix: calls $21
*** RIVER *** [Jd 4d Kc Jh] [Kd]
Priidix: checks 
agritom: checks 
*** SHOW DOWN ***
Priidix: shows [Ks 8s] (a full house, Kings full of Jacks)
agritom: mucks hand 
Priidix collected $75.92 from pot
*** SUMMARY ***
Total pot $78.72 | Rake $2.80 
Board [Jd 4d Kc Jh Kd]
Seat 1: agritom (button) mucked [Jc Qc]
Seat 2: mzsportline (small blind) folded before Flop
Seat 3: VanDobeln (big blind) folded before Flop
Seat 4: goransyruvka folded on the Flop
Seat 6: Priidix showed [Ks 8s] and won ($75.92) with a full house, Kings full of Jacks
Seat 7: matiko09 folded before Flop (didn't bet)
Seat 8: redacesfull folded before Flop (didn't bet)
Seat 9: er13to folded before Flop (didn't bet)





PokerStars Hand #148833086389:  Hold'em No Limit ($0.50/$1.00 USD) - 2016/02/15 11:06:32 CET [2016/02/15 5:06:32 ET]
Table 'Octans II' 9-max Seat #9 is the button
Seat 1: maxxmeister ($100 in chips) 
Seat 2: matiko09 ($101 in chips) 
Seat 3: novaeuropa ($81.25 in chips) 
Seat 4: Venomous100% ($166.30 in chips) 
Seat 5: AlKatrone ($100 in chips) 
Seat 6: er13to ($100 in chips) 
Seat 7: traficblues ($93.24 in chips) 
Seat 8: IHouseMusic ($139.47 in chips) 
Seat 9: mycka86 ($134.14 in chips) 
maxxmeister: posts small blind $0.50
matiko09: posts big blind $1
*** HOLE CARDS ***
Dealt to matiko09 [Kh 8c]
novaeuropa: folds 
novaeuropa leaves the table
Venomous100%: folds 
AlKatrone: folds 
er13to: folds 
traficblues: calls $1
IHouseMusic: folds 
mycka86: folds 
maxxmeister: calls $0.50
matiko09: checks 
*** FLOP *** [Th Ts 9d]
maxxmeister: bets $1.50
matiko09: folds 
traficblues: folds 
Uncalled bet ($1.50) returned to maxxmeister
Aalleekks joins the table at seat #3 
maxxmeister collected $2.86 from pot
maxxmeister: doesn't show hand 
*** SUMMARY ***
Total pot $3 | Rake $0.14 
Board [Th Ts 9d]
Seat 1: maxxmeister (small blind) collected ($2.86)
Seat 2: matiko09 (big blind) folded on the Flop
Seat 3: novaeuropa folded before Flop (didn't bet)
Seat 4: Venomous100% folded before Flop (didn't bet)
Seat 5: AlKatrone folded before Flop (didn't bet)
Seat 6: er13to folded before Flop (didn't bet)
Seat 7: traficblues folded on the Flop
Seat 8: IHouseMusic folded before Flop (didn't bet)
Seat 9: mycka86 (button) folded before Flop (didn't bet)





PokerStars Hand #148833087586:  Hold'em No Limit ($0.25/$0.50 USD) - 2016/02/15 11:06:35 CET [2016/02/15 5:06:35 ET]
Table 'Vesta II' 9-max Seat #5 is the button
Seat 1: Ahangama ($100.33 in chips) 
Seat 2: i L00K great ($51.47 in chips) 
Seat 3: matiko09 ($73.95 in chips) 
Seat 4: vlad11122007 ($49.25 in chips) 
Seat 5: dndngod ($76.15 in chips) 
Seat 6: pandalapa ($50 in chips) 
Seat 7: ruyingren ($31.79 in chips) 
Seat 8: Arystan ($72.24 in chips) 
Seat 9: Aoki42 ($73.51 in chips) 
pandalapa: posts small blind $0.25
ruyingren: posts big blind $0.50
*** HOLE CARDS ***
Dealt to matiko09 [Kh 6h]
Arystan: raises $1 to $1.50
Aoki42: raises $3 to $4.50
Ahangama: folds 
i L00K great: folds 
matiko09: folds 
vlad11122007: folds 
dndngod: folds 
pandalapa: folds 
ruyingren: calls $4
Arystan: calls $3
*** FLOP *** [7d 3h Jd]
ruyingren: checks 
Arystan: checks 
Aoki42: bets $8.66
ruyingren: folds 
Arystan: folds 
Uncalled bet ($8.66) returned to Aoki42
Aoki42 collected $13.13 from pot
Aoki42: doesn't show hand 
*** SUMMARY ***
Total pot $13.75 | Rake $0.62 
Board [7d 3h Jd]
Seat 1: Ahangama folded before Flop (didn't bet)
Seat 2: i L00K great folded before Flop (didn't bet)
Seat 3: matiko09 folded before Flop (didn't bet)
Seat 4: vlad11122007 folded before Flop (didn't bet)
Seat 5: dndngod (button) folded before Flop (didn't bet)
Seat 6: pandalapa (small blind) folded before Flop
Seat 7: ruyingren (big blind) folded on the Flop
Seat 8: Arystan folded on the Flop
Seat 9: Aoki42 collected ($13.13)





PokerStars Hand #148833090545:  Hold'em No Limit ($0.50/$1.00 USD) - 2016/02/15 11:06:41 CET [2016/02/15 5:06:41 ET]
Table 'Sekanina' 9-max Seat #2 is the button
Seat 1: LUTZ_11111 ($62.01 in chips) 
Seat 2: Priidix ($124.83 in chips) 
Seat 4: matiko09 ($100 in chips) 
Seat 5: IHouseMusic ($121.40 in chips) 
Seat 6: vinniesmol ($208.06 in chips) 
Seat 7: mycka86 ($100 in chips) 
Seat 8: Venomous100% ($100 in chips) 
Seat 9: er13to ($101 in chips) 
matiko09: posts small blind $0.50
IHouseMusic: posts big blind $1
*** HOLE CARDS ***
Dealt to matiko09 [Jc 2d]
vinniesmol: raises $2 to $3
mycka86: folds 
Venomous100%: folds 
er13to: folds 
LUTZ_11111: folds 
Priidix: folds 
matiko09: folds 
IHouseMusic: folds 
Uncalled bet ($2) returned to vinniesmol
vinniesmol collected $2.50 from pot
*** SUMMARY ***
Total pot $2.50 | Rake $0 
Seat 1: LUTZ_11111 folded before Flop (didn't bet)
Seat 2: Priidix (button) folded before Flop (didn't bet)
Seat 4: matiko09 (small blind) folded before Flop
Seat 5: IHouseMusic (big blind) folded before Flop
Seat 6: vinniesmol collected ($2.50)
Seat 7: mycka86 folded before Flop (didn't bet)
Seat 8: Venomous100% folded before Flop (didn't bet)
Seat 9: er13to folded before Flop (didn't bet)





PokerStars Hand #148833092033:  Hold'em No Limit ($0.50/$1.00 USD) - 2016/02/15 11:06:45 CET [2016/02/15 5:06:45 ET]
Table 'Anteros' 9-max Seat #4 is the button
Seat 1: redacesfull ($100 in chips) 
Seat 2: IHouseMusic ($106.56 in chips) 
Seat 3: er13to ($100 in chips) 
Seat 4: misherei ($199.01 in chips) 
Seat 5: Holm1991 ($65.98 in chips) 
Seat 6: SerAlGog ($139.81 in chips) 
Seat 7: Zoubou1983 ($150.48 in chips) 
Seat 8: matiko09 ($100 in chips) 
Holm1991: posts small blind $0.50
SerAlGog: posts big blind $1
mycka86: sits out 
*** HOLE CARDS ***
Dealt to matiko09 [3s 2s]
Zoubou1983: folds 
matiko09: folds 
redacesfull: raises $1.12 to $2.12
IHouseMusic: calls $2.12
er13to: raises $10.38 to $12.50
misherei has timed out
misherei: folds 
Holm1991: folds 
SerAlGog: folds 
redacesfull: folds 
IHouseMusic: folds 
Uncalled bet ($10.38) returned to er13to
er13to collected $7.86 from pot
*** SUMMARY ***
Total pot $7.86 | Rake $0 
Seat 1: redacesfull folded before Flop
Seat 2: IHouseMusic folded before Flop
Seat 3: er13to collected ($7.86)
Seat 4: misherei (button) folded before Flop (didn't bet)
Seat 5: Holm1991 (small blind) folded before Flop
Seat 6: SerAlGog (big blind) folded before Flop
Seat 7: Zoubou1983 folded before Flop (didn't bet)
Seat 8: matiko09 folded before Flop (didn't bet)





PokerStars Hand #148833094300:  Hold'em No Limit ($0.50/$1.00 USD) - 2016/02/15 11:06:50 CET [2016/02/15 5:06:50 ET]
Table 'Nata II' 9-max Seat #3 is the button
Seat 1: Priidix ($100 in chips) 
Seat 2: qqcom ($141.55 in chips) 
Seat 3: g00000se ($100 in chips) 
Seat 4: Good Dentist ($79 in chips) 
Seat 5: AGoodFell4 ($50.50 in chips) 
Seat 6: Arhistrareg ($59.10 in chips) 
Seat 7: er13to ($100 in chips) 
Seat 8: Igor DoUrden ($101.25 in chips) 
Seat 9: matiko09 ($104.87 in chips) 
Good Dentist: posts small blind $0.50
AGoodFell4: posts big blind $1
*** HOLE CARDS ***
Dealt to matiko09 [Qd 7s]
Arhistrareg: raises $2 to $3
er13to: folds 
Igor DoUrden: folds 
matiko09: folds 
Priidix: folds 
qqcom: folds 
g00000se: folds 
Good Dentist: folds 
AGoodFell4: calls $2
*** FLOP *** [2s 9c Ad]
AGoodFell4: bets $6
Arhistrareg: folds 
Uncalled bet ($6) returned to AGoodFell4
AGoodFell4 collected $6.21 from pot
AGoodFell4: doesn't show hand 
*** SUMMARY ***
Total pot $6.50 | Rake $0.29 
Board [2s 9c Ad]
Seat 1: Priidix folded before Flop (didn't bet)
Seat 2: qqcom folded before Flop (didn't bet)
Seat 3: g00000se (button) folded before Flop (didn't bet)
Seat 4: Good Dentist (small blind) folded before Flop
Seat 5: AGoodFell4 (big blind) collected ($6.21)
Seat 6: Arhistrareg folded on the Flop
Seat 7: er13to folded before Flop (didn't bet)
Seat 8: Igor DoUrden folded before Flop (didn't bet)
Seat 9: matiko09 folded before Flop (didn't bet)





PokerStars Hand #148833096039:  Hold'em No Limit ($0.25/$0.50 USD) - 2016/02/15 11:06:53 CET [2016/02/15 5:06:53 ET]
Table 'Laertes II' 9-max Seat #2 is the button
Seat 1: dade33 ($96.89 in chips) 
Seat 2: beluccix ($24.21 in chips) 
Seat 3: ljryviltj ($58.10 in chips) 
Seat 4: rgar93 ($40.72 in chips) 
Seat 5: vlad11122007 ($50 in chips) 
Seat 6: yats87 ($60.91 in chips) 
Seat 8: Trent444 ($44.28 in chips) 
Seat 9: matiko09 ($50 in chips) 
ljryviltj: posts small blind $0.25
rgar93: posts big blind $0.50
*** HOLE CARDS ***
Dealt to matiko09 [3s 2d]
vlad11122007: folds 
yats87: folds 
Trent444: folds 
matiko09: folds 
dade33: folds 
beluccix: raises $0.50 to $1
ljryviltj: folds 
rgar93: folds 
Uncalled bet ($0.50) returned to beluccix
beluccix collected $1.25 from pot
beluccix: doesn't show hand 
*** SUMMARY ***
Total pot $1.25 | Rake $0 
Seat 1: dade33 folded before Flop (didn't bet)
Seat 2: beluccix (button) collected ($1.25)
Seat 3: ljryviltj (small blind) folded before Flop
Seat 4: rgar93 (big blind) folded before Flop
Seat 5: vlad11122007 folded before Flop (didn't bet)
Seat 6: yats87 folded before Flop (didn't bet)
Seat 8: Trent444 folded before Flop (didn't bet)
Seat 9: matiko09 folded before Flop (didn't bet)





PokerStars Hand #148833098627:  Hold'em No Limit ($0.50/$1.00 USD) - 2016/02/15 11:06:59 CET [2016/02/15 5:06:59 ET]
Table 'Gemma II' 9-max Seat #3 is the button
Seat 1: Igor DoUrden ($176.34 in chips) 
Seat 2: er13to ($132.28 in chips) 
Seat 3: Venomous100% ($155.16 in chips) 
Seat 4: mycka86 ($100 in chips) 
Seat 5: PokerSash201 ($61.75 in chips) 
Seat 6: IHouseMusic ($101.50 in chips) 
Seat 7: AlKatrone ($129.49 in chips) 
Seat 9: matiko09 ($106.55 in chips) 
mycka86: posts small blind $0.50
PokerSash201: posts big blind $1
Priidix: sits out 
*** HOLE CARDS ***
Dealt to matiko09 [8s 7h]
IHouseMusic: folds 
AlKatrone: folds 
matiko09: folds 
Igor DoUrden: folds 
er13to: folds 
Venomous100%: raises $2 to $3
mycka86: folds 
PokerSash201: folds 
Uncalled bet ($2) returned to Venomous100%
Venomous100% collected $2.50 from pot
Venomous100%: doesn't show hand 
*** SUMMARY ***
Total pot $2.50 | Rake $0 
Seat 1: Igor DoUrden folded before Flop (didn't bet)
Seat 2: er13to folded before Flop (didn't bet)
Seat 3: Venomous100% (button) collected ($2.50)
Seat 4: mycka86 (small blind) folded before Flop
Seat 5: PokerSash201 (big blind) folded before Flop
Seat 6: IHouseMusic folded before Flop (didn't bet)
Seat 7: AlKatrone folded before Flop (didn't bet)
Seat 9: matiko09 folded before Flop (didn't bet)





PokerStars Hand #148833100705:  Hold'em No Limit ($0.50/$1.00 USD) - 2016/02/15 11:07:04 CET [2016/02/15 5:07:04 ET]
Table 'Sekanina' 9-max Seat #4 is the button
Seat 1: LUTZ_11111 ($62.01 in chips) 
Seat 2: Priidix ($124.83 in chips) 
Seat 4: matiko09 ($100 in chips) 
Seat 5: IHouseMusic ($120.40 in chips) 
Seat 6: vinniesmol ($209.56 in chips) 
Seat 7: mycka86 ($100 in chips) 
Seat 8: Venomous100% ($100 in chips) 
Seat 9: er13to ($101 in chips) 
IHouseMusic: posts small blind $0.50
vinniesmol: posts big blind $1
*** HOLE CARDS ***
Dealt to matiko09 [Js 6s]
mycka86: folds 
Venomous100%: folds 
er13to: folds 
LUTZ_11111: calls $1
Priidix: folds 
matiko09: raises $3 to $4
IHouseMusic: folds 
vinniesmol: calls $3
LUTZ_11111: calls $3
*** FLOP *** [7h Jc 9s]
vinniesmol: checks 
LUTZ_11111: checks 
matiko09: bets $7
vinniesmol: calls $7
LUTZ_11111: folds 
*** TURN *** [7h Jc 9s] [Td]
vinniesmol: checks 
matiko09: checks 
*** RIVER *** [7h Jc 9s Td] [9h]
vinniesmol: bets $25
matiko09: folds 
Uncalled bet ($25) returned to vinniesmol
vinniesmol collected $25.31 from pot
*** SUMMARY ***
Total pot $26.50 | Rake $1.19 
Board [7h Jc 9s Td 9h]
Seat 1: LUTZ_11111 folded on the Flop
Seat 2: Priidix folded before Flop (didn't bet)
Seat 4: matiko09 (button) folded on the River
Seat 5: IHouseMusic (small blind) folded before Flop
Seat 6: vinniesmol (big blind) collected ($25.31)
Seat 7: mycka86 folded before Flop (didn't bet)
Seat 8: Venomous100% folded before Flop (didn't bet)
Seat 9: er13to folded before Flop (didn't bet)





PokerStars Hand #148833102813:  Hold'em No Limit (€0.50/€1.00 EUR) - 2016/02/15 11:07:09 CET [2016/02/15 5:07:09 ET]
Table 'Ganesa II' 9-max Seat #3 is the button
Seat 2: maxxmeister (€102.61 in chips) 
Seat 3: BuBu 0187 (€76.20 in chips) 
Seat 4: Sreshta222 (€100 in chips) 
Seat 5: vano7777 (€75.24 in chips) 
Seat 6: matiko09 (€100 in chips) 
Seat 7: er13to (€113.50 in chips) 
Seat 8: mycka86 (€100 in chips) 
Seat 9: Priidix (€109.21 in chips) 
Sreshta222: posts small blind €0.50
vano7777: posts big blind €1
*** HOLE CARDS ***
Dealt to matiko09 [2h Qh]
matiko09: folds 
er13to: folds 
mycka86: folds 
Priidix: folds 
maxxmeister: folds 
BuBu 0187: raises €1 to €2
Sreshta222: raises €6 to €8
vano7777: folds 
BuBu 0187: folds 
Uncalled bet (€6) returned to Sreshta222
Sreshta222 collected €5 from pot
Sreshta222: doesn't show hand 
*** SUMMARY ***
Total pot €5 | Rake €0 
Seat 2: maxxmeister folded before Flop (didn't bet)
Seat 3: BuBu 0187 (button) folded before Flop
Seat 4: Sreshta222 (small blind) collected (€5)
Seat 5: vano7777 (big blind) folded before Flop
Seat 6: matiko09 folded before Flop (didn't bet)
Seat 7: er13to folded before Flop (didn't bet)
Seat 8: mycka86 folded before Flop (didn't bet)
Seat 9: Priidix folded before Flop (didn't bet)





PokerStars Hand #148833109442:  Hold'em No Limit ($0.50/$1.00 USD) - 2016/02/15 11:07:23 CET [2016/02/15 5:07:23 ET]
Table 'Gemma II' 9-max Seat #4 is the button
Seat 1: Igor DoUrden ($176.34 in chips) 
Seat 2: er13to ($132.28 in chips) 
Seat 3: Venomous100% ($156.66 in chips) 
Seat 4: mycka86 ($100 in chips) 
Seat 5: PokerSash201 ($60.75 in chips) 
Seat 6: IHouseMusic ($101.50 in chips) 
Seat 7: AlKatrone ($129.49 in chips) 
Seat 9: matiko09 ($106.55 in chips) 
PokerSash201: posts small blind $0.50
IHouseMusic: posts big blind $1
Priidix: sits out 
*** HOLE CARDS ***
Dealt to matiko09 [8h 9d]
AlKatrone: folds 
matiko09: folds 
Igor DoUrden: raises $1.25 to $2.25
er13to: folds 
Venomous100%: calls $2.25
mycka86: folds 
PokerSash201: folds 
IHouseMusic: folds 
*** FLOP *** [8d 7h 8s]
Igor DoUrden: bets $3.15
Venomous100%: raises $3.85 to $7
Igor DoUrden: folds 
Uncalled bet ($3.85) returned to Venomous100%
Venomous100% collected $11.75 from pot
Venomous100%: doesn't show hand 
*** SUMMARY ***
Total pot $12.30 | Rake $0.55 
Board [8d 7h 8s]
Seat 1: Igor DoUrden folded on the Flop
Seat 2: er13to folded before Flop (didn't bet)
Seat 3: Venomous100% collected ($11.75)
Seat 4: mycka86 (button) folded before Flop (didn't bet)
Seat 5: PokerSash201 (small blind) folded before Flop
Seat 6: IHouseMusic (big blind) folded before Flop
Seat 7: AlKatrone folded before Flop (didn't bet)
Seat 9: matiko09 folded before Flop (didn't bet)





PokerStars Hand #148833110323:  Hold'em No Limit ($0.50/$1.00 USD) - 2016/02/15 11:07:25 CET [2016/02/15 5:07:25 ET]
Table 'Corvus III' 9-max Seat #2 is the button
Seat 1: agritom ($221.87 in chips) 
Seat 2: mzsportline ($98.10 in chips) 
Seat 3: VanDobeln ($248.80 in chips) 
Seat 4: goransyruvka ($56.84 in chips) 
Seat 6: Priidix ($142.31 in chips) 
Seat 7: matiko09 ($208.56 in chips) 
Seat 8: redacesfull ($163.94 in chips) 
Seat 9: er13to ($100 in chips) 
VanDobeln: posts small blind $0.50
goransyruvka: posts big blind $1
agritom: posts the ante $0.20
mzsportline: posts the ante $0.20
VanDobeln: posts the ante $0.20
goransyruvka: posts the ante $0.20
Priidix: posts the ante $0.20
matiko09: posts the ante $0.20
redacesfull: posts the ante $0.20
er13to: posts the ante $0.20
*** HOLE CARDS ***
Dealt to matiko09 [8c Ts]
Priidix: folds 
matiko09: folds 
redacesfull: folds 
er13to: folds 
agritom: folds 
mzsportline: raises $2 to $3
VanDobeln: folds 
goransyruvka: raises $8.10 to $11.10
mzsportline: calls $8.10
*** FLOP *** [2c 5s 9c]
goransyruvka: bets $23.21
mzsportline: folds 
Uncalled bet ($23.21) returned to goransyruvka
goransyruvka collected $23.21 from pot
goransyruvka: doesn't show hand 
*** SUMMARY ***
Total pot $24.30 | Rake $1.09 
Board [2c 5s 9c]
Seat 1: agritom folded before Flop (didn't bet)
Seat 2: mzsportline (button) folded on the Flop
Seat 3: VanDobeln (small blind) folded before Flop
Seat 4: goransyruvka (big blind) collected ($23.21)
Seat 6: Priidix folded before Flop (didn't bet)
Seat 7: matiko09 folded before Flop (didn't bet)
Seat 8: redacesfull folded before Flop (didn't bet)
Seat 9: er13to folded before Flop (didn't bet)





PokerStars Hand #148833110247:  Hold'em No Limit ($0.50/$1.00 USD) - 2016/02/15 11:07:25 CET [2016/02/15 5:07:25 ET]
Table 'Octans II' 9-max Seat #1 is the button
Seat 1: maxxmeister ($101.86 in chips) 
Seat 2: matiko09 ($100 in chips) 
Seat 3: Aalleekks ($100 in chips) 
Seat 4: Venomous100% ($166.30 in chips) 
Seat 5: AlKatrone ($100 in chips) 
Seat 6: er13to ($100 in chips) 
Seat 7: traficblues ($92.24 in chips) 
Seat 8: IHouseMusic ($139.47 in chips) 
Seat 9: mycka86 ($134.14 in chips) 
matiko09: posts small blind $0.50
Aalleekks: posts big blind $1
*** HOLE CARDS ***
Dealt to matiko09 [Jd 2h]
Venomous100%: folds 
AlKatrone: folds 
er13to: folds 
traficblues: calls $1
IHouseMusic: folds 
mycka86: raises $3.50 to $4.50
maxxmeister: folds 
matiko09: folds 
Aalleekks: folds 
traficblues: calls $3.50
*** FLOP *** [2d 5h Qc]
traficblues: bets $5.01
mycka86: calls $5.01
*** TURN *** [2d 5h Qc] [3d]
traficblues: bets $7
mycka86: calls $7
*** RIVER *** [2d 5h Qc 3d] [9c]
traficblues: bets $7
mycka86: calls $7
*** SHOW DOWN ***
traficblues: shows [Qd 7d] (a pair of Queens)
mycka86: mucks hand 
traficblues collected $46.34 from pot
*** SUMMARY ***
Total pot $48.52 | Rake $2.18 
Board [2d 5h Qc 3d 9c]
Seat 1: maxxmeister (button) folded before Flop (didn't bet)
Seat 2: matiko09 (small blind) folded before Flop
Seat 3: Aalleekks (big blind) folded before Flop
Seat 4: Venomous100% folded before Flop (didn't bet)
Seat 5: AlKatrone folded before Flop (didn't bet)
Seat 6: er13to folded before Flop (didn't bet)
Seat 7: traficblues showed [Qd 7d] and won ($46.34) with a pair of Queens
Seat 8: IHouseMusic folded before Flop (didn't bet)
Seat 9: mycka86 mucked [Th Td]





PokerStars Hand #148833112401:  Hold'em No Limit ($0.50/$1.00 USD) - 2016/02/15 11:07:29 CET [2016/02/15 5:07:29 ET]
Table 'Euanthe II' 9-max Seat #3 is the button
Seat 1: maxxmeister ($128.44 in chips) 
Seat 2: mycka86 ($269.04 in chips) 
Seat 3: Sreshta222 ($100 in chips) 
Seat 4: er13to ($112.08 in chips) 
Seat 7: vinniesmol ($217.59 in chips) 
Seat 8: matiko09 ($123.79 in chips) 
Seat 9: Venomous100% ($101.50 in chips) 
er13to: posts small blind $0.50
vinniesmol: posts big blind $1
*** HOLE CARDS ***
Dealt to matiko09 [6d Qh]
matiko09: folds 
Venomous100%: folds 
maxxmeister: folds 
mycka86: raises $1.10 to $2.10
Sreshta222: folds 
er13to: folds 
vinniesmol: calls $1.10
*** FLOP *** [Js 5c 5h]
vinniesmol: checks 
mycka86: bets $2.46
vinniesmol: folds 
Uncalled bet ($2.46) returned to mycka86
mycka86 collected $4.49 from pot
*** SUMMARY ***
Total pot $4.70 | Rake $0.21 
Board [Js 5c 5h]
Seat 1: maxxmeister folded before Flop (didn't bet)
Seat 2: mycka86 collected ($4.49)
Seat 3: Sreshta222 (button) folded before Flop (didn't bet)
Seat 4: er13to (small blind) folded before Flop
Seat 7: vinniesmol (big blind) folded on the Flop
Seat 8: matiko09 folded before Flop (didn't bet)
Seat 9: Venomous100% folded before Flop (didn't bet)





PokerStars Hand #148833112395:  Hold'em No Limit ($0.25/$0.50 USD) - 2016/02/15 11:07:29 CET [2016/02/15 5:07:29 ET]
Table 'Laertes II' 9-max Seat #3 is the button
Seat 1: dade33 ($96.89 in chips) 
Seat 2: beluccix ($24.96 in chips) 
Seat 3: ljryviltj ($57.85 in chips) 
Seat 4: rgar93 ($40.22 in chips) 
Seat 5: vlad11122007 ($50 in chips) 
Seat 6: yats87 ($60.91 in chips) 
Seat 8: Trent444 ($44.28 in chips) 
Seat 9: matiko09 ($50 in chips) 
rgar93: posts small blind $0.25
vlad11122007: posts big blind $0.50
*** HOLE CARDS ***
Dealt to matiko09 [5h Kd]
yats87: folds 
Trent444: folds 
matiko09: folds 
dade33: folds 
beluccix: folds 
ljryviltj: raises $0.56 to $1.06
rgar93: folds 
vlad11122007: calls $0.56
*** FLOP *** [3s Jh Ad]
vlad11122007: checks 
ljryviltj: checks 
*** TURN *** [3s Jh Ad] [2s]
vlad11122007: checks 
ljryviltj: checks 
*** RIVER *** [3s Jh Ad 2s] [2h]
vlad11122007: checks 
ljryviltj: checks 
*** SHOW DOWN ***
vlad11122007: shows [Td 9s] (a pair of Deuces)
ljryviltj: shows [Jd Qh] (two pair, Jacks and Deuces)
ljryviltj collected $2.26 from pot
*** SUMMARY ***
Total pot $2.37 | Rake $0.11 
Board [3s Jh Ad 2s 2h]
Seat 1: dade33 folded before Flop (didn't bet)
Seat 2: beluccix folded before Flop (didn't bet)
Seat 3: ljryviltj (button) showed [Jd Qh] and won ($2.26) with two pair, Jacks and Deuces
Seat 4: rgar93 (small blind) folded before Flop
Seat 5: vlad11122007 (big blind) showed [Td 9s] and lost with a pair of Deuces
Seat 6: yats87 folded before Flop (didn't bet)
Seat 8: Trent444 folded before Flop (didn't bet)
Seat 9: matiko09 folded before Flop (didn't bet)





PokerStars Hand #148833114254:  Hold'em No Limit (€0.25/€0.50 EUR) - 2016/02/15 11:07:34 CET [2016/02/15 5:07:34 ET]
Table 'Walinskia II' 9-max Seat #3 is the button
Seat 1: ljryviltj (€50.84 in chips) 
Seat 2: yats87 (€55.70 in chips) 
Seat 3: beluccix (€25.64 in chips) 
Seat 4: Otsime (€24.80 in chips) 
Seat 5: vano7777 (€66.30 in chips) 
Seat 6: 50CandyJoe (€68.54 in chips) 
Seat 7: etny99 (€50 in chips) 
Seat 8: matiko09 (€74.63 in chips) 
Seat 9: Ahangama (€53.54 in chips) 
Otsime: posts small blind €0.25
vano7777: posts big blind €0.50
*** HOLE CARDS ***
Dealt to matiko09 [9s Kd]
50CandyJoe: folds 
etny99: folds 
matiko09: folds 
Ahangama: folds 
ljryviltj: folds 
yats87: folds 
beluccix: raises €0.50 to €1
Otsime: raises €2.50 to €3.50
vano7777: folds 
beluccix: folds 
Uncalled bet (€2.50) returned to Otsime
Otsime collected €2.50 from pot
Otsime: doesn't show hand 
*** SUMMARY ***
Total pot €2.50 | Rake €0 
Seat 1: ljryviltj folded before Flop (didn't bet)
Seat 2: yats87 folded before Flop (didn't bet)
Seat 3: beluccix (button) folded before Flop
Seat 4: Otsime (small blind) collected (€2.50)
Seat 5: vano7777 (big blind) folded before Flop
Seat 6: 50CandyJoe folded before Flop (didn't bet)
Seat 7: etny99 folded before Flop (didn't bet)
Seat 8: matiko09 folded before Flop (didn't bet)
Seat 9: Ahangama folded before Flop (didn't bet)





PokerStars Hand #148833115340:  Hold'em No Limit ($0.50/$1.00 USD) - 2016/02/15 11:07:36 CET [2016/02/15 5:07:36 ET]
Table 'Nata II' 9-max Seat #4 is the button
Seat 1: Priidix ($100 in chips) 
Seat 2: qqcom ($141.55 in chips) 
Seat 3: g00000se ($100 in chips) 
Seat 4: Good Dentist ($78.50 in chips) 
Seat 5: AGoodFell4 ($53.71 in chips) 
Seat 6: Arhistrareg ($56.10 in chips) 
Seat 7: er13to ($100 in chips) 
Seat 8: Igor DoUrden ($101.25 in chips) 
Seat 9: matiko09 ($104.87 in chips) 
AGoodFell4: posts small blind $0.50
Arhistrareg: posts big blind $1
*** HOLE CARDS ***
Dealt to matiko09 [As 6d]
er13to: folds 
Igor DoUrden: folds 
matiko09: folds 
Priidix: folds 
qqcom: folds 
g00000se: folds 
Good Dentist: raises $2 to $3
AGoodFell4: folds 
Arhistrareg: raises $3 to $6
Good Dentist: raises $8 to $14
Arhistrareg: calls $8
*** FLOP *** [Jd 8s 2c]
Arhistrareg: bets $27.22
Good Dentist: calls $27.22
*** TURN *** [Jd 8s 2c] [Ad]
Arhistrareg: bets $14.88 and is all-in
Good Dentist: calls $14.88
*** RIVER *** [Jd 8s 2c Ad] [5c]
*** SHOW DOWN ***
Arhistrareg: shows [8c Kc] (a pair of Eights)
Good Dentist: shows [9s Kh] (high card Ace)
Arhistrareg collected $109.90 from pot
*** SUMMARY ***
Total pot $112.70 | Rake $2.80 
Board [Jd 8s 2c Ad 5c]
Seat 1: Priidix folded before Flop (didn't bet)
Seat 2: qqcom folded before Flop (didn't bet)
Seat 3: g00000se folded before Flop (didn't bet)
Seat 4: Good Dentist (button) showed [9s Kh] and lost with high card Ace
Seat 5: AGoodFell4 (small blind) folded before Flop
Seat 6: Arhistrareg (big blind) showed [8c Kc] and won ($109.90) with a pair of Eights
Seat 7: er13to folded before Flop (didn't bet)
Seat 8: Igor DoUrden folded before Flop (didn't bet)
Seat 9: matiko09 folded before Flop (didn't bet)





PokerStars Hand #148833118182:  Hold'em No Limit ($0.25/$0.50 USD) - 2016/02/15 11:07:42 CET [2016/02/15 5:07:42 ET]
Table 'Vesta II' 9-max Seat #6 is the button
Seat 1: Ahangama ($100.33 in chips) 
Seat 2: i L00K great ($51.47 in chips) 
Seat 3: matiko09 ($73.95 in chips) 
Seat 4: vlad11122007 ($49.25 in chips) 
Seat 5: dndngod ($76.15 in chips) 
Seat 6: pandalapa ($50 in chips) 
Seat 7: ruyingren ($27.29 in chips) 
Seat 8: Arystan ($67.74 in chips) 
Seat 9: Aoki42 ($82.14 in chips) 
ruyingren: posts small blind $0.25
Arystan: posts big blind $0.50
*** HOLE CARDS ***
Dealt to matiko09 [Js 3c]
Aoki42: folds 
Ahangama: folds 
i L00K great: raises $1 to $1.50
matiko09: folds 
vlad11122007: folds 
dndngod: folds 
pandalapa: folds 
ruyingren: folds 
Arystan: calls $1
*** FLOP *** [9c 2c 9s]
Arystan: bets $1.55
i L00K great: calls $1.55
*** TURN *** [9c 2c 9s] [Qh]
Arystan: checks 
i L00K great: checks 
*** RIVER *** [9c 2c 9s Qh] [Qs]
Arystan: checks 
i L00K great: checks 
*** SHOW DOWN ***
Arystan: shows [7d Jd] (two pair, Queens and Nines)
i L00K great: mucks hand 
Arystan collected $6.06 from pot
*** SUMMARY ***
Total pot $6.35 | Rake $0.29 
Board [9c 2c 9s Qh Qs]
Seat 1: Ahangama folded before Flop (didn't bet)
Seat 2: i L00K great mucked [7c 7s]
Seat 3: matiko09 folded before Flop (didn't bet)
Seat 4: vlad11122007 folded before Flop (didn't bet)
Seat 5: dndngod folded before Flop (didn't bet)
Seat 6: pandalapa (button) folded before Flop (didn't bet)
Seat 7: ruyingren (small blind) folded before Flop
Seat 8: Arystan (big blind) showed [7d Jd] and won ($6.06) with two pair, Queens and Nines
Seat 9: Aoki42 folded before Flop (didn't bet)





PokerStars Hand #148833118887:  Hold'em No Limit ($0.50/$1.00 USD) - 2016/02/15 11:07:44 CET [2016/02/15 5:07:44 ET]
Table 'Anteros' 9-max Seat #5 is the button
Seat 1: redacesfull ($100 in chips) 
Seat 2: IHouseMusic ($104.44 in chips) 
Seat 3: er13to ($105.74 in chips) 
Seat 5: Holm1991 ($65.48 in chips) 
Seat 6: SerAlGog ($138.81 in chips) 
Seat 7: Zoubou1983 ($150.48 in chips) 
Seat 8: matiko09 ($100 in chips) 
SerAlGog: posts small blind $0.50
Zoubou1983: posts big blind $1
mycka86: sits out 
*** HOLE CARDS ***
Dealt to matiko09 [Kd 5c]
matiko09: folds 
redacesfull: raises $1.12 to $2.12
IHouseMusic: folds 
er13to: folds 
Holm1991: folds 
SerAlGog: folds 
Zoubou1983: calls $1.12
*** FLOP *** [3s 9h Th]
Zoubou1983: checks 
redacesfull: bets $2
Zoubou1983: raises $2 to $4
redacesfull: calls $2
*** TURN *** [3s 9h Th] [Kc]
Zoubou1983: checks 
redacesfull: checks 
*** RIVER *** [3s 9h Th Kc] [9s]
Zoubou1983: checks 
redacesfull: bets $10
Zoubou1983: folds 
Uncalled bet ($10) returned to redacesfull
redacesfull collected $12.17 from pot
redacesfull: doesn't show hand 
*** SUMMARY ***
Total pot $12.74 | Rake $0.57 
Board [3s 9h Th Kc 9s]
Seat 1: redacesfull collected ($12.17)
Seat 2: IHouseMusic folded before Flop (didn't bet)
Seat 3: er13to folded before Flop (didn't bet)
Seat 5: Holm1991 (button) folded before Flop (didn't bet)
Seat 6: SerAlGog (small blind) folded before Flop
Seat 7: Zoubou1983 (big blind) folded on the River
Seat 8: matiko09 folded before Flop (didn't bet)





PokerStars Hand #148833125636:  Hold'em No Limit (€0.50/€1.00 EUR) - 2016/02/15 11:07:59 CET [2016/02/15 5:07:59 ET]
Table 'Ganesa II' 9-max Seat #4 is the button
Seat 2: maxxmeister (€102.61 in chips) 
Seat 3: BuBu 0187 (€74.20 in chips) 
Seat 4: Sreshta222 (€103 in chips) 
Seat 5: vano7777 (€74.24 in chips) 
Seat 6: matiko09 (€100 in chips) 
Seat 7: er13to (€113.50 in chips) 
Seat 8: mycka86 (€100 in chips) 
Seat 9: Priidix (€109.21 in chips) 
vano7777: posts small blind €0.50
matiko09: posts big blind €1
*** HOLE CARDS ***
Dealt to matiko09 [9c Th]
er13to: raises €1.50 to €2.50
mycka86: folds 
Priidix: folds 
maxxmeister: folds 
BuBu 0187: folds 
Sreshta222: folds 
vano7777: folds 
matiko09: folds 
Uncalled bet (€1.50) returned to er13to
er13to collected €2.50 from pot
*** SUMMARY ***
Total pot €2.50 | Rake €0 
Seat 2: maxxmeister folded before Flop (didn't bet)
Seat 3: BuBu 0187 folded before Flop (didn't bet)
Seat 4: Sreshta222 (button) folded before Flop (didn't bet)
Seat 5: vano7777 (small blind) folded before Flop
Seat 6: matiko09 (big blind) folded before Flop
Seat 7: er13to collected (€2.50)
Seat 8: mycka86 folded before Flop (didn't bet)
Seat 9: Priidix folded before Flop (didn't bet)





PokerStars Hand #148833128709:  Hold'em No Limit ($0.50/$1.00 USD) - 2016/02/15 11:08:06 CET [2016/02/15 5:08:06 ET]
Table 'Gemma II' 9-max Seat #5 is the button
Seat 1: Igor DoUrden ($170.94 in chips) 
Seat 2: er13to ($132.28 in chips) 
Seat 3: Venomous100% ($163.01 in chips) 
Seat 4: mycka86 ($100 in chips) 
Seat 5: PokerSash201 ($60.25 in chips) 
Seat 6: IHouseMusic ($100.50 in chips) 
Seat 7: AlKatrone ($129.49 in chips) 
Seat 9: matiko09 ($106.55 in chips) 
IHouseMusic: posts small blind $0.50
AlKatrone: posts big blind $1
Priidix: sits out 
*** HOLE CARDS ***
Dealt to matiko09 [2s 7c]
matiko09: folds 
Igor DoUrden: folds 
er13to: folds 
Venomous100%: folds 
mycka86: folds 
PokerSash201: raises $1 to $2
IHouseMusic: calls $1.50
AlKatrone: calls $1
*** FLOP *** [6s Jh 3s]
IHouseMusic: checks 
AlKatrone: checks 
PokerSash201: checks 
*** TURN *** [6s Jh 3s] [4s]
IHouseMusic: checks 
AlKatrone: bets $4.30
PokerSash201: calls $4.30
IHouseMusic: folds 
*** RIVER *** [6s Jh 3s 4s] [Kh]
AlKatrone: bets $8
PokerSash201: raises $8 to $16
AlKatrone: folds 
Uncalled bet ($8) returned to PokerSash201
PokerSash201 collected $29.22 from pot
PokerSash201: doesn't show hand 
*** SUMMARY ***
Total pot $30.60 | Rake $1.38 
Board [6s Jh 3s 4s Kh]
Seat 1: Igor DoUrden folded before Flop (didn't bet)
Seat 2: er13to folded before Flop (didn't bet)
Seat 3: Venomous100% folded before Flop (didn't bet)
Seat 4: mycka86 folded before Flop (didn't bet)
Seat 5: PokerSash201 (button) collected ($29.22)
Seat 6: IHouseMusic (small blind) folded on the Turn
Seat 7: AlKatrone (big blind) folded on the River
Seat 9: matiko09 folded before Flop (didn't bet)





PokerStars Hand #148833129837:  Hold'em No Limit ($0.50/$1.00 USD) - 2016/02/15 11:08:08 CET [2016/02/15 5:08:08 ET]
Table 'Euanthe II' 9-max Seat #4 is the button
Seat 1: maxxmeister ($128.44 in chips) 
Seat 2: mycka86 ($271.43 in chips) 
Seat 3: Sreshta222 ($100 in chips) 
Seat 4: er13to ($111.58 in chips) 
Seat 7: vinniesmol ($215.49 in chips) 
Seat 8: matiko09 ($123.79 in chips) 
Seat 9: Venomous100% ($101.50 in chips) 
vinniesmol: posts small blind $0.50
matiko09: posts big blind $1
*** HOLE CARDS ***
Dealt to matiko09 [8s Jd]
Venomous100%: raises $2 to $3
maxxmeister: folds 
mycka86: folds 
Sreshta222: folds 
er13to: folds 
vinniesmol: calls $2.50
matiko09: folds 
*** FLOP *** [3c 9d 2d]
vinniesmol: checks 
Venomous100%: checks 
*** TURN *** [3c 9d 2d] [2s]
vinniesmol: bets $5
Venomous100%: folds 
Uncalled bet ($5) returned to vinniesmol
vinniesmol collected $6.68 from pot
*** SUMMARY ***
Total pot $7 | Rake $0.32 
Board [3c 9d 2d 2s]
Seat 1: maxxmeister folded before Flop (didn't bet)
Seat 2: mycka86 folded before Flop (didn't bet)
Seat 3: Sreshta222 folded before Flop (didn't bet)
Seat 4: er13to (button) folded before Flop (didn't bet)
Seat 7: vinniesmol (small blind) collected ($6.68)
Seat 8: matiko09 (big blind) folded before Flop
Seat 9: Venomous100% folded on the Turn





PokerStars Hand #148833130817:  Hold'em No Limit ($0.50/$1.00 USD) - 2016/02/15 11:08:10 CET [2016/02/15 5:08:10 ET]
Table 'Sekanina' 9-max Seat #5 is the button
Seat 1: LUTZ_11111 ($58.01 in chips) 
Seat 2: Priidix ($124.83 in chips) 
Seat 4: matiko09 ($100 in chips) 
Seat 5: IHouseMusic ($119.90 in chips) 
Seat 6: vinniesmol ($223.87 in chips) 
Seat 7: mycka86 ($100 in chips) 
Seat 8: Venomous100% ($100 in chips) 
Seat 9: er13to ($101 in chips) 
vinniesmol: posts small blind $0.50
mycka86: posts big blind $1
*** HOLE CARDS ***
Dealt to matiko09 [8h 6s]
Venomous100%: folds 
er13to: folds 
LUTZ_11111: folds 
Priidix: folds 
matiko09: folds 
IHouseMusic: raises $1 to $2
vinniesmol: folds 
mycka86: calls $1
*** FLOP *** [Qc Qd Td]
mycka86: checks 
IHouseMusic: bets $3.02
mycka86: folds 
Uncalled bet ($3.02) returned to IHouseMusic
IHouseMusic collected $4.30 from pot
IHouseMusic: doesn't show hand 
*** SUMMARY ***
Total pot $4.50 | Rake $0.20 
Board [Qc Qd Td]
Seat 1: LUTZ_11111 folded before Flop (didn't bet)
Seat 2: Priidix folded before Flop (didn't bet)
Seat 4: matiko09 folded before Flop (didn't bet)
Seat 5: IHouseMusic (button) collected ($4.30)
Seat 6: vinniesmol (small blind) folded before Flop
Seat 7: mycka86 (big blind) folded on the Flop
Seat 8: Venomous100% folded before Flop (didn't bet)
Seat 9: er13to folded before Flop (didn't bet)





PokerStars Hand #148833132080:  Hold'em No Limit ($0.50/$1.00 USD) - 2016/02/15 11:08:13 CET [2016/02/15 5:08:13 ET]
Table 'Corvus III' 9-max Seat #3 is the button
Seat 1: agritom ($242.36 in chips) 
Seat 2: mzsportline ($86.80 in chips) 
Seat 3: VanDobeln ($248.10 in chips) 
Seat 4: goransyruvka ($68.75 in chips) 
Seat 6: Priidix ($142.11 in chips) 
Seat 7: matiko09 ($208.36 in chips) 
Seat 8: redacesfull ($163.74 in chips) 
Seat 9: er13to ($100 in chips) 
goransyruvka: posts small blind $0.50
Priidix: posts big blind $1
agritom: posts the ante $0.20
mzsportline: posts the ante $0.20
VanDobeln: posts the ante $0.20
goransyruvka: posts the ante $0.20
Priidix: posts the ante $0.20
matiko09: posts the ante $0.20
redacesfull: posts the ante $0.20
er13to: posts the ante $0.20
*** HOLE CARDS ***
Dealt to matiko09 [Kc 5s]
matiko09: folds 
redacesfull: folds 
er13to: folds 
agritom: folds 
mzsportline: raises $2 to $3
VanDobeln: folds 
goransyruvka: calls $2.50
Priidix: folds 
*** FLOP *** [Kd 8d Jd]
goransyruvka: checks 
mzsportline: bets $6
goransyruvka: calls $6
*** TURN *** [Kd 8d Jd] [As]
goransyruvka: checks 
mzsportline: checks 
*** RIVER *** [Kd 8d Jd As] [6c]
goransyruvka: bets $19.67
mzsportline: folds 
Uncalled bet ($19.67) returned to goransyruvka
goransyruvka collected $19.67 from pot
goransyruvka: doesn't show hand 
*** SUMMARY ***
Total pot $20.60 | Rake $0.93 
Board [Kd 8d Jd As 6c]
Seat 1: agritom folded before Flop (didn't bet)
Seat 2: mzsportline folded on the River
Seat 3: VanDobeln (button) folded before Flop (didn't bet)
Seat 4: goransyruvka (small blind) collected ($19.67)
Seat 6: Priidix (big blind) folded before Flop
Seat 7: matiko09 folded before Flop (didn't bet)
Seat 8: redacesfull folded before Flop (didn't bet)
Seat 9: er13to folded before Flop (didn't bet)





PokerStars Hand #148833133940:  Hold'em No Limit ($0.50/$1.00 USD) - 2016/02/15 11:08:17 CET [2016/02/15 5:08:17 ET]
Table 'Praecipua' 9-max Seat #9 is the button
Seat 1: er13to ($100 in chips) 
Seat 2: matiko09 ($121.07 in chips) 
Seat 3: Venomous100% ($110.32 in chips) 
Seat 4: Priidix ($105 in chips) 
Seat 5: huffwag ($162.49 in chips) 
Seat 6: mycka86 ($110.60 in chips) 
Seat 7: maxxmeister ($141.91 in chips) 
Seat 8: Ellis Ng ($40 in chips) 
Seat 9: AlKatrone ($100 in chips) 
er13to: posts small blind $0.50
matiko09: posts big blind $1
*** HOLE CARDS ***
Dealt to matiko09 [Jd Kd]
Venomous100%: folds 
Priidix: folds 
huffwag: folds 
mycka86: folds 
maxxmeister: raises $2 to $3
Ellis Ng: folds 
AlKatrone: calls $3
er13to: folds 
matiko09: calls $2
*** FLOP *** [6h 6d Qs]
matiko09: checks 
maxxmeister: bets $5
AlKatrone: folds 
matiko09: folds 
Uncalled bet ($5) returned to maxxmeister
maxxmeister collected $9.07 from pot
maxxmeister: doesn't show hand 
*** SUMMARY ***
Total pot $9.50 | Rake $0.43 
Board [6h 6d Qs]
Seat 1: er13to (small blind) folded before Flop
Seat 2: matiko09 (big blind) folded on the Flop
Seat 3: Venomous100% folded before Flop (didn't bet)
Seat 4: Priidix folded before Flop (didn't bet)
Seat 5: huffwag folded before Flop (didn't bet)
Seat 6: mycka86 folded before Flop (didn't bet)
Seat 7: maxxmeister collected ($9.07)
Seat 8: Ellis Ng folded before Flop (didn't bet)
Seat 9: AlKatrone (button) folded on the Flop





PokerStars Hand #148833138267:  Hold'em No Limit ($0.25/$0.50 USD) - 2016/02/15 11:08:27 CET [2016/02/15 5:08:27 ET]
Table 'Vesta II' 9-max Seat #7 is the button
Seat 1: Ahangama ($100.33 in chips) 
Seat 2: i L00K great ($50 in chips) 
Seat 3: matiko09 ($73.95 in chips) 
Seat 4: vlad11122007 ($49.25 in chips) 
Seat 5: dndngod ($76.15 in chips) 
Seat 6: pandalapa ($50 in chips) 
Seat 7: ruyingren ($27.04 in chips) 
Seat 8: Arystan ($70.75 in chips) 
Seat 9: Aoki42 ($82.14 in chips) 
Arystan: posts small blind $0.25
Aoki42: posts big blind $0.50
*** HOLE CARDS ***
Dealt to matiko09 [Kh 7h]
Ahangama: raises $0.75 to $1.25
i L00K great: folds 
matiko09: folds 
vlad11122007: folds 
dndngod: folds 
pandalapa: folds 
ruyingren: folds 
Arystan: folds 
Aoki42: folds 
Uncalled bet ($0.75) returned to Ahangama
Ahangama collected $1.25 from pot
Ahangama: doesn't show hand 
*** SUMMARY ***
Total pot $1.25 | Rake $0 
Seat 1: Ahangama collected ($1.25)
Seat 2: i L00K great folded before Flop (didn't bet)
Seat 3: matiko09 folded before Flop (didn't bet)
Seat 4: vlad11122007 folded before Flop (didn't bet)
Seat 5: dndngod folded before Flop (didn't bet)
Seat 6: pandalapa folded before Flop (didn't bet)
Seat 7: ruyingren (button) folded before Flop (didn't bet)
Seat 8: Arystan (small blind) folded before Flop
Seat 9: Aoki42 (big blind) folded before Flop





PokerStars Hand #148833141096:  Hold'em No Limit ($0.50/$1.00 USD) - 2016/02/15 11:08:33 CET [2016/02/15 5:08:33 ET]
Table 'Octans II' 9-max Seat #2 is the button
Seat 1: maxxmeister ($101.86 in chips) 
Seat 2: matiko09 ($100 in chips) 
Seat 3: Aalleekks ($100 in chips) 
Seat 4: Venomous100% ($166.30 in chips) 
Seat 5: AlKatrone ($100 in chips) 
Seat 6: er13to ($100 in chips) 
Seat 7: traficblues ($115.07 in chips) 
Seat 8: IHouseMusic ($139.47 in chips) 
Seat 9: mycka86 ($110.63 in chips) 
Aalleekks: posts small blind $0.50
Venomous100%: posts big blind $1
*** HOLE CARDS ***
Dealt to matiko09 [Ac 4s]
AlKatrone: folds 
er13to: folds 
traficblues: calls $1
IHouseMusic: folds 
mycka86: folds 
maxxmeister: folds 
matiko09: raises $3 to $4
Aalleekks: folds 
Venomous100%: calls $3
traficblues: calls $3
*** FLOP *** [Ad 5d 2h]
Venomous100%: checks 
traficblues: checks 
matiko09: bets $7
Venomous100%: folds 
traficblues: folds 
Uncalled bet ($7) returned to matiko09
matiko09 collected $11.94 from pot
matiko09: doesn't show hand 
*** SUMMARY ***
Total pot $12.50 | Rake $0.56 
Board [Ad 5d 2h]
Seat 1: maxxmeister folded before Flop (didn't bet)
Seat 2: matiko09 (button) collected ($11.94)
Seat 3: Aalleekks (small blind) folded before Flop
Seat 4: Venomous100% (big blind) folded on the Flop
Seat 5: AlKatrone folded before Flop (didn't bet)
Seat 6: er13to folded before Flop (didn't bet)
Seat 7: traficblues folded on the Flop
Seat 8: IHouseMusic folded before Flop (didn't bet)
Seat 9: mycka86 folded before Flop (didn't bet)





PokerStars Hand #148833141946:  Hold'em No Limit ($0.50/$1.00 USD) - 2016/02/15 11:08:35 CET [2016/02/15 5:08:35 ET]
Table 'Anteros' 9-max Seat #6 is the button
Seat 1: redacesfull ($106.05 in chips) 
Seat 2: IHouseMusic ($104.44 in chips) 
Seat 3: er13to ($105.74 in chips) 
Seat 4: misherei ($199.01 in chips) 
Seat 5: Holm1991 ($65.48 in chips) 
Seat 6: SerAlGog ($138.31 in chips) 
Seat 7: Zoubou1983 ($144.36 in chips) 
Seat 8: matiko09 ($100 in chips) 
Zoubou1983: posts small blind $0.50
matiko09: posts big blind $1
mycka86: sits out 
*** HOLE CARDS ***
Dealt to matiko09 [6c 3h]
redacesfull: folds 
IHouseMusic: folds 
er13to: folds 
misherei: folds 
Holm1991: calls $1
SerAlGog: folds 
Zoubou1983: calls $0.50
matiko09: checks 
*** FLOP *** [Ts 9c 2s]
Zoubou1983: checks 
matiko09: checks 
Holm1991: checks 
*** TURN *** [Ts 9c 2s] [8c]
Zoubou1983: checks 
matiko09: checks 
Holm1991: checks 
*** RIVER *** [Ts 9c 2s 8c] [4s]
Zoubou1983: checks 
matiko09: checks 
Holm1991: checks 
*** SHOW DOWN ***
Zoubou1983: shows [2d Ad] (a pair of Deuces)
matiko09: mucks hand 
Holm1991: mucks hand 
Zoubou1983 collected $2.86 from pot
*** SUMMARY ***
Total pot $3 | Rake $0.14 
Board [Ts 9c 2s 8c 4s]
Seat 1: redacesfull folded before Flop (didn't bet)
Seat 2: IHouseMusic folded before Flop (didn't bet)
Seat 3: er13to folded before Flop (didn't bet)
Seat 4: misherei folded before Flop (didn't bet)
Seat 5: Holm1991 mucked [7d As]
Seat 6: SerAlGog (button) folded before Flop (didn't bet)
Seat 7: Zoubou1983 (small blind) showed [2d Ad] and won ($2.86) with a pair of Deuces
Seat 8: matiko09 (big blind) mucked [6c 3h]





PokerStars Hand #148833147543:  Hold'em No Limit (€0.25/€0.50 EUR) - 2016/02/15 11:08:47 CET [2016/02/15 5:08:47 ET]
Table 'Walinskia II' 9-max Seat #4 is the button
Seat 1: ljryviltj (€50.84 in chips) 
Seat 2: yats87 (€55.70 in chips) 
Seat 3: beluccix (€24.91 in chips) 
Seat 4: Otsime (€26.30 in chips) 
Seat 5: vano7777 (€65.80 in chips) 
Seat 6: 50CandyJoe (€68.54 in chips) 
Seat 7: etny99 (€50 in chips) 
Seat 8: matiko09 (€74.63 in chips) 
Seat 9: Ahangama (€53.54 in chips) 
vano7777: posts small blind €0.25
50CandyJoe: posts big blind €0.50
*** HOLE CARDS ***
Dealt to matiko09 [Tc 6d]
etny99: folds 
matiko09: folds 
Ahangama: folds 
ljryviltj: folds 
yats87: raises €1 to €1.50
beluccix: folds 
Otsime: folds 
vano7777: folds 
50CandyJoe: folds 
Uncalled bet (€1) returned to yats87
yats87 collected €1.25 from pot
yats87: doesn't show hand 
*** SUMMARY ***
Total pot €1.25 | Rake €0 
Seat 1: ljryviltj folded before Flop (didn't bet)
Seat 2: yats87 collected (€1.25)
Seat 3: beluccix folded before Flop (didn't bet)
Seat 4: Otsime (button) folded before Flop (didn't bet)
Seat 5: vano7777 (small blind) folded before Flop
Seat 6: 50CandyJoe (big blind) folded before Flop
Seat 7: etny99 folded before Flop (didn't bet)
Seat 8: matiko09 folded before Flop (didn't bet)
Seat 9: Ahangama folded before Flop (didn't bet)





PokerStars Hand #148833147605:  Hold'em No Limit ($0.50/$1.00 USD) - 2016/02/15 11:08:47 CET [2016/02/15 5:08:47 ET]
Table 'Sekanina' 9-max Seat #6 is the button
Seat 1: LUTZ_11111 ($58.01 in chips) 
Seat 2: Priidix ($124.83 in chips) 
Seat 4: matiko09 ($100 in chips) 
Seat 5: IHouseMusic ($122.20 in chips) 
Seat 6: vinniesmol ($223.37 in chips) 
Seat 7: mycka86 ($100 in chips) 
Seat 8: Venomous100% ($100 in chips) 
Seat 9: er13to ($101 in chips) 
mycka86: posts small blind $0.50
Venomous100%: posts big blind $1
*** HOLE CARDS ***
Dealt to matiko09 [4h Ah]
er13to: folds 
LUTZ_11111: folds 
Priidix: folds 
matiko09: raises $2 to $3
IHouseMusic: folds 
vinniesmol: calls $3
mycka86: folds 
Venomous100%: calls $2
*** FLOP *** [8c As 8s]
Venomous100%: checks 
matiko09: bets $5
vinniesmol: calls $5
Venomous100%: calls $5
*** TURN *** [8c As 8s] [6h]
Venomous100%: checks 
matiko09: checks 
vinniesmol: bets $13
Venomous100%: calls $13
matiko09: folds 
*** RIVER *** [8c As 8s 6h] [6c]
Venomous100%: checks 
vinniesmol: bets $31
Venomous100%: folds 
Uncalled bet ($31) returned to vinniesmol
vinniesmol collected $48.23 from pot
*** SUMMARY ***
Total pot $50.50 | Rake $2.27 
Board [8c As 8s 6h 6c]
Seat 1: LUTZ_11111 folded before Flop (didn't bet)
Seat 2: Priidix folded before Flop (didn't bet)
Seat 4: matiko09 folded on the Turn
Seat 5: IHouseMusic folded before Flop (didn't bet)
Seat 6: vinniesmol (button) collected ($48.23)
Seat 7: mycka86 (small blind) folded before Flop
Seat 8: Venomous100% (big blind) folded on the River
Seat 9: er13to folded before Flop (didn't bet)





PokerStars Hand #148833150621:  Hold'em No Limit (€0.50/€1.00 EUR) - 2016/02/15 11:08:54 CET [2016/02/15 5:08:54 ET]
Table 'Ganesa II' 9-max Seat #5 is the button
Seat 2: maxxmeister (€102.61 in chips) 
Seat 3: BuBu 0187 (€74.20 in chips) 
Seat 4: Sreshta222 (€103 in chips) 
Seat 5: vano7777 (€73.74 in chips) 
Seat 6: matiko09 (€100 in chips) 
Seat 7: er13to (€115 in chips) 
Seat 8: mycka86 (€100 in chips) 
Seat 9: Priidix (€109.21 in chips) 
matiko09: posts small blind €0.50
er13to: posts big blind €1
*** HOLE CARDS ***
Dealt to matiko09 [Kc Qc]
mycka86: raises €2 to €3
Priidix: calls €3
maxxmeister: folds 
BuBu 0187: calls €3
Sreshta222: folds 
vano7777: folds 
matiko09: raises €11 to €14
er13to: folds 
mycka86: folds 
Priidix: folds 
BuBu 0187: folds 
Uncalled bet (€11) returned to matiko09
matiko09 collected €13 from pot
matiko09: doesn't show hand 
*** SUMMARY ***
Total pot €13 | Rake €0 
Seat 2: maxxmeister folded before Flop (didn't bet)
Seat 3: BuBu 0187 folded before Flop
Seat 4: Sreshta222 folded before Flop (didn't bet)
Seat 5: vano7777 (button) folded before Flop (didn't bet)
Seat 6: matiko09 (small blind) collected (€13)
Seat 7: er13to (big blind) folded before Flop
Seat 8: mycka86 folded before Flop
Seat 9: Priidix folded before Flop





PokerStars Hand #148833151857:  Hold'em No Limit ($0.25/$0.50 USD) - 2016/02/15 11:08:57 CET [2016/02/15 5:08:57 ET]
Table 'Vesta II' 9-max Seat #8 is the button
Seat 1: Ahangama ($101.08 in chips) 
Seat 2: i L00K great ($50 in chips) 
Seat 3: matiko09 ($73.95 in chips) 
Seat 4: vlad11122007 ($49.25 in chips) 
Seat 5: dndngod ($76.15 in chips) 
Seat 6: pandalapa ($50 in chips) 
Seat 7: ruyingren ($27.04 in chips) 
Seat 8: Arystan ($70.50 in chips) 
Seat 9: Aoki42 ($81.64 in chips) 
Aoki42: posts small blind $0.25
Ahangama: posts big blind $0.50
*** HOLE CARDS ***
Dealt to matiko09 [3s 5d]
i L00K great: folds 
matiko09: folds 
vlad11122007: folds 
dndngod: folds 
pandalapa: raises $1 to $1.50
ruyingren: folds 
Arystan: raises $2.50 to $4
Aoki42: folds 
Ahangama: folds 
pandalapa: calls $2.50
*** FLOP *** [4s Jd Kc]
pandalapa: checks 
Arystan: bets $4.18
pandalapa: folds 
Uncalled bet ($4.18) returned to Arystan
Arystan collected $8.36 from pot
Arystan: doesn't show hand 
*** SUMMARY ***
Total pot $8.75 | Rake $0.39 
Board [4s Jd Kc]
Seat 1: Ahangama (big blind) folded before Flop
Seat 2: i L00K great folded before Flop (didn't bet)
Seat 3: matiko09 folded before Flop (didn't bet)
Seat 4: vlad11122007 folded before Flop (didn't bet)
Seat 5: dndngod folded before Flop (didn't bet)
Seat 6: pandalapa folded on the Flop
Seat 7: ruyingren folded before Flop (didn't bet)
Seat 8: Arystan (button) collected ($8.36)
Seat 9: Aoki42 (small blind) folded before Flop





PokerStars Hand #148833152551:  Hold'em No Limit ($0.50/$1.00 USD) - 2016/02/15 11:08:58 CET [2016/02/15 5:08:58 ET]
Table 'Euanthe II' 9-max Seat #7 is the button
Seat 1: maxxmeister ($128.44 in chips) 
Seat 2: mycka86 ($271.43 in chips) 
Seat 3: Sreshta222 ($100 in chips) 
Seat 4: er13to ($111.58 in chips) 
Seat 5: damienwilde ($62.86 in chips) 
Seat 7: vinniesmol ($219.17 in chips) 
Seat 8: matiko09 ($122.79 in chips) 
matiko09: posts small blind $0.50
Venomous100%: is sitting out 
maxxmeister: posts big blind $1
damienwilde: posts small & big blinds $1.50
*** HOLE CARDS ***
Dealt to matiko09 [Ks Ac]
mycka86: folds 
Sreshta222: folds 
ChefCatalin was removed from the table for failing to post
er13to: folds 
IHouseMusic joins the table at seat #6 
damienwilde: checks 
vinniesmol: folds 
matiko09: raises $4 to $5
maxxmeister: folds 
damienwilde: calls $4
*** FLOP *** [Js 4c 8d]
matiko09: checks 
damienwilde: checks 
*** TURN *** [Js 4c 8d] [8h]
matiko09: checks 
damienwilde: checks 
*** RIVER *** [Js 4c 8d 8h] [7d]
matiko09: checks 
damienwilde: checks 
*** SHOW DOWN ***
matiko09: shows [Ks Ac] (a pair of Eights)
damienwilde: mucks hand 
matiko09 collected $10.98 from pot
*** SUMMARY ***
Total pot $11.50 | Rake $0.52 
Board [Js 4c 8d 8h 7d]
Seat 1: maxxmeister (big blind) folded before Flop
Seat 2: mycka86 folded before Flop (didn't bet)
Seat 3: Sreshta222 folded before Flop (didn't bet)
Seat 4: er13to folded before Flop (didn't bet)
Seat 5: damienwilde mucked [Qd Tc]
Seat 7: vinniesmol (button) folded before Flop (didn't bet)
Seat 8: matiko09 (small blind) showed [Ks Ac] and won ($10.98) with a pair of Eights





PokerStars Hand #148833158977:  Hold'em No Limit ($0.25/$0.50 USD) - 2016/02/15 11:09:12 CET [2016/02/15 5:09:12 ET]
Table 'Laertes II' 9-max Seat #4 is the button
Seat 1: dade33 ($96.89 in chips) 
Seat 2: beluccix ($24.96 in chips) 
Seat 3: ljryviltj ($59.05 in chips) 
Seat 4: rgar93 ($39.97 in chips) 
Seat 5: vlad11122007 ($48.94 in chips) 
Seat 6: yats87 ($60.91 in chips) 
Seat 8: Trent444 ($44.28 in chips) 
Seat 9: matiko09 ($50 in chips) 
vlad11122007: posts small blind $0.25
yats87: posts big blind $0.50
*** HOLE CARDS ***
Dealt to matiko09 [Qs 9d]
Trent444: folds 
matiko09: folds 
dade33: folds 
beluccix: folds 
ljryviltj: folds 
rgar93: folds 
vlad11122007: raises $1 to $1.50
yats87: calls $1
*** FLOP *** [7s 3c 6d]
vlad11122007: bets $1.94
yats87: folds 
Uncalled bet ($1.94) returned to vlad11122007
vlad11122007 collected $2.86 from pot
vlad11122007: doesn't show hand 
*** SUMMARY ***
Total pot $3 | Rake $0.14 
Board [7s 3c 6d]
Seat 1: dade33 folded before Flop (didn't bet)
Seat 2: beluccix folded before Flop (didn't bet)
Seat 3: ljryviltj folded before Flop (didn't bet)
Seat 4: rgar93 (button) folded before Flop (didn't bet)
Seat 5: vlad11122007 (small blind) collected ($2.86)
Seat 6: yats87 (big blind) folded on the Flop
Seat 8: Trent444 folded before Flop (didn't bet)
Seat 9: matiko09 folded before Flop (didn't bet)





PokerStars Hand #148833159338:  Hold'em No Limit ($0.50/$1.00 USD) - 2016/02/15 11:09:13 CET [2016/02/15 5:09:13 ET]
Table 'Nata II' 9-max Seat #5 is the button
Seat 1: Priidix ($100 in chips) 
Seat 2: qqcom ($141.55 in chips) 
Seat 3: g00000se ($100 in chips) 
Seat 4: Good Dentist ($22.40 in chips) 
Seat 5: AGoodFell4 ($53.21 in chips) 
Seat 6: Arhistrareg ($109.90 in chips) 
Seat 7: er13to ($100 in chips) 
Seat 8: Igor DoUrden ($101.25 in chips) 
Seat 9: matiko09 ($104.87 in chips) 
Arhistrareg: posts small blind $0.50
er13to: posts big blind $1
*** HOLE CARDS ***
Dealt to matiko09 [Kc Jc]
Igor DoUrden: folds 
matiko09: raises $2 to $3
Priidix: folds 
qqcom: folds 
g00000se: folds 
Good Dentist: calls $3
AGoodFell4: folds 
Arhistrareg: calls $2.50
er13to: folds 
*** FLOP *** [6s As Th]
Arhistrareg: checks 
matiko09: checks 
Good Dentist: bets $6
Arhistrareg: folds 
matiko09: folds 
Uncalled bet ($6) returned to Good Dentist
Good Dentist collected $9.55 from pot
*** SUMMARY ***
Total pot $10 | Rake $0.45 
Board [6s As Th]
Seat 1: Priidix folded before Flop (didn't bet)
Seat 2: qqcom folded before Flop (didn't bet)
Seat 3: g00000se folded before Flop (didn't bet)
Seat 4: Good Dentist collected ($9.55)
Seat 5: AGoodFell4 (button) folded before Flop (didn't bet)
Seat 6: Arhistrareg (small blind) folded on the Flop
Seat 7: er13to (big blind) folded before Flop
Seat 8: Igor DoUrden folded before Flop (didn't bet)
Seat 9: matiko09 folded on the Flop





PokerStars Hand #148833161381:  Hold'em No Limit ($0.50/$1.00 USD) - 2016/02/15 11:09:18 CET [2016/02/15 5:09:18 ET]
Table 'Octans II' 9-max Seat #3 is the button
Seat 1: maxxmeister ($101.86 in chips) 
Seat 2: matiko09 ($107.94 in chips) 
Seat 3: Aalleekks ($100 in chips) 
Seat 4: Venomous100% ($162.30 in chips) 
Seat 5: AlKatrone ($100 in chips) 
Seat 6: er13to ($100 in chips) 
Seat 7: traficblues ($111.07 in chips) 
Seat 8: IHouseMusic ($139.47 in chips) 
Seat 9: mycka86 ($110.63 in chips) 
Venomous100%: posts small blind $0.50
AlKatrone: posts big blind $1
*** HOLE CARDS ***
Dealt to matiko09 [3c Ac]
er13to: folds 
traficblues: folds 
IHouseMusic: folds 
mycka86: folds 
maxxmeister: raises $2 to $3
matiko09: raises $6.50 to $9.50
Aalleekks: folds 
Venomous100%: folds 
AlKatrone: folds 
maxxmeister: folds 
Uncalled bet ($6.50) returned to matiko09
matiko09 collected $7.50 from pot
matiko09: doesn't show hand 
*** SUMMARY ***
Total pot $7.50 | Rake $0 
Seat 1: maxxmeister folded before Flop
Seat 2: matiko09 collected ($7.50)
Seat 3: Aalleekks (button) folded before Flop (didn't bet)
Seat 4: Venomous100% (small blind) folded before Flop
Seat 5: AlKatrone (big blind) folded before Flop
Seat 6: er13to folded before Flop (didn't bet)
Seat 7: traficblues folded before Flop (didn't bet)
Seat 8: IHouseMusic folded before Flop (didn't bet)
Seat 9: mycka86 folded before Flop (didn't bet)





PokerStars Hand #148833165352:  Hold'em No Limit (€0.25/€0.50 EUR) - 2016/02/15 11:09:26 CET [2016/02/15 5:09:26 ET]
Table 'Walinskia II' 9-max Seat #5 is the button
Seat 1: ljryviltj (€50.84 in chips) 
Seat 2: yats87 (€56.45 in chips) 
Seat 3: beluccix (€24.91 in chips) 
Seat 4: Otsime (€26.30 in chips) 
Seat 5: vano7777 (€65.55 in chips) 
Seat 6: 50CandyJoe (€68.04 in chips) 
Seat 7: etny99 (€50 in chips) 
Seat 8: matiko09 (€74.63 in chips) 
Seat 9: Ahangama (€53.54 in chips) 
50CandyJoe: posts small blind €0.25
etny99: posts big blind €0.50
*** HOLE CARDS ***
Dealt to matiko09 [9h 2s]
matiko09: folds 
Ahangama: folds 
ljryviltj: folds 
yats87: folds 
beluccix: folds 
Otsime: calls €0.50
vano7777: folds 
50CandyJoe: folds 
etny99: checks 
*** FLOP *** [4s 2c 8h]
etny99: checks 
Otsime: checks 
*** TURN *** [4s 2c 8h] [8c]
etny99: bets €0.89
Otsime: folds 
Uncalled bet (€0.89) returned to etny99
etny99 collected €1.19 from pot
etny99: doesn't show hand 
*** SUMMARY ***
Total pot €1.25 | Rake €0.06 
Board [4s 2c 8h 8c]
Seat 1: ljryviltj folded before Flop (didn't bet)
Seat 2: yats87 folded before Flop (didn't bet)
Seat 3: beluccix folded before Flop (didn't bet)
Seat 4: Otsime folded on the Turn
Seat 5: vano7777 (button) folded before Flop (didn't bet)
Seat 6: 50CandyJoe (small blind) folded before Flop
Seat 7: etny99 (big blind) collected (€1.19)
Seat 8: matiko09 folded before Flop (didn't bet)
Seat 9: Ahangama folded before Flop (didn't bet)





PokerStars Hand #148833168544:  Hold'em No Limit ($0.50/$1.00 USD) - 2016/02/15 11:09:33 CET [2016/02/15 5:09:33 ET]
Table 'Praecipua' 9-max Seat #1 is the button
Seat 1: er13to ($100 in chips) 
Seat 2: matiko09 ($118.07 in chips) 
Seat 3: Venomous100% ($110.32 in chips) 
Seat 4: Priidix ($105 in chips) 
Seat 5: huffwag ($162.49 in chips) 
Seat 6: mycka86 ($110.60 in chips) 
Seat 7: maxxmeister ($147.98 in chips) 
Seat 8: Ellis Ng ($40 in chips) 
Seat 9: AlKatrone ($100 in chips) 
matiko09: posts small blind $0.50
Venomous100%: posts big blind $1
*** HOLE CARDS ***
Dealt to matiko09 [Kc Qd]
Priidix: folds 
huffwag: folds 
mycka86: folds 
maxxmeister: folds 
Ellis Ng: folds 
AlKatrone: folds 
er13to: raises $1.50 to $2.50
matiko09: raises $6.50 to $9
Venomous100%: folds 
er13to: calls $6.50
*** FLOP *** [Ts 5c 4d]
matiko09: bets $9.43
er13to: calls $9.43
*** TURN *** [Ts 5c 4d] [As]
matiko09: bets $18.80
er13to: calls $18.80
*** RIVER *** [Ts 5c 4d As] [6h]
matiko09: checks 
er13to: checks 
*** SHOW DOWN ***
matiko09: shows [Kc Qd] (high card Ace)
er13to: shows [Ac 8h] (a pair of Aces)
er13to collected $72.66 from pot
*** SUMMARY ***
Total pot $75.46 | Rake $2.80 
Board [Ts 5c 4d As 6h]
Seat 1: er13to (button) showed [Ac 8h] and won ($72.66) with a pair of Aces
Seat 2: matiko09 (small blind) showed [Kc Qd] and lost with high card Ace
Seat 3: Venomous100% (big blind) folded before Flop
Seat 4: Priidix folded before Flop (didn't bet)
Seat 5: huffwag folded before Flop (didn't bet)
Seat 6: mycka86 folded before Flop (didn't bet)
Seat 7: maxxmeister folded before Flop (didn't bet)
Seat 8: Ellis Ng folded before Flop (didn't bet)
Seat 9: AlKatrone folded before Flop (didn't bet)





PokerStars Hand #148833169801:  Hold'em No Limit ($0.50/$1.00 USD) - 2016/02/15 11:09:36 CET [2016/02/15 5:09:36 ET]
Table 'Gemma II' 9-max Seat #6 is the button
Seat 1: Igor DoUrden ($170.94 in chips) 
Seat 2: er13to ($132.28 in chips) 
Seat 3: Venomous100% ($163.01 in chips) 
Seat 4: mycka86 ($100 in chips) 
Seat 5: PokerSash201 ($75.17 in chips) 
Seat 6: IHouseMusic ($100 in chips) 
Seat 7: AlKatrone ($115.19 in chips) 
Seat 8: Priidix ($101.66 in chips) 
Seat 9: matiko09 ($106.55 in chips) 
AlKatrone: posts small blind $0.50
Priidix: posts big blind $1
*** HOLE CARDS ***
Dealt to matiko09 [6h 6s]
matiko09: folds 
Igor DoUrden: folds 
er13to: folds 
Venomous100%: folds 
mycka86: folds 
PokerSash201: folds 
IHouseMusic: raises $1 to $2
AlKatrone: folds 
Priidix: folds 
Uncalled bet ($1) returned to IHouseMusic
IHouseMusic collected $2.50 from pot
IHouseMusic: doesn't show hand 
*** SUMMARY ***
Total pot $2.50 | Rake $0 
Seat 1: Igor DoUrden folded before Flop (didn't bet)
Seat 2: er13to folded before Flop (didn't bet)
Seat 3: Venomous100% folded before Flop (didn't bet)
Seat 4: mycka86 folded before Flop (didn't bet)
Seat 5: PokerSash201 folded before Flop (didn't bet)
Seat 6: IHouseMusic (button) collected ($2.50)
Seat 7: AlKatrone (small blind) folded before Flop
Seat 8: Priidix (big blind) folded before Flop
Seat 9: matiko09 folded before Flop (didn't bet)





PokerStars Hand #148833170161:  Hold'em No Limit ($0.50/$1.00 USD) - 2016/02/15 11:09:37 CET [2016/02/15 5:09:37 ET]
Table 'Corvus III' 9-max Seat #4 is the button
Seat 1: agritom ($242.16 in chips) 
Seat 2: mzsportline ($77.60 in chips) 
Seat 3: VanDobeln ($247.90 in chips) 
Seat 4: goransyruvka ($79.22 in chips) 
Seat 6: Priidix ($140.91 in chips) 
Seat 7: matiko09 ($208.16 in chips) 
Seat 8: redacesfull ($163.54 in chips) 
Seat 9: er13to ($100 in chips) 
koib88 will be allowed to play after the button
Priidix: posts small blind $0.50
matiko09: posts big blind $1
agritom: posts the ante $0.20
mzsportline: posts the ante $0.20
VanDobeln: posts the ante $0.20
goransyruvka: posts the ante $0.20
Priidix: posts the ante $0.20
matiko09: posts the ante $0.20
redacesfull: posts the ante $0.20
er13to: posts the ante $0.20
*** HOLE CARDS ***
Dealt to matiko09 [As 8c]
redacesfull: folds 
er13to: folds 
agritom: folds 
mzsportline: folds 
VanDobeln: folds 
goransyruvka: folds 
Priidix: folds 
Uncalled bet ($0.50) returned to matiko09
matiko09 collected $2.60 from pot
matiko09: doesn't show hand 
*** SUMMARY ***
Total pot $2.60 | Rake $0 
Seat 1: agritom folded before Flop (didn't bet)
Seat 2: mzsportline folded before Flop (didn't bet)
Seat 3: VanDobeln folded before Flop (didn't bet)
Seat 4: goransyruvka (button) folded before Flop (didn't bet)
Seat 6: Priidix (small blind) folded before Flop
Seat 7: matiko09 (big blind) collected ($2.60)
Seat 8: redacesfull folded before Flop (didn't bet)
Seat 9: er13to folded before Flop (didn't bet)





PokerStars Hand #148833170777:  Hold'em No Limit (€0.50/€1.00 EUR) - 2016/02/15 11:09:38 CET [2016/02/15 5:09:38 ET]
Table 'Ganesa II' 9-max Seat #6 is the button
Seat 2: maxxmeister (€102.61 in chips) 
Seat 3: BuBu 0187 (€71.20 in chips) 
Seat 4: Sreshta222 (€103 in chips) 
Seat 5: vano7777 (€73.74 in chips) 
Seat 6: matiko09 (€110 in chips) 
Seat 7: er13to (€114 in chips) 
Seat 8: mycka86 (€100 in chips) 
Seat 9: Priidix (€106.21 in chips) 
er13to: posts small blind €0.50
mycka86: posts big blind €1
*** HOLE CARDS ***
Dealt to matiko09 [Ad Jc]
Priidix: folds 
maxxmeister: folds 
BuBu 0187: folds 
Sreshta222: folds 
vano7777: folds 
matiko09: raises €1.27 to €2.27
er13to: folds 
mycka86: raises €6.23 to €8.50
matiko09: calls €6.23
*** FLOP *** [Jd 5s Qc]
mycka86: bets €9.19
matiko09: calls €9.19
*** TURN *** [Jd 5s Qc] [6d]
mycka86: checks 
matiko09: checks 
*** RIVER *** [Jd 5s Qc 6d] [4c]
mycka86: checks 
matiko09: checks 
*** SHOW DOWN ***
mycka86: shows [As Ks] (high card Ace)
matiko09: shows [Ad Jc] (a pair of Jacks)
matiko09 collected €34.27 from pot
*** SUMMARY ***
Total pot €35.88 | Rake €1.61 
Board [Jd 5s Qc 6d 4c]
Seat 2: maxxmeister folded before Flop (didn't bet)
Seat 3: BuBu 0187 folded before Flop (didn't bet)
Seat 4: Sreshta222 folded before Flop (didn't bet)
Seat 5: vano7777 folded before Flop (didn't bet)
Seat 6: matiko09 (button) showed [Ad Jc] and won (€34.27) with a pair of Jacks
Seat 7: er13to (small blind) folded before Flop
Seat 8: mycka86 (big blind) showed [As Ks] and lost with high card Ace
Seat 9: Priidix folded before Flop (didn't bet)





PokerStars Hand #148833174881:  Hold'em No Limit ($0.25/$0.50 USD) - 2016/02/15 11:09:47 CET [2016/02/15 5:09:47 ET]
Table 'Vesta II' 9-max Seat #9 is the button
Seat 1: Ahangama ($100.58 in chips) 
Seat 2: i L00K great ($50 in chips) 
Seat 3: matiko09 ($73.95 in chips) 
Seat 4: vlad11122007 ($49.25 in chips) 
Seat 5: dndngod ($76.15 in chips) 
Seat 6: pandalapa ($50 in chips) 
Seat 7: ruyingren ($27.04 in chips) 
Seat 8: Arystan ($74.86 in chips) 
Seat 9: Aoki42 ($81.39 in chips) 
Ahangama: posts small blind $0.25
i L00K great: posts big blind $0.50
*** HOLE CARDS ***
Dealt to matiko09 [5s 9c]
matiko09: folds 
vlad11122007: folds 
dndngod: folds 
pandalapa: folds 
ruyingren: folds 
Arystan: raises $1 to $1.50
Aoki42: calls $1.50
Ahangama: folds 
i L00K great: folds 
*** FLOP *** [7h Qd 8h]
Arystan: checks 
Aoki42: bets $2.36
Arystan: folds 
Uncalled bet ($2.36) returned to Aoki42
Aoki42 collected $3.58 from pot
Aoki42: doesn't show hand 
*** SUMMARY ***
Total pot $3.75 | Rake $0.17 
Board [7h Qd 8h]
Seat 1: Ahangama (small blind) folded before Flop
Seat 2: i L00K great (big blind) folded before Flop
Seat 3: matiko09 folded before Flop (didn't bet)
Seat 4: vlad11122007 folded before Flop (didn't bet)
Seat 5: dndngod folded before Flop (didn't bet)
Seat 6: pandalapa folded before Flop (didn't bet)
Seat 7: ruyingren folded before Flop (didn't bet)
Seat 8: Arystan folded on the Flop
Seat 9: Aoki42 (button) collected ($3.58)





PokerStars Hand #148833175968:  Hold'em No Limit ($0.50/$1.00 USD) - 2016/02/15 11:09:50 CET [2016/02/15 5:09:50 ET]
Table 'Corvus III' 9-max Seat #6 is the button
Seat 1: agritom ($241.96 in chips) 
Seat 2: mzsportline ($77.40 in chips) 
Seat 3: VanDobeln ($247.70 in chips) 
Seat 4: goransyruvka ($79.02 in chips) 
Seat 5: koib88 ($347.93 in chips) 
Seat 6: Priidix ($140.21 in chips) 
Seat 7: matiko09 ($210.06 in chips) 
Seat 8: redacesfull ($163.34 in chips) 
Seat 9: er13to ($100 in chips) 
matiko09: posts small blind $0.50
redacesfull: posts big blind $1
koib88: posts small & big blinds $1.50
agritom: posts the ante $0.20
mzsportline: posts the ante $0.20
VanDobeln: posts the ante $0.20
goransyruvka: posts the ante $0.20
koib88: posts the ante $0.20
Priidix: posts the ante $0.20
matiko09: posts the ante $0.20
redacesfull: posts the ante $0.20
er13to: posts the ante $0.20
*** HOLE CARDS ***
Dealt to matiko09 [5s Ah]
er13to: folds 
agritom: raises $2 to $3
mzsportline: folds 
VanDobeln: folds 
goransyruvka: calls $3
koib88: calls $2
Priidix: folds 
matiko09: folds 
redacesfull: folds 
*** FLOP *** [9d Qd 6d]
agritom: bets $9
goransyruvka: folds 
koib88: calls $9
*** TURN *** [9d Qd 6d] [2d]
agritom: bets $20
koib88: calls $20
*** RIVER *** [9d Qd 6d 2d] [Ac]
agritom: bets $52
koib88: calls $52
*** SHOW DOWN ***
agritom: shows [9s Tc] (a pair of Nines)
koib88: shows [Kd 3c] (a flush, King high)
koib88 collected $172 from pot
*** SUMMARY ***
Total pot $174.80 | Rake $2.80 
Board [9d Qd 6d 2d Ac]
Seat 1: agritom showed [9s Tc] and lost with a pair of Nines
Seat 2: mzsportline folded before Flop (didn't bet)
Seat 3: VanDobeln folded before Flop (didn't bet)
Seat 4: goransyruvka folded on the Flop
Seat 5: koib88 showed [Kd 3c] and won ($172) with a flush, King high
Seat 6: Priidix (button) folded before Flop (didn't bet)
Seat 7: matiko09 (small blind) folded before Flop
Seat 8: redacesfull (big blind) folded before Flop
Seat 9: er13to folded before Flop (didn't bet)





PokerStars Hand #148833176965:  Hold'em No Limit ($0.50/$1.00 USD) - 2016/02/15 11:09:52 CET [2016/02/15 5:09:52 ET]
Table 'Euanthe II' 9-max Seat #8 is the button
Seat 1: maxxmeister ($127.44 in chips) 
Seat 2: mycka86 ($271.43 in chips) 
Seat 3: Sreshta222 ($100 in chips) 
Seat 4: er13to ($111.58 in chips) 
Seat 5: damienwilde ($57.36 in chips) 
Seat 7: vinniesmol ($219.17 in chips) 
Seat 8: matiko09 ($128.77 in chips) 
Venomous100% will be allowed to play after the button
maxxmeister: posts small blind $0.50
mycka86: posts big blind $1
IHouseMusic: sits out 
*** HOLE CARDS ***
Dealt to matiko09 [Qd 4c]
Sreshta222: folds 
er13to: folds 
damienwilde: raises $3 to $4
vinniesmol: folds 
matiko09: folds 
maxxmeister: folds 
mycka86: folds 
Uncalled bet ($3) returned to damienwilde
damienwilde collected $2.50 from pot
damienwilde: doesn't show hand 
*** SUMMARY ***
Total pot $2.50 | Rake $0 
Seat 1: maxxmeister (small blind) folded before Flop
Seat 2: mycka86 (big blind) folded before Flop
Seat 3: Sreshta222 folded before Flop (didn't bet)
Seat 4: er13to folded before Flop (didn't bet)
Seat 5: damienwilde collected ($2.50)
Seat 7: vinniesmol folded before Flop (didn't bet)
Seat 8: matiko09 (button) folded before Flop (didn't bet)





PokerStars Hand #148833177410:  Hold'em No Limit ($0.50/$1.00 USD) - 2016/02/15 11:09:53 CET [2016/02/15 5:09:53 ET]
Table 'Octans II' 9-max Seat #4 is the button
Seat 1: maxxmeister ($100 in chips) 
Seat 2: matiko09 ($112.44 in chips) 
Seat 3: Aalleekks ($100 in chips) 
Seat 4: Venomous100% ($161.80 in chips) 
Seat 5: AlKatrone ($100 in chips) 
Seat 6: er13to ($100 in chips) 
Seat 7: traficblues ($111.07 in chips) 
Seat 8: IHouseMusic ($139.47 in chips) 
Seat 9: mycka86 ($110.63 in chips) 
AlKatrone: posts small blind $0.50
er13to: posts big blind $1
*** HOLE CARDS ***
Dealt to matiko09 [4c 8c]
traficblues: calls $1
IHouseMusic: folds 
mycka86: folds 
maxxmeister: folds 
matiko09: folds 
Aalleekks: folds 
Venomous100%: folds 
AlKatrone: folds 
er13to: checks 
*** FLOP *** [9c Jh 5h]
er13to: checks 
traficblues: checks 
*** TURN *** [9c Jh 5h] [6s]
er13to: checks 
traficblues: checks 
*** RIVER *** [9c Jh 5h 6s] [Jc]
er13to: checks 
traficblues: checks 
*** SHOW DOWN ***
er13to: shows [4h 4s] (two pair, Jacks and Fours)
traficblues: mucks hand 
er13to collected $2.39 from pot
*** SUMMARY ***
Total pot $2.50 | Rake $0.11 
Board [9c Jh 5h 6s Jc]
Seat 1: maxxmeister folded before Flop (didn't bet)
Seat 2: matiko09 folded before Flop (didn't bet)
Seat 3: Aalleekks folded before Flop (didn't bet)
Seat 4: Venomous100% (button) folded before Flop (didn't bet)
Seat 5: AlKatrone (small blind) folded before Flop
Seat 6: er13to (big blind) showed [4h 4s] and won ($2.39) with two pair, Jacks and Fours
Seat 7: traficblues mucked [Ts Kd]
Seat 8: IHouseMusic folded before Flop (didn't bet)
Seat 9: mycka86 folded before Flop (didn't bet)





PokerStars Hand #148833183676:  Hold'em No Limit ($0.25/$0.50 USD) - 2016/02/15 11:10:07 CET [2016/02/15 5:10:07 ET]
Table 'Laertes II' 9-max Seat #5 is the button
Seat 1: dade33 ($96.89 in chips) 
Seat 2: beluccix ($24.96 in chips) 
Seat 3: ljryviltj ($59.05 in chips) 
Seat 4: rgar93 ($39.97 in chips) 
Seat 5: vlad11122007 ($50.30 in chips) 
Seat 6: yats87 ($59.41 in chips) 
Seat 7: Vedpapa ($62.42 in chips) 
Seat 8: Trent444 ($44.28 in chips) 
Seat 9: matiko09 ($50 in chips) 
yats87: posts small blind $0.25
Vedpapa: posts big blind $0.50
*** HOLE CARDS ***
Dealt to matiko09 [9s Jd]
Trent444: folds 
matiko09: folds 
dade33: folds 
beluccix: folds 
ljryviltj: folds 
rgar93: folds 
vlad11122007: folds 
yats87: raises $0.75 to $1.25
Vedpapa: folds 
Uncalled bet ($0.75) returned to yats87
yats87 collected $1 from pot
yats87: doesn't show hand 
*** SUMMARY ***
Total pot $1 | Rake $0 
Seat 1: dade33 folded before Flop (didn't bet)
Seat 2: beluccix folded before Flop (didn't bet)
Seat 3: ljryviltj folded before Flop (didn't bet)
Seat 4: rgar93 folded before Flop (didn't bet)
Seat 5: vlad11122007 (button) folded before Flop (didn't bet)
Seat 6: yats87 (small blind) collected ($1)
Seat 7: Vedpapa (big blind) folded before Flop
Seat 8: Trent444 folded before Flop (didn't bet)
Seat 9: matiko09 folded before Flop (didn't bet)





PokerStars Hand #148833183442:  Hold'em No Limit ($0.50/$1.00 USD) - 2016/02/15 11:10:07 CET [2016/02/15 5:10:07 ET]
Table 'Nata II' 9-max Seat #6 is the button
Seat 1: Priidix ($100 in chips) 
Seat 2: qqcom ($141.55 in chips) 
Seat 3: g00000se ($100 in chips) 
Seat 4: Good Dentist ($28.95 in chips) 
Seat 5: AGoodFell4 ($53.21 in chips) 
Seat 6: Arhistrareg ($106.90 in chips) 
Seat 7: er13to ($100 in chips) 
Seat 8: Igor DoUrden ($101.25 in chips) 
Seat 9: matiko09 ($101.87 in chips) 
er13to: posts small blind $0.50
Igor DoUrden: posts big blind $1
*** HOLE CARDS ***
Dealt to matiko09 [5d 4h]
matiko09: folds 
Priidix: folds 
qqcom: raises $2 to $3
g00000se: folds 
Good Dentist: folds 
AGoodFell4: folds 
Arhistrareg: folds 
er13to: raises $11.77 to $14.77
Igor DoUrden: folds 
qqcom: calls $11.77
*** FLOP *** [3s Ad Tc]
er13to: bets $19.25
qqcom: folds 
Uncalled bet ($19.25) returned to er13to
er13to collected $29.17 from pot
Arhistrareg leaves the table
*** SUMMARY ***
Total pot $30.54 | Rake $1.37 
Board [3s Ad Tc]
Seat 1: Priidix folded before Flop (didn't bet)
Seat 2: qqcom folded on the Flop
Seat 3: g00000se folded before Flop (didn't bet)
Seat 4: Good Dentist folded before Flop (didn't bet)
Seat 5: AGoodFell4 folded before Flop (didn't bet)
Seat 6: Arhistrareg (button) folded before Flop (didn't bet)
Seat 7: er13to (small blind) collected ($29.17)
Seat 8: Igor DoUrden (big blind) folded before Flop
Seat 9: matiko09 folded before Flop (didn't bet)





PokerStars Hand #148833184441:  Hold'em No Limit ($0.50/$1.00 USD) - 2016/02/15 11:10:09 CET [2016/02/15 5:10:09 ET]
Table 'Gemma II' 9-max Seat #7 is the button
Seat 1: Igor DoUrden ($170.94 in chips) 
Seat 2: er13to ($132.28 in chips) 
Seat 3: Venomous100% ($163.01 in chips) 
Seat 4: mycka86 ($100 in chips) 
Seat 5: PokerSash201 ($75.17 in chips) 
Seat 6: IHouseMusic ($101.50 in chips) 
Seat 7: AlKatrone ($114.69 in chips) 
Seat 8: Priidix ($100.66 in chips) 
Seat 9: matiko09 ($106.55 in chips) 
Priidix: posts small blind $0.50
matiko09: posts big blind $1
*** HOLE CARDS ***
Dealt to matiko09 [2c 8s]
Igor DoUrden: folds 
er13to: raises $1.50 to $2.50
Venomous100%: folds 
mycka86: folds 
PokerSash201: folds 
IHouseMusic: folds 
AlKatrone: folds 
Priidix: folds 
matiko09: folds 
Uncalled bet ($1.50) returned to er13to
er13to collected $2.50 from pot
*** SUMMARY ***
Total pot $2.50 | Rake $0 
Seat 1: Igor DoUrden folded before Flop (didn't bet)
Seat 2: er13to collected ($2.50)
Seat 3: Venomous100% folded before Flop (didn't bet)
Seat 4: mycka86 folded before Flop (didn't bet)
Seat 5: PokerSash201 folded before Flop (didn't bet)
Seat 6: IHouseMusic folded before Flop (didn't bet)
Seat 7: AlKatrone (button) folded before Flop (didn't bet)
Seat 8: Priidix (small blind) folded before Flop
Seat 9: matiko09 (big blind) folded before Flop





PokerStars Hand #148833185143:  Hold'em No Limit (€0.25/€0.50 EUR) - 2016/02/15 11:10:10 CET [2016/02/15 5:10:10 ET]
Table 'Walinskia II' 9-max Seat #6 is the button
Seat 1: ljryviltj (€50.84 in chips) 
Seat 2: yats87 (€56.45 in chips) 
Seat 3: beluccix (€24.91 in chips) 
Seat 4: Otsime (€25.80 in chips) 
Seat 5: vano7777 (€65.55 in chips) 
Seat 6: 50CandyJoe (€67.79 in chips) 
Seat 7: etny99 (€50.69 in chips) 
Seat 8: matiko09 (€74.63 in chips) 
Seat 9: Ahangama (€53.54 in chips) 
etny99: posts small blind €0.25
matiko09: posts big blind €0.50
*** HOLE CARDS ***
Dealt to matiko09 [Th 9h]
Ahangama: folds 
ljryviltj: folds 
yats87: folds 
beluccix: folds 
Otsime: calls €0.50
vano7777: folds 
50CandyJoe: raises €1.50 to €2
etny99: folds 
matiko09: calls €1.50
Otsime: calls €1.50
*** FLOP *** [2h 8d 4s]
matiko09: bets €3.10
Otsime: folds 
50CandyJoe: folds 
Uncalled bet (€3.10) returned to matiko09
matiko09 collected €5.97 from pot
matiko09: doesn't show hand 
*** SUMMARY ***
Total pot €6.25 | Rake €0.28 
Board [2h 8d 4s]
Seat 1: ljryviltj folded before Flop (didn't bet)
Seat 2: yats87 folded before Flop (didn't bet)
Seat 3: beluccix folded before Flop (didn't bet)
Seat 4: Otsime folded on the Flop
Seat 5: vano7777 folded before Flop (didn't bet)
Seat 6: 50CandyJoe (button) folded on the Flop
Seat 7: etny99 (small blind) folded before Flop
Seat 8: matiko09 (big blind) collected (€5.97)
Seat 9: Ahangama folded before Flop (didn't bet)





PokerStars Hand #148833187816:  Hold'em No Limit ($0.50/$1.00 USD) - 2016/02/15 11:10:16 CET [2016/02/15 5:10:16 ET]
Table 'Anteros' 9-max Seat #7 is the button
Seat 1: redacesfull ($106.05 in chips) 
Seat 2: IHouseMusic ($104.44 in chips) 
Seat 3: er13to ($105.74 in chips) 
Seat 4: misherei ($199.01 in chips) 
Seat 5: Holm1991 ($64.48 in chips) 
Seat 6: SerAlGog ($138.31 in chips) 
Seat 7: Zoubou1983 ($146.22 in chips) 
Seat 8: matiko09 ($100 in chips) 
Seat 9: mycka86 ($100 in chips) 
matiko09: posts small blind $0.50
mycka86: posts big blind $1
*** HOLE CARDS ***
Dealt to matiko09 [Tc 5h]
redacesfull: raises $1.12 to $2.12
IHouseMusic: folds 
er13to: folds 
misherei: folds 
Holm1991: calls $2.12
SerAlGog: folds 
Zoubou1983: calls $2.12
matiko09: folds 
mycka86: calls $1.12
*** FLOP *** [Ad Qs 8c]
mycka86: checks 
redacesfull: checks 
Holm1991: bets $4
Zoubou1983: calls $4
mycka86: folds 
redacesfull: folds 
*** TURN *** [Ad Qs 8c] [Qh]
Holm1991: bets $8
Zoubou1983: raises $10 to $18
Holm1991: folds 
Uncalled bet ($10) returned to Zoubou1983
Zoubou1983 collected $31.50 from pot
Zoubou1983: doesn't show hand 
*** SUMMARY ***
Total pot $32.98 | Rake $1.48 
Board [Ad Qs 8c Qh]
Seat 1: redacesfull folded on the Flop
Seat 2: IHouseMusic folded before Flop (didn't bet)
Seat 3: er13to folded before Flop (didn't bet)
Seat 4: misherei folded before Flop (didn't bet)
Seat 5: Holm1991 folded on the Turn
Seat 6: SerAlGog folded before Flop (didn't bet)
Seat 7: Zoubou1983 (button) collected ($31.50)
Seat 8: matiko09 (small blind) folded before Flop
Seat 9: mycka86 (big blind) folded on the Flop





PokerStars Hand #148833189774:  Hold'em No Limit ($0.50/$1.00 USD) - 2016/02/15 11:10:21 CET [2016/02/15 5:10:21 ET]
Table 'Euanthe II' 9-max Seat #1 is the button
Seat 1: maxxmeister ($126.94 in chips) 
Seat 2: mycka86 ($270.43 in chips) 
Seat 3: Sreshta222 ($100 in chips) 
Seat 4: er13to ($111.58 in chips) 
Seat 5: damienwilde ($58.86 in chips) 
Seat 7: vinniesmol ($219.17 in chips) 
Seat 8: matiko09 ($128.77 in chips) 
mycka86: posts small blind $0.50
Sreshta222: posts big blind $1
IHouseMusic: sits out 
Venomous100%: sits out 
*** HOLE CARDS ***
Dealt to matiko09 [7d 7c]
er13to: folds 
damienwilde: calls $1
vinniesmol: folds 
matiko09: raises $3 to $4
maxxmeister: folds 
mycka86: calls $3.50
Sreshta222: folds 
damienwilde: calls $3
*** FLOP *** [Ts 5s 8d]
mycka86: checks 
damienwilde: checks 
matiko09: checks 
*** TURN *** [Ts 5s 8d] [2c]
mycka86: checks 
damienwilde: bets $7
matiko09: folds 
mycka86: raises $14.53 to $21.53
damienwilde: calls $14.53
*** RIVER *** [Ts 5s 8d 2c] [Kh]
mycka86: bets $36.40
damienwilde: calls $33.33 and is all-in
Uncalled bet ($3.07) returned to mycka86
*** SHOW DOWN ***
mycka86: shows [Tc Th] (three of a kind, Tens)
damienwilde: shows [Kc 8s] (two pair, Kings and Eights)
mycka86 collected $119.92 from pot
*** SUMMARY ***
Total pot $122.72 | Rake $2.80 
Board [Ts 5s 8d 2c Kh]
Seat 1: maxxmeister (button) folded before Flop (didn't bet)
Seat 2: mycka86 (small blind) showed [Tc Th] and won ($119.92) with three of a kind, Tens
Seat 3: Sreshta222 (big blind) folded before Flop
Seat 4: er13to folded before Flop (didn't bet)
Seat 5: damienwilde showed [Kc 8s] and lost with two pair, Kings and Eights
Seat 7: vinniesmol folded before Flop (didn't bet)
Seat 8: matiko09 folded on the Turn





PokerStars Hand #148833195638:  Hold'em No Limit ($0.25/$0.50 USD) - 2016/02/15 11:10:34 CET [2016/02/15 5:10:34 ET]
Table 'Laertes II' 9-max Seat #6 is the button
Seat 1: dade33 ($96.89 in chips) 
Seat 2: beluccix ($24.96 in chips) 
Seat 3: ljryviltj ($59.05 in chips) 
Seat 4: rgar93 ($39.97 in chips) 
Seat 5: vlad11122007 ($50.30 in chips) 
Seat 6: yats87 ($59.91 in chips) 
Seat 7: Vedpapa ($61.92 in chips) 
Seat 8: Trent444 ($44.28 in chips) 
Seat 9: matiko09 ($50 in chips) 
Vedpapa: posts small blind $0.25
Trent444: posts big blind $0.50
*** HOLE CARDS ***
Dealt to matiko09 [As Kc]
matiko09: raises $1 to $1.50
dade33: folds 
beluccix: folds 
ljryviltj: folds 
rgar93: folds 
dade33 leaves the table
vlad11122007: folds 
yats87: folds 
Vedpapa: folds 
Trent444: calls $1
*** FLOP *** [2h Qd 2c]
Trent444: checks 
matiko09: bets $2.02
Trent444: folds 
Uncalled bet ($2.02) returned to matiko09
matiko09 collected $3.10 from pot
matiko09: doesn't show hand 
*** SUMMARY ***
Total pot $3.25 | Rake $0.15 
Board [2h Qd 2c]
Seat 1: dade33 folded before Flop (didn't bet)
Seat 2: beluccix folded before Flop (didn't bet)
Seat 3: ljryviltj folded before Flop (didn't bet)
Seat 4: rgar93 folded before Flop (didn't bet)
Seat 5: vlad11122007 folded before Flop (didn't bet)
Seat 6: yats87 (button) folded before Flop (didn't bet)
Seat 7: Vedpapa (small blind) folded before Flop
Seat 8: Trent444 (big blind) folded on the Flop
Seat 9: matiko09 collected ($3.10)





PokerStars Hand #148833200437:  Hold'em No Limit ($0.50/$1.00 USD) - 2016/02/15 11:10:45 CET [2016/02/15 5:10:45 ET]
Table 'Gemma II' 9-max Seat #8 is the button
Seat 1: Igor DoUrden ($170.94 in chips) 
Seat 2: er13to ($133.78 in chips) 
Seat 3: Venomous100% ($163.01 in chips) 
Seat 4: mycka86 ($100 in chips) 
Seat 5: PokerSash201 ($75.17 in chips) 
Seat 6: IHouseMusic ($101.50 in chips) 
Seat 7: AlKatrone ($114.69 in chips) 
Seat 8: Priidix ($100.16 in chips) 
Seat 9: matiko09 ($105.55 in chips) 
matiko09: posts small blind $0.50
Igor DoUrden: posts big blind $1
*** HOLE CARDS ***
Dealt to matiko09 [Kc 4h]
er13to: folds 
Venomous100%: folds 
mycka86: folds 
PokerSash201: folds 
IHouseMusic: folds 
AlKatrone: raises $1.50 to $2.50
Priidix: folds 
matiko09: folds 
Igor DoUrden: folds 
Uncalled bet ($1.50) returned to AlKatrone
AlKatrone collected $2.50 from pot
AlKatrone: doesn't show hand 
*** SUMMARY ***
Total pot $2.50 | Rake $0 
Seat 1: Igor DoUrden (big blind) folded before Flop
Seat 2: er13to folded before Flop (didn't bet)
Seat 3: Venomous100% folded before Flop (didn't bet)
Seat 4: mycka86 folded before Flop (didn't bet)
Seat 5: PokerSash201 folded before Flop (didn't bet)
Seat 6: IHouseMusic folded before Flop (didn't bet)
Seat 7: AlKatrone collected ($2.50)
Seat 8: Priidix (button) folded before Flop (didn't bet)
Seat 9: matiko09 (small blind) folded before Flop





PokerStars Hand #148833204905:  Hold'em No Limit ($0.50/$1.00 USD) - 2016/02/15 11:10:55 CET [2016/02/15 5:10:55 ET]
Table 'Corvus III' 9-max Seat #7 is the button
Seat 1: agritom ($157.76 in chips) 
Seat 2: mzsportline ($77.20 in chips) 
Seat 3: VanDobeln ($247.50 in chips) 
Seat 4: goransyruvka ($75.82 in chips) 
Seat 5: koib88 ($435.23 in chips) 
Seat 6: Priidix ($140.01 in chips) 
Seat 7: matiko09 ($209.36 in chips) 
Seat 8: redacesfull ($162.14 in chips) 
Seat 9: er13to ($100 in chips) 
redacesfull: posts small blind $0.50
er13to: posts big blind $1
agritom: posts the ante $0.20
mzsportline: posts the ante $0.20
VanDobeln: posts the ante $0.20
goransyruvka: posts the ante $0.20
koib88: posts the ante $0.20
Priidix: posts the ante $0.20
matiko09: posts the ante $0.20
redacesfull: posts the ante $0.20
er13to: posts the ante $0.20
*** HOLE CARDS ***
Dealt to matiko09 [Jh 4c]
agritom: raises $2 to $3
mzsportline: folds 
VanDobeln: folds 
goransyruvka: folds 
agritom said, "hahaha"
koib88: calls $3
Priidix: folds 
matiko09: folds 
agritom said, "k3, chimpanzee playing poker"
redacesfull: raises $12 to $15
er13to: folds 
agritom: calls $12
koib88: calls $12
*** FLOP *** [3s 2h 6d]
redacesfull: bets $23
agritom: folds 
koib88: calls $23
*** TURN *** [3s 2h 6d] [4s]
redacesfull: checks 
agritom said, "idiot luckbox cun t"
agritom leaves the table
koib88: bets $397.03 and is all-in
redacesfull: folds 
Uncalled bet ($397.03) returned to koib88
koib88 collected $91 from pot
koib88: doesn't show hand 
*** SUMMARY ***
Total pot $93.80 | Rake $2.80 
Board [3s 2h 6d 4s]
Seat 1: agritom folded on the Flop
Seat 2: mzsportline folded before Flop (didn't bet)
Seat 3: VanDobeln folded before Flop (didn't bet)
Seat 4: goransyruvka folded before Flop (didn't bet)
Seat 5: koib88 collected ($91)
Seat 6: Priidix folded before Flop (didn't bet)
Seat 7: matiko09 (button) folded before Flop (didn't bet)
Seat 8: redacesfull (small blind) folded on the Turn
Seat 9: er13to (big blind) folded before Flop





PokerStars Hand #148833205020:  Hold'em No Limit ($0.25/$0.50 USD) - 2016/02/15 11:10:55 CET [2016/02/15 5:10:55 ET]
Table 'Vesta II' 9-max Seat #1 is the button
Seat 1: Ahangama ($100.33 in chips) 
Seat 2: i L00K great ($50 in chips) 
Seat 3: matiko09 ($73.95 in chips) 
Seat 4: vlad11122007 ($49.25 in chips) 
Seat 5: dndngod ($76.15 in chips) 
Seat 6: pandalapa ($50 in chips) 
Seat 7: ruyingren ($27.04 in chips) 
Seat 8: Arystan ($73.36 in chips) 
Seat 9: Aoki42 ($83.47 in chips) 
i L00K great: posts small blind $0.25
matiko09: posts big blind $0.50
*** HOLE CARDS ***
Dealt to matiko09 [9s Qs]
vlad11122007: folds 
dndngod: folds 
pandalapa: folds 
ruyingren: folds 
Arystan: raises $1 to $1.50
Aoki42: folds 
Ahangama: folds 
i L00K great: calls $1.25
matiko09: folds 
*** FLOP *** [8s 8h Jd]
i L00K great: checks 
Arystan: bets $1.67
i L00K great: folds 
Uncalled bet ($1.67) returned to Arystan
Arystan collected $3.34 from pot
Arystan: doesn't show hand 
*** SUMMARY ***
Total pot $3.50 | Rake $0.16 
Board [8s 8h Jd]
Seat 1: Ahangama (button) folded before Flop (didn't bet)
Seat 2: i L00K great (small blind) folded on the Flop
Seat 3: matiko09 (big blind) folded before Flop
Seat 4: vlad11122007 folded before Flop (didn't bet)
Seat 5: dndngod folded before Flop (didn't bet)
Seat 6: pandalapa folded before Flop (didn't bet)
Seat 7: ruyingren folded before Flop (didn't bet)
Seat 8: Arystan collected ($3.34)
Seat 9: Aoki42 folded before Flop (didn't bet)





PokerStars Hand #148833205450:  Hold'em No Limit ($0.50/$1.00 USD) - 2016/02/15 11:10:56 CET [2016/02/15 5:10:56 ET]
Table 'Nata II' 9-max Seat #7 is the button
Seat 1: Priidix ($100 in chips) 
Seat 2: qqcom ($126.78 in chips) 
Seat 3: g00000se ($100 in chips) 
Seat 4: Good Dentist ($28.95 in chips) 
Seat 5: AGoodFell4 ($53.21 in chips) 
Seat 7: er13to ($114.40 in chips) 
Seat 8: Igor DoUrden ($100.25 in chips) 
Seat 9: matiko09 ($101.87 in chips) 
Igor DoUrden: posts small blind $0.50
matiko09: posts big blind $1
*** HOLE CARDS ***
Dealt to matiko09 [Jc 3d]
AlKatrone joins the table at seat #6 
Priidix: raises $2 to $3
qqcom: calls $3
g00000se: folds 
Good Dentist: raises $5 to $8
AGoodFell4: folds 
er13to: folds 
Igor DoUrden: folds 
matiko09: folds 
Priidix: calls $5
qqcom: calls $5
*** FLOP *** [Qd 4c Jd]
Priidix: checks 
qqcom: checks 
Good Dentist: bets $10
Priidix: folds 
qqcom: calls $10
*** TURN *** [Qd 4c Jd] [3c]
qqcom: checks 
Good Dentist: bets $10.95 and is all-in
qqcom: calls $10.95
*** RIVER *** [Qd 4c Jd 3c] [4d]
*** SHOW DOWN ***
qqcom: shows [2s 4s] (three of a kind, Fours)
Good Dentist: shows [Qc Tc] (two pair, Queens and Fours)
qqcom collected $64.60 from pot
*** SUMMARY ***
Total pot $67.40 | Rake $2.80 
Board [Qd 4c Jd 3c 4d]
Seat 1: Priidix folded on the Flop
Seat 2: qqcom showed [2s 4s] and won ($64.60) with three of a kind, Fours
Seat 3: g00000se folded before Flop (didn't bet)
Seat 4: Good Dentist showed [Qc Tc] and lost with two pair, Queens and Fours
Seat 5: AGoodFell4 folded before Flop (didn't bet)
Seat 7: er13to (button) folded before Flop (didn't bet)
Seat 8: Igor DoUrden (small blind) folded before Flop
Seat 9: matiko09 (big blind) folded before Flop





PokerStars Hand #148833205934:  Hold'em No Limit ($0.50/$1.00 USD) - 2016/02/15 11:10:57 CET [2016/02/15 5:10:57 ET]
Table 'Sekanina' 9-max Seat #7 is the button
Seat 1: LUTZ_11111 ($58.01 in chips) 
Seat 2: Priidix ($124.83 in chips) 
Seat 4: matiko09 ($100 in chips) 
Seat 5: IHouseMusic ($122.20 in chips) 
Seat 6: vinniesmol ($250.60 in chips) 
Seat 7: mycka86 ($100 in chips) 
Seat 8: Venomous100% ($100 in chips) 
Seat 9: er13to ($101 in chips) 
Venomous100%: posts small blind $0.50
er13to: posts big blind $1
*** HOLE CARDS ***
Dealt to matiko09 [6d 3c]
LUTZ_11111: folds 
Priidix: folds 
matiko09: folds 
IHouseMusic: folds 
vinniesmol: folds 
mycka86: raises $1.10 to $2.10
Venomous100%: folds 
er13to: folds 
Uncalled bet ($1.10) returned to mycka86
mycka86 collected $2.50 from pot
*** SUMMARY ***
Total pot $2.50 | Rake $0 
Seat 1: LUTZ_11111 folded before Flop (didn't bet)
Seat 2: Priidix folded before Flop (didn't bet)
Seat 4: matiko09 folded before Flop (didn't bet)
Seat 5: IHouseMusic folded before Flop (didn't bet)
Seat 6: vinniesmol folded before Flop (didn't bet)
Seat 7: mycka86 (button) collected ($2.50)
Seat 8: Venomous100% (small blind) folded before Flop
Seat 9: er13to (big blind) folded before Flop





PokerStars Hand #148833210005:  Hold'em No Limit ($0.50/$1.00 USD) - 2016/02/15 11:11:06 CET [2016/02/15 5:11:06 ET]
Table 'Octans II' 9-max Seat #5 is the button
Seat 1: maxxmeister ($100 in chips) 
Seat 2: matiko09 ($112.44 in chips) 
Seat 3: Aalleekks ($100 in chips) 
Seat 4: Venomous100% ($161.80 in chips) 
Seat 5: AlKatrone ($100 in chips) 
Seat 6: er13to ($101.39 in chips) 
Seat 7: traficblues ($110.07 in chips) 
Seat 8: IHouseMusic ($139.47 in chips) 
Seat 9: mycka86 ($110.63 in chips) 
er13to: posts small blind $0.50
traficblues: posts big blind $1
*** HOLE CARDS ***
Dealt to matiko09 [Ks Kc]
IHouseMusic: raises $2 to $3
mycka86: folds 
maxxmeister: folds 
matiko09: calls $3
Aalleekks: folds 
Venomous100%: folds 
AlKatrone: folds 
er13to: calls $2.50
traficblues: calls $2
*** FLOP *** [6h Ac 9s]
er13to: checks 
traficblues: checks 
IHouseMusic: bets $8.04
matiko09: folds 
er13to: folds 
traficblues: folds 
Uncalled bet ($8.04) returned to IHouseMusic
IHouseMusic collected $11.46 from pot
IHouseMusic: doesn't show hand 
*** SUMMARY ***
Total pot $12 | Rake $0.54 
Board [6h Ac 9s]
Seat 1: maxxmeister folded before Flop (didn't bet)
Seat 2: matiko09 folded on the Flop
Seat 3: Aalleekks folded before Flop (didn't bet)
Seat 4: Venomous100% folded before Flop (didn't bet)
Seat 5: AlKatrone (button) folded before Flop (didn't bet)
Seat 6: er13to (small blind) folded on the Flop
Seat 7: traficblues (big blind) folded on the Flop
Seat 8: IHouseMusic collected ($11.46)
Seat 9: mycka86 folded before Flop (didn't bet)





PokerStars Hand #148833214596:  Hold'em No Limit (€0.25/€0.50 EUR) - 2016/02/15 11:11:17 CET [2016/02/15 5:11:17 ET]
Table 'Walinskia II' 9-max Seat #7 is the button
Seat 1: ljryviltj (€50.84 in chips) 
Seat 2: yats87 (€56.45 in chips) 
Seat 3: beluccix (€24.91 in chips) 
Seat 4: Otsime (€23.80 in chips) 
Seat 5: vano7777 (€65.55 in chips) 
Seat 6: 50CandyJoe (€65.79 in chips) 
Seat 7: etny99 (€50.44 in chips) 
Seat 8: matiko09 (€78.60 in chips) 
matiko09: posts small blind €0.25
Ahangama: is sitting out 
ljryviltj: posts big blind €0.50
*** HOLE CARDS ***
Dealt to matiko09 [Ad Ts]
Ahangama leaves the table
vlad11122007 joins the table at seat #9 
vlad11122007 leaves the table
yats87: folds 
beluccix: folds 
Otsime: folds 
vano7777: folds 
50CandyJoe: folds 
etny99: raises €0.50 to €1
matiko09: folds 
ljryviltj: folds 
Uncalled bet (€0.50) returned to etny99
etny99 collected €1.25 from pot
etny99: doesn't show hand 
*** SUMMARY ***
Total pot €1.25 | Rake €0 
Seat 1: ljryviltj (big blind) folded before Flop
Seat 2: yats87 folded before Flop (didn't bet)
Seat 3: beluccix folded before Flop (didn't bet)
Seat 4: Otsime folded before Flop (didn't bet)
Seat 5: vano7777 folded before Flop (didn't bet)
Seat 6: 50CandyJoe folded before Flop (didn't bet)
Seat 7: etny99 (button) collected (€1.25)
Seat 8: matiko09 (small blind) folded before Flop





PokerStars Hand #148833215694:  Hold'em No Limit ($0.50/$1.00 USD) - 2016/02/15 11:11:19 CET [2016/02/15 5:11:19 ET]
Table 'Gemma II' 9-max Seat #9 is the button
Seat 1: Igor DoUrden ($169.94 in chips) 
Seat 3: Venomous100% ($163.01 in chips) 
Seat 4: mycka86 ($100 in chips) 
Seat 5: PokerSash201 ($75.17 in chips) 
Seat 6: IHouseMusic ($101.50 in chips) 
Seat 7: AlKatrone ($116.19 in chips) 
Seat 8: Priidix ($100.16 in chips) 
Seat 9: matiko09 ($105.05 in chips) 
Igor DoUrden: posts small blind $0.50
er13to: is sitting out 
Venomous100%: posts big blind $1
*** HOLE CARDS ***
Dealt to matiko09 [4h 8c]
mycka86: folds 
PokerSash201: folds 
IHouseMusic: folds 
AlKatrone: raises $2 to $3
Priidix: folds 
matiko09: folds 
Igor DoUrden: folds 
Venomous100%: folds 
Uncalled bet ($2) returned to AlKatrone
AlKatrone collected $2.50 from pot
AlKatrone: doesn't show hand 
*** SUMMARY ***
Total pot $2.50 | Rake $0 
Seat 1: Igor DoUrden (small blind) folded before Flop
Seat 3: Venomous100% (big blind) folded before Flop
Seat 4: mycka86 folded before Flop (didn't bet)
Seat 5: PokerSash201 folded before Flop (didn't bet)
Seat 6: IHouseMusic folded before Flop (didn't bet)
Seat 7: AlKatrone collected ($2.50)
Seat 8: Priidix folded before Flop (didn't bet)
Seat 9: matiko09 (button) folded before Flop (didn't bet)





PokerStars Hand #148833215502:  Hold'em No Limit ($0.50/$1.00 USD) - 2016/02/15 11:11:19 CET [2016/02/15 5:11:19 ET]
Table 'Praecipua' 9-max Seat #2 is the button
Seat 1: er13to ($135.43 in chips) 
Seat 2: matiko09 ($100 in chips) 
Seat 3: Venomous100% ($109.32 in chips) 
Seat 5: huffwag ($162.49 in chips) 
Seat 6: mycka86 ($110.60 in chips) 
Seat 7: maxxmeister ($147.98 in chips) 
Seat 8: Ellis Ng ($40 in chips) 
Seat 9: AlKatrone ($100 in chips) 
Venomous100%: posts small blind $0.50
Priidix: is sitting out 
huffwag: posts big blind $1
*** HOLE CARDS ***
Dealt to matiko09 [Jc 9h]
Priidix leaves the table
mycka86: folds 
maxxmeister: folds 
Ellis Ng: raises $2 to $3
gabi_igna joins the table at seat #4 
AlKatrone: raises $5 to $8
er13to: folds 
matiko09: folds 
Venomous100%: folds 
huffwag: folds 
Ellis Ng: folds 
Uncalled bet ($5) returned to AlKatrone
AlKatrone collected $7.50 from pot
AlKatrone: doesn't show hand 
*** SUMMARY ***
Total pot $7.50 | Rake $0 
Seat 1: er13to folded before Flop (didn't bet)
Seat 2: matiko09 (button) folded before Flop (didn't bet)
Seat 3: Venomous100% (small blind) folded before Flop
Seat 5: huffwag (big blind) folded before Flop
Seat 6: mycka86 folded before Flop (didn't bet)
Seat 7: maxxmeister folded before Flop (didn't bet)
Seat 8: Ellis Ng folded before Flop
Seat 9: AlKatrone collected ($7.50)





PokerStars Hand #148833222371:  Hold'em No Limit ($0.25/$0.50 USD) - 2016/02/15 11:11:34 CET [2016/02/15 5:11:34 ET]
Table 'Vesta II' 9-max Seat #2 is the button
Seat 1: Ahangama ($100.33 in chips) 
Seat 2: i L00K great ($50 in chips) 
Seat 3: matiko09 ($73.45 in chips) 
Seat 4: vlad11122007 ($49.25 in chips) 
Seat 5: dndngod ($76.15 in chips) 
Seat 6: pandalapa ($50 in chips) 
Seat 7: ruyingren ($27.04 in chips) 
Seat 8: Arystan ($75.20 in chips) 
Seat 9: Aoki42 ($83.47 in chips) 
matiko09: posts small blind $0.25
vlad11122007: posts big blind $0.50
*** HOLE CARDS ***
Dealt to matiko09 [Kh 2c]
dndngod: raises $1 to $1.50
pandalapa: folds 
ruyingren: folds 
Arystan: calls $1.50
Aoki42: folds 
Ahangama: folds 
i L00K great: folds 
matiko09: folds 
vlad11122007: folds 
*** FLOP *** [Jd 2s 9d]
dndngod: checks 
Arystan: bets $1.79
dndngod: folds 
Uncalled bet ($1.79) returned to Arystan
Arystan collected $3.58 from pot
Arystan: doesn't show hand 
*** SUMMARY ***
Total pot $3.75 | Rake $0.17 
Board [Jd 2s 9d]
Seat 1: Ahangama folded before Flop (didn't bet)
Seat 2: i L00K great (button) folded before Flop (didn't bet)
Seat 3: matiko09 (small blind) folded before Flop
Seat 4: vlad11122007 (big blind) folded before Flop
Seat 5: dndngod folded on the Flop
Seat 6: pandalapa folded before Flop (didn't bet)
Seat 7: ruyingren folded before Flop (didn't bet)
Seat 8: Arystan collected ($3.58)
Seat 9: Aoki42 folded before Flop (didn't bet)





PokerStars Hand #148833222952:  Hold'em No Limit ($0.50/$1.00 USD) - 2016/02/15 11:11:35 CET [2016/02/15 5:11:35 ET]
Table 'Sekanina' 9-max Seat #8 is the button
Seat 1: LUTZ_11111 ($58.01 in chips) 
Seat 2: Priidix ($124.83 in chips) 
Seat 4: matiko09 ($100 in chips) 
Seat 5: IHouseMusic ($122.20 in chips) 
Seat 6: vinniesmol ($250.60 in chips) 
Seat 7: mycka86 ($101.50 in chips) 
Seat 8: Venomous100% ($100 in chips) 
Seat 9: er13to ($100 in chips) 
er13to: posts small blind $0.50
LUTZ_11111: posts big blind $1
*** HOLE CARDS ***
Dealt to matiko09 [7s Kd]
Priidix: folds 
matiko09: folds 
IHouseMusic: folds 
vinniesmol: folds 
mycka86: folds 
Venomous100%: folds 
er13to: raises $2 to $3
LUTZ_11111: calls $2
*** FLOP *** [Ts 7h 6d]
er13to: checks 
LUTZ_11111: checks 
*** TURN *** [Ts 7h 6d] [Th]
er13to: checks 
LUTZ_11111: checks 
*** RIVER *** [Ts 7h 6d Th] [Ks]
er13to: checks 
LUTZ_11111: checks 
*** SHOW DOWN ***
er13to: shows [Ac Jh] (a pair of Tens)
LUTZ_11111: mucks hand 
er13to collected $5.73 from pot
*** SUMMARY ***
Total pot $6 | Rake $0.27 
Board [Ts 7h 6d Th Ks]
Seat 1: LUTZ_11111 (big blind) mucked [Qs 8d]
Seat 2: Priidix folded before Flop (didn't bet)
Seat 4: matiko09 folded before Flop (didn't bet)
Seat 5: IHouseMusic folded before Flop (didn't bet)
Seat 6: vinniesmol folded before Flop (didn't bet)
Seat 7: mycka86 folded before Flop (didn't bet)
Seat 8: Venomous100% (button) folded before Flop (didn't bet)
Seat 9: er13to (small blind) showed [Ac Jh] and won ($5.73) with a pair of Tens





PokerStars Hand #148833229364:  Hold'em No Limit ($0.25/$0.50 USD) - 2016/02/15 11:11:49 CET [2016/02/15 5:11:49 ET]
Table 'Laertes II' 9-max Seat #7 is the button
Seat 2: beluccix ($24.96 in chips) 
Seat 3: ljryviltj ($59.05 in chips) 
Seat 4: rgar93 ($39.97 in chips) 
Seat 5: vlad11122007 ($50.30 in chips) 
Seat 6: yats87 ($59.91 in chips) 
Seat 7: Vedpapa ($61.67 in chips) 
Seat 8: Trent444 ($42.78 in chips) 
Seat 9: matiko09 ($51.60 in chips) 
Trent444: posts small blind $0.25
matiko09: posts big blind $0.50
*** HOLE CARDS ***
Dealt to matiko09 [5c Ts]
beluccix: folds 
etny99 joins the table at seat #1 
ljryviltj: folds 
rgar93: folds 
vlad11122007: folds 
yats87: folds 
Vedpapa: raises $0.75 to $1.25
Trent444: calls $1
matiko09: folds 
*** FLOP *** [6h 2s Kc]
Trent444: checks 
Vedpapa: bets $2
Trent444: folds 
Uncalled bet ($2) returned to Vedpapa
Vedpapa collected $2.86 from pot
*** SUMMARY ***
Total pot $3 | Rake $0.14 
Board [6h 2s Kc]
Seat 2: beluccix folded before Flop (didn't bet)
Seat 3: ljryviltj folded before Flop (didn't bet)
Seat 4: rgar93 folded before Flop (didn't bet)
Seat 5: vlad11122007 folded before Flop (didn't bet)
Seat 6: yats87 folded before Flop (didn't bet)
Seat 7: Vedpapa (button) collected ($2.86)
Seat 8: Trent444 (small blind) folded on the Flop
Seat 9: matiko09 (big blind) folded before Flop





PokerStars Hand #148833231206:  Hold'em No Limit ($0.50/$1.00 USD) - 2016/02/15 11:11:53 CET [2016/02/15 5:11:53 ET]
Table 'Corvus III' 9-max Seat #8 is the button
Seat 2: mzsportline ($145.40 in chips) 
Seat 3: VanDobeln ($247.30 in chips) 
Seat 4: goransyruvka ($75.62 in chips) 
Seat 5: koib88 ($488.03 in chips) 
Seat 6: Priidix ($139.81 in chips) 
Seat 7: matiko09 ($209.16 in chips) 
Seat 8: redacesfull ($123.94 in chips) 
Seat 9: er13to ($100 in chips) 
er13to: posts small blind $0.50
mzsportline: posts big blind $1
mzsportline: posts the ante $0.20
VanDobeln: posts the ante $0.20
goransyruvka: posts the ante $0.20
koib88: posts the ante $0.20
Priidix: posts the ante $0.20
matiko09: posts the ante $0.20
redacesfull: posts the ante $0.20
er13to: posts the ante $0.20
*** HOLE CARDS ***
Dealt to matiko09 [7s 2s]
VanDobeln: folds 
goransyruvka: calls $1
koib88: calls $1
Priidix: folds 
matiko09: folds 
redacesfull: raises $3 to $4
er13to: calls $3.50
mzsportline: folds 
goransyruvka: calls $3
koib88: calls $3
*** FLOP *** [8s 2h 8c]
er13to: checks 
goransyruvka: checks 
koib88: bets $8.88
redacesfull: folds 
er13to: folds 
goransyruvka: folds 
Uncalled bet ($8.88) returned to koib88
koib88 collected $17.76 from pot
koib88: doesn't show hand 
*** SUMMARY ***
Total pot $18.60 | Rake $0.84 
Board [8s 2h 8c]
Seat 2: mzsportline (big blind) folded before Flop
Seat 3: VanDobeln folded before Flop (didn't bet)
Seat 4: goransyruvka folded on the Flop
Seat 5: koib88 collected ($17.76)
Seat 6: Priidix folded before Flop (didn't bet)
Seat 7: matiko09 folded before Flop (didn't bet)
Seat 8: redacesfull (button) folded on the Flop
Seat 9: er13to (small blind) folded on the Flop





PokerStars Hand #148833234691:  Hold'em No Limit ($0.50/$1.00 USD) - 2016/02/15 11:12:01 CET [2016/02/15 5:12:01 ET]
Table 'Gemma II' 9-max Seat #1 is the button
Seat 1: Igor DoUrden ($169.44 in chips) 
Seat 3: Venomous100% ($162.01 in chips) 
Seat 4: mycka86 ($100 in chips) 
Seat 5: PokerSash201 ($75.17 in chips) 
Seat 6: IHouseMusic ($101.50 in chips) 
Seat 7: AlKatrone ($117.69 in chips) 
Seat 8: Priidix ($100.16 in chips) 
Seat 9: matiko09 ($105.05 in chips) 
Venomous100%: posts small blind $0.50
mycka86: posts big blind $1
*** HOLE CARDS ***
Dealt to matiko09 [7s Td]
PokerSash201: folds 
IHouseMusic: folds 
AlKatrone: folds 
er13to leaves the table
Priidix: folds 
matiko09: folds 
Igor DoUrden: raises $1.08 to $2.08
Venomous100%: folds 
mycka86: folds 
Uncalled bet ($1.08) returned to Igor DoUrden
Igor DoUrden collected $2.50 from pot
Igor DoUrden: doesn't show hand 
*** SUMMARY ***
Total pot $2.50 | Rake $0 
Seat 1: Igor DoUrden (button) collected ($2.50)
Seat 3: Venomous100% (small blind) folded before Flop
Seat 4: mycka86 (big blind) folded before Flop
Seat 5: PokerSash201 folded before Flop (didn't bet)
Seat 6: IHouseMusic folded before Flop (didn't bet)
Seat 7: AlKatrone folded before Flop (didn't bet)
Seat 8: Priidix folded before Flop (didn't bet)
Seat 9: matiko09 folded before Flop (didn't bet)





PokerStars Hand #148833235028:  Hold'em No Limit (€0.50/€1.00 EUR) - 2016/02/15 11:12:02 CET [2016/02/15 5:12:02 ET]
Table 'Ganesa II' 9-max Seat #7 is the button
Seat 2: maxxmeister (€102.61 in chips) 
Seat 3: BuBu 0187 (€71.20 in chips) 
Seat 4: Sreshta222 (€103 in chips) 
Seat 5: vano7777 (€73.74 in chips) 
Seat 6: matiko09 (€126.58 in chips) 
Seat 7: er13to (€113.50 in chips) 
Seat 8: mycka86 (€100 in chips) 
Seat 9: Priidix (€106.21 in chips) 
mycka86: posts small blind €0.50
Priidix: posts big blind €1
*** HOLE CARDS ***
Dealt to matiko09 [Jd 9s]
maxxmeister: folds 
BuBu 0187: folds 
Sreshta222: folds 
vano7777: folds 
matiko09: folds 
er13to: raises €1.50 to €2.50
mycka86: folds 
Priidix: folds 
Uncalled bet (€1.50) returned to er13to
er13to collected €2.50 from pot
*** SUMMARY ***
Total pot €2.50 | Rake €0 
Seat 2: maxxmeister folded before Flop (didn't bet)
Seat 3: BuBu 0187 folded before Flop (didn't bet)
Seat 4: Sreshta222 folded before Flop (didn't bet)
Seat 5: vano7777 folded before Flop (didn't bet)
Seat 6: matiko09 folded before Flop (didn't bet)
Seat 7: er13to (button) collected (€2.50)
Seat 8: mycka86 (small blind) folded before Flop
Seat 9: Priidix (big blind) folded before Flop





PokerStars Hand #148833235167:  Hold'em No Limit ($0.50/$1.00 USD) - 2016/02/15 11:12:02 CET [2016/02/15 5:12:02 ET]
Table 'Euanthe II' 9-max Seat #2 is the button
Seat 1: maxxmeister ($126.94 in chips) 
Seat 2: mycka86 ($331.49 in chips) 
Seat 3: Sreshta222 ($100 in chips) 
Seat 4: er13to ($111.58 in chips) 
Seat 7: vinniesmol ($219.17 in chips) 
Seat 8: matiko09 ($124.77 in chips) 
Sreshta222: posts small blind $0.50
er13to: posts big blind $1
IHouseMusic: sits out 
Venomous100%: sits out 
*** HOLE CARDS ***
Dealt to matiko09 [9h Td]
vinniesmol: folds 
damienwilde leaves the table
matiko09: folds 
maxxmeister: folds 
mycka86: folds 
Sreshta222: raises $1.09 to $2.09
er13to: raises $4.91 to $7
Sreshta222: calls $4.91
*** FLOP *** [8c Jh Jd]
Sreshta222: checks 
er13to: bets $6.95
gabi_igna joins the table at seat #5 
Sreshta222: folds 
Uncalled bet ($6.95) returned to er13to
er13to collected $13.37 from pot
*** SUMMARY ***
Total pot $14 | Rake $0.63 
Board [8c Jh Jd]
Seat 1: maxxmeister folded before Flop (didn't bet)
Seat 2: mycka86 (button) folded before Flop (didn't bet)
Seat 3: Sreshta222 (small blind) folded on the Flop
Seat 4: er13to (big blind) collected ($13.37)
Seat 7: vinniesmol folded before Flop (didn't bet)
Seat 8: matiko09 folded before Flop (didn't bet)





PokerStars Hand #148833235131:  Hold'em No Limit (€0.25/€0.50 EUR) - 2016/02/15 11:12:02 CET [2016/02/15 5:12:02 ET]
Table 'Walinskia II' 9-max Seat #8 is the button
Seat 1: ljryviltj (€50.34 in chips) 
Seat 3: beluccix (€24.91 in chips) 
Seat 4: Otsime (€23.80 in chips) 
Seat 5: vano7777 (€65.55 in chips) 
Seat 6: 50CandyJoe (€65.79 in chips) 
Seat 7: etny99 (€51.19 in chips) 
Seat 8: matiko09 (€78.35 in chips) 
ljryviltj: posts small blind €0.25
yats87: is sitting out 
beluccix: posts big blind €0.50
*** HOLE CARDS ***
Dealt to matiko09 [Ad 7c]
yats87 leaves the table
Otsime: folds 
vano7777: folds 
50CandyJoe: folds 
etny99: folds 
matiko09: raises €0.75 to €1.25
ljryviltj: folds 
beluccix: folds 
Uncalled bet (€0.75) returned to matiko09
matiko09 collected €1.25 from pot
matiko09: doesn't show hand 
*** SUMMARY ***
Total pot €1.25 | Rake €0 
Seat 1: ljryviltj (small blind) folded before Flop
Seat 3: beluccix (big blind) folded before Flop
Seat 4: Otsime folded before Flop (didn't bet)
Seat 5: vano7777 folded before Flop (didn't bet)
Seat 6: 50CandyJoe folded before Flop (didn't bet)
Seat 7: etny99 folded before Flop (didn't bet)
Seat 8: matiko09 (button) collected (€1.25)





PokerStars Hand #148833236794:  Hold'em No Limit ($0.50/$1.00 USD) - 2016/02/15 11:12:06 CET [2016/02/15 5:12:06 ET]
Table 'Praecipua' 9-max Seat #3 is the button
Seat 1: er13to ($135.43 in chips) 
Seat 2: matiko09 ($100 in chips) 
Seat 3: Venomous100% ($108.82 in chips) 
Seat 5: huffwag ($161.49 in chips) 
Seat 6: mycka86 ($110.60 in chips) 
Seat 7: maxxmeister ($147.98 in chips) 
Seat 8: Ellis Ng ($37 in chips) 
Seat 9: AlKatrone ($104.50 in chips) 
gabi_igna will be allowed to play after the button
huffwag: posts small blind $0.50
mycka86: posts big blind $1
*** HOLE CARDS ***
Dealt to matiko09 [7h 9d]
maxxmeister: folds 
Ellis Ng: folds 
AlKatrone: folds 
er13to: folds 
matiko09: folds 
Venomous100%: folds 
huffwag: folds 
Uncalled bet ($0.50) returned to mycka86
mycka86 collected $1 from pot
*** SUMMARY ***
Total pot $1 | Rake $0 
Seat 1: er13to folded before Flop (didn't bet)
Seat 2: matiko09 folded before Flop (didn't bet)
Seat 3: Venomous100% (button) folded before Flop (didn't bet)
Seat 5: huffwag (small blind) folded before Flop
Seat 6: mycka86 (big blind) collected ($1)
Seat 7: maxxmeister folded before Flop (didn't bet)
Seat 8: Ellis Ng folded before Flop (didn't bet)
Seat 9: AlKatrone folded before Flop (didn't bet)





PokerStars Hand #148833237286:  Hold'em No Limit ($0.50/$1.00 USD) - 2016/02/15 11:12:07 CET [2016/02/15 5:12:07 ET]
Table 'Nata II' 9-max Seat #8 is the button
Seat 1: Priidix ($100 in chips) 
Seat 2: qqcom ($162.43 in chips) 
Seat 3: g00000se ($100 in chips) 
Seat 5: AGoodFell4 ($53.21 in chips) 
Seat 7: er13to ($114.40 in chips) 
Seat 8: Igor DoUrden ($100 in chips) 
Seat 9: matiko09 ($100.87 in chips) 
matiko09: posts small blind $0.50
Priidix: posts big blind $1
AlKatrone: sits out 
*** HOLE CARDS ***
Dealt to matiko09 [8h Kc]
qqcom: calls $1
g00000se: raises $2.50 to $3.50
Good Dentist leaves the table
AGoodFell4: folds 
er13to: folds 
Igor DoUrden: folds 
gabi_igna joins the table at seat #4 
matiko09: folds 
Priidix: folds 
qqcom: calls $2.50
*** FLOP *** [6h 8d 7c]
qqcom: checks 
g00000se: bets $6
qqcom: calls $6
*** TURN *** [6h 8d 7c] [3d]
qqcom: checks 
g00000se: bets $12.50
qqcom: calls $12.50
*** RIVER *** [6h 8d 7c 3d] [Ks]
qqcom: checks 
g00000se: bets $28
qqcom: folds 
Uncalled bet ($28) returned to g00000se
g00000se collected $43.45 from pot
g00000se: doesn't show hand 
*** SUMMARY ***
Total pot $45.50 | Rake $2.05 
Board [6h 8d 7c 3d Ks]
Seat 1: Priidix (big blind) folded before Flop
Seat 2: qqcom folded on the River
Seat 3: g00000se collected ($43.45)
Seat 5: AGoodFell4 folded before Flop (didn't bet)
Seat 7: er13to folded before Flop (didn't bet)
Seat 8: Igor DoUrden (button) folded before Flop (didn't bet)
Seat 9: matiko09 (small blind) folded before Flop





PokerStars Hand #148833237561:  Hold'em No Limit ($0.50/$1.00 USD) - 2016/02/15 11:12:08 CET [2016/02/15 5:12:08 ET]
Table 'Anteros' 9-max Seat #8 is the button
Seat 1: redacesfull ($103.93 in chips) 
Seat 2: IHouseMusic ($104.44 in chips) 
Seat 3: er13to ($105.74 in chips) 
Seat 4: misherei ($199.01 in chips) 
Seat 5: Holm1991 ($50.36 in chips) 
Seat 6: SerAlGog ($138.31 in chips) 
Seat 7: Zoubou1983 ($163.60 in chips) 
Seat 8: matiko09 ($100 in chips) 
Seat 9: mycka86 ($100 in chips) 
mycka86: posts small blind $0.50
redacesfull: posts big blind $1
*** HOLE CARDS ***
Dealt to matiko09 [2c 6s]
IHouseMusic: folds 
er13to: raises $2 to $3
misherei: folds 
Holm1991: folds 
SerAlGog: folds 
Zoubou1983: folds 
matiko09: folds 
mycka86: folds 
redacesfull: folds 
Uncalled bet ($2) returned to er13to
er13to collected $2.50 from pot
*** SUMMARY ***
Total pot $2.50 | Rake $0 
Seat 1: redacesfull (big blind) folded before Flop
Seat 2: IHouseMusic folded before Flop (didn't bet)
Seat 3: er13to collected ($2.50)
Seat 4: misherei folded before Flop (didn't bet)
Seat 5: Holm1991 folded before Flop (didn't bet)
Seat 6: SerAlGog folded before Flop (didn't bet)
Seat 7: Zoubou1983 folded before Flop (didn't bet)
Seat 8: matiko09 (button) folded before Flop (didn't bet)
Seat 9: mycka86 (small blind) folded before Flop





PokerStars Hand #148833244357:  Hold'em No Limit ($0.50/$1.00 USD) - 2016/02/15 11:12:23 CET [2016/02/15 5:12:23 ET]
Table 'Praecipua' 9-max Seat #5 is the button
Seat 1: er13to ($135.43 in chips) 
Seat 2: matiko09 ($100 in chips) 
Seat 3: Venomous100% ($108.82 in chips) 
Seat 5: huffwag ($160.99 in chips) 
Seat 6: mycka86 ($111.10 in chips) 
Seat 7: maxxmeister ($147.98 in chips) 
Seat 8: Ellis Ng ($37 in chips) 
Seat 9: AlKatrone ($104.50 in chips) 
mycka86: posts small blind $0.50
maxxmeister: posts big blind $1
gabi_igna: sits out 
*** HOLE CARDS ***
Dealt to matiko09 [Th 7h]
Ellis Ng: folds 
AlKatrone: folds 
er13to: folds 
matiko09: folds 
Venomous100%: folds 
huffwag: folds 
mycka86: raises $1.75 to $2.75
maxxmeister: calls $1.75
*** FLOP *** [6h 3s 6d]
Ellis Ng is disconnected 
mycka86: bets $2.88
maxxmeister: folds 
Uncalled bet ($2.88) returned to mycka86
mycka86 collected $5.25 from pot
*** SUMMARY ***
Total pot $5.50 | Rake $0.25 
Board [6h 3s 6d]
Seat 1: er13to folded before Flop (didn't bet)
Seat 2: matiko09 folded before Flop (didn't bet)
Seat 3: Venomous100% folded before Flop (didn't bet)
Seat 5: huffwag (button) folded before Flop (didn't bet)
Seat 6: mycka86 (small blind) collected ($5.25)
Seat 7: maxxmeister (big blind) folded on the Flop
Seat 8: Ellis Ng folded before Flop (didn't bet)
Seat 9: AlKatrone folded before Flop (didn't bet)





PokerStars Hand #148833245423:  Hold'em No Limit ($0.50/$1.00 USD) - 2016/02/15 11:12:25 CET [2016/02/15 5:12:25 ET]
Table 'Octans II' 9-max Seat #6 is the button
Seat 1: maxxmeister ($100 in chips) 
Seat 2: matiko09 ($109.44 in chips) 
Seat 3: Aalleekks ($100 in chips) 
Seat 4: Venomous100% ($161.80 in chips) 
Seat 5: AlKatrone ($100 in chips) 
Seat 6: er13to ($100 in chips) 
Seat 7: traficblues ($107.07 in chips) 
Seat 8: IHouseMusic ($147.93 in chips) 
Seat 9: mycka86 ($110.63 in chips) 
traficblues: posts small blind $0.50
IHouseMusic: posts big blind $1
*** HOLE CARDS ***
Dealt to matiko09 [Jc Js]
mycka86: raises $2 to $3
maxxmeister: calls $3
matiko09: calls $3
Aalleekks: folds 
Venomous100%: folds 
AlKatrone: folds 
er13to: folds 
traficblues: calls $2.50
IHouseMusic: calls $2
*** FLOP *** [4h 9d Qc]
traficblues: bets $7.16
IHouseMusic: folds 
mycka86: folds 
maxxmeister: calls $7.16
matiko09: calls $7.16
*** TURN *** [4h 9d Qc] [Jd]
traficblues: bets $17.42
maxxmeister: calls $17.42
matiko09: raises $81.86 to $99.28 and is all-in
traficblues: calls $79.49 and is all-in
maxxmeister: folds 
Uncalled bet ($2.37) returned to matiko09
*** RIVER *** [4h 9d Qc Jd] [3d]
*** SHOW DOWN ***
traficblues: shows [9h Qd] (two pair, Queens and Nines)
matiko09: shows [Jc Js] (three of a kind, Jacks)
matiko09 collected $244.92 from pot
*** SUMMARY ***
Total pot $247.72 | Rake $2.80 
Board [4h 9d Qc Jd 3d]
Seat 1: maxxmeister folded on the Turn
Seat 2: matiko09 showed [Jc Js] and won ($244.92) with three of a kind, Jacks
Seat 3: Aalleekks folded before Flop (didn't bet)
Seat 4: Venomous100% folded before Flop (didn't bet)
Seat 5: AlKatrone folded before Flop (didn't bet)
Seat 6: er13to (button) folded before Flop (didn't bet)
Seat 7: traficblues (small blind) showed [9h Qd] and lost with two pair, Queens and Nines
Seat 8: IHouseMusic (big blind) folded on the Flop
Seat 9: mycka86 folded on the Flop





PokerStars Hand #148833247054:  Hold'em No Limit ($0.25/$0.50 USD) - 2016/02/15 11:12:29 CET [2016/02/15 5:12:29 ET]
Table 'Vesta II' 9-max Seat #3 is the button
Seat 1: Ahangama ($100.33 in chips) 
Seat 2: i L00K great ($50 in chips) 
Seat 3: matiko09 ($73.20 in chips) 
Seat 4: vlad11122007 ($48.75 in chips) 
Seat 5: dndngod ($74.65 in chips) 
Seat 6: pandalapa ($50 in chips) 
Seat 7: ruyingren ($27.04 in chips) 
Seat 8: Arystan ($77.28 in chips) 
Seat 9: Aoki42 ($83.47 in chips) 
vlad11122007: posts small blind $0.25
dndngod: posts big blind $0.50
*** HOLE CARDS ***
Dealt to matiko09 [6s 5d]
pandalapa: folds 
ruyingren: folds 
Arystan: raises $1 to $1.50
Aoki42: folds 
Ahangama: calls $1.50
i L00K great: raises $4.50 to $6
matiko09: folds 
vlad11122007: folds 
dndngod: folds 
Arystan: calls $4.50
Ahangama: calls $4.50
*** FLOP *** [Jh 3c 9c]
Arystan: bets $8.95
Ahangama: folds 
i L00K great: calls $8.95
*** TURN *** [Jh 3c 9c] [8d]
Arystan: bets $12
i L00K great: raises $23.05 to $35.05 and is all-in
Arystan: calls $23.05
*** RIVER *** [Jh 3c 9c 8d] [8c]
*** SHOW DOWN ***
Arystan: shows [7d Td] (a straight, Seven to Jack)
i L00K great: shows [Ac Ad] (two pair, Aces and Eights)
Arystan collected $104.25 from pot
*** SUMMARY ***
Total pot $106.75 | Rake $2.50 
Board [Jh 3c 9c 8d 8c]
Seat 1: Ahangama folded on the Flop
Seat 2: i L00K great showed [Ac Ad] and lost with two pair, Aces and Eights
Seat 3: matiko09 (button) folded before Flop (didn't bet)
Seat 4: vlad11122007 (small blind) folded before Flop
Seat 5: dndngod (big blind) folded before Flop
Seat 6: pandalapa folded before Flop (didn't bet)
Seat 7: ruyingren folded before Flop (didn't bet)
Seat 8: Arystan showed [7d Td] and won ($104.25) with a straight, Seven to Jack
Seat 9: Aoki42 folded before Flop (didn't bet)





PokerStars Hand #148833248063:  Hold'em No Limit (€0.25/€0.50 EUR) - 2016/02/15 11:12:31 CET [2016/02/15 5:12:31 ET]
Table 'Walinskia II' 9-max Seat #1 is the button
Seat 1: ljryviltj (€50.09 in chips) 
Seat 3: beluccix (€24.91 in chips) 
Seat 4: Otsime (€23.80 in chips) 
Seat 5: vano7777 (€65.55 in chips) 
Seat 6: 50CandyJoe (€65.79 in chips) 
Seat 7: etny99 (€51.19 in chips) 
Seat 8: matiko09 (€79.10 in chips) 
beluccix: posts small blind €0.25
Otsime: posts big blind €0.50
*** HOLE CARDS ***
Dealt to matiko09 [8d 5s]
vano7777: folds 
50CandyJoe: folds 
etny99: raises €0.50 to €1
matiko09: folds 
ljryviltj: calls €1
beluccix: folds 
Otsime: calls €0.50
*** FLOP *** [Th Td 3c]
Otsime: checks 
etny99: checks 
ljryviltj: bets €2
Otsime: folds 
etny99: folds 
Uncalled bet (€2) returned to ljryviltj
ljryviltj collected €3.10 from pot
ljryviltj: doesn't show hand 
*** SUMMARY ***
Total pot €3.25 | Rake €0.15 
Board [Th Td 3c]
Seat 1: ljryviltj (button) collected (€3.10)
Seat 3: beluccix (small blind) folded before Flop
Seat 4: Otsime (big blind) folded on the Flop
Seat 5: vano7777 folded before Flop (didn't bet)
Seat 6: 50CandyJoe folded before Flop (didn't bet)
Seat 7: etny99 folded on the Flop
Seat 8: matiko09 folded before Flop (didn't bet)





PokerStars Hand #148833248834:  Hold'em No Limit ($0.50/$1.00 USD) - 2016/02/15 11:12:32 CET [2016/02/15 5:12:32 ET]
Table 'Gemma II' 9-max Seat #3 is the button
Seat 1: Igor DoUrden ($170.94 in chips) 
Seat 3: Venomous100% ($161.51 in chips) 
Seat 4: mycka86 ($100 in chips) 
Seat 5: PokerSash201 ($75.17 in chips) 
Seat 6: IHouseMusic ($101.50 in chips) 
Seat 7: AlKatrone ($117.69 in chips) 
Seat 8: Priidix ($100.16 in chips) 
Seat 9: matiko09 ($105.05 in chips) 
mycka86: posts small blind $0.50
PokerSash201: posts big blind $1
*** HOLE CARDS ***
Dealt to matiko09 [Ts 2h]
IHouseMusic: folds 
AlKatrone: folds 
Priidix: folds 
matiko09: folds 
Igor DoUrden: raises $1.25 to $2.25
Venomous100%: folds 
gabi_igna joins the table at seat #2 
mycka86: folds 
PokerSash201: folds 
Uncalled bet ($1.25) returned to Igor DoUrden
Igor DoUrden collected $2.50 from pot
Igor DoUrden: doesn't show hand 
*** SUMMARY ***
Total pot $2.50 | Rake $0 
Seat 1: Igor DoUrden collected ($2.50)
Seat 3: Venomous100% (button) folded before Flop (didn't bet)
Seat 4: mycka86 (small blind) folded before Flop
Seat 5: PokerSash201 (big blind) folded before Flop
Seat 6: IHouseMusic folded before Flop (didn't bet)
Seat 7: AlKatrone folded before Flop (didn't bet)
Seat 8: Priidix folded before Flop (didn't bet)
Seat 9: matiko09 folded before Flop (didn't bet)





PokerStars Hand #148833251658:  Hold'em No Limit ($0.25/$0.50 USD) - 2016/02/15 11:12:39 CET [2016/02/15 5:12:39 ET]
Table 'Laertes II' 9-max Seat #8 is the button
Seat 1: etny99 ($50 in chips) 
Seat 2: beluccix ($24.96 in chips) 
Seat 3: ljryviltj ($59.05 in chips) 
Seat 4: rgar93 ($39.97 in chips) 
Seat 5: vlad11122007 ($50.30 in chips) 
Seat 6: yats87 ($59.91 in chips) 
Seat 7: Vedpapa ($63.28 in chips) 
Seat 8: Trent444 ($41.53 in chips) 
Seat 9: matiko09 ($51.10 in chips) 
matiko09: posts small blind $0.25
etny99: posts big blind $0.50
*** HOLE CARDS ***
Dealt to matiko09 [4h 6h]
beluccix: folds 
ljryviltj: folds 
rgar93: raises $0.50 to $1
vlad11122007: folds 
yats87: folds 
Vedpapa: folds 
Trent444: calls $1
matiko09: folds 
etny99: calls $0.50
*** FLOP *** [Jh 8d 3h]
etny99: checks 
rgar93: bets $1.55
Trent444: folds 
etny99: calls $1.55
*** TURN *** [Jh 8d 3h] [Kd]
etny99: checks 
rgar93: checks 
*** RIVER *** [Jh 8d 3h Kd] [5s]
etny99: checks 
rgar93: bets $4
etny99: folds 
Uncalled bet ($4) returned to rgar93
rgar93 collected $6.06 from pot
rgar93: doesn't show hand 
*** SUMMARY ***
Total pot $6.35 | Rake $0.29 
Board [Jh 8d 3h Kd 5s]
Seat 1: etny99 (big blind) folded on the River
Seat 2: beluccix folded before Flop (didn't bet)
Seat 3: ljryviltj folded before Flop (didn't bet)
Seat 4: rgar93 collected ($6.06)
Seat 5: vlad11122007 folded before Flop (didn't bet)
Seat 6: yats87 folded before Flop (didn't bet)
Seat 7: Vedpapa folded before Flop (didn't bet)
Seat 8: Trent444 (button) folded on the Flop
Seat 9: matiko09 (small blind) folded before Flop





PokerStars Hand #148833252298:  Hold'em No Limit ($0.50/$1.00 USD) - 2016/02/15 11:12:40 CET [2016/02/15 5:12:40 ET]
Table 'Sekanina' 9-max Seat #9 is the button
Seat 1: LUTZ_11111 ($55.01 in chips) 
Seat 2: Priidix ($124.83 in chips) 
Seat 4: matiko09 ($100 in chips) 
Seat 5: IHouseMusic ($122.20 in chips) 
Seat 6: vinniesmol ($250.60 in chips) 
Seat 7: mycka86 ($101.50 in chips) 
Seat 8: Venomous100% ($100 in chips) 
Seat 9: er13to ($102.73 in chips) 
LUTZ_11111: posts small blind $0.50
Priidix: posts big blind $1
*** HOLE CARDS ***
Dealt to matiko09 [Qd Tc]
matiko09: folds 
IHouseMusic: folds 
vinniesmol: folds 
mycka86: raises $1.50 to $2.50
Venomous100%: folds 
er13to: folds 
LUTZ_11111: calls $2
Priidix: folds 
*** FLOP *** [2h Qs Th]
LUTZ_11111: bets $2.86
mycka86: folds 
Uncalled bet ($2.86) returned to LUTZ_11111
LUTZ_11111 collected $5.73 from pot
LUTZ_11111: doesn't show hand 
*** SUMMARY ***
Total pot $6 | Rake $0.27 
Board [2h Qs Th]
Seat 1: LUTZ_11111 (small blind) collected ($5.73)
Seat 2: Priidix (big blind) folded before Flop
Seat 4: matiko09 folded before Flop (didn't bet)
Seat 5: IHouseMusic folded before Flop (didn't bet)
Seat 6: vinniesmol folded before Flop (didn't bet)
Seat 7: mycka86 folded on the Flop
Seat 8: Venomous100% folded before Flop (didn't bet)
Seat 9: er13to (button) folded before Flop (didn't bet)





PokerStars Hand #148833252826:  Hold'em No Limit ($0.50/$1.00 USD) - 2016/02/15 11:12:41 CET [2016/02/15 5:12:41 ET]
Table 'Anteros' 9-max Seat #9 is the button
Seat 1: redacesfull ($102.93 in chips) 
Seat 2: IHouseMusic ($104.44 in chips) 
Seat 3: er13to ($107.24 in chips) 
Seat 4: misherei ($199.01 in chips) 
Seat 5: Holm1991 ($50.36 in chips) 
Seat 6: SerAlGog ($138.31 in chips) 
Seat 7: Zoubou1983 ($163.60 in chips) 
Seat 8: matiko09 ($100 in chips) 
Seat 9: mycka86 ($100 in chips) 
redacesfull: posts small blind $0.50
IHouseMusic: posts big blind $1
*** HOLE CARDS ***
Dealt to matiko09 [2s 3s]
er13to: raises $1.50 to $2.50
misherei: folds 
Holm1991: folds 
SerAlGog: folds 
Zoubou1983: raises $2.50 to $5
matiko09: folds 
mycka86: folds 
redacesfull: folds 
IHouseMusic: folds 
er13to: calls $2.50
*** FLOP *** [7h 6c 7c]
er13to: checks 
Zoubou1983: bets $11
er13to: folds 
Uncalled bet ($11) returned to Zoubou1983
Zoubou1983 collected $10.98 from pot
Zoubou1983: doesn't show hand 
*** SUMMARY ***
Total pot $11.50 | Rake $0.52 
Board [7h 6c 7c]
Seat 1: redacesfull (small blind) folded before Flop
Seat 2: IHouseMusic (big blind) folded before Flop
Seat 3: er13to folded on the Flop
Seat 4: misherei folded before Flop (didn't bet)
Seat 5: Holm1991 folded before Flop (didn't bet)
Seat 6: SerAlGog folded before Flop (didn't bet)
Seat 7: Zoubou1983 collected ($10.98)
Seat 8: matiko09 folded before Flop (didn't bet)
Seat 9: mycka86 (button) folded before Flop (didn't bet)





PokerStars Hand #148833258580:  Hold'em No Limit (€0.50/€1.00 EUR) - 2016/02/15 11:12:54 CET [2016/02/15 5:12:54 ET]
Table 'Ganesa II' 9-max Seat #8 is the button
Seat 2: maxxmeister (€102.61 in chips) 
Seat 3: BuBu 0187 (€71.20 in chips) 
Seat 4: Sreshta222 (€103 in chips) 
Seat 5: vano7777 (€73.74 in chips) 
Seat 6: matiko09 (€126.58 in chips) 
Seat 7: er13to (€115 in chips) 
Seat 8: mycka86 (€100 in chips) 
Seat 9: Priidix (€105.21 in chips) 
Priidix: posts small blind €0.50
maxxmeister: posts big blind €1
*** HOLE CARDS ***
Dealt to matiko09 [6s Jd]
BuBu 0187 has timed out
BuBu 0187: folds 
Sreshta222: folds 
vano7777: folds 
matiko09: folds 
er13to: folds 
mycka86: raises €1.10 to €2.10
Priidix: folds 
maxxmeister: raises €5.90 to €8
mycka86: folds 
Uncalled bet (€5.90) returned to maxxmeister
maxxmeister collected €4.70 from pot
maxxmeister: doesn't show hand 
*** SUMMARY ***
Total pot €4.70 | Rake €0 
Seat 2: maxxmeister (big blind) collected (€4.70)
Seat 3: BuBu 0187 folded before Flop (didn't bet)
Seat 4: Sreshta222 folded before Flop (didn't bet)
Seat 5: vano7777 folded before Flop (didn't bet)
Seat 6: matiko09 folded before Flop (didn't bet)
Seat 7: er13to folded before Flop (didn't bet)
Seat 8: mycka86 (button) folded before Flop
Seat 9: Priidix (small blind) folded before Flop





PokerStars Hand #148833264524:  Hold'em No Limit ($0.50/$1.00 USD) - 2016/02/15 11:13:07 CET [2016/02/15 5:13:07 ET]
Table 'Corvus III' 9-max Seat #9 is the button
Seat 2: mzsportline ($144.20 in chips) 
Seat 3: VanDobeln ($247.10 in chips) 
Seat 4: goransyruvka ($71.42 in chips) 
Seat 5: koib88 ($501.59 in chips) 
Seat 6: Priidix ($139.61 in chips) 
Seat 7: matiko09 ($208.96 in chips) 
Seat 8: redacesfull ($119.74 in chips) 
Seat 9: er13to ($100 in chips) 
mzsportline: posts small blind $0.50
VanDobeln: posts big blind $1
mzsportline: posts the ante $0.20
VanDobeln: posts the ante $0.20
goransyruvka: posts the ante $0.20
koib88: posts the ante $0.20
Priidix: posts the ante $0.20
matiko09: posts the ante $0.20
redacesfull: posts the ante $0.20
er13to: posts the ante $0.20
*** HOLE CARDS ***
Dealt to matiko09 [6d Qd]
goransyruvka: calls $1
koib88: calls $1
Priidix: raises $5 to $6
matiko09: folds 
redacesfull: folds 
er13to: folds 
mzsportline: calls $5.50
VanDobeln: folds 
goransyruvka: calls $5
koib88: calls $5
*** FLOP *** [Th 3d 9c]
mzsportline: checks 
goransyruvka: checks 
koib88: checks 
Priidix: bets $19.05
mzsportline: folds 
goransyruvka: folds 
koib88: calls $19.05
*** TURN *** [Th 3d 9c] [Qc]
koib88: checks 
Priidix: checks 
*** RIVER *** [Th 3d 9c Qc] [6c]
koib88: checks 
Priidix: checks 
*** SHOW DOWN ***
koib88: shows [2h 3c] (a pair of Threes)
Priidix: shows [Td Jc] (a pair of Tens)
Priidix collected $61.90 from pot
*** SUMMARY ***
Total pot $64.70 | Rake $2.80 
Board [Th 3d 9c Qc 6c]
Seat 2: mzsportline (small blind) folded on the Flop
Seat 3: VanDobeln (big blind) folded before Flop
Seat 4: goransyruvka folded on the Flop
Seat 5: koib88 showed [2h 3c] and lost with a pair of Threes
Seat 6: Priidix showed [Td Jc] and won ($61.90) with a pair of Tens
Seat 7: matiko09 folded before Flop (didn't bet)
Seat 8: redacesfull folded before Flop (didn't bet)
Seat 9: er13to (button) folded before Flop (didn't bet)





PokerStars Hand #148833271937:  Hold'em No Limit ($0.50/$1.00 USD) - 2016/02/15 11:13:23 CET [2016/02/15 5:13:23 ET]
Table 'Euanthe II' 9-max Seat #3 is the button
Seat 1: maxxmeister ($126.94 in chips) 
Seat 2: mycka86 ($331.49 in chips) 
Seat 3: Sreshta222 ($100 in chips) 
Seat 4: er13to ($117.95 in chips) 
Seat 5: gabi_igna ($100 in chips) 
Seat 7: vinniesmol ($219.17 in chips) 
Seat 8: matiko09 ($124.77 in chips) 
er13to: posts small blind $0.50
gabi_igna: posts big blind $1
IHouseMusic: sits out 
Venomous100%: sits out 
*** HOLE CARDS ***
Dealt to matiko09 [3s 7h]
vinniesmol: raises $2 to $3
matiko09: folds 
maxxmeister: folds 
mycka86: folds 
Sreshta222: folds 
er13to: folds 
gabi_igna: folds 
Uncalled bet ($2) returned to vinniesmol
vinniesmol collected $2.50 from pot
*** SUMMARY ***
Total pot $2.50 | Rake $0 
Seat 1: maxxmeister folded before Flop (didn't bet)
Seat 2: mycka86 folded before Flop (didn't bet)
Seat 3: Sreshta222 (button) folded before Flop (didn't bet)
Seat 4: er13to (small blind) folded before Flop
Seat 5: gabi_igna (big blind) folded before Flop
Seat 7: vinniesmol collected ($2.50)
Seat 8: matiko09 folded before Flop (didn't bet)





PokerStars Hand #148833273170:  Hold'em No Limit ($0.50/$1.00 USD) - 2016/02/15 11:13:26 CET [2016/02/15 5:13:26 ET]
Table 'Gemma II' 9-max Seat #4 is the button
Seat 1: Igor DoUrden ($172.44 in chips) 
Seat 3: Venomous100% ($161.51 in chips) 
Seat 4: mycka86 ($100 in chips) 
Seat 5: PokerSash201 ($74.17 in chips) 
Seat 6: IHouseMusic ($101.50 in chips) 
Seat 7: AlKatrone ($117.69 in chips) 
Seat 8: Priidix ($100.16 in chips) 
Seat 9: matiko09 ($105.05 in chips) 
PokerSash201: posts small blind $0.50
IHouseMusic: posts big blind $1
gabi_igna: sits out 
*** HOLE CARDS ***
Dealt to matiko09 [5d 8s]
AlKatrone: raises $2 to $3
Priidix: folds 
matiko09: folds 
Igor DoUrden: folds 
Venomous100%: folds 
mycka86: folds 
PokerSash201: raises $7 to $10
IHouseMusic: folds 
AlKatrone: folds 
Uncalled bet ($7) returned to PokerSash201
PokerSash201 collected $7 from pot
PokerSash201: doesn't show hand 
*** SUMMARY ***
Total pot $7 | Rake $0 
Seat 1: Igor DoUrden folded before Flop (didn't bet)
Seat 3: Venomous100% folded before Flop (didn't bet)
Seat 4: mycka86 (button) folded before Flop (didn't bet)
Seat 5: PokerSash201 (small blind) collected ($7)
Seat 6: IHouseMusic (big blind) folded before Flop
Seat 7: AlKatrone folded before Flop
Seat 8: Priidix folded before Flop (didn't bet)
Seat 9: matiko09 folded before Flop (didn't bet)





PokerStars Hand #148833274341:  Hold'em No Limit ($0.50/$1.00 USD) - 2016/02/15 11:13:29 CET [2016/02/15 5:13:29 ET]
Table 'Sekanina' 9-max Seat #1 is the button
Seat 1: LUTZ_11111 ($58.24 in chips) 
Seat 2: Priidix ($123.83 in chips) 
Seat 4: matiko09 ($100 in chips) 
Seat 5: IHouseMusic ($122.20 in chips) 
Seat 6: vinniesmol ($250.60 in chips) 
Seat 7: mycka86 ($100 in chips) 
Seat 8: Venomous100% ($100 in chips) 
Seat 9: er13to ($102.73 in chips) 
Priidix: posts small blind $0.50
matiko09: posts big blind $1
*** HOLE CARDS ***
Dealt to matiko09 [2h Ts]
IHouseMusic: folds 
vinniesmol: folds 
mycka86: folds 
Venomous100%: folds 
er13to: raises $2 to $3
LUTZ_11111: folds 
Priidix: folds 
matiko09: folds 
Uncalled bet ($2) returned to er13to
er13to collected $2.50 from pot
er13to: doesn't show hand 
*** SUMMARY ***
Total pot $2.50 | Rake $0 
Seat 1: LUTZ_11111 (button) folded before Flop (didn't bet)
Seat 2: Priidix (small blind) folded before Flop
Seat 4: matiko09 (big blind) folded before Flop
Seat 5: IHouseMusic folded before Flop (didn't bet)
Seat 6: vinniesmol folded before Flop (didn't bet)
Seat 7: mycka86 folded before Flop (didn't bet)
Seat 8: Venomous100% folded before Flop (didn't bet)
Seat 9: er13to collected ($2.50)





PokerStars Hand #148833275369:  Hold'em No Limit ($0.50/$1.00 USD) - 2016/02/15 11:13:31 CET [2016/02/15 5:13:31 ET]
Table 'Praecipua' 9-max Seat #6 is the button
Seat 1: er13to ($135.43 in chips) 
Seat 2: matiko09 ($100 in chips) 
Seat 3: Venomous100% ($108.82 in chips) 
Seat 5: huffwag ($160.99 in chips) 
Seat 6: mycka86 ($113.60 in chips) 
Seat 7: maxxmeister ($145.23 in chips) 
Seat 8: Ellis Ng ($37 in chips) 
Seat 9: AlKatrone ($104.50 in chips) 
maxxmeister: posts small blind $0.50
Ellis Ng: posts big blind $1
gabi_igna: sits out 
*** HOLE CARDS ***
Dealt to matiko09 [Kd Kh]
AlKatrone: folds 
er13to: folds 
matiko09: raises $2 to $3
Venomous100%: folds 
huffwag: folds 
mycka86: folds 
maxxmeister: folds 
Ellis Ng: folds 
Uncalled bet ($2) returned to matiko09
matiko09 collected $2.50 from pot
matiko09: doesn't show hand 
*** SUMMARY ***
Total pot $2.50 | Rake $0 
Seat 1: er13to folded before Flop (didn't bet)
Seat 2: matiko09 collected ($2.50)
Seat 3: Venomous100% folded before Flop (didn't bet)
Seat 5: huffwag folded before Flop (didn't bet)
Seat 6: mycka86 (button) folded before Flop (didn't bet)
Seat 7: maxxmeister (small blind) folded before Flop
Seat 8: Ellis Ng (big blind) folded before Flop
Seat 9: AlKatrone folded before Flop (didn't bet)





PokerStars Hand #148833280390:  Hold'em No Limit ($0.50/$1.00 USD) - 2016/02/15 11:13:42 CET [2016/02/15 5:13:42 ET]
Table 'Euanthe II' 9-max Seat #4 is the button
Seat 1: maxxmeister ($126.94 in chips) 
Seat 2: mycka86 ($331.49 in chips) 
Seat 3: Sreshta222 ($100 in chips) 
Seat 4: er13to ($117.45 in chips) 
Seat 5: gabi_igna ($100 in chips) 
Seat 6: IHouseMusic ($100 in chips) 
Seat 7: vinniesmol ($220.67 in chips) 
Seat 8: matiko09 ($124.77 in chips) 
gabi_igna: posts small blind $0.50
IHouseMusic: posts big blind $1
Venomous100%: sits out 
*** HOLE CARDS ***
Dealt to matiko09 [Jh 8c]
vinniesmol: folds 
matiko09: folds 
maxxmeister: raises $2.50 to $3.50
mycka86: folds 
Sreshta222: folds 
er13to: folds 
gabi_igna: folds 
IHouseMusic: folds 
Uncalled bet ($2.50) returned to maxxmeister
maxxmeister collected $2.50 from pot
maxxmeister: doesn't show hand 
*** SUMMARY ***
Total pot $2.50 | Rake $0 
Seat 1: maxxmeister collected ($2.50)
Seat 2: mycka86 folded before Flop (didn't bet)
Seat 3: Sreshta222 folded before Flop (didn't bet)
Seat 4: er13to (button) folded before Flop (didn't bet)
Seat 5: gabi_igna (small blind) folded before Flop
Seat 6: IHouseMusic (big blind) folded before Flop
Seat 7: vinniesmol folded before Flop (didn't bet)
Seat 8: matiko09 folded before Flop (didn't bet)





PokerStars Hand #148833284174:  Hold'em No Limit ($0.25/$0.50 USD) - 2016/02/15 11:13:50 CET [2016/02/15 5:13:50 ET]
Table 'Vesta II' 9-max Seat #4 is the button
Seat 1: Ahangama ($94.33 in chips) 
Seat 2: i L00K great ($17.34 in chips) 
Seat 3: matiko09 ($73.20 in chips) 
Seat 4: vlad11122007 ($48.50 in chips) 
Seat 5: dndngod ($74.15 in chips) 
Seat 6: pandalapa ($50 in chips) 
Seat 7: ruyingren ($27.04 in chips) 
Seat 8: Arystan ($131.53 in chips) 
Seat 9: Aoki42 ($83.47 in chips) 
dndngod: posts small blind $0.25
pandalapa: posts big blind $0.50
*** HOLE CARDS ***
Dealt to matiko09 [3h Ts]
ruyingren: folds 
Arystan: folds 
Aoki42: folds 
Ahangama: folds 
i L00K great: folds 
matiko09: folds 
vlad11122007: raises $0.50 to $1
dndngod: folds 
pandalapa: calls $0.50
*** FLOP *** [2d Js 6d]
pandalapa: checks 
vlad11122007: bets $1.50
pandalapa: folds 
Uncalled bet ($1.50) returned to vlad11122007
vlad11122007 collected $2.15 from pot
vlad11122007: doesn't show hand 
*** SUMMARY ***
Total pot $2.25 | Rake $0.10 
Board [2d Js 6d]
Seat 1: Ahangama folded before Flop (didn't bet)
Seat 2: i L00K great folded before Flop (didn't bet)
Seat 3: matiko09 folded before Flop (didn't bet)
Seat 4: vlad11122007 (button) collected ($2.15)
Seat 5: dndngod (small blind) folded before Flop
Seat 6: pandalapa (big blind) folded on the Flop
Seat 7: ruyingren folded before Flop (didn't bet)
Seat 8: Arystan folded before Flop (didn't bet)
Seat 9: Aoki42 folded before Flop (didn't bet)





PokerStars Hand #148833284904:  Hold'em No Limit ($0.50/$1.00 USD) - 2016/02/15 11:13:51 CET [2016/02/15 5:13:51 ET]
Table 'Anteros' 9-max Seat #1 is the button
Seat 1: redacesfull ($102.43 in chips) 
Seat 2: IHouseMusic ($103.44 in chips) 
Seat 3: er13to ($102.24 in chips) 
Seat 4: misherei ($199.01 in chips) 
Seat 5: Holm1991 ($50.36 in chips) 
Seat 6: SerAlGog ($138.31 in chips) 
Seat 7: Zoubou1983 ($169.58 in chips) 
Seat 8: matiko09 ($100 in chips) 
Seat 9: mycka86 ($100 in chips) 
IHouseMusic: posts small blind $0.50
er13to: posts big blind $1
*** HOLE CARDS ***
Dealt to matiko09 [Jh 7d]
misherei: folds 
Holm1991: folds 
SerAlGog: folds 
Zoubou1983: calls $1
matiko09: folds 
mycka86: folds 
redacesfull: folds 
IHouseMusic: folds 
er13to: checks 
*** FLOP *** [Ah 6c 5h]
er13to: checks 
Zoubou1983: checks 
*** TURN *** [Ah 6c 5h] [2h]
er13to: checks 
Zoubou1983: checks 
*** RIVER *** [Ah 6c 5h 2h] [Ac]
er13to: checks 
Zoubou1983: bets $3
er13to: folds 
Uncalled bet ($3) returned to Zoubou1983
Zoubou1983 collected $2.39 from pot
Zoubou1983: doesn't show hand 
*** SUMMARY ***
Total pot $2.50 | Rake $0.11 
Board [Ah 6c 5h 2h Ac]
Seat 1: redacesfull (button) folded before Flop (didn't bet)
Seat 2: IHouseMusic (small blind) folded before Flop
Seat 3: er13to (big blind) folded on the River
Seat 4: misherei folded before Flop (didn't bet)
Seat 5: Holm1991 folded before Flop (didn't bet)
Seat 6: SerAlGog folded before Flop (didn't bet)
Seat 7: Zoubou1983 collected ($2.39)
Seat 8: matiko09 folded before Flop (didn't bet)
Seat 9: mycka86 folded before Flop (didn't bet)





PokerStars Hand #148833284959:  Hold'em No Limit ($0.50/$1.00 USD) - 2016/02/15 11:13:52 CET [2016/02/15 5:13:52 ET]
Table 'Nata II' 9-max Seat #9 is the button
Seat 1: Priidix ($100 in chips) 
Seat 2: qqcom ($140.43 in chips) 
Seat 3: g00000se ($121.45 in chips) 
Seat 5: AGoodFell4 ($53.21 in chips) 
Seat 7: er13to ($114.40 in chips) 
Seat 8: Igor DoUrden ($100 in chips) 
Seat 9: matiko09 ($100.37 in chips) 
Priidix: posts small blind $0.50
qqcom: posts big blind $1
gabi_igna: sits out 
AlKatrone: sits out 
*** HOLE CARDS ***
Dealt to matiko09 [9d 6s]
g00000se: folds 
AGoodFell4: raises $2 to $3
er13to: folds 
Igor DoUrden: folds 
matiko09: folds 
Priidix: folds 
qqcom: calls $2
*** FLOP *** [6d 7s 2s]
qqcom: checks 
AGoodFell4: bets $4
qqcom: raises $4 to $8
AGoodFell4: folds 
Uncalled bet ($4) returned to qqcom
qqcom collected $13.85 from pot
*** SUMMARY ***
Total pot $14.50 | Rake $0.65 
Board [6d 7s 2s]
Seat 1: Priidix (small blind) folded before Flop
Seat 2: qqcom (big blind) collected ($13.85)
Seat 3: g00000se folded before Flop (didn't bet)
Seat 5: AGoodFell4 folded on the Flop
Seat 7: er13to folded before Flop (didn't bet)
Seat 8: Igor DoUrden folded before Flop (didn't bet)
Seat 9: matiko09 (button) folded before Flop (didn't bet)





PokerStars Hand #148833287537:  Hold'em No Limit ($0.50/$1.00 USD) - 2016/02/15 11:13:57 CET [2016/02/15 5:13:57 ET]
Table 'Sekanina' 9-max Seat #2 is the button
Seat 1: LUTZ_11111 ($58.24 in chips) 
Seat 2: Priidix ($123.33 in chips) 
Seat 4: matiko09 ($100 in chips) 
Seat 5: IHouseMusic ($122.20 in chips) 
Seat 6: vinniesmol ($250.60 in chips) 
Seat 7: mycka86 ($100 in chips) 
Seat 8: Venomous100% ($100 in chips) 
Seat 9: er13to ($104.23 in chips) 
matiko09: posts small blind $0.50
IHouseMusic: posts big blind $1
*** HOLE CARDS ***
Dealt to matiko09 [Qh 5s]
vinniesmol: folds 
mycka86: folds 
Venomous100%: raises $2 to $3
er13to: folds 
LUTZ_11111: folds 
Priidix: folds 
matiko09: folds 
IHouseMusic: folds 
Uncalled bet ($2) returned to Venomous100%
Venomous100% collected $2.50 from pot
Venomous100%: doesn't show hand 
*** SUMMARY ***
Total pot $2.50 | Rake $0 
Seat 1: LUTZ_11111 folded before Flop (didn't bet)
Seat 2: Priidix (button) folded before Flop (didn't bet)
Seat 4: matiko09 (small blind) folded before Flop
Seat 5: IHouseMusic (big blind) folded before Flop
Seat 6: vinniesmol folded before Flop (didn't bet)
Seat 7: mycka86 folded before Flop (didn't bet)
Seat 8: Venomous100% collected ($2.50)
Seat 9: er13to folded before Flop (didn't bet)





PokerStars Hand #148833290531:  Hold'em No Limit (€0.50/€1.00 EUR) - 2016/02/15 11:14:04 CET [2016/02/15 5:14:04 ET]
Table 'Ganesa II' 9-max Seat #9 is the button
Seat 2: maxxmeister (€105.21 in chips) 
Seat 3: BuBu 0187 (€71.20 in chips) 
Seat 4: Sreshta222 (€103 in chips) 
Seat 5: vano7777 (€73.74 in chips) 
Seat 6: matiko09 (€126.58 in chips) 
Seat 7: er13to (€115 in chips) 
Seat 8: mycka86 (€100 in chips) 
Seat 9: Priidix (€104.71 in chips) 
maxxmeister: posts small blind €0.50
BuBu 0187: posts big blind €1
*** HOLE CARDS ***
Dealt to matiko09 [Kd Ts]
Sreshta222: folds 
vano7777: folds 
matiko09: raises €2 to €3
er13to: folds 
mycka86: raises €6 to €9
Priidix: folds 
maxxmeister: folds 
BuBu 0187: folds 
matiko09: folds 
Uncalled bet (€6) returned to mycka86
mycka86 collected €7.50 from pot
*** SUMMARY ***
Total pot €7.50 | Rake €0 
Seat 2: maxxmeister (small blind) folded before Flop
Seat 3: BuBu 0187 (big blind) folded before Flop
Seat 4: Sreshta222 folded before Flop (didn't bet)
Seat 5: vano7777 folded before Flop (didn't bet)
Seat 6: matiko09 folded before Flop
Seat 7: er13to folded before Flop (didn't bet)
Seat 8: mycka86 collected (€7.50)
Seat 9: Priidix (button) folded before Flop (didn't bet)





PokerStars Hand #148833292290:  Hold'em No Limit ($0.50/$1.00 USD) - 2016/02/15 11:14:07 CET [2016/02/15 5:14:07 ET]
Table 'Gemma II' 9-max Seat #5 is the button
Seat 1: Igor DoUrden ($172.44 in chips) 
Seat 3: Venomous100% ($161.51 in chips) 
Seat 4: mycka86 ($100 in chips) 
Seat 5: PokerSash201 ($78.17 in chips) 
Seat 6: IHouseMusic ($100.50 in chips) 
Seat 7: AlKatrone ($114.69 in chips) 
Seat 8: Priidix ($100.16 in chips) 
Seat 9: matiko09 ($105.05 in chips) 
IHouseMusic: posts small blind $0.50
AlKatrone: posts big blind $1
gabi_igna: sits out 
*** HOLE CARDS ***
Dealt to matiko09 [Qh 5s]
Priidix: raises $2 to $3
matiko09: folds 
Igor DoUrden: folds 
Venomous100%: folds 
mycka86: folds 
PokerSash201: folds 
IHouseMusic: folds 
AlKatrone: folds 
Uncalled bet ($2) returned to Priidix
Priidix collected $2.50 from pot
Priidix: doesn't show hand 
*** SUMMARY ***
Total pot $2.50 | Rake $0 
Seat 1: Igor DoUrden folded before Flop (didn't bet)
Seat 3: Venomous100% folded before Flop (didn't bet)
Seat 4: mycka86 folded before Flop (didn't bet)
Seat 5: PokerSash201 (button) folded before Flop (didn't bet)
Seat 6: IHouseMusic (small blind) folded before Flop
Seat 7: AlKatrone (big blind) folded before Flop
Seat 8: Priidix collected ($2.50)
Seat 9: matiko09 folded before Flop (didn't bet)





PokerStars Hand #148833292090:  Hold'em No Limit (€0.25/€0.50 EUR) - 2016/02/15 11:14:07 CET [2016/02/15 5:14:07 ET]
Table 'Walinskia II' 9-max Seat #3 is the button
Seat 1: ljryviltj (€52.19 in chips) 
Seat 3: beluccix (€24.91 in chips) 
Seat 4: Otsime (€22.80 in chips) 
Seat 5: vano7777 (€65.55 in chips) 
Seat 6: 50CandyJoe (€65.79 in chips) 
Seat 7: etny99 (€50.19 in chips) 
Seat 8: matiko09 (€79.10 in chips) 
Otsime: posts small blind €0.25
vano7777: posts big blind €0.50
*** HOLE CARDS ***
Dealt to matiko09 [5s Ts]
50CandyJoe: folds 
etny99: folds 
matiko09: folds 
ljryviltj: folds 
beluccix: folds 
Otsime: raises €1 to €1.50
vano7777: calls €1
*** FLOP *** [6s 7c 7s]
Otsime: checks 
vano7777: checks 
*** TURN *** [6s 7c 7s] [5c]
Otsime: checks 
vano7777: bets €2
Otsime: calls €2
*** RIVER *** [6s 7c 7s 5c] [9d]
Otsime: checks 
vano7777: bets €5.50
Otsime: raises €13.80 to €19.30 and is all-in
vano7777: calls €13.80
*** SHOW DOWN ***
Otsime: shows [7d Jd] (three of a kind, Sevens)
vano7777: shows [8s Kc] (a straight, Five to Nine)
vano7777 collected €43.60 from pot
*** SUMMARY ***
Total pot €45.60 | Rake €2 
Board [6s 7c 7s 5c 9d]
Seat 1: ljryviltj folded before Flop (didn't bet)
Seat 3: beluccix (button) folded before Flop (didn't bet)
Seat 4: Otsime (small blind) showed [7d Jd] and lost with three of a kind, Sevens
Seat 5: vano7777 (big blind) showed [8s Kc] and won (€43.60) with a straight, Five to Nine
Seat 6: 50CandyJoe folded before Flop (didn't bet)
Seat 7: etny99 folded before Flop (didn't bet)
Seat 8: matiko09 folded before Flop (didn't bet)





PokerStars Hand #148833295599:  Hold'em No Limit ($0.50/$1.00 USD) - 2016/02/15 11:14:15 CET [2016/02/15 5:14:15 ET]
Table 'Euanthe II' 9-max Seat #5 is the button
Seat 1: maxxmeister ($128.44 in chips) 
Seat 2: mycka86 ($331.49 in chips) 
Seat 3: Sreshta222 ($100 in chips) 
Seat 4: er13to ($117.45 in chips) 
Seat 5: gabi_igna ($100 in chips) 
Seat 6: IHouseMusic ($100 in chips) 
Seat 7: vinniesmol ($220.67 in chips) 
Seat 8: matiko09 ($124.77 in chips) 
IHouseMusic: posts small blind $0.50
vinniesmol: posts big blind $1
Venomous100%: sits out 
*** HOLE CARDS ***
Dealt to matiko09 [2s Jh]
matiko09: folds 
maxxmeister: folds 
mycka86: folds 
Sreshta222: folds 
er13to: raises $1.50 to $2.50
gabi_igna: raises $6.50 to $9
IHouseMusic: folds 
vinniesmol: folds 
er13to: folds 
Uncalled bet ($6.50) returned to gabi_igna
gabi_igna collected $6.50 from pot
gabi_igna: doesn't show hand 
*** SUMMARY ***
Total pot $6.50 | Rake $0 
Seat 1: maxxmeister folded before Flop (didn't bet)
Seat 2: mycka86 folded before Flop (didn't bet)
Seat 3: Sreshta222 folded before Flop (didn't bet)
Seat 4: er13to folded before Flop
Seat 5: gabi_igna (button) collected ($6.50)
Seat 6: IHouseMusic (small blind) folded before Flop
Seat 7: vinniesmol (big blind) folded before Flop
Seat 8: matiko09 folded before Flop (didn't bet)





PokerStars Hand #148833296049:  Hold'em No Limit ($0.50/$1.00 USD) - 2016/02/15 11:14:16 CET [2016/02/15 5:14:16 ET]
Table 'Sekanina' 9-max Seat #4 is the button
Seat 1: LUTZ_11111 ($58.24 in chips) 
Seat 2: Priidix ($123.33 in chips) 
Seat 4: matiko09 ($100 in chips) 
Seat 5: IHouseMusic ($121.20 in chips) 
Seat 6: vinniesmol ($250.60 in chips) 
Seat 7: mycka86 ($100 in chips) 
Seat 8: Venomous100% ($101.50 in chips) 
Seat 9: er13to ($104.23 in chips) 
IHouseMusic: posts small blind $0.50
vinniesmol: posts big blind $1
*** HOLE CARDS ***
Dealt to matiko09 [2h Td]
mycka86: folds 
Venomous100%: folds 
er13to: folds 
LUTZ_11111: folds 
Priidix: folds 
matiko09: folds 
IHouseMusic: folds 
Uncalled bet ($0.50) returned to vinniesmol
vinniesmol collected $1 from pot
*** SUMMARY ***
Total pot $1 | Rake $0 
Seat 1: LUTZ_11111 folded before Flop (didn't bet)
Seat 2: Priidix folded before Flop (didn't bet)
Seat 4: matiko09 (button) folded before Flop (didn't bet)
Seat 5: IHouseMusic (small blind) folded before Flop
Seat 6: vinniesmol (big blind) collected ($1)
Seat 7: mycka86 folded before Flop (didn't bet)
Seat 8: Venomous100% folded before Flop (didn't bet)
Seat 9: er13to folded before Flop (didn't bet)





PokerStars Hand #148833297134:  Hold'em No Limit ($0.25/$0.50 USD) - 2016/02/15 11:14:18 CET [2016/02/15 5:14:18 ET]
Table 'Laertes II' 9-max Seat #9 is the button
Seat 1: etny99 ($50 in chips) 
Seat 2: beluccix ($24.96 in chips) 
Seat 3: ljryviltj ($59.05 in chips) 
Seat 4: rgar93 ($43.48 in chips) 
Seat 5: vlad11122007 ($50.30 in chips) 
Seat 6: yats87 ($59.91 in chips) 
Seat 7: Vedpapa ($63.28 in chips) 
Seat 8: Trent444 ($40.53 in chips) 
Seat 9: matiko09 ($50.85 in chips) 
etny99: posts small blind $0.25
beluccix: posts big blind $0.50
*** HOLE CARDS ***
Dealt to matiko09 [9d 6c]
ljryviltj: folds 
rgar93: folds 
vlad11122007: folds 
yats87: folds 
Vedpapa: folds 
Trent444: folds 
matiko09: folds 
etny99: raises $0.75 to $1.25
beluccix: calls $0.75
*** FLOP *** [5c Ad Js]
etny99: bets $1.19
beluccix: folds 
Uncalled bet ($1.19) returned to etny99
etny99 collected $2.39 from pot
etny99: doesn't show hand 
*** SUMMARY ***
Total pot $2.50 | Rake $0.11 
Board [5c Ad Js]
Seat 1: etny99 (small blind) collected ($2.39)
Seat 2: beluccix (big blind) folded on the Flop
Seat 3: ljryviltj folded before Flop (didn't bet)
Seat 4: rgar93 folded before Flop (didn't bet)
Seat 5: vlad11122007 folded before Flop (didn't bet)
Seat 6: yats87 folded before Flop (didn't bet)
Seat 7: Vedpapa folded before Flop (didn't bet)
Seat 8: Trent444 folded before Flop (didn't bet)
Seat 9: matiko09 (button) folded before Flop (didn't bet)





PokerStars Hand #148833298489:  Hold'em No Limit ($0.50/$1.00 USD) - 2016/02/15 11:14:21 CET [2016/02/15 5:14:21 ET]
Table 'Ristenpart' 9-max Seat #4 is the button
Seat 1: vano7777 ($52 in chips) 
Seat 2: IHouseMusic ($117.33 in chips) 
Seat 3: RYUJI07 ($21.44 in chips) 
Seat 4: miyashin ($109.60 in chips) 
Seat 5: lingyyang ($49 in chips) 
Seat 6: matiko09 ($100 in chips) 
Seat 8: gwwsb ($39.88 in chips) 
Seat 9: Igor DoUrden ($103.23 in chips) 
lingyyang: posts small blind $0.50
matiko09: posts big blind $1
Aalleekks: sits out 
*** HOLE CARDS ***
Dealt to matiko09 [Th 2d]
gwwsb: raises $2 to $3
Igor DoUrden: folds 
vano7777: folds 
IHouseMusic: folds 
RYUJI07: folds 
miyashin: calls $3
lingyyang: folds 
matiko09: folds 
*** FLOP *** [6c 2c 8s]
gwwsb: bets $6
miyashin: calls $6
*** TURN *** [6c 2c 8s] [Ts]
gwwsb: bets $11
miyashin: raises $89.60 to $100.60 and is all-in
gwwsb: calls $19.88 and is all-in
Uncalled bet ($69.72) returned to miyashin
*** RIVER *** [6c 2c 8s Ts] [Ks]
*** SHOW DOWN ***
gwwsb: shows [Js Jc] (a pair of Jacks)
miyashin: shows [Td Ah] (a pair of Tens)
gwwsb collected $78.46 from pot
*** SUMMARY ***
Total pot $81.26 | Rake $2.80 
Board [6c 2c 8s Ts Ks]
Seat 1: vano7777 folded before Flop (didn't bet)
Seat 2: IHouseMusic folded before Flop (didn't bet)
Seat 3: RYUJI07 folded before Flop (didn't bet)
Seat 4: miyashin (button) showed [Td Ah] and lost with a pair of Tens
Seat 5: lingyyang (small blind) folded before Flop
Seat 6: matiko09 (big blind) folded before Flop
Seat 8: gwwsb showed [Js Jc] and won ($78.46) with a pair of Jacks
Seat 9: Igor DoUrden folded before Flop (didn't bet)





PokerStars Hand #148833299692:  Hold'em No Limit ($0.50/$1.00 USD) - 2016/02/15 11:14:24 CET [2016/02/15 5:14:24 ET]
Table 'Corvus III' 9-max Seat #2 is the button
Seat 2: mzsportline ($138 in chips) 
Seat 3: VanDobeln ($245.90 in chips) 
Seat 4: goransyruvka ($65.22 in chips) 
Seat 5: koib88 ($476.34 in chips) 
Seat 6: Priidix ($176.26 in chips) 
Seat 7: matiko09 ($208.76 in chips) 
Seat 8: redacesfull ($250 in chips) 
Seat 9: er13to ($100 in chips) 
VanDobeln: posts small blind $0.50
goransyruvka: posts big blind $1
mzsportline: posts the ante $0.20
VanDobeln: posts the ante $0.20
goransyruvka: posts the ante $0.20
koib88: posts the ante $0.20
Priidix: posts the ante $0.20
matiko09: posts the ante $0.20
redacesfull: posts the ante $0.20
er13to: posts the ante $0.20
*** HOLE CARDS ***
Dealt to matiko09 [2h Jc]
koib88: calls $1
Priidix: folds 
matiko09: folds 
redacesfull: folds 
er13to: folds 
mzsportline: folds 
VanDobeln: folds 
goransyruvka: checks 
*** FLOP *** [7h 9s 6s]
goransyruvka: checks 
koib88: checks 
*** TURN *** [7h 9s 6s] [Tc]
goransyruvka: bets $1.96
koib88: folds 
Uncalled bet ($1.96) returned to goransyruvka
goransyruvka collected $3.92 from pot
goransyruvka: doesn't show hand 
*** SUMMARY ***
Total pot $4.10 | Rake $0.18 
Board [7h 9s 6s Tc]
Seat 2: mzsportline (button) folded before Flop (didn't bet)
Seat 3: VanDobeln (small blind) folded before Flop
Seat 4: goransyruvka (big blind) collected ($3.92)
Seat 5: koib88 folded on the Turn
Seat 6: Priidix folded before Flop (didn't bet)
Seat 7: matiko09 folded before Flop (didn't bet)
Seat 8: redacesfull folded before Flop (didn't bet)
Seat 9: er13to folded before Flop (didn't bet)





PokerStars Hand #148833300703:  Hold'em No Limit ($0.50/$1.00 USD) - 2016/02/15 11:14:26 CET [2016/02/15 5:14:26 ET]
Table 'Praecipua' 9-max Seat #7 is the button
Seat 1: er13to ($135.43 in chips) 
Seat 2: matiko09 ($101.50 in chips) 
Seat 3: Venomous100% ($108.82 in chips) 
Seat 5: huffwag ($160.99 in chips) 
Seat 6: mycka86 ($113.60 in chips) 
Seat 7: maxxmeister ($144.73 in chips) 
Seat 8: Ellis Ng ($36 in chips) 
Seat 9: AlKatrone ($104.50 in chips) 
Ellis Ng: posts small blind $0.50
AlKatrone: posts big blind $1
gabi_igna: sits out 
*** HOLE CARDS ***
Dealt to matiko09 [9d Ac]
er13to: folds 
matiko09: folds 
Venomous100%: folds 
huffwag: folds 
mycka86: raises $1.10 to $2.10
maxxmeister: folds 
Ellis Ng: calls $1.60
AlKatrone: calls $1.10
*** FLOP *** [Qd 4h 2d]
Ellis Ng: checks 
AlKatrone: checks 
mycka86: checks 
*** TURN *** [Qd 4h 2d] [Js]
Ellis Ng: checks 
AlKatrone: checks 
mycka86: checks 
*** RIVER *** [Qd 4h 2d Js] [Kh]
Ellis Ng: bets $3
AlKatrone: folds 
mycka86: folds 
Uncalled bet ($3) returned to Ellis Ng
Ellis Ng collected $6.02 from pot
*** SUMMARY ***
Total pot $6.30 | Rake $0.28 
Board [Qd 4h 2d Js Kh]
Seat 1: er13to folded before Flop (didn't bet)
Seat 2: matiko09 folded before Flop (didn't bet)
Seat 3: Venomous100% folded before Flop (didn't bet)
Seat 5: huffwag folded before Flop (didn't bet)
Seat 6: mycka86 folded on the River
Seat 7: maxxmeister (button) folded before Flop (didn't bet)
Seat 8: Ellis Ng (small blind) collected ($6.02)
Seat 9: AlKatrone (big blind) folded on the River





PokerStars Hand #148833301839:  Hold'em No Limit ($0.50/$1.00 USD) - 2016/02/15 11:14:28 CET [2016/02/15 5:14:28 ET]
Table 'Nata II' 9-max Seat #1 is the button
Seat 1: Priidix ($100 in chips) 
Seat 2: qqcom ($147.28 in chips) 
Seat 3: g00000se ($121.45 in chips) 
Seat 5: AGoodFell4 ($46.21 in chips) 
Seat 7: er13to ($114.40 in chips) 
Seat 8: Igor DoUrden ($100 in chips) 
Seat 9: matiko09 ($100.37 in chips) 
qqcom: posts small blind $0.50
g00000se: posts big blind $1
gabi_igna: sits out 
AlKatrone: sits out 
*** HOLE CARDS ***
Dealt to matiko09 [9h 8d]
AGoodFell4: folds 
er13to: folds 
Igor DoUrden: raises $1.25 to $2.25
matiko09: folds 
Priidix: calls $2.25
qqcom: folds 
g00000se: folds 
*** FLOP *** [Qh 4c 3d]
Igor DoUrden: bets $3.15
Priidix: calls $3.15
*** TURN *** [Qh 4c 3d] [9d]
Igor DoUrden: checks 
Priidix: checks 
*** RIVER *** [Qh 4c 3d 9d] [6d]
Igor DoUrden: checks 
Priidix: checks 
*** SHOW DOWN ***
Igor DoUrden: shows [Qc Kc] (a pair of Queens)
Priidix: mucks hand 
Igor DoUrden collected $11.75 from pot
*** SUMMARY ***
Total pot $12.30 | Rake $0.55 
Board [Qh 4c 3d 9d 6d]
Seat 1: Priidix (button) mucked [As Ks]
Seat 2: qqcom (small blind) folded before Flop
Seat 3: g00000se (big blind) folded before Flop
Seat 5: AGoodFell4 folded before Flop (didn't bet)
Seat 7: er13to folded before Flop (didn't bet)
Seat 8: Igor DoUrden showed [Qc Kc] and won ($11.75) with a pair of Queens
Seat 9: matiko09 folded before Flop (didn't bet)





PokerStars Hand #148833303067:  Hold'em No Limit ($0.50/$1.00 USD) - 2016/02/15 11:14:31 CET [2016/02/15 5:14:31 ET]
Table 'Gemma II' 9-max Seat #6 is the button
Seat 1: Igor DoUrden ($172.44 in chips) 
Seat 3: Venomous100% ($161.51 in chips) 
Seat 4: mycka86 ($100 in chips) 
Seat 5: PokerSash201 ($78.17 in chips) 
Seat 6: IHouseMusic ($100 in chips) 
Seat 7: AlKatrone ($113.69 in chips) 
Seat 8: Priidix ($101.66 in chips) 
Seat 9: matiko09 ($105.05 in chips) 
AlKatrone: posts small blind $0.50
Priidix: posts big blind $1
gabi_igna: sits out 
*** HOLE CARDS ***
Dealt to matiko09 [2c 9c]
matiko09: folds 
Igor DoUrden: folds 
Venomous100%: folds 
mycka86: raises $1.50 to $2.50
PokerSash201: calls $2.50
IHouseMusic: folds 
AlKatrone: raises $9.25 to $11.75
Priidix: folds 
mycka86: folds 
PokerSash201: folds 
Uncalled bet ($9.25) returned to AlKatrone
AlKatrone collected $8.50 from pot
AlKatrone: doesn't show hand 
*** SUMMARY ***
Total pot $8.50 | Rake $0 
Seat 1: Igor DoUrden folded before Flop (didn't bet)
Seat 3: Venomous100% folded before Flop (didn't bet)
Seat 4: mycka86 folded before Flop
Seat 5: PokerSash201 folded before Flop
Seat 6: IHouseMusic (button) folded before Flop (didn't bet)
Seat 7: AlKatrone (small blind) collected ($8.50)
Seat 8: Priidix (big blind) folded before Flop
Seat 9: matiko09 folded before Flop (didn't bet)





PokerStars Hand #148833305131:  Hold'em No Limit ($0.50/$1.00 USD) - 2016/02/15 11:14:35 CET [2016/02/15 5:14:35 ET]
Table 'Sekanina' 9-max Seat #5 is the button
Seat 1: LUTZ_11111 ($58.24 in chips) 
Seat 2: Priidix ($123.33 in chips) 
Seat 4: matiko09 ($100 in chips) 
Seat 5: IHouseMusic ($120.70 in chips) 
Seat 6: vinniesmol ($251.10 in chips) 
Seat 7: mycka86 ($100 in chips) 
Seat 8: Venomous100% ($101.50 in chips) 
Seat 9: er13to ($104.23 in chips) 
vinniesmol: posts small blind $0.50
mycka86: posts big blind $1
*** HOLE CARDS ***
Dealt to matiko09 [Ac 3d]
Venomous100%: folds 
er13to: folds 
LUTZ_11111: calls $1
Priidix: folds 
matiko09: folds 
IHouseMusic: folds 
vinniesmol: folds 
mycka86: checks 
*** FLOP *** [4h Ts 8h]
mycka86: checks 
LUTZ_11111: bets $2
mycka86: folds 
Uncalled bet ($2) returned to LUTZ_11111
LUTZ_11111 collected $2.39 from pot
LUTZ_11111: doesn't show hand 
*** SUMMARY ***
Total pot $2.50 | Rake $0.11 
Board [4h Ts 8h]
Seat 1: LUTZ_11111 collected ($2.39)
Seat 2: Priidix folded before Flop (didn't bet)
Seat 4: matiko09 folded before Flop (didn't bet)
Seat 5: IHouseMusic (button) folded before Flop (didn't bet)
Seat 6: vinniesmol (small blind) folded before Flop
Seat 7: mycka86 (big blind) folded on the Flop
Seat 8: Venomous100% folded before Flop (didn't bet)
Seat 9: er13to folded before Flop (didn't bet)





PokerStars Hand #148833310038:  Hold'em No Limit ($0.25/$0.50 USD) - 2016/02/15 11:14:46 CET [2016/02/15 5:14:46 ET]
Table 'Vesta II' 9-max Seat #5 is the button
Seat 1: Ahangama ($94.33 in chips) 
Seat 2: i L00K great ($50 in chips) 
Seat 3: matiko09 ($73.20 in chips) 
Seat 4: vlad11122007 ($49.65 in chips) 
Seat 5: dndngod ($73.90 in chips) 
Seat 6: pandalapa ($50 in chips) 
Seat 7: ruyingren ($27.04 in chips) 
Seat 8: Arystan ($131.53 in chips) 
Seat 9: Aoki42 ($83.47 in chips) 
pandalapa: posts small blind $0.25
ruyingren: posts big blind $0.50
*** HOLE CARDS ***
Dealt to matiko09 [Ad Ts]
Arystan: raises $1 to $1.50
Aoki42: folds 
Ahangama: folds 
i L00K great: folds 
matiko09: folds 
vlad11122007: folds 
dndngod: folds 
pandalapa: folds 
ruyingren: folds 
Uncalled bet ($1) returned to Arystan
Arystan collected $1.25 from pot
Arystan: doesn't show hand 
*** SUMMARY ***
Total pot $1.25 | Rake $0 
Seat 1: Ahangama folded before Flop (didn't bet)
Seat 2: i L00K great folded before Flop (didn't bet)
Seat 3: matiko09 folded before Flop (didn't bet)
Seat 4: vlad11122007 folded before Flop (didn't bet)
Seat 5: dndngod (button) folded before Flop (didn't bet)
Seat 6: pandalapa (small blind) folded before Flop
Seat 7: ruyingren (big blind) folded before Flop
Seat 8: Arystan collected ($1.25)
Seat 9: Aoki42 folded before Flop (didn't bet)





PokerStars Hand #148833315042:  Hold'em No Limit ($0.50/$1.00 USD) - 2016/02/15 11:14:57 CET [2016/02/15 5:14:57 ET]
Table 'Corvus III' 9-max Seat #3 is the button
Seat 2: mzsportline ($137.80 in chips) 
Seat 3: VanDobeln ($245.20 in chips) 
Seat 4: goransyruvka ($67.94 in chips) 
Seat 5: koib88 ($475.14 in chips) 
Seat 6: Priidix ($176.06 in chips) 
Seat 7: matiko09 ($208.56 in chips) 
Seat 8: redacesfull ($249.80 in chips) 
Seat 9: er13to ($100 in chips) 
goransyruvka: posts small blind $0.50
koib88: posts big blind $1
mzsportline: posts the ante $0.20
VanDobeln: posts the ante $0.20
goransyruvka: posts the ante $0.20
koib88: posts the ante $0.20
Priidix: posts the ante $0.20
matiko09: posts the ante $0.20
redacesfull: posts the ante $0.20
er13to: posts the ante $0.20
*** HOLE CARDS ***
Dealt to matiko09 [Ks 3h]
Priidix: folds 
matiko09: folds 
redacesfull: raises $1.12 to $2.12
er13to: raises $8.18 to $10.30
mzsportline: folds 
VanDobeln: folds 
goransyruvka: folds 
koib88: folds 
redacesfull: folds 
Uncalled bet ($8.18) returned to er13to
er13to collected $7.34 from pot
*** SUMMARY ***
Total pot $7.34 | Rake $0 
Seat 2: mzsportline folded before Flop (didn't bet)
Seat 3: VanDobeln (button) folded before Flop (didn't bet)
Seat 4: goransyruvka (small blind) folded before Flop
Seat 5: koib88 (big blind) folded before Flop
Seat 6: Priidix folded before Flop (didn't bet)
Seat 7: matiko09 folded before Flop (didn't bet)
Seat 8: redacesfull folded before Flop
Seat 9: er13to collected ($7.34)





PokerStars Hand #148833316370:  Hold'em No Limit (€0.50/€1.00 EUR) - 2016/02/15 11:15:00 CET [2016/02/15 5:15:00 ET]
Table 'Ganesa II' 9-max Seat #2 is the button
Seat 2: maxxmeister (€104.71 in chips) 
Seat 3: BuBu 0187 (€70.20 in chips) 
Seat 4: Sreshta222 (€103 in chips) 
Seat 5: vano7777 (€73.74 in chips) 
Seat 6: matiko09 (€123.58 in chips) 
Seat 7: er13to (€115 in chips) 
Seat 8: mycka86 (€104.50 in chips) 
Seat 9: Priidix (€104.71 in chips) 
BuBu 0187: posts small blind €0.50
Sreshta222: posts big blind €1
*** HOLE CARDS ***
Dealt to matiko09 [3h 8c]
vano7777: folds 
matiko09: folds 
er13to: folds 
mycka86: folds 
Priidix: folds 
maxxmeister: raises €2 to €3
BuBu 0187: calls €2.50
Sreshta222: calls €2
*** FLOP *** [7h 4c 3d]
BuBu 0187: checks 
Sreshta222: checks 
maxxmeister: checks 
*** TURN *** [7h 4c 3d] [4s]
BuBu 0187: bets €4
Sreshta222: calls €4
maxxmeister: folds 
*** RIVER *** [7h 4c 3d 4s] [2h]
BuBu 0187: bets €8
Sreshta222: calls €8
*** SHOW DOWN ***
BuBu 0187: shows [Th Ah] (a pair of Fours)
Sreshta222: shows [5d 7d] (two pair, Sevens and Fours)
Sreshta222 collected €31.52 from pot
*** SUMMARY ***
Total pot €33 | Rake €1.48 
Board [7h 4c 3d 4s 2h]
Seat 2: maxxmeister (button) folded on the Turn
Seat 3: BuBu 0187 (small blind) showed [Th Ah] and lost with a pair of Fours
Seat 4: Sreshta222 (big blind) showed [5d 7d] and won (€31.52) with two pair, Sevens and Fours
Seat 5: vano7777 folded before Flop (didn't bet)
Seat 6: matiko09 folded before Flop (didn't bet)
Seat 7: er13to folded before Flop (didn't bet)
Seat 8: mycka86 folded before Flop (didn't bet)
Seat 9: Priidix folded before Flop (didn't bet)





PokerStars Hand #148833320175:  Hold'em No Limit ($0.50/$1.00 USD) - 2016/02/15 11:15:08 CET [2016/02/15 5:15:08 ET]
Table 'Octans II' 9-max Seat #8 is the button
Seat 1: maxxmeister ($100 in chips) 
Seat 2: matiko09 ($247.29 in chips) 
Seat 3: Aalleekks ($100 in chips) 
Seat 4: Venomous100% ($161.80 in chips) 
Seat 5: AlKatrone ($100 in chips) 
Seat 6: er13to ($100 in chips) 
Seat 8: IHouseMusic ($144.93 in chips) 
Seat 9: mycka86 ($107.63 in chips) 
mycka86: posts small blind $0.50
maxxmeister: posts big blind $1
*** HOLE CARDS ***
Dealt to matiko09 [5d 7s]
matiko09: folds 
Aalleekks: folds 
Venomous100%: folds 
AlKatrone: raises $2 to $3
er13to: folds 
IHouseMusic: folds 
mycka86: raises $6.50 to $9.50
maxxmeister: folds 
AlKatrone: calls $6.50
*** FLOP *** [5c Jh 3s]
mycka86: bets $10.50
AlKatrone: calls $10.50
*** TURN *** [5c Jh 3s] [9s]
mycka86: checks 
AlKatrone: bets $21
mycka86: folds 
Uncalled bet ($21) returned to AlKatrone
AlKatrone collected $39.16 from pot
AlKatrone: doesn't show hand 
*** SUMMARY ***
Total pot $41 | Rake $1.84 
Board [5c Jh 3s 9s]
Seat 1: maxxmeister (big blind) folded before Flop
Seat 2: matiko09 folded before Flop (didn't bet)
Seat 3: Aalleekks folded before Flop (didn't bet)
Seat 4: Venomous100% folded before Flop (didn't bet)
Seat 5: AlKatrone collected ($39.16)
Seat 6: er13to folded before Flop (didn't bet)
Seat 8: IHouseMusic (button) folded before Flop (didn't bet)
Seat 9: mycka86 (small blind) folded on the Turn





PokerStars Hand #148833324640:  Hold'em No Limit ($0.50/$1.00 USD) - 2016/02/15 11:15:18 CET [2016/02/15 5:15:18 ET]
Table 'Ristenpart' 9-max Seat #5 is the button
Seat 1: vano7777 ($52 in chips) 
Seat 2: IHouseMusic ($117.33 in chips) 
Seat 3: RYUJI07 ($21.44 in chips) 
Seat 4: miyashin ($69.72 in chips) 
Seat 5: lingyyang ($48.50 in chips) 
Seat 6: matiko09 ($100 in chips) 
Seat 7: Aalleekks ($100 in chips) 
Seat 8: gwwsb ($78.46 in chips) 
Seat 9: Igor DoUrden ($103.23 in chips) 
matiko09: posts small blind $0.50
Aalleekks: posts big blind $1
*** HOLE CARDS ***
Dealt to matiko09 [9c 3s]
gwwsb: folds 
Igor DoUrden: raises $1.25 to $2.25
vano7777: folds 
IHouseMusic: folds 
RYUJI07: folds 
miyashin: calls $2.25
lingyyang: folds 
matiko09: folds 
Aalleekks: raises $7.75 to $10
Igor DoUrden: calls $7.75
miyashin: calls $7.75
*** FLOP *** [Kd 9h 3h]
Aalleekks: bets $17
Igor DoUrden: folds 
miyashin: raises $42.72 to $59.72 and is all-in
Aalleekks: folds 
Uncalled bet ($42.72) returned to miyashin
miyashin collected $61.70 from pot
miyashin: doesn't show hand 
*** SUMMARY ***
Total pot $64.50 | Rake $2.80 
Board [Kd 9h 3h]
Seat 1: vano7777 folded before Flop (didn't bet)
Seat 2: IHouseMusic folded before Flop (didn't bet)
Seat 3: RYUJI07 folded before Flop (didn't bet)
Seat 4: miyashin collected ($61.70)
Seat 5: lingyyang (button) folded before Flop (didn't bet)
Seat 6: matiko09 (small blind) folded before Flop
Seat 7: Aalleekks (big blind) folded on the Flop
Seat 8: gwwsb folded before Flop (didn't bet)
Seat 9: Igor DoUrden folded on the Flop





PokerStars Hand #148833325320:  Hold'em No Limit ($0.50/$1.00 USD) - 2016/02/15 11:15:19 CET [2016/02/15 5:15:19 ET]
Table 'Corvus III' 9-max Seat #4 is the button
Seat 2: mzsportline ($137.60 in chips) 
Seat 3: VanDobeln ($245 in chips) 
Seat 4: goransyruvka ($67.24 in chips) 
Seat 5: koib88 ($473.94 in chips) 
Seat 6: Priidix ($175.86 in chips) 
Seat 7: matiko09 ($208.36 in chips) 
Seat 8: redacesfull ($247.48 in chips) 
Seat 9: er13to ($105.02 in chips) 
koib88: posts small blind $0.50
Priidix: posts big blind $1
mzsportline: posts the ante $0.20
VanDobeln: posts the ante $0.20
goransyruvka: posts the ante $0.20
koib88: posts the ante $0.20
Priidix: posts the ante $0.20
matiko09: posts the ante $0.20
redacesfull: posts the ante $0.20
er13to: posts the ante $0.20
*** HOLE CARDS ***
Dealt to matiko09 [Td Kh]
matiko09: folds 
redacesfull: folds 
er13to: folds 
mzsportline: folds 
VanDobeln: folds 
goransyruvka: calls $1
koib88: calls $0.50
Priidix: raises $4 to $5
goransyruvka: calls $4
koib88: calls $4
*** FLOP *** [Kd Ts 4h]
koib88: checks 
Priidix: bets $11.88
goransyruvka: calls $11.88
koib88: folds 
*** TURN *** [Kd Ts 4h] [3s]
Priidix: checks 
goransyruvka: bets $19.27
Priidix: folds 
Uncalled bet ($19.27) returned to goransyruvka
goransyruvka collected $38.54 from pot
goransyruvka: doesn't show hand 
*** SUMMARY ***
Total pot $40.36 | Rake $1.82 
Board [Kd Ts 4h 3s]
Seat 2: mzsportline folded before Flop (didn't bet)
Seat 3: VanDobeln folded before Flop (didn't bet)
Seat 4: goransyruvka (button) collected ($38.54)
Seat 5: koib88 (small blind) folded on the Flop
Seat 6: Priidix (big blind) folded on the Turn
Seat 7: matiko09 folded before Flop (didn't bet)
Seat 8: redacesfull folded before Flop (didn't bet)
Seat 9: er13to folded before Flop (didn't bet)





PokerStars Hand #148833328472:  Hold'em No Limit (€0.25/€0.50 EUR) - 2016/02/15 11:15:26 CET [2016/02/15 5:15:26 ET]
Table 'Walinskia II' 9-max Seat #5 is the button
Seat 1: ljryviltj (€52.19 in chips) 
Seat 3: beluccix (€24.91 in chips) 
Seat 5: vano7777 (€86.35 in chips) 
Seat 6: 50CandyJoe (€65.79 in chips) 
Seat 7: etny99 (€50.19 in chips) 
Seat 8: matiko09 (€79.10 in chips) 
50CandyJoe: posts small blind €0.25
etny99: posts big blind €0.50
*** HOLE CARDS ***
Dealt to matiko09 [Js Qh]
matiko09: folds 
Otsime leaves the table
ljryviltj: folds 
beluccix: folds 
vano7777: raises €0.50 to €1
50CandyJoe: folds 
etny99: folds 
Uncalled bet (€0.50) returned to vano7777
vano7777 collected €1.25 from pot
*** SUMMARY ***
Total pot €1.25 | Rake €0 
Seat 1: ljryviltj folded before Flop (didn't bet)
Seat 3: beluccix folded before Flop (didn't bet)
Seat 5: vano7777 (button) collected (€1.25)
Seat 6: 50CandyJoe (small blind) folded before Flop
Seat 7: etny99 (big blind) folded before Flop
Seat 8: matiko09 folded before Flop (didn't bet)





PokerStars Hand #148833328924:  Hold'em No Limit ($0.25/$0.50 USD) - 2016/02/15 11:15:27 CET [2016/02/15 5:15:27 ET]
Table 'Laertes II' 9-max Seat #1 is the button
Seat 1: etny99 ($51.14 in chips) 
Seat 2: beluccix ($24.21 in chips) 
Seat 4: rgar93 ($43.48 in chips) 
Seat 5: vlad11122007 ($50.30 in chips) 
Seat 6: yats87 ($59.91 in chips) 
Seat 7: Vedpapa ($63.28 in chips) 
Seat 8: Trent444 ($40.53 in chips) 
Seat 9: matiko09 ($50.85 in chips) 
beluccix: posts small blind $0.25
ljryviltj: is sitting out 
ljryviltj leaves the table
rgar93: posts big blind $0.50
*** HOLE CARDS ***
Dealt to matiko09 [6c 8d]
vlad11122007: folds 
valfan911 joins the table at seat #3 
yats87: folds 
Vedpapa: folds 
Trent444: calls $0.50
matiko09: folds 
etny99: folds 
beluccix: folds 
rgar93: checks 
*** FLOP *** [4c 2d 7s]
rgar93: checks 
Trent444: checks 
*** TURN *** [4c 2d 7s] [Jc]
rgar93: bets $0.50
Trent444: calls $0.50
*** RIVER *** [4c 2d 7s Jc] [5s]
rgar93: checks 
Trent444: bets $2.15
rgar93: folds 
Uncalled bet ($2.15) returned to Trent444
Trent444 collected $2.15 from pot
Trent444: doesn't show hand 
*** SUMMARY ***
Total pot $2.25 | Rake $0.10 
Board [4c 2d 7s Jc 5s]
Seat 1: etny99 (button) folded before Flop (didn't bet)
Seat 2: beluccix (small blind) folded before Flop
Seat 4: rgar93 (big blind) folded on the River
Seat 5: vlad11122007 folded before Flop (didn't bet)
Seat 6: yats87 folded before Flop (didn't bet)
Seat 7: Vedpapa folded before Flop (didn't bet)
Seat 8: Trent444 collected ($2.15)
Seat 9: matiko09 folded before Flop (didn't bet)





PokerStars Hand #148833329167:  Hold'em No Limit ($0.50/$1.00 USD) - 2016/02/15 11:15:27 CET [2016/02/15 5:15:27 ET]
Table 'Anteros' 9-max Seat #2 is the button
Seat 1: redacesfull ($102.43 in chips) 
Seat 2: IHouseMusic ($102.94 in chips) 
Seat 3: er13to ($101.24 in chips) 
Seat 4: misherei ($199.01 in chips) 
Seat 5: Holm1991 ($50.36 in chips) 
Seat 6: SerAlGog ($138.31 in chips) 
Seat 7: Zoubou1983 ($170.97 in chips) 
Seat 8: matiko09 ($100 in chips) 
Seat 9: mycka86 ($100 in chips) 
er13to: posts small blind $0.50
misherei: posts big blind $1
*** HOLE CARDS ***
Dealt to matiko09 [4c 3d]
Holm1991: folds 
SerAlGog: folds 
Zoubou1983: folds 
matiko09: folds 
mycka86: folds 
redacesfull: folds 
IHouseMusic: raises $1 to $2
er13to: folds 
misherei: calls $1
*** FLOP *** [Ac Ad Ts]
misherei: checks 
IHouseMusic: checks 
*** TURN *** [Ac Ad Ts] [5d]
misherei: checks 
IHouseMusic: bets $3.02
misherei: folds 
Uncalled bet ($3.02) returned to IHouseMusic
IHouseMusic collected $4.30 from pot
IHouseMusic: doesn't show hand 
*** SUMMARY ***
Total pot $4.50 | Rake $0.20 
Board [Ac Ad Ts 5d]
Seat 1: redacesfull folded before Flop (didn't bet)
Seat 2: IHouseMusic (button) collected ($4.30)
Seat 3: er13to (small blind) folded before Flop
Seat 4: misherei (big blind) folded on the Turn
Seat 5: Holm1991 folded before Flop (didn't bet)
Seat 6: SerAlGog folded before Flop (didn't bet)
Seat 7: Zoubou1983 folded before Flop (didn't bet)
Seat 8: matiko09 folded before Flop (didn't bet)
Seat 9: mycka86 folded before Flop (didn't bet)





PokerStars Hand #148833330800:  Hold'em No Limit ($0.50/$1.00 USD) - 2016/02/15 11:15:31 CET [2016/02/15 5:15:31 ET]
Table 'Gemma II' 9-max Seat #7 is the button
Seat 1: Igor DoUrden ($172.44 in chips) 
Seat 3: Venomous100% ($161.51 in chips) 
Seat 4: mycka86 ($100 in chips) 
Seat 5: PokerSash201 ($75.67 in chips) 
Seat 6: IHouseMusic ($100 in chips) 
Seat 7: AlKatrone ($119.69 in chips) 
Seat 8: Priidix ($100.66 in chips) 
Seat 9: matiko09 ($105.05 in chips) 
Priidix: posts small blind $0.50
matiko09: posts big blind $1
gabi_igna: sits out 
*** HOLE CARDS ***
Dealt to matiko09 [Jd 8h]
Igor DoUrden: folds 
Venomous100%: folds 
mycka86: folds 
PokerSash201: folds 
IHouseMusic: folds 
AlKatrone: raises $1 to $2
Priidix: folds 
matiko09: folds 
Uncalled bet ($1) returned to AlKatrone
AlKatrone collected $2.50 from pot
AlKatrone: doesn't show hand 
*** SUMMARY ***
Total pot $2.50 | Rake $0 
Seat 1: Igor DoUrden folded before Flop (didn't bet)
Seat 3: Venomous100% folded before Flop (didn't bet)
Seat 4: mycka86 folded before Flop (didn't bet)
Seat 5: PokerSash201 folded before Flop (didn't bet)
Seat 6: IHouseMusic folded before Flop (didn't bet)
Seat 7: AlKatrone (button) collected ($2.50)
Seat 8: Priidix (small blind) folded before Flop
Seat 9: matiko09 (big blind) folded before Flop





PokerStars Hand #148833331218:  Hold'em No Limit ($0.50/$1.00 USD) - 2016/02/15 11:15:32 CET [2016/02/15 5:15:32 ET]
Table 'Sekanina' 9-max Seat #6 is the button
Seat 1: LUTZ_11111 ($59.63 in chips) 
Seat 2: Priidix ($123.33 in chips) 
Seat 4: matiko09 ($100 in chips) 
Seat 5: IHouseMusic ($120.70 in chips) 
Seat 6: vinniesmol ($250.60 in chips) 
Seat 7: mycka86 ($100 in chips) 
Seat 8: Venomous100% ($101.50 in chips) 
Seat 9: er13to ($104.23 in chips) 
mycka86: posts small blind $0.50
Venomous100%: posts big blind $1
*** HOLE CARDS ***
Dealt to matiko09 [As 2d]
er13to: folds 
LUTZ_11111: folds 
Priidix: folds 
matiko09: folds 
IHouseMusic: folds 
vinniesmol: folds 
mycka86: raises $1.75 to $2.75
Venomous100%: raises $6.25 to $9
mycka86: folds 
Uncalled bet ($6.25) returned to Venomous100%
Venomous100% collected $5.50 from pot
Venomous100%: doesn't show hand 
*** SUMMARY ***
Total pot $5.50 | Rake $0 
Seat 1: LUTZ_11111 folded before Flop (didn't bet)
Seat 2: Priidix folded before Flop (didn't bet)
Seat 4: matiko09 folded before Flop (didn't bet)
Seat 5: IHouseMusic folded before Flop (didn't bet)
Seat 6: vinniesmol (button) folded before Flop (didn't bet)
Seat 7: mycka86 (small blind) folded before Flop
Seat 8: Venomous100% (big blind) collected ($5.50)
Seat 9: er13to folded before Flop (didn't bet)





PokerStars Hand #148833334920:  Hold'em No Limit ($0.25/$0.50 USD) - 2016/02/15 11:15:40 CET [2016/02/15 5:15:40 ET]
Table 'Vesta II' 9-max Seat #6 is the button
Seat 1: Ahangama ($94.33 in chips) 
Seat 2: i L00K great ($50 in chips) 
Seat 3: matiko09 ($73.20 in chips) 
Seat 4: vlad11122007 ($49.65 in chips) 
Seat 5: dndngod ($73.90 in chips) 
Seat 6: pandalapa ($50 in chips) 
Seat 7: ruyingren ($26.54 in chips) 
Seat 8: Arystan ($132.28 in chips) 
Seat 9: Aoki42 ($83.47 in chips) 
ruyingren: posts small blind $0.25
Arystan: posts big blind $0.50
*** HOLE CARDS ***
Dealt to matiko09 [Jh 4h]
Aoki42: folds 
Ahangama: folds 
i L00K great: folds 
matiko09: folds 
vlad11122007: folds 
dndngod: folds 
pandalapa: raises $0.50 to $1
ruyingren: folds 
Arystan: calls $0.50
*** FLOP *** [Kc Ah 9s]
Arystan: bets $0.50
pandalapa: calls $0.50
*** TURN *** [Kc Ah 9s] [Js]
Arystan: checks 
pandalapa: checks 
*** RIVER *** [Kc Ah 9s Js] [6d]
Arystan: checks 
pandalapa: checks 
*** SHOW DOWN ***
Arystan: shows [3s 5c] (high card Ace)
pandalapa: shows [Kd 2d] (a pair of Kings)
pandalapa collected $3.10 from pot
*** SUMMARY ***
Total pot $3.25 | Rake $0.15 
Board [Kc Ah 9s Js 6d]
Seat 1: Ahangama folded before Flop (didn't bet)
Seat 2: i L00K great folded before Flop (didn't bet)
Seat 3: matiko09 folded before Flop (didn't bet)
Seat 4: vlad11122007 folded before Flop (didn't bet)
Seat 5: dndngod folded before Flop (didn't bet)
Seat 6: pandalapa (button) showed [Kd 2d] and won ($3.10) with a pair of Kings
Seat 7: ruyingren (small blind) folded before Flop
Seat 8: Arystan (big blind) showed [3s 5c] and lost with high card Ace
Seat 9: Aoki42 folded before Flop (didn't bet)





PokerStars Hand #148833337090:  Hold'em No Limit ($0.50/$1.00 USD) - 2016/02/15 11:15:45 CET [2016/02/15 5:15:45 ET]
Table 'Saldanha' 9-max Seat #3 is the button
Seat 1: mycka86 ($100 in chips) 
Seat 2: Congo Sam ($102.38 in chips) 
Seat 3: maxxmeister ($140.13 in chips) 
Seat 4: er13to ($110.84 in chips) 
Seat 5: matiko09 ($101.50 in chips) 
Seat 6: huffwag ($20.37 in chips) 
Seat 7: Venomous100% ($158.26 in chips) 
Seat 8: masaytoo ($131.19 in chips) 
Seat 9: SerAlGog ($111.66 in chips) 
er13to: posts small blind $0.50
matiko09: posts big blind $1
*** HOLE CARDS ***
Dealt to matiko09 [9c Kc]
huffwag: folds 
Venomous100%: folds 
masaytoo: folds 
SerAlGog: folds 
mycka86: folds 
Congo Sam: folds 
maxxmeister: folds 
er13to: folds 
Uncalled bet ($0.50) returned to matiko09
matiko09 collected $1 from pot
matiko09: doesn't show hand 
*** SUMMARY ***
Total pot $1 | Rake $0 
Seat 1: mycka86 folded before Flop (didn't bet)
Seat 2: Congo Sam folded before Flop (didn't bet)
Seat 3: maxxmeister (button) folded before Flop (didn't bet)
Seat 4: er13to (small blind) folded before Flop
Seat 5: matiko09 (big blind) collected ($1)
Seat 6: huffwag folded before Flop (didn't bet)
Seat 7: Venomous100% folded before Flop (didn't bet)
Seat 8: masaytoo folded before Flop (didn't bet)
Seat 9: SerAlGog folded before Flop (didn't bet)





PokerStars Hand #148833343259:  Hold'em No Limit ($0.50/$1.00 USD) - 2016/02/15 11:15:58 CET [2016/02/15 5:15:58 ET]
Table 'Nata II' 9-max Seat #2 is the button
Seat 1: Priidix ($100 in chips) 
Seat 2: qqcom ($146.78 in chips) 
Seat 3: g00000se ($120.45 in chips) 
Seat 4: gabi_igna ($100 in chips) 
Seat 5: AGoodFell4 ($46.21 in chips) 
Seat 7: er13to ($114.40 in chips) 
Seat 8: Igor DoUrden ($106.35 in chips) 
Seat 9: matiko09 ($100.37 in chips) 
g00000se: posts small blind $0.50
gabi_igna: posts big blind $1
AlKatrone: sits out 
*** HOLE CARDS ***
Dealt to matiko09 [7c Js]
AGoodFell4: folds 
er13to: folds 
Igor DoUrden: folds 
matiko09: folds 
Priidix: folds 
qqcom: raises $2 to $3
g00000se: folds 
gabi_igna: folds 
Uncalled bet ($2) returned to qqcom
qqcom collected $2.50 from pot
*** SUMMARY ***
Total pot $2.50 | Rake $0 
Seat 1: Priidix folded before Flop (didn't bet)
Seat 2: qqcom (button) collected ($2.50)
Seat 3: g00000se (small blind) folded before Flop
Seat 4: gabi_igna (big blind) folded before Flop
Seat 5: AGoodFell4 folded before Flop (didn't bet)
Seat 7: er13to folded before Flop (didn't bet)
Seat 8: Igor DoUrden folded before Flop (didn't bet)
Seat 9: matiko09 folded before Flop (didn't bet)





PokerStars Hand #148833343526:  Hold'em No Limit ($0.50/$1.00 USD) - 2016/02/15 11:15:58 CET [2016/02/15 5:15:58 ET]
Table 'Saldanha' 9-max Seat #4 is the button
Seat 1: mycka86 ($100 in chips) 
Seat 2: Congo Sam ($102.38 in chips) 
Seat 3: maxxmeister ($140.13 in chips) 
Seat 4: er13to ($110.34 in chips) 
Seat 5: matiko09 ($102 in chips) 
Seat 6: huffwag ($20.37 in chips) 
Seat 7: Venomous100% ($158.26 in chips) 
Seat 8: masaytoo ($131.19 in chips) 
Seat 9: SerAlGog ($111.66 in chips) 
matiko09: posts small blind $0.50
huffwag: posts big blind $1
*** HOLE CARDS ***
Dealt to matiko09 [Ks Ah]
Venomous100%: folds 
masaytoo: folds 
masaytoo leaves the table
SerAlGog: folds 
gabi_igna joins the table at seat #8 
mycka86: folds 
Congo Sam: folds 
maxxmeister: raises $2.50 to $3.50
er13to: folds 
matiko09: raises $7.50 to $11
huffwag: folds 
maxxmeister: folds 
Uncalled bet ($7.50) returned to matiko09
matiko09 collected $8 from pot
matiko09: doesn't show hand 
*** SUMMARY ***
Total pot $8 | Rake $0 
Seat 1: mycka86 folded before Flop (didn't bet)
Seat 2: Congo Sam folded before Flop (didn't bet)
Seat 3: maxxmeister folded before Flop
Seat 4: er13to (button) folded before Flop (didn't bet)
Seat 5: matiko09 (small blind) collected ($8)
Seat 6: huffwag (big blind) folded before Flop
Seat 7: Venomous100% folded before Flop (didn't bet)
Seat 8: masaytoo folded before Flop (didn't bet)
Seat 9: SerAlGog folded before Flop (didn't bet)





PokerStars Hand #148833346557:  Hold'em No Limit ($0.50/$1.00 USD) - 2016/02/15 11:16:05 CET [2016/02/15 5:16:05 ET]
Table 'Gemma II' 9-max Seat #8 is the button
Seat 1: Igor DoUrden ($172.44 in chips) 
Seat 3: Venomous100% ($161.51 in chips) 
Seat 4: mycka86 ($100 in chips) 
Seat 5: PokerSash201 ($75.67 in chips) 
Seat 6: IHouseMusic ($100 in chips) 
Seat 7: AlKatrone ($121.19 in chips) 
Seat 8: Priidix ($100.16 in chips) 
Seat 9: matiko09 ($104.05 in chips) 
matiko09: posts small blind $0.50
Igor DoUrden: posts big blind $1
gabi_igna: sits out 
*** HOLE CARDS ***
Dealt to matiko09 [9c 9s]
Venomous100%: folds 
mycka86: folds 
PokerSash201: folds 
IHouseMusic: folds 
AlKatrone: folds 
Priidix: folds 
matiko09: raises $1.50 to $2.50
Igor DoUrden: folds 
Uncalled bet ($1.50) returned to matiko09
matiko09 collected $2 from pot
matiko09: doesn't show hand 
*** SUMMARY ***
Total pot $2 | Rake $0 
Seat 1: Igor DoUrden (big blind) folded before Flop
Seat 3: Venomous100% folded before Flop (didn't bet)
Seat 4: mycka86 folded before Flop (didn't bet)
Seat 5: PokerSash201 folded before Flop (didn't bet)
Seat 6: IHouseMusic folded before Flop (didn't bet)
Seat 7: AlKatrone folded before Flop (didn't bet)
Seat 8: Priidix (button) folded before Flop (didn't bet)
Seat 9: matiko09 (small blind) collected ($2)





PokerStars Hand #148833349023:  Hold'em No Limit ($0.50/$1.00 USD) - 2016/02/15 11:16:10 CET [2016/02/15 5:16:10 ET]
Table 'Sekanina' 9-max Seat #7 is the button
Seat 1: LUTZ_11111 ($59.63 in chips) 
Seat 2: Priidix ($123.33 in chips) 
Seat 4: matiko09 ($100 in chips) 
Seat 5: IHouseMusic ($120.70 in chips) 
Seat 6: vinniesmol ($250.60 in chips) 
Seat 7: mycka86 ($100 in chips) 
Seat 8: Venomous100% ($104.25 in chips) 
Seat 9: er13to ($104.23 in chips) 
Venomous100%: posts small blind $0.50
er13to: posts big blind $1
*** HOLE CARDS ***
Dealt to matiko09 [Qh 8h]
LUTZ_11111: folds 
Priidix: folds 
matiko09: folds 
IHouseMusic: folds 
vinniesmol: raises $2 to $3
mycka86: folds 
Venomous100%: folds 
er13to: calls $2
*** FLOP *** [5c 4s 5d]
er13to: checks 
vinniesmol: bets $4
er13to: folds 
Uncalled bet ($4) returned to vinniesmol
vinniesmol collected $6.21 from pot
*** SUMMARY ***
Total pot $6.50 | Rake $0.29 
Board [5c 4s 5d]
Seat 1: LUTZ_11111 folded before Flop (didn't bet)
Seat 2: Priidix folded before Flop (didn't bet)
Seat 4: matiko09 folded before Flop (didn't bet)
Seat 5: IHouseMusic folded before Flop (didn't bet)
Seat 6: vinniesmol collected ($6.21)
Seat 7: mycka86 (button) folded before Flop (didn't bet)
Seat 8: Venomous100% (small blind) folded before Flop
Seat 9: er13to (big blind) folded on the Flop





PokerStars Hand #148833354085:  Hold'em No Limit ($0.50/$1.00 USD) - 2016/02/15 11:16:21 CET [2016/02/15 5:16:21 ET]
Table 'Corvus III' 9-max Seat #5 is the button
Seat 2: mzsportline ($137.40 in chips) 
Seat 3: VanDobeln ($244.80 in chips) 
Seat 4: goransyruvka ($88.70 in chips) 
Seat 5: koib88 ($468.74 in chips) 
Seat 6: Priidix ($158.78 in chips) 
Seat 7: matiko09 ($250 in chips) 
Seat 8: redacesfull ($247.28 in chips) 
Seat 9: er13to ($104.82 in chips) 
Priidix: posts small blind $0.50
matiko09: posts big blind $1
mzsportline: posts the ante $0.20
VanDobeln: posts the ante $0.20
goransyruvka: posts the ante $0.20
koib88: posts the ante $0.20
Priidix: posts the ante $0.20
matiko09: posts the ante $0.20
redacesfull: posts the ante $0.20
er13to: posts the ante $0.20
*** HOLE CARDS ***
Dealt to matiko09 [5h 5s]
redacesfull: folds 
er13to: folds 
mzsportline: folds 
VanDobeln: folds 
goransyruvka: folds 
koib88: calls $1
Priidix: folds 
matiko09: checks 
*** FLOP *** [Ah 4d 9d]
matiko09: checks 
koib88: bets $1
matiko09: folds 
Uncalled bet ($1) returned to koib88
koib88 collected $3.92 from pot
koib88: doesn't show hand 
*** SUMMARY ***
Total pot $4.10 | Rake $0.18 
Board [Ah 4d 9d]
Seat 2: mzsportline folded before Flop (didn't bet)
Seat 3: VanDobeln folded before Flop (didn't bet)
Seat 4: goransyruvka folded before Flop (didn't bet)
Seat 5: koib88 (button) collected ($3.92)
Seat 6: Priidix (small blind) folded before Flop
Seat 7: matiko09 (big blind) folded on the Flop
Seat 8: redacesfull folded before Flop (didn't bet)
Seat 9: er13to folded before Flop (didn't bet)





PokerStars Hand #148833360816:  Hold'em No Limit ($0.50/$1.00 USD) - 2016/02/15 11:16:35 CET [2016/02/15 5:16:35 ET]
Table 'Nata II' 9-max Seat #3 is the button
Seat 1: Priidix ($100 in chips) 
Seat 2: qqcom ($148.28 in chips) 
Seat 3: g00000se ($119.95 in chips) 
Seat 4: gabi_igna ($100 in chips) 
Seat 5: AGoodFell4 ($46.21 in chips) 
Seat 7: er13to ($114.40 in chips) 
Seat 8: Igor DoUrden ($106.35 in chips) 
Seat 9: matiko09 ($100.37 in chips) 
gabi_igna: posts small blind $0.50
AGoodFell4: posts big blind $1
AlKatrone: sits out 
*** HOLE CARDS ***
Dealt to matiko09 [2d Tc]
er13to: folds 
Igor DoUrden: folds 
matiko09: folds 
Priidix: folds 
qqcom: raises $2.50 to $3.50
g00000se: folds 
gabi_igna: folds 
AGoodFell4: raises $6.50 to $10
qqcom: calls $6.50
*** FLOP *** [Js Qc Td]
AGoodFell4: checks 
qqcom: bets $9.79
AGoodFell4: raises $26.42 to $36.21 and is all-in
qqcom: calls $26.42
*** TURN *** [Js Qc Td] [5c]
*** RIVER *** [Js Qc Td 5c] [3s]
*** SHOW DOWN ***
AGoodFell4: shows [Jc Jh] (three of a kind, Jacks)
qqcom: shows [Qs Kc] (a pair of Queens)
AGoodFell4 collected $90.12 from pot
*** SUMMARY ***
Total pot $92.92 | Rake $2.80 
Board [Js Qc Td 5c 3s]
Seat 1: Priidix folded before Flop (didn't bet)
Seat 2: qqcom showed [Qs Kc] and lost with a pair of Queens
Seat 3: g00000se (button) folded before Flop (didn't bet)
Seat 4: gabi_igna (small blind) folded before Flop
Seat 5: AGoodFell4 (big blind) showed [Jc Jh] and won ($90.12) with three of a kind, Jacks
Seat 7: er13to folded before Flop (didn't bet)
Seat 8: Igor DoUrden folded before Flop (didn't bet)
Seat 9: matiko09 folded before Flop (didn't bet)





PokerStars Hand #148833361218:  Hold'em No Limit (€0.50/€1.00 EUR) - 2016/02/15 11:16:36 CET [2016/02/15 5:16:36 ET]
Table 'Ganesa II' 9-max Seat #3 is the button
Seat 2: maxxmeister (€101.71 in chips) 
Seat 3: BuBu 0187 (€55.20 in chips) 
Seat 4: Sreshta222 (€119.52 in chips) 
Seat 5: vano7777 (€73.74 in chips) 
Seat 6: matiko09 (€123.58 in chips) 
Seat 7: er13to (€115 in chips) 
Seat 8: mycka86 (€104.50 in chips) 
Seat 9: Priidix (€104.71 in chips) 
Sreshta222: posts small blind €0.50
vano7777: posts big blind €1
*** HOLE CARDS ***
Dealt to matiko09 [2d 3s]
matiko09: folds 
er13to: folds 
mycka86: raises €2 to €3
Priidix: calls €3
maxxmeister: folds 
BuBu 0187: calls €3
Sreshta222: folds 
vano7777: folds 
*** FLOP *** [Js 9s 5h]
mycka86: bets €7.30
Priidix: calls €7.30
BuBu 0187: calls €7.30
*** TURN *** [Js 9s 5h] [5d]
mycka86: checks 
Priidix: checks 
BuBu 0187: bets €10
mycka86: folds 
Priidix: folds 
Uncalled bet (€10) returned to BuBu 0187
BuBu 0187 collected €30.94 from pot
BuBu 0187: doesn't show hand 
*** SUMMARY ***
Total pot €32.40 | Rake €1.46 
Board [Js 9s 5h 5d]
Seat 2: maxxmeister folded before Flop (didn't bet)
Seat 3: BuBu 0187 (button) collected (€30.94)
Seat 4: Sreshta222 (small blind) folded before Flop
Seat 5: vano7777 (big blind) folded before Flop
Seat 6: matiko09 folded before Flop (didn't bet)
Seat 7: er13to folded before Flop (didn't bet)
Seat 8: mycka86 folded on the Turn
Seat 9: Priidix folded on the Turn





PokerStars Hand #148833360998:  Hold'em No Limit ($0.50/$1.00 USD) - 2016/02/15 11:16:36 CET [2016/02/15 5:16:36 ET]
Table 'Gemma II' 9-max Seat #9 is the button
Seat 1: Igor DoUrden ($171.44 in chips) 
Seat 2: gabi_igna ($100 in chips) 
Seat 3: Venomous100% ($161.51 in chips) 
Seat 4: mycka86 ($100 in chips) 
Seat 5: PokerSash201 ($75.67 in chips) 
Seat 6: IHouseMusic ($100 in chips) 
Seat 7: AlKatrone ($121.19 in chips) 
Seat 8: Priidix ($100.16 in chips) 
Seat 9: matiko09 ($105.05 in chips) 
Igor DoUrden: posts small blind $0.50
gabi_igna: posts big blind $1
*** HOLE CARDS ***
Dealt to matiko09 [Ac 9h]
Venomous100%: folds 
mycka86: folds 
PokerSash201: folds 
IHouseMusic: folds 
AlKatrone: folds 
Priidix: folds 
matiko09: raises $1.27 to $2.27
Igor DoUrden: folds 
gabi_igna: calls $1.27
*** FLOP *** [9d Kc Kh]
gabi_igna: checks 
matiko09: bets $2.50
gabi_igna: calls $2.50
*** TURN *** [9d Kc Kh] [4s]
gabi_igna: checks 
matiko09: bets $4.98
gabi_igna: calls $4.98
*** RIVER *** [9d Kc Kh 4s] [6h]
gabi_igna: checks 
matiko09: checks 
*** SHOW DOWN ***
gabi_igna: shows [7h 7c] (two pair, Kings and Sevens)
matiko09: shows [Ac 9h] (two pair, Kings and Nines)
matiko09 collected $19.10 from pot
*** SUMMARY ***
Total pot $20 | Rake $0.90 
Board [9d Kc Kh 4s 6h]
Seat 1: Igor DoUrden (small blind) folded before Flop
Seat 2: gabi_igna (big blind) showed [7h 7c] and lost with two pair, Kings and Sevens
Seat 3: Venomous100% folded before Flop (didn't bet)
Seat 4: mycka86 folded before Flop (didn't bet)
Seat 5: PokerSash201 folded before Flop (didn't bet)
Seat 6: IHouseMusic folded before Flop (didn't bet)
Seat 7: AlKatrone folded before Flop (didn't bet)
Seat 8: Priidix folded before Flop (didn't bet)
Seat 9: matiko09 (button) showed [Ac 9h] and won ($19.10) with two pair, Kings and Nines





PokerStars Hand #148833361754:  Hold'em No Limit ($0.50/$1.00 USD) - 2016/02/15 11:16:37 CET [2016/02/15 5:16:37 ET]
Table 'Octans II' 9-max Seat #9 is the button
Seat 1: maxxmeister ($100 in chips) 
Seat 2: matiko09 ($247.29 in chips) 
Seat 3: Aalleekks ($100 in chips) 
Seat 4: Venomous100% ($161.80 in chips) 
Seat 5: AlKatrone ($119.16 in chips) 
Seat 6: er13to ($100 in chips) 
Seat 7: traficblues ($43.45 in chips) 
Seat 8: IHouseMusic ($144.93 in chips) 
Seat 9: mycka86 ($100 in chips) 
maxxmeister: posts small blind $0.50
matiko09: posts big blind $1
*** HOLE CARDS ***
Dealt to matiko09 [9d 7s]
Aalleekks: folds 
Venomous100%: folds 
AlKatrone: folds 
er13to: folds 
traficblues: calls $1
IHouseMusic: folds 
mycka86: folds 
maxxmeister: folds 
matiko09: checks 
*** FLOP *** [5c 6h 5d]
matiko09: bets $1
traficblues: calls $1
*** TURN *** [5c 6h 5d] [Kh]
matiko09: checks 
traficblues: checks 
*** RIVER *** [5c 6h 5d Kh] [Jh]
matiko09: checks 
traficblues: checks 
*** SHOW DOWN ***
matiko09: shows [9d 7s] (a pair of Fives)
traficblues: shows [Ts Qs] (a pair of Fives - King+Queen kicker)
traficblues collected $4.30 from pot
*** SUMMARY ***
Total pot $4.50 | Rake $0.20 
Board [5c 6h 5d Kh Jh]
Seat 1: maxxmeister (small blind) folded before Flop
Seat 2: matiko09 (big blind) showed [9d 7s] and lost with a pair of Fives
Seat 3: Aalleekks folded before Flop (didn't bet)
Seat 4: Venomous100% folded before Flop (didn't bet)
Seat 5: AlKatrone folded before Flop (didn't bet)
Seat 6: er13to folded before Flop (didn't bet)
Seat 7: traficblues showed [Ts Qs] and won ($4.30) with a pair of Fives
Seat 8: IHouseMusic folded before Flop (didn't bet)
Seat 9: mycka86 (button) folded before Flop (didn't bet)





PokerStars Hand #148833362376:  Hold'em No Limit ($0.50/$1.00 USD) - 2016/02/15 11:16:38 CET [2016/02/15 5:16:38 ET]
Table 'Sekanina' 9-max Seat #8 is the button
Seat 1: LUTZ_11111 ($59.63 in chips) 
Seat 2: Priidix ($123.33 in chips) 
Seat 4: matiko09 ($100 in chips) 
Seat 5: IHouseMusic ($120.70 in chips) 
Seat 6: vinniesmol ($253.81 in chips) 
Seat 7: mycka86 ($100 in chips) 
Seat 8: Venomous100% ($103.75 in chips) 
Seat 9: er13to ($101.23 in chips) 
er13to: posts small blind $0.50
LUTZ_11111: posts big blind $1
*** HOLE CARDS ***
Dealt to matiko09 [7s Ks]
Priidix: folds 
matiko09: folds 
IHouseMusic: raises $2 to $3
vinniesmol: calls $3
mycka86: folds 
Venomous100%: folds 
er13to: folds 
LUTZ_11111: calls $2
*** FLOP *** [Jc 2s Jd]
LUTZ_11111: checks 
IHouseMusic: checks 
vinniesmol: checks 
*** TURN *** [Jc 2s Jd] [Ts]
LUTZ_11111: checks 
IHouseMusic: bets $6.36
vinniesmol: folds 
LUTZ_11111: folds 
Uncalled bet ($6.36) returned to IHouseMusic
IHouseMusic collected $9.07 from pot
IHouseMusic: doesn't show hand 
*** SUMMARY ***
Total pot $9.50 | Rake $0.43 
Board [Jc 2s Jd Ts]
Seat 1: LUTZ_11111 (big blind) folded on the Turn
Seat 2: Priidix folded before Flop (didn't bet)
Seat 4: matiko09 folded before Flop (didn't bet)
Seat 5: IHouseMusic collected ($9.07)
Seat 6: vinniesmol folded on the Turn
Seat 7: mycka86 folded before Flop (didn't bet)
Seat 8: Venomous100% (button) folded before Flop (didn't bet)
Seat 9: er13to (small blind) folded before Flop





PokerStars Hand #148833365323:  Hold'em No Limit ($0.25/$0.50 USD) - 2016/02/15 11:16:45 CET [2016/02/15 5:16:45 ET]
Table 'Vesta II' 9-max Seat #7 is the button
Seat 1: Ahangama ($94.33 in chips) 
Seat 2: i L00K great ($50 in chips) 
Seat 3: matiko09 ($73.20 in chips) 
Seat 4: vlad11122007 ($49.65 in chips) 
Seat 5: dndngod ($73.90 in chips) 
Seat 6: pandalapa ($51.60 in chips) 
Seat 7: ruyingren ($26.29 in chips) 
Seat 8: Arystan ($130.78 in chips) 
Seat 9: Aoki42 ($83.47 in chips) 
Arystan: posts small blind $0.25
Aoki42: posts big blind $0.50
*** HOLE CARDS ***
Dealt to matiko09 [Qc 9s]
Ahangama: folds 
i L00K great: folds 
matiko09: folds 
vlad11122007: folds 
dndngod: folds 
pandalapa: raises $0.75 to $1.25
ruyingren: calls $1.25
Arystan: calls $1
Aoki42: folds 
*** FLOP *** [9h 5h 7s]
Arystan: checks 
pandalapa: checks 
ruyingren: checks 
*** TURN *** [9h 5h 7s] [3h]
Arystan: bets $2.03
pandalapa: folds 
ruyingren: folds 
Uncalled bet ($2.03) returned to Arystan
Arystan collected $4.06 from pot
Arystan: doesn't show hand 
*** SUMMARY ***
Total pot $4.25 | Rake $0.19 
Board [9h 5h 7s 3h]
Seat 1: Ahangama folded before Flop (didn't bet)
Seat 2: i L00K great folded before Flop (didn't bet)
Seat 3: matiko09 folded before Flop (didn't bet)
Seat 4: vlad11122007 folded before Flop (didn't bet)
Seat 5: dndngod folded before Flop (didn't bet)
Seat 6: pandalapa folded on the Turn
Seat 7: ruyingren (button) folded on the Turn
Seat 8: Arystan (small blind) collected ($4.06)
Seat 9: Aoki42 (big blind) folded before Flop





PokerStars Hand #148833368042:  Hold'em No Limit ($0.50/$1.00 USD) - 2016/02/15 11:16:50 CET [2016/02/15 5:16:50 ET]
Table 'Saldanha' 9-max Seat #5 is the button
Seat 1: mycka86 ($100 in chips) 
Seat 2: Congo Sam ($102.38 in chips) 
Seat 3: maxxmeister ($136.63 in chips) 
Seat 4: er13to ($110.34 in chips) 
Seat 5: matiko09 ($106.50 in chips) 
Seat 6: huffwag ($19.37 in chips) 
Seat 7: Venomous100% ($158.26 in chips) 
Seat 9: SerAlGog ($111.66 in chips) 
huffwag: posts small blind $0.50
Venomous100%: posts big blind $1
gabi_igna: sits out 
*** HOLE CARDS ***
Dealt to matiko09 [8d 5d]
SerAlGog: folds 
mycka86: folds 
Congo Sam: folds 
maxxmeister: folds 
er13to: folds 
matiko09: folds 
huffwag: folds 
Uncalled bet ($0.50) returned to Venomous100%
Venomous100% collected $1 from pot
Venomous100%: doesn't show hand 
*** SUMMARY ***
Total pot $1 | Rake $0 
Seat 1: mycka86 folded before Flop (didn't bet)
Seat 2: Congo Sam folded before Flop (didn't bet)
Seat 3: maxxmeister folded before Flop (didn't bet)
Seat 4: er13to folded before Flop (didn't bet)
Seat 5: matiko09 (button) folded before Flop (didn't bet)
Seat 6: huffwag (small blind) folded before Flop
Seat 7: Venomous100% (big blind) collected ($1)
Seat 9: SerAlGog folded before Flop (didn't bet)





PokerStars Hand #148833368649:  Hold'em No Limit ($0.50/$1.00 USD) - 2016/02/15 11:16:52 CET [2016/02/15 5:16:52 ET]
Table 'Anteros' 9-max Seat #3 is the button
Seat 1: redacesfull ($102.43 in chips) 
Seat 2: IHouseMusic ($105.24 in chips) 
Seat 3: er13to ($100.74 in chips) 
Seat 4: misherei ($197.01 in chips) 
Seat 5: Holm1991 ($50.36 in chips) 
Seat 6: SerAlGog ($138.31 in chips) 
Seat 7: Zoubou1983 ($170.97 in chips) 
Seat 8: matiko09 ($100 in chips) 
Seat 9: mycka86 ($100 in chips) 
misherei: posts small blind $0.50
Holm1991: posts big blind $1
*** HOLE CARDS ***
Dealt to matiko09 [9d 7d]
SerAlGog: folds 
Zoubou1983: folds 
matiko09: folds 
mycka86: folds 
redacesfull: raises $1.12 to $2.12
IHouseMusic: raises $5.88 to $8
er13to: folds 
misherei: folds 
Holm1991: folds 
redacesfull: folds 
Uncalled bet ($5.88) returned to IHouseMusic
IHouseMusic collected $5.74 from pot
IHouseMusic: doesn't show hand 
*** SUMMARY ***
Total pot $5.74 | Rake $0 
Seat 1: redacesfull folded before Flop
Seat 2: IHouseMusic collected ($5.74)
Seat 3: er13to (button) folded before Flop (didn't bet)
Seat 4: misherei (small blind) folded before Flop
Seat 5: Holm1991 (big blind) folded before Flop
Seat 6: SerAlGog folded before Flop (didn't bet)
Seat 7: Zoubou1983 folded before Flop (didn't bet)
Seat 8: matiko09 folded before Flop (didn't bet)
Seat 9: mycka86 folded before Flop (didn't bet)





PokerStars Hand #148833370655:  Hold'em No Limit ($0.25/$0.50 USD) - 2016/02/15 11:16:56 CET [2016/02/15 5:16:56 ET]
Table 'Laertes II' 9-max Seat #2 is the button
Seat 1: etny99 ($51.14 in chips) 
Seat 2: beluccix ($24.21 in chips) 
Seat 4: rgar93 ($42.48 in chips) 
Seat 7: Vedpapa ($63.28 in chips) 
Seat 8: Trent444 ($41.68 in chips) 
Seat 9: matiko09 ($50.85 in chips) 
valfan911 will be allowed to play after the button
rgar93: posts small blind $0.25
vlad11122007: is sitting out 
vlad11122007 leaves the table
yats87: is sitting out 
Vedpapa: posts big blind $0.50
*** HOLE CARDS ***
Dealt to matiko09 [2h 4d]
yats87 leaves the table
Trent444: calls $0.50
matiko09: folds 
ZonTTT joins the table at seat #6 
etny99: folds 
beluccix: folds 
rgar93: folds 
Serhent joins the table at seat #5 
Vedpapa: checks 
*** FLOP *** [As 6c 5c]
Vedpapa: bets $0.59
Trent444: calls $0.59
*** TURN *** [As 6c 5c] [8s]
Vedpapa: checks 
Trent444: bets $3
Vedpapa: calls $3
*** RIVER *** [As 6c 5c 8s] [9h]
Vedpapa: checks 
Trent444: bets $6
Vedpapa: folds 
Uncalled bet ($6) returned to Trent444
Trent444 collected $8.05 from pot
Trent444: doesn't show hand 
*** SUMMARY ***
Total pot $8.43 | Rake $0.38 
Board [As 6c 5c 8s 9h]
Seat 1: etny99 folded before Flop (didn't bet)
Seat 2: beluccix (button) folded before Flop (didn't bet)
Seat 4: rgar93 (small blind) folded before Flop
Seat 7: Vedpapa (big blind) folded on the River
Seat 8: Trent444 collected ($8.05)
Seat 9: matiko09 folded before Flop (didn't bet)





PokerStars Hand #148833377165:  Hold'em No Limit ($0.50/$1.00 USD) - 2016/02/15 11:17:10 CET [2016/02/15 5:17:10 ET]
Table 'Corvus III' 9-max Seat #6 is the button
Seat 2: mzsportline ($137.20 in chips) 
Seat 3: VanDobeln ($244.60 in chips) 
Seat 4: goransyruvka ($88.50 in chips) 
Seat 5: koib88 ($471.46 in chips) 
Seat 6: Priidix ($158.08 in chips) 
Seat 7: matiko09 ($248.80 in chips) 
Seat 8: redacesfull ($247.08 in chips) 
Seat 9: er13to ($104.62 in chips) 
matiko09: posts small blind $0.50
redacesfull: posts big blind $1
mzsportline: posts the ante $0.20
VanDobeln: posts the ante $0.20
goransyruvka: posts the ante $0.20
koib88: posts the ante $0.20
Priidix: posts the ante $0.20
matiko09: posts the ante $0.20
redacesfull: posts the ante $0.20
er13to: posts the ante $0.20
*** HOLE CARDS ***
Dealt to matiko09 [5d 7c]
er13to: folds 
mzsportline: folds 
VanDobeln: raises $2 to $3
goransyruvka: calls $3
koib88: calls $3
Priidix: folds 
matiko09: folds 
redacesfull: folds 
*** FLOP *** [8d 4h Qh]
VanDobeln: checks 
goransyruvka: checks 
koib88: bets $6
VanDobeln: folds 
goransyruvka: calls $6
*** TURN *** [8d 4h Qh] [6s]
goransyruvka: checks 
koib88: bets $12
goransyruvka: calls $12
*** RIVER *** [8d 4h Qh 6s] [8c]
goransyruvka: bets $45.94
koib88: folds 
Uncalled bet ($45.94) returned to goransyruvka
goransyruvka collected $45.94 from pot
goransyruvka: doesn't show hand 
*** SUMMARY ***
Total pot $48.10 | Rake $2.16 
Board [8d 4h Qh 6s 8c]
Seat 2: mzsportline folded before Flop (didn't bet)
Seat 3: VanDobeln folded on the Flop
Seat 4: goransyruvka collected ($45.94)
Seat 5: koib88 folded on the River
Seat 6: Priidix (button) folded before Flop (didn't bet)
Seat 7: matiko09 (small blind) folded before Flop
Seat 8: redacesfull (big blind) folded before Flop
Seat 9: er13to folded before Flop (didn't bet)





PokerStars Hand #148833379838:  Hold'em No Limit ($0.50/$1.00 USD) - 2016/02/15 11:17:16 CET [2016/02/15 5:17:16 ET]
Table 'Praecipua' 9-max Seat #8 is the button
Seat 1: er13to ($135.43 in chips) 
Seat 2: matiko09 ($101.50 in chips) 
Seat 3: Venomous100% ($108.82 in chips) 
Seat 5: huffwag ($160.99 in chips) 
Seat 6: mycka86 ($111.50 in chips) 
Seat 7: maxxmeister ($144.73 in chips) 
Seat 8: Ellis Ng ($39.92 in chips) 
Seat 9: AlKatrone ($102.40 in chips) 
AlKatrone: posts small blind $0.50
er13to: posts big blind $1
gabi_igna: sits out 
*** HOLE CARDS ***
Dealt to matiko09 [9c Js]
matiko09: folds 
Venomous100%: folds 
huffwag: folds 
mycka86: raises $1.50 to $2.50
maxxmeister: folds 
Ellis Ng: folds 
AlKatrone: folds 
er13to: folds 
Uncalled bet ($1.50) returned to mycka86
mycka86 collected $2.50 from pot
*** SUMMARY ***
Total pot $2.50 | Rake $0 
Seat 1: er13to (big blind) folded before Flop
Seat 2: matiko09 folded before Flop (didn't bet)
Seat 3: Venomous100% folded before Flop (didn't bet)
Seat 5: huffwag folded before Flop (didn't bet)
Seat 6: mycka86 collected ($2.50)
Seat 7: maxxmeister folded before Flop (didn't bet)
Seat 8: Ellis Ng (button) folded before Flop (didn't bet)
Seat 9: AlKatrone (small blind) folded before Flop





PokerStars Hand #148833380690:  Hold'em No Limit ($0.50/$1.00 USD) - 2016/02/15 11:17:18 CET [2016/02/15 5:17:18 ET]
Table 'Saldanha' 9-max Seat #6 is the button
Seat 1: mycka86 ($100 in chips) 
Seat 2: Congo Sam ($102.38 in chips) 
Seat 3: maxxmeister ($136.63 in chips) 
Seat 4: er13to ($110.34 in chips) 
Seat 5: matiko09 ($106.50 in chips) 
Seat 6: huffwag ($18.87 in chips) 
Seat 7: Venomous100% ($158.76 in chips) 
Seat 8: gabi_igna ($100 in chips) 
Seat 9: SerAlGog ($111.66 in chips) 
Venomous100%: posts small blind $0.50
gabi_igna: posts big blind $1
*** HOLE CARDS ***
Dealt to matiko09 [Ac 8s]
SerAlGog: folds 
mycka86: folds 
Congo Sam: folds 
maxxmeister: folds 
er13to: folds 
matiko09: folds 
huffwag: folds 
Venomous100%: raises $2 to $3
gabi_igna: folds 
Uncalled bet ($2) returned to Venomous100%
Venomous100% collected $2 from pot
Venomous100%: doesn't show hand 
*** SUMMARY ***
Total pot $2 | Rake $0 
Seat 1: mycka86 folded before Flop (didn't bet)
Seat 2: Congo Sam folded before Flop (didn't bet)
Seat 3: maxxmeister folded before Flop (didn't bet)
Seat 4: er13to folded before Flop (didn't bet)
Seat 5: matiko09 folded before Flop (didn't bet)
Seat 6: huffwag (button) folded before Flop (didn't bet)
Seat 7: Venomous100% (small blind) collected ($2)
Seat 8: gabi_igna (big blind) folded before Flop
Seat 9: SerAlGog folded before Flop (didn't bet)





PokerStars Hand #148833382663:  Hold'em No Limit ($0.50/$1.00 USD) - 2016/02/15 11:17:22 CET [2016/02/15 5:17:22 ET]
Table 'Sekanina' 9-max Seat #9 is the button
Seat 1: LUTZ_11111 ($56.63 in chips) 
Seat 2: Priidix ($123.33 in chips) 
Seat 4: matiko09 ($100 in chips) 
Seat 5: IHouseMusic ($126.77 in chips) 
Seat 6: vinniesmol ($250.81 in chips) 
Seat 7: mycka86 ($100 in chips) 
Seat 8: Venomous100% ($103.75 in chips) 
Seat 9: er13to ($100.73 in chips) 
LUTZ_11111: posts small blind $0.50
Priidix: posts big blind $1
*** HOLE CARDS ***
Dealt to matiko09 [Kh Ah]
matiko09: raises $2 to $3
IHouseMusic: folds 
vinniesmol: folds 
mycka86: calls $3
Venomous100%: folds 
er13to: folds 
LUTZ_11111: folds 
Priidix: folds 
*** FLOP *** [4h 5s Kd]
matiko09: bets $4.65
Igor DoUrden leaves the table
mycka86: calls $4.65
*** TURN *** [4h 5s Kd] [4s]
matiko09: bets $10
mycka86: calls $10
*** RIVER *** [4h 5s Kd 4s] [Jc]
matiko09: bets $19
mycka86: calls $19
*** SHOW DOWN ***
matiko09: shows [Kh Ah] (two pair, Kings and Fours)
mycka86: shows [Ks Js] (two pair, Kings and Jacks)
gabi_igna joins the table at seat #3 
mycka86 collected $72 from pot
*** SUMMARY ***
Total pot $74.80 | Rake $2.80 
Board [4h 5s Kd 4s Jc]
Seat 1: LUTZ_11111 (small blind) folded before Flop
Seat 2: Priidix (big blind) folded before Flop
Seat 4: matiko09 showed [Kh Ah] and lost with two pair, Kings and Fours
Seat 5: IHouseMusic folded before Flop (didn't bet)
Seat 6: vinniesmol folded before Flop (didn't bet)
Seat 7: mycka86 showed [Ks Js] and won ($72) with two pair, Kings and Jacks
Seat 8: Venomous100% folded before Flop (didn't bet)
Seat 9: er13to (button) folded before Flop (didn't bet)





PokerStars Hand #148833384734:  Hold'em No Limit ($0.50/$1.00 USD) - 2016/02/15 11:17:26 CET [2016/02/15 5:17:26 ET]
Table 'Ristenpart' 9-max Seat #6 is the button
Seat 1: vano7777 ($52 in chips) 
Seat 2: IHouseMusic ($117.33 in chips) 
Seat 3: RYUJI07 ($21.44 in chips) 
Seat 4: miyashin ($104.42 in chips) 
Seat 5: lingyyang ($48.50 in chips) 
Seat 6: matiko09 ($100 in chips) 
Seat 7: Aalleekks ($100 in chips) 
Seat 8: gwwsb ($78.46 in chips) 
Seat 9: Igor DoUrden ($100 in chips) 
Aalleekks: posts small blind $0.50
gwwsb: posts big blind $1
*** HOLE CARDS ***
Dealt to matiko09 [Tc 8c]
Igor DoUrden: folds 
vano7777: raises $1 to $2
IHouseMusic: folds 
RYUJI07: folds 
miyashin: folds 
lingyyang: raises $5.50 to $7.50
matiko09: folds 
Aalleekks: folds 
gwwsb: folds 
vano7777: folds 
Uncalled bet ($5.50) returned to lingyyang
lingyyang collected $5.50 from pot
*** SUMMARY ***
Total pot $5.50 | Rake $0 
Seat 1: vano7777 folded before Flop
Seat 2: IHouseMusic folded before Flop (didn't bet)
Seat 3: RYUJI07 folded before Flop (didn't bet)
Seat 4: miyashin folded before Flop (didn't bet)
Seat 5: lingyyang collected ($5.50)
Seat 6: matiko09 (button) folded before Flop (didn't bet)
Seat 7: Aalleekks (small blind) folded before Flop
Seat 8: gwwsb (big blind) folded before Flop
Seat 9: Igor DoUrden folded before Flop (didn't bet)





PokerStars Hand #148833385322:  Hold'em No Limit ($0.50/$1.00 USD) - 2016/02/15 11:17:27 CET [2016/02/15 5:17:27 ET]
Table 'Octans II' 9-max Seat #1 is the button
Seat 1: maxxmeister ($100 in chips) 
Seat 2: matiko09 ($245.29 in chips) 
Seat 4: Venomous100% ($161.80 in chips) 
Seat 5: AlKatrone ($119.16 in chips) 
Seat 6: er13to ($100 in chips) 
Seat 7: traficblues ($45.75 in chips) 
Seat 8: IHouseMusic ($144.93 in chips) 
Seat 9: mycka86 ($100 in chips) 
matiko09: posts small blind $0.50
Aalleekks: is sitting out 
Venomous100%: posts big blind $1
*** HOLE CARDS ***
Dealt to matiko09 [8s 2c]
AlKatrone: folds 
er13to: folds 
traficblues: folds 
IHouseMusic: folds 
mycka86: folds 
maxxmeister: folds 
matiko09: folds 
Uncalled bet ($0.50) returned to Venomous100%
Venomous100% collected $1 from pot
Venomous100%: doesn't show hand 
*** SUMMARY ***
Total pot $1 | Rake $0 
Seat 1: maxxmeister (button) folded before Flop (didn't bet)
Seat 2: matiko09 (small blind) folded before Flop
Seat 4: Venomous100% (big blind) collected ($1)
Seat 5: AlKatrone folded before Flop (didn't bet)
Seat 6: er13to folded before Flop (didn't bet)
Seat 7: traficblues folded before Flop (didn't bet)
Seat 8: IHouseMusic folded before Flop (didn't bet)
Seat 9: mycka86 folded before Flop (didn't bet)





PokerStars Hand #148833386077:  Hold'em No Limit ($0.50/$1.00 USD) - 2016/02/15 11:17:29 CET [2016/02/15 5:17:29 ET]
Table 'Gemma II' 9-max Seat #1 is the button
Seat 1: Igor DoUrden ($170.94 in chips) 
Seat 2: gabi_igna ($100 in chips) 
Seat 3: Venomous100% ($161.51 in chips) 
Seat 4: mycka86 ($100 in chips) 
Seat 5: PokerSash201 ($75.67 in chips) 
Seat 6: IHouseMusic ($100 in chips) 
Seat 7: AlKatrone ($121.19 in chips) 
Seat 8: Priidix ($100.16 in chips) 
Seat 9: matiko09 ($114.40 in chips) 
gabi_igna: posts small blind $0.50
Venomous100%: posts big blind $1
*** HOLE CARDS ***
Dealt to matiko09 [Jh Js]
mycka86: folds 
PokerSash201: folds 
IHouseMusic: folds 
AlKatrone: folds 
Priidix: folds 
matiko09: raises $1.50 to $2.50
Igor DoUrden: folds 
gabi_igna: folds 
Venomous100%: folds 
Uncalled bet ($1.50) returned to matiko09
matiko09 collected $2.50 from pot
matiko09: doesn't show hand 
*** SUMMARY ***
Total pot $2.50 | Rake $0 
Seat 1: Igor DoUrden (button) folded before Flop (didn't bet)
Seat 2: gabi_igna (small blind) folded before Flop
Seat 3: Venomous100% (big blind) folded before Flop
Seat 4: mycka86 folded before Flop (didn't bet)
Seat 5: PokerSash201 folded before Flop (didn't bet)
Seat 6: IHouseMusic folded before Flop (didn't bet)
Seat 7: AlKatrone folded before Flop (didn't bet)
Seat 8: Priidix folded before Flop (didn't bet)
Seat 9: matiko09 collected ($2.50)





PokerStars Hand #148833387072:  Hold'em No Limit ($0.50/$1.00 USD) - 2016/02/15 11:17:31 CET [2016/02/15 5:17:31 ET]
Table 'Anteros' 9-max Seat #4 is the button
Seat 1: redacesfull ($100.31 in chips) 
Seat 2: IHouseMusic ($108.86 in chips) 
Seat 3: er13to ($100.74 in chips) 
Seat 4: misherei ($196.51 in chips) 
Seat 5: Holm1991 ($49.36 in chips) 
Seat 7: Zoubou1983 ($170.97 in chips) 
Seat 8: matiko09 ($100 in chips) 
Seat 9: mycka86 ($100 in chips) 
Holm1991: posts small blind $0.50
SerAlGog: is sitting out 
Zoubou1983: posts big blind $1
*** HOLE CARDS ***
Dealt to matiko09 [8s 2s]
matiko09: folds 
mycka86: folds 
redacesfull: folds 
IHouseMusic: folds 
er13to: raises $2 to $3
misherei: calls $3
Holm1991: calls $2.50
Zoubou1983: calls $2
*** FLOP *** [6d 7h 3c]
Holm1991: checks 
Zoubou1983: checks 
er13to: bets $9.50
misherei: folds 
Holm1991: folds 
Zoubou1983: folds 
Uncalled bet ($9.50) returned to er13to
er13to collected $11.46 from pot
*** SUMMARY ***
Total pot $12 | Rake $0.54 
Board [6d 7h 3c]
Seat 1: redacesfull folded before Flop (didn't bet)
Seat 2: IHouseMusic folded before Flop (didn't bet)
Seat 3: er13to collected ($11.46)
Seat 4: misherei (button) folded on the Flop
Seat 5: Holm1991 (small blind) folded on the Flop
Seat 7: Zoubou1983 (big blind) folded on the Flop
Seat 8: matiko09 folded before Flop (didn't bet)
Seat 9: mycka86 folded before Flop (didn't bet)





PokerStars Hand #148833390073:  Hold'em No Limit ($0.50/$1.00 USD) - 2016/02/15 11:17:38 CET [2016/02/15 5:17:38 ET]
Table 'Saldanha' 9-max Seat #7 is the button
Seat 1: mycka86 ($100 in chips) 
Seat 2: Congo Sam ($102.38 in chips) 
Seat 3: maxxmeister ($136.63 in chips) 
Seat 4: er13to ($110.34 in chips) 
Seat 5: matiko09 ($106.50 in chips) 
Seat 6: huffwag ($18.87 in chips) 
Seat 7: Venomous100% ($159.76 in chips) 
Seat 8: gabi_igna ($100 in chips) 
gabi_igna: posts small blind $0.50
SerAlGog: is sitting out 
mycka86: posts big blind $1
*** HOLE CARDS ***
Dealt to matiko09 [Jh 9d]
Congo Sam: folds 
maxxmeister: folds 
er13to: folds 
matiko09: folds 
huffwag: raises $2 to $3
Venomous100%: folds 
gabi_igna: raises $6 to $9
mycka86: folds 
huffwag: calls $6
*** FLOP *** [8c Qc Kh]
gabi_igna: checks 
huffwag: checks 
*** TURN *** [8c Qc Kh] [Kd]
gabi_igna: bets $12.09
huffwag: folds 
Uncalled bet ($12.09) returned to gabi_igna
gabi_igna collected $18.14 from pot
gabi_igna: doesn't show hand 
*** SUMMARY ***
Total pot $19 | Rake $0.86 
Board [8c Qc Kh Kd]
Seat 1: mycka86 (big blind) folded before Flop
Seat 2: Congo Sam folded before Flop (didn't bet)
Seat 3: maxxmeister folded before Flop (didn't bet)
Seat 4: er13to folded before Flop (didn't bet)
Seat 5: matiko09 folded before Flop (didn't bet)
Seat 6: huffwag folded on the Turn
Seat 7: Venomous100% (button) folded before Flop (didn't bet)
Seat 8: gabi_igna (small blind) collected ($18.14)





PokerStars Hand #148833393293:  Hold'em No Limit (€0.50/€1.00 EUR) - 2016/02/15 11:17:44 CET [2016/02/15 5:17:44 ET]
Table 'Ganesa II' 9-max Seat #4 is the button
Seat 2: maxxmeister (€101.71 in chips) 
Seat 3: BuBu 0187 (€75.84 in chips) 
Seat 4: Sreshta222 (€119.02 in chips) 
Seat 5: vano7777 (€72.74 in chips) 
Seat 6: matiko09 (€123.58 in chips) 
Seat 7: er13to (€115 in chips) 
Seat 8: mycka86 (€100 in chips) 
Seat 9: Priidix (€100 in chips) 
vano7777: posts small blind €0.50
matiko09: posts big blind €1
*** HOLE CARDS ***
Dealt to matiko09 [Ac 4s]
er13to: folds 
mycka86: folds 
Priidix: folds 
maxxmeister: raises €2 to €3
BuBu 0187 has timed out
BuBu 0187: folds 
Sreshta222: folds 
vano7777: folds 
matiko09: folds 
Uncalled bet (€2) returned to maxxmeister
maxxmeister collected €2.50 from pot
maxxmeister: doesn't show hand 
*** SUMMARY ***
Total pot €2.50 | Rake €0 
Seat 2: maxxmeister collected (€2.50)
Seat 3: BuBu 0187 folded before Flop (didn't bet)
Seat 4: Sreshta222 (button) folded before Flop (didn't bet)
Seat 5: vano7777 (small blind) folded before Flop
Seat 6: matiko09 (big blind) folded before Flop
Seat 7: er13to folded before Flop (didn't bet)
Seat 8: mycka86 folded before Flop (didn't bet)
Seat 9: Priidix folded before Flop (didn't bet)





PokerStars Hand #148833394330:  Hold'em No Limit ($0.50/$1.00 USD) - 2016/02/15 11:17:47 CET [2016/02/15 5:17:47 ET]
Table 'Octans II' 9-max Seat #2 is the button
Seat 1: maxxmeister ($100 in chips) 
Seat 2: matiko09 ($244.79 in chips) 
Seat 4: Venomous100% ($162.30 in chips) 
Seat 5: AlKatrone ($119.16 in chips) 
Seat 6: er13to ($100 in chips) 
Seat 7: traficblues ($45.75 in chips) 
Seat 8: IHouseMusic ($144.93 in chips) 
Seat 9: mycka86 ($100 in chips) 
Aalleekks will be allowed to play after the button
Venomous100%: posts small blind $0.50
AlKatrone: posts big blind $1
*** HOLE CARDS ***
Dealt to matiko09 [9c Td]
er13to: folds 
traficblues: calls $1
IHouseMusic: folds 
mycka86: folds 
maxxmeister: calls $1
matiko09: folds 
Venomous100%: folds 
AlKatrone: raises $4 to $5
traficblues: folds 
maxxmeister: folds 
Uncalled bet ($4) returned to AlKatrone
AlKatrone collected $3.50 from pot
AlKatrone: doesn't show hand 
*** SUMMARY ***
Total pot $3.50 | Rake $0 
Seat 1: maxxmeister folded before Flop
Seat 2: matiko09 (button) folded before Flop (didn't bet)
Seat 4: Venomous100% (small blind) folded before Flop
Seat 5: AlKatrone (big blind) collected ($3.50)
Seat 6: er13to folded before Flop (didn't bet)
Seat 7: traficblues folded before Flop
Seat 8: IHouseMusic folded before Flop (didn't bet)
Seat 9: mycka86 folded before Flop (didn't bet)





PokerStars Hand #148833395322:  Hold'em No Limit ($0.50/$1.00 USD) - 2016/02/15 11:17:49 CET [2016/02/15 5:17:49 ET]
Table 'Nata II' 9-max Seat #4 is the button
Seat 1: Priidix ($100 in chips) 
Seat 2: qqcom ($102.07 in chips) 
Seat 3: g00000se ($119.95 in chips) 
Seat 4: gabi_igna ($100 in chips) 
Seat 5: AGoodFell4 ($90.12 in chips) 
Seat 6: AlKatrone ($100 in chips) 
Seat 7: er13to ($114.40 in chips) 
Seat 8: Igor DoUrden ($106.35 in chips) 
Seat 9: matiko09 ($100.37 in chips) 
AGoodFell4: posts small blind $0.50
AlKatrone: posts big blind $1
*** HOLE CARDS ***
Dealt to matiko09 [As 8d]
er13to: folds 
Igor DoUrden: folds 
matiko09: folds 
Priidix: folds 
qqcom: raises $2.50 to $3.50
g00000se: folds 
gabi_igna: folds 
AGoodFell4: calls $3
AlKatrone: folds 
*** FLOP *** [8c Ac 6c]
AGoodFell4: bets $6
qqcom: calls $6
*** TURN *** [8c Ac 6c] [3s]
AGoodFell4: bets $10.10
qqcom: calls $10.10
*** RIVER *** [8c Ac 6c 3s] [Kd]
AGoodFell4: bets $20
qqcom: folds 
Uncalled bet ($20) returned to AGoodFell4
AGoodFell4 collected $38.39 from pot
AGoodFell4: doesn't show hand 
*** SUMMARY ***
Total pot $40.20 | Rake $1.81 
Board [8c Ac 6c 3s Kd]
Seat 1: Priidix folded before Flop (didn't bet)
Seat 2: qqcom folded on the River
Seat 3: g00000se folded before Flop (didn't bet)
Seat 4: gabi_igna (button) folded before Flop (didn't bet)
Seat 5: AGoodFell4 (small blind) collected ($38.39)
Seat 6: AlKatrone (big blind) folded before Flop
Seat 7: er13to folded before Flop (didn't bet)
Seat 8: Igor DoUrden folded before Flop (didn't bet)
Seat 9: matiko09 folded before Flop (didn't bet)





PokerStars Hand #148833396611:  Hold'em No Limit ($0.50/$1.00 USD) - 2016/02/15 11:17:52 CET [2016/02/15 5:17:52 ET]
Table 'Praecipua' 9-max Seat #9 is the button
Seat 1: er13to ($134.43 in chips) 
Seat 2: matiko09 ($101.50 in chips) 
Seat 3: Venomous100% ($108.82 in chips) 
Seat 5: huffwag ($160.99 in chips) 
Seat 6: mycka86 ($113 in chips) 
Seat 7: maxxmeister ($144.73 in chips) 
Seat 8: Ellis Ng ($39.92 in chips) 
Seat 9: AlKatrone ($101.90 in chips) 
er13to: posts small blind $0.50
matiko09: posts big blind $1
gabi_igna: sits out 
*** HOLE CARDS ***
Dealt to matiko09 [Ks 2c]
Venomous100%: folds 
huffwag: raises $2 to $3
mycka86: folds 
maxxmeister: folds 
Ellis Ng: folds 
AlKatrone: folds 
er13to: folds 
matiko09: folds 
Uncalled bet ($2) returned to huffwag
huffwag collected $2.50 from pot
huffwag: doesn't show hand 
*** SUMMARY ***
Total pot $2.50 | Rake $0 
Seat 1: er13to (small blind) folded before Flop
Seat 2: matiko09 (big blind) folded before Flop
Seat 3: Venomous100% folded before Flop (didn't bet)
Seat 5: huffwag collected ($2.50)
Seat 6: mycka86 folded before Flop (didn't bet)
Seat 7: maxxmeister folded before Flop (didn't bet)
Seat 8: Ellis Ng folded before Flop (didn't bet)
Seat 9: AlKatrone (button) folded before Flop (didn't bet)





PokerStars Hand #148833401482:  Hold'em No Limit ($0.50/$1.00 USD) - 2016/02/15 11:18:02 CET [2016/02/15 5:18:02 ET]
Table 'Gemma II' 9-max Seat #2 is the button
Seat 1: Igor DoUrden ($170.94 in chips) 
Seat 2: gabi_igna ($100 in chips) 
Seat 3: Venomous100% ($160.51 in chips) 
Seat 4: mycka86 ($100 in chips) 
Seat 5: PokerSash201 ($75.67 in chips) 
Seat 6: IHouseMusic ($100 in chips) 
Seat 7: AlKatrone ($121.19 in chips) 
Seat 8: Priidix ($100.16 in chips) 
Seat 9: matiko09 ($115.90 in chips) 
Venomous100%: posts small blind $0.50
mycka86: posts big blind $1
*** HOLE CARDS ***
Dealt to matiko09 [Kd 9d]
PokerSash201: folds 
IHouseMusic: folds 
AlKatrone: folds 
Priidix: folds 
matiko09: folds 
Igor DoUrden: folds 
gabi_igna: raises $1.50 to $2.50
Venomous100%: folds 
mycka86: folds 
Uncalled bet ($1.50) returned to gabi_igna
gabi_igna collected $2.50 from pot
gabi_igna: doesn't show hand 
*** SUMMARY ***
Total pot $2.50 | Rake $0 
Seat 1: Igor DoUrden folded before Flop (didn't bet)
Seat 2: gabi_igna (button) collected ($2.50)
Seat 3: Venomous100% (small blind) folded before Flop
Seat 4: mycka86 (big blind) folded before Flop
Seat 5: PokerSash201 folded before Flop (didn't bet)
Seat 6: IHouseMusic folded before Flop (didn't bet)
Seat 7: AlKatrone folded before Flop (didn't bet)
Seat 8: Priidix folded before Flop (didn't bet)
Seat 9: matiko09 folded before Flop (didn't bet)





PokerStars Hand #148833404557:  Hold'em No Limit ($0.50/$1.00 USD) - 2016/02/15 11:18:08 CET [2016/02/15 5:18:08 ET]
Table 'Ristenpart' 9-max Seat #7 is the button
Seat 1: vano7777 ($50 in chips) 
Seat 2: IHouseMusic ($117.33 in chips) 
Seat 3: RYUJI07 ($21.44 in chips) 
Seat 4: miyashin ($104.42 in chips) 
Seat 5: lingyyang ($52 in chips) 
Seat 6: matiko09 ($100 in chips) 
Seat 7: Aalleekks ($100 in chips) 
Seat 8: gwwsb ($77.46 in chips) 
Seat 9: Igor DoUrden ($100 in chips) 
gwwsb: posts small blind $0.50
Igor DoUrden: posts big blind $1
*** HOLE CARDS ***
Dealt to matiko09 [Qc Qs]
vano7777: folds 
IHouseMusic: folds 
RYUJI07: calls $1
miyashin: folds 
lingyyang: folds 
matiko09: raises $3 to $4
Aalleekks: folds 
gwwsb: folds 
Igor DoUrden: folds 
RYUJI07: calls $3
*** FLOP *** [Qd Js 7s]
RYUJI07: checks 
matiko09: bets $4
RYUJI07: calls $4
*** TURN *** [Qd Js 7s] [Jh]
RYUJI07: checks 
matiko09: checks 
*** RIVER *** [Qd Js 7s Jh] [9d]
RYUJI07: bets $13.44 and is all-in
matiko09: calls $13.44
*** SHOW DOWN ***
RYUJI07: shows [Ac Ad] (two pair, Aces and Jacks)
matiko09: shows [Qc Qs] (a full house, Queens full of Jacks)
matiko09 collected $42.38 from pot
*** SUMMARY ***
Total pot $44.38 | Rake $2 
Board [Qd Js 7s Jh 9d]
Seat 1: vano7777 folded before Flop (didn't bet)
Seat 2: IHouseMusic folded before Flop (didn't bet)
Seat 3: RYUJI07 showed [Ac Ad] and lost with two pair, Aces and Jacks
Seat 4: miyashin folded before Flop (didn't bet)
Seat 5: lingyyang folded before Flop (didn't bet)
Seat 6: matiko09 showed [Qc Qs] and won ($42.38) with a full house, Queens full of Jacks
Seat 7: Aalleekks (button) folded before Flop (didn't bet)
Seat 8: gwwsb (small blind) folded before Flop
Seat 9: Igor DoUrden (big blind) folded before Flop





PokerStars Hand #148833405116:  Hold'em No Limit ($0.25/$0.50 USD) - 2016/02/15 11:18:10 CET [2016/02/15 5:18:10 ET]
Table 'Vesta II' 9-max Seat #8 is the button
Seat 3: matiko09 ($73.20 in chips) 
Seat 4: vlad11122007 ($49.65 in chips) 
Seat 5: dndngod ($73.90 in chips) 
Seat 6: pandalapa ($50.35 in chips) 
Seat 7: ruyingren ($25.04 in chips) 
Seat 8: Arystan ($133.59 in chips) 
Seat 9: Aoki42 ($82.97 in chips) 
Aoki42: posts small blind $0.25
Ahangama: is sitting out 
i L00K great: is sitting out 
Ahangama leaves the table
matiko09: posts big blind $0.50
*** HOLE CARDS ***
Dealt to matiko09 [6s Th]
i L00K great leaves the table
etny99 joins the table at seat #1 
vlad11122007: raises $1 to $1.50
dndngod: folds 
pandalapa: folds 
ruyingren: calls $1.50
Arystan: folds 
ljryviltj joins the table at seat #2 
Aoki42: folds 
matiko09: folds 
*** FLOP *** [4c Js Kd]
vlad11122007: bets $2.50
ruyingren: raises $4 to $6.50
vlad11122007: calls $4
*** TURN *** [4c Js Kd] [5h]
vlad11122007: checks 
ruyingren: checks 
*** RIVER *** [4c Js Kd 5h] [Ts]
vlad11122007: checks 
ruyingren: bets $8.50
vlad11122007: calls $8.50
*** SHOW DOWN ***
ruyingren: shows [5d 5c] (three of a kind, Fives)
vlad11122007: mucks hand 
ruyingren collected $32.23 from pot
*** SUMMARY ***
Total pot $33.75 | Rake $1.52 
Board [4c Js Kd 5h Ts]
Seat 3: matiko09 (big blind) folded before Flop
Seat 4: vlad11122007 mucked [Qh Kc]
Seat 5: dndngod folded before Flop (didn't bet)
Seat 6: pandalapa folded before Flop (didn't bet)
Seat 7: ruyingren showed [5d 5c] and won ($32.23) with three of a kind, Fives
Seat 8: Arystan (button) folded before Flop (didn't bet)
Seat 9: Aoki42 (small blind) folded before Flop





PokerStars Hand #148833412767:  Hold'em No Limit ($0.50/$1.00 USD) - 2016/02/15 11:18:26 CET [2016/02/15 5:18:26 ET]
Table 'Saldanha' 9-max Seat #8 is the button
Seat 1: mycka86 ($100 in chips) 
Seat 2: Congo Sam ($102.38 in chips) 
Seat 3: maxxmeister ($136.63 in chips) 
Seat 4: er13to ($110.34 in chips) 
Seat 5: matiko09 ($106.50 in chips) 
Seat 6: huffwag ($9.87 in chips) 
Seat 7: Venomous100% ($159.76 in chips) 
Seat 8: gabi_igna ($109.14 in chips) 
mycka86: posts small blind $0.50
Congo Sam: posts big blind $1
*** HOLE CARDS ***
Dealt to matiko09 [6d 9h]
maxxmeister: raises $3 to $4
er13to: folds 
matiko09: folds 
huffwag: folds 
Venomous100%: folds 
gabi_igna: folds 
mycka86: folds 
Congo Sam: folds 
Uncalled bet ($3) returned to maxxmeister
maxxmeister collected $2.50 from pot
maxxmeister: doesn't show hand 
*** SUMMARY ***
Total pot $2.50 | Rake $0 
Seat 1: mycka86 (small blind) folded before Flop
Seat 2: Congo Sam (big blind) folded before Flop
Seat 3: maxxmeister collected ($2.50)
Seat 4: er13to folded before Flop (didn't bet)
Seat 5: matiko09 folded before Flop (didn't bet)
Seat 6: huffwag folded before Flop (didn't bet)
Seat 7: Venomous100% folded before Flop (didn't bet)
Seat 8: gabi_igna (button) folded before Flop (didn't bet)





PokerStars Hand #148833415658:  Hold'em No Limit ($0.25/$0.50 USD) - 2016/02/15 11:18:32 CET [2016/02/15 5:18:32 ET]
Table 'Laertes II' 9-max Seat #4 is the button
Seat 1: etny99 ($51.14 in chips) 
Seat 2: beluccix ($24.21 in chips) 
Seat 4: rgar93 ($42.23 in chips) 
Seat 7: Vedpapa ($59.19 in chips) 
Seat 8: Trent444 ($45.64 in chips) 
Seat 9: matiko09 ($50.85 in chips) 
Serhent will be allowed to play after the button
ZonTTT will be allowed to play after the button
Vedpapa: posts small blind $0.25
Trent444: posts big blind $0.50
valfan911: sits out 
*** HOLE CARDS ***
Dealt to matiko09 [Ts 2c]
matiko09: folds 
etny99: raises $0.62 to $1.12
beluccix: folds 
rgar93: calls $1.12
Vedpapa: raises $3.88 to $5
Trent444: folds 
etny99: calls $3.88
rgar93: calls $3.88
*** FLOP *** [7c 3d Tc]
Vedpapa: bets $8.50
etny99: folds 
rgar93: folds 
Uncalled bet ($8.50) returned to Vedpapa
Vedpapa collected $14.80 from pot
*** SUMMARY ***
Total pot $15.50 | Rake $0.70 
Board [7c 3d Tc]
Seat 1: etny99 folded on the Flop
Seat 2: beluccix folded before Flop (didn't bet)
Seat 4: rgar93 (button) folded on the Flop
Seat 7: Vedpapa (small blind) collected ($14.80)
Seat 8: Trent444 (big blind) folded before Flop
Seat 9: matiko09 folded before Flop (didn't bet)





PokerStars Hand #148833416207:  Hold'em No Limit ($0.50/$1.00 USD) - 2016/02/15 11:18:33 CET [2016/02/15 5:18:33 ET]
Table 'Praecipua' 9-max Seat #1 is the button
Seat 1: er13to ($133.93 in chips) 
Seat 2: matiko09 ($100.50 in chips) 
Seat 3: Venomous100% ($108.82 in chips) 
Seat 5: huffwag ($162.49 in chips) 
Seat 6: mycka86 ($113 in chips) 
Seat 7: maxxmeister ($144.73 in chips) 
Seat 8: Ellis Ng ($39.92 in chips) 
Seat 9: AlKatrone ($101.90 in chips) 
matiko09: posts small blind $0.50
Venomous100%: posts big blind $1
gabi_igna: sits out 
*** HOLE CARDS ***
Dealt to matiko09 [Kc 8s]
huffwag: folds 
mycka86: raises $2 to $3
maxxmeister: folds 
Ellis Ng: calls $3
AlKatrone: folds 
er13to: folds 
matiko09: folds 
Venomous100%: raises $10 to $13
mycka86: folds 
Ellis Ng: folds 
Uncalled bet ($10) returned to Venomous100%
Venomous100% collected $9.50 from pot
Venomous100%: doesn't show hand 
*** SUMMARY ***
Total pot $9.50 | Rake $0 
Seat 1: er13to (button) folded before Flop (didn't bet)
Seat 2: matiko09 (small blind) folded before Flop
Seat 3: Venomous100% (big blind) collected ($9.50)
Seat 5: huffwag folded before Flop (didn't bet)
Seat 6: mycka86 folded before Flop
Seat 7: maxxmeister folded before Flop (didn't bet)
Seat 8: Ellis Ng folded before Flop
Seat 9: AlKatrone folded before Flop (didn't bet)





PokerStars Hand #148833417386:  Hold'em No Limit (€0.50/€1.00 EUR) - 2016/02/15 11:18:36 CET [2016/02/15 5:18:36 ET]
Table 'Ganesa II' 9-max Seat #5 is the button
Seat 2: maxxmeister (€103.21 in chips) 
Seat 3: BuBu 0187 (€75.84 in chips) 
Seat 4: Sreshta222 (€119.02 in chips) 
Seat 5: vano7777 (€72.24 in chips) 
Seat 6: matiko09 (€122.58 in chips) 
Seat 7: er13to (€115 in chips) 
Seat 8: mycka86 (€100 in chips) 
Seat 9: Priidix (€100 in chips) 
matiko09: posts small blind €0.50
er13to: posts big blind €1
*** HOLE CARDS ***
Dealt to matiko09 [Ad 5d]
mycka86: folds 
Priidix: folds 
maxxmeister: folds 
BuBu 0187: calls €1
Sreshta222: folds 
vano7777: calls €1
matiko09: calls €0.50
er13to: raises €7 to €8
BuBu 0187: folds 
AARON1953 joins the table at seat #1 
vano7777: folds 
matiko09: folds 
Uncalled bet (€7) returned to er13to
er13to collected €4 from pot
*** SUMMARY ***
Total pot €4 | Rake €0 
Seat 2: maxxmeister folded before Flop (didn't bet)
Seat 3: BuBu 0187 folded before Flop
Seat 4: Sreshta222 folded before Flop (didn't bet)
Seat 5: vano7777 (button) folded before Flop
Seat 6: matiko09 (small blind) folded before Flop
Seat 7: er13to (big blind) collected (€4)
Seat 8: mycka86 folded before Flop (didn't bet)
Seat 9: Priidix folded before Flop (didn't bet)





PokerStars Hand #148833419148:  Hold'em No Limit ($0.50/$1.00 USD) - 2016/02/15 11:18:39 CET [2016/02/15 5:18:39 ET]
Table 'Anteros' 9-max Seat #5 is the button
Seat 1: redacesfull ($100.31 in chips) 
Seat 2: IHouseMusic ($108.86 in chips) 
Seat 3: er13to ($109.20 in chips) 
Seat 4: misherei ($193.51 in chips) 
Seat 5: Holm1991 ($46.36 in chips) 
Seat 7: Zoubou1983 ($167.97 in chips) 
Seat 8: matiko09 ($100 in chips) 
Seat 9: mycka86 ($100 in chips) 
Zoubou1983: posts small blind $0.50
matiko09: posts big blind $1
*** HOLE CARDS ***
Dealt to matiko09 [2c 6d]
mycka86: folds 
redacesfull: folds 
IHouseMusic: folds 
er13to: folds 
misherei: calls $1
Holm1991: calls $1
Zoubou1983: calls $0.50
matiko09: checks 
*** FLOP *** [8c Ks 5d]
Zoubou1983: bets $2
matiko09: folds 
misherei: calls $2
Holm1991: folds 
*** TURN *** [8c Ks 5d] [2d]
Zoubou1983: bets $4
misherei: calls $4
*** RIVER *** [8c Ks 5d 2d] [Th]
Zoubou1983: bets $15
misherei: calls $15
*** SHOW DOWN ***
Zoubou1983: shows [Qs Kd] (a pair of Kings)
misherei: mucks hand 
Zoubou1983 collected $43.93 from pot
*** SUMMARY ***
Total pot $46 | Rake $2.07 
Board [8c Ks 5d 2d Th]
Seat 1: redacesfull folded before Flop (didn't bet)
Seat 2: IHouseMusic folded before Flop (didn't bet)
Seat 3: er13to folded before Flop (didn't bet)
Seat 4: misherei mucked [Kh 4h]
Seat 5: Holm1991 (button) folded on the Flop
Seat 7: Zoubou1983 (small blind) showed [Qs Kd] and won ($43.93) with a pair of Kings
Seat 8: matiko09 (big blind) folded on the Flop
Seat 9: mycka86 folded before Flop (didn't bet)





PokerStars Hand #148833419119:  Hold'em No Limit ($0.50/$1.00 USD) - 2016/02/15 11:18:39 CET [2016/02/15 5:18:39 ET]
Table 'Gemma II' 9-max Seat #3 is the button
Seat 1: Igor DoUrden ($170.94 in chips) 
Seat 2: gabi_igna ($101.50 in chips) 
Seat 3: Venomous100% ($160.01 in chips) 
Seat 4: mycka86 ($100 in chips) 
Seat 5: PokerSash201 ($75.67 in chips) 
Seat 6: IHouseMusic ($100 in chips) 
Seat 7: AlKatrone ($121.19 in chips) 
Seat 8: Priidix ($100.16 in chips) 
Seat 9: matiko09 ($115.90 in chips) 
mycka86: posts small blind $0.50
PokerSash201: posts big blind $1
*** HOLE CARDS ***
Dealt to matiko09 [9c 3d]
IHouseMusic: raises $2 to $3
AlKatrone: folds 
Priidix: calls $3
matiko09: folds 
Igor DoUrden: folds 
gabi_igna: folds 
Venomous100%: folds 
mycka86: folds 
PokerSash201: folds 
*** FLOP *** [Ah As Ts]
IHouseMusic: bets $5.02
Priidix: calls $5.02
*** TURN *** [Ah As Ts] [6c]
IHouseMusic: checks 
Priidix: checks 
*** RIVER *** [Ah As Ts 6c] [3s]
IHouseMusic: checks 
Priidix: checks 
*** SHOW DOWN ***
IHouseMusic: shows [Qh Kh] (a pair of Aces)
Priidix: shows [Jd Jh] (two pair, Aces and Jacks)
Priidix collected $16.75 from pot
*** SUMMARY ***
Total pot $17.54 | Rake $0.79 
Board [Ah As Ts 6c 3s]
Seat 1: Igor DoUrden folded before Flop (didn't bet)
Seat 2: gabi_igna folded before Flop (didn't bet)
Seat 3: Venomous100% (button) folded before Flop (didn't bet)
Seat 4: mycka86 (small blind) folded before Flop
Seat 5: PokerSash201 (big blind) folded before Flop
Seat 6: IHouseMusic showed [Qh Kh] and lost with a pair of Aces
Seat 7: AlKatrone folded before Flop (didn't bet)
Seat 8: Priidix showed [Jd Jh] and won ($16.75) with two pair, Aces and Jacks
Seat 9: matiko09 folded before Flop (didn't bet)





PokerStars Hand #148833422430:  Hold'em No Limit ($0.50/$1.00 USD) - 2016/02/15 11:18:46 CET [2016/02/15 5:18:46 ET]
Table 'Octans II' 9-max Seat #4 is the button
Seat 1: maxxmeister ($100 in chips) 
Seat 2: matiko09 ($244.79 in chips) 
Seat 4: Venomous100% ($161.80 in chips) 
Seat 5: AlKatrone ($121.66 in chips) 
Seat 6: er13to ($100 in chips) 
Seat 7: traficblues ($44.75 in chips) 
Seat 8: IHouseMusic ($144.93 in chips) 
Seat 9: mycka86 ($100 in chips) 
AlKatrone: posts small blind $0.50
er13to: posts big blind $1
Aalleekks: sits out 
*** HOLE CARDS ***
Dealt to matiko09 [2s 4h]
traficblues: calls $1
IHouseMusic: folds 
mycka86: folds 
maxxmeister: folds 
matiko09: folds 
Venomous100%: folds 
AlKatrone: calls $0.50
er13to: checks 
*** FLOP *** [6d 2c 7d]
AlKatrone: bets $2.54
er13to: folds 
traficblues: folds 
Uncalled bet ($2.54) returned to AlKatrone
AlKatrone collected $2.86 from pot
AlKatrone: doesn't show hand 
*** SUMMARY ***
Total pot $3 | Rake $0.14 
Board [6d 2c 7d]
Seat 1: maxxmeister folded before Flop (didn't bet)
Seat 2: matiko09 folded before Flop (didn't bet)
Seat 4: Venomous100% (button) folded before Flop (didn't bet)
Seat 5: AlKatrone (small blind) collected ($2.86)
Seat 6: er13to (big blind) folded on the Flop
Seat 7: traficblues folded on the Flop
Seat 8: IHouseMusic folded before Flop (didn't bet)
Seat 9: mycka86 folded before Flop (didn't bet)





PokerStars Hand #148833427075:  Hold'em No Limit ($0.50/$1.00 USD) - 2016/02/15 11:18:56 CET [2016/02/15 5:18:56 ET]
Table 'Corvus III' 9-max Seat #7 is the button
Seat 2: mzsportline ($137 in chips) 
Seat 3: VanDobeln ($241.40 in chips) 
Seat 4: goransyruvka ($113.24 in chips) 
Seat 5: koib88 ($450.26 in chips) 
Seat 6: Priidix ($157.88 in chips) 
Seat 7: matiko09 ($248.10 in chips) 
Seat 8: redacesfull ($245.88 in chips) 
Seat 9: er13to ($104.42 in chips) 
redacesfull: posts small blind $0.50
er13to: posts big blind $1
mzsportline: posts the ante $0.20
VanDobeln: posts the ante $0.20
goransyruvka: posts the ante $0.20
koib88: posts the ante $0.20
Priidix: posts the ante $0.20
matiko09: posts the ante $0.20
redacesfull: posts the ante $0.20
er13to: posts the ante $0.20
*** HOLE CARDS ***
Dealt to matiko09 [5c 2d]
mzsportline: folds 
VanDobeln: folds 
goransyruvka: calls $1
koib88: folds 
koib88 leaves the table
Priidix: folds 
matiko09: folds 
redacesfull: folds 
er13to: checks 
*** FLOP *** [Kh 5h Ks]
er13to: checks 
goransyruvka: bets $1.96
er13to: folds 
Uncalled bet ($1.96) returned to goransyruvka
goransyruvka collected $3.92 from pot
goransyruvka: doesn't show hand 
*** SUMMARY ***
Total pot $4.10 | Rake $0.18 
Board [Kh 5h Ks]
Seat 2: mzsportline folded before Flop (didn't bet)
Seat 3: VanDobeln folded before Flop (didn't bet)
Seat 4: goransyruvka collected ($3.92)
Seat 5: koib88 folded before Flop (didn't bet)
Seat 6: Priidix folded before Flop (didn't bet)
Seat 7: matiko09 (button) folded before Flop (didn't bet)
Seat 8: redacesfull (small blind) folded before Flop
Seat 9: er13to (big blind) folded on the Flop





PokerStars Hand #148833427303:  Hold'em No Limit ($0.50/$1.00 USD) - 2016/02/15 11:18:57 CET [2016/02/15 5:18:57 ET]
Table 'Saldanha' 9-max Seat #1 is the button
Seat 1: mycka86 ($100 in chips) 
Seat 2: Congo Sam ($101.38 in chips) 
Seat 3: maxxmeister ($138.13 in chips) 
Seat 4: er13to ($110.34 in chips) 
Seat 5: matiko09 ($106.50 in chips) 
Seat 6: huffwag ($9.87 in chips) 
Seat 7: Venomous100% ($159.76 in chips) 
Seat 8: gabi_igna ($109.14 in chips) 
Congo Sam: posts small blind $0.50
maxxmeister: posts big blind $1
*** HOLE CARDS ***
Dealt to matiko09 [2c 3d]
er13to: folds 
matiko09: folds 
huffwag: folds 
Venomous100%: folds 
gabi_igna: raises $1.50 to $2.50
mycka86: folds 
Congo Sam: folds 
maxxmeister: folds 
Uncalled bet ($1.50) returned to gabi_igna
gabi_igna collected $2.50 from pot
gabi_igna: doesn't show hand 
*** SUMMARY ***
Total pot $2.50 | Rake $0 
Seat 1: mycka86 (button) folded before Flop (didn't bet)
Seat 2: Congo Sam (small blind) folded before Flop
Seat 3: maxxmeister (big blind) folded before Flop
Seat 4: er13to folded before Flop (didn't bet)
Seat 5: matiko09 folded before Flop (didn't bet)
Seat 6: huffwag folded before Flop (didn't bet)
Seat 7: Venomous100% folded before Flop (didn't bet)
Seat 8: gabi_igna collected ($2.50)





PokerStars Hand #148833429523:  Hold'em No Limit ($0.50/$1.00 USD) - 2016/02/15 11:19:01 CET [2016/02/15 5:19:01 ET]
Table 'Sekanina' 9-max Seat #1 is the button
Seat 1: LUTZ_11111 ($56.13 in chips) 
Seat 2: Priidix ($122.33 in chips) 
Seat 3: gabi_igna ($100 in chips) 
Seat 4: matiko09 ($100 in chips) 
Seat 5: IHouseMusic ($126.77 in chips) 
Seat 6: vinniesmol ($250.81 in chips) 
Seat 7: mycka86 ($135.35 in chips) 
Seat 8: Venomous100% ($103.75 in chips) 
Seat 9: er13to ($100.73 in chips) 
Priidix: posts small blind $0.50
gabi_igna: posts big blind $1
*** HOLE CARDS ***
Dealt to matiko09 [9c 6s]
matiko09: folds 
IHouseMusic: folds 
vinniesmol: folds 
mycka86: folds 
Venomous100%: raises $2 to $3
er13to: folds 
LUTZ_11111: calls $3
Priidix: calls $2.50
gabi_igna: folds 
*** FLOP *** [7c 5c 8s]
Priidix: checks 
Venomous100%: checks 
LUTZ_11111: bets $5
Priidix: calls $5
Venomous100%: folds 
*** TURN *** [7c 5c 8s] [Jd]
Priidix: checks 
LUTZ_11111: bets $19.10
Priidix: raises $19.10 to $38.20
LUTZ_11111: calls $19.10
*** RIVER *** [7c 5c 8s Jd] [9d]
Priidix: bets $75.19
LUTZ_11111: calls $9.93 and is all-in
Uncalled bet ($65.26) returned to Priidix
*** SHOW DOWN ***
Priidix: shows [Th 9h] (a straight, Seven to Jack)
LUTZ_11111: shows [8c Jc] (two pair, Jacks and Eights)
Priidix collected $113.46 from pot
*** SUMMARY ***
Total pot $116.26 | Rake $2.80 
Board [7c 5c 8s Jd 9d]
Seat 1: LUTZ_11111 (button) showed [8c Jc] and lost with two pair, Jacks and Eights
Seat 2: Priidix (small blind) showed [Th 9h] and won ($113.46) with a straight, Seven to Jack
Seat 3: gabi_igna (big blind) folded before Flop
Seat 4: matiko09 folded before Flop (didn't bet)
Seat 5: IHouseMusic folded before Flop (didn't bet)
Seat 6: vinniesmol folded before Flop (didn't bet)
Seat 7: mycka86 folded before Flop (didn't bet)
Seat 8: Venomous100% folded on the Flop
Seat 9: er13to folded before Flop (didn't bet)





PokerStars Hand #148833432438:  Hold'em No Limit ($0.50/$1.00 USD) - 2016/02/15 11:19:08 CET [2016/02/15 5:19:08 ET]
Table 'Nata II' 9-max Seat #5 is the button
Seat 1: Priidix ($100 in chips) 
Seat 2: qqcom ($100 in chips) 
Seat 3: g00000se ($119.95 in chips) 
Seat 4: gabi_igna ($100 in chips) 
Seat 5: AGoodFell4 ($108.91 in chips) 
Seat 6: AlKatrone ($100 in chips) 
Seat 7: er13to ($114.40 in chips) 
Seat 8: Igor DoUrden ($106.35 in chips) 
Seat 9: matiko09 ($100.37 in chips) 
AlKatrone: posts small blind $0.50
er13to: posts big blind $1
*** HOLE CARDS ***
Dealt to matiko09 [6d Ah]
Igor DoUrden: folds 
matiko09: folds 
Priidix: raises $2 to $3
qqcom: raises $2 to $5
g00000se: folds 
gabi_igna: folds 
AGoodFell4: folds 
AlKatrone: folds 
er13to: folds 
Priidix: calls $2
*** FLOP *** [Ac 8h 4h]
Priidix: checks 
qqcom: bets $5.49
Priidix: calls $5.49
*** TURN *** [Ac 8h 4h] [Qc]
Priidix: checks 
qqcom: bets $7
Priidix: calls $7
*** RIVER *** [Ac 8h 4h Qc] [Td]
Priidix: checks 
qqcom: bets $17.42
Priidix: calls $17.42
*** SHOW DOWN ***
qqcom: shows [8d 9d] (a pair of Eights)
Priidix: shows [5d Ad] (a pair of Aces)
Priidix collected $68.52 from pot
*** SUMMARY ***
Total pot $71.32 | Rake $2.80 
Board [Ac 8h 4h Qc Td]
Seat 1: Priidix showed [5d Ad] and won ($68.52) with a pair of Aces
Seat 2: qqcom showed [8d 9d] and lost with a pair of Eights
Seat 3: g00000se folded before Flop (didn't bet)
Seat 4: gabi_igna folded before Flop (didn't bet)
Seat 5: AGoodFell4 (button) folded before Flop (didn't bet)
Seat 6: AlKatrone (small blind) folded before Flop
Seat 7: er13to (big blind) folded before Flop
Seat 8: Igor DoUrden folded before Flop (didn't bet)
Seat 9: matiko09 folded before Flop (didn't bet)





PokerStars Hand #148833437196:  Hold'em No Limit ($0.25/$0.50 USD) - 2016/02/15 11:19:18 CET [2016/02/15 5:19:18 ET]
Table 'Vesta II' 9-max Seat #9 is the button
Seat 3: matiko09 ($72.70 in chips) 
Seat 4: vlad11122007 ($50 in chips) 
Seat 5: dndngod ($73.90 in chips) 
Seat 6: pandalapa ($50.35 in chips) 
Seat 7: ruyingren ($40.77 in chips) 
Seat 8: Arystan ($133.59 in chips) 
Seat 9: Aoki42 ($82.72 in chips) 
etny99 will be allowed to play after the button
ljryviltj will be allowed to play after the button
matiko09: posts small blind $0.25
vlad11122007: posts big blind $0.50
*** HOLE CARDS ***
Dealt to matiko09 [5c Tc]
dndngod: folds 
pandalapa: raises $1 to $1.50
ruyingren: folds 
Arystan: folds 
Aoki42: folds 
matiko09: folds 
vlad11122007: calls $1
*** FLOP *** [7c Jh Qs]
vlad11122007: checks 
pandalapa: bets $2.06
vlad11122007: calls $2.06
*** TURN *** [7c Jh Qs] [9h]
vlad11122007: checks 
pandalapa: checks 
*** RIVER *** [7c Jh Qs 9h] [5s]
vlad11122007: bets $5
pandalapa: calls $5
*** SHOW DOWN ***
vlad11122007: shows [Jc Qc] (two pair, Queens and Jacks)
pandalapa: mucks hand 
vlad11122007 collected $16.59 from pot
*** SUMMARY ***
Total pot $17.37 | Rake $0.78 
Board [7c Jh Qs 9h 5s]
Seat 3: matiko09 (small blind) folded before Flop
Seat 4: vlad11122007 (big blind) showed [Jc Qc] and won ($16.59) with two pair, Queens and Jacks
Seat 5: dndngod folded before Flop (didn't bet)
Seat 6: pandalapa mucked [Ah Ad]
Seat 7: ruyingren folded before Flop (didn't bet)
Seat 8: Arystan folded before Flop (didn't bet)
Seat 9: Aoki42 (button) folded before Flop (didn't bet)





PokerStars Hand #148833438211:  Hold'em No Limit ($0.50/$1.00 USD) - 2016/02/15 11:19:20 CET [2016/02/15 5:19:20 ET]
Table 'Ristenpart' 9-max Seat #8 is the button
Seat 1: vano7777 ($50 in chips) 
Seat 2: IHouseMusic ($117.33 in chips) 
Seat 4: miyashin ($104.42 in chips) 
Seat 5: lingyyang ($52 in chips) 
Seat 6: matiko09 ($120.94 in chips) 
Seat 7: Aalleekks ($100 in chips) 
Seat 8: gwwsb ($76.96 in chips) 
Seat 9: Igor DoUrden ($100 in chips) 
Igor DoUrden: posts small blind $0.50
vano7777: posts big blind $1
*** HOLE CARDS ***
Dealt to matiko09 [9h 3s]
RYUJI07 leaves the table
IHouseMusic: folds 
miyashin: folds 
lingyyang: folds 
matiko09: folds 
Aalleekks: raises $1.50 to $2.50
gwwsb: folds 
Igor DoUrden: folds 
vano7777: folds 
Uncalled bet ($1.50) returned to Aalleekks
Aalleekks collected $2.50 from pot
Aalleekks: doesn't show hand 
*** SUMMARY ***
Total pot $2.50 | Rake $0 
Seat 1: vano7777 (big blind) folded before Flop
Seat 2: IHouseMusic folded before Flop (didn't bet)
Seat 4: miyashin folded before Flop (didn't bet)
Seat 5: lingyyang folded before Flop (didn't bet)
Seat 6: matiko09 folded before Flop (didn't bet)
Seat 7: Aalleekks collected ($2.50)
Seat 8: gwwsb (button) folded before Flop (didn't bet)
Seat 9: Igor DoUrden (small blind) folded before Flop





PokerStars Hand #148833439176:  Hold'em No Limit ($0.50/$1.00 USD) - 2016/02/15 11:19:22 CET [2016/02/15 5:19:22 ET]
Table 'Saldanha' 9-max Seat #2 is the button
Seat 1: mycka86 ($100 in chips) 
Seat 2: Congo Sam ($100.88 in chips) 
Seat 3: maxxmeister ($137.13 in chips) 
Seat 4: er13to ($110.34 in chips) 
Seat 5: matiko09 ($106.50 in chips) 
Seat 6: huffwag ($9.87 in chips) 
Seat 7: Venomous100% ($159.76 in chips) 
Seat 8: gabi_igna ($110.64 in chips) 
maxxmeister: posts small blind $0.50
er13to: posts big blind $1
*** HOLE CARDS ***
Dealt to matiko09 [4h Ts]
matiko09: folds 
huffwag: raises $8.87 to $9.87 and is all-in
Venomous100%: folds 
gabi_igna: folds 
mycka86: folds 
Congo Sam: folds 
maxxmeister: folds 
er13to: folds 
Uncalled bet ($8.87) returned to huffwag
huffwag collected $2.50 from pot
huffwag: doesn't show hand 
*** SUMMARY ***
Total pot $2.50 | Rake $0 
Seat 1: mycka86 folded before Flop (didn't bet)
Seat 2: Congo Sam (button) folded before Flop (didn't bet)
Seat 3: maxxmeister (small blind) folded before Flop
Seat 4: er13to (big blind) folded before Flop
Seat 5: matiko09 folded before Flop (didn't bet)
Seat 6: huffwag collected ($2.50)
Seat 7: Venomous100% folded before Flop (didn't bet)
Seat 8: gabi_igna folded before Flop (didn't bet)





PokerStars Hand #148833445475:  Hold'em No Limit ($0.50/$1.00 USD) - 2016/02/15 11:19:36 CET [2016/02/15 5:19:36 ET]
Table 'Praecipua' 9-max Seat #2 is the button
Seat 1: er13to ($133.93 in chips) 
Seat 2: matiko09 ($100 in chips) 
Seat 3: Venomous100% ($115.32 in chips) 
Seat 4: gabi_igna ($100 in chips) 
Seat 5: huffwag ($162.49 in chips) 
Seat 6: mycka86 ($110 in chips) 
Seat 7: maxxmeister ($144.73 in chips) 
Seat 8: Ellis Ng ($36.92 in chips) 
Seat 9: AlKatrone ($101.90 in chips) 
Venomous100%: posts small blind $0.50
gabi_igna: posts big blind $1
*** HOLE CARDS ***
Dealt to matiko09 [7d 4h]
huffwag: raises $2 to $3
mycka86: folds 
maxxmeister: calls $3
Ellis Ng: folds 
AlKatrone: folds 
er13to: folds 
matiko09: folds 
Venomous100%: folds 
gabi_igna: folds 
*** FLOP *** [2h 6h Kh]
huffwag: checks 
maxxmeister: checks 
*** TURN *** [2h 6h Kh] [Ah]
huffwag: checks 
maxxmeister: checks 
*** RIVER *** [2h 6h Kh Ah] [9c]
huffwag: bets $7.16
maxxmeister: folds 
Uncalled bet ($7.16) returned to huffwag
huffwag collected $7.16 from pot
huffwag: doesn't show hand 
*** SUMMARY ***
Total pot $7.50 | Rake $0.34 
Board [2h 6h Kh Ah 9c]
Seat 1: er13to folded before Flop (didn't bet)
Seat 2: matiko09 (button) folded before Flop (didn't bet)
Seat 3: Venomous100% (small blind) folded before Flop
Seat 4: gabi_igna (big blind) folded before Flop
Seat 5: huffwag collected ($7.16)
Seat 6: mycka86 folded before Flop (didn't bet)
Seat 7: maxxmeister folded on the River
Seat 8: Ellis Ng folded before Flop (didn't bet)
Seat 9: AlKatrone folded before Flop (didn't bet)





PokerStars Hand #148833446719:  Hold'em No Limit ($0.50/$1.00 USD) - 2016/02/15 11:19:38 CET [2016/02/15 5:19:38 ET]
Table 'Corvus III' 9-max Seat #8 is the button
Seat 2: mzsportline ($136.80 in chips) 
Seat 3: VanDobeln ($241.20 in chips) 
Seat 4: goransyruvka ($115.96 in chips) 
Seat 6: Priidix ($157.68 in chips) 
Seat 7: matiko09 ($247.90 in chips) 
Seat 8: redacesfull ($245.18 in chips) 
Seat 9: er13to ($103.22 in chips) 
er13to: posts small blind $0.50
mzsportline: posts big blind $1
mzsportline: posts the ante $0.20
VanDobeln: posts the ante $0.20
goransyruvka: posts the ante $0.20
Priidix: posts the ante $0.20
matiko09: posts the ante $0.20
redacesfull: posts the ante $0.20
er13to: posts the ante $0.20
*** HOLE CARDS ***
Dealt to matiko09 [5d Ad]
VanDobeln: folds 
goransyruvka: calls $1
Priidix: folds 
matiko09: raises $4 to $5
redacesfull: folds 
er13to: folds 
maxxmeister joins the table at seat #5 
mzsportline: calls $4
goransyruvka: calls $4
*** FLOP *** [7d 4d 2d]
mzsportline: checks 
goransyruvka: checks 
matiko09: bets $10
mzsportline: calls $10
goransyruvka: folds 
*** TURN *** [7d 4d 2d] [6s]
mzsportline: checks 
matiko09: bets $24
mzsportline: calls $24
*** RIVER *** [7d 4d 2d 6s] [5s]
mzsportline: checks 
pk4DW joins the table at seat #1 
matiko09: bets $72
mzsportline: folds 
Uncalled bet ($72) returned to matiko09
matiko09 collected $82.10 from pot
matiko09: doesn't show hand 
*** SUMMARY ***
Total pot $84.90 | Rake $2.80 
Board [7d 4d 2d 6s 5s]
Seat 2: mzsportline (big blind) folded on the River
Seat 3: VanDobeln folded before Flop (didn't bet)
Seat 4: goransyruvka folded on the Flop
Seat 6: Priidix folded before Flop (didn't bet)
Seat 7: matiko09 collected ($82.10)
Seat 8: redacesfull (button) folded before Flop (didn't bet)
Seat 9: er13to (small blind) folded before Flop





PokerStars Hand #148833451147:  Hold'em No Limit ($0.25/$0.50 USD) - 2016/02/15 11:19:48 CET [2016/02/15 5:19:48 ET]
Table 'Laertes II' 9-max Seat #7 is the button
Seat 1: etny99 ($50 in chips) 
Seat 2: beluccix ($24.21 in chips) 
Seat 4: rgar93 ($37.23 in chips) 
Seat 7: Vedpapa ($68.99 in chips) 
Seat 8: Trent444 ($45.14 in chips) 
Seat 9: matiko09 ($50.85 in chips) 
Trent444: posts small blind $0.25
matiko09: posts big blind $0.50
valfan911: sits out 
Serhent: sits out 
ZonTTT: sits out 
*** HOLE CARDS ***
Dealt to matiko09 [6h Jh]
etny99: folds 
beluccix: folds 
rgar93: folds 
Vedpapa: folds 
Trent444: calls $0.25
matiko09: checks 
*** FLOP *** [Qc 3s Kd]
Trent444: checks 
matiko09: checks 
*** TURN *** [Qc 3s Kd] [2s]
Trent444: bets $2
matiko09: folds 
Uncalled bet ($2) returned to Trent444
Trent444 collected $0.96 from pot
Trent444: doesn't show hand 
*** SUMMARY ***
Total pot $1 | Rake $0.04 
Board [Qc 3s Kd 2s]
Seat 1: etny99 folded before Flop (didn't bet)
Seat 2: beluccix folded before Flop (didn't bet)
Seat 4: rgar93 folded before Flop (didn't bet)
Seat 7: Vedpapa (button) folded before Flop (didn't bet)
Seat 8: Trent444 (small blind) collected ($0.96)
Seat 9: matiko09 (big blind) folded on the Turn





PokerStars Hand #148833451378:  Hold'em No Limit (€0.50/€1.00 EUR) - 2016/02/15 11:19:48 CET [2016/02/15 5:19:48 ET]
Table 'Ganesa II' 9-max Seat #6 is the button
Seat 1: AARON1953 (€80 in chips) 
Seat 2: maxxmeister (€103.21 in chips) 
Seat 3: BuBu 0187 (€74.84 in chips) 
Seat 4: Sreshta222 (€119.02 in chips) 
Seat 5: vano7777 (€71.24 in chips) 
Seat 6: matiko09 (€121.58 in chips) 
Seat 7: er13to (€118 in chips) 
Seat 8: mycka86 (€100 in chips) 
Seat 9: Priidix (€100 in chips) 
er13to: posts small blind €0.50
mycka86: posts big blind €1
AARON1953: posts big blind €1
*** HOLE CARDS ***
Dealt to matiko09 [Ad 9s]
Priidix: folds 
AARON1953: checks 
maxxmeister: folds 
BuBu 0187: folds 
Sreshta222: calls €1
vano7777: folds 
matiko09: raises €4 to €5
er13to: folds 
mycka86: folds 
AARON1953: folds 
Sreshta222: calls €4
*** FLOP *** [7s Jd 3c]
Sreshta222: checks 
matiko09: bets €7
Sreshta222: calls €7
*** TURN *** [7s Jd 3c] [2s]
Sreshta222: checks 
matiko09: checks 
*** RIVER *** [7s Jd 3c 2s] [5d]
Sreshta222: bets €16.87
matiko09: folds 
Uncalled bet (€16.87) returned to Sreshta222
Sreshta222 collected €25.31 from pot
Sreshta222: doesn't show hand 
*** SUMMARY ***
Total pot €26.50 | Rake €1.19 
Board [7s Jd 3c 2s 5d]
Seat 1: AARON1953 folded before Flop
Seat 2: maxxmeister folded before Flop (didn't bet)
Seat 3: BuBu 0187 folded before Flop (didn't bet)
Seat 4: Sreshta222 collected (€25.31)
Seat 5: vano7777 folded before Flop (didn't bet)
Seat 6: matiko09 (button) folded on the River
Seat 7: er13to (small blind) folded before Flop
Seat 8: mycka86 (big blind) folded before Flop
Seat 9: Priidix folded before Flop (didn't bet)





PokerStars Hand #148833452440:  Hold'em No Limit ($0.50/$1.00 USD) - 2016/02/15 11:19:50 CET [2016/02/15 5:19:50 ET]
Table 'Ristenpart' 9-max Seat #9 is the button
Seat 1: vano7777 ($49 in chips) 
Seat 2: IHouseMusic ($117.33 in chips) 
Seat 4: miyashin ($104.42 in chips) 
Seat 5: lingyyang ($52 in chips) 
Seat 6: matiko09 ($120.94 in chips) 
Seat 7: Aalleekks ($101.50 in chips) 
Seat 8: gwwsb ($76.96 in chips) 
Seat 9: Igor DoUrden ($100 in chips) 
vano7777: posts small blind $0.50
IHouseMusic: posts big blind $1
*** HOLE CARDS ***
Dealt to matiko09 [Kh 6d]
miyashin: folds 
lingyyang: raises $2 to $3
matiko09: folds 
Aalleekks: folds 
gwwsb: folds 
Igor DoUrden: folds 
vano7777: folds 
IHouseMusic: folds 
Uncalled bet ($2) returned to lingyyang
lingyyang collected $2.50 from pot
*** SUMMARY ***
Total pot $2.50 | Rake $0 
Seat 1: vano7777 (small blind) folded before Flop
Seat 2: IHouseMusic (big blind) folded before Flop
Seat 4: miyashin folded before Flop (didn't bet)
Seat 5: lingyyang collected ($2.50)
Seat 6: matiko09 folded before Flop (didn't bet)
Seat 7: Aalleekks folded before Flop (didn't bet)
Seat 8: gwwsb folded before Flop (didn't bet)
Seat 9: Igor DoUrden (button) folded before Flop (didn't bet)





PokerStars Hand #148833452174:  Hold'em No Limit ($0.50/$1.00 USD) - 2016/02/15 11:19:50 CET [2016/02/15 5:19:50 ET]
Table 'Octans II' 9-max Seat #5 is the button
Seat 1: maxxmeister ($100 in chips) 
Seat 2: matiko09 ($244.79 in chips) 
Seat 4: Venomous100% ($161.80 in chips) 
Seat 5: AlKatrone ($123.52 in chips) 
Seat 6: er13to ($100 in chips) 
Seat 7: traficblues ($43.75 in chips) 
Seat 8: IHouseMusic ($144.93 in chips) 
Seat 9: mycka86 ($100 in chips) 
er13to: posts small blind $0.50
traficblues: posts big blind $1
Aalleekks: sits out 
*** HOLE CARDS ***
Dealt to matiko09 [8d 4s]
IHouseMusic: folds 
mycka86: folds 
maxxmeister: folds 
matiko09: folds 
Venomous100%: folds 
AlKatrone: folds 
er13to: folds 
Uncalled bet ($0.50) returned to traficblues
traficblues collected $1 from pot
traficblues: doesn't show hand 
*** SUMMARY ***
Total pot $1 | Rake $0 
Seat 1: maxxmeister folded before Flop (didn't bet)
Seat 2: matiko09 folded before Flop (didn't bet)
Seat 4: Venomous100% folded before Flop (didn't bet)
Seat 5: AlKatrone (button) folded before Flop (didn't bet)
Seat 6: er13to (small blind) folded before Flop
Seat 7: traficblues (big blind) collected ($1)
Seat 8: IHouseMusic folded before Flop (didn't bet)
Seat 9: mycka86 folded before Flop (didn't bet)





PokerStars Hand #148833453281:  Hold'em No Limit ($0.50/$1.00 USD) - 2016/02/15 11:19:52 CET [2016/02/15 5:19:52 ET]
Table 'Saldanha' 9-max Seat #3 is the button
Seat 1: mycka86 ($100 in chips) 
Seat 2: Congo Sam ($100.88 in chips) 
Seat 3: maxxmeister ($136.63 in chips) 
Seat 4: er13to ($109.34 in chips) 
Seat 5: matiko09 ($106.50 in chips) 
Seat 6: huffwag ($11.37 in chips) 
Seat 7: Venomous100% ($159.76 in chips) 
Seat 8: gabi_igna ($110.64 in chips) 
er13to: posts small blind $0.50
matiko09: posts big blind $1
*** HOLE CARDS ***
Dealt to matiko09 [Ah 9s]
huffwag: folds 
Venomous100%: folds 
gabi_igna: folds 
mycka86: folds 
Congo Sam: folds 
maxxmeister: raises $2 to $3
er13to: folds 
matiko09: raises $6.50 to $9.50
maxxmeister: folds 
Uncalled bet ($6.50) returned to matiko09
matiko09 collected $6.50 from pot
matiko09: doesn't show hand 
*** SUMMARY ***
Total pot $6.50 | Rake $0 
Seat 1: mycka86 folded before Flop (didn't bet)
Seat 2: Congo Sam folded before Flop (didn't bet)
Seat 3: maxxmeister (button) folded before Flop
Seat 4: er13to (small blind) folded before Flop
Seat 5: matiko09 (big blind) collected ($6.50)
Seat 6: huffwag folded before Flop (didn't bet)
Seat 7: Venomous100% folded before Flop (didn't bet)
Seat 8: gabi_igna folded before Flop (didn't bet)





PokerStars Hand #148833454804:  Hold'em No Limit ($0.50/$1.00 USD) - 2016/02/15 11:19:55 CET [2016/02/15 5:19:55 ET]
Table 'Gemma II' 9-max Seat #4 is the button
Seat 1: Igor DoUrden ($170.94 in chips) 
Seat 2: gabi_igna ($101.50 in chips) 
Seat 3: Venomous100% ($160.01 in chips) 
Seat 4: mycka86 ($100 in chips) 
Seat 5: PokerSash201 ($74.67 in chips) 
Seat 6: IHouseMusic ($100 in chips) 
Seat 7: AlKatrone ($121.19 in chips) 
Seat 8: Priidix ($108.89 in chips) 
Seat 9: matiko09 ($115.90 in chips) 
PokerSash201: posts small blind $0.50
IHouseMusic: posts big blind $1
*** HOLE CARDS ***
Dealt to matiko09 [As 4d]
AlKatrone: raises $2 to $3
Priidix: folds 
matiko09: folds 
Igor DoUrden: folds 
gabi_igna: folds 
Venomous100%: folds 
mycka86: folds 
PokerSash201: folds 
IHouseMusic: folds 
Uncalled bet ($2) returned to AlKatrone
AlKatrone collected $2.50 from pot
AlKatrone: doesn't show hand 
*** SUMMARY ***
Total pot $2.50 | Rake $0 
Seat 1: Igor DoUrden folded before Flop (didn't bet)
Seat 2: gabi_igna folded before Flop (didn't bet)
Seat 3: Venomous100% folded before Flop (didn't bet)
Seat 4: mycka86 (button) folded before Flop (didn't bet)
Seat 5: PokerSash201 (small blind) folded before Flop
Seat 6: IHouseMusic (big blind) folded before Flop
Seat 7: AlKatrone collected ($2.50)
Seat 8: Priidix folded before Flop (didn't bet)
Seat 9: matiko09 folded before Flop (didn't bet)





PokerStars Hand #148833457437:  Hold'em No Limit ($0.50/$1.00 USD) - 2016/02/15 11:20:01 CET [2016/02/15 5:20:01 ET]
Table 'Anteros' 9-max Seat #7 is the button
Seat 1: redacesfull ($100.31 in chips) 
Seat 2: IHouseMusic ($108.86 in chips) 
Seat 3: er13to ($109.20 in chips) 
Seat 4: misherei ($171.51 in chips) 
Seat 5: Holm1991 ($45.36 in chips) 
Seat 7: Zoubou1983 ($189.90 in chips) 
Seat 8: matiko09 ($100 in chips) 
Seat 9: mycka86 ($100 in chips) 
matiko09: posts small blind $0.50
mycka86: posts big blind $1
*** HOLE CARDS ***
Dealt to matiko09 [Js 3s]
redacesfull: folds 
IHouseMusic: raises $2 to $3
er13to: folds 
misherei: folds 
Holm1991: folds 
Zoubou1983: folds 
matiko09: folds 
mycka86: folds 
Uncalled bet ($2) returned to IHouseMusic
IHouseMusic collected $2.50 from pot
IHouseMusic: doesn't show hand 
*** SUMMARY ***
Total pot $2.50 | Rake $0 
Seat 1: redacesfull folded before Flop (didn't bet)
Seat 2: IHouseMusic collected ($2.50)
Seat 3: er13to folded before Flop (didn't bet)
Seat 4: misherei folded before Flop (didn't bet)
Seat 5: Holm1991 folded before Flop (didn't bet)
Seat 7: Zoubou1983 (button) folded before Flop (didn't bet)
Seat 8: matiko09 (small blind) folded before Flop
Seat 9: mycka86 (big blind) folded before Flop





PokerStars Hand #148833461018:  Hold'em No Limit ($0.50/$1.00 USD) - 2016/02/15 11:20:09 CET [2016/02/15 5:20:09 ET]
Table 'Octans II' 9-max Seat #6 is the button
Seat 1: maxxmeister ($100 in chips) 
Seat 2: matiko09 ($244.79 in chips) 
Seat 4: Venomous100% ($161.80 in chips) 
Seat 5: AlKatrone ($123.52 in chips) 
Seat 6: er13to ($100 in chips) 
Seat 7: traficblues ($44.25 in chips) 
Seat 8: IHouseMusic ($144.93 in chips) 
Seat 9: mycka86 ($100 in chips) 
traficblues: posts small blind $0.50
IHouseMusic: posts big blind $1
Aalleekks: sits out 
*** HOLE CARDS ***
Dealt to matiko09 [5c 9d]
mycka86: folds 
maxxmeister: folds 
matiko09: folds 
Venomous100%: folds 
AlKatrone: folds 
er13to: raises $1 to $2
traficblues: calls $1.50
IHouseMusic: folds 
*** FLOP *** [8d As 9c]
traficblues: bets $2.39
er13to: folds 
Uncalled bet ($2.39) returned to traficblues
traficblues collected $4.78 from pot
traficblues: doesn't show hand 
*** SUMMARY ***
Total pot $5 | Rake $0.22 
Board [8d As 9c]
Seat 1: maxxmeister folded before Flop (didn't bet)
Seat 2: matiko09 folded before Flop (didn't bet)
Seat 4: Venomous100% folded before Flop (didn't bet)
Seat 5: AlKatrone folded before Flop (didn't bet)
Seat 6: er13to (button) folded on the Flop
Seat 7: traficblues (small blind) collected ($4.78)
Seat 8: IHouseMusic (big blind) folded before Flop
Seat 9: mycka86 folded before Flop (didn't bet)





PokerStars Hand #148833461029:  Hold'em No Limit ($0.50/$1.00 USD) - 2016/02/15 11:20:09 CET [2016/02/15 5:20:09 ET]
Table 'Sekanina' 9-max Seat #2 is the button
Seat 2: Priidix ($179.66 in chips) 
Seat 3: gabi_igna ($100 in chips) 
Seat 4: matiko09 ($100 in chips) 
Seat 5: IHouseMusic ($126.77 in chips) 
Seat 6: vinniesmol ($250.81 in chips) 
Seat 7: mycka86 ($135.35 in chips) 
Seat 8: Venomous100% ($100.75 in chips) 
Seat 9: er13to ($100.73 in chips) 
gabi_igna: posts small blind $0.50
matiko09: posts big blind $1
*** HOLE CARDS ***
Dealt to matiko09 [7h 5d]
IHouseMusic: folds 
vinniesmol: folds 
LUTZ_11111 leaves the table
mycka86: folds 
Venomous100%: folds 
er13to: raises $2 to $3
Priidix: folds 
maxxmeister joins the table at seat #1 
gabi_igna: folds 
matiko09: folds 
Uncalled bet ($2) returned to er13to
er13to collected $2.50 from pot
*** SUMMARY ***
Total pot $2.50 | Rake $0 
Seat 2: Priidix (button) folded before Flop (didn't bet)
Seat 3: gabi_igna (small blind) folded before Flop
Seat 4: matiko09 (big blind) folded before Flop
Seat 5: IHouseMusic folded before Flop (didn't bet)
Seat 6: vinniesmol folded before Flop (didn't bet)
Seat 7: mycka86 folded before Flop (didn't bet)
Seat 8: Venomous100% folded before Flop (didn't bet)
Seat 9: er13to collected ($2.50)





PokerStars Hand #148833464018:  Hold'em No Limit ($0.50/$1.00 USD) - 2016/02/15 11:20:15 CET [2016/02/15 5:20:15 ET]
Table 'Ristenpart' 9-max Seat #1 is the button
Seat 1: vano7777 ($48.50 in chips) 
Seat 2: IHouseMusic ($116.33 in chips) 
Seat 4: miyashin ($104.42 in chips) 
Seat 5: lingyyang ($53.50 in chips) 
Seat 6: matiko09 ($120.94 in chips) 
Seat 7: Aalleekks ($101.50 in chips) 
Seat 8: gwwsb ($76.96 in chips) 
Seat 9: Igor DoUrden ($100 in chips) 
IHouseMusic: posts small blind $0.50
miyashin: posts big blind $1
*** HOLE CARDS ***
Dealt to matiko09 [Ad Ks]
lingyyang: folds 
matiko09: raises $2 to $3
Aalleekks: folds 
gwwsb: folds 
Igor DoUrden: folds 
vano7777: folds 
IHouseMusic: folds 
miyashin: folds 
Uncalled bet ($2) returned to matiko09
matiko09 collected $2.50 from pot
matiko09: doesn't show hand 
*** SUMMARY ***
Total pot $2.50 | Rake $0 
Seat 1: vano7777 (button) folded before Flop (didn't bet)
Seat 2: IHouseMusic (small blind) folded before Flop
Seat 4: miyashin (big blind) folded before Flop
Seat 5: lingyyang folded before Flop (didn't bet)
Seat 6: matiko09 collected ($2.50)
Seat 7: Aalleekks folded before Flop (didn't bet)
Seat 8: gwwsb folded before Flop (didn't bet)
Seat 9: Igor DoUrden folded before Flop (didn't bet)





PokerStars Hand #148833471091:  Hold'em No Limit ($0.50/$1.00 USD) - 2016/02/15 11:20:30 CET [2016/02/15 5:20:30 ET]
Table 'Saldanha' 9-max Seat #4 is the button
Seat 1: mycka86 ($100 in chips) 
Seat 2: Congo Sam ($100.88 in chips) 
Seat 3: maxxmeister ($133.63 in chips) 
Seat 4: er13to ($108.84 in chips) 
Seat 5: matiko09 ($110 in chips) 
Seat 6: huffwag ($11.37 in chips) 
Seat 7: Venomous100% ($159.76 in chips) 
Seat 8: gabi_igna ($110.64 in chips) 
matiko09: posts small blind $0.50
huffwag: posts big blind $1
*** HOLE CARDS ***
Dealt to matiko09 [6h 2d]
Venomous100%: folds 
gabi_igna: folds 
mycka86: folds 
Congo Sam: folds 
maxxmeister: folds 
er13to: raises $1.50 to $2.50
matiko09: folds 
huffwag: raises $8.87 to $11.37 and is all-in
er13to: folds 
Uncalled bet ($8.87) returned to huffwag
huffwag collected $5.50 from pot
huffwag: doesn't show hand 
*** SUMMARY ***
Total pot $5.50 | Rake $0 
Seat 1: mycka86 folded before Flop (didn't bet)
Seat 2: Congo Sam folded before Flop (didn't bet)
Seat 3: maxxmeister folded before Flop (didn't bet)
Seat 4: er13to (button) folded before Flop
Seat 5: matiko09 (small blind) folded before Flop
Seat 6: huffwag (big blind) collected ($5.50)
Seat 7: Venomous100% folded before Flop (didn't bet)
Seat 8: gabi_igna folded before Flop (didn't bet)





PokerStars Hand #148833470910:  Hold'em No Limit ($0.50/$1.00 USD) - 2016/02/15 11:20:30 CET [2016/02/15 5:20:30 ET]
Table 'Nata II' 9-max Seat #6 is the button
Seat 1: Priidix ($133.61 in chips) 
Seat 2: qqcom ($100 in chips) 
Seat 3: g00000se ($119.95 in chips) 
Seat 4: gabi_igna ($100 in chips) 
Seat 5: AGoodFell4 ($108.91 in chips) 
Seat 6: AlKatrone ($100 in chips) 
Seat 7: er13to ($113.40 in chips) 
Seat 9: matiko09 ($100.37 in chips) 
er13to: posts small blind $0.50
Igor DoUrden: is sitting out 
matiko09: posts big blind $1
*** HOLE CARDS ***
Dealt to matiko09 [3d 7h]
Igor DoUrden leaves the table
Priidix: raises $2 to $3
qqcom: folds 
g00000se: folds 
gabi_igna: folds 
lumen21 joins the table at seat #8 
AGoodFell4: calls $3
AlKatrone: folds 
er13to: folds 
matiko09: folds 
*** FLOP *** [4c 3h Js]
Priidix: checks 
AGoodFell4: bets $5
Priidix: calls $5
*** TURN *** [4c 3h Js] [9d]
Priidix: checks 
AGoodFell4: checks 
*** RIVER *** [4c 3h Js 9d] [7c]
Priidix: checks 
AGoodFell4: checks 
*** SHOW DOWN ***
Priidix: shows [Kd Ah] (high card Ace)
AGoodFell4: shows [3c Ac] (a pair of Threes)
AGoodFell4 collected $16.71 from pot
*** SUMMARY ***
Total pot $17.50 | Rake $0.79 
Board [4c 3h Js 9d 7c]
Seat 1: Priidix showed [Kd Ah] and lost with high card Ace
Seat 2: qqcom folded before Flop (didn't bet)
Seat 3: g00000se folded before Flop (didn't bet)
Seat 4: gabi_igna folded before Flop (didn't bet)
Seat 5: AGoodFell4 showed [3c Ac] and won ($16.71) with a pair of Threes
Seat 6: AlKatrone (button) folded before Flop (didn't bet)
Seat 7: er13to (small blind) folded before Flop
Seat 9: matiko09 (big blind) folded before Flop





PokerStars Hand #148833471368:  Hold'em No Limit ($0.25/$0.50 USD) - 2016/02/15 11:20:31 CET [2016/02/15 5:20:31 ET]
Table 'Vesta II' 9-max Seat #3 is the button
Seat 3: matiko09 ($72.45 in chips) 
Seat 4: vlad11122007 ($58.03 in chips) 
Seat 5: dndngod ($73.90 in chips) 
Seat 6: pandalapa ($50 in chips) 
Seat 7: ruyingren ($40.77 in chips) 
Seat 8: Arystan ($133.59 in chips) 
Seat 9: Aoki42 ($82.72 in chips) 
vlad11122007: posts small blind $0.25
dndngod: posts big blind $0.50
etny99: sits out 
ljryviltj: sits out 
*** HOLE CARDS ***
Dealt to matiko09 [Tc 4h]
pandalapa: raises $1 to $1.50
ruyingren: calls $1.50
Arystan: raises $3 to $4.50
Aoki42: folds 
matiko09: folds 
vlad11122007: folds 
dndngod: folds 
pandalapa: calls $3
ruyingren: calls $3
*** FLOP *** [Ks Th Jc]
pandalapa: checks 
ruyingren: checks 
Arystan: bets $13.61
pandalapa: folds 
ruyingren: folds 
Uncalled bet ($13.61) returned to Arystan
Arystan collected $13.61 from pot
Arystan: doesn't show hand 
*** SUMMARY ***
Total pot $14.25 | Rake $0.64 
Board [Ks Th Jc]
Seat 3: matiko09 (button) folded before Flop (didn't bet)
Seat 4: vlad11122007 (small blind) folded before Flop
Seat 5: dndngod (big blind) folded before Flop
Seat 6: pandalapa folded on the Flop
Seat 7: ruyingren folded on the Flop
Seat 8: Arystan collected ($13.61)
Seat 9: Aoki42 folded before Flop (didn't bet)





PokerStars Hand #148833474374:  Hold'em No Limit ($0.50/$1.00 USD) - 2016/02/15 11:20:37 CET [2016/02/15 5:20:37 ET]
Table 'Euanthe II' 9-max Seat #9 is the button
Seat 2: mahalko0925 ($87 in chips) 
Seat 3: matiko09 ($124.77 in chips) 
Seat 4: er13to ($116.45 in chips) 
Seat 5: gabi_igna ($104 in chips) 
Seat 7: vinniesmol ($221.88 in chips) 
Seat 8: Sashey2708 ($112.29 in chips) 
Seat 9: Venomous100% ($100 in chips) 
mahalko0925: posts small blind $0.50
matiko09: posts big blind $1
IHouseMusic: sits out 
*** HOLE CARDS ***
Dealt to matiko09 [2h 5d]
er13to: folds 
gabi_igna: raises $2 to $3
vinniesmol: folds 
Sashey2708: calls $3
Venomous100%: raises $9 to $12
mahalko0925: folds 
matiko09: folds 
gabi_igna: folds 
Sashey2708: calls $9
*** FLOP *** [5h 3h Td]
Sashey2708: checks 
Venomous100%: bets $12
Sashey2708: folds 
Uncalled bet ($12) returned to Venomous100%
Venomous100% collected $27.22 from pot
Venomous100%: doesn't show hand 
*** SUMMARY ***
Total pot $28.50 | Rake $1.28 
Board [5h 3h Td]
Seat 2: mahalko0925 (small blind) folded before Flop
Seat 3: matiko09 (big blind) folded before Flop
Seat 4: er13to folded before Flop (didn't bet)
Seat 5: gabi_igna folded before Flop
Seat 7: vinniesmol folded before Flop (didn't bet)
Seat 8: Sashey2708 folded on the Flop
Seat 9: Venomous100% (button) collected ($27.22)





PokerStars Hand #148833475206:  Hold'em No Limit ($0.50/$1.00 USD) - 2016/02/15 11:20:39 CET [2016/02/15 5:20:39 ET]
Table 'Anteros' 9-max Seat #8 is the button
Seat 1: redacesfull ($100.31 in chips) 
Seat 2: IHouseMusic ($110.36 in chips) 
Seat 3: er13to ($109.20 in chips) 
Seat 4: misherei ($171.51 in chips) 
Seat 5: Holm1991 ($45.36 in chips) 
Seat 7: Zoubou1983 ($189.90 in chips) 
Seat 8: matiko09 ($100 in chips) 
Seat 9: mycka86 ($100 in chips) 
mycka86: posts small blind $0.50
redacesfull: posts big blind $1
*** HOLE CARDS ***
Dealt to matiko09 [9c Jd]
IHouseMusic: folds 
er13to: folds 
misherei: calls $1
Holm1991: calls $1
Zoubou1983: calls $1
matiko09: folds 
mycka86: folds 
redacesfull: checks 
*** FLOP *** [Jh 8d 8h]
redacesfull: checks 
misherei: checks 
Holm1991: checks 
Zoubou1983: bets $1
redacesfull: calls $1
misherei: folds 
Holm1991: folds 
*** TURN *** [Jh 8d 8h] [Ac]
redacesfull: checks 
Zoubou1983: bets $1
redacesfull: folds 
Uncalled bet ($1) returned to Zoubou1983
Zoubou1983 collected $6.21 from pot
Zoubou1983: doesn't show hand 
*** SUMMARY ***
Total pot $6.50 | Rake $0.29 
Board [Jh 8d 8h Ac]
Seat 1: redacesfull (big blind) folded on the Turn
Seat 2: IHouseMusic folded before Flop (didn't bet)
Seat 3: er13to folded before Flop (didn't bet)
Seat 4: misherei folded on the Flop
Seat 5: Holm1991 folded on the Flop
Seat 7: Zoubou1983 collected ($6.21)
Seat 8: matiko09 (button) folded before Flop (didn't bet)
Seat 9: mycka86 (small blind) folded before Flop





PokerStars Hand #148833475572:  Hold'em No Limit ($0.50/$1.00 USD) - 2016/02/15 11:20:40 CET [2016/02/15 5:20:40 ET]
Table 'Ristenpart' 9-max Seat #2 is the button
Seat 1: vano7777 ($48.50 in chips) 
Seat 2: IHouseMusic ($115.83 in chips) 
Seat 4: miyashin ($103.42 in chips) 
Seat 5: lingyyang ($53.50 in chips) 
Seat 6: matiko09 ($122.44 in chips) 
Seat 7: Aalleekks ($101.50 in chips) 
Seat 8: gwwsb ($76.96 in chips) 
Seat 9: Igor DoUrden ($100 in chips) 
miyashin: posts small blind $0.50
lingyyang: posts big blind $1
*** HOLE CARDS ***
Dealt to matiko09 [6c Qs]
lumen21 joins the table at seat #3 
matiko09: folds 
Aalleekks: folds 
gwwsb: folds 
Igor DoUrden: raises $1.25 to $2.25
vano7777: folds 
IHouseMusic: folds 
miyashin: folds 
lingyyang: folds 
Uncalled bet ($1.25) returned to Igor DoUrden
Igor DoUrden collected $2.50 from pot
Igor DoUrden: doesn't show hand 
*** SUMMARY ***
Total pot $2.50 | Rake $0 
Seat 1: vano7777 folded before Flop (didn't bet)
Seat 2: IHouseMusic (button) folded before Flop (didn't bet)
Seat 4: miyashin (small blind) folded before Flop
Seat 5: lingyyang (big blind) folded before Flop
Seat 6: matiko09 folded before Flop (didn't bet)
Seat 7: Aalleekks folded before Flop (didn't bet)
Seat 8: gwwsb folded before Flop (didn't bet)
Seat 9: Igor DoUrden collected ($2.50)





PokerStars Hand #148833477142:  Hold'em No Limit ($0.50/$1.00 USD) - 2016/02/15 11:20:43 CET [2016/02/15 5:20:43 ET]
Table 'Gemma II' 9-max Seat #5 is the button
Seat 1: Igor DoUrden ($170.94 in chips) 
Seat 2: gabi_igna ($101.50 in chips) 
Seat 3: Venomous100% ($160.01 in chips) 
Seat 4: mycka86 ($100 in chips) 
Seat 5: PokerSash201 ($74.17 in chips) 
Seat 6: IHouseMusic ($100 in chips) 
Seat 7: AlKatrone ($122.69 in chips) 
Seat 8: Priidix ($108.89 in chips) 
Seat 9: matiko09 ($115.90 in chips) 
IHouseMusic: posts small blind $0.50
AlKatrone: posts big blind $1
*** HOLE CARDS ***
Dealt to matiko09 [3h 3s]
Priidix: folds 
matiko09: folds 
Igor DoUrden: folds 
gabi_igna: folds 
Venomous100%: raises $2 to $3
mycka86: folds 
PokerSash201: calls $3
IHouseMusic: folds 
AlKatrone: calls $2
*** FLOP *** [7s Qc Kd]
AlKatrone: checks 
Venomous100%: bets $5.99
PokerSash201: calls $5.99
AlKatrone: folds 
*** TURN *** [7s Qc Kd] [7d]
Venomous100%: bets $13.54
PokerSash201: folds 
Uncalled bet ($13.54) returned to Venomous100%
Venomous100% collected $20.51 from pot
Venomous100%: doesn't show hand 
*** SUMMARY ***
Total pot $21.48 | Rake $0.97 
Board [7s Qc Kd 7d]
Seat 1: Igor DoUrden folded before Flop (didn't bet)
Seat 2: gabi_igna folded before Flop (didn't bet)
Seat 3: Venomous100% collected ($20.51)
Seat 4: mycka86 folded before Flop (didn't bet)
Seat 5: PokerSash201 (button) folded on the Turn
Seat 6: IHouseMusic (small blind) folded before Flop
Seat 7: AlKatrone (big blind) folded on the Flop
Seat 8: Priidix folded before Flop (didn't bet)
Seat 9: matiko09 folded before Flop (didn't bet)





PokerStars Hand #148833477821:  Hold'em No Limit ($0.50/$1.00 USD) - 2016/02/15 11:20:45 CET [2016/02/15 5:20:45 ET]
Table 'Praecipua' 9-max Seat #3 is the button
Seat 1: er13to ($133.93 in chips) 
Seat 2: matiko09 ($100 in chips) 
Seat 3: Venomous100% ($114.82 in chips) 
Seat 4: gabi_igna ($100 in chips) 
Seat 5: huffwag ($166.65 in chips) 
Seat 6: mycka86 ($110 in chips) 
Seat 7: maxxmeister ($141.73 in chips) 
Seat 8: Ellis Ng ($36.92 in chips) 
Seat 9: AlKatrone ($101.90 in chips) 
gabi_igna: posts small blind $0.50
huffwag: posts big blind $1
*** HOLE CARDS ***
Dealt to matiko09 [Jc 7s]
mycka86: folds 
maxxmeister: folds 
Ellis Ng: folds 
AlKatrone: raises $2 to $3
er13to: folds 
matiko09: folds 
Venomous100%: calls $3
gabi_igna: folds 
huffwag: folds 
*** FLOP *** [Ac 7d Ah]
AlKatrone: checks 
Venomous100%: bets $4.73
AlKatrone: calls $4.73
*** TURN *** [Ac 7d Ah] [5h]
AlKatrone: checks 
Venomous100%: bets $10.69
AlKatrone: calls $10.69
*** RIVER *** [Ac 7d Ah 5h] [9d]
AlKatrone: checks 
Venomous100%: bets $30
AlKatrone: folds 
Uncalled bet ($30) returned to Venomous100%
Venomous100% collected $36.61 from pot
Venomous100%: doesn't show hand 
*** SUMMARY ***
Total pot $38.34 | Rake $1.73 
Board [Ac 7d Ah 5h 9d]
Seat 1: er13to folded before Flop (didn't bet)
Seat 2: matiko09 folded before Flop (didn't bet)
Seat 3: Venomous100% (button) collected ($36.61)
Seat 4: gabi_igna (small blind) folded before Flop
Seat 5: huffwag (big blind) folded before Flop
Seat 6: mycka86 folded before Flop (didn't bet)
Seat 7: maxxmeister folded before Flop (didn't bet)
Seat 8: Ellis Ng folded before Flop (didn't bet)
Seat 9: AlKatrone folded on the River





PokerStars Hand #148833479248:  Hold'em No Limit ($0.50/$1.00 USD) - 2016/02/15 11:20:48 CET [2016/02/15 5:20:48 ET]
Table 'Sekanina' 9-max Seat #3 is the button
Seat 2: Priidix ($179.66 in chips) 
Seat 3: gabi_igna ($100 in chips) 
Seat 4: matiko09 ($100 in chips) 
Seat 6: vinniesmol ($250.81 in chips) 
Seat 7: mycka86 ($135.35 in chips) 
Seat 8: Venomous100% ($100.75 in chips) 
Seat 9: er13to ($102.23 in chips) 
matiko09: posts small blind $0.50
IHouseMusic: is sitting out 
vinniesmol: posts big blind $1
*** HOLE CARDS ***
Dealt to matiko09 [Qs 7s]
IHouseMusic leaves the table
mycka86: raises $2 to $3
Venomous100%: folds 
er13to: folds 
Priidix: folds 
gabi_igna: raises $6 to $9
matiko09: folds 
vinniesmol: folds 
mycka86: raises $13 to $22
gabi_igna: folds 
Uncalled bet ($13) returned to mycka86
mycka86 collected $19.50 from pot
*** SUMMARY ***
Total pot $19.50 | Rake $0 
Seat 2: Priidix folded before Flop (didn't bet)
Seat 3: gabi_igna (button) folded before Flop
Seat 4: matiko09 (small blind) folded before Flop
Seat 6: vinniesmol (big blind) folded before Flop
Seat 7: mycka86 collected ($19.50)
Seat 8: Venomous100% folded before Flop (didn't bet)
Seat 9: er13to folded before Flop (didn't bet)





PokerStars Hand #148833479913:  Hold'em No Limit ($0.25/$0.50 USD) - 2016/02/15 11:20:49 CET [2016/02/15 5:20:49 ET]
Table 'Laertes II' 9-max Seat #8 is the button
Seat 1: etny99 ($50 in chips) 
Seat 2: beluccix ($24.21 in chips) 
Seat 4: rgar93 ($37.23 in chips) 
Seat 7: Vedpapa ($68.99 in chips) 
Seat 8: Trent444 ($45.60 in chips) 
Seat 9: matiko09 ($50.35 in chips) 
matiko09: posts small blind $0.25
etny99: posts big blind $0.50
valfan911: sits out 
Serhent: sits out 
ZonTTT: sits out 
*** HOLE CARDS ***
Dealt to matiko09 [Ac Js]
beluccix: folds 
rgar93: folds 
Vedpapa: raises $0.75 to $1.25
Trent444: calls $1.25
matiko09: raises $4.75 to $6
etny99: folds 
Vedpapa: folds 
Trent444: folds 
Uncalled bet ($4.75) returned to matiko09
matiko09 collected $4.25 from pot
matiko09: doesn't show hand 
*** SUMMARY ***
Total pot $4.25 | Rake $0 
Seat 1: etny99 (big blind) folded before Flop
Seat 2: beluccix folded before Flop (didn't bet)
Seat 4: rgar93 folded before Flop (didn't bet)
Seat 7: Vedpapa folded before Flop
Seat 8: Trent444 (button) folded before Flop
Seat 9: matiko09 (small blind) collected ($4.25)





PokerStars Hand #148833482733:  Hold'em No Limit ($0.50/$1.00 USD) - 2016/02/15 11:20:55 CET [2016/02/15 5:20:55 ET]
Table 'Octans II' 9-max Seat #7 is the button
Seat 1: maxxmeister ($100 in chips) 
Seat 2: matiko09 ($244.79 in chips) 
Seat 4: Venomous100% ($161.80 in chips) 
Seat 5: AlKatrone ($123.52 in chips) 
Seat 6: er13to ($100 in chips) 
Seat 7: traficblues ($47.03 in chips) 
Seat 8: IHouseMusic ($143.93 in chips) 
Seat 9: mycka86 ($100 in chips) 
IHouseMusic: posts small blind $0.50
mycka86: posts big blind $1
Aalleekks: sits out 
*** HOLE CARDS ***
Dealt to matiko09 [5d 7s]
maxxmeister: folds 
matiko09: folds 
Venomous100%: folds 
AlKatrone: folds 
er13to: folds 
traficblues: calls $1
IHouseMusic: raises $3 to $4
mycka86: folds 
traficblues: calls $3
*** FLOP *** [Ks Ac 4d]
IHouseMusic: checks 
traficblues: checks 
*** TURN *** [Ks Ac 4d] [9h]
IHouseMusic: checks 
traficblues: checks 
*** RIVER *** [Ks Ac 4d 9h] [2s]
IHouseMusic: bets $4.30
traficblues: raises $5.70 to $10
IHouseMusic: calls $5.70
*** SHOW DOWN ***
traficblues: shows [As 4c] (two pair, Aces and Fours)
IHouseMusic: mucks hand 
traficblues collected $27.70 from pot
*** SUMMARY ***
Total pot $29 | Rake $1.30 
Board [Ks Ac 4d 9h 2s]
Seat 1: maxxmeister folded before Flop (didn't bet)
Seat 2: matiko09 folded before Flop (didn't bet)
Seat 4: Venomous100% folded before Flop (didn't bet)
Seat 5: AlKatrone folded before Flop (didn't bet)
Seat 6: er13to folded before Flop (didn't bet)
Seat 7: traficblues (button) showed [As 4c] and won ($27.70) with two pair, Aces and Fours
Seat 8: IHouseMusic (small blind) mucked [Ts Kc]
Seat 9: mycka86 (big blind) folded before Flop





PokerStars Hand #148833491371:  Hold'em No Limit ($0.50/$1.00 USD) - 2016/02/15 11:21:13 CET [2016/02/15 5:21:13 ET]
Table 'Ristenpart' 9-max Seat #4 is the button
Seat 1: vano7777 ($48.50 in chips) 
Seat 2: IHouseMusic ($115.83 in chips) 
Seat 4: miyashin ($102.92 in chips) 
Seat 5: lingyyang ($52.50 in chips) 
Seat 6: matiko09 ($122.44 in chips) 
Seat 7: Aalleekks ($101.50 in chips) 
Seat 8: gwwsb ($76.96 in chips) 
Seat 9: Igor DoUrden ($101.50 in chips) 
lingyyang: posts small blind $0.50
matiko09: posts big blind $1
lumen21: sits out 
*** HOLE CARDS ***
Dealt to matiko09 [8d Ac]
Aalleekks: folds 
gwwsb: calls $1
Igor DoUrden: calls $1
vano7777: raises $5.50 to $6.50
IHouseMusic: folds 
miyashin: folds 
lingyyang: folds 
matiko09: folds 
gwwsb: calls $5.50
Igor DoUrden: folds 
*** FLOP *** [5c 2c Ts]
gwwsb: checks 
vano7777: checks 
*** TURN *** [5c 2c Ts] [5s]
gwwsb: bets $7.40
vano7777: calls $7.40
*** RIVER *** [5c 2c Ts 5s] [9s]
gwwsb: bets $14.47
vano7777: folds 
Uncalled bet ($14.47) returned to gwwsb
gwwsb collected $28.94 from pot
gwwsb: doesn't show hand 
*** SUMMARY ***
Total pot $30.30 | Rake $1.36 
Board [5c 2c Ts 5s 9s]
Seat 1: vano7777 folded on the River
Seat 2: IHouseMusic folded before Flop (didn't bet)
Seat 4: miyashin (button) folded before Flop (didn't bet)
Seat 5: lingyyang (small blind) folded before Flop
Seat 6: matiko09 (big blind) folded before Flop
Seat 7: Aalleekks folded before Flop (didn't bet)
Seat 8: gwwsb collected ($28.94)
Seat 9: Igor DoUrden folded before Flop





PokerStars Hand #148833492015:  Hold'em No Limit ($0.25/$0.50 USD) - 2016/02/15 11:21:15 CET [2016/02/15 5:21:15 ET]
Table 'Vesta II' 9-max Seat #4 is the button
Seat 3: matiko09 ($72.45 in chips) 
Seat 4: vlad11122007 ($57.78 in chips) 
Seat 5: dndngod ($73.40 in chips) 
Seat 6: pandalapa ($50 in chips) 
Seat 7: ruyingren ($36.27 in chips) 
Seat 8: Arystan ($142.70 in chips) 
Seat 9: Aoki42 ($82.72 in chips) 
dndngod: posts small blind $0.25
pandalapa: posts big blind $0.50
etny99: sits out 
ljryviltj: sits out 
*** HOLE CARDS ***
Dealt to matiko09 [Ks 8h]
ruyingren: folds 
Arystan: folds 
Aoki42: raises $1 to $1.50
matiko09: folds 
vlad11122007: folds 
dndngod: folds 
pandalapa: calls $1
*** FLOP *** [8d Ah 6h]
pandalapa: checks 
Aoki42: checks 
*** TURN *** [8d Ah 6h] [2d]
pandalapa: checks 
Aoki42: checks 
*** RIVER *** [8d Ah 6h 2d] [5d]
pandalapa: checks 
Aoki42: checks 
*** SHOW DOWN ***
pandalapa: shows [9c 9d] (a pair of Nines)
Aoki42: mucks hand 
pandalapa collected $3.10 from pot
*** SUMMARY ***
Total pot $3.25 | Rake $0.15 
Board [8d Ah 6h 2d 5d]
Seat 3: matiko09 folded before Flop (didn't bet)
Seat 4: vlad11122007 (button) folded before Flop (didn't bet)
Seat 5: dndngod (small blind) folded before Flop
Seat 6: pandalapa (big blind) showed [9c 9d] and won ($3.10) with a pair of Nines
Seat 7: ruyingren folded before Flop (didn't bet)
Seat 8: Arystan folded before Flop (didn't bet)
Seat 9: Aoki42 mucked [4s 4h]





PokerStars Hand #148833496572:  Hold'em No Limit ($0.50/$1.00 USD) - 2016/02/15 11:21:25 CET [2016/02/15 5:21:25 ET]
Table 'Corvus III' 9-max Seat #9 is the button
Seat 2: mzsportline ($97.60 in chips) 
Seat 3: VanDobeln ($241 in chips) 
Seat 4: goransyruvka ($110.76 in chips) 
Seat 6: Priidix ($157.48 in chips) 
Seat 7: matiko09 ($290.80 in chips) 
Seat 8: redacesfull ($244.98 in chips) 
Seat 9: er13to ($102.52 in chips) 
pk4DW will be allowed to play after the button
mzsportline: posts small blind $0.50
VanDobeln: posts big blind $1
mzsportline: posts the ante $0.20
VanDobeln: posts the ante $0.20
goransyruvka: posts the ante $0.20
Priidix: posts the ante $0.20
matiko09: posts the ante $0.20
redacesfull: posts the ante $0.20
er13to: posts the ante $0.20
*** HOLE CARDS ***
Dealt to matiko09 [9d 4c]
goransyruvka: raises $3.90 to $4.90
Priidix: folds 
matiko09: folds 
redacesfull: folds 
er13to: folds 
mzsportline: folds 
VanDobeln: folds 
Uncalled bet ($3.90) returned to goransyruvka
goransyruvka collected $3.90 from pot
goransyruvka: doesn't show hand 
*** SUMMARY ***
Total pot $3.90 | Rake $0 
Seat 2: mzsportline (small blind) folded before Flop
Seat 3: VanDobeln (big blind) folded before Flop
Seat 4: goransyruvka collected ($3.90)
Seat 6: Priidix folded before Flop (didn't bet)
Seat 7: matiko09 folded before Flop (didn't bet)
Seat 8: redacesfull folded before Flop (didn't bet)
Seat 9: er13to (button) folded before Flop (didn't bet)





PokerStars Hand #148833498613:  Hold'em No Limit ($0.50/$1.00 USD) - 2016/02/15 11:21:29 CET [2016/02/15 5:21:29 ET]
Table 'Saldanha' 9-max Seat #5 is the button
Seat 1: mycka86 ($100 in chips) 
Seat 2: Congo Sam ($100.88 in chips) 
Seat 3: maxxmeister ($133.63 in chips) 
Seat 4: er13to ($106.34 in chips) 
Seat 5: matiko09 ($109.50 in chips) 
Seat 6: huffwag ($14.37 in chips) 
Seat 7: Venomous100% ($159.76 in chips) 
Seat 8: gabi_igna ($110.64 in chips) 
huffwag: posts small blind $0.50
Venomous100%: posts big blind $1
*** HOLE CARDS ***
Dealt to matiko09 [7d 6h]
gabi_igna: folds 
mycka86: folds 
Congo Sam: folds 
maxxmeister: folds 
er13to: folds 
matiko09: folds 
huffwag: folds 
Uncalled bet ($0.50) returned to Venomous100%
Venomous100% collected $1 from pot
Venomous100%: doesn't show hand 
*** SUMMARY ***
Total pot $1 | Rake $0 
Seat 1: mycka86 folded before Flop (didn't bet)
Seat 2: Congo Sam folded before Flop (didn't bet)
Seat 3: maxxmeister folded before Flop (didn't bet)
Seat 4: er13to folded before Flop (didn't bet)
Seat 5: matiko09 (button) folded before Flop (didn't bet)
Seat 6: huffwag (small blind) folded before Flop
Seat 7: Venomous100% (big blind) collected ($1)
Seat 8: gabi_igna folded before Flop (didn't bet)





PokerStars Hand #148833505541:  Hold'em No Limit ($0.50/$1.00 USD) - 2016/02/15 11:21:44 CET [2016/02/15 5:21:44 ET]
Table 'Saldanha' 9-max Seat #6 is the button
Seat 1: mycka86 ($100 in chips) 
Seat 2: Congo Sam ($100.88 in chips) 
Seat 3: maxxmeister ($133.63 in chips) 
Seat 4: er13to ($106.34 in chips) 
Seat 5: matiko09 ($109.50 in chips) 
Seat 6: huffwag ($13.87 in chips) 
Seat 7: Venomous100% ($160.26 in chips) 
Seat 8: gabi_igna ($110.64 in chips) 
Venomous100%: posts small blind $0.50
gabi_igna: posts big blind $1
*** HOLE CARDS ***
Dealt to matiko09 [2c Ks]
mycka86: folds 
Congo Sam: folds 
maxxmeister: folds 
er13to: folds 
matiko09: folds 
huffwag: raises $1 to $2
Venomous100%: raises $7 to $9
gabi_igna: folds 
huffwag: raises $4.87 to $13.87 and is all-in
Venomous100%: calls $4.87
*** FLOP *** [Ah Qd Td]
*** TURN *** [Ah Qd Td] [Kc]
*** RIVER *** [Ah Qd Td Kc] [2d]
*** SHOW DOWN ***
Venomous100%: shows [9s 9d] (a pair of Nines)
huffwag: shows [Ad Kh] (two pair, Aces and Kings)
huffwag collected $27.45 from pot
*** SUMMARY ***
Total pot $28.74 | Rake $1.29 
Board [Ah Qd Td Kc 2d]
Seat 1: mycka86 folded before Flop (didn't bet)
Seat 2: Congo Sam folded before Flop (didn't bet)
Seat 3: maxxmeister folded before Flop (didn't bet)
Seat 4: er13to folded before Flop (didn't bet)
Seat 5: matiko09 folded before Flop (didn't bet)
Seat 6: huffwag (button) showed [Ad Kh] and won ($27.45) with two pair, Aces and Kings
Seat 7: Venomous100% (small blind) showed [9s 9d] and lost with a pair of Nines
Seat 8: gabi_igna (big blind) folded before Flop





PokerStars Hand #148833507678:  Hold'em No Limit (€0.50/€1.00 EUR) - 2016/02/15 11:21:48 CET [2016/02/15 5:21:48 ET]
Table 'Ganesa II' 9-max Seat #7 is the button
Seat 1: AARON1953 (€79 in chips) 
Seat 2: maxxmeister (€103.21 in chips) 
Seat 3: BuBu 0187 (€74.84 in chips) 
Seat 4: Sreshta222 (€132.33 in chips) 
Seat 5: vano7777 (€71.24 in chips) 
Seat 6: matiko09 (€109.58 in chips) 
Seat 7: er13to (€117.50 in chips) 
Seat 8: mycka86 (€100 in chips) 
Seat 9: Priidix (€100 in chips) 
mycka86: posts small blind €0.50
Priidix: posts big blind €1
*** HOLE CARDS ***
Dealt to matiko09 [Jd 8c]
AARON1953: calls €1
maxxmeister: raises €1 to €2
BuBu 0187: folds 
Sreshta222: folds 
vano7777: calls €2
matiko09: folds 
er13to: folds 
mycka86: folds 
Priidix: folds 
AARON1953: calls €1
*** FLOP *** [6h Js 6c]
AARON1953: checks 
maxxmeister: bets €4.40
vano7777: folds 
AARON1953: folds 
Uncalled bet (€4.40) returned to maxxmeister
maxxmeister collected €7.16 from pot
maxxmeister: doesn't show hand 
*** SUMMARY ***
Total pot €7.50 | Rake €0.34 
Board [6h Js 6c]
Seat 1: AARON1953 folded on the Flop
Seat 2: maxxmeister collected (€7.16)
Seat 3: BuBu 0187 folded before Flop (didn't bet)
Seat 4: Sreshta222 folded before Flop (didn't bet)
Seat 5: vano7777 folded on the Flop
Seat 6: matiko09 folded before Flop (didn't bet)
Seat 7: er13to (button) folded before Flop (didn't bet)
Seat 8: mycka86 (small blind) folded before Flop
Seat 9: Priidix (big blind) folded before Flop





PokerStars Hand #148833507582:  Hold'em No Limit ($0.25/$0.50 USD) - 2016/02/15 11:21:48 CET [2016/02/15 5:21:48 ET]
Table 'Laertes II' 9-max Seat #9 is the button
Seat 1: etny99 ($50 in chips) 
Seat 2: beluccix ($24.21 in chips) 
Seat 4: rgar93 ($37.23 in chips) 
Seat 7: Vedpapa ($67.74 in chips) 
Seat 8: Trent444 ($44.35 in chips) 
Seat 9: matiko09 ($53.35 in chips) 
etny99: posts small blind $0.25
beluccix: posts big blind $0.50
valfan911: sits out 
Serhent: sits out 
ZonTTT: sits out 
*** HOLE CARDS ***
Dealt to matiko09 [6h Td]
rgar93: raises $0.50 to $1
Vedpapa: folds 
Trent444: calls $1
matiko09: folds 
etny99: folds 
beluccix: folds 
*** FLOP *** [2s Kd Ts]
rgar93: bets $1.31
Trent444: folds 
Uncalled bet ($1.31) returned to rgar93
rgar93 collected $2.63 from pot
rgar93: doesn't show hand 
*** SUMMARY ***
Total pot $2.75 | Rake $0.12 
Board [2s Kd Ts]
Seat 1: etny99 (small blind) folded before Flop
Seat 2: beluccix (big blind) folded before Flop
Seat 4: rgar93 collected ($2.63)
Seat 7: Vedpapa folded before Flop (didn't bet)
Seat 8: Trent444 folded on the Flop
Seat 9: matiko09 (button) folded before Flop (didn't bet)





PokerStars Hand #148833509275:  Hold'em No Limit ($0.50/$1.00 USD) - 2016/02/15 11:21:52 CET [2016/02/15 5:21:52 ET]
Table 'Corvus III' 9-max Seat #2 is the button
Seat 1: pk4DW ($130.02 in chips) 
Seat 2: mzsportline ($96.90 in chips) 
Seat 3: VanDobeln ($239.80 in chips) 
Seat 4: goransyruvka ($113.46 in chips) 
Seat 6: Priidix ($157.28 in chips) 
Seat 7: matiko09 ($290.60 in chips) 
Seat 8: redacesfull ($244.78 in chips) 
Seat 9: er13to ($102.32 in chips) 
VanDobeln: posts small blind $0.50
goransyruvka: posts big blind $1
pk4DW: posts big blind $1
pk4DW: posts the ante $0.20
mzsportline: posts the ante $0.20
VanDobeln: posts the ante $0.20
goransyruvka: posts the ante $0.20
Priidix: posts the ante $0.20
matiko09: posts the ante $0.20
redacesfull: posts the ante $0.20
er13to: posts the ante $0.20
*** HOLE CARDS ***
Dealt to matiko09 [6d Qd]
Priidix: folds 
matiko09: folds 
redacesfull: folds 
er13to: folds 
pk4DW: checks 
mzsportline: folds 
VanDobeln: calls $0.50
goransyruvka: checks 
*** FLOP *** [Qc 7d Js]
VanDobeln: bets $3
goransyruvka: calls $3
pk4DW: folds 
*** TURN *** [Qc 7d Js] [3s]
VanDobeln: checks 
goransyruvka: checks 
*** RIVER *** [Qc 7d Js 3s] [2d]
VanDobeln: bets $7.59
goransyruvka: folds 
Uncalled bet ($7.59) returned to VanDobeln
VanDobeln collected $10.12 from pot
VanDobeln: doesn't show hand 
*** SUMMARY ***
Total pot $10.60 | Rake $0.48 
Board [Qc 7d Js 3s 2d]
Seat 1: pk4DW folded on the Flop
Seat 2: mzsportline (button) folded before Flop (didn't bet)
Seat 3: VanDobeln (small blind) collected ($10.12)
Seat 4: goransyruvka (big blind) folded on the River
Seat 6: Priidix folded before Flop (didn't bet)
Seat 7: matiko09 folded before Flop (didn't bet)
Seat 8: redacesfull folded before Flop (didn't bet)
Seat 9: er13to folded before Flop (didn't bet)





PokerStars Hand #148833513504:  Hold'em No Limit ($0.50/$1.00 USD) - 2016/02/15 11:22:01 CET [2016/02/15 5:22:01 ET]
Table 'Anteros' 9-max Seat #9 is the button
Seat 1: redacesfull ($100 in chips) 
Seat 2: IHouseMusic ($110.36 in chips) 
Seat 3: er13to ($109.20 in chips) 
Seat 4: misherei ($170.51 in chips) 
Seat 5: Holm1991 ($44.36 in chips) 
Seat 7: Zoubou1983 ($194.11 in chips) 
Seat 8: matiko09 ($100 in chips) 
Seat 9: mycka86 ($100 in chips) 
redacesfull: posts small blind $0.50
IHouseMusic: posts big blind $1
*** HOLE CARDS ***
Dealt to matiko09 [Ac 5s]
er13to: folds 
misherei: folds 
Holm1991: folds 
Zoubou1983: folds 
matiko09: folds 
mycka86: raises $1.10 to $2.10
redacesfull: folds 
IHouseMusic: calls $1.10
*** FLOP *** [Jh 9h 3c]
IHouseMusic: checks 
mycka86: bets $3.30
IHouseMusic: calls $3.30
*** TURN *** [Jh 9h 3c] [8c]
IHouseMusic: checks 
mycka86: checks 
*** RIVER *** [Jh 9h 3c 8c] [Th]
IHouseMusic: checks 
mycka86: checks 
*** SHOW DOWN ***
IHouseMusic: shows [7s 7c] (a straight, Seven to Jack)
mycka86: mucks hand 
IHouseMusic collected $10.79 from pot
*** SUMMARY ***
Total pot $11.30 | Rake $0.51 
Board [Jh 9h 3c 8c Th]
Seat 1: redacesfull (small blind) folded before Flop
Seat 2: IHouseMusic (big blind) showed [7s 7c] and won ($10.79) with a straight, Seven to Jack
Seat 3: er13to folded before Flop (didn't bet)
Seat 4: misherei folded before Flop (didn't bet)
Seat 5: Holm1991 folded before Flop (didn't bet)
Seat 7: Zoubou1983 folded before Flop (didn't bet)
Seat 8: matiko09 folded before Flop (didn't bet)
Seat 9: mycka86 (button) mucked [Ts Js]





PokerStars Hand #148833514815:  Hold'em No Limit ($0.50/$1.00 USD) - 2016/02/15 11:22:03 CET [2016/02/15 5:22:03 ET]
Table 'Sekanina' 9-max Seat #4 is the button
Seat 2: Priidix ($179.66 in chips) 
Seat 3: gabi_igna ($100 in chips) 
Seat 4: matiko09 ($100 in chips) 
Seat 6: vinniesmol ($249.81 in chips) 
Seat 7: mycka86 ($145.85 in chips) 
Seat 8: Venomous100% ($100.75 in chips) 
Seat 9: er13to ($102.23 in chips) 
vinniesmol: posts small blind $0.50
mycka86: posts big blind $1
*** HOLE CARDS ***
Dealt to matiko09 [Kh 7d]
Venomous100%: folds 
er13to: folds 
Priidix: folds 
gabi_igna: folds 
matiko09: folds 
vinniesmol: raises $2 to $3
mycka86: folds 
Uncalled bet ($2) returned to vinniesmol
vinniesmol collected $2 from pot
*** SUMMARY ***
Total pot $2 | Rake $0 
Seat 2: Priidix folded before Flop (didn't bet)
Seat 3: gabi_igna folded before Flop (didn't bet)
Seat 4: matiko09 (button) folded before Flop (didn't bet)
Seat 6: vinniesmol (small blind) collected ($2)
Seat 7: mycka86 (big blind) folded before Flop
Seat 8: Venomous100% folded before Flop (didn't bet)
Seat 9: er13to folded before Flop (didn't bet)





PokerStars Hand #148833515689:  Hold'em No Limit ($0.50/$1.00 USD) - 2016/02/15 11:22:05 CET [2016/02/15 5:22:05 ET]
Table 'Nata II' 9-max Seat #7 is the button
Seat 1: Priidix ($125.61 in chips) 
Seat 2: qqcom ($100 in chips) 
Seat 3: g00000se ($119.95 in chips) 
Seat 4: gabi_igna ($100 in chips) 
Seat 5: AGoodFell4 ($117.62 in chips) 
Seat 6: AlKatrone ($100 in chips) 
Seat 7: er13to ($112.90 in chips) 
Seat 9: matiko09 ($100 in chips) 
lumen21 will be allowed to play after the button
matiko09: posts small blind $0.50
Priidix: posts big blind $1
*** HOLE CARDS ***
Dealt to matiko09 [Ad 2c]
qqcom: folds 
g00000se: folds 
gabi_igna: folds 
AGoodFell4: folds 
AlKatrone: folds 
er13to: folds 
matiko09: folds 
Uncalled bet ($0.50) returned to Priidix
Priidix collected $1 from pot
Priidix: doesn't show hand 
*** SUMMARY ***
Total pot $1 | Rake $0 
Seat 1: Priidix (big blind) collected ($1)
Seat 2: qqcom folded before Flop (didn't bet)
Seat 3: g00000se folded before Flop (didn't bet)
Seat 4: gabi_igna folded before Flop (didn't bet)
Seat 5: AGoodFell4 folded before Flop (didn't bet)
Seat 6: AlKatrone folded before Flop (didn't bet)
Seat 7: er13to (button) folded before Flop (didn't bet)
Seat 9: matiko09 (small blind) folded before Flop





PokerStars Hand #148833516854:  Hold'em No Limit ($0.50/$1.00 USD) - 2016/02/15 11:22:08 CET [2016/02/15 5:22:08 ET]
Table 'Ristenpart' 9-max Seat #5 is the button
Seat 1: vano7777 ($40 in chips) 
Seat 2: IHouseMusic ($115.83 in chips) 
Seat 4: miyashin ($102.92 in chips) 
Seat 5: lingyyang ($52 in chips) 
Seat 6: matiko09 ($121.44 in chips) 
Seat 7: Aalleekks ($101.50 in chips) 
Seat 8: gwwsb ($92 in chips) 
Seat 9: Igor DoUrden ($100.50 in chips) 
matiko09: posts small blind $0.50
Aalleekks: posts big blind $1
lumen21: sits out 
*** HOLE CARDS ***
Dealt to matiko09 [4c 7s]
gwwsb: folds 
Igor DoUrden: folds 
vano7777: folds 
IHouseMusic: folds 
miyashin: folds 
lingyyang: raises $1 to $2
matiko09: folds 
Aalleekks: folds 
Uncalled bet ($1) returned to lingyyang
lingyyang collected $2.50 from pot
lingyyang: doesn't show hand 
*** SUMMARY ***
Total pot $2.50 | Rake $0 
Seat 1: vano7777 folded before Flop (didn't bet)
Seat 2: IHouseMusic folded before Flop (didn't bet)
Seat 4: miyashin folded before Flop (didn't bet)
Seat 5: lingyyang (button) collected ($2.50)
Seat 6: matiko09 (small blind) folded before Flop
Seat 7: Aalleekks (big blind) folded before Flop
Seat 8: gwwsb folded before Flop (didn't bet)
Seat 9: Igor DoUrden folded before Flop (didn't bet)





PokerStars Hand #148833520176:  Hold'em No Limit ($0.50/$1.00 USD) - 2016/02/15 11:22:15 CET [2016/02/15 5:22:15 ET]
Table 'Saldanha' 9-max Seat #7 is the button
Seat 1: mycka86 ($100 in chips) 
Seat 2: Congo Sam ($100.88 in chips) 
Seat 3: maxxmeister ($133.63 in chips) 
Seat 4: er13to ($106.34 in chips) 
Seat 5: matiko09 ($109.50 in chips) 
Seat 6: huffwag ($27.45 in chips) 
Seat 7: Venomous100% ($146.39 in chips) 
Seat 8: gabi_igna ($109.64 in chips) 
gabi_igna: posts small blind $0.50
mycka86: posts big blind $1
*** HOLE CARDS ***
Dealt to matiko09 [7s 6c]
Congo Sam: folds 
maxxmeister: folds 
er13to: folds 
matiko09: folds 
huffwag: folds 
Venomous100%: raises $1 to $2
gabi_igna: folds 
mycka86: folds 
Uncalled bet ($1) returned to Venomous100%
Venomous100% collected $2.50 from pot
Venomous100%: doesn't show hand 
*** SUMMARY ***
Total pot $2.50 | Rake $0 
Seat 1: mycka86 (big blind) folded before Flop
Seat 2: Congo Sam folded before Flop (didn't bet)
Seat 3: maxxmeister folded before Flop (didn't bet)
Seat 4: er13to folded before Flop (didn't bet)
Seat 5: matiko09 folded before Flop (didn't bet)
Seat 6: huffwag folded before Flop (didn't bet)
Seat 7: Venomous100% (button) collected ($2.50)
Seat 8: gabi_igna (small blind) folded before Flop





PokerStars Hand #148833521807:  Hold'em No Limit ($0.50/$1.00 USD) - 2016/02/15 11:22:18 CET [2016/02/15 5:22:18 ET]
Table 'Sekanina' 9-max Seat #6 is the button
Seat 2: Priidix ($179.66 in chips) 
Seat 3: gabi_igna ($100 in chips) 
Seat 4: matiko09 ($100 in chips) 
Seat 6: vinniesmol ($250.81 in chips) 
Seat 7: mycka86 ($144.85 in chips) 
Seat 8: Venomous100% ($100.75 in chips) 
Seat 9: er13to ($102.23 in chips) 
mycka86: posts small blind $0.50
Venomous100%: posts big blind $1
*** HOLE CARDS ***
Dealt to matiko09 [3c 7c]
er13to: folds 
Priidix: folds 
gabi_igna: raises $2 to $3
matiko09: folds 
vinniesmol: folds 
dv3491 joins the table at seat #5 
mycka86: folds 
Venomous100%: folds 
Uncalled bet ($2) returned to gabi_igna
gabi_igna collected $2.50 from pot
gabi_igna: doesn't show hand 
*** SUMMARY ***
Total pot $2.50 | Rake $0 
Seat 2: Priidix folded before Flop (didn't bet)
Seat 3: gabi_igna collected ($2.50)
Seat 4: matiko09 folded before Flop (didn't bet)
Seat 6: vinniesmol (button) folded before Flop (didn't bet)
Seat 7: mycka86 (small blind) folded before Flop
Seat 8: Venomous100% (big blind) folded before Flop
Seat 9: er13to folded before Flop (didn't bet)





PokerStars Hand #148833524058:  Hold'em No Limit ($0.50/$1.00 USD) - 2016/02/15 11:22:23 CET [2016/02/15 5:22:23 ET]
Table 'Octans II' 9-max Seat #8 is the button
Seat 2: matiko09 ($244.79 in chips) 
Seat 4: Venomous100% ($161.80 in chips) 
Seat 5: AlKatrone ($123.52 in chips) 
Seat 6: er13to ($100 in chips) 
Seat 7: traficblues ($60.73 in chips) 
Seat 8: IHouseMusic ($129.93 in chips) 
Seat 9: mycka86 ($100 in chips) 
mycka86: posts small blind $0.50
matiko09: posts big blind $1
Aalleekks: sits out 
*** HOLE CARDS ***
Dealt to matiko09 [4s Jc]
Venomous100%: folds 
AlKatrone: folds 
er13to: folds 
traficblues: calls $1
IHouseMusic: folds 
mycka86: folds 
matiko09: checks 
*** FLOP *** [As Jd Qs]
matiko09: checks 
traficblues: checks 
*** TURN *** [As Jd Qs] [Ac]
matiko09: checks 
traficblues: checks 
*** RIVER *** [As Jd Qs Ac] [3h]
matiko09: checks 
traficblues: checks 
*** SHOW DOWN ***
matiko09: shows [4s Jc] (two pair, Aces and Jacks)
traficblues: mucks hand 
matiko09 collected $2.39 from pot
*** SUMMARY ***
Total pot $2.50 | Rake $0.11 
Board [As Jd Qs Ac 3h]
Seat 2: matiko09 (big blind) showed [4s Jc] and won ($2.39) with two pair, Aces and Jacks
Seat 4: Venomous100% folded before Flop (didn't bet)
Seat 5: AlKatrone folded before Flop (didn't bet)
Seat 6: er13to folded before Flop (didn't bet)
Seat 7: traficblues mucked [Ks 2h]
Seat 8: IHouseMusic (button) folded before Flop (didn't bet)
Seat 9: mycka86 (small blind) folded before Flop





PokerStars Hand #148833525749:  Hold'em No Limit ($0.25/$0.50 USD) - 2016/02/15 11:22:27 CET [2016/02/15 5:22:27 ET]
Table 'Vesta II' 9-max Seat #5 is the button
Seat 3: matiko09 ($72.45 in chips) 
Seat 4: vlad11122007 ($57.78 in chips) 
Seat 5: dndngod ($73.15 in chips) 
Seat 6: pandalapa ($51.60 in chips) 
Seat 7: ruyingren ($36.27 in chips) 
Seat 8: Arystan ($142.70 in chips) 
Seat 9: Aoki42 ($81.22 in chips) 
pandalapa: posts small blind $0.25
ruyingren: posts big blind $0.50
etny99: sits out 
ljryviltj: sits out 
*** HOLE CARDS ***
Dealt to matiko09 [Qs Qd]
Arystan: folds 
Aoki42: folds 
matiko09: raises $1 to $1.50
vlad11122007: folds 
dndngod: folds 
pandalapa: folds 
ruyingren: calls $1
*** FLOP *** [8d Js 2s]
ruyingren: bets $1.55
matiko09: raises $3.95 to $5.50
ruyingren: calls $3.95
*** TURN *** [8d Js 2s] [Qh]
ruyingren: bets $6.80
matiko09: raises $7.70 to $14.50
ruyingren: calls $7.70
*** RIVER *** [8d Js 2s Qh] [Ts]
ruyingren: bets $14.77 and is all-in
matiko09: calls $14.77
*** SHOW DOWN ***
ruyingren: shows [9d 7s] (a straight, Eight to Queen)
matiko09: mucks hand 
ruyingren collected $70.29 from pot
*** SUMMARY ***
Total pot $72.79 | Rake $2.50 
Board [8d Js 2s Qh Ts]
Seat 3: matiko09 mucked [Qs Qd]
Seat 4: vlad11122007 folded before Flop (didn't bet)
Seat 5: dndngod (button) folded before Flop (didn't bet)
Seat 6: pandalapa (small blind) folded before Flop
Seat 7: ruyingren (big blind) showed [9d 7s] and won ($70.29) with a straight, Eight to Queen
Seat 8: Arystan folded before Flop (didn't bet)
Seat 9: Aoki42 folded before Flop (didn't bet)





PokerStars Hand #148833526214:  Hold'em No Limit ($0.50/$1.00 USD) - 2016/02/15 11:22:28 CET [2016/02/15 5:22:28 ET]
Table 'Nata II' 9-max Seat #9 is the button
Seat 1: Priidix ($126.11 in chips) 
Seat 2: qqcom ($100 in chips) 
Seat 3: g00000se ($119.95 in chips) 
Seat 4: gabi_igna ($100 in chips) 
Seat 5: AGoodFell4 ($117.62 in chips) 
Seat 6: AlKatrone ($100 in chips) 
Seat 7: er13to ($112.90 in chips) 
Seat 9: matiko09 ($100 in chips) 
Priidix: posts small blind $0.50
qqcom: posts big blind $1
lumen21: sits out 
*** HOLE CARDS ***
Dealt to matiko09 [2s 4d]
g00000se: folds 
gabi_igna: folds 
AGoodFell4: folds 
AlKatrone: folds 
er13to: raises $1.50 to $2.50
matiko09: folds 
Priidix: folds 
qqcom: calls $1.50
*** FLOP *** [7h Td 8s]
qqcom: checks 
er13to: bets $4.04
qqcom: folds 
Uncalled bet ($4.04) returned to er13to
er13to collected $5.25 from pot
er13to: doesn't show hand 
*** SUMMARY ***
Total pot $5.50 | Rake $0.25 
Board [7h Td 8s]
Seat 1: Priidix (small blind) folded before Flop
Seat 2: qqcom (big blind) folded on the Flop
Seat 3: g00000se folded before Flop (didn't bet)
Seat 4: gabi_igna folded before Flop (didn't bet)
Seat 5: AGoodFell4 folded before Flop (didn't bet)
Seat 6: AlKatrone folded before Flop (didn't bet)
Seat 7: er13to collected ($5.25)
Seat 9: matiko09 (button) folded before Flop (didn't bet)





PokerStars Hand #148833528475:  Hold'em No Limit ($0.25/$0.50 USD) - 2016/02/15 11:22:33 CET [2016/02/15 5:22:33 ET]
Table 'Laertes II' 9-max Seat #1 is the button
Seat 1: etny99 ($50 in chips) 
Seat 2: beluccix ($24.21 in chips) 
Seat 3: valfan911 ($50 in chips) 
Seat 4: rgar93 ($38.86 in chips) 
Seat 7: Vedpapa ($67.74 in chips) 
Seat 8: Trent444 ($43.35 in chips) 
Seat 9: matiko09 ($53.35 in chips) 
beluccix: posts small blind $0.25
valfan911: posts big blind $0.50
Serhent: sits out 
ZonTTT: sits out 
*** HOLE CARDS ***
Dealt to matiko09 [3s Kh]
rgar93: folds 
Vedpapa: folds 
Trent444: folds 
matiko09: folds 
etny99: raises $0.50 to $1
beluccix: folds 
valfan911: raises $2 to $3
etny99: folds 
Uncalled bet ($2) returned to valfan911
valfan911 collected $2.25 from pot
valfan911: doesn't show hand 
*** SUMMARY ***
Total pot $2.25 | Rake $0 
Seat 1: etny99 (button) folded before Flop
Seat 2: beluccix (small blind) folded before Flop
Seat 3: valfan911 (big blind) collected ($2.25)
Seat 4: rgar93 folded before Flop (didn't bet)
Seat 7: Vedpapa folded before Flop (didn't bet)
Seat 8: Trent444 folded before Flop (didn't bet)
Seat 9: matiko09 folded before Flop (didn't bet)





PokerStars Hand #148833529616:  Hold'em No Limit ($0.50/$1.00 USD) - 2016/02/15 11:22:35 CET [2016/02/15 5:22:35 ET]
Table 'Corvus III' 9-max Seat #3 is the button
Seat 1: pk4DW ($128.82 in chips) 
Seat 2: mzsportline ($96.70 in chips) 
Seat 3: VanDobeln ($245.72 in chips) 
Seat 4: goransyruvka ($109.26 in chips) 
Seat 6: Priidix ($157.08 in chips) 
Seat 7: matiko09 ($290.40 in chips) 
Seat 8: redacesfull ($244.58 in chips) 
Seat 9: er13to ($102.12 in chips) 
goransyruvka: posts small blind $0.50
Priidix: posts big blind $1
pk4DW: posts the ante $0.20
mzsportline: posts the ante $0.20
VanDobeln: posts the ante $0.20
goransyruvka: posts the ante $0.20
Priidix: posts the ante $0.20
matiko09: posts the ante $0.20
redacesfull: posts the ante $0.20
er13to: posts the ante $0.20
*** HOLE CARDS ***
Dealt to matiko09 [Ah Kh]
matiko09: raises $2 to $3
redacesfull: folds 
er13to: folds 
pk4DW: folds 
mzsportline: folds 
VanDobeln: folds 
goransyruvka: folds 
Priidix: calls $2
*** FLOP *** [9d Kd 2d]
Priidix: checks 
matiko09: bets $5
Priidix: calls $5
*** TURN *** [9d Kd 2d] [9c]
Priidix: bets $6.05
matiko09: raises $10.95 to $17
Priidix: folds 
Uncalled bet ($10.95) returned to matiko09
matiko09 collected $28.84 from pot
matiko09: doesn't show hand 
*** SUMMARY ***
Total pot $30.20 | Rake $1.36 
Board [9d Kd 2d 9c]
Seat 1: pk4DW folded before Flop (didn't bet)
Seat 2: mzsportline folded before Flop (didn't bet)
Seat 3: VanDobeln (button) folded before Flop (didn't bet)
Seat 4: goransyruvka (small blind) folded before Flop
Seat 6: Priidix (big blind) folded on the Turn
Seat 7: matiko09 collected ($28.84)
Seat 8: redacesfull folded before Flop (didn't bet)
Seat 9: er13to folded before Flop (didn't bet)





PokerStars Hand #148833532942:  Hold'em No Limit ($0.50/$1.00 USD) - 2016/02/15 11:22:42 CET [2016/02/15 5:22:42 ET]
Table 'Ristenpart' 9-max Seat #6 is the button
Seat 1: vano7777 ($40 in chips) 
Seat 2: IHouseMusic ($115.83 in chips) 
Seat 4: miyashin ($102.92 in chips) 
Seat 5: lingyyang ($53.50 in chips) 
Seat 6: matiko09 ($120.94 in chips) 
Seat 7: Aalleekks ($100.50 in chips) 
Seat 8: gwwsb ($92 in chips) 
Seat 9: Igor DoUrden ($100.50 in chips) 
Aalleekks: posts small blind $0.50
gwwsb: posts big blind $1
lumen21: sits out 
*** HOLE CARDS ***
Dealt to matiko09 [Tc Kh]
Igor DoUrden: folds 
vano7777: raises $1 to $2
IHouseMusic: folds 
miyashin: raises $4 to $6
lingyyang: folds 
matiko09: folds 
Aalleekks: folds 
gwwsb: folds 
vano7777: folds 
Uncalled bet ($4) returned to miyashin
miyashin collected $5.50 from pot
miyashin: doesn't show hand 
*** SUMMARY ***
Total pot $5.50 | Rake $0 
Seat 1: vano7777 folded before Flop
Seat 2: IHouseMusic folded before Flop (didn't bet)
Seat 4: miyashin collected ($5.50)
Seat 5: lingyyang folded before Flop (didn't bet)
Seat 6: matiko09 (button) folded before Flop (didn't bet)
Seat 7: Aalleekks (small blind) folded before Flop
Seat 8: gwwsb (big blind) folded before Flop
Seat 9: Igor DoUrden folded before Flop (didn't bet)





PokerStars Hand #148833533253:  Hold'em No Limit ($0.50/$1.00 USD) - 2016/02/15 11:22:43 CET [2016/02/15 5:22:43 ET]
Table 'Saldanha' 9-max Seat #8 is the button
Seat 1: mycka86 ($100 in chips) 
Seat 2: Congo Sam ($100.88 in chips) 
Seat 3: maxxmeister ($133.63 in chips) 
Seat 4: er13to ($106.34 in chips) 
Seat 5: matiko09 ($109.50 in chips) 
Seat 6: huffwag ($27.45 in chips) 
Seat 7: Venomous100% ($147.89 in chips) 
Seat 8: gabi_igna ($109.14 in chips) 
mycka86: posts small blind $0.50
Congo Sam: posts big blind $1
*** HOLE CARDS ***
Dealt to matiko09 [7s Jc]
maxxmeister: folds 
er13to: folds 
matiko09: folds 
huffwag: raises $2 to $3
Venomous100%: folds 
gabi_igna: folds 
mycka86: raises $5.50 to $8.50
Congo Sam: folds 
huffwag: calls $5.50
*** FLOP *** [Jh Qc As]
mycka86: bets $5.67
huffwag: folds 
Uncalled bet ($5.67) returned to mycka86
mycka86 collected $17.19 from pot
*** SUMMARY ***
Total pot $18 | Rake $0.81 
Board [Jh Qc As]
Seat 1: mycka86 (small blind) collected ($17.19)
Seat 2: Congo Sam (big blind) folded before Flop
Seat 3: maxxmeister folded before Flop (didn't bet)
Seat 4: er13to folded before Flop (didn't bet)
Seat 5: matiko09 folded before Flop (didn't bet)
Seat 6: huffwag folded on the Flop
Seat 7: Venomous100% folded before Flop (didn't bet)
Seat 8: gabi_igna (button) folded before Flop (didn't bet)





PokerStars Hand #148833536444:  Hold'em No Limit ($0.50/$1.00 USD) - 2016/02/15 11:22:50 CET [2016/02/15 5:22:50 ET]
Table 'Sekanina' 9-max Seat #7 is the button
Seat 2: Priidix ($179.66 in chips) 
Seat 3: gabi_igna ($101.50 in chips) 
Seat 4: matiko09 ($100 in chips) 
Seat 5: dv3491 ($41.77 in chips) 
Seat 6: vinniesmol ($250.81 in chips) 
Seat 7: mycka86 ($144.35 in chips) 
Seat 8: Venomous100% ($100 in chips) 
Seat 9: er13to ($102.23 in chips) 
Venomous100%: posts small blind $0.50
er13to: posts big blind $1
dv3491: posts big blind $1
*** HOLE CARDS ***
Dealt to matiko09 [3c 3h]
Priidix: folds 
gabi_igna: folds 
matiko09: folds 
dv3491: raises $2 to $3
vinniesmol: folds 
mycka86: folds 
Venomous100%: folds 
er13to: calls $2
*** FLOP *** [8s Jc Ad]
er13to: checks 
dv3491: bets $2
er13to: folds 
Uncalled bet ($2) returned to dv3491
dv3491 collected $6.21 from pot
dv3491: doesn't show hand 
*** SUMMARY ***
Total pot $6.50 | Rake $0.29 
Board [8s Jc Ad]
Seat 2: Priidix folded before Flop (didn't bet)
Seat 3: gabi_igna folded before Flop (didn't bet)
Seat 4: matiko09 folded before Flop (didn't bet)
Seat 5: dv3491 collected ($6.21)
Seat 6: vinniesmol folded before Flop (didn't bet)
Seat 7: mycka86 (button) folded before Flop (didn't bet)
Seat 8: Venomous100% (small blind) folded before Flop
Seat 9: er13to (big blind) folded on the Flop





PokerStars Hand #148833537725:  Hold'em No Limit ($0.50/$1.00 USD) - 2016/02/15 11:22:52 CET [2016/02/15 5:22:52 ET]
Table 'Euanthe II' 9-max Seat #2 is the button
Seat 2: mahalko0925 ($86.50 in chips) 
Seat 3: matiko09 ($123.77 in chips) 
Seat 4: er13to ($116.45 in chips) 
Seat 5: gabi_igna ($101 in chips) 
Seat 7: vinniesmol ($221.88 in chips) 
Seat 8: Sashey2708 ($100.29 in chips) 
Seat 9: Venomous100% ($115.22 in chips) 
matiko09: posts small blind $0.50
er13to: posts big blind $1
IHouseMusic: sits out 
*** HOLE CARDS ***
Dealt to matiko09 [Qc 5h]
gabi_igna: folds 
vinniesmol: raises $2 to $3
Sashey2708: folds 
Venomous100%: folds 
mahalko0925: folds 
matiko09: folds 
er13to: calls $2
*** FLOP *** [3s 6d 7d]
er13to: checks 
vinniesmol: bets $4
er13to: calls $4
*** TURN *** [3s 6d 7d] [5s]
er13to: checks 
vinniesmol: checks 
*** RIVER *** [3s 6d 7d 5s] [4c]
er13to: checks 
vinniesmol: checks 
*** SHOW DOWN ***
er13to: shows [9s 6s] (a straight, Three to Seven)
vinniesmol: shows [Jd Kh] (a straight, Three to Seven)
er13to collected $6.93 from pot
vinniesmol collected $6.92 from pot
*** SUMMARY ***
Total pot $14.50 | Rake $0.65 
Board [3s 6d 7d 5s 4c]
Seat 2: mahalko0925 (button) folded before Flop (didn't bet)
Seat 3: matiko09 (small blind) folded before Flop
Seat 4: er13to (big blind) showed [9s 6s] and won ($6.93) with a straight, Three to Seven
Seat 5: gabi_igna folded before Flop (didn't bet)
Seat 7: vinniesmol showed [Jd Kh] and won ($6.92) with a straight, Three to Seven
Seat 8: Sashey2708 folded before Flop (didn't bet)
Seat 9: Venomous100% folded before Flop (didn't bet)





PokerStars Hand #148833540194:  Hold'em No Limit ($0.50/$1.00 USD) - 2016/02/15 11:22:58 CET [2016/02/15 5:22:58 ET]
Table 'Nata II' 9-max Seat #1 is the button
Seat 1: Priidix ($125.61 in chips) 
Seat 2: qqcom ($100 in chips) 
Seat 3: g00000se ($119.95 in chips) 
Seat 4: gabi_igna ($100 in chips) 
Seat 5: AGoodFell4 ($117.62 in chips) 
Seat 6: AlKatrone ($100 in chips) 
Seat 7: er13to ($115.65 in chips) 
Seat 9: matiko09 ($100 in chips) 
qqcom: posts small blind $0.50
g00000se: posts big blind $1
lumen21: sits out 
*** HOLE CARDS ***
Dealt to matiko09 [9d 2d]
gabi_igna: folds 
AGoodFell4: raises $2 to $3
AlKatrone: raises $6 to $9
er13to: folds 
matiko09: folds 
Priidix: folds 
qqcom: calls $8.50
g00000se: folds 
AGoodFell4: calls $6
*** FLOP *** [2h 4c 8h]
qqcom: checks 
AGoodFell4: bets $18
AlKatrone: raises $73 to $91 and is all-in
qqcom: folds 
AGoodFell4: folds 
Uncalled bet ($73) returned to AlKatrone
AlKatrone collected $61.20 from pot
AlKatrone: doesn't show hand 
*** SUMMARY ***
Total pot $64 | Rake $2.80 
Board [2h 4c 8h]
Seat 1: Priidix (button) folded before Flop (didn't bet)
Seat 2: qqcom (small blind) folded on the Flop
Seat 3: g00000se (big blind) folded before Flop
Seat 4: gabi_igna folded before Flop (didn't bet)
Seat 5: AGoodFell4 folded on the Flop
Seat 6: AlKatrone collected ($61.20)
Seat 7: er13to folded before Flop (didn't bet)
Seat 9: matiko09 folded before Flop (didn't bet)





PokerStars Hand #148833540601:  Hold'em No Limit ($0.50/$1.00 USD) - 2016/02/15 11:22:59 CET [2016/02/15 5:22:59 ET]
Table 'Octans II' 9-max Seat #9 is the button
Seat 2: matiko09 ($246.18 in chips) 
Seat 3: Aalleekks ($100 in chips) 
Seat 4: Venomous100% ($161.80 in chips) 
Seat 5: AlKatrone ($123.52 in chips) 
Seat 6: er13to ($100 in chips) 
Seat 7: traficblues ($59.73 in chips) 
Seat 8: IHouseMusic ($129.93 in chips) 
Seat 9: mycka86 ($100 in chips) 
matiko09: posts small blind $0.50
Aalleekks: posts big blind $1
*** HOLE CARDS ***
Dealt to matiko09 [9s As]
Venomous100%: folds 
AlKatrone: folds 
er13to: folds 
traficblues: calls $1
IHouseMusic: folds 
mycka86: raises $3.50 to $4.50
matiko09: folds 
Aalleekks: folds 
traficblues: calls $3.50
*** FLOP *** [8d Kh Td]
traficblues: checks 
mycka86: bets $5.51
traficblues: folds 
Uncalled bet ($5.51) returned to mycka86
mycka86 collected $10.03 from pot
*** SUMMARY ***
Total pot $10.50 | Rake $0.47 
Board [8d Kh Td]
Seat 2: matiko09 (small blind) folded before Flop
Seat 3: Aalleekks (big blind) folded before Flop
Seat 4: Venomous100% folded before Flop (didn't bet)
Seat 5: AlKatrone folded before Flop (didn't bet)
Seat 6: er13to folded before Flop (didn't bet)
Seat 7: traficblues folded on the Flop
Seat 8: IHouseMusic folded before Flop (didn't bet)
Seat 9: mycka86 (button) collected ($10.03)





PokerStars Hand #148833544254:  Hold'em No Limit ($0.25/$0.50 USD) - 2016/02/15 11:23:06 CET [2016/02/15 5:23:06 ET]
Table 'Laertes II' 9-max Seat #2 is the button
Seat 1: etny99 ($50 in chips) 
Seat 2: beluccix ($24.21 in chips) 
Seat 3: valfan911 ($51.25 in chips) 
Seat 4: rgar93 ($38.86 in chips) 
Seat 7: Vedpapa ($67.74 in chips) 
Seat 8: Trent444 ($43.35 in chips) 
Seat 9: matiko09 ($53.35 in chips) 
valfan911: posts small blind $0.25
rgar93: posts big blind $0.50
Serhent: sits out 
ZonTTT: sits out 
*** HOLE CARDS ***
Dealt to matiko09 [Qh 7h]
Vedpapa: folds 
Trent444: folds 
matiko09: folds 
etny99: raises $0.50 to $1
beluccix: folds 
valfan911: folds 
rgar93: calls $0.50
*** FLOP *** [6s 4d 7c]
rgar93: checks 
etny99: checks 
*** TURN *** [6s 4d 7c] [Ts]
rgar93: checks 
etny99: bets $1.61
rgar93: calls $1.61
*** RIVER *** [6s 4d 7c Ts] [7s]
rgar93: checks 
Serhent leaves the table
etny99: checks 
*** SHOW DOWN ***
rgar93: shows [6h 9s] (two pair, Sevens and Sixes)
etny99: mucks hand 
rgar93 collected $5.22 from pot
*** SUMMARY ***
Total pot $5.47 | Rake $0.25 
Board [6s 4d 7c Ts 7s]
Seat 1: etny99 mucked [Qc Kd]
Seat 2: beluccix (button) folded before Flop (didn't bet)
Seat 3: valfan911 (small blind) folded before Flop
Seat 4: rgar93 (big blind) showed [6h 9s] and won ($5.22) with two pair, Sevens and Sixes
Seat 7: Vedpapa folded before Flop (didn't bet)
Seat 8: Trent444 folded before Flop (didn't bet)
Seat 9: matiko09 folded before Flop (didn't bet)





PokerStars Hand #148833545472:  Hold'em No Limit ($0.50/$1.00 USD) - 2016/02/15 11:23:09 CET [2016/02/15 5:23:09 ET]
Table 'Anteros' 9-max Seat #1 is the button
Seat 1: redacesfull ($100 in chips) 
Seat 2: IHouseMusic ($115.75 in chips) 
Seat 3: er13to ($109.20 in chips) 
Seat 4: misherei ($170.51 in chips) 
Seat 5: Holm1991 ($44.36 in chips) 
Seat 7: Zoubou1983 ($194.11 in chips) 
Seat 8: matiko09 ($100 in chips) 
Seat 9: mycka86 ($100 in chips) 
IHouseMusic: posts small blind $0.50
er13to: posts big blind $1
*** HOLE CARDS ***
Dealt to matiko09 [Qs Kh]
misherei: folds 
Holm1991: folds 
Zoubou1983: folds 
matiko09: raises $2 to $3
mycka86: folds 
redacesfull: folds 
IHouseMusic: folds 
er13to: folds 
Uncalled bet ($2) returned to matiko09
matiko09 collected $2.50 from pot
matiko09: doesn't show hand 
*** SUMMARY ***
Total pot $2.50 | Rake $0 
Seat 1: redacesfull (button) folded before Flop (didn't bet)
Seat 2: IHouseMusic (small blind) folded before Flop
Seat 3: er13to (big blind) folded before Flop
Seat 4: misherei folded before Flop (didn't bet)
Seat 5: Holm1991 folded before Flop (didn't bet)
Seat 7: Zoubou1983 folded before Flop (didn't bet)
Seat 8: matiko09 collected ($2.50)
Seat 9: mycka86 folded before Flop (didn't bet)





PokerStars Hand #148833547131:  Hold'em No Limit ($0.50/$1.00 USD) - 2016/02/15 11:23:13 CET [2016/02/15 5:23:13 ET]
Table 'Ristenpart' 9-max Seat #7 is the button
Seat 2: IHouseMusic ($115.83 in chips) 
Seat 4: miyashin ($106.42 in chips) 
Seat 5: lingyyang ($53.50 in chips) 
Seat 6: matiko09 ($120.94 in chips) 
Seat 7: Aalleekks ($100 in chips) 
Seat 8: gwwsb ($91 in chips) 
gwwsb: posts small blind $0.50
Igor DoUrden: is sitting out 
vano7777: is sitting out 
Igor DoUrden leaves the table
IHouseMusic: posts big blind $1
lumen21: sits out 
*** HOLE CARDS ***
Dealt to matiko09 [3c 5c]
miyashin: folds 
maxxmeister joins the table at seat #9 
lingyyang: raises $1 to $2
vano7777 leaves the table
matiko09: folds 
Aalleekks: folds 
gwwsb: folds 
IHouseMusic: folds 
Uncalled bet ($1) returned to lingyyang
lingyyang collected $2.50 from pot
gabi_igna joins the table at seat #1 
lingyyang: doesn't show hand 
*** SUMMARY ***
Total pot $2.50 | Rake $0 
Seat 2: IHouseMusic (big blind) folded before Flop
Seat 4: miyashin folded before Flop (didn't bet)
Seat 5: lingyyang collected ($2.50)
Seat 6: matiko09 folded before Flop (didn't bet)
Seat 7: Aalleekks (button) folded before Flop (didn't bet)
Seat 8: gwwsb (small blind) folded before Flop





PokerStars Hand #148833548959:  Hold'em No Limit (€0.50/€1.00 EUR) - 2016/02/15 11:23:16 CET [2016/02/15 5:23:16 ET]
Table 'Ganesa II' 9-max Seat #8 is the button
Seat 1: AARON1953 (€77 in chips) 
Seat 2: maxxmeister (€108.37 in chips) 
Seat 3: BuBu 0187 (€74.84 in chips) 
Seat 4: Sreshta222 (€132.33 in chips) 
Seat 5: vano7777 (€69.24 in chips) 
Seat 6: matiko09 (€109.58 in chips) 
Seat 7: er13to (€117.50 in chips) 
Seat 8: mycka86 (€100 in chips) 
Seat 9: Priidix (€100 in chips) 
Priidix: posts small blind €0.50
AARON1953: posts big blind €1
*** HOLE CARDS ***
Dealt to matiko09 [8s 4s]
maxxmeister: folds 
BuBu 0187 has timed out
BuBu 0187: folds 
Sreshta222: folds 
vano7777: folds 
matiko09: folds 
er13to: folds 
mycka86: folds 
Priidix: raises €1.60 to €2.60
AARON1953: raises €4.40 to €7
Priidix: calls €4.40
*** FLOP *** [4c Kc Ah]
Priidix: checks 
AARON1953: bets €8
Priidix: calls €8
*** TURN *** [4c Kc Ah] [9h]
Priidix: checks 
AARON1953: bets €15
Priidix: calls €15
*** RIVER *** [4c Kc Ah 9h] [Th]
Priidix: checks 
AARON1953: bets €46
Priidix: calls €46
*** SHOW DOWN ***
AARON1953: shows [8h 8d] (a pair of Eights)
Priidix: shows [5h Ad] (a pair of Aces)
Priidix collected €149.85 from pot
*** SUMMARY ***
Total pot €152 | Rake €2.15 
Board [4c Kc Ah 9h Th]
Seat 1: AARON1953 (big blind) showed [8h 8d] and lost with a pair of Eights
Seat 2: maxxmeister folded before Flop (didn't bet)
Seat 3: BuBu 0187 folded before Flop (didn't bet)
Seat 4: Sreshta222 folded before Flop (didn't bet)
Seat 5: vano7777 folded before Flop (didn't bet)
Seat 6: matiko09 folded before Flop (didn't bet)
Seat 7: er13to folded before Flop (didn't bet)
Seat 8: mycka86 (button) folded before Flop (didn't bet)
Seat 9: Priidix (small blind) showed [5h Ad] and won (€149.85) with a pair of Aces





PokerStars Hand #148833552476:  Hold'em No Limit ($0.50/$1.00 USD) - 2016/02/15 11:23:24 CET [2016/02/15 5:23:24 ET]
Table 'Corvus III' 9-max Seat #4 is the button
Seat 1: pk4DW ($128.62 in chips) 
Seat 2: mzsportline ($96.50 in chips) 
Seat 3: VanDobeln ($245.52 in chips) 
Seat 4: goransyruvka ($108.56 in chips) 
Seat 6: Priidix ($142.83 in chips) 
Seat 7: matiko09 ($304.99 in chips) 
Seat 8: redacesfull ($244.38 in chips) 
Seat 9: er13to ($101.92 in chips) 
Priidix: posts small blind $0.50
matiko09: posts big blind $1
pk4DW: posts the ante $0.20
mzsportline: posts the ante $0.20
VanDobeln: posts the ante $0.20
goransyruvka: posts the ante $0.20
Priidix: posts the ante $0.20
matiko09: posts the ante $0.20
redacesfull: posts the ante $0.20
er13to: posts the ante $0.20
*** HOLE CARDS ***
Dealt to matiko09 [3d Kd]
redacesfull: folds 
er13to: folds 
pk4DW: folds 
mzsportline: folds 
VanDobeln: folds 
goransyruvka: calls $1
Priidix: calls $0.50
matiko09: checks 
*** FLOP *** [Tc 6c 2c]
Priidix: checks 
matiko09: checks 
goransyruvka: checks 
*** TURN *** [Tc 6c 2c] [3c]
Priidix: checks 
matiko09: checks 
goransyruvka: checks 
*** RIVER *** [Tc 6c 2c 3c] [9h]
Priidix: checks 
matiko09: checks 
goransyruvka: checks 
*** SHOW DOWN ***
Priidix: shows [9s Qh] (a pair of Nines)
matiko09: mucks hand 
goransyruvka: shows [Ts 8h] (a pair of Tens)
goransyruvka collected $4.39 from pot
*** SUMMARY ***
Total pot $4.60 | Rake $0.21 
Board [Tc 6c 2c 3c 9h]
Seat 1: pk4DW folded before Flop (didn't bet)
Seat 2: mzsportline folded before Flop (didn't bet)
Seat 3: VanDobeln folded before Flop (didn't bet)
Seat 4: goransyruvka (button) showed [Ts 8h] and won ($4.39) with a pair of Tens
Seat 6: Priidix (small blind) showed [9s Qh] and lost with a pair of Nines
Seat 7: matiko09 (big blind) mucked [3d Kd]
Seat 8: redacesfull folded before Flop (didn't bet)
Seat 9: er13to folded before Flop (didn't bet)





PokerStars Hand #148833555382:  Hold'em No Limit ($0.50/$1.00 USD) - 2016/02/15 11:23:30 CET [2016/02/15 5:23:30 ET]
Table 'Ristenpart' 9-max Seat #8 is the button
Seat 2: IHouseMusic ($114.83 in chips) 
Seat 3: lumen21 ($100 in chips) 
Seat 4: miyashin ($106.42 in chips) 
Seat 5: lingyyang ($55 in chips) 
Seat 6: matiko09 ($120.94 in chips) 
Seat 7: Aalleekks ($100 in chips) 
Seat 8: gwwsb ($90.50 in chips) 
gabi_igna will be allowed to play after the button
IHouseMusic: posts small blind $0.50
lumen21: posts big blind $1
*** HOLE CARDS ***
Dealt to matiko09 [5d 4h]
miyashin: folds 
lingyyang: folds 
matiko09: folds 
Aalleekks: folds 
gwwsb: raises $1 to $2
IHouseMusic: folds 
lumen21: folds 
Uncalled bet ($1) returned to gwwsb
gwwsb collected $2.50 from pot
gwwsb: doesn't show hand 
*** SUMMARY ***
Total pot $2.50 | Rake $0 
Seat 2: IHouseMusic (small blind) folded before Flop
Seat 3: lumen21 (big blind) folded before Flop
Seat 4: miyashin folded before Flop (didn't bet)
Seat 5: lingyyang folded before Flop (didn't bet)
Seat 6: matiko09 folded before Flop (didn't bet)
Seat 7: Aalleekks folded before Flop (didn't bet)
Seat 8: gwwsb (button) collected ($2.50)





PokerStars Hand #148833556348:  Hold'em No Limit ($0.50/$1.00 USD) - 2016/02/15 11:23:32 CET [2016/02/15 5:23:32 ET]
Table 'Anteros' 9-max Seat #2 is the button
Seat 1: redacesfull ($100 in chips) 
Seat 2: IHouseMusic ($115.25 in chips) 
Seat 3: er13to ($108.20 in chips) 
Seat 4: misherei ($170.51 in chips) 
Seat 5: Holm1991 ($44.36 in chips) 
Seat 7: Zoubou1983 ($194.11 in chips) 
Seat 8: matiko09 ($101.50 in chips) 
Seat 9: mycka86 ($100 in chips) 
er13to: posts small blind $0.50
misherei: posts big blind $1
*** HOLE CARDS ***
Dealt to matiko09 [Ah 5c]
Holm1991: calls $1
Zoubou1983: folds 
matiko09: folds 
mycka86: folds 
redacesfull: folds 
IHouseMusic: folds 
er13to: folds 
misherei: checks 
*** FLOP *** [2d 2h Jc]
misherei: checks 
Holm1991: checks 
*** TURN *** [2d 2h Jc] [7h]
misherei: checks 
Holm1991: checks 
*** RIVER *** [2d 2h Jc 7h] [2s]
misherei: checks 
Holm1991: checks 
*** SHOW DOWN ***
misherei: shows [8d Qd] (three of a kind, Deuces)
Holm1991: shows [Ad Tc] (three of a kind, Deuces - Ace kicker)
Holm1991 collected $2.39 from pot
*** SUMMARY ***
Total pot $2.50 | Rake $0.11 
Board [2d 2h Jc 7h 2s]
Seat 1: redacesfull folded before Flop (didn't bet)
Seat 2: IHouseMusic (button) folded before Flop (didn't bet)
Seat 3: er13to (small blind) folded before Flop
Seat 4: misherei (big blind) showed [8d Qd] and lost with three of a kind, Deuces
Seat 5: Holm1991 showed [Ad Tc] and won ($2.39) with three of a kind, Deuces
Seat 7: Zoubou1983 folded before Flop (didn't bet)
Seat 8: matiko09 folded before Flop (didn't bet)
Seat 9: mycka86 folded before Flop (didn't bet)





PokerStars Hand #148833560618:  Hold'em No Limit ($0.50/$1.00 USD) - 2016/02/15 11:23:41 CET [2016/02/15 5:23:41 ET]
Table 'Sekanina' 9-max Seat #8 is the button
Seat 3: gabi_igna ($101.50 in chips) 
Seat 4: matiko09 ($100 in chips) 
Seat 5: dv3491 ($44.98 in chips) 
Seat 6: vinniesmol ($250.81 in chips) 
Seat 7: mycka86 ($144.35 in chips) 
Seat 8: Venomous100% ($100 in chips) 
Seat 9: er13to ($100 in chips) 
er13to: posts small blind $0.50
Priidix: is sitting out 
gabi_igna: posts big blind $1
*** HOLE CARDS ***
Dealt to matiko09 [Td 4c]
matiko09: folds 
dv3491: raises $1 to $2
vinniesmol: calls $2
mycka86: folds 
Venomous100%: folds 
er13to: raises $9.50 to $11.50
gabi_igna: folds 
dv3491: folds 
vinniesmol: folds 
Uncalled bet ($9.50) returned to er13to
er13to collected $7 from pot
*** SUMMARY ***
Total pot $7 | Rake $0 
Seat 3: gabi_igna (big blind) folded before Flop
Seat 4: matiko09 folded before Flop (didn't bet)
Seat 5: dv3491 folded before Flop
Seat 6: vinniesmol folded before Flop
Seat 7: mycka86 folded before Flop (didn't bet)
Seat 8: Venomous100% (button) folded before Flop (didn't bet)
Seat 9: er13to (small blind) collected ($7)





PokerStars Hand #148833562120:  Hold'em No Limit ($0.50/$1.00 USD) - 2016/02/15 11:23:45 CET [2016/02/15 5:23:45 ET]
Table 'Octans II' 9-max Seat #2 is the button
Seat 2: matiko09 ($245.68 in chips) 
Seat 3: Aalleekks ($100 in chips) 
Seat 4: Venomous100% ($161.80 in chips) 
Seat 5: AlKatrone ($123.52 in chips) 
Seat 6: er13to ($100 in chips) 
Seat 7: traficblues ($55.23 in chips) 
Seat 8: IHouseMusic ($129.93 in chips) 
Seat 9: mycka86 ($105.53 in chips) 
Aalleekks: posts small blind $0.50
Venomous100%: posts big blind $1
*** HOLE CARDS ***
Dealt to matiko09 [Qh 5h]
AlKatrone: folds 
er13to: folds 
traficblues: folds 
IHouseMusic: folds 
mycka86: raises $1.10 to $2.10
matiko09: folds 
Aalleekks: calls $1.60
Venomous100%: calls $1.10
*** FLOP *** [Kc 8c 8h]
Aalleekks: checks 
Venomous100%: bets $4.01
mycka86: folds 
Aalleekks: folds 
Uncalled bet ($4.01) returned to Venomous100%
Venomous100% collected $6.02 from pot
Venomous100%: doesn't show hand 
*** SUMMARY ***
Total pot $6.30 | Rake $0.28 
Board [Kc 8c 8h]
Seat 2: matiko09 (button) folded before Flop (didn't bet)
Seat 3: Aalleekks (small blind) folded on the Flop
Seat 4: Venomous100% (big blind) collected ($6.02)
Seat 5: AlKatrone folded before Flop (didn't bet)
Seat 6: er13to folded before Flop (didn't bet)
Seat 7: traficblues folded before Flop (didn't bet)
Seat 8: IHouseMusic folded before Flop (didn't bet)
Seat 9: mycka86 folded on the Flop





PokerStars Hand #148833563433:  Hold'em No Limit ($0.50/$1.00 USD) - 2016/02/15 11:23:47 CET [2016/02/15 5:23:47 ET]
Table 'Ristenpart' 9-max Seat #2 is the button
Seat 2: IHouseMusic ($114.33 in chips) 
Seat 3: lumen21 ($100 in chips) 
Seat 4: miyashin ($106.42 in chips) 
Seat 5: lingyyang ($55 in chips) 
Seat 6: matiko09 ($120.94 in chips) 
Seat 7: Aalleekks ($100 in chips) 
Seat 8: gwwsb ($92 in chips) 
lumen21: posts small blind $0.50
miyashin: posts big blind $1
gabi_igna: sits out 
*** HOLE CARDS ***
Dealt to matiko09 [Ks 6c]
lingyyang: folds 
matiko09: folds 
Aalleekks: folds 
gwwsb: folds 
IHouseMusic: folds 
lumen21: folds 
Uncalled bet ($0.50) returned to miyashin
lingyyang leaves the table
miyashin collected $1 from pot
miyashin: doesn't show hand 
*** SUMMARY ***
Total pot $1 | Rake $0 
Seat 2: IHouseMusic (button) folded before Flop (didn't bet)
Seat 3: lumen21 (small blind) folded before Flop
Seat 4: miyashin (big blind) collected ($1)
Seat 5: lingyyang folded before Flop (didn't bet)
Seat 6: matiko09 folded before Flop (didn't bet)
Seat 7: Aalleekks folded before Flop (didn't bet)
Seat 8: gwwsb folded before Flop (didn't bet)





PokerStars Hand #148833566504:  Hold'em No Limit ($0.50/$1.00 USD) - 2016/02/15 11:23:54 CET [2016/02/15 5:23:54 ET]
Table 'Euanthe II' 9-max Seat #3 is the button
Seat 2: mahalko0925 ($86.50 in chips) 
Seat 3: matiko09 ($123.27 in chips) 
Seat 4: er13to ($116.38 in chips) 
Seat 5: gabi_igna ($101 in chips) 
Seat 7: vinniesmol ($221.80 in chips) 
Seat 8: Sashey2708 ($100.29 in chips) 
Seat 9: Venomous100% ($115.22 in chips) 
er13to: posts small blind $0.50
gabi_igna: posts big blind $1
IHouseMusic: sits out 
*** HOLE CARDS ***
Dealt to matiko09 [Qh Qd]
vinniesmol: folds 
Sashey2708: folds 
Venomous100%: folds 
mahalko0925: raises $1 to $2
matiko09: raises $5 to $7
er13to: folds 
gabi_igna: folds 
mahalko0925: folds 
Uncalled bet ($5) returned to matiko09
matiko09 collected $5.50 from pot
matiko09: doesn't show hand 
*** SUMMARY ***
Total pot $5.50 | Rake $0 
Seat 2: mahalko0925 folded before Flop
Seat 3: matiko09 (button) collected ($5.50)
Seat 4: er13to (small blind) folded before Flop
Seat 5: gabi_igna (big blind) folded before Flop
Seat 7: vinniesmol folded before Flop (didn't bet)
Seat 8: Sashey2708 folded before Flop (didn't bet)
Seat 9: Venomous100% folded before Flop (didn't bet)





PokerStars Hand #148833568228:  Hold'em No Limit ($0.50/$1.00 USD) - 2016/02/15 11:23:57 CET [2016/02/15 5:23:57 ET]
Table 'Ristenpart' 9-max Seat #3 is the button
Seat 2: IHouseMusic ($114.33 in chips) 
Seat 3: lumen21 ($100 in chips) 
Seat 4: miyashin ($106.92 in chips) 
Seat 6: matiko09 ($120.94 in chips) 
Seat 7: Aalleekks ($100 in chips) 
Seat 8: gwwsb ($92 in chips) 
miyashin: posts small blind $0.50
matiko09: posts big blind $1
gabi_igna: sits out 
*** HOLE CARDS ***
Dealt to matiko09 [7d Tc]
redacesfull joins the table at seat #5 
Aalleekks: raises $2 to $3
gwwsb: folds 
IHouseMusic: folds 
lumen21: folds 
miyashin: folds 
matiko09: folds 
Uncalled bet ($2) returned to Aalleekks
Aalleekks collected $2.50 from pot
Aalleekks: doesn't show hand 
*** SUMMARY ***
Total pot $2.50 | Rake $0 
Seat 2: IHouseMusic folded before Flop (didn't bet)
Seat 3: lumen21 (button) folded before Flop (didn't bet)
Seat 4: miyashin (small blind) folded before Flop
Seat 6: matiko09 (big blind) folded before Flop
Seat 7: Aalleekks collected ($2.50)
Seat 8: gwwsb folded before Flop (didn't bet)





PokerStars Hand #148833568434:  Hold'em No Limit ($0.50/$1.00 USD) - 2016/02/15 11:23:58 CET [2016/02/15 5:23:58 ET]
Table 'Praecipua' 9-max Seat #4 is the button
Seat 1: er13to ($133.93 in chips) 
Seat 2: matiko09 ($100 in chips) 
Seat 3: Venomous100% ($133.01 in chips) 
Seat 4: gabi_igna ($100 in chips) 
Seat 5: huffwag ($165.65 in chips) 
Seat 6: mycka86 ($110 in chips) 
Seat 7: maxxmeister ($141.73 in chips) 
Seat 8: Ellis Ng ($36.92 in chips) 
Seat 9: AlKatrone ($100 in chips) 
huffwag: posts small blind $0.50
mycka86: posts big blind $1
*** HOLE CARDS ***
Dealt to matiko09 [Qs Ac]
maxxmeister: raises $2 to $3
Ellis Ng: folds 
AlKatrone: folds 
er13to: folds 
matiko09: calls $3
Venomous100%: folds 
gabi_igna: folds 
huffwag: calls $2.50
mycka86: folds 
*** FLOP *** [8c Tc Ad]
huffwag: checks 
maxxmeister: checks 
matiko09: bets $6.21
huffwag: folds 
maxxmeister: calls $6.21
*** TURN *** [8c Tc Ad] [3s]
maxxmeister: checks 
matiko09: checks 
*** RIVER *** [8c Tc Ad 3s] [Kc]
maxxmeister: checks 
matiko09: checks 
*** SHOW DOWN ***
maxxmeister: shows [As 2s] (a pair of Aces)
matiko09: shows [Qs Ac] (a pair of Aces - King+Queen kicker)
matiko09 collected $21.41 from pot
*** SUMMARY ***
Total pot $22.42 | Rake $1.01 
Board [8c Tc Ad 3s Kc]
Seat 1: er13to folded before Flop (didn't bet)
Seat 2: matiko09 showed [Qs Ac] and won ($21.41) with a pair of Aces
Seat 3: Venomous100% folded before Flop (didn't bet)
Seat 4: gabi_igna (button) folded before Flop (didn't bet)
Seat 5: huffwag (small blind) folded on the Flop
Seat 6: mycka86 (big blind) folded before Flop
Seat 7: maxxmeister showed [As 2s] and lost with a pair of Aces
Seat 8: Ellis Ng folded before Flop (didn't bet)
Seat 9: AlKatrone folded before Flop (didn't bet)





PokerStars Hand #148833569909:  Hold'em No Limit ($0.50/$1.00 USD) - 2016/02/15 11:24:01 CET [2016/02/15 5:24:01 ET]
Table 'Saldanha' 9-max Seat #1 is the button
Seat 1: mycka86 ($108.69 in chips) 
Seat 2: Congo Sam ($99.88 in chips) 
Seat 4: er13to ($106.34 in chips) 
Seat 5: matiko09 ($109.50 in chips) 
Seat 6: huffwag ($18.95 in chips) 
Seat 7: Venomous100% ($147.89 in chips) 
Seat 8: gabi_igna ($109.14 in chips) 
Congo Sam: posts small blind $0.50
er13to: posts big blind $1
*** HOLE CARDS ***
Dealt to matiko09 [Qh 6c]
matiko09: folds 
huffwag: raises $2 to $3
Venomous100%: raises $6 to $9
gabi_igna: folds 
mycka86: folds 
Congo Sam: folds 
er13to: folds 
huffwag: raises $9.95 to $18.95 and is all-in
Venomous100%: calls $9.95
*** FLOP *** [Jc 2d Ad]
*** TURN *** [Jc 2d Ad] [9s]
*** RIVER *** [Jc 2d Ad 9s] [7s]
*** SHOW DOWN ***
huffwag: shows [Ks Js] (a pair of Jacks)
Venomous100%: shows [9c 9h] (three of a kind, Nines)
Venomous100% collected $37.63 from pot
*** SUMMARY ***
Total pot $39.40 | Rake $1.77 
Board [Jc 2d Ad 9s 7s]
Seat 1: mycka86 (button) folded before Flop (didn't bet)
Seat 2: Congo Sam (small blind) folded before Flop
Seat 4: er13to (big blind) folded before Flop
Seat 5: matiko09 folded before Flop (didn't bet)
Seat 6: huffwag showed [Ks Js] and lost with a pair of Jacks
Seat 7: Venomous100% showed [9c 9h] and won ($37.63) with three of a kind, Nines
Seat 8: gabi_igna folded before Flop (didn't bet)





PokerStars Hand #148833573186:  Hold'em No Limit ($0.25/$0.50 USD) - 2016/02/15 11:24:08 CET [2016/02/15 5:24:08 ET]
Table 'Vesta II' 9-max Seat #6 is the button
Seat 3: matiko09 ($50 in chips) 
Seat 4: vlad11122007 ($57.78 in chips) 
Seat 5: dndngod ($73.15 in chips) 
Seat 6: pandalapa ($51.35 in chips) 
Seat 7: ruyingren ($70.29 in chips) 
Seat 8: Arystan ($142.70 in chips) 
ruyingren: posts small blind $0.25
Arystan: posts big blind $0.50
etny99: sits out 
ljryviltj: sits out 
*** HOLE CARDS ***
Dealt to matiko09 [Jh 8d]
matiko09: folds 
vlad11122007: raises $1 to $1.50
dndngod: folds 
pandalapa: folds 
ruyingren: folds 
Arystan: calls $1
*** FLOP *** [6h Ac Kd]
Arystan: checks 
vlad11122007: bets $2.10
Arystan: folds 
Uncalled bet ($2.10) returned to vlad11122007
vlad11122007 collected $3.10 from pot
vlad11122007: doesn't show hand 
*** SUMMARY ***
Total pot $3.25 | Rake $0.15 
Board [6h Ac Kd]
Seat 3: matiko09 folded before Flop (didn't bet)
Seat 4: vlad11122007 collected ($3.10)
Seat 5: dndngod folded before Flop (didn't bet)
Seat 6: pandalapa (button) folded before Flop (didn't bet)
Seat 7: ruyingren (small blind) folded before Flop
Seat 8: Arystan (big blind) folded on the Flop





PokerStars Hand #148833573082:  Hold'em No Limit ($0.50/$1.00 USD) - 2016/02/15 11:24:08 CET [2016/02/15 5:24:08 ET]
Table 'Nata II' 9-max Seat #2 is the button
Seat 1: Priidix ($125.61 in chips) 
Seat 2: qqcom ($100 in chips) 
Seat 3: g00000se ($118.95 in chips) 
Seat 4: gabi_igna ($100 in chips) 
Seat 5: AGoodFell4 ($90.62 in chips) 
Seat 6: AlKatrone ($134.20 in chips) 
Seat 7: er13to ($115.65 in chips) 
Seat 9: matiko09 ($100 in chips) 
g00000se: posts small blind $0.50
gabi_igna: posts big blind $1
lumen21: sits out 
*** HOLE CARDS ***
Dealt to matiko09 [5c 8s]
AGoodFell4: folds 
AlKatrone has timed out
AlKatrone: folds 
er13to: folds 
matiko09: folds 
Priidix: folds 
qqcom: raises $2 to $3
g00000se: folds 
gabi_igna: folds 
Uncalled bet ($2) returned to qqcom
qqcom collected $2.50 from pot
*** SUMMARY ***
Total pot $2.50 | Rake $0 
Seat 1: Priidix folded before Flop (didn't bet)
Seat 2: qqcom (button) collected ($2.50)
Seat 3: g00000se (small blind) folded before Flop
Seat 4: gabi_igna (big blind) folded before Flop
Seat 5: AGoodFell4 folded before Flop (didn't bet)
Seat 6: AlKatrone folded before Flop (didn't bet)
Seat 7: er13to folded before Flop (didn't bet)
Seat 9: matiko09 folded before Flop (didn't bet)





PokerStars Hand #148833576589:  Hold'em No Limit ($0.50/$1.00 USD) - 2016/02/15 11:24:15 CET [2016/02/15 5:24:15 ET]
Table 'Ristenpart' 9-max Seat #4 is the button
Seat 2: IHouseMusic ($114.33 in chips) 
Seat 3: lumen21 ($100 in chips) 
Seat 4: miyashin ($106.42 in chips) 
Seat 6: matiko09 ($119.94 in chips) 
Seat 8: gwwsb ($92 in chips) 
redacesfull will be allowed to play after the button
matiko09: posts small blind $0.50
Aalleekks: is sitting out 
gwwsb: posts big blind $1
gabi_igna: sits out 
*** HOLE CARDS ***
Dealt to matiko09 [7s 8s]
IHouseMusic: folds 
lumen21: folds 
Aalleekks leaves the table
miyashin: folds 
Kalesmash08 joins the table at seat #7 
matiko09: raises $1.50 to $2.50
gwwsb: calls $1.50
*** FLOP *** [Kc 9d 6s]
matiko09: bets $3.11
gwwsb: calls $3.11
*** TURN *** [Kc 9d 6s] [8c]
matiko09: checks 
gwwsb: checks 
*** RIVER *** [Kc 9d 6s 8c] [4c]
matiko09: checks 
gwwsb: bets $8
matiko09: folds 
Uncalled bet ($8) returned to gwwsb
gwwsb collected $10.72 from pot
gwwsb: doesn't show hand 
*** SUMMARY ***
Total pot $11.22 | Rake $0.50 
Board [Kc 9d 6s 8c 4c]
Seat 2: IHouseMusic folded before Flop (didn't bet)
Seat 3: lumen21 folded before Flop (didn't bet)
Seat 4: miyashin (button) folded before Flop (didn't bet)
Seat 6: matiko09 (small blind) folded on the River
Seat 8: gwwsb (big blind) collected ($10.72)





PokerStars Hand #148833578253:  Hold'em No Limit ($0.50/$1.00 USD) - 2016/02/15 11:24:19 CET [2016/02/15 5:24:19 ET]
Table 'Euanthe II' 9-max Seat #4 is the button
Seat 2: mahalko0925 ($84.50 in chips) 
Seat 3: matiko09 ($126.77 in chips) 
Seat 4: er13to ($115.88 in chips) 
Seat 5: gabi_igna ($100 in chips) 
Seat 6: IHouseMusic ($100 in chips) 
Seat 7: vinniesmol ($221.80 in chips) 
Seat 8: Sashey2708 ($100.29 in chips) 
Seat 9: Venomous100% ($115.22 in chips) 
gabi_igna: posts small blind $0.50
IHouseMusic: posts big blind $1
*** HOLE CARDS ***
Dealt to matiko09 [Qd 9s]
vinniesmol: folds 
Sashey2708: raises $2 to $3
Venomous100%: folds 
mahalko0925: folds 
matiko09: folds 
er13to: folds 
gabi_igna: folds 
IHouseMusic: folds 
Uncalled bet ($2) returned to Sashey2708
Sashey2708 collected $2.50 from pot
Sashey2708: doesn't show hand 
*** SUMMARY ***
Total pot $2.50 | Rake $0 
Seat 2: mahalko0925 folded before Flop (didn't bet)
Seat 3: matiko09 folded before Flop (didn't bet)
Seat 4: er13to (button) folded before Flop (didn't bet)
Seat 5: gabi_igna (small blind) folded before Flop
Seat 6: IHouseMusic (big blind) folded before Flop
Seat 7: vinniesmol folded before Flop (didn't bet)
Seat 8: Sashey2708 collected ($2.50)
Seat 9: Venomous100% folded before Flop (didn't bet)





PokerStars Hand #148833580389:  Hold'em No Limit ($0.25/$0.50 USD) - 2016/02/15 11:24:23 CET [2016/02/15 5:24:23 ET]
Table 'Laertes II' 9-max Seat #3 is the button
Seat 1: etny99 ($50 in chips) 
Seat 2: beluccix ($24.21 in chips) 
Seat 3: valfan911 ($51 in chips) 
Seat 4: rgar93 ($41.47 in chips) 
Seat 6: ZonTTT ($50 in chips) 
Seat 7: Vedpapa ($67.74 in chips) 
Seat 8: Trent444 ($43.35 in chips) 
Seat 9: matiko09 ($53.35 in chips) 
rgar93: posts small blind $0.25
ZonTTT: posts big blind $0.50
*** HOLE CARDS ***
Dealt to matiko09 [3c 6c]
Sherlockplay joins the table at seat #5 
Vedpapa: raises $1 to $1.50
Trent444: folds 
matiko09: folds 
etny99: folds 
beluccix: folds 
valfan911: calls $1.50
rgar93: raises $5 to $6.50
ZonTTT: folds 
Vedpapa: folds 
valfan911: folds 
Uncalled bet ($5) returned to rgar93
rgar93 collected $5 from pot
*** SUMMARY ***
Total pot $5 | Rake $0 
Seat 1: etny99 folded before Flop (didn't bet)
Seat 2: beluccix folded before Flop (didn't bet)
Seat 3: valfan911 (button) folded before Flop
Seat 4: rgar93 (small blind) collected ($5)
Seat 6: ZonTTT (big blind) folded before Flop
Seat 7: Vedpapa folded before Flop
Seat 8: Trent444 folded before Flop (didn't bet)
Seat 9: matiko09 folded before Flop (didn't bet)





PokerStars Hand #148833584689:  Hold'em No Limit ($0.50/$1.00 USD) - 2016/02/15 11:24:32 CET [2016/02/15 5:24:32 ET]
Table 'Octans II' 9-max Seat #3 is the button
Seat 2: matiko09 ($245.68 in chips) 
Seat 3: Aalleekks ($100 in chips) 
Seat 4: Venomous100% ($165.72 in chips) 
Seat 6: er13to ($100 in chips) 
Seat 7: traficblues ($55.23 in chips) 
Seat 8: IHouseMusic ($129.93 in chips) 
Seat 9: mycka86 ($103.43 in chips) 
Venomous100%: posts small blind $0.50
AlKatrone: is sitting out 
er13to: posts big blind $1
*** HOLE CARDS ***
Dealt to matiko09 [Qc Qd]
traficblues: folds 
IHouseMusic: folds 
AlKatrone leaves the table
mycka86: folds 
matiko09: raises $1.50 to $2.50
Aalleekks: folds 
Priidix joins the table at seat #5 
Venomous100%: raises $4.50 to $7
er13to: folds 
matiko09: raises $10 to $17
Venomous100%: calls $10
*** FLOP *** [Ks 2d Ad]
Venomous100%: checks 
matiko09: checks 
*** TURN *** [Ks 2d Ad] [Ac]
Venomous100%: bets $12
matiko09: folds 
Uncalled bet ($12) returned to Venomous100%
Venomous100% collected $33.42 from pot
Venomous100%: doesn't show hand 
*** SUMMARY ***
Total pot $35 | Rake $1.58 
Board [Ks 2d Ad Ac]
Seat 2: matiko09 folded on the Turn
Seat 3: Aalleekks (button) folded before Flop (didn't bet)
Seat 4: Venomous100% (small blind) collected ($33.42)
Seat 6: er13to (big blind) folded before Flop
Seat 7: traficblues folded before Flop (didn't bet)
Seat 8: IHouseMusic folded before Flop (didn't bet)
Seat 9: mycka86 folded before Flop (didn't bet)





PokerStars Hand #148833585466:  Hold'em No Limit ($0.50/$1.00 USD) - 2016/02/15 11:24:34 CET [2016/02/15 5:24:34 ET]
Table 'Corvus III' 9-max Seat #6 is the button
Seat 1: pk4DW ($128.42 in chips) 
Seat 2: mzsportline ($96.30 in chips) 
Seat 3: VanDobeln ($245.32 in chips) 
Seat 4: goransyruvka ($111.75 in chips) 
Seat 6: Priidix ($141.63 in chips) 
Seat 7: matiko09 ($303.79 in chips) 
Seat 8: redacesfull ($244.18 in chips) 
Seat 9: er13to ($101.72 in chips) 
matiko09: posts small blind $0.50
redacesfull: posts big blind $1
pk4DW: posts the ante $0.20
mzsportline: posts the ante $0.20
VanDobeln: posts the ante $0.20
goransyruvka: posts the ante $0.20
Priidix: posts the ante $0.20
matiko09: posts the ante $0.20
redacesfull: posts the ante $0.20
er13to: posts the ante $0.20
*** HOLE CARDS ***
Dealt to matiko09 [3c 6h]
er13to: folds 
pk4DW: raises $1.22 to $2.22
mzsportline: folds 
VanDobeln: folds 
goransyruvka: folds 
Priidix: folds 
matiko09: folds 
redacesfull: folds 
Uncalled bet ($1.22) returned to pk4DW
pk4DW collected $4.10 from pot
pk4DW: doesn't show hand 
*** SUMMARY ***
Total pot $4.10 | Rake $0 
Seat 1: pk4DW collected ($4.10)
Seat 2: mzsportline folded before Flop (didn't bet)
Seat 3: VanDobeln folded before Flop (didn't bet)
Seat 4: goransyruvka folded before Flop (didn't bet)
Seat 6: Priidix (button) folded before Flop (didn't bet)
Seat 7: matiko09 (small blind) folded before Flop
Seat 8: redacesfull (big blind) folded before Flop
Seat 9: er13to folded before Flop (didn't bet)





PokerStars Hand #148833587432:  Hold'em No Limit ($0.50/$1.00 USD) - 2016/02/15 11:24:38 CET [2016/02/15 5:24:38 ET]
Table 'Kitalpha II' 9-max Seat #1 is the button
Seat 1: IHouseMusic ($101 in chips) 
Seat 2: Charity86 ($79 in chips) 
Seat 3: matiko09 ($100 in chips) 
Seat 8: skram2 ($99.50 in chips) 
Seat 9: Waltz88 ($112.99 in chips) 
Charity86: posts small blind $0.50
matiko09: posts big blind $1
*** HOLE CARDS ***
Dealt to matiko09 [6d Ks]
skram2: folds 
Waltz88: folds 
IHouseMusic: raises $1 to $2
Charity86: folds 
Sreshta222 joins the table at seat #4 
matiko09: folds 
Uncalled bet ($1) returned to IHouseMusic
IHouseMusic collected $2.50 from pot
IHouseMusic: doesn't show hand 
*** SUMMARY ***
Total pot $2.50 | Rake $0 
Seat 1: IHouseMusic (button) collected ($2.50)
Seat 2: Charity86 (small blind) folded before Flop
Seat 3: matiko09 (big blind) folded before Flop
Seat 8: skram2 folded before Flop (didn't bet)
Seat 9: Waltz88 folded before Flop (didn't bet)





PokerStars Hand #148833587270:  Hold'em No Limit ($0.50/$1.00 USD) - 2016/02/15 11:24:38 CET [2016/02/15 5:24:38 ET]
Table 'Euanthe II' 9-max Seat #5 is the button
Seat 2: mahalko0925 ($84.50 in chips) 
Seat 3: matiko09 ($126.77 in chips) 
Seat 4: er13to ($115.88 in chips) 
Seat 5: gabi_igna ($100 in chips) 
Seat 6: IHouseMusic ($100 in chips) 
Seat 7: vinniesmol ($221.80 in chips) 
Seat 8: Sashey2708 ($101.79 in chips) 
Seat 9: Venomous100% ($115.22 in chips) 
IHouseMusic: posts small blind $0.50
vinniesmol: posts big blind $1
*** HOLE CARDS ***
Dealt to matiko09 [8s Ah]
Sashey2708: folds 
Venomous100%: folds 
mahalko0925: raises $1 to $2
matiko09: folds 
er13to: calls $2
gabi_igna: folds 
IHouseMusic: folds 
vinniesmol: folds 
*** FLOP *** [Tc Kh 9c]
mahalko0925: checks 
er13to: checks 
*** TURN *** [Tc Kh 9c] [8h]
mahalko0925: checks 
er13to: bets $5
mahalko0925: calls $5
*** RIVER *** [Tc Kh 9c 8h] [4h]
mahalko0925: checks 
er13to: checks 
*** SHOW DOWN ***
mahalko0925: shows [Td Qs] (a pair of Tens)
er13to: shows [Kc Js] (a pair of Kings)
er13to collected $14.80 from pot
*** SUMMARY ***
Total pot $15.50 | Rake $0.70 
Board [Tc Kh 9c 8h 4h]
Seat 2: mahalko0925 showed [Td Qs] and lost with a pair of Tens
Seat 3: matiko09 folded before Flop (didn't bet)
Seat 4: er13to showed [Kc Js] and won ($14.80) with a pair of Kings
Seat 5: gabi_igna (button) folded before Flop (didn't bet)
Seat 6: IHouseMusic (small blind) folded before Flop
Seat 7: vinniesmol (big blind) folded before Flop
Seat 8: Sashey2708 folded before Flop (didn't bet)
Seat 9: Venomous100% folded before Flop (didn't bet)





PokerStars Hand #148833588183:  Hold'em No Limit ($0.50/$1.00 USD) - 2016/02/15 11:24:40 CET [2016/02/15 5:24:40 ET]
Table 'Anteros' 9-max Seat #3 is the button
Seat 1: redacesfull ($100 in chips) 
Seat 2: IHouseMusic ($115.25 in chips) 
Seat 3: er13to ($107.70 in chips) 
Seat 4: misherei ($169.51 in chips) 
Seat 5: Holm1991 ($45.75 in chips) 
Seat 7: Zoubou1983 ($194.11 in chips) 
Seat 8: matiko09 ($101.50 in chips) 
Seat 9: mycka86 ($100 in chips) 
misherei: posts small blind $0.50
Holm1991: posts big blind $1
SerAlGog: sits out 
*** HOLE CARDS ***
Dealt to matiko09 [9s Qd]
Zoubou1983: calls $1
matiko09: folds 
mycka86: folds 
redacesfull: folds 
IHouseMusic: folds 
er13to: folds 
misherei: raises $2 to $3
Holm1991: folds 
Zoubou1983: calls $2
*** FLOP *** [Ah 7d 9c]
misherei: checks 
Zoubou1983: checks 
*** TURN *** [Ah 7d 9c] [5h]
misherei: checks 
Zoubou1983: bets $3
misherei: folds 
Uncalled bet ($3) returned to Zoubou1983
Zoubou1983 collected $6.68 from pot
Zoubou1983: doesn't show hand 
*** SUMMARY ***
Total pot $7 | Rake $0.32 
Board [Ah 7d 9c 5h]
Seat 1: redacesfull folded before Flop (didn't bet)
Seat 2: IHouseMusic folded before Flop (didn't bet)
Seat 3: er13to (button) folded before Flop (didn't bet)
Seat 4: misherei (small blind) folded on the Turn
Seat 5: Holm1991 (big blind) folded before Flop
Seat 7: Zoubou1983 collected ($6.68)
Seat 8: matiko09 folded before Flop (didn't bet)
Seat 9: mycka86 folded before Flop (didn't bet)





PokerStars Hand #148833589703:  Hold'em No Limit ($0.25/$0.50 USD) - 2016/02/15 11:24:43 CET [2016/02/15 5:24:43 ET]
Table 'Vesta II' 9-max Seat #7 is the button
Seat 1: etny99 ($50 in chips) 
Seat 3: matiko09 ($50 in chips) 
Seat 4: vlad11122007 ($59.38 in chips) 
Seat 5: dndngod ($73.15 in chips) 
Seat 6: pandalapa ($51.35 in chips) 
Seat 7: ruyingren ($70.04 in chips) 
Seat 8: Arystan ($141.20 in chips) 
Arystan: posts small blind $0.25
etny99: posts big blind $0.50
ljryviltj: sits out 
*** HOLE CARDS ***
Dealt to matiko09 [Qh Td]
matiko09: folds 
vlad11122007: folds 
dndngod: folds 
pandalapa: folds 
ruyingren: folds 
Arystan: raises $1 to $1.50
etny99: folds 
Uncalled bet ($1) returned to Arystan
Arystan collected $1 from pot
Arystan: doesn't show hand 
*** SUMMARY ***
Total pot $1 | Rake $0 
Seat 1: etny99 (big blind) folded before Flop
Seat 3: matiko09 folded before Flop (didn't bet)
Seat 4: vlad11122007 folded before Flop (didn't bet)
Seat 5: dndngod folded before Flop (didn't bet)
Seat 6: pandalapa folded before Flop (didn't bet)
Seat 7: ruyingren (button) folded before Flop (didn't bet)
Seat 8: Arystan (small blind) collected ($1)





PokerStars Hand #148833592018:  Hold'em No Limit ($0.50/$1.00 USD) - 2016/02/15 11:24:48 CET [2016/02/15 5:24:48 ET]
Table 'Saldanha' 9-max Seat #2 is the button
Seat 1: mycka86 ($108.69 in chips) 
Seat 2: Congo Sam ($99.38 in chips) 
Seat 4: er13to ($105.34 in chips) 
Seat 5: matiko09 ($109.50 in chips) 
Seat 7: Venomous100% ($166.57 in chips) 
Seat 8: gabi_igna ($109.14 in chips) 
er13to: posts small blind $0.50
matiko09: posts big blind $1
*** HOLE CARDS ***
Dealt to matiko09 [Qc Kc]
Venomous100%: folds 
huffwag leaves the table
gabi_igna: folds 
mycka86: raises $1.10 to $2.10
AlKatrone joins the table at seat #6 
Congo Sam: calls $2.10
er13to: folds 
SerAlGog leaves the table
matiko09: raises $7.90 to $10
mycka86: folds 
Congo Sam: folds 
Uncalled bet ($7.90) returned to matiko09
matiko09 collected $6.80 from pot
masaytoo joins the table at seat #9 
matiko09: doesn't show hand 
*** SUMMARY ***
Total pot $6.80 | Rake $0 
Seat 1: mycka86 folded before Flop
Seat 2: Congo Sam (button) folded before Flop
Seat 4: er13to (small blind) folded before Flop
Seat 5: matiko09 (big blind) collected ($6.80)
Seat 7: Venomous100% folded before Flop (didn't bet)
Seat 8: gabi_igna folded before Flop (didn't bet)





PokerStars Hand #148833594907:  Hold'em No Limit ($0.50/$1.00 USD) - 2016/02/15 11:24:54 CET [2016/02/15 5:24:54 ET]
Table 'Nata II' 9-max Seat #3 is the button
Seat 1: Priidix ($125.61 in chips) 
Seat 2: qqcom ($101.50 in chips) 
Seat 3: g00000se ($118.45 in chips) 
Seat 4: gabi_igna ($100 in chips) 
Seat 5: AGoodFell4 ($90.62 in chips) 
Seat 6: AlKatrone ($134.20 in chips) 
Seat 7: er13to ($115.65 in chips) 
Seat 9: matiko09 ($100 in chips) 
gabi_igna: posts small blind $0.50
AGoodFell4: posts big blind $1
lumen21: sits out 
*** HOLE CARDS ***
Dealt to matiko09 [7c 3d]
AlKatrone: raises $2 to $3
er13to: folds 
matiko09: folds 
Priidix: folds 
qqcom: folds 
g00000se: folds 
gabi_igna: folds 
AGoodFell4: calls $2
*** FLOP *** [Qd 7d Qc]
AGoodFell4: checks 
AlKatrone: checks 
*** TURN *** [Qd 7d Qc] [3h]
AGoodFell4: bets $7
AlKatrone: calls $7
*** RIVER *** [Qd 7d Qc 3h] [2d]
AGoodFell4: bets $5
AlKatrone: calls $5
*** SHOW DOWN ***
AGoodFell4: shows [8c 7s] (two pair, Queens and Sevens)
AlKatrone: shows [Kd Kc] (two pair, Kings and Queens)
AlKatrone collected $29.13 from pot
*** SUMMARY ***
Total pot $30.50 | Rake $1.37 
Board [Qd 7d Qc 3h 2d]
Seat 1: Priidix folded before Flop (didn't bet)
Seat 2: qqcom folded before Flop (didn't bet)
Seat 3: g00000se (button) folded before Flop (didn't bet)
Seat 4: gabi_igna (small blind) folded before Flop
Seat 5: AGoodFell4 (big blind) showed [8c 7s] and lost with two pair, Queens and Sevens
Seat 6: AlKatrone showed [Kd Kc] and won ($29.13) with two pair, Kings and Queens
Seat 7: er13to folded before Flop (didn't bet)
Seat 9: matiko09 folded before Flop (didn't bet)





PokerStars Hand #148833602184:  Hold'em No Limit ($0.50/$1.00 USD) - 2016/02/15 11:25:10 CET [2016/02/15 5:25:10 ET]
Table 'Praecipua' 9-max Seat #5 is the button
Seat 1: er13to ($133.93 in chips) 
Seat 2: matiko09 ($112.20 in chips) 
Seat 3: Venomous100% ($133.01 in chips) 
Seat 4: gabi_igna ($100 in chips) 
Seat 5: huffwag ($162.65 in chips) 
Seat 6: mycka86 ($109 in chips) 
Seat 8: Ellis Ng ($36.92 in chips) 
Seat 9: AlKatrone ($100 in chips) 
mycka86: posts small blind $0.50
maxxmeister: is sitting out 
Ellis Ng: posts big blind $1
*** HOLE CARDS ***
Dealt to matiko09 [2h 9c]
AlKatrone: folds 
er13to: folds 
matiko09: folds 
Venomous100%: folds 
gabi_igna: folds 
huffwag: folds 
mycka86: raises $1.75 to $2.75
Ellis Ng: raises $5.50 to $8.25
mycka86: folds 
Uncalled bet ($5.50) returned to Ellis Ng
Ellis Ng collected $5.50 from pot
*** SUMMARY ***
Total pot $5.50 | Rake $0 
Seat 1: er13to folded before Flop (didn't bet)
Seat 2: matiko09 folded before Flop (didn't bet)
Seat 3: Venomous100% folded before Flop (didn't bet)
Seat 4: gabi_igna folded before Flop (didn't bet)
Seat 5: huffwag (button) folded before Flop (didn't bet)
Seat 6: mycka86 (small blind) folded before Flop
Seat 8: Ellis Ng (big blind) collected ($5.50)
Seat 9: AlKatrone folded before Flop (didn't bet)





PokerStars Hand #148833604113:  Hold'em No Limit ($0.50/$1.00 USD) - 2016/02/15 11:25:14 CET [2016/02/15 5:25:14 ET]
Table 'Corvus III' 9-max Seat #7 is the button
Seat 1: pk4DW ($131.32 in chips) 
Seat 2: mzsportline ($96.10 in chips) 
Seat 3: VanDobeln ($245.12 in chips) 
Seat 4: goransyruvka ($111.55 in chips) 
Seat 6: Priidix ($141.43 in chips) 
Seat 7: matiko09 ($303.09 in chips) 
Seat 8: redacesfull ($242.98 in chips) 
Seat 9: er13to ($101.52 in chips) 
redacesfull: posts small blind $0.50
er13to: posts big blind $1
pk4DW: posts the ante $0.20
mzsportline: posts the ante $0.20
VanDobeln: posts the ante $0.20
goransyruvka: posts the ante $0.20
Priidix: posts the ante $0.20
matiko09: posts the ante $0.20
redacesfull: posts the ante $0.20
er13to: posts the ante $0.20
*** HOLE CARDS ***
Dealt to matiko09 [Ad 5h]
pk4DW: folds 
mzsportline: folds 
VanDobeln: folds 
goransyruvka: calls $1
Priidix: folds 
matiko09: raises $3 to $4
redacesfull: folds 
er13to: folds 
goransyruvka: calls $3
*** FLOP *** [3s 8s 7h]
goransyruvka: checks 
matiko09: checks 
*** TURN *** [3s 8s 7h] [2s]
goransyruvka: checks 
matiko09: checks 
*** RIVER *** [3s 8s 7h 2s] [Ts]
goransyruvka: checks 
matiko09: checks 
*** SHOW DOWN ***
goransyruvka: shows [As Jc] (a flush, Ace high)
matiko09: mucks hand 
goransyruvka collected $10.60 from pot
*** SUMMARY ***
Total pot $11.10 | Rake $0.50 
Board [3s 8s 7h 2s Ts]
Seat 1: pk4DW folded before Flop (didn't bet)
Seat 2: mzsportline folded before Flop (didn't bet)
Seat 3: VanDobeln folded before Flop (didn't bet)
Seat 4: goransyruvka showed [As Jc] and won ($10.60) with a flush, Ace high
Seat 6: Priidix folded before Flop (didn't bet)
Seat 7: matiko09 (button) mucked [Ad 5h]
Seat 8: redacesfull (small blind) folded before Flop
Seat 9: er13to (big blind) folded before Flop





PokerStars Hand #148833606702:  Hold'em No Limit ($0.50/$1.00 USD) - 2016/02/15 11:25:20 CET [2016/02/15 5:25:20 ET]
Table 'Kitalpha II' 9-max Seat #2 is the button
Seat 1: IHouseMusic ($102.50 in chips) 
Seat 2: Charity86 ($78.50 in chips) 
Seat 3: matiko09 ($100 in chips) 
Seat 4: Sreshta222 ($100 in chips) 
Seat 8: skram2 ($99.50 in chips) 
Seat 9: Waltz88 ($112.99 in chips) 
matiko09: posts small blind $0.50
Sreshta222: posts big blind $1
*** HOLE CARDS ***
Dealt to matiko09 [6c 9d]
skram2: raises $1 to $2
Waltz88: folds 
IHouseMusic: folds 
Charity86: folds 
matiko09: folds 
Sreshta222: folds 
Uncalled bet ($1) returned to skram2
skram2 collected $2.50 from pot
skram2: doesn't show hand 
*** SUMMARY ***
Total pot $2.50 | Rake $0 
Seat 1: IHouseMusic folded before Flop (didn't bet)
Seat 2: Charity86 (button) folded before Flop (didn't bet)
Seat 3: matiko09 (small blind) folded before Flop
Seat 4: Sreshta222 (big blind) folded before Flop
Seat 8: skram2 collected ($2.50)
Seat 9: Waltz88 folded before Flop (didn't bet)





PokerStars Hand #148833608887:  Hold'em No Limit ($0.25/$0.50 USD) - 2016/02/15 11:25:24 CET [2016/02/15 5:25:24 ET]
Table 'Vesta II' 9-max Seat #8 is the button
Seat 1: etny99 ($50 in chips) 
Seat 2: ljryviltj ($50 in chips) 
Seat 3: matiko09 ($50 in chips) 
Seat 4: vlad11122007 ($59.38 in chips) 
Seat 5: dndngod ($73.15 in chips) 
Seat 6: pandalapa ($51.35 in chips) 
Seat 7: ruyingren ($70.04 in chips) 
Seat 8: Arystan ($141.70 in chips) 
etny99: posts small blind $0.25
ljryviltj: posts big blind $0.50
*** HOLE CARDS ***
Dealt to matiko09 [Jh Ah]
matiko09: raises $1 to $1.50
vlad11122007: folds 
dndngod: folds 
pandalapa: folds 
ruyingren: folds 
Arystan: folds 
etny99: folds 
ljryviltj: folds 
Uncalled bet ($1) returned to matiko09
matiko09 collected $1.25 from pot
matiko09: doesn't show hand 
*** SUMMARY ***
Total pot $1.25 | Rake $0 
Seat 1: etny99 (small blind) folded before Flop
Seat 2: ljryviltj (big blind) folded before Flop
Seat 3: matiko09 collected ($1.25)
Seat 4: vlad11122007 folded before Flop (didn't bet)
Seat 5: dndngod folded before Flop (didn't bet)
Seat 6: pandalapa folded before Flop (didn't bet)
Seat 7: ruyingren folded before Flop (didn't bet)
Seat 8: Arystan (button) folded before Flop (didn't bet)





PokerStars Hand #148833611061:  Hold'em No Limit ($0.25/$0.50 USD) - 2016/02/15 11:25:29 CET [2016/02/15 5:25:29 ET]
Table 'Laertes II' 9-max Seat #4 is the button
Seat 1: etny99 ($50 in chips) 
Seat 2: beluccix ($24.21 in chips) 
Seat 3: valfan911 ($49.50 in chips) 
Seat 4: rgar93 ($44.97 in chips) 
Seat 6: ZonTTT ($50 in chips) 
Seat 7: Vedpapa ($66.24 in chips) 
Seat 8: Trent444 ($43.35 in chips) 
Seat 9: matiko09 ($53.35 in chips) 
Sherlockplay will be allowed to play after the button
ZonTTT: posts small blind $0.25
Vedpapa: posts big blind $0.50
*** HOLE CARDS ***
Dealt to matiko09 [3s 7d]
Trent444: calls $0.50
matiko09: folds 
etny99: folds 
beluccix: raises $1 to $1.50
valfan911: folds 
rgar93: raises $1.50 to $3
ZonTTT: folds 
Vedpapa: folds 
Trent444: folds 
beluccix: folds 
Uncalled bet ($1.50) returned to rgar93
rgar93 collected $4.25 from pot
rgar93: doesn't show hand 
*** SUMMARY ***
Total pot $4.25 | Rake $0 
Seat 1: etny99 folded before Flop (didn't bet)
Seat 2: beluccix folded before Flop
Seat 3: valfan911 folded before Flop (didn't bet)
Seat 4: rgar93 (button) collected ($4.25)
Seat 6: ZonTTT (small blind) folded before Flop
Seat 7: Vedpapa (big blind) folded before Flop
Seat 8: Trent444 folded before Flop
Seat 9: matiko09 folded before Flop (didn't bet)





PokerStars Hand #148833614800:  Hold'em No Limit ($0.50/$1.00 USD) - 2016/02/15 11:25:37 CET [2016/02/15 5:25:37 ET]
Table 'Anteros' 9-max Seat #4 is the button
Seat 1: redacesfull ($100 in chips) 
Seat 2: IHouseMusic ($115.25 in chips) 
Seat 3: er13to ($107.70 in chips) 
Seat 4: misherei ($166.51 in chips) 
Seat 5: Holm1991 ($44.75 in chips) 
Seat 6: SerAlGog ($138.31 in chips) 
Seat 7: Zoubou1983 ($197.79 in chips) 
Seat 8: matiko09 ($101.50 in chips) 
Seat 9: mycka86 ($100 in chips) 
Holm1991: posts small blind $0.50
SerAlGog: posts big blind $1
*** HOLE CARDS ***
Dealt to matiko09 [Th Ac]
Zoubou1983: folds 
matiko09: folds 
mycka86: folds 
redacesfull: folds 
IHouseMusic: folds 
er13to: raises $1.50 to $2.50
misherei: calls $2.50
Holm1991: folds 
SerAlGog: folds 
*** FLOP *** [6d Ts Kh]
er13to: bets $3.23
misherei: calls $3.23
*** TURN *** [6d Ts Kh] [Ks]
er13to: checks 
misherei: checks 
*** RIVER *** [6d Ts Kh Ks] [2s]
er13to: checks 
misherei: checks 
*** SHOW DOWN ***
er13to: shows [Qs Jd] (a pair of Kings)
misherei: shows [Td Qd] (two pair, Kings and Tens)
misherei collected $12.38 from pot
*** SUMMARY ***
Total pot $12.96 | Rake $0.58 
Board [6d Ts Kh Ks 2s]
Seat 1: redacesfull folded before Flop (didn't bet)
Seat 2: IHouseMusic folded before Flop (didn't bet)
Seat 3: er13to showed [Qs Jd] and lost with a pair of Kings
Seat 4: misherei (button) showed [Td Qd] and won ($12.38) with two pair, Kings and Tens
Seat 5: Holm1991 (small blind) folded before Flop
Seat 6: SerAlGog (big blind) folded before Flop
Seat 7: Zoubou1983 folded before Flop (didn't bet)
Seat 8: matiko09 folded before Flop (didn't bet)
Seat 9: mycka86 folded before Flop (didn't bet)





PokerStars Hand #148833615369:  Hold'em No Limit (€0.50/€1.00 EUR) - 2016/02/15 11:25:38 CET [2016/02/15 5:25:38 ET]
Table 'Ganesa II' 9-max Seat #9 is the button
Seat 1: AARON1953 (€1 in chips) 
Seat 3: BuBu 0187 (€74.84 in chips) 
Seat 4: Sreshta222 (€132.33 in chips) 
Seat 5: vano7777 (€69.24 in chips) 
Seat 6: matiko09 (€109.58 in chips) 
Seat 7: er13to (€117.50 in chips) 
Seat 8: mycka86 (€100 in chips) 
Seat 9: Priidix (€173.85 in chips) 
AARON1953: posts small blind €0.50
BuBu 0187: posts big blind €1
*** HOLE CARDS ***
Dealt to matiko09 [Qh 2c]
Sreshta222: folds 
vano7777: folds 
matiko09: folds 
er13to: folds 
mycka86: folds 
Priidix: raises €1.60 to €2.60
AARON1953: calls €0.50 and is all-in
BuBu 0187: folds 
Uncalled bet (€1.60) returned to Priidix
*** FLOP *** [Ad Qs Jd]
*** TURN *** [Ad Qs Jd] [2s]
*** RIVER *** [Ad Qs Jd 2s] [8d]
*** SHOW DOWN ***
AARON1953: shows [Ac As] (three of a kind, Aces)
Priidix: shows [5s 6d] (high card Ace)
AARON1953 collected €2.86 from pot
*** SUMMARY ***
Total pot €3 | Rake €0.14 
Board [Ad Qs Jd 2s 8d]
Seat 1: AARON1953 (small blind) showed [Ac As] and won (€2.86) with three of a kind, Aces
Seat 3: BuBu 0187 (big blind) folded before Flop
Seat 4: Sreshta222 folded before Flop (didn't bet)
Seat 5: vano7777 folded before Flop (didn't bet)
Seat 6: matiko09 folded before Flop (didn't bet)
Seat 7: er13to folded before Flop (didn't bet)
Seat 8: mycka86 folded before Flop (didn't bet)
Seat 9: Priidix (button) showed [5s 6d] and lost with high card Ace





PokerStars Hand #148833616332:  Hold'em No Limit ($0.50/$1.00 USD) - 2016/02/15 11:25:40 CET [2016/02/15 5:25:40 ET]
Table 'Kitalpha II' 9-max Seat #3 is the button
Seat 1: IHouseMusic ($102.50 in chips) 
Seat 2: Charity86 ($78.50 in chips) 
Seat 3: matiko09 ($100 in chips) 
Seat 4: Sreshta222 ($100 in chips) 
Seat 8: skram2 ($101 in chips) 
Seat 9: Waltz88 ($112.99 in chips) 
Sreshta222: posts small blind $0.50
skram2: posts big blind $1
*** HOLE CARDS ***
Dealt to matiko09 [8d Js]
Waltz88: calls $1
IHouseMusic: folds 
Charity86: raises $3 to $4
matiko09: folds 
Sreshta222: folds 
skram2: folds 
Waltz88: folds 
Uncalled bet ($3) returned to Charity86
Charity86 collected $3.50 from pot
*** SUMMARY ***
Total pot $3.50 | Rake $0 
Seat 1: IHouseMusic folded before Flop (didn't bet)
Seat 2: Charity86 collected ($3.50)
Seat 3: matiko09 (button) folded before Flop (didn't bet)
Seat 4: Sreshta222 (small blind) folded before Flop
Seat 8: skram2 (big blind) folded before Flop
Seat 9: Waltz88 folded before Flop





PokerStars Hand #148833617353:  Hold'em No Limit ($0.50/$1.00 USD) - 2016/02/15 11:25:42 CET [2016/02/15 5:25:42 ET]
Table 'Saldanha' 9-max Seat #4 is the button
Seat 1: mycka86 ($106.59 in chips) 
Seat 2: Congo Sam ($97.28 in chips) 
Seat 4: er13to ($104.84 in chips) 
Seat 5: matiko09 ($114.20 in chips) 
Seat 6: AlKatrone ($217.21 in chips) 
Seat 7: Venomous100% ($166.57 in chips) 
Seat 8: gabi_igna ($109.14 in chips) 
matiko09: posts small blind $0.50
AlKatrone: posts big blind $1
masaytoo: sits out 
*** HOLE CARDS ***
Dealt to matiko09 [4s 5c]
masaytoo leaves the table
Venomous100%: folds 
gabi_igna: raises $2 to $3
mycka86: folds 
Congo Sam: folds 
er13to: folds 
matiko09: folds 
AlKatrone: folds 
Uncalled bet ($2) returned to gabi_igna
gabi_igna collected $2.50 from pot
gabi_igna: doesn't show hand 
*** SUMMARY ***
Total pot $2.50 | Rake $0 
Seat 1: mycka86 folded before Flop (didn't bet)
Seat 2: Congo Sam folded before Flop (didn't bet)
Seat 4: er13to (button) folded before Flop (didn't bet)
Seat 5: matiko09 (small blind) folded before Flop
Seat 6: AlKatrone (big blind) folded before Flop
Seat 7: Venomous100% folded before Flop (didn't bet)
Seat 8: gabi_igna collected ($2.50)





PokerStars Hand #148833617783:  Hold'em No Limit ($0.50/$1.00 USD) - 2016/02/15 11:25:43 CET [2016/02/15 5:25:43 ET]
Table 'Euanthe II' 9-max Seat #6 is the button
Seat 2: mahalko0925 ($77.50 in chips) 
Seat 3: matiko09 ($126.77 in chips) 
Seat 4: er13to ($123.68 in chips) 
Seat 5: gabi_igna ($100 in chips) 
Seat 6: IHouseMusic ($100 in chips) 
Seat 7: vinniesmol ($220.80 in chips) 
Seat 8: Sashey2708 ($101.79 in chips) 
Seat 9: Venomous100% ($115.22 in chips) 
vinniesmol: posts small blind $0.50
Sashey2708: posts big blind $1
*** HOLE CARDS ***
Dealt to matiko09 [2c 3c]
Venomous100%: folds 
mahalko0925: folds 
matiko09: folds 
er13to: raises $1.50 to $2.50
gabi_igna: raises $6.50 to $9
IHouseMusic: folds 
vinniesmol: folds 
Sashey2708: calls $8
er13to: folds 
*** FLOP *** [Kc 6s 2s]
Sashey2708: bets $4
gabi_igna: calls $4
*** TURN *** [Kc 6s 2s] [3s]
Sashey2708: bets $12
gabi_igna: calls $12
*** RIVER *** [Kc 6s 2s 3s] [2d]
Sashey2708: bets $20
gabi_igna: calls $20
*** SHOW DOWN ***
Sashey2708: shows [Td Ad] (a pair of Deuces)
gabi_igna: shows [Qd Kh] (two pair, Kings and Deuces)
gabi_igna collected $90.20 from pot
*** SUMMARY ***
Total pot $93 | Rake $2.80 
Board [Kc 6s 2s 3s 2d]
Seat 2: mahalko0925 folded before Flop (didn't bet)
Seat 3: matiko09 folded before Flop (didn't bet)
Seat 4: er13to folded before Flop
Seat 5: gabi_igna showed [Qd Kh] and won ($90.20) with two pair, Kings and Deuces
Seat 6: IHouseMusic (button) folded before Flop (didn't bet)
Seat 7: vinniesmol (small blind) folded before Flop
Seat 8: Sashey2708 (big blind) showed [Td Ad] and lost with a pair of Deuces
Seat 9: Venomous100% folded before Flop (didn't bet)





PokerStars Hand #148833621354:  Hold'em No Limit ($0.25/$0.50 USD) - 2016/02/15 11:25:51 CET [2016/02/15 5:25:51 ET]
Table 'Vesta II' 9-max Seat #1 is the button
Seat 1: etny99 ($50 in chips) 
Seat 2: ljryviltj ($49.50 in chips) 
Seat 3: matiko09 ($50.75 in chips) 
Seat 4: vlad11122007 ($59.38 in chips) 
Seat 5: dndngod ($73.15 in chips) 
Seat 6: pandalapa ($51.35 in chips) 
Seat 7: ruyingren ($70.04 in chips) 
Seat 8: Arystan ($141.70 in chips) 
ljryviltj: posts small blind $0.25
matiko09: posts big blind $0.50
*** HOLE CARDS ***
Dealt to matiko09 [3h Tc]
vlad11122007: folds 
dndngod: raises $1 to $1.50
pandalapa: folds 
ruyingren: folds 
Arystan: calls $1.50
etny99: folds 
ljryviltj: folds 
matiko09: folds 
*** FLOP *** [9c Qc Ts]
dndngod: checks 
Arystan: checks 
*** TURN *** [9c Qc Ts] [Kd]
dndngod: checks 
Arystan: checks 
*** RIVER *** [9c Qc Ts Kd] [As]
dndngod: checks 
Arystan: checks 
*** SHOW DOWN ***
dndngod: shows [Ah Th] (two pair, Aces and Tens)
Arystan: mucks hand 
dndngod collected $3.58 from pot
*** SUMMARY ***
Total pot $3.75 | Rake $0.17 
Board [9c Qc Ts Kd As]
Seat 1: etny99 (button) folded before Flop (didn't bet)
Seat 2: ljryviltj (small blind) folded before Flop
Seat 3: matiko09 (big blind) folded before Flop
Seat 4: vlad11122007 folded before Flop (didn't bet)
Seat 5: dndngod showed [Ah Th] and won ($3.58) with two pair, Aces and Tens
Seat 6: pandalapa folded before Flop (didn't bet)
Seat 7: ruyingren folded before Flop (didn't bet)
Seat 8: Arystan mucked [Ac 4h]





PokerStars Hand #148833624657:  Hold'em No Limit ($0.50/$1.00 USD) - 2016/02/15 11:25:58 CET [2016/02/15 5:25:58 ET]
Table 'Octans II' 9-max Seat #4 is the button
Seat 2: matiko09 ($228.68 in chips) 
Seat 3: Aalleekks ($100 in chips) 
Seat 4: Venomous100% ($182.14 in chips) 
Seat 6: er13to ($100 in chips) 
Seat 7: traficblues ($55.23 in chips) 
Seat 8: IHouseMusic ($129.93 in chips) 
Seat 9: mycka86 ($103.43 in chips) 
Priidix will be allowed to play after the button
er13to: posts small blind $0.50
traficblues: posts big blind $1
*** HOLE CARDS ***
Dealt to matiko09 [9c 4d]
IHouseMusic: folds 
mycka86: folds 
matiko09: folds 
Aalleekks: folds 
Venomous100%: raises $2 to $3
er13to: folds 
traficblues: folds 
Uncalled bet ($2) returned to Venomous100%
Venomous100% collected $2.50 from pot
Venomous100%: doesn't show hand 
*** SUMMARY ***
Total pot $2.50 | Rake $0 
Seat 2: matiko09 folded before Flop (didn't bet)
Seat 3: Aalleekks folded before Flop (didn't bet)
Seat 4: Venomous100% (button) collected ($2.50)
Seat 6: er13to (small blind) folded before Flop
Seat 7: traficblues (big blind) folded before Flop
Seat 8: IHouseMusic folded before Flop (didn't bet)
Seat 9: mycka86 folded before Flop (didn't bet)





PokerStars Hand #148833625875:  Hold'em No Limit ($0.50/$1.00 USD) - 2016/02/15 11:26:00 CET [2016/02/15 5:26:00 ET]
Table 'Praecipua' 9-max Seat #6 is the button
Seat 1: er13to ($133.93 in chips) 
Seat 2: matiko09 ($112.20 in chips) 
Seat 3: Venomous100% ($133.01 in chips) 
Seat 4: gabi_igna ($100 in chips) 
Seat 5: huffwag ($162.65 in chips) 
Seat 6: mycka86 ($106.25 in chips) 
Seat 8: Ellis Ng ($39.67 in chips) 
Seat 9: AlKatrone ($100 in chips) 
Ellis Ng: posts small blind $0.50
AlKatrone: posts big blind $1
*** HOLE CARDS ***
Dealt to matiko09 [Ac 5h]
er13to: raises $2 to $3
matiko09: folds 
Venomous100%: folds 
gabi_igna: folds 
huffwag: folds 
mycka86: calls $3
Ellis Ng: folds 
AlKatrone: calls $2
*** FLOP *** [Kc 9s 2c]
AlKatrone: checks 
er13to: checks 
mycka86: checks 
*** TURN *** [Kc 9s 2c] [Js]
AlKatrone: checks 
er13to: bets $6.98
mycka86: folds 
AlKatrone: folds 
Uncalled bet ($6.98) returned to er13to
er13to collected $9.07 from pot
*** SUMMARY ***
Total pot $9.50 | Rake $0.43 
Board [Kc 9s 2c Js]
Seat 1: er13to collected ($9.07)
Seat 2: matiko09 folded before Flop (didn't bet)
Seat 3: Venomous100% folded before Flop (didn't bet)
Seat 4: gabi_igna folded before Flop (didn't bet)
Seat 5: huffwag folded before Flop (didn't bet)
Seat 6: mycka86 (button) folded on the Turn
Seat 8: Ellis Ng (small blind) folded before Flop
Seat 9: AlKatrone (big blind) folded on the Turn





PokerStars Hand #148833626239:  Hold'em No Limit ($0.50/$1.00 USD) - 2016/02/15 11:26:01 CET [2016/02/15 5:26:01 ET]
Table 'Ristenpart' 9-max Seat #6 is the button
Seat 1: gabi_igna ($100 in chips) 
Seat 2: IHouseMusic ($114.33 in chips) 
Seat 3: lumen21 ($100 in chips) 
Seat 4: miyashin ($106.42 in chips) 
Seat 6: matiko09 ($114.33 in chips) 
Seat 8: gwwsb ($97.11 in chips) 
Kalesmash08 will be allowed to play after the button
gwwsb: posts small blind $0.50
gabi_igna: posts big blind $1
redacesfull: sits out 
*** HOLE CARDS ***
Dealt to matiko09 [4s 6h]
IHouseMusic: folds 
lumen21: folds 
miyashin: raises $2 to $3
matiko09: folds 
gwwsb: folds 
gabi_igna: folds 
Uncalled bet ($2) returned to miyashin
miyashin collected $2.50 from pot
miyashin: doesn't show hand 
*** SUMMARY ***
Total pot $2.50 | Rake $0 
Seat 1: gabi_igna (big blind) folded before Flop
Seat 2: IHouseMusic folded before Flop (didn't bet)
Seat 3: lumen21 folded before Flop (didn't bet)
Seat 4: miyashin collected ($2.50)
Seat 6: matiko09 (button) folded before Flop (didn't bet)
Seat 8: gwwsb (small blind) folded before Flop





PokerStars Hand #148833626877:  Hold'em No Limit ($0.50/$1.00 USD) - 2016/02/15 11:26:02 CET [2016/02/15 5:26:02 ET]
Table 'Corvus III' 9-max Seat #8 is the button
Seat 1: pk4DW ($131.12 in chips) 
Seat 2: mzsportline ($95.90 in chips) 
Seat 3: VanDobeln ($244.92 in chips) 
Seat 4: goransyruvka ($117.95 in chips) 
Seat 6: Priidix ($141.23 in chips) 
Seat 7: matiko09 ($298.89 in chips) 
Seat 8: redacesfull ($242.28 in chips) 
Seat 9: er13to ($100.32 in chips) 
er13to: posts small blind $0.50
pk4DW: posts big blind $1
pk4DW: posts the ante $0.20
mzsportline: posts the ante $0.20
VanDobeln: posts the ante $0.20
goransyruvka: posts the ante $0.20
Priidix: posts the ante $0.20
matiko09: posts the ante $0.20
redacesfull: posts the ante $0.20
er13to: posts the ante $0.20
*** HOLE CARDS ***
Dealt to matiko09 [9d Th]
mzsportline: folds 
VanDobeln: folds 
goransyruvka: folds 
Priidix: folds 
matiko09: folds 
redacesfull: raises $1.12 to $2.12
er13to: folds 
pk4DW: calls $1.12
*** FLOP *** [8d 8s 5c]
pk4DW: checks 
redacesfull: bets $2
pk4DW: calls $2
*** TURN *** [8d 8s 5c] [4s]
pk4DW: checks 
redacesfull: bets $8
pk4DW: folds 
Uncalled bet ($8) returned to redacesfull
redacesfull collected $9.87 from pot
redacesfull: doesn't show hand 
*** SUMMARY ***
Total pot $10.34 | Rake $0.47 
Board [8d 8s 5c 4s]
Seat 1: pk4DW (big blind) folded on the Turn
Seat 2: mzsportline folded before Flop (didn't bet)
Seat 3: VanDobeln folded before Flop (didn't bet)
Seat 4: goransyruvka folded before Flop (didn't bet)
Seat 6: Priidix folded before Flop (didn't bet)
Seat 7: matiko09 folded before Flop (didn't bet)
Seat 8: redacesfull (button) collected ($9.87)
Seat 9: er13to (small blind) folded before Flop





PokerStars Hand #148833628820:  Hold'em No Limit ($0.50/$1.00 USD) - 2016/02/15 11:26:06 CET [2016/02/15 5:26:06 ET]
Table 'Saldanha' 9-max Seat #5 is the button
Seat 1: mycka86 ($106.59 in chips) 
Seat 2: Congo Sam ($97.28 in chips) 
Seat 4: er13to ($104.84 in chips) 
Seat 5: matiko09 ($113.70 in chips) 
Seat 6: AlKatrone ($216.21 in chips) 
Seat 7: Venomous100% ($166.57 in chips) 
Seat 8: gabi_igna ($110.64 in chips) 
AlKatrone: posts small blind $0.50
Venomous100%: posts big blind $1
*** HOLE CARDS ***
Dealt to matiko09 [2c Ks]
gabi_igna: folds 
mycka86: folds 
Congo Sam: folds 
er13to: folds 
matiko09: folds 
AlKatrone: folds 
Uncalled bet ($0.50) returned to Venomous100%
Venomous100% collected $1 from pot
Venomous100%: doesn't show hand 
*** SUMMARY ***
Total pot $1 | Rake $0 
Seat 1: mycka86 folded before Flop (didn't bet)
Seat 2: Congo Sam folded before Flop (didn't bet)
Seat 4: er13to folded before Flop (didn't bet)
Seat 5: matiko09 (button) folded before Flop (didn't bet)
Seat 6: AlKatrone (small blind) folded before Flop
Seat 7: Venomous100% (big blind) collected ($1)
Seat 8: gabi_igna folded before Flop (didn't bet)





PokerStars Hand #148833637109:  Hold'em No Limit (€0.50/€1.00 EUR) - 2016/02/15 11:26:24 CET [2016/02/15 5:26:24 ET]
Table 'Ganesa II' 9-max Seat #3 is the button
Seat 3: BuBu 0187 (€73.84 in chips) 
Seat 4: Sreshta222 (€132.33 in chips) 
Seat 6: matiko09 (€109.58 in chips) 
Seat 7: er13to (€117.50 in chips) 
Seat 8: mycka86 (€100 in chips) 
Seat 9: Priidix (€172.85 in chips) 
Sreshta222: posts small blind €0.50
vano7777: is sitting out 
matiko09: posts big blind €1
*** HOLE CARDS ***
Dealt to matiko09 [Qd Jh]
er13to: folds 
AARON1953 leaves the table
vano7777 leaves the table
Aalleekks joins the table at seat #1 
AlKatrone joins the table at seat #5 
Aalleekks leaves the table
mycka86: folds 
Priidix: folds 
BuBu 0187: folds 
Sreshta222: folds 
Uncalled bet (€0.50) returned to matiko09
matiko09 collected €1 from pot
matiko09: doesn't show hand 
*** SUMMARY ***
Total pot €1 | Rake €0 
Seat 3: BuBu 0187 (button) folded before Flop (didn't bet)
Seat 4: Sreshta222 (small blind) folded before Flop
Seat 6: matiko09 (big blind) collected (€1)
Seat 7: er13to folded before Flop (didn't bet)
Seat 8: mycka86 folded before Flop (didn't bet)
Seat 9: Priidix folded before Flop (didn't bet)





PokerStars Hand #148833638594:  Hold'em No Limit ($0.50/$1.00 USD) - 2016/02/15 11:26:27 CET [2016/02/15 5:26:27 ET]
Table 'Saldanha' 9-max Seat #6 is the button
Seat 1: mycka86 ($106.59 in chips) 
Seat 2: Congo Sam ($97.28 in chips) 
Seat 4: er13to ($104.84 in chips) 
Seat 5: matiko09 ($113.70 in chips) 
Seat 6: AlKatrone ($215.71 in chips) 
Seat 7: Venomous100% ($167.07 in chips) 
Seat 8: gabi_igna ($110.64 in chips) 
Venomous100%: posts small blind $0.50
gabi_igna: posts big blind $1
*** HOLE CARDS ***
Dealt to matiko09 [3s 9s]
mycka86: folds 
Congo Sam: folds 
er13to: raises $1.50 to $2.50
matiko09: folds 
AlKatrone: folds 
Venomous100%: folds 
gabi_igna: calls $1.50
*** FLOP *** [Ad 8h 9h]
gabi_igna: checks 
er13to: checks 
*** TURN *** [Ad 8h 9h] [Qd]
gabi_igna: bets $3
er13to: folds 
Uncalled bet ($3) returned to gabi_igna
gabi_igna collected $5.25 from pot
gabi_igna: doesn't show hand 
*** SUMMARY ***
Total pot $5.50 | Rake $0.25 
Board [Ad 8h 9h Qd]
Seat 1: mycka86 folded before Flop (didn't bet)
Seat 2: Congo Sam folded before Flop (didn't bet)
Seat 4: er13to folded on the Turn
Seat 5: matiko09 folded before Flop (didn't bet)
Seat 6: AlKatrone (button) folded before Flop (didn't bet)
Seat 7: Venomous100% (small blind) folded before Flop
Seat 8: gabi_igna (big blind) collected ($5.25)





PokerStars Hand #148833640349:  Hold'em No Limit ($0.50/$1.00 USD) - 2016/02/15 11:26:31 CET [2016/02/15 5:26:31 ET]
Table 'Octans II' 9-max Seat #6 is the button
Seat 2: matiko09 ($228.68 in chips) 
Seat 3: Aalleekks ($100 in chips) 
Seat 4: Venomous100% ($183.64 in chips) 
Seat 6: er13to ($100 in chips) 
Seat 7: traficblues ($54.23 in chips) 
Seat 8: IHouseMusic ($129.93 in chips) 
Seat 9: mycka86 ($103.43 in chips) 
traficblues: posts small blind $0.50
IHouseMusic: posts big blind $1
Priidix: sits out 
*** HOLE CARDS ***
Dealt to matiko09 [Kh 2h]
mycka86: folds 
matiko09: folds 
Aalleekks: folds 
Venomous100%: folds 
er13to: folds 
traficblues: folds 
Uncalled bet ($0.50) returned to IHouseMusic
IHouseMusic collected $1 from pot
IHouseMusic: doesn't show hand 
*** SUMMARY ***
Total pot $1 | Rake $0 
Seat 2: matiko09 folded before Flop (didn't bet)
Seat 3: Aalleekks folded before Flop (didn't bet)
Seat 4: Venomous100% folded before Flop (didn't bet)
Seat 6: er13to (button) folded before Flop (didn't bet)
Seat 7: traficblues (small blind) folded before Flop
Seat 8: IHouseMusic (big blind) collected ($1)
Seat 9: mycka86 folded before Flop (didn't bet)





PokerStars Hand #148833640543:  Hold'em No Limit ($0.50/$1.00 USD) - 2016/02/15 11:26:32 CET [2016/02/15 5:26:32 ET]
Table 'Ristenpart' 9-max Seat #8 is the button
Seat 1: gabi_igna ($100 in chips) 
Seat 2: IHouseMusic ($114.33 in chips) 
Seat 3: lumen21 ($100 in chips) 
Seat 4: miyashin ($107.92 in chips) 
Seat 6: matiko09 ($114.33 in chips) 
Seat 8: gwwsb ($96.61 in chips) 
gabi_igna: posts small blind $0.50
IHouseMusic: posts big blind $1
redacesfull: sits out 
Kalesmash08: sits out 
*** HOLE CARDS ***
Dealt to matiko09 [4d 8h]
lumen21: folds 
miyashin: folds 
matiko09: folds 
gwwsb: raises $1 to $2
gabi_igna: folds 
IHouseMusic: folds 
Uncalled bet ($1) returned to gwwsb
gwwsb collected $2.50 from pot
gwwsb: doesn't show hand 
*** SUMMARY ***
Total pot $2.50 | Rake $0 
Seat 1: gabi_igna (small blind) folded before Flop
Seat 2: IHouseMusic (big blind) folded before Flop
Seat 3: lumen21 folded before Flop (didn't bet)
Seat 4: miyashin folded before Flop (didn't bet)
Seat 6: matiko09 folded before Flop (didn't bet)
Seat 8: gwwsb (button) collected ($2.50)





PokerStars Hand #148833641141:  Hold'em No Limit ($0.50/$1.00 USD) - 2016/02/15 11:26:33 CET [2016/02/15 5:26:33 ET]
Table 'Kitalpha II' 9-max Seat #4 is the button
Seat 1: IHouseMusic ($102.50 in chips) 
Seat 2: Charity86 ($81 in chips) 
Seat 3: matiko09 ($100 in chips) 
Seat 4: Sreshta222 ($100 in chips) 
Seat 8: skram2 ($100 in chips) 
Seat 9: Waltz88 ($111.99 in chips) 
skram2: posts small blind $0.50
Waltz88: posts big blind $1
*** HOLE CARDS ***
Dealt to matiko09 [Qc Qd]
IHouseMusic: raises $2 to $3
Charity86: folds 
matiko09: raises $6 to $9
Sreshta222: folds 
skram2: folds 
Waltz88: folds 
IHouseMusic: folds 
Uncalled bet ($6) returned to matiko09
matiko09 collected $7.50 from pot
matiko09: doesn't show hand 
*** SUMMARY ***
Total pot $7.50 | Rake $0 
Seat 1: IHouseMusic folded before Flop
Seat 2: Charity86 folded before Flop (didn't bet)
Seat 3: matiko09 collected ($7.50)
Seat 4: Sreshta222 (button) folded before Flop (didn't bet)
Seat 8: skram2 (small blind) folded before Flop
Seat 9: Waltz88 (big blind) folded before Flop





PokerStars Hand #148833644134:  Hold'em No Limit ($0.50/$1.00 USD) - 2016/02/15 11:26:39 CET [2016/02/15 5:26:39 ET]
Table 'Nata II' 9-max Seat #4 is the button
Seat 1: Priidix ($125.61 in chips) 
Seat 2: qqcom ($101.50 in chips) 
Seat 3: g00000se ($118.45 in chips) 
Seat 4: gabi_igna ($100 in chips) 
Seat 5: AGoodFell4 ($75.62 in chips) 
Seat 6: AlKatrone ($148.33 in chips) 
Seat 7: er13to ($115.65 in chips) 
Seat 9: matiko09 ($100 in chips) 
AGoodFell4: posts small blind $0.50
AlKatrone: posts big blind $1
lumen21: sits out 
*** HOLE CARDS ***
Dealt to matiko09 [Kd 8s]
er13to: folds 
matiko09: folds 
Priidix: folds 
qqcom: raises $2.50 to $3.50
g00000se: folds 
gabi_igna: folds 
AGoodFell4: folds 
AlKatrone: folds 
Uncalled bet ($2.50) returned to qqcom
qqcom collected $2.50 from pot
*** SUMMARY ***
Total pot $2.50 | Rake $0 
Seat 1: Priidix folded before Flop (didn't bet)
Seat 2: qqcom collected ($2.50)
Seat 3: g00000se folded before Flop (didn't bet)
Seat 4: gabi_igna (button) folded before Flop (didn't bet)
Seat 5: AGoodFell4 (small blind) folded before Flop
Seat 6: AlKatrone (big blind) folded before Flop
Seat 7: er13to folded before Flop (didn't bet)
Seat 9: matiko09 folded before Flop (didn't bet)





PokerStars Hand #148833646183:  Hold'em No Limit ($0.25/$0.50 USD) - 2016/02/15 11:26:44 CET [2016/02/15 5:26:44 ET]
Table 'Vesta II' 9-max Seat #2 is the button
Seat 1: etny99 ($50 in chips) 
Seat 2: ljryviltj ($49.25 in chips) 
Seat 3: matiko09 ($50.25 in chips) 
Seat 4: vlad11122007 ($59.38 in chips) 
Seat 5: dndngod ($75.23 in chips) 
Seat 6: pandalapa ($51.35 in chips) 
Seat 7: ruyingren ($70.04 in chips) 
Seat 8: Arystan ($140.20 in chips) 
matiko09: posts small blind $0.25
vlad11122007: posts big blind $0.50
*** HOLE CARDS ***
Dealt to matiko09 [Ad Kd]
dndngod: folds 
pandalapa: folds 
ruyingren: folds 
Arystan: raises $1 to $1.50
etny99: folds 
ljryviltj: folds 
matiko09: raises $4.50 to $6
vlad11122007: folds 
Arystan: folds 
Uncalled bet ($4.50) returned to matiko09
matiko09 collected $3.50 from pot
matiko09: doesn't show hand 
*** SUMMARY ***
Total pot $3.50 | Rake $0 
Seat 1: etny99 folded before Flop (didn't bet)
Seat 2: ljryviltj (button) folded before Flop (didn't bet)
Seat 3: matiko09 (small blind) collected ($3.50)
Seat 4: vlad11122007 (big blind) folded before Flop
Seat 5: dndngod folded before Flop (didn't bet)
Seat 6: pandalapa folded before Flop (didn't bet)
Seat 7: ruyingren folded before Flop (didn't bet)
Seat 8: Arystan folded before Flop





PokerStars Hand #148833646490:  Hold'em No Limit ($0.50/$1.00 USD) - 2016/02/15 11:26:44 CET [2016/02/15 5:26:44 ET]
Table 'Anteros' 9-max Seat #5 is the button
Seat 1: redacesfull ($100 in chips) 
Seat 2: IHouseMusic ($115.25 in chips) 
Seat 3: er13to ($101.97 in chips) 
Seat 4: misherei ($173.16 in chips) 
Seat 5: Holm1991 ($44.25 in chips) 
Seat 6: SerAlGog ($137.31 in chips) 
Seat 7: Zoubou1983 ($197.79 in chips) 
Seat 8: matiko09 ($101.50 in chips) 
Seat 9: mycka86 ($100 in chips) 
SerAlGog: posts small blind $0.50
Zoubou1983: posts big blind $1
*** HOLE CARDS ***
Dealt to matiko09 [5s Kh]
matiko09: folds 
mycka86: folds 
redacesfull: raises $1.12 to $2.12
IHouseMusic: folds 
er13to: folds 
misherei: calls $2.12
Holm1991: folds 
SerAlGog: folds 
Zoubou1983: calls $1.12
*** FLOP *** [5h 8h 7c]
Zoubou1983: checks 
redacesfull: bets $4
misherei: calls $4
Zoubou1983: calls $4
*** TURN *** [5h 8h 7c] [6d]
Zoubou1983: checks 
redacesfull: bets $12.61
misherei: folds 
Zoubou1983: folds 
Uncalled bet ($12.61) returned to redacesfull
redacesfull collected $18.01 from pot
redacesfull: doesn't show hand 
*** SUMMARY ***
Total pot $18.86 | Rake $0.85 
Board [5h 8h 7c 6d]
Seat 1: redacesfull collected ($18.01)
Seat 2: IHouseMusic folded before Flop (didn't bet)
Seat 3: er13to folded before Flop (didn't bet)
Seat 4: misherei folded on the Turn
Seat 5: Holm1991 (button) folded before Flop (didn't bet)
Seat 6: SerAlGog (small blind) folded before Flop
Seat 7: Zoubou1983 (big blind) folded on the Turn
Seat 8: matiko09 folded before Flop (didn't bet)
Seat 9: mycka86 folded before Flop (didn't bet)





PokerStars Hand #148833646161:  Hold'em No Limit ($0.50/$1.00 USD) - 2016/02/15 11:26:44 CET [2016/02/15 5:26:44 ET]
Table 'Octans II' 9-max Seat #7 is the button
Seat 2: matiko09 ($228.68 in chips) 
Seat 3: Aalleekks ($100 in chips) 
Seat 4: Venomous100% ($183.64 in chips) 
Seat 6: er13to ($100 in chips) 
Seat 7: traficblues ($53.73 in chips) 
Seat 8: IHouseMusic ($130.43 in chips) 
Seat 9: mycka86 ($103.43 in chips) 
IHouseMusic: posts small blind $0.50
mycka86: posts big blind $1
Priidix: sits out 
*** HOLE CARDS ***
Dealt to matiko09 [Kh 8c]
matiko09: folds 
Aalleekks: folds 
Venomous100%: raises $2 to $3
er13to: folds 
traficblues: folds 
IHouseMusic: folds 
mycka86: folds 
Uncalled bet ($2) returned to Venomous100%
Venomous100% collected $2.50 from pot
Venomous100%: doesn't show hand 
*** SUMMARY ***
Total pot $2.50 | Rake $0 
Seat 2: matiko09 folded before Flop (didn't bet)
Seat 3: Aalleekks folded before Flop (didn't bet)
Seat 4: Venomous100% collected ($2.50)
Seat 6: er13to folded before Flop (didn't bet)
Seat 7: traficblues (button) folded before Flop (didn't bet)
Seat 8: IHouseMusic (small blind) folded before Flop
Seat 9: mycka86 (big blind) folded before Flop





PokerStars Hand #148833646244:  Hold'em No Limit ($0.25/$0.50 USD) - 2016/02/15 11:26:44 CET [2016/02/15 5:26:44 ET]
Table 'Laertes II' 9-max Seat #6 is the button
Seat 1: etny99 ($50 in chips) 
Seat 2: beluccix ($24.21 in chips) 
Seat 3: valfan911 ($49.50 in chips) 
Seat 4: rgar93 ($47.72 in chips) 
Seat 6: ZonTTT ($50 in chips) 
Seat 7: Vedpapa ($65.74 in chips) 
Seat 9: matiko09 ($53.35 in chips) 
Vedpapa: posts small blind $0.25
Trent444: is sitting out 
matiko09: posts big blind $0.50
Sherlockplay: sits out 
*** HOLE CARDS ***
Dealt to matiko09 [Qs Kh]
etny99: folds 
Trent444 leaves the table
beluccix: folds 
valfan911: folds 
apfush joins the table at seat #8 
rgar93: folds 
ZonTTT: raises $0.50 to $1
Vedpapa: calls $0.75
matiko09: raises $3 to $4
ZonTTT: folds 
Vedpapa: folds 
Uncalled bet ($3) returned to matiko09
matiko09 collected $3 from pot
matiko09: doesn't show hand 
*** SUMMARY ***
Total pot $3 | Rake $0 
Seat 1: etny99 folded before Flop (didn't bet)
Seat 2: beluccix folded before Flop (didn't bet)
Seat 3: valfan911 folded before Flop (didn't bet)
Seat 4: rgar93 folded before Flop (didn't bet)
Seat 6: ZonTTT (button) folded before Flop
Seat 7: Vedpapa (small blind) folded before Flop
Seat 9: matiko09 (big blind) collected ($3)





PokerStars Hand #148833648994:  Hold'em No Limit ($0.50/$1.00 USD) - 2016/02/15 11:26:50 CET [2016/02/15 5:26:50 ET]
Table 'Ristenpart' 9-max Seat #1 is the button
Seat 1: gabi_igna ($100 in chips) 
Seat 2: IHouseMusic ($113.33 in chips) 
Seat 4: miyashin ($107.92 in chips) 
Seat 6: matiko09 ($114.33 in chips) 
Seat 8: gwwsb ($98.11 in chips) 
IHouseMusic: posts small blind $0.50
lumen21: is sitting out 
miyashin: posts big blind $1
redacesfull: sits out 
Kalesmash08: sits out 
*** HOLE CARDS ***
Dealt to matiko09 [5d 3h]
matiko09: folds 
gwwsb: folds 
lumen21 leaves the table
gabi_igna: folds 
IHouseMusic: raises $2 to $3
miyashin: raises $7 to $10
IHouseMusic: folds 
Uncalled bet ($7) returned to miyashin
miyashin collected $6 from pot
miyashin: doesn't show hand 
*** SUMMARY ***
Total pot $6 | Rake $0 
Seat 1: gabi_igna (button) folded before Flop (didn't bet)
Seat 2: IHouseMusic (small blind) folded before Flop
Seat 4: miyashin (big blind) collected ($6)
Seat 6: matiko09 folded before Flop (didn't bet)
Seat 8: gwwsb folded before Flop (didn't bet)





PokerStars Hand #148833653330:  Hold'em No Limit ($0.50/$1.00 USD) - 2016/02/15 11:26:59 CET [2016/02/15 5:26:59 ET]
Table 'Corvus III' 9-max Seat #9 is the button
Seat 1: pk4DW ($126.80 in chips) 
Seat 2: mzsportline ($95.70 in chips) 
Seat 3: VanDobeln ($244.72 in chips) 
Seat 4: goransyruvka ($117.75 in chips) 
Seat 6: Priidix ($141.03 in chips) 
Seat 7: matiko09 ($298.69 in chips) 
Seat 8: redacesfull ($247.83 in chips) 
Seat 9: er13to ($100 in chips) 
pk4DW: posts small blind $0.50
mzsportline: posts big blind $1
pk4DW: posts the ante $0.20
mzsportline: posts the ante $0.20
VanDobeln: posts the ante $0.20
goransyruvka: posts the ante $0.20
Priidix: posts the ante $0.20
matiko09: posts the ante $0.20
redacesfull: posts the ante $0.20
er13to: posts the ante $0.20
*** HOLE CARDS ***
Dealt to matiko09 [9s 8s]
VanDobeln: folds 
goransyruvka: calls $1
Priidix: folds 
matiko09: raises $4 to $5
redacesfull: folds 
er13to: calls $5
pk4DW: folds 
mzsportline: folds 
goransyruvka: calls $4
*** FLOP *** [2d 4s 5c]
goransyruvka: checks 
matiko09: checks 
er13to: bets $13.31
goransyruvka: folds 
matiko09: folds 
Uncalled bet ($13.31) returned to er13to
er13to collected $17.29 from pot
*** SUMMARY ***
Total pot $18.10 | Rake $0.81 
Board [2d 4s 5c]
Seat 1: pk4DW (small blind) folded before Flop
Seat 2: mzsportline (big blind) folded before Flop
Seat 3: VanDobeln folded before Flop (didn't bet)
Seat 4: goransyruvka folded on the Flop
Seat 6: Priidix folded before Flop (didn't bet)
Seat 7: matiko09 folded on the Flop
Seat 8: redacesfull folded before Flop (didn't bet)
Seat 9: er13to (button) collected ($17.29)





PokerStars Hand #148833657734:  Hold'em No Limit ($0.50/$1.00 USD) - 2016/02/15 11:27:08 CET [2016/02/15 5:27:08 ET]
Table 'Nata II' 9-max Seat #5 is the button
Seat 1: Priidix ($125.61 in chips) 
Seat 2: qqcom ($103 in chips) 
Seat 3: g00000se ($118.45 in chips) 
Seat 4: gabi_igna ($100 in chips) 
Seat 5: AGoodFell4 ($75.12 in chips) 
Seat 6: AlKatrone ($147.33 in chips) 
Seat 7: er13to ($115.65 in chips) 
Seat 9: matiko09 ($100 in chips) 
AlKatrone: posts small blind $0.50
er13to: posts big blind $1
lumen21: sits out 
*** HOLE CARDS ***
Dealt to matiko09 [7c 7d]
matiko09: raises $2 to $3
Priidix: folds 
qqcom: folds 
g00000se: folds 
gabi_igna: calls $3
AGoodFell4: raises $4 to $7
AlKatrone: folds 
er13to: folds 
matiko09: calls $4
gabi_igna: calls $4
*** FLOP *** [Qd 3c 6d]
matiko09: checks 
gabi_igna: checks 
AGoodFell4: bets $5
matiko09: folds 
gabi_igna: calls $5
*** TURN *** [Qd 3c 6d] [Js]
gabi_igna: checks 
AGoodFell4: bets $12
gabi_igna: folds 
Uncalled bet ($12) returned to AGoodFell4
AGoodFell4 collected $31.04 from pot
AGoodFell4: doesn't show hand 
*** SUMMARY ***
Total pot $32.50 | Rake $1.46 
Board [Qd 3c 6d Js]
Seat 1: Priidix folded before Flop (didn't bet)
Seat 2: qqcom folded before Flop (didn't bet)
Seat 3: g00000se folded before Flop (didn't bet)
Seat 4: gabi_igna folded on the Turn
Seat 5: AGoodFell4 (button) collected ($31.04)
Seat 6: AlKatrone (small blind) folded before Flop
Seat 7: er13to (big blind) folded before Flop
Seat 9: matiko09 folded on the Flop





PokerStars Hand #148833657580:  Hold'em No Limit ($0.50/$1.00 USD) - 2016/02/15 11:27:08 CET [2016/02/15 5:27:08 ET]
Table 'Octans II' 9-max Seat #8 is the button
Seat 2: matiko09 ($228.68 in chips) 
Seat 3: Aalleekks ($100 in chips) 
Seat 4: Venomous100% ($185.14 in chips) 
Seat 6: er13to ($100 in chips) 
Seat 7: traficblues ($53.73 in chips) 
Seat 8: IHouseMusic ($129.93 in chips) 
Seat 9: mycka86 ($102.43 in chips) 
mycka86: posts small blind $0.50
matiko09: posts big blind $1
Priidix: sits out 
*** HOLE CARDS ***
Dealt to matiko09 [9c 6s]
Aalleekks: folds 
Venomous100%: folds 
er13to: folds 
traficblues: calls $1
IHouseMusic: folds 
mycka86: calls $0.50
matiko09: checks 
*** FLOP *** [6c Kd Kc]
mycka86: checks 
matiko09: bets $1.48
traficblues: calls $1.48
mycka86: folds 
*** TURN *** [6c Kd Kc] [6h]
matiko09: checks 
traficblues: checks 
*** RIVER *** [6c Kd Kc 6h] [3s]
matiko09: bets $3.70
traficblues: folds 
Uncalled bet ($3.70) returned to matiko09
matiko09 collected $5.69 from pot
matiko09: doesn't show hand 
*** SUMMARY ***
Total pot $5.96 | Rake $0.27 
Board [6c Kd Kc 6h 3s]
Seat 2: matiko09 (big blind) collected ($5.69)
Seat 3: Aalleekks folded before Flop (didn't bet)
Seat 4: Venomous100% folded before Flop (didn't bet)
Seat 6: er13to folded before Flop (didn't bet)
Seat 7: traficblues folded on the River
Seat 8: IHouseMusic (button) folded before Flop (didn't bet)
Seat 9: mycka86 (small blind) folded on the Flop





PokerStars Hand #148833658191:  Hold'em No Limit (€0.50/€1.00 EUR) - 2016/02/15 11:27:09 CET [2016/02/15 5:27:09 ET]
Table 'Ganesa II' 9-max Seat #4 is the button
Seat 3: BuBu 0187 (€73.84 in chips) 
Seat 4: Sreshta222 (€131.83 in chips) 
Seat 6: matiko09 (€110.08 in chips) 
Seat 7: er13to (€117.50 in chips) 
Seat 8: mycka86 (€100 in chips) 
Seat 9: Priidix (€172.85 in chips) 
AlKatrone will be allowed to play after the button
matiko09: posts small blind €0.50
er13to: posts big blind €1
*** HOLE CARDS ***
Dealt to matiko09 [5s 4s]
mycka86: folds 
Priidix: folds 
BuBu 0187: folds 
Sreshta222: folds 
matiko09: folds 
Uncalled bet (€0.50) returned to er13to
er13to collected €1 from pot
*** SUMMARY ***
Total pot €1 | Rake €0 
Seat 3: BuBu 0187 folded before Flop (didn't bet)
Seat 4: Sreshta222 (button) folded before Flop (didn't bet)
Seat 6: matiko09 (small blind) folded before Flop
Seat 7: er13to (big blind) collected (€1)
Seat 8: mycka86 folded before Flop (didn't bet)
Seat 9: Priidix folded before Flop (didn't bet)





PokerStars Hand #148833663915:  Hold'em No Limit ($0.50/$1.00 USD) - 2016/02/15 11:27:21 CET [2016/02/15 5:27:21 ET]
Table 'Saldanha' 9-max Seat #7 is the button
Seat 1: mycka86 ($106.59 in chips) 
Seat 2: Congo Sam ($97.28 in chips) 
Seat 4: er13to ($102.34 in chips) 
Seat 5: matiko09 ($113.70 in chips) 
Seat 6: AlKatrone ($215.71 in chips) 
Seat 7: Venomous100% ($166.57 in chips) 
Seat 8: gabi_igna ($113.39 in chips) 
gabi_igna: posts small blind $0.50
mycka86: posts big blind $1
*** HOLE CARDS ***
Dealt to matiko09 [7c 6s]
Congo Sam: folds 
pokertom2525 joins the table at seat #9 
er13to: folds 
matiko09: folds 
AlKatrone: raises $1.50 to $2.50
Venomous100%: folds 
gabi_igna: raises $6.50 to $9
mycka86: folds 
AlKatrone: calls $6.50
*** FLOP *** [9c 6h 8h]
gabi_igna: bets $10
AlKatrone: folds 
Uncalled bet ($10) returned to gabi_igna
gabi_igna collected $18.14 from pot
gabi_igna: doesn't show hand 
*** SUMMARY ***
Total pot $19 | Rake $0.86 
Board [9c 6h 8h]
Seat 1: mycka86 (big blind) folded before Flop
Seat 2: Congo Sam folded before Flop (didn't bet)
Seat 4: er13to folded before Flop (didn't bet)
Seat 5: matiko09 folded before Flop (didn't bet)
Seat 6: AlKatrone folded on the Flop
Seat 7: Venomous100% (button) folded before Flop (didn't bet)
Seat 8: gabi_igna (small blind) collected ($18.14)





PokerStars Hand #148833664005:  Hold'em No Limit ($0.50/$1.00 USD) - 2016/02/15 11:27:21 CET [2016/02/15 5:27:21 ET]
Table 'Euanthe II' 9-max Seat #7 is the button
Seat 2: mahalko0925 ($77.50 in chips) 
Seat 3: matiko09 ($126.77 in chips) 
Seat 4: er13to ($121.18 in chips) 
Seat 5: gabi_igna ($145.20 in chips) 
Seat 6: IHouseMusic ($100 in chips) 
Seat 7: vinniesmol ($220.30 in chips) 
Seat 8: Sashey2708 ($56.79 in chips) 
Seat 9: Venomous100% ($115.22 in chips) 
Sashey2708: posts small blind $0.50
Venomous100%: posts big blind $1
*** HOLE CARDS ***
Dealt to matiko09 [Td Jc]
mahalko0925: folds 
matiko09: folds 
er13to: folds 
gabi_igna: folds 
IHouseMusic: raises $2 to $3
vinniesmol: folds 
Sashey2708: calls $2.50
Venomous100%: folds 
*** FLOP *** [Qh 5d Qs]
Sashey2708: bets $2
IHouseMusic: calls $2
*** TURN *** [Qh 5d Qs] [Qd]
Sashey2708: bets $4
IHouseMusic: calls $4
*** RIVER *** [Qh 5d Qs Qd] [2s]
Sashey2708: bets $9
IHouseMusic: calls $9
*** SHOW DOWN ***
Sashey2708: shows [4s 5c] (a full house, Queens full of Fives)
IHouseMusic: shows [8d 8s] (a full house, Queens full of Eights)
IHouseMusic collected $35.34 from pot
*** SUMMARY ***
Total pot $37 | Rake $1.66 
Board [Qh 5d Qs Qd 2s]
Seat 2: mahalko0925 folded before Flop (didn't bet)
Seat 3: matiko09 folded before Flop (didn't bet)
Seat 4: er13to folded before Flop (didn't bet)
Seat 5: gabi_igna folded before Flop (didn't bet)
Seat 6: IHouseMusic showed [8d 8s] and won ($35.34) with a full house, Queens full of Eights
Seat 7: vinniesmol (button) folded before Flop (didn't bet)
Seat 8: Sashey2708 (small blind) showed [4s 5c] and lost with a full house, Queens full of Fives
Seat 9: Venomous100% (big blind) folded before Flop





PokerStars Hand #148833666185:  Hold'em No Limit ($0.25/$0.50 USD) - 2016/02/15 11:27:26 CET [2016/02/15 5:27:26 ET]
Table 'Vesta II' 9-max Seat #3 is the button
Seat 1: etny99 ($50 in chips) 
Seat 2: ljryviltj ($49.25 in chips) 
Seat 3: matiko09 ($52.25 in chips) 
Seat 4: vlad11122007 ($58.88 in chips) 
Seat 5: dndngod ($75.23 in chips) 
Seat 6: pandalapa ($51.35 in chips) 
Seat 7: ruyingren ($70.04 in chips) 
Seat 8: Arystan ($138.70 in chips) 
vlad11122007: posts small blind $0.25
dndngod: posts big blind $0.50
Aoki42: sits out 
*** HOLE CARDS ***
Dealt to matiko09 [Qc 6s]
pandalapa: folds 
ruyingren: folds 
Arystan: folds 
etny99: folds 
ljryviltj: folds 
matiko09: folds 
vlad11122007: raises $1 to $1.50
dndngod: folds 
Uncalled bet ($1) returned to vlad11122007
vlad11122007 collected $1 from pot
vlad11122007: doesn't show hand 
*** SUMMARY ***
Total pot $1 | Rake $0 
Seat 1: etny99 folded before Flop (didn't bet)
Seat 2: ljryviltj folded before Flop (didn't bet)
Seat 3: matiko09 (button) folded before Flop (didn't bet)
Seat 4: vlad11122007 (small blind) collected ($1)
Seat 5: dndngod (big blind) folded before Flop
Seat 6: pandalapa folded before Flop (didn't bet)
Seat 7: ruyingren folded before Flop (didn't bet)
Seat 8: Arystan folded before Flop (didn't bet)





PokerStars Hand #148833666923:  Hold'em No Limit ($0.50/$1.00 USD) - 2016/02/15 11:27:28 CET [2016/02/15 5:27:28 ET]
Table 'Kitalpha II' 9-max Seat #8 is the button
Seat 1: IHouseMusic ($100 in chips) 
Seat 2: Charity86 ($81 in chips) 
Seat 3: matiko09 ($104.50 in chips) 
Seat 4: Sreshta222 ($100 in chips) 
Seat 8: skram2 ($99.50 in chips) 
Seat 9: Waltz88 ($110.99 in chips) 
Waltz88: posts small blind $0.50
IHouseMusic: posts big blind $1
*** HOLE CARDS ***
Dealt to matiko09 [Qh Kh]
Charity86: folds 
matiko09: raises $2 to $3
Sreshta222: folds 
skram2: folds 
Waltz88: folds 
IHouseMusic: folds 
Uncalled bet ($2) returned to matiko09
matiko09 collected $2.50 from pot
matiko09: doesn't show hand 
*** SUMMARY ***
Total pot $2.50 | Rake $0 
Seat 1: IHouseMusic (big blind) folded before Flop
Seat 2: Charity86 folded before Flop (didn't bet)
Seat 3: matiko09 collected ($2.50)
Seat 4: Sreshta222 folded before Flop (didn't bet)
Seat 8: skram2 (button) folded before Flop (didn't bet)
Seat 9: Waltz88 (small blind) folded before Flop





PokerStars Hand #148833677124:  Hold'em No Limit (€0.50/€1.00 EUR) - 2016/02/15 11:27:49 CET [2016/02/15 5:27:49 ET]
Table 'Ganesa II' 9-max Seat #6 is the button
Seat 3: BuBu 0187 (€73.84 in chips) 
Seat 4: Sreshta222 (€131.83 in chips) 
Seat 6: matiko09 (€109.58 in chips) 
Seat 7: er13to (€118 in chips) 
Seat 8: mycka86 (€100 in chips) 
Seat 9: Priidix (€172.85 in chips) 
er13to: posts small blind €0.50
mycka86: posts big blind €1
AlKatrone: sits out 
*** HOLE CARDS ***
Dealt to matiko09 [7h 2c]
Priidix: folds 
BuBu 0187 has timed out
BuBu 0187: folds 
Sreshta222: raises €1.50 to €2.50
matiko09: folds 
er13to: folds 
mycka86: folds 
Uncalled bet (€1.50) returned to Sreshta222
Sreshta222 collected €2.50 from pot
Sreshta222: doesn't show hand 
*** SUMMARY ***
Total pot €2.50 | Rake €0 
Seat 3: BuBu 0187 folded before Flop (didn't bet)
Seat 4: Sreshta222 collected (€2.50)
Seat 6: matiko09 (button) folded before Flop (didn't bet)
Seat 7: er13to (small blind) folded before Flop
Seat 8: mycka86 (big blind) folded before Flop
Seat 9: Priidix folded before Flop (didn't bet)





PokerStars Hand #148833677781:  Hold'em No Limit ($0.25/$0.50 USD) - 2016/02/15 11:27:51 CET [2016/02/15 5:27:51 ET]
Table 'Laertes II' 9-max Seat #7 is the button
Seat 3: valfan911 ($49.50 in chips) 
Seat 4: rgar93 ($47.72 in chips) 
Seat 6: ZonTTT ($50 in chips) 
Seat 7: Vedpapa ($64.74 in chips) 
Seat 9: matiko09 ($55.35 in chips) 
apfush will be allowed to play after the button
matiko09: posts small blind $0.25
etny99: is sitting out 
beluccix: is sitting out 
etny99 leaves the table
valfan911: posts big blind $0.50
Sherlockplay: sits out 
*** HOLE CARDS ***
Dealt to matiko09 [8c As]
beluccix leaves the table
rgar93: folds 
ZonTTT: folds 
Vedpapa: raises $1 to $1.50
matiko09: folds 
valfan911: folds 
Uncalled bet ($1) returned to Vedpapa
Vedpapa collected $1.25 from pot
*** SUMMARY ***
Total pot $1.25 | Rake $0 
Seat 3: valfan911 (big blind) folded before Flop
Seat 4: rgar93 folded before Flop (didn't bet)
Seat 6: ZonTTT folded before Flop (didn't bet)
Seat 7: Vedpapa (button) collected ($1.25)
Seat 9: matiko09 (small blind) folded before Flop





PokerStars Hand #148833679910:  Hold'em No Limit ($0.50/$1.00 USD) - 2016/02/15 11:27:55 CET [2016/02/15 5:27:55 ET]
Table 'Anteros' 9-max Seat #6 is the button
Seat 1: redacesfull ($111.89 in chips) 
Seat 2: IHouseMusic ($115.25 in chips) 
Seat 3: er13to ($101.97 in chips) 
Seat 4: misherei ($167.04 in chips) 
Seat 5: Holm1991 ($44.25 in chips) 
Seat 6: SerAlGog ($136.81 in chips) 
Seat 7: Zoubou1983 ($191.67 in chips) 
Seat 8: matiko09 ($101.50 in chips) 
Seat 9: mycka86 ($100 in chips) 
Zoubou1983: posts small blind $0.50
matiko09: posts big blind $1
*** HOLE CARDS ***
Dealt to matiko09 [Jc Td]
mycka86: folds 
redacesfull: raises $1.12 to $2.12
IHouseMusic: folds 
er13to: folds 
misherei: folds 
Holm1991: folds 
SerAlGog: folds 
Zoubou1983: calls $1.62
matiko09: folds 
*** FLOP *** [Tc 3s 9d]
Zoubou1983: checks 
redacesfull: checks 
*** TURN *** [Tc 3s 9d] [Js]
Zoubou1983: bets $2
redacesfull: folds 
Uncalled bet ($2) returned to Zoubou1983
Zoubou1983 collected $5 from pot
Zoubou1983: doesn't show hand 
*** SUMMARY ***
Total pot $5.24 | Rake $0.24 
Board [Tc 3s 9d Js]
Seat 1: redacesfull folded on the Turn
Seat 2: IHouseMusic folded before Flop (didn't bet)
Seat 3: er13to folded before Flop (didn't bet)
Seat 4: misherei folded before Flop (didn't bet)
Seat 5: Holm1991 folded before Flop (didn't bet)
Seat 6: SerAlGog (button) folded before Flop (didn't bet)
Seat 7: Zoubou1983 (small blind) collected ($5)
Seat 8: matiko09 (big blind) folded before Flop
Seat 9: mycka86 folded before Flop (didn't bet)





PokerStars Hand #148833683786:  Hold'em No Limit ($0.50/$1.00 USD) - 2016/02/15 11:28:04 CET [2016/02/15 5:28:04 ET]
Table 'Kitalpha II' 9-max Seat #9 is the button
Seat 1: IHouseMusic ($100 in chips) 
Seat 2: Charity86 ($81 in chips) 
Seat 3: matiko09 ($106 in chips) 
Seat 4: Sreshta222 ($100 in chips) 
Seat 8: skram2 ($99.50 in chips) 
Seat 9: Waltz88 ($110.49 in chips) 
IHouseMusic: posts small blind $0.50
Charity86: posts big blind $1
*** HOLE CARDS ***
Dealt to matiko09 [3s Th]
Congo Sam joins the table at seat #6 
matiko09: folds 
Sreshta222: folds 
skram2: raises $1 to $2
Waltz88: calls $2
IHouseMusic: folds 
4Aces4Roses joins the table at seat #7 
Charity86: calls $1
*** FLOP *** [2s 7c 3h]
Charity86: bets $3.80
skram2: folds 
Waltz88: folds 
Uncalled bet ($3.80) returned to Charity86
Charity86 collected $6.21 from pot
*** SUMMARY ***
Total pot $6.50 | Rake $0.29 
Board [2s 7c 3h]
Seat 1: IHouseMusic (small blind) folded before Flop
Seat 2: Charity86 (big blind) collected ($6.21)
Seat 3: matiko09 folded before Flop (didn't bet)
Seat 4: Sreshta222 folded before Flop (didn't bet)
Seat 8: skram2 folded on the Flop
Seat 9: Waltz88 (button) folded on the Flop





PokerStars Hand #148833689778:  Hold'em No Limit ($0.50/$1.00 USD) - 2016/02/15 11:28:16 CET [2016/02/15 5:28:16 ET]
Table 'Euanthe II' 9-max Seat #8 is the button
Seat 2: mahalko0925 ($77.50 in chips) 
Seat 3: matiko09 ($126.77 in chips) 
Seat 4: er13to ($121.18 in chips) 
Seat 5: gabi_igna ($145.20 in chips) 
Seat 6: IHouseMusic ($117.34 in chips) 
Seat 7: vinniesmol ($220.30 in chips) 
Seat 8: Sashey2708 ($38.79 in chips) 
Seat 9: Venomous100% ($114.22 in chips) 
Venomous100%: posts small blind $0.50
mahalko0925: posts big blind $1
*** HOLE CARDS ***
Dealt to matiko09 [6d Jh]
matiko09: folds 
er13to: folds 
gabi_igna: folds 
IHouseMusic: folds 
vinniesmol: folds 
Sashey2708: raises $2 to $3
Venomous100%: folds 
mahalko0925: folds 
Uncalled bet ($2) returned to Sashey2708
Sashey2708 collected $2.50 from pot
Sashey2708: doesn't show hand 
*** SUMMARY ***
Total pot $2.50 | Rake $0 
Seat 2: mahalko0925 (big blind) folded before Flop
Seat 3: matiko09 folded before Flop (didn't bet)
Seat 4: er13to folded before Flop (didn't bet)
Seat 5: gabi_igna folded before Flop (didn't bet)
Seat 6: IHouseMusic folded before Flop (didn't bet)
Seat 7: vinniesmol folded before Flop (didn't bet)
Seat 8: Sashey2708 (button) collected ($2.50)
Seat 9: Venomous100% (small blind) folded before Flop





PokerStars Hand #148833690134:  Hold'em No Limit ($0.25/$0.50 USD) - 2016/02/15 11:28:17 CET [2016/02/15 5:28:17 ET]
Table 'Vesta II' 9-max Seat #4 is the button
Seat 1: etny99 ($50 in chips) 
Seat 2: ljryviltj ($49.25 in chips) 
Seat 3: matiko09 ($52.25 in chips) 
Seat 4: vlad11122007 ($59.38 in chips) 
Seat 5: dndngod ($74.73 in chips) 
Seat 6: pandalapa ($51.35 in chips) 
Seat 7: ruyingren ($70.04 in chips) 
Seat 8: Arystan ($138.70 in chips) 
dndngod: posts small blind $0.25
pandalapa: posts big blind $0.50
Aoki42: sits out 
*** HOLE CARDS ***
Dealt to matiko09 [5c 8s]
ruyingren: folds 
Arystan: raises $1 to $1.50
etny99: folds 
ljryviltj: folds 
matiko09: folds 
vlad11122007: folds 
dndngod: calls $1.25
pandalapa: calls $1
*** FLOP *** [6s 2s 4h]
dndngod: checks 
pandalapa: checks 
Arystan: bets $4.30
dndngod: raises $7.70 to $12
pandalapa: folds 
Arystan: raises $15 to $27
dndngod: raises $46.23 to $73.23 and is all-in
Arystan: calls $46.23
*** TURN *** [6s 2s 4h] [3c]
*** RIVER *** [6s 2s 4h 3c] [Th]
*** SHOW DOWN ***
dndngod: shows [2c 2h] (three of a kind, Deuces)
Arystan: mucks hand 
dndngod collected $148.46 from pot
*** SUMMARY ***
Total pot $150.96 | Rake $2.50 
Board [6s 2s 4h 3c Th]
Seat 1: etny99 folded before Flop (didn't bet)
Seat 2: ljryviltj folded before Flop (didn't bet)
Seat 3: matiko09 folded before Flop (didn't bet)
Seat 4: vlad11122007 (button) folded before Flop (didn't bet)
Seat 5: dndngod (small blind) showed [2c 2h] and won ($148.46) with three of a kind, Deuces
Seat 6: pandalapa (big blind) folded on the Flop
Seat 7: ruyingren folded before Flop (didn't bet)
Seat 8: Arystan mucked [Kd Kh]





PokerStars Hand #148833690458:  Hold'em No Limit ($0.50/$1.00 USD) - 2016/02/15 11:28:18 CET [2016/02/15 5:28:18 ET]
Table 'Octans II' 9-max Seat #9 is the button
Seat 2: matiko09 ($231.89 in chips) 
Seat 3: Aalleekks ($100 in chips) 
Seat 4: Venomous100% ($185.14 in chips) 
Seat 6: er13to ($100 in chips) 
Seat 7: traficblues ($51.25 in chips) 
Seat 8: IHouseMusic ($129.93 in chips) 
Seat 9: mycka86 ($101.43 in chips) 
matiko09: posts small blind $0.50
Aalleekks: posts big blind $1
Priidix: sits out 
*** HOLE CARDS ***
Dealt to matiko09 [8c Ah]
Venomous100%: folds 
er13to: folds 
traficblues: calls $1
IHouseMusic: folds 
mycka86: folds 
matiko09: calls $0.50
Aalleekks: checks 
*** FLOP *** [6s Ks 9h]
matiko09: checks 
Aalleekks: checks 
traficblues: checks 
*** TURN *** [6s Ks 9h] [3d]
matiko09: checks 
Aalleekks: checks 
traficblues: checks 
*** RIVER *** [6s Ks 9h 3d] [Kc]
matiko09: checks 
Aalleekks: checks 
traficblues: checks 
*** SHOW DOWN ***
matiko09: shows [8c Ah] (a pair of Kings)
Aalleekks: mucks hand 
traficblues: mucks hand 
matiko09 collected $2.86 from pot
*** SUMMARY ***
Total pot $3 | Rake $0.14 
Board [6s Ks 9h 3d Kc]
Seat 2: matiko09 (small blind) showed [8c Ah] and won ($2.86) with a pair of Kings
Seat 3: Aalleekks (big blind) mucked [5s 8d]
Seat 4: Venomous100% folded before Flop (didn't bet)
Seat 6: er13to folded before Flop (didn't bet)
Seat 7: traficblues mucked [Th Jh]
Seat 8: IHouseMusic folded before Flop (didn't bet)
Seat 9: mycka86 (button) folded before Flop (didn't bet)





PokerStars Hand #148833692543:  Hold'em No Limit ($0.50/$1.00 USD) - 2016/02/15 11:28:22 CET [2016/02/15 5:28:22 ET]
Table 'Praecipua' 9-max Seat #8 is the button
Seat 1: er13to ($140 in chips) 
Seat 2: matiko09 ($112.20 in chips) 
Seat 3: Venomous100% ($133.01 in chips) 
Seat 4: gabi_igna ($100 in chips) 
Seat 5: huffwag ($162.65 in chips) 
Seat 6: mycka86 ($103.25 in chips) 
Seat 8: Ellis Ng ($39.17 in chips) 
Seat 9: AlKatrone ($100 in chips) 
AlKatrone: posts small blind $0.50
er13to: posts big blind $1
*** HOLE CARDS ***
Dealt to matiko09 [Kc 3d]
matiko09: folds 
Venomous100%: folds 
gabi_igna: folds 
huffwag: folds 
mycka86: folds 
Ellis Ng: folds 
AlKatrone: folds 
Uncalled bet ($0.50) returned to er13to
er13to collected $1 from pot
*** SUMMARY ***
Total pot $1 | Rake $0 
Seat 1: er13to (big blind) collected ($1)
Seat 2: matiko09 folded before Flop (didn't bet)
Seat 3: Venomous100% folded before Flop (didn't bet)
Seat 4: gabi_igna folded before Flop (didn't bet)
Seat 5: huffwag folded before Flop (didn't bet)
Seat 6: mycka86 folded before Flop (didn't bet)
Seat 8: Ellis Ng (button) folded before Flop (didn't bet)
Seat 9: AlKatrone (small blind) folded before Flop





PokerStars Hand #148833692328:  Hold'em No Limit ($0.25/$0.50 USD) - 2016/02/15 11:28:22 CET [2016/02/15 5:28:22 ET]
Table 'Laertes II' 9-max Seat #9 is the button
Seat 3: valfan911 ($49 in chips) 
Seat 4: rgar93 ($47.72 in chips) 
Seat 6: ZonTTT ($50 in chips) 
Seat 7: Vedpapa ($65.49 in chips) 
Seat 9: matiko09 ($55.10 in chips) 
valfan911: posts small blind $0.25
rgar93: posts big blind $0.50
Sherlockplay: sits out 
apfush: sits out 
*** HOLE CARDS ***
Dealt to matiko09 [4h 2c]
ZonTTT: folds 
Vedpapa is connected 
Seby&Sandra joins the table at seat #2 
Vedpapa has timed out while being disconnected
Vedpapa: folds 
matiko09: folds 
valfan911: raises $0.50 to $1
Gutschel joins the table at seat #1 
rgar93: calls $0.50
*** FLOP *** [4d 5d Js]
valfan911: bets $1.50
rgar93: calls $1.50
*** TURN *** [4d 5d Js] [Qs]
valfan911: checks 
Vedpapa is disconnected 
rgar93: bets $2.39
valfan911: calls $2.39
*** RIVER *** [4d 5d Js Qs] [8d]
valfan911: checks 
rgar93: checks 
*** SHOW DOWN ***
valfan911: shows [Ad Jh] (a pair of Jacks)
rgar93: shows [Kd Qh] (a pair of Queens)
rgar93 collected $9.34 from pot
*** SUMMARY ***
Total pot $9.78 | Rake $0.44 
Board [4d 5d Js Qs 8d]
Seat 3: valfan911 (small blind) showed [Ad Jh] and lost with a pair of Jacks
Seat 4: rgar93 (big blind) showed [Kd Qh] and won ($9.34) with a pair of Queens
Seat 6: ZonTTT folded before Flop (didn't bet)
Seat 7: Vedpapa folded before Flop (didn't bet)
Seat 9: matiko09 (button) folded before Flop (didn't bet)





PokerStars Hand #148833693765:  Hold'em No Limit ($0.50/$1.00 USD) - 2016/02/15 11:28:25 CET [2016/02/15 5:28:25 ET]
Table 'Corvus III' 9-max Seat #1 is the button
Seat 1: pk4DW ($126.10 in chips) 
Seat 2: mzsportline ($94.50 in chips) 
Seat 3: VanDobeln ($244.52 in chips) 
Seat 4: goransyruvka ($112.55 in chips) 
Seat 6: Priidix ($140.83 in chips) 
Seat 7: matiko09 ($293.49 in chips) 
Seat 8: redacesfull ($247.63 in chips) 
Seat 9: er13to ($112.09 in chips) 
mzsportline: posts small blind $0.50
VanDobeln: posts big blind $1
pk4DW: posts the ante $0.20
mzsportline: posts the ante $0.20
VanDobeln: posts the ante $0.20
goransyruvka: posts the ante $0.20
Priidix: posts the ante $0.20
matiko09: posts the ante $0.20
redacesfull: posts the ante $0.20
er13to: posts the ante $0.20
*** HOLE CARDS ***
Dealt to matiko09 [4d 3h]
goransyruvka: calls $1
Priidix: raises $3 to $4
matiko09: folds 
redacesfull: folds 
er13to: folds 
pk4DW: calls $4
mzsportline: folds 
VanDobeln: folds 
goransyruvka: calls $3
*** FLOP *** [3d 2s 6s]
goransyruvka: checks 
Priidix: checks 
pk4DW: bets $7.21
goransyruvka: folds 
Priidix: folds 
Uncalled bet ($7.21) returned to pk4DW
pk4DW collected $14.42 from pot
pk4DW: doesn't show hand 
*** SUMMARY ***
Total pot $15.10 | Rake $0.68 
Board [3d 2s 6s]
Seat 1: pk4DW (button) collected ($14.42)
Seat 2: mzsportline (small blind) folded before Flop
Seat 3: VanDobeln (big blind) folded before Flop
Seat 4: goransyruvka folded on the Flop
Seat 6: Priidix folded on the Flop
Seat 7: matiko09 folded before Flop (didn't bet)
Seat 8: redacesfull folded before Flop (didn't bet)
Seat 9: er13to folded before Flop (didn't bet)





PokerStars Hand #148833695267:  Hold'em No Limit (€0.50/€1.00 EUR) - 2016/02/15 11:28:28 CET [2016/02/15 5:28:28 ET]
Table 'Ganesa II' 9-max Seat #7 is the button
Seat 4: Sreshta222 (€133.33 in chips) 
Seat 6: matiko09 (€109.58 in chips) 
Seat 7: er13to (€117.50 in chips) 
Seat 8: mycka86 (€100 in chips) 
Seat 9: Priidix (€172.85 in chips) 
mycka86: posts small blind €0.50
Priidix: posts big blind €1
AlKatrone: sits out 
*** HOLE CARDS ***
Dealt to matiko09 [Qh 3s]
Sreshta222: raises €1.50 to €2.50
matiko09: folds 
er13to: calls €2.50
mycka86: folds 
Priidix: folds 
*** FLOP *** [5d Ks Jc]
Sreshta222: checks 
er13to: checks 
*** TURN *** [5d Ks Jc] [6s]
Sreshta222: checks 
er13to: bets €4.04
Sreshta222: folds 
Uncalled bet (€4.04) returned to er13to
er13to collected €6.21 from pot
*** SUMMARY ***
Total pot €6.50 | Rake €0.29 
Board [5d Ks Jc 6s]
Seat 4: Sreshta222 folded on the Turn
Seat 6: matiko09 folded before Flop (didn't bet)
Seat 7: er13to (button) collected (€6.21)
Seat 8: mycka86 (small blind) folded before Flop
Seat 9: Priidix (big blind) folded before Flop





PokerStars Hand #148833696657:  Hold'em No Limit ($0.50/$1.00 USD) - 2016/02/15 11:28:31 CET [2016/02/15 5:28:31 ET]
Table 'Saldanha' 9-max Seat #8 is the button
Seat 1: mycka86 ($105.59 in chips) 
Seat 2: Congo Sam ($97.28 in chips) 
Seat 4: er13to ($102.34 in chips) 
Seat 5: matiko09 ($113.70 in chips) 
Seat 6: AlKatrone ($206.71 in chips) 
Seat 7: Venomous100% ($166.57 in chips) 
Seat 8: gabi_igna ($122.53 in chips) 
pokertom2525 will be allowed to play after the button
mycka86: posts small blind $0.50
Congo Sam: posts big blind $1
*** HOLE CARDS ***
Dealt to matiko09 [5h 6c]
er13to: raises $1.50 to $2.50
matiko09: folds 
AlKatrone: folds 
Venomous100%: folds 
gabi_igna: folds 
mycka86: folds 
Congo Sam: folds 
Uncalled bet ($1.50) returned to er13to
er13to collected $2.50 from pot
*** SUMMARY ***
Total pot $2.50 | Rake $0 
Seat 1: mycka86 (small blind) folded before Flop
Seat 2: Congo Sam (big blind) folded before Flop
Seat 4: er13to collected ($2.50)
Seat 5: matiko09 folded before Flop (didn't bet)
Seat 6: AlKatrone folded before Flop (didn't bet)
Seat 7: Venomous100% folded before Flop (didn't bet)
Seat 8: gabi_igna (button) folded before Flop (didn't bet)





PokerStars Hand #148833700025:  Hold'em No Limit ($0.50/$1.00 USD) - 2016/02/15 11:28:38 CET [2016/02/15 5:28:38 ET]
Table 'Euanthe II' 9-max Seat #9 is the button
Seat 2: mahalko0925 ($76.50 in chips) 
Seat 3: matiko09 ($126.77 in chips) 
Seat 4: er13to ($121.18 in chips) 
Seat 5: gabi_igna ($145.20 in chips) 
Seat 6: IHouseMusic ($117.34 in chips) 
Seat 7: vinniesmol ($220.30 in chips) 
Seat 8: Sashey2708 ($40.29 in chips) 
Seat 9: Venomous100% ($113.72 in chips) 
mahalko0925: posts small blind $0.50
matiko09: posts big blind $1
*** HOLE CARDS ***
Dealt to matiko09 [7s 9h]
er13to: folds 
gabi_igna: folds 
IHouseMusic: folds 
vinniesmol: folds 
Sashey2708: folds 
Venomous100%: raises $1 to $2
mahalko0925: folds 
matiko09: folds 
Uncalled bet ($1) returned to Venomous100%
Venomous100% collected $2.50 from pot
Venomous100%: doesn't show hand 
*** SUMMARY ***
Total pot $2.50 | Rake $0 
Seat 2: mahalko0925 (small blind) folded before Flop
Seat 3: matiko09 (big blind) folded before Flop
Seat 4: er13to folded before Flop (didn't bet)
Seat 5: gabi_igna folded before Flop (didn't bet)
Seat 6: IHouseMusic folded before Flop (didn't bet)
Seat 7: vinniesmol folded before Flop (didn't bet)
Seat 8: Sashey2708 folded before Flop (didn't bet)
Seat 9: Venomous100% (button) collected ($2.50)





PokerStars Hand #148833704316:  Hold'em No Limit ($0.50/$1.00 USD) - 2016/02/15 11:28:47 CET [2016/02/15 5:28:47 ET]
Table 'Anteros' 9-max Seat #7 is the button
Seat 1: redacesfull ($109.77 in chips) 
Seat 2: IHouseMusic ($115.25 in chips) 
Seat 3: er13to ($101.97 in chips) 
Seat 4: misherei ($167.04 in chips) 
Seat 5: Holm1991 ($44.25 in chips) 
Seat 6: SerAlGog ($136.81 in chips) 
Seat 7: Zoubou1983 ($194.55 in chips) 
Seat 8: matiko09 ($100.50 in chips) 
Seat 9: mycka86 ($100 in chips) 
matiko09: posts small blind $0.50
mycka86: posts big blind $1
*** HOLE CARDS ***
Dealt to matiko09 [2s Qd]
redacesfull: folds 
IHouseMusic: folds 
er13to: folds 
misherei: folds 
Holm1991: folds 
SerAlGog: raises $1.25 to $2.25
Zoubou1983: folds 
matiko09: folds 
mycka86: calls $1.25
*** FLOP *** [5c 9h Ts]
mycka86: checks 
SerAlGog: bets $2.91
mycka86: raises $7.09 to $10
SerAlGog: folds 
Uncalled bet ($7.09) returned to mycka86
mycka86 collected $10.33 from pot
*** SUMMARY ***
Total pot $10.82 | Rake $0.49 
Board [5c 9h Ts]
Seat 1: redacesfull folded before Flop (didn't bet)
Seat 2: IHouseMusic folded before Flop (didn't bet)
Seat 3: er13to folded before Flop (didn't bet)
Seat 4: misherei folded before Flop (didn't bet)
Seat 5: Holm1991 folded before Flop (didn't bet)
Seat 6: SerAlGog folded on the Flop
Seat 7: Zoubou1983 (button) folded before Flop (didn't bet)
Seat 8: matiko09 (small blind) folded before Flop
Seat 9: mycka86 (big blind) collected ($10.33)





PokerStars Hand #148833706577:  Hold'em No Limit ($0.50/$1.00 USD) - 2016/02/15 11:28:52 CET [2016/02/15 5:28:52 ET]
Table 'Euanthe II' 9-max Seat #2 is the button
Seat 2: mahalko0925 ($76 in chips) 
Seat 3: matiko09 ($125.77 in chips) 
Seat 4: er13to ($121.18 in chips) 
Seat 5: gabi_igna ($145.20 in chips) 
Seat 6: IHouseMusic ($117.34 in chips) 
Seat 7: vinniesmol ($220.30 in chips) 
Seat 8: Sashey2708 ($40.29 in chips) 
Seat 9: Venomous100% ($115.22 in chips) 
matiko09: posts small blind $0.50
er13to: posts big blind $1
*** HOLE CARDS ***
Dealt to matiko09 [3h Kd]
gabi_igna: folds 
IHouseMusic: folds 
vinniesmol: folds 
Sashey2708: folds 
Venomous100%: raises $1.50 to $2.50
mahalko0925: folds 
matiko09: folds 
er13to: folds 
Uncalled bet ($1.50) returned to Venomous100%
Venomous100% collected $2.50 from pot
Venomous100%: doesn't show hand 
*** SUMMARY ***
Total pot $2.50 | Rake $0 
Seat 2: mahalko0925 (button) folded before Flop (didn't bet)
Seat 3: matiko09 (small blind) folded before Flop
Seat 4: er13to (big blind) folded before Flop
Seat 5: gabi_igna folded before Flop (didn't bet)
Seat 6: IHouseMusic folded before Flop (didn't bet)
Seat 7: vinniesmol folded before Flop (didn't bet)
Seat 8: Sashey2708 folded before Flop (didn't bet)
Seat 9: Venomous100% collected ($2.50)





PokerStars Hand #148833708744:  Hold'em No Limit ($0.50/$1.00 USD) - 2016/02/15 11:28:56 CET [2016/02/15 5:28:56 ET]
Table 'Octans II' 9-max Seat #2 is the button
Seat 2: matiko09 ($233.75 in chips) 
Seat 3: Aalleekks ($100 in chips) 
Seat 4: Venomous100% ($185.14 in chips) 
Seat 6: er13to ($100 in chips) 
Seat 7: traficblues ($50.25 in chips) 
Seat 8: IHouseMusic ($129.93 in chips) 
Seat 9: mycka86 ($101.43 in chips) 
Aalleekks: posts small blind $0.50
Venomous100%: posts big blind $1
Priidix: sits out 
*** HOLE CARDS ***
Dealt to matiko09 [3c 9d]
er13to: folds 
traficblues: calls $1
IHouseMusic: raises $3 to $4
mycka86: folds 
matiko09: folds 
Aalleekks: folds 
Venomous100%: folds 
traficblues: calls $3
*** FLOP *** [5d 8s 2h]
traficblues: checks 
IHouseMusic: checks 
*** TURN *** [5d 8s 2h] [Qh]
traficblues: bets $4.53
IHouseMusic: folds 
Uncalled bet ($4.53) returned to traficblues
traficblues collected $9.07 from pot
traficblues: doesn't show hand 
*** SUMMARY ***
Total pot $9.50 | Rake $0.43 
Board [5d 8s 2h Qh]
Seat 2: matiko09 (button) folded before Flop (didn't bet)
Seat 3: Aalleekks (small blind) folded before Flop
Seat 4: Venomous100% (big blind) folded before Flop
Seat 6: er13to folded before Flop (didn't bet)
Seat 7: traficblues collected ($9.07)
Seat 8: IHouseMusic folded on the Turn
Seat 9: mycka86 folded before Flop (didn't bet)





PokerStars Hand #148833708538:  Hold'em No Limit ($0.50/$1.00 USD) - 2016/02/15 11:28:56 CET [2016/02/15 5:28:56 ET]
Table 'Nata II' 9-max Seat #6 is the button
Seat 1: Priidix ($125.61 in chips) 
Seat 2: qqcom ($103 in chips) 
Seat 3: g00000se ($118.45 in chips) 
Seat 4: gabi_igna ($100 in chips) 
Seat 5: AGoodFell4 ($94.16 in chips) 
Seat 6: AlKatrone ($146.83 in chips) 
Seat 7: er13to ($114.65 in chips) 
Seat 8: lumen21 ($100 in chips) 
Seat 9: matiko09 ($100 in chips) 
er13to: posts small blind $0.50
lumen21: posts big blind $1
*** HOLE CARDS ***
Dealt to matiko09 [4c Td]
matiko09: folds 
Priidix: folds 
qqcom: folds 
g00000se: raises $1.50 to $2.50
gabi_igna: calls $2.50
AGoodFell4: calls $2.50
AlKatrone: folds 
er13to: folds 
lumen21: folds 
*** FLOP *** [Jc 6d 5c]
g00000se: checks 
gabi_igna: checks 
AGoodFell4: checks 
*** TURN *** [Jc 6d 5c] [5h]
g00000se: checks 
gabi_igna: checks 
AGoodFell4: bets $6.66
g00000se: folds 
gabi_igna: folds 
Uncalled bet ($6.66) returned to AGoodFell4
AGoodFell4 collected $8.60 from pot
AGoodFell4: doesn't show hand 
*** SUMMARY ***
Total pot $9 | Rake $0.40 
Board [Jc 6d 5c 5h]
Seat 1: Priidix folded before Flop (didn't bet)
Seat 2: qqcom folded before Flop (didn't bet)
Seat 3: g00000se folded on the Turn
Seat 4: gabi_igna folded on the Turn
Seat 5: AGoodFell4 collected ($8.60)
Seat 6: AlKatrone (button) folded before Flop (didn't bet)
Seat 7: er13to (small blind) folded before Flop
Seat 8: lumen21 (big blind) folded before Flop
Seat 9: matiko09 folded before Flop (didn't bet)





PokerStars Hand #148833714408:  Hold'em No Limit ($0.50/$1.00 USD) - 2016/02/15 11:29:08 CET [2016/02/15 5:29:08 ET]
Table 'Kitalpha II' 9-max Seat #1 is the button
Seat 1: IHouseMusic ($100 in chips) 
Seat 2: Charity86 ($85.21 in chips) 
Seat 3: matiko09 ($106 in chips) 
Seat 4: Sreshta222 ($100 in chips) 
Seat 8: skram2 ($97.50 in chips) 
Seat 9: Waltz88 ($108.49 in chips) 
Charity86: posts small blind $0.50
matiko09: posts big blind $1
4Aces4Roses: sits out 
*** HOLE CARDS ***
Dealt to matiko09 [2c Ac]
Sreshta222: folds 
skram2: folds 
Waltz88: folds 
IHouseMusic: folds 
Charity86: folds 
Uncalled bet ($0.50) returned to matiko09
matiko09 collected $1 from pot
matiko09: doesn't show hand 
*** SUMMARY ***
Total pot $1 | Rake $0 
Seat 1: IHouseMusic (button) folded before Flop (didn't bet)
Seat 2: Charity86 (small blind) folded before Flop
Seat 3: matiko09 (big blind) collected ($1)
Seat 4: Sreshta222 folded before Flop (didn't bet)
Seat 8: skram2 folded before Flop (didn't bet)
Seat 9: Waltz88 folded before Flop (didn't bet)





PokerStars Hand #148833716019:  Hold'em No Limit ($0.50/$1.00 USD) - 2016/02/15 11:29:12 CET [2016/02/15 5:29:12 ET]
Table 'Corvus III' 9-max Seat #2 is the button
Seat 1: pk4DW ($136.32 in chips) 
Seat 2: mzsportline ($93.80 in chips) 
Seat 3: VanDobeln ($243.32 in chips) 
Seat 4: goransyruvka ($108.35 in chips) 
Seat 6: Priidix ($136.63 in chips) 
Seat 7: matiko09 ($293.29 in chips) 
Seat 8: redacesfull ($247.43 in chips) 
Seat 9: er13to ($111.89 in chips) 
VanDobeln: posts small blind $0.50
goransyruvka: posts big blind $1
pk4DW: posts the ante $0.20
mzsportline: posts the ante $0.20
VanDobeln: posts the ante $0.20
goransyruvka: posts the ante $0.20
Priidix: posts the ante $0.20
matiko09: posts the ante $0.20
redacesfull: posts the ante $0.20
er13to: posts the ante $0.20
*** HOLE CARDS ***
Dealt to matiko09 [As 8d]
Priidix: folds 
matiko09: folds 
redacesfull: raises $1.12 to $2.12
er13to: folds 
pk4DW: calls $2.12
mzsportline: folds 
VanDobeln: calls $1.62
goransyruvka: calls $1.12
*** FLOP *** [8h Qd 9c]
VanDobeln: checks 
goransyruvka: bets $4.81
redacesfull: folds 
pk4DW: folds 
VanDobeln: calls $4.81
*** TURN *** [8h Qd 9c] [Kc]
VanDobeln: checks 
goransyruvka: bets $9.40
VanDobeln: folds 
Uncalled bet ($9.40) returned to goransyruvka
goransyruvka collected $18.81 from pot
goransyruvka: doesn't show hand 
*** SUMMARY ***
Total pot $19.70 | Rake $0.89 
Board [8h Qd 9c Kc]
Seat 1: pk4DW folded on the Flop
Seat 2: mzsportline (button) folded before Flop (didn't bet)
Seat 3: VanDobeln (small blind) folded on the Turn
Seat 4: goransyruvka (big blind) collected ($18.81)
Seat 6: Priidix folded before Flop (didn't bet)
Seat 7: matiko09 folded before Flop (didn't bet)
Seat 8: redacesfull folded on the Flop
Seat 9: er13to folded before Flop (didn't bet)





PokerStars Hand #148833717845:  Hold'em No Limit ($0.50/$1.00 USD) - 2016/02/15 11:29:16 CET [2016/02/15 5:29:16 ET]
Table 'Euanthe II' 9-max Seat #3 is the button
Seat 2: mahalko0925 ($76 in chips) 
Seat 3: matiko09 ($125.27 in chips) 
Seat 4: er13to ($120.18 in chips) 
Seat 5: gabi_igna ($145.20 in chips) 
Seat 6: IHouseMusic ($117.34 in chips) 
Seat 7: vinniesmol ($220.30 in chips) 
Seat 8: Sashey2708 ($40.29 in chips) 
Seat 9: Venomous100% ($116.72 in chips) 
er13to: posts small blind $0.50
gabi_igna: posts big blind $1
*** HOLE CARDS ***
Dealt to matiko09 [Kd 9d]
IHouseMusic: folds 
vinniesmol: folds 
Sashey2708: raises $2 to $3
Venomous100%: folds 
mahalko0925: folds 
matiko09: folds 
er13to: folds 
gabi_igna: folds 
Uncalled bet ($2) returned to Sashey2708
Sashey2708 collected $2.50 from pot
Sashey2708: doesn't show hand 
*** SUMMARY ***
Total pot $2.50 | Rake $0 
Seat 2: mahalko0925 folded before Flop (didn't bet)
Seat 3: matiko09 (button) folded before Flop (didn't bet)
Seat 4: er13to (small blind) folded before Flop
Seat 5: gabi_igna (big blind) folded before Flop
Seat 6: IHouseMusic folded before Flop (didn't bet)
Seat 7: vinniesmol folded before Flop (didn't bet)
Seat 8: Sashey2708 collected ($2.50)
Seat 9: Venomous100% folded before Flop (didn't bet)





PokerStars Hand #148833719454:  Hold'em No Limit ($0.50/$1.00 USD) - 2016/02/15 11:29:19 CET [2016/02/15 5:29:19 ET]
Table 'Kitalpha II' 9-max Seat #2 is the button
Seat 1: IHouseMusic ($100 in chips) 
Seat 2: Charity86 ($84.71 in chips) 
Seat 3: matiko09 ($106.50 in chips) 
Seat 4: Sreshta222 ($100 in chips) 
Seat 8: skram2 ($97.50 in chips) 
Seat 9: Waltz88 ($108.49 in chips) 
matiko09: posts small blind $0.50
Sreshta222: posts big blind $1
4Aces4Roses: sits out 
*** HOLE CARDS ***
Dealt to matiko09 [Ah 8h]
apfush joins the table at seat #5 
skram2: folds 
Waltz88: calls $1
IHouseMusic: folds 
Charity86: raises $3 to $4
matiko09: folds 
Sreshta222: folds 
Waltz88: folds 
Uncalled bet ($3) returned to Charity86
Charity86 collected $3.50 from pot
*** SUMMARY ***
Total pot $3.50 | Rake $0 
Seat 1: IHouseMusic folded before Flop (didn't bet)
Seat 2: Charity86 (button) collected ($3.50)
Seat 3: matiko09 (small blind) folded before Flop
Seat 4: Sreshta222 (big blind) folded before Flop
Seat 8: skram2 folded before Flop (didn't bet)
Seat 9: Waltz88 folded before Flop





PokerStars Hand #148833719227:  Hold'em No Limit ($0.50/$1.00 USD) - 2016/02/15 11:29:19 CET [2016/02/15 5:29:19 ET]
Table 'Praecipua' 9-max Seat #9 is the button
Seat 1: er13to ($140.50 in chips) 
Seat 2: matiko09 ($112.20 in chips) 
Seat 3: Venomous100% ($133.01 in chips) 
Seat 4: gabi_igna ($100 in chips) 
Seat 5: huffwag ($162.65 in chips) 
Seat 6: mycka86 ($103.25 in chips) 
Seat 8: Ellis Ng ($39.17 in chips) 
Seat 9: AlKatrone ($100 in chips) 
er13to: posts small blind $0.50
matiko09: posts big blind $1
*** HOLE CARDS ***
Dealt to matiko09 [3d Js]
Venomous100%: folds 
gabi_igna: folds 
huffwag: raises $1.50 to $2.50
mycka86: folds 
Ellis Ng: raises $9.50 to $12
AlKatrone: folds 
er13to: folds 
matiko09: folds 
huffwag: folds 
Uncalled bet ($9.50) returned to Ellis Ng
Ellis Ng collected $6.50 from pot
*** SUMMARY ***
Total pot $6.50 | Rake $0 
Seat 1: er13to (small blind) folded before Flop
Seat 2: matiko09 (big blind) folded before Flop
Seat 3: Venomous100% folded before Flop (didn't bet)
Seat 4: gabi_igna folded before Flop (didn't bet)
Seat 5: huffwag folded before Flop
Seat 6: mycka86 folded before Flop (didn't bet)
Seat 8: Ellis Ng collected ($6.50)
Seat 9: AlKatrone (button) folded before Flop (didn't bet)





PokerStars Hand #148833723789:  Hold'em No Limit ($0.25/$0.50 USD) - 2016/02/15 11:29:28 CET [2016/02/15 5:29:28 ET]
Table 'Vesta II' 9-max Seat #5 is the button
Seat 1: etny99 ($50 in chips) 
Seat 2: ljryviltj ($49.25 in chips) 
Seat 3: matiko09 ($52.25 in chips) 
Seat 4: vlad11122007 ($59.38 in chips) 
Seat 5: dndngod ($148.46 in chips) 
Seat 6: pandalapa ($50 in chips) 
Seat 7: ruyingren ($70.04 in chips) 
Seat 8: Arystan ($63.97 in chips) 
pandalapa: posts small blind $0.25
ruyingren: posts big blind $0.50
Aoki42: sits out 
*** HOLE CARDS ***
Dealt to matiko09 [5d Qh]
Arystan: raises $1 to $1.50
etny99: folds 
ljryviltj: raises $3 to $4.50
matiko09: folds 
vlad11122007: folds 
dndngod: folds 
pandalapa: folds 
ruyingren: folds 
Arystan: folds 
Uncalled bet ($3) returned to ljryviltj
ljryviltj collected $3.75 from pot
ljryviltj: doesn't show hand 
*** SUMMARY ***
Total pot $3.75 | Rake $0 
Seat 1: etny99 folded before Flop (didn't bet)
Seat 2: ljryviltj collected ($3.75)
Seat 3: matiko09 folded before Flop (didn't bet)
Seat 4: vlad11122007 folded before Flop (didn't bet)
Seat 5: dndngod (button) folded before Flop (didn't bet)
Seat 6: pandalapa (small blind) folded before Flop
Seat 7: ruyingren (big blind) folded before Flop
Seat 8: Arystan folded before Flop





PokerStars Hand #148833725739:  Hold'em No Limit ($0.50/$1.00 USD) - 2016/02/15 11:29:32 CET [2016/02/15 5:29:32 ET]
Table 'Anteros' 9-max Seat #8 is the button
Seat 1: redacesfull ($109.77 in chips) 
Seat 2: IHouseMusic ($115.25 in chips) 
Seat 3: er13to ($101.97 in chips) 
Seat 4: misherei ($167.04 in chips) 
Seat 5: Holm1991 ($44.25 in chips) 
Seat 6: SerAlGog ($131.65 in chips) 
Seat 7: Zoubou1983 ($194.55 in chips) 
Seat 8: matiko09 ($100 in chips) 
Seat 9: mycka86 ($105.17 in chips) 
mycka86: posts small blind $0.50
redacesfull: posts big blind $1
*** HOLE CARDS ***
Dealt to matiko09 [Tc Jh]
IHouseMusic: folds 
er13to: folds 
misherei: folds 
Holm1991: folds 
SerAlGog: raises $1.50 to $2.50
Zoubou1983: folds 
matiko09: folds 
mycka86: folds 
redacesfull: folds 
Uncalled bet ($1.50) returned to SerAlGog
SerAlGog collected $2.50 from pot
SerAlGog: doesn't show hand 
*** SUMMARY ***
Total pot $2.50 | Rake $0 
Seat 1: redacesfull (big blind) folded before Flop
Seat 2: IHouseMusic folded before Flop (didn't bet)
Seat 3: er13to folded before Flop (didn't bet)
Seat 4: misherei folded before Flop (didn't bet)
Seat 5: Holm1991 folded before Flop (didn't bet)
Seat 6: SerAlGog collected ($2.50)
Seat 7: Zoubou1983 folded before Flop (didn't bet)
Seat 8: matiko09 (button) folded before Flop (didn't bet)
Seat 9: mycka86 (small blind) folded before Flop





PokerStars Hand #148833727519:  Hold'em No Limit (€0.50/€1.00 EUR) - 2016/02/15 11:29:36 CET [2016/02/15 5:29:36 ET]
Table 'Ganesa II' 9-max Seat #8 is the button
Seat 4: Sreshta222 (€130.83 in chips) 
Seat 6: matiko09 (€109.58 in chips) 
Seat 7: er13to (€121.21 in chips) 
Seat 8: mycka86 (€100 in chips) 
Seat 9: Priidix (€171.85 in chips) 
Priidix: posts small blind €0.50
Sreshta222: posts big blind €1
AlKatrone: sits out 
*** HOLE CARDS ***
Dealt to matiko09 [9s Jh]
matiko09: folds 
er13to: folds 
mycka86: folds 
Priidix: folds 
Uncalled bet (€0.50) returned to Sreshta222
Sreshta222 collected €1 from pot
Sreshta222: doesn't show hand 
*** SUMMARY ***
Total pot €1 | Rake €0 
Seat 4: Sreshta222 (big blind) collected (€1)
Seat 6: matiko09 folded before Flop (didn't bet)
Seat 7: er13to folded before Flop (didn't bet)
Seat 8: mycka86 (button) folded before Flop (didn't bet)
Seat 9: Priidix (small blind) folded before Flop





PokerStars Hand #148833729584:  Hold'em No Limit ($0.50/$1.00 USD) - 2016/02/15 11:29:41 CET [2016/02/15 5:29:41 ET]
Table 'Octans II' 9-max Seat #3 is the button
Seat 2: matiko09 ($233.75 in chips) 
Seat 3: Aalleekks ($100 in chips) 
Seat 4: Venomous100% ($184.14 in chips) 
Seat 5: Priidix ($218.40 in chips) 
Seat 6: er13to ($100 in chips) 
Seat 7: traficblues ($55.32 in chips) 
Seat 8: IHouseMusic ($125.93 in chips) 
Seat 9: mycka86 ($101.43 in chips) 
Venomous100%: posts small blind $0.50
Priidix: posts big blind $1
*** HOLE CARDS ***
Dealt to matiko09 [7s 4s]
er13to: folds 
traficblues: folds 
IHouseMusic: folds 
mycka86: folds 
matiko09: folds 
Aalleekks: raises $1 to $2
Venomous100%: folds 
Priidix: folds 
Uncalled bet ($1) returned to Aalleekks
Aalleekks collected $2.50 from pot
Aalleekks: doesn't show hand 
*** SUMMARY ***
Total pot $2.50 | Rake $0 
Seat 2: matiko09 folded before Flop (didn't bet)
Seat 3: Aalleekks (button) collected ($2.50)
Seat 4: Venomous100% (small blind) folded before Flop
Seat 5: Priidix (big blind) folded before Flop
Seat 6: er13to folded before Flop (didn't bet)
Seat 7: traficblues folded before Flop (didn't bet)
Seat 8: IHouseMusic folded before Flop (didn't bet)
Seat 9: mycka86 folded before Flop (didn't bet)





PokerStars Hand #148833730204:  Hold'em No Limit ($0.50/$1.00 USD) - 2016/02/15 11:29:42 CET [2016/02/15 5:29:42 ET]
Table 'Kitalpha II' 9-max Seat #3 is the button
Seat 1: IHouseMusic ($100 in chips) 
Seat 2: Charity86 ($87.21 in chips) 
Seat 3: matiko09 ($106 in chips) 
Seat 4: Sreshta222 ($100 in chips) 
Seat 5: apfush ($100 in chips) 
Seat 8: skram2 ($97.50 in chips) 
Seat 9: Waltz88 ($107.49 in chips) 
Sreshta222: posts small blind $0.50
apfush: posts big blind $1
4Aces4Roses: sits out 
*** HOLE CARDS ***
Dealt to matiko09 [3h 2h]
skram2: folds 
Waltz88: calls $1
IHouseMusic: folds 
Charity86: folds 
matiko09: folds 
Sreshta222: raises $3 to $4
apfush: folds 
Waltz88: calls $3
*** FLOP *** [Ah 4d 5h]
Sreshta222: bets $6.45
Waltz88: raises $6.45 to $12.90
Sreshta222: calls $6.45
*** TURN *** [Ah 4d 5h] [Qs]
Sreshta222: checks 
Waltz88: checks 
*** RIVER *** [Ah 4d 5h Qs] [Js]
Sreshta222: checks 
Waltz88: bets $2
Sreshta222: calls $2
*** SHOW DOWN ***
Waltz88: shows [4h Ac] (two pair, Aces and Fours)
Sreshta222: mucks hand 
Waltz88 collected $37.05 from pot
*** SUMMARY ***
Total pot $38.80 | Rake $1.75 
Board [Ah 4d 5h Qs Js]
Seat 1: IHouseMusic folded before Flop (didn't bet)
Seat 2: Charity86 folded before Flop (didn't bet)
Seat 3: matiko09 (button) folded before Flop (didn't bet)
Seat 4: Sreshta222 (small blind) mucked [8c As]
Seat 5: apfush (big blind) folded before Flop
Seat 8: skram2 folded before Flop (didn't bet)
Seat 9: Waltz88 showed [4h Ac] and won ($37.05) with two pair, Aces and Fours





PokerStars Hand #148833730412:  Hold'em No Limit ($0.50/$1.00 USD) - 2016/02/15 11:29:42 CET [2016/02/15 5:29:42 ET]
Table 'Euanthe II' 9-max Seat #4 is the button
Seat 2: mahalko0925 ($76 in chips) 
Seat 3: matiko09 ($125.27 in chips) 
Seat 4: er13to ($119.68 in chips) 
Seat 5: gabi_igna ($144.20 in chips) 
Seat 6: IHouseMusic ($117.34 in chips) 
Seat 7: vinniesmol ($220.30 in chips) 
Seat 8: Sashey2708 ($41.79 in chips) 
Seat 9: Venomous100% ($116.72 in chips) 
gabi_igna: posts small blind $0.50
IHouseMusic: posts big blind $1
*** HOLE CARDS ***
Dealt to matiko09 [Ts Jd]
vinniesmol: folds 
Sashey2708: folds 
Venomous100%: folds 
mahalko0925: raises $1 to $2
matiko09: folds 
er13to: folds 
gabi_igna: folds 
IHouseMusic: calls $1
*** FLOP *** [5c 4c 8s]
IHouseMusic: checks 
mahalko0925: checks 
*** TURN *** [5c 4c 8s] [Jc]
IHouseMusic: checks 
mahalko0925: bets $3
IHouseMusic: calls $3
*** RIVER *** [5c 4c 8s Jc] [Js]
IHouseMusic: checks 
mahalko0925: checks 
*** SHOW DOWN ***
IHouseMusic: shows [9d 7d] (a pair of Jacks)
mahalko0925: shows [5d Kd] (two pair, Jacks and Fives)
mahalko0925 collected $10.03 from pot
*** SUMMARY ***
Total pot $10.50 | Rake $0.47 
Board [5c 4c 8s Jc Js]
Seat 2: mahalko0925 showed [5d Kd] and won ($10.03) with two pair, Jacks and Fives
Seat 3: matiko09 folded before Flop (didn't bet)
Seat 4: er13to (button) folded before Flop (didn't bet)
Seat 5: gabi_igna (small blind) folded before Flop
Seat 6: IHouseMusic (big blind) showed [9d 7d] and lost with a pair of Jacks
Seat 7: vinniesmol folded before Flop (didn't bet)
Seat 8: Sashey2708 folded before Flop (didn't bet)
Seat 9: Venomous100% folded before Flop (didn't bet)





PokerStars Hand #148833735747:  Hold'em No Limit (€0.50/€1.00 EUR) - 2016/02/15 11:29:54 CET [2016/02/15 5:29:54 ET]
Table 'Ganesa II' 9-max Seat #9 is the button
Seat 4: Sreshta222 (€131.33 in chips) 
Seat 5: AlKatrone (€100 in chips) 
Seat 6: matiko09 (€109.58 in chips) 
Seat 7: er13to (€121.21 in chips) 
Seat 8: mycka86 (€100 in chips) 
Seat 9: Priidix (€171.35 in chips) 
BuBu 0187 will be allowed to play after the button
Sreshta222: posts small blind €0.50
AlKatrone: posts big blind €1
*** HOLE CARDS ***
Dealt to matiko09 [Qc As]
matiko09: raises €2 to €3
er13to: raises €5 to €8
mycka86: folds 
Priidix: folds 
Sreshta222: folds 
AlKatrone: folds 
matiko09: folds 
Uncalled bet (€5) returned to er13to
er13to collected €7.50 from pot
*** SUMMARY ***
Total pot €7.50 | Rake €0 
Seat 4: Sreshta222 (small blind) folded before Flop
Seat 5: AlKatrone (big blind) folded before Flop
Seat 6: matiko09 folded before Flop
Seat 7: er13to collected (€7.50)
Seat 8: mycka86 folded before Flop (didn't bet)
Seat 9: Priidix (button) folded before Flop (didn't bet)





PokerStars Hand #148833735906:  Hold'em No Limit ($0.50/$1.00 USD) - 2016/02/15 11:29:54 CET [2016/02/15 5:29:54 ET]
Table 'Corvus III' 9-max Seat #3 is the button
Seat 1: pk4DW ($134 in chips) 
Seat 2: mzsportline ($93.60 in chips) 
Seat 3: VanDobeln ($236.19 in chips) 
Seat 4: goransyruvka ($120.03 in chips) 
Seat 6: Priidix ($136.43 in chips) 
Seat 7: matiko09 ($293.09 in chips) 
Seat 8: redacesfull ($245.11 in chips) 
Seat 9: er13to ($111.69 in chips) 
goransyruvka: posts small blind $0.50
Priidix: posts big blind $1
pk4DW: posts the ante $0.20
mzsportline: posts the ante $0.20
VanDobeln: posts the ante $0.20
goransyruvka: posts the ante $0.20
Priidix: posts the ante $0.20
matiko09: posts the ante $0.20
redacesfull: posts the ante $0.20
er13to: posts the ante $0.20
*** HOLE CARDS ***
Dealt to matiko09 [8c 4s]
matiko09: folds 
redacesfull: folds 
er13to: folds 
pk4DW: folds 
mzsportline: raises $2 to $3
VanDobeln: folds 
goransyruvka: folds 
Priidix: raises $7 to $10
mzsportline: raises $12 to $22
Priidix: calls $12
*** FLOP *** [5d 2d 2s]
Priidix: checks 
mzsportline: bets $25
Priidix: folds 
Uncalled bet ($25) returned to mzsportline
mzsportline collected $44.03 from pot
mzsportline: doesn't show hand 
*** SUMMARY ***
Total pot $46.10 | Rake $2.07 
Board [5d 2d 2s]
Seat 1: pk4DW folded before Flop (didn't bet)
Seat 2: mzsportline collected ($44.03)
Seat 3: VanDobeln (button) folded before Flop (didn't bet)
Seat 4: goransyruvka (small blind) folded before Flop
Seat 6: Priidix (big blind) folded on the Flop
Seat 7: matiko09 folded before Flop (didn't bet)
Seat 8: redacesfull folded before Flop (didn't bet)
Seat 9: er13to folded before Flop (didn't bet)





PokerStars Hand #148833738409:  Hold'em No Limit ($0.50/$1.00 USD) - 2016/02/15 11:29:59 CET [2016/02/15 5:29:59 ET]
Table 'Anteros' 9-max Seat #9 is the button
Seat 1: redacesfull ($108.77 in chips) 
Seat 2: IHouseMusic ($115.25 in chips) 
Seat 3: er13to ($101.97 in chips) 
Seat 4: misherei ($167.04 in chips) 
Seat 5: Holm1991 ($44.25 in chips) 
Seat 6: SerAlGog ($133.15 in chips) 
Seat 7: Zoubou1983 ($194.55 in chips) 
Seat 8: matiko09 ($100 in chips) 
Seat 9: mycka86 ($104.67 in chips) 
redacesfull: posts small blind $0.50
IHouseMusic: posts big blind $1
*** HOLE CARDS ***
Dealt to matiko09 [Qc 4c]
er13to: folds 
misherei: calls $1
Holm1991: folds 
SerAlGog: folds 
Zoubou1983: calls $1
matiko09: folds 
mycka86: folds 
redacesfull: folds 
IHouseMusic: checks 
*** FLOP *** [3s 9d Th]
IHouseMusic: bets $2.34
misherei: calls $2.34
Zoubou1983: calls $2.34
*** TURN *** [3s 9d Th] [5c]
IHouseMusic: checks 
misherei: bets $3
Zoubou1983: calls $3
IHouseMusic: calls $3
*** RIVER *** [3s 9d Th 5c] [3c]
IHouseMusic: checks 
misherei: checks 
Zoubou1983: checks 
*** SHOW DOWN ***
IHouseMusic: shows [Td 6h] (two pair, Tens and Threes)
misherei: shows [Tc Jc] (two pair, Tens and Threes - Jack kicker)
Zoubou1983: mucks hand 
misherei collected $18.64 from pot
*** SUMMARY ***
Total pot $19.52 | Rake $0.88 
Board [3s 9d Th 5c 3c]
Seat 1: redacesfull (small blind) folded before Flop
Seat 2: IHouseMusic (big blind) showed [Td 6h] and lost with two pair, Tens and Threes
Seat 3: er13to folded before Flop (didn't bet)
Seat 4: misherei showed [Tc Jc] and won ($18.64) with two pair, Tens and Threes
Seat 5: Holm1991 folded before Flop (didn't bet)
Seat 6: SerAlGog folded before Flop (didn't bet)
Seat 7: Zoubou1983 mucked [Ks 9s]
Seat 8: matiko09 folded before Flop (didn't bet)
Seat 9: mycka86 (button) folded before Flop (didn't bet)





PokerStars Hand #148833739844:  Hold'em No Limit ($0.25/$0.50 USD) - 2016/02/15 11:30:02 CET [2016/02/15 5:30:02 ET]
Table 'Laertes II' 9-max Seat #3 is the button
Seat 2: Seby&Sandra ($50 in chips) 
Seat 3: valfan911 ($44.11 in chips) 
Seat 4: rgar93 ($52.17 in chips) 
Seat 5: Sherlockplay ($50 in chips) 
Seat 6: ZonTTT ($50 in chips) 
Seat 9: matiko09 ($55.10 in chips) 
rgar93: posts small blind $0.25
Sherlockplay: posts big blind $0.50
apfush: sits out 
Gutschel: sits out 
Seby&Sandra: posts big blind $0.50
*** HOLE CARDS ***
Dealt to matiko09 [Ts 3d]
ZonTTT: folds 
matiko09: folds 
Seby&Sandra: checks 
valfan911: raises $1 to $1.50
rgar93: folds 
Sherlockplay: folds 
Seby&Sandra: calls $1
*** FLOP *** [8h 7c Ah]
Seby&Sandra: checks 
valfan911: bets $2.50
Seby&Sandra: folds 
Uncalled bet ($2.50) returned to valfan911
valfan911 collected $3.58 from pot
valfan911: doesn't show hand 
*** SUMMARY ***
Total pot $3.75 | Rake $0.17 
Board [8h 7c Ah]
Seat 2: Seby&Sandra folded on the Flop
Seat 3: valfan911 (button) collected ($3.58)
Seat 4: rgar93 (small blind) folded before Flop
Seat 5: Sherlockplay (big blind) folded before Flop
Seat 6: ZonTTT folded before Flop (didn't bet)
Seat 9: matiko09 folded before Flop (didn't bet)





PokerStars Hand #148833742336:  Hold'em No Limit ($0.25/$0.50 USD) - 2016/02/15 11:30:07 CET [2016/02/15 5:30:07 ET]
Table 'Vesta II' 9-max Seat #6 is the button
Seat 1: etny99 ($50 in chips) 
Seat 2: ljryviltj ($51.50 in chips) 
Seat 3: matiko09 ($52.25 in chips) 
Seat 4: vlad11122007 ($59.38 in chips) 
Seat 5: dndngod ($148.46 in chips) 
Seat 6: pandalapa ($50 in chips) 
Seat 7: ruyingren ($69.54 in chips) 
Seat 8: Arystan ($62.47 in chips) 
ruyingren: posts small blind $0.25
Arystan: posts big blind $0.50
Aoki42: sits out 
*** HOLE CARDS ***
Dealt to matiko09 [2s 9h]
etny99: folds 
ljryviltj: folds 
matiko09: folds 
vlad11122007: folds 
dndngod: folds 
pandalapa: folds 
ruyingren: folds 
Uncalled bet ($0.25) returned to Arystan
Arystan collected $0.50 from pot
Arystan: doesn't show hand 
*** SUMMARY ***
Total pot $0.50 | Rake $0 
Seat 1: etny99 folded before Flop (didn't bet)
Seat 2: ljryviltj folded before Flop (didn't bet)
Seat 3: matiko09 folded before Flop (didn't bet)
Seat 4: vlad11122007 folded before Flop (didn't bet)
Seat 5: dndngod folded before Flop (didn't bet)
Seat 6: pandalapa (button) folded before Flop (didn't bet)
Seat 7: ruyingren (small blind) folded before Flop
Seat 8: Arystan (big blind) collected ($0.50)





PokerStars Hand #148833741986:  Hold'em No Limit ($0.50/$1.00 USD) - 2016/02/15 11:30:07 CET [2016/02/15 5:30:07 ET]
Table 'Praecipua' 9-max Seat #1 is the button
Seat 1: er13to ($140 in chips) 
Seat 2: matiko09 ($111.20 in chips) 
Seat 3: Venomous100% ($133.01 in chips) 
Seat 4: gabi_igna ($100 in chips) 
Seat 5: huffwag ($160.15 in chips) 
Seat 6: mycka86 ($103.25 in chips) 
Seat 8: Ellis Ng ($43.17 in chips) 
Seat 9: AlKatrone ($100 in chips) 
matiko09: posts small blind $0.50
Venomous100%: posts big blind $1
*** HOLE CARDS ***
Dealt to matiko09 [Qc 6h]
gabi_igna: folds 
huffwag: folds 
huffwag leaves the table
mycka86: folds 
Ellis Ng: folds 
AlKatrone: folds 
er13to: raises $1.50 to $2.50
matiko09: folds 
Venomous100%: calls $1.50
*** FLOP *** [Kh 8d Kc]
Venomous100%: checks 
er13to: checks 
*** TURN *** [Kh 8d Kc] [Jc]
Venomous100%: bets $4
er13to: folds 
Uncalled bet ($4) returned to Venomous100%
Venomous100% collected $5.25 from pot
Venomous100%: doesn't show hand 
*** SUMMARY ***
Total pot $5.50 | Rake $0.25 
Board [Kh 8d Kc Jc]
Seat 1: er13to (button) folded on the Turn
Seat 2: matiko09 (small blind) folded before Flop
Seat 3: Venomous100% (big blind) collected ($5.25)
Seat 4: gabi_igna folded before Flop (didn't bet)
Seat 5: huffwag folded before Flop (didn't bet)
Seat 6: mycka86 folded before Flop (didn't bet)
Seat 8: Ellis Ng folded before Flop (didn't bet)
Seat 9: AlKatrone folded before Flop (didn't bet)





PokerStars Hand #148833743341:  Hold'em No Limit ($0.50/$1.00 USD) - 2016/02/15 11:30:10 CET [2016/02/15 5:30:10 ET]
Table 'Nata II' 9-max Seat #7 is the button
Seat 1: Priidix ($125.61 in chips) 
Seat 2: qqcom ($103 in chips) 
Seat 3: g00000se ($115.95 in chips) 
Seat 4: gabi_igna ($100 in chips) 
Seat 5: AGoodFell4 ($100.26 in chips) 
Seat 6: AlKatrone ($146.83 in chips) 
Seat 7: er13to ($114.15 in chips) 
Seat 8: lumen21 ($100 in chips) 
Seat 9: matiko09 ($100 in chips) 
lumen21: posts small blind $0.50
matiko09: posts big blind $1
*** HOLE CARDS ***
Dealt to matiko09 [5d 2c]
Priidix: folds 
qqcom: raises $2 to $3
g00000se: folds 
gabi_igna: folds 
AGoodFell4: folds 
AlKatrone: folds 
er13to: folds 
lumen21: raises $7 to $10
matiko09: folds 
qqcom: folds 
Uncalled bet ($7) returned to lumen21
lumen21 collected $7 from pot
lumen21: doesn't show hand 
*** SUMMARY ***
Total pot $7 | Rake $0 
Seat 1: Priidix folded before Flop (didn't bet)
Seat 2: qqcom folded before Flop
Seat 3: g00000se folded before Flop (didn't bet)
Seat 4: gabi_igna folded before Flop (didn't bet)
Seat 5: AGoodFell4 folded before Flop (didn't bet)
Seat 6: AlKatrone folded before Flop (didn't bet)
Seat 7: er13to (button) folded before Flop (didn't bet)
Seat 8: lumen21 (small blind) collected ($7)
Seat 9: matiko09 (big blind) folded before Flop





PokerStars Hand #148833749909:  Hold'em No Limit ($0.25/$0.50 USD) - 2016/02/15 11:30:24 CET [2016/02/15 5:30:24 ET]
Table 'Vesta II' 9-max Seat #7 is the button
Seat 1: etny99 ($50 in chips) 
Seat 2: ljryviltj ($51.50 in chips) 
Seat 3: matiko09 ($52.25 in chips) 
Seat 4: vlad11122007 ($59.38 in chips) 
Seat 5: dndngod ($148.46 in chips) 
Seat 6: pandalapa ($50 in chips) 
Seat 7: ruyingren ($69.29 in chips) 
Seat 8: Arystan ($62.72 in chips) 
Seat 9: Aoki42 ($81.22 in chips) 
Arystan: posts small blind $0.25
Aoki42: posts big blind $0.50
*** HOLE CARDS ***
Dealt to matiko09 [Qh Ad]
etny99: folds 
ljryviltj: folds 
matiko09: raises $1 to $1.50
vlad11122007: folds 
dndngod: folds 
pandalapa: folds 
ruyingren: folds 
Arystan: raises $2.50 to $4
Aoki42: folds 
matiko09: calls $2.50
*** FLOP *** [Jd 7c Th]
Arystan: bets $4.06
matiko09: calls $4.06
*** TURN *** [Jd 7c Th] [Qc]
Arystan: checks 
matiko09: checks 
*** RIVER *** [Jd 7c Th Qc] [4c]
Arystan: bets $7.93
matiko09: calls $7.93
*** SHOW DOWN ***
Arystan: shows [Js As] (a pair of Jacks)
matiko09: shows [Qh Ad] (a pair of Queens)
matiko09 collected $31.02 from pot
*** SUMMARY ***
Total pot $32.48 | Rake $1.46 
Board [Jd 7c Th Qc 4c]
Seat 1: etny99 folded before Flop (didn't bet)
Seat 2: ljryviltj folded before Flop (didn't bet)
Seat 3: matiko09 showed [Qh Ad] and won ($31.02) with a pair of Queens
Seat 4: vlad11122007 folded before Flop (didn't bet)
Seat 5: dndngod folded before Flop (didn't bet)
Seat 6: pandalapa folded before Flop (didn't bet)
Seat 7: ruyingren (button) folded before Flop (didn't bet)
Seat 8: Arystan (small blind) showed [Js As] and lost with a pair of Jacks
Seat 9: Aoki42 (big blind) folded before Flop





PokerStars Hand #148833752523:  Hold'em No Limit ($0.50/$1.00 USD) - 2016/02/15 11:30:29 CET [2016/02/15 5:30:29 ET]
Table 'Octans II' 9-max Seat #4 is the button
Seat 2: matiko09 ($233.75 in chips) 
Seat 3: Aalleekks ($101.50 in chips) 
Seat 4: Venomous100% ($183.64 in chips) 
Seat 5: Priidix ($217.40 in chips) 
Seat 6: er13to ($100 in chips) 
Seat 7: traficblues ($55.32 in chips) 
Seat 8: IHouseMusic ($125.93 in chips) 
Seat 9: mycka86 ($101.43 in chips) 
Priidix: posts small blind $0.50
er13to: posts big blind $1
*** HOLE CARDS ***
Dealt to matiko09 [Kh Ah]
traficblues: calls $1
IHouseMusic: folds 
mycka86: folds 
matiko09: raises $3 to $4
Aalleekks: folds 
Venomous100%: folds 
Priidix: raises $10 to $14
er13to: folds 
traficblues: folds 
matiko09: calls $10
*** FLOP *** [4c Js Qd]
Priidix: bets $14.89
matiko09: calls $14.89
*** TURN *** [4c Js Qd] [6c]
Priidix: checks 
matiko09: bets $41
Priidix: folds 
Uncalled bet ($41) returned to matiko09
matiko09 collected $57.09 from pot
matiko09: doesn't show hand 
*** SUMMARY ***
Total pot $59.78 | Rake $2.69 
Board [4c Js Qd 6c]
Seat 2: matiko09 collected ($57.09)
Seat 3: Aalleekks folded before Flop (didn't bet)
Seat 4: Venomous100% (button) folded before Flop (didn't bet)
Seat 5: Priidix (small blind) folded on the Turn
Seat 6: er13to (big blind) folded before Flop
Seat 7: traficblues folded before Flop
Seat 8: IHouseMusic folded before Flop (didn't bet)
Seat 9: mycka86 folded before Flop (didn't bet)





PokerStars Hand #148833756954:  Hold'em No Limit (€0.50/€1.00 EUR) - 2016/02/15 11:30:39 CET [2016/02/15 5:30:39 ET]
Table 'Ganesa II' 9-max Seat #4 is the button
Seat 3: BuBu 0187 (€73.84 in chips) 
Seat 4: Sreshta222 (€130.83 in chips) 
Seat 5: AlKatrone (€100 in chips) 
Seat 6: matiko09 (€106.58 in chips) 
Seat 7: er13to (€125.71 in chips) 
Seat 8: mycka86 (€100 in chips) 
Seat 9: Priidix (€171.35 in chips) 
AlKatrone: posts small blind €0.50
matiko09: posts big blind €1
BuBu 0187: posts small & big blinds €1.50
*** HOLE CARDS ***
Dealt to matiko09 [9h Jh]
Apparat888 joins the table at seat #1 
er13to: raises €3.20 to €4.20
mycka86: folds 
Priidix: folds 
BuBu 0187: calls €3.20
Sreshta222: folds 
AlKatrone: folds 
matiko09: folds 
*** FLOP *** [8s 4h Qh]
er13to: checks 
BuBu 0187: bets €5
er13to: raises €7.50 to €12.50
BuBu 0187: folds 
Uncalled bet (€7.50) returned to er13to
er13to collected €19.48 from pot
*** SUMMARY ***
Total pot €20.40 | Rake €0.92 
Board [8s 4h Qh]
Seat 3: BuBu 0187 folded on the Flop
Seat 4: Sreshta222 (button) folded before Flop (didn't bet)
Seat 5: AlKatrone (small blind) folded before Flop
Seat 6: matiko09 (big blind) folded before Flop
Seat 7: er13to collected (€19.48)
Seat 8: mycka86 folded before Flop (didn't bet)
Seat 9: Priidix folded before Flop (didn't bet)





PokerStars Hand #148833757443:  Hold'em No Limit ($0.50/$1.00 USD) - 2016/02/15 11:30:40 CET [2016/02/15 5:30:40 ET]
Table 'Kitalpha II' 9-max Seat #4 is the button
Seat 1: IHouseMusic ($100 in chips) 
Seat 2: Charity86 ($87.21 in chips) 
Seat 3: matiko09 ($106 in chips) 
Seat 4: Sreshta222 ($100 in chips) 
Seat 5: apfush ($100 in chips) 
Seat 7: 4Aces4Roses ($80 in chips) 
Seat 8: skram2 ($97.50 in chips) 
Seat 9: Waltz88 ($125.64 in chips) 
apfush: posts small blind $0.50
4Aces4Roses: posts big blind $1
*** HOLE CARDS ***
Dealt to matiko09 [7d 2d]
skram2: raises $2 to $3
Waltz88: folds 
IHouseMusic: folds 
Charity86: folds 
matiko09: folds 
Sreshta222: folds 
apfush: folds 
4Aces4Roses: calls $2
*** FLOP *** [9d Kh Jc]
4Aces4Roses: checks 
skram2: bets $4
4Aces4Roses: calls $4
*** TURN *** [9d Kh Jc] [Td]
4Aces4Roses: checks 
skram2: checks 
*** RIVER *** [9d Kh Jc Td] [9c]
4Aces4Roses: bets $6.92
skram2: folds 
Uncalled bet ($6.92) returned to 4Aces4Roses
4Aces4Roses collected $13.85 from pot
4Aces4Roses: doesn't show hand 
*** SUMMARY ***
Total pot $14.50 | Rake $0.65 
Board [9d Kh Jc Td 9c]
Seat 1: IHouseMusic folded before Flop (didn't bet)
Seat 2: Charity86 folded before Flop (didn't bet)
Seat 3: matiko09 folded before Flop (didn't bet)
Seat 4: Sreshta222 (button) folded before Flop (didn't bet)
Seat 5: apfush (small blind) folded before Flop
Seat 7: 4Aces4Roses (big blind) collected ($13.85)
Seat 8: skram2 folded on the River
Seat 9: Waltz88 folded before Flop (didn't bet)





PokerStars Hand #148833760972:  Hold'em No Limit ($0.50/$1.00 USD) - 2016/02/15 11:30:47 CET [2016/02/15 5:30:47 ET]
Table 'Euanthe II' 9-max Seat #5 is the button
Seat 2: mahalko0925 ($81.03 in chips) 
Seat 3: matiko09 ($125.27 in chips) 
Seat 4: er13to ($119.68 in chips) 
Seat 5: gabi_igna ($143.70 in chips) 
Seat 6: IHouseMusic ($112.34 in chips) 
Seat 7: vinniesmol ($220.30 in chips) 
Seat 8: Sashey2708 ($41.79 in chips) 
Seat 9: Venomous100% ($116.72 in chips) 
IHouseMusic: posts small blind $0.50
vinniesmol: posts big blind $1
*** HOLE CARDS ***
Dealt to matiko09 [Qc 7c]
Sashey2708: folds 
Venomous100%: raises $2 to $3
mahalko0925: folds 
matiko09: folds 
er13to: folds 
gabi_igna: folds 
IHouseMusic: folds 
vinniesmol: calls $2
*** FLOP *** [Ac 4c 3h]
vinniesmol: checks 
Venomous100%: bets $4.10
vinniesmol: calls $4.10
*** TURN *** [Ac 4c 3h] [5s]
vinniesmol: checks 
Venomous100%: bets $9.27
vinniesmol: calls $9.27
*** RIVER *** [Ac 4c 3h 5s] [Tc]
vinniesmol: checks 
Venomous100%: checks 
*** SHOW DOWN ***
vinniesmol: shows [Qs Ad] (a pair of Aces)
Venomous100%: shows [Ah Kc] (a pair of Aces - King kicker)
Venomous100% collected $31.74 from pot
*** SUMMARY ***
Total pot $33.24 | Rake $1.50 
Board [Ac 4c 3h 5s Tc]
Seat 2: mahalko0925 folded before Flop (didn't bet)
Seat 3: matiko09 folded before Flop (didn't bet)
Seat 4: er13to folded before Flop (didn't bet)
Seat 5: gabi_igna (button) folded before Flop (didn't bet)
Seat 6: IHouseMusic (small blind) folded before Flop
Seat 7: vinniesmol (big blind) showed [Qs Ad] and lost with a pair of Aces
Seat 8: Sashey2708 folded before Flop (didn't bet)
Seat 9: Venomous100% showed [Ah Kc] and won ($31.74) with a pair of Aces





PokerStars Hand #148833761685:  Hold'em No Limit ($0.50/$1.00 USD) - 2016/02/15 11:30:48 CET [2016/02/15 5:30:48 ET]
Table 'Praecipua' 9-max Seat #2 is the button
Seat 1: er13to ($137.50 in chips) 
Seat 2: matiko09 ($110.70 in chips) 
Seat 3: Venomous100% ($135.76 in chips) 
Seat 4: gabi_igna ($100 in chips) 
Seat 6: mycka86 ($103.25 in chips) 
Seat 8: Ellis Ng ($43.17 in chips) 
Seat 9: AlKatrone ($100 in chips) 
Venomous100%: posts small blind $0.50
gabi_igna: posts big blind $1
*** HOLE CARDS ***
Dealt to matiko09 [Kc 3d]
mycka86: folds 
Ellis Ng: folds 
AlKatrone: folds 
er13to: raises $1.50 to $2.50
matiko09: folds 
Venomous100%: folds 
gabi_igna: folds 
Uncalled bet ($1.50) returned to er13to
er13to collected $2.50 from pot
*** SUMMARY ***
Total pot $2.50 | Rake $0 
Seat 1: er13to collected ($2.50)
Seat 2: matiko09 (button) folded before Flop (didn't bet)
Seat 3: Venomous100% (small blind) folded before Flop
Seat 4: gabi_igna (big blind) folded before Flop
Seat 6: mycka86 folded before Flop (didn't bet)
Seat 8: Ellis Ng folded before Flop (didn't bet)
Seat 9: AlKatrone folded before Flop (didn't bet)





PokerStars Hand #148833763362:  Hold'em No Limit ($0.25/$0.50 USD) - 2016/02/15 11:30:52 CET [2016/02/15 5:30:52 ET]
Table 'Laertes II' 9-max Seat #4 is the button
Seat 2: Seby&Sandra ($48.50 in chips) 
Seat 3: valfan911 ($46.19 in chips) 
Seat 4: rgar93 ($51.92 in chips) 
Seat 5: Sherlockplay ($50 in chips) 
Seat 6: ZonTTT ($50 in chips) 
Seat 9: matiko09 ($55.10 in chips) 
Sherlockplay: posts small blind $0.25
ZonTTT: posts big blind $0.50
apfush: sits out 
Gutschel: sits out 
*** HOLE CARDS ***
Dealt to matiko09 [2d 7c]
matiko09: folds 
Seby&Sandra: raises $0.75 to $1.25
valfan911: folds 
rgar93: folds 
Sherlockplay: folds 
ZonTTT: folds 
Uncalled bet ($0.75) returned to Seby&Sandra
Seby&Sandra collected $1.25 from pot
Seby&Sandra: doesn't show hand 
*** SUMMARY ***
Total pot $1.25 | Rake $0 
Seat 2: Seby&Sandra collected ($1.25)
Seat 3: valfan911 folded before Flop (didn't bet)
Seat 4: rgar93 (button) folded before Flop (didn't bet)
Seat 5: Sherlockplay (small blind) folded before Flop
Seat 6: ZonTTT (big blind) folded before Flop
Seat 9: matiko09 folded before Flop (didn't bet)





PokerStars Hand #148833766935:  Hold'em No Limit ($0.50/$1.00 USD) - 2016/02/15 11:31:00 CET [2016/02/15 5:31:00 ET]
Table 'Nata II' 9-max Seat #8 is the button
Seat 1: Priidix ($125.61 in chips) 
Seat 2: qqcom ($100 in chips) 
Seat 3: g00000se ($115.95 in chips) 
Seat 4: gabi_igna ($100 in chips) 
Seat 5: AGoodFell4 ($100.26 in chips) 
Seat 6: AlKatrone ($146.83 in chips) 
Seat 7: er13to ($114.15 in chips) 
Seat 8: lumen21 ($104 in chips) 
Seat 9: matiko09 ($100 in chips) 
matiko09: posts small blind $0.50
Priidix: posts big blind $1
*** HOLE CARDS ***
Dealt to matiko09 [6d Jc]
qqcom: folds 
g00000se: folds 
gabi_igna: folds 
AGoodFell4: folds 
AlKatrone: raises $2 to $3
er13to: folds 
lumen21: calls $3
matiko09: folds 
Priidix: folds 
*** FLOP *** [8h Ad Jh]
AlKatrone: checks 
lumen21: bets $5
AlKatrone: folds 
Uncalled bet ($5) returned to lumen21
lumen21 collected $7.16 from pot
lumen21: doesn't show hand 
*** SUMMARY ***
Total pot $7.50 | Rake $0.34 
Board [8h Ad Jh]
Seat 1: Priidix (big blind) folded before Flop
Seat 2: qqcom folded before Flop (didn't bet)
Seat 3: g00000se folded before Flop (didn't bet)
Seat 4: gabi_igna folded before Flop (didn't bet)
Seat 5: AGoodFell4 folded before Flop (didn't bet)
Seat 6: AlKatrone folded on the Flop
Seat 7: er13to folded before Flop (didn't bet)
Seat 8: lumen21 (button) collected ($7.16)
Seat 9: matiko09 (small blind) folded before Flop





PokerStars Hand #148833770476:  Hold'em No Limit ($0.50/$1.00 USD) - 2016/02/15 11:31:07 CET [2016/02/15 5:31:07 ET]
Table 'Praecipua' 9-max Seat #3 is the button
Seat 1: er13to ($139 in chips) 
Seat 2: matiko09 ($110.70 in chips) 
Seat 3: Venomous100% ($135.26 in chips) 
Seat 4: gabi_igna ($100 in chips) 
Seat 6: mycka86 ($103.25 in chips) 
Seat 8: Ellis Ng ($43.17 in chips) 
Seat 9: AlKatrone ($100 in chips) 
gabi_igna: posts small blind $0.50
mycka86: posts big blind $1
*** HOLE CARDS ***
Dealt to matiko09 [4h 6c]
Ellis Ng: folds 
AlKatrone: folds 
er13to: folds 
matiko09: folds 
Venomous100%: folds 
gabi_igna: raises $2 to $3
mycka86: calls $2
*** FLOP *** [Qc 3d Ad]
gabi_igna: checks 
mycka86: checks 
*** TURN *** [Qc 3d Ad] [6d]
gabi_igna: bets $3
mycka86: calls $3
*** RIVER *** [Qc 3d Ad 6d] [9d]
gabi_igna: checks 
mycka86: bets $6.30
gabi_igna: folds 
Uncalled bet ($6.30) returned to mycka86
mycka86 collected $11.46 from pot
*** SUMMARY ***
Total pot $12 | Rake $0.54 
Board [Qc 3d Ad 6d 9d]
Seat 1: er13to folded before Flop (didn't bet)
Seat 2: matiko09 folded before Flop (didn't bet)
Seat 3: Venomous100% (button) folded before Flop (didn't bet)
Seat 4: gabi_igna (small blind) folded on the River
Seat 6: mycka86 (big blind) collected ($11.46)
Seat 8: Ellis Ng folded before Flop (didn't bet)
Seat 9: AlKatrone folded before Flop (didn't bet)





PokerStars Hand #148833773409:  Hold'em No Limit ($0.25/$0.50 USD) - 2016/02/15 11:31:13 CET [2016/02/15 5:31:13 ET]
Table 'Laertes II' 9-max Seat #5 is the button
Seat 2: Seby&Sandra ($49.25 in chips) 
Seat 3: valfan911 ($50 in chips) 
Seat 4: rgar93 ($51.92 in chips) 
Seat 5: Sherlockplay ($50 in chips) 
Seat 6: ZonTTT ($50 in chips) 
Seat 8: apfush ($50 in chips) 
Seat 9: matiko09 ($55.10 in chips) 
ZonTTT: posts small blind $0.25
apfush: posts big blind $0.50
Gutschel: sits out 
*** HOLE CARDS ***
Dealt to matiko09 [Js Qs]
matiko09: raises $1 to $1.50
Seby&Sandra: folds 
valfan911: folds 
rgar93: calls $1.50
Sherlockplay: calls $1.50
ZonTTT: folds 
apfush: folds 
*** FLOP *** [7s 5s As]
matiko09: bets $3.26
rgar93: calls $3.26
Sherlockplay: folds 
*** TURN *** [7s 5s As] [Th]
matiko09: bets $7.50
rgar93: calls $7.50
*** RIVER *** [7s 5s As Th] [3h]
matiko09: bets $17.50
rgar93: folds 
Uncalled bet ($17.50) returned to matiko09
matiko09 collected $25.57 from pot
matiko09: doesn't show hand 
*** SUMMARY ***
Total pot $26.77 | Rake $1.20 
Board [7s 5s As Th 3h]
Seat 2: Seby&Sandra folded before Flop (didn't bet)
Seat 3: valfan911 folded before Flop (didn't bet)
Seat 4: rgar93 folded on the River
Seat 5: Sherlockplay (button) folded on the Flop
Seat 6: ZonTTT (small blind) folded before Flop
Seat 8: apfush (big blind) folded before Flop
Seat 9: matiko09 collected ($25.57)





PokerStars Hand #148833781460:  Hold'em No Limit ($0.50/$1.00 USD) - 2016/02/15 11:31:30 CET [2016/02/15 5:31:30 ET]
Table 'Anteros' 9-max Seat #1 is the button
Seat 1: redacesfull ($108.27 in chips) 
Seat 2: IHouseMusic ($108.91 in chips) 
Seat 3: er13to ($101.97 in chips) 
Seat 4: misherei ($179.34 in chips) 
Seat 5: Holm1991 ($44.25 in chips) 
Seat 6: SerAlGog ($133.15 in chips) 
Seat 7: Zoubou1983 ($188.21 in chips) 
Seat 8: matiko09 ($100 in chips) 
Seat 9: mycka86 ($104.67 in chips) 
IHouseMusic: posts small blind $0.50
er13to: posts big blind $1
*** HOLE CARDS ***
Dealt to matiko09 [5s Ah]
misherei: folds 
Holm1991: calls $1
SerAlGog: folds 
Zoubou1983: calls $1
matiko09: folds 
mycka86: folds 
redacesfull: folds 
IHouseMusic: folds 
er13to: checks 
*** FLOP *** [Js Qc 3h]
er13to: checks 
Holm1991: checks 
Zoubou1983: checks 
*** TURN *** [Js Qc 3h] [9c]
er13to: checks 
Holm1991: checks 
Zoubou1983: bets $4
er13to: folds 
Holm1991: folds 
Uncalled bet ($4) returned to Zoubou1983
Zoubou1983 collected $3.34 from pot
Zoubou1983: doesn't show hand 
*** SUMMARY ***
Total pot $3.50 | Rake $0.16 
Board [Js Qc 3h 9c]
Seat 1: redacesfull (button) folded before Flop (didn't bet)
Seat 2: IHouseMusic (small blind) folded before Flop
Seat 3: er13to (big blind) folded on the Turn
Seat 4: misherei folded before Flop (didn't bet)
Seat 5: Holm1991 folded on the Turn
Seat 6: SerAlGog folded before Flop (didn't bet)
Seat 7: Zoubou1983 collected ($3.34)
Seat 8: matiko09 folded before Flop (didn't bet)
Seat 9: mycka86 folded before Flop (didn't bet)





PokerStars Hand #148833785304:  Hold'em No Limit ($0.50/$1.00 USD) - 2016/02/15 11:31:39 CET [2016/02/15 5:31:39 ET]
Table 'Corvus III' 9-max Seat #4 is the button
Seat 1: pk4DW ($133.80 in chips) 
Seat 2: mzsportline ($115.43 in chips) 
Seat 3: VanDobeln ($235.99 in chips) 
Seat 4: goransyruvka ($119.33 in chips) 
Seat 6: Priidix ($114.23 in chips) 
Seat 7: matiko09 ($292.89 in chips) 
Seat 8: redacesfull ($244.91 in chips) 
Seat 9: er13to ($111.49 in chips) 
Priidix: posts small blind $0.50
matiko09: posts big blind $1
pk4DW: posts the ante $0.20
mzsportline: posts the ante $0.20
VanDobeln: posts the ante $0.20
goransyruvka: posts the ante $0.20
Priidix: posts the ante $0.20
matiko09: posts the ante $0.20
redacesfull: posts the ante $0.20
er13to: posts the ante $0.20
*** HOLE CARDS ***
Dealt to matiko09 [2s 3c]
redacesfull: raises $1.12 to $2.12
er13to: folds 
pk4DW: raises $3.48 to $5.60
mzsportline: folds 
VanDobeln: folds 
goransyruvka: calls $5.60
Priidix: folds 
matiko09: folds 
redacesfull: calls $3.48
*** FLOP *** [Qc Js Jd]
redacesfull: checks 
pk4DW: bets $8
goransyruvka: folds 
redacesfull: folds 
Uncalled bet ($8) returned to pk4DW
pk4DW collected $19 from pot
pk4DW: doesn't show hand 
*** SUMMARY ***
Total pot $19.90 | Rake $0.90 
Board [Qc Js Jd]
Seat 1: pk4DW collected ($19)
Seat 2: mzsportline folded before Flop (didn't bet)
Seat 3: VanDobeln folded before Flop (didn't bet)
Seat 4: goransyruvka (button) folded on the Flop
Seat 6: Priidix (small blind) folded before Flop
Seat 7: matiko09 (big blind) folded before Flop
Seat 8: redacesfull folded on the Flop
Seat 9: er13to folded before Flop (didn't bet)





PokerStars Hand #148833785735:  Hold'em No Limit ($0.50/$1.00 USD) - 2016/02/15 11:31:39 CET [2016/02/15 5:31:39 ET]
Table 'Kitalpha II' 9-max Seat #5 is the button
Seat 1: IHouseMusic ($100 in chips) 
Seat 2: Charity86 ($87.21 in chips) 
Seat 3: matiko09 ($106 in chips) 
Seat 4: Sreshta222 ($100 in chips) 
Seat 5: apfush ($100 in chips) 
Seat 7: 4Aces4Roses ($86.85 in chips) 
Seat 8: skram2 ($90.50 in chips) 
Seat 9: Waltz88 ($125.64 in chips) 
Congo Sam will be allowed to play after the button
4Aces4Roses: posts small blind $0.50
skram2: posts big blind $1
*** HOLE CARDS ***
Dealt to matiko09 [2d 2c]
Waltz88: calls $1
IHouseMusic: folds 
Charity86: raises $2 to $3
matiko09: calls $3
Sreshta222: folds 
apfush: folds 
4Aces4Roses: folds 
skram2: folds 
Waltz88: calls $2
*** FLOP *** [8s Jd Ks]
Waltz88: bets $2
Charity86: calls $2
matiko09: folds 
*** TURN *** [8s Jd Ks] [6c]
Waltz88: checks 
Charity86: checks 
*** RIVER *** [8s Jd Ks 6c] [9h]
Waltz88: checks 
Charity86: checks 
*** SHOW DOWN ***
Waltz88: shows [Kc 5c] (a pair of Kings)
Charity86: mucks hand 
Waltz88 collected $13.85 from pot
*** SUMMARY ***
Total pot $14.50 | Rake $0.65 
Board [8s Jd Ks 6c 9h]
Seat 1: IHouseMusic folded before Flop (didn't bet)
Seat 2: Charity86 mucked [Ah Qh]
Seat 3: matiko09 folded on the Flop
Seat 4: Sreshta222 folded before Flop (didn't bet)
Seat 5: apfush (button) folded before Flop (didn't bet)
Seat 7: 4Aces4Roses (small blind) folded before Flop
Seat 8: skram2 (big blind) folded before Flop
Seat 9: Waltz88 showed [Kc 5c] and won ($13.85) with a pair of Kings





PokerStars Hand #148833788512:  Hold'em No Limit ($0.25/$0.50 USD) - 2016/02/15 11:31:45 CET [2016/02/15 5:31:45 ET]
Table 'Vesta II' 9-max Seat #8 is the button
Seat 2: ljryviltj ($51.50 in chips) 
Seat 3: matiko09 ($67.28 in chips) 
Seat 4: vlad11122007 ($59.38 in chips) 
Seat 5: dndngod ($148.46 in chips) 
Seat 6: pandalapa ($50 in chips) 
Seat 7: ruyingren ($69.29 in chips) 
Seat 8: Arystan ($46.73 in chips) 
Seat 9: Aoki42 ($80.72 in chips) 
Aoki42: posts small blind $0.25
etny99: is sitting out 
etny99 leaves the table
ljryviltj: posts big blind $0.50
*** HOLE CARDS ***
Dealt to matiko09 [3s 2h]
matiko09: folds 
vlad11122007: folds 
dndngod: raises $1 to $1.50
pandalapa: folds 
ruyingren: folds 
Arystan: raises $3 to $4.50
Aoki42: folds 
lumen21 joins the table at seat #1 
ljryviltj: folds 
dndngod: calls $3
*** FLOP *** [Ah 5s 2c]
dndngod: checks 
Arystan: bets $4.65
dndngod: folds 
Uncalled bet ($4.65) returned to Arystan
Arystan collected $9.31 from pot
Arystan: doesn't show hand 
*** SUMMARY ***
Total pot $9.75 | Rake $0.44 
Board [Ah 5s 2c]
Seat 2: ljryviltj (big blind) folded before Flop
Seat 3: matiko09 folded before Flop (didn't bet)
Seat 4: vlad11122007 folded before Flop (didn't bet)
Seat 5: dndngod folded on the Flop
Seat 6: pandalapa folded before Flop (didn't bet)
Seat 7: ruyingren folded before Flop (didn't bet)
Seat 8: Arystan (button) collected ($9.31)
Seat 9: Aoki42 (small blind) folded before Flop





PokerStars Hand #148833788812:  Hold'em No Limit ($0.50/$1.00 USD) - 2016/02/15 11:31:46 CET [2016/02/15 5:31:46 ET]
Table 'Euanthe II' 9-max Seat #6 is the button
Seat 2: mahalko0925 ($81.03 in chips) 
Seat 3: matiko09 ($125.27 in chips) 
Seat 4: er13to ($119.68 in chips) 
Seat 5: gabi_igna ($143.70 in chips) 
Seat 6: IHouseMusic ($111.84 in chips) 
Seat 7: vinniesmol ($203.93 in chips) 
Seat 8: Sashey2708 ($41.79 in chips) 
Seat 9: Venomous100% ($132.09 in chips) 
vinniesmol: posts small blind $0.50
Sashey2708: posts big blind $1
*** HOLE CARDS ***
Dealt to matiko09 [Ks Ah]
Venomous100%: folds 
mahalko0925: raises $1 to $2
matiko09: raises $5 to $7
er13to: folds 
gabi_igna: raises $11 to $18
IHouseMusic: folds 
vinniesmol: folds 
Sashey2708: folds 
mahalko0925: folds 
matiko09: calls $11
*** FLOP *** [8h 9d 3s]
matiko09: checks 
gabi_igna: bets $13
matiko09: calls $13
*** TURN *** [8h 9d 3s] [2c]
matiko09: checks 
gabi_igna: bets $25
matiko09: folds 
Uncalled bet ($25) returned to gabi_igna
gabi_igna collected $62.70 from pot
gabi_igna: doesn't show hand 
*** SUMMARY ***
Total pot $65.50 | Rake $2.80 
Board [8h 9d 3s 2c]
Seat 2: mahalko0925 folded before Flop
Seat 3: matiko09 folded on the Turn
Seat 4: er13to folded before Flop (didn't bet)
Seat 5: gabi_igna collected ($62.70)
Seat 6: IHouseMusic (button) folded before Flop (didn't bet)
Seat 7: vinniesmol (small blind) folded before Flop
Seat 8: Sashey2708 (big blind) folded before Flop
Seat 9: Venomous100% folded before Flop (didn't bet)





PokerStars Hand #148833790953:  Hold'em No Limit ($0.50/$1.00 USD) - 2016/02/15 11:31:51 CET [2016/02/15 5:31:51 ET]
Table 'Oongaq' 9-max Seat #8 is the button
Seat 1: matiko09 ($100 in chips) 
Seat 2: Priidix ($105.07 in chips) 
Seat 3: wilsong96 ($102.58 in chips) 
Seat 5: mn230758 ($25.11 in chips) 
Seat 6: IHouseMusic ($113.96 in chips) 
Seat 7: gwwsb ($68.92 in chips) 
Seat 8: AlKatrone ($106.04 in chips) 
Seat 9: alpw47 ($30.40 in chips) 
alpw47: posts small blind $0.50
matiko09: posts big blind $1
*** HOLE CARDS ***
Dealt to matiko09 [6d Jd]
Priidix: folds 
wilsong96: folds 
mn230758: folds 
IHouseMusic: folds 
gwwsb: raises $1 to $2
AlKatrone: folds 
alpw47: calls $1.50
matiko09: folds 
*** FLOP *** [Ks 9s 4d]
alpw47: checks 
gwwsb: checks 
*** TURN *** [Ks 9s 4d] [7s]
alpw47: checks 
gwwsb: bets $2.39
alpw47: calls $2.39
*** RIVER *** [Ks 9s 4d 7s] [Qd]
alpw47: checks 
gwwsb: checks 
*** SHOW DOWN ***
alpw47: shows [8d 8s] (a pair of Eights)
gwwsb: mucks hand 
alpw47 collected $9.34 from pot
*** SUMMARY ***
Total pot $9.78 | Rake $0.44 
Board [Ks 9s 4d 7s Qd]
Seat 1: matiko09 (big blind) folded before Flop
Seat 2: Priidix folded before Flop (didn't bet)
Seat 3: wilsong96 folded before Flop (didn't bet)
Seat 5: mn230758 folded before Flop (didn't bet)
Seat 6: IHouseMusic folded before Flop (didn't bet)
Seat 7: gwwsb mucked [8c 7h]
Seat 8: AlKatrone (button) folded before Flop (didn't bet)
Seat 9: alpw47 (small blind) showed [8d 8s] and won ($9.34) with a pair of Eights





PokerStars Hand #148833802497:  Hold'em No Limit ($0.50/$1.00 USD) - 2016/02/15 11:32:15 CET [2016/02/15 5:32:15 ET]
Table 'Praecipua' 9-max Seat #4 is the button
Seat 1: er13to ($139 in chips) 
Seat 2: matiko09 ($110.70 in chips) 
Seat 3: Venomous100% ($135.26 in chips) 
Seat 4: gabi_igna ($100 in chips) 
Seat 6: mycka86 ($108.71 in chips) 
Seat 8: Ellis Ng ($43.17 in chips) 
Seat 9: AlKatrone ($100 in chips) 
mycka86: posts small blind $0.50
Ellis Ng: posts big blind $1
*** HOLE CARDS ***
Dealt to matiko09 [Jh 8s]
AlKatrone: folds 
er13to: folds 
matiko09: folds 
Venomous100%: folds 
gabi_igna: folds 
mycka86: raises $1.75 to $2.75
Ellis Ng: calls $1.75
*** FLOP *** [7c 4s 3d]
mycka86: bets $3.50
Ellis Ng: calls $3.50
*** TURN *** [7c 4s 3d] [5s]
mycka86: checks 
Ellis Ng: checks 
*** RIVER *** [7c 4s 3d 5s] [5d]
mycka86: bets $7.50
Ellis Ng: calls $7.50
*** SHOW DOWN ***
mycka86: shows [6d 6s] (a straight, Three to Seven)
Ellis Ng: mucks hand 
mycka86 collected $26.26 from pot
*** SUMMARY ***
Total pot $27.50 | Rake $1.24 
Board [7c 4s 3d 5s 5d]
Seat 1: er13to folded before Flop (didn't bet)
Seat 2: matiko09 folded before Flop (didn't bet)
Seat 3: Venomous100% folded before Flop (didn't bet)
Seat 4: gabi_igna (button) folded before Flop (didn't bet)
Seat 6: mycka86 (small blind) showed [6d 6s] and won ($26.26) with a straight, Three to Seven
Seat 8: Ellis Ng (big blind) mucked [Kh 7h]
Seat 9: AlKatrone folded before Flop (didn't bet)





PokerStars Hand #148833810656:  Hold'em No Limit ($0.25/$0.50 USD) - 2016/02/15 11:32:32 CET [2016/02/15 5:32:32 ET]
Table 'Vesta II' 9-max Seat #9 is the button
Seat 2: ljryviltj ($51 in chips) 
Seat 3: matiko09 ($67.28 in chips) 
Seat 4: vlad11122007 ($59.38 in chips) 
Seat 5: dndngod ($143.96 in chips) 
Seat 6: pandalapa ($50 in chips) 
Seat 7: ruyingren ($69.29 in chips) 
Seat 8: Arystan ($51.54 in chips) 
Seat 9: Aoki42 ($80.47 in chips) 
lumen21 will be allowed to play after the button
ljryviltj: posts small blind $0.25
matiko09: posts big blind $0.50
*** HOLE CARDS ***
Dealt to matiko09 [3s 6d]
vlad11122007: folds 
dndngod: folds 
pandalapa: folds 
ruyingren: folds 
Arystan: raises $1 to $1.50
Aoki42: calls $1.50
ljryviltj: folds 
matiko09: folds 
*** FLOP *** [2s Td Ks]
Arystan: bets $1.79
Aoki42: raises $3.72 to $5.51
Arystan: calls $3.72
*** TURN *** [2s Td Ks] [9s]
Arystan: checks 
Aoki42: bets $9.31
Arystan: calls $9.31
*** RIVER *** [2s Td Ks 9s] [3h]
Arystan: checks 
Aoki42: checks 
*** SHOW DOWN ***
Arystan: shows [Ad Kc] (a pair of Kings)
Aoki42: shows [2d 2c] (three of a kind, Deuces)
Aoki42 collected $31.89 from pot
*** SUMMARY ***
Total pot $33.39 | Rake $1.50 
Board [2s Td Ks 9s 3h]
Seat 2: ljryviltj (small blind) folded before Flop
Seat 3: matiko09 (big blind) folded before Flop
Seat 4: vlad11122007 folded before Flop (didn't bet)
Seat 5: dndngod folded before Flop (didn't bet)
Seat 6: pandalapa folded before Flop (didn't bet)
Seat 7: ruyingren folded before Flop (didn't bet)
Seat 8: Arystan showed [Ad Kc] and lost with a pair of Kings
Seat 9: Aoki42 (button) showed [2d 2c] and won ($31.89) with three of a kind, Deuces





PokerStars Hand #148833812294:  Hold'em No Limit ($0.50/$1.00 USD) - 2016/02/15 11:32:35 CET [2016/02/15 5:32:35 ET]
Table 'Corvus III' 9-max Seat #6 is the button
Seat 1: pk4DW ($147 in chips) 
Seat 2: mzsportline ($115.23 in chips) 
Seat 3: VanDobeln ($235.79 in chips) 
Seat 4: goransyruvka ($113.53 in chips) 
Seat 6: Priidix ($113.53 in chips) 
Seat 7: matiko09 ($291.69 in chips) 
Seat 8: redacesfull ($239.11 in chips) 
Seat 9: er13to ($111.29 in chips) 
matiko09: posts small blind $0.50
redacesfull: posts big blind $1
pk4DW: posts the ante $0.20
mzsportline: posts the ante $0.20
VanDobeln: posts the ante $0.20
goransyruvka: posts the ante $0.20
Priidix: posts the ante $0.20
matiko09: posts the ante $0.20
redacesfull: posts the ante $0.20
er13to: posts the ante $0.20
*** HOLE CARDS ***
Dealt to matiko09 [4d 3d]
er13to: folds 
pk4DW: calls $1
mzsportline: folds 
VanDobeln: folds 
goransyruvka: calls $1
Priidix: raises $6.10 to $7.10
matiko09: folds 
redacesfull: folds 
pk4DW: folds 
goransyruvka: calls $6.10
*** FLOP *** [7c 2d 4s]
goransyruvka: bets $8.74
Priidix: calls $8.74
*** TURN *** [7c 2d 4s] [4c]
goransyruvka: bets $17.08
Priidix: calls $17.08
*** RIVER *** [7c 2d 4s 4c] [2s]
goransyruvka: bets $67.14
Priidix: calls $67.14
*** SHOW DOWN ***
goransyruvka: shows [4h Ad] (a full house, Fours full of Deuces)
Priidix: mucks hand 
goransyruvka collected $201.42 from pot
*** SUMMARY ***
Total pot $204.22 | Rake $2.80 
Board [7c 2d 4s 4c 2s]
Seat 1: pk4DW folded before Flop
Seat 2: mzsportline folded before Flop (didn't bet)
Seat 3: VanDobeln folded before Flop (didn't bet)
Seat 4: goransyruvka showed [4h Ad] and won ($201.42) with a full house, Fours full of Deuces
Seat 6: Priidix (button) mucked [Tc Ac]
Seat 7: matiko09 (small blind) folded before Flop
Seat 8: redacesfull (big blind) folded before Flop
Seat 9: er13to folded before Flop (didn't bet)





PokerStars Hand #148833813910:  Hold'em No Limit ($0.50/$1.00 USD) - 2016/02/15 11:32:39 CET [2016/02/15 5:32:39 ET]
Table 'Anteros' 9-max Seat #2 is the button
Seat 1: redacesfull ($108.27 in chips) 
Seat 2: IHouseMusic ($108.41 in chips) 
Seat 3: er13to ($100.97 in chips) 
Seat 4: misherei ($179.34 in chips) 
Seat 5: Holm1991 ($43.25 in chips) 
Seat 6: SerAlGog ($133.15 in chips) 
Seat 7: Zoubou1983 ($190.55 in chips) 
Seat 8: matiko09 ($100 in chips) 
Seat 9: mycka86 ($104.67 in chips) 
er13to: posts small blind $0.50
misherei: posts big blind $1
*** HOLE CARDS ***
Dealt to matiko09 [Tc 2d]
Holm1991: folds 
SerAlGog: folds 
Zoubou1983: calls $1
matiko09: folds 
mycka86: folds 
redacesfull: folds 
IHouseMusic: folds 
er13to: folds 
misherei: checks 
*** FLOP *** [5d 8s 5s]
misherei: checks 
Zoubou1983: checks 
*** TURN *** [5d 8s 5s] [2h]
misherei: checks 
Zoubou1983: bets $2
misherei: calls $2
*** RIVER *** [5d 8s 5s 2h] [Td]
misherei: checks 
Zoubou1983: bets $6
misherei: folds 
Uncalled bet ($6) returned to Zoubou1983
Zoubou1983 collected $6.21 from pot
Zoubou1983: doesn't show hand 
*** SUMMARY ***
Total pot $6.50 | Rake $0.29 
Board [5d 8s 5s 2h Td]
Seat 1: redacesfull folded before Flop (didn't bet)
Seat 2: IHouseMusic (button) folded before Flop (didn't bet)
Seat 3: er13to (small blind) folded before Flop
Seat 4: misherei (big blind) folded on the River
Seat 5: Holm1991 folded before Flop (didn't bet)
Seat 6: SerAlGog folded before Flop (didn't bet)
Seat 7: Zoubou1983 collected ($6.21)
Seat 8: matiko09 folded before Flop (didn't bet)
Seat 9: mycka86 folded before Flop (didn't bet)





PokerStars Hand #148833815993:  Hold'em No Limit (€0.50/€1.00 EUR) - 2016/02/15 11:32:43 CET [2016/02/15 5:32:43 ET]
Table 'Ganesa II' 9-max Seat #5 is the button
Seat 3: BuBu 0187 (€64.14 in chips) 
Seat 4: Sreshta222 (€130.83 in chips) 
Seat 5: AlKatrone (€100 in chips) 
Seat 6: matiko09 (€105.58 in chips) 
Seat 7: er13to (€135.99 in chips) 
Seat 8: mycka86 (€100 in chips) 
Seat 9: Priidix (€171.35 in chips) 
matiko09: posts small blind €0.50
er13to: posts big blind €1
Apparat888: sits out 
*** HOLE CARDS ***
Dealt to matiko09 [7h Qd]
mycka86: folds 
Priidix: folds 
BuBu 0187: folds 
Sreshta222: raises €1.50 to €2.50
AlKatrone: raises €5.50 to €8
matiko09: folds 
er13to: folds 
Sreshta222: calls €5.50
*** FLOP *** [7d 8d 6s]
Sreshta222: checks 
AlKatrone: checks 
*** TURN *** [7d 8d 6s] [4h]
Sreshta222: checks 
AlKatrone: bets €11
Sreshta222: folds 
Uncalled bet (€11) returned to AlKatrone
AlKatrone collected €16.71 from pot
AlKatrone: doesn't show hand 
*** SUMMARY ***
Total pot €17.50 | Rake €0.79 
Board [7d 8d 6s 4h]
Seat 3: BuBu 0187 folded before Flop (didn't bet)
Seat 4: Sreshta222 folded on the Turn
Seat 5: AlKatrone (button) collected (€16.71)
Seat 6: matiko09 (small blind) folded before Flop
Seat 7: er13to (big blind) folded before Flop
Seat 8: mycka86 folded before Flop (didn't bet)
Seat 9: Priidix folded before Flop (didn't bet)





PokerStars Hand #148833816192:  Hold'em No Limit ($0.50/$1.00 USD) - 2016/02/15 11:32:44 CET [2016/02/15 5:32:44 ET]
Table 'Octans II' 9-max Seat #5 is the button
Seat 2: matiko09 ($261.95 in chips) 
Seat 3: Aalleekks ($101.50 in chips) 
Seat 4: Venomous100% ($183.64 in chips) 
Seat 5: Priidix ($188.51 in chips) 
Seat 6: er13to ($100 in chips) 
Seat 7: traficblues ($54.32 in chips) 
Seat 8: IHouseMusic ($125.93 in chips) 
Seat 9: mycka86 ($101.43 in chips) 
er13to: posts small blind $0.50
traficblues: posts big blind $1
*** HOLE CARDS ***
Dealt to matiko09 [Jh Ah]
IHouseMusic: folds 
mycka86: folds 
matiko09: raises $2 to $3
Aalleekks: folds 
Venomous100%: folds 
Priidix: folds 
er13to: folds 
traficblues: calls $2
*** FLOP *** [3d 4d Kh]
traficblues: checks 
matiko09: bets $4.04
traficblues: calls $4.04
*** TURN *** [3d 4d Kh] [9s]
traficblues: checks 
matiko09: checks 
*** RIVER *** [3d 4d Kh 9s] [8s]
traficblues: checks 
matiko09: checks 
*** SHOW DOWN ***
traficblues: shows [Td 6d] (high card King)
matiko09: shows [Jh Ah] (high card Ace)
matiko09 collected $13.92 from pot
*** SUMMARY ***
Total pot $14.58 | Rake $0.66 
Board [3d 4d Kh 9s 8s]
Seat 2: matiko09 showed [Jh Ah] and won ($13.92) with high card Ace
Seat 3: Aalleekks folded before Flop (didn't bet)
Seat 4: Venomous100% folded before Flop (didn't bet)
Seat 5: Priidix (button) folded before Flop (didn't bet)
Seat 6: er13to (small blind) folded before Flop
Seat 7: traficblues (big blind) showed [Td 6d] and lost with high card King
Seat 8: IHouseMusic folded before Flop (didn't bet)
Seat 9: mycka86 folded before Flop (didn't bet)





PokerStars Hand #148833819280:  Hold'em No Limit ($0.50/$1.00 USD) - 2016/02/15 11:32:50 CET [2016/02/15 5:32:50 ET]
Table 'Nata II' 9-max Seat #9 is the button
Seat 1: Priidix ($124.61 in chips) 
Seat 2: qqcom ($100 in chips) 
Seat 3: g00000se ($115.95 in chips) 
Seat 4: gabi_igna ($100 in chips) 
Seat 5: AGoodFell4 ($100.26 in chips) 
Seat 6: AlKatrone ($143.83 in chips) 
Seat 7: er13to ($114.15 in chips) 
Seat 8: lumen21 ($108.16 in chips) 
Seat 9: matiko09 ($100 in chips) 
Priidix: posts small blind $0.50
qqcom: posts big blind $1
*** HOLE CARDS ***
Dealt to matiko09 [Ks 7d]
g00000se: raises $1.50 to $2.50
gabi_igna: folds 
AGoodFell4: folds 
AlKatrone: folds 
er13to: folds 
lumen21: folds 
matiko09: folds 
Priidix: folds 
qqcom: raises $5.50 to $8
g00000se: calls $5.50
*** FLOP *** [Th 2s Ts]
qqcom: bets $15.76
g00000se: folds 
Uncalled bet ($15.76) returned to qqcom
qqcom collected $15.76 from pot
*** SUMMARY ***
Total pot $16.50 | Rake $0.74 
Board [Th 2s Ts]
Seat 1: Priidix (small blind) folded before Flop
Seat 2: qqcom (big blind) collected ($15.76)
Seat 3: g00000se folded on the Flop
Seat 4: gabi_igna folded before Flop (didn't bet)
Seat 5: AGoodFell4 folded before Flop (didn't bet)
Seat 6: AlKatrone folded before Flop (didn't bet)
Seat 7: er13to folded before Flop (didn't bet)
Seat 8: lumen21 folded before Flop (didn't bet)
Seat 9: matiko09 (button) folded before Flop (didn't bet)





PokerStars Hand #148833828751:  Hold'em No Limit ($0.50/$1.00 USD) - 2016/02/15 11:33:10 CET [2016/02/15 5:33:10 ET]
Table 'Kitalpha II' 9-max Seat #7 is the button
Seat 1: IHouseMusic ($100 in chips) 
Seat 2: Charity86 ($82.21 in chips) 
Seat 3: matiko09 ($103 in chips) 
Seat 4: Sreshta222 ($100 in chips) 
Seat 5: apfush ($100 in chips) 
Seat 7: 4Aces4Roses ($86.35 in chips) 
Seat 8: skram2 ($89.50 in chips) 
Seat 9: Waltz88 ($134.49 in chips) 
skram2: posts small blind $0.50
Waltz88: posts big blind $1
Congo Sam: sits out 
*** HOLE CARDS ***
Dealt to matiko09 [Qd 5s]
IHouseMusic: folds 
Charity86: folds 
matiko09: folds 
Sreshta222: raises $1.50 to $2.50
apfush: calls $2.50
4Aces4Roses: folds 
skram2: folds 
Waltz88: calls $1.50
*** FLOP *** [3s 8c 6s]
Waltz88: bets $3
Sreshta222: calls $3
apfush: calls $3
*** TURN *** [3s 8c 6s] [Qs]
Waltz88: bets $5
Sreshta222: calls $5
apfush: raises $13.50 to $18.50
Waltz88: calls $13.50
Sreshta222: calls $13.50
*** RIVER *** [3s 8c 6s Qs] [Jc]
Waltz88: checks 
Sreshta222: checks 
apfush: bets $37
Waltz88: raises $73.49 to $110.49 and is all-in
Sreshta222: folds 
apfush: calls $39 and is all-in
Uncalled bet ($34.49) returned to Waltz88
*** SHOW DOWN ***
Waltz88: shows [2s Ks] (a flush, King high)
apfush: shows [Ts 9s] (a flush, Queen high)
Waltz88 collected $221.70 from pot
*** SUMMARY ***
Total pot $224.50 | Rake $2.80 
Board [3s 8c 6s Qs Jc]
Seat 1: IHouseMusic folded before Flop (didn't bet)
Seat 2: Charity86 folded before Flop (didn't bet)
Seat 3: matiko09 folded before Flop (didn't bet)
Seat 4: Sreshta222 folded on the River
Seat 5: apfush showed [Ts 9s] and lost with a flush, Queen high
Seat 7: 4Aces4Roses (button) folded before Flop (didn't bet)
Seat 8: skram2 (small blind) folded before Flop
Seat 9: Waltz88 (big blind) showed [2s Ks] and won ($221.70) with a flush, King high





PokerStars Hand #148833834152:  Hold'em No Limit ($0.50/$1.00 USD) - 2016/02/15 11:33:22 CET [2016/02/15 5:33:22 ET]
Table 'Euanthe II' 9-max Seat #7 is the button
Seat 2: mahalko0925 ($79.03 in chips) 
Seat 3: matiko09 ($100 in chips) 
Seat 4: er13to ($119.68 in chips) 
Seat 5: gabi_igna ($175.40 in chips) 
Seat 6: IHouseMusic ($111.84 in chips) 
Seat 7: vinniesmol ($203.43 in chips) 
Seat 8: Sashey2708 ($40.79 in chips) 
Seat 9: Venomous100% ($132.09 in chips) 
Sashey2708: posts small blind $0.50
Venomous100%: posts big blind $1
*** HOLE CARDS ***
Dealt to matiko09 [Kh Ac]
mahalko0925: folds 
matiko09: raises $2 to $3
er13to: folds 
gabi_igna: folds 
IHouseMusic: folds 
vinniesmol: folds 
Sashey2708: calls $2.50
Venomous100%: folds 
*** FLOP *** [7h Ks 8d]
Sashey2708: bets $2
matiko09: raises $4 to $6
Sashey2708: calls $4
*** TURN *** [7h Ks 8d] [3d]
Sashey2708: checks 
matiko09: bets $10
Sashey2708: folds 
Uncalled bet ($10) returned to matiko09
matiko09 collected $18.14 from pot
matiko09: doesn't show hand 
*** SUMMARY ***
Total pot $19 | Rake $0.86 
Board [7h Ks 8d 3d]
Seat 2: mahalko0925 folded before Flop (didn't bet)
Seat 3: matiko09 collected ($18.14)
Seat 4: er13to folded before Flop (didn't bet)
Seat 5: gabi_igna folded before Flop (didn't bet)
Seat 6: IHouseMusic folded before Flop (didn't bet)
Seat 7: vinniesmol (button) folded before Flop (didn't bet)
Seat 8: Sashey2708 (small blind) folded on the Turn
Seat 9: Venomous100% (big blind) folded before Flop





PokerStars Hand #148833839625:  Hold'em No Limit ($0.50/$1.00 USD) - 2016/02/15 11:33:33 CET [2016/02/15 5:33:33 ET]
Table 'Praecipua' 9-max Seat #6 is the button
Seat 1: er13to ($139 in chips) 
Seat 2: matiko09 ($110.70 in chips) 
Seat 3: Venomous100% ($135.26 in chips) 
Seat 4: gabi_igna ($100 in chips) 
Seat 6: mycka86 ($121.22 in chips) 
Seat 8: Ellis Ng ($29.42 in chips) 
Seat 9: AlKatrone ($100 in chips) 
Ellis Ng: posts small blind $0.50
AlKatrone: posts big blind $1
*** HOLE CARDS ***
Dealt to matiko09 [4s 7s]
er13to: folds 
matiko09: folds 
Venomous100%: folds 
gabi_igna: folds 
mycka86: raises $1.10 to $2.10
Ellis Ng: folds 
AlKatrone: folds 
Uncalled bet ($1.10) returned to mycka86
mycka86 collected $2.50 from pot
*** SUMMARY ***
Total pot $2.50 | Rake $0 
Seat 1: er13to folded before Flop (didn't bet)
Seat 2: matiko09 folded before Flop (didn't bet)
Seat 3: Venomous100% folded before Flop (didn't bet)
Seat 4: gabi_igna folded before Flop (didn't bet)
Seat 6: mycka86 (button) collected ($2.50)
Seat 8: Ellis Ng (small blind) folded before Flop
Seat 9: AlKatrone (big blind) folded before Flop





PokerStars Hand #148833841379:  Hold'em No Limit ($0.50/$1.00 USD) - 2016/02/15 11:33:37 CET [2016/02/15 5:33:37 ET]
Table 'Nata II' 9-max Seat #1 is the button
Seat 1: Priidix ($124.11 in chips) 
Seat 2: qqcom ($107.76 in chips) 
Seat 3: g00000se ($107.95 in chips) 
Seat 4: gabi_igna ($100 in chips) 
Seat 5: AGoodFell4 ($100.26 in chips) 
Seat 6: AlKatrone ($143.83 in chips) 
Seat 7: er13to ($114.15 in chips) 
Seat 8: lumen21 ($108.16 in chips) 
Seat 9: matiko09 ($100 in chips) 
qqcom: posts small blind $0.50
g00000se: posts big blind $1
*** HOLE CARDS ***
Dealt to matiko09 [6s 4h]
gabi_igna: folds 
AGoodFell4 has timed out
AGoodFell4: folds 
AlKatrone: folds 
er13to: folds 
lumen21: folds 
matiko09: folds 
Priidix: raises $1.60 to $2.60
qqcom: raises $6.20 to $8.80
g00000se: folds 
Priidix: calls $6.20
*** FLOP *** [Ks 8c Td]
qqcom: bets $17.76
Priidix: calls $17.76
*** TURN *** [Ks 8c Td] [Js]
qqcom: bets $25.84
Priidix: calls $25.84
*** RIVER *** [Ks 8c Td Js] [4s]
qqcom: checks 
Priidix: checks 
*** SHOW DOWN ***
qqcom: shows [Ac Jd] (a pair of Jacks)
Priidix: shows [3h Kh] (a pair of Kings)
Priidix collected $103 from pot
*** SUMMARY ***
Total pot $105.80 | Rake $2.80 
Board [Ks 8c Td Js 4s]
Seat 1: Priidix (button) showed [3h Kh] and won ($103) with a pair of Kings
Seat 2: qqcom (small blind) showed [Ac Jd] and lost with a pair of Jacks
Seat 3: g00000se (big blind) folded before Flop
Seat 4: gabi_igna folded before Flop (didn't bet)
Seat 5: AGoodFell4 folded before Flop (didn't bet)
Seat 6: AlKatrone folded before Flop (didn't bet)
Seat 7: er13to folded before Flop (didn't bet)
Seat 8: lumen21 folded before Flop (didn't bet)
Seat 9: matiko09 folded before Flop (didn't bet)





PokerStars Hand #148833843665:  Hold'em No Limit ($0.50/$1.00 USD) - 2016/02/15 11:33:42 CET [2016/02/15 5:33:42 ET]
Table 'Oongaq' 9-max Seat #9 is the button
Seat 1: matiko09 ($100 in chips) 
Seat 2: Priidix ($105.07 in chips) 
Seat 3: wilsong96 ($102.58 in chips) 
Seat 5: mn230758 ($25.11 in chips) 
Seat 6: IHouseMusic ($113.96 in chips) 
Seat 7: gwwsb ($64.53 in chips) 
Seat 8: AlKatrone ($106.04 in chips) 
Seat 9: alpw47 ($35.35 in chips) 
matiko09: posts small blind $0.50
Priidix: posts big blind $1
*** HOLE CARDS ***
Dealt to matiko09 [Ad Qc]
wilsong96: calls $1
mn230758: calls $1
IHouseMusic: raises $4 to $5
gwwsb: folds 
AlKatrone: folds 
alpw47: folds 
matiko09: calls $4.50
Priidix: folds 
wilsong96: folds 
mn230758: raises $20.11 to $25.11 and is all-in
IHouseMusic: calls $20.11
matiko09: folds 
*** FLOP *** [Kc 7s Ah]
*** TURN *** [Kc 7s Ah] [9s]
*** RIVER *** [Kc 7s Ah 9s] [Qd]
*** SHOW DOWN ***
mn230758: shows [9c 9h] (three of a kind, Nines)
IHouseMusic: shows [Js Jh] (a pair of Jacks)
mn230758 collected $54.65 from pot
*** SUMMARY ***
Total pot $57.22 | Rake $2.57 
Board [Kc 7s Ah 9s Qd]
Seat 1: matiko09 (small blind) folded before Flop
Seat 2: Priidix (big blind) folded before Flop
Seat 3: wilsong96 folded before Flop
Seat 5: mn230758 showed [9c 9h] and won ($54.65) with three of a kind, Nines
Seat 6: IHouseMusic showed [Js Jh] and lost with a pair of Jacks
Seat 7: gwwsb folded before Flop (didn't bet)
Seat 8: AlKatrone folded before Flop (didn't bet)
Seat 9: alpw47 (button) folded before Flop (didn't bet)





PokerStars Hand #148833845035:  Hold'em No Limit ($0.50/$1.00 USD) - 2016/02/15 11:33:45 CET [2016/02/15 5:33:45 ET]
Table 'Octans II' 9-max Seat #6 is the button
Seat 2: matiko09 ($268.83 in chips) 
Seat 3: Aalleekks ($101.50 in chips) 
Seat 4: Venomous100% ($183.64 in chips) 
Seat 5: Priidix ($188.51 in chips) 
Seat 6: er13to ($100 in chips) 
Seat 7: traficblues ($47.28 in chips) 
Seat 8: IHouseMusic ($125.93 in chips) 
Seat 9: mycka86 ($101.43 in chips) 
traficblues: posts small blind $0.50
IHouseMusic: posts big blind $1
*** HOLE CARDS ***
Dealt to matiko09 [9d Js]
mycka86: raises $2 to $3
matiko09: folds 
Aalleekks: folds 
Venomous100%: folds 
Priidix: folds 
er13to: folds 
traficblues: folds 
IHouseMusic: folds 
Uncalled bet ($2) returned to mycka86
mycka86 collected $2.50 from pot
*** SUMMARY ***
Total pot $2.50 | Rake $0 
Seat 2: matiko09 folded before Flop (didn't bet)
Seat 3: Aalleekks folded before Flop (didn't bet)
Seat 4: Venomous100% folded before Flop (didn't bet)
Seat 5: Priidix folded before Flop (didn't bet)
Seat 6: er13to (button) folded before Flop (didn't bet)
Seat 7: traficblues (small blind) folded before Flop
Seat 8: IHouseMusic (big blind) folded before Flop
Seat 9: mycka86 collected ($2.50)





PokerStars Hand #148833845325:  Hold'em No Limit ($0.25/$0.50 USD) - 2016/02/15 11:33:45 CET [2016/02/15 5:33:45 ET]
Table 'Vesta II' 9-max Seat #2 is the button
Seat 2: ljryviltj ($50.75 in chips) 
Seat 3: matiko09 ($66.78 in chips) 
Seat 4: vlad11122007 ($59.38 in chips) 
Seat 5: dndngod ($143.96 in chips) 
Seat 6: pandalapa ($50 in chips) 
Seat 7: ruyingren ($69.29 in chips) 
Seat 8: Arystan ($35.22 in chips) 
Seat 9: Aoki42 ($96.04 in chips) 
matiko09: posts small blind $0.25
vlad11122007: posts big blind $0.50
lumen21: sits out 
*** HOLE CARDS ***
Dealt to matiko09 [Js 8d]
dndngod: raises $1 to $1.50
pandalapa: folds 
ruyingren: folds 
Arystan: raises $2.50 to $4
Aoki42: folds 
ljryviltj: folds 
matiko09: folds 
vlad11122007: folds 
dndngod: calls $2.50
*** FLOP *** [8s 9h Tc]
dndngod: checks 
Arystan: bets $0.50
dndngod: raises $139.46 to $139.96 and is all-in
Arystan: calls $30.72 and is all-in
Uncalled bet ($108.74) returned to dndngod
*** TURN *** [8s 9h Tc] [Jd]
*** RIVER *** [8s 9h Tc Jd] [7d]
*** SHOW DOWN ***
dndngod: shows [Ad As] (a straight, Seven to Jack)
Arystan: shows [7s Jc] (a straight, Seven to Jack)
dndngod collected $34.35 from pot
Arystan collected $34.34 from pot
*** SUMMARY ***
Total pot $71.19 | Rake $2.50 
Board [8s 9h Tc Jd 7d]
Seat 2: ljryviltj (button) folded before Flop (didn't bet)
Seat 3: matiko09 (small blind) folded before Flop
Seat 4: vlad11122007 (big blind) folded before Flop
Seat 5: dndngod showed [Ad As] and won ($34.35) with a straight, Seven to Jack
Seat 6: pandalapa folded before Flop (didn't bet)
Seat 7: ruyingren folded before Flop (didn't bet)
Seat 8: Arystan showed [7s Jc] and won ($34.34) with a straight, Seven to Jack
Seat 9: Aoki42 folded before Flop (didn't bet)





PokerStars Hand #148833846237:  Hold'em No Limit ($0.50/$1.00 USD) - 2016/02/15 11:33:47 CET [2016/02/15 5:33:47 ET]
Table 'Anteros' 9-max Seat #3 is the button
Seat 1: redacesfull ($108.27 in chips) 
Seat 2: IHouseMusic ($108.41 in chips) 
Seat 3: er13to ($100.47 in chips) 
Seat 4: misherei ($176.34 in chips) 
Seat 5: Holm1991 ($43.25 in chips) 
Seat 6: SerAlGog ($133.15 in chips) 
Seat 7: Zoubou1983 ($193.76 in chips) 
Seat 8: matiko09 ($100 in chips) 
Seat 9: mycka86 ($104.67 in chips) 
misherei: posts small blind $0.50
Holm1991: posts big blind $1
*** HOLE CARDS ***
Dealt to matiko09 [Qh 2h]
SerAlGog: folds 
Zoubou1983: folds 
matiko09: folds 
mycka86: folds 
redacesfull: folds 
IHouseMusic: folds 
er13to: folds 
misherei: calls $0.50
Holm1991: checks 
*** FLOP *** [2s As Qs]
misherei: checks 
Holm1991: checks 
*** TURN *** [2s As Qs] [6c]
misherei: checks 
Holm1991: checks 
*** RIVER *** [2s As Qs 6c] [7d]
misherei: checks 
Holm1991: checks 
*** SHOW DOWN ***
misherei: shows [Qc 8h] (a pair of Queens)
Holm1991: mucks hand 
misherei collected $1.91 from pot
*** SUMMARY ***
Total pot $2 | Rake $0.09 
Board [2s As Qs 6c 7d]
Seat 1: redacesfull folded before Flop (didn't bet)
Seat 2: IHouseMusic folded before Flop (didn't bet)
Seat 3: er13to (button) folded before Flop (didn't bet)
Seat 4: misherei (small blind) showed [Qc 8h] and won ($1.91) with a pair of Queens
Seat 5: Holm1991 (big blind) mucked [8d Td]
Seat 6: SerAlGog folded before Flop (didn't bet)
Seat 7: Zoubou1983 folded before Flop (didn't bet)
Seat 8: matiko09 folded before Flop (didn't bet)
Seat 9: mycka86 folded before Flop (didn't bet)





PokerStars Hand #148833854534:  Hold'em No Limit ($0.50/$1.00 USD) - 2016/02/15 11:34:05 CET [2016/02/15 5:34:05 ET]
Table 'Praecipua' 9-max Seat #8 is the button
Seat 1: er13to ($139 in chips) 
Seat 2: matiko09 ($110.70 in chips) 
Seat 3: Venomous100% ($135.26 in chips) 
Seat 4: gabi_igna ($100 in chips) 
Seat 6: mycka86 ($122.72 in chips) 
Seat 8: Ellis Ng ($28.92 in chips) 
Seat 9: AlKatrone ($100 in chips) 
AlKatrone: posts small blind $0.50
er13to: posts big blind $1
*** HOLE CARDS ***
Dealt to matiko09 [Ah Qc]
matiko09: raises $2 to $3
Venomous100%: folds 
gabi_igna: folds 
mycka86: folds 
Ellis Ng: calls $3
AlKatrone: folds 
er13to: folds 
*** FLOP *** [7c 6h 6c]
matiko09: checks 
Ellis Ng: bets $4
matiko09: calls $4
*** TURN *** [7c 6h 6c] [3d]
matiko09: checks 
Ellis Ng: checks 
*** RIVER *** [7c 6h 6c 3d] [Ks]
matiko09: checks 
di0d80 joins the table at seat #5 
di0d80 leaves the table
Ellis Ng: bets $7
apfush joins the table at seat #5 
matiko09: calls $7
*** SHOW DOWN ***
Ellis Ng: shows [8c 5c] (a pair of Sixes)
matiko09: shows [Ah Qc] (a pair of Sixes - Ace kicker)
matiko09 collected $28.17 from pot
*** SUMMARY ***
Total pot $29.50 | Rake $1.33 
Board [7c 6h 6c 3d Ks]
Seat 1: er13to (big blind) folded before Flop
Seat 2: matiko09 showed [Ah Qc] and won ($28.17) with a pair of Sixes
Seat 3: Venomous100% folded before Flop (didn't bet)
Seat 4: gabi_igna folded before Flop (didn't bet)
Seat 6: mycka86 folded before Flop (didn't bet)
Seat 8: Ellis Ng (button) showed [8c 5c] and lost with a pair of Sixes
Seat 9: AlKatrone (small blind) folded before Flop





PokerStars Hand #148833855157:  Hold'em No Limit ($0.50/$1.00 USD) - 2016/02/15 11:34:06 CET [2016/02/15 5:34:06 ET]
Table 'Euanthe II' 9-max Seat #8 is the button
Seat 2: mahalko0925 ($79.03 in chips) 
Seat 3: matiko09 ($109.14 in chips) 
Seat 4: er13to ($119.68 in chips) 
Seat 5: gabi_igna ($175.40 in chips) 
Seat 6: IHouseMusic ($111.84 in chips) 
Seat 7: vinniesmol ($203.43 in chips) 
Seat 8: Sashey2708 ($31.79 in chips) 
Seat 9: Venomous100% ($131.09 in chips) 
Venomous100%: posts small blind $0.50
mahalko0925: posts big blind $1
*** HOLE CARDS ***
Dealt to matiko09 [3h 8d]
matiko09: folds 
er13to: folds 
gabi_igna: folds 
IHouseMusic: raises $2 to $3
vinniesmol: folds 
Sashey2708: calls $3
Venomous100%: folds 
mahalko0925: calls $2
*** FLOP *** [Tc 6h 5h]
mahalko0925: checks 
IHouseMusic: bets $4.54
Sashey2708: folds 
mahalko0925: folds 
Uncalled bet ($4.54) returned to IHouseMusic
Sashey2708 leaves the table
IHouseMusic collected $9.07 from pot
IHouseMusic: doesn't show hand 
*** SUMMARY ***
Total pot $9.50 | Rake $0.43 
Board [Tc 6h 5h]
Seat 2: mahalko0925 (big blind) folded on the Flop
Seat 3: matiko09 folded before Flop (didn't bet)
Seat 4: er13to folded before Flop (didn't bet)
Seat 5: gabi_igna folded before Flop (didn't bet)
Seat 6: IHouseMusic collected ($9.07)
Seat 7: vinniesmol folded before Flop (didn't bet)
Seat 8: Sashey2708 (button) folded on the Flop
Seat 9: Venomous100% (small blind) folded before Flop





PokerStars Hand #148833857103:  Hold'em No Limit ($0.50/$1.00 USD) - 2016/02/15 11:34:10 CET [2016/02/15 5:34:10 ET]
Table 'Corvus III' 9-max Seat #7 is the button
Seat 1: pk4DW ($145.80 in chips) 
Seat 2: mzsportline ($115.03 in chips) 
Seat 3: VanDobeln ($235.59 in chips) 
Seat 4: goransyruvka ($214.69 in chips) 
Seat 6: Priidix ($100 in chips) 
Seat 7: matiko09 ($290.99 in chips) 
Seat 8: redacesfull ($237.91 in chips) 
Seat 9: er13to ($111.09 in chips) 
redacesfull: posts small blind $0.50
er13to: posts big blind $1
pk4DW: posts the ante $0.20
mzsportline: posts the ante $0.20
VanDobeln: posts the ante $0.20
goransyruvka: posts the ante $0.20
Priidix: posts the ante $0.20
matiko09: posts the ante $0.20
redacesfull: posts the ante $0.20
er13to: posts the ante $0.20
*** HOLE CARDS ***
Dealt to matiko09 [6s Qs]
pk4DW: raises $1.60 to $2.60
mzsportline: raises $5.60 to $8.20
VanDobeln: folds 
goransyruvka: folds 
Priidix: folds 
matiko09: folds 
redacesfull: folds 
er13to: folds 
pk4DW: folds 
Uncalled bet ($5.60) returned to mzsportline
mzsportline collected $8.30 from pot
mzsportline: doesn't show hand 
*** SUMMARY ***
Total pot $8.30 | Rake $0 
Seat 1: pk4DW folded before Flop
Seat 2: mzsportline collected ($8.30)
Seat 3: VanDobeln folded before Flop (didn't bet)
Seat 4: goransyruvka folded before Flop (didn't bet)
Seat 6: Priidix folded before Flop (didn't bet)
Seat 7: matiko09 (button) folded before Flop (didn't bet)
Seat 8: redacesfull (small blind) folded before Flop
Seat 9: er13to (big blind) folded before Flop





PokerStars Hand #148833856880:  Hold'em No Limit ($0.50/$1.00 USD) - 2016/02/15 11:34:10 CET [2016/02/15 5:34:10 ET]
Table 'Octans II' 9-max Seat #7 is the button
Seat 2: matiko09 ($268.83 in chips) 
Seat 3: Aalleekks ($101.50 in chips) 
Seat 4: Venomous100% ($183.64 in chips) 
Seat 5: Priidix ($188.51 in chips) 
Seat 6: er13to ($100 in chips) 
Seat 7: traficblues ($46.78 in chips) 
Seat 8: IHouseMusic ($124.93 in chips) 
Seat 9: mycka86 ($102.93 in chips) 
IHouseMusic: posts small blind $0.50
mycka86: posts big blind $1
*** HOLE CARDS ***
Dealt to matiko09 [5h 9h]
matiko09: folds 
Aalleekks: folds 
Venomous100%: folds 
Priidix: folds 
er13to: folds 
traficblues: calls $1
IHouseMusic: raises $2 to $3
mycka86: folds 
traficblues: calls $2
*** FLOP *** [As 4s 8h]
IHouseMusic: checks 
traficblues: checks 
*** TURN *** [As 4s 8h] [Ks]
IHouseMusic: checks 
traficblues: checks 
*** RIVER *** [As 4s 8h Ks] [5c]
IHouseMusic: bets $4.69
traficblues: calls $4.69
*** SHOW DOWN ***
IHouseMusic: shows [7c 6c] (a straight, Four to Eight)
traficblues: mucks hand 
IHouseMusic collected $15.64 from pot
*** SUMMARY ***
Total pot $16.38 | Rake $0.74 
Board [As 4s 8h Ks 5c]
Seat 2: matiko09 folded before Flop (didn't bet)
Seat 3: Aalleekks folded before Flop (didn't bet)
Seat 4: Venomous100% folded before Flop (didn't bet)
Seat 5: Priidix folded before Flop (didn't bet)
Seat 6: er13to folded before Flop (didn't bet)
Seat 7: traficblues (button) mucked [9c 8c]
Seat 8: IHouseMusic (small blind) showed [7c 6c] and won ($15.64) with a straight, Four to Eight
Seat 9: mycka86 (big blind) folded before Flop





PokerStars Hand #148833864033:  Hold'em No Limit (€0.50/€1.00 EUR) - 2016/02/15 11:34:25 CET [2016/02/15 5:34:25 ET]
Table 'Ganesa II' 9-max Seat #6 is the button
Seat 3: BuBu 0187 (€64.14 in chips) 
Seat 4: Sreshta222 (€122.83 in chips) 
Seat 5: AlKatrone (€108.71 in chips) 
Seat 6: matiko09 (€105.08 in chips) 
Seat 7: er13to (€134.99 in chips) 
Seat 8: mycka86 (€100 in chips) 
Seat 9: Priidix (€171.35 in chips) 
er13to: posts small blind €0.50
mycka86: posts big blind €1
Apparat888: sits out 
*** HOLE CARDS ***
Dealt to matiko09 [As 3c]
Priidix: folds 
BuBu 0187: folds 
Sreshta222: folds 
AlKatrone: raises €1.50 to €2.50
matiko09: folds 
er13to: folds 
mycka86: folds 
Uncalled bet (€1.50) returned to AlKatrone
AlKatrone collected €2.50 from pot
AlKatrone: doesn't show hand 
*** SUMMARY ***
Total pot €2.50 | Rake €0 
Seat 3: BuBu 0187 folded before Flop (didn't bet)
Seat 4: Sreshta222 folded before Flop (didn't bet)
Seat 5: AlKatrone collected (€2.50)
Seat 6: matiko09 (button) folded before Flop (didn't bet)
Seat 7: er13to (small blind) folded before Flop
Seat 8: mycka86 (big blind) folded before Flop
Seat 9: Priidix folded before Flop (didn't bet)





PokerStars Hand #148833864815:  Hold'em No Limit ($0.25/$0.50 USD) - 2016/02/15 11:34:26 CET [2016/02/15 5:34:26 ET]
Table 'Vesta II' 9-max Seat #3 is the button
Seat 2: ljryviltj ($50.75 in chips) 
Seat 3: matiko09 ($66.53 in chips) 
Seat 4: vlad11122007 ($58.88 in chips) 
Seat 5: dndngod ($143.09 in chips) 
Seat 6: pandalapa ($50 in chips) 
Seat 7: ruyingren ($69.29 in chips) 
Seat 8: Arystan ($34.34 in chips) 
Seat 9: Aoki42 ($96.04 in chips) 
vlad11122007: posts small blind $0.25
dndngod: posts big blind $0.50
lumen21: sits out 
*** HOLE CARDS ***
Dealt to matiko09 [Kh Jc]
pandalapa: folds 
ruyingren: folds 
Arystan: raises $1 to $1.50
Aoki42: folds 
ljryviltj: folds 
matiko09: folds 
vlad11122007: folds 
dndngod: folds 
Uncalled bet ($1) returned to Arystan
Arystan collected $1.25 from pot
Arystan: doesn't show hand 
*** SUMMARY ***
Total pot $1.25 | Rake $0 
Seat 2: ljryviltj folded before Flop (didn't bet)
Seat 3: matiko09 (button) folded before Flop (didn't bet)
Seat 4: vlad11122007 (small blind) folded before Flop
Seat 5: dndngod (big blind) folded before Flop
Seat 6: pandalapa folded before Flop (didn't bet)
Seat 7: ruyingren folded before Flop (didn't bet)
Seat 8: Arystan collected ($1.25)
Seat 9: Aoki42 folded before Flop (didn't bet)





PokerStars Hand #148833873631:  Hold'em No Limit ($0.50/$1.00 USD) - 2016/02/15 11:34:45 CET [2016/02/15 5:34:45 ET]
Table 'Corvus III' 9-max Seat #8 is the button
Seat 1: pk4DW ($143 in chips) 
Seat 2: mzsportline ($120.53 in chips) 
Seat 3: VanDobeln ($235.39 in chips) 
Seat 4: goransyruvka ($214.49 in chips) 
Seat 6: Priidix ($211 in chips) 
Seat 7: matiko09 ($290.79 in chips) 
Seat 8: redacesfull ($237.21 in chips) 
Seat 9: er13to ($109.89 in chips) 
er13to: posts small blind $0.50
pk4DW: posts big blind $1
pk4DW: posts the ante $0.20
mzsportline: posts the ante $0.20
VanDobeln: posts the ante $0.20
goransyruvka: posts the ante $0.20
Priidix: posts the ante $0.20
matiko09: posts the ante $0.20
redacesfull: posts the ante $0.20
er13to: posts the ante $0.20
*** HOLE CARDS ***
Dealt to matiko09 [9d 9s]
mzsportline: folds 
VanDobeln: folds 
goransyruvka: folds 
Priidix: raises $1.60 to $2.60
matiko09: calls $2.60
redacesfull: folds 
er13to: folds 
pk4DW: folds 
*** FLOP *** [3h 5c 3d]
Priidix: checks 
matiko09: bets $5.15
Priidix: folds 
Uncalled bet ($5.15) returned to matiko09
matiko09 collected $7.93 from pot
matiko09: doesn't show hand 
*** SUMMARY ***
Total pot $8.30 | Rake $0.37 
Board [3h 5c 3d]
Seat 1: pk4DW (big blind) folded before Flop
Seat 2: mzsportline folded before Flop (didn't bet)
Seat 3: VanDobeln folded before Flop (didn't bet)
Seat 4: goransyruvka folded before Flop (didn't bet)
Seat 6: Priidix folded on the Flop
Seat 7: matiko09 collected ($7.93)
Seat 8: redacesfull (button) folded before Flop (didn't bet)
Seat 9: er13to (small blind) folded before Flop





PokerStars Hand #148833875516:  Hold'em No Limit ($0.50/$1.00 USD) - 2016/02/15 11:34:49 CET [2016/02/15 5:34:49 ET]
Table 'Euanthe II' 9-max Seat #9 is the button
Seat 2: mahalko0925 ($76.03 in chips) 
Seat 3: matiko09 ($109.14 in chips) 
Seat 4: er13to ($119.68 in chips) 
Seat 5: gabi_igna ($175.40 in chips) 
Seat 6: IHouseMusic ($117.91 in chips) 
Seat 7: vinniesmol ($203.43 in chips) 
Seat 9: Venomous100% ($130.59 in chips) 
mahalko0925: posts small blind $0.50
matiko09: posts big blind $1
*** HOLE CARDS ***
Dealt to matiko09 [3d 8h]
AlKatrone joins the table at seat #8 
er13to: raises $2 to $3
gabi_igna: folds 
IHouseMusic: folds 
vinniesmol: folds 
Venomous100%: folds 
mahalko0925: folds 
matiko09: folds 
Uncalled bet ($2) returned to er13to
er13to collected $2.50 from pot
*** SUMMARY ***
Total pot $2.50 | Rake $0 
Seat 2: mahalko0925 (small blind) folded before Flop
Seat 3: matiko09 (big blind) folded before Flop
Seat 4: er13to collected ($2.50)
Seat 5: gabi_igna folded before Flop (didn't bet)
Seat 6: IHouseMusic folded before Flop (didn't bet)
Seat 7: vinniesmol folded before Flop (didn't bet)
Seat 9: Venomous100% (button) folded before Flop (didn't bet)





PokerStars Hand #148833877576:  Hold'em No Limit ($0.50/$1.00 USD) - 2016/02/15 11:34:53 CET [2016/02/15 5:34:53 ET]
Table 'Anteros' 9-max Seat #4 is the button
Seat 1: redacesfull ($108.27 in chips) 
Seat 2: IHouseMusic ($108.41 in chips) 
Seat 3: er13to ($100.47 in chips) 
Seat 4: misherei ($177.25 in chips) 
Seat 5: Holm1991 ($42.25 in chips) 
Seat 6: SerAlGog ($133.15 in chips) 
Seat 7: Zoubou1983 ($193.76 in chips) 
Seat 8: matiko09 ($100 in chips) 
Seat 9: mycka86 ($104.67 in chips) 
Holm1991: posts small blind $0.50
SerAlGog: posts big blind $1
*** HOLE CARDS ***
Dealt to matiko09 [8s Td]
Zoubou1983: folds 
matiko09: folds 
mycka86: folds 
redacesfull: folds 
IHouseMusic: folds 
er13to: folds 
misherei: calls $1
Holm1991: folds 
SerAlGog: checks 
*** FLOP *** [4s 9c Tc]
SerAlGog: checks 
misherei: checks 
*** TURN *** [4s 9c Tc] [7h]
SerAlGog: bets $1.69
misherei: folds 
Uncalled bet ($1.69) returned to SerAlGog
SerAlGog collected $2.39 from pot
SerAlGog: doesn't show hand 
*** SUMMARY ***
Total pot $2.50 | Rake $0.11 
Board [4s 9c Tc 7h]
Seat 1: redacesfull folded before Flop (didn't bet)
Seat 2: IHouseMusic folded before Flop (didn't bet)
Seat 3: er13to folded before Flop (didn't bet)
Seat 4: misherei (button) folded on the Turn
Seat 5: Holm1991 (small blind) folded before Flop
Seat 6: SerAlGog (big blind) collected ($2.39)
Seat 7: Zoubou1983 folded before Flop (didn't bet)
Seat 8: matiko09 folded before Flop (didn't bet)
Seat 9: mycka86 folded before Flop (didn't bet)





PokerStars Hand #148833883109:  Hold'em No Limit (€0.50/€1.00 EUR) - 2016/02/15 11:35:05 CET [2016/02/15 5:35:05 ET]
Table 'Ganesa II' 9-max Seat #7 is the button
Seat 3: BuBu 0187 (€64.14 in chips) 
Seat 4: Sreshta222 (€122.83 in chips) 
Seat 5: AlKatrone (€110.21 in chips) 
Seat 6: matiko09 (€105.08 in chips) 
Seat 7: er13to (€134.49 in chips) 
Seat 8: mycka86 (€100 in chips) 
Seat 9: Priidix (€171.35 in chips) 
mycka86: posts small blind €0.50
Priidix: posts big blind €1
Apparat888: sits out 
*** HOLE CARDS ***
Dealt to matiko09 [5d Ts]
BuBu 0187: folds 
Sreshta222: folds 
AlKatrone: folds 
matiko09: folds 
er13to: raises €1.50 to €2.50
mycka86: raises €6.50 to €9
Priidix: folds 
er13to: calls €6.50
*** FLOP *** [2s 8h 3s]
mycka86: checks 
er13to: checks 
*** TURN *** [2s 8h 3s] [As]
mycka86: bets €10.50
er13to: calls €10.50
*** RIVER *** [2s 8h 3s As] [7d]
mycka86: bets €23.01
er13to: calls €23.01
*** SHOW DOWN ***
mycka86: shows [Qh Ac] (a pair of Aces)
er13to: shows [Ah Qs] (a pair of Aces)
mycka86 collected €41.94 from pot
er13to collected €41.93 from pot
*** SUMMARY ***
Total pot €86.02 | Rake €2.15 
Board [2s 8h 3s As 7d]
Seat 3: BuBu 0187 folded before Flop (didn't bet)
Seat 4: Sreshta222 folded before Flop (didn't bet)
Seat 5: AlKatrone folded before Flop (didn't bet)
Seat 6: matiko09 folded before Flop (didn't bet)
Seat 7: er13to (button) showed [Ah Qs] and won (€41.93) with a pair of Aces
Seat 8: mycka86 (small blind) showed [Qh Ac] and won (€41.94) with a pair of Aces
Seat 9: Priidix (big blind) folded before Flop





PokerStars Hand #148833883540:  Hold'em No Limit ($0.50/$1.00 USD) - 2016/02/15 11:35:06 CET [2016/02/15 5:35:06 ET]
Table 'Oongaq' 9-max Seat #1 is the button
Seat 1: matiko09 ($100 in chips) 
Seat 2: Priidix ($104.07 in chips) 
Seat 3: wilsong96 ($101.58 in chips) 
Seat 5: mn230758 ($54.65 in chips) 
Seat 6: IHouseMusic ($100 in chips) 
Seat 7: gwwsb ($64.53 in chips) 
Seat 8: AlKatrone ($106.04 in chips) 
Seat 9: alpw47 ($35.35 in chips) 
Priidix: posts small blind $0.50
wilsong96: posts big blind $1
*** HOLE CARDS ***
Dealt to matiko09 [6s Jh]
mn230758: folds 
IHouseMusic: raises $2 to $3
gwwsb: folds 
gwwsb said, "surprise"
AlKatrone: folds 
mn230758 said, "yes"
alpw47: folds 
matiko09: folds 
Priidix: folds 
wilsong96: calls $2
*** FLOP *** [8h Kc 9s]
wilsong96: checks 
IHouseMusic: bets $4.36
wilsong96: folds 
Uncalled bet ($4.36) returned to IHouseMusic
IHouseMusic collected $6.21 from pot
IHouseMusic: doesn't show hand 
*** SUMMARY ***
Total pot $6.50 | Rake $0.29 
Board [8h Kc 9s]
Seat 1: matiko09 (button) folded before Flop (didn't bet)
Seat 2: Priidix (small blind) folded before Flop
Seat 3: wilsong96 (big blind) folded on the Flop
Seat 5: mn230758 folded before Flop (didn't bet)
Seat 6: IHouseMusic collected ($6.21)
Seat 7: gwwsb folded before Flop (didn't bet)
Seat 8: AlKatrone folded before Flop (didn't bet)
Seat 9: alpw47 folded before Flop (didn't bet)





PokerStars Hand #148833885316:  Hold'em No Limit ($0.25/$0.50 USD) - 2016/02/15 11:35:09 CET [2016/02/15 5:35:09 ET]
Table 'Vesta II' 9-max Seat #4 is the button
Seat 2: ljryviltj ($50.75 in chips) 
Seat 3: matiko09 ($66.53 in chips) 
Seat 4: vlad11122007 ($58.63 in chips) 
Seat 5: dndngod ($142.59 in chips) 
Seat 6: pandalapa ($50 in chips) 
Seat 7: ruyingren ($69.29 in chips) 
Seat 8: Arystan ($35.09 in chips) 
Seat 9: Aoki42 ($96.04 in chips) 
dndngod: posts small blind $0.25
pandalapa: posts big blind $0.50
lumen21: sits out 
*** HOLE CARDS ***
Dealt to matiko09 [3h 2h]
ruyingren: raises $1 to $1.50
Arystan: raises $1 to $2.50
Aoki42: folds 
ljryviltj: folds 
matiko09: folds 
vlad11122007: folds 
dndngod: folds 
pandalapa: folds 
ruyingren: raises $66.79 to $69.29 and is all-in
Arystan: calls $32.59 and is all-in
Uncalled bet ($34.20) returned to ruyingren
*** FLOP *** [Qd 7c Th]
*** TURN *** [Qd 7c Th] [3c]
*** RIVER *** [Qd 7c Th 3c] [Kh]
*** SHOW DOWN ***
ruyingren: shows [Ad Td] (a pair of Tens)
Arystan: shows [3d Kd] (two pair, Kings and Threes)
Arystan collected $68.43 from pot
*** SUMMARY ***
Total pot $70.93 | Rake $2.50 
Board [Qd 7c Th 3c Kh]
Seat 2: ljryviltj folded before Flop (didn't bet)
Seat 3: matiko09 folded before Flop (didn't bet)
Seat 4: vlad11122007 (button) folded before Flop (didn't bet)
Seat 5: dndngod (small blind) folded before Flop
Seat 6: pandalapa (big blind) folded before Flop
Seat 7: ruyingren showed [Ad Td] and lost with a pair of Tens
Seat 8: Arystan showed [3d Kd] and won ($68.43) with two pair, Kings and Threes
Seat 9: Aoki42 folded before Flop (didn't bet)





PokerStars Hand #148833886939:  Hold'em No Limit ($0.50/$1.00 USD) - 2016/02/15 11:35:13 CET [2016/02/15 5:35:13 ET]
Table 'Kitalpha II' 9-max Seat #8 is the button
Seat 1: IHouseMusic ($100 in chips) 
Seat 2: Charity86 ($82.21 in chips) 
Seat 3: matiko09 ($103 in chips) 
Seat 4: Sreshta222 ($100 in chips) 
Seat 5: apfush ($100 in chips) 
Seat 7: 4Aces4Roses ($86.35 in chips) 
Seat 8: skram2 ($89 in chips) 
Seat 9: Waltz88 ($256.19 in chips) 
Waltz88: posts small blind $0.50
IHouseMusic: posts big blind $1
Congo Sam: sits out 
*** HOLE CARDS ***
Dealt to matiko09 [Jc 8s]
Charity86: folds 
matiko09: folds 
Sreshta222: raises $1.50 to $2.50
apfush: folds 
4Aces4Roses: calls $2.50
skram2: folds 
Waltz88: folds 
IHouseMusic: folds 
*** FLOP *** [2h 8h 3h]
Sreshta222: bets $4.66
4Aces4Roses: calls $4.66
*** TURN *** [2h 8h 3h] [Qh]
Sreshta222: checks 
4Aces4Roses: bets $5
Sreshta222: folds 
Uncalled bet ($5) returned to 4Aces4Roses
4Aces4Roses collected $15.11 from pot
4Aces4Roses: doesn't show hand 
*** SUMMARY ***
Total pot $15.82 | Rake $0.71 
Board [2h 8h 3h Qh]
Seat 1: IHouseMusic (big blind) folded before Flop
Seat 2: Charity86 folded before Flop (didn't bet)
Seat 3: matiko09 folded before Flop (didn't bet)
Seat 4: Sreshta222 folded on the Turn
Seat 5: apfush folded before Flop (didn't bet)
Seat 7: 4Aces4Roses collected ($15.11)
Seat 8: skram2 (button) folded before Flop (didn't bet)
Seat 9: Waltz88 (small blind) folded before Flop





PokerStars Hand #148833887662:  Hold'em No Limit ($0.50/$1.00 USD) - 2016/02/15 11:35:14 CET [2016/02/15 5:35:14 ET]
Table 'Euanthe II' 9-max Seat #2 is the button
Seat 2: mahalko0925 ($75.53 in chips) 
Seat 3: matiko09 ($108.14 in chips) 
Seat 4: er13to ($121.18 in chips) 
Seat 5: gabi_igna ($175.40 in chips) 
Seat 6: IHouseMusic ($117.91 in chips) 
Seat 7: vinniesmol ($203.43 in chips) 
Seat 9: Venomous100% ($130.59 in chips) 
matiko09: posts small blind $0.50
er13to: posts big blind $1
AlKatrone: sits out 
*** HOLE CARDS ***
Dealt to matiko09 [5h 9d]
gabi_igna: folds 
IHouseMusic: folds 
vinniesmol: folds 
Venomous100%: folds 
mahalko0925: raises $1 to $2
matiko09: folds 
er13to: calls $1
*** FLOP *** [6s Ts Tc]
er13to: checks 
mahalko0925: checks 
*** TURN *** [6s Ts Tc] [Qc]
er13to: checks 
mahalko0925: bets $5
er13to: folds 
Uncalled bet ($5) returned to mahalko0925
mahalko0925 collected $4.30 from pot
*** SUMMARY ***
Total pot $4.50 | Rake $0.20 
Board [6s Ts Tc Qc]
Seat 2: mahalko0925 (button) collected ($4.30)
Seat 3: matiko09 (small blind) folded before Flop
Seat 4: er13to (big blind) folded on the Turn
Seat 5: gabi_igna folded before Flop (didn't bet)
Seat 6: IHouseMusic folded before Flop (didn't bet)
Seat 7: vinniesmol folded before Flop (didn't bet)
Seat 9: Venomous100% folded before Flop (didn't bet)





PokerStars Hand #148833887988:  Hold'em No Limit ($0.50/$1.00 USD) - 2016/02/15 11:35:15 CET [2016/02/15 5:35:15 ET]
Table 'Octans II' 9-max Seat #8 is the button
Seat 2: matiko09 ($268.83 in chips) 
Seat 3: Aalleekks ($101.50 in chips) 
Seat 4: Venomous100% ($183.64 in chips) 
Seat 5: Priidix ($188.51 in chips) 
Seat 6: er13to ($100 in chips) 
Seat 7: traficblues ($39.09 in chips) 
Seat 8: IHouseMusic ($132.88 in chips) 
Seat 9: mycka86 ($101.93 in chips) 
mycka86: posts small blind $0.50
matiko09: posts big blind $1
*** HOLE CARDS ***
Dealt to matiko09 [Jd 2d]
Aalleekks: raises $2 to $3
Venomous100%: folds 
Priidix: folds 
er13to: folds 
traficblues: folds 
IHouseMusic: folds 
mycka86: folds 
matiko09: folds 
Uncalled bet ($2) returned to Aalleekks
Aalleekks collected $2.50 from pot
Aalleekks: doesn't show hand 
*** SUMMARY ***
Total pot $2.50 | Rake $0 
Seat 2: matiko09 (big blind) folded before Flop
Seat 3: Aalleekks collected ($2.50)
Seat 4: Venomous100% folded before Flop (didn't bet)
Seat 5: Priidix folded before Flop (didn't bet)
Seat 6: er13to folded before Flop (didn't bet)
Seat 7: traficblues folded before Flop (didn't bet)
Seat 8: IHouseMusic (button) folded before Flop (didn't bet)
Seat 9: mycka86 (small blind) folded before Flop





PokerStars Hand #148833891786:  Hold'em No Limit ($0.50/$1.00 USD) - 2016/02/15 11:35:23 CET [2016/02/15 5:35:23 ET]
Table 'Corvus III' 9-max Seat #9 is the button
Seat 1: pk4DW ($141.80 in chips) 
Seat 2: mzsportline ($120.33 in chips) 
Seat 3: VanDobeln ($235.19 in chips) 
Seat 4: goransyruvka ($214.29 in chips) 
Seat 6: Priidix ($208.20 in chips) 
Seat 7: matiko09 ($295.92 in chips) 
Seat 8: redacesfull ($237.01 in chips) 
Seat 9: er13to ($109.19 in chips) 
pk4DW: posts small blind $0.50
mzsportline: posts big blind $1
pk4DW: posts the ante $0.20
mzsportline: posts the ante $0.20
VanDobeln: posts the ante $0.20
goransyruvka: posts the ante $0.20
Priidix: posts the ante $0.20
matiko09: posts the ante $0.20
redacesfull: posts the ante $0.20
er13to: posts the ante $0.20
*** HOLE CARDS ***
Dealt to matiko09 [Qd Kd]
VanDobeln: folds 
goransyruvka: folds 
Priidix: folds 
matiko09: raises $2 to $3
redacesfull: folds 
er13to: calls $3
pk4DW: calls $2.50
mzsportline: raises $12 to $15
matiko09: folds 
er13to: folds 
pk4DW: calls $12
*** FLOP *** [Ah 8c 7h]
pk4DW: checks 
mzsportline: bets $22
pk4DW: folds 
Uncalled bet ($22) returned to mzsportline
mzsportline collected $35.91 from pot
mzsportline: doesn't show hand 
*** SUMMARY ***
Total pot $37.60 | Rake $1.69 
Board [Ah 8c 7h]
Seat 1: pk4DW (small blind) folded on the Flop
Seat 2: mzsportline (big blind) collected ($35.91)
Seat 3: VanDobeln folded before Flop (didn't bet)
Seat 4: goransyruvka folded before Flop (didn't bet)
Seat 6: Priidix folded before Flop (didn't bet)
Seat 7: matiko09 folded before Flop
Seat 8: redacesfull folded before Flop (didn't bet)
Seat 9: er13to (button) folded before Flop





PokerStars Hand #148833897912:  Hold'em No Limit ($0.50/$1.00 USD) - 2016/02/15 11:35:36 CET [2016/02/15 5:35:36 ET]
Table 'Octans II' 9-max Seat #9 is the button
Seat 2: matiko09 ($267.83 in chips) 
Seat 3: Aalleekks ($103 in chips) 
Seat 4: Venomous100% ($183.64 in chips) 
Seat 5: Priidix ($188.51 in chips) 
Seat 6: er13to ($100 in chips) 
Seat 7: traficblues ($39.09 in chips) 
Seat 8: IHouseMusic ($132.88 in chips) 
Seat 9: mycka86 ($101.43 in chips) 
matiko09: posts small blind $0.50
Aalleekks: posts big blind $1
*** HOLE CARDS ***
Dealt to matiko09 [Js 4h]
Venomous100%: folds 
Priidix: folds 
er13to: raises $1.50 to $2.50
traficblues: folds 
IHouseMusic: raises $5.50 to $8
mycka86: folds 
matiko09: folds 
Aalleekks: folds 
er13to: folds 
Uncalled bet ($5.50) returned to IHouseMusic
IHouseMusic collected $6.50 from pot
IHouseMusic: doesn't show hand 
*** SUMMARY ***
Total pot $6.50 | Rake $0 
Seat 2: matiko09 (small blind) folded before Flop
Seat 3: Aalleekks (big blind) folded before Flop
Seat 4: Venomous100% folded before Flop (didn't bet)
Seat 5: Priidix folded before Flop (didn't bet)
Seat 6: er13to folded before Flop
Seat 7: traficblues folded before Flop (didn't bet)
Seat 8: IHouseMusic collected ($6.50)
Seat 9: mycka86 (button) folded before Flop (didn't bet)





PokerStars Hand #148833899757:  Hold'em No Limit ($0.50/$1.00 USD) - 2016/02/15 11:35:40 CET [2016/02/15 5:35:40 ET]
Table 'Nata II' 9-max Seat #2 is the button
Seat 1: Priidix ($174.71 in chips) 
Seat 2: qqcom ($100 in chips) 
Seat 3: g00000se ($106.95 in chips) 
Seat 4: gabi_igna ($100 in chips) 
Seat 5: AGoodFell4 ($100.26 in chips) 
Seat 6: AlKatrone ($143.83 in chips) 
Seat 7: er13to ($114.15 in chips) 
Seat 8: lumen21 ($108.16 in chips) 
Seat 9: matiko09 ($100 in chips) 
g00000se: posts small blind $0.50
gabi_igna: posts big blind $1
*** HOLE CARDS ***
Dealt to matiko09 [Jh Kc]
AGoodFell4: folds 
AlKatrone: folds 
er13to: folds 
lumen21: folds 
matiko09: raises $2 to $3
Priidix: folds 
qqcom: calls $3
g00000se: folds 
gabi_igna: folds 
*** FLOP *** [Tc 4s Qh]
matiko09: bets $4
qqcom: calls $4
*** TURN *** [Tc 4s Qh] [Ac]
matiko09: bets $11
qqcom: folds 
Uncalled bet ($11) returned to matiko09
matiko09 collected $14.80 from pot
matiko09: doesn't show hand 
*** SUMMARY ***
Total pot $15.50 | Rake $0.70 
Board [Tc 4s Qh Ac]
Seat 1: Priidix folded before Flop (didn't bet)
Seat 2: qqcom (button) folded on the Turn
Seat 3: g00000se (small blind) folded before Flop
Seat 4: gabi_igna (big blind) folded before Flop
Seat 5: AGoodFell4 folded before Flop (didn't bet)
Seat 6: AlKatrone folded before Flop (didn't bet)
Seat 7: er13to folded before Flop (didn't bet)
Seat 8: lumen21 folded before Flop (didn't bet)
Seat 9: matiko09 collected ($14.80)





PokerStars Hand #148833901160:  Hold'em No Limit ($0.50/$1.00 USD) - 2016/02/15 11:35:43 CET [2016/02/15 5:35:43 ET]
Table 'Praecipua' 9-max Seat #9 is the button
Seat 1: er13to ($138 in chips) 
Seat 2: matiko09 ($124.87 in chips) 
Seat 3: Venomous100% ($135.26 in chips) 
Seat 4: gabi_igna ($100 in chips) 
Seat 6: mycka86 ($122.72 in chips) 
Seat 8: Ellis Ng ($14.92 in chips) 
Seat 9: AlKatrone ($100 in chips) 
er13to: posts small blind $0.50
matiko09: posts big blind $1
apfush: sits out 
*** HOLE CARDS ***
Dealt to matiko09 [Td Th]
Venomous100%: raises $2 to $3
gabi_igna: folds 
mycka86: folds 
Ellis Ng: folds 
AlKatrone: folds 
er13to: folds 
matiko09: calls $2
*** FLOP *** [2c 7c 9h]
matiko09: checks 
Venomous100%: bets $4.10
matiko09: calls $4.10
*** TURN *** [2c 7c 9h] [5c]
matiko09: checks 
Venomous100%: checks 
*** RIVER *** [2c 7c 9h 5c] [6s]
matiko09: checks 
Venomous100%: checks 
*** SHOW DOWN ***
matiko09: shows [Td Th] (a pair of Tens)
Venomous100%: mucks hand 
matiko09 collected $14.04 from pot
*** SUMMARY ***
Total pot $14.70 | Rake $0.66 
Board [2c 7c 9h 5c 6s]
Seat 1: er13to (small blind) folded before Flop
Seat 2: matiko09 (big blind) showed [Td Th] and won ($14.04) with a pair of Tens
Seat 3: Venomous100% mucked [Js Ah]
Seat 4: gabi_igna folded before Flop (didn't bet)
Seat 6: mycka86 folded before Flop (didn't bet)
Seat 8: Ellis Ng folded before Flop (didn't bet)
Seat 9: AlKatrone (button) folded before Flop (didn't bet)





PokerStars Hand #148833902759:  Hold'em No Limit ($0.50/$1.00 USD) - 2016/02/15 11:35:46 CET [2016/02/15 5:35:46 ET]
Table 'Urania' 9-max Seat #1 is the button
Seat 1: GRISHANYASHA ($55.30 in chips) 
Seat 3: Priidix ($159.51 in chips) 
Seat 4: matiko09 ($100 in chips) 
Seat 5: maxonplay ($203.31 in chips) 
Seat 6: skaits ($92.50 in chips) 
Seat 7: er13to ($105.90 in chips) 
Seat 8: IHouseMusic ($108.37 in chips) 
Seat 9: mycka86 ($100 in chips) 
Priidix: posts small blind $0.50
matiko09: posts big blind $1
*** HOLE CARDS ***
Dealt to matiko09 [Qc 4h]
maxonplay: folds 
skaits: folds 
er13to: folds 
IHouseMusic: raises $2 to $3
mycka86: folds 
GRISHANYASHA: folds 
Priidix: folds 
matiko09: folds 
Uncalled bet ($2) returned to IHouseMusic
IHouseMusic collected $2.50 from pot
IHouseMusic: doesn't show hand 
*** SUMMARY ***
Total pot $2.50 | Rake $0 
Seat 1: GRISHANYASHA (button) folded before Flop (didn't bet)
Seat 3: Priidix (small blind) folded before Flop
Seat 4: matiko09 (big blind) folded before Flop
Seat 5: maxonplay folded before Flop (didn't bet)
Seat 6: skaits folded before Flop (didn't bet)
Seat 7: er13to folded before Flop (didn't bet)
Seat 8: IHouseMusic collected ($2.50)
Seat 9: mycka86 folded before Flop (didn't bet)





PokerStars Hand #148833908973:  Hold'em No Limit ($0.50/$1.00 USD) - 2016/02/15 11:35:59 CET [2016/02/15 5:35:59 ET]
Table 'Euanthe II' 9-max Seat #3 is the button
Seat 2: mahalko0925 ($77.83 in chips) 
Seat 3: matiko09 ($107.64 in chips) 
Seat 4: er13to ($119.18 in chips) 
Seat 5: gabi_igna ($175.40 in chips) 
Seat 6: IHouseMusic ($117.91 in chips) 
Seat 7: vinniesmol ($203.43 in chips) 
Seat 9: Venomous100% ($130.59 in chips) 
er13to: posts small blind $0.50
gabi_igna: posts big blind $1
AlKatrone: sits out 
*** HOLE CARDS ***
Dealt to matiko09 [9s 4h]
IHouseMusic: folds 
vinniesmol: folds 
Venomous100%: folds 
mahalko0925: raises $1 to $2
matiko09: folds 
er13to: folds 
gabi_igna: calls $1
*** FLOP *** [4d Ks 5h]
gabi_igna: checks 
mahalko0925: checks 
*** TURN *** [4d Ks 5h] [Qs]
gabi_igna: bets $3
mahalko0925: raises $3 to $6
gabi_igna: folds 
Uncalled bet ($3) returned to mahalko0925
mahalko0925 collected $10.03 from pot
*** SUMMARY ***
Total pot $10.50 | Rake $0.47 
Board [4d Ks 5h Qs]
Seat 2: mahalko0925 collected ($10.03)
Seat 3: matiko09 (button) folded before Flop (didn't bet)
Seat 4: er13to (small blind) folded before Flop
Seat 5: gabi_igna (big blind) folded on the Turn
Seat 6: IHouseMusic folded before Flop (didn't bet)
Seat 7: vinniesmol folded before Flop (didn't bet)
Seat 9: Venomous100% folded before Flop (didn't bet)





PokerStars Hand #148833910338:  Hold'em No Limit ($0.50/$1.00 USD) - 2016/02/15 11:36:02 CET [2016/02/15 5:36:02 ET]
Table 'Anteros' 9-max Seat #5 is the button
Seat 1: redacesfull ($108.27 in chips) 
Seat 2: IHouseMusic ($108.41 in chips) 
Seat 3: er13to ($100.47 in chips) 
Seat 4: misherei ($176.25 in chips) 
Seat 5: Holm1991 ($41.75 in chips) 
Seat 6: SerAlGog ($134.54 in chips) 
Seat 7: Zoubou1983 ($193.76 in chips) 
Seat 8: matiko09 ($100 in chips) 
Seat 9: mycka86 ($104.67 in chips) 
SerAlGog: posts small blind $0.50
Zoubou1983: posts big blind $1
*** HOLE CARDS ***
Dealt to matiko09 [7s Kh]
matiko09: folds 
mycka86: folds 
redacesfull: folds 
IHouseMusic: folds 
er13to: raises $1.50 to $2.50
misherei: folds 
Holm1991: folds 
SerAlGog: folds 
Zoubou1983: calls $1.50
*** FLOP *** [2s 6s 6d]
Zoubou1983: checks 
er13to: checks 
*** TURN *** [2s 6s 6d] [Js]
Zoubou1983: bets $3
er13to: folds 
Uncalled bet ($3) returned to Zoubou1983
Zoubou1983 collected $5.25 from pot
Zoubou1983: doesn't show hand 
*** SUMMARY ***
Total pot $5.50 | Rake $0.25 
Board [2s 6s 6d Js]
Seat 1: redacesfull folded before Flop (didn't bet)
Seat 2: IHouseMusic folded before Flop (didn't bet)
Seat 3: er13to folded on the Turn
Seat 4: misherei folded before Flop (didn't bet)
Seat 5: Holm1991 (button) folded before Flop (didn't bet)
Seat 6: SerAlGog (small blind) folded before Flop
Seat 7: Zoubou1983 (big blind) collected ($5.25)
Seat 8: matiko09 folded before Flop (didn't bet)
Seat 9: mycka86 folded before Flop (didn't bet)





PokerStars Hand #148833912350:  Hold'em No Limit ($0.50/$1.00 USD) - 2016/02/15 11:36:06 CET [2016/02/15 5:36:06 ET]
Table 'Urania' 9-max Seat #3 is the button
Seat 1: GRISHANYASHA ($55.30 in chips) 
Seat 3: Priidix ($159.01 in chips) 
Seat 4: matiko09 ($100 in chips) 
Seat 5: maxonplay ($203.31 in chips) 
Seat 6: skaits ($92.50 in chips) 
Seat 7: er13to ($105.90 in chips) 
Seat 8: IHouseMusic ($109.87 in chips) 
Seat 9: mycka86 ($100 in chips) 
matiko09: posts small blind $0.50
maxonplay: posts big blind $1
*** HOLE CARDS ***
Dealt to matiko09 [Ac Td]
skaits: folds 
er13to: folds 
IHouseMusic: folds 
mycka86: folds 
GRISHANYASHA: folds 
Priidix: folds 
matiko09: raises $1.50 to $2.50
maxonplay: calls $1.50
*** FLOP *** [Kh 8h Tc]
matiko09: checks 
maxonplay: bets $4.78
matiko09: calls $4.78
*** TURN *** [Kh 8h Tc] [Kc]
matiko09: checks 
maxonplay: checks 
*** RIVER *** [Kh 8h Tc Kc] [2h]
matiko09: checks 
maxonplay: checks 
*** SHOW DOWN ***
matiko09: shows [Ac Td] (two pair, Kings and Tens)
maxonplay: mucks hand 
matiko09 collected $13.90 from pot
*** SUMMARY ***
Total pot $14.56 | Rake $0.66 
Board [Kh 8h Tc Kc 2h]
Seat 1: GRISHANYASHA folded before Flop (didn't bet)
Seat 3: Priidix (button) folded before Flop (didn't bet)
Seat 4: matiko09 (small blind) showed [Ac Td] and won ($13.90) with two pair, Kings and Tens
Seat 5: maxonplay (big blind) mucked [4s 4h]
Seat 6: skaits folded before Flop (didn't bet)
Seat 7: er13to folded before Flop (didn't bet)
Seat 8: IHouseMusic folded before Flop (didn't bet)
Seat 9: mycka86 folded before Flop (didn't bet)





PokerStars Hand #148833912994:  Hold'em No Limit ($0.50/$1.00 USD) - 2016/02/15 11:36:08 CET [2016/02/15 5:36:08 ET]
Table 'Oongaq' 9-max Seat #2 is the button
Seat 1: matiko09 ($100 in chips) 
Seat 2: Priidix ($103.57 in chips) 
Seat 3: wilsong96 ($98.58 in chips) 
Seat 5: mn230758 ($54.65 in chips) 
Seat 6: IHouseMusic ($103.21 in chips) 
Seat 7: gwwsb ($64.53 in chips) 
Seat 8: AlKatrone ($106.04 in chips) 
Seat 9: alpw47 ($35.35 in chips) 
wilsong96: posts small blind $0.50
mn230758: posts big blind $1
*** HOLE CARDS ***
Dealt to matiko09 [8c Ks]
IHouseMusic: folds 
gwwsb: folds 
AlKatrone: folds 
alpw47: folds 
matiko09: folds 
Priidix: raises $1.60 to $2.60
wilsong96: folds 
mn230758: calls $1.60
*** FLOP *** [4c 4d 4h]
mn230758: checks 
Priidix: bets $3.37
mn230758: folds 
Uncalled bet ($3.37) returned to Priidix
Priidix collected $5.44 from pot
*** SUMMARY ***
Total pot $5.70 | Rake $0.26 
Board [4c 4d 4h]
Seat 1: matiko09 folded before Flop (didn't bet)
Seat 2: Priidix (button) collected ($5.44)
Seat 3: wilsong96 (small blind) folded before Flop
Seat 5: mn230758 (big blind) folded on the Flop
Seat 6: IHouseMusic folded before Flop (didn't bet)
Seat 7: gwwsb folded before Flop (didn't bet)
Seat 8: AlKatrone folded before Flop (didn't bet)
Seat 9: alpw47 folded before Flop (didn't bet)





PokerStars Hand #148833918054:  Hold'em No Limit ($0.50/$1.00 USD) - 2016/02/15 11:36:18 CET [2016/02/15 5:36:18 ET]
Table 'Kitalpha II' 9-max Seat #9 is the button
Seat 1: IHouseMusic ($100 in chips) 
Seat 2: Charity86 ($82.21 in chips) 
Seat 3: matiko09 ($103 in chips) 
Seat 4: Sreshta222 ($100 in chips) 
Seat 5: apfush ($100 in chips) 
Seat 7: 4Aces4Roses ($94.30 in chips) 
Seat 8: skram2 ($89 in chips) 
Seat 9: Waltz88 ($255.69 in chips) 
IHouseMusic: posts small blind $0.50
Charity86: posts big blind $1
Congo Sam: sits out 
*** HOLE CARDS ***
Dealt to matiko09 [Ts Js]
matiko09: raises $2 to $3
Sreshta222: folds 
apfush: folds 
4Aces4Roses: folds 
skram2: calls $3
Waltz88: folds 
IHouseMusic: raises $9 to $12
Charity86: folds 
matiko09: folds 
skram2: calls $9
*** FLOP *** [3c 5c 6c]
IHouseMusic: checks 
skram2: checks 
*** TURN *** [3c 5c 6c] [6s]
IHouseMusic: bets $13.37
skram2: calls $13.37
*** RIVER *** [3c 5c 6c 6s] [Ad]
IHouseMusic: checks 
skram2: checks 
*** SHOW DOWN ***
IHouseMusic: shows [Jh Ah] (two pair, Aces and Sixes)
skram2: shows [Qd Ac] (two pair, Aces and Sixes - Queen kicker)
skram2 collected $52.28 from pot
*** SUMMARY ***
Total pot $54.74 | Rake $2.46 
Board [3c 5c 6c 6s Ad]
Seat 1: IHouseMusic (small blind) showed [Jh Ah] and lost with two pair, Aces and Sixes
Seat 2: Charity86 (big blind) folded before Flop
Seat 3: matiko09 folded before Flop
Seat 4: Sreshta222 folded before Flop (didn't bet)
Seat 5: apfush folded before Flop (didn't bet)
Seat 7: 4Aces4Roses folded before Flop (didn't bet)
Seat 8: skram2 showed [Qd Ac] and won ($52.28) with two pair, Aces and Sixes
Seat 9: Waltz88 (button) folded before Flop (didn't bet)





PokerStars Hand #148833918694:  Hold'em No Limit ($0.25/$0.50 USD) - 2016/02/15 11:36:20 CET [2016/02/15 5:36:20 ET]
Table 'Vesta II' 9-max Seat #6 is the button
Seat 2: ljryviltj ($50.75 in chips) 
Seat 3: matiko09 ($66.53 in chips) 
Seat 4: vlad11122007 ($58.63 in chips) 
Seat 6: pandalapa ($50 in chips) 
Seat 7: ruyingren ($34.20 in chips) 
Seat 8: Arystan ($68.43 in chips) 
Seat 9: Aoki42 ($96.04 in chips) 
ruyingren: posts small blind $0.25
Arystan: posts big blind $0.50
lumen21: sits out 
*** HOLE CARDS ***
Dealt to matiko09 [Ks 2h]
Aoki42: folds 
ljryviltj: raises $1 to $1.50
matiko09: folds 
vlad11122007: folds 
pandalapa: folds 
ruyingren: calls $1.25
dndngod leaves the table
Arystan: calls $1
*** FLOP *** [Js 4s 2d]
ruyingren: bets $4.30
Arystan: calls $4.30
ljryviltj: calls $4.30
*** TURN *** [Js 4s 2d] [Kh]
Serhent joins the table at seat #5 
ruyingren: checks 
Arystan: checks 
ljryviltj: checks 
*** RIVER *** [Js 4s 2d Kh] [7s]
ruyingren: checks 
Arystan: bets $8.31
ljryviltj: folds 
ruyingren: folds 
Uncalled bet ($8.31) returned to Arystan
Arystan collected $16.62 from pot
Arystan: doesn't show hand 
*** SUMMARY ***
Total pot $17.40 | Rake $0.78 
Board [Js 4s 2d Kh 7s]
Seat 2: ljryviltj folded on the River
Seat 3: matiko09 folded before Flop (didn't bet)
Seat 4: vlad11122007 folded before Flop (didn't bet)
Seat 6: pandalapa (button) folded before Flop (didn't bet)
Seat 7: ruyingren (small blind) folded on the River
Seat 8: Arystan (big blind) collected ($16.62)
Seat 9: Aoki42 folded before Flop (didn't bet)





PokerStars Hand #148833921627:  Hold'em No Limit ($0.50/$1.00 USD) - 2016/02/15 11:36:26 CET [2016/02/15 5:36:26 ET]
Table 'Octans II' 9-max Seat #2 is the button
Seat 2: matiko09 ($267.33 in chips) 
Seat 3: Aalleekks ($102 in chips) 
Seat 4: Venomous100% ($183.64 in chips) 
Seat 5: Priidix ($188.51 in chips) 
Seat 6: er13to ($100 in chips) 
Seat 7: traficblues ($39.09 in chips) 
Seat 8: IHouseMusic ($136.88 in chips) 
Seat 9: mycka86 ($101.43 in chips) 
Aalleekks: posts small blind $0.50
Venomous100%: posts big blind $1
*** HOLE CARDS ***
Dealt to matiko09 [6c 6s]
Priidix: raises $2 to $3
er13to: folds 
traficblues: calls $3
IHouseMusic: folds 
mycka86: folds 
matiko09: calls $3
Aalleekks: folds 
Venomous100%: folds 
*** FLOP *** [Ts Kh 4c]
Priidix: checks 
traficblues: checks 
matiko09: checks 
*** TURN *** [Ts Kh 4c] [Ad]
Priidix: bets $8.19
traficblues: folds 
matiko09: folds 
Uncalled bet ($8.19) returned to Priidix
Priidix collected $10.03 from pot
Priidix: doesn't show hand 
*** SUMMARY ***
Total pot $10.50 | Rake $0.47 
Board [Ts Kh 4c Ad]
Seat 2: matiko09 (button) folded on the Turn
Seat 3: Aalleekks (small blind) folded before Flop
Seat 4: Venomous100% (big blind) folded before Flop
Seat 5: Priidix collected ($10.03)
Seat 6: er13to folded before Flop (didn't bet)
Seat 7: traficblues folded on the Turn
Seat 8: IHouseMusic folded before Flop (didn't bet)
Seat 9: mycka86 folded before Flop (didn't bet)





PokerStars Hand #148833924947:  Hold'em No Limit ($0.50/$1.00 USD) - 2016/02/15 11:36:33 CET [2016/02/15 5:36:33 ET]
Table 'Nata II' 9-max Seat #3 is the button
Seat 1: Priidix ($174.71 in chips) 
Seat 2: qqcom ($100 in chips) 
Seat 3: g00000se ($106.45 in chips) 
Seat 4: gabi_igna ($100 in chips) 
Seat 5: AGoodFell4 ($100.26 in chips) 
Seat 6: AlKatrone ($143.83 in chips) 
Seat 7: er13to ($114.15 in chips) 
Seat 8: lumen21 ($108.16 in chips) 
Seat 9: matiko09 ($107.80 in chips) 
gabi_igna: posts small blind $0.50
AGoodFell4: posts big blind $1
*** HOLE CARDS ***
Dealt to matiko09 [9c Qc]
AlKatrone: folds 
er13to: folds 
lumen21: folds 
matiko09: folds 
Priidix: folds 
qqcom: raises $2 to $3
g00000se: calls $3
gabi_igna: folds 
AGoodFell4: calls $2
*** FLOP *** [Ks 8d 7c]
AGoodFell4: checks 
qqcom: bets $9.07
g00000se: folds 
AGoodFell4: folds 
Uncalled bet ($9.07) returned to qqcom
qqcom collected $9.07 from pot
*** SUMMARY ***
Total pot $9.50 | Rake $0.43 
Board [Ks 8d 7c]
Seat 1: Priidix folded before Flop (didn't bet)
Seat 2: qqcom collected ($9.07)
Seat 3: g00000se (button) folded on the Flop
Seat 4: gabi_igna (small blind) folded before Flop
Seat 5: AGoodFell4 (big blind) folded on the Flop
Seat 6: AlKatrone folded before Flop (didn't bet)
Seat 7: er13to folded before Flop (didn't bet)
Seat 8: lumen21 folded before Flop (didn't bet)
Seat 9: matiko09 folded before Flop (didn't bet)





PokerStars Hand #148833931141:  Hold'em No Limit ($0.50/$1.00 USD) - 2016/02/15 11:36:46 CET [2016/02/15 5:36:46 ET]
Table 'Praecipua' 9-max Seat #1 is the button
Seat 1: er13to ($137.50 in chips) 
Seat 2: matiko09 ($131.81 in chips) 
Seat 3: Venomous100% ($128.16 in chips) 
Seat 4: gabi_igna ($100 in chips) 
Seat 6: mycka86 ($122.72 in chips) 
Seat 8: Ellis Ng ($14.92 in chips) 
Seat 9: AlKatrone ($100 in chips) 
matiko09: posts small blind $0.50
Venomous100%: posts big blind $1
apfush: sits out 
*** HOLE CARDS ***
Dealt to matiko09 [3d 4h]
gabi_igna: folds 
mycka86: folds 
Ellis Ng: folds 
AlKatrone: folds 
er13to: raises $1.50 to $2.50
matiko09: folds 
Venomous100%: calls $1.50
*** FLOP *** [Qh 7s 9s]
Venomous100%: checks 
er13to: bets $4.04
Venomous100%: calls $4.04
*** TURN *** [Qh 7s 9s] [6c]
Venomous100%: checks 
er13to: bets $9.98
Venomous100%: calls $9.98
*** RIVER *** [Qh 7s 9s 6c] [Jd]
Venomous100%: checks 
er13to: bets $45.50
Venomous100%: folds 
Uncalled bet ($45.50) returned to er13to
er13to collected $32.03 from pot
*** SUMMARY ***
Total pot $33.54 | Rake $1.51 
Board [Qh 7s 9s 6c Jd]
Seat 1: er13to (button) collected ($32.03)
Seat 2: matiko09 (small blind) folded before Flop
Seat 3: Venomous100% (big blind) folded on the River
Seat 4: gabi_igna folded before Flop (didn't bet)
Seat 6: mycka86 folded before Flop (didn't bet)
Seat 8: Ellis Ng folded before Flop (didn't bet)
Seat 9: AlKatrone folded before Flop (didn't bet)





PokerStars Hand #148833933659:  Hold'em No Limit ($0.50/$1.00 USD) - 2016/02/15 11:36:51 CET [2016/02/15 5:36:51 ET]
Table 'Oongaq' 9-max Seat #3 is the button
Seat 1: matiko09 ($100 in chips) 
Seat 2: Priidix ($106.41 in chips) 
Seat 3: wilsong96 ($98.08 in chips) 
Seat 5: mn230758 ($52.05 in chips) 
Seat 6: IHouseMusic ($103.21 in chips) 
Seat 7: gwwsb ($64.53 in chips) 
Seat 8: AlKatrone ($106.04 in chips) 
Seat 9: alpw47 ($35.35 in chips) 
mn230758: posts small blind $0.50
IHouseMusic: posts big blind $1
*** HOLE CARDS ***
Dealt to matiko09 [As 9s]
gwwsb: calls $1
AlKatrone: folds 
alpw47: calls $1
matiko09: raises $4 to $5
Priidix: folds 
wilsong96: folds 
mn230758: folds 
IHouseMusic: folds 
gwwsb: folds 
alpw47: folds 
Uncalled bet ($4) returned to matiko09
matiko09 collected $4.50 from pot
matiko09: doesn't show hand 
*** SUMMARY ***
Total pot $4.50 | Rake $0 
Seat 1: matiko09 collected ($4.50)
Seat 2: Priidix folded before Flop (didn't bet)
Seat 3: wilsong96 (button) folded before Flop (didn't bet)
Seat 5: mn230758 (small blind) folded before Flop
Seat 6: IHouseMusic (big blind) folded before Flop
Seat 7: gwwsb folded before Flop
Seat 8: AlKatrone folded before Flop (didn't bet)
Seat 9: alpw47 folded before Flop





PokerStars Hand #148833937027:  Hold'em No Limit ($0.50/$1.00 USD) - 2016/02/15 11:36:58 CET [2016/02/15 5:36:58 ET]
Table 'Anteros' 9-max Seat #6 is the button
Seat 1: redacesfull ($108.27 in chips) 
Seat 2: IHouseMusic ($108.41 in chips) 
Seat 3: er13to ($100 in chips) 
Seat 4: misherei ($176.25 in chips) 
Seat 5: Holm1991 ($41.75 in chips) 
Seat 6: SerAlGog ($134.04 in chips) 
Seat 7: Zoubou1983 ($196.51 in chips) 
Seat 8: matiko09 ($100 in chips) 
Seat 9: mycka86 ($104.67 in chips) 
Zoubou1983: posts small blind $0.50
matiko09: posts big blind $1
*** HOLE CARDS ***
Dealt to matiko09 [3h 4c]
mycka86: raises $2 to $3
redacesfull: folds 
IHouseMusic: folds 
er13to: folds 
misherei: folds 
Holm1991: folds 
SerAlGog: raises $6 to $9
Zoubou1983: folds 
matiko09: folds 
mycka86: calls $6
*** FLOP *** [Th 4h 9s]
mycka86: checks 
SerAlGog: bets $9.50
mycka86: calls $9.50
*** TURN *** [Th 4h 9s] [5h]
mycka86: checks 
SerAlGog: bets $18.75
mycka86: folds 
Uncalled bet ($18.75) returned to SerAlGog
SerAlGog collected $36.77 from pot
SerAlGog: doesn't show hand 
*** SUMMARY ***
Total pot $38.50 | Rake $1.73 
Board [Th 4h 9s 5h]
Seat 1: redacesfull folded before Flop (didn't bet)
Seat 2: IHouseMusic folded before Flop (didn't bet)
Seat 3: er13to folded before Flop (didn't bet)
Seat 4: misherei folded before Flop (didn't bet)
Seat 5: Holm1991 folded before Flop (didn't bet)
Seat 6: SerAlGog (button) collected ($36.77)
Seat 7: Zoubou1983 (small blind) folded before Flop
Seat 8: matiko09 (big blind) folded before Flop
Seat 9: mycka86 folded on the Turn





PokerStars Hand #148833942321:  Hold'em No Limit ($0.50/$1.00 USD) - 2016/02/15 11:37:10 CET [2016/02/15 5:37:10 ET]
Table 'Urania' 9-max Seat #4 is the button
Seat 1: GRISHANYASHA ($55.30 in chips) 
Seat 3: Priidix ($159.01 in chips) 
Seat 4: matiko09 ($106.62 in chips) 
Seat 5: maxonplay ($196.03 in chips) 
Seat 6: skaits ($92.50 in chips) 
Seat 7: er13to ($105.90 in chips) 
Seat 8: IHouseMusic ($109.87 in chips) 
Seat 9: mycka86 ($100 in chips) 
maxonplay: posts small blind $0.50
skaits: posts big blind $1
*** HOLE CARDS ***
Dealt to matiko09 [Ah 2c]
er13to: folds 
IHouseMusic: folds 
mycka86: raises $2 to $3
GRISHANYASHA: folds 
Priidix: folds 
matiko09: folds 
maxonplay: folds 
skaits: folds 
Uncalled bet ($2) returned to mycka86
mycka86 collected $2.50 from pot
*** SUMMARY ***
Total pot $2.50 | Rake $0 
Seat 1: GRISHANYASHA folded before Flop (didn't bet)
Seat 3: Priidix folded before Flop (didn't bet)
Seat 4: matiko09 (button) folded before Flop (didn't bet)
Seat 5: maxonplay (small blind) folded before Flop
Seat 6: skaits (big blind) folded before Flop
Seat 7: er13to folded before Flop (didn't bet)
Seat 8: IHouseMusic folded before Flop (didn't bet)
Seat 9: mycka86 collected ($2.50)





PokerStars Hand #148833943409:  Hold'em No Limit ($0.50/$1.00 USD) - 2016/02/15 11:37:12 CET [2016/02/15 5:37:12 ET]
Table 'Octans II' 9-max Seat #3 is the button
Seat 2: matiko09 ($264.33 in chips) 
Seat 3: Aalleekks ($101.50 in chips) 
Seat 4: Venomous100% ($182.64 in chips) 
Seat 6: er13to ($100 in chips) 
Seat 7: traficblues ($36.09 in chips) 
Seat 8: IHouseMusic ($136.88 in chips) 
Seat 9: mycka86 ($101.43 in chips) 
Venomous100%: posts small blind $0.50
Priidix: is sitting out 
er13to: posts big blind $1
*** HOLE CARDS ***
Dealt to matiko09 [Js Ah]
Priidix leaves the table
traficblues: calls $1
IHouseMusic: folds 
gabi_igna joins the table at seat #5 
mycka86: folds 
matiko09: raises $3 to $4
Aalleekks: folds 
Venomous100%: folds 
er13to: folds 
traficblues: calls $3
*** FLOP *** [5d 5s Ac]
traficblues: checks 
matiko09: checks 
*** TURN *** [5d 5s Ac] [4d]
traficblues: bets $4.53
matiko09: calls $4.53
*** RIVER *** [5d 5s Ac 4d] [Kd]
traficblues: bets $10
matiko09: calls $10
*** SHOW DOWN ***
traficblues: shows [Ad Tc] (two pair, Aces and Fives)
matiko09: shows [Js Ah] (two pair, Aces and Fives)
traficblues collected $18.41 from pot
matiko09 collected $18.41 from pot
*** SUMMARY ***
Total pot $38.56 | Rake $1.74 
Board [5d 5s Ac 4d Kd]
Seat 2: matiko09 showed [Js Ah] and won ($18.41) with two pair, Aces and Fives
Seat 3: Aalleekks (button) folded before Flop (didn't bet)
Seat 4: Venomous100% (small blind) folded before Flop
Seat 6: er13to (big blind) folded before Flop
Seat 7: traficblues showed [Ad Tc] and won ($18.41) with two pair, Aces and Fives
Seat 8: IHouseMusic folded before Flop (didn't bet)
Seat 9: mycka86 folded before Flop (didn't bet)





PokerStars Hand #148833946186:  Hold'em No Limit ($0.50/$1.00 USD) - 2016/02/15 11:37:18 CET [2016/02/15 5:37:18 ET]
Table 'Corvus III' 9-max Seat #1 is the button
Seat 1: pk4DW ($126.60 in chips) 
Seat 2: mzsportline ($141.04 in chips) 
Seat 3: VanDobeln ($234.99 in chips) 
Seat 4: goransyruvka ($214.09 in chips) 
Seat 6: Priidix ($208 in chips) 
Seat 7: matiko09 ($292.72 in chips) 
Seat 8: redacesfull ($236.81 in chips) 
Seat 9: er13to ($105.99 in chips) 
mzsportline: posts small blind $0.50
VanDobeln: posts big blind $1
pk4DW: posts the ante $0.20
mzsportline: posts the ante $0.20
VanDobeln: posts the ante $0.20
goransyruvka: posts the ante $0.20
Priidix: posts the ante $0.20
matiko09: posts the ante $0.20
redacesfull: posts the ante $0.20
er13to: posts the ante $0.20
*** HOLE CARDS ***
Dealt to matiko09 [6d 2d]
goransyruvka: folds 
Priidix: folds 
matiko09: folds 
redacesfull: folds 
er13to: folds 
pk4DW: calls $1
mzsportline: raises $4 to $5
VanDobeln: folds 
pk4DW: folds 
Uncalled bet ($4) returned to mzsportline
mzsportline collected $4.60 from pot
mzsportline: doesn't show hand 
*** SUMMARY ***
Total pot $4.60 | Rake $0 
Seat 1: pk4DW (button) folded before Flop
Seat 2: mzsportline (small blind) collected ($4.60)
Seat 3: VanDobeln (big blind) folded before Flop
Seat 4: goransyruvka folded before Flop (didn't bet)
Seat 6: Priidix folded before Flop (didn't bet)
Seat 7: matiko09 folded before Flop (didn't bet)
Seat 8: redacesfull folded before Flop (didn't bet)
Seat 9: er13to folded before Flop (didn't bet)





PokerStars Hand #148833948933:  Hold'em No Limit (€0.50/€1.00 EUR) - 2016/02/15 11:37:24 CET [2016/02/15 5:37:24 ET]
Table 'Ganesa II' 9-max Seat #8 is the button
Seat 1: Apparat888 (€46 in chips) 
Seat 3: BuBu 0187 (€64.14 in chips) 
Seat 4: Sreshta222 (€122.83 in chips) 
Seat 5: AlKatrone (€110.21 in chips) 
Seat 6: matiko09 (€105.08 in chips) 
Seat 7: er13to (€133.91 in chips) 
Seat 8: mycka86 (€100 in chips) 
Seat 9: Priidix (€170.35 in chips) 
Priidix: posts small blind €0.50
Apparat888: posts big blind €1
*** HOLE CARDS ***
Dealt to matiko09 [Kc 6h]
BuBu 0187: calls €1
Sreshta222: calls €1
AlKatrone: folds 
matiko09: folds 
er13to: folds 
mycka86: folds 
Priidix: folds 
Apparat888: raises €3 to €4
maxxmeister leaves the table
Venomous100% joins the table at seat #2 
BuBu 0187 has timed out
BuBu 0187: folds 
Sreshta222: calls €3
*** FLOP *** [Ts 6s 2h]
Apparat888: bets €6
Sreshta222: folds 
Uncalled bet (€6) returned to Apparat888
Apparat888 collected €9.07 from pot
*** SUMMARY ***
Total pot €9.50 | Rake €0.43 
Board [Ts 6s 2h]
Seat 1: Apparat888 (big blind) collected (€9.07)
Seat 3: BuBu 0187 folded before Flop
Seat 4: Sreshta222 folded on the Flop
Seat 5: AlKatrone folded before Flop (didn't bet)
Seat 6: matiko09 folded before Flop (didn't bet)
Seat 7: er13to folded before Flop (didn't bet)
Seat 8: mycka86 (button) folded before Flop (didn't bet)
Seat 9: Priidix (small blind) folded before Flop





PokerStars Hand #148833950554:  Hold'em No Limit ($0.50/$1.00 USD) - 2016/02/15 11:37:27 CET [2016/02/15 5:37:27 ET]
Table 'Euanthe II' 9-max Seat #4 is the button
Seat 2: mahalko0925 ($82.86 in chips) 
Seat 3: matiko09 ($107.64 in chips) 
Seat 4: er13to ($118.68 in chips) 
Seat 5: gabi_igna ($170.40 in chips) 
Seat 6: IHouseMusic ($117.91 in chips) 
Seat 7: vinniesmol ($203.43 in chips) 
Seat 9: Venomous100% ($130.59 in chips) 
gabi_igna: posts small blind $0.50
IHouseMusic: posts big blind $1
AlKatrone: sits out 
*** HOLE CARDS ***
Dealt to matiko09 [2h Ad]
vinniesmol: folds 
Venomous100%: raises $2 to $3
mahalko0925: folds 
matiko09: folds 
er13to: folds 
gabi_igna: folds 
IHouseMusic: folds 
Uncalled bet ($2) returned to Venomous100%
Venomous100% collected $2.50 from pot
Venomous100%: doesn't show hand 
*** SUMMARY ***
Total pot $2.50 | Rake $0 
Seat 2: mahalko0925 folded before Flop (didn't bet)
Seat 3: matiko09 folded before Flop (didn't bet)
Seat 4: er13to (button) folded before Flop (didn't bet)
Seat 5: gabi_igna (small blind) folded before Flop
Seat 6: IHouseMusic (big blind) folded before Flop
Seat 7: vinniesmol folded before Flop (didn't bet)
Seat 9: Venomous100% collected ($2.50)





PokerStars Hand #148833950705:  Hold'em No Limit ($0.50/$1.00 USD) - 2016/02/15 11:37:27 CET [2016/02/15 5:37:27 ET]
Table 'Nata II' 9-max Seat #4 is the button
Seat 1: Priidix ($174.71 in chips) 
Seat 2: qqcom ($106.07 in chips) 
Seat 3: g00000se ($103.45 in chips) 
Seat 4: gabi_igna ($100 in chips) 
Seat 5: AGoodFell4 ($97.26 in chips) 
Seat 6: AlKatrone ($143.83 in chips) 
Seat 7: er13to ($114.15 in chips) 
Seat 8: lumen21 ($108.16 in chips) 
Seat 9: matiko09 ($107.80 in chips) 
AGoodFell4: posts small blind $0.50
AlKatrone: posts big blind $1
*** HOLE CARDS ***
Dealt to matiko09 [4h 7c]
er13to: folds 
lumen21: folds 
matiko09: folds 
Priidix: folds 
qqcom: folds 
g00000se: folds 
gabi_igna: raises $1.50 to $2.50
AGoodFell4: calls $2
AlKatrone: calls $1.50
*** FLOP *** [2s Qd 6h]
AGoodFell4: checks 
AlKatrone: checks 
gabi_igna: bets $5
AGoodFell4: raises $7.50 to $12.50
AlKatrone: folds 
gabi_igna: calls $7.50
*** TURN *** [2s Qd 6h] [Ts]
AGoodFell4: checks 
gabi_igna: checks 
*** RIVER *** [2s Qd 6h Ts] [7s]
AGoodFell4: checks 
gabi_igna: bets $23
AGoodFell4: calls $23
*** SHOW DOWN ***
gabi_igna: shows [Ah Qh] (a pair of Queens)
AGoodFell4: mucks hand 
gabi_igna collected $75.70 from pot
*** SUMMARY ***
Total pot $78.50 | Rake $2.80 
Board [2s Qd 6h Ts 7s]
Seat 1: Priidix folded before Flop (didn't bet)
Seat 2: qqcom folded before Flop (didn't bet)
Seat 3: g00000se folded before Flop (didn't bet)
Seat 4: gabi_igna (button) showed [Ah Qh] and won ($75.70) with a pair of Queens
Seat 5: AGoodFell4 (small blind) mucked [9d Qs]
Seat 6: AlKatrone (big blind) folded on the Flop
Seat 7: er13to folded before Flop (didn't bet)
Seat 8: lumen21 folded before Flop (didn't bet)
Seat 9: matiko09 folded before Flop (didn't bet)





PokerStars Hand #148833952553:  Hold'em No Limit ($0.50/$1.00 USD) - 2016/02/15 11:37:31 CET [2016/02/15 5:37:31 ET]
Table 'Urania' 9-max Seat #5 is the button
Seat 1: GRISHANYASHA ($55.30 in chips) 
Seat 3: Priidix ($159.01 in chips) 
Seat 4: matiko09 ($106.62 in chips) 
Seat 5: maxonplay ($195.53 in chips) 
Seat 6: skaits ($91.50 in chips) 
Seat 7: er13to ($105.90 in chips) 
Seat 8: IHouseMusic ($109.87 in chips) 
Seat 9: mycka86 ($101.50 in chips) 
skaits: posts small blind $0.50
er13to: posts big blind $1
*** HOLE CARDS ***
Dealt to matiko09 [4h 2h]
IHouseMusic: folds 
mycka86: folds 
GRISHANYASHA: raises $2 to $3
Priidix: folds 
matiko09: folds 
maxonplay: folds 
skaits: folds 
er13to: folds 
Uncalled bet ($2) returned to GRISHANYASHA
GRISHANYASHA collected $2.50 from pot
*** SUMMARY ***
Total pot $2.50 | Rake $0 
Seat 1: GRISHANYASHA collected ($2.50)
Seat 3: Priidix folded before Flop (didn't bet)
Seat 4: matiko09 folded before Flop (didn't bet)
Seat 5: maxonplay (button) folded before Flop (didn't bet)
Seat 6: skaits (small blind) folded before Flop
Seat 7: er13to (big blind) folded before Flop
Seat 8: IHouseMusic folded before Flop (didn't bet)
Seat 9: mycka86 folded before Flop (didn't bet)





PokerStars Hand #148833959029:  Hold'em No Limit ($0.50/$1.00 USD) - 2016/02/15 11:37:45 CET [2016/02/15 5:37:45 ET]
Table 'Oongaq' 9-max Seat #5 is the button
Seat 1: matiko09 ($103.50 in chips) 
Seat 2: Priidix ($106.41 in chips) 
Seat 3: wilsong96 ($98.08 in chips) 
Seat 5: mn230758 ($51.55 in chips) 
Seat 6: IHouseMusic ($102.21 in chips) 
Seat 7: gwwsb ($63.53 in chips) 
Seat 8: AlKatrone ($106.04 in chips) 
Seat 9: alpw47 ($34.35 in chips) 
IHouseMusic: posts small blind $0.50
gwwsb: posts big blind $1
*** HOLE CARDS ***
Dealt to matiko09 [9c 8d]
AlKatrone: folds 
alpw47: folds 
matiko09: folds 
Priidix: raises $1.60 to $2.60
wilsong96: folds 
mn230758: folds 
IHouseMusic: folds 
gwwsb: folds 
Uncalled bet ($1.60) returned to Priidix
Priidix collected $2.50 from pot
Priidix: doesn't show hand 
*** SUMMARY ***
Total pot $2.50 | Rake $0 
Seat 1: matiko09 folded before Flop (didn't bet)
Seat 2: Priidix collected ($2.50)
Seat 3: wilsong96 folded before Flop (didn't bet)
Seat 5: mn230758 (button) folded before Flop (didn't bet)
Seat 6: IHouseMusic (small blind) folded before Flop
Seat 7: gwwsb (big blind) folded before Flop
Seat 8: AlKatrone folded before Flop (didn't bet)
Seat 9: alpw47 folded before Flop (didn't bet)





PokerStars Hand #148833959776:  Hold'em No Limit ($0.50/$1.00 USD) - 2016/02/15 11:37:46 CET [2016/02/15 5:37:46 ET]
Table 'Kitalpha II' 9-max Seat #1 is the button
Seat 1: IHouseMusic ($100 in chips) 
Seat 2: Charity86 ($81.21 in chips) 
Seat 3: matiko09 ($100 in chips) 
Seat 4: Sreshta222 ($100 in chips) 
Seat 5: apfush ($100 in chips) 
Seat 7: 4Aces4Roses ($94.30 in chips) 
Seat 8: skram2 ($115.91 in chips) 
Seat 9: Waltz88 ($255.69 in chips) 
Charity86: posts small blind $0.50
matiko09: posts big blind $1
Congo Sam: sits out 
*** HOLE CARDS ***
Dealt to matiko09 [As 8d]
Sreshta222: folds 
apfush: folds 
4Aces4Roses: raises $3 to $4
skram2: folds 
Waltz88: calls $4
IHouseMusic: folds 
Charity86: folds 
matiko09: folds 
*** FLOP *** [5s Ts 6s]
4Aces4Roses: bets $5
Waltz88: calls $5
*** TURN *** [5s Ts 6s] [Jc]
4Aces4Roses: bets $8
Waltz88: folds 
Uncalled bet ($8) returned to 4Aces4Roses
4Aces4Roses collected $18.62 from pot
4Aces4Roses: doesn't show hand 
*** SUMMARY ***
Total pot $19.50 | Rake $0.88 
Board [5s Ts 6s Jc]
Seat 1: IHouseMusic (button) folded before Flop (didn't bet)
Seat 2: Charity86 (small blind) folded before Flop
Seat 3: matiko09 (big blind) folded before Flop
Seat 4: Sreshta222 folded before Flop (didn't bet)
Seat 5: apfush folded before Flop (didn't bet)
Seat 7: 4Aces4Roses collected ($18.62)
Seat 8: skram2 folded before Flop (didn't bet)
Seat 9: Waltz88 folded on the Turn





PokerStars Hand #148833960340:  Hold'em No Limit ($0.50/$1.00 USD) - 2016/02/15 11:37:48 CET [2016/02/15 5:37:48 ET]
Table 'Euanthe II' 9-max Seat #5 is the button
Seat 2: mahalko0925 ($82.86 in chips) 
Seat 3: matiko09 ($107.64 in chips) 
Seat 4: er13to ($118.68 in chips) 
Seat 5: gabi_igna ($169.90 in chips) 
Seat 6: IHouseMusic ($116.91 in chips) 
Seat 7: vinniesmol ($203.43 in chips) 
Seat 9: Venomous100% ($132.09 in chips) 
IHouseMusic: posts small blind $0.50
vinniesmol: posts big blind $1
AlKatrone: sits out 
*** HOLE CARDS ***
Dealt to matiko09 [5s 4d]
Venomous100%: folds 
mahalko0925: raises $1 to $2
matiko09: folds 
er13to: folds 
gabi_igna: raises $5.50 to $7.50
IHouseMusic: folds 
vinniesmol: folds 
mahalko0925: calls $5.50
*** FLOP *** [4s Kd 9h]
mahalko0925: checks 
gabi_igna: bets $10
mahalko0925: folds 
Uncalled bet ($10) returned to gabi_igna
gabi_igna collected $15.76 from pot
gabi_igna: doesn't show hand 
*** SUMMARY ***
Total pot $16.50 | Rake $0.74 
Board [4s Kd 9h]
Seat 2: mahalko0925 folded on the Flop
Seat 3: matiko09 folded before Flop (didn't bet)
Seat 4: er13to folded before Flop (didn't bet)
Seat 5: gabi_igna (button) collected ($15.76)
Seat 6: IHouseMusic (small blind) folded before Flop
Seat 7: vinniesmol (big blind) folded before Flop
Seat 9: Venomous100% folded before Flop (didn't bet)





PokerStars Hand #148833961447:  Hold'em No Limit ($0.25/$0.50 USD) - 2016/02/15 11:37:50 CET [2016/02/15 5:37:50 ET]
Table 'Vesta II' 9-max Seat #7 is the button
Seat 2: ljryviltj ($50 in chips) 
Seat 3: matiko09 ($66.53 in chips) 
Seat 4: vlad11122007 ($58.63 in chips) 
Seat 6: pandalapa ($50 in chips) 
Seat 7: ruyingren ($28.40 in chips) 
Seat 8: Arystan ($79.25 in chips) 
Seat 9: Aoki42 ($96.04 in chips) 
Arystan: posts small blind $0.25
Aoki42: posts big blind $0.50
lumen21: sits out 
Serhent: sits out 
*** HOLE CARDS ***
Dealt to matiko09 [9c 4h]
ljryviltj: raises $1 to $1.50
matiko09: folds 
vlad11122007: folds 
pandalapa: folds 
ruyingren: folds 
Arystan: folds 
Aoki42: folds 
Uncalled bet ($1) returned to ljryviltj
ljryviltj collected $1.25 from pot
ljryviltj: doesn't show hand 
*** SUMMARY ***
Total pot $1.25 | Rake $0 
Seat 2: ljryviltj collected ($1.25)
Seat 3: matiko09 folded before Flop (didn't bet)
Seat 4: vlad11122007 folded before Flop (didn't bet)
Seat 6: pandalapa folded before Flop (didn't bet)
Seat 7: ruyingren (button) folded before Flop (didn't bet)
Seat 8: Arystan (small blind) folded before Flop
Seat 9: Aoki42 (big blind) folded before Flop





PokerStars Hand #148833965088:  Hold'em No Limit ($0.50/$1.00 USD) - 2016/02/15 11:37:58 CET [2016/02/15 5:37:58 ET]
Table 'Corvus III' 9-max Seat #2 is the button
Seat 1: pk4DW ($125.40 in chips) 
Seat 2: mzsportline ($144.44 in chips) 
Seat 3: VanDobeln ($233.79 in chips) 
Seat 4: goransyruvka ($213.89 in chips) 
Seat 6: Priidix ($207.80 in chips) 
Seat 7: matiko09 ($292.52 in chips) 
Seat 8: redacesfull ($236.61 in chips) 
Seat 9: er13to ($105.79 in chips) 
VanDobeln: posts small blind $0.50
goransyruvka: posts big blind $1
pk4DW: posts the ante $0.20
mzsportline: posts the ante $0.20
VanDobeln: posts the ante $0.20
goransyruvka: posts the ante $0.20
Priidix: posts the ante $0.20
matiko09: posts the ante $0.20
redacesfull: posts the ante $0.20
er13to: posts the ante $0.20
*** HOLE CARDS ***
Dealt to matiko09 [Ts 7d]
Priidix: folds 
matiko09: folds 
redacesfull: folds 
er13to: folds 
pk4DW: folds 
mzsportline: raises $2 to $3
VanDobeln: folds 
goransyruvka: folds 
Uncalled bet ($2) returned to mzsportline
mzsportline collected $4.10 from pot
mzsportline: doesn't show hand 
*** SUMMARY ***
Total pot $4.10 | Rake $0 
Seat 1: pk4DW folded before Flop (didn't bet)
Seat 2: mzsportline (button) collected ($4.10)
Seat 3: VanDobeln (small blind) folded before Flop
Seat 4: goransyruvka (big blind) folded before Flop
Seat 6: Priidix folded before Flop (didn't bet)
Seat 7: matiko09 folded before Flop (didn't bet)
Seat 8: redacesfull folded before Flop (didn't bet)
Seat 9: er13to folded before Flop (didn't bet)





PokerStars Hand #148833965775:  Hold'em No Limit ($0.50/$1.00 USD) - 2016/02/15 11:37:59 CET [2016/02/15 5:37:59 ET]
Table 'Urania' 9-max Seat #6 is the button
Seat 1: GRISHANYASHA ($56.80 in chips) 
Seat 3: Priidix ($159.01 in chips) 
Seat 4: matiko09 ($106.62 in chips) 
Seat 5: maxonplay ($195.53 in chips) 
Seat 6: skaits ($91 in chips) 
Seat 7: er13to ($104.90 in chips) 
Seat 8: IHouseMusic ($109.87 in chips) 
Seat 9: mycka86 ($101.50 in chips) 
er13to: posts small blind $0.50
IHouseMusic: posts big blind $1
*** HOLE CARDS ***
Dealt to matiko09 [8h 5s]
mycka86: folds 
GRISHANYASHA: folds 
Priidix: folds 
matiko09: folds 
maxonplay: folds 
skaits: folds 
er13to: folds 
Uncalled bet ($0.50) returned to IHouseMusic
IHouseMusic collected $1 from pot
IHouseMusic: doesn't show hand 
*** SUMMARY ***
Total pot $1 | Rake $0 
Seat 1: GRISHANYASHA folded before Flop (didn't bet)
Seat 3: Priidix folded before Flop (didn't bet)
Seat 4: matiko09 folded before Flop (didn't bet)
Seat 5: maxonplay folded before Flop (didn't bet)
Seat 6: skaits (button) folded before Flop (didn't bet)
Seat 7: er13to (small blind) folded before Flop
Seat 8: IHouseMusic (big blind) collected ($1)
Seat 9: mycka86 folded before Flop (didn't bet)





PokerStars Hand #148833972356:  Hold'em No Limit ($0.50/$1.00 USD) - 2016/02/15 11:38:13 CET [2016/02/15 5:38:13 ET]
Table 'Octans II' 9-max Seat #4 is the button
Seat 2: matiko09 ($264.21 in chips) 
Seat 3: Aalleekks ($101.50 in chips) 
Seat 4: Venomous100% ($182.14 in chips) 
Seat 6: er13to ($100 in chips) 
Seat 7: traficblues ($35.97 in chips) 
Seat 8: IHouseMusic ($136.88 in chips) 
Seat 9: mycka86 ($101.43 in chips) 
gabi_igna will be allowed to play after the button
er13to: posts small blind $0.50
traficblues: posts big blind $1
*** HOLE CARDS ***
Dealt to matiko09 [6s Td]
IHouseMusic: folds 
mycka86: folds 
matiko09: folds 
Aalleekks: folds 
Venomous100%: folds 
er13to: folds 
Uncalled bet ($0.50) returned to traficblues
traficblues collected $1 from pot
traficblues: doesn't show hand 
*** SUMMARY ***
Total pot $1 | Rake $0 
Seat 2: matiko09 folded before Flop (didn't bet)
Seat 3: Aalleekks folded before Flop (didn't bet)
Seat 4: Venomous100% (button) folded before Flop (didn't bet)
Seat 6: er13to (small blind) folded before Flop
Seat 7: traficblues (big blind) collected ($1)
Seat 8: IHouseMusic folded before Flop (didn't bet)
Seat 9: mycka86 folded before Flop (didn't bet)





PokerStars Hand #148833972513:  Hold'em No Limit ($0.50/$1.00 USD) - 2016/02/15 11:38:13 CET [2016/02/15 5:38:13 ET]
Table 'Oongaq' 9-max Seat #6 is the button
Seat 1: matiko09 ($103.50 in chips) 
Seat 2: Priidix ($107.91 in chips) 
Seat 3: wilsong96 ($98.08 in chips) 
Seat 5: mn230758 ($51.55 in chips) 
Seat 6: IHouseMusic ($101.71 in chips) 
Seat 7: gwwsb ($62.53 in chips) 
Seat 8: AlKatrone ($106.04 in chips) 
Seat 9: alpw47 ($34.35 in chips) 
gwwsb: posts small blind $0.50
AlKatrone: posts big blind $1
*** HOLE CARDS ***
Dealt to matiko09 [4c 2s]
alpw47: calls $1
matiko09: folds 
Priidix: folds 
wilsong96: folds 
mn230758: raises $2 to $3
IHouseMusic: folds 
gwwsb: folds 
AlKatrone: folds 
alpw47: calls $2
*** FLOP *** [6c 9c 5s]
alpw47: checks 
mn230758: bets $6
alpw47: raises $6 to $12
mn230758: calls $6
*** TURN *** [6c 9c 5s] [Td]
alpw47: bets $5
mn230758: calls $5
*** RIVER *** [6c 9c 5s Td] [6d]
alpw47: bets $5
mn230758: calls $5
*** SHOW DOWN ***
alpw47: shows [Ad 9h] (two pair, Nines and Sixes)
mn230758: shows [9d As] (two pair, Nines and Sixes)
alpw47 collected $24.59 from pot
mn230758 collected $24.59 from pot
*** SUMMARY ***
Total pot $51.50 | Rake $2.32 
Board [6c 9c 5s Td 6d]
Seat 1: matiko09 folded before Flop (didn't bet)
Seat 2: Priidix folded before Flop (didn't bet)
Seat 3: wilsong96 folded before Flop (didn't bet)
Seat 5: mn230758 showed [9d As] and won ($24.59) with two pair, Nines and Sixes
Seat 6: IHouseMusic (button) folded before Flop (didn't bet)
Seat 7: gwwsb (small blind) folded before Flop
Seat 8: AlKatrone (big blind) folded before Flop
Seat 9: alpw47 showed [Ad 9h] and won ($24.59) with two pair, Nines and Sixes





PokerStars Hand #148833973593:  Hold'em No Limit ($0.25/$0.50 USD) - 2016/02/15 11:38:15 CET [2016/02/15 5:38:15 ET]
Table 'Vesta II' 9-max Seat #8 is the button
Seat 1: lumen21 ($50 in chips) 
Seat 2: ljryviltj ($50.75 in chips) 
Seat 3: matiko09 ($66.53 in chips) 
Seat 4: vlad11122007 ($58.63 in chips) 
Seat 6: pandalapa ($50 in chips) 
Seat 7: ruyingren ($28.40 in chips) 
Seat 8: Arystan ($79 in chips) 
Seat 9: Aoki42 ($95.54 in chips) 
Aoki42: posts small blind $0.25
lumen21: posts big blind $0.50
Serhent: sits out 
*** HOLE CARDS ***
Dealt to matiko09 [9c Qs]
ljryviltj: folds 
matiko09: folds 
vlad11122007: raises $1 to $1.50
pandalapa: folds 
ruyingren: calls $1.50
Arystan: calls $1.50
Aoki42: calls $1.25
lumen21: folds 
*** FLOP *** [2h 4c Qc]
Aoki42: checks 
vlad11122007: checks 
ruyingren: bets $3.10
Arystan: folds 
Aoki42: folds 
vlad11122007: calls $3.10
*** TURN *** [2h 4c Qc] [5d]
vlad11122007: checks 
ruyingren: bets $23.80 and is all-in
vlad11122007: folds 
Uncalled bet ($23.80) returned to ruyingren
ruyingren collected $12.13 from pot
ruyingren: doesn't show hand 
*** SUMMARY ***
Total pot $12.70 | Rake $0.57 
Board [2h 4c Qc 5d]
Seat 1: lumen21 (big blind) folded before Flop
Seat 2: ljryviltj folded before Flop (didn't bet)
Seat 3: matiko09 folded before Flop (didn't bet)
Seat 4: vlad11122007 folded on the Turn
Seat 6: pandalapa folded before Flop (didn't bet)
Seat 7: ruyingren collected ($12.13)
Seat 8: Arystan (button) folded on the Flop
Seat 9: Aoki42 (small blind) folded on the Flop





PokerStars Hand #148833975768:  Hold'em No Limit ($0.50/$1.00 USD) - 2016/02/15 11:38:20 CET [2016/02/15 5:38:20 ET]
Table 'Urania' 9-max Seat #7 is the button
Seat 1: GRISHANYASHA ($56.80 in chips) 
Seat 3: Priidix ($159.01 in chips) 
Seat 4: matiko09 ($106.62 in chips) 
Seat 5: maxonplay ($195.53 in chips) 
Seat 6: skaits ($91 in chips) 
Seat 7: er13to ($104.40 in chips) 
Seat 8: IHouseMusic ($110.37 in chips) 
Seat 9: mycka86 ($101.50 in chips) 
IHouseMusic: posts small blind $0.50
mycka86: posts big blind $1
maxxmeister: sits out 
*** HOLE CARDS ***
Dealt to matiko09 [As Th]
GRISHANYASHA: folds 
Priidix: folds 
matiko09: folds 
maxonplay: raises $3 to $4
skaits: folds 
er13to: folds 
IHouseMusic: folds 
mycka86: calls $3
*** FLOP *** [8h 4d Tc]
mycka86: checks 
maxonplay: checks 
*** TURN *** [8h 4d Tc] [2s]
mycka86: bets $5.80
maxonplay: folds 
Uncalled bet ($5.80) returned to mycka86
mycka86 collected $8.12 from pot
*** SUMMARY ***
Total pot $8.50 | Rake $0.38 
Board [8h 4d Tc 2s]
Seat 1: GRISHANYASHA folded before Flop (didn't bet)
Seat 3: Priidix folded before Flop (didn't bet)
Seat 4: matiko09 folded before Flop (didn't bet)
Seat 5: maxonplay folded on the Turn
Seat 6: skaits folded before Flop (didn't bet)
Seat 7: er13to (button) folded before Flop (didn't bet)
Seat 8: IHouseMusic (small blind) folded before Flop
Seat 9: mycka86 (big blind) collected ($8.12)





PokerStars Hand #148833977279:  Hold'em No Limit ($0.50/$1.00 USD) - 2016/02/15 11:38:23 CET [2016/02/15 5:38:23 ET]
Table 'Corvus III' 9-max Seat #3 is the button
Seat 1: pk4DW ($125.20 in chips) 
Seat 2: mzsportline ($147.34 in chips) 
Seat 3: VanDobeln ($233.09 in chips) 
Seat 4: goransyruvka ($212.69 in chips) 
Seat 5: maxxmeister ($255.32 in chips) 
Seat 6: Priidix ($207.60 in chips) 
Seat 7: matiko09 ($292.32 in chips) 
Seat 8: redacesfull ($236.41 in chips) 
Seat 9: er13to ($105.59 in chips) 
goransyruvka: posts small blind $0.50
maxxmeister: posts big blind $1
pk4DW: posts the ante $0.20
mzsportline: posts the ante $0.20
VanDobeln: posts the ante $0.20
goransyruvka: posts the ante $0.20
maxxmeister: posts the ante $0.20
Priidix: posts the ante $0.20
matiko09: posts the ante $0.20
redacesfull: posts the ante $0.20
er13to: posts the ante $0.20
*** HOLE CARDS ***
Dealt to matiko09 [6h 7s]
Priidix: folds 
matiko09: folds 
redacesfull: folds 
er13to: folds 
pk4DW: calls $1
mzsportline: folds 
VanDobeln: folds 
goransyruvka: calls $0.50
maxxmeister: checks 
*** FLOP *** [8h 5d Ks]
goransyruvka: checks 
maxxmeister: checks 
pk4DW: checks 
*** TURN *** [8h 5d Ks] [Qh]
goransyruvka: bets $1
maxxmeister: folds 
pk4DW: calls $1
*** RIVER *** [8h 5d Ks Qh] [2h]
goransyruvka: bets $1
pk4DW: raises $5 to $6
goransyruvka: folds 
Uncalled bet ($5) returned to pk4DW
pk4DW collected $8.40 from pot
pk4DW: doesn't show hand 
*** SUMMARY ***
Total pot $8.80 | Rake $0.40 
Board [8h 5d Ks Qh 2h]
Seat 1: pk4DW collected ($8.40)
Seat 2: mzsportline folded before Flop (didn't bet)
Seat 3: VanDobeln (button) folded before Flop (didn't bet)
Seat 4: goransyruvka (small blind) folded on the River
Seat 5: maxxmeister (big blind) folded on the Turn
Seat 6: Priidix folded before Flop (didn't bet)
Seat 7: matiko09 folded before Flop (didn't bet)
Seat 8: redacesfull folded before Flop (didn't bet)
Seat 9: er13to folded before Flop (didn't bet)





PokerStars Hand #148833977621:  Hold'em No Limit ($0.50/$1.00 USD) - 2016/02/15 11:38:24 CET [2016/02/15 5:38:24 ET]
Table 'Praecipua' 9-max Seat #2 is the button
Seat 1: er13to ($153.01 in chips) 
Seat 2: matiko09 ($131.31 in chips) 
Seat 3: Venomous100% ($111.64 in chips) 
Seat 4: gabi_igna ($100 in chips) 
Seat 6: mycka86 ($122.72 in chips) 
Seat 8: Ellis Ng ($14.92 in chips) 
Seat 9: AlKatrone ($100 in chips) 
Venomous100%: posts small blind $0.50
gabi_igna: posts big blind $1
apfush: sits out 
maxxmeister: sits out 
*** HOLE CARDS ***
Dealt to matiko09 [4d 5h]
mycka86: folds 
Ellis Ng: raises $2 to $3
AlKatrone: folds 
er13to: folds 
matiko09: folds 
Venomous100%: folds 
gabi_igna: folds 
Uncalled bet ($2) returned to Ellis Ng
Ellis Ng collected $2.50 from pot
Ellis Ng: doesn't show hand 
*** SUMMARY ***
Total pot $2.50 | Rake $0 
Seat 1: er13to folded before Flop (didn't bet)
Seat 2: matiko09 (button) folded before Flop (didn't bet)
Seat 3: Venomous100% (small blind) folded before Flop
Seat 4: gabi_igna (big blind) folded before Flop
Seat 6: mycka86 folded before Flop (didn't bet)
Seat 8: Ellis Ng collected ($2.50)
Seat 9: AlKatrone folded before Flop (didn't bet)





PokerStars Hand #148833978122:  Hold'em No Limit ($0.50/$1.00 USD) - 2016/02/15 11:38:25 CET [2016/02/15 5:38:25 ET]
Table 'Euanthe II' 9-max Seat #6 is the button
Seat 2: mahalko0925 ($75.36 in chips) 
Seat 3: matiko09 ($107.64 in chips) 
Seat 4: er13to ($118.68 in chips) 
Seat 5: gabi_igna ($178.16 in chips) 
Seat 6: IHouseMusic ($116.41 in chips) 
Seat 7: vinniesmol ($202.43 in chips) 
Seat 8: AlKatrone ($100 in chips) 
Seat 9: Venomous100% ($132.09 in chips) 
vinniesmol: posts small blind $0.50
AlKatrone: posts big blind $1
maxxmeister: sits out 
*** HOLE CARDS ***
Dealt to matiko09 [6d 3c]
Venomous100%: folds 
mahalko0925: raises $1 to $2
matiko09: folds 
er13to: folds 
gabi_igna: raises $6 to $8
IHouseMusic: folds 
vinniesmol: folds 
AlKatrone: folds 
mahalko0925: folds 
Uncalled bet ($6) returned to gabi_igna
gabi_igna collected $5.50 from pot
gabi_igna: doesn't show hand 
*** SUMMARY ***
Total pot $5.50 | Rake $0 
Seat 2: mahalko0925 folded before Flop
Seat 3: matiko09 folded before Flop (didn't bet)
Seat 4: er13to folded before Flop (didn't bet)
Seat 5: gabi_igna collected ($5.50)
Seat 6: IHouseMusic (button) folded before Flop (didn't bet)
Seat 7: vinniesmol (small blind) folded before Flop
Seat 8: AlKatrone (big blind) folded before Flop
Seat 9: Venomous100% folded before Flop (didn't bet)





PokerStars Hand #148833980570:  Hold'em No Limit ($0.50/$1.00 USD) - 2016/02/15 11:38:30 CET [2016/02/15 5:38:30 ET]
Table 'Kitalpha II' 9-max Seat #2 is the button
Seat 1: IHouseMusic ($100 in chips) 
Seat 2: Charity86 ($80.71 in chips) 
Seat 3: matiko09 ($100 in chips) 
Seat 4: Sreshta222 ($100 in chips) 
Seat 5: apfush ($100 in chips) 
Seat 7: 4Aces4Roses ($103.92 in chips) 
Seat 8: skram2 ($115.91 in chips) 
Seat 9: Waltz88 ($246.69 in chips) 
matiko09: posts small blind $0.50
Sreshta222: posts big blind $1
Congo Sam: sits out 
*** HOLE CARDS ***
Dealt to matiko09 [Ac 9h]
apfush: folds 
4Aces4Roses: calls $1
skram2: folds 
Waltz88: folds 
IHouseMusic: folds 
Charity86: folds 
matiko09: calls $0.50
Charity86 leaves the table
Aalleekks joins the table at seat #2 
Sreshta222: checks 
*** FLOP *** [Ad 8d 6d]
matiko09: bets $1.86
Sreshta222: folds 
4Aces4Roses: folds 
Uncalled bet ($1.86) returned to matiko09
matiko09 collected $2.86 from pot
matiko09: doesn't show hand 
*** SUMMARY ***
Total pot $3 | Rake $0.14 
Board [Ad 8d 6d]
Seat 1: IHouseMusic folded before Flop (didn't bet)
Seat 2: Charity86 (button) folded before Flop (didn't bet)
Seat 3: matiko09 (small blind) collected ($2.86)
Seat 4: Sreshta222 (big blind) folded on the Flop
Seat 5: apfush folded before Flop (didn't bet)
Seat 7: 4Aces4Roses folded on the Flop
Seat 8: skram2 folded before Flop (didn't bet)
Seat 9: Waltz88 folded before Flop (didn't bet)





PokerStars Hand #148833982677:  Hold'em No Limit ($0.50/$1.00 USD) - 2016/02/15 11:38:35 CET [2016/02/15 5:38:35 ET]
Table 'Octans II' 9-max Seat #6 is the button
Seat 2: matiko09 ($264.21 in chips) 
Seat 3: Aalleekks ($101.50 in chips) 
Seat 4: Venomous100% ($182.14 in chips) 
Seat 6: er13to ($100 in chips) 
Seat 7: traficblues ($36.47 in chips) 
Seat 8: IHouseMusic ($136.88 in chips) 
Seat 9: mycka86 ($101.43 in chips) 
traficblues: posts small blind $0.50
IHouseMusic: posts big blind $1
maxxmeister: sits out 
gabi_igna: sits out 
*** HOLE CARDS ***
Dealt to matiko09 [Kh 7h]
mycka86: raises $2 to $3
matiko09: folds 
Aalleekks: folds 
Venomous100%: folds 
er13to: folds 
traficblues: folds 
IHouseMusic: folds 
Uncalled bet ($2) returned to mycka86
mycka86 collected $2.50 from pot
*** SUMMARY ***
Total pot $2.50 | Rake $0 
Seat 2: matiko09 folded before Flop (didn't bet)
Seat 3: Aalleekks folded before Flop (didn't bet)
Seat 4: Venomous100% folded before Flop (didn't bet)
Seat 6: er13to (button) folded before Flop (didn't bet)
Seat 7: traficblues (small blind) folded before Flop
Seat 8: IHouseMusic (big blind) folded before Flop
Seat 9: mycka86 collected ($2.50)





PokerStars Hand #148833989802:  Hold'em No Limit ($0.50/$1.00 USD) - 2016/02/15 11:38:50 CET [2016/02/15 5:38:50 ET]
Table 'Euanthe II' 9-max Seat #7 is the button
Seat 2: mahalko0925 ($73.36 in chips) 
Seat 3: matiko09 ($107.64 in chips) 
Seat 4: er13to ($118.68 in chips) 
Seat 5: gabi_igna ($181.66 in chips) 
Seat 6: IHouseMusic ($116.41 in chips) 
Seat 7: vinniesmol ($201.93 in chips) 
Seat 8: AlKatrone ($100 in chips) 
Seat 9: Venomous100% ($132.09 in chips) 
AlKatrone: posts small blind $0.50
Venomous100%: posts big blind $1
maxxmeister: sits out 
*** HOLE CARDS ***
Dealt to matiko09 [As 8c]
mahalko0925: folds 
matiko09: folds 
er13to: folds 
gabi_igna: raises $2 to $3
IHouseMusic: raises $6 to $9
vinniesmol: folds 
AlKatrone: folds 
Venomous100%: folds 
gabi_igna: folds 
Uncalled bet ($6) returned to IHouseMusic
IHouseMusic collected $7.50 from pot
IHouseMusic: doesn't show hand 
*** SUMMARY ***
Total pot $7.50 | Rake $0 
Seat 2: mahalko0925 folded before Flop (didn't bet)
Seat 3: matiko09 folded before Flop (didn't bet)
Seat 4: er13to folded before Flop (didn't bet)
Seat 5: gabi_igna folded before Flop
Seat 6: IHouseMusic collected ($7.50)
Seat 7: vinniesmol (button) folded before Flop (didn't bet)
Seat 8: AlKatrone (small blind) folded before Flop
Seat 9: Venomous100% (big blind) folded before Flop





PokerStars Hand #148833991640:  Hold'em No Limit ($0.50/$1.00 USD) - 2016/02/15 11:38:53 CET [2016/02/15 5:38:53 ET]
Table 'Anteros' 9-max Seat #7 is the button
Seat 1: redacesfull ($108.27 in chips) 
Seat 2: IHouseMusic ($108.41 in chips) 
Seat 3: er13to ($100 in chips) 
Seat 4: misherei ($176.25 in chips) 
Seat 5: Holm1991 ($41.75 in chips) 
Seat 6: SerAlGog ($152.31 in chips) 
Seat 7: Zoubou1983 ($196.01 in chips) 
Seat 8: matiko09 ($100 in chips) 
Seat 9: mycka86 ($100 in chips) 
matiko09: posts small blind $0.50
mycka86: posts big blind $1
*** HOLE CARDS ***
Dealt to matiko09 [Js Tc]
redacesfull: folds 
IHouseMusic: folds 
er13to: folds 
misherei: folds 
Holm1991: folds 
SerAlGog: folds 
Zoubou1983: calls $1
matiko09: calls $0.50
mycka86: checks 
*** FLOP *** [Ac Kh 6h]
matiko09: checks 
mycka86: checks 
Zoubou1983: checks 
*** TURN *** [Ac Kh 6h] [2d]
matiko09: checks 
mycka86: checks 
Zoubou1983: bets $2
matiko09: folds 
mycka86: folds 
Uncalled bet ($2) returned to Zoubou1983
Zoubou1983 collected $2.86 from pot
Zoubou1983: doesn't show hand 
*** SUMMARY ***
Total pot $3 | Rake $0.14 
Board [Ac Kh 6h 2d]
Seat 1: redacesfull folded before Flop (didn't bet)
Seat 2: IHouseMusic folded before Flop (didn't bet)
Seat 3: er13to folded before Flop (didn't bet)
Seat 4: misherei folded before Flop (didn't bet)
Seat 5: Holm1991 folded before Flop (didn't bet)
Seat 6: SerAlGog folded before Flop (didn't bet)
Seat 7: Zoubou1983 (button) collected ($2.86)
Seat 8: matiko09 (small blind) folded on the Turn
Seat 9: mycka86 (big blind) folded on the Turn





PokerStars Hand #148833992957:  Hold'em No Limit ($0.50/$1.00 USD) - 2016/02/15 11:38:56 CET [2016/02/15 5:38:56 ET]
Table 'Praecipua' 9-max Seat #3 is the button
Seat 1: er13to ($153.01 in chips) 
Seat 2: matiko09 ($131.31 in chips) 
Seat 3: Venomous100% ($111.14 in chips) 
Seat 4: gabi_igna ($100 in chips) 
Seat 5: apfush ($100 in chips) 
Seat 6: mycka86 ($122.72 in chips) 
Seat 8: Ellis Ng ($16.42 in chips) 
Seat 9: AlKatrone ($100 in chips) 
gabi_igna: posts small blind $0.50
apfush: posts big blind $1
maxxmeister: sits out 
*** HOLE CARDS ***
Dealt to matiko09 [Js 6c]
mycka86: folds 
Ellis Ng: folds 
AlKatrone: folds 
er13to: folds 
matiko09: folds 
Venomous100%: folds 
gabi_igna: raises $2 to $3
apfush: folds 
Uncalled bet ($2) returned to gabi_igna
gabi_igna collected $2 from pot
gabi_igna: doesn't show hand 
*** SUMMARY ***
Total pot $2 | Rake $0 
Seat 1: er13to folded before Flop (didn't bet)
Seat 2: matiko09 folded before Flop (didn't bet)
Seat 3: Venomous100% (button) folded before Flop (didn't bet)
Seat 4: gabi_igna (small blind) collected ($2)
Seat 5: apfush (big blind) folded before Flop
Seat 6: mycka86 folded before Flop (didn't bet)
Seat 8: Ellis Ng folded before Flop (didn't bet)
Seat 9: AlKatrone folded before Flop (didn't bet)





PokerStars Hand #148833993021:  Hold'em No Limit ($0.50/$1.00 USD) - 2016/02/15 11:38:56 CET [2016/02/15 5:38:56 ET]
Table 'Urania' 9-max Seat #8 is the button
Seat 1: GRISHANYASHA ($56.80 in chips) 
Seat 3: Priidix ($159.01 in chips) 
Seat 4: matiko09 ($106.62 in chips) 
Seat 5: maxonplay ($191.53 in chips) 
Seat 6: skaits ($91 in chips) 
Seat 7: er13to ($104.40 in chips) 
Seat 8: IHouseMusic ($109.87 in chips) 
Seat 9: mycka86 ($105.62 in chips) 
mycka86: posts small blind $0.50
GRISHANYASHA: posts big blind $1
maxxmeister: sits out 
*** HOLE CARDS ***
Dealt to matiko09 [7c 2h]
Priidix: folds 
matiko09: folds 
maxonplay: folds 
skaits: folds 
er13to: folds 
IHouseMusic: raises $1 to $2
mycka86: folds 
GRISHANYASHA: raises $4.50 to $6.50
IHouseMusic: calls $4.50
*** FLOP *** [Jh Ah 9s]
GRISHANYASHA: bets $6.70
IHouseMusic: folds 
Uncalled bet ($6.70) returned to GRISHANYASHA
GRISHANYASHA collected $12.89 from pot
*** SUMMARY ***
Total pot $13.50 | Rake $0.61 
Board [Jh Ah 9s]
Seat 1: GRISHANYASHA (big blind) collected ($12.89)
Seat 3: Priidix folded before Flop (didn't bet)
Seat 4: matiko09 folded before Flop (didn't bet)
Seat 5: maxonplay folded before Flop (didn't bet)
Seat 6: skaits folded before Flop (didn't bet)
Seat 7: er13to folded before Flop (didn't bet)
Seat 8: IHouseMusic (button) folded on the Flop
Seat 9: mycka86 (small blind) folded before Flop





PokerStars Hand #148834000100:  Hold'em No Limit (€0.50/€1.00 EUR) - 2016/02/15 11:39:11 CET [2016/02/15 5:39:11 ET]
Table 'Ganesa II' 9-max Seat #9 is the button
Seat 1: Apparat888 (€51.07 in chips) 
Seat 2: Venomous100% (€100 in chips) 
Seat 4: Sreshta222 (€118.83 in chips) 
Seat 5: AlKatrone (€110.21 in chips) 
Seat 6: matiko09 (€105.08 in chips) 
Seat 7: er13to (€133.91 in chips) 
Seat 8: mycka86 (€100 in chips) 
Seat 9: Priidix (€169.85 in chips) 
Apparat888: posts small blind €0.50
Venomous100%: posts big blind €1
*** HOLE CARDS ***
Dealt to matiko09 [7s 5s]
Sreshta222: raises €1.50 to €2.50
AlKatrone: folds 
matiko09: folds 
er13to: folds 
mycka86: folds 
Priidix: folds 
Apparat888: folds 
Venomous100%: folds 
Uncalled bet (€1.50) returned to Sreshta222
Sreshta222 collected €2.50 from pot
Sreshta222: doesn't show hand 
*** SUMMARY ***
Total pot €2.50 | Rake €0 
Seat 1: Apparat888 (small blind) folded before Flop
Seat 2: Venomous100% (big blind) folded before Flop
Seat 4: Sreshta222 collected (€2.50)
Seat 5: AlKatrone folded before Flop (didn't bet)
Seat 6: matiko09 folded before Flop (didn't bet)
Seat 7: er13to folded before Flop (didn't bet)
Seat 8: mycka86 folded before Flop (didn't bet)
Seat 9: Priidix (button) folded before Flop (didn't bet)





PokerStars Hand #148833999904:  Hold'em No Limit ($0.50/$1.00 USD) - 2016/02/15 11:39:11 CET [2016/02/15 5:39:11 ET]
Table 'Octans II' 9-max Seat #7 is the button
Seat 2: matiko09 ($264.21 in chips) 
Seat 3: Aalleekks ($101.50 in chips) 
Seat 4: Venomous100% ($182.14 in chips) 
Seat 6: er13to ($100 in chips) 
Seat 7: traficblues ($35.97 in chips) 
Seat 8: IHouseMusic ($135.88 in chips) 
Seat 9: mycka86 ($102.93 in chips) 
IHouseMusic: posts small blind $0.50
mycka86: posts big blind $1
maxxmeister: sits out 
gabi_igna: sits out 
*** HOLE CARDS ***
Dealt to matiko09 [2c 2s]
matiko09: folds 
Aalleekks: folds 
Venomous100%: folds 
er13to: raises $1.50 to $2.50
traficblues: folds 
IHouseMusic: folds 
mycka86: folds 
Uncalled bet ($1.50) returned to er13to
er13to collected $2.50 from pot
*** SUMMARY ***
Total pot $2.50 | Rake $0 
Seat 2: matiko09 folded before Flop (didn't bet)
Seat 3: Aalleekks folded before Flop (didn't bet)
Seat 4: Venomous100% folded before Flop (didn't bet)
Seat 6: er13to collected ($2.50)
Seat 7: traficblues (button) folded before Flop (didn't bet)
Seat 8: IHouseMusic (small blind) folded before Flop
Seat 9: mycka86 (big blind) folded before Flop





PokerStars Hand #148834000956:  Hold'em No Limit ($0.50/$1.00 USD) - 2016/02/15 11:39:13 CET [2016/02/15 5:39:13 ET]
Table 'Kitalpha II' 9-max Seat #3 is the button
Seat 1: IHouseMusic ($100 in chips) 
Seat 3: matiko09 ($101.86 in chips) 
Seat 4: Sreshta222 ($100 in chips) 
Seat 5: apfush ($100 in chips) 
Seat 7: 4Aces4Roses ($102.92 in chips) 
Seat 8: skram2 ($115.91 in chips) 
Seat 9: Waltz88 ($246.69 in chips) 
Sreshta222: posts small blind $0.50
apfush: posts big blind $1
Congo Sam: sits out 
Aalleekks: sits out 
*** HOLE CARDS ***
Dealt to matiko09 [7c 2d]
4Aces4Roses: folds 
skram2: folds 
Waltz88 has timed out
Waltz88: folds 
IHouseMusic: folds 
matiko09: folds 
Sreshta222: folds 
Uncalled bet ($0.50) returned to apfush
apfush collected $1 from pot
apfush: doesn't show hand 
*** SUMMARY ***
Total pot $1 | Rake $0 
Seat 1: IHouseMusic folded before Flop (didn't bet)
Seat 3: matiko09 (button) folded before Flop (didn't bet)
Seat 4: Sreshta222 (small blind) folded before Flop
Seat 5: apfush (big blind) collected ($1)
Seat 7: 4Aces4Roses folded before Flop (didn't bet)
Seat 8: skram2 folded before Flop (didn't bet)
Seat 9: Waltz88 folded before Flop (didn't bet)





PokerStars Hand #148834001405:  Hold'em No Limit ($0.50/$1.00 USD) - 2016/02/15 11:39:14 CET [2016/02/15 5:39:14 ET]
Table 'Nata II' 9-max Seat #5 is the button
Seat 1: Priidix ($174.71 in chips) 
Seat 2: qqcom ($106.07 in chips) 
Seat 3: g00000se ($103.45 in chips) 
Seat 4: gabi_igna ($137.70 in chips) 
Seat 5: AGoodFell4 ($59.26 in chips) 
Seat 6: AlKatrone ($141.33 in chips) 
Seat 7: er13to ($114.15 in chips) 
Seat 8: lumen21 ($108.16 in chips) 
Seat 9: matiko09 ($107.80 in chips) 
AlKatrone: posts small blind $0.50
er13to: posts big blind $1
*** HOLE CARDS ***
Dealt to matiko09 [Ks 8h]
lumen21: raises $2 to $3
matiko09: folds 
Priidix: folds 
qqcom: folds 
g00000se: folds 
gabi_igna: folds 
AGoodFell4: folds 
AlKatrone: folds 
er13to: calls $2
*** FLOP *** [6h 4s 4d]
er13to: checks 
lumen21: bets $3.41
er13to: calls $3.41
*** TURN *** [6h 4s 4d] [9c]
er13to: checks 
lumen21: bets $6.99
er13to: calls $6.99
*** RIVER *** [6h 4s 4d 9c] [Kc]
er13to: checks 
lumen21: bets $14.33
er13to: folds 
Uncalled bet ($14.33) returned to lumen21
lumen21 collected $26.07 from pot
lumen21: doesn't show hand 
*** SUMMARY ***
Total pot $27.30 | Rake $1.23 
Board [6h 4s 4d 9c Kc]
Seat 1: Priidix folded before Flop (didn't bet)
Seat 2: qqcom folded before Flop (didn't bet)
Seat 3: g00000se folded before Flop (didn't bet)
Seat 4: gabi_igna folded before Flop (didn't bet)
Seat 5: AGoodFell4 (button) folded before Flop (didn't bet)
Seat 6: AlKatrone (small blind) folded before Flop
Seat 7: er13to (big blind) folded on the River
Seat 8: lumen21 collected ($26.07)
Seat 9: matiko09 folded before Flop (didn't bet)





PokerStars Hand #148834003783:  Hold'em No Limit ($0.50/$1.00 USD) - 2016/02/15 11:39:19 CET [2016/02/15 5:39:19 ET]
Table 'Oongaq' 9-max Seat #7 is the button
Seat 1: matiko09 ($103.50 in chips) 
Seat 2: Priidix ($107.91 in chips) 
Seat 3: wilsong96 ($98.08 in chips) 
Seat 5: mn230758 ($51.14 in chips) 
Seat 6: IHouseMusic ($101.71 in chips) 
Seat 7: gwwsb ($62.03 in chips) 
Seat 8: AlKatrone ($105.04 in chips) 
Seat 9: alpw47 ($33.94 in chips) 
AlKatrone: posts small blind $0.50
alpw47: posts big blind $1
maxxmeister: sits out 
*** HOLE CARDS ***
Dealt to matiko09 [Qh Ts]
matiko09: folds 
Priidix: folds 
wilsong96: calls $1
mn230758: folds 
IHouseMusic: folds 
gwwsb: calls $1
AlKatrone: calls $0.50
alpw47: checks 
*** FLOP *** [8c Qc Qs]
AlKatrone: checks 
alpw47: checks 
wilsong96: checks 
gwwsb: checks 
*** TURN *** [8c Qc Qs] [9c]
AlKatrone: checks 
alpw47: checks 
wilsong96: checks 
gwwsb: checks 
*** RIVER *** [8c Qc Qs 9c] [Tc]
AlKatrone: checks 
alpw47: bets $5
wilsong96: folds 
gwwsb: raises $13.82 to $18.82
AlKatrone: folds 
alpw47: calls $13.82
*** SHOW DOWN ***
gwwsb: shows [9d Jc] (a straight flush, Eight to Queen)
alpw47: mucks hand 
gwwsb collected $39.77 from pot
*** SUMMARY ***
Total pot $41.64 | Rake $1.87 
Board [8c Qc Qs 9c Tc]
Seat 1: matiko09 folded before Flop (didn't bet)
Seat 2: Priidix folded before Flop (didn't bet)
Seat 3: wilsong96 folded on the River
Seat 5: mn230758 folded before Flop (didn't bet)
Seat 6: IHouseMusic folded before Flop (didn't bet)
Seat 7: gwwsb (button) showed [9d Jc] and won ($39.77) with a straight flush, Eight to Queen
Seat 8: AlKatrone (small blind) folded on the River
Seat 9: alpw47 (big blind) mucked [Kc 5c]





PokerStars Hand #148834007234:  Hold'em No Limit ($0.50/$1.00 USD) - 2016/02/15 11:39:26 CET [2016/02/15 5:39:26 ET]
Table 'Praecipua' 9-max Seat #4 is the button
Seat 1: er13to ($153.01 in chips) 
Seat 2: matiko09 ($131.31 in chips) 
Seat 3: Venomous100% ($111.14 in chips) 
Seat 4: gabi_igna ($101 in chips) 
Seat 5: apfush ($100 in chips) 
Seat 6: mycka86 ($122.72 in chips) 
Seat 8: Ellis Ng ($16.42 in chips) 
Seat 9: AlKatrone ($100 in chips) 
apfush: posts small blind $0.50
mycka86: posts big blind $1
maxxmeister: sits out 
*** HOLE CARDS ***
Dealt to matiko09 [9d 6c]
Ellis Ng: folds 
AlKatrone: raises $2 to $3
er13to: folds 
matiko09: folds 
Venomous100%: folds 
gabi_igna: folds 
apfush: folds 
mycka86: folds 
Uncalled bet ($2) returned to AlKatrone
AlKatrone collected $2.50 from pot
AlKatrone: doesn't show hand 
*** SUMMARY ***
Total pot $2.50 | Rake $0 
Seat 1: er13to folded before Flop (didn't bet)
Seat 2: matiko09 folded before Flop (didn't bet)
Seat 3: Venomous100% folded before Flop (didn't bet)
Seat 4: gabi_igna (button) folded before Flop (didn't bet)
Seat 5: apfush (small blind) folded before Flop
Seat 6: mycka86 (big blind) folded before Flop
Seat 8: Ellis Ng folded before Flop (didn't bet)
Seat 9: AlKatrone collected ($2.50)





PokerStars Hand #148834007793:  Hold'em No Limit ($0.50/$1.00 USD) - 2016/02/15 11:39:27 CET [2016/02/15 5:39:27 ET]
Table 'Euanthe II' 9-max Seat #8 is the button
Seat 1: maxxmeister ($125.44 in chips) 
Seat 2: mahalko0925 ($73.36 in chips) 
Seat 3: matiko09 ($107.64 in chips) 
Seat 4: er13to ($118.68 in chips) 
Seat 5: gabi_igna ($178.66 in chips) 
Seat 6: IHouseMusic ($120.91 in chips) 
Seat 7: vinniesmol ($201.93 in chips) 
Seat 8: AlKatrone ($100 in chips) 
Seat 9: Venomous100% ($131.09 in chips) 
Venomous100%: posts small blind $0.50
maxxmeister: posts big blind $1
*** HOLE CARDS ***
Dealt to matiko09 [Qc 9c]
mahalko0925: raises $1 to $2
matiko09: folds 
er13to: folds 
gabi_igna: folds 
IHouseMusic: folds 
vinniesmol: folds 
AlKatrone: folds 
Venomous100%: raises $7 to $9
maxxmeister: folds 
mahalko0925: calls $7
*** FLOP *** [9s 5s 2s]
Venomous100%: bets $7
mahalko0925: calls $7
*** TURN *** [9s 5s 2s] [6d]
Venomous100%: checks 
mahalko0925: bets $4
Venomous100%: folds 
Uncalled bet ($4) returned to mahalko0925
mahalko0925 collected $31.52 from pot
*** SUMMARY ***
Total pot $33 | Rake $1.48 
Board [9s 5s 2s 6d]
Seat 1: maxxmeister (big blind) folded before Flop
Seat 2: mahalko0925 collected ($31.52)
Seat 3: matiko09 folded before Flop (didn't bet)
Seat 4: er13to folded before Flop (didn't bet)
Seat 5: gabi_igna folded before Flop (didn't bet)
Seat 6: IHouseMusic folded before Flop (didn't bet)
Seat 7: vinniesmol folded before Flop (didn't bet)
Seat 8: AlKatrone (button) folded before Flop (didn't bet)
Seat 9: Venomous100% (small blind) folded on the Turn





PokerStars Hand #148834008040:  Hold'em No Limit ($0.25/$0.50 USD) - 2016/02/15 11:39:28 CET [2016/02/15 5:39:28 ET]
Table 'Vesta II' 9-max Seat #9 is the button
Seat 1: lumen21 ($50 in chips) 
Seat 2: ljryviltj ($50.75 in chips) 
Seat 3: matiko09 ($66.53 in chips) 
Seat 4: vlad11122007 ($54.03 in chips) 
Seat 6: pandalapa ($50 in chips) 
Seat 7: ruyingren ($35.93 in chips) 
Seat 8: Arystan ($77.50 in chips) 
Seat 9: Aoki42 ($94.04 in chips) 
lumen21: posts small blind $0.25
ljryviltj: posts big blind $0.50
Serhent: sits out 
*** HOLE CARDS ***
Dealt to matiko09 [3h Tc]
matiko09: folds 
vlad11122007: folds 
pandalapa: folds 
ruyingren: folds 
Arystan: raises $1 to $1.50
Aoki42: raises $3 to $4.50
lumen21: folds 
ljryviltj: folds 
Arystan: calls $3
*** FLOP *** [3d 8d 3s]
Arystan: bets $4.65
Aoki42: calls $4.65
*** TURN *** [3d 8d 3s] [Qc]
Arystan: bets $9.09
Aoki42: calls $9.09
*** RIVER *** [3d 8d 3s Qc] [Kh]
Arystan: checks 
Aoki42: bets $9.50
Arystan: folds 
Uncalled bet ($9.50) returned to Aoki42
Aoki42 collected $35.55 from pot
Aoki42: doesn't show hand 
*** SUMMARY ***
Total pot $37.23 | Rake $1.68 
Board [3d 8d 3s Qc Kh]
Seat 1: lumen21 (small blind) folded before Flop
Seat 2: ljryviltj (big blind) folded before Flop
Seat 3: matiko09 folded before Flop (didn't bet)
Seat 4: vlad11122007 folded before Flop (didn't bet)
Seat 6: pandalapa folded before Flop (didn't bet)
Seat 7: ruyingren folded before Flop (didn't bet)
Seat 8: Arystan folded on the River
Seat 9: Aoki42 (button) collected ($35.55)





PokerStars Hand #148834012836:  Hold'em No Limit ($0.50/$1.00 USD) - 2016/02/15 11:39:38 CET [2016/02/15 5:39:38 ET]
Table 'Urania' 9-max Seat #9 is the button
Seat 1: GRISHANYASHA ($63.19 in chips) 
Seat 2: maxxmeister ($101.50 in chips) 
Seat 3: Priidix ($159.01 in chips) 
Seat 4: matiko09 ($106.62 in chips) 
Seat 5: maxonplay ($191.53 in chips) 
Seat 6: skaits ($91 in chips) 
Seat 7: er13to ($104.40 in chips) 
Seat 8: IHouseMusic ($103.37 in chips) 
Seat 9: mycka86 ($105.12 in chips) 
GRISHANYASHA: posts small blind $0.50
maxxmeister: posts big blind $1
*** HOLE CARDS ***
Dealt to matiko09 [7s Kd]
Priidix: folds 
matiko09: folds 
maxonplay: folds 
skaits: folds 
er13to: raises $1.50 to $2.50
IHouseMusic: calls $2.50
mycka86: folds 
GRISHANYASHA: folds 
maxxmeister: calls $1.50
*** FLOP *** [Jd Js 5c]
maxxmeister: bets $4.32
er13to: folds 
IHouseMusic: calls $4.32
*** TURN *** [Jd Js 5c] [5d]
maxxmeister: bets $8.10
IHouseMusic: folds 
Uncalled bet ($8.10) returned to maxxmeister
maxxmeister collected $15.89 from pot
maxxmeister: doesn't show hand 
*** SUMMARY ***
Total pot $16.64 | Rake $0.75 
Board [Jd Js 5c 5d]
Seat 1: GRISHANYASHA (small blind) folded before Flop
Seat 2: maxxmeister (big blind) collected ($15.89)
Seat 3: Priidix folded before Flop (didn't bet)
Seat 4: matiko09 folded before Flop (didn't bet)
Seat 5: maxonplay folded before Flop (didn't bet)
Seat 6: skaits folded before Flop (didn't bet)
Seat 7: er13to folded on the Flop
Seat 8: IHouseMusic folded on the Turn
Seat 9: mycka86 (button) folded before Flop (didn't bet)





PokerStars Hand #148834014172:  Hold'em No Limit ($0.50/$1.00 USD) - 2016/02/15 11:39:41 CET [2016/02/15 5:39:41 ET]
Table 'Octans II' 9-max Seat #8 is the button
Seat 1: maxxmeister ($100 in chips) 
Seat 2: matiko09 ($264.21 in chips) 
Seat 3: Aalleekks ($101.50 in chips) 
Seat 4: Venomous100% ($182.14 in chips) 
Seat 6: er13to ($101.50 in chips) 
Seat 7: traficblues ($35.97 in chips) 
Seat 8: IHouseMusic ($135.38 in chips) 
Seat 9: mycka86 ($101.93 in chips) 
mycka86: posts small blind $0.50
maxxmeister: posts big blind $1
gabi_igna: sits out 
*** HOLE CARDS ***
Dealt to matiko09 [Jd 5s]
matiko09: folds 
Aalleekks: folds 
Venomous100%: folds 
er13to: folds 
traficblues: folds 
IHouseMusic: folds 
mycka86: raises $1.75 to $2.75
maxxmeister: calls $1.75
*** FLOP *** [Ts 7c 9d]
mycka86: checks 
maxxmeister: bets $3.11
mycka86: folds 
Uncalled bet ($3.11) returned to maxxmeister
maxxmeister collected $5.25 from pot
maxxmeister: doesn't show hand 
*** SUMMARY ***
Total pot $5.50 | Rake $0.25 
Board [Ts 7c 9d]
Seat 1: maxxmeister (big blind) collected ($5.25)
Seat 2: matiko09 folded before Flop (didn't bet)
Seat 3: Aalleekks folded before Flop (didn't bet)
Seat 4: Venomous100% folded before Flop (didn't bet)
Seat 6: er13to folded before Flop (didn't bet)
Seat 7: traficblues folded before Flop (didn't bet)
Seat 8: IHouseMusic (button) folded before Flop (didn't bet)
Seat 9: mycka86 (small blind) folded on the Flop





PokerStars Hand #148834014596:  Hold'em No Limit ($0.50/$1.00 USD) - 2016/02/15 11:39:41 CET [2016/02/15 5:39:41 ET]
Table 'Corvus III' 9-max Seat #4 is the button
Seat 1: pk4DW ($130.40 in chips) 
Seat 2: mzsportline ($147.14 in chips) 
Seat 3: VanDobeln ($232.89 in chips) 
Seat 4: goransyruvka ($209.49 in chips) 
Seat 5: maxxmeister ($254.12 in chips) 
Seat 7: matiko09 ($292.12 in chips) 
Seat 8: redacesfull ($236.21 in chips) 
Seat 9: er13to ($105.39 in chips) 
maxxmeister: posts small blind $0.50
Priidix: is sitting out 
matiko09: posts big blind $1
pk4DW: posts the ante $0.20
mzsportline: posts the ante $0.20
VanDobeln: posts the ante $0.20
goransyruvka: posts the ante $0.20
maxxmeister: posts the ante $0.20
matiko09: posts the ante $0.20
redacesfull: posts the ante $0.20
er13to: posts the ante $0.20
*** HOLE CARDS ***
Dealt to matiko09 [Qs 9s]
redacesfull: raises $1.12 to $2.12
er13to: folds 
pk4DW: folds 
mzsportline: folds 
VanDobeln: folds 
goransyruvka: calls $2.12
maxxmeister: folds 
matiko09: calls $1.12
*** FLOP *** [8s Kh 9h]
matiko09: checks 
redacesfull: checks 
goransyruvka: checks 
*** TURN *** [8s Kh 9h] [Td]
matiko09: checks 
redacesfull: checks 
goransyruvka: checks 
*** RIVER *** [8s Kh 9h Td] [4h]
matiko09: checks 
redacesfull: checks 
goransyruvka: checks 
*** SHOW DOWN ***
matiko09: shows [Qs 9s] (a pair of Nines)
redacesfull: mucks hand 
goransyruvka: mucks hand 
matiko09 collected $8.08 from pot
*** SUMMARY ***
Total pot $8.46 | Rake $0.38 
Board [8s Kh 9h Td 4h]
Seat 1: pk4DW folded before Flop (didn't bet)
Seat 2: mzsportline folded before Flop (didn't bet)
Seat 3: VanDobeln folded before Flop (didn't bet)
Seat 4: goransyruvka (button) mucked [As 6h]
Seat 5: maxxmeister (small blind) folded before Flop
Seat 7: matiko09 (big blind) showed [Qs 9s] and won ($8.08) with a pair of Nines
Seat 8: redacesfull mucked [3s 3h]
Seat 9: er13to folded before Flop (didn't bet)





PokerStars Hand #148834018565:  Hold'em No Limit (€0.50/€1.00 EUR) - 2016/02/15 11:39:50 CET [2016/02/15 5:39:50 ET]
Table 'Ganesa II' 9-max Seat #1 is the button
Seat 1: Apparat888 (€50.57 in chips) 
Seat 2: Venomous100% (€100 in chips) 
Seat 3: BuBu 0187 (€63.14 in chips) 
Seat 4: Sreshta222 (€120.33 in chips) 
Seat 5: AlKatrone (€110.21 in chips) 
Seat 6: matiko09 (€105.08 in chips) 
Seat 7: er13to (€133.91 in chips) 
Seat 8: mycka86 (€100 in chips) 
Seat 9: Priidix (€169.85 in chips) 
Venomous100%: posts small blind €0.50
BuBu 0187: posts big blind €1
*** HOLE CARDS ***
Dealt to matiko09 [Kh 6s]
Sreshta222: folds 
AlKatrone: folds 
matiko09: folds 
er13to: folds 
mycka86: folds 
Priidix: folds 
Apparat888: folds 
Venomous100%: folds 
Uncalled bet (€0.50) returned to BuBu 0187
BuBu 0187 collected €1 from pot
BuBu 0187: doesn't show hand 
*** SUMMARY ***
Total pot €1 | Rake €0 
Seat 1: Apparat888 (button) folded before Flop (didn't bet)
Seat 2: Venomous100% (small blind) folded before Flop
Seat 3: BuBu 0187 (big blind) collected (€1)
Seat 4: Sreshta222 folded before Flop (didn't bet)
Seat 5: AlKatrone folded before Flop (didn't bet)
Seat 6: matiko09 folded before Flop (didn't bet)
Seat 7: er13to folded before Flop (didn't bet)
Seat 8: mycka86 folded before Flop (didn't bet)
Seat 9: Priidix folded before Flop (didn't bet)





PokerStars Hand #148834018478:  Hold'em No Limit ($0.50/$1.00 USD) - 2016/02/15 11:39:50 CET [2016/02/15 5:39:50 ET]
Table 'Kitalpha II' 9-max Seat #4 is the button
Seat 1: IHouseMusic ($100 in chips) 
Seat 3: matiko09 ($101.86 in chips) 
Seat 4: Sreshta222 ($100 in chips) 
Seat 5: apfush ($100.50 in chips) 
Seat 6: Congo Sam ($100 in chips) 
Seat 7: 4Aces4Roses ($102.92 in chips) 
Seat 8: skram2 ($115.91 in chips) 
apfush: posts small blind $0.50
Congo Sam: posts big blind $1
Aalleekks: sits out 
*** HOLE CARDS ***
Dealt to matiko09 [9c 2d]
4Aces4Roses: raises $4 to $5
skram2: folds 
IHouseMusic: folds 
matiko09: folds 
Sreshta222: calls $5
apfush: folds 
Congo Sam: folds 
*** FLOP *** [4d 5h Kh]
4Aces4Roses: bets $5
Sreshta222: calls $5
*** TURN *** [4d 5h Kh] [3h]
4Aces4Roses: checks 
Sreshta222: bets $13.68
4Aces4Roses: calls $13.68
*** RIVER *** [4d 5h Kh 3h] [Qh]
4Aces4Roses: checks 
Sreshta222: checks 
*** SHOW DOWN ***
4Aces4Roses: shows [Kd Ks] (three of a kind, Kings)
Sreshta222: mucks hand 
4Aces4Roses collected $46.66 from pot
*** SUMMARY ***
Total pot $48.86 | Rake $2.20 
Board [4d 5h Kh 3h Qh]
Seat 1: IHouseMusic folded before Flop (didn't bet)
Seat 3: matiko09 folded before Flop (didn't bet)
Seat 4: Sreshta222 (button) mucked [As Kc]
Seat 5: apfush (small blind) folded before Flop
Seat 6: Congo Sam (big blind) folded before Flop
Seat 7: 4Aces4Roses showed [Kd Ks] and won ($46.66) with three of a kind, Kings
Seat 8: skram2 folded before Flop (didn't bet)





PokerStars Hand #148834020480:  Hold'em No Limit ($0.50/$1.00 USD) - 2016/02/15 11:39:54 CET [2016/02/15 5:39:54 ET]
Table 'Anteros' 9-max Seat #8 is the button
Seat 1: redacesfull ($108.27 in chips) 
Seat 2: IHouseMusic ($108.41 in chips) 
Seat 3: er13to ($100 in chips) 
Seat 4: misherei ($176.25 in chips) 
Seat 5: Holm1991 ($41.75 in chips) 
Seat 6: SerAlGog ($152.31 in chips) 
Seat 7: Zoubou1983 ($197.87 in chips) 
Seat 8: matiko09 ($100 in chips) 
Seat 9: mycka86 ($100 in chips) 
mycka86: posts small blind $0.50
redacesfull: posts big blind $1
*** HOLE CARDS ***
Dealt to matiko09 [4h 5c]
IHouseMusic: folds 
er13to: folds 
misherei: folds 
Holm1991: folds 
SerAlGog: folds 
Zoubou1983: calls $1
matiko09: folds 
mycka86: raises $3 to $4
redacesfull: folds 
Zoubou1983: folds 
Uncalled bet ($3) returned to mycka86
mycka86 collected $3 from pot
*** SUMMARY ***
Total pot $3 | Rake $0 
Seat 1: redacesfull (big blind) folded before Flop
Seat 2: IHouseMusic folded before Flop (didn't bet)
Seat 3: er13to folded before Flop (didn't bet)
Seat 4: misherei folded before Flop (didn't bet)
Seat 5: Holm1991 folded before Flop (didn't bet)
Seat 6: SerAlGog folded before Flop (didn't bet)
Seat 7: Zoubou1983 folded before Flop
Seat 8: matiko09 (button) folded before Flop (didn't bet)
Seat 9: mycka86 (small blind) collected ($3)





PokerStars Hand #148834021623:  Hold'em No Limit ($0.50/$1.00 USD) - 2016/02/15 11:39:56 CET [2016/02/15 5:39:56 ET]
Table 'Praecipua' 9-max Seat #5 is the button
Seat 1: er13to ($153.01 in chips) 
Seat 2: matiko09 ($131.31 in chips) 
Seat 3: Venomous100% ($111.14 in chips) 
Seat 4: gabi_igna ($101 in chips) 
Seat 5: apfush ($100 in chips) 
Seat 6: mycka86 ($121.72 in chips) 
Seat 7: maxxmeister ($132.52 in chips) 
Seat 8: Ellis Ng ($16.42 in chips) 
Seat 9: AlKatrone ($101.50 in chips) 
mycka86: posts small blind $0.50
maxxmeister: posts big blind $1
*** HOLE CARDS ***
Dealt to matiko09 [4d 2d]
Ellis Ng: folds 
AlKatrone: folds 
er13to: folds 
matiko09: folds 
Venomous100%: folds 
gabi_igna: raises $1.50 to $2.50
apfush: folds 
mycka86: folds 
maxxmeister: folds 
Uncalled bet ($1.50) returned to gabi_igna
gabi_igna collected $2.50 from pot
gabi_igna: doesn't show hand 
*** SUMMARY ***
Total pot $2.50 | Rake $0 
Seat 1: er13to folded before Flop (didn't bet)
Seat 2: matiko09 folded before Flop (didn't bet)
Seat 3: Venomous100% folded before Flop (didn't bet)
Seat 4: gabi_igna collected ($2.50)
Seat 5: apfush (button) folded before Flop (didn't bet)
Seat 6: mycka86 (small blind) folded before Flop
Seat 7: maxxmeister (big blind) folded before Flop
Seat 8: Ellis Ng folded before Flop (didn't bet)
Seat 9: AlKatrone folded before Flop (didn't bet)





PokerStars Hand #148834029478:  Hold'em No Limit ($0.50/$1.00 USD) - 2016/02/15 11:40:13 CET [2016/02/15 5:40:13 ET]
Table 'Euanthe II' 9-max Seat #9 is the button
Seat 1: maxxmeister ($124.44 in chips) 
Seat 2: mahalko0925 ($88.88 in chips) 
Seat 3: matiko09 ($107.64 in chips) 
Seat 4: er13to ($118.68 in chips) 
Seat 5: gabi_igna ($178.66 in chips) 
Seat 6: IHouseMusic ($120.91 in chips) 
Seat 7: vinniesmol ($201.93 in chips) 
Seat 8: AlKatrone ($100 in chips) 
Seat 9: Venomous100% ($115.09 in chips) 
maxxmeister: posts small blind $0.50
mahalko0925: posts big blind $1
*** HOLE CARDS ***
Dealt to matiko09 [6s 9d]
matiko09: folds 
er13to: folds 
gabi_igna: folds 
IHouseMusic: folds 
vinniesmol: folds 
AlKatrone: folds 
Venomous100%: raises $1 to $2
maxxmeister: raises $7 to $9
mahalko0925: folds 
Venomous100%: folds 
Uncalled bet ($7) returned to maxxmeister
maxxmeister collected $5 from pot
maxxmeister: doesn't show hand 
*** SUMMARY ***
Total pot $5 | Rake $0 
Seat 1: maxxmeister (small blind) collected ($5)
Seat 2: mahalko0925 (big blind) folded before Flop
Seat 3: matiko09 folded before Flop (didn't bet)
Seat 4: er13to folded before Flop (didn't bet)
Seat 5: gabi_igna folded before Flop (didn't bet)
Seat 6: IHouseMusic folded before Flop (didn't bet)
Seat 7: vinniesmol folded before Flop (didn't bet)
Seat 8: AlKatrone folded before Flop (didn't bet)
Seat 9: Venomous100% (button) folded before Flop





PokerStars Hand #148834037042:  Hold'em No Limit ($0.50/$1.00 USD) - 2016/02/15 11:40:28 CET [2016/02/15 5:40:28 ET]
Table 'Corvus III' 9-max Seat #5 is the button
Seat 1: pk4DW ($130.20 in chips) 
Seat 2: mzsportline ($146.94 in chips) 
Seat 3: VanDobeln ($232.69 in chips) 
Seat 4: goransyruvka ($207.17 in chips) 
Seat 5: maxxmeister ($253.42 in chips) 
Seat 7: matiko09 ($297.88 in chips) 
Seat 8: redacesfull ($233.89 in chips) 
Seat 9: er13to ($105.19 in chips) 
matiko09: posts small blind $0.50
redacesfull: posts big blind $1
pk4DW: posts the ante $0.20
mzsportline: posts the ante $0.20
VanDobeln: posts the ante $0.20
goransyruvka: posts the ante $0.20
maxxmeister: posts the ante $0.20
matiko09: posts the ante $0.20
redacesfull: posts the ante $0.20
er13to: posts the ante $0.20
*** HOLE CARDS ***
Dealt to matiko09 [6h 3d]
er13to: folds 
pk4DW: raises $1 to $2
mzsportline: folds 
VanDobeln: folds 
goransyruvka: calls $2
maxxmeister: raises $9 to $11
matiko09: folds 
redacesfull: folds 
pk4DW: folds 
goransyruvka: folds 
Uncalled bet ($9) returned to maxxmeister
maxxmeister collected $9.10 from pot
maxxmeister: doesn't show hand 
*** SUMMARY ***
Total pot $9.10 | Rake $0 
Seat 1: pk4DW folded before Flop
Seat 2: mzsportline folded before Flop (didn't bet)
Seat 3: VanDobeln folded before Flop (didn't bet)
Seat 4: goransyruvka folded before Flop
Seat 5: maxxmeister (button) collected ($9.10)
Seat 7: matiko09 (small blind) folded before Flop
Seat 8: redacesfull (big blind) folded before Flop
Seat 9: er13to folded before Flop (didn't bet)





PokerStars Hand #148834038636:  Hold'em No Limit ($0.50/$1.00 USD) - 2016/02/15 11:40:31 CET [2016/02/15 5:40:31 ET]
Table 'Anteros' 9-max Seat #9 is the button
Seat 1: redacesfull ($107.27 in chips) 
Seat 2: IHouseMusic ($108.41 in chips) 
Seat 3: er13to ($100 in chips) 
Seat 4: misherei ($176.25 in chips) 
Seat 5: Holm1991 ($41.75 in chips) 
Seat 6: SerAlGog ($152.31 in chips) 
Seat 7: Zoubou1983 ($196.87 in chips) 
Seat 8: matiko09 ($100 in chips) 
Seat 9: mycka86 ($102 in chips) 
redacesfull: posts small blind $0.50
IHouseMusic: posts big blind $1
*** HOLE CARDS ***
Dealt to matiko09 [9s Ks]
er13to: folds 
misherei: folds 
Holm1991: folds 
SerAlGog: folds 
Zoubou1983: folds 
matiko09: raises $1.50 to $2.50
mycka86: folds 
redacesfull: folds 
IHouseMusic: calls $1.50
*** FLOP *** [Qc Jd Jc]
IHouseMusic: checks 
matiko09: bets $3.41
IHouseMusic: calls $3.41
*** TURN *** [Qc Jd Jc] [Td]
IHouseMusic: checks 
matiko09: bets $8
IHouseMusic: folds 
Uncalled bet ($8) returned to matiko09
matiko09 collected $11.77 from pot
matiko09: doesn't show hand 
*** SUMMARY ***
Total pot $12.32 | Rake $0.55 
Board [Qc Jd Jc Td]
Seat 1: redacesfull (small blind) folded before Flop
Seat 2: IHouseMusic (big blind) folded on the Turn
Seat 3: er13to folded before Flop (didn't bet)
Seat 4: misherei folded before Flop (didn't bet)
Seat 5: Holm1991 folded before Flop (didn't bet)
Seat 6: SerAlGog folded before Flop (didn't bet)
Seat 7: Zoubou1983 folded before Flop (didn't bet)
Seat 8: matiko09 collected ($11.77)
Seat 9: mycka86 (button) folded before Flop (didn't bet)





PokerStars Hand #148834038375:  Hold'em No Limit ($0.50/$1.00 USD) - 2016/02/15 11:40:31 CET [2016/02/15 5:40:31 ET]
Table 'Octans II' 9-max Seat #9 is the button
Seat 1: maxxmeister ($102.50 in chips) 
Seat 2: matiko09 ($264.21 in chips) 
Seat 3: Aalleekks ($101.50 in chips) 
Seat 4: Venomous100% ($182.14 in chips) 
Seat 6: er13to ($101.50 in chips) 
Seat 7: traficblues ($35.97 in chips) 
Seat 8: IHouseMusic ($135.38 in chips) 
Seat 9: mycka86 ($100 in chips) 
maxxmeister: posts small blind $0.50
matiko09: posts big blind $1
gabi_igna: sits out 
*** HOLE CARDS ***
Dealt to matiko09 [Kc 2d]
Aalleekks: folds 
Venomous100%: folds 
er13to: folds 
traficblues: calls $1
IHouseMusic: folds 
mycka86: raises $3 to $4
maxxmeister: folds 
matiko09: folds 
traficblues: calls $3
*** FLOP *** [4c 7c 6d]
traficblues: checks 
mycka86: bets $6
traficblues: folds 
Uncalled bet ($6) returned to mycka86
mycka86 collected $9.07 from pot
*** SUMMARY ***
Total pot $9.50 | Rake $0.43 
Board [4c 7c 6d]
Seat 1: maxxmeister (small blind) folded before Flop
Seat 2: matiko09 (big blind) folded before Flop
Seat 3: Aalleekks folded before Flop (didn't bet)
Seat 4: Venomous100% folded before Flop (didn't bet)
Seat 6: er13to folded before Flop (didn't bet)
Seat 7: traficblues folded on the Flop
Seat 8: IHouseMusic folded before Flop (didn't bet)
Seat 9: mycka86 (button) collected ($9.07)





PokerStars Hand #148834038744:  Hold'em No Limit (€0.50/€1.00 EUR) - 2016/02/15 11:40:32 CET [2016/02/15 5:40:32 ET]
Table 'Ganesa II' 9-max Seat #2 is the button
Seat 1: Apparat888 (€50.57 in chips) 
Seat 2: Venomous100% (€100 in chips) 
Seat 3: BuBu 0187 (€63.64 in chips) 
Seat 4: Sreshta222 (€120.33 in chips) 
Seat 5: AlKatrone (€110.21 in chips) 
Seat 6: matiko09 (€105.08 in chips) 
Seat 7: er13to (€133.91 in chips) 
Seat 8: mycka86 (€100 in chips) 
Seat 9: Priidix (€169.85 in chips) 
BuBu 0187: posts small blind €0.50
Sreshta222: posts big blind €1
*** HOLE CARDS ***
Dealt to matiko09 [3c 9c]
AlKatrone: folds 
matiko09: folds 
er13to: raises €1.50 to €2.50
mycka86: folds 
Priidix: folds 
Apparat888: folds 
Venomous100%: folds 
BuBu 0187: raises €3.50 to €6
Sreshta222: folds 
er13to: folds 
Uncalled bet (€3.50) returned to BuBu 0187
BuBu 0187 collected €6 from pot
BuBu 0187: doesn't show hand 
*** SUMMARY ***
Total pot €6 | Rake €0 
Seat 1: Apparat888 folded before Flop (didn't bet)
Seat 2: Venomous100% (button) folded before Flop (didn't bet)
Seat 3: BuBu 0187 (small blind) collected (€6)
Seat 4: Sreshta222 (big blind) folded before Flop
Seat 5: AlKatrone folded before Flop (didn't bet)
Seat 6: matiko09 folded before Flop (didn't bet)
Seat 7: er13to folded before Flop
Seat 8: mycka86 folded before Flop (didn't bet)
Seat 9: Priidix folded before Flop (didn't bet)





PokerStars Hand #148834042565:  Hold'em No Limit ($0.50/$1.00 USD) - 2016/02/15 11:40:40 CET [2016/02/15 5:40:40 ET]
Table 'Urania' 9-max Seat #1 is the button
Seat 1: GRISHANYASHA ($62.69 in chips) 
Seat 2: maxxmeister ($110.57 in chips) 
Seat 4: matiko09 ($106.62 in chips) 
Seat 5: maxonplay ($191.53 in chips) 
Seat 6: skaits ($91 in chips) 
Seat 7: er13to ($101.90 in chips) 
Seat 8: IHouseMusic ($100 in chips) 
Seat 9: mycka86 ($105.12 in chips) 
maxxmeister: posts small blind $0.50
Priidix: is sitting out 
matiko09: posts big blind $1
*** HOLE CARDS ***
Dealt to matiko09 [3h Tc]
maxonplay: folds 
skaits: folds 
er13to: folds 
IHouseMusic: folds 
mycka86: folds 
GRISHANYASHA: folds 
maxxmeister: raises $2.50 to $3.50
matiko09: raises $6.50 to $10
maxxmeister: folds 
Uncalled bet ($6.50) returned to matiko09
matiko09 collected $7 from pot
matiko09: doesn't show hand 
*** SUMMARY ***
Total pot $7 | Rake $0 
Seat 1: GRISHANYASHA (button) folded before Flop (didn't bet)
Seat 2: maxxmeister (small blind) folded before Flop
Seat 4: matiko09 (big blind) collected ($7)
Seat 5: maxonplay folded before Flop (didn't bet)
Seat 6: skaits folded before Flop (didn't bet)
Seat 7: er13to folded before Flop (didn't bet)
Seat 8: IHouseMusic folded before Flop (didn't bet)
Seat 9: mycka86 folded before Flop (didn't bet)





PokerStars Hand #148834044791:  Hold'em No Limit ($0.50/$1.00 USD) - 2016/02/15 11:40:44 CET [2016/02/15 5:40:44 ET]
Table 'Nata II' 9-max Seat #6 is the button
Seat 1: Priidix ($174.71 in chips) 
Seat 2: qqcom ($106.07 in chips) 
Seat 3: g00000se ($103.45 in chips) 
Seat 4: gabi_igna ($137.70 in chips) 
Seat 5: AGoodFell4 ($59.26 in chips) 
Seat 6: AlKatrone ($140.83 in chips) 
Seat 7: er13to ($100.75 in chips) 
Seat 8: lumen21 ($120.83 in chips) 
Seat 9: matiko09 ($107.80 in chips) 
er13to: posts small blind $0.50
lumen21: posts big blind $1
*** HOLE CARDS ***
Dealt to matiko09 [9h Qs]
matiko09: folds 
Priidix: folds 
qqcom: raises $2 to $3
g00000se: folds 
gabi_igna: folds 
AGoodFell4: folds 
AlKatrone: folds 
er13to: folds 
lumen21: folds 
Uncalled bet ($2) returned to qqcom
qqcom collected $2.50 from pot
*** SUMMARY ***
Total pot $2.50 | Rake $0 
Seat 1: Priidix folded before Flop (didn't bet)
Seat 2: qqcom collected ($2.50)
Seat 3: g00000se folded before Flop (didn't bet)
Seat 4: gabi_igna folded before Flop (didn't bet)
Seat 5: AGoodFell4 folded before Flop (didn't bet)
Seat 6: AlKatrone (button) folded before Flop (didn't bet)
Seat 7: er13to (small blind) folded before Flop
Seat 8: lumen21 (big blind) folded before Flop
Seat 9: matiko09 folded before Flop (didn't bet)





PokerStars Hand #148834048064:  Hold'em No Limit ($0.25/$0.50 USD) - 2016/02/15 11:40:51 CET [2016/02/15 5:40:51 ET]
Table 'Vesta II' 9-max Seat #1 is the button
Seat 1: lumen21 ($50 in chips) 
Seat 2: ljryviltj ($50.25 in chips) 
Seat 3: matiko09 ($66.53 in chips) 
Seat 4: vlad11122007 ($54.03 in chips) 
Seat 6: pandalapa ($50 in chips) 
Seat 7: ruyingren ($35.93 in chips) 
Seat 8: Arystan ($59.26 in chips) 
Seat 9: Aoki42 ($111.35 in chips) 
ljryviltj: posts small blind $0.25
matiko09: posts big blind $0.50
Serhent: sits out 
*** HOLE CARDS ***
Dealt to matiko09 [9d 6d]
vlad11122007: folds 
pandalapa: folds 
ruyingren: raises $1 to $1.50
Arystan: folds 
Aoki42: folds 
lumen21: folds 
ljryviltj: folds 
matiko09: folds 
Uncalled bet ($1) returned to ruyingren
ruyingren collected $1.25 from pot
ruyingren: doesn't show hand 
*** SUMMARY ***
Total pot $1.25 | Rake $0 
Seat 1: lumen21 (button) folded before Flop (didn't bet)
Seat 2: ljryviltj (small blind) folded before Flop
Seat 3: matiko09 (big blind) folded before Flop
Seat 4: vlad11122007 folded before Flop (didn't bet)
Seat 6: pandalapa folded before Flop (didn't bet)
Seat 7: ruyingren collected ($1.25)
Seat 8: Arystan folded before Flop (didn't bet)
Seat 9: Aoki42 folded before Flop (didn't bet)





PokerStars Hand #148834049468:  Hold'em No Limit ($0.50/$1.00 USD) - 2016/02/15 11:40:54 CET [2016/02/15 5:40:54 ET]
Table 'Euanthe II' 9-max Seat #1 is the button
Seat 1: maxxmeister ($127.44 in chips) 
Seat 2: mahalko0925 ($87.88 in chips) 
Seat 3: matiko09 ($107.64 in chips) 
Seat 4: er13to ($118.68 in chips) 
Seat 5: gabi_igna ($178.66 in chips) 
Seat 6: IHouseMusic ($120.91 in chips) 
Seat 7: vinniesmol ($201.93 in chips) 
Seat 8: AlKatrone ($100 in chips) 
Seat 9: Venomous100% ($113.09 in chips) 
mahalko0925: posts small blind $0.50
matiko09: posts big blind $1
*** HOLE CARDS ***
Dealt to matiko09 [Tc 6c]
er13to: raises $1.50 to $2.50
gabi_igna: calls $2.50
IHouseMusic: folds 
vinniesmol: folds 
AlKatrone: folds 
Venomous100%: folds 
maxxmeister: folds 
mahalko0925: folds 
matiko09: folds 
*** FLOP *** [Qd 3s Qh]
er13to: checks 
gabi_igna: checks 
*** TURN *** [Qd 3s Qh] [4d]
er13to: checks 
gabi_igna: bets $4
er13to: calls $4
*** RIVER *** [Qd 3s Qh 4d] [5s]
er13to: checks 
gabi_igna: checks 
*** SHOW DOWN ***
er13to: shows [Ad Jc] (a pair of Queens)
gabi_igna: shows [9c 9h] (two pair, Queens and Nines)
gabi_igna collected $13.85 from pot
*** SUMMARY ***
Total pot $14.50 | Rake $0.65 
Board [Qd 3s Qh 4d 5s]
Seat 1: maxxmeister (button) folded before Flop (didn't bet)
Seat 2: mahalko0925 (small blind) folded before Flop
Seat 3: matiko09 (big blind) folded before Flop
Seat 4: er13to showed [Ad Jc] and lost with a pair of Queens
Seat 5: gabi_igna showed [9c 9h] and won ($13.85) with two pair, Queens and Nines
Seat 6: IHouseMusic folded before Flop (didn't bet)
Seat 7: vinniesmol folded before Flop (didn't bet)
Seat 8: AlKatrone folded before Flop (didn't bet)
Seat 9: Venomous100% folded before Flop (didn't bet)





PokerStars Hand #148834049778:  Hold'em No Limit ($0.50/$1.00 USD) - 2016/02/15 11:40:54 CET [2016/02/15 5:40:54 ET]
Table 'Praecipua' 9-max Seat #6 is the button
Seat 1: er13to ($153.01 in chips) 
Seat 2: matiko09 ($131.31 in chips) 
Seat 3: Venomous100% ($111.14 in chips) 
Seat 4: gabi_igna ($102.50 in chips) 
Seat 5: apfush ($100 in chips) 
Seat 6: mycka86 ($121.22 in chips) 
Seat 7: maxxmeister ($131.52 in chips) 
Seat 8: Ellis Ng ($16.42 in chips) 
Seat 9: AlKatrone ($101.50 in chips) 
maxxmeister: posts small blind $0.50
Ellis Ng: posts big blind $1
*** HOLE CARDS ***
Dealt to matiko09 [8c 3c]
AlKatrone: folds 
er13to: raises $1.50 to $2.50
matiko09: folds 
Venomous100%: folds 
gabi_igna: folds 
apfush: folds 
mycka86: raises $6.50 to $9
maxxmeister: folds 
Ellis Ng: folds 
er13to: calls $6.50
*** FLOP *** [Ts 2s Ah]
er13to: checks 
mycka86: bets $11.24
er13to: calls $11.24
*** TURN *** [Ts 2s Ah] [Ks]
er13to: checks 
mycka86: bets $23.50
er13to: folds 
Uncalled bet ($23.50) returned to mycka86
mycka86 collected $40.09 from pot
*** SUMMARY ***
Total pot $41.98 | Rake $1.89 
Board [Ts 2s Ah Ks]
Seat 1: er13to folded on the Turn
Seat 2: matiko09 folded before Flop (didn't bet)
Seat 3: Venomous100% folded before Flop (didn't bet)
Seat 4: gabi_igna folded before Flop (didn't bet)
Seat 5: apfush folded before Flop (didn't bet)
Seat 6: mycka86 (button) collected ($40.09)
Seat 7: maxxmeister (small blind) folded before Flop
Seat 8: Ellis Ng (big blind) folded before Flop
Seat 9: AlKatrone folded before Flop (didn't bet)





PokerStars Hand #148834050355:  Hold'em No Limit ($0.50/$1.00 USD) - 2016/02/15 11:40:56 CET [2016/02/15 5:40:56 ET]
Table 'Kitalpha II' 9-max Seat #5 is the button
Seat 1: IHouseMusic ($100 in chips) 
Seat 3: matiko09 ($101.86 in chips) 
Seat 4: Sreshta222 ($100 in chips) 
Seat 5: apfush ($100 in chips) 
Seat 6: Congo Sam ($99 in chips) 
Seat 7: 4Aces4Roses ($125.90 in chips) 
Seat 8: skram2 ($115.91 in chips) 
Seat 9: Waltz88 ($246.69 in chips) 
Congo Sam: posts small blind $0.50
4Aces4Roses: posts big blind $1
Aalleekks: sits out 
*** HOLE CARDS ***
Dealt to matiko09 [2s Kd]
skram2: folds 
Waltz88: folds 
IHouseMusic: folds 
matiko09: folds 
Sreshta222: folds 
apfush: raises $1.20 to $2.20
Congo Sam: calls $1.70
4Aces4Roses: folds 
*** FLOP *** [5s Qs Tc]
Congo Sam: checks 
apfush: bets $3.50
Congo Sam: calls $3.50
*** TURN *** [5s Qs Tc] [Ah]
Congo Sam: checks 
apfush: checks 
*** RIVER *** [5s Qs Tc Ah] [Qh]
Congo Sam: checks 
apfush: bets $8.50
Congo Sam: calls $8.50
*** SHOW DOWN ***
apfush: shows [4c 6c] (a pair of Queens)
Congo Sam: shows [As Ts] (two pair, Aces and Queens)
Congo Sam collected $28.08 from pot
*** SUMMARY ***
Total pot $29.40 | Rake $1.32 
Board [5s Qs Tc Ah Qh]
Seat 1: IHouseMusic folded before Flop (didn't bet)
Seat 3: matiko09 folded before Flop (didn't bet)
Seat 4: Sreshta222 folded before Flop (didn't bet)
Seat 5: apfush (button) showed [4c 6c] and lost with a pair of Queens
Seat 6: Congo Sam (small blind) showed [As Ts] and won ($28.08) with two pair, Aces and Queens
Seat 7: 4Aces4Roses (big blind) folded before Flop
Seat 8: skram2 folded before Flop (didn't bet)
Seat 9: Waltz88 folded before Flop (didn't bet)





PokerStars Hand #148834056190:  Hold'em No Limit ($0.50/$1.00 USD) - 2016/02/15 11:41:08 CET [2016/02/15 5:41:08 ET]
Table 'Nata II' 9-max Seat #7 is the button
Seat 1: Priidix ($174.71 in chips) 
Seat 2: qqcom ($107.57 in chips) 
Seat 3: g00000se ($103.45 in chips) 
Seat 4: gabi_igna ($137.70 in chips) 
Seat 5: AGoodFell4 ($59.26 in chips) 
Seat 6: AlKatrone ($140.83 in chips) 
Seat 7: er13to ($100.25 in chips) 
Seat 8: lumen21 ($119.83 in chips) 
Seat 9: matiko09 ($107.80 in chips) 
lumen21: posts small blind $0.50
matiko09: posts big blind $1
*** HOLE CARDS ***
Dealt to matiko09 [7h 2c]
Priidix: folds 
qqcom: raises $2.50 to $3.50
g00000se: folds 
gabi_igna: folds 
AGoodFell4: calls $3.50
AlKatrone: folds 
er13to: folds 
lumen21: raises $9.50 to $13
matiko09: folds 
qqcom: calls $9.50
AGoodFell4: calls $9.50
*** FLOP *** [5h Kd Qd]
lumen21: bets $28.65
qqcom: calls $28.65
AGoodFell4: folds 
*** TURN *** [5h Kd Qd] [4h]
lumen21: bets $78.18 and is all-in
qqcom: folds 
Uncalled bet ($78.18) returned to lumen21
lumen21 collected $94.50 from pot
lumen21: doesn't show hand 
*** SUMMARY ***
Total pot $97.30 | Rake $2.80 
Board [5h Kd Qd 4h]
Seat 1: Priidix folded before Flop (didn't bet)
Seat 2: qqcom folded on the Turn
Seat 3: g00000se folded before Flop (didn't bet)
Seat 4: gabi_igna folded before Flop (didn't bet)
Seat 5: AGoodFell4 folded on the Flop
Seat 6: AlKatrone folded before Flop (didn't bet)
Seat 7: er13to (button) folded before Flop (didn't bet)
Seat 8: lumen21 (small blind) collected ($94.50)
Seat 9: matiko09 (big blind) folded before Flop





PokerStars Hand #148834057598:  Hold'em No Limit ($0.50/$1.00 USD) - 2016/02/15 11:41:11 CET [2016/02/15 5:41:11 ET]
Table 'Corvus III' 9-max Seat #7 is the button
Seat 1: pk4DW ($128 in chips) 
Seat 2: mzsportline ($146.74 in chips) 
Seat 3: VanDobeln ($232.49 in chips) 
Seat 4: goransyruvka ($204.97 in chips) 
Seat 5: maxxmeister ($260.32 in chips) 
Seat 7: matiko09 ($297.18 in chips) 
Seat 8: redacesfull ($232.69 in chips) 
Seat 9: er13to ($104.99 in chips) 
redacesfull: posts small blind $0.50
er13to: posts big blind $1
pk4DW: posts the ante $0.20
mzsportline: posts the ante $0.20
VanDobeln: posts the ante $0.20
goransyruvka: posts the ante $0.20
maxxmeister: posts the ante $0.20
matiko09: posts the ante $0.20
redacesfull: posts the ante $0.20
er13to: posts the ante $0.20
*** HOLE CARDS ***
Dealt to matiko09 [4h 5h]
pk4DW: folds 
mzsportline: calls $1
VanDobeln: raises $3 to $4
goransyruvka: calls $4
maxxmeister: folds 
matiko09: calls $4
redacesfull: folds 
er13to: folds 
mzsportline: folds 
*** FLOP *** [Ah Qh 2c]
VanDobeln: checks 
goransyruvka: bets $7.69
matiko09: calls $7.69
VanDobeln: folds 
*** TURN *** [Ah Qh 2c] [5s]
goransyruvka: bets $15.03
matiko09: calls $15.03
*** RIVER *** [Ah Qh 2c 5s] [8h]
goransyruvka: bets $29.38
matiko09: raises $240.88 to $270.26 and is all-in
goransyruvka: folds 
Uncalled bet ($240.88) returned to matiko09
matiko09 collected $117.50 from pot
matiko09: doesn't show hand 
*** SUMMARY ***
Total pot $120.30 | Rake $2.80 
Board [Ah Qh 2c 5s 8h]
Seat 1: pk4DW folded before Flop (didn't bet)
Seat 2: mzsportline folded before Flop
Seat 3: VanDobeln folded on the Flop
Seat 4: goransyruvka folded on the River
Seat 5: maxxmeister folded before Flop (didn't bet)
Seat 7: matiko09 (button) collected ($117.50)
Seat 8: redacesfull (small blind) folded before Flop
Seat 9: er13to (big blind) folded before Flop





PokerStars Hand #148834066379:  Hold'em No Limit ($0.25/$0.50 USD) - 2016/02/15 11:41:28 CET [2016/02/15 5:41:28 ET]
Table 'Vesta II' 9-max Seat #2 is the button
Seat 1: lumen21 ($50 in chips) 
Seat 2: ljryviltj ($50 in chips) 
Seat 3: matiko09 ($66.03 in chips) 
Seat 4: vlad11122007 ($54.03 in chips) 
Seat 6: pandalapa ($50 in chips) 
Seat 7: ruyingren ($36.68 in chips) 
Seat 8: Arystan ($59.26 in chips) 
Seat 9: Aoki42 ($111.35 in chips) 
matiko09: posts small blind $0.25
vlad11122007: posts big blind $0.50
Serhent: sits out 
*** HOLE CARDS ***
Dealt to matiko09 [Qc 7h]
pandalapa: folds 
ruyingren: folds 
Arystan: raises $0.50 to $1
Aoki42: folds 
lumen21: folds 
ljryviltj: folds 
matiko09: folds 
vlad11122007: folds 
Uncalled bet ($0.50) returned to Arystan
Arystan collected $1.25 from pot
Arystan: doesn't show hand 
*** SUMMARY ***
Total pot $1.25 | Rake $0 
Seat 1: lumen21 folded before Flop (didn't bet)
Seat 2: ljryviltj (button) folded before Flop (didn't bet)
Seat 3: matiko09 (small blind) folded before Flop
Seat 4: vlad11122007 (big blind) folded before Flop
Seat 6: pandalapa folded before Flop (didn't bet)
Seat 7: ruyingren folded before Flop (didn't bet)
Seat 8: Arystan collected ($1.25)
Seat 9: Aoki42 folded before Flop (didn't bet)





PokerStars Hand #148834068696:  Hold'em No Limit (€0.50/€1.00 EUR) - 2016/02/15 11:41:33 CET [2016/02/15 5:41:33 ET]
Table 'Ganesa II' 9-max Seat #3 is the button
Seat 1: Apparat888 (€50.57 in chips) 
Seat 2: Venomous100% (€100 in chips) 
Seat 3: BuBu 0187 (€67.14 in chips) 
Seat 4: Sreshta222 (€119.33 in chips) 
Seat 5: AlKatrone (€110.21 in chips) 
Seat 6: matiko09 (€105.08 in chips) 
Seat 7: er13to (€131.41 in chips) 
Seat 8: mycka86 (€100 in chips) 
Seat 9: Priidix (€169.85 in chips) 
Sreshta222: posts small blind €0.50
AlKatrone: posts big blind €1
*** HOLE CARDS ***
Dealt to matiko09 [Kc Qh]
matiko09: raises €2 to €3
er13to: folds 
mycka86: folds 
Priidix: folds 
Apparat888: folds 
Venomous100%: calls €3
BuBu 0187: calls €3
Sreshta222: folds 
AlKatrone: calls €2
*** FLOP *** [5h Ks Td]
AlKatrone: checks 
matiko09: bets €7.76
Venomous100%: folds 
BuBu 0187: folds 
AlKatrone: folds 
Uncalled bet (€7.76) returned to matiko09
matiko09 collected €11.94 from pot
matiko09: doesn't show hand 
*** SUMMARY ***
Total pot €12.50 | Rake €0.56 
Board [5h Ks Td]
Seat 1: Apparat888 folded before Flop (didn't bet)
Seat 2: Venomous100% folded on the Flop
Seat 3: BuBu 0187 (button) folded on the Flop
Seat 4: Sreshta222 (small blind) folded before Flop
Seat 5: AlKatrone (big blind) folded on the Flop
Seat 6: matiko09 collected (€11.94)
Seat 7: er13to folded before Flop (didn't bet)
Seat 8: mycka86 folded before Flop (didn't bet)
Seat 9: Priidix folded before Flop (didn't bet)





PokerStars Hand #148834069436:  Hold'em No Limit ($0.50/$1.00 USD) - 2016/02/15 11:41:34 CET [2016/02/15 5:41:34 ET]
Table 'Anteros' 9-max Seat #1 is the button
Seat 1: redacesfull ($106.77 in chips) 
Seat 2: IHouseMusic ($102.50 in chips) 
Seat 3: er13to ($100 in chips) 
Seat 4: misherei ($176.25 in chips) 
Seat 5: Holm1991 ($41.75 in chips) 
Seat 6: SerAlGog ($152.31 in chips) 
Seat 7: Zoubou1983 ($196.87 in chips) 
Seat 8: matiko09 ($105.86 in chips) 
Seat 9: mycka86 ($102 in chips) 
IHouseMusic: posts small blind $0.50
er13to: posts big blind $1
*** HOLE CARDS ***
Dealt to matiko09 [5h 6h]
misherei: folds 
Holm1991: folds 
SerAlGog: folds 
Zoubou1983: calls $1
matiko09: raises $4 to $5
mycka86: folds 
redacesfull: folds 
IHouseMusic: folds 
er13to: folds 
Zoubou1983: calls $4
*** FLOP *** [9s 7d 3s]
Zoubou1983: bets $11
matiko09: calls $11
*** TURN *** [9s 7d 3s] [Ah]
Zoubou1983: checks 
matiko09: checks 
*** RIVER *** [9s 7d 3s Ah] [Jh]
Zoubou1983: bets $16
matiko09: folds 
Uncalled bet ($16) returned to Zoubou1983
Zoubou1983 collected $31.99 from pot
Zoubou1983: doesn't show hand 
*** SUMMARY ***
Total pot $33.50 | Rake $1.51 
Board [9s 7d 3s Ah Jh]
Seat 1: redacesfull (button) folded before Flop (didn't bet)
Seat 2: IHouseMusic (small blind) folded before Flop
Seat 3: er13to (big blind) folded before Flop
Seat 4: misherei folded before Flop (didn't bet)
Seat 5: Holm1991 folded before Flop (didn't bet)
Seat 6: SerAlGog folded before Flop (didn't bet)
Seat 7: Zoubou1983 collected ($31.99)
Seat 8: matiko09 folded on the River
Seat 9: mycka86 folded before Flop (didn't bet)





PokerStars Hand #148834071182:  Hold'em No Limit ($0.50/$1.00 USD) - 2016/02/15 11:41:38 CET [2016/02/15 5:41:38 ET]
Table 'Urania' 9-max Seat #2 is the button
Seat 1: GRISHANYASHA ($62.69 in chips) 
Seat 2: maxxmeister ($107.07 in chips) 
Seat 4: matiko09 ($110.12 in chips) 
Seat 5: maxonplay ($191.53 in chips) 
Seat 6: skaits ($91 in chips) 
Seat 7: er13to ($101.90 in chips) 
Seat 8: IHouseMusic ($100 in chips) 
Seat 9: mycka86 ($105.12 in chips) 
matiko09: posts small blind $0.50
maxonplay: posts big blind $1
*** HOLE CARDS ***
Dealt to matiko09 [4h Td]
skaits: folds 
er13to: folds 
IHouseMusic: folds 
mycka86: raises $1.50 to $2.50
GRISHANYASHA: folds 
maxxmeister: folds 
matiko09: folds 
maxonplay: folds 
Uncalled bet ($1.50) returned to mycka86
mycka86 collected $2.50 from pot
*** SUMMARY ***
Total pot $2.50 | Rake $0 
Seat 1: GRISHANYASHA folded before Flop (didn't bet)
Seat 2: maxxmeister (button) folded before Flop (didn't bet)
Seat 4: matiko09 (small blind) folded before Flop
Seat 5: maxonplay (big blind) folded before Flop
Seat 6: skaits folded before Flop (didn't bet)
Seat 7: er13to folded before Flop (didn't bet)
Seat 8: IHouseMusic folded before Flop (didn't bet)
Seat 9: mycka86 collected ($2.50)





PokerStars Hand #148834071939:  Hold'em No Limit ($0.50/$1.00 USD) - 2016/02/15 11:41:39 CET [2016/02/15 5:41:39 ET]
Table 'Octans II' 9-max Seat #1 is the button
Seat 1: maxxmeister ($102 in chips) 
Seat 2: matiko09 ($263.21 in chips) 
Seat 3: Aalleekks ($101.50 in chips) 
Seat 4: Venomous100% ($182.14 in chips) 
Seat 6: er13to ($101.50 in chips) 
Seat 7: traficblues ($31.97 in chips) 
Seat 8: IHouseMusic ($135.38 in chips) 
Seat 9: mycka86 ($105.07 in chips) 
matiko09: posts small blind $0.50
Aalleekks: posts big blind $1
gabi_igna: sits out 
*** HOLE CARDS ***
Dealt to matiko09 [Js Ah]
Venomous100%: folds 
er13to: folds 
traficblues: folds 
IHouseMusic: folds 
mycka86: raises $1.10 to $2.10
maxxmeister: calls $2.10
matiko09: raises $7.90 to $10
Aalleekks: folds 
mycka86: folds 
maxxmeister: folds 
Uncalled bet ($7.90) returned to matiko09
matiko09 collected $7.30 from pot
matiko09: doesn't show hand 
*** SUMMARY ***
Total pot $7.30 | Rake $0 
Seat 1: maxxmeister (button) folded before Flop
Seat 2: matiko09 (small blind) collected ($7.30)
Seat 3: Aalleekks (big blind) folded before Flop
Seat 4: Venomous100% folded before Flop (didn't bet)
Seat 6: er13to folded before Flop (didn't bet)
Seat 7: traficblues folded before Flop (didn't bet)
Seat 8: IHouseMusic folded before Flop (didn't bet)
Seat 9: mycka86 folded before Flop





PokerStars Hand #148834074948:  Hold'em No Limit ($0.50/$1.00 USD) - 2016/02/15 11:41:46 CET [2016/02/15 5:41:46 ET]
Table 'Oongaq' 9-max Seat #8 is the button
Seat 1: matiko09 ($103.50 in chips) 
Seat 2: Priidix ($107.91 in chips) 
Seat 3: wilsong96 ($97.08 in chips) 
Seat 5: mn230758 ($51.14 in chips) 
Seat 6: IHouseMusic ($101.71 in chips) 
Seat 7: gwwsb ($81.98 in chips) 
Seat 8: AlKatrone ($104.04 in chips) 
Seat 9: alpw47 ($14.12 in chips) 
alpw47: posts small blind $0.50
matiko09: posts big blind $1
maxxmeister: sits out 
*** HOLE CARDS ***
Dealt to matiko09 [7d Qs]
Priidix: raises $2 to $3
wilsong96: calls $3
mn230758: folds 
IHouseMusic: folds 
gwwsb: folds 
AlKatrone: folds 
alpw47: calls $2.50
matiko09: folds 
*** FLOP *** [4d Ah As]
alpw47: checks 
Priidix: checks 
wilsong96: bets $7
alpw47: folds 
Priidix: folds 
Uncalled bet ($7) returned to wilsong96
wilsong96 collected $9.55 from pot
*** SUMMARY ***
Total pot $10 | Rake $0.45 
Board [4d Ah As]
Seat 1: matiko09 (big blind) folded before Flop
Seat 2: Priidix folded on the Flop
Seat 3: wilsong96 collected ($9.55)
Seat 5: mn230758 folded before Flop (didn't bet)
Seat 6: IHouseMusic folded before Flop (didn't bet)
Seat 7: gwwsb folded before Flop (didn't bet)
Seat 8: AlKatrone (button) folded before Flop (didn't bet)
Seat 9: alpw47 (small blind) folded on the Flop





PokerStars Hand #148834083507:  Hold'em No Limit ($0.50/$1.00 USD) - 2016/02/15 11:42:03 CET [2016/02/15 5:42:03 ET]
Table 'Urania' 9-max Seat #4 is the button
Seat 1: GRISHANYASHA ($62.69 in chips) 
Seat 2: maxxmeister ($107.07 in chips) 
Seat 4: matiko09 ($109.62 in chips) 
Seat 5: maxonplay ($190.53 in chips) 
Seat 7: er13to ($101.90 in chips) 
Seat 8: IHouseMusic ($100 in chips) 
Seat 9: mycka86 ($106.62 in chips) 
maxonplay: posts small blind $0.50
skaits: is sitting out 
er13to: posts big blind $1
*** HOLE CARDS ***
Dealt to matiko09 [Kc 6s]
IHouseMusic: folds 
skaits leaves the table
gabi_igna joins the table at seat #6 
mycka86: raises $2 to $3
GRISHANYASHA: folds 
maxxmeister: folds 
matiko09: folds 
maxonplay: folds 
er13to: folds 
Uncalled bet ($2) returned to mycka86
mycka86 collected $2.50 from pot
*** SUMMARY ***
Total pot $2.50 | Rake $0 
Seat 1: GRISHANYASHA folded before Flop (didn't bet)
Seat 2: maxxmeister folded before Flop (didn't bet)
Seat 4: matiko09 (button) folded before Flop (didn't bet)
Seat 5: maxonplay (small blind) folded before Flop
Seat 7: er13to (big blind) folded before Flop
Seat 8: IHouseMusic folded before Flop (didn't bet)
Seat 9: mycka86 collected ($2.50)





PokerStars Hand #148834087831:  Hold'em No Limit ($0.50/$1.00 USD) - 2016/02/15 11:42:12 CET [2016/02/15 5:42:12 ET]
Table 'Kitalpha II' 9-max Seat #6 is the button
Seat 1: IHouseMusic ($100 in chips) 
Seat 3: matiko09 ($101.86 in chips) 
Seat 4: Sreshta222 ($100 in chips) 
Seat 5: apfush ($100 in chips) 
Seat 6: Congo Sam ($112.88 in chips) 
Seat 7: 4Aces4Roses ($124.90 in chips) 
Seat 8: skram2 ($115.91 in chips) 
Seat 9: Waltz88 ($246.69 in chips) 
4Aces4Roses: posts small blind $0.50
skram2: posts big blind $1
Aalleekks: sits out 
*** HOLE CARDS ***
Dealt to matiko09 [Js 3h]
Waltz88: folds 
IHouseMusic: folds 
matiko09: folds 
Sreshta222: folds 
apfush: raises $1.50 to $2.50
Congo Sam: folds 
4Aces4Roses: calls $2
skram2: folds 
*** FLOP *** [Kh 2d Ts]
4Aces4Roses: checks 
apfush: checks 
*** TURN *** [Kh 2d Ts] [Jd]
4Aces4Roses: bets $4
apfush: raises $9.50 to $13.50
4Aces4Roses: calls $9.50
*** RIVER *** [Kh 2d Ts Jd] [Kc]
4Aces4Roses: bets $42
apfush: folds 
Uncalled bet ($42) returned to 4Aces4Roses
4Aces4Roses collected $31.52 from pot
4Aces4Roses: doesn't show hand 
*** SUMMARY ***
Total pot $33 | Rake $1.48 
Board [Kh 2d Ts Jd Kc]
Seat 1: IHouseMusic folded before Flop (didn't bet)
Seat 3: matiko09 folded before Flop (didn't bet)
Seat 4: Sreshta222 folded before Flop (didn't bet)
Seat 5: apfush folded on the River
Seat 6: Congo Sam (button) folded before Flop (didn't bet)
Seat 7: 4Aces4Roses (small blind) collected ($31.52)
Seat 8: skram2 (big blind) folded before Flop
Seat 9: Waltz88 folded before Flop (didn't bet)





PokerStars Hand #148834090343:  Hold'em No Limit ($0.25/$0.50 USD) - 2016/02/15 11:42:17 CET [2016/02/15 5:42:17 ET]
Table 'Vesta II' 9-max Seat #3 is the button
Seat 1: lumen21 ($50 in chips) 
Seat 2: ljryviltj ($50 in chips) 
Seat 3: matiko09 ($65.78 in chips) 
Seat 4: vlad11122007 ($53.53 in chips) 
Seat 5: Serhent ($50 in chips) 
Seat 6: pandalapa ($50 in chips) 
Seat 7: ruyingren ($36.68 in chips) 
Seat 8: Arystan ($60.01 in chips) 
Seat 9: Aoki42 ($111.35 in chips) 
vlad11122007: posts small blind $0.25
Serhent: posts big blind $0.50
*** HOLE CARDS ***
Dealt to matiko09 [4d Ad]
pandalapa: folds 
ruyingren: folds 
pandalapa leaves the table
Arystan: raises $1 to $1.50
Aoki42: folds 
lumen21: folds 
Gutschel joins the table at seat #6 
ljryviltj: raises $3 to $4.50
matiko09: folds 
vlad11122007: folds 
Serhent: folds 
Arystan: calls $3
*** FLOP *** [6d 3c 7s]
Arystan: bets $4.65
ljryviltj: calls $4.65
*** TURN *** [6d 3c 7s] [4h]
Arystan: checks 
ljryviltj: checks 
*** RIVER *** [6d 3c 7s 4h] [5d]
Arystan: checks 
ljryviltj: bets $7.50
Arystan: folds 
Uncalled bet ($7.50) returned to ljryviltj
ljryviltj collected $18.19 from pot
ljryviltj: doesn't show hand 
*** SUMMARY ***
Total pot $19.05 | Rake $0.86 
Board [6d 3c 7s 4h 5d]
Seat 1: lumen21 folded before Flop (didn't bet)
Seat 2: ljryviltj collected ($18.19)
Seat 3: matiko09 (button) folded before Flop (didn't bet)
Seat 4: vlad11122007 (small blind) folded before Flop
Seat 5: Serhent (big blind) folded before Flop
Seat 6: pandalapa folded before Flop (didn't bet)
Seat 7: ruyingren folded before Flop (didn't bet)
Seat 8: Arystan folded on the River
Seat 9: Aoki42 folded before Flop (didn't bet)





PokerStars Hand #148834095838:  Hold'em No Limit ($0.50/$1.00 USD) - 2016/02/15 11:42:28 CET [2016/02/15 5:42:28 ET]
Table 'Octans II' 9-max Seat #2 is the button
Seat 1: maxxmeister ($100 in chips) 
Seat 2: matiko09 ($268.41 in chips) 
Seat 3: Aalleekks ($100.50 in chips) 
Seat 4: Venomous100% ($182.14 in chips) 
Seat 6: er13to ($101.50 in chips) 
Seat 7: traficblues ($31.97 in chips) 
Seat 8: IHouseMusic ($135.38 in chips) 
Seat 9: mycka86 ($102.97 in chips) 
Aalleekks: posts small blind $0.50
Venomous100%: posts big blind $1
gabi_igna: sits out 
*** HOLE CARDS ***
Dealt to matiko09 [2d Qc]
er13to: folds 
traficblues: calls $1
IHouseMusic: folds 
mycka86: folds 
maxxmeister: raises $3 to $4
matiko09: folds 
Aalleekks: folds 
Venomous100%: folds 
traficblues: folds 
Uncalled bet ($3) returned to maxxmeister
maxxmeister collected $3.50 from pot
maxxmeister: doesn't show hand 
*** SUMMARY ***
Total pot $3.50 | Rake $0 
Seat 1: maxxmeister collected ($3.50)
Seat 2: matiko09 (button) folded before Flop (didn't bet)
Seat 3: Aalleekks (small blind) folded before Flop
Seat 4: Venomous100% (big blind) folded before Flop
Seat 6: er13to folded before Flop (didn't bet)
Seat 7: traficblues folded before Flop
Seat 8: IHouseMusic folded before Flop (didn't bet)
Seat 9: mycka86 folded before Flop (didn't bet)





PokerStars Hand #148834095934:  Hold'em No Limit ($0.50/$1.00 USD) - 2016/02/15 11:42:29 CET [2016/02/15 5:42:29 ET]
Table 'Euanthe II' 9-max Seat #2 is the button
Seat 1: maxxmeister ($127.44 in chips) 
Seat 2: mahalko0925 ($87.38 in chips) 
Seat 3: matiko09 ($106.64 in chips) 
Seat 4: er13to ($112.18 in chips) 
Seat 5: gabi_igna ($186.01 in chips) 
Seat 6: IHouseMusic ($120.91 in chips) 
Seat 7: vinniesmol ($201.93 in chips) 
Seat 8: AlKatrone ($100 in chips) 
Seat 9: Venomous100% ($113.09 in chips) 
matiko09: posts small blind $0.50
er13to: posts big blind $1
*** HOLE CARDS ***
Dealt to matiko09 [7c 9h]
gabi_igna: folds 
IHouseMusic: folds 
vinniesmol: folds 
AlKatrone: folds 
Venomous100%: folds 
maxxmeister: folds 
mahalko0925: folds 
matiko09: folds 
Uncalled bet ($0.50) returned to er13to
er13to collected $1 from pot
*** SUMMARY ***
Total pot $1 | Rake $0 
Seat 1: maxxmeister folded before Flop (didn't bet)
Seat 2: mahalko0925 (button) folded before Flop (didn't bet)
Seat 3: matiko09 (small blind) folded before Flop
Seat 4: er13to (big blind) collected ($1)
Seat 5: gabi_igna folded before Flop (didn't bet)
Seat 6: IHouseMusic folded before Flop (didn't bet)
Seat 7: vinniesmol folded before Flop (didn't bet)
Seat 8: AlKatrone folded before Flop (didn't bet)
Seat 9: Venomous100% folded before Flop (didn't bet)





PokerStars Hand #148834101096:  Hold'em No Limit ($0.50/$1.00 USD) - 2016/02/15 11:42:39 CET [2016/02/15 5:42:39 ET]
Table 'Urania' 9-max Seat #5 is the button
Seat 1: GRISHANYASHA ($62.69 in chips) 
Seat 2: maxxmeister ($107.07 in chips) 
Seat 4: matiko09 ($109.62 in chips) 
Seat 5: maxonplay ($190.03 in chips) 
Seat 7: er13to ($100.90 in chips) 
Seat 9: mycka86 ($108.12 in chips) 
gabi_igna will be allowed to play after the button
er13to: posts small blind $0.50
IHouseMusic: is sitting out 
mycka86: posts big blind $1
*** HOLE CARDS ***
Dealt to matiko09 [7d Ac]
IHouseMusic leaves the table
GRISHANYASHA: folds 
maxxmeister: folds 
apfush joins the table at seat #8 
matiko09: folds 
maxonplay: folds 
er13to: raises $1.50 to $2.50
mycka86: folds 
Uncalled bet ($1.50) returned to er13to
er13to collected $2 from pot
*** SUMMARY ***
Total pot $2 | Rake $0 
Seat 1: GRISHANYASHA folded before Flop (didn't bet)
Seat 2: maxxmeister folded before Flop (didn't bet)
Seat 4: matiko09 folded before Flop (didn't bet)
Seat 5: maxonplay (button) folded before Flop (didn't bet)
Seat 7: er13to (small blind) collected ($2)
Seat 9: mycka86 (big blind) folded before Flop





PokerStars Hand #148834102043:  Hold'em No Limit ($0.50/$1.00 USD) - 2016/02/15 11:42:41 CET [2016/02/15 5:42:41 ET]
Table 'Nata II' 9-max Seat #8 is the button
Seat 2: qqcom ($100 in chips) 
Seat 3: g00000se ($103.45 in chips) 
Seat 4: gabi_igna ($137.70 in chips) 
Seat 5: AGoodFell4 ($46.26 in chips) 
Seat 6: AlKatrone ($140.83 in chips) 
Seat 7: er13to ($100.25 in chips) 
Seat 8: lumen21 ($172.68 in chips) 
Seat 9: matiko09 ($106.80 in chips) 
matiko09: posts small blind $0.50
Priidix: is sitting out 
qqcom: posts big blind $1
*** HOLE CARDS ***
Dealt to matiko09 [4h 3d]
g00000se: folds 
gabi_igna: raises $2 to $3
AGoodFell4: folds 
AlKatrone: folds 
er13to: folds 
lumen21: folds 
matiko09: folds 
qqcom: calls $2
*** FLOP *** [3s 4d Qs]
qqcom: bets $6.21
gabi_igna: calls $6.21
*** TURN *** [3s 4d Qs] [5h]
qqcom: bets $9.03
gabi_igna: calls $9.03
*** RIVER *** [3s 4d Qs 5h] [2s]
qqcom: checks 
gabi_igna: bets $27
qqcom: folds 
Uncalled bet ($27) returned to gabi_igna
gabi_igna collected $35.32 from pot
gabi_igna: doesn't show hand 
*** SUMMARY ***
Total pot $36.98 | Rake $1.66 
Board [3s 4d Qs 5h 2s]
Seat 2: qqcom (big blind) folded on the River
Seat 3: g00000se folded before Flop (didn't bet)
Seat 4: gabi_igna collected ($35.32)
Seat 5: AGoodFell4 folded before Flop (didn't bet)
Seat 6: AlKatrone folded before Flop (didn't bet)
Seat 7: er13to folded before Flop (didn't bet)
Seat 8: lumen21 (button) folded before Flop (didn't bet)
Seat 9: matiko09 (small blind) folded before Flop





PokerStars Hand #148834109177:  Hold'em No Limit ($0.50/$1.00 USD) - 2016/02/15 11:42:56 CET [2016/02/15 5:42:56 ET]
Table 'Corvus III' 9-max Seat #8 is the button
Seat 1: pk4DW ($127.80 in chips) 
Seat 2: mzsportline ($145.54 in chips) 
Seat 3: VanDobeln ($228.29 in chips) 
Seat 4: goransyruvka ($148.67 in chips) 
Seat 5: maxxmeister ($260.12 in chips) 
Seat 7: matiko09 ($358.38 in chips) 
Seat 8: redacesfull ($231.99 in chips) 
Seat 9: er13to ($103.79 in chips) 
er13to: posts small blind $0.50
pk4DW: posts big blind $1
pk4DW: posts the ante $0.20
mzsportline: posts the ante $0.20
VanDobeln: posts the ante $0.20
goransyruvka: posts the ante $0.20
maxxmeister: posts the ante $0.20
matiko09: posts the ante $0.20
redacesfull: posts the ante $0.20
er13to: posts the ante $0.20
*** HOLE CARDS ***
Dealt to matiko09 [Ac As]
mzsportline: raises $2 to $3
VanDobeln: folds 
goransyruvka: calls $3
maxxmeister: folds 
matiko09: raises $12 to $15
redacesfull: folds 
er13to: folds 
pk4DW: folds 
mzsportline: calls $12
goransyruvka: calls $12
*** FLOP *** [6h 9h 3h]
mzsportline: checks 
goransyruvka: bets $22.97
matiko09: calls $22.97
mzsportline: folds 
*** TURN *** [6h 9h 3h] [Jh]
goransyruvka: bets $45.62
matiko09: folds 
Uncalled bet ($45.62) returned to goransyruvka
goransyruvka collected $91.24 from pot
goransyruvka: doesn't show hand 
*** SUMMARY ***
Total pot $94.04 | Rake $2.80 
Board [6h 9h 3h Jh]
Seat 1: pk4DW (big blind) folded before Flop
Seat 2: mzsportline folded on the Flop
Seat 3: VanDobeln folded before Flop (didn't bet)
Seat 4: goransyruvka collected ($91.24)
Seat 5: maxxmeister folded before Flop (didn't bet)
Seat 7: matiko09 folded on the Turn
Seat 8: redacesfull (button) folded before Flop (didn't bet)
Seat 9: er13to (small blind) folded before Flop





PokerStars Hand #148834110685:  Hold'em No Limit ($0.50/$1.00 USD) - 2016/02/15 11:42:59 CET [2016/02/15 5:42:59 ET]
Table 'Euanthe II' 9-max Seat #3 is the button
Seat 1: maxxmeister ($127.44 in chips) 
Seat 2: mahalko0925 ($87.38 in chips) 
Seat 3: matiko09 ($106.14 in chips) 
Seat 4: er13to ($112.68 in chips) 
Seat 5: gabi_igna ($186.01 in chips) 
Seat 6: IHouseMusic ($120.91 in chips) 
Seat 7: vinniesmol ($201.93 in chips) 
Seat 8: AlKatrone ($100 in chips) 
Seat 9: Venomous100% ($113.09 in chips) 
er13to: posts small blind $0.50
gabi_igna: posts big blind $1
*** HOLE CARDS ***
Dealt to matiko09 [Ks 2c]
IHouseMusic: folds 
vinniesmol: folds 
AlKatrone: folds 
Venomous100%: folds 
maxxmeister: folds 
mahalko0925: folds 
matiko09: folds 
er13to: folds 
Uncalled bet ($0.50) returned to gabi_igna
gabi_igna collected $1 from pot
gabi_igna: doesn't show hand 
*** SUMMARY ***
Total pot $1 | Rake $0 
Seat 1: maxxmeister folded before Flop (didn't bet)
Seat 2: mahalko0925 folded before Flop (didn't bet)
Seat 3: matiko09 (button) folded before Flop (didn't bet)
Seat 4: er13to (small blind) folded before Flop
Seat 5: gabi_igna (big blind) collected ($1)
Seat 6: IHouseMusic folded before Flop (didn't bet)
Seat 7: vinniesmol folded before Flop (didn't bet)
Seat 8: AlKatrone folded before Flop (didn't bet)
Seat 9: Venomous100% folded before Flop (didn't bet)





PokerStars Hand #148834110845:  Hold'em No Limit ($0.50/$1.00 USD) - 2016/02/15 11:42:59 CET [2016/02/15 5:42:59 ET]
Table 'Urania' 9-max Seat #7 is the button
Seat 1: GRISHANYASHA ($62.69 in chips) 
Seat 2: maxxmeister ($107.07 in chips) 
Seat 4: matiko09 ($109.62 in chips) 
Seat 5: maxonplay ($190.03 in chips) 
Seat 7: er13to ($101.90 in chips) 
Seat 9: mycka86 ($107.12 in chips) 
apfush will be allowed to play after the button
mycka86: posts small blind $0.50
GRISHANYASHA: posts big blind $1
gabi_igna: sits out 
*** HOLE CARDS ***
Dealt to matiko09 [3s Qc]
maxxmeister: folds 
matiko09: folds 
maxonplay: folds 
er13to: raises $1.50 to $2.50
mycka86: folds 
GRISHANYASHA: calls $1.50
*** FLOP *** [8h 9s Td]
GRISHANYASHA: checks 
er13to: checks 
*** TURN *** [8h 9s Td] [6s]
GRISHANYASHA: checks 
er13to: bets $12.77
GRISHANYASHA: calls $12.77
*** RIVER *** [8h 9s Td 6s] [7d]
GRISHANYASHA: checks 
er13to: checks 
*** SHOW DOWN ***
GRISHANYASHA: shows [7s 8s] (a straight, Six to Ten)
er13to: shows [As Qs] (a straight, Six to Ten)
GRISHANYASHA collected $14.82 from pot
er13to collected $14.82 from pot
*** SUMMARY ***
Total pot $31.04 | Rake $1.40 
Board [8h 9s Td 6s 7d]
Seat 1: GRISHANYASHA (big blind) showed [7s 8s] and won ($14.82) with a straight, Six to Ten
Seat 2: maxxmeister folded before Flop (didn't bet)
Seat 4: matiko09 folded before Flop (didn't bet)
Seat 5: maxonplay folded before Flop (didn't bet)
Seat 7: er13to (button) showed [As Qs] and won ($14.82) with a straight, Six to Ten
Seat 9: mycka86 (small blind) folded before Flop





PokerStars Hand #148834110649:  Hold'em No Limit ($0.50/$1.00 USD) - 2016/02/15 11:42:59 CET [2016/02/15 5:42:59 ET]
Table 'Praecipua' 9-max Seat #7 is the button
Seat 1: er13to ($132.77 in chips) 
Seat 2: matiko09 ($131.31 in chips) 
Seat 3: Venomous100% ($111.14 in chips) 
Seat 4: gabi_igna ($102.50 in chips) 
Seat 5: apfush ($100 in chips) 
Seat 6: mycka86 ($141.07 in chips) 
Seat 7: maxxmeister ($131.02 in chips) 
Seat 8: Ellis Ng ($15.42 in chips) 
Seat 9: AlKatrone ($101.50 in chips) 
Ellis Ng: posts small blind $0.50
AlKatrone: posts big blind $1
*** HOLE CARDS ***
Dealt to matiko09 [4s Jc]
er13to: folds 
matiko09: folds 
Venomous100%: folds 
gabi_igna: folds 
er13to leaves the table
apfush: raises $2 to $3
TomK39 joins the table at seat #1 
mycka86: folds 
maxxmeister: raises $7.50 to $10.50
Ellis Ng: folds 
AlKatrone: folds 
apfush: folds 
Uncalled bet ($7.50) returned to maxxmeister
maxxmeister collected $7.50 from pot
maxxmeister: doesn't show hand 
*** SUMMARY ***
Total pot $7.50 | Rake $0 
Seat 1: er13to folded before Flop (didn't bet)
Seat 2: matiko09 folded before Flop (didn't bet)
Seat 3: Venomous100% folded before Flop (didn't bet)
Seat 4: gabi_igna folded before Flop (didn't bet)
Seat 5: apfush folded before Flop
Seat 6: mycka86 folded before Flop (didn't bet)
Seat 7: maxxmeister (button) collected ($7.50)
Seat 8: Ellis Ng (small blind) folded before Flop
Seat 9: AlKatrone (big blind) folded before Flop





PokerStars Hand #148834113286:  Hold'em No Limit ($0.50/$1.00 USD) - 2016/02/15 11:43:04 CET [2016/02/15 5:43:04 ET]
Table 'Oongaq' 9-max Seat #9 is the button
Seat 1: matiko09 ($102.50 in chips) 
Seat 3: wilsong96 ($103.63 in chips) 
Seat 5: mn230758 ($51.14 in chips) 
Seat 6: IHouseMusic ($101.71 in chips) 
Seat 7: gwwsb ($81.98 in chips) 
Seat 8: AlKatrone ($104.04 in chips) 
Seat 9: alpw47 ($11.12 in chips) 
matiko09: posts small blind $0.50
Priidix: is sitting out 
wilsong96: posts big blind $1
maxxmeister: sits out 
*** HOLE CARDS ***
Dealt to matiko09 [Ac Ts]
mn230758: folds 
IHouseMusic: folds 
gwwsb: folds 
AlKatrone: raises $1.50 to $2.50
alpw47: folds 
matiko09: folds 
wilsong96: folds 
Uncalled bet ($1.50) returned to AlKatrone
AlKatrone collected $2.50 from pot
AlKatrone: doesn't show hand 
*** SUMMARY ***
Total pot $2.50 | Rake $0 
Seat 1: matiko09 (small blind) folded before Flop
Seat 3: wilsong96 (big blind) folded before Flop
Seat 5: mn230758 folded before Flop (didn't bet)
Seat 6: IHouseMusic folded before Flop (didn't bet)
Seat 7: gwwsb folded before Flop (didn't bet)
Seat 8: AlKatrone collected ($2.50)
Seat 9: alpw47 (button) folded before Flop (didn't bet)





PokerStars Hand #148834113929:  Hold'em No Limit ($0.50/$1.00 USD) - 2016/02/15 11:43:05 CET [2016/02/15 5:43:05 ET]
Table 'Octans II' 9-max Seat #3 is the button
Seat 1: maxxmeister ($102.50 in chips) 
Seat 2: matiko09 ($268.41 in chips) 
Seat 3: Aalleekks ($100 in chips) 
Seat 4: Venomous100% ($181.14 in chips) 
Seat 5: gabi_igna ($100 in chips) 
Seat 6: er13to ($101.50 in chips) 
Seat 7: traficblues ($30.97 in chips) 
Seat 8: IHouseMusic ($135.38 in chips) 
Seat 9: mycka86 ($102.97 in chips) 
Venomous100%: posts small blind $0.50
gabi_igna: posts big blind $1
*** HOLE CARDS ***
Dealt to matiko09 [3d Qd]
er13to: folds 
traficblues: folds 
IHouseMusic: folds 
mycka86: folds 
maxxmeister: folds 
matiko09: folds 
Aalleekks: raises $1 to $2
Venomous100%: folds 
gabi_igna: calls $1
*** FLOP *** [5d 8d 4s]
gabi_igna: checks 
Aalleekks: bets $3.87
gabi_igna: calls $3.87
*** TURN *** [5d 8d 4s] [9d]
gabi_igna: checks 
Aalleekks: checks 
*** RIVER *** [5d 8d 4s 9d] [Js]
gabi_igna: bets $5
Aalleekks: calls $5
*** SHOW DOWN ***
gabi_igna: shows [Ks 8c] (a pair of Eights)
Aalleekks: shows [5c 4h] (two pair, Fives and Fours)
Aalleekks collected $21.24 from pot
*** SUMMARY ***
Total pot $22.24 | Rake $1 
Board [5d 8d 4s 9d Js]
Seat 1: maxxmeister folded before Flop (didn't bet)
Seat 2: matiko09 folded before Flop (didn't bet)
Seat 3: Aalleekks (button) showed [5c 4h] and won ($21.24) with two pair, Fives and Fours
Seat 4: Venomous100% (small blind) folded before Flop
Seat 5: gabi_igna (big blind) showed [Ks 8c] and lost with a pair of Eights
Seat 6: er13to folded before Flop (didn't bet)
Seat 7: traficblues folded before Flop (didn't bet)
Seat 8: IHouseMusic folded before Flop (didn't bet)
Seat 9: mycka86 folded before Flop (didn't bet)





PokerStars Hand #148834116977:  Hold'em No Limit ($0.50/$1.00 USD) - 2016/02/15 11:43:12 CET [2016/02/15 5:43:12 ET]
Table 'Anteros' 9-max Seat #2 is the button
Seat 1: redacesfull ($106.77 in chips) 
Seat 2: IHouseMusic ($102 in chips) 
Seat 3: er13to ($100 in chips) 
Seat 4: misherei ($176.25 in chips) 
Seat 5: Holm1991 ($41.75 in chips) 
Seat 6: SerAlGog ($152.31 in chips) 
Seat 7: Zoubou1983 ($212.86 in chips) 
Seat 8: matiko09 ($100 in chips) 
Seat 9: mycka86 ($102 in chips) 
er13to: posts small blind $0.50
misherei: posts big blind $1
*** HOLE CARDS ***
Dealt to matiko09 [4c 6d]
Holm1991: folds 
SerAlGog: folds 
Zoubou1983: folds 
matiko09: folds 
mycka86: folds 
redacesfull: folds 
IHouseMusic: raises $1 to $2
er13to: folds 
misherei: calls $1
*** FLOP *** [Ad 4h As]
misherei: checks 
IHouseMusic: checks 
*** TURN *** [Ad 4h As] [Jc]
misherei: checks 
IHouseMusic: checks 
*** RIVER *** [Ad 4h As Jc] [Jd]
misherei: bets $2
IHouseMusic: calls $2
*** SHOW DOWN ***
misherei: shows [2c 6s] (two pair, Aces and Jacks)
IHouseMusic: shows [9c Ks] (two pair, Aces and Jacks - King kicker)
IHouseMusic collected $8.12 from pot
*** SUMMARY ***
Total pot $8.50 | Rake $0.38 
Board [Ad 4h As Jc Jd]
Seat 1: redacesfull folded before Flop (didn't bet)
Seat 2: IHouseMusic (button) showed [9c Ks] and won ($8.12) with two pair, Aces and Jacks
Seat 3: er13to (small blind) folded before Flop
Seat 4: misherei (big blind) showed [2c 6s] and lost with two pair, Aces and Jacks
Seat 5: Holm1991 folded before Flop (didn't bet)
Seat 6: SerAlGog folded before Flop (didn't bet)
Seat 7: Zoubou1983 folded before Flop (didn't bet)
Seat 8: matiko09 folded before Flop (didn't bet)
Seat 9: mycka86 folded before Flop (didn't bet)





PokerStars Hand #148834117583:  Hold'em No Limit (€0.50/€1.00 EUR) - 2016/02/15 11:43:13 CET [2016/02/15 5:43:13 ET]
Table 'Ganesa II' 9-max Seat #4 is the button
Seat 1: Apparat888 (€50.57 in chips) 
Seat 2: Venomous100% (€100 in chips) 
Seat 3: BuBu 0187 (€64.14 in chips) 
Seat 4: Sreshta222 (€118.83 in chips) 
Seat 5: AlKatrone (€107.21 in chips) 
Seat 6: matiko09 (€114.02 in chips) 
Seat 7: er13to (€131.41 in chips) 
Seat 8: mycka86 (€100 in chips) 
Seat 9: Priidix (€169.85 in chips) 
AlKatrone: posts small blind €0.50
matiko09: posts big blind €1
*** HOLE CARDS ***
Dealt to matiko09 [6s As]
er13to: folds 
mycka86: folds 
Priidix: folds 
Apparat888: folds 
Venomous100%: folds 
BuBu 0187: folds 
Sreshta222: folds 
AlKatrone: raises €2 to €3
matiko09: calls €2
*** FLOP *** [Qs 5h 2d]
AlKatrone: bets €1.94
matiko09: calls €1.94
*** TURN *** [Qs 5h 2d] [4h]
AlKatrone: checks 
matiko09: bets €6.14
AlKatrone: folds 
Uncalled bet (€6.14) returned to matiko09
matiko09 collected €9.44 from pot
matiko09: doesn't show hand 
*** SUMMARY ***
Total pot €9.88 | Rake €0.44 
Board [Qs 5h 2d 4h]
Seat 1: Apparat888 folded before Flop (didn't bet)
Seat 2: Venomous100% folded before Flop (didn't bet)
Seat 3: BuBu 0187 folded before Flop (didn't bet)
Seat 4: Sreshta222 (button) folded before Flop (didn't bet)
Seat 5: AlKatrone (small blind) folded on the Turn
Seat 6: matiko09 (big blind) collected (€9.44)
Seat 7: er13to folded before Flop (didn't bet)
Seat 8: mycka86 folded before Flop (didn't bet)
Seat 9: Priidix folded before Flop (didn't bet)





PokerStars Hand #148834120380:  Hold'em No Limit ($0.50/$1.00 USD) - 2016/02/15 11:43:18 CET [2016/02/15 5:43:18 ET]
Table 'Euanthe II' 9-max Seat #4 is the button
Seat 1: maxxmeister ($127.44 in chips) 
Seat 2: mahalko0925 ($87.38 in chips) 
Seat 3: matiko09 ($106.14 in chips) 
Seat 4: er13to ($112.18 in chips) 
Seat 5: gabi_igna ($186.51 in chips) 
Seat 6: IHouseMusic ($120.91 in chips) 
Seat 7: vinniesmol ($201.93 in chips) 
Seat 8: AlKatrone ($100 in chips) 
Seat 9: Venomous100% ($113.09 in chips) 
gabi_igna: posts small blind $0.50
IHouseMusic: posts big blind $1
*** HOLE CARDS ***
Dealt to matiko09 [6h Qd]
vinniesmol: folds 
AlKatrone: folds 
Venomous100%: folds 
maxxmeister: raises $2 to $3
mahalko0925: folds 
matiko09: folds 
er13to: folds 
gabi_igna: folds 
IHouseMusic: folds 
Uncalled bet ($2) returned to maxxmeister
maxxmeister collected $2.50 from pot
maxxmeister: doesn't show hand 
*** SUMMARY ***
Total pot $2.50 | Rake $0 
Seat 1: maxxmeister collected ($2.50)
Seat 2: mahalko0925 folded before Flop (didn't bet)
Seat 3: matiko09 folded before Flop (didn't bet)
Seat 4: er13to (button) folded before Flop (didn't bet)
Seat 5: gabi_igna (small blind) folded before Flop
Seat 6: IHouseMusic (big blind) folded before Flop
Seat 7: vinniesmol folded before Flop (didn't bet)
Seat 8: AlKatrone folded before Flop (didn't bet)
Seat 9: Venomous100% folded before Flop (didn't bet)





PokerStars Hand #148834130996:  Hold'em No Limit ($0.50/$1.00 USD) - 2016/02/15 11:43:40 CET [2016/02/15 5:43:40 ET]
Table 'Kitalpha II' 9-max Seat #7 is the button
Seat 1: IHouseMusic ($100 in chips) 
Seat 3: matiko09 ($101.86 in chips) 
Seat 4: Sreshta222 ($100 in chips) 
Seat 5: apfush ($100 in chips) 
Seat 6: Congo Sam ($112.88 in chips) 
Seat 7: 4Aces4Roses ($140.42 in chips) 
Seat 8: skram2 ($114.91 in chips) 
Seat 9: Waltz88 ($246.69 in chips) 
skram2: posts small blind $0.50
Waltz88: posts big blind $1
Aalleekks: sits out 
*** HOLE CARDS ***
Dealt to matiko09 [8d 3h]
IHouseMusic: folds 
matiko09: folds 
Sreshta222: folds 
apfush: raises $2 to $3
Congo Sam: folds 
4Aces4Roses: folds 
skram2: folds 
Waltz88: calls $2
*** FLOP *** [7s 2c Jh]
Waltz88: checks 
apfush: bets $4
Waltz88: raises $4 to $8
apfush: calls $4
*** TURN *** [7s 2c Jh] [6s]
Waltz88: checks 
apfush: checks 
*** RIVER *** [7s 2c Jh 6s] [5c]
Waltz88: checks 
apfush: checks 
*** SHOW DOWN ***
Waltz88: shows [Ks 8c] (high card King)
apfush: mucks hand 
Waltz88 collected $21.49 from pot
*** SUMMARY ***
Total pot $22.50 | Rake $1.01 
Board [7s 2c Jh 6s 5c]
Seat 1: IHouseMusic folded before Flop (didn't bet)
Seat 3: matiko09 folded before Flop (didn't bet)
Seat 4: Sreshta222 folded before Flop (didn't bet)
Seat 5: apfush mucked [Qh Th]
Seat 6: Congo Sam folded before Flop (didn't bet)
Seat 7: 4Aces4Roses (button) folded before Flop (didn't bet)
Seat 8: skram2 (small blind) folded before Flop
Seat 9: Waltz88 (big blind) showed [Ks 8c] and won ($21.49) with high card King





PokerStars Hand #148834134931:  Hold'em No Limit ($0.50/$1.00 USD) - 2016/02/15 11:43:48 CET [2016/02/15 5:43:48 ET]
Table 'Oongaq' 9-max Seat #1 is the button
Seat 1: matiko09 ($102 in chips) 
Seat 3: wilsong96 ($102.63 in chips) 
Seat 4: maxxmeister ($100 in chips) 
Seat 5: mn230758 ($51.14 in chips) 
Seat 6: IHouseMusic ($101.71 in chips) 
Seat 7: gwwsb ($81.98 in chips) 
Seat 8: AlKatrone ($105.54 in chips) 
Seat 9: alpw47 ($11.12 in chips) 
wilsong96: posts small blind $0.50
maxxmeister: posts big blind $1
*** HOLE CARDS ***
Dealt to matiko09 [Qc 4h]
mn230758: folds 
IHouseMusic: folds 
gwwsb: folds 
AlKatrone: folds 
alpw47: calls $1
matiko09: folds 
wilsong96: folds 
maxxmeister: checks 
*** FLOP *** [Kd Qd Jd]
maxxmeister: checks 
alpw47: checks 
*** TURN *** [Kd Qd Jd] [2d]
maxxmeister: checks 
alpw47: checks 
*** RIVER *** [Kd Qd Jd 2d] [9d]
maxxmeister: checks 
alpw47: bets $5
maxxmeister: folds 
Uncalled bet ($5) returned to alpw47
alpw47 collected $2.39 from pot
alpw47: doesn't show hand 
*** SUMMARY ***
Total pot $2.50 | Rake $0.11 
Board [Kd Qd Jd 2d 9d]
Seat 1: matiko09 (button) folded before Flop (didn't bet)
Seat 3: wilsong96 (small blind) folded before Flop
Seat 4: maxxmeister (big blind) folded on the River
Seat 5: mn230758 folded before Flop (didn't bet)
Seat 6: IHouseMusic folded before Flop (didn't bet)
Seat 7: gwwsb folded before Flop (didn't bet)
Seat 8: AlKatrone folded before Flop (didn't bet)
Seat 9: alpw47 collected ($2.39)





PokerStars Hand #148834136238:  Hold'em No Limit ($0.50/$1.00 USD) - 2016/02/15 11:43:51 CET [2016/02/15 5:43:51 ET]
Table 'Praecipua' 9-max Seat #8 is the button
Seat 1: TomK39 ($100 in chips) 
Seat 2: matiko09 ($131.31 in chips) 
Seat 3: Venomous100% ($111.14 in chips) 
Seat 4: gabi_igna ($102.50 in chips) 
Seat 5: apfush ($100 in chips) 
Seat 6: mycka86 ($141.07 in chips) 
Seat 7: maxxmeister ($135.52 in chips) 
Seat 8: Ellis Ng ($14.92 in chips) 
Seat 9: AlKatrone ($100.50 in chips) 
AlKatrone: posts small blind $0.50
TomK39: posts big blind $1
*** HOLE CARDS ***
Dealt to matiko09 [6s 5h]
matiko09: folds 
Venomous100%: folds 
gabi_igna: folds 
apfush: folds 
mycka86: folds 
maxxmeister: raises $2.50 to $3.50
Ellis Ng: folds 
AlKatrone: folds 
TomK39: folds 
Uncalled bet ($2.50) returned to maxxmeister
maxxmeister collected $2.50 from pot
maxxmeister: doesn't show hand 
*** SUMMARY ***
Total pot $2.50 | Rake $0 
Seat 1: TomK39 (big blind) folded before Flop
Seat 2: matiko09 folded before Flop (didn't bet)
Seat 3: Venomous100% folded before Flop (didn't bet)
Seat 4: gabi_igna folded before Flop (didn't bet)
Seat 5: apfush folded before Flop (didn't bet)
Seat 6: mycka86 folded before Flop (didn't bet)
Seat 7: maxxmeister collected ($2.50)
Seat 8: Ellis Ng (button) folded before Flop (didn't bet)
Seat 9: AlKatrone (small blind) folded before Flop





PokerStars Hand #148834139137:  Hold'em No Limit ($0.50/$1.00 USD) - 2016/02/15 11:43:57 CET [2016/02/15 5:43:57 ET]
Table 'Urania' 9-max Seat #9 is the button
Seat 1: GRISHANYASHA ($62.24 in chips) 
Seat 2: maxxmeister ($107.07 in chips) 
Seat 4: matiko09 ($109.62 in chips) 
Seat 5: maxonplay ($190.03 in chips) 
Seat 7: er13to ($101.45 in chips) 
Seat 9: mycka86 ($106.62 in chips) 
GRISHANYASHA: posts small blind $0.50
maxxmeister: posts big blind $1
gabi_igna: sits out 
apfush: sits out 
*** HOLE CARDS ***
Dealt to matiko09 [Kh 6c]
matiko09: folds 
maxonplay: folds 
er13to: folds 
mycka86: folds 
GRISHANYASHA: raises $1.47 to $2.47
maxxmeister: raises $4.94 to $7.41
GRISHANYASHA: folds 
Uncalled bet ($4.94) returned to maxxmeister
maxxmeister collected $4.94 from pot
maxxmeister: doesn't show hand 
*** SUMMARY ***
Total pot $4.94 | Rake $0 
Seat 1: GRISHANYASHA (small blind) folded before Flop
Seat 2: maxxmeister (big blind) collected ($4.94)
Seat 4: matiko09 folded before Flop (didn't bet)
Seat 5: maxonplay folded before Flop (didn't bet)
Seat 7: er13to folded before Flop (didn't bet)
Seat 9: mycka86 (button) folded before Flop (didn't bet)





PokerStars Hand #148834139069:  Hold'em No Limit ($0.50/$1.00 USD) - 2016/02/15 11:43:57 CET [2016/02/15 5:43:57 ET]
Table 'Nata II' 9-max Seat #9 is the button
Seat 2: qqcom ($100 in chips) 
Seat 3: g00000se ($103.45 in chips) 
Seat 4: gabi_igna ($154.78 in chips) 
Seat 5: AGoodFell4 ($46.26 in chips) 
Seat 6: AlKatrone ($140.83 in chips) 
Seat 7: er13to ($100.25 in chips) 
Seat 8: lumen21 ($172.68 in chips) 
Seat 9: matiko09 ($106.30 in chips) 
qqcom: posts small blind $0.50
g00000se: posts big blind $1
*** HOLE CARDS ***
Dealt to matiko09 [3d Ts]
gabi_igna: raises $2 to $3
AGoodFell4: calls $3
AlKatrone: folds 
er13to: folds 
lumen21: folds 
matiko09: folds 
qqcom: folds 
g00000se: folds 
*** FLOP *** [6h Kc 3s]
gabi_igna: bets $4
AGoodFell4: folds 
Uncalled bet ($4) returned to gabi_igna
gabi_igna collected $7.16 from pot
gabi_igna: doesn't show hand 
*** SUMMARY ***
Total pot $7.50 | Rake $0.34 
Board [6h Kc 3s]
Seat 2: qqcom (small blind) folded before Flop
Seat 3: g00000se (big blind) folded before Flop
Seat 4: gabi_igna collected ($7.16)
Seat 5: AGoodFell4 folded on the Flop
Seat 6: AlKatrone folded before Flop (didn't bet)
Seat 7: er13to folded before Flop (didn't bet)
Seat 8: lumen21 folded before Flop (didn't bet)
Seat 9: matiko09 (button) folded before Flop (didn't bet)





PokerStars Hand #148834141961:  Hold'em No Limit ($0.50/$1.00 USD) - 2016/02/15 11:44:03 CET [2016/02/15 5:44:03 ET]
Table 'Euanthe II' 9-max Seat #5 is the button
Seat 1: maxxmeister ($128.94 in chips) 
Seat 2: mahalko0925 ($87.38 in chips) 
Seat 3: matiko09 ($106.14 in chips) 
Seat 4: er13to ($112.18 in chips) 
Seat 5: gabi_igna ($186.01 in chips) 
Seat 6: IHouseMusic ($119.91 in chips) 
Seat 7: vinniesmol ($201.93 in chips) 
Seat 8: AlKatrone ($100 in chips) 
Seat 9: Venomous100% ($113.09 in chips) 
IHouseMusic: posts small blind $0.50
vinniesmol: posts big blind $1
*** HOLE CARDS ***
Dealt to matiko09 [9d 5h]
AlKatrone: folds 
Venomous100%: folds 
maxxmeister: folds 
mahalko0925: folds 
matiko09: folds 
er13to: folds 
gabi_igna: raises $1.50 to $2.50
IHouseMusic: folds 
vinniesmol: calls $1.50
*** FLOP *** [Tc 8s 5s]
vinniesmol: checks 
gabi_igna: bets $3
vinniesmol: calls $3
*** TURN *** [Tc 8s 5s] [2d]
vinniesmol: checks 
gabi_igna: checks 
*** RIVER *** [Tc 8s 5s 2d] [7d]
vinniesmol: bets $6
gabi_igna: calls $6
*** SHOW DOWN ***
vinniesmol: shows [Ts Qc] (a pair of Tens)
gabi_igna: mucks hand 
vinniesmol collected $22.44 from pot
*** SUMMARY ***
Total pot $23.50 | Rake $1.06 
Board [Tc 8s 5s 2d 7d]
Seat 1: maxxmeister folded before Flop (didn't bet)
Seat 2: mahalko0925 folded before Flop (didn't bet)
Seat 3: matiko09 folded before Flop (didn't bet)
Seat 4: er13to folded before Flop (didn't bet)
Seat 5: gabi_igna (button) mucked [8h 4h]
Seat 6: IHouseMusic (small blind) folded before Flop
Seat 7: vinniesmol (big blind) showed [Ts Qc] and won ($22.44) with a pair of Tens
Seat 8: AlKatrone folded before Flop (didn't bet)
Seat 9: Venomous100% folded before Flop (didn't bet)





PokerStars Hand #148834147183:  Hold'em No Limit ($0.25/$0.50 USD) - 2016/02/15 11:44:13 CET [2016/02/15 5:44:13 ET]
Table 'Vesta II' 9-max Seat #4 is the button
Seat 1: lumen21 ($50 in chips) 
Seat 2: ljryviltj ($59.04 in chips) 
Seat 3: matiko09 ($65.78 in chips) 
Seat 4: vlad11122007 ($53.28 in chips) 
Seat 5: Serhent ($50 in chips) 
Seat 6: Gutschel ($50 in chips) 
Seat 7: ruyingren ($36.68 in chips) 
Seat 8: Arystan ($50.86 in chips) 
Seat 9: Aoki42 ($111.35 in chips) 
Serhent: posts small blind $0.25
Gutschel: posts big blind $0.50
*** HOLE CARDS ***
Dealt to matiko09 [Kd Th]
ruyingren: folds 
Arystan: folds 
Aoki42: folds 
lumen21: folds 
ljryviltj: raises $1 to $1.50
matiko09: folds 
vlad11122007: folds 
Serhent: folds 
Gutschel: folds 
Uncalled bet ($1) returned to ljryviltj
ljryviltj collected $1.25 from pot
ljryviltj: doesn't show hand 
*** SUMMARY ***
Total pot $1.25 | Rake $0 
Seat 1: lumen21 folded before Flop (didn't bet)
Seat 2: ljryviltj collected ($1.25)
Seat 3: matiko09 folded before Flop (didn't bet)
Seat 4: vlad11122007 (button) folded before Flop (didn't bet)
Seat 5: Serhent (small blind) folded before Flop
Seat 6: Gutschel (big blind) folded before Flop
Seat 7: ruyingren folded before Flop (didn't bet)
Seat 8: Arystan folded before Flop (didn't bet)
Seat 9: Aoki42 folded before Flop (didn't bet)





PokerStars Hand #148834148554:  Hold'em No Limit ($0.50/$1.00 USD) - 2016/02/15 11:44:16 CET [2016/02/15 5:44:16 ET]
Table 'Octans II' 9-max Seat #4 is the button
Seat 1: maxxmeister ($102.50 in chips) 
Seat 2: matiko09 ($268.41 in chips) 
Seat 3: Aalleekks ($110.37 in chips) 
Seat 4: Venomous100% ($180.64 in chips) 
Seat 5: gabi_igna ($100 in chips) 
Seat 6: er13to ($101.50 in chips) 
Seat 7: traficblues ($30.97 in chips) 
Seat 8: IHouseMusic ($135.38 in chips) 
Seat 9: mycka86 ($102.97 in chips) 
gabi_igna: posts small blind $0.50
er13to: posts big blind $1
*** HOLE CARDS ***
Dealt to matiko09 [Qs 3c]
traficblues: calls $1
IHouseMusic: folds 
mycka86: folds 
maxxmeister: raises $1 to $2
matiko09: folds 
Aalleekks: folds 
Venomous100%: raises $5 to $7
gabi_igna: folds 
er13to: folds 
traficblues: folds 
maxxmeister: calls $5
*** FLOP *** [Js Qc Qh]
maxxmeister: checks 
Venomous100%: bets $10.50
maxxmeister: folds 
Uncalled bet ($10.50) returned to Venomous100%
Venomous100% collected $15.76 from pot
Venomous100%: doesn't show hand 
*** SUMMARY ***
Total pot $16.50 | Rake $0.74 
Board [Js Qc Qh]
Seat 1: maxxmeister folded on the Flop
Seat 2: matiko09 folded before Flop (didn't bet)
Seat 3: Aalleekks folded before Flop (didn't bet)
Seat 4: Venomous100% (button) collected ($15.76)
Seat 5: gabi_igna (small blind) folded before Flop
Seat 6: er13to (big blind) folded before Flop
Seat 7: traficblues folded before Flop
Seat 8: IHouseMusic folded before Flop (didn't bet)
Seat 9: mycka86 folded before Flop (didn't bet)





PokerStars Hand #148834148382:  Hold'em No Limit ($0.50/$1.00 USD) - 2016/02/15 11:44:16 CET [2016/02/15 5:44:16 ET]
Table 'Anteros' 9-max Seat #3 is the button
Seat 1: redacesfull ($106.77 in chips) 
Seat 2: IHouseMusic ($106.12 in chips) 
Seat 3: er13to ($100 in chips) 
Seat 4: misherei ($172.25 in chips) 
Seat 5: Holm1991 ($41.75 in chips) 
Seat 6: SerAlGog ($152.31 in chips) 
Seat 7: Zoubou1983 ($212.86 in chips) 
Seat 8: matiko09 ($100 in chips) 
Seat 9: mycka86 ($102 in chips) 
misherei: posts small blind $0.50
Holm1991: posts big blind $1
*** HOLE CARDS ***
Dealt to matiko09 [3d 4c]
SerAlGog: folds 
Zoubou1983: calls $1
matiko09: folds 
mycka86: folds 
redacesfull: folds 
IHouseMusic: folds 
er13to: raises $3.20 to $4.20
misherei: folds 
Holm1991: folds 
Zoubou1983: folds 
Uncalled bet ($3.20) returned to er13to
er13to collected $3.50 from pot
*** SUMMARY ***
Total pot $3.50 | Rake $0 
Seat 1: redacesfull folded before Flop (didn't bet)
Seat 2: IHouseMusic folded before Flop (didn't bet)
Seat 3: er13to (button) collected ($3.50)
Seat 4: misherei (small blind) folded before Flop
Seat 5: Holm1991 (big blind) folded before Flop
Seat 6: SerAlGog folded before Flop (didn't bet)
Seat 7: Zoubou1983 folded before Flop
Seat 8: matiko09 folded before Flop (didn't bet)
Seat 9: mycka86 folded before Flop (didn't bet)





PokerStars Hand #148834151942:  Hold'em No Limit ($0.50/$1.00 USD) - 2016/02/15 11:44:23 CET [2016/02/15 5:44:23 ET]
Table 'Urania' 9-max Seat #1 is the button
Seat 1: GRISHANYASHA ($59.77 in chips) 
Seat 2: maxxmeister ($109.54 in chips) 
Seat 4: matiko09 ($109.62 in chips) 
Seat 5: maxonplay ($190.03 in chips) 
Seat 7: er13to ($101.45 in chips) 
Seat 9: mycka86 ($106.62 in chips) 
maxxmeister: posts small blind $0.50
matiko09: posts big blind $1
gabi_igna: sits out 
apfush: sits out 
*** HOLE CARDS ***
Dealt to matiko09 [6s 8h]
maxonplay: folds 
er13to: folds 
mycka86: raises $1.10 to $2.10
GRISHANYASHA: folds 
maxxmeister: folds 
matiko09: folds 
Uncalled bet ($1.10) returned to mycka86
mycka86 collected $2.50 from pot
*** SUMMARY ***
Total pot $2.50 | Rake $0 
Seat 1: GRISHANYASHA (button) folded before Flop (didn't bet)
Seat 2: maxxmeister (small blind) folded before Flop
Seat 4: matiko09 (big blind) folded before Flop
Seat 5: maxonplay folded before Flop (didn't bet)
Seat 7: er13to folded before Flop (didn't bet)
Seat 9: mycka86 collected ($2.50)





PokerStars Hand #148834152538:  Hold'em No Limit ($0.50/$1.00 USD) - 2016/02/15 11:44:24 CET [2016/02/15 5:44:24 ET]
Table 'Corvus III' 9-max Seat #9 is the button
Seat 1: pk4DW ($126.60 in chips) 
Seat 2: mzsportline ($130.34 in chips) 
Seat 3: VanDobeln ($228.09 in chips) 
Seat 4: goransyruvka ($201.74 in chips) 
Seat 5: maxxmeister ($259.92 in chips) 
Seat 7: matiko09 ($320.21 in chips) 
Seat 8: redacesfull ($231.79 in chips) 
Seat 9: er13to ($103.09 in chips) 
pk4DW: posts small blind $0.50
mzsportline: posts big blind $1
pk4DW: posts the ante $0.20
mzsportline: posts the ante $0.20
VanDobeln: posts the ante $0.20
goransyruvka: posts the ante $0.20
maxxmeister: posts the ante $0.20
matiko09: posts the ante $0.20
redacesfull: posts the ante $0.20
er13to: posts the ante $0.20
*** HOLE CARDS ***
Dealt to matiko09 [2c Td]
VanDobeln: raises $2 to $3
goransyruvka: folds 
maxxmeister: folds 
matiko09: folds 
redacesfull: calls $3
er13to: folds 
pk4DW: folds 
mzsportline: folds 
*** FLOP *** [Kc 6c Js]
VanDobeln: bets $5
redacesfull: calls $5
*** TURN *** [Kc 6c Js] [8c]
VanDobeln: checks 
redacesfull: bets $12.77
VanDobeln: calls $12.77
*** RIVER *** [Kc 6c Js 8c] [7d]
VanDobeln: checks 
redacesfull: bets $42.63
goransyruvka is disconnected 
VanDobeln: folds 
Uncalled bet ($42.63) returned to redacesfull
redacesfull collected $42.63 from pot
redacesfull: doesn't show hand 
*** SUMMARY ***
Total pot $44.64 | Rake $2.01 
Board [Kc 6c Js 8c 7d]
Seat 1: pk4DW (small blind) folded before Flop
Seat 2: mzsportline (big blind) folded before Flop
Seat 3: VanDobeln folded on the River
Seat 4: goransyruvka folded before Flop (didn't bet)
Seat 5: maxxmeister folded before Flop (didn't bet)
Seat 7: matiko09 folded before Flop (didn't bet)
Seat 8: redacesfull collected ($42.63)
Seat 9: er13to (button) folded before Flop (didn't bet)





PokerStars Hand #148834153774:  Hold'em No Limit ($0.50/$1.00 USD) - 2016/02/15 11:44:27 CET [2016/02/15 5:44:27 ET]
Table 'Praecipua' 9-max Seat #9 is the button
Seat 1: TomK39 ($100 in chips) 
Seat 2: matiko09 ($131.31 in chips) 
Seat 3: Venomous100% ($111.14 in chips) 
Seat 4: gabi_igna ($102.50 in chips) 
Seat 5: apfush ($100 in chips) 
Seat 6: mycka86 ($141.07 in chips) 
Seat 7: maxxmeister ($137.02 in chips) 
Seat 8: Ellis Ng ($14.92 in chips) 
Seat 9: AlKatrone ($100 in chips) 
TomK39: posts small blind $0.50
matiko09: posts big blind $1
*** HOLE CARDS ***
Dealt to matiko09 [Qs Jh]
Venomous100%: folds 
Venomous100% leaves the table
gabi_igna: raises $2 to $3
apfush: folds 
mycka86: folds 
maxxmeister: folds 
Ellis Ng: folds 
AlKatrone: folds 
TomK39: folds 
matiko09: folds 
Uncalled bet ($2) returned to gabi_igna
gabi_igna collected $2.50 from pot
gabi_igna: doesn't show hand 
*** SUMMARY ***
Total pot $2.50 | Rake $0 
Seat 1: TomK39 (small blind) folded before Flop
Seat 2: matiko09 (big blind) folded before Flop
Seat 3: Venomous100% folded before Flop (didn't bet)
Seat 4: gabi_igna collected ($2.50)
Seat 5: apfush folded before Flop (didn't bet)
Seat 6: mycka86 folded before Flop (didn't bet)
Seat 7: maxxmeister folded before Flop (didn't bet)
Seat 8: Ellis Ng folded before Flop (didn't bet)
Seat 9: AlKatrone (button) folded before Flop (didn't bet)





PokerStars Hand #148834162569:  Hold'em No Limit ($0.50/$1.00 USD) - 2016/02/15 11:44:45 CET [2016/02/15 5:44:45 ET]
Table 'Nata II' 9-max Seat #2 is the button
Seat 2: qqcom ($100 in chips) 
Seat 3: g00000se ($102.45 in chips) 
Seat 4: gabi_igna ($158.94 in chips) 
Seat 5: AGoodFell4 ($43.26 in chips) 
Seat 6: AlKatrone ($140.83 in chips) 
Seat 7: er13to ($100.25 in chips) 
Seat 8: lumen21 ($172.68 in chips) 
Seat 9: matiko09 ($106.30 in chips) 
g00000se: posts small blind $0.50
gabi_igna: posts big blind $1
*** HOLE CARDS ***
Dealt to matiko09 [9h Jc]
AGoodFell4: raises $2 to $3
AlKatrone: folds 
er13to: folds 
lumen21: folds 
matiko09: folds 
qqcom: calls $3
g00000se: folds 
gabi_igna: folds 
*** FLOP *** [3h Jd 8h]
AGoodFell4: checks 
qqcom: bets $7.16
AGoodFell4: raises $7.16 to $14.32
qqcom: raises $7.16 to $21.48
AGoodFell4: calls $7.16
*** TURN *** [3h Jd 8h] [Qh]
AGoodFell4: bets $18.78 and is all-in
qqcom: folds 
Uncalled bet ($18.78) returned to AGoodFell4
AGoodFell4 collected $48.19 from pot
AGoodFell4: doesn't show hand 
*** SUMMARY ***
Total pot $50.46 | Rake $2.27 
Board [3h Jd 8h Qh]
Seat 2: qqcom (button) folded on the Turn
Seat 3: g00000se (small blind) folded before Flop
Seat 4: gabi_igna (big blind) folded before Flop
Seat 5: AGoodFell4 collected ($48.19)
Seat 6: AlKatrone folded before Flop (didn't bet)
Seat 7: er13to folded before Flop (didn't bet)
Seat 8: lumen21 folded before Flop (didn't bet)
Seat 9: matiko09 folded before Flop (didn't bet)





PokerStars Hand #148834163553:  Hold'em No Limit ($0.25/$0.50 USD) - 2016/02/15 11:44:47 CET [2016/02/15 5:44:47 ET]
Table 'Vesta II' 9-max Seat #5 is the button
Seat 1: lumen21 ($50 in chips) 
Seat 2: ljryviltj ($59.79 in chips) 
Seat 3: matiko09 ($65.78 in chips) 
Seat 4: vlad11122007 ($53.28 in chips) 
Seat 5: Serhent ($50 in chips) 
Seat 6: Gutschel ($50 in chips) 
Seat 7: ruyingren ($36.68 in chips) 
Seat 8: Arystan ($50.86 in chips) 
Seat 9: Aoki42 ($111.35 in chips) 
Gutschel: posts small blind $0.25
ruyingren: posts big blind $0.50
*** HOLE CARDS ***
Dealt to matiko09 [9d 7h]
Arystan: raises $1 to $1.50
Aoki42: folds 
lumen21: folds 
ljryviltj: folds 
matiko09: folds 
vlad11122007: folds 
Serhent: folds 
Gutschel: folds 
ruyingren: folds 
Uncalled bet ($1) returned to Arystan
Arystan collected $1.25 from pot
Arystan: doesn't show hand 
*** SUMMARY ***
Total pot $1.25 | Rake $0 
Seat 1: lumen21 folded before Flop (didn't bet)
Seat 2: ljryviltj folded before Flop (didn't bet)
Seat 3: matiko09 folded before Flop (didn't bet)
Seat 4: vlad11122007 folded before Flop (didn't bet)
Seat 5: Serhent (button) folded before Flop (didn't bet)
Seat 6: Gutschel (small blind) folded before Flop
Seat 7: ruyingren (big blind) folded before Flop
Seat 8: Arystan collected ($1.25)
Seat 9: Aoki42 folded before Flop (didn't bet)





PokerStars Hand #148834164620:  Hold'em No Limit ($0.50/$1.00 USD) - 2016/02/15 11:44:49 CET [2016/02/15 5:44:49 ET]
Table 'Urania' 9-max Seat #2 is the button
Seat 1: GRISHANYASHA ($59.77 in chips) 
Seat 2: maxxmeister ($109.04 in chips) 
Seat 4: matiko09 ($108.62 in chips) 
Seat 5: maxonplay ($190.03 in chips) 
Seat 7: er13to ($101.45 in chips) 
Seat 9: mycka86 ($108.12 in chips) 
matiko09: posts small blind $0.50
maxonplay: posts big blind $1
gabi_igna: sits out 
apfush: sits out 
*** HOLE CARDS ***
Dealt to matiko09 [2d Ah]
er13to: folds 
mycka86: folds 
GRISHANYASHA: folds 
maxxmeister: raises $2.50 to $3.50
matiko09: folds 
maxonplay: calls $2.50
*** FLOP *** [5c Qh Qd]
maxonplay: checks 
maxxmeister: checks 
*** TURN *** [5c Qh Qd] [4d]
maxonplay: bets $3.58
maxxmeister: calls $3.58
*** RIVER *** [5c Qh Qd 4d] [3h]
maxonplay: checks 
maxxmeister: checks 
*** SHOW DOWN ***
maxonplay: shows [8d As] (a pair of Queens)
maxxmeister: shows [Ac Td] (a pair of Queens - Ace+Ten kicker)
maxxmeister collected $14 from pot
*** SUMMARY ***
Total pot $14.66 | Rake $0.66 
Board [5c Qh Qd 4d 3h]
Seat 1: GRISHANYASHA folded before Flop (didn't bet)
Seat 2: maxxmeister (button) showed [Ac Td] and won ($14) with a pair of Queens
Seat 4: matiko09 (small blind) folded before Flop
Seat 5: maxonplay (big blind) showed [8d As] and lost with a pair of Queens
Seat 7: er13to folded before Flop (didn't bet)
Seat 9: mycka86 folded before Flop (didn't bet)





PokerStars Hand #148834166424:  Hold'em No Limit ($0.50/$1.00 USD) - 2016/02/15 11:44:52 CET [2016/02/15 5:44:52 ET]
Table 'Praecipua' 9-max Seat #1 is the button
Seat 1: TomK39 ($100 in chips) 
Seat 2: matiko09 ($130.31 in chips) 
Seat 4: gabi_igna ($104 in chips) 
Seat 5: apfush ($100 in chips) 
Seat 6: mycka86 ($141.07 in chips) 
Seat 7: maxxmeister ($137.02 in chips) 
Seat 8: Ellis Ng ($14.92 in chips) 
Seat 9: AlKatrone ($100 in chips) 
matiko09: posts small blind $0.50
gabi_igna: posts big blind $1
*** HOLE CARDS ***
Dealt to matiko09 [5c 4s]
apfush: raises $2 to $3
mycka86: folds 
maxxmeister: calls $3
Ellis Ng: folds 
AlKatrone: folds 
TomK39: folds 
matiko09: folds 
gabi_igna: folds 
*** FLOP *** [5h 8s 2h]
J0k3rF4c3_FD joins the table at seat #3 
apfush: bets $5
maxxmeister: calls $5
*** TURN *** [5h 8s 2h] [6d]
apfush: bets $11.50
maxxmeister: calls $11.50
*** RIVER *** [5h 8s 2h 6d] [Th]
apfush: checks 
maxxmeister: bets $24
apfush: folds 
Uncalled bet ($24) returned to maxxmeister
maxxmeister collected $38.68 from pot
maxxmeister: doesn't show hand 
*** SUMMARY ***
Total pot $40.50 | Rake $1.82 
Board [5h 8s 2h 6d Th]
Seat 1: TomK39 (button) folded before Flop (didn't bet)
Seat 2: matiko09 (small blind) folded before Flop
Seat 4: gabi_igna (big blind) folded before Flop
Seat 5: apfush folded on the River
Seat 6: mycka86 folded before Flop (didn't bet)
Seat 7: maxxmeister collected ($38.68)
Seat 8: Ellis Ng folded before Flop (didn't bet)
Seat 9: AlKatrone folded before Flop (didn't bet)





PokerStars Hand #148834167504:  Hold'em No Limit ($0.50/$1.00 USD) - 2016/02/15 11:44:55 CET [2016/02/15 5:44:55 ET]
Table 'Anteros' 9-max Seat #4 is the button
Seat 1: redacesfull ($106.77 in chips) 
Seat 2: IHouseMusic ($106.12 in chips) 
Seat 3: er13to ($102.50 in chips) 
Seat 4: misherei ($171.75 in chips) 
Seat 5: Holm1991 ($40.75 in chips) 
Seat 6: SerAlGog ($152.31 in chips) 
Seat 7: Zoubou1983 ($211.86 in chips) 
Seat 8: matiko09 ($100 in chips) 
Seat 9: mycka86 ($102 in chips) 
Holm1991: posts small blind $0.50
SerAlGog: posts big blind $1
*** HOLE CARDS ***
Dealt to matiko09 [Td 2c]
Zoubou1983: folds 
matiko09: folds 
mycka86: folds 
redacesfull: raises $1.12 to $2.12
IHouseMusic: folds 
er13to: raises $5.88 to $8
misherei: folds 
Holm1991: folds 
SerAlGog: folds 
redacesfull: raises $12 to $20
er13to: calls $12
*** FLOP *** [Th 4d Kc]
redacesfull: bets $21
er13to: folds 
Uncalled bet ($21) returned to redacesfull
redacesfull collected $39.63 from pot
redacesfull: doesn't show hand 
*** SUMMARY ***
Total pot $41.50 | Rake $1.87 
Board [Th 4d Kc]
Seat 1: redacesfull collected ($39.63)
Seat 2: IHouseMusic folded before Flop (didn't bet)
Seat 3: er13to folded on the Flop
Seat 4: misherei (button) folded before Flop (didn't bet)
Seat 5: Holm1991 (small blind) folded before Flop
Seat 6: SerAlGog (big blind) folded before Flop
Seat 7: Zoubou1983 folded before Flop (didn't bet)
Seat 8: matiko09 folded before Flop (didn't bet)
Seat 9: mycka86 folded before Flop (didn't bet)





PokerStars Hand #148834168404:  Hold'em No Limit ($0.50/$1.00 USD) - 2016/02/15 11:44:56 CET [2016/02/15 5:44:56 ET]
Table 'Euanthe II' 9-max Seat #6 is the button
Seat 1: maxxmeister ($128.94 in chips) 
Seat 2: mahalko0925 ($87.38 in chips) 
Seat 3: matiko09 ($106.14 in chips) 
Seat 4: er13to ($112.18 in chips) 
Seat 5: gabi_igna ($174.51 in chips) 
Seat 6: IHouseMusic ($119.41 in chips) 
Seat 7: vinniesmol ($212.87 in chips) 
Seat 8: AlKatrone ($100 in chips) 
Seat 9: Venomous100% ($113.09 in chips) 
vinniesmol: posts small blind $0.50
AlKatrone: posts big blind $1
*** HOLE CARDS ***
Dealt to matiko09 [5d Kc]
Venomous100%: folds 
maxxmeister: folds 
mahalko0925: folds 
matiko09: folds 
er13to: folds 
gabi_igna: folds 
IHouseMusic: folds 
vinniesmol: folds 
Uncalled bet ($0.50) returned to AlKatrone
AlKatrone collected $1 from pot
AlKatrone: doesn't show hand 
*** SUMMARY ***
Total pot $1 | Rake $0 
Seat 1: maxxmeister folded before Flop (didn't bet)
Seat 2: mahalko0925 folded before Flop (didn't bet)
Seat 3: matiko09 folded before Flop (didn't bet)
Seat 4: er13to folded before Flop (didn't bet)
Seat 5: gabi_igna folded before Flop (didn't bet)
Seat 6: IHouseMusic (button) folded before Flop (didn't bet)
Seat 7: vinniesmol (small blind) folded before Flop
Seat 8: AlKatrone (big blind) collected ($1)
Seat 9: Venomous100% folded before Flop (didn't bet)





PokerStars Hand #148834171360:  Hold'em No Limit ($0.50/$1.00 USD) - 2016/02/15 11:45:02 CET [2016/02/15 5:45:02 ET]
Table 'Kitalpha II' 9-max Seat #8 is the button
Seat 1: IHouseMusic ($100 in chips) 
Seat 3: matiko09 ($101.86 in chips) 
Seat 4: Sreshta222 ($100 in chips) 
Seat 5: apfush ($100 in chips) 
Seat 6: Congo Sam ($112.88 in chips) 
Seat 7: 4Aces4Roses ($140.42 in chips) 
Seat 8: skram2 ($114.41 in chips) 
Seat 9: Waltz88 ($257.18 in chips) 
Waltz88: posts small blind $0.50
IHouseMusic: posts big blind $1
Aalleekks: sits out 
*** HOLE CARDS ***
Dealt to matiko09 [3h Js]
matiko09: folds 
Sreshta222: folds 
apfush: folds 
Congo Sam: folds 
4Aces4Roses: raises $2 to $3
skram2: folds 
Waltz88: calls $2.50
IHouseMusic: folds 
*** FLOP *** [9h 6h Th]
Waltz88: checks 
4Aces4Roses: bets $4
Waltz88: calls $4
*** TURN *** [9h 6h Th] [As]
Waltz88: checks 
4Aces4Roses: bets $5
Waltz88: calls $5
*** RIVER *** [9h 6h Th As] [Ad]
Waltz88: checks 
4Aces4Roses: bets $23
Waltz88: folds [Kh]
Uncalled bet ($23) returned to 4Aces4Roses
4Aces4Roses collected $23.88 from pot
4Aces4Roses: doesn't show hand 
*** SUMMARY ***
Total pot $25 | Rake $1.12 
Board [9h 6h Th As Ad]
Seat 1: IHouseMusic (big blind) folded before Flop
Seat 3: matiko09 folded before Flop (didn't bet)
Seat 4: Sreshta222 folded before Flop (didn't bet)
Seat 5: apfush folded before Flop (didn't bet)
Seat 6: Congo Sam folded before Flop (didn't bet)
Seat 7: 4Aces4Roses collected ($23.88)
Seat 8: skram2 (button) folded before Flop (didn't bet)
Seat 9: Waltz88 (small blind) folded on the River





PokerStars Hand #148834171379:  Hold'em No Limit (€0.50/€1.00 EUR) - 2016/02/15 11:45:02 CET [2016/02/15 5:45:02 ET]
Table 'Ganesa II' 9-max Seat #5 is the button
Seat 1: Apparat888 (€50.57 in chips) 
Seat 2: Venomous100% (€100 in chips) 
Seat 3: BuBu 0187 (€64.14 in chips) 
Seat 4: Sreshta222 (€118.83 in chips) 
Seat 5: AlKatrone (€102.27 in chips) 
Seat 6: matiko09 (€118.52 in chips) 
Seat 7: er13to (€131.41 in chips) 
Seat 8: mycka86 (€100 in chips) 
matiko09: posts small blind €0.50
er13to: posts big blind €1
*** HOLE CARDS ***
Dealt to matiko09 [3s Jh]
mycka86: raises €2 to €3
Apparat888: folds 
Venomous100%: folds 
BuBu 0187: calls €3
Sreshta222: folds 
AlKatrone: folds 
matiko09: folds 
er13to: folds 
*** FLOP *** [Jc 5c 7s]
mycka86: bets €4.50
BuBu 0187: calls €4.50
*** TURN *** [Jc 5c 7s] [5s]
mycka86: bets €8.66
BuBu 0187: calls €8.66
*** RIVER *** [Jc 5c 7s 5s] [5h]
mycka86: checks 
BuBu 0187: bets €20
mycka86: calls €20
*** SHOW DOWN ***
BuBu 0187: shows [6c 8c] (three of a kind, Fives)
mycka86: shows [Td Ts] (a full house, Fives full of Tens)
mycka86 collected €71.67 from pot
*** SUMMARY ***
Total pot €73.82 | Rake €2.15 
Board [Jc 5c 7s 5s 5h]
Seat 1: Apparat888 folded before Flop (didn't bet)
Seat 2: Venomous100% folded before Flop (didn't bet)
Seat 3: BuBu 0187 showed [6c 8c] and lost with three of a kind, Fives
Seat 4: Sreshta222 folded before Flop (didn't bet)
Seat 5: AlKatrone (button) folded before Flop (didn't bet)
Seat 6: matiko09 (small blind) folded before Flop
Seat 7: er13to (big blind) folded before Flop
Seat 8: mycka86 showed [Td Ts] and won (€71.67) with a full house, Fives full of Tens





PokerStars Hand #148834175262:  Hold'em No Limit ($0.25/$0.50 USD) - 2016/02/15 11:45:10 CET [2016/02/15 5:45:10 ET]
Table 'Vesta II' 9-max Seat #6 is the button
Seat 1: lumen21 ($50 in chips) 
Seat 2: ljryviltj ($59.79 in chips) 
Seat 3: matiko09 ($65.78 in chips) 
Seat 4: vlad11122007 ($53.28 in chips) 
Seat 5: Serhent ($50 in chips) 
Seat 6: Gutschel ($50 in chips) 
Seat 7: ruyingren ($36.18 in chips) 
Seat 8: Arystan ($51.61 in chips) 
Seat 9: Aoki42 ($111.35 in chips) 
ruyingren: posts small blind $0.25
Arystan: posts big blind $0.50
*** HOLE CARDS ***
Dealt to matiko09 [8c Th]
Aoki42: folds 
lumen21: folds 
ljryviltj: folds 
matiko09: folds 
vlad11122007: folds 
Serhent: folds 
Gutschel: raises $0.75 to $1.25
ruyingren: calls $1
Arystan: calls $0.75
*** FLOP *** [Ks 7h 3c]
ruyingren: checks 
Arystan: checks 
Gutschel: bets $1.96
ruyingren: calls $1.96
Arystan: folds 
*** TURN *** [Ks 7h 3c] [2c]
ruyingren: bets $3.50
Gutschel: calls $3.50
*** RIVER *** [Ks 7h 3c 2c] [Kd]
ruyingren: checks 
Gutschel: bets $7.70
ruyingren: folds 
Uncalled bet ($7.70) returned to Gutschel
Gutschel collected $14.01 from pot
Gutschel: doesn't show hand 
*** SUMMARY ***
Total pot $14.67 | Rake $0.66 
Board [Ks 7h 3c 2c Kd]
Seat 1: lumen21 folded before Flop (didn't bet)
Seat 2: ljryviltj folded before Flop (didn't bet)
Seat 3: matiko09 folded before Flop (didn't bet)
Seat 4: vlad11122007 folded before Flop (didn't bet)
Seat 5: Serhent folded before Flop (didn't bet)
Seat 6: Gutschel (button) collected ($14.01)
Seat 7: ruyingren (small blind) folded on the River
Seat 8: Arystan (big blind) folded on the Flop
Seat 9: Aoki42 folded before Flop (didn't bet)





PokerStars Hand #148834180448:  Hold'em No Limit ($0.50/$1.00 USD) - 2016/02/15 11:45:21 CET [2016/02/15 5:45:21 ET]
Table 'Oongaq' 9-max Seat #3 is the button
Seat 1: matiko09 ($102 in chips) 
Seat 3: wilsong96 ($102.13 in chips) 
Seat 4: maxxmeister ($100 in chips) 
Seat 5: mn230758 ($51.14 in chips) 
Seat 6: IHouseMusic ($101.71 in chips) 
Seat 7: gwwsb ($81.98 in chips) 
Seat 8: AlKatrone ($105.54 in chips) 
Seat 9: alpw47 ($12.51 in chips) 
maxxmeister: posts small blind $0.50
mn230758: posts big blind $1
*** HOLE CARDS ***
Dealt to matiko09 [3h 7h]
IHouseMusic: folds 
gwwsb: folds 
AlKatrone: folds 
alpw47: folds 
matiko09: folds 
wilsong96: calls $1
maxxmeister: calls $0.50
mn230758: checks 
*** FLOP *** [Ac 2h 7c]
maxxmeister: checks 
mn230758: checks 
wilsong96: checks 
*** TURN *** [Ac 2h 7c] [Jh]
maxxmeister: bets $3
mn230758: folds 
wilsong96: folds 
Uncalled bet ($3) returned to maxxmeister
maxxmeister collected $2.86 from pot
maxxmeister: doesn't show hand 
*** SUMMARY ***
Total pot $3 | Rake $0.14 
Board [Ac 2h 7c Jh]
Seat 1: matiko09 folded before Flop (didn't bet)
Seat 3: wilsong96 (button) folded on the Turn
Seat 4: maxxmeister (small blind) collected ($2.86)
Seat 5: mn230758 (big blind) folded on the Turn
Seat 6: IHouseMusic folded before Flop (didn't bet)
Seat 7: gwwsb folded before Flop (didn't bet)
Seat 8: AlKatrone folded before Flop (didn't bet)
Seat 9: alpw47 folded before Flop (didn't bet)





PokerStars Hand #148834181158:  Hold'em No Limit ($0.50/$1.00 USD) - 2016/02/15 11:45:22 CET [2016/02/15 5:45:22 ET]
Table 'Euanthe II' 9-max Seat #7 is the button
Seat 1: maxxmeister ($128.94 in chips) 
Seat 2: mahalko0925 ($87.38 in chips) 
Seat 3: matiko09 ($106.14 in chips) 
Seat 4: er13to ($112.18 in chips) 
Seat 5: gabi_igna ($174.51 in chips) 
Seat 6: IHouseMusic ($119.41 in chips) 
Seat 7: vinniesmol ($212.37 in chips) 
Seat 8: AlKatrone ($100.50 in chips) 
Seat 9: Venomous100% ($113.09 in chips) 
AlKatrone: posts small blind $0.50
Venomous100%: posts big blind $1
*** HOLE CARDS ***
Dealt to matiko09 [Ts 8s]
maxxmeister: folds 
mahalko0925: folds 
matiko09: folds 
er13to: folds 
gabi_igna: folds 
IHouseMusic: folds 
vinniesmol: folds 
AlKatrone: folds 
Uncalled bet ($0.50) returned to Venomous100%
Venomous100% collected $1 from pot
Venomous100%: doesn't show hand 
*** SUMMARY ***
Total pot $1 | Rake $0 
Seat 1: maxxmeister folded before Flop (didn't bet)
Seat 2: mahalko0925 folded before Flop (didn't bet)
Seat 3: matiko09 folded before Flop (didn't bet)
Seat 4: er13to folded before Flop (didn't bet)
Seat 5: gabi_igna folded before Flop (didn't bet)
Seat 6: IHouseMusic folded before Flop (didn't bet)
Seat 7: vinniesmol (button) folded before Flop (didn't bet)
Seat 8: AlKatrone (small blind) folded before Flop
Seat 9: Venomous100% (big blind) collected ($1)





PokerStars Hand #148834188557:  Hold'em No Limit ($0.50/$1.00 USD) - 2016/02/15 11:45:37 CET [2016/02/15 5:45:37 ET]
Table 'Octans II' 9-max Seat #5 is the button
Seat 1: maxxmeister ($100 in chips) 
Seat 2: matiko09 ($268.41 in chips) 
Seat 3: Aalleekks ($110.37 in chips) 
Seat 4: Venomous100% ($189.40 in chips) 
Seat 5: gabi_igna ($100 in chips) 
Seat 6: er13to ($100.50 in chips) 
Seat 7: traficblues ($29.97 in chips) 
Seat 8: IHouseMusic ($135.38 in chips) 
Seat 9: mycka86 ($102.97 in chips) 
er13to: posts small blind $0.50
traficblues: posts big blind $1
*** HOLE CARDS ***
Dealt to matiko09 [8c 4d]
IHouseMusic: folds 
mycka86: folds 
maxxmeister: folds 
matiko09: folds 
Aalleekks: folds 
Venomous100%: raises $1.50 to $2.50
gabi_igna: folds 
er13to: folds 
traficblues: calls $1.50
*** FLOP *** [9d 8h Jd]
traficblues: checks 
Venomous100%: checks 
*** TURN *** [9d 8h Jd] [6h]
traficblues: checks 
Venomous100%: checks 
*** RIVER *** [9d 8h Jd 6h] [Ks]
traficblues: checks 
Venomous100%: bets $4
traficblues: folds 
Uncalled bet ($4) returned to Venomous100%
Venomous100% collected $5.25 from pot
Venomous100%: doesn't show hand 
*** SUMMARY ***
Total pot $5.50 | Rake $0.25 
Board [9d 8h Jd 6h Ks]
Seat 1: maxxmeister folded before Flop (didn't bet)
Seat 2: matiko09 folded before Flop (didn't bet)
Seat 3: Aalleekks folded before Flop (didn't bet)
Seat 4: Venomous100% collected ($5.25)
Seat 5: gabi_igna (button) folded before Flop (didn't bet)
Seat 6: er13to (small blind) folded before Flop
Seat 7: traficblues (big blind) folded on the River
Seat 8: IHouseMusic folded before Flop (didn't bet)
Seat 9: mycka86 folded before Flop (didn't bet)





PokerStars Hand #148834190339:  Hold'em No Limit ($0.50/$1.00 USD) - 2016/02/15 11:45:41 CET [2016/02/15 5:45:41 ET]
Table 'Corvus III' 9-max Seat #1 is the button
Seat 1: pk4DW ($125.90 in chips) 
Seat 2: mzsportline ($129.14 in chips) 
Seat 3: VanDobeln ($207.12 in chips) 
Seat 4: goransyruvka ($201.54 in chips) 
Seat 5: maxxmeister ($259.72 in chips) 
Seat 7: matiko09 ($320.01 in chips) 
Seat 8: redacesfull ($253.45 in chips) 
Seat 9: er13to ($102.89 in chips) 
mzsportline: posts small blind $0.50
VanDobeln: posts big blind $1
pk4DW: posts the ante $0.20
mzsportline: posts the ante $0.20
VanDobeln: posts the ante $0.20
goransyruvka: posts the ante $0.20
maxxmeister: posts the ante $0.20
matiko09: posts the ante $0.20
redacesfull: posts the ante $0.20
er13to: posts the ante $0.20
*** HOLE CARDS ***
Dealt to matiko09 [Kc Qh]
goransyruvka has timed out while disconnected
goransyruvka: folds 
maxxmeister: raises $2.50 to $3.50
matiko09: folds 
redacesfull: folds 
er13to: folds 
pk4DW: folds 
mzsportline: calls $3
VanDobeln: calls $2.50
*** FLOP *** [2s 2h Ah]
mzsportline: checks 
VanDobeln: checks 
maxxmeister: bets $6.16
mzsportline: calls $6.16
VanDobeln: folds 
*** TURN *** [2s 2h Ah] [3d]
mzsportline: bets $14
maxxmeister: folds 
Uncalled bet ($14) returned to mzsportline
mzsportline collected $23.32 from pot
mzsportline: doesn't show hand 
*** SUMMARY ***
Total pot $24.42 | Rake $1.10 
Board [2s 2h Ah 3d]
Seat 1: pk4DW (button) folded before Flop (didn't bet)
Seat 2: mzsportline (small blind) collected ($23.32)
Seat 3: VanDobeln (big blind) folded on the Flop
Seat 4: goransyruvka folded before Flop (didn't bet)
Seat 5: maxxmeister folded on the Turn
Seat 7: matiko09 folded before Flop (didn't bet)
Seat 8: redacesfull folded before Flop (didn't bet)
Seat 9: er13to folded before Flop (didn't bet)





PokerStars Hand #148834193041:  Hold'em No Limit ($0.50/$1.00 USD) - 2016/02/15 11:45:46 CET [2016/02/15 5:45:46 ET]
Table 'Urania' 9-max Seat #4 is the button
Seat 1: GRISHANYASHA ($59.77 in chips) 
Seat 2: maxxmeister ($115.96 in chips) 
Seat 4: matiko09 ($108.12 in chips) 
Seat 5: maxonplay ($182.95 in chips) 
Seat 6: gabi_igna ($100 in chips) 
Seat 7: er13to ($101.45 in chips) 
Seat 9: mycka86 ($108.12 in chips) 
maxonplay: posts small blind $0.50
gabi_igna: posts big blind $1
apfush: sits out 
*** HOLE CARDS ***
Dealt to matiko09 [Ks Ah]
er13to: folds 
mycka86: folds 
GRISHANYASHA: folds 
maxxmeister: folds 
matiko09: raises $1.27 to $2.27
maxonplay: folds 
gabi_igna: calls $1.27
*** FLOP *** [6c 5c 5d]
gabi_igna: checks 
matiko09: bets $3.13
gabi_igna: folds 
Uncalled bet ($3.13) returned to matiko09
matiko09 collected $4.81 from pot
matiko09: doesn't show hand 
*** SUMMARY ***
Total pot $5.04 | Rake $0.23 
Board [6c 5c 5d]
Seat 1: GRISHANYASHA folded before Flop (didn't bet)
Seat 2: maxxmeister folded before Flop (didn't bet)
Seat 4: matiko09 (button) collected ($4.81)
Seat 5: maxonplay (small blind) folded before Flop
Seat 6: gabi_igna (big blind) folded on the Flop
Seat 7: er13to folded before Flop (didn't bet)
Seat 9: mycka86 folded before Flop (didn't bet)





PokerStars Hand #148834195682:  Hold'em No Limit ($0.50/$1.00 USD) - 2016/02/15 11:45:51 CET [2016/02/15 5:45:51 ET]
Table 'Euanthe II' 9-max Seat #8 is the button
Seat 1: maxxmeister ($128.94 in chips) 
Seat 2: mahalko0925 ($87.38 in chips) 
Seat 3: matiko09 ($106.14 in chips) 
Seat 4: er13to ($112.18 in chips) 
Seat 5: gabi_igna ($174.51 in chips) 
Seat 6: IHouseMusic ($119.41 in chips) 
Seat 7: vinniesmol ($212.37 in chips) 
Seat 8: AlKatrone ($100 in chips) 
Seat 9: Venomous100% ($113.59 in chips) 
Venomous100%: posts small blind $0.50
maxxmeister: posts big blind $1
*** HOLE CARDS ***
Dealt to matiko09 [Kh 6d]
mahalko0925: folds 
matiko09: folds 
er13to: folds 
gabi_igna: folds 
IHouseMusic: folds 
vinniesmol: folds 
AlKatrone: folds 
Venomous100%: folds 
Uncalled bet ($0.50) returned to maxxmeister
maxxmeister collected $1 from pot
maxxmeister: doesn't show hand 
*** SUMMARY ***
Total pot $1 | Rake $0 
Seat 1: maxxmeister (big blind) collected ($1)
Seat 2: mahalko0925 folded before Flop (didn't bet)
Seat 3: matiko09 folded before Flop (didn't bet)
Seat 4: er13to folded before Flop (didn't bet)
Seat 5: gabi_igna folded before Flop (didn't bet)
Seat 6: IHouseMusic folded before Flop (didn't bet)
Seat 7: vinniesmol folded before Flop (didn't bet)
Seat 8: AlKatrone (button) folded before Flop (didn't bet)
Seat 9: Venomous100% (small blind) folded before Flop





PokerStars Hand #148834197392:  Hold'em No Limit ($0.50/$1.00 USD) - 2016/02/15 11:45:55 CET [2016/02/15 5:45:55 ET]
Table 'Anteros' 9-max Seat #5 is the button
Seat 1: redacesfull ($126.40 in chips) 
Seat 2: IHouseMusic ($106.12 in chips) 
Seat 3: er13to ($100 in chips) 
Seat 4: misherei ($171.75 in chips) 
Seat 5: Holm1991 ($40.25 in chips) 
Seat 6: SerAlGog ($151.31 in chips) 
Seat 7: Zoubou1983 ($211.86 in chips) 
Seat 8: matiko09 ($100 in chips) 
Seat 9: mycka86 ($102 in chips) 
SerAlGog: posts small blind $0.50
Zoubou1983: posts big blind $1
*** HOLE CARDS ***
Dealt to matiko09 [2d As]
matiko09: folds 
mycka86: folds 
redacesfull: folds 
IHouseMusic: folds 
er13to: raises $1.50 to $2.50
misherei: calls $2.50
Holm1991: folds 
SerAlGog: folds 
Zoubou1983: calls $1.50
*** FLOP *** [9h 4h 8s]
Zoubou1983: checks 
er13to: checks 
misherei: bets $4
Zoubou1983: raises $4 to $8
er13to: folds 
misherei: calls $4
*** TURN *** [9h 4h 8s] [2h]
Zoubou1983: checks 
misherei: checks 
*** RIVER *** [9h 4h 8s 2h] [Ah]
Zoubou1983: bets $11
misherei: folds 
Uncalled bet ($11) returned to Zoubou1983
Zoubou1983 collected $22.92 from pot
Zoubou1983: doesn't show hand 
*** SUMMARY ***
Total pot $24 | Rake $1.08 
Board [9h 4h 8s 2h Ah]
Seat 1: redacesfull folded before Flop (didn't bet)
Seat 2: IHouseMusic folded before Flop (didn't bet)
Seat 3: er13to folded on the Flop
Seat 4: misherei folded on the River
Seat 5: Holm1991 (button) folded before Flop (didn't bet)
Seat 6: SerAlGog (small blind) folded before Flop
Seat 7: Zoubou1983 (big blind) collected ($22.92)
Seat 8: matiko09 folded before Flop (didn't bet)
Seat 9: mycka86 folded before Flop (didn't bet)





PokerStars Hand #148834202819:  Hold'em No Limit ($0.50/$1.00 USD) - 2016/02/15 11:46:06 CET [2016/02/15 5:46:06 ET]
Table 'Kitalpha II' 9-max Seat #9 is the button
Seat 1: IHouseMusic ($100 in chips) 
Seat 2: Aalleekks ($100 in chips) 
Seat 3: matiko09 ($101.86 in chips) 
Seat 4: Sreshta222 ($100 in chips) 
Seat 5: apfush ($100 in chips) 
Seat 6: Congo Sam ($112.88 in chips) 
Seat 7: 4Aces4Roses ($152.30 in chips) 
Seat 8: skram2 ($114.41 in chips) 
Seat 9: Waltz88 ($245.18 in chips) 
IHouseMusic: posts small blind $0.50
Aalleekks: posts big blind $1
*** HOLE CARDS ***
Dealt to matiko09 [Qd Jh]
matiko09: folds 
Sreshta222: folds 
apfush: folds 
Congo Sam: calls $1
4Aces4Roses: calls $1
skram2: folds 
Waltz88: folds 
IHouseMusic: folds 
Aalleekks: checks 
*** FLOP *** [8d Jc 6d]
Aalleekks: checks 
Congo Sam: checks 
4Aces4Roses: checks 
*** TURN *** [8d Jc 6d] [8s]
Aalleekks: bets $1.83
Congo Sam: folds 
4Aces4Roses: calls $1.83
*** RIVER *** [8d Jc 6d 8s] [9s]
Aalleekks: checks 
4Aces4Roses: checks 
*** SHOW DOWN ***
Aalleekks: shows [6h 2s] (two pair, Eights and Sixes)
4Aces4Roses: mucks hand 
Aalleekks collected $6.84 from pot
*** SUMMARY ***
Total pot $7.16 | Rake $0.32 
Board [8d Jc 6d 8s 9s]
Seat 1: IHouseMusic (small blind) folded before Flop
Seat 2: Aalleekks (big blind) showed [6h 2s] and won ($6.84) with two pair, Eights and Sixes
Seat 3: matiko09 folded before Flop (didn't bet)
Seat 4: Sreshta222 folded before Flop (didn't bet)
Seat 5: apfush folded before Flop (didn't bet)
Seat 6: Congo Sam folded on the Turn
Seat 7: 4Aces4Roses mucked [4s 7s]
Seat 8: skram2 folded before Flop (didn't bet)
Seat 9: Waltz88 (button) folded before Flop (didn't bet)





PokerStars Hand #148834205121:  Hold'em No Limit ($0.50/$1.00 USD) - 2016/02/15 11:46:11 CET [2016/02/15 5:46:11 ET]
Table 'Euanthe II' 9-max Seat #9 is the button
Seat 1: maxxmeister ($129.44 in chips) 
Seat 2: mahalko0925 ($87.38 in chips) 
Seat 3: matiko09 ($106.14 in chips) 
Seat 4: er13to ($112.18 in chips) 
Seat 5: gabi_igna ($174.51 in chips) 
Seat 6: IHouseMusic ($119.41 in chips) 
Seat 7: vinniesmol ($212.37 in chips) 
Seat 8: AlKatrone ($100 in chips) 
Seat 9: Venomous100% ($113.09 in chips) 
maxxmeister: posts small blind $0.50
mahalko0925: posts big blind $1
*** HOLE CARDS ***
Dealt to matiko09 [3d Qc]
matiko09: folds 
er13to: folds 
gabi_igna: folds 
IHouseMusic: raises $2 to $3
vinniesmol: folds 
AlKatrone: folds 
Venomous100%: folds 
maxxmeister: folds 
mahalko0925: calls $2
*** FLOP *** [Ts Tc Ks]
mahalko0925: checks 
IHouseMusic: checks 
*** TURN *** [Ts Tc Ks] [Jd]
mahalko0925: bets $6
IHouseMusic: folds 
Uncalled bet ($6) returned to mahalko0925
mahalko0925 collected $6.21 from pot
*** SUMMARY ***
Total pot $6.50 | Rake $0.29 
Board [Ts Tc Ks Jd]
Seat 1: maxxmeister (small blind) folded before Flop
Seat 2: mahalko0925 (big blind) collected ($6.21)
Seat 3: matiko09 folded before Flop (didn't bet)
Seat 4: er13to folded before Flop (didn't bet)
Seat 5: gabi_igna folded before Flop (didn't bet)
Seat 6: IHouseMusic folded on the Turn
Seat 7: vinniesmol folded before Flop (didn't bet)
Seat 8: AlKatrone folded before Flop (didn't bet)
Seat 9: Venomous100% (button) folded before Flop (didn't bet)





PokerStars Hand #148834206744:  Hold'em No Limit ($0.50/$1.00 USD) - 2016/02/15 11:46:14 CET [2016/02/15 5:46:14 ET]
Table 'Nata II' 9-max Seat #3 is the button
Seat 2: qqcom ($100 in chips) 
Seat 3: g00000se ($101.95 in chips) 
Seat 4: gabi_igna ($157.94 in chips) 
Seat 5: AGoodFell4 ($66.97 in chips) 
Seat 6: AlKatrone ($140.83 in chips) 
Seat 7: er13to ($100.25 in chips) 
Seat 8: lumen21 ($172.68 in chips) 
Seat 9: matiko09 ($106.30 in chips) 
gabi_igna: posts small blind $0.50
AGoodFell4: posts big blind $1
*** HOLE CARDS ***
Dealt to matiko09 [6s 3h]
AlKatrone: folds 
er13to: folds 
lumen21: folds 
matiko09: folds 
qqcom: folds 
g00000se: raises $1 to $2
gabi_igna: folds 
AGoodFell4: folds 
Uncalled bet ($1) returned to g00000se
g00000se collected $2.50 from pot
g00000se: doesn't show hand 
*** SUMMARY ***
Total pot $2.50 | Rake $0 
Seat 2: qqcom folded before Flop (didn't bet)
Seat 3: g00000se (button) collected ($2.50)
Seat 4: gabi_igna (small blind) folded before Flop
Seat 5: AGoodFell4 (big blind) folded before Flop
Seat 6: AlKatrone folded before Flop (didn't bet)
Seat 7: er13to folded before Flop (didn't bet)
Seat 8: lumen21 folded before Flop (didn't bet)
Seat 9: matiko09 folded before Flop (didn't bet)





PokerStars Hand #148834209004:  Hold'em No Limit ($0.50/$1.00 USD) - 2016/02/15 11:46:19 CET [2016/02/15 5:46:19 ET]
Table 'Urania' 9-max Seat #5 is the button
Seat 1: GRISHANYASHA ($59.77 in chips) 
Seat 2: maxxmeister ($115.96 in chips) 
Seat 4: matiko09 ($110.66 in chips) 
Seat 5: maxonplay ($182.45 in chips) 
Seat 6: gabi_igna ($100 in chips) 
Seat 7: er13to ($101.45 in chips) 
Seat 9: mycka86 ($108.12 in chips) 
gabi_igna: posts small blind $0.50
er13to: posts big blind $1
apfush: sits out 
*** HOLE CARDS ***
Dealt to matiko09 [3s Jd]
mycka86: raises $2 to $3
GRISHANYASHA: folds 
maxxmeister: folds 
matiko09: folds 
maxonplay: folds 
gabi_igna: folds 
er13to: folds 
Uncalled bet ($2) returned to mycka86
mycka86 collected $2.50 from pot
*** SUMMARY ***
Total pot $2.50 | Rake $0 
Seat 1: GRISHANYASHA folded before Flop (didn't bet)
Seat 2: maxxmeister folded before Flop (didn't bet)
Seat 4: matiko09 folded before Flop (didn't bet)
Seat 5: maxonplay (button) folded before Flop (didn't bet)
Seat 6: gabi_igna (small blind) folded before Flop
Seat 7: er13to (big blind) folded before Flop
Seat 9: mycka86 collected ($2.50)





PokerStars Hand #148834214199:  Hold'em No Limit ($0.25/$0.50 USD) - 2016/02/15 11:46:29 CET [2016/02/15 5:46:29 ET]
Table 'Vesta II' 9-max Seat #7 is the button
Seat 1: lumen21 ($50 in chips) 
Seat 2: ljryviltj ($59.79 in chips) 
Seat 3: matiko09 ($65.78 in chips) 
Seat 4: vlad11122007 ($53.28 in chips) 
Seat 5: Serhent ($50 in chips) 
Seat 6: Gutschel ($57.30 in chips) 
Seat 7: ruyingren ($29.47 in chips) 
Seat 8: Arystan ($50.36 in chips) 
Seat 9: Aoki42 ($111.35 in chips) 
Arystan: posts small blind $0.25
Aoki42: posts big blind $0.50
*** HOLE CARDS ***
Dealt to matiko09 [7s 8s]
lumen21: raises $1 to $1.50
ljryviltj: folds 
matiko09: calls $1.50
vlad11122007: folds 
Serhent: folds 
Gutschel: folds 
ruyingren: folds 
Arystan: calls $1.25
Aoki42: folds 
*** FLOP *** [Js 2c As]
Arystan: bets $2.39
lumen21: folds 
matiko09: raises $5.11 to $7.50
Arystan: raises $41.36 to $48.86 and is all-in
matiko09: folds 
Uncalled bet ($41.36) returned to Arystan
Arystan collected $19.10 from pot
Arystan: doesn't show hand 
*** SUMMARY ***
Total pot $20 | Rake $0.90 
Board [Js 2c As]
Seat 1: lumen21 folded on the Flop
Seat 2: ljryviltj folded before Flop (didn't bet)
Seat 3: matiko09 folded on the Flop
Seat 4: vlad11122007 folded before Flop (didn't bet)
Seat 5: Serhent folded before Flop (didn't bet)
Seat 6: Gutschel folded before Flop (didn't bet)
Seat 7: ruyingren (button) folded before Flop (didn't bet)
Seat 8: Arystan (small blind) collected ($19.10)
Seat 9: Aoki42 (big blind) folded before Flop





PokerStars Hand #148834219166:  Hold'em No Limit ($0.50/$1.00 USD) - 2016/02/15 11:46:39 CET [2016/02/15 5:46:39 ET]
Table 'Urania' 9-max Seat #6 is the button
Seat 1: GRISHANYASHA ($59.77 in chips) 
Seat 2: maxxmeister ($115.96 in chips) 
Seat 4: matiko09 ($110.66 in chips) 
Seat 5: maxonplay ($182.45 in chips) 
Seat 6: gabi_igna ($100 in chips) 
Seat 7: er13to ($100.45 in chips) 
Seat 8: apfush ($100 in chips) 
Seat 9: mycka86 ($109.62 in chips) 
er13to: posts small blind $0.50
apfush: posts big blind $1
*** HOLE CARDS ***
Dealt to matiko09 [As 5h]
mycka86: folds 
GRISHANYASHA: raises $1.47 to $2.47
maxxmeister: folds 
matiko09: folds 
maxonplay: folds 
gabi_igna: calls $2.47
er13to: folds 
apfush: calls $1.47
*** FLOP *** [Kd Jd 9c]
apfush: checks 
GRISHANYASHA: bets $4
gabi_igna: folds 
apfush: calls $4
*** TURN *** [Kd Jd 9c] [7h]
apfush: checks 
GRISHANYASHA: bets $7.89
apfush: calls $7.89
*** RIVER *** [Kd Jd 9c 7h] [2c]
apfush: checks 
GRISHANYASHA: bets $11
apfush: calls $11
*** SHOW DOWN ***
GRISHANYASHA: shows [9h Qh] (a pair of Nines)
apfush: shows [Ks Qc] (a pair of Kings)
apfush collected $51.27 from pot
*** SUMMARY ***
Total pot $53.69 | Rake $2.42 
Board [Kd Jd 9c 7h 2c]
Seat 1: GRISHANYASHA showed [9h Qh] and lost with a pair of Nines
Seat 2: maxxmeister folded before Flop (didn't bet)
Seat 4: matiko09 folded before Flop (didn't bet)
Seat 5: maxonplay folded before Flop (didn't bet)
Seat 6: gabi_igna (button) folded on the Flop
Seat 7: er13to (small blind) folded before Flop
Seat 8: apfush (big blind) showed [Ks Qc] and won ($51.27) with a pair of Kings
Seat 9: mycka86 folded before Flop (didn't bet)





PokerStars Hand #148834219751:  Hold'em No Limit ($0.50/$1.00 USD) - 2016/02/15 11:46:40 CET [2016/02/15 5:46:40 ET]
Table 'Octans II' 9-max Seat #6 is the button
Seat 1: maxxmeister ($100 in chips) 
Seat 2: matiko09 ($268.41 in chips) 
Seat 3: Aalleekks ($110.37 in chips) 
Seat 4: Venomous100% ($192.15 in chips) 
Seat 5: gabi_igna ($100 in chips) 
Seat 6: er13to ($100 in chips) 
Seat 7: traficblues ($27.47 in chips) 
Seat 8: IHouseMusic ($135.38 in chips) 
Seat 9: mycka86 ($102.97 in chips) 
traficblues: posts small blind $0.50
IHouseMusic: posts big blind $1
*** HOLE CARDS ***
Dealt to matiko09 [Jd Jh]
mycka86: folds 
maxxmeister: folds 
matiko09: raises $2 to $3
Aalleekks: folds 
Venomous100%: folds 
gabi_igna: folds 
er13to: folds 
traficblues: calls $2.50
IHouseMusic: raises $9 to $12
matiko09: calls $9
traficblues: raises $15.47 to $27.47 and is all-in
IHouseMusic: folds 
matiko09: calls $15.47
*** FLOP *** [Qc 4c 3d]
*** TURN *** [Qc 4c 3d] [6s]
*** RIVER *** [Qc 4c 3d 6s] [3h]
*** SHOW DOWN ***
traficblues: shows [8s 8c] (two pair, Eights and Threes)
matiko09: shows [Jd Jh] (two pair, Jacks and Threes)
matiko09 collected $64.14 from pot
*** SUMMARY ***
Total pot $66.94 | Rake $2.80 
Board [Qc 4c 3d 6s 3h]
Seat 1: maxxmeister folded before Flop (didn't bet)
Seat 2: matiko09 showed [Jd Jh] and won ($64.14) with two pair, Jacks and Threes
Seat 3: Aalleekks folded before Flop (didn't bet)
Seat 4: Venomous100% folded before Flop (didn't bet)
Seat 5: gabi_igna folded before Flop (didn't bet)
Seat 6: er13to (button) folded before Flop (didn't bet)
Seat 7: traficblues (small blind) showed [8s 8c] and lost with two pair, Eights and Threes
Seat 8: IHouseMusic (big blind) folded before Flop
Seat 9: mycka86 folded before Flop (didn't bet)





PokerStars Hand #148834219878:  Hold'em No Limit ($0.50/$1.00 USD) - 2016/02/15 11:46:40 CET [2016/02/15 5:46:40 ET]
Table 'Oongaq' 9-max Seat #4 is the button
Seat 1: matiko09 ($102 in chips) 
Seat 3: wilsong96 ($101.13 in chips) 
Seat 4: maxxmeister ($101.86 in chips) 
Seat 5: mn230758 ($50.14 in chips) 
Seat 6: IHouseMusic ($101.71 in chips) 
Seat 7: gwwsb ($81.98 in chips) 
Seat 8: AlKatrone ($105.54 in chips) 
Seat 9: alpw47 ($12.51 in chips) 
mn230758: posts small blind $0.50
IHouseMusic: posts big blind $1
*** HOLE CARDS ***
Dealt to matiko09 [Ts 4c]
gwwsb: raises $1 to $2
AlKatrone: folds 
alpw47: folds 
matiko09: folds 
wilsong96: folds 
maxxmeister: raises $6 to $8
mn230758: folds 
IHouseMusic: folds 
gwwsb: calls $6
*** FLOP *** [7s Qs 6s]
gwwsb: checks 
maxxmeister: bets $10
gwwsb: folds 
Uncalled bet ($10) returned to maxxmeister
maxxmeister collected $16.71 from pot
maxxmeister: doesn't show hand 
*** SUMMARY ***
Total pot $17.50 | Rake $0.79 
Board [7s Qs 6s]
Seat 1: matiko09 folded before Flop (didn't bet)
Seat 3: wilsong96 folded before Flop (didn't bet)
Seat 4: maxxmeister (button) collected ($16.71)
Seat 5: mn230758 (small blind) folded before Flop
Seat 6: IHouseMusic (big blind) folded before Flop
Seat 7: gwwsb folded on the Flop
Seat 8: AlKatrone folded before Flop (didn't bet)
Seat 9: alpw47 folded before Flop (didn't bet)





PokerStars Hand #148834222407:  Hold'em No Limit ($0.50/$1.00 USD) - 2016/02/15 11:46:46 CET [2016/02/15 5:46:46 ET]
Table 'Nata II' 9-max Seat #4 is the button
Seat 2: qqcom ($100 in chips) 
Seat 3: g00000se ($103.45 in chips) 
Seat 4: gabi_igna ($157.44 in chips) 
Seat 5: AGoodFell4 ($65.97 in chips) 
Seat 6: AlKatrone ($140.83 in chips) 
Seat 7: er13to ($100.25 in chips) 
Seat 8: lumen21 ($172.68 in chips) 
Seat 9: matiko09 ($106.30 in chips) 
AGoodFell4: posts small blind $0.50
AlKatrone: posts big blind $1
*** HOLE CARDS ***
Dealt to matiko09 [9s Qs]
er13to: raises $2 to $3
lumen21: folds 
matiko09: folds 
qqcom: folds 
g00000se: folds 
gabi_igna: folds 
AGoodFell4: folds 
AlKatrone: folds 
Uncalled bet ($2) returned to er13to
er13to collected $2.50 from pot
*** SUMMARY ***
Total pot $2.50 | Rake $0 
Seat 2: qqcom folded before Flop (didn't bet)
Seat 3: g00000se folded before Flop (didn't bet)
Seat 4: gabi_igna (button) folded before Flop (didn't bet)
Seat 5: AGoodFell4 (small blind) folded before Flop
Seat 6: AlKatrone (big blind) folded before Flop
Seat 7: er13to collected ($2.50)
Seat 8: lumen21 folded before Flop (didn't bet)
Seat 9: matiko09 folded before Flop (didn't bet)





PokerStars Hand #148834224717:  Hold'em No Limit ($0.50/$1.00 USD) - 2016/02/15 11:46:50 CET [2016/02/15 5:46:50 ET]
Table 'Ristenpart' 9-max Seat #7 is the button
Seat 1: gabi_igna ($133.80 in chips) 
Seat 2: IHouseMusic ($100 in chips) 
Seat 4: di0d80 ($101.50 in chips) 
Seat 5: redacesfull ($101.50 in chips) 
Seat 6: apfush ($121.45 in chips) 
Seat 7: Kalesmash08 ($19.95 in chips) 
Seat 8: gwwsb ($135.11 in chips) 
Seat 9: matiko09 ($114.33 in chips) 
gwwsb: posts small blind $0.50
matiko09: posts big blind $1
*** HOLE CARDS ***
Dealt to matiko09 [Qs Qd]
gabi_igna: folds 
IHouseMusic: folds 
di0d80: folds 
redacesfull: raises $1.12 to $2.12
apfush: folds 
Kalesmash08: calls $2.12
gwwsb: folds 
matiko09: raises $6.88 to $9
redacesfull: folds 
Kalesmash08: folds 
Uncalled bet ($6.88) returned to matiko09
matiko09 collected $6.86 from pot
matiko09: doesn't show hand 
*** SUMMARY ***
Total pot $6.86 | Rake $0 
Seat 1: gabi_igna folded before Flop (didn't bet)
Seat 2: IHouseMusic folded before Flop (didn't bet)
Seat 4: di0d80 folded before Flop (didn't bet)
Seat 5: redacesfull folded before Flop
Seat 6: apfush folded before Flop (didn't bet)
Seat 7: Kalesmash08 (button) folded before Flop
Seat 8: gwwsb (small blind) folded before Flop
Seat 9: matiko09 (big blind) collected ($6.86)





PokerStars Hand #148834224417:  Hold'em No Limit ($0.50/$1.00 USD) - 2016/02/15 11:46:50 CET [2016/02/15 5:46:50 ET]
Table 'Kitalpha II' 9-max Seat #1 is the button
Seat 1: IHouseMusic ($100 in chips) 
Seat 2: Aalleekks ($104.01 in chips) 
Seat 3: matiko09 ($101.86 in chips) 
Seat 4: Sreshta222 ($100 in chips) 
Seat 5: apfush ($100 in chips) 
Seat 6: Congo Sam ($111.88 in chips) 
Seat 7: 4Aces4Roses ($149.47 in chips) 
Seat 8: skram2 ($114.41 in chips) 
Seat 9: Waltz88 ($245.18 in chips) 
Aalleekks: posts small blind $0.50
matiko09: posts big blind $1
*** HOLE CARDS ***
Dealt to matiko09 [Ah 9h]
Sreshta222: folds 
apfush: folds 
Congo Sam: folds 
4Aces4Roses: folds 
skram2: raises $2 to $3
Waltz88: folds 
IHouseMusic: folds 
Aalleekks: folds 
matiko09: folds 
Uncalled bet ($2) returned to skram2
skram2 collected $2.50 from pot
skram2: doesn't show hand 
*** SUMMARY ***
Total pot $2.50 | Rake $0 
Seat 1: IHouseMusic (button) folded before Flop (didn't bet)
Seat 2: Aalleekks (small blind) folded before Flop
Seat 3: matiko09 (big blind) folded before Flop
Seat 4: Sreshta222 folded before Flop (didn't bet)
Seat 5: apfush folded before Flop (didn't bet)
Seat 6: Congo Sam folded before Flop (didn't bet)
Seat 7: 4Aces4Roses folded before Flop (didn't bet)
Seat 8: skram2 collected ($2.50)
Seat 9: Waltz88 folded before Flop (didn't bet)





PokerStars Hand #148834229044:  Hold'em No Limit ($0.50/$1.00 USD) - 2016/02/15 11:46:59 CET [2016/02/15 5:46:59 ET]
Table 'Euanthe II' 9-max Seat #1 is the button
Seat 1: maxxmeister ($128.94 in chips) 
Seat 2: mahalko0925 ($90.59 in chips) 
Seat 3: matiko09 ($106.14 in chips) 
Seat 4: er13to ($112.18 in chips) 
Seat 5: gabi_igna ($174.51 in chips) 
Seat 6: IHouseMusic ($116.41 in chips) 
Seat 7: vinniesmol ($212.37 in chips) 
Seat 8: AlKatrone ($100 in chips) 
Seat 9: Venomous100% ($113.09 in chips) 
mahalko0925: posts small blind $0.50
matiko09: posts big blind $1
*** HOLE CARDS ***
Dealt to matiko09 [4c 7d]
er13to: folds 
gabi_igna: folds 
IHouseMusic: folds 
vinniesmol: folds 
AlKatrone: folds 
Venomous100%: folds 
maxxmeister: raises $2 to $3
mahalko0925: folds 
matiko09: folds 
Uncalled bet ($2) returned to maxxmeister
maxxmeister collected $2.50 from pot
maxxmeister: doesn't show hand 
*** SUMMARY ***
Total pot $2.50 | Rake $0 
Seat 1: maxxmeister (button) collected ($2.50)
Seat 2: mahalko0925 (small blind) folded before Flop
Seat 3: matiko09 (big blind) folded before Flop
Seat 4: er13to folded before Flop (didn't bet)
Seat 5: gabi_igna folded before Flop (didn't bet)
Seat 6: IHouseMusic folded before Flop (didn't bet)
Seat 7: vinniesmol folded before Flop (didn't bet)
Seat 8: AlKatrone folded before Flop (didn't bet)
Seat 9: Venomous100% folded before Flop (didn't bet)





PokerStars Hand #148834229425:  Hold'em No Limit ($0.50/$1.00 USD) - 2016/02/15 11:47:00 CET [2016/02/15 5:47:00 ET]
Table 'Corvus III' 9-max Seat #2 is the button
Seat 2: mzsportline ($142.60 in chips) 
Seat 3: VanDobeln ($247.50 in chips) 
Seat 5: maxxmeister ($250 in chips) 
Seat 7: matiko09 ($319.81 in chips) 
Seat 8: redacesfull ($253.25 in chips) 
Seat 9: er13to ($102.69 in chips) 
VanDobeln: posts small blind $0.50
maxxmeister: posts big blind $1
mzsportline: posts the ante $0.20
VanDobeln: posts the ante $0.20
maxxmeister: posts the ante $0.20
matiko09: posts the ante $0.20
redacesfull: posts the ante $0.20
er13to: posts the ante $0.20
*** HOLE CARDS ***
Dealt to matiko09 [4h 5d]
matiko09: folds 
redacesfull: folds 
er13to: folds 
mzsportline: folds 
VanDobeln: folds 
Uncalled bet ($0.50) returned to maxxmeister
maxxmeister collected $2.20 from pot
maxxmeister: doesn't show hand 
*** SUMMARY ***
Total pot $2.20 | Rake $0 
Seat 2: mzsportline (button) folded before Flop (didn't bet)
Seat 3: VanDobeln (small blind) folded before Flop
Seat 5: maxxmeister (big blind) collected ($2.20)
Seat 7: matiko09 folded before Flop (didn't bet)
Seat 8: redacesfull folded before Flop (didn't bet)
Seat 9: er13to folded before Flop (didn't bet)





PokerStars Hand #148834230286:  Hold'em No Limit ($0.50/$1.00 USD) - 2016/02/15 11:47:01 CET [2016/02/15 5:47:01 ET]
Table 'Anteros' 9-max Seat #6 is the button
Seat 1: redacesfull ($126.40 in chips) 
Seat 2: IHouseMusic ($106.12 in chips) 
Seat 3: er13to ($100 in chips) 
Seat 4: misherei ($161.25 in chips) 
Seat 5: Holm1991 ($40.25 in chips) 
Seat 6: SerAlGog ($150.81 in chips) 
Seat 7: Zoubou1983 ($224.28 in chips) 
Seat 8: matiko09 ($100 in chips) 
Seat 9: mycka86 ($102 in chips) 
Zoubou1983: posts small blind $0.50
matiko09: posts big blind $1
*** HOLE CARDS ***
Dealt to matiko09 [Js 5h]
mycka86: folds 
redacesfull: folds 
IHouseMusic: raises $2 to $3
er13to: folds 
misherei is disconnected 
misherei is connected 
misherei: folds 
Holm1991: folds 
SerAlGog: folds 
Zoubou1983: raises $2 to $5
matiko09: folds 
IHouseMusic: raises $10 to $15
Zoubou1983: calls $10
*** FLOP *** [2d 6d 9c]
Zoubou1983: checks 
IHouseMusic: bets $26.64
Zoubou1983: calls $26.64
*** TURN *** [2d 6d 9c] [Ah]
Zoubou1983: checks 
IHouseMusic: checks 
*** RIVER *** [2d 6d 9c Ah] [7d]
Zoubou1983: bets $41
IHouseMusic: folds 
Uncalled bet ($41) returned to Zoubou1983
Zoubou1983 collected $81.48 from pot
Zoubou1983: doesn't show hand 
*** SUMMARY ***
Total pot $84.28 | Rake $2.80 
Board [2d 6d 9c Ah 7d]
Seat 1: redacesfull folded before Flop (didn't bet)
Seat 2: IHouseMusic folded on the River
Seat 3: er13to folded before Flop (didn't bet)
Seat 4: misherei folded before Flop (didn't bet)
Seat 5: Holm1991 folded before Flop (didn't bet)
Seat 6: SerAlGog (button) folded before Flop (didn't bet)
Seat 7: Zoubou1983 (small blind) collected ($81.48)
Seat 8: matiko09 (big blind) folded before Flop
Seat 9: mycka86 folded before Flop (didn't bet)





PokerStars Hand #148834233949:  Hold'em No Limit ($0.50/$1.00 USD) - 2016/02/15 11:47:09 CET [2016/02/15 5:47:09 ET]
Table 'Corvus III' 9-max Seat #3 is the button
Seat 2: mzsportline ($142.40 in chips) 
Seat 3: VanDobeln ($246.80 in chips) 
Seat 5: maxxmeister ($251.50 in chips) 
Seat 7: matiko09 ($319.61 in chips) 
Seat 8: redacesfull ($253.05 in chips) 
Seat 9: er13to ($102.49 in chips) 
maxxmeister: posts small blind $0.50
matiko09: posts big blind $1
mzsportline: posts the ante $0.20
VanDobeln: posts the ante $0.20
maxxmeister: posts the ante $0.20
matiko09: posts the ante $0.20
redacesfull: posts the ante $0.20
er13to: posts the ante $0.20
*** HOLE CARDS ***
Dealt to matiko09 [Jh Qc]
redacesfull: folds 
er13to: folds 
mzsportline: folds 
VanDobeln: folds 
maxxmeister: raises $3 to $4
matiko09: calls $3
*** FLOP *** [3c 7c 8s]
maxxmeister: checks 
matiko09: checks 
*** TURN *** [3c 7c 8s] [5h]
maxxmeister: checks 
matiko09: checks 
*** RIVER *** [3c 7c 8s 5h] [8h]
maxxmeister: checks 
matiko09: checks 
*** SHOW DOWN ***
maxxmeister: shows [Ad 4h] (a pair of Eights)
matiko09: mucks hand 
maxxmeister collected $8.79 from pot
*** SUMMARY ***
Total pot $9.20 | Rake $0.41 
Board [3c 7c 8s 5h 8h]
Seat 2: mzsportline folded before Flop (didn't bet)
Seat 3: VanDobeln (button) folded before Flop (didn't bet)
Seat 5: maxxmeister (small blind) showed [Ad 4h] and won ($8.79) with a pair of Eights
Seat 7: matiko09 (big blind) mucked [Jh Qc]
Seat 8: redacesfull folded before Flop (didn't bet)
Seat 9: er13to folded before Flop (didn't bet)





PokerStars Hand #148834233890:  Hold'em No Limit ($0.50/$1.00 USD) - 2016/02/15 11:47:09 CET [2016/02/15 5:47:09 ET]
Table 'Praecipua' 9-max Seat #2 is the button
Seat 1: TomK39 ($100 in chips) 
Seat 2: matiko09 ($129.81 in chips) 
Seat 4: gabi_igna ($103 in chips) 
Seat 5: apfush ($100 in chips) 
Seat 6: mycka86 ($141.07 in chips) 
Seat 7: maxxmeister ($156.20 in chips) 
Seat 8: Ellis Ng ($14.92 in chips) 
Seat 9: AlKatrone ($100 in chips) 
J0k3rF4c3_FD will be allowed to play after the button
gabi_igna: posts small blind $0.50
apfush: posts big blind $1
*** HOLE CARDS ***
Dealt to matiko09 [9s 4d]
mycka86: folds 
maxxmeister: raises $1 to $2
Ellis Ng: folds 
AlKatrone: folds 
TomK39: calls $2
matiko09: folds 
gabi_igna: folds 
apfush: folds 
*** FLOP *** [Qh 5d 9c]
maxxmeister: checks 
TomK39: bets $5.25
maxxmeister: raises $11.93 to $17.18
TomK39: folds 
Uncalled bet ($11.93) returned to maxxmeister
maxxmeister collected $15.28 from pot
maxxmeister: doesn't show hand 
*** SUMMARY ***
Total pot $16 | Rake $0.72 
Board [Qh 5d 9c]
Seat 1: TomK39 folded on the Flop
Seat 2: matiko09 (button) folded before Flop (didn't bet)
Seat 4: gabi_igna (small blind) folded before Flop
Seat 5: apfush (big blind) folded before Flop
Seat 6: mycka86 folded before Flop (didn't bet)
Seat 7: maxxmeister collected ($15.28)
Seat 8: Ellis Ng folded before Flop (didn't bet)
Seat 9: AlKatrone folded before Flop (didn't bet)





PokerStars Hand #148834236559:  Hold'em No Limit (€0.50/€1.00 EUR) - 2016/02/15 11:47:14 CET [2016/02/15 5:47:14 ET]
Table 'Ganesa II' 9-max Seat #6 is the button
Seat 1: Apparat888 (€50.57 in chips) 
Seat 2: Venomous100% (€100 in chips) 
Seat 3: BuBu 0187 (€27.98 in chips) 
Seat 4: Sreshta222 (€118.83 in chips) 
Seat 5: AlKatrone (€102.27 in chips) 
Seat 6: matiko09 (€118.02 in chips) 
Seat 7: er13to (€130.41 in chips) 
Seat 8: mycka86 (€135.51 in chips) 
er13to: posts small blind €0.50
mycka86: posts big blind €1
*** HOLE CARDS ***
Dealt to matiko09 [Qd 3d]
Apparat888: folds 
Venomous100%: folds 
BuBu 0187: folds 
Sreshta222: raises €2 to €3
AlKatrone: folds 
matiko09: folds 
er13to: folds 
mycka86: folds 
Uncalled bet (€2) returned to Sreshta222
Sreshta222 collected €2.50 from pot
Sreshta222: doesn't show hand 
*** SUMMARY ***
Total pot €2.50 | Rake €0 
Seat 1: Apparat888 folded before Flop (didn't bet)
Seat 2: Venomous100% folded before Flop (didn't bet)
Seat 3: BuBu 0187 folded before Flop (didn't bet)
Seat 4: Sreshta222 collected (€2.50)
Seat 5: AlKatrone folded before Flop (didn't bet)
Seat 6: matiko09 (button) folded before Flop (didn't bet)
Seat 7: er13to (small blind) folded before Flop
Seat 8: mycka86 (big blind) folded before Flop





PokerStars Hand #148834238627:  Hold'em No Limit ($0.50/$1.00 USD) - 2016/02/15 11:47:18 CET [2016/02/15 5:47:18 ET]
Table 'Gemma II' 9-max Seat #7 is the button
Seat 1: matiko09 ($115.90 in chips) 
Seat 2: gabi_igna ($141.70 in chips) 
Seat 3: Venomous100% ($159.09 in chips) 
Seat 4: mycka86 ($105.90 in chips) 
Seat 5: PokerSash201 ($72.69 in chips) 
Seat 6: IHouseMusic ($136.01 in chips) 
Seat 7: AlKatrone ($100 in chips) 
Seat 9: Waltz88 ($93.19 in chips) 
Waltz88: posts small blind $0.50
matiko09: posts big blind $1
*** HOLE CARDS ***
Dealt to matiko09 [7s 5c]
gabi_igna: folds 
Venomous100%: folds 
mycka86: folds 
PokerSash201: calls $1
IHouseMusic: raises $3 to $4
AlKatrone: folds 
Waltz88: folds 
matiko09: folds 
PokerSash201: calls $3
*** FLOP *** [Kc Qs 4h]
PokerSash201: checks 
IHouseMusic: checks 
*** TURN *** [Kc Qs 4h] [4d]
PokerSash201: checks 
IHouseMusic: checks 
*** RIVER *** [Kc Qs 4h 4d] [2d]
PokerSash201: checks 
IHouseMusic: checks 
*** SHOW DOWN ***
PokerSash201: shows [6h Ah] (a pair of Fours)
IHouseMusic: shows [8d 8h] (two pair, Eights and Fours)
IHouseMusic collected $9.07 from pot
*** SUMMARY ***
Total pot $9.50 | Rake $0.43 
Board [Kc Qs 4h 4d 2d]
Seat 1: matiko09 (big blind) folded before Flop
Seat 2: gabi_igna folded before Flop (didn't bet)
Seat 3: Venomous100% folded before Flop (didn't bet)
Seat 4: mycka86 folded before Flop (didn't bet)
Seat 5: PokerSash201 showed [6h Ah] and lost with a pair of Fours
Seat 6: IHouseMusic showed [8d 8h] and won ($9.07) with two pair, Eights and Fours
Seat 7: AlKatrone (button) folded before Flop (didn't bet)
Seat 9: Waltz88 (small blind) folded before Flop





PokerStars Hand #148834241944:  Hold'em No Limit ($0.50/$1.00 USD) - 2016/02/15 11:47:25 CET [2016/02/15 5:47:25 ET]
Table 'Kitalpha II' 9-max Seat #2 is the button
Seat 1: IHouseMusic ($100 in chips) 
Seat 2: Aalleekks ($103.51 in chips) 
Seat 3: matiko09 ($100.86 in chips) 
Seat 4: Sreshta222 ($100 in chips) 
Seat 5: apfush ($100 in chips) 
Seat 6: Congo Sam ($111.88 in chips) 
Seat 7: 4Aces4Roses ($149.47 in chips) 
Seat 8: skram2 ($115.91 in chips) 
Seat 9: Waltz88 ($245.18 in chips) 
matiko09: posts small blind $0.50
Sreshta222: posts big blind $1
*** HOLE CARDS ***
Dealt to matiko09 [Js 9d]
apfush: folds 
Congo Sam: folds 
4Aces4Roses: raises $1 to $2
skram2: folds 
Waltz88: calls $2
IHouseMusic: folds 
Aalleekks: folds 
matiko09: folds 
Sreshta222: folds 
*** FLOP *** [Ad 8d 9h]
4Aces4Roses: checks 
Waltz88: checks 
*** TURN *** [Ad 8d 9h] [Tc]
4Aces4Roses: bets $2
Waltz88: folds 
Uncalled bet ($2) returned to 4Aces4Roses
4Aces4Roses collected $5.25 from pot
4Aces4Roses: doesn't show hand 
*** SUMMARY ***
Total pot $5.50 | Rake $0.25 
Board [Ad 8d 9h Tc]
Seat 1: IHouseMusic folded before Flop (didn't bet)
Seat 2: Aalleekks (button) folded before Flop (didn't bet)
Seat 3: matiko09 (small blind) folded before Flop
Seat 4: Sreshta222 (big blind) folded before Flop
Seat 5: apfush folded before Flop (didn't bet)
Seat 6: Congo Sam folded before Flop (didn't bet)
Seat 7: 4Aces4Roses collected ($5.25)
Seat 8: skram2 folded before Flop (didn't bet)
Seat 9: Waltz88 folded on the Turn





PokerStars Hand #148834241797:  Hold'em No Limit ($0.50/$1.00 USD) - 2016/02/15 11:47:25 CET [2016/02/15 5:47:25 ET]
Table 'Nata II' 9-max Seat #5 is the button
Seat 2: qqcom ($100 in chips) 
Seat 3: g00000se ($103.45 in chips) 
Seat 4: gabi_igna ($157.44 in chips) 
Seat 5: AGoodFell4 ($65.47 in chips) 
Seat 6: AlKatrone ($139.83 in chips) 
Seat 7: er13to ($101.75 in chips) 
Seat 8: lumen21 ($172.68 in chips) 
Seat 9: matiko09 ($106.30 in chips) 
AlKatrone: posts small blind $0.50
er13to: posts big blind $1
*** HOLE CARDS ***
Dealt to matiko09 [8d 6s]
lumen21: folds 
matiko09: folds 
qqcom: raises $2 to $3
g00000se: folds 
gabi_igna: folds 
AGoodFell4: calls $3
AlKatrone: raises $9 to $12
er13to: folds 
qqcom: folds 
AGoodFell4: folds 
Uncalled bet ($9) returned to AlKatrone
AlKatrone collected $10 from pot
AlKatrone: doesn't show hand 
*** SUMMARY ***
Total pot $10 | Rake $0 
Seat 2: qqcom folded before Flop
Seat 3: g00000se folded before Flop (didn't bet)
Seat 4: gabi_igna folded before Flop (didn't bet)
Seat 5: AGoodFell4 (button) folded before Flop
Seat 6: AlKatrone (small blind) collected ($10)
Seat 7: er13to (big blind) folded before Flop
Seat 8: lumen21 folded before Flop (didn't bet)
Seat 9: matiko09 folded before Flop (didn't bet)





PokerStars Hand #148834242712:  Hold'em No Limit ($0.25/$0.50 USD) - 2016/02/15 11:47:27 CET [2016/02/15 5:47:27 ET]
Table 'Vesta II' 9-max Seat #8 is the button
Seat 1: lumen21 ($50 in chips) 
Seat 2: ljryviltj ($59.79 in chips) 
Seat 3: matiko09 ($56.78 in chips) 
Seat 4: vlad11122007 ($53.28 in chips) 
Seat 5: Serhent ($50 in chips) 
Seat 6: Gutschel ($57.30 in chips) 
Seat 7: ruyingren ($29.47 in chips) 
Seat 8: Arystan ($60.46 in chips) 
Seat 9: Aoki42 ($110.85 in chips) 
Aoki42: posts small blind $0.25
lumen21: posts big blind $0.50
*** HOLE CARDS ***
Dealt to matiko09 [5d 2c]
ljryviltj: folds 
matiko09: folds 
vlad11122007: folds 
Serhent: folds 
Gutschel: raises $1 to $1.50
ruyingren: calls $1.50
Arystan: folds 
Aoki42: folds 
lumen21: folds 
*** FLOP *** [6s Th Kd]
Gutschel: bets $2
ruyingren: raises $4 to $6
Gutschel: calls $4
*** TURN *** [6s Th Kd] [Ac]
Gutschel: checks 
ruyingren: bets $8
Gutschel: raises $21.41 to $29.41
ruyingren: folds 
Uncalled bet ($21.41) returned to Gutschel
Gutschel collected $30.32 from pot
Gutschel: doesn't show hand 
*** SUMMARY ***
Total pot $31.75 | Rake $1.43 
Board [6s Th Kd Ac]
Seat 1: lumen21 (big blind) folded before Flop
Seat 2: ljryviltj folded before Flop (didn't bet)
Seat 3: matiko09 folded before Flop (didn't bet)
Seat 4: vlad11122007 folded before Flop (didn't bet)
Seat 5: Serhent folded before Flop (didn't bet)
Seat 6: Gutschel collected ($30.32)
Seat 7: ruyingren folded on the Turn
Seat 8: Arystan (button) folded before Flop (didn't bet)
Seat 9: Aoki42 (small blind) folded before Flop





PokerStars Hand #148834246105:  Hold'em No Limit ($0.50/$1.00 USD) - 2016/02/15 11:47:33 CET [2016/02/15 5:47:33 ET]
Table 'Octans II' 9-max Seat #8 is the button
Seat 1: maxxmeister ($100 in chips) 
Seat 2: matiko09 ($305.08 in chips) 
Seat 3: Aalleekks ($110.37 in chips) 
Seat 4: Venomous100% ($192.15 in chips) 
Seat 5: gabi_igna ($100 in chips) 
Seat 6: er13to ($100 in chips) 
Seat 8: IHouseMusic ($123.38 in chips) 
Seat 9: mycka86 ($102.97 in chips) 
mycka86: posts small blind $0.50
maxxmeister: posts big blind $1
*** HOLE CARDS ***
Dealt to matiko09 [6c Jc]
matiko09: folds 
Aalleekks: folds 
Venomous100%: folds 
gabi_igna: folds 
er13to: folds 
IHouseMusic: raises $1 to $2
mycka86: folds 
maxxmeister: folds 
Uncalled bet ($1) returned to IHouseMusic
IHouseMusic collected $2.50 from pot
IHouseMusic: doesn't show hand 
*** SUMMARY ***
Total pot $2.50 | Rake $0 
Seat 1: maxxmeister (big blind) folded before Flop
Seat 2: matiko09 folded before Flop (didn't bet)
Seat 3: Aalleekks folded before Flop (didn't bet)
Seat 4: Venomous100% folded before Flop (didn't bet)
Seat 5: gabi_igna folded before Flop (didn't bet)
Seat 6: er13to folded before Flop (didn't bet)
Seat 8: IHouseMusic (button) collected ($2.50)
Seat 9: mycka86 (small blind) folded before Flop





PokerStars Hand #148834251881:  Hold'em No Limit ($0.50/$1.00 USD) - 2016/02/15 11:47:45 CET [2016/02/15 5:47:45 ET]
Table 'Euanthe II' 9-max Seat #2 is the button
Seat 1: maxxmeister ($130.44 in chips) 
Seat 2: mahalko0925 ($90.09 in chips) 
Seat 3: matiko09 ($105.14 in chips) 
Seat 4: er13to ($112.18 in chips) 
Seat 5: gabi_igna ($174.51 in chips) 
Seat 6: IHouseMusic ($116.41 in chips) 
Seat 7: vinniesmol ($212.37 in chips) 
Seat 8: AlKatrone ($100 in chips) 
Seat 9: Venomous100% ($113.09 in chips) 
matiko09: posts small blind $0.50
er13to: posts big blind $1
*** HOLE CARDS ***
Dealt to matiko09 [8d 2c]
gabi_igna: folds 
IHouseMusic: folds 
vinniesmol: folds 
AlKatrone: folds 
Venomous100%: folds 
maxxmeister: raises $1 to $2
mahalko0925: folds 
matiko09: folds 
er13to: calls $1
*** FLOP *** [4d Ac Ad]
er13to: checks 
maxxmeister: bets $2.35
er13to: folds 
Uncalled bet ($2.35) returned to maxxmeister
maxxmeister collected $4.30 from pot
maxxmeister: doesn't show hand 
*** SUMMARY ***
Total pot $4.50 | Rake $0.20 
Board [4d Ac Ad]
Seat 1: maxxmeister collected ($4.30)
Seat 2: mahalko0925 (button) folded before Flop (didn't bet)
Seat 3: matiko09 (small blind) folded before Flop
Seat 4: er13to (big blind) folded on the Flop
Seat 5: gabi_igna folded before Flop (didn't bet)
Seat 6: IHouseMusic folded before Flop (didn't bet)
Seat 7: vinniesmol folded before Flop (didn't bet)
Seat 8: AlKatrone folded before Flop (didn't bet)
Seat 9: Venomous100% folded before Flop (didn't bet)





PokerStars Hand #148834251816:  Hold'em No Limit (€0.50/€1.00 EUR) - 2016/02/15 11:47:45 CET [2016/02/15 5:47:45 ET]
Table 'Ganesa II' 9-max Seat #7 is the button
Seat 2: Venomous100% (€100 in chips) 
Seat 3: BuBu 0187 (€27.98 in chips) 
Seat 4: Sreshta222 (€120.33 in chips) 
Seat 5: AlKatrone (€102.27 in chips) 
Seat 6: matiko09 (€118.02 in chips) 
Seat 7: er13to (€129.91 in chips) 
Seat 8: mycka86 (€134.51 in chips) 
mycka86: posts small blind €0.50
Apparat888: is sitting out 
Venomous100%: posts big blind €1
*** HOLE CARDS ***
Dealt to matiko09 [Ac 6d]
BuBu 0187: raises €2 to €3
Apparat888 leaves the table
di0d80 joins the table at seat #1 
Sreshta222: folds 
AlKatrone: folds 
di0d80 leaves the table
matiko09: folds 
er13to: folds 
mycka86: folds 
Venomous100%: raises €6 to €9
maxxmeister joins the table at seat #1 
BuBu 0187: calls €6
*** FLOP *** [Kh 4d Jh]
Venomous100%: checks 
BuBu 0187: bets €18.98 and is all-in
Venomous100%: calls €18.98
*** TURN *** [Kh 4d Jh] [6h]
*** RIVER *** [Kh 4d Jh 6h] [3s]
*** SHOW DOWN ***
Venomous100%: shows [Js Jd] (three of a kind, Jacks)
BuBu 0187: mucks hand 
Venomous100% collected €54.31 from pot
*** SUMMARY ***
Total pot €56.46 | Rake €2.15 
Board [Kh 4d Jh 6h 3s]
Seat 2: Venomous100% (big blind) showed [Js Jd] and won (€54.31) with three of a kind, Jacks
Seat 3: BuBu 0187 mucked [Jc As]
Seat 4: Sreshta222 folded before Flop (didn't bet)
Seat 5: AlKatrone folded before Flop (didn't bet)
Seat 6: matiko09 folded before Flop (didn't bet)
Seat 7: er13to (button) folded before Flop (didn't bet)
Seat 8: mycka86 (small blind) folded before Flop





PokerStars Hand #148834254706:  Hold'em No Limit ($0.50/$1.00 USD) - 2016/02/15 11:47:51 CET [2016/02/15 5:47:51 ET]
Table 'Octans II' 9-max Seat #9 is the button
Seat 1: maxxmeister ($100 in chips) 
Seat 2: matiko09 ($305.08 in chips) 
Seat 3: Aalleekks ($110.37 in chips) 
Seat 4: Venomous100% ($192.15 in chips) 
Seat 5: gabi_igna ($100 in chips) 
Seat 6: er13to ($100 in chips) 
Seat 8: IHouseMusic ($124.88 in chips) 
Seat 9: mycka86 ($102.47 in chips) 
maxxmeister: posts small blind $0.50
matiko09: posts big blind $1
*** HOLE CARDS ***
Dealt to matiko09 [Kd 7c]
Aalleekks: folds 
Aalleekks leaves the table
Venomous100%: raises $2 to $3
traficblues leaves the table
gabi_igna: folds 
er13to: folds 
VanDobeln joins the table at seat #3 
IHouseMusic: folds 
mycka86: raises $6.50 to $9.50
maxxmeister: folds 
matiko09: folds 
Venomous100%: calls $6.50
*** FLOP *** [2d Qd 5h]
redacesfull joins the table at seat #7 
Venomous100%: checks 
mycka86: checks 
*** TURN *** [2d Qd 5h] [4c]
Venomous100%: bets $12.92
mycka86: folds 
Uncalled bet ($12.92) returned to Venomous100%
Venomous100% collected $19.58 from pot
Venomous100%: doesn't show hand 
*** SUMMARY ***
Total pot $20.50 | Rake $0.92 
Board [2d Qd 5h 4c]
Seat 1: maxxmeister (small blind) folded before Flop
Seat 2: matiko09 (big blind) folded before Flop
Seat 3: Aalleekks folded before Flop (didn't bet)
Seat 4: Venomous100% collected ($19.58)
Seat 5: gabi_igna folded before Flop (didn't bet)
Seat 6: er13to folded before Flop (didn't bet)
Seat 8: IHouseMusic folded before Flop (didn't bet)
Seat 9: mycka86 (button) folded on the Turn





PokerStars Hand #148834255562:  Hold'em No Limit ($0.50/$1.00 USD) - 2016/02/15 11:47:53 CET [2016/02/15 5:47:53 ET]
Table 'Oongaq' 9-max Seat #5 is the button
Seat 1: matiko09 ($102 in chips) 
Seat 3: wilsong96 ($101.13 in chips) 
Seat 4: maxxmeister ($110.57 in chips) 
Seat 5: mn230758 ($49.64 in chips) 
Seat 6: IHouseMusic ($100.71 in chips) 
Seat 7: gwwsb ($73.98 in chips) 
Seat 8: AlKatrone ($105.54 in chips) 
Seat 9: alpw47 ($12.51 in chips) 
IHouseMusic: posts small blind $0.50
gwwsb: posts big blind $1
*** HOLE CARDS ***
Dealt to matiko09 [2h 3d]
AlKatrone: raises $2 to $3
alpw47: folds 
matiko09: folds 
wilsong96: calls $3
maxxmeister: folds 
mn230758: folds 
IHouseMusic: folds 
gwwsb: folds 
*** FLOP *** [Ac 8d 8c]
AlKatrone: bets $5
wilsong96: calls $5
*** TURN *** [Ac 8d 8c] [9h]
AlKatrone: bets $11
wilsong96: folds 
Uncalled bet ($11) returned to AlKatrone
AlKatrone collected $16.71 from pot
AlKatrone: doesn't show hand 
*** SUMMARY ***
Total pot $17.50 | Rake $0.79 
Board [Ac 8d 8c 9h]
Seat 1: matiko09 folded before Flop (didn't bet)
Seat 3: wilsong96 folded on the Turn
Seat 4: maxxmeister folded before Flop (didn't bet)
Seat 5: mn230758 (button) folded before Flop (didn't bet)
Seat 6: IHouseMusic (small blind) folded before Flop
Seat 7: gwwsb (big blind) folded before Flop
Seat 8: AlKatrone collected ($16.71)
Seat 9: alpw47 folded before Flop (didn't bet)





PokerStars Hand #148834256748:  Hold'em No Limit ($0.50/$1.00 USD) - 2016/02/15 11:47:55 CET [2016/02/15 5:47:55 ET]
Table 'Nata II' 9-max Seat #6 is the button
Seat 2: qqcom ($100 in chips) 
Seat 3: g00000se ($103.45 in chips) 
Seat 4: gabi_igna ($157.44 in chips) 
Seat 5: AGoodFell4 ($62.47 in chips) 
Seat 6: AlKatrone ($146.83 in chips) 
Seat 7: er13to ($100.75 in chips) 
Seat 8: lumen21 ($172.68 in chips) 
Seat 9: matiko09 ($106.30 in chips) 
er13to: posts small blind $0.50
lumen21: posts big blind $1
*** HOLE CARDS ***
Dealt to matiko09 [Qc Jd]
matiko09: folds 
qqcom: folds 
g00000se: folds 
gabi_igna: folds 
AGoodFell4: folds 
AGoodFell4 leaves the table
VanDobeln joins the table at seat #5 
AlKatrone: raises $1 to $2
er13to: folds 
lumen21: folds 
Uncalled bet ($1) returned to AlKatrone
AlKatrone collected $2.50 from pot
AlKatrone: doesn't show hand 
*** SUMMARY ***
Total pot $2.50 | Rake $0 
Seat 2: qqcom folded before Flop (didn't bet)
Seat 3: g00000se folded before Flop (didn't bet)
Seat 4: gabi_igna folded before Flop (didn't bet)
Seat 5: AGoodFell4 folded before Flop (didn't bet)
Seat 6: AlKatrone (button) collected ($2.50)
Seat 7: er13to (small blind) folded before Flop
Seat 8: lumen21 (big blind) folded before Flop
Seat 9: matiko09 folded before Flop (didn't bet)





PokerStars Hand #148834257357:  Hold'em No Limit ($0.50/$1.00 USD) - 2016/02/15 11:47:56 CET [2016/02/15 5:47:56 ET]
Table 'Ristenpart' 9-max Seat #8 is the button
Seat 1: gabi_igna ($133.80 in chips) 
Seat 2: IHouseMusic ($100 in chips) 
Seat 4: di0d80 ($101.50 in chips) 
Seat 5: redacesfull ($100 in chips) 
Seat 6: apfush ($121.45 in chips) 
Seat 7: Kalesmash08 ($17.83 in chips) 
Seat 8: gwwsb ($134.61 in chips) 
Seat 9: matiko09 ($119.07 in chips) 
matiko09: posts small blind $0.50
gabi_igna: posts big blind $1
*** HOLE CARDS ***
Dealt to matiko09 [Th 9d]
IHouseMusic: folds 
di0d80: folds 
redacesfull: folds 
apfush: folds 
Kalesmash08: folds 
gwwsb: folds 
matiko09: raises $1.50 to $2.50
gabi_igna: folds 
Uncalled bet ($1.50) returned to matiko09
matiko09 collected $2 from pot
matiko09: doesn't show hand 
*** SUMMARY ***
Total pot $2 | Rake $0 
Seat 1: gabi_igna (big blind) folded before Flop
Seat 2: IHouseMusic folded before Flop (didn't bet)
Seat 4: di0d80 folded before Flop (didn't bet)
Seat 5: redacesfull folded before Flop (didn't bet)
Seat 6: apfush folded before Flop (didn't bet)
Seat 7: Kalesmash08 folded before Flop (didn't bet)
Seat 8: gwwsb (button) folded before Flop (didn't bet)
Seat 9: matiko09 (small blind) collected ($2)





PokerStars Hand #148834260206:  Hold'em No Limit ($0.50/$1.00 USD) - 2016/02/15 11:48:02 CET [2016/02/15 5:48:02 ET]
Table 'Urania' 9-max Seat #7 is the button
Seat 1: GRISHANYASHA ($34.41 in chips) 
Seat 2: maxxmeister ($115.96 in chips) 
Seat 4: matiko09 ($110.66 in chips) 
Seat 5: maxonplay ($182.45 in chips) 
Seat 6: gabi_igna ($100 in chips) 
Seat 7: er13to ($100 in chips) 
Seat 8: apfush ($125.91 in chips) 
Seat 9: mycka86 ($109.62 in chips) 
apfush: posts small blind $0.50
mycka86: posts big blind $1
*** HOLE CARDS ***
Dealt to matiko09 [2d Ac]
GRISHANYASHA: folds 
maxxmeister: folds 
matiko09: folds 
maxonplay: raises $3 to $4
gabi_igna: folds 
er13to: folds 
apfush: raises $9 to $13
mycka86: folds 
maxonplay: calls $9
*** FLOP *** [3h 5d 8h]
apfush: bets $15
maxonplay: folds 
Uncalled bet ($15) returned to apfush
apfush collected $25.78 from pot
apfush: doesn't show hand 
*** SUMMARY ***
Total pot $27 | Rake $1.22 
Board [3h 5d 8h]
Seat 1: GRISHANYASHA folded before Flop (didn't bet)
Seat 2: maxxmeister folded before Flop (didn't bet)
Seat 4: matiko09 folded before Flop (didn't bet)
Seat 5: maxonplay folded on the Flop
Seat 6: gabi_igna folded before Flop (didn't bet)
Seat 7: er13to (button) folded before Flop (didn't bet)
Seat 8: apfush (small blind) collected ($25.78)
Seat 9: mycka86 (big blind) folded before Flop





PokerStars Hand #148834265925:  Hold'em No Limit ($0.50/$1.00 USD) - 2016/02/15 11:48:14 CET [2016/02/15 5:48:14 ET]
Table 'Kitalpha II' 9-max Seat #3 is the button
Seat 1: IHouseMusic ($100 in chips) 
Seat 2: Aalleekks ($103.51 in chips) 
Seat 3: matiko09 ($100.36 in chips) 
Seat 4: Sreshta222 ($100 in chips) 
Seat 5: apfush ($100 in chips) 
Seat 6: Congo Sam ($111.88 in chips) 
Seat 7: 4Aces4Roses ($152.72 in chips) 
Seat 8: skram2 ($115.91 in chips) 
Seat 9: Waltz88 ($243.18 in chips) 
Sreshta222: posts small blind $0.50
apfush: posts big blind $1
*** HOLE CARDS ***
Dealt to matiko09 [4d 9s]
Congo Sam: folds 
4Aces4Roses: folds 
skram2: folds 
Waltz88: calls $1
IHouseMusic: folds 
Aalleekks: folds 
matiko09: folds 
Sreshta222: calls $0.50
apfush: raises $4.50 to $5.50
Waltz88: folds 
Sreshta222: folds 
Uncalled bet ($4.50) returned to apfush
apfush collected $3 from pot
apfush: doesn't show hand 
*** SUMMARY ***
Total pot $3 | Rake $0 
Seat 1: IHouseMusic folded before Flop (didn't bet)
Seat 2: Aalleekks folded before Flop (didn't bet)
Seat 3: matiko09 (button) folded before Flop (didn't bet)
Seat 4: Sreshta222 (small blind) folded before Flop
Seat 5: apfush (big blind) collected ($3)
Seat 6: Congo Sam folded before Flop (didn't bet)
Seat 7: 4Aces4Roses folded before Flop (didn't bet)
Seat 8: skram2 folded before Flop (didn't bet)
Seat 9: Waltz88 folded before Flop





PokerStars Hand #148834269653:  Hold'em No Limit ($0.50/$1.00 USD) - 2016/02/15 11:48:21 CET [2016/02/15 5:48:21 ET]
Table 'Gemma II' 9-max Seat #9 is the button
Seat 1: matiko09 ($114.90 in chips) 
Seat 2: gabi_igna ($141.70 in chips) 
Seat 3: Venomous100% ($159.09 in chips) 
Seat 4: mycka86 ($105.90 in chips) 
Seat 5: PokerSash201 ($68.69 in chips) 
Seat 6: IHouseMusic ($141.08 in chips) 
Seat 7: AlKatrone ($100 in chips) 
Seat 9: Waltz88 ($92.69 in chips) 
matiko09: posts small blind $0.50
gabi_igna: posts big blind $1
*** HOLE CARDS ***
Dealt to matiko09 [9h 6d]
Venomous100%: folds 
mycka86: raises $2 to $3
PokerSash201: folds 
IHouseMusic: folds 
AlKatrone: folds 
Waltz88: folds 
matiko09: folds 
gabi_igna: folds 
Uncalled bet ($2) returned to mycka86
mycka86 collected $2.50 from pot
*** SUMMARY ***
Total pot $2.50 | Rake $0 
Seat 1: matiko09 (small blind) folded before Flop
Seat 2: gabi_igna (big blind) folded before Flop
Seat 3: Venomous100% folded before Flop (didn't bet)
Seat 4: mycka86 collected ($2.50)
Seat 5: PokerSash201 folded before Flop (didn't bet)
Seat 6: IHouseMusic folded before Flop (didn't bet)
Seat 7: AlKatrone folded before Flop (didn't bet)
Seat 9: Waltz88 (button) folded before Flop (didn't bet)





PokerStars Hand #148834269744:  Hold'em No Limit ($0.50/$1.00 USD) - 2016/02/15 11:48:22 CET [2016/02/15 5:48:22 ET]
Table 'Corvus III' 9-max Seat #5 is the button
Seat 2: mzsportline ($142.20 in chips) 
Seat 3: VanDobeln ($246.60 in chips) 
Seat 5: maxxmeister ($256.09 in chips) 
Seat 7: matiko09 ($315.41 in chips) 
Seat 8: redacesfull ($252.85 in chips) 
Seat 9: er13to ($102.29 in chips) 
matiko09: posts small blind $0.50
redacesfull: posts big blind $1
mzsportline: posts the ante $0.20
VanDobeln: posts the ante $0.20
maxxmeister: posts the ante $0.20
matiko09: posts the ante $0.20
redacesfull: posts the ante $0.20
er13to: posts the ante $0.20
*** HOLE CARDS ***
Dealt to matiko09 [Ah Ac]
er13to: folds 
mzsportline: folds 
VanDobeln: folds 
maxxmeister: folds 
matiko09: raises $1.50 to $2.50
redacesfull: calls $1.50
*** FLOP *** [2h 7c Js]
matiko09: bets $3.85
redacesfull: folds 
Uncalled bet ($3.85) returned to matiko09
matiko09 collected $5.92 from pot
matiko09: doesn't show hand 
*** SUMMARY ***
Total pot $6.20 | Rake $0.28 
Board [2h 7c Js]
Seat 2: mzsportline folded before Flop (didn't bet)
Seat 3: VanDobeln folded before Flop (didn't bet)
Seat 5: maxxmeister (button) folded before Flop (didn't bet)
Seat 7: matiko09 (small blind) collected ($5.92)
Seat 8: redacesfull (big blind) folded on the Flop
Seat 9: er13to folded before Flop (didn't bet)





PokerStars Hand #148834271698:  Hold'em No Limit ($0.50/$1.00 USD) - 2016/02/15 11:48:26 CET [2016/02/15 5:48:26 ET]
Table 'Euanthe II' 9-max Seat #3 is the button
Seat 1: maxxmeister ($132.74 in chips) 
Seat 2: mahalko0925 ($90.09 in chips) 
Seat 3: matiko09 ($104.64 in chips) 
Seat 4: er13to ($110.18 in chips) 
Seat 5: gabi_igna ($174.51 in chips) 
Seat 6: IHouseMusic ($116.41 in chips) 
Seat 7: vinniesmol ($212.37 in chips) 
Seat 8: AlKatrone ($100 in chips) 
Seat 9: Venomous100% ($113.09 in chips) 
er13to: posts small blind $0.50
gabi_igna: posts big blind $1
*** HOLE CARDS ***
Dealt to matiko09 [As Jh]
IHouseMusic: folds 
vinniesmol: folds 
AlKatrone: raises $2 to $3
Venomous100%: folds 
maxxmeister: folds 
mahalko0925: calls $3
matiko09: calls $3
er13to: folds 
gabi_igna: folds 
*** FLOP *** [4c Ah 6h]
AlKatrone: checks 
mahalko0925: checks 
matiko09: bets $6.52
AlKatrone: folds 
mahalko0925: calls $6.52
*** TURN *** [4c Ah 6h] [2d]
mahalko0925: checks 
matiko09: bets $14.61
mahalko0925: folds 
Uncalled bet ($14.61) returned to matiko09
matiko09 collected $22.48 from pot
matiko09: doesn't show hand 
*** SUMMARY ***
Total pot $23.54 | Rake $1.06 
Board [4c Ah 6h 2d]
Seat 1: maxxmeister folded before Flop (didn't bet)
Seat 2: mahalko0925 folded on the Turn
Seat 3: matiko09 (button) collected ($22.48)
Seat 4: er13to (small blind) folded before Flop
Seat 5: gabi_igna (big blind) folded before Flop
Seat 6: IHouseMusic folded before Flop (didn't bet)
Seat 7: vinniesmol folded before Flop (didn't bet)
Seat 8: AlKatrone folded on the Flop
Seat 9: Venomous100% folded before Flop (didn't bet)





PokerStars Hand #148834276447:  Hold'em No Limit ($0.50/$1.00 USD) - 2016/02/15 11:48:35 CET [2016/02/15 5:48:35 ET]
Table 'Anteros' 9-max Seat #7 is the button
Seat 1: redacesfull ($126.40 in chips) 
Seat 2: IHouseMusic ($100 in chips) 
Seat 3: er13to ($100 in chips) 
Seat 4: misherei ($161.25 in chips) 
Seat 5: Holm1991 ($40.25 in chips) 
Seat 6: SerAlGog ($150.81 in chips) 
Seat 7: Zoubou1983 ($264.12 in chips) 
Seat 8: matiko09 ($100 in chips) 
Seat 9: mycka86 ($102 in chips) 
matiko09: posts small blind $0.50
mycka86: posts big blind $1
*** HOLE CARDS ***
Dealt to matiko09 [Jc Jd]
redacesfull: folds 
IHouseMusic: folds 
er13to: folds 
misherei: folds 
Holm1991: folds 
SerAlGog: raises $1.25 to $2.25
Zoubou1983: calls $2.25
matiko09: raises $7.75 to $10
mycka86: folds 
SerAlGog: calls $7.75
Zoubou1983: calls $7.75
*** FLOP *** [Jh Ts Js]
matiko09: checks 
SerAlGog: checks 
Zoubou1983: bets $15
matiko09: calls $15
SerAlGog: folds 
*** TURN *** [Jh Ts Js] [2h]
matiko09: checks 
Zoubou1983: bets $29
matiko09: calls $29
*** RIVER *** [Jh Ts Js 2h] [9s]
matiko09: checks 
Zoubou1983: bets $58
matiko09: calls $46 and is all-in
Uncalled bet ($12) returned to Zoubou1983
*** SHOW DOWN ***
Zoubou1983: shows [5c 5s] (two pair, Jacks and Fives)
matiko09: shows [Jc Jd] (four of a kind, Jacks)
matiko09 collected $208.20 from pot
*** SUMMARY ***
Total pot $211 | Rake $2.80 
Board [Jh Ts Js 2h 9s]
Seat 1: redacesfull folded before Flop (didn't bet)
Seat 2: IHouseMusic folded before Flop (didn't bet)
Seat 3: er13to folded before Flop (didn't bet)
Seat 4: misherei folded before Flop (didn't bet)
Seat 5: Holm1991 folded before Flop (didn't bet)
Seat 6: SerAlGog folded on the Flop
Seat 7: Zoubou1983 (button) showed [5c 5s] and lost with two pair, Jacks and Fives
Seat 8: matiko09 (small blind) showed [Jc Jd] and won ($208.20) with four of a kind, Jacks
Seat 9: mycka86 (big blind) folded before Flop





PokerStars Hand #148834277194:  Hold'em No Limit ($0.50/$1.00 USD) - 2016/02/15 11:48:37 CET [2016/02/15 5:48:37 ET]
Table 'Praecipua' 9-max Seat #4 is the button
Seat 1: TomK39 ($100 in chips) 
Seat 2: matiko09 ($129.81 in chips) 
Seat 4: gabi_igna ($102.50 in chips) 
Seat 5: apfush ($100 in chips) 
Seat 6: mycka86 ($141.07 in chips) 
Seat 7: maxxmeister ($164.23 in chips) 
Seat 8: Ellis Ng ($14.92 in chips) 
Seat 9: AlKatrone ($100 in chips) 
apfush: posts small blind $0.50
mycka86: posts big blind $1
J0k3rF4c3_FD: sits out 
*** HOLE CARDS ***
Dealt to matiko09 [Ac 7s]
maxxmeister: folds 
maxxmeister leaves the table
Ellis Ng: folds 
pandalapa joins the table at seat #7 
AlKatrone: folds 
TomK39: folds 
matiko09: folds 
gabi_igna: folds 
apfush: folds 
Uncalled bet ($0.50) returned to mycka86
mycka86 collected $1 from pot
*** SUMMARY ***
Total pot $1 | Rake $0 
Seat 1: TomK39 folded before Flop (didn't bet)
Seat 2: matiko09 folded before Flop (didn't bet)
Seat 4: gabi_igna (button) folded before Flop (didn't bet)
Seat 5: apfush (small blind) folded before Flop
Seat 6: mycka86 (big blind) collected ($1)
Seat 7: maxxmeister folded before Flop (didn't bet)
Seat 8: Ellis Ng folded before Flop (didn't bet)
Seat 9: AlKatrone folded before Flop (didn't bet)





PokerStars Hand #148834277199:  Hold'em No Limit ($0.50/$1.00 USD) - 2016/02/15 11:48:37 CET [2016/02/15 5:48:37 ET]
Table 'Nata II' 9-max Seat #7 is the button
Seat 2: qqcom ($100 in chips) 
Seat 3: g00000se ($103.45 in chips) 
Seat 4: gabi_igna ($157.44 in chips) 
Seat 6: AlKatrone ($148.33 in chips) 
Seat 7: er13to ($100.25 in chips) 
Seat 8: lumen21 ($171.68 in chips) 
Seat 9: matiko09 ($106.30 in chips) 
lumen21: posts small blind $0.50
matiko09: posts big blind $1
VanDobeln: sits out 
*** HOLE CARDS ***
Dealt to matiko09 [5c 8d]
qqcom: folds 
g00000se: folds 
gabi_igna: folds 
AlKatrone: folds 
er13to: folds 
lumen21: folds 
Uncalled bet ($0.50) returned to matiko09
matiko09 collected $1 from pot
matiko09: doesn't show hand 
*** SUMMARY ***
Total pot $1 | Rake $0 
Seat 2: qqcom folded before Flop (didn't bet)
Seat 3: g00000se folded before Flop (didn't bet)
Seat 4: gabi_igna folded before Flop (didn't bet)
Seat 6: AlKatrone folded before Flop (didn't bet)
Seat 7: er13to (button) folded before Flop (didn't bet)
Seat 8: lumen21 (small blind) folded before Flop
Seat 9: matiko09 (big blind) collected ($1)





PokerStars Hand #148834279389:  Hold'em No Limit ($0.50/$1.00 USD) - 2016/02/15 11:48:41 CET [2016/02/15 5:48:41 ET]
Table 'Ristenpart' 9-max Seat #9 is the button
Seat 1: gabi_igna ($132.80 in chips) 
Seat 2: IHouseMusic ($100 in chips) 
Seat 4: di0d80 ($101.50 in chips) 
Seat 5: redacesfull ($100 in chips) 
Seat 6: apfush ($121.45 in chips) 
Seat 7: Kalesmash08 ($17.83 in chips) 
Seat 8: gwwsb ($134.61 in chips) 
Seat 9: matiko09 ($120.07 in chips) 
gabi_igna: posts small blind $0.50
IHouseMusic: posts big blind $1
*** HOLE CARDS ***
Dealt to matiko09 [Kd Ks]
di0d80: folds 
redacesfull: folds 
apfush: folds 
Kalesmash08: folds 
gwwsb: raises $1 to $2
matiko09: raises $5 to $7
gabi_igna: folds 
IHouseMusic: raises $11 to $18
gwwsb: folds 
matiko09: raises $102.07 to $120.07 and is all-in
IHouseMusic: folds 
Uncalled bet ($102.07) returned to matiko09
matiko09 collected $38.50 from pot
matiko09: doesn't show hand 
*** SUMMARY ***
Total pot $38.50 | Rake $0 
Seat 1: gabi_igna (small blind) folded before Flop
Seat 2: IHouseMusic (big blind) folded before Flop
Seat 4: di0d80 folded before Flop (didn't bet)
Seat 5: redacesfull folded before Flop (didn't bet)
Seat 6: apfush folded before Flop (didn't bet)
Seat 7: Kalesmash08 folded before Flop (didn't bet)
Seat 8: gwwsb folded before Flop
Seat 9: matiko09 (button) collected ($38.50)





PokerStars Hand #148834283325:  Hold'em No Limit ($0.50/$1.00 USD) - 2016/02/15 11:48:49 CET [2016/02/15 5:48:49 ET]
Table 'Gemma II' 9-max Seat #1 is the button
Seat 1: matiko09 ($114.40 in chips) 
Seat 2: gabi_igna ($140.70 in chips) 
Seat 3: Venomous100% ($159.09 in chips) 
Seat 4: mycka86 ($107.40 in chips) 
Seat 5: PokerSash201 ($68.69 in chips) 
Seat 6: IHouseMusic ($141.08 in chips) 
Seat 7: AlKatrone ($100 in chips) 
Seat 9: Waltz88 ($92.69 in chips) 
gabi_igna: posts small blind $0.50
Venomous100%: posts big blind $1
*** HOLE CARDS ***
Dealt to matiko09 [8d As]
mycka86: raises $2 to $3
PokerSash201: folds 
IHouseMusic: folds 
AlKatrone: folds 
Waltz88: folds 
matiko09: folds 
gabi_igna: folds 
Venomous100%: folds 
Uncalled bet ($2) returned to mycka86
mycka86 collected $2.50 from pot
*** SUMMARY ***
Total pot $2.50 | Rake $0 
Seat 1: matiko09 (button) folded before Flop (didn't bet)
Seat 2: gabi_igna (small blind) folded before Flop
Seat 3: Venomous100% (big blind) folded before Flop
Seat 4: mycka86 collected ($2.50)
Seat 5: PokerSash201 folded before Flop (didn't bet)
Seat 6: IHouseMusic folded before Flop (didn't bet)
Seat 7: AlKatrone folded before Flop (didn't bet)
Seat 9: Waltz88 folded before Flop (didn't bet)





PokerStars Hand #148834283922:  Hold'em No Limit ($0.25/$0.50 USD) - 2016/02/15 11:48:50 CET [2016/02/15 5:48:50 ET]
Table 'Vesta II' 9-max Seat #9 is the button
Seat 1: lumen21 ($50 in chips) 
Seat 2: ljryviltj ($59.79 in chips) 
Seat 3: matiko09 ($56.78 in chips) 
Seat 4: vlad11122007 ($53.28 in chips) 
Seat 5: Serhent ($50 in chips) 
Seat 6: Gutschel ($72.12 in chips) 
Seat 7: ruyingren ($13.97 in chips) 
Seat 8: Arystan ($60.46 in chips) 
Seat 9: Aoki42 ($110.60 in chips) 
lumen21: posts small blind $0.25
ljryviltj: posts big blind $0.50
*** HOLE CARDS ***
Dealt to matiko09 [Ac 2h]
matiko09: folds 
vlad11122007: raises $1 to $1.50
Serhent: folds 
Gutschel: folds 
ruyingren: folds 
Arystan has timed out
Arystan: folds 
Aoki42: folds 
lumen21: folds 
ljryviltj: folds 
Uncalled bet ($1) returned to vlad11122007
vlad11122007 collected $1.25 from pot
vlad11122007: doesn't show hand 
*** SUMMARY ***
Total pot $1.25 | Rake $0 
Seat 1: lumen21 (small blind) folded before Flop
Seat 2: ljryviltj (big blind) folded before Flop
Seat 3: matiko09 folded before Flop (didn't bet)
Seat 4: vlad11122007 collected ($1.25)
Seat 5: Serhent folded before Flop (didn't bet)
Seat 6: Gutschel folded before Flop (didn't bet)
Seat 7: ruyingren folded before Flop (didn't bet)
Seat 8: Arystan folded before Flop (didn't bet)
Seat 9: Aoki42 (button) folded before Flop (didn't bet)





PokerStars Hand #148834286857:  Hold'em No Limit (€0.50/€1.00 EUR) - 2016/02/15 11:48:56 CET [2016/02/15 5:48:56 ET]
Table 'Ganesa II' 9-max Seat #8 is the button
Seat 2: Venomous100% (€126.33 in chips) 
Seat 4: Sreshta222 (€120.33 in chips) 
Seat 5: AlKatrone (€102.27 in chips) 
Seat 6: matiko09 (€118.02 in chips) 
Seat 7: er13to (€129.91 in chips) 
Seat 8: mycka86 (€134.01 in chips) 
maxxmeister will be allowed to play after the button
Venomous100%: posts small blind €0.50
Sreshta222: posts big blind €1
*** HOLE CARDS ***
Dealt to matiko09 [3h 2h]
AlKatrone: folds 
matiko09: folds 
er13to: folds 
mycka86: raises €1.10 to €2.10
Venomous100%: folds 
Sreshta222: calls €1.10
*** FLOP *** [4h 9s Kd]
Sreshta222: checks 
mycka86: bets €3.30
Sreshta222: raises €7.39 to €10.69
mycka86: calls €7.39
*** TURN *** [4h 9s Kd] [Qd]
Sreshta222: bets €18.68
mycka86: calls €18.68
*** RIVER *** [4h 9s Kd Qd] [Ts]
Sreshta222: bets €24.51
mycka86: folds 
Uncalled bet (€24.51) returned to Sreshta222
Sreshta222 collected €61.29 from pot
Sreshta222: doesn't show hand 
*** SUMMARY ***
Total pot €63.44 | Rake €2.15 
Board [4h 9s Kd Qd Ts]
Seat 2: Venomous100% (small blind) folded before Flop
Seat 4: Sreshta222 (big blind) collected (€61.29)
Seat 5: AlKatrone folded before Flop (didn't bet)
Seat 6: matiko09 folded before Flop (didn't bet)
Seat 7: er13to folded before Flop (didn't bet)
Seat 8: mycka86 (button) folded on the River





PokerStars Hand #148834286831:  Hold'em No Limit ($0.50/$1.00 USD) - 2016/02/15 11:48:56 CET [2016/02/15 5:48:56 ET]
Table 'Corvus III' 9-max Seat #7 is the button
Seat 2: mzsportline ($142 in chips) 
Seat 3: VanDobeln ($246.40 in chips) 
Seat 5: maxxmeister ($255.89 in chips) 
Seat 7: matiko09 ($318.63 in chips) 
Seat 8: redacesfull ($250.15 in chips) 
Seat 9: er13to ($102.09 in chips) 
redacesfull: posts small blind $0.50
er13to: posts big blind $1
mzsportline: posts the ante $0.20
VanDobeln: posts the ante $0.20
maxxmeister: posts the ante $0.20
matiko09: posts the ante $0.20
redacesfull: posts the ante $0.20
er13to: posts the ante $0.20
*** HOLE CARDS ***
Dealt to matiko09 [Jc 5d]
mzsportline: folds 
VanDobeln: folds 
maxxmeister: folds 
matiko09: folds 
redacesfull: folds 
Uncalled bet ($0.50) returned to er13to
er13to collected $2.20 from pot
*** SUMMARY ***
Total pot $2.20 | Rake $0 
Seat 2: mzsportline folded before Flop (didn't bet)
Seat 3: VanDobeln folded before Flop (didn't bet)
Seat 5: maxxmeister folded before Flop (didn't bet)
Seat 7: matiko09 (button) folded before Flop (didn't bet)
Seat 8: redacesfull (small blind) folded before Flop
Seat 9: er13to (big blind) collected ($2.20)





PokerStars Hand #148834289130:  Hold'em No Limit ($0.50/$1.00 USD) - 2016/02/15 11:49:01 CET [2016/02/15 5:49:01 ET]
Table 'Nata II' 9-max Seat #8 is the button
Seat 2: qqcom ($100 in chips) 
Seat 3: g00000se ($103.45 in chips) 
Seat 4: gabi_igna ($157.44 in chips) 
Seat 6: AlKatrone ($148.33 in chips) 
Seat 7: er13to ($100.25 in chips) 
Seat 8: lumen21 ($171.18 in chips) 
Seat 9: matiko09 ($106.80 in chips) 
matiko09: posts small blind $0.50
qqcom: posts big blind $1
VanDobeln: sits out 
*** HOLE CARDS ***
Dealt to matiko09 [Jh 7d]
g00000se: raises $1.50 to $2.50
gabi_igna: folds 
AlKatrone: raises $5.50 to $8
er13to: folds 
lumen21: folds 
matiko09: folds 
qqcom: folds 
g00000se: folds 
Uncalled bet ($5.50) returned to AlKatrone
AlKatrone collected $6.50 from pot
AlKatrone: doesn't show hand 
*** SUMMARY ***
Total pot $6.50 | Rake $0 
Seat 2: qqcom (big blind) folded before Flop
Seat 3: g00000se folded before Flop
Seat 4: gabi_igna folded before Flop (didn't bet)
Seat 6: AlKatrone collected ($6.50)
Seat 7: er13to folded before Flop (didn't bet)
Seat 8: lumen21 (button) folded before Flop (didn't bet)
Seat 9: matiko09 (small blind) folded before Flop





PokerStars Hand #148834290929:  Hold'em No Limit ($0.50/$1.00 USD) - 2016/02/15 11:49:04 CET [2016/02/15 5:49:04 ET]
Table 'Urania' 9-max Seat #8 is the button
Seat 1: GRISHANYASHA ($34.41 in chips) 
Seat 2: maxxmeister ($115.96 in chips) 
Seat 4: matiko09 ($110.66 in chips) 
Seat 5: maxonplay ($169.45 in chips) 
Seat 6: gabi_igna ($100 in chips) 
Seat 7: er13to ($100 in chips) 
Seat 8: apfush ($138.69 in chips) 
Seat 9: mycka86 ($108.62 in chips) 
mycka86: posts small blind $0.50
GRISHANYASHA: posts big blind $1
*** HOLE CARDS ***
Dealt to matiko09 [6h 3d]
maxxmeister: folds 
matiko09: folds 
maxonplay: raises $3 to $4
gabi_igna: folds 
er13to: folds 
apfush: folds 
mycka86: folds 
GRISHANYASHA: folds 
Uncalled bet ($3) returned to maxonplay
maxonplay collected $2.50 from pot
maxonplay: doesn't show hand 
*** SUMMARY ***
Total pot $2.50 | Rake $0 
Seat 1: GRISHANYASHA (big blind) folded before Flop
Seat 2: maxxmeister folded before Flop (didn't bet)
Seat 4: matiko09 folded before Flop (didn't bet)
Seat 5: maxonplay collected ($2.50)
Seat 6: gabi_igna folded before Flop (didn't bet)
Seat 7: er13to folded before Flop (didn't bet)
Seat 8: apfush (button) folded before Flop (didn't bet)
Seat 9: mycka86 (small blind) folded before Flop





PokerStars Hand #148834290479:  Hold'em No Limit ($0.50/$1.00 USD) - 2016/02/15 11:49:04 CET [2016/02/15 5:49:04 ET]
Table 'Kitalpha II' 9-max Seat #4 is the button
Seat 1: IHouseMusic ($100 in chips) 
Seat 2: Aalleekks ($103.51 in chips) 
Seat 3: matiko09 ($100.36 in chips) 
Seat 4: Sreshta222 ($100 in chips) 
Seat 5: apfush ($102 in chips) 
Seat 6: Congo Sam ($111.88 in chips) 
Seat 7: 4Aces4Roses ($152.72 in chips) 
Seat 8: skram2 ($115.91 in chips) 
Seat 9: Waltz88 ($242.18 in chips) 
apfush: posts small blind $0.50
Congo Sam: posts big blind $1
*** HOLE CARDS ***
Dealt to matiko09 [2s Tc]
4Aces4Roses: raises $1 to $2
skram2: folds 
Waltz88: folds 
IHouseMusic: folds 
Aalleekks: folds 
matiko09: folds 
Waltz88 leaves the table
Sreshta222: folds 
apfush: folds 
Congo Sam: folds 
Uncalled bet ($1) returned to 4Aces4Roses
4Aces4Roses collected $2.50 from pot
4Aces4Roses: doesn't show hand 
*** SUMMARY ***
Total pot $2.50 | Rake $0 
Seat 1: IHouseMusic folded before Flop (didn't bet)
Seat 2: Aalleekks folded before Flop (didn't bet)
Seat 3: matiko09 folded before Flop (didn't bet)
Seat 4: Sreshta222 (button) folded before Flop (didn't bet)
Seat 5: apfush (small blind) folded before Flop
Seat 6: Congo Sam (big blind) folded before Flop
Seat 7: 4Aces4Roses collected ($2.50)
Seat 8: skram2 folded before Flop (didn't bet)
Seat 9: Waltz88 folded before Flop (didn't bet)





PokerStars Hand #148834292408:  Hold'em No Limit ($0.50/$1.00 USD) - 2016/02/15 11:49:07 CET [2016/02/15 5:49:07 ET]
Table 'Praecipua' 9-max Seat #5 is the button
Seat 1: TomK39 ($100 in chips) 
Seat 2: matiko09 ($129.81 in chips) 
Seat 4: gabi_igna ($102.50 in chips) 
Seat 5: apfush ($100 in chips) 
Seat 6: mycka86 ($141.57 in chips) 
Seat 7: pandalapa ($100 in chips) 
Seat 8: Ellis Ng ($14.92 in chips) 
Seat 9: AlKatrone ($100 in chips) 
mycka86: posts small blind $0.50
pandalapa: posts big blind $1
J0k3rF4c3_FD: sits out 
*** HOLE CARDS ***
Dealt to matiko09 [9c Ts]
Ellis Ng: folds 
AlKatrone: raises $2 to $3
TomK39: folds 
matiko09: folds 
gabi_igna: raises $6 to $9
apfush: folds 
mycka86: folds 
pandalapa: folds 
AlKatrone: folds 
Uncalled bet ($6) returned to gabi_igna
gabi_igna collected $7.50 from pot
gabi_igna: doesn't show hand 
*** SUMMARY ***
Total pot $7.50 | Rake $0 
Seat 1: TomK39 folded before Flop (didn't bet)
Seat 2: matiko09 folded before Flop (didn't bet)
Seat 4: gabi_igna collected ($7.50)
Seat 5: apfush (button) folded before Flop (didn't bet)
Seat 6: mycka86 (small blind) folded before Flop
Seat 7: pandalapa (big blind) folded before Flop
Seat 8: Ellis Ng folded before Flop (didn't bet)
Seat 9: AlKatrone folded before Flop





PokerStars Hand #148834294642:  Hold'em No Limit ($0.50/$1.00 USD) - 2016/02/15 11:49:12 CET [2016/02/15 5:49:12 ET]
Table 'Corvus III' 9-max Seat #8 is the button
Seat 2: mzsportline ($141.80 in chips) 
Seat 3: VanDobeln ($246.20 in chips) 
Seat 5: maxxmeister ($255.69 in chips) 
Seat 7: matiko09 ($318.43 in chips) 
Seat 8: redacesfull ($249.45 in chips) 
Seat 9: er13to ($103.59 in chips) 
er13to: posts small blind $0.50
mzsportline: posts big blind $1
Priidix: sits out 
mzsportline: posts the ante $0.20
VanDobeln: posts the ante $0.20
maxxmeister: posts the ante $0.20
matiko09: posts the ante $0.20
redacesfull: posts the ante $0.20
er13to: posts the ante $0.20
*** HOLE CARDS ***
Dealt to matiko09 [2d Qs]
VanDobeln: raises $2 to $3
maxxmeister: folds 
matiko09: folds 
redacesfull: folds 
er13to: folds 
mzsportline: folds 
Uncalled bet ($2) returned to VanDobeln
VanDobeln collected $3.70 from pot
VanDobeln: doesn't show hand 
*** SUMMARY ***
Total pot $3.70 | Rake $0 
Seat 2: mzsportline (big blind) folded before Flop
Seat 3: VanDobeln collected ($3.70)
Seat 5: maxxmeister folded before Flop (didn't bet)
Seat 7: matiko09 folded before Flop (didn't bet)
Seat 8: redacesfull (button) folded before Flop (didn't bet)
Seat 9: er13to (small blind) folded before Flop





PokerStars Hand #148834295502:  Hold'em No Limit ($0.50/$1.00 USD) - 2016/02/15 11:49:14 CET [2016/02/15 5:49:14 ET]
Table 'Octans II' 9-max Seat #1 is the button
Seat 1: maxxmeister ($100 in chips) 
Seat 2: matiko09 ($304.08 in chips) 
Seat 3: VanDobeln ($100 in chips) 
Seat 4: Venomous100% ($202.23 in chips) 
Seat 5: gabi_igna ($100 in chips) 
Seat 6: er13to ($100 in chips) 
Seat 8: IHouseMusic ($124.88 in chips) 
Seat 9: mycka86 ($100 in chips) 
matiko09: posts small blind $0.50
VanDobeln: posts big blind $1
redacesfull: sits out 
*** HOLE CARDS ***
Dealt to matiko09 [Kh 5s]
Venomous100%: folds 
gabi_igna: folds 
er13to: folds 
IHouseMusic: folds 
mycka86: raises $1.10 to $2.10
maxxmeister: folds 
matiko09: folds 
VanDobeln: folds 
Uncalled bet ($1.10) returned to mycka86
mycka86 collected $2.50 from pot
*** SUMMARY ***
Total pot $2.50 | Rake $0 
Seat 1: maxxmeister (button) folded before Flop (didn't bet)
Seat 2: matiko09 (small blind) folded before Flop
Seat 3: VanDobeln (big blind) folded before Flop
Seat 4: Venomous100% folded before Flop (didn't bet)
Seat 5: gabi_igna folded before Flop (didn't bet)
Seat 6: er13to folded before Flop (didn't bet)
Seat 8: IHouseMusic folded before Flop (didn't bet)
Seat 9: mycka86 collected ($2.50)





PokerStars Hand #148834296373:  Hold'em No Limit ($0.50/$1.00 USD) - 2016/02/15 11:49:15 CET [2016/02/15 5:49:15 ET]
Table 'Oongaq' 9-max Seat #6 is the button
Seat 1: matiko09 ($102 in chips) 
Seat 3: wilsong96 ($93.13 in chips) 
Seat 4: maxxmeister ($110.57 in chips) 
Seat 5: mn230758 ($49.64 in chips) 
Seat 6: IHouseMusic ($100.21 in chips) 
Seat 7: gwwsb ($72.98 in chips) 
Seat 8: AlKatrone ($114.25 in chips) 
Seat 9: alpw47 ($12.51 in chips) 
gwwsb: posts small blind $0.50
AlKatrone: posts big blind $1
Priidix: sits out 
*** HOLE CARDS ***
Dealt to matiko09 [4c Js]
alpw47: calls $1
matiko09: folds 
wilsong96: calls $1
maxxmeister: raises $6 to $7
mn230758: folds 
IHouseMusic: folds 
gwwsb: folds 
AlKatrone: raises $10 to $17
alpw47: folds 
wilsong96: calls $16
maxxmeister: calls $10
*** FLOP *** [Qd 3s 9h]
AlKatrone: bets $17.04
wilsong96: folds 
maxxmeister: folds 
Uncalled bet ($17.04) returned to AlKatrone
AlKatrone collected $50.14 from pot
AlKatrone: doesn't show hand 
*** SUMMARY ***
Total pot $52.50 | Rake $2.36 
Board [Qd 3s 9h]
Seat 1: matiko09 folded before Flop (didn't bet)
Seat 3: wilsong96 folded on the Flop
Seat 4: maxxmeister folded on the Flop
Seat 5: mn230758 folded before Flop (didn't bet)
Seat 6: IHouseMusic (button) folded before Flop (didn't bet)
Seat 7: gwwsb (small blind) folded before Flop
Seat 8: AlKatrone (big blind) collected ($50.14)
Seat 9: alpw47 folded before Flop





PokerStars Hand #148834299137:  Hold'em No Limit ($0.50/$1.00 USD) - 2016/02/15 11:49:21 CET [2016/02/15 5:49:21 ET]
Table 'Gemma II' 9-max Seat #2 is the button
Seat 1: matiko09 ($114.40 in chips) 
Seat 2: gabi_igna ($140.20 in chips) 
Seat 3: Venomous100% ($158.09 in chips) 
Seat 4: mycka86 ($108.90 in chips) 
Seat 5: PokerSash201 ($68.69 in chips) 
Seat 6: IHouseMusic ($141.08 in chips) 
Seat 7: AlKatrone ($100 in chips) 
Seat 9: Waltz88 ($92.69 in chips) 
Venomous100%: posts small blind $0.50
mycka86: posts big blind $1
Priidix: sits out 
*** HOLE CARDS ***
Dealt to matiko09 [Kd 4s]
PokerSash201: calls $1
IHouseMusic: folds 
AlKatrone: folds 
Waltz88: folds 
Waltz88 leaves the table
matiko09: folds 
gabi_igna: folds 
Venomous100%: raises $5 to $6
mycka86: folds 
PokerSash201: calls $5
*** FLOP *** [9c 4d Th]
Venomous100%: bets $8.20
PokerSash201: calls $8.20
*** TURN *** [9c 4d Th] [8s]
Jimy Tiltman joins the table at seat #9 
Venomous100%: checks 
PokerSash201: checks 
*** RIVER *** [9c 4d Th 8s] [8d]
Venomous100%: checks 
PokerSash201: checks 
*** SHOW DOWN ***
Venomous100%: shows [9s 6s] (two pair, Nines and Eights)
PokerSash201: shows [Kc Td] (two pair, Tens and Eights)
PokerSash201 collected $28.08 from pot
*** SUMMARY ***
Total pot $29.40 | Rake $1.32 
Board [9c 4d Th 8s 8d]
Seat 1: matiko09 folded before Flop (didn't bet)
Seat 2: gabi_igna (button) folded before Flop (didn't bet)
Seat 3: Venomous100% (small blind) showed [9s 6s] and lost with two pair, Nines and Eights
Seat 4: mycka86 (big blind) folded before Flop
Seat 5: PokerSash201 showed [Kc Td] and won ($28.08) with two pair, Tens and Eights
Seat 6: IHouseMusic folded before Flop (didn't bet)
Seat 7: AlKatrone folded before Flop (didn't bet)
Seat 9: Waltz88 folded before Flop (didn't bet)





PokerStars Hand #148834302039:  Hold'em No Limit ($0.50/$1.00 USD) - 2016/02/15 11:49:27 CET [2016/02/15 5:49:27 ET]
Table 'Urania' 9-max Seat #9 is the button
Seat 1: GRISHANYASHA ($33.41 in chips) 
Seat 2: maxxmeister ($115.96 in chips) 
Seat 4: matiko09 ($110.66 in chips) 
Seat 5: maxonplay ($170.95 in chips) 
Seat 6: gabi_igna ($100 in chips) 
Seat 7: er13to ($100 in chips) 
Seat 8: apfush ($138.69 in chips) 
Seat 9: mycka86 ($108.12 in chips) 
GRISHANYASHA: posts small blind $0.50
maxxmeister: posts big blind $1
Priidix: sits out 
*** HOLE CARDS ***
Dealt to matiko09 [5h 9d]
matiko09: folds 
maxonplay: folds 
gabi_igna: folds 
er13to: folds 
apfush: folds 
mycka86: raises $1.10 to $2.10
GRISHANYASHA: folds 
maxxmeister: folds 
Uncalled bet ($1.10) returned to mycka86
mycka86 collected $2.50 from pot
*** SUMMARY ***
Total pot $2.50 | Rake $0 
Seat 1: GRISHANYASHA (small blind) folded before Flop
Seat 2: maxxmeister (big blind) folded before Flop
Seat 4: matiko09 folded before Flop (didn't bet)
Seat 5: maxonplay folded before Flop (didn't bet)
Seat 6: gabi_igna folded before Flop (didn't bet)
Seat 7: er13to folded before Flop (didn't bet)
Seat 8: apfush folded before Flop (didn't bet)
Seat 9: mycka86 (button) collected ($2.50)





PokerStars Hand #148834307391:  Hold'em No Limit ($0.50/$1.00 USD) - 2016/02/15 11:49:38 CET [2016/02/15 5:49:38 ET]
Table 'Kitalpha II' 9-max Seat #5 is the button
Seat 1: IHouseMusic ($100 in chips) 
Seat 2: Aalleekks ($103.51 in chips) 
Seat 3: matiko09 ($100.36 in chips) 
Seat 4: Sreshta222 ($100 in chips) 
Seat 5: apfush ($101.50 in chips) 
Seat 6: Congo Sam ($110.88 in chips) 
Seat 7: 4Aces4Roses ($154.22 in chips) 
Seat 8: skram2 ($115.91 in chips) 
Congo Sam: posts small blind $0.50
4Aces4Roses: posts big blind $1
*** HOLE CARDS ***
Dealt to matiko09 [8d Kc]
skram2: raises $1 to $2
IHouseMusic: folds 
Aalleekks: folds 
matiko09: folds 
Sreshta222: folds 
apfush: folds 
Congo Sam: calls $1.50
4Aces4Roses: folds 
*** FLOP *** [9h Ks 8c]
Congo Sam: checks 
skram2: checks 
*** TURN *** [9h Ks 8c] [Qh]
Congo Sam: checks 
skram2: checks 
*** RIVER *** [9h Ks 8c Qh] [3s]
Congo Sam: checks 
skram2: checks 
*** SHOW DOWN ***
Congo Sam: shows [7d Td] (high card King)
skram2: shows [Th As] (high card Ace)
skram2 collected $4.78 from pot
*** SUMMARY ***
Total pot $5 | Rake $0.22 
Board [9h Ks 8c Qh 3s]
Seat 1: IHouseMusic folded before Flop (didn't bet)
Seat 2: Aalleekks folded before Flop (didn't bet)
Seat 3: matiko09 folded before Flop (didn't bet)
Seat 4: Sreshta222 folded before Flop (didn't bet)
Seat 5: apfush (button) folded before Flop (didn't bet)
Seat 6: Congo Sam (small blind) showed [7d Td] and lost with high card King
Seat 7: 4Aces4Roses (big blind) folded before Flop
Seat 8: skram2 showed [Th As] and won ($4.78) with high card Ace





PokerStars Hand #148834309848:  Hold'em No Limit ($0.50/$1.00 USD) - 2016/02/15 11:49:43 CET [2016/02/15 5:49:43 ET]
Table 'Octans II' 9-max Seat #2 is the button
Seat 1: maxxmeister ($100 in chips) 
Seat 2: matiko09 ($303.58 in chips) 
Seat 3: VanDobeln ($99 in chips) 
Seat 4: Venomous100% ($202.23 in chips) 
Seat 5: gabi_igna ($100 in chips) 
Seat 6: er13to ($100 in chips) 
Seat 8: IHouseMusic ($124.88 in chips) 
Seat 9: mycka86 ($101.50 in chips) 
VanDobeln: posts small blind $0.50
Venomous100%: posts big blind $1
redacesfull: sits out 
*** HOLE CARDS ***
Dealt to matiko09 [7s 8d]
gabi_igna: folds 
er13to: folds 
IHouseMusic: folds 
mycka86: raises $1.50 to $2.50
maxxmeister: folds 
matiko09: folds 
VanDobeln: folds 
Venomous100%: folds 
Uncalled bet ($1.50) returned to mycka86
mycka86 collected $2.50 from pot
*** SUMMARY ***
Total pot $2.50 | Rake $0 
Seat 1: maxxmeister folded before Flop (didn't bet)
Seat 2: matiko09 (button) folded before Flop (didn't bet)
Seat 3: VanDobeln (small blind) folded before Flop
Seat 4: Venomous100% (big blind) folded before Flop
Seat 5: gabi_igna folded before Flop (didn't bet)
Seat 6: er13to folded before Flop (didn't bet)
Seat 8: IHouseMusic folded before Flop (didn't bet)
Seat 9: mycka86 collected ($2.50)





PokerStars Hand #148834311329:  Hold'em No Limit ($0.50/$1.00 USD) - 2016/02/15 11:49:46 CET [2016/02/15 5:49:46 ET]
Table 'Euanthe II' 9-max Seat #4 is the button
Seat 1: maxxmeister ($132.74 in chips) 
Seat 2: mahalko0925 ($80.57 in chips) 
Seat 3: matiko09 ($117.60 in chips) 
Seat 4: er13to ($109.68 in chips) 
Seat 5: gabi_igna ($173.51 in chips) 
Seat 6: IHouseMusic ($116.41 in chips) 
Seat 7: vinniesmol ($212.37 in chips) 
Seat 8: AlKatrone ($100 in chips) 
Seat 9: Venomous100% ($113.09 in chips) 
gabi_igna: posts small blind $0.50
IHouseMusic: posts big blind $1
*** HOLE CARDS ***
Dealt to matiko09 [4d Kc]
vinniesmol: folds 
AlKatrone has timed out
AlKatrone: folds 
Venomous100%: folds 
maxxmeister: folds 
mahalko0925: folds 
matiko09: folds 
er13to: folds 
gabi_igna: raises $2 to $3
IHouseMusic: calls $2
*** FLOP *** [7s Ks 7d]
gabi_igna: checks 
IHouseMusic: checks 
*** TURN *** [7s Ks 7d] [9s]
gabi_igna: bets $3
IHouseMusic: calls $3
*** RIVER *** [7s Ks 7d 9s] [3d]
gabi_igna: bets $8
IHouseMusic: raises $13 to $21
gabi_igna: folds 
Uncalled bet ($13) returned to IHouseMusic
IHouseMusic collected $26.74 from pot
IHouseMusic: doesn't show hand 
*** SUMMARY ***
Total pot $28 | Rake $1.26 
Board [7s Ks 7d 9s 3d]
Seat 1: maxxmeister folded before Flop (didn't bet)
Seat 2: mahalko0925 folded before Flop (didn't bet)
Seat 3: matiko09 folded before Flop (didn't bet)
Seat 4: er13to (button) folded before Flop (didn't bet)
Seat 5: gabi_igna (small blind) folded on the River
Seat 6: IHouseMusic (big blind) collected ($26.74)
Seat 7: vinniesmol folded before Flop (didn't bet)
Seat 8: AlKatrone folded before Flop (didn't bet)
Seat 9: Venomous100% folded before Flop (didn't bet)





PokerStars Hand #148834312099:  Hold'em No Limit ($0.50/$1.00 USD) - 2016/02/15 11:49:47 CET [2016/02/15 5:49:47 ET]
Table 'Urania' 9-max Seat #1 is the button
Seat 1: GRISHANYASHA ($32.91 in chips) 
Seat 2: maxxmeister ($114.96 in chips) 
Seat 3: Priidix ($159.01 in chips) 
Seat 4: matiko09 ($110.66 in chips) 
Seat 5: maxonplay ($170.95 in chips) 
Seat 6: gabi_igna ($100 in chips) 
Seat 7: er13to ($100 in chips) 
Seat 8: apfush ($138.69 in chips) 
Seat 9: mycka86 ($109.62 in chips) 
maxxmeister: posts small blind $0.50
Priidix: posts big blind $1
*** HOLE CARDS ***
Dealt to matiko09 [Ts Jh]
matiko09: folds 
maxonplay: folds 
gabi_igna: folds 
er13to: folds 
apfush: folds 
mycka86: folds 
GRISHANYASHA: folds 
maxxmeister: raises $3 to $4
Priidix: folds 
Uncalled bet ($3) returned to maxxmeister
maxxmeister collected $2 from pot
maxxmeister: doesn't show hand 
*** SUMMARY ***
Total pot $2 | Rake $0 
Seat 1: GRISHANYASHA (button) folded before Flop (didn't bet)
Seat 2: maxxmeister (small blind) collected ($2)
Seat 3: Priidix (big blind) folded before Flop
Seat 4: matiko09 folded before Flop (didn't bet)
Seat 5: maxonplay folded before Flop (didn't bet)
Seat 6: gabi_igna folded before Flop (didn't bet)
Seat 7: er13to folded before Flop (didn't bet)
Seat 8: apfush folded before Flop (didn't bet)
Seat 9: mycka86 folded before Flop (didn't bet)





