PokerStars Hand #148607054339:  Hold'em No Limit ($0.50/$1.00 USD) - 2016/02/11 12:15:05 CET [2016/02/11 6:15:05 ET]
Table 'Magaclite' 9-max Seat #3 is the button
Seat 1: oscarleon ($109 in chips) 
Seat 2: AlKatrone ($106.55 in chips) 
Seat 3: matiko09 ($100 in chips) 
Seat 4: Sweden_Pound ($100 in chips) 
Seat 5: Tarjei82 ($78.50 in chips) 
Seat 6: er13to ($104.35 in chips) 
Seat 7: sebaaastian ($100 in chips) 
Seat 8: CoolFireX ($106.07 in chips) 
Seat 9: Lujan87 ($140.73 in chips) 
Sweden_Pound: posts small blind $0.50
Tarjei82: posts big blind $1
*** HOLE CARDS ***
Dealt to matiko09 [Ac 7c]
er13to: folds 
sebaaastian: raises $2 to $3
CoolFireX: folds 
Lujan87: folds 
oscarleon: folds 
AlKatrone: folds 
matiko09: folds 
Sweden_Pound: folds 
Tarjei82: folds 
Uncalled bet ($2) returned to sebaaastian
sebaaastian collected $2.50 from pot
sebaaastian: doesn't show hand 
*** SUMMARY ***
Total pot $2.50 | Rake $0 
Seat 1: oscarleon folded before Flop (didn't bet)
Seat 2: AlKatrone folded before Flop (didn't bet)
Seat 3: matiko09 (button) folded before Flop (didn't bet)
Seat 4: Sweden_Pound (small blind) folded before Flop
Seat 5: Tarjei82 (big blind) folded before Flop
Seat 6: er13to folded before Flop (didn't bet)
Seat 7: sebaaastian collected ($2.50)
Seat 8: CoolFireX folded before Flop (didn't bet)
Seat 9: Lujan87 folded before Flop (didn't bet)





PokerStars Hand #148607055253:  Hold'em No Limit ($0.25/$0.50 USD) - 2016/02/11 12:15:06 CET [2016/02/11 6:15:06 ET]
Table 'Sylvania II' 9-max Seat #7 is the button
Seat 1: mexx1234 ($191.50 in chips) 
Seat 2: Effort92 ($51.35 in chips) 
Seat 3: ruyingren ($216.55 in chips) 
Seat 4: matiko09 ($120.70 in chips) 
Seat 5: vlad11122007 ($48.35 in chips) 
Seat 6: TonnaMunz ($120.39 in chips) 
Seat 7: i L00K great ($60.39 in chips) 
Seat 8: Optimistic21 ($50 in chips) 
Seat 9: Kud3 ($151.25 in chips) 
Optimistic21: posts small blind $0.25
Kud3: posts big blind $0.50
mexx1234: posts the ante $0.10
Effort92: posts the ante $0.10
ruyingren: posts the ante $0.10
matiko09: posts the ante $0.10
vlad11122007: posts the ante $0.10
TonnaMunz: posts the ante $0.10
i L00K great: posts the ante $0.10
Optimistic21: posts the ante $0.10
Kud3: posts the ante $0.10
*** HOLE CARDS ***
Dealt to matiko09 [Th Jd]
mexx1234: folds 
Effort92: folds 
ruyingren: folds 
matiko09: folds 
vlad11122007: raises $1 to $1.50
TonnaMunz: folds 
i L00K great: folds 
Optimistic21: folds 
Kud3: calls $1
*** FLOP *** [Qd 4c 8c]
Kud3: checks 
vlad11122007: checks 
*** TURN *** [Qd 4c 8c] [7d]
Kud3: bets $2.85
vlad11122007: calls $2.85
*** RIVER *** [Qd 4c 8c 7d] [6h]
Kud3: checks 
vlad11122007: checks 
*** SHOW DOWN ***
Kud3: shows [Tc 7c] (a pair of Sevens)
vlad11122007: shows [Qc Ad] (a pair of Queens)
vlad11122007 collected $9.41 from pot
*** SUMMARY ***
Total pot $9.85 | Rake $0.44 
Board [Qd 4c 8c 7d 6h]
Seat 1: mexx1234 folded before Flop (didn't bet)
Seat 2: Effort92 folded before Flop (didn't bet)
Seat 3: ruyingren folded before Flop (didn't bet)
Seat 4: matiko09 folded before Flop (didn't bet)
Seat 5: vlad11122007 showed [Qc Ad] and won ($9.41) with a pair of Queens
Seat 6: TonnaMunz folded before Flop (didn't bet)
Seat 7: i L00K great (button) folded before Flop (didn't bet)
Seat 8: Optimistic21 (small blind) folded before Flop
Seat 9: Kud3 (big blind) showed [Tc 7c] and lost with a pair of Sevens





PokerStars Hand #148607057065:  Hold'em No Limit ($0.50/$1.00 USD) - 2016/02/11 12:15:10 CET [2016/02/11 6:15:10 ET]
Table 'Regor' 9-max Seat #8 is the button
Seat 1: matiko09 ($122.72 in chips) 
Seat 3: oscarleon ($101.50 in chips) 
Seat 4: Sweden_Pound ($100 in chips) 
Seat 5: apfush ($101.50 in chips) 
Seat 6: Filojoes ($100 in chips) 
Seat 7: Troll8989 ($117.19 in chips) 
Seat 8: R3NZONIT3 ($60.86 in chips) 
Seat 9: CoolFireX ($100 in chips) 
CoolFireX: posts small blind $0.50
matiko09: posts big blind $1
*** HOLE CARDS ***
Dealt to matiko09 [3s Qs]
oscarleon: folds 
Sweden_Pound: folds 
apfush: folds 
Filojoes: folds 
Troll8989: folds 
R3NZONIT3: calls $1
CoolFireX: folds 
matiko09: checks 
*** FLOP *** [9d 8s 5s]
matiko09: bets $1.55
R3NZONIT3: folds 
Uncalled bet ($1.55) returned to matiko09
matiko09 collected $2.39 from pot
matiko09: doesn't show hand 
*** SUMMARY ***
Total pot $2.50 | Rake $0.11 
Board [9d 8s 5s]
Seat 1: matiko09 (big blind) collected ($2.39)
Seat 3: oscarleon folded before Flop (didn't bet)
Seat 4: Sweden_Pound folded before Flop (didn't bet)
Seat 5: apfush folded before Flop (didn't bet)
Seat 6: Filojoes folded before Flop (didn't bet)
Seat 7: Troll8989 folded before Flop (didn't bet)
Seat 8: R3NZONIT3 (button) folded on the Flop
Seat 9: CoolFireX (small blind) folded before Flop





PokerStars Hand #148607058068:  Hold'em No Limit ($0.50/$1.00 USD) - 2016/02/11 12:15:12 CET [2016/02/11 6:15:12 ET]
Table 'Sycorax II' 9-max Seat #5 is the button
Seat 2: hammerwife ($100 in chips) 
Seat 5: Effort92 ($102.30 in chips) 
Seat 8: matiko09 ($118 in chips) 
Seat 9: mrfoldcall ($85 in chips) 
matiko09: posts small blind $0.50
mrfoldcall: posts big blind $1
Luck In Me: sits out 
*** HOLE CARDS ***
Dealt to matiko09 [Td 3c]
hammerwife: raises $1.50 to $2.50
Effort92: folds 
matiko09: folds 
mrfoldcall: folds 
Uncalled bet ($1.50) returned to hammerwife
hammerwife collected $2.50 from pot
hammerwife: doesn't show hand 
*** SUMMARY ***
Total pot $2.50 | Rake $0 
Seat 2: hammerwife collected ($2.50)
Seat 5: Effort92 (button) folded before Flop (didn't bet)
Seat 8: matiko09 (small blind) folded before Flop
Seat 9: mrfoldcall (big blind) folded before Flop





PokerStars Hand #148607062057:  Hold'em No Limit (€0.25/€0.50 EUR) - 2016/02/11 12:15:19 CET [2016/02/11 6:15:19 ET]
Table 'Otero II' 9-max Seat #7 is the button
Seat 1: Red_Warning (€50 in chips) 
Seat 2: 100+x (€32.30 in chips) 
Seat 3: chaogoose82 (€27.11 in chips) 
Seat 4: 50CandyJoe (€50 in chips) 
Seat 5: Picolo1301 (€14.96 in chips) 
Seat 6: TonnaMunz (€57.23 in chips) 
Seat 7: PacPacBum (€50 in chips) 
Seat 8: matiko09 (€69.09 in chips) 
Seat 9: Optimistic21 (€60.79 in chips) 
matiko09: posts small blind €0.25
Optimistic21: posts big blind €0.50
*** HOLE CARDS ***
Dealt to matiko09 [Kh 2d]
Red_Warning: folds 
100+x: folds 
chaogoose82: folds 
50CandyJoe: folds 
Picolo1301: folds 
TonnaMunz: folds 
PacPacBum: raises €0.52 to €1.02
matiko09: folds 
Optimistic21: folds 
Uncalled bet (€0.52) returned to PacPacBum
PacPacBum collected €1.25 from pot
PacPacBum: doesn't show hand 
*** SUMMARY ***
Total pot €1.25 | Rake €0 
Seat 1: Red_Warning folded before Flop (didn't bet)
Seat 2: 100+x folded before Flop (didn't bet)
Seat 3: chaogoose82 folded before Flop (didn't bet)
Seat 4: 50CandyJoe folded before Flop (didn't bet)
Seat 5: Picolo1301 folded before Flop (didn't bet)
Seat 6: TonnaMunz folded before Flop (didn't bet)
Seat 7: PacPacBum (button) collected (€1.25)
Seat 8: matiko09 (small blind) folded before Flop
Seat 9: Optimistic21 (big blind) folded before Flop





PokerStars Hand #148607064258:  Hold'em No Limit ($0.50/$1.00 USD) - 2016/02/11 12:15:23 CET [2016/02/11 6:15:23 ET]
Table 'Isis II' 9-max Seat #9 is the button
Seat 1: CoolFireX ($138.70 in chips) 
Seat 2: matiko09 ($100 in chips) 
Seat 3: oscarleon ($101.50 in chips) 
Seat 4: sebaaastian ($101 in chips) 
Seat 5: vezunchik79 ($30.09 in chips) 
Seat 6: kouchan-max ($100.24 in chips) 
Seat 7: lutr1923 ($100.72 in chips) 
Seat 8: Troll8989 ($143.03 in chips) 
Seat 9: maxxmeister ($101.71 in chips) 
CoolFireX: posts small blind $0.50
matiko09: posts big blind $1
*** HOLE CARDS ***
Dealt to matiko09 [5h Tc]
oscarleon: folds 
sebaaastian: folds 
vezunchik79: folds 
kouchan-max: folds 
lutr1923: folds 
Troll8989: raises $1.50 to $2.50
maxxmeister: calls $2.50
CoolFireX: folds 
matiko09: folds 
*** FLOP *** [Kc Kd 7d]
Troll8989: bets $4
maxxmeister: calls $4
*** TURN *** [Kc Kd 7d] [4d]
Troll8989: bets $8
maxxmeister: calls $8
*** RIVER *** [Kc Kd 7d 4d] [5d]
Troll8989: checks 
maxxmeister: bets $58
Troll8989: calls $58
*** SHOW DOWN ***
maxxmeister: shows [7h 7c] (a full house, Sevens full of Kings)
Troll8989: mucks hand 
maxxmeister collected $143.70 from pot
*** SUMMARY ***
Total pot $146.50 | Rake $2.80 
Board [Kc Kd 7d 4d 5d]
Seat 1: CoolFireX (small blind) folded before Flop
Seat 2: matiko09 (big blind) folded before Flop
Seat 3: oscarleon folded before Flop (didn't bet)
Seat 4: sebaaastian folded before Flop (didn't bet)
Seat 5: vezunchik79 folded before Flop (didn't bet)
Seat 6: kouchan-max folded before Flop (didn't bet)
Seat 7: lutr1923 folded before Flop (didn't bet)
Seat 8: Troll8989 mucked [Qc Qd]
Seat 9: maxxmeister (button) showed [7h 7c] and won ($143.70) with a full house, Sevens full of Kings





PokerStars Hand #148607065100:  Hold'em No Limit ($0.50/$1.00 USD) - 2016/02/11 12:15:25 CET [2016/02/11 6:15:25 ET]
Table 'Sycorax II' 9-max Seat #8 is the button
Seat 1: Luck In Me ($100 in chips) 
Seat 2: hammerwife ($101.50 in chips) 
Seat 5: Effort92 ($102.30 in chips) 
Seat 8: matiko09 ($117.50 in chips) 
Seat 9: mrfoldcall ($84 in chips) 
mrfoldcall: posts small blind $0.50
Luck In Me: posts big blind $1
*** HOLE CARDS ***
Dealt to matiko09 [8c 6h]
hammerwife: folds 
Effort92: raises $2 to $3
matiko09: folds 
mrfoldcall: folds 
Luck In Me: folds 
Uncalled bet ($2) returned to Effort92
Effort92 collected $2.50 from pot
Effort92: doesn't show hand 
*** SUMMARY ***
Total pot $2.50 | Rake $0 
Seat 1: Luck In Me (big blind) folded before Flop
Seat 2: hammerwife folded before Flop (didn't bet)
Seat 5: Effort92 collected ($2.50)
Seat 8: matiko09 (button) folded before Flop (didn't bet)
Seat 9: mrfoldcall (small blind) folded before Flop





PokerStars Hand #148607070617:  Hold'em No Limit ($0.25/$0.50 USD) - 2016/02/11 12:15:36 CET [2016/02/11 6:15:36 ET]
Table 'Stereoskopia' 9-max Seat #5 is the button
Seat 1: 50CandyJoe ($52.54 in chips) 
Seat 2: Optimistic21 ($50 in chips) 
Seat 4: King brid ($34.93 in chips) 
Seat 5: ReinisRNS ($62.76 in chips) 
Seat 6: matiko09 ($50 in chips) 
Seat 7: tallonn88 ($50 in chips) 
Seat 8: banit7 ($90.03 in chips) 
Seat 9: anubis4455 ($58.17 in chips) 
matiko09: posts small blind $0.25
tallonn88: posts big blind $0.50
*** HOLE CARDS ***
Dealt to matiko09 [9h 4h]
banit7: folds 
anubis4455: folds 
50CandyJoe: folds 
Optimistic21: folds 
King brid: folds 
ReinisRNS: folds 
Donko jr joins the table at seat #3 
matiko09: folds 
Uncalled bet ($0.25) returned to tallonn88
tallonn88 collected $0.50 from pot
tallonn88: doesn't show hand 
*** SUMMARY ***
Total pot $0.50 | Rake $0 
Seat 1: 50CandyJoe folded before Flop (didn't bet)
Seat 2: Optimistic21 folded before Flop (didn't bet)
Seat 4: King brid folded before Flop (didn't bet)
Seat 5: ReinisRNS (button) folded before Flop (didn't bet)
Seat 6: matiko09 (small blind) folded before Flop
Seat 7: tallonn88 (big blind) collected ($0.50)
Seat 8: banit7 folded before Flop (didn't bet)
Seat 9: anubis4455 folded before Flop (didn't bet)





PokerStars Hand #148607074406:  Hold'em No Limit ($0.50/$1.00 USD) - 2016/02/11 12:15:43 CET [2016/02/11 6:15:43 ET]
Table 'Sycorax II' 9-max Seat #9 is the button
Seat 1: Luck In Me ($100 in chips) 
Seat 2: hammerwife ($101.50 in chips) 
Seat 5: Effort92 ($103.80 in chips) 
Seat 8: matiko09 ($117.50 in chips) 
Seat 9: mrfoldcall ($83.50 in chips) 
Luck In Me: posts small blind $0.50
hammerwife: posts big blind $1
*** HOLE CARDS ***
Dealt to matiko09 [5c Td]
Effort92: folds 
matiko09: folds 
mrfoldcall: folds 
Luck In Me: raises $2 to $3
hammerwife: folds 
Uncalled bet ($2) returned to Luck In Me
Luck In Me collected $2 from pot
Luck In Me: doesn't show hand 
*** SUMMARY ***
Total pot $2 | Rake $0 
Seat 1: Luck In Me (small blind) collected ($2)
Seat 2: hammerwife (big blind) folded before Flop
Seat 5: Effort92 folded before Flop (didn't bet)
Seat 8: matiko09 folded before Flop (didn't bet)
Seat 9: mrfoldcall (button) folded before Flop (didn't bet)





PokerStars Hand #148607083981:  Hold'em No Limit ($0.50/$1.00 USD) - 2016/02/11 12:16:01 CET [2016/02/11 6:16:01 ET]
Table 'Sycorax II' 9-max Seat #1 is the button
Seat 1: Luck In Me ($101 in chips) 
Seat 2: hammerwife ($100.50 in chips) 
Seat 5: Effort92 ($103.80 in chips) 
Seat 8: matiko09 ($117.50 in chips) 
Seat 9: mrfoldcall ($83.50 in chips) 
hammerwife: posts small blind $0.50
Effort92: posts big blind $1
*** HOLE CARDS ***
Dealt to matiko09 [8h Tc]
matiko09: folds 
mrfoldcall: raises $2 to $3
Luck In Me: folds 
hammerwife: folds 
Effort92: folds 
Uncalled bet ($2) returned to mrfoldcall
mrfoldcall collected $2.50 from pot
mrfoldcall: doesn't show hand 
*** SUMMARY ***
Total pot $2.50 | Rake $0 
Seat 1: Luck In Me (button) folded before Flop (didn't bet)
Seat 2: hammerwife (small blind) folded before Flop
Seat 5: Effort92 (big blind) folded before Flop
Seat 8: matiko09 folded before Flop (didn't bet)
Seat 9: mrfoldcall collected ($2.50)





PokerStars Hand #148607083760:  Hold'em No Limit ($0.50/$1.00 USD) - 2016/02/11 12:16:01 CET [2016/02/11 6:16:01 ET]
Table 'Magaclite' 9-max Seat #4 is the button
Seat 1: oscarleon ($109 in chips) 
Seat 2: AlKatrone ($106.55 in chips) 
Seat 3: matiko09 ($100 in chips) 
Seat 4: Sweden_Pound ($100 in chips) 
Seat 5: Tarjei82 ($77.50 in chips) 
Seat 6: er13to ($104.35 in chips) 
Seat 7: sebaaastian ($101.50 in chips) 
Seat 8: CoolFireX ($106.07 in chips) 
Seat 9: Lujan87 ($140.73 in chips) 
Tarjei82: posts small blind $0.50
er13to: posts big blind $1
*** HOLE CARDS ***
Dealt to matiko09 [Kd Qd]
sebaaastian: folds 
CoolFireX: folds 
Lujan87: folds 
oscarleon: folds 
AlKatrone: folds 
matiko09: raises $1.50 to $2.50
Sweden_Pound: folds 
Tarjei82: folds 
er13to: calls $1.50
*** FLOP *** [9h Kc 4d]
er13to: checks 
matiko09: bets $3.41
er13to: calls $3.41
*** TURN *** [9h Kc 4d] [Ad]
er13to: checks 
matiko09: bets $7.65
er13to: calls $7.65
*** RIVER *** [9h Kc 4d Ad] [Td]
er13to: checks 
matiko09: bets $19
er13to: folds 
Uncalled bet ($19) returned to matiko09
matiko09 collected $26.38 from pot
matiko09: doesn't show hand 
*** SUMMARY ***
Total pot $27.62 | Rake $1.24 
Board [9h Kc 4d Ad Td]
Seat 1: oscarleon folded before Flop (didn't bet)
Seat 2: AlKatrone folded before Flop (didn't bet)
Seat 3: matiko09 collected ($26.38)
Seat 4: Sweden_Pound (button) folded before Flop (didn't bet)
Seat 5: Tarjei82 (small blind) folded before Flop
Seat 6: er13to (big blind) folded on the River
Seat 7: sebaaastian folded before Flop (didn't bet)
Seat 8: CoolFireX folded before Flop (didn't bet)
Seat 9: Lujan87 folded before Flop (didn't bet)





PokerStars Hand #148607089897:  Hold'em No Limit ($0.25/$0.50 USD) - 2016/02/11 12:16:12 CET [2016/02/11 6:16:12 ET]
Table 'Hunan' 9-max Seat #8 is the button
Seat 1: matiko09 ($50 in chips) 
Seat 2: smirnoff993 ($130.61 in chips) 
Seat 3: TheMinion ($50 in chips) 
Seat 5: apfush ($52.98 in chips) 
Seat 6: i L00K great ($64.41 in chips) 
Seat 7: SForces33 ($27.63 in chips) 
Seat 8: Reven9er ($55.20 in chips) 
Seat 9: Optimistic21 ($72.99 in chips) 
Optimistic21: posts small blind $0.25
matiko09: posts big blind $0.50
banit7: sits out 
*** HOLE CARDS ***
Dealt to matiko09 [Js Ad]
smirnoff993: folds 
TheMinion: folds 
apfush: folds 
i L00K great: raises $1 to $1.50
SForces33: folds 
Reven9er: folds 
Optimistic21: folds 
matiko09: raises $3.50 to $5
i L00K great: folds 
Uncalled bet ($3.50) returned to matiko09
matiko09 collected $3.25 from pot
matiko09: doesn't show hand 
*** SUMMARY ***
Total pot $3.25 | Rake $0 
Seat 1: matiko09 (big blind) collected ($3.25)
Seat 2: smirnoff993 folded before Flop (didn't bet)
Seat 3: TheMinion folded before Flop (didn't bet)
Seat 5: apfush folded before Flop (didn't bet)
Seat 6: i L00K great folded before Flop
Seat 7: SForces33 folded before Flop (didn't bet)
Seat 8: Reven9er (button) folded before Flop (didn't bet)
Seat 9: Optimistic21 (small blind) folded before Flop





PokerStars Hand #148607091831:  Hold'em No Limit (€0.25/€0.50 EUR) - 2016/02/11 12:16:16 CET [2016/02/11 6:16:16 ET]
Table 'Otero II' 9-max Seat #8 is the button
Seat 1: Red_Warning (€50 in chips) 
Seat 2: 100+x (€32.30 in chips) 
Seat 3: chaogoose82 (€27.11 in chips) 
Seat 4: 50CandyJoe (€50 in chips) 
Seat 5: Picolo1301 (€14.96 in chips) 
Seat 6: TonnaMunz (€57.23 in chips) 
Seat 7: PacPacBum (€50.75 in chips) 
Seat 8: matiko09 (€68.84 in chips) 
Seat 9: Optimistic21 (€60.29 in chips) 
Optimistic21: posts small blind €0.25
Red_Warning: posts big blind €0.50
*** HOLE CARDS ***
Dealt to matiko09 [5d Jh]
100+x: folds 
chaogoose82: raises €1 to €1.50
50CandyJoe: folds 
Picolo1301: folds 
TonnaMunz: calls €1.50
PacPacBum: folds 
matiko09: folds 
Optimistic21: folds 
Red_Warning: folds 
*** FLOP *** [4d Th 4h]
Picolo1301 leaves the table
chaogoose82: bets €1.79
vlad11122007 joins the table at seat #5 
TonnaMunz: folds 
Uncalled bet (€1.79) returned to chaogoose82
chaogoose82 collected €3.58 from pot
chaogoose82: doesn't show hand 
*** SUMMARY ***
Total pot €3.75 | Rake €0.17 
Board [4d Th 4h]
Seat 1: Red_Warning (big blind) folded before Flop
Seat 2: 100+x folded before Flop (didn't bet)
Seat 3: chaogoose82 collected (€3.58)
Seat 4: 50CandyJoe folded before Flop (didn't bet)
Seat 5: Picolo1301 folded before Flop (didn't bet)
Seat 6: TonnaMunz folded on the Flop
Seat 7: PacPacBum folded before Flop (didn't bet)
Seat 8: matiko09 (button) folded before Flop (didn't bet)
Seat 9: Optimistic21 (small blind) folded before Flop





PokerStars Hand #148607092855:  Hold'em No Limit ($0.50/$1.00 USD) - 2016/02/11 12:16:18 CET [2016/02/11 6:16:18 ET]
Table 'Sycorax II' 9-max Seat #2 is the button
Seat 1: Luck In Me ($101 in chips) 
Seat 2: hammerwife ($100 in chips) 
Seat 5: Effort92 ($102.80 in chips) 
Seat 8: matiko09 ($117.50 in chips) 
Seat 9: mrfoldcall ($85 in chips) 
Effort92: posts small blind $0.50
matiko09: posts big blind $1
*** HOLE CARDS ***
Dealt to matiko09 [4h Th]
mrfoldcall: raises $2 to $3
Luck In Me: folds 
hammerwife: folds 
Effort92: folds 
matiko09: folds 
Uncalled bet ($2) returned to mrfoldcall
mrfoldcall collected $2.50 from pot
mrfoldcall: doesn't show hand 
*** SUMMARY ***
Total pot $2.50 | Rake $0 
Seat 1: Luck In Me folded before Flop (didn't bet)
Seat 2: hammerwife (button) folded before Flop (didn't bet)
Seat 5: Effort92 (small blind) folded before Flop
Seat 8: matiko09 (big blind) folded before Flop
Seat 9: mrfoldcall collected ($2.50)





PokerStars Hand #148607093380:  Hold'em No Limit ($0.50/$1.00 USD) - 2016/02/11 12:16:19 CET [2016/02/11 6:16:19 ET]
Table 'Regor' 9-max Seat #9 is the button
Seat 1: matiko09 ($124.11 in chips) 
Seat 3: oscarleon ($101.50 in chips) 
Seat 4: Sweden_Pound ($100 in chips) 
Seat 5: apfush ($101.50 in chips) 
Seat 6: Filojoes ($100 in chips) 
Seat 7: Troll8989 ($117.19 in chips) 
Seat 8: R3NZONIT3 ($59.86 in chips) 
Seat 9: CoolFireX ($100 in chips) 
matiko09: posts small blind $0.50
oscarleon: posts big blind $1
*** HOLE CARDS ***
Dealt to matiko09 [Js Kc]
Sweden_Pound: folds 
apfush: folds 
Filojoes: folds 
Troll8989: folds 
R3NZONIT3: folds 
CoolFireX: raises $1.50 to $2.50
matiko09: folds 
oscarleon: folds 
Uncalled bet ($1.50) returned to CoolFireX
CoolFireX collected $2.50 from pot
CoolFireX: doesn't show hand 
*** SUMMARY ***
Total pot $2.50 | Rake $0 
Seat 1: matiko09 (small blind) folded before Flop
Seat 3: oscarleon (big blind) folded before Flop
Seat 4: Sweden_Pound folded before Flop (didn't bet)
Seat 5: apfush folded before Flop (didn't bet)
Seat 6: Filojoes folded before Flop (didn't bet)
Seat 7: Troll8989 folded before Flop (didn't bet)
Seat 8: R3NZONIT3 folded before Flop (didn't bet)
Seat 9: CoolFireX (button) collected ($2.50)





PokerStars Hand #148607100363:  Hold'em No Limit ($0.25/$0.50 USD) - 2016/02/11 12:16:32 CET [2016/02/11 6:16:32 ET]
Table 'Stereoskopia' 9-max Seat #6 is the button
Seat 1: 50CandyJoe ($52.54 in chips) 
Seat 2: Optimistic21 ($50 in chips) 
Seat 4: King brid ($34.93 in chips) 
Seat 5: ReinisRNS ($62.76 in chips) 
Seat 6: matiko09 ($50 in chips) 
Seat 7: tallonn88 ($50.25 in chips) 
Seat 8: banit7 ($90.03 in chips) 
Seat 9: anubis4455 ($58.17 in chips) 
tallonn88: posts small blind $0.25
banit7: posts big blind $0.50
Donko jr: sits out 
*** HOLE CARDS ***
Dealt to matiko09 [3d 3s]
anubis4455: folds 
50CandyJoe: folds 
Optimistic21: folds 
King brid: calls $0.50
ReinisRNS: folds 
matiko09: raises $1 to $1.50
tallonn88: folds 
banit7: folds 
King brid: calls $1
*** FLOP *** [6h Kd Kh]
King brid: checks 
matiko09: checks 
*** TURN *** [6h Kd Kh] [7h]
King brid: checks 
matiko09: checks 
*** RIVER *** [6h Kd Kh 7h] [Qs]
King brid: checks 
matiko09: checks 
*** SHOW DOWN ***
King brid: shows [Ad 9c] (a pair of Kings)
matiko09: shows [3d 3s] (two pair, Kings and Threes)
matiko09 collected $3.58 from pot
*** SUMMARY ***
Total pot $3.75 | Rake $0.17 
Board [6h Kd Kh 7h Qs]
Seat 1: 50CandyJoe folded before Flop (didn't bet)
Seat 2: Optimistic21 folded before Flop (didn't bet)
Seat 4: King brid showed [Ad 9c] and lost with a pair of Kings
Seat 5: ReinisRNS folded before Flop (didn't bet)
Seat 6: matiko09 (button) showed [3d 3s] and won ($3.58) with two pair, Kings and Threes
Seat 7: tallonn88 (small blind) folded before Flop
Seat 8: banit7 (big blind) folded before Flop
Seat 9: anubis4455 folded before Flop (didn't bet)





PokerStars Hand #148607103148:  Hold'em No Limit ($0.50/$1.00 USD) - 2016/02/11 12:16:38 CET [2016/02/11 6:16:38 ET]
Table 'Sycorax II' 9-max Seat #5 is the button
Seat 1: Luck In Me ($101 in chips) 
Seat 2: hammerwife ($100 in chips) 
Seat 5: Effort92 ($102.30 in chips) 
Seat 8: matiko09 ($116.50 in chips) 
Seat 9: mrfoldcall ($86.50 in chips) 
matiko09: posts small blind $0.50
mrfoldcall: posts big blind $1
*** HOLE CARDS ***
Dealt to matiko09 [8c Jh]
Luck In Me: folds 
hammerwife: folds 
Effort92: folds 
matiko09: folds 
Uncalled bet ($0.50) returned to mrfoldcall
mrfoldcall collected $1 from pot
mrfoldcall: doesn't show hand 
*** SUMMARY ***
Total pot $1 | Rake $0 
Seat 1: Luck In Me folded before Flop (didn't bet)
Seat 2: hammerwife folded before Flop (didn't bet)
Seat 5: Effort92 (button) folded before Flop (didn't bet)
Seat 8: matiko09 (small blind) folded before Flop
Seat 9: mrfoldcall (big blind) collected ($1)





PokerStars Hand #148607110581:  Hold'em No Limit ($0.25/$0.50 USD) - 2016/02/11 12:16:52 CET [2016/02/11 6:16:52 ET]
Table 'Sylvania II' 9-max Seat #8 is the button
Seat 1: mexx1234 ($191.40 in chips) 
Seat 2: Effort92 ($51.25 in chips) 
Seat 3: ruyingren ($216.45 in chips) 
Seat 4: matiko09 ($120.60 in chips) 
Seat 5: vlad11122007 ($53.31 in chips) 
Seat 6: TonnaMunz ($120.29 in chips) 
Seat 7: i L00K great ($60.29 in chips) 
Seat 8: Optimistic21 ($50 in chips) 
Seat 9: Kud3 ($146.80 in chips) 
Kud3: posts small blind $0.25
mexx1234: posts big blind $0.50
mexx1234: posts the ante $0.10
Effort92: posts the ante $0.10
ruyingren: posts the ante $0.10
matiko09: posts the ante $0.10
vlad11122007: posts the ante $0.10
TonnaMunz: posts the ante $0.10
i L00K great: posts the ante $0.10
Optimistic21: posts the ante $0.10
Kud3: posts the ante $0.10
*** HOLE CARDS ***
Dealt to matiko09 [9h Ad]
Effort92: folds 
ruyingren: raises $1 to $1.50
matiko09: folds 
vlad11122007: raises $3 to $4.50
TonnaMunz: folds 
i L00K great: folds 
Optimistic21: folds 
Kud3: folds 
mexx1234: folds 
ruyingren: calls $3
*** FLOP *** [2s Jd 9s]
ruyingren: bets $5.50
vlad11122007: folds 
Uncalled bet ($5.50) returned to ruyingren
ruyingren collected $10.17 from pot
ruyingren: doesn't show hand 
*** SUMMARY ***
Total pot $10.65 | Rake $0.48 
Board [2s Jd 9s]
Seat 1: mexx1234 (big blind) folded before Flop
Seat 2: Effort92 folded before Flop (didn't bet)
Seat 3: ruyingren collected ($10.17)
Seat 4: matiko09 folded before Flop (didn't bet)
Seat 5: vlad11122007 folded on the Flop
Seat 6: TonnaMunz folded before Flop (didn't bet)
Seat 7: i L00K great folded before Flop (didn't bet)
Seat 8: Optimistic21 (button) folded before Flop (didn't bet)
Seat 9: Kud3 (small blind) folded before Flop





PokerStars Hand #148607114216:  Hold'em No Limit ($0.50/$1.00 USD) - 2016/02/11 12:16:58 CET [2016/02/11 6:16:58 ET]
Table 'Regor' 9-max Seat #1 is the button
Seat 1: matiko09 ($123.61 in chips) 
Seat 3: oscarleon ($100.50 in chips) 
Seat 4: Sweden_Pound ($100 in chips) 
Seat 5: apfush ($101.50 in chips) 
Seat 6: Filojoes ($100 in chips) 
Seat 7: Troll8989 ($117.19 in chips) 
Seat 8: R3NZONIT3 ($59.86 in chips) 
Seat 9: CoolFireX ($101.50 in chips) 
oscarleon: posts small blind $0.50
Sweden_Pound: posts big blind $1
*** HOLE CARDS ***
Dealt to matiko09 [5s Qd]
apfush: raises $2 to $3
Filojoes: folds 
Troll8989 has timed out
Troll8989: folds 
R3NZONIT3: folds 
CoolFireX: folds 
matiko09: folds 
oscarleon: folds 
Sweden_Pound: folds 
Uncalled bet ($2) returned to apfush
apfush collected $2.50 from pot
apfush: doesn't show hand 
*** SUMMARY ***
Total pot $2.50 | Rake $0 
Seat 1: matiko09 (button) folded before Flop (didn't bet)
Seat 3: oscarleon (small blind) folded before Flop
Seat 4: Sweden_Pound (big blind) folded before Flop
Seat 5: apfush collected ($2.50)
Seat 6: Filojoes folded before Flop (didn't bet)
Seat 7: Troll8989 folded before Flop (didn't bet)
Seat 8: R3NZONIT3 folded before Flop (didn't bet)
Seat 9: CoolFireX folded before Flop (didn't bet)





PokerStars Hand #148607116033:  Hold'em No Limit ($0.25/$0.50 USD) - 2016/02/11 12:17:02 CET [2016/02/11 6:17:02 ET]
Table 'Hunan' 9-max Seat #9 is the button
Seat 1: matiko09 ($51.75 in chips) 
Seat 2: smirnoff993 ($130.61 in chips) 
Seat 3: TheMinion ($50 in chips) 
Seat 5: apfush ($52.98 in chips) 
Seat 6: i L00K great ($62.91 in chips) 
Seat 7: SForces33 ($27.63 in chips) 
Seat 8: Reven9er ($55.20 in chips) 
Seat 9: Optimistic21 ($72.74 in chips) 
matiko09: posts small blind $0.25
smirnoff993: posts big blind $0.50
banit7: sits out 
*** HOLE CARDS ***
Dealt to matiko09 [5h 4c]
TheMinion: folds 
apfush: folds 
i L00K great: folds 
SForces33: raises $1 to $1.50
Reven9er: folds 
Optimistic21: calls $1.50
matiko09: folds 
smirnoff993: raises $3 to $4.50
SForces33: calls $3
Optimistic21: calls $3
*** FLOP *** [9c 4h 8h]
smirnoff993: bets $8.53
SForces33: folds 
Optimistic21: calls $8.53
*** TURN *** [9c 4h 8h] [2d]
smirnoff993: checks 
Optimistic21: checks 
*** RIVER *** [9c 4h 8h 2d] [6c]
smirnoff993: bets $13.23
Optimistic21: folds 
Uncalled bet ($13.23) returned to smirnoff993
smirnoff993 collected $29.42 from pot
smirnoff993: doesn't show hand 
*** SUMMARY ***
Total pot $30.81 | Rake $1.39 
Board [9c 4h 8h 2d 6c]
Seat 1: matiko09 (small blind) folded before Flop
Seat 2: smirnoff993 (big blind) collected ($29.42)
Seat 3: TheMinion folded before Flop (didn't bet)
Seat 5: apfush folded before Flop (didn't bet)
Seat 6: i L00K great folded before Flop (didn't bet)
Seat 7: SForces33 folded on the Flop
Seat 8: Reven9er folded before Flop (didn't bet)
Seat 9: Optimistic21 (button) folded on the River





PokerStars Hand #148607116604:  Hold'em No Limit ($0.50/$1.00 USD) - 2016/02/11 12:17:03 CET [2016/02/11 6:17:03 ET]
Table 'Sycorax II' 9-max Seat #8 is the button
Seat 1: Luck In Me ($101 in chips) 
Seat 2: hammerwife ($100 in chips) 
Seat 5: Effort92 ($102.30 in chips) 
Seat 8: matiko09 ($116 in chips) 
Seat 9: mrfoldcall ($87 in chips) 
mrfoldcall: posts small blind $0.50
Luck In Me: posts big blind $1
*** HOLE CARDS ***
Dealt to matiko09 [Ts 4d]
hammerwife: folds 
Effort92: folds 
hammerwife leaves the table
matiko09: folds 
mrfoldcall: folds 
Uncalled bet ($0.50) returned to Luck In Me
Luck In Me collected $1 from pot
Luck In Me: doesn't show hand 
*** SUMMARY ***
Total pot $1 | Rake $0 
Seat 1: Luck In Me (big blind) collected ($1)
Seat 2: hammerwife folded before Flop (didn't bet)
Seat 5: Effort92 folded before Flop (didn't bet)
Seat 8: matiko09 (button) folded before Flop (didn't bet)
Seat 9: mrfoldcall (small blind) folded before Flop





PokerStars Hand #148607117352:  Hold'em No Limit ($0.50/$1.00 USD) - 2016/02/11 12:17:04 CET [2016/02/11 6:17:04 ET]
Table 'Isis II' 9-max Seat #1 is the button
Seat 1: CoolFireX ($138.20 in chips) 
Seat 2: matiko09 ($100 in chips) 
Seat 3: oscarleon ($101.50 in chips) 
Seat 4: sebaaastian ($101 in chips) 
Seat 5: vezunchik79 ($30.09 in chips) 
Seat 6: kouchan-max ($100.24 in chips) 
Seat 7: lutr1923 ($100.72 in chips) 
Seat 8: Troll8989 ($100 in chips) 
Seat 9: maxxmeister ($172.91 in chips) 
matiko09: posts small blind $0.50
oscarleon: posts big blind $1
*** HOLE CARDS ***
Dealt to matiko09 [3c 7s]
sebaaastian: folds 
vezunchik79: raises $1 to $2
kouchan-max: folds 
lutr1923: folds 
Troll8989: folds 
maxxmeister: folds 
Troll8989 said, "oh look"
CoolFireX: folds 
Troll8989 said, "koksaker wins lotery"
matiko09: folds 
oscarleon: folds 
Uncalled bet ($1) returned to vezunchik79
vezunchik79 collected $2.50 from pot
*** SUMMARY ***
Total pot $2.50 | Rake $0 
Seat 1: CoolFireX (button) folded before Flop (didn't bet)
Seat 2: matiko09 (small blind) folded before Flop
Seat 3: oscarleon (big blind) folded before Flop
Seat 4: sebaaastian folded before Flop (didn't bet)
Seat 5: vezunchik79 collected ($2.50)
Seat 6: kouchan-max folded before Flop (didn't bet)
Seat 7: lutr1923 folded before Flop (didn't bet)
Seat 8: Troll8989 folded before Flop (didn't bet)
Seat 9: maxxmeister folded before Flop (didn't bet)





PokerStars Hand #148607119236:  Hold'em No Limit (€0.25/€0.50 EUR) - 2016/02/11 12:17:08 CET [2016/02/11 6:17:08 ET]
Table 'Otero II' 9-max Seat #9 is the button
Seat 1: Red_Warning (€50 in chips) 
Seat 2: 100+x (€32.30 in chips) 
Seat 3: chaogoose82 (€29.19 in chips) 
Seat 4: 50CandyJoe (€50 in chips) 
Seat 6: TonnaMunz (€55.73 in chips) 
Seat 7: PacPacBum (€50.75 in chips) 
Seat 8: matiko09 (€68.84 in chips) 
Seat 9: Optimistic21 (€60.04 in chips) 
Red_Warning: posts small blind €0.25
100+x: posts big blind €0.50
vlad11122007: sits out 
*** HOLE CARDS ***
Dealt to matiko09 [8s 7s]
chaogoose82: folds 
50CandyJoe: folds 
TonnaMunz: folds 
PacPacBum: folds 
matiko09: raises €1 to €1.50
Optimistic21: folds 
Red_Warning: folds 
100+x: folds 
Uncalled bet (€1) returned to matiko09
matiko09 collected €1.25 from pot
matiko09: doesn't show hand 
*** SUMMARY ***
Total pot €1.25 | Rake €0 
Seat 1: Red_Warning (small blind) folded before Flop
Seat 2: 100+x (big blind) folded before Flop
Seat 3: chaogoose82 folded before Flop (didn't bet)
Seat 4: 50CandyJoe folded before Flop (didn't bet)
Seat 6: TonnaMunz folded before Flop (didn't bet)
Seat 7: PacPacBum folded before Flop (didn't bet)
Seat 8: matiko09 collected (€1.25)
Seat 9: Optimistic21 (button) folded before Flop (didn't bet)





PokerStars Hand #148607125798:  Hold'em No Limit ($0.50/$1.00 USD) - 2016/02/11 12:17:21 CET [2016/02/11 6:17:21 ET]
Table 'Sycorax II' 9-max Seat #9 is the button
Seat 1: Luck In Me ($101.50 in chips) 
Seat 5: Effort92 ($102.30 in chips) 
Seat 8: matiko09 ($116 in chips) 
Seat 9: mrfoldcall ($86.50 in chips) 
Luck In Me: posts small blind $0.50
Effort92: posts big blind $1
*** HOLE CARDS ***
Dealt to matiko09 [Ad Th]
matiko09: raises $1.50 to $2.50
Lujan87 joins the table at seat #2 
mrfoldcall: raises $5.50 to $8
Luck In Me: folds 
Effort92: folds 
matiko09: folds 
Uncalled bet ($5.50) returned to mrfoldcall
mrfoldcall collected $6.50 from pot
mrfoldcall: doesn't show hand 
*** SUMMARY ***
Total pot $6.50 | Rake $0 
Seat 1: Luck In Me (small blind) folded before Flop
Seat 5: Effort92 (big blind) folded before Flop
Seat 8: matiko09 folded before Flop
Seat 9: mrfoldcall (button) collected ($6.50)





PokerStars Hand #148607127323:  Hold'em No Limit ($0.25/$0.50 USD) - 2016/02/11 12:17:23 CET [2016/02/11 6:17:23 ET]
Table 'Stereoskopia' 9-max Seat #7 is the button
Seat 1: 50CandyJoe ($52.54 in chips) 
Seat 2: Optimistic21 ($50 in chips) 
Seat 4: King brid ($33.43 in chips) 
Seat 5: ReinisRNS ($62.76 in chips) 
Seat 6: matiko09 ($52.08 in chips) 
Seat 7: tallonn88 ($50 in chips) 
Seat 8: banit7 ($89.53 in chips) 
Seat 9: anubis4455 ($58.17 in chips) 
banit7: posts small blind $0.25
anubis4455: posts big blind $0.50
Donko jr: sits out 
*** HOLE CARDS ***
Dealt to matiko09 [3h 8h]
50CandyJoe: folds 
Optimistic21: folds 
King brid: calls $0.50
ReinisRNS: folds 
matiko09: folds 
tallonn88: raises $1.75 to $2.25
banit7: folds 
anubis4455: folds 
King brid: folds 
Uncalled bet ($1.75) returned to tallonn88
tallonn88 collected $1.75 from pot
tallonn88: doesn't show hand 
*** SUMMARY ***
Total pot $1.75 | Rake $0 
Seat 1: 50CandyJoe folded before Flop (didn't bet)
Seat 2: Optimistic21 folded before Flop (didn't bet)
Seat 4: King brid folded before Flop
Seat 5: ReinisRNS folded before Flop (didn't bet)
Seat 6: matiko09 folded before Flop (didn't bet)
Seat 7: tallonn88 (button) collected ($1.75)
Seat 8: banit7 (small blind) folded before Flop
Seat 9: anubis4455 (big blind) folded before Flop





PokerStars Hand #148607130132:  Hold'em No Limit ($0.25/$0.50 USD) - 2016/02/11 12:17:29 CET [2016/02/11 6:17:29 ET]
Table 'Ambrosia II' 9-max Seat #8 is the button
Seat 1: matiko09 ($50 in chips) 
Seat 2: TheMinion ($117.69 in chips) 
Seat 3: apfush ($84.76 in chips) 
Seat 4: huudk2016 ($25 in chips) 
Seat 5: smirnoff993 ($70.75 in chips) 
Seat 6: Reven9er ($50 in chips) 
Seat 7: mexx1234 ($57.37 in chips) 
Seat 8: tallonn88 ($51.30 in chips) 
Seat 9: arctur17 ($50.54 in chips) 
arctur17: posts small blind $0.25
matiko09: posts big blind $0.50
*** HOLE CARDS ***
Dealt to matiko09 [Qh 8s]
TheMinion: folds 
apfush: folds 
huudk2016: calls $0.50
smirnoff993: folds 
Reven9er: folds 
mexx1234: folds 
tallonn88: raises $1.75 to $2.25
arctur17: folds 
matiko09: folds 
huudk2016: calls $1.75
*** FLOP *** [9c 9h Jc]
huudk2016: checks 
tallonn88: bets $3
huudk2016: folds 
Uncalled bet ($3) returned to tallonn88
tallonn88 collected $5.01 from pot
tallonn88: doesn't show hand 
*** SUMMARY ***
Total pot $5.25 | Rake $0.24 
Board [9c 9h Jc]
Seat 1: matiko09 (big blind) folded before Flop
Seat 2: TheMinion folded before Flop (didn't bet)
Seat 3: apfush folded before Flop (didn't bet)
Seat 4: huudk2016 folded on the Flop
Seat 5: smirnoff993 folded before Flop (didn't bet)
Seat 6: Reven9er folded before Flop (didn't bet)
Seat 7: mexx1234 folded before Flop (didn't bet)
Seat 8: tallonn88 (button) collected ($5.01)
Seat 9: arctur17 (small blind) folded before Flop





PokerStars Hand #148607131377:  Hold'em No Limit ($0.25/$0.50 USD) - 2016/02/11 12:17:31 CET [2016/02/11 6:17:31 ET]
Table 'Algedi' 9-max Seat #6 is the button
Seat 5: andyjensen14 ($50.28 in chips) 
Seat 6: TonnaMunz ($120.78 in chips) 
Seat 7: hoedtrob ($60.55 in chips) 
Seat 8: matiko09 ($50 in chips) 
Seat 9: Kud3 ($125 in chips) 
hoedtrob: posts small blind $0.25
matiko09: posts big blind $0.50
andyjensen14: posts the ante $0.10
TonnaMunz: posts the ante $0.10
hoedtrob: posts the ante $0.10
matiko09: posts the ante $0.10
Kud3: posts the ante $0.10
*** HOLE CARDS ***
Dealt to matiko09 [Qd 6s]
Kud3: folds 
andyjensen14: calls $0.50
TonnaMunz: raises $1.50 to $2
hoedtrob: folds 
matiko09: folds 
andyjensen14: calls $1.50
*** FLOP *** [Kc Ac 3s]
andyjensen14: checks 
TonnaMunz: bets $2.50
andyjensen14: folds 
Uncalled bet ($2.50) returned to TonnaMunz
TonnaMunz collected $5.01 from pot
TonnaMunz: doesn't show hand 
*** SUMMARY ***
Total pot $5.25 | Rake $0.24 
Board [Kc Ac 3s]
Seat 5: andyjensen14 folded on the Flop
Seat 6: TonnaMunz (button) collected ($5.01)
Seat 7: hoedtrob (small blind) folded before Flop
Seat 8: matiko09 (big blind) folded before Flop
Seat 9: Kud3 folded before Flop (didn't bet)





PokerStars Hand #148607134376:  Hold'em No Limit ($0.50/$1.00 USD) - 2016/02/11 12:17:37 CET [2016/02/11 6:17:37 ET]
Table 'Sycorax II' 9-max Seat #1 is the button
Seat 1: Luck In Me ($101 in chips) 
Seat 5: Effort92 ($101.30 in chips) 
Seat 8: matiko09 ($113.50 in chips) 
Seat 9: mrfoldcall ($90.50 in chips) 
Lujan87 will be allowed to play after the button
Effort92: posts small blind $0.50
matiko09: posts big blind $1
*** HOLE CARDS ***
Dealt to matiko09 [4d Ad]
mrfoldcall: folds 
Luck In Me: raises $1.50 to $2.50
Effort92: calls $2
matiko09: calls $1.50
*** FLOP *** [3h Ks Kh]
Effort92: checks 
matiko09: checks 
Luck In Me: bets $4.50
Effort92: calls $4.50
matiko09: folds 
*** TURN *** [3h Ks Kh] [8h]
Effort92: checks 
Luck In Me: bets $11
Effort92: folds 
Uncalled bet ($11) returned to Luck In Me
Luck In Me collected $15.76 from pot
Luck In Me: doesn't show hand 
*** SUMMARY ***
Total pot $16.50 | Rake $0.74 
Board [3h Ks Kh 8h]
Seat 1: Luck In Me (button) collected ($15.76)
Seat 5: Effort92 (small blind) folded on the Turn
Seat 8: matiko09 (big blind) folded on the Flop
Seat 9: mrfoldcall folded before Flop (didn't bet)





PokerStars Hand #148607137451:  Hold'em No Limit ($0.50/$1.00 USD) - 2016/02/11 12:17:43 CET [2016/02/11 6:17:43 ET]
Table 'Isis II' 9-max Seat #2 is the button
Seat 1: CoolFireX ($138.20 in chips) 
Seat 2: matiko09 ($100 in chips) 
Seat 3: oscarleon ($100.50 in chips) 
Seat 4: sebaaastian ($101 in chips) 
Seat 5: vezunchik79 ($31.59 in chips) 
Seat 6: kouchan-max ($100.24 in chips) 
Seat 7: lutr1923 ($100.72 in chips) 
Seat 8: Troll8989 ($100 in chips) 
Seat 9: maxxmeister ($172.91 in chips) 
oscarleon: posts small blind $0.50
sebaaastian: posts big blind $1
*** HOLE CARDS ***
Dealt to matiko09 [6h 2c]
vezunchik79: folds 
kouchan-max: folds 
lutr1923: raises $3 to $4
Troll8989: folds 
maxxmeister: folds 
CoolFireX: folds 
matiko09: folds 
oscarleon: folds 
sebaaastian: folds 
Uncalled bet ($3) returned to lutr1923
lutr1923 collected $2.50 from pot
lutr1923: doesn't show hand 
*** SUMMARY ***
Total pot $2.50 | Rake $0 
Seat 1: CoolFireX folded before Flop (didn't bet)
Seat 2: matiko09 (button) folded before Flop (didn't bet)
Seat 3: oscarleon (small blind) folded before Flop
Seat 4: sebaaastian (big blind) folded before Flop
Seat 5: vezunchik79 folded before Flop (didn't bet)
Seat 6: kouchan-max folded before Flop (didn't bet)
Seat 7: lutr1923 collected ($2.50)
Seat 8: Troll8989 folded before Flop (didn't bet)
Seat 9: maxxmeister folded before Flop (didn't bet)





PokerStars Hand #148607138723:  Hold'em No Limit ($0.25/$0.50 USD) - 2016/02/11 12:17:45 CET [2016/02/11 6:17:45 ET]
Table 'Sylvania II' 9-max Seat #9 is the button
Seat 1: mexx1234 ($190.80 in chips) 
Seat 2: Effort92 ($51.15 in chips) 
Seat 3: ruyingren ($222.02 in chips) 
Seat 4: matiko09 ($120.50 in chips) 
Seat 5: vlad11122007 ($48.71 in chips) 
Seat 6: TonnaMunz ($120.19 in chips) 
Seat 7: i L00K great ($60.19 in chips) 
Seat 8: Optimistic21 ($50 in chips) 
Seat 9: Kud3 ($146.45 in chips) 
mexx1234: posts small blind $0.25
Effort92: posts big blind $0.50
mexx1234: posts the ante $0.10
Effort92: posts the ante $0.10
ruyingren: posts the ante $0.10
matiko09: posts the ante $0.10
vlad11122007: posts the ante $0.10
TonnaMunz: posts the ante $0.10
i L00K great: posts the ante $0.10
Optimistic21: posts the ante $0.10
Kud3: posts the ante $0.10
*** HOLE CARDS ***
Dealt to matiko09 [2c 3h]
ruyingren: folds 
matiko09: folds 
vlad11122007: folds 
TonnaMunz: folds 
i L00K great: raises $1 to $1.50
Optimistic21: folds 
Kud3: calls $1.50
mexx1234: folds 
Effort92: folds 
*** FLOP *** [5s 7s Qs]
i L00K great: checks 
Kud3: bets $3.81
i L00K great: calls $3.81
*** TURN *** [5s 7s Qs] [6s]
i L00K great: checks 
Kud3: bets $8.43
i L00K great: folds 
Uncalled bet ($8.43) returned to Kud3
Kud3 collected $11.72 from pot
Kud3: doesn't show hand 
*** SUMMARY ***
Total pot $12.27 | Rake $0.55 
Board [5s 7s Qs 6s]
Seat 1: mexx1234 (small blind) folded before Flop
Seat 2: Effort92 (big blind) folded before Flop
Seat 3: ruyingren folded before Flop (didn't bet)
Seat 4: matiko09 folded before Flop (didn't bet)
Seat 5: vlad11122007 folded before Flop (didn't bet)
Seat 6: TonnaMunz folded before Flop (didn't bet)
Seat 7: i L00K great folded on the Turn
Seat 8: Optimistic21 folded before Flop (didn't bet)
Seat 9: Kud3 (button) collected ($11.72)





PokerStars Hand #148607146033:  Hold'em No Limit (€0.25/€0.50 EUR) - 2016/02/11 12:17:59 CET [2016/02/11 6:17:59 ET]
Table 'Otero II' 9-max Seat #1 is the button
Seat 1: Red_Warning (€50 in chips) 
Seat 2: 100+x (€31.80 in chips) 
Seat 3: chaogoose82 (€29.19 in chips) 
Seat 4: 50CandyJoe (€50 in chips) 
Seat 6: TonnaMunz (€55.73 in chips) 
Seat 7: PacPacBum (€50.75 in chips) 
Seat 8: matiko09 (€69.59 in chips) 
Seat 9: Optimistic21 (€60.04 in chips) 
100+x: posts small blind €0.25
chaogoose82: posts big blind €0.50
vlad11122007: sits out 
*** HOLE CARDS ***
Dealt to matiko09 [9s 6s]
50CandyJoe: folds 
TonnaMunz: folds 
PacPacBum: raises €1 to €1.50
matiko09: folds 
Optimistic21: folds 
Red_Warning: folds 
100+x: calls €1.25
chaogoose82: calls €1
*** FLOP *** [8d 9c Jc]
100+x: checks 
chaogoose82: checks 
PacPacBum: bets €2.96
100+x: folds 
chaogoose82: calls €2.96
*** TURN *** [8d 9c Jc] [Jh]
chaogoose82: bets €4.97
PacPacBum: calls €4.97
*** RIVER *** [8d 9c Jc Jh] [6d]
chaogoose82: bets €19.76 and is all-in
PacPacBum: folds 
Uncalled bet (€19.76) returned to chaogoose82
chaogoose82 collected €19.44 from pot
chaogoose82: doesn't show hand 
*** SUMMARY ***
Total pot €20.36 | Rake €0.92 
Board [8d 9c Jc Jh 6d]
Seat 1: Red_Warning (button) folded before Flop (didn't bet)
Seat 2: 100+x (small blind) folded on the Flop
Seat 3: chaogoose82 (big blind) collected (€19.44)
Seat 4: 50CandyJoe folded before Flop (didn't bet)
Seat 6: TonnaMunz folded before Flop (didn't bet)
Seat 7: PacPacBum folded on the River
Seat 8: matiko09 folded before Flop (didn't bet)
Seat 9: Optimistic21 folded before Flop (didn't bet)





PokerStars Hand #148607151967:  Hold'em No Limit ($0.50/$1.00 USD) - 2016/02/11 12:18:11 CET [2016/02/11 6:18:11 ET]
Table 'Magaclite' 9-max Seat #5 is the button
Seat 1: oscarleon ($109 in chips) 
Seat 2: AlKatrone ($106.55 in chips) 
Seat 3: matiko09 ($112.82 in chips) 
Seat 4: Sweden_Pound ($100 in chips) 
Seat 5: Tarjei82 ($77 in chips) 
Seat 6: er13to ($100 in chips) 
Seat 7: sebaaastian ($101.50 in chips) 
Seat 8: CoolFireX ($106.07 in chips) 
Seat 9: Lujan87 ($140.73 in chips) 
er13to: posts small blind $0.50
sebaaastian: posts big blind $1
*** HOLE CARDS ***
Dealt to matiko09 [4h 9s]
CoolFireX: folds 
Lujan87: folds 
oscarleon: folds 
AlKatrone: folds 
matiko09: folds 
Sweden_Pound: folds 
Tarjei82: raises $1.50 to $2.50
er13to: folds 
sebaaastian: calls $1.50
*** FLOP *** [6d As Qc]
sebaaastian: checks 
Tarjei82: bets $2.50
sebaaastian: folds 
Uncalled bet ($2.50) returned to Tarjei82
Tarjei82 collected $5.25 from pot
Tarjei82: doesn't show hand 
*** SUMMARY ***
Total pot $5.50 | Rake $0.25 
Board [6d As Qc]
Seat 1: oscarleon folded before Flop (didn't bet)
Seat 2: AlKatrone folded before Flop (didn't bet)
Seat 3: matiko09 folded before Flop (didn't bet)
Seat 4: Sweden_Pound folded before Flop (didn't bet)
Seat 5: Tarjei82 (button) collected ($5.25)
Seat 6: er13to (small blind) folded before Flop
Seat 7: sebaaastian (big blind) folded on the Flop
Seat 8: CoolFireX folded before Flop (didn't bet)
Seat 9: Lujan87 folded before Flop (didn't bet)





PokerStars Hand #148607153393:  Hold'em No Limit ($0.25/$0.50 USD) - 2016/02/11 12:18:13 CET [2016/02/11 6:18:13 ET]
Table 'Stereoskopia' 9-max Seat #8 is the button
Seat 1: 50CandyJoe ($52.54 in chips) 
Seat 2: Optimistic21 ($50 in chips) 
Seat 4: King brid ($32.93 in chips) 
Seat 5: ReinisRNS ($62.76 in chips) 
Seat 6: matiko09 ($52.08 in chips) 
Seat 7: tallonn88 ($51.25 in chips) 
Seat 8: banit7 ($89.28 in chips) 
Seat 9: anubis4455 ($57.67 in chips) 
anubis4455: posts small blind $0.25
50CandyJoe: posts big blind $0.50
Donko jr: sits out 
*** HOLE CARDS ***
Dealt to matiko09 [5h 6d]
Optimistic21: folds 
King brid: folds 
ReinisRNS: folds 
matiko09: folds 
tallonn88: folds 
banit7: folds 
anubis4455: raises $0.50 to $1
50CandyJoe: folds 
Uncalled bet ($0.50) returned to anubis4455
anubis4455 collected $1 from pot
anubis4455: doesn't show hand 
*** SUMMARY ***
Total pot $1 | Rake $0 
Seat 1: 50CandyJoe (big blind) folded before Flop
Seat 2: Optimistic21 folded before Flop (didn't bet)
Seat 4: King brid folded before Flop (didn't bet)
Seat 5: ReinisRNS folded before Flop (didn't bet)
Seat 6: matiko09 folded before Flop (didn't bet)
Seat 7: tallonn88 folded before Flop (didn't bet)
Seat 8: banit7 (button) folded before Flop (didn't bet)
Seat 9: anubis4455 (small blind) collected ($1)





PokerStars Hand #148607155743:  Hold'em No Limit ($0.50/$1.00 USD) - 2016/02/11 12:18:18 CET [2016/02/11 6:18:18 ET]
Table 'Isis II' 9-max Seat #3 is the button
Seat 1: CoolFireX ($138.20 in chips) 
Seat 2: matiko09 ($100 in chips) 
Seat 3: oscarleon ($100 in chips) 
Seat 4: sebaaastian ($100 in chips) 
Seat 5: vezunchik79 ($31.59 in chips) 
Seat 6: kouchan-max ($100.24 in chips) 
Seat 7: lutr1923 ($102.22 in chips) 
Seat 8: Troll8989 ($100 in chips) 
Seat 9: maxxmeister ($172.91 in chips) 
sebaaastian: posts small blind $0.50
vezunchik79: posts big blind $1
*** HOLE CARDS ***
Dealt to matiko09 [2c Jd]
kouchan-max: folds 
lutr1923: calls $1
Troll8989: folds 
maxxmeister: folds 
CoolFireX: folds 
matiko09: folds 
oscarleon: folds 
sebaaastian: folds 
vezunchik79: checks 
*** FLOP *** [Qc Qd Kc]
vezunchik79: checks 
lutr1923: checks 
*** TURN *** [Qc Qd Kc] [9d]
vezunchik79: checks 
lutr1923: checks 
*** RIVER *** [Qc Qd Kc 9d] [4d]
vezunchik79: checks 
lutr1923: checks 
*** SHOW DOWN ***
vezunchik79: shows [3d 4c] (two pair, Queens and Fours)
lutr1923: mucks hand 
vezunchik79 collected $2.39 from pot
*** SUMMARY ***
Total pot $2.50 | Rake $0.11 
Board [Qc Qd Kc 9d 4d]
Seat 1: CoolFireX folded before Flop (didn't bet)
Seat 2: matiko09 folded before Flop (didn't bet)
Seat 3: oscarleon (button) folded before Flop (didn't bet)
Seat 4: sebaaastian (small blind) folded before Flop
Seat 5: vezunchik79 (big blind) showed [3d 4c] and won ($2.39) with two pair, Queens and Fours
Seat 6: kouchan-max folded before Flop (didn't bet)
Seat 7: lutr1923 mucked [7s 8d]
Seat 8: Troll8989 folded before Flop (didn't bet)
Seat 9: maxxmeister folded before Flop (didn't bet)





PokerStars Hand #148607162482:  Hold'em No Limit ($0.50/$1.00 USD) - 2016/02/11 12:18:31 CET [2016/02/11 6:18:31 ET]
Table 'Regor' 9-max Seat #3 is the button
Seat 1: matiko09 ($123.61 in chips) 
Seat 3: oscarleon ($100 in chips) 
Seat 4: Sweden_Pound ($100 in chips) 
Seat 7: Troll8989 ($117.19 in chips) 
Seat 8: R3NZONIT3 ($59.86 in chips) 
Seat 9: CoolFireX ($101.50 in chips) 
Sweden_Pound: posts small blind $0.50
apfush: is sitting out 
apfush leaves the table
Filojoes: is sitting out 
Troll8989: posts big blind $1
*** HOLE CARDS ***
Dealt to matiko09 [6c 5s]
Filojoes leaves the table
R3NZONIT3: folds 
CoolFireX: folds 
matiko09: folds 
oscarleon: raises $2 to $3
Sweden_Pound: folds 
Troll8989: folds 
Uncalled bet ($2) returned to oscarleon
oscarleon collected $2.50 from pot
oscarleon: doesn't show hand 
*** SUMMARY ***
Total pot $2.50 | Rake $0 
Seat 1: matiko09 folded before Flop (didn't bet)
Seat 3: oscarleon (button) collected ($2.50)
Seat 4: Sweden_Pound (small blind) folded before Flop
Seat 7: Troll8989 (big blind) folded before Flop
Seat 8: R3NZONIT3 folded before Flop (didn't bet)
Seat 9: CoolFireX folded before Flop (didn't bet)





PokerStars Hand #148607162651:  Hold'em No Limit ($0.25/$0.50 USD) - 2016/02/11 12:18:31 CET [2016/02/11 6:18:31 ET]
Table 'Algedi' 9-max Seat #7 is the button
Seat 5: andyjensen14 ($48.18 in chips) 
Seat 6: TonnaMunz ($123.69 in chips) 
Seat 7: hoedtrob ($60.20 in chips) 
Seat 8: matiko09 ($50 in chips) 
Seat 9: Kud3 ($125 in chips) 
matiko09: posts small blind $0.25
Kud3: posts big blind $0.50
andyjensen14: posts the ante $0.10
TonnaMunz: posts the ante $0.10
hoedtrob: posts the ante $0.10
matiko09: posts the ante $0.10
Kud3: posts the ante $0.10
*** HOLE CARDS ***
Dealt to matiko09 [7d 9d]
andyjensen14: calls $0.50
TonnaMunz: folds 
hoedtrob: calls $0.50
matiko09: calls $0.25
Kud3: checks 
*** FLOP *** [Th 4c Qh]
matiko09: checks 
Kud3: checks 
andyjensen14: bets $3
hoedtrob: folds 
matiko09: folds 
Kud3: folds 
Uncalled bet ($3) returned to andyjensen14
andyjensen14 collected $2.39 from pot
*** SUMMARY ***
Total pot $2.50 | Rake $0.11 
Board [Th 4c Qh]
Seat 5: andyjensen14 collected ($2.39)
Seat 6: TonnaMunz folded before Flop (didn't bet)
Seat 7: hoedtrob (button) folded on the Flop
Seat 8: matiko09 (small blind) folded on the Flop
Seat 9: Kud3 (big blind) folded on the Flop





PokerStars Hand #148607166645:  Hold'em No Limit ($0.25/$0.50 USD) - 2016/02/11 12:18:39 CET [2016/02/11 6:18:39 ET]
Table 'Hunan' 9-max Seat #1 is the button
Seat 1: matiko09 ($51.50 in chips) 
Seat 2: smirnoff993 ($147 in chips) 
Seat 3: TheMinion ($50 in chips) 
Seat 5: apfush ($52.98 in chips) 
Seat 6: i L00K great ($62.91 in chips) 
Seat 7: SForces33 ($23.13 in chips) 
Seat 8: Reven9er ($55.20 in chips) 
Seat 9: Optimistic21 ($59.71 in chips) 
smirnoff993: posts small blind $0.25
TheMinion: posts big blind $0.50
banit7: sits out 
*** HOLE CARDS ***
Dealt to matiko09 [Td 6h]
apfush: folds 
i L00K great: folds 
SForces33: folds 
Reven9er: folds 
Optimistic21: folds 
matiko09: folds 
smirnoff993: raises $1 to $1.50
TheMinion: folds 
Uncalled bet ($1) returned to smirnoff993
smirnoff993 collected $1 from pot
smirnoff993: doesn't show hand 
*** SUMMARY ***
Total pot $1 | Rake $0 
Seat 1: matiko09 (button) folded before Flop (didn't bet)
Seat 2: smirnoff993 (small blind) collected ($1)
Seat 3: TheMinion (big blind) folded before Flop
Seat 5: apfush folded before Flop (didn't bet)
Seat 6: i L00K great folded before Flop (didn't bet)
Seat 7: SForces33 folded before Flop (didn't bet)
Seat 8: Reven9er folded before Flop (didn't bet)
Seat 9: Optimistic21 folded before Flop (didn't bet)





PokerStars Hand #148607169749:  Hold'em No Limit ($0.25/$0.50 USD) - 2016/02/11 12:18:45 CET [2016/02/11 6:18:45 ET]
Table 'Ambrosia II' 9-max Seat #9 is the button
Seat 1: matiko09 ($50 in chips) 
Seat 2: TheMinion ($117.69 in chips) 
Seat 3: apfush ($84.76 in chips) 
Seat 4: huudk2016 ($22.75 in chips) 
Seat 5: smirnoff993 ($70.75 in chips) 
Seat 6: Reven9er ($50 in chips) 
Seat 7: mexx1234 ($57.37 in chips) 
Seat 8: tallonn88 ($54.06 in chips) 
Seat 9: arctur17 ($50.29 in chips) 
matiko09: posts small blind $0.25
TheMinion: posts big blind $0.50
*** HOLE CARDS ***
Dealt to matiko09 [5d 9d]
apfush: folds 
huudk2016: calls $0.50
smirnoff993: folds 
Reven9er: folds 
mexx1234: folds 
tallonn88: folds 
arctur17: calls $0.50
matiko09: folds 
TheMinion: checks 
*** FLOP *** [3c 9h Ks]
TheMinion: checks 
huudk2016: checks 
arctur17: bets $1
TheMinion: calls $1
huudk2016: calls $1
*** TURN *** [3c 9h Ks] [Jh]
TheMinion: checks 
huudk2016: bets $2.50
arctur17: calls $2.50
TheMinion: folds 
*** RIVER *** [3c 9h Ks Jh] [Kh]
huudk2016: checks 
arctur17: checks 
*** SHOW DOWN ***
huudk2016: shows [Js Tc] (two pair, Kings and Jacks)
arctur17: shows [Td Kc] (three of a kind, Kings)
arctur17 collected $9.31 from pot
*** SUMMARY ***
Total pot $9.75 | Rake $0.44 
Board [3c 9h Ks Jh Kh]
Seat 1: matiko09 (small blind) folded before Flop
Seat 2: TheMinion (big blind) folded on the Turn
Seat 3: apfush folded before Flop (didn't bet)
Seat 4: huudk2016 showed [Js Tc] and lost with two pair, Kings and Jacks
Seat 5: smirnoff993 folded before Flop (didn't bet)
Seat 6: Reven9er folded before Flop (didn't bet)
Seat 7: mexx1234 folded before Flop (didn't bet)
Seat 8: tallonn88 folded before Flop (didn't bet)
Seat 9: arctur17 (button) showed [Td Kc] and won ($9.31) with three of a kind, Kings





PokerStars Hand #148607171198:  Hold'em No Limit ($0.50/$1.00 USD) - 2016/02/11 12:18:47 CET [2016/02/11 6:18:47 ET]
Table 'Sycorax II' 9-max Seat #5 is the button
Seat 1: Luck In Me ($109.76 in chips) 
Seat 5: Effort92 ($100 in chips) 
Seat 8: matiko09 ($111 in chips) 
Seat 9: mrfoldcall ($90.50 in chips) 
matiko09: posts small blind $0.50
mrfoldcall: posts big blind $1
Lujan87: sits out 
*** HOLE CARDS ***
Dealt to matiko09 [5h 7c]
Luck In Me: folds 
Effort92: folds 
matiko09: folds 
Uncalled bet ($0.50) returned to mrfoldcall
mrfoldcall collected $1 from pot
mrfoldcall: doesn't show hand 
*** SUMMARY ***
Total pot $1 | Rake $0 
Seat 1: Luck In Me folded before Flop (didn't bet)
Seat 5: Effort92 (button) folded before Flop (didn't bet)
Seat 8: matiko09 (small blind) folded before Flop
Seat 9: mrfoldcall (big blind) collected ($1)





PokerStars Hand #148607173095:  Hold'em No Limit ($0.25/$0.50 USD) - 2016/02/11 12:18:51 CET [2016/02/11 6:18:51 ET]
Table 'Stereoskopia' 9-max Seat #9 is the button
Seat 1: 50CandyJoe ($52.04 in chips) 
Seat 2: Optimistic21 ($50 in chips) 
Seat 4: King brid ($32.93 in chips) 
Seat 5: ReinisRNS ($62.76 in chips) 
Seat 6: matiko09 ($52.08 in chips) 
Seat 7: tallonn88 ($51.25 in chips) 
Seat 8: banit7 ($89.28 in chips) 
Seat 9: anubis4455 ($58.17 in chips) 
50CandyJoe: posts small blind $0.25
Optimistic21: posts big blind $0.50
Donko jr: sits out 
*** HOLE CARDS ***
Dealt to matiko09 [6s 9d]
King brid: calls $0.50
ReinisRNS: calls $0.50
matiko09: folds 
tallonn88: folds 
banit7: folds 
anubis4455: folds 
50CandyJoe: folds 
Optimistic21: checks 
*** FLOP *** [8d 5c 6d]
Optimistic21: checks 
King brid: checks 
ReinisRNS: checks 
*** TURN *** [8d 5c 6d] [9s]
Optimistic21: checks 
King brid: checks 
ReinisRNS: bets $0.83
Optimistic21: folds 
King brid: calls $0.83
*** RIVER *** [8d 5c 6d 9s] [7s]
King brid: bets $3.50
ReinisRNS: folds 
Uncalled bet ($3.50) returned to King brid
King brid collected $3.26 from pot
King brid: doesn't show hand 
*** SUMMARY ***
Total pot $3.41 | Rake $0.15 
Board [8d 5c 6d 9s 7s]
Seat 1: 50CandyJoe (small blind) folded before Flop
Seat 2: Optimistic21 (big blind) folded on the Turn
Seat 4: King brid collected ($3.26)
Seat 5: ReinisRNS folded on the River
Seat 6: matiko09 folded before Flop (didn't bet)
Seat 7: tallonn88 folded before Flop (didn't bet)
Seat 8: banit7 folded before Flop (didn't bet)
Seat 9: anubis4455 (button) folded before Flop (didn't bet)





PokerStars Hand #148607174901:  Hold'em No Limit ($0.50/$1.00 USD) - 2016/02/11 12:18:54 CET [2016/02/11 6:18:54 ET]
Table 'Sycorax II' 9-max Seat #8 is the button
Seat 1: Luck In Me ($109.76 in chips) 
Seat 5: Effort92 ($100 in chips) 
Seat 8: matiko09 ($110.50 in chips) 
Seat 9: mrfoldcall ($91 in chips) 
mrfoldcall: posts small blind $0.50
Luck In Me: posts big blind $1
Lujan87: sits out 
*** HOLE CARDS ***
Dealt to matiko09 [9h 9s]
Effort92: folds 
matiko09: raises $1.50 to $2.50
mrfoldcall: calls $2
Luck In Me: folds 
*** FLOP *** [Qd 9c 7c]
mrfoldcall: bets $4
matiko09: raises $9 to $13
mrfoldcall: folds 
Uncalled bet ($9) returned to matiko09
matiko09 collected $13.37 from pot
matiko09: doesn't show hand 
*** SUMMARY ***
Total pot $14 | Rake $0.63 
Board [Qd 9c 7c]
Seat 1: Luck In Me (big blind) folded before Flop
Seat 5: Effort92 folded before Flop (didn't bet)
Seat 8: matiko09 (button) collected ($13.37)
Seat 9: mrfoldcall (small blind) folded on the Flop





PokerStars Hand #148607178440:  Hold'em No Limit ($0.50/$1.00 USD) - 2016/02/11 12:19:01 CET [2016/02/11 6:19:01 ET]
Table 'Regor' 9-max Seat #4 is the button
Seat 1: matiko09 ($123.61 in chips) 
Seat 3: oscarleon ($101.50 in chips) 
Seat 4: Sweden_Pound ($100 in chips) 
Seat 7: Troll8989 ($116.19 in chips) 
Seat 8: R3NZONIT3 ($59.86 in chips) 
Seat 9: CoolFireX ($101.50 in chips) 
Troll8989: posts small blind $0.50
R3NZONIT3: posts big blind $1
*** HOLE CARDS ***
Dealt to matiko09 [2s Qh]
CoolFireX: folds 
matiko09: folds 
oscarleon: folds 
Sweden_Pound: raises $1 to $2
Troll8989: folds 
R3NZONIT3: calls $1
*** FLOP *** [Tc Jc 5h]
R3NZONIT3: bets $1
Sweden_Pound: folds 
Uncalled bet ($1) returned to R3NZONIT3
R3NZONIT3 collected $4.30 from pot
R3NZONIT3: doesn't show hand 
*** SUMMARY ***
Total pot $4.50 | Rake $0.20 
Board [Tc Jc 5h]
Seat 1: matiko09 folded before Flop (didn't bet)
Seat 3: oscarleon folded before Flop (didn't bet)
Seat 4: Sweden_Pound (button) folded on the Flop
Seat 7: Troll8989 (small blind) folded before Flop
Seat 8: R3NZONIT3 (big blind) collected ($4.30)
Seat 9: CoolFireX folded before Flop (didn't bet)





PokerStars Hand #148607182144:  Hold'em No Limit ($0.50/$1.00 USD) - 2016/02/11 12:19:08 CET [2016/02/11 6:19:08 ET]
Table 'Isis II' 9-max Seat #4 is the button
Seat 1: CoolFireX ($138.20 in chips) 
Seat 2: matiko09 ($100 in chips) 
Seat 3: oscarleon ($100 in chips) 
Seat 4: sebaaastian ($100 in chips) 
Seat 5: vezunchik79 ($32.98 in chips) 
Seat 6: kouchan-max ($100.24 in chips) 
Seat 7: lutr1923 ($101.22 in chips) 
Seat 8: Troll8989 ($100 in chips) 
Seat 9: maxxmeister ($172.91 in chips) 
vezunchik79: posts small blind $0.50
kouchan-max: posts big blind $1
*** HOLE CARDS ***
Dealt to matiko09 [6c 8c]
lutr1923: folds 
lutr1923 leaves the table
Troll8989: raises $1.50 to $2.50
maxxmeister: folds 
CoolFireX: calls $2.50
matiko09: folds 
oscarleon: folds 
sebaaastian: folds 
vezunchik79: folds 
kouchan-max: folds 
*** FLOP *** [Kd 3h 9d]
Troll8989: bets $4
CoolFireX: folds 
Uncalled bet ($4) returned to Troll8989
Troll8989 collected $6.21 from pot
Troll8989: doesn't show hand 
PacPacBum joins the table at seat #7 
*** SUMMARY ***
Total pot $6.50 | Rake $0.29 
Board [Kd 3h 9d]
Seat 1: CoolFireX folded on the Flop
Seat 2: matiko09 folded before Flop (didn't bet)
Seat 3: oscarleon folded before Flop (didn't bet)
Seat 4: sebaaastian (button) folded before Flop (didn't bet)
Seat 5: vezunchik79 (small blind) folded before Flop
Seat 6: kouchan-max (big blind) folded before Flop
Seat 7: lutr1923 folded before Flop (didn't bet)
Seat 8: Troll8989 collected ($6.21)
Seat 9: maxxmeister folded before Flop (didn't bet)





PokerStars Hand #148607189784:  Hold'em No Limit (€0.25/€0.50 EUR) - 2016/02/11 12:19:23 CET [2016/02/11 6:19:23 ET]
Table 'Otero II' 9-max Seat #2 is the button
Seat 1: Red_Warning (€50 in chips) 
Seat 2: 100+x (€30.30 in chips) 
Seat 3: chaogoose82 (€39.20 in chips) 
Seat 4: 50CandyJoe (€50 in chips) 
Seat 6: TonnaMunz (€55.73 in chips) 
Seat 7: PacPacBum (€50 in chips) 
Seat 8: matiko09 (€69.59 in chips) 
Seat 9: Optimistic21 (€60.04 in chips) 
chaogoose82: posts small blind €0.25
50CandyJoe: posts big blind €0.50
vlad11122007: sits out 
*** HOLE CARDS ***
Dealt to matiko09 [6d As]
TonnaMunz: raises €1 to €1.50
PacPacBum: folds 
matiko09: folds 
Optimistic21: folds 
Red_Warning: folds 
100+x: folds 
chaogoose82: folds 
50CandyJoe: folds 
Uncalled bet (€1) returned to TonnaMunz
TonnaMunz collected €1.25 from pot
TonnaMunz: doesn't show hand 
*** SUMMARY ***
Total pot €1.25 | Rake €0 
Seat 1: Red_Warning folded before Flop (didn't bet)
Seat 2: 100+x (button) folded before Flop (didn't bet)
Seat 3: chaogoose82 (small blind) folded before Flop
Seat 4: 50CandyJoe (big blind) folded before Flop
Seat 6: TonnaMunz collected (€1.25)
Seat 7: PacPacBum folded before Flop (didn't bet)
Seat 8: matiko09 folded before Flop (didn't bet)
Seat 9: Optimistic21 folded before Flop (didn't bet)





PokerStars Hand #148607190471:  Hold'em No Limit ($0.25/$0.50 USD) - 2016/02/11 12:19:24 CET [2016/02/11 6:19:24 ET]
Table 'Hunan' 9-max Seat #2 is the button
Seat 1: matiko09 ($51.50 in chips) 
Seat 2: smirnoff993 ($147.50 in chips) 
Seat 3: TheMinion ($50 in chips) 
Seat 4: banit7 ($50 in chips) 
Seat 5: apfush ($52.98 in chips) 
Seat 6: i L00K great ($62.91 in chips) 
Seat 7: SForces33 ($23.13 in chips) 
Seat 8: Reven9er ($55.20 in chips) 
Seat 9: Optimistic21 ($59.71 in chips) 
TheMinion: posts small blind $0.25
banit7: posts big blind $0.50
*** HOLE CARDS ***
Dealt to matiko09 [Jd 7s]
apfush: raises $1 to $1.50
i L00K great: folds 
SForces33: calls $1.50
Reven9er: folds 
Optimistic21: calls $1.50
matiko09: folds 
smirnoff993: folds 
TheMinion: calls $1.25
banit7: folds 
*** FLOP *** [Jc 4d 7d]
TheMinion: checks 
apfush: checks 
SForces33: checks 
Optimistic21: checks 
*** TURN *** [Jc 4d 7d] [Ts]
TheMinion: bets $4.01
apfush: folds 
SForces33: calls $4.01
Optimistic21: folds 
*** RIVER *** [Jc 4d 7d Ts] [Jh]
TheMinion: bets $9.15
SForces33: folds 
Uncalled bet ($9.15) returned to TheMinion
TheMinion collected $13.87 from pot
TheMinion: doesn't show hand 
*** SUMMARY ***
Total pot $14.52 | Rake $0.65 
Board [Jc 4d 7d Ts Jh]
Seat 1: matiko09 folded before Flop (didn't bet)
Seat 2: smirnoff993 (button) folded before Flop (didn't bet)
Seat 3: TheMinion (small blind) collected ($13.87)
Seat 4: banit7 (big blind) folded before Flop
Seat 5: apfush folded on the Turn
Seat 6: i L00K great folded before Flop (didn't bet)
Seat 7: SForces33 folded on the River
Seat 8: Reven9er folded before Flop (didn't bet)
Seat 9: Optimistic21 folded on the Turn





PokerStars Hand #148607191516:  Hold'em No Limit ($0.50/$1.00 USD) - 2016/02/11 12:19:26 CET [2016/02/11 6:19:26 ET]
Table 'Sycorax II' 9-max Seat #9 is the button
Seat 1: Luck In Me ($108.76 in chips) 
Seat 2: Lujan87 ($100 in chips) 
Seat 5: Effort92 ($100 in chips) 
Seat 8: matiko09 ($117.37 in chips) 
Seat 9: mrfoldcall ($84.50 in chips) 
Luck In Me: posts small blind $0.50
Lujan87: posts big blind $1
*** HOLE CARDS ***
Dealt to matiko09 [3h 6h]
Effort92: folds 
matiko09: folds 
mrfoldcall: folds 
Luck In Me: raises $2 to $3
Lujan87: calls $2
*** FLOP *** [5h 7s Ts]
Luck In Me: checks 
Lujan87: checks 
*** TURN *** [5h 7s Ts] [9c]
apfush joins the table at seat #3 
Luck In Me: checks 
Lujan87: bets $3.77
Luck In Me: folds 
Uncalled bet ($3.77) returned to Lujan87
Lujan87 collected $5.73 from pot
Lujan87: doesn't show hand 
*** SUMMARY ***
Total pot $6 | Rake $0.27 
Board [5h 7s Ts 9c]
Seat 1: Luck In Me (small blind) folded on the Turn
Seat 2: Lujan87 (big blind) collected ($5.73)
Seat 5: Effort92 folded before Flop (didn't bet)
Seat 8: matiko09 folded before Flop (didn't bet)
Seat 9: mrfoldcall (button) folded before Flop (didn't bet)





PokerStars Hand #148607191455:  Hold'em No Limit ($0.50/$1.00 USD) - 2016/02/11 12:19:26 CET [2016/02/11 6:19:26 ET]
Table 'Magaclite' 9-max Seat #6 is the button
Seat 1: oscarleon ($109 in chips) 
Seat 2: AlKatrone ($106.55 in chips) 
Seat 3: matiko09 ($112.82 in chips) 
Seat 4: Sweden_Pound ($100 in chips) 
Seat 5: Tarjei82 ($79.75 in chips) 
Seat 6: er13to ($100 in chips) 
Seat 7: sebaaastian ($100 in chips) 
Seat 8: CoolFireX ($106.07 in chips) 
Seat 9: Lujan87 ($140.73 in chips) 
sebaaastian: posts small blind $0.50
CoolFireX: posts big blind $1
*** HOLE CARDS ***
Dealt to matiko09 [7d 6c]
Lujan87: folds 
oscarleon: raises $2 to $3
Lujan87 leaves the table
AlKatrone: folds 
matiko09: folds 
Sweden_Pound: folds 
Tarjei82: folds 
er13to: folds 
sebaaastian: folds 
PacPacBum joins the table at seat #9 
CoolFireX: folds 
Uncalled bet ($2) returned to oscarleon
oscarleon collected $2.50 from pot
oscarleon: doesn't show hand 
*** SUMMARY ***
Total pot $2.50 | Rake $0 
Seat 1: oscarleon collected ($2.50)
Seat 2: AlKatrone folded before Flop (didn't bet)
Seat 3: matiko09 folded before Flop (didn't bet)
Seat 4: Sweden_Pound folded before Flop (didn't bet)
Seat 5: Tarjei82 folded before Flop (didn't bet)
Seat 6: er13to (button) folded before Flop (didn't bet)
Seat 7: sebaaastian (small blind) folded before Flop
Seat 8: CoolFireX (big blind) folded before Flop
Seat 9: Lujan87 folded before Flop (didn't bet)





PokerStars Hand #148607195207:  Hold'em No Limit ($0.25/$0.50 USD) - 2016/02/11 12:19:33 CET [2016/02/11 6:19:33 ET]
Table 'Algedi' 9-max Seat #8 is the button
Seat 5: andyjensen14 ($49.97 in chips) 
Seat 6: TonnaMunz ($123.59 in chips) 
Seat 7: hoedtrob ($59.60 in chips) 
Seat 8: matiko09 ($50 in chips) 
Seat 9: Kud3 ($125 in chips) 
Kud3: posts small blind $0.25
andyjensen14: posts big blind $0.50
andyjensen14: posts the ante $0.10
TonnaMunz: posts the ante $0.10
hoedtrob: posts the ante $0.10
matiko09: posts the ante $0.10
Kud3: posts the ante $0.10
*** HOLE CARDS ***
Dealt to matiko09 [2d 8d]
TonnaMunz: raises $0.74 to $1.24
hoedtrob: folds 
matiko09: folds 
Kud3: folds 
andyjensen14: calls $0.74
*** FLOP *** [8c 5h Kc]
andyjensen14: checks 
TonnaMunz: bets $2.50
andyjensen14 is connected 
andyjensen14: calls $2.50
*** TURN *** [8c 5h Kc] [3s]
andyjensen14: checks 
TonnaMunz: bets $7.75
andyjensen14: folds 
Uncalled bet ($7.75) returned to TonnaMunz
TonnaMunz collected $7.86 from pot
TonnaMunz: doesn't show hand 
*** SUMMARY ***
Total pot $8.23 | Rake $0.37 
Board [8c 5h Kc 3s]
Seat 5: andyjensen14 (big blind) folded on the Turn
Seat 6: TonnaMunz collected ($7.86)
Seat 7: hoedtrob folded before Flop (didn't bet)
Seat 8: matiko09 (button) folded before Flop (didn't bet)
Seat 9: Kud3 (small blind) folded before Flop





PokerStars Hand #148607198845:  Hold'em No Limit (€0.25/€0.50 EUR) - 2016/02/11 12:19:40 CET [2016/02/11 6:19:40 ET]
Table 'Otero II' 9-max Seat #3 is the button
Seat 1: Red_Warning (€50 in chips) 
Seat 2: 100+x (€30.30 in chips) 
Seat 3: chaogoose82 (€38.95 in chips) 
Seat 6: TonnaMunz (€56.48 in chips) 
Seat 7: PacPacBum (€50 in chips) 
Seat 8: matiko09 (€69.59 in chips) 
Seat 9: Optimistic21 (€60.04 in chips) 
vlad11122007 will be allowed to play after the button
TonnaMunz: posts small blind €0.25
PacPacBum: posts big blind €0.50
*** HOLE CARDS ***
Dealt to matiko09 [Ac 4d]
50CandyJoe leaves the table
matiko09: folds 
Optimistic21: folds 
Red_Warning: folds 
100+x: folds 
chaogoose82: folds 
TonnaMunz: raises €0.97 to €1.47
PacPacBum: folds 
Uncalled bet (€0.97) returned to TonnaMunz
TonnaMunz collected €1 from pot
TonnaMunz: doesn't show hand 
*** SUMMARY ***
Total pot €1 | Rake €0 
Seat 1: Red_Warning folded before Flop (didn't bet)
Seat 2: 100+x folded before Flop (didn't bet)
Seat 3: chaogoose82 (button) folded before Flop (didn't bet)
Seat 6: TonnaMunz (small blind) collected (€1)
Seat 7: PacPacBum (big blind) folded before Flop
Seat 8: matiko09 folded before Flop (didn't bet)
Seat 9: Optimistic21 folded before Flop (didn't bet)





PokerStars Hand #148607201811:  Hold'em No Limit ($0.25/$0.50 USD) - 2016/02/11 12:19:46 CET [2016/02/11 6:19:46 ET]
Table 'Sylvania II' 9-max Seat #1 is the button
Seat 1: mexx1234 ($190.45 in chips) 
Seat 2: Effort92 ($50.55 in chips) 
Seat 3: ruyingren ($221.92 in chips) 
Seat 4: matiko09 ($120.40 in chips) 
Seat 5: vlad11122007 ($48.61 in chips) 
Seat 6: TonnaMunz ($120.09 in chips) 
Seat 7: i L00K great ($54.78 in chips) 
Seat 8: Optimistic21 ($50 in chips) 
Seat 9: Kud3 ($152.76 in chips) 
Effort92: posts small blind $0.25
ruyingren: posts big blind $0.50
mexx1234: posts the ante $0.10
Effort92: posts the ante $0.10
ruyingren: posts the ante $0.10
matiko09: posts the ante $0.10
vlad11122007: posts the ante $0.10
TonnaMunz: posts the ante $0.10
i L00K great: posts the ante $0.10
Optimistic21: posts the ante $0.10
Kud3: posts the ante $0.10
*** HOLE CARDS ***
Dealt to matiko09 [Tc 5s]
matiko09: folds 
vlad11122007: folds 
TonnaMunz: folds 
i L00K great: folds 
Optimistic21: folds 
Kud3: folds 
mexx1234: raises $0.75 to $1.25
Effort92: folds 
ruyingren: folds 
Uncalled bet ($0.75) returned to mexx1234
mexx1234 collected $2.15 from pot
mexx1234: doesn't show hand 
*** SUMMARY ***
Total pot $2.15 | Rake $0 
Seat 1: mexx1234 (button) collected ($2.15)
Seat 2: Effort92 (small blind) folded before Flop
Seat 3: ruyingren (big blind) folded before Flop
Seat 4: matiko09 folded before Flop (didn't bet)
Seat 5: vlad11122007 folded before Flop (didn't bet)
Seat 6: TonnaMunz folded before Flop (didn't bet)
Seat 7: i L00K great folded before Flop (didn't bet)
Seat 8: Optimistic21 folded before Flop (didn't bet)
Seat 9: Kud3 folded before Flop (didn't bet)





PokerStars Hand #148607201690:  Hold'em No Limit ($0.50/$1.00 USD) - 2016/02/11 12:19:46 CET [2016/02/11 6:19:46 ET]
Table 'Regor' 9-max Seat #7 is the button
Seat 1: matiko09 ($123.61 in chips) 
Seat 3: oscarleon ($101.50 in chips) 
Seat 4: Sweden_Pound ($100 in chips) 
Seat 7: Troll8989 ($115.69 in chips) 
Seat 8: R3NZONIT3 ($62.16 in chips) 
Seat 9: CoolFireX ($101.50 in chips) 
R3NZONIT3: posts small blind $0.50
CoolFireX: posts big blind $1
*** HOLE CARDS ***
Dealt to matiko09 [4h Qh]
matiko09: folds 
oscarleon: folds 
Sweden_Pound: folds 
Troll8989: raises $1.50 to $2.50
R3NZONIT3: calls $2
CoolFireX: folds 
*** FLOP *** [8c 3s Ac]
R3NZONIT3: checks 
Troll8989: checks 
*** TURN *** [8c 3s Ac] [Qc]
Luck In Me joins the table at seat #2 
R3NZONIT3: checks 
Troll8989: bets $3.50
R3NZONIT3: calls $3.50
*** RIVER *** [8c 3s Ac Qc] [7d]
R3NZONIT3: checks 
Troll8989: checks 
*** SHOW DOWN ***
R3NZONIT3: shows [2h Ah] (a pair of Aces)
Troll8989: mucks hand 
R3NZONIT3 collected $12.42 from pot
*** SUMMARY ***
Total pot $13 | Rake $0.58 
Board [8c 3s Ac Qc 7d]
Seat 1: matiko09 folded before Flop (didn't bet)
Seat 3: oscarleon folded before Flop (didn't bet)
Seat 4: Sweden_Pound folded before Flop (didn't bet)
Seat 7: Troll8989 (button) mucked [Jd Kd]
Seat 8: R3NZONIT3 (small blind) showed [2h Ah] and won ($12.42) with a pair of Aces
Seat 9: CoolFireX (big blind) folded before Flop





PokerStars Hand #148607209142:  Hold'em No Limit (€0.25/€0.50 EUR) - 2016/02/11 12:20:00 CET [2016/02/11 6:20:00 ET]
Table 'Otero II' 9-max Seat #6 is the button
Seat 1: Red_Warning (€50 in chips) 
Seat 2: 100+x (€30.30 in chips) 
Seat 3: chaogoose82 (€38.95 in chips) 
Seat 6: TonnaMunz (€56.98 in chips) 
Seat 7: PacPacBum (€50 in chips) 
Seat 8: matiko09 (€69.59 in chips) 
Seat 9: Optimistic21 (€60.04 in chips) 
PacPacBum: posts small blind €0.25
matiko09: posts big blind €0.50
vlad11122007: sits out 
*** HOLE CARDS ***
Dealt to matiko09 [6d 9d]
Optimistic21: folds 
Red_Warning: folds 
100+x: folds 
chaogoose82: folds 
TonnaMunz: folds 
PacPacBum: raises €0.52 to €1.02
matiko09: calls €0.52
*** FLOP *** [As Qc 6h]
PacPacBum: checks 
matiko09: checks 
*** TURN *** [As Qc 6h] [Ad]
PacPacBum: checks 
matiko09: checks 
*** RIVER *** [As Qc 6h Ad] [4h]
PacPacBum: bets €3
matiko09: folds 
Uncalled bet (€3) returned to PacPacBum
PacPacBum collected €1.95 from pot
PacPacBum: doesn't show hand 
*** SUMMARY ***
Total pot €2.04 | Rake €0.09 
Board [As Qc 6h Ad 4h]
Seat 1: Red_Warning folded before Flop (didn't bet)
Seat 2: 100+x folded before Flop (didn't bet)
Seat 3: chaogoose82 folded before Flop (didn't bet)
Seat 6: TonnaMunz (button) folded before Flop (didn't bet)
Seat 7: PacPacBum (small blind) collected (€1.95)
Seat 8: matiko09 (big blind) folded on the River
Seat 9: Optimistic21 folded before Flop (didn't bet)





PokerStars Hand #148607210537:  Hold'em No Limit ($0.50/$1.00 USD) - 2016/02/11 12:20:02 CET [2016/02/11 6:20:02 ET]
Table 'Sycorax II' 9-max Seat #1 is the button
Seat 1: Luck In Me ($105.76 in chips) 
Seat 2: Lujan87 ($102.73 in chips) 
Seat 3: apfush ($100 in chips) 
Seat 5: Effort92 ($100 in chips) 
Seat 8: matiko09 ($117.37 in chips) 
Seat 9: mrfoldcall ($84.50 in chips) 
Lujan87: posts small blind $0.50
apfush: posts big blind $1
*** HOLE CARDS ***
Dealt to matiko09 [2s Jd]
Effort92: raises $2 to $3
matiko09: folds 
mrfoldcall: raises $6 to $9
Luck In Me: folds 
Lujan87: folds 
Sweden_Pound joins the table at seat #4 
apfush: folds 
Effort92: folds 
Uncalled bet ($6) returned to mrfoldcall
mrfoldcall collected $7.50 from pot
mrfoldcall: doesn't show hand 
*** SUMMARY ***
Total pot $7.50 | Rake $0 
Seat 1: Luck In Me (button) folded before Flop (didn't bet)
Seat 2: Lujan87 (small blind) folded before Flop
Seat 3: apfush (big blind) folded before Flop
Seat 5: Effort92 folded before Flop
Seat 8: matiko09 folded before Flop (didn't bet)
Seat 9: mrfoldcall collected ($7.50)





PokerStars Hand #148607212317:  Hold'em No Limit ($0.50/$1.00 USD) - 2016/02/11 12:20:06 CET [2016/02/11 6:20:06 ET]
Table 'Isis II' 9-max Seat #5 is the button
Seat 1: CoolFireX ($135.70 in chips) 
Seat 2: matiko09 ($100 in chips) 
Seat 3: oscarleon ($100 in chips) 
Seat 4: sebaaastian ($100 in chips) 
Seat 5: vezunchik79 ($32.48 in chips) 
Seat 6: kouchan-max ($99.24 in chips) 
Seat 7: PacPacBum ($100 in chips) 
Seat 8: Troll8989 ($103.71 in chips) 
Seat 9: maxxmeister ($172.91 in chips) 
kouchan-max: posts small blind $0.50
PacPacBum: posts big blind $1
*** HOLE CARDS ***
Dealt to matiko09 [As 7c]
Troll8989: folds 
maxxmeister: folds 
CoolFireX: raises $2 to $3
matiko09: folds 
oscarleon: folds 
sebaaastian: folds 
vezunchik79: folds 
kouchan-max: folds 
PacPacBum: folds 
Uncalled bet ($2) returned to CoolFireX
CoolFireX collected $2.50 from pot
CoolFireX: doesn't show hand 
*** SUMMARY ***
Total pot $2.50 | Rake $0 
Seat 1: CoolFireX collected ($2.50)
Seat 2: matiko09 folded before Flop (didn't bet)
Seat 3: oscarleon folded before Flop (didn't bet)
Seat 4: sebaaastian folded before Flop (didn't bet)
Seat 5: vezunchik79 (button) folded before Flop (didn't bet)
Seat 6: kouchan-max (small blind) folded before Flop
Seat 7: PacPacBum (big blind) folded before Flop
Seat 8: Troll8989 folded before Flop (didn't bet)
Seat 9: maxxmeister folded before Flop (didn't bet)





PokerStars Hand #148607213863:  Hold'em No Limit ($0.50/$1.00 USD) - 2016/02/11 12:20:09 CET [2016/02/11 6:20:09 ET]
Table 'Magaclite' 9-max Seat #7 is the button
Seat 1: oscarleon ($110.50 in chips) 
Seat 2: AlKatrone ($106.55 in chips) 
Seat 3: matiko09 ($112.82 in chips) 
Seat 4: Sweden_Pound ($100 in chips) 
Seat 5: Tarjei82 ($79.75 in chips) 
Seat 6: er13to ($100 in chips) 
Seat 7: sebaaastian ($100 in chips) 
Seat 8: CoolFireX ($105.07 in chips) 
Seat 9: PacPacBum ($100 in chips) 
CoolFireX: posts small blind $0.50
PacPacBum: posts big blind $1
*** HOLE CARDS ***
Dealt to matiko09 [Qd Ts]
oscarleon: folds 
AlKatrone: raises $2 to $3
matiko09: folds 
Sweden_Pound: folds 
Tarjei82: folds 
er13to: folds 
sebaaastian: folds 
CoolFireX: folds 
PacPacBum: folds 
Uncalled bet ($2) returned to AlKatrone
AlKatrone collected $2.50 from pot
AlKatrone: doesn't show hand 
*** SUMMARY ***
Total pot $2.50 | Rake $0 
Seat 1: oscarleon folded before Flop (didn't bet)
Seat 2: AlKatrone collected ($2.50)
Seat 3: matiko09 folded before Flop (didn't bet)
Seat 4: Sweden_Pound folded before Flop (didn't bet)
Seat 5: Tarjei82 folded before Flop (didn't bet)
Seat 6: er13to folded before Flop (didn't bet)
Seat 7: sebaaastian (button) folded before Flop (didn't bet)
Seat 8: CoolFireX (small blind) folded before Flop
Seat 9: PacPacBum (big blind) folded before Flop





PokerStars Hand #148607214677:  Hold'em No Limit ($0.25/$0.50 USD) - 2016/02/11 12:20:10 CET [2016/02/11 6:20:10 ET]
Table 'Stereoskopia' 9-max Seat #1 is the button
Seat 1: 50CandyJoe ($51.79 in chips) 
Seat 2: Optimistic21 ($50 in chips) 
Seat 3: Donko jr ($50 in chips) 
Seat 4: King brid ($34.86 in chips) 
Seat 5: ReinisRNS ($61.43 in chips) 
Seat 6: matiko09 ($52.08 in chips) 
Seat 7: tallonn88 ($51.25 in chips) 
Seat 8: banit7 ($89.28 in chips) 
Seat 9: anubis4455 ($58.17 in chips) 
Optimistic21: posts small blind $0.25
Donko jr: posts big blind $0.50
*** HOLE CARDS ***
Dealt to matiko09 [As 6c]
King brid: folds 
ReinisRNS: folds 
matiko09: folds 
tallonn88: folds 
banit7: folds 
anubis4455: folds 
50CandyJoe: folds 
Optimistic21: folds 
Uncalled bet ($0.25) returned to Donko jr
Donko jr collected $0.50 from pot
*** SUMMARY ***
Total pot $0.50 | Rake $0 
Seat 1: 50CandyJoe (button) folded before Flop (didn't bet)
Seat 2: Optimistic21 (small blind) folded before Flop
Seat 3: Donko jr (big blind) collected ($0.50)
Seat 4: King brid folded before Flop (didn't bet)
Seat 5: ReinisRNS folded before Flop (didn't bet)
Seat 6: matiko09 folded before Flop (didn't bet)
Seat 7: tallonn88 folded before Flop (didn't bet)
Seat 8: banit7 folded before Flop (didn't bet)
Seat 9: anubis4455 folded before Flop (didn't bet)





PokerStars Hand #148607227536:  Hold'em No Limit ($0.50/$1.00 USD) - 2016/02/11 12:20:35 CET [2016/02/11 6:20:35 ET]
Table 'Isis II' 9-max Seat #6 is the button
Seat 1: CoolFireX ($137.20 in chips) 
Seat 2: matiko09 ($100 in chips) 
Seat 3: oscarleon ($100 in chips) 
Seat 4: sebaaastian ($100 in chips) 
Seat 5: vezunchik79 ($32.48 in chips) 
Seat 6: kouchan-max ($98.74 in chips) 
Seat 7: PacPacBum ($100 in chips) 
Seat 8: Troll8989 ($103.71 in chips) 
Seat 9: maxxmeister ($172.91 in chips) 
PacPacBum: posts small blind $0.50
Troll8989: posts big blind $1
*** HOLE CARDS ***
Dealt to matiko09 [Ts 9s]
maxxmeister: folds 
maxxmeister leaves the table
hurtNCYDE joins the table at seat #9 
CoolFireX: folds 
hurtNCYDE leaves the table
matiko09: raises $2 to $3
Sweden_Pound joins the table at seat #9 
oscarleon: folds 
sebaaastian: folds 
vezunchik79: folds 
kouchan-max: folds 
PacPacBum: folds 
Troll8989 has timed out
Troll8989: folds 
Uncalled bet ($2) returned to matiko09
matiko09 collected $2.50 from pot
matiko09: doesn't show hand 
*** SUMMARY ***
Total pot $2.50 | Rake $0 
Seat 1: CoolFireX folded before Flop (didn't bet)
Seat 2: matiko09 collected ($2.50)
Seat 3: oscarleon folded before Flop (didn't bet)
Seat 4: sebaaastian folded before Flop (didn't bet)
Seat 5: vezunchik79 folded before Flop (didn't bet)
Seat 6: kouchan-max (button) folded before Flop (didn't bet)
Seat 7: PacPacBum (small blind) folded before Flop
Seat 8: Troll8989 (big blind) folded before Flop
Seat 9: maxxmeister folded before Flop (didn't bet)





PokerStars Hand #148607227818:  Hold'em No Limit ($0.25/$0.50 USD) - 2016/02/11 12:20:35 CET [2016/02/11 6:20:35 ET]
Table 'Stereoskopia' 9-max Seat #2 is the button
Seat 1: 50CandyJoe ($51.79 in chips) 
Seat 2: Optimistic21 ($50 in chips) 
Seat 3: Donko jr ($50.25 in chips) 
Seat 4: King brid ($34.86 in chips) 
Seat 5: ReinisRNS ($61.43 in chips) 
Seat 6: matiko09 ($52.08 in chips) 
Seat 7: tallonn88 ($51.25 in chips) 
Seat 8: banit7 ($89.28 in chips) 
Seat 9: anubis4455 ($58.17 in chips) 
Donko jr: posts small blind $0.25
King brid: posts big blind $0.50
*** HOLE CARDS ***
Dealt to matiko09 [8h 7h]
ReinisRNS: folds 
matiko09: raises $1 to $1.50
tallonn88: folds 
banit7: folds 
anubis4455: folds 
50CandyJoe: folds 
Optimistic21: folds 
Donko jr: calls $1.25
King brid: folds 
*** FLOP *** [Qd 6s Jd]
Donko jr: checks 
matiko09: checks 
*** TURN *** [Qd 6s Jd] [9s]
Donko jr: checks 
matiko09: bets $2.17
Donko jr: calls $2.17
*** RIVER *** [Qd 6s Jd 9s] [Tc]
Donko jr: checks 
matiko09: bets $3
Donko jr: calls $3
*** SHOW DOWN ***
matiko09: shows [8h 7h] (a straight, Eight to Queen)
Donko jr: shows [4c Kc] (a straight, Nine to King)
Donko jr collected $13.22 from pot
*** SUMMARY ***
Total pot $13.84 | Rake $0.62 
Board [Qd 6s Jd 9s Tc]
Seat 1: 50CandyJoe folded before Flop (didn't bet)
Seat 2: Optimistic21 (button) folded before Flop (didn't bet)
Seat 3: Donko jr (small blind) showed [4c Kc] and won ($13.22) with a straight, Nine to King
Seat 4: King brid (big blind) folded before Flop
Seat 5: ReinisRNS folded before Flop (didn't bet)
Seat 6: matiko09 showed [8h 7h] and lost with a straight, Eight to Queen
Seat 7: tallonn88 folded before Flop (didn't bet)
Seat 8: banit7 folded before Flop (didn't bet)
Seat 9: anubis4455 folded before Flop (didn't bet)





PokerStars Hand #148607229050:  Hold'em No Limit ($0.25/$0.50 USD) - 2016/02/11 12:20:38 CET [2016/02/11 6:20:38 ET]
Table 'Algedi' 9-max Seat #9 is the button
Seat 5: andyjensen14 ($46.13 in chips) 
Seat 6: TonnaMunz ($127.61 in chips) 
Seat 7: hoedtrob ($59.50 in chips) 
Seat 8: matiko09 ($50 in chips) 
Seat 9: Kud3 ($125 in chips) 
andyjensen14: posts small blind $0.25
TonnaMunz: posts big blind $0.50
andyjensen14: posts the ante $0.10
TonnaMunz: posts the ante $0.10
hoedtrob: posts the ante $0.10
matiko09: posts the ante $0.10
Kud3: posts the ante $0.10
*** HOLE CARDS ***
Dealt to matiko09 [9s Kh]
hoedtrob: folds 
matiko09: folds 
Kud3: raises $1 to $1.50
andyjensen14: calls $1.25
TonnaMunz: folds 
*** FLOP *** [9d 5d 5c]
andyjensen14: checks 
vlad11122007 joins the table at seat #1 
Kud3: bets $2.55
andyjensen14: folds 
Uncalled bet ($2.55) returned to Kud3
Kud3 collected $3.82 from pot
Kud3: doesn't show hand 
*** SUMMARY ***
Total pot $4 | Rake $0.18 
Board [9d 5d 5c]
Seat 5: andyjensen14 (small blind) folded on the Flop
Seat 6: TonnaMunz (big blind) folded before Flop
Seat 7: hoedtrob folded before Flop (didn't bet)
Seat 8: matiko09 folded before Flop (didn't bet)
Seat 9: Kud3 (button) collected ($3.82)





PokerStars Hand #148607230071:  Hold'em No Limit ($0.25/$0.50 USD) - 2016/02/11 12:20:40 CET [2016/02/11 6:20:40 ET]
Table 'Hunan' 9-max Seat #3 is the button
Seat 1: matiko09 ($51.50 in chips) 
Seat 2: smirnoff993 ($147.50 in chips) 
Seat 3: TheMinion ($58.36 in chips) 
Seat 4: banit7 ($50 in chips) 
Seat 6: i L00K great ($62.91 in chips) 
Seat 7: SForces33 ($17.62 in chips) 
Seat 8: Reven9er ($55.20 in chips) 
Seat 9: Optimistic21 ($58.21 in chips) 
banit7: posts small blind $0.25
apfush: is sitting out 
apfush leaves the table
i L00K great: posts big blind $0.50
*** HOLE CARDS ***
Dealt to matiko09 [9s 6d]
SForces33: folds 
Reven9er: folds 
Honk115 joins the table at seat #5 
Optimistic21: folds 
matiko09: folds 
smirnoff993: folds 
TheMinion: raises $0.52 to $1.02
banit7: folds 
i L00K great: folds 
Uncalled bet ($0.52) returned to TheMinion
TheMinion collected $1.25 from pot
TheMinion: doesn't show hand 
*** SUMMARY ***
Total pot $1.25 | Rake $0 
Seat 1: matiko09 folded before Flop (didn't bet)
Seat 2: smirnoff993 folded before Flop (didn't bet)
Seat 3: TheMinion (button) collected ($1.25)
Seat 4: banit7 (small blind) folded before Flop
Seat 6: i L00K great (big blind) folded before Flop
Seat 7: SForces33 folded before Flop (didn't bet)
Seat 8: Reven9er folded before Flop (didn't bet)
Seat 9: Optimistic21 folded before Flop (didn't bet)





PokerStars Hand #148607233081:  Hold'em No Limit ($0.50/$1.00 USD) - 2016/02/11 12:20:45 CET [2016/02/11 6:20:45 ET]
Table 'Sycorax II' 9-max Seat #2 is the button
Seat 1: Luck In Me ($105.76 in chips) 
Seat 2: Lujan87 ($102.23 in chips) 
Seat 3: apfush ($100 in chips) 
Seat 4: Sweden_Pound ($149.44 in chips) 
Seat 5: Effort92 ($100 in chips) 
Seat 8: matiko09 ($117.37 in chips) 
Seat 9: mrfoldcall ($89 in chips) 
apfush: posts small blind $0.50
Sweden_Pound: posts big blind $1
*** HOLE CARDS ***
Dealt to matiko09 [Kd 3d]
Effort92: folds 
matiko09: folds 
mrfoldcall: raises $2 to $3
Luck In Me: folds 
Lujan87: folds 
apfush: folds 
Sweden_Pound: folds 
Uncalled bet ($2) returned to mrfoldcall
mrfoldcall collected $2.50 from pot
mrfoldcall: doesn't show hand 
*** SUMMARY ***
Total pot $2.50 | Rake $0 
Seat 1: Luck In Me folded before Flop (didn't bet)
Seat 2: Lujan87 (button) folded before Flop (didn't bet)
Seat 3: apfush (small blind) folded before Flop
Seat 4: Sweden_Pound (big blind) folded before Flop
Seat 5: Effort92 folded before Flop (didn't bet)
Seat 8: matiko09 folded before Flop (didn't bet)
Seat 9: mrfoldcall collected ($2.50)





PokerStars Hand #148607232892:  Hold'em No Limit ($0.25/$0.50 USD) - 2016/02/11 12:20:45 CET [2016/02/11 6:20:45 ET]
Table 'Sylvania II' 9-max Seat #2 is the button
Seat 1: mexx1234 ($192 in chips) 
Seat 2: Effort92 ($50.20 in chips) 
Seat 3: ruyingren ($221.32 in chips) 
Seat 4: matiko09 ($120.30 in chips) 
Seat 5: vlad11122007 ($48.51 in chips) 
Seat 6: TonnaMunz ($119.99 in chips) 
Seat 7: i L00K great ($54.68 in chips) 
Seat 8: Optimistic21 ($50 in chips) 
Seat 9: Kud3 ($152.66 in chips) 
ruyingren: posts small blind $0.25
matiko09: posts big blind $0.50
mexx1234: posts the ante $0.10
Effort92: posts the ante $0.10
ruyingren: posts the ante $0.10
matiko09: posts the ante $0.10
vlad11122007: posts the ante $0.10
TonnaMunz: posts the ante $0.10
i L00K great: posts the ante $0.10
Optimistic21: posts the ante $0.10
Kud3: posts the ante $0.10
*** HOLE CARDS ***
Dealt to matiko09 [Qh 9d]
vlad11122007: raises $1 to $1.50
TonnaMunz: folds 
i L00K great: folds 
Optimistic21: folds 
Kud3: folds 
mexx1234: folds 
Effort92: folds 
ruyingren: folds 
matiko09: folds 
Uncalled bet ($1) returned to vlad11122007
vlad11122007 collected $2.15 from pot
vlad11122007: doesn't show hand 
*** SUMMARY ***
Total pot $2.15 | Rake $0 
Seat 1: mexx1234 folded before Flop (didn't bet)
Seat 2: Effort92 (button) folded before Flop (didn't bet)
Seat 3: ruyingren (small blind) folded before Flop
Seat 4: matiko09 (big blind) folded before Flop
Seat 5: vlad11122007 collected ($2.15)
Seat 6: TonnaMunz folded before Flop (didn't bet)
Seat 7: i L00K great folded before Flop (didn't bet)
Seat 8: Optimistic21 folded before Flop (didn't bet)
Seat 9: Kud3 folded before Flop (didn't bet)





PokerStars Hand #148607233460:  Hold'em No Limit ($0.25/$0.50 USD) - 2016/02/11 12:20:46 CET [2016/02/11 6:20:46 ET]
Table 'Ambrosia II' 9-max Seat #1 is the button
Seat 1: matiko09 ($50 in chips) 
Seat 2: TheMinion ($116.19 in chips) 
Seat 4: huudk2016 ($18.75 in chips) 
Seat 5: smirnoff993 ($70.75 in chips) 
Seat 6: Reven9er ($50 in chips) 
Seat 7: mexx1234 ($57.37 in chips) 
Seat 8: tallonn88 ($54.06 in chips) 
Seat 9: arctur17 ($55.60 in chips) 
TheMinion: posts small blind $0.25
apfush: is sitting out 
huudk2016: posts big blind $0.50
*** HOLE CARDS ***
Dealt to matiko09 [3d 2h]
apfush leaves the table
smirnoff993: folds 
Reven9er: folds 
mexx1234: folds 
tallonn88: folds 
arctur17: raises $0.50 to $1
matiko09: folds 
TheMinion: folds 
huudk2016: calls $0.50
*** FLOP *** [Ks Js Jc]
huudk2016: checks 
arctur17: checks 
*** TURN *** [Ks Js Jc] [4d]
huudk2016: bets $2
arctur17: folds 
Uncalled bet ($2) returned to huudk2016
huudk2016 collected $2.15 from pot
make6a joins the table at seat #3 
huudk2016: doesn't show hand 
*** SUMMARY ***
Total pot $2.25 | Rake $0.10 
Board [Ks Js Jc 4d]
Seat 1: matiko09 (button) folded before Flop (didn't bet)
Seat 2: TheMinion (small blind) folded before Flop
Seat 4: huudk2016 (big blind) collected ($2.15)
Seat 5: smirnoff993 folded before Flop (didn't bet)
Seat 6: Reven9er folded before Flop (didn't bet)
Seat 7: mexx1234 folded before Flop (didn't bet)
Seat 8: tallonn88 folded before Flop (didn't bet)
Seat 9: arctur17 folded on the Turn





PokerStars Hand #148607233548:  Hold'em No Limit ($0.50/$1.00 USD) - 2016/02/11 12:20:46 CET [2016/02/11 6:20:46 ET]
Table 'Magaclite' 9-max Seat #8 is the button
Seat 1: oscarleon ($110.50 in chips) 
Seat 2: AlKatrone ($108.05 in chips) 
Seat 3: matiko09 ($112.82 in chips) 
Seat 4: Sweden_Pound ($100 in chips) 
Seat 5: Tarjei82 ($79.75 in chips) 
Seat 6: er13to ($100 in chips) 
Seat 7: sebaaastian ($100 in chips) 
Seat 8: CoolFireX ($104.57 in chips) 
Seat 9: PacPacBum ($100 in chips) 
PacPacBum: posts small blind $0.50
oscarleon: posts big blind $1
*** HOLE CARDS ***
Dealt to matiko09 [As 8c]
AlKatrone: folds 
matiko09: folds 
Sweden_Pound: folds 
Tarjei82: folds 
er13to: folds 
sebaaastian: raises $1.50 to $2.50
CoolFireX: folds 
PacPacBum: folds 
oscarleon: folds 
Uncalled bet ($1.50) returned to sebaaastian
sebaaastian collected $2.50 from pot
sebaaastian: doesn't show hand 
*** SUMMARY ***
Total pot $2.50 | Rake $0 
Seat 1: oscarleon (big blind) folded before Flop
Seat 2: AlKatrone folded before Flop (didn't bet)
Seat 3: matiko09 folded before Flop (didn't bet)
Seat 4: Sweden_Pound folded before Flop (didn't bet)
Seat 5: Tarjei82 folded before Flop (didn't bet)
Seat 6: er13to folded before Flop (didn't bet)
Seat 7: sebaaastian collected ($2.50)
Seat 8: CoolFireX (button) folded before Flop (didn't bet)
Seat 9: PacPacBum (small blind) folded before Flop





PokerStars Hand #148607237304:  Hold'em No Limit ($0.25/$0.50 USD) - 2016/02/11 12:20:53 CET [2016/02/11 6:20:53 ET]
Table 'Boliviana II' 9-max Seat #9 is the button
Seat 1: Optimistic21 ($57.63 in chips) 
Seat 2: matiko09 ($50 in chips) 
Seat 3: LyDynasty ($50.29 in chips) 
Seat 4: i L00K great ($79.06 in chips) 
Seat 5: make6a ($47.58 in chips) 
Seat 6: corsair888 ($58.31 in chips) 
Seat 7: vlad11122007 ($48.50 in chips) 
Seat 8: TheMinion ($50 in chips) 
Seat 9: PokerSash201 ($47.31 in chips) 
Optimistic21: posts small blind $0.25
matiko09: posts big blind $0.50
*** HOLE CARDS ***
Dealt to matiko09 [3s 9s]
LyDynasty: calls $0.50
i L00K great: folds 
make6a: folds 
corsair888: folds 
vlad11122007: folds 
TheMinion: folds 
PokerSash201: folds 
Optimistic21: raises $2 to $2.50
matiko09: folds 
LyDynasty: calls $2
*** FLOP *** [9c Ts 2d]
Optimistic21: bets $4
LyDynasty: folds 
Uncalled bet ($4) returned to Optimistic21
Optimistic21 collected $5.25 from pot
*** SUMMARY ***
Total pot $5.50 | Rake $0.25 
Board [9c Ts 2d]
Seat 1: Optimistic21 (small blind) collected ($5.25)
Seat 2: matiko09 (big blind) folded before Flop
Seat 3: LyDynasty folded on the Flop
Seat 4: i L00K great folded before Flop (didn't bet)
Seat 5: make6a folded before Flop (didn't bet)
Seat 6: corsair888 folded before Flop (didn't bet)
Seat 7: vlad11122007 folded before Flop (didn't bet)
Seat 8: TheMinion folded before Flop (didn't bet)
Seat 9: PokerSash201 (button) folded before Flop (didn't bet)





PokerStars Hand #148607241348:  Hold'em No Limit ($0.50/$1.00 USD) - 2016/02/11 12:21:01 CET [2016/02/11 6:21:01 ET]
Table 'Regor' 9-max Seat #8 is the button
Seat 1: matiko09 ($123.61 in chips) 
Seat 3: oscarleon ($101.50 in chips) 
Seat 4: Sweden_Pound ($100 in chips) 
Seat 7: Troll8989 ($109.69 in chips) 
Seat 8: R3NZONIT3 ($68.58 in chips) 
Seat 9: CoolFireX ($100.50 in chips) 
CoolFireX: posts small blind $0.50
matiko09: posts big blind $1
Luck In Me: sits out 
*** HOLE CARDS ***
Dealt to matiko09 [4h 4c]
oscarleon: folds 
Sweden_Pound: folds 
Troll8989 has timed out
Troll8989: folds 
R3NZONIT3: folds 
CoolFireX: folds 
Uncalled bet ($0.50) returned to matiko09
matiko09 collected $1 from pot
matiko09: doesn't show hand 
*** SUMMARY ***
Total pot $1 | Rake $0 
Seat 1: matiko09 (big blind) collected ($1)
Seat 3: oscarleon folded before Flop (didn't bet)
Seat 4: Sweden_Pound folded before Flop (didn't bet)
Seat 7: Troll8989 folded before Flop (didn't bet)
Seat 8: R3NZONIT3 (button) folded before Flop (didn't bet)
Seat 9: CoolFireX (small blind) folded before Flop





PokerStars Hand #148607241253:  Hold'em No Limit (€0.25/€0.50 EUR) - 2016/02/11 12:21:01 CET [2016/02/11 6:21:01 ET]
Table 'Otero II' 9-max Seat #7 is the button
Seat 1: Red_Warning (€50 in chips) 
Seat 2: 100+x (€30.30 in chips) 
Seat 3: chaogoose82 (€38.95 in chips) 
Seat 6: TonnaMunz (€56.98 in chips) 
Seat 7: PacPacBum (€50.93 in chips) 
Seat 8: matiko09 (€68.57 in chips) 
Seat 9: Optimistic21 (€60.04 in chips) 
matiko09: posts small blind €0.25
Optimistic21: posts big blind €0.50
vlad11122007: sits out 
*** HOLE CARDS ***
Dealt to matiko09 [5s 2c]
Red_Warning: folds 
100+x: raises €1 to €1.50
chaogoose82: folds 
Red_Warning leaves the table
TonnaMunz: calls €1.50
PacPacBum: folds 
matiko09: folds 
Optimistic21: folds 
*** FLOP *** [6h Ah 9d]
100+x: bets €2
TonnaMunz: calls €2
*** TURN *** [6h Ah 9d] [4c]
100+x: checks 
TonnaMunz: bets €5.50
100+x: calls €5.50
*** RIVER *** [6h Ah 9d 4c] [3h]
100+x: bets €7.50
TonnaMunz: folds 
Uncalled bet (€7.50) returned to 100+x
100+x collected €17.91 from pot
100+x: doesn't show hand 
*** SUMMARY ***
Total pot €18.75 | Rake €0.84 
Board [6h Ah 9d 4c 3h]
Seat 1: Red_Warning folded before Flop (didn't bet)
Seat 2: 100+x collected (€17.91)
Seat 3: chaogoose82 folded before Flop (didn't bet)
Seat 6: TonnaMunz folded on the River
Seat 7: PacPacBum (button) folded before Flop (didn't bet)
Seat 8: matiko09 (small blind) folded before Flop
Seat 9: Optimistic21 (big blind) folded before Flop





PokerStars Hand #148607248743:  Hold'em No Limit ($0.25/$0.50 USD) - 2016/02/11 12:21:15 CET [2016/02/11 6:21:15 ET]
Table 'Sylvania II' 9-max Seat #3 is the button
Seat 1: mexx1234 ($191.90 in chips) 
Seat 2: Effort92 ($50.10 in chips) 
Seat 3: ruyingren ($220.97 in chips) 
Seat 4: matiko09 ($119.70 in chips) 
Seat 5: vlad11122007 ($50.06 in chips) 
Seat 6: TonnaMunz ($119.89 in chips) 
Seat 7: i L00K great ($54.58 in chips) 
Seat 8: Optimistic21 ($50 in chips) 
Seat 9: Kud3 ($152.56 in chips) 
matiko09: posts small blind $0.25
vlad11122007: posts big blind $0.50
mexx1234: posts the ante $0.10
Effort92: posts the ante $0.10
ruyingren: posts the ante $0.10
matiko09: posts the ante $0.10
vlad11122007: posts the ante $0.10
TonnaMunz: posts the ante $0.10
i L00K great: posts the ante $0.10
Optimistic21: posts the ante $0.10
Kud3: posts the ante $0.10
*** HOLE CARDS ***
Dealt to matiko09 [As 2d]
TonnaMunz: folds 
i L00K great: folds 
Optimistic21: folds 
Kud3: folds 
mexx1234: folds 
Effort92: raises $0.75 to $1.25
ruyingren: calls $1.25
matiko09: folds 
vlad11122007: folds 
*** FLOP *** [Jh 3s 4d]
Effort92: checks 
ruyingren: bets $2.50
Effort92: calls $2.50
*** TURN *** [Jh 3s 4d] [5h]
Effort92: checks 
ruyingren: checks 
*** RIVER *** [Jh 3s 4d 5h] [4s]
Effort92: bets $5.82
ruyingren: folds 
Uncalled bet ($5.82) returned to Effort92
Effort92 collected $8.74 from pot
Effort92: doesn't show hand 
*** SUMMARY ***
Total pot $9.15 | Rake $0.41 
Board [Jh 3s 4d 5h 4s]
Seat 1: mexx1234 folded before Flop (didn't bet)
Seat 2: Effort92 collected ($8.74)
Seat 3: ruyingren (button) folded on the River
Seat 4: matiko09 (small blind) folded before Flop
Seat 5: vlad11122007 (big blind) folded before Flop
Seat 6: TonnaMunz folded before Flop (didn't bet)
Seat 7: i L00K great folded before Flop (didn't bet)
Seat 8: Optimistic21 folded before Flop (didn't bet)
Seat 9: Kud3 folded before Flop (didn't bet)





PokerStars Hand #148607249957:  Hold'em No Limit ($0.25/$0.50 USD) - 2016/02/11 12:21:17 CET [2016/02/11 6:21:17 ET]
Table 'Hunan' 9-max Seat #4 is the button
Seat 1: matiko09 ($51.50 in chips) 
Seat 2: smirnoff993 ($147.50 in chips) 
Seat 3: TheMinion ($59.11 in chips) 
Seat 4: banit7 ($50 in chips) 
Seat 6: i L00K great ($62.41 in chips) 
Seat 7: SForces33 ($17.62 in chips) 
Seat 8: Reven9er ($55.20 in chips) 
Seat 9: Optimistic21 ($58.21 in chips) 
Honk115 will be allowed to play after the button
i L00K great: posts small blind $0.25
SForces33: posts big blind $0.50
*** HOLE CARDS ***
Dealt to matiko09 [2h Td]
Reven9er: folds 
Optimistic21: folds 
matiko09: folds 
smirnoff993: folds 
TheMinion: raises $0.75 to $1.25
banit7: folds 
i L00K great: folds 
SForces33: folds 
Uncalled bet ($0.75) returned to TheMinion
TheMinion collected $1.25 from pot
TheMinion: doesn't show hand 
*** SUMMARY ***
Total pot $1.25 | Rake $0 
Seat 1: matiko09 folded before Flop (didn't bet)
Seat 2: smirnoff993 folded before Flop (didn't bet)
Seat 3: TheMinion collected ($1.25)
Seat 4: banit7 (button) folded before Flop (didn't bet)
Seat 6: i L00K great (small blind) folded before Flop
Seat 7: SForces33 (big blind) folded before Flop
Seat 8: Reven9er folded before Flop (didn't bet)
Seat 9: Optimistic21 folded before Flop (didn't bet)





PokerStars Hand #148607252756:  Hold'em No Limit ($0.50/$1.00 USD) - 2016/02/11 12:21:23 CET [2016/02/11 6:21:23 ET]
Table 'Sycorax II' 9-max Seat #3 is the button
Seat 1: Luck In Me ($105.76 in chips) 
Seat 2: Lujan87 ($102.23 in chips) 
Seat 3: apfush ($100 in chips) 
Seat 4: Sweden_Pound ($148.44 in chips) 
Seat 5: Effort92 ($100 in chips) 
Seat 8: matiko09 ($117.37 in chips) 
Seat 9: mrfoldcall ($90.50 in chips) 
Sweden_Pound: posts small blind $0.50
Effort92: posts big blind $1
*** HOLE CARDS ***
Dealt to matiko09 [6c 8s]
matiko09: folds 
mrfoldcall: folds 
Luck In Me: raises $2 to $3
Lujan87: folds 
apfush: folds 
Sweden_Pound: folds 
Effort92: folds 
Uncalled bet ($2) returned to Luck In Me
Luck In Me collected $2.50 from pot
Luck In Me: doesn't show hand 
*** SUMMARY ***
Total pot $2.50 | Rake $0 
Seat 1: Luck In Me collected ($2.50)
Seat 2: Lujan87 folded before Flop (didn't bet)
Seat 3: apfush (button) folded before Flop (didn't bet)
Seat 4: Sweden_Pound (small blind) folded before Flop
Seat 5: Effort92 (big blind) folded before Flop
Seat 8: matiko09 folded before Flop (didn't bet)
Seat 9: mrfoldcall folded before Flop (didn't bet)





PokerStars Hand #148607255056:  Hold'em No Limit ($0.50/$1.00 USD) - 2016/02/11 12:21:27 CET [2016/02/11 6:21:27 ET]
Table 'Isis II' 9-max Seat #7 is the button
Seat 1: CoolFireX ($137.20 in chips) 
Seat 2: matiko09 ($101.50 in chips) 
Seat 3: oscarleon ($100 in chips) 
Seat 4: sebaaastian ($100 in chips) 
Seat 5: vezunchik79 ($32.48 in chips) 
Seat 6: kouchan-max ($98.74 in chips) 
Seat 7: PacPacBum ($100 in chips) 
Sweden_Pound will be allowed to play after the button
CoolFireX: posts small blind $0.50
matiko09: posts big blind $1
*** HOLE CARDS ***
Dealt to matiko09 [8d Qs]
oscarleon: raises $2 to $3
sebaaastian: folds 
vezunchik79: folds 
kouchan-max: folds 
PacPacBum: folds 
CoolFireX: folds 
matiko09: folds 
Uncalled bet ($2) returned to oscarleon
oscarleon collected $2.50 from pot
oscarleon: doesn't show hand 
*** SUMMARY ***
Total pot $2.50 | Rake $0 
Seat 1: CoolFireX (small blind) folded before Flop
Seat 2: matiko09 (big blind) folded before Flop
Seat 3: oscarleon collected ($2.50)
Seat 4: sebaaastian folded before Flop (didn't bet)
Seat 5: vezunchik79 folded before Flop (didn't bet)
Seat 6: kouchan-max folded before Flop (didn't bet)
Seat 7: PacPacBum (button) folded before Flop (didn't bet)





PokerStars Hand #148607256807:  Hold'em No Limit ($0.25/$0.50 USD) - 2016/02/11 12:21:30 CET [2016/02/11 6:21:30 ET]
Table 'Boliviana II' 9-max Seat #1 is the button
Seat 1: Optimistic21 ($60.38 in chips) 
Seat 2: matiko09 ($50 in chips) 
Seat 3: LyDynasty ($47.79 in chips) 
Seat 4: i L00K great ($79.06 in chips) 
Seat 5: make6a ($47.58 in chips) 
Seat 6: corsair888 ($58.31 in chips) 
Seat 7: vlad11122007 ($48.50 in chips) 
Seat 8: TheMinion ($50 in chips) 
Seat 9: PokerSash201 ($47.31 in chips) 
matiko09: posts small blind $0.25
LyDynasty: posts big blind $0.50
*** HOLE CARDS ***
Dealt to matiko09 [4h As]
i L00K great: folds 
make6a: folds 
corsair888: folds 
vlad11122007: folds 
TheMinion: folds 
PokerSash201: folds 
Optimistic21: folds 
matiko09: folds 
Uncalled bet ($0.25) returned to LyDynasty
LyDynasty collected $0.50 from pot
LyDynasty: doesn't show hand 
*** SUMMARY ***
Total pot $0.50 | Rake $0 
Seat 1: Optimistic21 (button) folded before Flop (didn't bet)
Seat 2: matiko09 (small blind) folded before Flop
Seat 3: LyDynasty (big blind) collected ($0.50)
Seat 4: i L00K great folded before Flop (didn't bet)
Seat 5: make6a folded before Flop (didn't bet)
Seat 6: corsair888 folded before Flop (didn't bet)
Seat 7: vlad11122007 folded before Flop (didn't bet)
Seat 8: TheMinion folded before Flop (didn't bet)
Seat 9: PokerSash201 folded before Flop (didn't bet)





PokerStars Hand #148607257458:  Hold'em No Limit ($0.25/$0.50 USD) - 2016/02/11 12:21:32 CET [2016/02/11 6:21:32 ET]
Table 'Stereoskopia' 9-max Seat #3 is the button
Seat 1: 50CandyJoe ($51.79 in chips) 
Seat 2: Optimistic21 ($50 in chips) 
Seat 3: Donko jr ($56.80 in chips) 
Seat 4: King brid ($34.36 in chips) 
Seat 5: ReinisRNS ($61.43 in chips) 
Seat 6: matiko09 ($50 in chips) 
Seat 7: tallonn88 ($51.25 in chips) 
Seat 8: banit7 ($89.28 in chips) 
Seat 9: anubis4455 ($58.17 in chips) 
King brid: posts small blind $0.25
ReinisRNS: posts big blind $0.50
*** HOLE CARDS ***
Dealt to matiko09 [4c 9h]
matiko09: folds 
tallonn88: folds 
banit7: folds 
anubis4455: folds 
50CandyJoe: folds 
Optimistic21: folds 
Donko jr: folds 
King brid: raises $1 to $1.50
ReinisRNS: folds 
Uncalled bet ($1) returned to King brid
King brid collected $1 from pot
King brid: doesn't show hand 
*** SUMMARY ***
Total pot $1 | Rake $0 
Seat 1: 50CandyJoe folded before Flop (didn't bet)
Seat 2: Optimistic21 folded before Flop (didn't bet)
Seat 3: Donko jr (button) folded before Flop (didn't bet)
Seat 4: King brid (small blind) collected ($1)
Seat 5: ReinisRNS (big blind) folded before Flop
Seat 6: matiko09 folded before Flop (didn't bet)
Seat 7: tallonn88 folded before Flop (didn't bet)
Seat 8: banit7 folded before Flop (didn't bet)
Seat 9: anubis4455 folded before Flop (didn't bet)





PokerStars Hand #148607260857:  Hold'em No Limit ($0.25/$0.50 USD) - 2016/02/11 12:21:38 CET [2016/02/11 6:21:38 ET]
Table 'Hunan' 9-max Seat #6 is the button
Seat 1: matiko09 ($51.50 in chips) 
Seat 2: smirnoff993 ($147.50 in chips) 
Seat 3: TheMinion ($59.86 in chips) 
Seat 4: banit7 ($50 in chips) 
Seat 5: Honk115 ($40 in chips) 
Seat 6: i L00K great ($62.16 in chips) 
Seat 7: SForces33 ($17.12 in chips) 
Seat 8: Reven9er ($55.20 in chips) 
Seat 9: Optimistic21 ($58.21 in chips) 
SForces33: posts small blind $0.25
Reven9er: posts big blind $0.50
Honk115: posts big blind $0.50
*** HOLE CARDS ***
Dealt to matiko09 [6d 2s]
Optimistic21 has timed out
Optimistic21: folds 
matiko09: folds 
smirnoff993: raises $1 to $1.50
TheMinion: folds 
banit7: folds 
Honk115: folds 
i L00K great: folds 
SForces33: calls $1.25
Reven9er: folds 
*** FLOP *** [Qs 3s Th]
SForces33: checks 
smirnoff993: bets $2
SForces33: folds 
Uncalled bet ($2) returned to smirnoff993
smirnoff993 collected $3.82 from pot
smirnoff993: doesn't show hand 
*** SUMMARY ***
Total pot $4 | Rake $0.18 
Board [Qs 3s Th]
Seat 1: matiko09 folded before Flop (didn't bet)
Seat 2: smirnoff993 collected ($3.82)
Seat 3: TheMinion folded before Flop (didn't bet)
Seat 4: banit7 folded before Flop (didn't bet)
Seat 5: Honk115 folded before Flop
Seat 6: i L00K great (button) folded before Flop (didn't bet)
Seat 7: SForces33 (small blind) folded on the Flop
Seat 8: Reven9er (big blind) folded before Flop
Seat 9: Optimistic21 folded before Flop (didn't bet)





PokerStars Hand #148607266480:  Hold'em No Limit ($0.25/$0.50 USD) - 2016/02/11 12:21:49 CET [2016/02/11 6:21:49 ET]
Table 'Ambrosia II' 9-max Seat #2 is the button
Seat 1: matiko09 ($50 in chips) 
Seat 2: TheMinion ($115.94 in chips) 
Seat 4: huudk2016 ($19.90 in chips) 
Seat 5: smirnoff993 ($70.75 in chips) 
Seat 6: Reven9er ($50 in chips) 
Seat 7: mexx1234 ($57.37 in chips) 
Seat 8: tallonn88 ($54.06 in chips) 
Seat 9: arctur17 ($54.60 in chips) 
make6a will be allowed to play after the button
huudk2016: posts small blind $0.25
smirnoff993: posts big blind $0.50
*** HOLE CARDS ***
Dealt to matiko09 [8s 8h]
Reven9er: folds 
mexx1234: folds 
tallonn88: folds 
arctur17: folds 
matiko09: raises $1 to $1.50
TheMinion: folds 
huudk2016: folds 
smirnoff993: calls $1
*** FLOP *** [6d Ks 9h]
smirnoff993: checks 
matiko09: checks 
*** TURN *** [6d Ks 9h] [2h]
smirnoff993: bets $1.39
matiko09: calls $1.39
*** RIVER *** [6d Ks 9h 2h] [7c]
smirnoff993: checks 
matiko09: checks 
*** SHOW DOWN ***
smirnoff993: shows [8d Ad] (high card Ace)
matiko09: shows [8s 8h] (a pair of Eights)
matiko09 collected $5.76 from pot
*** SUMMARY ***
Total pot $6.03 | Rake $0.27 
Board [6d Ks 9h 2h 7c]
Seat 1: matiko09 showed [8s 8h] and won ($5.76) with a pair of Eights
Seat 2: TheMinion (button) folded before Flop (didn't bet)
Seat 4: huudk2016 (small blind) folded before Flop
Seat 5: smirnoff993 (big blind) showed [8d Ad] and lost with high card Ace
Seat 6: Reven9er folded before Flop (didn't bet)
Seat 7: mexx1234 folded before Flop (didn't bet)
Seat 8: tallonn88 folded before Flop (didn't bet)
Seat 9: arctur17 folded before Flop (didn't bet)





PokerStars Hand #148607267459:  Hold'em No Limit ($0.50/$1.00 USD) - 2016/02/11 12:21:51 CET [2016/02/11 6:21:51 ET]
Table 'Regor' 9-max Seat #9 is the button
Seat 1: matiko09 ($124.11 in chips) 
Seat 2: Luck In Me ($100 in chips) 
Seat 3: oscarleon ($101.50 in chips) 
Seat 4: Sweden_Pound ($100 in chips) 
Seat 7: Troll8989 ($109.69 in chips) 
Seat 8: R3NZONIT3 ($68.58 in chips) 
Seat 9: CoolFireX ($100 in chips) 
matiko09: posts small blind $0.50
Luck In Me: posts big blind $1
*** HOLE CARDS ***
Dealt to matiko09 [7d 9h]
oscarleon: folds 
Sweden_Pound: folds 
Troll8989 has timed out
Troll8989: folds 
R3NZONIT3: folds 
CoolFireX: raises $1.50 to $2.50
matiko09: folds 
Luck In Me: raises $6 to $8.50
CoolFireX: folds 
Uncalled bet ($6) returned to Luck In Me
Luck In Me collected $5.50 from pot
Luck In Me: doesn't show hand 
*** SUMMARY ***
Total pot $5.50 | Rake $0 
Seat 1: matiko09 (small blind) folded before Flop
Seat 2: Luck In Me (big blind) collected ($5.50)
Seat 3: oscarleon folded before Flop (didn't bet)
Seat 4: Sweden_Pound folded before Flop (didn't bet)
Seat 7: Troll8989 folded before Flop (didn't bet)
Seat 8: R3NZONIT3 folded before Flop (didn't bet)
Seat 9: CoolFireX (button) folded before Flop





PokerStars Hand #148607269429:  Hold'em No Limit ($0.50/$1.00 USD) - 2016/02/11 12:21:54 CET [2016/02/11 6:21:54 ET]
Table 'Sycorax II' 9-max Seat #4 is the button
Seat 1: Luck In Me ($107.26 in chips) 
Seat 2: Lujan87 ($102.23 in chips) 
Seat 3: apfush ($100 in chips) 
Seat 4: Sweden_Pound ($147.94 in chips) 
Seat 5: Effort92 ($100 in chips) 
Seat 8: matiko09 ($117.37 in chips) 
Seat 9: mrfoldcall ($90.50 in chips) 
Effort92: posts small blind $0.50
matiko09: posts big blind $1
*** HOLE CARDS ***
Dealt to matiko09 [Kd Kh]
mrfoldcall: folds 
Luck In Me: raises $2 to $3
Lujan87: folds 
apfush: raises $6 to $9
Sweden_Pound: folds 
Effort92: folds 
matiko09: raises $13 to $22
Luck In Me: folds 
apfush: folds 
Uncalled bet ($13) returned to matiko09
matiko09 collected $21.50 from pot
matiko09: doesn't show hand 
*** SUMMARY ***
Total pot $21.50 | Rake $0 
Seat 1: Luck In Me folded before Flop
Seat 2: Lujan87 folded before Flop (didn't bet)
Seat 3: apfush folded before Flop
Seat 4: Sweden_Pound (button) folded before Flop (didn't bet)
Seat 5: Effort92 (small blind) folded before Flop
Seat 8: matiko09 (big blind) collected ($21.50)
Seat 9: mrfoldcall folded before Flop (didn't bet)





PokerStars Hand #148607269711:  Hold'em No Limit ($0.25/$0.50 USD) - 2016/02/11 12:21:55 CET [2016/02/11 6:21:55 ET]
Table 'Algedi' 9-max Seat #5 is the button
Seat 5: andyjensen14 ($44.53 in chips) 
Seat 6: TonnaMunz ($127.01 in chips) 
Seat 7: hoedtrob ($59.40 in chips) 
Seat 8: matiko09 ($50 in chips) 
Seat 9: Kud3 ($127.22 in chips) 
TonnaMunz: posts small blind $0.25
hoedtrob: posts big blind $0.50
vlad11122007: sits out 
andyjensen14: posts the ante $0.10
TonnaMunz: posts the ante $0.10
hoedtrob: posts the ante $0.10
matiko09: posts the ante $0.10
Kud3: posts the ante $0.10
*** HOLE CARDS ***
Dealt to matiko09 [Js 6c]
matiko09: folds 
Kud3: folds 
andyjensen14: calls $0.50
TonnaMunz: folds 
hoedtrob: checks 
*** FLOP *** [Td 7h 3s]
hoedtrob: checks 
andyjensen14 has timed out
andyjensen14: checks 
*** TURN *** [Td 7h 3s] [Qc]
hoedtrob: bets $1
andyjensen14 has timed out
andyjensen14: folds 
Uncalled bet ($1) returned to hoedtrob
hoedtrob collected $1.67 from pot
hoedtrob: doesn't show hand 
*** SUMMARY ***
Total pot $1.75 | Rake $0.08 
Board [Td 7h 3s Qc]
Seat 5: andyjensen14 (button) folded on the Turn
Seat 6: TonnaMunz (small blind) folded before Flop
Seat 7: hoedtrob (big blind) collected ($1.67)
Seat 8: matiko09 folded before Flop (didn't bet)
Seat 9: Kud3 folded before Flop (didn't bet)





PokerStars Hand #148607270446:  Hold'em No Limit ($0.25/$0.50 USD) - 2016/02/11 12:21:56 CET [2016/02/11 6:21:56 ET]
Table 'Boliviana II' 9-max Seat #2 is the button
Seat 1: Optimistic21 ($60.38 in chips) 
Seat 2: matiko09 ($50 in chips) 
Seat 3: LyDynasty ($48.04 in chips) 
Seat 4: i L00K great ($79.06 in chips) 
Seat 5: make6a ($47.58 in chips) 
Seat 6: corsair888 ($58.31 in chips) 
Seat 7: vlad11122007 ($48.50 in chips) 
Seat 8: TheMinion ($50 in chips) 
Seat 9: PokerSash201 ($47.31 in chips) 
LyDynasty: posts small blind $0.25
i L00K great: posts big blind $0.50
*** HOLE CARDS ***
Dealt to matiko09 [2c 8h]
make6a: raises $1 to $1.50
corsair888: folds 
vlad11122007: folds 
TheMinion: folds 
PokerSash201: folds 
Optimistic21: folds 
matiko09: folds 
LyDynasty: folds 
i L00K great: calls $1
*** FLOP *** [9h As Jc]
i L00K great: checks 
make6a: checks 
*** TURN *** [9h As Jc] [3s]
i L00K great: bets $2.48
make6a: folds 
Uncalled bet ($2.48) returned to i L00K great
i L00K great collected $3.10 from pot
i L00K great: doesn't show hand 
*** SUMMARY ***
Total pot $3.25 | Rake $0.15 
Board [9h As Jc 3s]
Seat 1: Optimistic21 folded before Flop (didn't bet)
Seat 2: matiko09 (button) folded before Flop (didn't bet)
Seat 3: LyDynasty (small blind) folded before Flop
Seat 4: i L00K great (big blind) collected ($3.10)
Seat 5: make6a folded on the Turn
Seat 6: corsair888 folded before Flop (didn't bet)
Seat 7: vlad11122007 folded before Flop (didn't bet)
Seat 8: TheMinion folded before Flop (didn't bet)
Seat 9: PokerSash201 folded before Flop (didn't bet)





PokerStars Hand #148607275215:  Hold'em No Limit ($0.50/$1.00 USD) - 2016/02/11 12:22:05 CET [2016/02/11 6:22:05 ET]
Table 'Isis II' 9-max Seat #1 is the button
Seat 1: CoolFireX ($136.70 in chips) 
Seat 2: matiko09 ($100.50 in chips) 
Seat 3: oscarleon ($101.50 in chips) 
Seat 4: sebaaastian ($100 in chips) 
Seat 5: vezunchik79 ($32.48 in chips) 
Seat 6: kouchan-max ($98.74 in chips) 
Seat 7: PacPacBum ($100 in chips) 
matiko09: posts small blind $0.50
oscarleon: posts big blind $1
Troll8989: sits out 
Sweden_Pound: sits out 
*** HOLE CARDS ***
Dealt to matiko09 [5h 9h]
sebaaastian: folds 
vezunchik79: folds 
kouchan-max: folds 
PacPacBum: folds 
CoolFireX: folds 
Troll8989 leaves the table
matiko09: folds 
Uncalled bet ($0.50) returned to oscarleon
oscarleon collected $1 from pot
oscarleon: doesn't show hand 
*** SUMMARY ***
Total pot $1 | Rake $0 
Seat 1: CoolFireX (button) folded before Flop (didn't bet)
Seat 2: matiko09 (small blind) folded before Flop
Seat 3: oscarleon (big blind) collected ($1)
Seat 4: sebaaastian folded before Flop (didn't bet)
Seat 5: vezunchik79 folded before Flop (didn't bet)
Seat 6: kouchan-max folded before Flop (didn't bet)
Seat 7: PacPacBum folded before Flop (didn't bet)





PokerStars Hand #148607276137:  Hold'em No Limit (€0.25/€0.50 EUR) - 2016/02/11 12:22:07 CET [2016/02/11 6:22:07 ET]
Table 'Otero II' 9-max Seat #8 is the button
Seat 2: 100+x (€39.21 in chips) 
Seat 3: chaogoose82 (€38.95 in chips) 
Seat 6: TonnaMunz (€50 in chips) 
Seat 7: PacPacBum (€50.93 in chips) 
Seat 8: matiko09 (€68.32 in chips) 
Seat 9: Optimistic21 (€59.54 in chips) 
Optimistic21: posts small blind €0.25
100+x: posts big blind €0.50
vlad11122007: sits out 
*** HOLE CARDS ***
Dealt to matiko09 [Qs 2c]
chaogoose82: calls €0.50
TonnaMunz: folds 
PacPacBum: folds 
matiko09: folds 
Nacho2556 joins the table at seat #1 
Optimistic21: folds 
100+x: checks 
*** FLOP *** [9s 7c Kd]
100+x: checks 
chaogoose82: bets €0.59
100+x: calls €0.59
*** TURN *** [9s 7c Kd] [7s]
100+x: checks 
chaogoose82: bets €2.32
100+x: folds 
Uncalled bet (€2.32) returned to chaogoose82
chaogoose82 collected €2.32 from pot
chaogoose82: doesn't show hand 
*** SUMMARY ***
Total pot €2.43 | Rake €0.11 
Board [9s 7c Kd 7s]
Seat 2: 100+x (big blind) folded on the Turn
Seat 3: chaogoose82 collected (€2.32)
Seat 6: TonnaMunz folded before Flop (didn't bet)
Seat 7: PacPacBum folded before Flop (didn't bet)
Seat 8: matiko09 (button) folded before Flop (didn't bet)
Seat 9: Optimistic21 (small blind) folded before Flop





PokerStars Hand #148607280403:  Hold'em No Limit ($0.25/$0.50 USD) - 2016/02/11 12:22:15 CET [2016/02/11 6:22:15 ET]
Table 'Stereoskopia' 9-max Seat #4 is the button
Seat 1: 50CandyJoe ($51.79 in chips) 
Seat 2: Optimistic21 ($50 in chips) 
Seat 3: Donko jr ($56.80 in chips) 
Seat 4: King brid ($34.86 in chips) 
Seat 5: ReinisRNS ($60.93 in chips) 
Seat 6: matiko09 ($50 in chips) 
Seat 7: tallonn88 ($51.25 in chips) 
Seat 8: banit7 ($89.28 in chips) 
Seat 9: anubis4455 ($58.17 in chips) 
ReinisRNS: posts small blind $0.25
matiko09: posts big blind $0.50
*** HOLE CARDS ***
Dealt to matiko09 [6c 7c]
tallonn88: folds 
banit7: folds 
anubis4455: folds 
50CandyJoe: folds 
Optimistic21: folds 
Donko jr: folds 
King brid: folds 
ReinisRNS: folds 
Uncalled bet ($0.25) returned to matiko09
matiko09 collected $0.50 from pot
matiko09: doesn't show hand 
*** SUMMARY ***
Total pot $0.50 | Rake $0 
Seat 1: 50CandyJoe folded before Flop (didn't bet)
Seat 2: Optimistic21 folded before Flop (didn't bet)
Seat 3: Donko jr folded before Flop (didn't bet)
Seat 4: King brid (button) folded before Flop (didn't bet)
Seat 5: ReinisRNS (small blind) folded before Flop
Seat 6: matiko09 (big blind) collected ($0.50)
Seat 7: tallonn88 folded before Flop (didn't bet)
Seat 8: banit7 folded before Flop (didn't bet)
Seat 9: anubis4455 folded before Flop (didn't bet)





PokerStars Hand #148607290732:  Hold'em No Limit ($0.50/$1.00 USD) - 2016/02/11 12:22:35 CET [2016/02/11 6:22:35 ET]
Table 'Isis II' 9-max Seat #2 is the button
Seat 1: CoolFireX ($136.70 in chips) 
Seat 2: matiko09 ($100 in chips) 
Seat 3: oscarleon ($102 in chips) 
Seat 5: vezunchik79 ($32.48 in chips) 
Seat 6: kouchan-max ($98.74 in chips) 
Seat 7: PacPacBum ($100 in chips) 
oscarleon: posts small blind $0.50
sebaaastian: is sitting out 
vezunchik79: posts big blind $1
sebaaastian leaves the table
Sweden_Pound: sits out 
*** HOLE CARDS ***
Dealt to matiko09 [As Tc]
kouchan-max: folds 
PacPacBum: folds 
CoolFireX: folds 
matiko09: raises $1.27 to $2.27
torkkdnm joins the table at seat #8 
oscarleon: folds 
vezunchik79: folds 
Uncalled bet ($1.27) returned to matiko09
matiko09 collected $2.50 from pot
matiko09: doesn't show hand 
*** SUMMARY ***
Total pot $2.50 | Rake $0 
Seat 1: CoolFireX folded before Flop (didn't bet)
Seat 2: matiko09 (button) collected ($2.50)
Seat 3: oscarleon (small blind) folded before Flop
Seat 5: vezunchik79 (big blind) folded before Flop
Seat 6: kouchan-max folded before Flop (didn't bet)
Seat 7: PacPacBum folded before Flop (didn't bet)





PokerStars Hand #148607296957:  Hold'em No Limit ($0.25/$0.50 USD) - 2016/02/11 12:22:46 CET [2016/02/11 6:22:46 ET]
Table 'Stereoskopia' 9-max Seat #5 is the button
Seat 1: 50CandyJoe ($51.79 in chips) 
Seat 2: Optimistic21 ($50 in chips) 
Seat 3: Donko jr ($56.80 in chips) 
Seat 4: King brid ($34.86 in chips) 
Seat 5: ReinisRNS ($60.68 in chips) 
Seat 6: matiko09 ($50.25 in chips) 
Seat 7: tallonn88 ($51.25 in chips) 
Seat 8: banit7 ($89.28 in chips) 
Seat 9: anubis4455 ($58.17 in chips) 
matiko09: posts small blind $0.25
tallonn88: posts big blind $0.50
*** HOLE CARDS ***
Dealt to matiko09 [9d 4h]
banit7: folds 
anubis4455: folds 
50CandyJoe: folds 
Optimistic21: raises $1 to $1.50
Donko jr: folds 
King brid: folds 
ReinisRNS: folds 
matiko09: folds 
tallonn88: folds 
Uncalled bet ($1) returned to Optimistic21
Optimistic21 collected $1.25 from pot
*** SUMMARY ***
Total pot $1.25 | Rake $0 
Seat 1: 50CandyJoe folded before Flop (didn't bet)
Seat 2: Optimistic21 collected ($1.25)
Seat 3: Donko jr folded before Flop (didn't bet)
Seat 4: King brid folded before Flop (didn't bet)
Seat 5: ReinisRNS (button) folded before Flop (didn't bet)
Seat 6: matiko09 (small blind) folded before Flop
Seat 7: tallonn88 (big blind) folded before Flop
Seat 8: banit7 folded before Flop (didn't bet)
Seat 9: anubis4455 folded before Flop (didn't bet)





PokerStars Hand #148607297866:  Hold'em No Limit ($0.50/$1.00 USD) - 2016/02/11 12:22:48 CET [2016/02/11 6:22:48 ET]
Table 'Regor' 9-max Seat #1 is the button
Seat 1: matiko09 ($123.61 in chips) 
Seat 2: Luck In Me ($103 in chips) 
Seat 3: oscarleon ($101.50 in chips) 
Seat 4: Sweden_Pound ($100 in chips) 
Seat 7: Troll8989 ($109.69 in chips) 
Seat 8: R3NZONIT3 ($68.58 in chips) 
Seat 9: CoolFireX ($100 in chips) 
Luck In Me: posts small blind $0.50
oscarleon: posts big blind $1
*** HOLE CARDS ***
Dealt to matiko09 [Qc 7c]
Sweden_Pound: folds 
Sweden_Pound leaves the table
Troll8989: folds 
R3NZONIT3: folds 
CoolFireX: folds 
matiko09: raises $1.27 to $2.27
Luck In Me: folds 
oscarleon: folds 
Uncalled bet ($1.27) returned to matiko09
matiko09 collected $2.50 from pot
matiko09: doesn't show hand 
*** SUMMARY ***
Total pot $2.50 | Rake $0 
Seat 1: matiko09 (button) collected ($2.50)
Seat 2: Luck In Me (small blind) folded before Flop
Seat 3: oscarleon (big blind) folded before Flop
Seat 4: Sweden_Pound folded before Flop (didn't bet)
Seat 7: Troll8989 folded before Flop (didn't bet)
Seat 8: R3NZONIT3 folded before Flop (didn't bet)
Seat 9: CoolFireX folded before Flop (didn't bet)





PokerStars Hand #148607297849:  Hold'em No Limit ($0.25/$0.50 USD) - 2016/02/11 12:22:48 CET [2016/02/11 6:22:48 ET]
Table 'Hunan' 9-max Seat #7 is the button
Seat 1: matiko09 ($51.50 in chips) 
Seat 2: smirnoff993 ($149.82 in chips) 
Seat 3: TheMinion ($59.86 in chips) 
Seat 4: banit7 ($50 in chips) 
Seat 5: Honk115 ($39.50 in chips) 
Seat 6: i L00K great ($62.16 in chips) 
Seat 7: SForces33 ($15.62 in chips) 
Seat 8: Reven9er ($54.70 in chips) 
Seat 9: Optimistic21 ($58.21 in chips) 
Reven9er: posts small blind $0.25
Optimistic21: posts big blind $0.50
*** HOLE CARDS ***
Dealt to matiko09 [2h 9h]
matiko09: folds 
smirnoff993: folds 
TheMinion: folds 
banit7: folds 
Honk115: raises $1 to $1.50
i L00K great: folds 
SForces33: calls $1.50
Reven9er: folds 
Optimistic21: calls $1
*** FLOP *** [Js 3c 8s]
Optimistic21: checks 
Honk115: bets $4.50
SForces33: calls $4.50
Optimistic21: calls $4.50
*** TURN *** [Js 3c 8s] [4c]
Optimistic21: checks 
Honk115: checks 
SForces33: bets $9.62 and is all-in
Optimistic21: folds 
Honk115: folds 
Uncalled bet ($9.62) returned to SForces33
SForces33 collected $17.43 from pot
SForces33: doesn't show hand 
*** SUMMARY ***
Total pot $18.25 | Rake $0.82 
Board [Js 3c 8s 4c]
Seat 1: matiko09 folded before Flop (didn't bet)
Seat 2: smirnoff993 folded before Flop (didn't bet)
Seat 3: TheMinion folded before Flop (didn't bet)
Seat 4: banit7 folded before Flop (didn't bet)
Seat 5: Honk115 folded on the Turn
Seat 6: i L00K great folded before Flop (didn't bet)
Seat 7: SForces33 (button) collected ($17.43)
Seat 8: Reven9er (small blind) folded before Flop
Seat 9: Optimistic21 (big blind) folded on the Turn





PokerStars Hand #148607301021:  Hold'em No Limit ($0.50/$1.00 USD) - 2016/02/11 12:22:54 CET [2016/02/11 6:22:54 ET]
Table 'Sycorax II' 9-max Seat #5 is the button
Seat 1: Luck In Me ($104.26 in chips) 
Seat 2: Lujan87 ($102.23 in chips) 
Seat 3: apfush ($100 in chips) 
Seat 4: Sweden_Pound ($147.94 in chips) 
Seat 5: Effort92 ($100 in chips) 
Seat 8: matiko09 ($129.87 in chips) 
Seat 9: mrfoldcall ($90.50 in chips) 
matiko09: posts small blind $0.50
mrfoldcall: posts big blind $1
*** HOLE CARDS ***
Dealt to matiko09 [2s 8s]
Luck In Me: folds 
Lujan87: folds 
apfush: folds 
Sweden_Pound: folds 
Effort92: folds 
matiko09: folds 
Uncalled bet ($0.50) returned to mrfoldcall
mrfoldcall collected $1 from pot
mrfoldcall: doesn't show hand 
*** SUMMARY ***
Total pot $1 | Rake $0 
Seat 1: Luck In Me folded before Flop (didn't bet)
Seat 2: Lujan87 folded before Flop (didn't bet)
Seat 3: apfush folded before Flop (didn't bet)
Seat 4: Sweden_Pound folded before Flop (didn't bet)
Seat 5: Effort92 (button) folded before Flop (didn't bet)
Seat 8: matiko09 (small blind) folded before Flop
Seat 9: mrfoldcall (big blind) collected ($1)





PokerStars Hand #148607301729:  Hold'em No Limit ($0.25/$0.50 USD) - 2016/02/11 12:22:56 CET [2016/02/11 6:22:56 ET]
Table 'Sylvania II' 9-max Seat #4 is the button
Seat 1: mexx1234 ($191.80 in chips) 
Seat 2: Effort92 ($54.99 in chips) 
Seat 3: ruyingren ($217.12 in chips) 
Seat 4: matiko09 ($119.35 in chips) 
Seat 5: vlad11122007 ($49.46 in chips) 
Seat 6: TonnaMunz ($119.79 in chips) 
Seat 7: i L00K great ($54.48 in chips) 
Seat 8: Optimistic21 ($50 in chips) 
Seat 9: Kud3 ($152.46 in chips) 
vlad11122007: posts small blind $0.25
TonnaMunz: posts big blind $0.50
mexx1234: posts the ante $0.10
Effort92: posts the ante $0.10
ruyingren: posts the ante $0.10
matiko09: posts the ante $0.10
vlad11122007: posts the ante $0.10
TonnaMunz: posts the ante $0.10
i L00K great: posts the ante $0.10
Optimistic21: posts the ante $0.10
Kud3: posts the ante $0.10
*** HOLE CARDS ***
Dealt to matiko09 [7c 9s]
i L00K great: folds 
Optimistic21: folds 
Kud3: folds 
mexx1234: folds 
Effort92: folds 
ruyingren: folds 
matiko09: folds 
vlad11122007: folds 
Uncalled bet ($0.25) returned to TonnaMunz
TonnaMunz collected $1.40 from pot
TonnaMunz: doesn't show hand 
*** SUMMARY ***
Total pot $1.40 | Rake $0 
Seat 1: mexx1234 folded before Flop (didn't bet)
Seat 2: Effort92 folded before Flop (didn't bet)
Seat 3: ruyingren folded before Flop (didn't bet)
Seat 4: matiko09 (button) folded before Flop (didn't bet)
Seat 5: vlad11122007 (small blind) folded before Flop
Seat 6: TonnaMunz (big blind) collected ($1.40)
Seat 7: i L00K great folded before Flop (didn't bet)
Seat 8: Optimistic21 folded before Flop (didn't bet)
Seat 9: Kud3 folded before Flop (didn't bet)





PokerStars Hand #148607304385:  Hold'em No Limit ($0.25/$0.50 USD) - 2016/02/11 12:23:01 CET [2016/02/11 6:23:01 ET]
Table 'Boliviana II' 9-max Seat #3 is the button
Seat 1: Optimistic21 ($60.38 in chips) 
Seat 2: matiko09 ($50 in chips) 
Seat 3: LyDynasty ($47.79 in chips) 
Seat 4: i L00K great ($80.66 in chips) 
Seat 5: make6a ($46.08 in chips) 
Seat 6: corsair888 ($58.31 in chips) 
Seat 7: vlad11122007 ($48.50 in chips) 
Seat 8: TheMinion ($50 in chips) 
Seat 9: PokerSash201 ($47.31 in chips) 
i L00K great: posts small blind $0.25
make6a: posts big blind $0.50
*** HOLE CARDS ***
Dealt to matiko09 [7h 3d]
corsair888: folds 
vlad11122007: folds 
TheMinion: folds 
PokerSash201: folds 
Optimistic21: folds 
matiko09: folds 
LyDynasty: raises $0.50 to $1
i L00K great: raises $3 to $4
make6a: folds 
LyDynasty: calls $3
*** FLOP *** [9s Js Jh]
i L00K great: checks 
LyDynasty: bets $4.06
i L00K great: calls $4.06
*** TURN *** [9s Js Jh] [Jc]
i L00K great: checks 
LyDynasty: bets $15.87
i L00K great: calls $15.87
*** RIVER *** [9s Js Jh Jc] [6s]
i L00K great: checks 
LyDynasty: checks 
*** SHOW DOWN ***
i L00K great: shows [9d Ad] (a full house, Jacks full of Nines)
LyDynasty: shows [Th Ts] (a full house, Jacks full of Tens)
LyDynasty collected $46.18 from pot
*** SUMMARY ***
Total pot $48.36 | Rake $2.18 
Board [9s Js Jh Jc 6s]
Seat 1: Optimistic21 folded before Flop (didn't bet)
Seat 2: matiko09 folded before Flop (didn't bet)
Seat 3: LyDynasty (button) showed [Th Ts] and won ($46.18) with a full house, Jacks full of Tens
Seat 4: i L00K great (small blind) showed [9d Ad] and lost with a full house, Jacks full of Nines
Seat 5: make6a (big blind) folded before Flop
Seat 6: corsair888 folded before Flop (didn't bet)
Seat 7: vlad11122007 folded before Flop (didn't bet)
Seat 8: TheMinion folded before Flop (didn't bet)
Seat 9: PokerSash201 folded before Flop (didn't bet)





PokerStars Hand #148607305394:  Hold'em No Limit (€0.25/€0.50 EUR) - 2016/02/11 12:23:03 CET [2016/02/11 6:23:03 ET]
Table 'Otero II' 9-max Seat #9 is the button
Seat 2: 100+x (€38.12 in chips) 
Seat 3: chaogoose82 (€40.18 in chips) 
Seat 6: TonnaMunz (€50 in chips) 
Seat 7: PacPacBum (€50.93 in chips) 
Seat 8: matiko09 (€68.32 in chips) 
Seat 9: Optimistic21 (€59.29 in chips) 
Nacho2556 will be allowed to play after the button
100+x: posts small blind €0.25
chaogoose82: posts big blind €0.50
vlad11122007: sits out 
*** HOLE CARDS ***
Dealt to matiko09 [Kd 8h]
TonnaMunz: folds 
PacPacBum: folds 
matiko09: folds 
Optimistic21: folds 
100+x: folds 
Uncalled bet (€0.25) returned to chaogoose82
chaogoose82 collected €0.50 from pot
chaogoose82: doesn't show hand 
*** SUMMARY ***
Total pot €0.50 | Rake €0 
Seat 2: 100+x (small blind) folded before Flop
Seat 3: chaogoose82 (big blind) collected (€0.50)
Seat 6: TonnaMunz folded before Flop (didn't bet)
Seat 7: PacPacBum folded before Flop (didn't bet)
Seat 8: matiko09 folded before Flop (didn't bet)
Seat 9: Optimistic21 (button) folded before Flop (didn't bet)





PokerStars Hand #148607307731:  Hold'em No Limit ($0.50/$1.00 USD) - 2016/02/11 12:23:07 CET [2016/02/11 6:23:07 ET]
Table 'Isis II' 9-max Seat #3 is the button
Seat 1: CoolFireX ($136.70 in chips) 
Seat 2: matiko09 ($101.50 in chips) 
Seat 3: oscarleon ($101.50 in chips) 
Seat 5: vezunchik79 ($31.48 in chips) 
Seat 6: kouchan-max ($98.74 in chips) 
Seat 7: PacPacBum ($100 in chips) 
vezunchik79: posts small blind $0.50
kouchan-max: posts big blind $1
torkkdnm: sits out 
Sweden_Pound: sits out 
*** HOLE CARDS ***
Dealt to matiko09 [7c Jh]
PacPacBum: folds 
CoolFireX: folds 
matiko09: folds 
oscarleon: folds 
vezunchik79: folds 
Uncalled bet ($0.50) returned to kouchan-max
kouchan-max collected $1 from pot
kouchan-max: doesn't show hand 
*** SUMMARY ***
Total pot $1 | Rake $0 
Seat 1: CoolFireX folded before Flop (didn't bet)
Seat 2: matiko09 folded before Flop (didn't bet)
Seat 3: oscarleon (button) folded before Flop (didn't bet)
Seat 5: vezunchik79 (small blind) folded before Flop
Seat 6: kouchan-max (big blind) collected ($1)
Seat 7: PacPacBum folded before Flop (didn't bet)





PokerStars Hand #148607309266:  Hold'em No Limit ($0.25/$0.50 USD) - 2016/02/11 12:23:10 CET [2016/02/11 6:23:10 ET]
Table 'Ambrosia II' 9-max Seat #4 is the button
Seat 1: matiko09 ($52.87 in chips) 
Seat 2: TheMinion ($115.94 in chips) 
Seat 4: huudk2016 ($19.65 in chips) 
Seat 5: smirnoff993 ($67.86 in chips) 
Seat 6: Reven9er ($50 in chips) 
Seat 7: mexx1234 ($57.37 in chips) 
Seat 8: tallonn88 ($54.06 in chips) 
Seat 9: arctur17 ($54.60 in chips) 
smirnoff993: posts small blind $0.25
Reven9er: posts big blind $0.50
make6a: sits out 
*** HOLE CARDS ***
Dealt to matiko09 [3d 5d]
mexx1234: folds 
tallonn88: folds 
arctur17: folds 
matiko09: folds 
TheMinion: folds 
huudk2016: folds 
smirnoff993: folds 
Uncalled bet ($0.25) returned to Reven9er
Reven9er collected $0.50 from pot
Reven9er: doesn't show hand 
*** SUMMARY ***
Total pot $0.50 | Rake $0 
Seat 1: matiko09 folded before Flop (didn't bet)
Seat 2: TheMinion folded before Flop (didn't bet)
Seat 4: huudk2016 (button) folded before Flop (didn't bet)
Seat 5: smirnoff993 (small blind) folded before Flop
Seat 6: Reven9er (big blind) collected ($0.50)
Seat 7: mexx1234 folded before Flop (didn't bet)
Seat 8: tallonn88 folded before Flop (didn't bet)
Seat 9: arctur17 folded before Flop (didn't bet)





PokerStars Hand #148607311225:  Hold'em No Limit ($0.25/$0.50 USD) - 2016/02/11 12:23:14 CET [2016/02/11 6:23:14 ET]
Table 'Stereoskopia' 9-max Seat #6 is the button
Seat 1: 50CandyJoe ($51.79 in chips) 
Seat 2: Optimistic21 ($50.75 in chips) 
Seat 3: Donko jr ($56.80 in chips) 
Seat 4: King brid ($34.86 in chips) 
Seat 5: ReinisRNS ($60.68 in chips) 
Seat 6: matiko09 ($50 in chips) 
Seat 7: tallonn88 ($50.75 in chips) 
Seat 8: banit7 ($89.28 in chips) 
Seat 9: anubis4455 ($58.17 in chips) 
tallonn88: posts small blind $0.25
banit7: posts big blind $0.50
*** HOLE CARDS ***
Dealt to matiko09 [7c Jd]
anubis4455: calls $0.50
50CandyJoe: raises $1.50 to $2
Optimistic21: folds 
Donko jr: folds 
King brid: folds 
ReinisRNS: folds 
matiko09: folds 
tallonn88: folds 
banit7: folds 
anubis4455: calls $1.50
*** FLOP *** [Js 6h 6d]
anubis4455: checks 
50CandyJoe: bets $2.50
anubis4455: folds 
Uncalled bet ($2.50) returned to 50CandyJoe
50CandyJoe collected $4.54 from pot
50CandyJoe: doesn't show hand 
*** SUMMARY ***
Total pot $4.75 | Rake $0.21 
Board [Js 6h 6d]
Seat 1: 50CandyJoe collected ($4.54)
Seat 2: Optimistic21 folded before Flop (didn't bet)
Seat 3: Donko jr folded before Flop (didn't bet)
Seat 4: King brid folded before Flop (didn't bet)
Seat 5: ReinisRNS folded before Flop (didn't bet)
Seat 6: matiko09 (button) folded before Flop (didn't bet)
Seat 7: tallonn88 (small blind) folded before Flop
Seat 8: banit7 (big blind) folded before Flop
Seat 9: anubis4455 folded on the Flop





PokerStars Hand #148607313364:  Hold'em No Limit ($0.25/$0.50 USD) - 2016/02/11 12:23:18 CET [2016/02/11 6:23:18 ET]
Table 'Sylvania II' 9-max Seat #5 is the button
Seat 1: mexx1234 ($191.70 in chips) 
Seat 2: Effort92 ($54.89 in chips) 
Seat 3: ruyingren ($217.02 in chips) 
Seat 4: matiko09 ($119.25 in chips) 
Seat 5: vlad11122007 ($49.11 in chips) 
Seat 6: TonnaMunz ($120.84 in chips) 
Seat 7: i L00K great ($54.38 in chips) 
Seat 8: Optimistic21 ($50 in chips) 
Seat 9: Kud3 ($152.36 in chips) 
TonnaMunz: posts small blind $0.25
i L00K great: posts big blind $0.50
mexx1234: posts the ante $0.10
Effort92: posts the ante $0.10
ruyingren: posts the ante $0.10
matiko09: posts the ante $0.10
vlad11122007: posts the ante $0.10
TonnaMunz: posts the ante $0.10
i L00K great: posts the ante $0.10
Optimistic21: posts the ante $0.10
Kud3: posts the ante $0.10
*** HOLE CARDS ***
Dealt to matiko09 [2s Qs]
Optimistic21: folds 
Kud3: folds 
mexx1234: folds 
Effort92: folds 
ruyingren: folds 
matiko09: folds 
vlad11122007: raises $0.60 to $1.10
TonnaMunz: raises $3.40 to $4.50
i L00K great: folds 
vlad11122007: folds 
Uncalled bet ($3.40) returned to TonnaMunz
TonnaMunz collected $3.60 from pot
TonnaMunz: doesn't show hand 
*** SUMMARY ***
Total pot $3.60 | Rake $0 
Seat 1: mexx1234 folded before Flop (didn't bet)
Seat 2: Effort92 folded before Flop (didn't bet)
Seat 3: ruyingren folded before Flop (didn't bet)
Seat 4: matiko09 folded before Flop (didn't bet)
Seat 5: vlad11122007 (button) folded before Flop
Seat 6: TonnaMunz (small blind) collected ($3.60)
Seat 7: i L00K great (big blind) folded before Flop
Seat 8: Optimistic21 folded before Flop (didn't bet)
Seat 9: Kud3 folded before Flop (didn't bet)





PokerStars Hand #148607315863:  Hold'em No Limit (€0.25/€0.50 EUR) - 2016/02/11 12:23:23 CET [2016/02/11 6:23:23 ET]
Table 'Otero II' 9-max Seat #2 is the button
Seat 2: 100+x (€37.87 in chips) 
Seat 3: chaogoose82 (€40.43 in chips) 
Seat 5: vlad11122007 (€50 in chips) 
Seat 6: TonnaMunz (€50 in chips) 
Seat 7: PacPacBum (€50.93 in chips) 
Seat 8: matiko09 (€68.32 in chips) 
Seat 9: Optimistic21 (€59.29 in chips) 
chaogoose82: posts small blind €0.25
vlad11122007: posts big blind €0.50
Nacho2556: sits out 
*** HOLE CARDS ***
Dealt to matiko09 [5h 9c]
TonnaMunz: folds 
PacPacBum: folds 
matiko09: folds 
Optimistic21: raises €1 to €1.50
100+x: folds 
chaogoose82: folds 
alfonso733 joins the table at seat #4 
vlad11122007: folds 
Uncalled bet (€1) returned to Optimistic21
Optimistic21 collected €1.25 from pot
*** SUMMARY ***
Total pot €1.25 | Rake €0 
Seat 2: 100+x (button) folded before Flop (didn't bet)
Seat 3: chaogoose82 (small blind) folded before Flop
Seat 5: vlad11122007 (big blind) folded before Flop
Seat 6: TonnaMunz folded before Flop (didn't bet)
Seat 7: PacPacBum folded before Flop (didn't bet)
Seat 8: matiko09 folded before Flop (didn't bet)
Seat 9: Optimistic21 collected (€1.25)





PokerStars Hand #148607316494:  Hold'em No Limit ($0.50/$1.00 USD) - 2016/02/11 12:23:24 CET [2016/02/11 6:23:24 ET]
Table 'Sycorax II' 9-max Seat #8 is the button
Seat 1: Luck In Me ($104.26 in chips) 
Seat 2: Lujan87 ($102.23 in chips) 
Seat 3: apfush ($100 in chips) 
Seat 4: Sweden_Pound ($147.94 in chips) 
Seat 5: Effort92 ($100 in chips) 
Seat 8: matiko09 ($129.37 in chips) 
Seat 9: mrfoldcall ($91 in chips) 
mrfoldcall: posts small blind $0.50
Luck In Me: posts big blind $1
*** HOLE CARDS ***
Dealt to matiko09 [Qh Kd]
Lujan87: raises $2 to $3
apfush: folds 
Sweden_Pound: folds 
Effort92: folds 
matiko09: folds 
mrfoldcall: folds 
Luck In Me: raises $7 to $10
Lujan87: folds 
Uncalled bet ($7) returned to Luck In Me
Luck In Me collected $6.50 from pot
Luck In Me: doesn't show hand 
*** SUMMARY ***
Total pot $6.50 | Rake $0 
Seat 1: Luck In Me (big blind) collected ($6.50)
Seat 2: Lujan87 folded before Flop
Seat 3: apfush folded before Flop (didn't bet)
Seat 4: Sweden_Pound folded before Flop (didn't bet)
Seat 5: Effort92 folded before Flop (didn't bet)
Seat 8: matiko09 (button) folded before Flop (didn't bet)
Seat 9: mrfoldcall (small blind) folded before Flop





PokerStars Hand #148607317034:  Hold'em No Limit ($0.50/$1.00 USD) - 2016/02/11 12:23:25 CET [2016/02/11 6:23:25 ET]
Table 'Regor' 9-max Seat #2 is the button
Seat 1: matiko09 ($125.11 in chips) 
Seat 2: Luck In Me ($102.50 in chips) 
Seat 3: oscarleon ($100.50 in chips) 
Seat 8: R3NZONIT3 ($68.58 in chips) 
Seat 9: CoolFireX ($100 in chips) 
oscarleon: posts small blind $0.50
Troll8989: is sitting out 
Troll8989 leaves the table
R3NZONIT3: posts big blind $1
*** HOLE CARDS ***
Dealt to matiko09 [2d Qh]
CoolFireX: raises $2 to $3
matiko09: folds 
Luck In Me: folds 
oscarleon: folds 
R3NZONIT3: folds 
Uncalled bet ($2) returned to CoolFireX
CoolFireX collected $2.50 from pot
CoolFireX: doesn't show hand 
*** SUMMARY ***
Total pot $2.50 | Rake $0 
Seat 1: matiko09 folded before Flop (didn't bet)
Seat 2: Luck In Me (button) folded before Flop (didn't bet)
Seat 3: oscarleon (small blind) folded before Flop
Seat 8: R3NZONIT3 (big blind) folded before Flop
Seat 9: CoolFireX collected ($2.50)





PokerStars Hand #148607318990:  Hold'em No Limit ($0.50/$1.00 USD) - 2016/02/11 12:23:29 CET [2016/02/11 6:23:29 ET]
Table 'Isis II' 9-max Seat #5 is the button
Seat 1: CoolFireX ($136.70 in chips) 
Seat 2: matiko09 ($101.50 in chips) 
Seat 3: oscarleon ($101.50 in chips) 
Seat 5: vezunchik79 ($30.98 in chips) 
Seat 6: kouchan-max ($99.24 in chips) 
Seat 7: PacPacBum ($100 in chips) 
kouchan-max: posts small blind $0.50
PacPacBum: posts big blind $1
torkkdnm: sits out 
Sweden_Pound: sits out 
*** HOLE CARDS ***
Dealt to matiko09 [5d Ad]
CoolFireX: folds 
hurtNCYDE joins the table at seat #4 
matiko09: raises $2 to $3
hurtNCYDE leaves the table
Filojoes joins the table at seat #4 
oscarleon: folds 
vezunchik79: folds 
kouchan-max: folds 
PacPacBum: folds 
Uncalled bet ($2) returned to matiko09
matiko09 collected $2.50 from pot
matiko09: doesn't show hand 
*** SUMMARY ***
Total pot $2.50 | Rake $0 
Seat 1: CoolFireX folded before Flop (didn't bet)
Seat 2: matiko09 collected ($2.50)
Seat 3: oscarleon folded before Flop (didn't bet)
Seat 5: vezunchik79 (button) folded before Flop (didn't bet)
Seat 6: kouchan-max (small blind) folded before Flop
Seat 7: PacPacBum (big blind) folded before Flop





PokerStars Hand #148607323950:  Hold'em No Limit ($0.25/$0.50 USD) - 2016/02/11 12:23:38 CET [2016/02/11 6:23:38 ET]
Table 'Ambrosia II' 9-max Seat #5 is the button
Seat 1: matiko09 ($52.87 in chips) 
Seat 2: TheMinion ($115.94 in chips) 
Seat 4: huudk2016 ($19.65 in chips) 
Seat 5: smirnoff993 ($67.61 in chips) 
Seat 6: Reven9er ($50.25 in chips) 
Seat 7: mexx1234 ($57.37 in chips) 
Seat 8: tallonn88 ($54.06 in chips) 
Seat 9: arctur17 ($54.60 in chips) 
Reven9er: posts small blind $0.25
mexx1234: posts big blind $0.50
make6a: sits out 
*** HOLE CARDS ***
Dealt to matiko09 [3s Js]
tallonn88: folds 
arctur17: calls $0.50
matiko09: folds 
TheMinion: folds 
huudk2016: folds 
smirnoff993: folds 
Reven9er: folds 
mexx1234: checks 
*** FLOP *** [6d Ts 2s]
mexx1234: checks 
arctur17: bets $1
mexx1234: folds 
Uncalled bet ($1) returned to arctur17
arctur17 collected $1.19 from pot
arctur17: doesn't show hand 
*** SUMMARY ***
Total pot $1.25 | Rake $0.06 
Board [6d Ts 2s]
Seat 1: matiko09 folded before Flop (didn't bet)
Seat 2: TheMinion folded before Flop (didn't bet)
Seat 4: huudk2016 folded before Flop (didn't bet)
Seat 5: smirnoff993 (button) folded before Flop (didn't bet)
Seat 6: Reven9er (small blind) folded before Flop
Seat 7: mexx1234 (big blind) folded on the Flop
Seat 8: tallonn88 folded before Flop (didn't bet)
Seat 9: arctur17 collected ($1.19)





PokerStars Hand #148607326336:  Hold'em No Limit ($0.25/$0.50 USD) - 2016/02/11 12:23:42 CET [2016/02/11 6:23:42 ET]
Table 'Algedi' 9-max Seat #6 is the button
Seat 6: TonnaMunz ($126.66 in chips) 
Seat 7: hoedtrob ($60.47 in chips) 
Seat 8: matiko09 ($50 in chips) 
hoedtrob: posts small blind $0.25
matiko09: posts big blind $0.50
vlad11122007: sits out 
TonnaMunz: posts the ante $0.10
hoedtrob: posts the ante $0.10
matiko09: posts the ante $0.10
*** HOLE CARDS ***
Dealt to matiko09 [Qd 5h]
TonnaMunz: raises $0.68 to $1.18
hoedtrob: folds 
matiko09: folds 
Uncalled bet ($0.68) returned to TonnaMunz
TuaaL joins the table at seat #2 
TonnaMunz collected $1.55 from pot
*** SUMMARY ***
Total pot $1.55 | Rake $0 
Seat 6: TonnaMunz (button) collected ($1.55)
Seat 7: hoedtrob (small blind) folded before Flop
Seat 8: matiko09 (big blind) folded before Flop





PokerStars Hand #148607328716:  Hold'em No Limit ($0.50/$1.00 USD) - 2016/02/11 12:23:47 CET [2016/02/11 6:23:47 ET]
Table 'Isis II' 9-max Seat #6 is the button
Seat 1: CoolFireX ($136.70 in chips) 
Seat 2: matiko09 ($103 in chips) 
Seat 3: oscarleon ($101.50 in chips) 
Seat 5: vezunchik79 ($30.98 in chips) 
Seat 6: kouchan-max ($98.74 in chips) 
Seat 7: PacPacBum ($100 in chips) 
Seat 8: torkkdnm ($100 in chips) 
PacPacBum: posts small blind $0.50
torkkdnm: posts big blind $1
Sweden_Pound: sits out 
Filojoes: sits out 
*** HOLE CARDS ***
Dealt to matiko09 [9h As]
CoolFireX: folds 
matiko09: folds 
oscarleon: folds 
vezunchik79: raises $2 to $3
kouchan-max: folds 
PacPacBum: folds 
torkkdnm: folds 
Uncalled bet ($2) returned to vezunchik79
vezunchik79 collected $2.50 from pot
*** SUMMARY ***
Total pot $2.50 | Rake $0 
Seat 1: CoolFireX folded before Flop (didn't bet)
Seat 2: matiko09 folded before Flop (didn't bet)
Seat 3: oscarleon folded before Flop (didn't bet)
Seat 5: vezunchik79 collected ($2.50)
Seat 6: kouchan-max (button) folded before Flop (didn't bet)
Seat 7: PacPacBum (small blind) folded before Flop
Seat 8: torkkdnm (big blind) folded before Flop





PokerStars Hand #148607328946:  Hold'em No Limit ($0.50/$1.00 USD) - 2016/02/11 12:23:47 CET [2016/02/11 6:23:47 ET]
Table 'Regor' 9-max Seat #3 is the button
Seat 1: matiko09 ($125.11 in chips) 
Seat 2: Luck In Me ($102.50 in chips) 
Seat 3: oscarleon ($100 in chips) 
Seat 8: R3NZONIT3 ($67.58 in chips) 
Seat 9: CoolFireX ($101.50 in chips) 
R3NZONIT3: posts small blind $0.50
CoolFireX: posts big blind $1
*** HOLE CARDS ***
Dealt to matiko09 [8h 2s]
matiko09: folds 
Luck In Me: raises $2 to $3
oscarleon: folds 
R3NZONIT3: folds 
CoolFireX: folds 
Uncalled bet ($2) returned to Luck In Me
Luck In Me collected $2.50 from pot
Luck In Me: doesn't show hand 
*** SUMMARY ***
Total pot $2.50 | Rake $0 
Seat 1: matiko09 folded before Flop (didn't bet)
Seat 2: Luck In Me collected ($2.50)
Seat 3: oscarleon (button) folded before Flop (didn't bet)
Seat 8: R3NZONIT3 (small blind) folded before Flop
Seat 9: CoolFireX (big blind) folded before Flop





PokerStars Hand #148607330817:  Hold'em No Limit ($0.25/$0.50 USD) - 2016/02/11 12:23:51 CET [2016/02/11 6:23:51 ET]
Table 'Sylvania II' 9-max Seat #6 is the button
Seat 1: mexx1234 ($191.60 in chips) 
Seat 2: Effort92 ($54.79 in chips) 
Seat 3: ruyingren ($216.92 in chips) 
Seat 4: matiko09 ($119.15 in chips) 
Seat 5: vlad11122007 ($47.91 in chips) 
Seat 6: TonnaMunz ($123.24 in chips) 
Seat 7: i L00K great ($53.78 in chips) 
Seat 8: Optimistic21 ($50 in chips) 
i L00K great: posts small blind $0.25
Optimistic21: posts big blind $0.50
mexx1234: posts the ante $0.10
Effort92: posts the ante $0.10
ruyingren: posts the ante $0.10
matiko09: posts the ante $0.10
vlad11122007: posts the ante $0.10
TonnaMunz: posts the ante $0.10
i L00K great: posts the ante $0.10
Optimistic21: posts the ante $0.10
*** HOLE CARDS ***
Dealt to matiko09 [4c Ad]
mexx1234: raises $0.75 to $1.25
Effort92: folds 
ruyingren: folds 
matiko09: folds 
vlad11122007: folds 
TonnaMunz: folds 
i L00K great: folds 
Optimistic21: folds 
Uncalled bet ($0.75) returned to mexx1234
mexx1234 collected $2.05 from pot
mexx1234: doesn't show hand 
*** SUMMARY ***
Total pot $2.05 | Rake $0 
Seat 1: mexx1234 collected ($2.05)
Seat 2: Effort92 folded before Flop (didn't bet)
Seat 3: ruyingren folded before Flop (didn't bet)
Seat 4: matiko09 folded before Flop (didn't bet)
Seat 5: vlad11122007 folded before Flop (didn't bet)
Seat 6: TonnaMunz (button) folded before Flop (didn't bet)
Seat 7: i L00K great (small blind) folded before Flop
Seat 8: Optimistic21 (big blind) folded before Flop





PokerStars Hand #148607331323:  Hold'em No Limit (€0.25/€0.50 EUR) - 2016/02/11 12:23:52 CET [2016/02/11 6:23:52 ET]
Table 'Otero II' 9-max Seat #3 is the button
Seat 2: 100+x (€37.87 in chips) 
Seat 3: chaogoose82 (€40.18 in chips) 
Seat 5: vlad11122007 (€49.50 in chips) 
Seat 6: TonnaMunz (€50 in chips) 
Seat 7: PacPacBum (€50.93 in chips) 
Seat 8: matiko09 (€68.32 in chips) 
Seat 9: Optimistic21 (€60.04 in chips) 
alfonso733 will be allowed to play after the button
vlad11122007: posts small blind €0.25
TonnaMunz: posts big blind €0.50
Nacho2556: sits out 
*** HOLE CARDS ***
Dealt to matiko09 [7c Jd]
PacPacBum: folds 
matiko09: folds 
Optimistic21: folds 
100+x: folds 
chaogoose82: folds 
vlad11122007: folds 
Uncalled bet (€0.25) returned to TonnaMunz
TonnaMunz collected €0.50 from pot
TonnaMunz: doesn't show hand 
*** SUMMARY ***
Total pot €0.50 | Rake €0 
Seat 2: 100+x folded before Flop (didn't bet)
Seat 3: chaogoose82 (button) folded before Flop (didn't bet)
Seat 5: vlad11122007 (small blind) folded before Flop
Seat 6: TonnaMunz (big blind) collected (€0.50)
Seat 7: PacPacBum folded before Flop (didn't bet)
Seat 8: matiko09 folded before Flop (didn't bet)
Seat 9: Optimistic21 folded before Flop (didn't bet)





PokerStars Hand #148607335486:  Hold'em No Limit ($0.25/$0.50 USD) - 2016/02/11 12:24:00 CET [2016/02/11 6:24:00 ET]
Table 'Stereoskopia' 9-max Seat #7 is the button
Seat 1: 50CandyJoe ($54.33 in chips) 
Seat 2: Optimistic21 ($50.75 in chips) 
Seat 3: Donko jr ($56.80 in chips) 
Seat 4: King brid ($34.86 in chips) 
Seat 5: ReinisRNS ($60.68 in chips) 
Seat 6: matiko09 ($50 in chips) 
Seat 7: tallonn88 ($50.50 in chips) 
Seat 8: banit7 ($88.78 in chips) 
Seat 9: anubis4455 ($56.17 in chips) 
banit7: posts small blind $0.25
anubis4455: posts big blind $0.50
*** HOLE CARDS ***
Dealt to matiko09 [3h 8c]
50CandyJoe: folds 
Optimistic21: folds 
Donko jr: raises $0.50 to $1
King brid: folds 
ReinisRNS: folds 
matiko09: folds 
tallonn88: folds 
banit7: folds 
anubis4455: calls $0.50
*** FLOP *** [2h 8s 4h]
anubis4455: bets $2
Donko jr: calls $2
*** TURN *** [2h 8s 4h] [7h]
anubis4455: checks 
Donko jr: bets $3
anubis4455: calls $3
*** RIVER *** [2h 8s 4h 7h] [Ts]
anubis4455: checks 
Donko jr: bets $7.50
anubis4455: calls $7.50
*** SHOW DOWN ***
Donko jr: shows [6h 5h] (a flush, Seven high)
anubis4455: mucks hand 
Donko jr collected $26.02 from pot
*** SUMMARY ***
Total pot $27.25 | Rake $1.23 
Board [2h 8s 4h 7h Ts]
Seat 1: 50CandyJoe folded before Flop (didn't bet)
Seat 2: Optimistic21 folded before Flop (didn't bet)
Seat 3: Donko jr showed [6h 5h] and won ($26.02) with a flush, Seven high
Seat 4: King brid folded before Flop (didn't bet)
Seat 5: ReinisRNS folded before Flop (didn't bet)
Seat 6: matiko09 folded before Flop (didn't bet)
Seat 7: tallonn88 (button) folded before Flop (didn't bet)
Seat 8: banit7 (small blind) folded before Flop
Seat 9: anubis4455 (big blind) mucked [Td 9d]





PokerStars Hand #148607336353:  Hold'em No Limit ($0.25/$0.50 USD) - 2016/02/11 12:24:01 CET [2016/02/11 6:24:01 ET]
Table 'Algedi' 9-max Seat #7 is the button
Seat 1: vlad11122007 ($50 in chips) 
Seat 6: TonnaMunz ($127.61 in chips) 
Seat 7: hoedtrob ($60.12 in chips) 
Seat 8: matiko09 ($50 in chips) 
matiko09: posts small blind $0.25
vlad11122007: posts big blind $0.50
TuaaL: sits out 
vlad11122007: posts the ante $0.10
TonnaMunz: posts the ante $0.10
hoedtrob: posts the ante $0.10
matiko09: posts the ante $0.10
*** HOLE CARDS ***
Dealt to matiko09 [Tc 5h]
Effort92 joins the table at seat #4 
TonnaMunz: folds 
hoedtrob: raises $1 to $1.50
matiko09: folds 
vlad11122007: folds 
Uncalled bet ($1) returned to hoedtrob
hoedtrob collected $1.65 from pot
hoedtrob: doesn't show hand 
*** SUMMARY ***
Total pot $1.65 | Rake $0 
Seat 1: vlad11122007 (big blind) folded before Flop
Seat 6: TonnaMunz folded before Flop (didn't bet)
Seat 7: hoedtrob (button) collected ($1.65)
Seat 8: matiko09 (small blind) folded before Flop





PokerStars Hand #148607337359:  Hold'em No Limit ($0.50/$1.00 USD) - 2016/02/11 12:24:03 CET [2016/02/11 6:24:03 ET]
Table 'Sycorax II' 9-max Seat #9 is the button
Seat 1: Luck In Me ($107.76 in chips) 
Seat 2: Lujan87 ($100 in chips) 
Seat 3: apfush ($100 in chips) 
Seat 4: Sweden_Pound ($147.94 in chips) 
Seat 5: Effort92 ($100 in chips) 
Seat 8: matiko09 ($129.37 in chips) 
Seat 9: mrfoldcall ($90.50 in chips) 
Luck In Me: posts small blind $0.50
Lujan87: posts big blind $1
*** HOLE CARDS ***
Dealt to matiko09 [4s 7d]
apfush: folds 
Sweden_Pound: raises $2 to $3
Effort92: folds 
matiko09: folds 
mrfoldcall: folds 
Luck In Me: folds 
Lujan87: calls $2
*** FLOP *** [Kh 2s 2d]
Lujan87: checks 
FluentFlows joins the table at seat #6 
Sweden_Pound: checks 
*** TURN *** [Kh 2s 2d] [Ac]
djammusic joins the table at seat #7 
djammusic leaves the table
Lujan87: checks 
Sweden_Pound: checks 
*** RIVER *** [Kh 2s 2d Ac] [3h]
Lujan87: checks 
Sweden_Pound: checks 
*** SHOW DOWN ***
Lujan87: shows [9s 9d] (two pair, Nines and Deuces)
Sweden_Pound: mucks hand 
Lujan87 collected $6.21 from pot
*** SUMMARY ***
Total pot $6.50 | Rake $0.29 
Board [Kh 2s 2d Ac 3h]
Seat 1: Luck In Me (small blind) folded before Flop
Seat 2: Lujan87 (big blind) showed [9s 9d] and won ($6.21) with two pair, Nines and Deuces
Seat 3: apfush folded before Flop (didn't bet)
Seat 4: Sweden_Pound mucked [7c 7s]
Seat 5: Effort92 folded before Flop (didn't bet)
Seat 8: matiko09 folded before Flop (didn't bet)
Seat 9: mrfoldcall (button) folded before Flop (didn't bet)





PokerStars Hand #148607337594:  Hold'em No Limit ($0.50/$1.00 USD) - 2016/02/11 12:24:03 CET [2016/02/11 6:24:03 ET]
Table 'Isis II' 9-max Seat #7 is the button
Seat 1: CoolFireX ($136.70 in chips) 
Seat 2: matiko09 ($103 in chips) 
Seat 3: oscarleon ($101.50 in chips) 
Seat 5: vezunchik79 ($32.48 in chips) 
Seat 6: kouchan-max ($98.74 in chips) 
Seat 7: PacPacBum ($100 in chips) 
Seat 8: torkkdnm ($100 in chips) 
Seat 9: Sweden_Pound ($100 in chips) 
torkkdnm: posts small blind $0.50
Sweden_Pound: posts big blind $1
Filojoes: sits out 
*** HOLE CARDS ***
Dealt to matiko09 [9d Jc]
CoolFireX: folds 
matiko09: folds 
oscarleon: folds 
vezunchik79: folds 
kouchan-max: folds 
PacPacBum: raises $1.04 to $2.04
torkkdnm: folds 
Sweden_Pound: raises $5.96 to $8
PacPacBum: folds 
Uncalled bet ($5.96) returned to Sweden_Pound
Sweden_Pound collected $4.58 from pot
Sweden_Pound: doesn't show hand 
*** SUMMARY ***
Total pot $4.58 | Rake $0 
Seat 1: CoolFireX folded before Flop (didn't bet)
Seat 2: matiko09 folded before Flop (didn't bet)
Seat 3: oscarleon folded before Flop (didn't bet)
Seat 5: vezunchik79 folded before Flop (didn't bet)
Seat 6: kouchan-max folded before Flop (didn't bet)
Seat 7: PacPacBum (button) folded before Flop
Seat 8: torkkdnm (small blind) folded before Flop
Seat 9: Sweden_Pound (big blind) collected ($4.58)





PokerStars Hand #148607340013:  Hold'em No Limit ($0.25/$0.50 USD) - 2016/02/11 12:24:08 CET [2016/02/11 6:24:08 ET]
Table 'Boliviana II' 9-max Seat #4 is the button
Seat 1: Optimistic21 ($60.38 in chips) 
Seat 2: matiko09 ($50 in chips) 
Seat 3: LyDynasty ($70.04 in chips) 
Seat 4: i L00K great ($56.73 in chips) 
Seat 5: make6a ($45.58 in chips) 
Seat 6: corsair888 ($58.31 in chips) 
Seat 7: vlad11122007 ($48.50 in chips) 
Seat 8: TheMinion ($50 in chips) 
Seat 9: PokerSash201 ($47.31 in chips) 
make6a: posts small blind $0.25
corsair888: posts big blind $0.50
*** HOLE CARDS ***
Dealt to matiko09 [5c 4s]
vlad11122007: folds 
TheMinion: folds 
PokerSash201: folds 
Optimistic21: folds 
matiko09: folds 
LyDynasty: calls $0.50
i L00K great: raises $1.25 to $1.75
make6a: folds 
corsair888: folds 
LyDynasty: calls $1.25
*** FLOP *** [Jc Jd As]
LyDynasty: checks 
i L00K great: bets $1.42
LyDynasty: calls $1.42
*** TURN *** [Jc Jd As] [8c]
LyDynasty: checks 
i L00K great: checks 
*** RIVER *** [Jc Jd As 8c] [Qh]
LyDynasty: bets $3.38
i L00K great: folds 
Uncalled bet ($3.38) returned to LyDynasty
LyDynasty collected $6.77 from pot
LyDynasty: doesn't show hand 
*** SUMMARY ***
Total pot $7.09 | Rake $0.32 
Board [Jc Jd As 8c Qh]
Seat 1: Optimistic21 folded before Flop (didn't bet)
Seat 2: matiko09 folded before Flop (didn't bet)
Seat 3: LyDynasty collected ($6.77)
Seat 4: i L00K great (button) folded on the River
Seat 5: make6a (small blind) folded before Flop
Seat 6: corsair888 (big blind) folded before Flop
Seat 7: vlad11122007 folded before Flop (didn't bet)
Seat 8: TheMinion folded before Flop (didn't bet)
Seat 9: PokerSash201 folded before Flop (didn't bet)





PokerStars Hand #148607340633:  Hold'em No Limit ($0.25/$0.50 USD) - 2016/02/11 12:24:09 CET [2016/02/11 6:24:09 ET]
Table 'Hunan' 9-max Seat #8 is the button
Seat 1: matiko09 ($51.50 in chips) 
Seat 2: smirnoff993 ($149.82 in chips) 
Seat 3: TheMinion ($59.86 in chips) 
Seat 4: banit7 ($50 in chips) 
Seat 5: Honk115 ($33.50 in chips) 
Seat 6: i L00K great ($62.16 in chips) 
Seat 7: SForces33 ($27.05 in chips) 
Seat 8: Reven9er ($54.45 in chips) 
Seat 9: Optimistic21 ($52.21 in chips) 
Optimistic21: posts small blind $0.25
matiko09: posts big blind $0.50
*** HOLE CARDS ***
Dealt to matiko09 [6s 6c]
smirnoff993: folds 
TheMinion: folds 
banit7: folds 
Honk115: folds 
i L00K great: folds 
SForces33: folds 
Reven9er: folds 
Optimistic21: folds 
Uncalled bet ($0.25) returned to matiko09
matiko09 collected $0.50 from pot
matiko09: doesn't show hand 
*** SUMMARY ***
Total pot $0.50 | Rake $0 
Seat 1: matiko09 (big blind) collected ($0.50)
Seat 2: smirnoff993 folded before Flop (didn't bet)
Seat 3: TheMinion folded before Flop (didn't bet)
Seat 4: banit7 folded before Flop (didn't bet)
Seat 5: Honk115 folded before Flop (didn't bet)
Seat 6: i L00K great folded before Flop (didn't bet)
Seat 7: SForces33 folded before Flop (didn't bet)
Seat 8: Reven9er (button) folded before Flop (didn't bet)
Seat 9: Optimistic21 (small blind) folded before Flop





PokerStars Hand #148607341290:  Hold'em No Limit ($0.50/$1.00 USD) - 2016/02/11 12:24:10 CET [2016/02/11 6:24:10 ET]
Table 'Regor' 9-max Seat #8 is the button
Seat 1: matiko09 ($125.11 in chips) 
Seat 2: Luck In Me ($104 in chips) 
Seat 3: oscarleon ($100 in chips) 
Seat 8: R3NZONIT3 ($67.08 in chips) 
Seat 9: CoolFireX ($100.50 in chips) 
CoolFireX: posts small blind $0.50
matiko09: posts big blind $1
*** HOLE CARDS ***
Dealt to matiko09 [6d 5d]
Luck In Me: raises $2 to $3
oscarleon: folds 
R3NZONIT3: folds 
CoolFireX: folds 
matiko09: folds 
Uncalled bet ($2) returned to Luck In Me
Luck In Me collected $2.50 from pot
Luck In Me: doesn't show hand 
*** SUMMARY ***
Total pot $2.50 | Rake $0 
Seat 1: matiko09 (big blind) folded before Flop
Seat 2: Luck In Me collected ($2.50)
Seat 3: oscarleon folded before Flop (didn't bet)
Seat 8: R3NZONIT3 (button) folded before Flop (didn't bet)
Seat 9: CoolFireX (small blind) folded before Flop





PokerStars Hand #148607346586:  Hold'em No Limit ($0.25/$0.50 USD) - 2016/02/11 12:24:20 CET [2016/02/11 6:24:20 ET]
Table 'Algedi' 9-max Seat #8 is the button
Seat 1: vlad11122007 ($49.40 in chips) 
Seat 2: TuaaL ($70.99 in chips) 
Seat 6: TonnaMunz ($127.51 in chips) 
Seat 7: hoedtrob ($61.17 in chips) 
Seat 8: matiko09 ($50 in chips) 
vlad11122007: posts small blind $0.25
TuaaL: posts big blind $0.50
Effort92: sits out 
vlad11122007: posts the ante $0.10
TuaaL: posts the ante $0.10
TonnaMunz: posts the ante $0.10
hoedtrob: posts the ante $0.10
matiko09: posts the ante $0.10
*** HOLE CARDS ***
Dealt to matiko09 [6s 4c]
TonnaMunz: folds 
hoedtrob: folds 
matiko09: folds 
vlad11122007: raises $1.25 to $1.75
TuaaL: calls $1.25
*** FLOP *** [Qh 8d Ah]
vlad11122007: bets $2
TuaaL: folds 
Uncalled bet ($2) returned to vlad11122007
vlad11122007 collected $3.82 from pot
vlad11122007: doesn't show hand 
*** SUMMARY ***
Total pot $4 | Rake $0.18 
Board [Qh 8d Ah]
Seat 1: vlad11122007 (small blind) collected ($3.82)
Seat 2: TuaaL (big blind) folded on the Flop
Seat 6: TonnaMunz folded before Flop (didn't bet)
Seat 7: hoedtrob folded before Flop (didn't bet)
Seat 8: matiko09 (button) folded before Flop (didn't bet)





PokerStars Hand #148607347201:  Hold'em No Limit (€0.25/€0.50 EUR) - 2016/02/11 12:24:22 CET [2016/02/11 6:24:22 ET]
Table 'Otero II' 9-max Seat #5 is the button
Seat 2: 100+x (€37.87 in chips) 
Seat 3: chaogoose82 (€40.18 in chips) 
Seat 5: vlad11122007 (€49.25 in chips) 
Seat 6: TonnaMunz (€50.25 in chips) 
Seat 7: PacPacBum (€50.93 in chips) 
Seat 8: matiko09 (€68.32 in chips) 
Seat 9: Optimistic21 (€60.04 in chips) 
TonnaMunz: posts small blind €0.25
PacPacBum: posts big blind €0.50
Nacho2556: sits out 
alfonso733: sits out 
*** HOLE CARDS ***
Dealt to matiko09 [9d 8h]
matiko09: folds 
Optimistic21: folds 
100+x: raises €0.50 to €1
chaogoose82: folds 
vlad11122007: folds 
TonnaMunz: folds 
PacPacBum: folds 
Uncalled bet (€0.50) returned to 100+x
100+x collected €1.25 from pot
100+x: doesn't show hand 
*** SUMMARY ***
Total pot €1.25 | Rake €0 
Seat 2: 100+x collected (€1.25)
Seat 3: chaogoose82 folded before Flop (didn't bet)
Seat 5: vlad11122007 (button) folded before Flop (didn't bet)
Seat 6: TonnaMunz (small blind) folded before Flop
Seat 7: PacPacBum (big blind) folded before Flop
Seat 8: matiko09 folded before Flop (didn't bet)
Seat 9: Optimistic21 folded before Flop (didn't bet)





PokerStars Hand #148607348199:  Hold'em No Limit ($0.25/$0.50 USD) - 2016/02/11 12:24:24 CET [2016/02/11 6:24:24 ET]
Table 'Ambrosia II' 9-max Seat #6 is the button
Seat 1: matiko09 ($52.87 in chips) 
Seat 2: TheMinion ($115.94 in chips) 
Seat 4: huudk2016 ($19.65 in chips) 
Seat 5: smirnoff993 ($67.61 in chips) 
Seat 6: Reven9er ($50 in chips) 
Seat 7: mexx1234 ($56.87 in chips) 
Seat 8: tallonn88 ($54.06 in chips) 
Seat 9: arctur17 ($55.29 in chips) 
mexx1234: posts small blind $0.25
tallonn88: posts big blind $0.50
make6a: sits out 
*** HOLE CARDS ***
Dealt to matiko09 [4c 7h]
arctur17: folds 
matiko09: folds 
TheMinion: folds 
huudk2016: calls $0.50
smirnoff993: raises $1.50 to $2
Reven9er: calls $2
mexx1234: folds 
tallonn88: folds 
huudk2016: calls $1.50
*** FLOP *** [3h 7c Jc]
huudk2016: checks 
smirnoff993: checks 
Reven9er: bets $2.50
huudk2016: calls $2.50
smirnoff993: calls $2.50
*** TURN *** [3h 7c Jc] [5d]
huudk2016: checks 
smirnoff993: checks 
Reven9er: checks 
*** RIVER *** [3h 7c Jc 5d] [6h]
huudk2016: checks 
smirnoff993: checks 
Reven9er: bets $5
huudk2016: folds 
smirnoff993: folds 
Uncalled bet ($5) returned to Reven9er
Reven9er collected $13.61 from pot
Reven9er: doesn't show hand 
*** SUMMARY ***
Total pot $14.25 | Rake $0.64 
Board [3h 7c Jc 5d 6h]
Seat 1: matiko09 folded before Flop (didn't bet)
Seat 2: TheMinion folded before Flop (didn't bet)
Seat 4: huudk2016 folded on the River
Seat 5: smirnoff993 folded on the River
Seat 6: Reven9er (button) collected ($13.61)
Seat 7: mexx1234 (small blind) folded before Flop
Seat 8: tallonn88 (big blind) folded before Flop
Seat 9: arctur17 folded before Flop (didn't bet)





PokerStars Hand #148607351979:  Hold'em No Limit ($0.25/$0.50 USD) - 2016/02/11 12:24:30 CET [2016/02/11 6:24:30 ET]
Table 'Hunan' 9-max Seat #9 is the button
Seat 1: matiko09 ($51.75 in chips) 
Seat 2: smirnoff993 ($149.82 in chips) 
Seat 3: TheMinion ($59.86 in chips) 
Seat 4: banit7 ($50 in chips) 
Seat 5: Honk115 ($33.50 in chips) 
Seat 6: i L00K great ($62.16 in chips) 
Seat 7: SForces33 ($27.05 in chips) 
Seat 8: Reven9er ($54.45 in chips) 
Seat 9: Optimistic21 ($51.96 in chips) 
matiko09: posts small blind $0.25
smirnoff993: posts big blind $0.50
*** HOLE CARDS ***
Dealt to matiko09 [Ac 2h]
TheMinion: folds 
banit7: folds 
Honk115: calls $0.50
i L00K great: folds 
SForces33: folds 
Reven9er: folds 
Optimistic21: folds 
matiko09: calls $0.25
smirnoff993: checks 
*** FLOP *** [9d 2c Th]
matiko09: checks 
smirnoff993: checks 
Honk115: bets $1.50
matiko09: folds 
smirnoff993: calls $1.50
*** TURN *** [9d 2c Th] [5d]
smirnoff993: checks 
Honk115: bets $4.50
smirnoff993: calls $4.50
*** RIVER *** [9d 2c Th 5d] [5s]
smirnoff993: checks 
Honk115: checks 
*** SHOW DOWN ***
smirnoff993: shows [Ts 6h] (two pair, Tens and Fives)
Honk115: shows [Tc As] (two pair, Tens and Fives - Ace kicker)
Honk115 collected $12.89 from pot
*** SUMMARY ***
Total pot $13.50 | Rake $0.61 
Board [9d 2c Th 5d 5s]
Seat 1: matiko09 (small blind) folded on the Flop
Seat 2: smirnoff993 (big blind) showed [Ts 6h] and lost with two pair, Tens and Fives
Seat 3: TheMinion folded before Flop (didn't bet)
Seat 4: banit7 folded before Flop (didn't bet)
Seat 5: Honk115 showed [Tc As] and won ($12.89) with two pair, Tens and Fives
Seat 6: i L00K great folded before Flop (didn't bet)
Seat 7: SForces33 folded before Flop (didn't bet)
Seat 8: Reven9er folded before Flop (didn't bet)
Seat 9: Optimistic21 (button) folded before Flop (didn't bet)





PokerStars Hand #148607352154:  Hold'em No Limit ($0.50/$1.00 USD) - 2016/02/11 12:24:31 CET [2016/02/11 6:24:31 ET]
Table 'Regor' 9-max Seat #9 is the button
Seat 1: matiko09 ($124.11 in chips) 
Seat 2: Luck In Me ($105.50 in chips) 
Seat 3: oscarleon ($100 in chips) 
Seat 8: R3NZONIT3 ($67.08 in chips) 
Seat 9: CoolFireX ($100 in chips) 
matiko09: posts small blind $0.50
Luck In Me: posts big blind $1
*** HOLE CARDS ***
Dealt to matiko09 [Th Js]
oscarleon: folds 
chauyeuba joins the table at seat #5 
R3NZONIT3: raises $2 to $3
CoolFireX: folds 
matiko09: folds 
Luck In Me: folds 
Uncalled bet ($2) returned to R3NZONIT3
R3NZONIT3 collected $2.50 from pot
R3NZONIT3: doesn't show hand 
*** SUMMARY ***
Total pot $2.50 | Rake $0 
Seat 1: matiko09 (small blind) folded before Flop
Seat 2: Luck In Me (big blind) folded before Flop
Seat 3: oscarleon folded before Flop (didn't bet)
Seat 8: R3NZONIT3 collected ($2.50)
Seat 9: CoolFireX (button) folded before Flop (didn't bet)





PokerStars Hand #148607355363:  Hold'em No Limit ($0.25/$0.50 USD) - 2016/02/11 12:24:37 CET [2016/02/11 6:24:37 ET]
Table 'Sylvania II' 9-max Seat #7 is the button
Seat 1: mexx1234 ($193.05 in chips) 
Seat 2: Effort92 ($54.69 in chips) 
Seat 3: ruyingren ($216.82 in chips) 
Seat 4: matiko09 ($119.05 in chips) 
Seat 5: vlad11122007 ($47.81 in chips) 
Seat 6: TonnaMunz ($123.14 in chips) 
Seat 7: i L00K great ($53.43 in chips) 
Seat 8: Optimistic21 ($50 in chips) 
Optimistic21: posts small blind $0.25
mexx1234: posts big blind $0.50
mexx1234: posts the ante $0.10
Effort92: posts the ante $0.10
ruyingren: posts the ante $0.10
matiko09: posts the ante $0.10
vlad11122007: posts the ante $0.10
TonnaMunz: posts the ante $0.10
i L00K great: posts the ante $0.10
Optimistic21: posts the ante $0.10
*** HOLE CARDS ***
Dealt to matiko09 [4s 5h]
Effort92: folds 
ruyingren: raises $1 to $1.50
matiko09: folds 
vlad11122007: calls $1.50
TonnaMunz: folds 
i L00K great: folds 
Optimistic21: folds 
mexx1234: folds 
*** FLOP *** [9c Qh Th]
ruyingren: bets $2.50
vlad11122007: folds 
Uncalled bet ($2.50) returned to ruyingren
ruyingren collected $4.35 from pot
ruyingren: doesn't show hand 
*** SUMMARY ***
Total pot $4.55 | Rake $0.20 
Board [9c Qh Th]
Seat 1: mexx1234 (big blind) folded before Flop
Seat 2: Effort92 folded before Flop (didn't bet)
Seat 3: ruyingren collected ($4.35)
Seat 4: matiko09 folded before Flop (didn't bet)
Seat 5: vlad11122007 folded on the Flop
Seat 6: TonnaMunz folded before Flop (didn't bet)
Seat 7: i L00K great (button) folded before Flop (didn't bet)
Seat 8: Optimistic21 (small blind) folded before Flop





PokerStars Hand #148607363381:  Hold'em No Limit ($0.50/$1.00 USD) - 2016/02/11 12:24:52 CET [2016/02/11 6:24:52 ET]
Table 'Sycorax II' 9-max Seat #1 is the button
Seat 1: Luck In Me ($107.26 in chips) 
Seat 2: Lujan87 ($103.21 in chips) 
Seat 4: Sweden_Pound ($144.94 in chips) 
Seat 5: Effort92 ($100 in chips) 
Seat 6: FluentFlows ($50 in chips) 
Seat 8: matiko09 ($129.37 in chips) 
Seat 9: mrfoldcall ($90.50 in chips) 
Lujan87: posts small blind $0.50
apfush: is sitting out 
apfush leaves the table
Sweden_Pound: posts big blind $1
FluentFlows: posts big blind $1
*** HOLE CARDS ***
Dealt to matiko09 [8c Kc]
hurtNCYDE joins the table at seat #7 
Effort92: folds 
FluentFlows: checks 
matiko09: raises $3 to $4
mrfoldcall: folds 
Luck In Me: folds 
Lujan87: folds 
Sweden_Pound: folds 
FluentFlows: folds 
Uncalled bet ($3) returned to matiko09
matiko09 collected $3.50 from pot
matiko09: doesn't show hand 
*** SUMMARY ***
Total pot $3.50 | Rake $0 
Seat 1: Luck In Me (button) folded before Flop (didn't bet)
Seat 2: Lujan87 (small blind) folded before Flop
Seat 4: Sweden_Pound (big blind) folded before Flop
Seat 5: Effort92 folded before Flop (didn't bet)
Seat 6: FluentFlows folded before Flop
Seat 8: matiko09 collected ($3.50)
Seat 9: mrfoldcall folded before Flop (didn't bet)





PokerStars Hand #148607363654:  Hold'em No Limit (€0.25/€0.50 EUR) - 2016/02/11 12:24:53 CET [2016/02/11 6:24:53 ET]
Table 'Otero II' 9-max Seat #6 is the button
Seat 1: Nacho2556 (€40 in chips) 
Seat 2: 100+x (€38.62 in chips) 
Seat 3: chaogoose82 (€40.18 in chips) 
Seat 4: alfonso733 (€25 in chips) 
Seat 5: vlad11122007 (€49.25 in chips) 
Seat 6: TonnaMunz (€50 in chips) 
Seat 7: PacPacBum (€50.43 in chips) 
Seat 8: matiko09 (€68.32 in chips) 
Seat 9: Optimistic21 (€60.04 in chips) 
PacPacBum: posts small blind €0.25
matiko09: posts big blind €0.50
Nacho2556: posts big blind €0.50
alfonso733: posts big blind €0.50
*** HOLE CARDS ***
Dealt to matiko09 [6s Jc]
Optimistic21: folds 
Nacho2556: checks 
100+x: folds 
chaogoose82: calls €0.50
alfonso733: checks 
vlad11122007: folds 
TonnaMunz: raises €2.50 to €3
PacPacBum: folds 
matiko09: folds 
Nacho2556: folds 
chaogoose82: calls €2.50
alfonso733: raises €7 to €10
TonnaMunz: folds 
chaogoose82: raises €7 to €17
alfonso733: raises €8 to €25 and is all-in
chaogoose82: calls €8
*** FLOP *** [7h 4s Ks]
*** TURN *** [7h 4s Ks] [Ad]
*** RIVER *** [7h 4s Ks Ad] [6d]
*** SHOW DOWN ***
chaogoose82: shows [6h Ac] (two pair, Aces and Sixes)
alfonso733: shows [Qs Qh] (a pair of Queens)
chaogoose82 collected €52.25 from pot
*** SUMMARY ***
Total pot €54.25 | Rake €2 
Board [7h 4s Ks Ad 6d]
Seat 1: Nacho2556 folded before Flop
Seat 2: 100+x folded before Flop (didn't bet)
Seat 3: chaogoose82 showed [6h Ac] and won (€52.25) with two pair, Aces and Sixes
Seat 4: alfonso733 showed [Qs Qh] and lost with a pair of Queens
Seat 5: vlad11122007 folded before Flop (didn't bet)
Seat 6: TonnaMunz (button) folded before Flop
Seat 7: PacPacBum (small blind) folded before Flop
Seat 8: matiko09 (big blind) folded before Flop
Seat 9: Optimistic21 folded before Flop (didn't bet)





PokerStars Hand #148607364180:  Hold'em No Limit ($0.50/$1.00 USD) - 2016/02/11 12:24:54 CET [2016/02/11 6:24:54 ET]
Table 'Isis II' 9-max Seat #8 is the button
Seat 1: CoolFireX ($136.70 in chips) 
Seat 2: matiko09 ($103 in chips) 
Seat 3: oscarleon ($101.50 in chips) 
Seat 5: vezunchik79 ($32.48 in chips) 
Seat 6: kouchan-max ($98.74 in chips) 
Seat 7: PacPacBum ($100 in chips) 
Seat 8: torkkdnm ($100 in chips) 
Seat 9: Sweden_Pound ($102.54 in chips) 
Sweden_Pound: posts small blind $0.50
CoolFireX: posts big blind $1
Filojoes: sits out 
*** HOLE CARDS ***
Dealt to matiko09 [4h Kd]
matiko09: folds 
oscarleon: folds 
vezunchik79: folds 
kouchan-max: folds 
PacPacBum: folds 
torkkdnm: folds 
Sweden_Pound: raises $2 to $3
CoolFireX: calls $2
*** FLOP *** [2d 3s 3c]
Sweden_Pound: bets $3.72
CoolFireX: calls $3.72
*** TURN *** [2d 3s 3c] [Ac]
Sweden_Pound: checks 
CoolFireX: checks 
*** RIVER *** [2d 3s 3c Ac] [Kh]
Sweden_Pound: checks 
CoolFireX: checks 
*** SHOW DOWN ***
Sweden_Pound: shows [Th Td] (two pair, Tens and Threes)
CoolFireX: mucks hand 
Sweden_Pound collected $12.84 from pot
*** SUMMARY ***
Total pot $13.44 | Rake $0.60 
Board [2d 3s 3c Ac Kh]
Seat 1: CoolFireX (big blind) mucked [5h 6h]
Seat 2: matiko09 folded before Flop (didn't bet)
Seat 3: oscarleon folded before Flop (didn't bet)
Seat 5: vezunchik79 folded before Flop (didn't bet)
Seat 6: kouchan-max folded before Flop (didn't bet)
Seat 7: PacPacBum folded before Flop (didn't bet)
Seat 8: torkkdnm (button) folded before Flop (didn't bet)
Seat 9: Sweden_Pound (small blind) showed [Th Td] and won ($12.84) with two pair, Tens and Threes





PokerStars Hand #148607368409:  Hold'em No Limit ($0.50/$1.00 USD) - 2016/02/11 12:25:02 CET [2016/02/11 6:25:02 ET]
Table 'Regor' 9-max Seat #1 is the button
Seat 1: matiko09 ($123.61 in chips) 
Seat 2: Luck In Me ($104.50 in chips) 
Seat 3: oscarleon ($100 in chips) 
Seat 8: R3NZONIT3 ($68.58 in chips) 
Seat 9: CoolFireX ($100 in chips) 
Luck In Me: posts small blind $0.50
oscarleon: posts big blind $1
chauyeuba: sits out 
*** HOLE CARDS ***
Dealt to matiko09 [Qh 3s]
R3NZONIT3: raises $1 to $2
CoolFireX: raises $5.50 to $7.50
matiko09: folds 
Luck In Me: folds 
oscarleon: folds 
R3NZONIT3: folds 
Uncalled bet ($5.50) returned to CoolFireX
CoolFireX collected $5.50 from pot
CoolFireX: doesn't show hand 
*** SUMMARY ***
Total pot $5.50 | Rake $0 
Seat 1: matiko09 (button) folded before Flop (didn't bet)
Seat 2: Luck In Me (small blind) folded before Flop
Seat 3: oscarleon (big blind) folded before Flop
Seat 8: R3NZONIT3 folded before Flop
Seat 9: CoolFireX collected ($5.50)





PokerStars Hand #148607370460:  Hold'em Pot Limit ($0.25/$0.50 USD) - 2016/02/11 12:25:05 CET [2016/02/11 6:25:05 ET]
Table 'Tinette' 9-max Seat #6 is the button
Seat 4: itzAddiction ($48.95 in chips) 
Seat 5: 50CandyJoe ($69.50 in chips) 
Seat 6: PokerAleman ($62.76 in chips) 
Seat 7: Red_Warning ($50 in chips) 
Seat 8: matiko09 ($50 in chips) 
Red_Warning: posts small blind $0.25
matiko09: posts big blind $0.50
Optimistic21: sits out 
*** HOLE CARDS ***
Dealt to matiko09 [2s 4s]
itzAddiction: raises $0.50 to $1
50CandyJoe: folds 
PokerAleman: calls $1
Red_Warning: calls $0.75
matiko09: folds 
*** FLOP *** [Qs 8c 9h]
Red_Warning: checks 
itzAddiction: bets $2
PokerAleman: folds 
Red_Warning: folds 
Uncalled bet ($2) returned to itzAddiction
itzAddiction collected $3.34 from pot
itzAddiction: doesn't show hand 
*** SUMMARY ***
Total pot $3.50 | Rake $0.16 
Board [Qs 8c 9h]
Seat 4: itzAddiction collected ($3.34)
Seat 5: 50CandyJoe folded before Flop (didn't bet)
Seat 6: PokerAleman (button) folded on the Flop
Seat 7: Red_Warning (small blind) folded on the Flop
Seat 8: matiko09 (big blind) folded before Flop





PokerStars Hand #148607374603:  Hold'em No Limit ($0.50/$1.00 USD) - 2016/02/11 12:25:13 CET [2016/02/11 6:25:13 ET]
Table 'Sycorax II' 9-max Seat #2 is the button
Seat 1: Luck In Me ($107.26 in chips) 
Seat 2: Lujan87 ($102.71 in chips) 
Seat 4: Sweden_Pound ($143.94 in chips) 
Seat 5: Effort92 ($100 in chips) 
Seat 6: FluentFlows ($49 in chips) 
Seat 8: matiko09 ($131.87 in chips) 
Seat 9: mrfoldcall ($90.50 in chips) 
Sweden_Pound: posts small blind $0.50
Effort92: posts big blind $1
hurtNCYDE: sits out 
*** HOLE CARDS ***
Dealt to matiko09 [Js 2c]
FluentFlows: folds 
matiko09: folds 
mrfoldcall: raises $2 to $3
Luck In Me: folds 
Lujan87: folds 
Sweden_Pound: folds 
Effort92: folds 
Uncalled bet ($2) returned to mrfoldcall
mrfoldcall collected $2.50 from pot
mrfoldcall: doesn't show hand 
*** SUMMARY ***
Total pot $2.50 | Rake $0 
Seat 1: Luck In Me folded before Flop (didn't bet)
Seat 2: Lujan87 (button) folded before Flop (didn't bet)
Seat 4: Sweden_Pound (small blind) folded before Flop
Seat 5: Effort92 (big blind) folded before Flop
Seat 6: FluentFlows folded before Flop (didn't bet)
Seat 8: matiko09 folded before Flop (didn't bet)
Seat 9: mrfoldcall collected ($2.50)





PokerStars Hand #148607377872:  Hold'em No Limit ($0.25/$0.50 USD) - 2016/02/11 12:25:20 CET [2016/02/11 6:25:20 ET]
Table 'Boliviana II' 9-max Seat #5 is the button
Seat 1: Optimistic21 ($60.38 in chips) 
Seat 2: matiko09 ($50 in chips) 
Seat 3: LyDynasty ($73.64 in chips) 
Seat 4: i L00K great ($53.56 in chips) 
Seat 5: make6a ($45.33 in chips) 
Seat 6: corsair888 ($57.81 in chips) 
Seat 7: vlad11122007 ($48.50 in chips) 
Seat 8: TheMinion ($50 in chips) 
Seat 9: PokerSash201 ($47.31 in chips) 
corsair888: posts small blind $0.25
vlad11122007: posts big blind $0.50
*** HOLE CARDS ***
Dealt to matiko09 [4c 5s]
TheMinion: folds 
PokerSash201: folds 
Optimistic21: folds 
matiko09: folds 
LyDynasty: folds 
i L00K great: raises $0.75 to $1.25
make6a: raises $2.25 to $3.50
corsair888: folds 
vlad11122007: folds 
i L00K great: folds 
Uncalled bet ($2.25) returned to make6a
make6a collected $3.25 from pot
make6a: doesn't show hand 
*** SUMMARY ***
Total pot $3.25 | Rake $0 
Seat 1: Optimistic21 folded before Flop (didn't bet)
Seat 2: matiko09 folded before Flop (didn't bet)
Seat 3: LyDynasty folded before Flop (didn't bet)
Seat 4: i L00K great folded before Flop
Seat 5: make6a (button) collected ($3.25)
Seat 6: corsair888 (small blind) folded before Flop
Seat 7: vlad11122007 (big blind) folded before Flop
Seat 8: TheMinion folded before Flop (didn't bet)
Seat 9: PokerSash201 folded before Flop (didn't bet)





PokerStars Hand #148607378939:  Hold'em No Limit ($0.25/$0.50 USD) - 2016/02/11 12:25:22 CET [2016/02/11 6:25:22 ET]
Table 'Stereoskopia' 9-max Seat #8 is the button
Seat 1: 50CandyJoe ($54.33 in chips) 
Seat 2: Optimistic21 ($50.75 in chips) 
Seat 3: Donko jr ($69.32 in chips) 
Seat 4: King brid ($34.86 in chips) 
Seat 5: ReinisRNS ($60.68 in chips) 
Seat 6: matiko09 ($50 in chips) 
Seat 7: tallonn88 ($50.50 in chips) 
Seat 8: banit7 ($88.53 in chips) 
Seat 9: anubis4455 ($42.67 in chips) 
anubis4455: posts small blind $0.25
50CandyJoe: posts big blind $0.50
*** HOLE CARDS ***
Dealt to matiko09 [7s As]
Optimistic21: folds 
Donko jr: raises $0.50 to $1
King brid: raises $0.50 to $1.50
ReinisRNS: raises $4.75 to $6.25
matiko09: folds 
tallonn88: folds 
banit7: folds 
anubis4455: folds 
50CandyJoe: folds 
Donko jr: folds 
King brid: raises $28.61 to $34.86 and is all-in
ReinisRNS: calls $28.61
*** FLOP *** [Ac 4h 5h]
*** TURN *** [Ac 4h 5h] [5d]
*** RIVER *** [Ac 4h 5h 5d] [9c]
*** SHOW DOWN ***
King brid: shows [Ad Ah] (a full house, Aces full of Fives)
ReinisRNS: shows [Kh Ks] (two pair, Kings and Fives)
King brid collected $68.97 from pot
*** SUMMARY ***
Total pot $71.47 | Rake $2.50 
Board [Ac 4h 5h 5d 9c]
Seat 1: 50CandyJoe (big blind) folded before Flop
Seat 2: Optimistic21 folded before Flop (didn't bet)
Seat 3: Donko jr folded before Flop
Seat 4: King brid showed [Ad Ah] and won ($68.97) with a full house, Aces full of Fives
Seat 5: ReinisRNS showed [Kh Ks] and lost with two pair, Kings and Fives
Seat 6: matiko09 folded before Flop (didn't bet)
Seat 7: tallonn88 folded before Flop (didn't bet)
Seat 8: banit7 (button) folded before Flop (didn't bet)
Seat 9: anubis4455 (small blind) folded before Flop





PokerStars Hand #148607379435:  Hold'em No Limit ($0.25/$0.50 USD) - 2016/02/11 12:25:23 CET [2016/02/11 6:25:23 ET]
Table 'Sylvania II' 9-max Seat #8 is the button
Seat 1: mexx1234 ($192.45 in chips) 
Seat 2: Effort92 ($54.59 in chips) 
Seat 3: ruyingren ($219.57 in chips) 
Seat 4: matiko09 ($118.95 in chips) 
Seat 5: vlad11122007 ($50 in chips) 
Seat 6: TonnaMunz ($123.04 in chips) 
Seat 7: i L00K great ($53.33 in chips) 
Seat 8: Optimistic21 ($50 in chips) 
Kud3 will be allowed to play after the button
mexx1234: posts small blind $0.25
Effort92: posts big blind $0.50
mexx1234: posts the ante $0.10
Effort92: posts the ante $0.10
ruyingren: posts the ante $0.10
matiko09: posts the ante $0.10
vlad11122007: posts the ante $0.10
TonnaMunz: posts the ante $0.10
i L00K great: posts the ante $0.10
Optimistic21: posts the ante $0.10
*** HOLE CARDS ***
Dealt to matiko09 [8h 8s]
ruyingren: raises $1 to $1.50
matiko09: raises $3 to $4.50
vlad11122007: folds 
TonnaMunz: folds 
i L00K great: folds 
Optimistic21: folds 
mexx1234: folds 
Effort92: folds 
ruyingren: calls $3
*** FLOP *** [6s 4d 2c]
ruyingren: checks 
matiko09: bets $6.55
ruyingren: raises $9.05 to $15.60
matiko09: calls $9.05
*** TURN *** [6s 4d 2c] [2d]
ruyingren: bets $13.50
matiko09: calls $13.50
*** RIVER *** [6s 4d 2c 2d] [5s]
ruyingren: checks 
matiko09: checks 
*** SHOW DOWN ***
ruyingren: shows [Ac 6c] (two pair, Sixes and Deuces)
matiko09: shows [8h 8s] (two pair, Eights and Deuces)
matiko09 collected $66.25 from pot
*** SUMMARY ***
Total pot $68.75 | Rake $2.50 
Board [6s 4d 2c 2d 5s]
Seat 1: mexx1234 (small blind) folded before Flop
Seat 2: Effort92 (big blind) folded before Flop
Seat 3: ruyingren showed [Ac 6c] and lost with two pair, Sixes and Deuces
Seat 4: matiko09 showed [8h 8s] and won ($66.25) with two pair, Eights and Deuces
Seat 5: vlad11122007 folded before Flop (didn't bet)
Seat 6: TonnaMunz folded before Flop (didn't bet)
Seat 7: i L00K great folded before Flop (didn't bet)
Seat 8: Optimistic21 (button) folded before Flop (didn't bet)





PokerStars Hand #148607380582:  Hold'em No Limit ($0.25/$0.50 USD) - 2016/02/11 12:25:25 CET [2016/02/11 6:25:25 ET]
Table 'Algedi' 9-max Seat #1 is the button
Seat 1: vlad11122007 ($51.37 in chips) 
Seat 2: TuaaL ($69.14 in chips) 
Seat 4: Effort92 ($50 in chips) 
Seat 6: TonnaMunz ($127.41 in chips) 
Seat 7: hoedtrob ($61.07 in chips) 
Seat 8: matiko09 ($50 in chips) 
TuaaL: posts small blind $0.25
Effort92: posts big blind $0.50
Kud3: sits out 
vlad11122007: posts the ante $0.10
TuaaL: posts the ante $0.10
Effort92: posts the ante $0.10
TonnaMunz: posts the ante $0.10
hoedtrob: posts the ante $0.10
matiko09: posts the ante $0.10
*** HOLE CARDS ***
Dealt to matiko09 [6s Js]
TonnaMunz: folds 
hoedtrob: folds 
matiko09: folds 
vlad11122007: folds 
TuaaL: calls $0.25
Effort92: checks 
*** FLOP *** [3d Ts 5s]
TuaaL: checks 
Effort92: checks 
*** TURN *** [3d Ts 5s] [4s]
TuaaL: checks 
Effort92: bets $1.14
TuaaL: calls $1.14
*** RIVER *** [3d Ts 5s 4s] [Ac]
TuaaL: checks 
Effort92: bets $1.90
TuaaL: folds 
Uncalled bet ($1.90) returned to Effort92
Effort92 collected $3.71 from pot
Effort92: doesn't show hand 
*** SUMMARY ***
Total pot $3.88 | Rake $0.17 
Board [3d Ts 5s 4s Ac]
Seat 1: vlad11122007 (button) folded before Flop (didn't bet)
Seat 2: TuaaL (small blind) folded on the River
Seat 4: Effort92 (big blind) collected ($3.71)
Seat 6: TonnaMunz folded before Flop (didn't bet)
Seat 7: hoedtrob folded before Flop (didn't bet)
Seat 8: matiko09 folded before Flop (didn't bet)





PokerStars Hand #148607382777:  Hold'em No Limit ($0.25/$0.50 USD) - 2016/02/11 12:25:29 CET [2016/02/11 6:25:29 ET]
Table 'Hunan' 9-max Seat #1 is the button
Seat 1: matiko09 ($51.25 in chips) 
Seat 2: smirnoff993 ($143.32 in chips) 
Seat 3: TheMinion ($59.86 in chips) 
Seat 4: banit7 ($50 in chips) 
Seat 5: Honk115 ($39.89 in chips) 
Seat 6: i L00K great ($62.16 in chips) 
Seat 7: SForces33 ($27.05 in chips) 
Seat 8: Reven9er ($54.45 in chips) 
Seat 9: Optimistic21 ($51.96 in chips) 
smirnoff993: posts small blind $0.25
TheMinion: posts big blind $0.50
*** HOLE CARDS ***
Dealt to matiko09 [As 2c]
banit7: folds 
Honk115: folds 
i L00K great: folds 
SForces33: folds 
Reven9er: raises $0.50 to $1
Optimistic21: folds 
matiko09: folds 
smirnoff993: folds 
TheMinion: folds 
Uncalled bet ($0.50) returned to Reven9er
Reven9er collected $1.25 from pot
Reven9er: doesn't show hand 
*** SUMMARY ***
Total pot $1.25 | Rake $0 
Seat 1: matiko09 (button) folded before Flop (didn't bet)
Seat 2: smirnoff993 (small blind) folded before Flop
Seat 3: TheMinion (big blind) folded before Flop
Seat 4: banit7 folded before Flop (didn't bet)
Seat 5: Honk115 folded before Flop (didn't bet)
Seat 6: i L00K great folded before Flop (didn't bet)
Seat 7: SForces33 folded before Flop (didn't bet)
Seat 8: Reven9er collected ($1.25)
Seat 9: Optimistic21 folded before Flop (didn't bet)





PokerStars Hand #148607385388:  Hold'em No Limit ($0.50/$1.00 USD) - 2016/02/11 12:25:34 CET [2016/02/11 6:25:34 ET]
Table 'Sycorax II' 9-max Seat #4 is the button
Seat 1: Luck In Me ($107.26 in chips) 
Seat 2: Lujan87 ($102.71 in chips) 
Seat 4: Sweden_Pound ($143.44 in chips) 
Seat 5: Effort92 ($100 in chips) 
Seat 6: FluentFlows ($49 in chips) 
Seat 8: matiko09 ($131.87 in chips) 
Seat 9: mrfoldcall ($92 in chips) 
Effort92: posts small blind $0.50
FluentFlows: posts big blind $1
hurtNCYDE: sits out 
*** HOLE CARDS ***
Dealt to matiko09 [8h 4s]
matiko09: folds 
mrfoldcall: folds 
Luck In Me: folds 
Lujan87: folds 
Sweden_Pound: raises $1 to $2
Effort92: folds 
chauyeuba joins the table at seat #3 
FluentFlows: calls $1
*** FLOP *** [6h 9d 3d]
FluentFlows: checks 
Sweden_Pound: checks 
*** TURN *** [6h 9d 3d] [9c]
FluentFlows: checks 
Sweden_Pound: checks 
*** RIVER *** [6h 9d 3d 9c] [5c]
FluentFlows: checks 
Sweden_Pound: checks 
*** SHOW DOWN ***
FluentFlows: shows [Kc Td] (a pair of Nines)
Sweden_Pound: shows [4c Ac] (a pair of Nines - Ace kicker)
Sweden_Pound collected $4.30 from pot
*** SUMMARY ***
Total pot $4.50 | Rake $0.20 
Board [6h 9d 3d 9c 5c]
Seat 1: Luck In Me folded before Flop (didn't bet)
Seat 2: Lujan87 folded before Flop (didn't bet)
Seat 4: Sweden_Pound (button) showed [4c Ac] and won ($4.30) with a pair of Nines
Seat 5: Effort92 (small blind) folded before Flop
Seat 6: FluentFlows (big blind) showed [Kc Td] and lost with a pair of Nines
Seat 8: matiko09 folded before Flop (didn't bet)
Seat 9: mrfoldcall folded before Flop (didn't bet)





PokerStars Hand #148607386851:  Hold'em Pot Limit ($0.25/$0.50 USD) - 2016/02/11 12:25:36 CET [2016/02/11 6:25:36 ET]
Table 'Tinette' 9-max Seat #7 is the button
Seat 4: itzAddiction ($51.29 in chips) 
Seat 6: PokerAleman ($61.76 in chips) 
Seat 7: Red_Warning ($50 in chips) 
Seat 8: matiko09 ($50 in chips) 
Seat 9: Optimistic21 ($50 in chips) 
matiko09: posts small blind $0.25
Optimistic21: posts big blind $0.50
*** HOLE CARDS ***
Dealt to matiko09 [Jc 7c]
itzAddiction: folds 
PokerAleman: folds 
Red_Warning: raises $0.50 to $1
matiko09: folds 
Optimistic21: folds 
Uncalled bet ($0.50) returned to Red_Warning
Red_Warning collected $1.25 from pot
Red_Warning: doesn't show hand 
*** SUMMARY ***
Total pot $1.25 | Rake $0 
Seat 4: itzAddiction folded before Flop (didn't bet)
Seat 6: PokerAleman folded before Flop (didn't bet)
Seat 7: Red_Warning (button) collected ($1.25)
Seat 8: matiko09 (small blind) folded before Flop
Seat 9: Optimistic21 (big blind) folded before Flop





PokerStars Hand #148607388000:  Hold'em No Limit ($0.50/$1.00 USD) - 2016/02/11 12:25:39 CET [2016/02/11 6:25:39 ET]
Table 'Regor' 9-max Seat #2 is the button
Seat 1: matiko09 ($123.61 in chips) 
Seat 2: Luck In Me ($104 in chips) 
Seat 3: oscarleon ($100 in chips) 
Seat 5: chauyeuba ($50 in chips) 
Seat 8: R3NZONIT3 ($66.58 in chips) 
Seat 9: CoolFireX ($103.50 in chips) 
oscarleon: posts small blind $0.50
chauyeuba: posts big blind $1
*** HOLE CARDS ***
Dealt to matiko09 [Js 3c]
R3NZONIT3: folds 
CoolFireX: folds 
matiko09: folds 
Luck In Me: raises $1.50 to $2.50
oscarleon: folds 
chauyeuba: folds 
Uncalled bet ($1.50) returned to Luck In Me
Luck In Me collected $2.50 from pot
Luck In Me: doesn't show hand 
*** SUMMARY ***
Total pot $2.50 | Rake $0 
Seat 1: matiko09 folded before Flop (didn't bet)
Seat 2: Luck In Me (button) collected ($2.50)
Seat 3: oscarleon (small blind) folded before Flop
Seat 5: chauyeuba (big blind) folded before Flop
Seat 8: R3NZONIT3 folded before Flop (didn't bet)
Seat 9: CoolFireX folded before Flop (didn't bet)





PokerStars Hand #148607395162:  Hold'em Pot Limit ($0.25/$0.50 USD) - 2016/02/11 12:25:52 CET [2016/02/11 6:25:52 ET]
Table 'Tinette' 9-max Seat #8 is the button
Seat 4: itzAddiction ($51.29 in chips) 
Seat 6: PokerAleman ($61.76 in chips) 
Seat 7: Red_Warning ($50.75 in chips) 
Seat 8: matiko09 ($50 in chips) 
Seat 9: Optimistic21 ($50 in chips) 
Optimistic21: posts small blind $0.25
itzAddiction: posts big blind $0.50
*** HOLE CARDS ***
Dealt to matiko09 [Kd 9d]
PokerAleman: folds 
Red_Warning: raises $0.75 to $1.25
matiko09: raises $2.76 to $4.01
Optimistic21: folds 
itzAddiction: folds 
Red_Warning: folds 
Uncalled bet ($2.76) returned to matiko09
matiko09 collected $3.25 from pot
matiko09: doesn't show hand 
*** SUMMARY ***
Total pot $3.25 | Rake $0 
Seat 4: itzAddiction (big blind) folded before Flop
Seat 6: PokerAleman folded before Flop (didn't bet)
Seat 7: Red_Warning folded before Flop
Seat 8: matiko09 (button) collected ($3.25)
Seat 9: Optimistic21 (small blind) folded before Flop





PokerStars Hand #148607401419:  Hold'em No Limit ($0.25/$0.50 USD) - 2016/02/11 12:26:04 CET [2016/02/11 6:26:04 ET]
Table 'Hunan' 9-max Seat #2 is the button
Seat 1: matiko09 ($51.25 in chips) 
Seat 2: smirnoff993 ($143.07 in chips) 
Seat 3: TheMinion ($59.36 in chips) 
Seat 4: banit7 ($50 in chips) 
Seat 5: Honk115 ($39.89 in chips) 
Seat 6: i L00K great ($62.16 in chips) 
Seat 7: SForces33 ($27.05 in chips) 
Seat 8: Reven9er ($55.20 in chips) 
Seat 9: Optimistic21 ($51.96 in chips) 
TheMinion: posts small blind $0.25
banit7: posts big blind $0.50
*** HOLE CARDS ***
Dealt to matiko09 [4s Jc]
Honk115: calls $0.50
i L00K great: raises $1.25 to $1.75
SForces33: folds 
Reven9er: folds 
Optimistic21: folds 
matiko09: folds 
smirnoff993: folds 
TheMinion: folds 
banit7: folds 
Honk115: calls $1.25
*** FLOP *** [Tc 3h Kc]
Honk115: checks 
i L00K great: checks 
*** TURN *** [Tc 3h Kc] [Ah]
Honk115: bets $4
i L00K great: folds 
Uncalled bet ($4) returned to Honk115
Honk115 collected $4.06 from pot
*** SUMMARY ***
Total pot $4.25 | Rake $0.19 
Board [Tc 3h Kc Ah]
Seat 1: matiko09 folded before Flop (didn't bet)
Seat 2: smirnoff993 (button) folded before Flop (didn't bet)
Seat 3: TheMinion (small blind) folded before Flop
Seat 4: banit7 (big blind) folded before Flop
Seat 5: Honk115 collected ($4.06)
Seat 6: i L00K great folded on the Turn
Seat 7: SForces33 folded before Flop (didn't bet)
Seat 8: Reven9er folded before Flop (didn't bet)
Seat 9: Optimistic21 folded before Flop (didn't bet)





PokerStars Hand #148607402118:  Hold'em No Limit ($0.25/$0.50 USD) - 2016/02/11 12:26:05 CET [2016/02/11 6:26:05 ET]
Table 'Boliviana II' 9-max Seat #6 is the button
Seat 1: Optimistic21 ($60.38 in chips) 
Seat 2: matiko09 ($50 in chips) 
Seat 3: LyDynasty ($73.64 in chips) 
Seat 4: i L00K great ($52.31 in chips) 
Seat 5: make6a ($47.33 in chips) 
Seat 6: corsair888 ($57.56 in chips) 
Seat 7: vlad11122007 ($48 in chips) 
Seat 8: TheMinion ($50 in chips) 
Seat 9: PokerSash201 ($47.31 in chips) 
vlad11122007: posts small blind $0.25
TheMinion: posts big blind $0.50
*** HOLE CARDS ***
Dealt to matiko09 [Qd 6d]
PokerSash201: folds 
Optimistic21: folds 
matiko09: folds 
LyDynasty: folds 
i L00K great: folds 
make6a: folds 
corsair888: raises $0.50 to $1
vlad11122007: folds 
TheMinion: folds 
Uncalled bet ($0.50) returned to corsair888
corsair888 collected $1.25 from pot
corsair888: doesn't show hand 
*** SUMMARY ***
Total pot $1.25 | Rake $0 
Seat 1: Optimistic21 folded before Flop (didn't bet)
Seat 2: matiko09 folded before Flop (didn't bet)
Seat 3: LyDynasty folded before Flop (didn't bet)
Seat 4: i L00K great folded before Flop (didn't bet)
Seat 5: make6a folded before Flop (didn't bet)
Seat 6: corsair888 (button) collected ($1.25)
Seat 7: vlad11122007 (small blind) folded before Flop
Seat 8: TheMinion (big blind) folded before Flop
Seat 9: PokerSash201 folded before Flop (didn't bet)





PokerStars Hand #148607408035:  Hold'em No Limit ($0.50/$1.00 USD) - 2016/02/11 12:26:16 CET [2016/02/11 6:26:16 ET]
Table 'Regor' 9-max Seat #3 is the button
Seat 1: matiko09 ($123.61 in chips) 
Seat 2: Luck In Me ($105.50 in chips) 
Seat 3: oscarleon ($100 in chips) 
Seat 5: chauyeuba ($49 in chips) 
Seat 8: R3NZONIT3 ($66.58 in chips) 
Seat 9: CoolFireX ($103.50 in chips) 
chauyeuba: posts small blind $0.50
R3NZONIT3: posts big blind $1
*** HOLE CARDS ***
Dealt to matiko09 [Jc 5d]
CoolFireX: raises $2 to $3
matiko09: folds 
Luck In Me: folds 
oscarleon: folds 
chauyeuba: folds 
R3NZONIT3: folds 
Uncalled bet ($2) returned to CoolFireX
CoolFireX collected $2.50 from pot
CoolFireX: doesn't show hand 
*** SUMMARY ***
Total pot $2.50 | Rake $0 
Seat 1: matiko09 folded before Flop (didn't bet)
Seat 2: Luck In Me folded before Flop (didn't bet)
Seat 3: oscarleon (button) folded before Flop (didn't bet)
Seat 5: chauyeuba (small blind) folded before Flop
Seat 8: R3NZONIT3 (big blind) folded before Flop
Seat 9: CoolFireX collected ($2.50)





PokerStars Hand #148607409146:  Hold'em No Limit ($0.25/$0.50 USD) - 2016/02/11 12:26:18 CET [2016/02/11 6:26:18 ET]
Table 'Ambrosia II' 9-max Seat #7 is the button
Seat 1: matiko09 ($52.87 in chips) 
Seat 2: TheMinion ($115.94 in chips) 
Seat 4: huudk2016 ($15.15 in chips) 
Seat 5: smirnoff993 ($63.11 in chips) 
Seat 6: Reven9er ($59.11 in chips) 
Seat 7: mexx1234 ($56.62 in chips) 
Seat 8: tallonn88 ($53.56 in chips) 
Seat 9: arctur17 ($55.29 in chips) 
tallonn88: posts small blind $0.25
arctur17: posts big blind $0.50
make6a: sits out 
*** HOLE CARDS ***
Dealt to matiko09 [9d Qs]
matiko09: folds 
TheMinion: folds 
huudk2016: calls $0.50
smirnoff993: folds 
Reven9er: raises $0.75 to $1.25
mexx1234: folds 
tallonn88: folds 
arctur17: folds 
huudk2016: calls $0.75
*** FLOP *** [Qc 6h 5c]
huudk2016: checks 
Reven9er: checks 
*** TURN *** [Qc 6h 5c] [9s]
huudk2016: checks 
Reven9er: bets $1
huudk2016: calls $1
*** RIVER *** [Qc 6h 5c 9s] [As]
huudk2016: checks 
Reven9er: bets $3.50
huudk2016: folds 
Uncalled bet ($3.50) returned to Reven9er
Reven9er collected $5.01 from pot
Reven9er: doesn't show hand 
*** SUMMARY ***
Total pot $5.25 | Rake $0.24 
Board [Qc 6h 5c 9s As]
Seat 1: matiko09 folded before Flop (didn't bet)
Seat 2: TheMinion folded before Flop (didn't bet)
Seat 4: huudk2016 folded on the River
Seat 5: smirnoff993 folded before Flop (didn't bet)
Seat 6: Reven9er collected ($5.01)
Seat 7: mexx1234 (button) folded before Flop (didn't bet)
Seat 8: tallonn88 (small blind) folded before Flop
Seat 9: arctur17 (big blind) folded before Flop





PokerStars Hand #148607409512:  Hold'em No Limit ($0.25/$0.50 USD) - 2016/02/11 12:26:19 CET [2016/02/11 6:26:19 ET]
Table 'Stereoskopia' 9-max Seat #9 is the button
Seat 2: Optimistic21 ($50.75 in chips) 
Seat 3: Donko jr ($68.32 in chips) 
Seat 4: King brid ($68.97 in chips) 
Seat 5: ReinisRNS ($25.82 in chips) 
Seat 6: matiko09 ($50 in chips) 
Seat 7: tallonn88 ($50.50 in chips) 
Seat 8: banit7 ($88.53 in chips) 
Seat 9: anubis4455 ($42.42 in chips) 
Optimistic21: posts small blind $0.25
Donko jr: posts big blind $0.50
*** HOLE CARDS ***
Dealt to matiko09 [Kh 2c]
King brid: folds 
ReinisRNS: calls $0.50
matiko09: folds 
tallonn88: folds 
banit7: raises $1.50 to $2
anubis4455: folds 
Optimistic21: folds 
Donko jr: folds 
ReinisRNS: calls $1.50
*** FLOP *** [Qs 9d 5s]
ReinisRNS: checks 
banit7: bets $2.50
ReinisRNS: raises $4.77 to $7.27
banit7: folds 
Uncalled bet ($4.77) returned to ReinisRNS
ReinisRNS collected $9.31 from pot
ReinisRNS: doesn't show hand 
*** SUMMARY ***
Total pot $9.75 | Rake $0.44 
Board [Qs 9d 5s]
Seat 2: Optimistic21 (small blind) folded before Flop
Seat 3: Donko jr (big blind) folded before Flop
Seat 4: King brid folded before Flop (didn't bet)
Seat 5: ReinisRNS collected ($9.31)
Seat 6: matiko09 folded before Flop (didn't bet)
Seat 7: tallonn88 folded before Flop (didn't bet)
Seat 8: banit7 folded on the Flop
Seat 9: anubis4455 (button) folded before Flop (didn't bet)





PokerStars Hand #148607410322:  Hold'em No Limit (€0.25/€0.50 EUR) - 2016/02/11 12:26:20 CET [2016/02/11 6:26:20 ET]
Table 'Otero II' 9-max Seat #7 is the button
Seat 1: Nacho2556 (€39.50 in chips) 
Seat 2: 100+x (€38.62 in chips) 
Seat 3: chaogoose82 (€67.43 in chips) 
Seat 5: vlad11122007 (€49.25 in chips) 
Seat 6: TonnaMunz (€50 in chips) 
Seat 7: PacPacBum (€50.18 in chips) 
Seat 8: matiko09 (€67.82 in chips) 
Seat 9: Optimistic21 (€60.04 in chips) 
matiko09: posts small blind €0.25
Optimistic21: posts big blind €0.50
*** HOLE CARDS ***
Dealt to matiko09 [Jh Ks]
Nacho2556: folds 
100+x: folds 
alfonso733 leaves the table
chaogoose82: folds 
vlad11122007: raises €1 to €1.50
TonnaMunz: folds 
PacPacBum: folds 
matiko09: folds 
Optimistic21: folds 
Uncalled bet (€1) returned to vlad11122007
vlad11122007 collected €1.25 from pot
vlad11122007: doesn't show hand 
*** SUMMARY ***
Total pot €1.25 | Rake €0 
Seat 1: Nacho2556 folded before Flop (didn't bet)
Seat 2: 100+x folded before Flop (didn't bet)
Seat 3: chaogoose82 folded before Flop (didn't bet)
Seat 5: vlad11122007 collected (€1.25)
Seat 6: TonnaMunz folded before Flop (didn't bet)
Seat 7: PacPacBum (button) folded before Flop (didn't bet)
Seat 8: matiko09 (small blind) folded before Flop
Seat 9: Optimistic21 (big blind) folded before Flop





PokerStars Hand #148607410804:  Hold'em No Limit ($0.25/$0.50 USD) - 2016/02/11 12:26:21 CET [2016/02/11 6:26:21 ET]
Table 'Amor II' 9-max Seat #4 is the button
Seat 2: GusenokRUS ($83.87 in chips) 
Seat 3: TheMinion ($60.22 in chips) 
Seat 4: Larzdog29 ($48.02 in chips) 
Seat 5: Optimistic21 ($52.44 in chips) 
Seat 6: matiko09 ($50 in chips) 
Seat 7: banit7 ($51.61 in chips) 
Seat 8: Reven9er ($61.43 in chips) 
Seat 9: tallonn88 ($52 in chips) 
Optimistic21: posts small blind $0.25
matiko09: posts big blind $0.50
Kud3: sits out 
*** HOLE CARDS ***
Dealt to matiko09 [8d Kh]
banit7: folds 
Reven9er: folds 
tallonn88: folds 
GusenokRUS: folds 
TheMinion: raises $0.75 to $1.25
Larzdog29: folds 
Optimistic21: folds 
matiko09: folds 
Uncalled bet ($0.75) returned to TheMinion
TheMinion collected $1.25 from pot
TheMinion: doesn't show hand 
*** SUMMARY ***
Total pot $1.25 | Rake $0 
Seat 2: GusenokRUS folded before Flop (didn't bet)
Seat 3: TheMinion collected ($1.25)
Seat 4: Larzdog29 (button) folded before Flop (didn't bet)
Seat 5: Optimistic21 (small blind) folded before Flop
Seat 6: matiko09 (big blind) folded before Flop
Seat 7: banit7 folded before Flop (didn't bet)
Seat 8: Reven9er folded before Flop (didn't bet)
Seat 9: tallonn88 folded before Flop (didn't bet)





PokerStars Hand #148607416048:  Hold'em Pot Limit ($0.25/$0.50 USD) - 2016/02/11 12:26:31 CET [2016/02/11 6:26:31 ET]
Table 'Tinette' 9-max Seat #9 is the button
Seat 4: itzAddiction ($50.79 in chips) 
Seat 6: PokerAleman ($61.76 in chips) 
Seat 7: Red_Warning ($50 in chips) 
Seat 8: matiko09 ($52 in chips) 
Seat 9: Optimistic21 ($50 in chips) 
itzAddiction: posts small blind $0.25
PokerAleman: posts big blind $0.50
*** HOLE CARDS ***
Dealt to matiko09 [6c Js]
Red_Warning: folds 
matiko09: folds 
Optimistic21: folds 
itzAddiction: folds 
Uncalled bet ($0.25) returned to PokerAleman
PokerAleman collected $0.50 from pot
PokerAleman: doesn't show hand 
*** SUMMARY ***
Total pot $0.50 | Rake $0 
Seat 4: itzAddiction (small blind) folded before Flop
Seat 6: PokerAleman (big blind) collected ($0.50)
Seat 7: Red_Warning folded before Flop (didn't bet)
Seat 8: matiko09 folded before Flop (didn't bet)
Seat 9: Optimistic21 (button) folded before Flop (didn't bet)





PokerStars Hand #148607418139:  Hold'em No Limit ($0.25/$0.50 USD) - 2016/02/11 12:26:35 CET [2016/02/11 6:26:35 ET]
Table 'Boliviana II' 9-max Seat #7 is the button
Seat 1: Optimistic21 ($60.38 in chips) 
Seat 2: matiko09 ($50 in chips) 
Seat 3: LyDynasty ($73.64 in chips) 
Seat 4: i L00K great ($52.31 in chips) 
Seat 5: make6a ($47.33 in chips) 
Seat 6: corsair888 ($58.31 in chips) 
Seat 7: vlad11122007 ($47.75 in chips) 
Seat 8: TheMinion ($50 in chips) 
Seat 9: PokerSash201 ($47.31 in chips) 
TheMinion: posts small blind $0.25
PokerSash201: posts big blind $0.50
*** HOLE CARDS ***
Dealt to matiko09 [3s Th]
Optimistic21: folds 
matiko09: folds 
LyDynasty: folds 
i L00K great: raises $1 to $1.50
make6a: calls $1.50
corsair888: folds 
vlad11122007: folds 
TheMinion: folds 
PokerSash201: raises $4.75 to $6.25
i L00K great: calls $4.75
make6a: calls $4.75
*** FLOP *** [2s 6h 2c]
PokerSash201: checks 
i L00K great: checks 
make6a: checks 
*** TURN *** [2s 6h 2c] [Jc]
PokerSash201: bets $4
i L00K great: calls $4
make6a: folds 
*** RIVER *** [2s 6h 2c Jc] [2h]
PokerSash201: checks 
i L00K great: bets $20.62
PokerSash201: calls $20.62
*** SHOW DOWN ***
i L00K great: shows [Jd Js] (a full house, Jacks full of Deuces)
PokerSash201: mucks hand 
i L00K great collected $65.74 from pot
*** SUMMARY ***
Total pot $68.24 | Rake $2.50 
Board [2s 6h 2c Jc 2h]
Seat 1: Optimistic21 folded before Flop (didn't bet)
Seat 2: matiko09 folded before Flop (didn't bet)
Seat 3: LyDynasty folded before Flop (didn't bet)
Seat 4: i L00K great showed [Jd Js] and won ($65.74) with a full house, Jacks full of Deuces
Seat 5: make6a folded on the Turn
Seat 6: corsair888 folded before Flop (didn't bet)
Seat 7: vlad11122007 (button) folded before Flop (didn't bet)
Seat 8: TheMinion (small blind) folded before Flop
Seat 9: PokerSash201 (big blind) mucked [Tc Ts]





PokerStars Hand #148607425141:  Hold'em No Limit ($0.50/$1.00 USD) - 2016/02/11 12:26:48 CET [2016/02/11 6:26:48 ET]
Table 'Sycorax II' 9-max Seat #5 is the button
Seat 1: Luck In Me ($107.26 in chips) 
Seat 2: Lujan87 ($102.71 in chips) 
Seat 4: Sweden_Pound ($145.74 in chips) 
Seat 5: Effort92 ($100 in chips) 
Seat 6: FluentFlows ($47 in chips) 
Seat 7: hurtNCYDE ($118.88 in chips) 
Seat 8: matiko09 ($131.87 in chips) 
Seat 9: mrfoldcall ($92 in chips) 
FluentFlows: posts small blind $0.50
hurtNCYDE: posts big blind $1
chauyeuba: sits out 
*** HOLE CARDS ***
Dealt to matiko09 [Jh 8s]
matiko09: folds 
mrfoldcall: raises $2 to $3
Luck In Me: folds 
Lujan87: folds 
Sweden_Pound: folds 
Effort92: folds 
FluentFlows: folds 
hurtNCYDE: folds 
Uncalled bet ($2) returned to mrfoldcall
mrfoldcall collected $2.50 from pot
mrfoldcall: doesn't show hand 
*** SUMMARY ***
Total pot $2.50 | Rake $0 
Seat 1: Luck In Me folded before Flop (didn't bet)
Seat 2: Lujan87 folded before Flop (didn't bet)
Seat 4: Sweden_Pound folded before Flop (didn't bet)
Seat 5: Effort92 (button) folded before Flop (didn't bet)
Seat 6: FluentFlows (small blind) folded before Flop
Seat 7: hurtNCYDE (big blind) folded before Flop
Seat 8: matiko09 folded before Flop (didn't bet)
Seat 9: mrfoldcall collected ($2.50)





PokerStars Hand #148607425456:  Hold'em No Limit ($0.25/$0.50 USD) - 2016/02/11 12:26:49 CET [2016/02/11 6:26:49 ET]
Table 'Amor II' 9-max Seat #5 is the button
Seat 2: GusenokRUS ($83.87 in chips) 
Seat 3: TheMinion ($60.97 in chips) 
Seat 4: Larzdog29 ($48.02 in chips) 
Seat 5: Optimistic21 ($52.19 in chips) 
Seat 6: matiko09 ($50 in chips) 
Seat 7: banit7 ($51.61 in chips) 
Seat 8: Reven9er ($61.43 in chips) 
Seat 9: tallonn88 ($52 in chips) 
matiko09: posts small blind $0.25
banit7: posts big blind $0.50
Kud3: sits out 
*** HOLE CARDS ***
Dealt to matiko09 [Jd 3s]
Reven9er: folds 
tallonn88: folds 
GusenokRUS: raises $1 to $1.50
TheMinion: folds 
Larzdog29: folds 
Optimistic21: folds 
matiko09: folds 
banit7: folds 
Uncalled bet ($1) returned to GusenokRUS
GusenokRUS collected $1.25 from pot
GusenokRUS: doesn't show hand 
*** SUMMARY ***
Total pot $1.25 | Rake $0 
Seat 2: GusenokRUS collected ($1.25)
Seat 3: TheMinion folded before Flop (didn't bet)
Seat 4: Larzdog29 folded before Flop (didn't bet)
Seat 5: Optimistic21 (button) folded before Flop (didn't bet)
Seat 6: matiko09 (small blind) folded before Flop
Seat 7: banit7 (big blind) folded before Flop
Seat 8: Reven9er folded before Flop (didn't bet)
Seat 9: tallonn88 folded before Flop (didn't bet)





PokerStars Hand #148607425382:  Hold'em Pot Limit ($0.25/$0.50 USD) - 2016/02/11 12:26:49 CET [2016/02/11 6:26:49 ET]
Table 'Tinette' 9-max Seat #4 is the button
Seat 4: itzAddiction ($50.54 in chips) 
Seat 6: PokerAleman ($62.01 in chips) 
Seat 7: Red_Warning ($50 in chips) 
Seat 8: matiko09 ($52 in chips) 
Seat 9: Optimistic21 ($50 in chips) 
PokerAleman: posts small blind $0.25
Red_Warning: posts big blind $0.50
*** HOLE CARDS ***
Dealt to matiko09 [3c 8d]
matiko09: folds 
Optimistic21: folds 
itzAddiction: folds 
PokerAleman: raises $1 to $1.50
Red_Warning: calls $1
*** FLOP *** [Kd 2s 2c]
PokerAleman: bets $1.50
Red_Warning: folds 
Uncalled bet ($1.50) returned to PokerAleman
PokerAleman collected $2.86 from pot
PokerAleman: doesn't show hand 
*** SUMMARY ***
Total pot $3 | Rake $0.14 
Board [Kd 2s 2c]
Seat 4: itzAddiction (button) folded before Flop (didn't bet)
Seat 6: PokerAleman (small blind) collected ($2.86)
Seat 7: Red_Warning (big blind) folded on the Flop
Seat 8: matiko09 folded before Flop (didn't bet)
Seat 9: Optimistic21 folded before Flop (didn't bet)





PokerStars Hand #148607428074:  Hold'em No Limit ($0.50/$1.00 USD) - 2016/02/11 12:26:54 CET [2016/02/11 6:26:54 ET]
Table 'Regor' 9-max Seat #5 is the button
Seat 1: matiko09 ($123.61 in chips) 
Seat 2: Luck In Me ($105.50 in chips) 
Seat 3: oscarleon ($100 in chips) 
Seat 5: chauyeuba ($48.50 in chips) 
Seat 8: R3NZONIT3 ($65.58 in chips) 
Seat 9: CoolFireX ($105 in chips) 
R3NZONIT3: posts small blind $0.50
CoolFireX: posts big blind $1
*** HOLE CARDS ***
Dealt to matiko09 [7c 8h]
matiko09: folds 
Luck In Me: folds 
oscarleon: folds 
chauyeuba: folds 
R3NZONIT3: folds 
Uncalled bet ($0.50) returned to CoolFireX
CoolFireX collected $1 from pot
CoolFireX: doesn't show hand 
*** SUMMARY ***
Total pot $1 | Rake $0 
Seat 1: matiko09 folded before Flop (didn't bet)
Seat 2: Luck In Me folded before Flop (didn't bet)
Seat 3: oscarleon folded before Flop (didn't bet)
Seat 5: chauyeuba (button) folded before Flop (didn't bet)
Seat 8: R3NZONIT3 (small blind) folded before Flop
Seat 9: CoolFireX (big blind) collected ($1)





PokerStars Hand #148607430242:  Hold'em No Limit ($0.25/$0.50 USD) - 2016/02/11 12:26:58 CET [2016/02/11 6:26:58 ET]
Table 'Stereoskopia' 9-max Seat #2 is the button
Seat 2: Optimistic21 ($50.50 in chips) 
Seat 3: Donko jr ($67.82 in chips) 
Seat 4: King brid ($68.97 in chips) 
Seat 5: ReinisRNS ($30.63 in chips) 
Seat 6: matiko09 ($50 in chips) 
Seat 7: tallonn88 ($50.50 in chips) 
Seat 8: banit7 ($84.03 in chips) 
Seat 9: anubis4455 ($42.42 in chips) 
Donko jr: posts small blind $0.25
King brid: posts big blind $0.50
*** HOLE CARDS ***
Dealt to matiko09 [Ah Kh]
ReinisRNS: folds 
matiko09: raises $1 to $1.50
tallonn88: folds 
banit7: folds 
anubis4455: folds 
Optimistic21: folds 
Donko jr: calls $1.25
King brid: folds 
*** FLOP *** [2d 7c Qs]
Donko jr: checks 
matiko09: bets $2.17
Donko jr: calls $2.17
*** TURN *** [2d 7c Qs] [Qh]
Donko jr: checks 
matiko09: checks 
*** RIVER *** [2d 7c Qs Qh] [As]
Donko jr: checks 
matiko09: checks 
*** SHOW DOWN ***
Donko jr: shows [6s 7s] (two pair, Queens and Sevens)
matiko09: shows [Ah Kh] (two pair, Aces and Queens)
matiko09 collected $7.49 from pot
*** SUMMARY ***
Total pot $7.84 | Rake $0.35 
Board [2d 7c Qs Qh As]
Seat 2: Optimistic21 (button) folded before Flop (didn't bet)
Seat 3: Donko jr (small blind) showed [6s 7s] and lost with two pair, Queens and Sevens
Seat 4: King brid (big blind) folded before Flop
Seat 5: ReinisRNS folded before Flop (didn't bet)
Seat 6: matiko09 showed [Ah Kh] and won ($7.49) with two pair, Aces and Queens
Seat 7: tallonn88 folded before Flop (didn't bet)
Seat 8: banit7 folded before Flop (didn't bet)
Seat 9: anubis4455 folded before Flop (didn't bet)





PokerStars Hand #148607434977:  Hold'em No Limit ($0.25/$0.50 USD) - 2016/02/11 12:27:07 CET [2016/02/11 6:27:07 ET]
Table 'Hunan' 9-max Seat #3 is the button
Seat 1: matiko09 ($51.25 in chips) 
Seat 2: smirnoff993 ($143.07 in chips) 
Seat 3: TheMinion ($59.11 in chips) 
Seat 4: banit7 ($50 in chips) 
Seat 5: Honk115 ($42.20 in chips) 
Seat 6: i L00K great ($60.41 in chips) 
Seat 7: SForces33 ($27.05 in chips) 
Seat 8: Reven9er ($55.20 in chips) 
Seat 9: Optimistic21 ($51.96 in chips) 
banit7: posts small blind $0.25
Honk115: posts big blind $0.50
*** HOLE CARDS ***
Dealt to matiko09 [Tc 5d]
i L00K great: folds 
SForces33: folds 
Reven9er: folds 
Optimistic21: folds 
matiko09: folds 
smirnoff993: folds 
TheMinion: folds 
banit7: raises $1 to $1.50
Honk115: folds 
Uncalled bet ($1) returned to banit7
banit7 collected $1 from pot
banit7: doesn't show hand 
*** SUMMARY ***
Total pot $1 | Rake $0 
Seat 1: matiko09 folded before Flop (didn't bet)
Seat 2: smirnoff993 folded before Flop (didn't bet)
Seat 3: TheMinion (button) folded before Flop (didn't bet)
Seat 4: banit7 (small blind) collected ($1)
Seat 5: Honk115 (big blind) folded before Flop
Seat 6: i L00K great folded before Flop (didn't bet)
Seat 7: SForces33 folded before Flop (didn't bet)
Seat 8: Reven9er folded before Flop (didn't bet)
Seat 9: Optimistic21 folded before Flop (didn't bet)





PokerStars Hand #148607436352:  Hold'em No Limit (€0.25/€0.50 EUR) - 2016/02/11 12:27:09 CET [2016/02/11 6:27:09 ET]
Table 'Otero II' 9-max Seat #8 is the button
Seat 1: Nacho2556 (€39.50 in chips) 
Seat 2: 100+x (€38.62 in chips) 
Seat 3: chaogoose82 (€67.43 in chips) 
Seat 5: vlad11122007 (€50 in chips) 
Seat 6: TonnaMunz (€50 in chips) 
Seat 7: PacPacBum (€50.18 in chips) 
Seat 8: matiko09 (€67.57 in chips) 
Seat 9: Optimistic21 (€59.54 in chips) 
Optimistic21: posts small blind €0.25
Nacho2556: posts big blind €0.50
*** HOLE CARDS ***
Dealt to matiko09 [Jc Jd]
100+x: folds 
chaogoose82: folds 
vlad11122007: folds 
TonnaMunz: raises €0.74 to €1.24
PacPacBum: folds 
matiko09: calls €1.24
Optimistic21: folds 
Nacho2556: folds 
*** FLOP *** [Qs 6c 7d]
TonnaMunz: bets €1.75
matiko09: calls €1.75
*** TURN *** [Qs 6c 7d] [5h]
TonnaMunz: checks 
matiko09: checks 
*** RIVER *** [Qs 6c 7d 5h] [3c]
TonnaMunz: bets €5
matiko09: folds 
Uncalled bet (€5) returned to TonnaMunz
TonnaMunz collected €6.43 from pot
TonnaMunz: doesn't show hand 
*** SUMMARY ***
Total pot €6.73 | Rake €0.30 
Board [Qs 6c 7d 5h 3c]
Seat 1: Nacho2556 (big blind) folded before Flop
Seat 2: 100+x folded before Flop (didn't bet)
Seat 3: chaogoose82 folded before Flop (didn't bet)
Seat 5: vlad11122007 folded before Flop (didn't bet)
Seat 6: TonnaMunz collected (€6.43)
Seat 7: PacPacBum folded before Flop (didn't bet)
Seat 8: matiko09 (button) folded on the River
Seat 9: Optimistic21 (small blind) folded before Flop





PokerStars Hand #148607436894:  Hold'em No Limit ($0.50/$1.00 USD) - 2016/02/11 12:27:11 CET [2016/02/11 6:27:11 ET]
Table 'Sycorax II' 9-max Seat #6 is the button
Seat 1: Luck In Me ($107.26 in chips) 
Seat 2: Lujan87 ($102.71 in chips) 
Seat 4: Sweden_Pound ($145.74 in chips) 
Seat 5: Effort92 ($100 in chips) 
Seat 6: FluentFlows ($46.50 in chips) 
Seat 7: hurtNCYDE ($117.88 in chips) 
Seat 8: matiko09 ($131.87 in chips) 
Seat 9: mrfoldcall ($93.50 in chips) 
hurtNCYDE: posts small blind $0.50
matiko09: posts big blind $1
chauyeuba: sits out 
*** HOLE CARDS ***
Dealt to matiko09 [Js 7c]
mrfoldcall: folds 
Luck In Me: folds 
Lujan87: raises $2 to $3
Sweden_Pound: folds 
Effort92: folds 
FluentFlows: folds 
hurtNCYDE: folds 
matiko09: folds 
Uncalled bet ($2) returned to Lujan87
Lujan87 collected $2.50 from pot
Lujan87: doesn't show hand 
*** SUMMARY ***
Total pot $2.50 | Rake $0 
Seat 1: Luck In Me folded before Flop (didn't bet)
Seat 2: Lujan87 collected ($2.50)
Seat 4: Sweden_Pound folded before Flop (didn't bet)
Seat 5: Effort92 folded before Flop (didn't bet)
Seat 6: FluentFlows (button) folded before Flop (didn't bet)
Seat 7: hurtNCYDE (small blind) folded before Flop
Seat 8: matiko09 (big blind) folded before Flop
Seat 9: mrfoldcall folded before Flop (didn't bet)





PokerStars Hand #148607437827:  Hold'em No Limit ($0.50/$1.00 USD) - 2016/02/11 12:27:12 CET [2016/02/11 6:27:12 ET]
Table 'Regor' 9-max Seat #8 is the button
Seat 1: matiko09 ($123.61 in chips) 
Seat 2: Luck In Me ($105.50 in chips) 
Seat 3: oscarleon ($100 in chips) 
Seat 5: chauyeuba ($48.50 in chips) 
Seat 8: R3NZONIT3 ($65.08 in chips) 
Seat 9: CoolFireX ($105.50 in chips) 
CoolFireX: posts small blind $0.50
matiko09: posts big blind $1
*** HOLE CARDS ***
Dealt to matiko09 [Kd 3d]
Luck In Me: folds 
oscarleon: folds 
chauyeuba: folds 
R3NZONIT3: folds 
CoolFireX: folds 
Uncalled bet ($0.50) returned to matiko09
matiko09 collected $1 from pot
matiko09: doesn't show hand 
*** SUMMARY ***
Total pot $1 | Rake $0 
Seat 1: matiko09 (big blind) collected ($1)
Seat 2: Luck In Me folded before Flop (didn't bet)
Seat 3: oscarleon folded before Flop (didn't bet)
Seat 5: chauyeuba folded before Flop (didn't bet)
Seat 8: R3NZONIT3 (button) folded before Flop (didn't bet)
Seat 9: CoolFireX (small blind) folded before Flop





PokerStars Hand #148607437970:  Hold'em No Limit ($0.25/$0.50 USD) - 2016/02/11 12:27:13 CET [2016/02/11 6:27:13 ET]
Table 'Amor II' 9-max Seat #6 is the button
Seat 2: GusenokRUS ($84.62 in chips) 
Seat 3: TheMinion ($60.97 in chips) 
Seat 4: Larzdog29 ($48.02 in chips) 
Seat 5: Optimistic21 ($52.19 in chips) 
Seat 6: matiko09 ($50 in chips) 
Seat 7: banit7 ($51.11 in chips) 
Seat 8: Reven9er ($61.43 in chips) 
Seat 9: tallonn88 ($52 in chips) 
banit7: posts small blind $0.25
Reven9er: posts big blind $0.50
Kud3: sits out 
*** HOLE CARDS ***
Dealt to matiko09 [8h 5c]
tallonn88: folds 
GusenokRUS: folds 
TheMinion: folds 
Larzdog29: folds 
Optimistic21: folds 
matiko09: folds 
banit7: folds 
Uncalled bet ($0.25) returned to Reven9er
Reven9er collected $0.50 from pot
Reven9er: doesn't show hand 
*** SUMMARY ***
Total pot $0.50 | Rake $0 
Seat 2: GusenokRUS folded before Flop (didn't bet)
Seat 3: TheMinion folded before Flop (didn't bet)
Seat 4: Larzdog29 folded before Flop (didn't bet)
Seat 5: Optimistic21 folded before Flop (didn't bet)
Seat 6: matiko09 (button) folded before Flop (didn't bet)
Seat 7: banit7 (small blind) folded before Flop
Seat 8: Reven9er (big blind) collected ($0.50)
Seat 9: tallonn88 folded before Flop (didn't bet)





PokerStars Hand #148607439360:  Hold'em No Limit ($0.25/$0.50 USD) - 2016/02/11 12:27:15 CET [2016/02/11 6:27:15 ET]
Table 'Sylvania II' 9-max Seat #1 is the button
Seat 1: mexx1234 ($192.10 in chips) 
Seat 2: Effort92 ($53.99 in chips) 
Seat 3: ruyingren ($185.87 in chips) 
Seat 4: matiko09 ($151.50 in chips) 
Seat 5: vlad11122007 ($49.90 in chips) 
Seat 6: TonnaMunz ($122.94 in chips) 
Seat 7: i L00K great ($53.23 in chips) 
Seat 8: Optimistic21 ($50 in chips) 
Effort92: posts small blind $0.25
ruyingren: posts big blind $0.50
Kud3: sits out 
mexx1234: posts the ante $0.10
Effort92: posts the ante $0.10
ruyingren: posts the ante $0.10
matiko09: posts the ante $0.10
vlad11122007: posts the ante $0.10
TonnaMunz: posts the ante $0.10
i L00K great: posts the ante $0.10
Optimistic21: posts the ante $0.10
*** HOLE CARDS ***
Dealt to matiko09 [4c 8h]
matiko09: folds 
vlad11122007: folds 
TonnaMunz: raises $0.74 to $1.24
i L00K great: folds 
Optimistic21: folds 
mexx1234: calls $1.24
Effort92: folds 
ruyingren: calls $0.74
*** FLOP *** [Kc 6c Kh]
ruyingren: checks 
TonnaMunz: checks 
mexx1234: bets $2.28
ruyingren: folds 
TonnaMunz: folds 
Uncalled bet ($2.28) returned to mexx1234
mexx1234 collected $4.56 from pot
mexx1234: doesn't show hand 
*** SUMMARY ***
Total pot $4.77 | Rake $0.21 
Board [Kc 6c Kh]
Seat 1: mexx1234 (button) collected ($4.56)
Seat 2: Effort92 (small blind) folded before Flop
Seat 3: ruyingren (big blind) folded on the Flop
Seat 4: matiko09 folded before Flop (didn't bet)
Seat 5: vlad11122007 folded before Flop (didn't bet)
Seat 6: TonnaMunz folded on the Flop
Seat 7: i L00K great folded before Flop (didn't bet)
Seat 8: Optimistic21 folded before Flop (didn't bet)





PokerStars Hand #148607444592:  Hold'em Pot Limit ($0.25/$0.50 USD) - 2016/02/11 12:27:25 CET [2016/02/11 6:27:25 ET]
Table 'Tinette' 9-max Seat #6 is the button
Seat 4: itzAddiction ($50.54 in chips) 
Seat 6: PokerAleman ($63.37 in chips) 
Seat 7: Red_Warning ($50 in chips) 
Seat 8: matiko09 ($52 in chips) 
Seat 9: Optimistic21 ($50 in chips) 
Red_Warning: posts small blind $0.25
matiko09: posts big blind $0.50
*** HOLE CARDS ***
Dealt to matiko09 [8s Qh]
Optimistic21: folds 
itzAddiction: folds 
PokerAleman: raises $0.50 to $1
Red_Warning: folds 
matiko09: folds 
Uncalled bet ($0.50) returned to PokerAleman
PokerAleman collected $1.25 from pot
PokerAleman: doesn't show hand 
*** SUMMARY ***
Total pot $1.25 | Rake $0 
Seat 4: itzAddiction folded before Flop (didn't bet)
Seat 6: PokerAleman (button) collected ($1.25)
Seat 7: Red_Warning (small blind) folded before Flop
Seat 8: matiko09 (big blind) folded before Flop
Seat 9: Optimistic21 folded before Flop (didn't bet)





PokerStars Hand #148607448956:  Hold'em No Limit ($0.25/$0.50 USD) - 2016/02/11 12:27:33 CET [2016/02/11 6:27:33 ET]
Table 'Hunan' 9-max Seat #4 is the button
Seat 1: matiko09 ($51.25 in chips) 
Seat 2: smirnoff993 ($143.07 in chips) 
Seat 3: TheMinion ($59.11 in chips) 
Seat 4: banit7 ($50.50 in chips) 
Seat 5: Honk115 ($41.70 in chips) 
Seat 6: i L00K great ($60.41 in chips) 
Seat 7: SForces33 ($27.05 in chips) 
Seat 8: Reven9er ($55.20 in chips) 
Seat 9: Optimistic21 ($51.96 in chips) 
Honk115: posts small blind $0.25
i L00K great: posts big blind $0.50
*** HOLE CARDS ***
Dealt to matiko09 [3h 3d]
SForces33: folds 
Reven9er: folds 
Optimistic21: folds 
matiko09: raises $1 to $1.50
smirnoff993: folds 
TheMinion: folds 
banit7: folds 
Honk115: folds 
i L00K great: folds 
Uncalled bet ($1) returned to matiko09
matiko09 collected $1.25 from pot
matiko09: doesn't show hand 
*** SUMMARY ***
Total pot $1.25 | Rake $0 
Seat 1: matiko09 collected ($1.25)
Seat 2: smirnoff993 folded before Flop (didn't bet)
Seat 3: TheMinion folded before Flop (didn't bet)
Seat 4: banit7 (button) folded before Flop (didn't bet)
Seat 5: Honk115 (small blind) folded before Flop
Seat 6: i L00K great (big blind) folded before Flop
Seat 7: SForces33 folded before Flop (didn't bet)
Seat 8: Reven9er folded before Flop (didn't bet)
Seat 9: Optimistic21 folded before Flop (didn't bet)





PokerStars Hand #148607449830:  Hold'em No Limit ($0.25/$0.50 USD) - 2016/02/11 12:27:35 CET [2016/02/11 6:27:35 ET]
Table 'Amor II' 9-max Seat #7 is the button
Seat 2: GusenokRUS ($84.62 in chips) 
Seat 3: TheMinion ($60.97 in chips) 
Seat 4: Larzdog29 ($48.02 in chips) 
Seat 5: Optimistic21 ($52.19 in chips) 
Seat 6: matiko09 ($50 in chips) 
Seat 7: banit7 ($50.86 in chips) 
Seat 8: Reven9er ($61.68 in chips) 
Seat 9: tallonn88 ($52 in chips) 
Reven9er: posts small blind $0.25
tallonn88: posts big blind $0.50
Kud3: sits out 
*** HOLE CARDS ***
Dealt to matiko09 [3d 6c]
GusenokRUS: folds 
TheMinion: folds 
Larzdog29: folds 
Optimistic21: folds 
matiko09: folds 
banit7: folds 
Reven9er: folds 
Uncalled bet ($0.25) returned to tallonn88
tallonn88 collected $0.50 from pot
tallonn88: doesn't show hand 
*** SUMMARY ***
Total pot $0.50 | Rake $0 
Seat 2: GusenokRUS folded before Flop (didn't bet)
Seat 3: TheMinion folded before Flop (didn't bet)
Seat 4: Larzdog29 folded before Flop (didn't bet)
Seat 5: Optimistic21 folded before Flop (didn't bet)
Seat 6: matiko09 folded before Flop (didn't bet)
Seat 7: banit7 (button) folded before Flop (didn't bet)
Seat 8: Reven9er (small blind) folded before Flop
Seat 9: tallonn88 (big blind) collected ($0.50)





PokerStars Hand #148607451233:  Hold'em No Limit ($0.50/$1.00 USD) - 2016/02/11 12:27:37 CET [2016/02/11 6:27:37 ET]
Table 'Sycorax II' 9-max Seat #7 is the button
Seat 1: Luck In Me ($107.26 in chips) 
Seat 2: Lujan87 ($104.21 in chips) 
Seat 4: Sweden_Pound ($145.74 in chips) 
Seat 5: Effort92 ($100 in chips) 
Seat 6: FluentFlows ($46.50 in chips) 
Seat 7: hurtNCYDE ($117.38 in chips) 
Seat 8: matiko09 ($130.87 in chips) 
Seat 9: mrfoldcall ($93.50 in chips) 
matiko09: posts small blind $0.50
mrfoldcall: posts big blind $1
chauyeuba: sits out 
*** HOLE CARDS ***
Dealt to matiko09 [9d Ad]
Luck In Me: folds 
Lujan87: raises $2 to $3
Sweden_Pound: folds 
Effort92: folds 
FluentFlows: folds 
hurtNCYDE: folds 
matiko09: folds 
mrfoldcall: calls $2
*** FLOP *** [4h 9c As]
mrfoldcall: checks 
Lujan87: bets $3.67
mrfoldcall: calls $3.67
*** TURN *** [4h 9c As] [6s]
mrfoldcall: checks 
Lujan87: bets $9
mrfoldcall: calls $9
*** RIVER *** [4h 9c As 6s] [6d]
mrfoldcall: checks 
Lujan87: checks 
*** SHOW DOWN ***
mrfoldcall: shows [Ah Jd] (two pair, Aces and Sixes)
Lujan87: mucks hand 
mrfoldcall collected $30.41 from pot
*** SUMMARY ***
Total pot $31.84 | Rake $1.43 
Board [4h 9c As 6s 6d]
Seat 1: Luck In Me folded before Flop (didn't bet)
Seat 2: Lujan87 mucked [Ts Js]
Seat 4: Sweden_Pound folded before Flop (didn't bet)
Seat 5: Effort92 folded before Flop (didn't bet)
Seat 6: FluentFlows folded before Flop (didn't bet)
Seat 7: hurtNCYDE (button) folded before Flop (didn't bet)
Seat 8: matiko09 (small blind) folded before Flop
Seat 9: mrfoldcall (big blind) showed [Ah Jd] and won ($30.41) with two pair, Aces and Sixes





PokerStars Hand #148607451702:  Hold'em No Limit ($0.25/$0.50 USD) - 2016/02/11 12:27:38 CET [2016/02/11 6:27:38 ET]
Table 'Algedi' 9-max Seat #2 is the button
Seat 1: vlad11122007 ($51.27 in chips) 
Seat 2: TuaaL ($67.40 in chips) 
Seat 4: Effort92 ($51.97 in chips) 
Seat 6: TonnaMunz ($127.31 in chips) 
Seat 7: hoedtrob ($60.97 in chips) 
Seat 8: matiko09 ($50 in chips) 
Effort92: posts small blind $0.25
TonnaMunz: posts big blind $0.50
Kud3: sits out 
vlad11122007: posts the ante $0.10
TuaaL: posts the ante $0.10
Effort92: posts the ante $0.10
TonnaMunz: posts the ante $0.10
hoedtrob: posts the ante $0.10
matiko09: posts the ante $0.10
*** HOLE CARDS ***
Dealt to matiko09 [Ac Js]
hoedtrob: folds 
Kud3 said, "so tonna i send stars an email"
Kud3 said, "cause u blocking all tables"
matiko09: raises $1 to $1.50
Kud3 said, "and people dont join"
vlad11122007: folds 
TuaaL: calls $1.50
Effort92: folds 
TonnaMunz: folds 
*** FLOP *** [Qd 7d Qs]
matiko09: checks 
TuaaL: checks 
*** TURN *** [Qd 7d Qs] [6d]
matiko09: checks 
TuaaL: checks 
*** RIVER *** [Qd 7d Qs 6d] [5d]
hoedtrob said, "what do you mean, kud3?"
matiko09: checks 
TuaaL: bets $13
matiko09: folds 
Uncalled bet ($13) returned to TuaaL
TuaaL collected $4.15 from pot
TuaaL: doesn't show hand 
*** SUMMARY ***
Total pot $4.35 | Rake $0.20 
Board [Qd 7d Qs 6d 5d]
Seat 1: vlad11122007 folded before Flop (didn't bet)
Seat 2: TuaaL (button) collected ($4.15)
Seat 4: Effort92 (small blind) folded before Flop
Seat 6: TonnaMunz (big blind) folded before Flop
Seat 7: hoedtrob folded before Flop (didn't bet)
Seat 8: matiko09 folded on the River





PokerStars Hand #148607453257:  Hold'em Pot Limit ($0.25/$0.50 USD) - 2016/02/11 12:27:41 CET [2016/02/11 6:27:41 ET]
Table 'Tinette' 9-max Seat #7 is the button
Seat 4: itzAddiction ($50.54 in chips) 
Seat 6: PokerAleman ($64.12 in chips) 
Seat 7: Red_Warning ($50 in chips) 
Seat 8: matiko09 ($51.50 in chips) 
Seat 9: Optimistic21 ($50 in chips) 
matiko09: posts small blind $0.25
Optimistic21: posts big blind $0.50
*** HOLE CARDS ***
Dealt to matiko09 [Ah Qc]
itzAddiction: folds 
PokerAleman: folds 
Red_Warning: folds 
matiko09: raises $1 to $1.50
Optimistic21: raises $3 to $4.50
matiko09: calls $3
*** FLOP *** [9c 7h 5h]
matiko09: checks 
Optimistic21: bets $5.50
matiko09: folds 
Uncalled bet ($5.50) returned to Optimistic21
Optimistic21 collected $8.60 from pot
*** SUMMARY ***
Total pot $9 | Rake $0.40 
Board [9c 7h 5h]
Seat 4: itzAddiction folded before Flop (didn't bet)
Seat 6: PokerAleman folded before Flop (didn't bet)
Seat 7: Red_Warning (button) folded before Flop (didn't bet)
Seat 8: matiko09 (small blind) folded on the Flop
Seat 9: Optimistic21 (big blind) collected ($8.60)





PokerStars Hand #148607453662:  Hold'em No Limit ($0.25/$0.50 USD) - 2016/02/11 12:27:42 CET [2016/02/11 6:27:42 ET]
Table 'Stereoskopia' 9-max Seat #3 is the button
Seat 2: Optimistic21 ($50.50 in chips) 
Seat 3: Donko jr ($64.15 in chips) 
Seat 4: King brid ($68.47 in chips) 
Seat 5: ReinisRNS ($30.63 in chips) 
Seat 6: matiko09 ($53.82 in chips) 
Seat 7: tallonn88 ($50.50 in chips) 
Seat 8: banit7 ($84.03 in chips) 
Seat 9: anubis4455 ($42.42 in chips) 
King brid: posts small blind $0.25
ReinisRNS: posts big blind $0.50
*** HOLE CARDS ***
Dealt to matiko09 [4s Jd]
matiko09: folds 
tallonn88: raises $1 to $1.50
banit7: folds 
anubis4455: folds 
Optimistic21: folds 
Donko jr: raises $2.50 to $4
King brid: folds 
ReinisRNS: folds 
tallonn88: calls $2.50
*** FLOP *** [Ah 9h 3s]
tallonn88: checks 
Donko jr: bets $4.50
tallonn88: raises $8 to $12.50
Donko jr: calls $8
*** TURN *** [Ah 9h 3s] [7s]
tallonn88: bets $15
Donko jr: calls $15
*** RIVER *** [Ah 9h 3s 7s] [9s]
tallonn88: bets $19 and is all-in
Donko jr: calls $19
*** SHOW DOWN ***
tallonn88: shows [Ad Ks] (two pair, Aces and Nines)
Donko jr: mucks hand 
tallonn88 collected $99.25 from pot
*** SUMMARY ***
Total pot $101.75 | Rake $2.50 
Board [Ah 9h 3s 7s 9s]
Seat 2: Optimistic21 folded before Flop (didn't bet)
Seat 3: Donko jr (button) mucked [Kd Kc]
Seat 4: King brid (small blind) folded before Flop
Seat 5: ReinisRNS (big blind) folded before Flop
Seat 6: matiko09 folded before Flop (didn't bet)
Seat 7: tallonn88 showed [Ad Ks] and won ($99.25) with two pair, Aces and Nines
Seat 8: banit7 folded before Flop (didn't bet)
Seat 9: anubis4455 folded before Flop (didn't bet)





PokerStars Hand #148607457260:  Hold'em No Limit ($0.50/$1.00 USD) - 2016/02/11 12:27:49 CET [2016/02/11 6:27:49 ET]
Table 'Regor' 9-max Seat #9 is the button
Seat 1: matiko09 ($124.11 in chips) 
Seat 2: Luck In Me ($105.50 in chips) 
Seat 3: oscarleon ($100 in chips) 
Seat 5: chauyeuba ($48.50 in chips) 
Seat 8: R3NZONIT3 ($65.08 in chips) 
Seat 9: CoolFireX ($105 in chips) 
matiko09: posts small blind $0.50
Luck In Me: posts big blind $1
*** HOLE CARDS ***
Dealt to matiko09 [6h 5h]
oscarleon: folds 
chauyeuba: folds 
R3NZONIT3: raises $1 to $2
CoolFireX: raises $5.50 to $7.50
matiko09: folds 
Luck In Me: folds 
R3NZONIT3: calls $5.50
*** FLOP *** [9s 4d Kc]
R3NZONIT3: checks 
CoolFireX: bets $9
R3NZONIT3: folds 
Uncalled bet ($9) returned to CoolFireX
CoolFireX collected $15.76 from pot
CoolFireX: doesn't show hand 
*** SUMMARY ***
Total pot $16.50 | Rake $0.74 
Board [9s 4d Kc]
Seat 1: matiko09 (small blind) folded before Flop
Seat 2: Luck In Me (big blind) folded before Flop
Seat 3: oscarleon folded before Flop (didn't bet)
Seat 5: chauyeuba folded before Flop (didn't bet)
Seat 8: R3NZONIT3 folded on the Flop
Seat 9: CoolFireX (button) collected ($15.76)





PokerStars Hand #148607459213:  Hold'em No Limit ($0.25/$0.50 USD) - 2016/02/11 12:27:52 CET [2016/02/11 6:27:52 ET]
Table 'Ambrosia II' 9-max Seat #8 is the button
Seat 1: matiko09 ($52.87 in chips) 
Seat 2: TheMinion ($115.94 in chips) 
Seat 4: huudk2016 ($12.90 in chips) 
Seat 5: smirnoff993 ($63.11 in chips) 
Seat 6: Reven9er ($61.87 in chips) 
Seat 7: mexx1234 ($56.62 in chips) 
Seat 8: tallonn88 ($53.31 in chips) 
Seat 9: arctur17 ($54.79 in chips) 
arctur17: posts small blind $0.25
matiko09: posts big blind $0.50
make6a: sits out 
*** HOLE CARDS ***
Dealt to matiko09 [7s 3h]
TheMinion: folds 
huudk2016: calls $0.50
smirnoff993: folds 
Reven9er: folds 
mexx1234: folds 
tallonn88: folds 
arctur17: calls $0.25
matiko09: checks 
*** FLOP *** [6s 8d 9d]
arctur17: bets $1
matiko09: calls $1
huudk2016: calls $1
*** TURN *** [6s 8d 9d] [5s]
arctur17: bets $1
matiko09: raises $3.27 to $4.27
huudk2016: folds 
arctur17: calls $3.27
*** RIVER *** [6s 8d 9d 5s] [7d]
arctur17: bets $4.50
matiko09: folds 
Uncalled bet ($4.50) returned to arctur17
arctur17 collected $12.45 from pot
arctur17: doesn't show hand 
*** SUMMARY ***
Total pot $13.04 | Rake $0.59 
Board [6s 8d 9d 5s 7d]
Seat 1: matiko09 (big blind) folded on the River
Seat 2: TheMinion folded before Flop (didn't bet)
Seat 4: huudk2016 folded on the Turn
Seat 5: smirnoff993 folded before Flop (didn't bet)
Seat 6: Reven9er folded before Flop (didn't bet)
Seat 7: mexx1234 folded before Flop (didn't bet)
Seat 8: tallonn88 (button) folded before Flop (didn't bet)
Seat 9: arctur17 (small blind) collected ($12.45)





PokerStars Hand #148607467403:  Hold'em No Limit ($0.25/$0.50 USD) - 2016/02/11 12:28:08 CET [2016/02/11 6:28:08 ET]
Table 'Amor II' 9-max Seat #8 is the button
Seat 1: Kud3 ($53.23 in chips) 
Seat 2: GusenokRUS ($84.62 in chips) 
Seat 3: TheMinion ($60.97 in chips) 
Seat 4: Larzdog29 ($48.02 in chips) 
Seat 5: Optimistic21 ($52.19 in chips) 
Seat 6: matiko09 ($50 in chips) 
Seat 7: banit7 ($50.86 in chips) 
Seat 8: Reven9er ($61.43 in chips) 
Seat 9: tallonn88 ($52.25 in chips) 
tallonn88: posts small blind $0.25
Kud3: posts big blind $0.50
*** HOLE CARDS ***
Dealt to matiko09 [6h 9d]
GusenokRUS: folds 
TheMinion: folds 
Larzdog29: folds 
Optimistic21: raises $1 to $1.50
matiko09: folds 
banit7: folds 
Reven9er: folds 
tallonn88: folds 
Kud3: calls $1
*** FLOP *** [8d Ks As]
Kud3: checks 
Optimistic21: bets $2
Kud3: calls $2
*** TURN *** [8d Ks As] [4d]
Kud3: checks 
Optimistic21: bets $4.50
Kud3: calls $4.50
*** RIVER *** [8d Ks As 4d] [Jd]
Kud3: checks 
Optimistic21: bets $9.50
Kud3: calls $9.50
*** SHOW DOWN ***
Optimistic21: shows [Ad Td] (a flush, Ace high)
Kud3: mucks hand 
Optimistic21 collected $33.66 from pot
*** SUMMARY ***
Total pot $35.25 | Rake $1.59 
Board [8d Ks As 4d Jd]
Seat 1: Kud3 (big blind) mucked [Ac Qd]
Seat 2: GusenokRUS folded before Flop (didn't bet)
Seat 3: TheMinion folded before Flop (didn't bet)
Seat 4: Larzdog29 folded before Flop (didn't bet)
Seat 5: Optimistic21 showed [Ad Td] and won ($33.66) with a flush, Ace high
Seat 6: matiko09 folded before Flop (didn't bet)
Seat 7: banit7 folded before Flop (didn't bet)
Seat 8: Reven9er (button) folded before Flop (didn't bet)
Seat 9: tallonn88 (small blind) folded before Flop





PokerStars Hand #148607476252:  Hold'em Pot Limit ($0.25/$0.50 USD) - 2016/02/11 12:28:24 CET [2016/02/11 6:28:24 ET]
Table 'Tinette' 9-max Seat #8 is the button
Seat 4: itzAddiction ($50.54 in chips) 
Seat 6: PokerAleman ($64.12 in chips) 
Seat 7: Red_Warning ($50 in chips) 
Seat 8: matiko09 ($50 in chips) 
Seat 9: Optimistic21 ($54.10 in chips) 
Optimistic21: posts small blind $0.25
itzAddiction: posts big blind $0.50
*** HOLE CARDS ***
Dealt to matiko09 [7c Kh]
PokerAleman: folds 
Red_Warning: folds 
matiko09: folds 
Optimistic21: raises $1 to $1.50
itzAddiction: calls $1
*** FLOP *** [6d 9d 3c]
Optimistic21: checks 
itzAddiction: checks 
*** TURN *** [6d 9d 3c] [5d]
Optimistic21: checks 
itzAddiction: checks 
*** RIVER *** [6d 9d 3c 5d] [Ac]
Optimistic21: bets $1.50
itzAddiction: calls $1.50
*** SHOW DOWN ***
Optimistic21: shows [Ah 4c] (a pair of Aces)
itzAddiction: mucks hand 
Optimistic21 collected $5.73 from pot
*** SUMMARY ***
Total pot $6 | Rake $0.27 
Board [6d 9d 3c 5d Ac]
Seat 4: itzAddiction (big blind) mucked [3h Jh]
Seat 6: PokerAleman folded before Flop (didn't bet)
Seat 7: Red_Warning folded before Flop (didn't bet)
Seat 8: matiko09 (button) folded before Flop (didn't bet)
Seat 9: Optimistic21 (small blind) showed [Ah 4c] and won ($5.73) with a pair of Aces





PokerStars Hand #148607476944:  Hold'em No Limit ($0.25/$0.50 USD) - 2016/02/11 12:28:26 CET [2016/02/11 6:28:26 ET]
Table 'Hunan' 9-max Seat #5 is the button
Seat 1: matiko09 ($52 in chips) 
Seat 2: smirnoff993 ($143.07 in chips) 
Seat 3: TheMinion ($59.11 in chips) 
Seat 4: banit7 ($50.50 in chips) 
Seat 5: Honk115 ($41.45 in chips) 
Seat 6: i L00K great ($59.91 in chips) 
Seat 7: SForces33 ($27.05 in chips) 
Seat 8: Reven9er ($55.20 in chips) 
Seat 9: Optimistic21 ($51.96 in chips) 
i L00K great: posts small blind $0.25
SForces33: posts big blind $0.50
*** HOLE CARDS ***
Dealt to matiko09 [6c 8c]
Reven9er: folds 
Optimistic21: folds 
matiko09: folds 
smirnoff993: folds 
TheMinion: folds 
banit7: folds 
Honk115: folds 
i L00K great: raises $1 to $1.50
SForces33: folds 
Uncalled bet ($1) returned to i L00K great
i L00K great collected $1 from pot
i L00K great: doesn't show hand 
*** SUMMARY ***
Total pot $1 | Rake $0 
Seat 1: matiko09 folded before Flop (didn't bet)
Seat 2: smirnoff993 folded before Flop (didn't bet)
Seat 3: TheMinion folded before Flop (didn't bet)
Seat 4: banit7 folded before Flop (didn't bet)
Seat 5: Honk115 (button) folded before Flop (didn't bet)
Seat 6: i L00K great (small blind) collected ($1)
Seat 7: SForces33 (big blind) folded before Flop
Seat 8: Reven9er folded before Flop (didn't bet)
Seat 9: Optimistic21 folded before Flop (didn't bet)





PokerStars Hand #148607478463:  Hold'em No Limit ($0.50/$1.00 USD) - 2016/02/11 12:28:29 CET [2016/02/11 6:28:29 ET]
Table 'Sycorax II' 9-max Seat #8 is the button
Seat 1: Luck In Me ($107.26 in chips) 
Seat 2: Lujan87 ($100 in chips) 
Seat 4: Sweden_Pound ($145.74 in chips) 
Seat 5: Effort92 ($100 in chips) 
Seat 6: FluentFlows ($46.50 in chips) 
Seat 7: hurtNCYDE ($117.38 in chips) 
Seat 8: matiko09 ($130.37 in chips) 
Seat 9: mrfoldcall ($108.24 in chips) 
mrfoldcall: posts small blind $0.50
Luck In Me: posts big blind $1
chauyeuba: sits out 
*** HOLE CARDS ***
Dealt to matiko09 [8c Jd]
Lujan87: folds 
Sweden_Pound: folds 
Effort92: folds 
FluentFlows: folds 
hurtNCYDE: folds 
matiko09: raises $1.50 to $2.50
mrfoldcall: folds 
Luck In Me: raises $6.50 to $9
matiko09: folds 
Uncalled bet ($6.50) returned to Luck In Me
Luck In Me collected $5.50 from pot
Luck In Me: doesn't show hand 
*** SUMMARY ***
Total pot $5.50 | Rake $0 
Seat 1: Luck In Me (big blind) collected ($5.50)
Seat 2: Lujan87 folded before Flop (didn't bet)
Seat 4: Sweden_Pound folded before Flop (didn't bet)
Seat 5: Effort92 folded before Flop (didn't bet)
Seat 6: FluentFlows folded before Flop (didn't bet)
Seat 7: hurtNCYDE folded before Flop (didn't bet)
Seat 8: matiko09 (button) folded before Flop
Seat 9: mrfoldcall (small blind) folded before Flop





PokerStars Hand #148607481472:  Hold'em No Limit ($0.25/$0.50 USD) - 2016/02/11 12:28:34 CET [2016/02/11 6:28:34 ET]
Table 'Sylvania II' 9-max Seat #2 is the button
Seat 1: mexx1234 ($195.32 in chips) 
Seat 2: Effort92 ($53.64 in chips) 
Seat 3: ruyingren ($184.53 in chips) 
Seat 4: matiko09 ($151.40 in chips) 
Seat 5: vlad11122007 ($49.80 in chips) 
Seat 6: TonnaMunz ($121.60 in chips) 
Seat 7: i L00K great ($53.13 in chips) 
Seat 8: Optimistic21 ($50 in chips) 
ruyingren: posts small blind $0.25
matiko09: posts big blind $0.50
Kud3: sits out 
mexx1234: posts the ante $0.10
Effort92: posts the ante $0.10
ruyingren: posts the ante $0.10
matiko09: posts the ante $0.10
vlad11122007: posts the ante $0.10
TonnaMunz: posts the ante $0.10
i L00K great: posts the ante $0.10
Optimistic21: posts the ante $0.10
*** HOLE CARDS ***
Dealt to matiko09 [9c Kh]
vlad11122007: folds 
TonnaMunz: folds 
i L00K great: folds 
Optimistic21: folds 
mexx1234: raises $0.75 to $1.25
Effort92: calls $1.25
ruyingren: folds 
matiko09: folds 
*** FLOP *** [5d 6c Ts]
mexx1234: bets $1.75
Effort92: calls $1.75
*** TURN *** [5d 6c Ts] [Ah]
mexx1234: checks 
Effort92: checks 
*** RIVER *** [5d 6c Ts Ah] [Td]
mexx1234: bets $2.52
Effort92: folds 
Uncalled bet ($2.52) returned to mexx1234
mexx1234 collected $7.21 from pot
mexx1234: doesn't show hand 
*** SUMMARY ***
Total pot $7.55 | Rake $0.34 
Board [5d 6c Ts Ah Td]
Seat 1: mexx1234 collected ($7.21)
Seat 2: Effort92 (button) folded on the River
Seat 3: ruyingren (small blind) folded before Flop
Seat 4: matiko09 (big blind) folded before Flop
Seat 5: vlad11122007 folded before Flop (didn't bet)
Seat 6: TonnaMunz folded before Flop (didn't bet)
Seat 7: i L00K great folded before Flop (didn't bet)
Seat 8: Optimistic21 folded before Flop (didn't bet)





PokerStars Hand #148607482938:  Hold'em No Limit ($0.50/$1.00 USD) - 2016/02/11 12:28:37 CET [2016/02/11 6:28:37 ET]
Table 'Regor' 9-max Seat #1 is the button
Seat 1: matiko09 ($123.61 in chips) 
Seat 2: Luck In Me ($104.50 in chips) 
Seat 3: oscarleon ($100 in chips) 
Seat 5: chauyeuba ($48.50 in chips) 
Seat 8: R3NZONIT3 ($57.58 in chips) 
Seat 9: CoolFireX ($113.26 in chips) 
Luck In Me: posts small blind $0.50
oscarleon: posts big blind $1
*** HOLE CARDS ***
Dealt to matiko09 [4h Ad]
chauyeuba: folds 
R3NZONIT3: folds 
CoolFireX: folds 
matiko09: raises $1.27 to $2.27
Luck In Me: folds 
oscarleon: folds 
Uncalled bet ($1.27) returned to matiko09
matiko09 collected $2.50 from pot
matiko09: doesn't show hand 
*** SUMMARY ***
Total pot $2.50 | Rake $0 
Seat 1: matiko09 (button) collected ($2.50)
Seat 2: Luck In Me (small blind) folded before Flop
Seat 3: oscarleon (big blind) folded before Flop
Seat 5: chauyeuba folded before Flop (didn't bet)
Seat 8: R3NZONIT3 folded before Flop (didn't bet)
Seat 9: CoolFireX folded before Flop (didn't bet)





PokerStars Hand #148607494547:  Hold'em Pot Limit ($0.25/$0.50 USD) - 2016/02/11 12:28:59 CET [2016/02/11 6:28:59 ET]
Table 'Tinette' 9-max Seat #9 is the button
Seat 4: itzAddiction ($47.54 in chips) 
Seat 5: 50CandyJoe ($69.50 in chips) 
Seat 6: PokerAleman ($64.12 in chips) 
Seat 7: Red_Warning ($50 in chips) 
Seat 8: matiko09 ($50 in chips) 
Seat 9: Optimistic21 ($56.83 in chips) 
itzAddiction: posts small blind $0.25
50CandyJoe: posts big blind $0.50
*** HOLE CARDS ***
Dealt to matiko09 [Td Qd]
PokerAleman: folds 
Red_Warning: raises $1 to $1.50
matiko09: folds 
Optimistic21: folds 
itzAddiction: folds 
50CandyJoe: folds 
Uncalled bet ($1) returned to Red_Warning
Red_Warning collected $1.25 from pot
Red_Warning: doesn't show hand 
*** SUMMARY ***
Total pot $1.25 | Rake $0 
Seat 4: itzAddiction (small blind) folded before Flop
Seat 5: 50CandyJoe (big blind) folded before Flop
Seat 6: PokerAleman folded before Flop (didn't bet)
Seat 7: Red_Warning collected ($1.25)
Seat 8: matiko09 folded before Flop (didn't bet)
Seat 9: Optimistic21 (button) folded before Flop (didn't bet)





PokerStars Hand #148607494426:  Hold'em No Limit ($0.25/$0.50 USD) - 2016/02/11 12:28:59 CET [2016/02/11 6:28:59 ET]
Table 'Hunan' 9-max Seat #6 is the button
Seat 1: matiko09 ($52 in chips) 
Seat 2: smirnoff993 ($143.07 in chips) 
Seat 3: TheMinion ($59.11 in chips) 
Seat 4: banit7 ($50.50 in chips) 
Seat 5: Honk115 ($41.45 in chips) 
Seat 6: i L00K great ($60.41 in chips) 
Seat 7: SForces33 ($26.55 in chips) 
Seat 8: Reven9er ($55.20 in chips) 
Seat 9: Optimistic21 ($51.96 in chips) 
SForces33: posts small blind $0.25
Reven9er: posts big blind $0.50
*** HOLE CARDS ***
Dealt to matiko09 [7h As]
Optimistic21: raises $1 to $1.50
matiko09: folds 
smirnoff993: folds 
TheMinion: folds 
banit7: folds 
Honk115: calls $1.50
i L00K great: calls $1.50
SForces33: folds 
Reven9er: folds 
*** FLOP *** [4d 3s Kc]
Optimistic21: bets $3.50
Honk115: calls $3.50
i L00K great: folds 
*** TURN *** [4d 3s Kc] [5c]
Optimistic21: bets $6.50
Honk115: raises $6.50 to $13
Optimistic21: calls $6.50
*** RIVER *** [4d 3s Kc 5c] [6c]
Optimistic21: checks 
Honk115: checks 
*** SHOW DOWN ***
Optimistic21: shows [Qc Ks] (a pair of Kings)
Honk115: shows [3h 3c] (three of a kind, Threes)
Honk115 collected $36.53 from pot
*** SUMMARY ***
Total pot $38.25 | Rake $1.72 
Board [4d 3s Kc 5c 6c]
Seat 1: matiko09 folded before Flop (didn't bet)
Seat 2: smirnoff993 folded before Flop (didn't bet)
Seat 3: TheMinion folded before Flop (didn't bet)
Seat 4: banit7 folded before Flop (didn't bet)
Seat 5: Honk115 showed [3h 3c] and won ($36.53) with three of a kind, Threes
Seat 6: i L00K great (button) folded on the Flop
Seat 7: SForces33 (small blind) folded before Flop
Seat 8: Reven9er (big blind) folded before Flop
Seat 9: Optimistic21 showed [Qc Ks] and lost with a pair of Kings





PokerStars Hand #148607495326:  Hold'em No Limit ($0.25/$0.50 USD) - 2016/02/11 12:29:00 CET [2016/02/11 6:29:00 ET]
Table 'Algedi' 9-max Seat #4 is the button
Seat 1: vlad11122007 ($51.17 in chips) 
Seat 2: TuaaL ($69.95 in chips) 
Seat 4: Effort92 ($51.62 in chips) 
Seat 6: TonnaMunz ($126.71 in chips) 
Seat 7: hoedtrob ($60.87 in chips) 
Seat 8: matiko09 ($50 in chips) 
TonnaMunz: posts small blind $0.25
hoedtrob: posts big blind $0.50
Kud3: sits out 
vlad11122007: posts the ante $0.10
TuaaL: posts the ante $0.10
Effort92: posts the ante $0.10
TonnaMunz: posts the ante $0.10
hoedtrob: posts the ante $0.10
matiko09: posts the ante $0.10
*** HOLE CARDS ***
Dealt to matiko09 [4c Qd]
matiko09: folds 
vlad11122007: folds 
TuaaL: calls $0.50
Effort92: raises $1.50 to $2
TonnaMunz: folds 
hoedtrob: folds 
TuaaL: calls $1.50
*** FLOP *** [Jd 5d 3c]
TuaaL: checks 
Effort92: bets $2.70
TuaaL: folds 
Uncalled bet ($2.70) returned to Effort92
Effort92 collected $5.11 from pot
Effort92: doesn't show hand 
*** SUMMARY ***
Total pot $5.35 | Rake $0.24 
Board [Jd 5d 3c]
Seat 1: vlad11122007 folded before Flop (didn't bet)
Seat 2: TuaaL folded on the Flop
Seat 4: Effort92 (button) collected ($5.11)
Seat 6: TonnaMunz (small blind) folded before Flop
Seat 7: hoedtrob (big blind) folded before Flop
Seat 8: matiko09 folded before Flop (didn't bet)





PokerStars Hand #148607496535:  Hold'em No Limit (€0.25/€0.50 EUR) - 2016/02/11 12:29:03 CET [2016/02/11 6:29:03 ET]
Table 'Otero II' 9-max Seat #9 is the button
Seat 1: Nacho2556 (€39 in chips) 
Seat 3: chaogoose82 (€67.43 in chips) 
Seat 5: vlad11122007 (€50 in chips) 
Seat 6: TonnaMunz (€53.44 in chips) 
Seat 7: PacPacBum (€50.18 in chips) 
Seat 8: matiko09 (€64.58 in chips) 
Seat 9: Optimistic21 (€59.29 in chips) 
Nacho2556: posts small blind €0.25
100+x: is sitting out 
chaogoose82: posts big blind €0.50
*** HOLE CARDS ***
Dealt to matiko09 [4s Js]
vlad11122007: raises €1 to €1.50
TonnaMunz: folds 
PacPacBum: folds 
matiko09: folds 
Optimistic21: folds 
Nacho2556: raises €3.50 to €5
chaogoose82: folds 
vlad11122007: folds 
Uncalled bet (€3.50) returned to Nacho2556
Nacho2556 collected €3.50 from pot
*** SUMMARY ***
Total pot €3.50 | Rake €0 
Seat 1: Nacho2556 (small blind) collected (€3.50)
Seat 3: chaogoose82 (big blind) folded before Flop
Seat 5: vlad11122007 folded before Flop
Seat 6: TonnaMunz folded before Flop (didn't bet)
Seat 7: PacPacBum folded before Flop (didn't bet)
Seat 8: matiko09 folded before Flop (didn't bet)
Seat 9: Optimistic21 (button) folded before Flop (didn't bet)





PokerStars Hand #148607496715:  Hold'em No Limit ($0.25/$0.50 USD) - 2016/02/11 12:29:03 CET [2016/02/11 6:29:03 ET]
Table 'Amor II' 9-max Seat #9 is the button
Seat 1: Kud3 ($50 in chips) 
Seat 2: GusenokRUS ($84.62 in chips) 
Seat 3: TheMinion ($60.97 in chips) 
Seat 4: Larzdog29 ($48.02 in chips) 
Seat 5: Optimistic21 ($68.35 in chips) 
Seat 6: matiko09 ($50 in chips) 
Seat 7: banit7 ($50.86 in chips) 
Seat 8: Reven9er ($61.43 in chips) 
Seat 9: tallonn88 ($52 in chips) 
Kud3: posts small blind $0.25
GusenokRUS: posts big blind $0.50
*** HOLE CARDS ***
Dealt to matiko09 [2c Ah]
Kud3 said, "lol"
TheMinion: raises $1 to $1.50
Kud3 said, "solid turnbet"
Larzdog29: folds 
Optimistic21: calls $1.50
matiko09: folds 
banit7: folds 
Reven9er: folds 
tallonn88: calls $1.50
Kud3: calls $1.25
GusenokRUS: calls $1
*** FLOP *** [8c Ts Kh]
Kud3: checks 
GusenokRUS: checks 
TheMinion: checks 
Optimistic21: bets $5
tallonn88: calls $5
Kud3: folds 
GusenokRUS: folds 
TheMinion: folds 
*** TURN *** [8c Ts Kh] [5s]
Optimistic21: bets $10.50
tallonn88: calls $10.50
*** RIVER *** [8c Ts Kh 5s] [9c]
Optimistic21: checks 
tallonn88: bets $35 and is all-in
Optimistic21: calls $35
*** SHOW DOWN ***
tallonn88: shows [Js Qs] (a straight, Nine to King)
Optimistic21: mucks hand 
tallonn88 collected $106 from pot
*** SUMMARY ***
Total pot $108.50 | Rake $2.50 
Board [8c Ts Kh 5s 9c]
Seat 1: Kud3 (small blind) folded on the Flop
Seat 2: GusenokRUS (big blind) folded on the Flop
Seat 3: TheMinion folded on the Flop
Seat 4: Larzdog29 folded before Flop (didn't bet)
Seat 5: Optimistic21 mucked [Tc Td]
Seat 6: matiko09 folded before Flop (didn't bet)
Seat 7: banit7 folded before Flop (didn't bet)
Seat 8: Reven9er folded before Flop (didn't bet)
Seat 9: tallonn88 (button) showed [Js Qs] and won ($106) with a straight, Nine to King





PokerStars Hand #148607497160:  Hold'em No Limit ($0.50/$1.00 USD) - 2016/02/11 12:29:04 CET [2016/02/11 6:29:04 ET]
Table 'Sycorax II' 9-max Seat #9 is the button
Seat 1: Luck In Me ($110.26 in chips) 
Seat 2: Lujan87 ($100 in chips) 
Seat 4: Sweden_Pound ($145.74 in chips) 
Seat 5: Effort92 ($100 in chips) 
Seat 6: FluentFlows ($46.50 in chips) 
Seat 7: hurtNCYDE ($117.38 in chips) 
Seat 8: matiko09 ($127.87 in chips) 
Seat 9: mrfoldcall ($107.74 in chips) 
Luck In Me: posts small blind $0.50
Lujan87: posts big blind $1
chauyeuba: sits out 
*** HOLE CARDS ***
Dealt to matiko09 [9c Kh]
Sweden_Pound: folds 
Effort92: folds 
FluentFlows: raises $2 to $3
hurtNCYDE: folds 
matiko09: folds 
mrfoldcall: folds 
Luck In Me: folds 
Lujan87: folds 
Uncalled bet ($2) returned to FluentFlows
FluentFlows collected $2.50 from pot
FluentFlows: doesn't show hand 
*** SUMMARY ***
Total pot $2.50 | Rake $0 
Seat 1: Luck In Me (small blind) folded before Flop
Seat 2: Lujan87 (big blind) folded before Flop
Seat 4: Sweden_Pound folded before Flop (didn't bet)
Seat 5: Effort92 folded before Flop (didn't bet)
Seat 6: FluentFlows collected ($2.50)
Seat 7: hurtNCYDE folded before Flop (didn't bet)
Seat 8: matiko09 folded before Flop (didn't bet)
Seat 9: mrfoldcall (button) folded before Flop (didn't bet)





PokerStars Hand #148607505371:  Hold'em No Limit ($0.50/$1.00 USD) - 2016/02/11 12:29:19 CET [2016/02/11 6:29:19 ET]
Table 'Regor' 9-max Seat #2 is the button
Seat 1: matiko09 ($125.11 in chips) 
Seat 2: Luck In Me ($104 in chips) 
Seat 3: oscarleon ($100 in chips) 
Seat 5: chauyeuba ($48.50 in chips) 
Seat 8: R3NZONIT3 ($57.58 in chips) 
Seat 9: CoolFireX ($113.26 in chips) 
oscarleon: posts small blind $0.50
chauyeuba: posts big blind $1
*** HOLE CARDS ***
Dealt to matiko09 [5d Qs]
gwwsb joins the table at seat #7 
R3NZONIT3: folds 
PacPacBum joins the table at seat #4 
CoolFireX: folds 
PacPacBum leaves the table
matiko09: folds 
Luck In Me: folds 
oscarleon: raises $2 to $3
chauyeuba: folds 
Uncalled bet ($2) returned to oscarleon
oscarleon collected $2 from pot
oscarleon: doesn't show hand 
*** SUMMARY ***
Total pot $2 | Rake $0 
Seat 1: matiko09 folded before Flop (didn't bet)
Seat 2: Luck In Me (button) folded before Flop (didn't bet)
Seat 3: oscarleon (small blind) collected ($2)
Seat 5: chauyeuba (big blind) folded before Flop
Seat 8: R3NZONIT3 folded before Flop (didn't bet)
Seat 9: CoolFireX folded before Flop (didn't bet)





PokerStars Hand #148607512704:  Hold'em No Limit ($0.50/$1.00 USD) - 2016/02/11 12:29:33 CET [2016/02/11 6:29:33 ET]
Table 'Sycorax II' 9-max Seat #1 is the button
Seat 1: Luck In Me ($109.76 in chips) 
Seat 2: Lujan87 ($100 in chips) 
Seat 3: chauyeuba ($50 in chips) 
Seat 4: Sweden_Pound ($145.74 in chips) 
Seat 5: Effort92 ($100 in chips) 
Seat 6: FluentFlows ($48 in chips) 
Seat 7: hurtNCYDE ($117.38 in chips) 
Seat 8: matiko09 ($127.87 in chips) 
Seat 9: mrfoldcall ($107.74 in chips) 
Lujan87: posts small blind $0.50
chauyeuba: posts big blind $1
*** HOLE CARDS ***
Dealt to matiko09 [5c 8c]
Sweden_Pound: folds 
Effort92: folds 
FluentFlows: raises $2 to $3
hurtNCYDE: folds 
matiko09: folds 
mrfoldcall: folds 
Luck In Me: folds 
Lujan87: folds 
chauyeuba: folds 
Uncalled bet ($2) returned to FluentFlows
FluentFlows collected $2.50 from pot
FluentFlows: doesn't show hand 
*** SUMMARY ***
Total pot $2.50 | Rake $0 
Seat 1: Luck In Me (button) folded before Flop (didn't bet)
Seat 2: Lujan87 (small blind) folded before Flop
Seat 3: chauyeuba (big blind) folded before Flop
Seat 4: Sweden_Pound folded before Flop (didn't bet)
Seat 5: Effort92 folded before Flop (didn't bet)
Seat 6: FluentFlows collected ($2.50)
Seat 7: hurtNCYDE folded before Flop (didn't bet)
Seat 8: matiko09 folded before Flop (didn't bet)
Seat 9: mrfoldcall folded before Flop (didn't bet)





PokerStars Hand #148607513003:  Hold'em No Limit ($0.25/$0.50 USD) - 2016/02/11 12:29:34 CET [2016/02/11 6:29:34 ET]
Table 'Ambrosia II' 9-max Seat #9 is the button
Seat 1: matiko09 ($50 in chips) 
Seat 2: TheMinion ($115.94 in chips) 
Seat 4: huudk2016 ($11.40 in chips) 
Seat 5: smirnoff993 ($63.11 in chips) 
Seat 6: Reven9er ($61.87 in chips) 
Seat 7: mexx1234 ($56.62 in chips) 
Seat 8: tallonn88 ($53.31 in chips) 
Seat 9: arctur17 ($61.47 in chips) 
matiko09: posts small blind $0.25
TheMinion: posts big blind $0.50
make6a: sits out 
*** HOLE CARDS ***
Dealt to matiko09 [Kh 2d]
huudk2016: folds 
smirnoff993: folds 
Reven9er: folds 
mexx1234: folds 
tallonn88: folds 
arctur17: folds 
matiko09: folds 
Uncalled bet ($0.25) returned to TheMinion
TheMinion collected $0.50 from pot
TheMinion: doesn't show hand 
*** SUMMARY ***
Total pot $0.50 | Rake $0 
Seat 1: matiko09 (small blind) folded before Flop
Seat 2: TheMinion (big blind) collected ($0.50)
Seat 4: huudk2016 folded before Flop (didn't bet)
Seat 5: smirnoff993 folded before Flop (didn't bet)
Seat 6: Reven9er folded before Flop (didn't bet)
Seat 7: mexx1234 folded before Flop (didn't bet)
Seat 8: tallonn88 folded before Flop (didn't bet)
Seat 9: arctur17 (button) folded before Flop (didn't bet)





PokerStars Hand #148607513545:  Hold'em Pot Limit ($0.25/$0.50 USD) - 2016/02/11 12:29:35 CET [2016/02/11 6:29:35 ET]
Table 'Tinette' 9-max Seat #4 is the button
Seat 4: itzAddiction ($47.29 in chips) 
Seat 5: 50CandyJoe ($69 in chips) 
Seat 6: PokerAleman ($64.12 in chips) 
Seat 7: Red_Warning ($50.75 in chips) 
Seat 8: matiko09 ($50 in chips) 
Seat 9: Optimistic21 ($56.83 in chips) 
50CandyJoe: posts small blind $0.25
PokerAleman: posts big blind $0.50
*** HOLE CARDS ***
Dealt to matiko09 [8s 2h]
Red_Warning: folds 
Red_Warning leaves the table
matiko09: folds 
Optimistic21: raises $1 to $1.50
itzAddiction: folds 
50CandyJoe: folds 
PokerAleman: folds 
Uncalled bet ($1) returned to Optimistic21
Optimistic21 collected $1.25 from pot
*** SUMMARY ***
Total pot $1.25 | Rake $0 
Seat 4: itzAddiction (button) folded before Flop (didn't bet)
Seat 5: 50CandyJoe (small blind) folded before Flop
Seat 6: PokerAleman (big blind) folded before Flop
Seat 7: Red_Warning folded before Flop (didn't bet)
Seat 8: matiko09 folded before Flop (didn't bet)
Seat 9: Optimistic21 collected ($1.25)





PokerStars Hand #148607517023:  Hold'em No Limit ($0.25/$0.50 USD) - 2016/02/11 12:29:41 CET [2016/02/11 6:29:41 ET]
Table 'Algedi' 9-max Seat #6 is the button
Seat 1: vlad11122007 ($51.07 in chips) 
Seat 2: TuaaL ($67.85 in chips) 
Seat 4: Effort92 ($54.63 in chips) 
Seat 6: TonnaMunz ($126.36 in chips) 
Seat 7: hoedtrob ($60.27 in chips) 
Seat 8: matiko09 ($50 in chips) 
hoedtrob: posts small blind $0.25
matiko09: posts big blind $0.50
Kud3: sits out 
vlad11122007: posts the ante $0.10
TuaaL: posts the ante $0.10
Effort92: posts the ante $0.10
TonnaMunz: posts the ante $0.10
hoedtrob: posts the ante $0.10
matiko09: posts the ante $0.10
*** HOLE CARDS ***
Dealt to matiko09 [6h Qc]
vlad11122007: folds 
TuaaL: folds 
TuaaL leaves the table
Effort92: raises $1 to $1.50
TonnaMunz: folds 
Kud3 said, "hes the reason"
Kud3 said, "for only 2 deep tables running"
hoedtrob: folds 
matiko09: folds 
Uncalled bet ($1) returned to Effort92
Effort92 collected $1.85 from pot
Effort92: doesn't show hand 
*** SUMMARY ***
Total pot $1.85 | Rake $0 
Seat 1: vlad11122007 folded before Flop (didn't bet)
Seat 2: TuaaL folded before Flop (didn't bet)
Seat 4: Effort92 collected ($1.85)
Seat 6: TonnaMunz (button) folded before Flop (didn't bet)
Seat 7: hoedtrob (small blind) folded before Flop
Seat 8: matiko09 (big blind) folded before Flop





PokerStars Hand #148607520771:  Hold'em Pot Limit ($0.25/$0.50 USD) - 2016/02/11 12:29:48 CET [2016/02/11 6:29:48 ET]
Table 'Tinette' 9-max Seat #5 is the button
Seat 4: itzAddiction ($47.29 in chips) 
Seat 5: 50CandyJoe ($68.75 in chips) 
Seat 6: PokerAleman ($63.62 in chips) 
Seat 8: matiko09 ($50 in chips) 
Seat 9: Optimistic21 ($57.58 in chips) 
PokerAleman: posts small blind $0.25
matiko09: posts big blind $0.50
*** HOLE CARDS ***
Dealt to matiko09 [Ad Qh]
Optimistic21: folds 
itzAddiction: folds 
50CandyJoe: raises $0.50 to $1
PokerAleman: calls $0.75
matiko09: raises $3 to $4
50CandyJoe: folds 
PokerAleman: folds 
Uncalled bet ($3) returned to matiko09
matiko09 collected $3 from pot
matiko09: doesn't show hand 
*** SUMMARY ***
Total pot $3 | Rake $0 
Seat 4: itzAddiction folded before Flop (didn't bet)
Seat 5: 50CandyJoe (button) folded before Flop
Seat 6: PokerAleman (small blind) folded before Flop
Seat 8: matiko09 (big blind) collected ($3)
Seat 9: Optimistic21 folded before Flop (didn't bet)





PokerStars Hand #148607521648:  Hold'em No Limit ($0.25/$0.50 USD) - 2016/02/11 12:29:50 CET [2016/02/11 6:29:50 ET]
Table 'Sylvania II' 9-max Seat #3 is the button
Seat 1: mexx1234 ($199.43 in chips) 
Seat 2: Effort92 ($50.54 in chips) 
Seat 3: ruyingren ($184.18 in chips) 
Seat 4: matiko09 ($150.80 in chips) 
Seat 5: vlad11122007 ($49.70 in chips) 
Seat 6: TonnaMunz ($121.50 in chips) 
Seat 7: i L00K great ($53.03 in chips) 
Seat 8: Optimistic21 ($50 in chips) 
matiko09: posts small blind $0.25
vlad11122007: posts big blind $0.50
Kud3: sits out 
mexx1234: posts the ante $0.10
Effort92: posts the ante $0.10
ruyingren: posts the ante $0.10
matiko09: posts the ante $0.10
vlad11122007: posts the ante $0.10
TonnaMunz: posts the ante $0.10
i L00K great: posts the ante $0.10
Optimistic21: posts the ante $0.10
*** HOLE CARDS ***
Dealt to matiko09 [3d 4d]
TonnaMunz: folds 
i L00K great: folds 
Optimistic21: folds 
mexx1234: folds 
Effort92: folds 
ruyingren: raises $1 to $1.50
matiko09: folds 
vlad11122007: folds 
Uncalled bet ($1) returned to ruyingren
ruyingren collected $2.05 from pot
ruyingren: doesn't show hand 
*** SUMMARY ***
Total pot $2.05 | Rake $0 
Seat 1: mexx1234 folded before Flop (didn't bet)
Seat 2: Effort92 folded before Flop (didn't bet)
Seat 3: ruyingren (button) collected ($2.05)
Seat 4: matiko09 (small blind) folded before Flop
Seat 5: vlad11122007 (big blind) folded before Flop
Seat 6: TonnaMunz folded before Flop (didn't bet)
Seat 7: i L00K great folded before Flop (didn't bet)
Seat 8: Optimistic21 folded before Flop (didn't bet)





PokerStars Hand #148607522662:  Hold'em No Limit (€0.25/€0.50 EUR) - 2016/02/11 12:29:52 CET [2016/02/11 6:29:52 ET]
Table 'Otero II' 9-max Seat #1 is the button
Seat 1: Nacho2556 (€41 in chips) 
Seat 3: chaogoose82 (€66.93 in chips) 
Seat 5: vlad11122007 (€48.50 in chips) 
Seat 6: TonnaMunz (€53.44 in chips) 
Seat 7: PacPacBum (€50.18 in chips) 
Seat 8: matiko09 (€64.58 in chips) 
Seat 9: Optimistic21 (€59.29 in chips) 
chaogoose82: posts small blind €0.25
vlad11122007: posts big blind €0.50
*** HOLE CARDS ***
Dealt to matiko09 [Qd 4s]
TonnaMunz: folds 
PacPacBum: folds 
matiko09: folds 
Optimistic21: folds 
Nacho2556: folds 
chaogoose82: calls €0.25
vlad11122007: raises €1.50 to €2
chaogoose82: calls €1.50
*** FLOP *** [6c Kh 2h]
chaogoose82: checks 
vlad11122007: bets €2.50
chaogoose82: calls €2.50
*** TURN *** [6c Kh 2h] [7s]
chaogoose82: checks 
vlad11122007: checks 
*** RIVER *** [6c Kh 2h 7s] [6h]
chaogoose82: bets €4.30
vlad11122007: folds 
Uncalled bet (€4.30) returned to chaogoose82
chaogoose82 collected €8.60 from pot
chaogoose82: doesn't show hand 
*** SUMMARY ***
Total pot €9 | Rake €0.40 
Board [6c Kh 2h 7s 6h]
Seat 1: Nacho2556 (button) folded before Flop (didn't bet)
Seat 3: chaogoose82 (small blind) collected (€8.60)
Seat 5: vlad11122007 (big blind) folded on the River
Seat 6: TonnaMunz folded before Flop (didn't bet)
Seat 7: PacPacBum folded before Flop (didn't bet)
Seat 8: matiko09 folded before Flop (didn't bet)
Seat 9: Optimistic21 folded before Flop (didn't bet)





PokerStars Hand #148607522905:  Hold'em No Limit ($0.50/$1.00 USD) - 2016/02/11 12:29:52 CET [2016/02/11 6:29:52 ET]
Table 'Regor' 9-max Seat #3 is the button
Seat 1: matiko09 ($125.11 in chips) 
Seat 2: Luck In Me ($104 in chips) 
Seat 3: oscarleon ($101 in chips) 
Seat 5: chauyeuba ($47.50 in chips) 
Seat 7: gwwsb ($40 in chips) 
Seat 8: R3NZONIT3 ($57.58 in chips) 
Seat 9: CoolFireX ($113.26 in chips) 
chauyeuba: posts small blind $0.50
gwwsb: posts big blind $1
*** HOLE CARDS ***
Dealt to matiko09 [2h Ad]
R3NZONIT3: folds 
CoolFireX: raises $2 to $3
matiko09: folds 
Luck In Me: folds 
oscarleon: folds 
chauyeuba: folds 
gwwsb: calls $2
*** FLOP *** [2c 3c 4d]
gwwsb: checks 
Filojoes joins the table at seat #4 
CoolFireX: bets $4.13
gwwsb: calls $4.13
*** TURN *** [2c 3c 4d] [Tc]
gwwsb: checks 
CoolFireX: bets $9.39
Dachish joins the table at seat #6 
gwwsb: raises $9.39 to $18.78
CoolFireX: folds 
Uncalled bet ($9.39) returned to gwwsb
gwwsb collected $32.03 from pot
gwwsb: doesn't show hand 
*** SUMMARY ***
Total pot $33.54 | Rake $1.51 
Board [2c 3c 4d Tc]
Seat 1: matiko09 folded before Flop (didn't bet)
Seat 2: Luck In Me folded before Flop (didn't bet)
Seat 3: oscarleon (button) folded before Flop (didn't bet)
Seat 5: chauyeuba (small blind) folded before Flop
Seat 7: gwwsb (big blind) collected ($32.03)
Seat 8: R3NZONIT3 folded before Flop (didn't bet)
Seat 9: CoolFireX folded on the Turn





PokerStars Hand #148607526339:  Hold'em No Limit ($0.25/$0.50 USD) - 2016/02/11 12:29:58 CET [2016/02/11 6:29:58 ET]
Table 'Ambrosia II' 9-max Seat #1 is the button
Seat 1: matiko09 ($50 in chips) 
Seat 2: TheMinion ($116.19 in chips) 
Seat 3: make6a ($50 in chips) 
Seat 4: huudk2016 ($11.40 in chips) 
Seat 5: smirnoff993 ($63.11 in chips) 
Seat 6: Reven9er ($61.87 in chips) 
Seat 7: mexx1234 ($56.62 in chips) 
Seat 8: tallonn88 ($53.31 in chips) 
Seat 9: arctur17 ($61.47 in chips) 
TheMinion: posts small blind $0.25
make6a: posts big blind $0.50
*** HOLE CARDS ***
Dealt to matiko09 [9h 5s]
huudk2016: folds 
smirnoff993: folds 
Reven9er: folds 
mexx1234: folds 
tallonn88: folds 
arctur17: folds 
matiko09: folds 
TheMinion: folds 
Uncalled bet ($0.25) returned to make6a
make6a collected $0.50 from pot
make6a: doesn't show hand 
*** SUMMARY ***
Total pot $0.50 | Rake $0 
Seat 1: matiko09 (button) folded before Flop (didn't bet)
Seat 2: TheMinion (small blind) folded before Flop
Seat 3: make6a (big blind) collected ($0.50)
Seat 4: huudk2016 folded before Flop (didn't bet)
Seat 5: smirnoff993 folded before Flop (didn't bet)
Seat 6: Reven9er folded before Flop (didn't bet)
Seat 7: mexx1234 folded before Flop (didn't bet)
Seat 8: tallonn88 folded before Flop (didn't bet)
Seat 9: arctur17 folded before Flop (didn't bet)





PokerStars Hand #148607526765:  Hold'em No Limit ($0.50/$1.00 USD) - 2016/02/11 12:29:59 CET [2016/02/11 6:29:59 ET]
Table 'Sycorax II' 9-max Seat #2 is the button
Seat 1: Luck In Me ($109.76 in chips) 
Seat 2: Lujan87 ($100 in chips) 
Seat 3: chauyeuba ($49 in chips) 
Seat 4: Sweden_Pound ($145.74 in chips) 
Seat 5: Effort92 ($100 in chips) 
Seat 6: FluentFlows ($49.50 in chips) 
Seat 7: hurtNCYDE ($117.38 in chips) 
Seat 8: matiko09 ($127.87 in chips) 
Seat 9: mrfoldcall ($107.74 in chips) 
chauyeuba: posts small blind $0.50
Sweden_Pound: posts big blind $1
*** HOLE CARDS ***
Dealt to matiko09 [8c Jc]
Effort92: folds 
FluentFlows: raises $2 to $3
hurtNCYDE: folds 
matiko09: folds 
mrfoldcall: folds 
Luck In Me: raises $4.50 to $7.50
Lujan87: folds 
chauyeuba: folds 
Sweden_Pound: folds 
FluentFlows: calls $4.50
*** FLOP *** [Ks 5s Ts]
FluentFlows: checks 
Luck In Me: bets $9
FluentFlows: folds 
Uncalled bet ($9) returned to Luck In Me
Luck In Me collected $15.76 from pot
Luck In Me: doesn't show hand 
*** SUMMARY ***
Total pot $16.50 | Rake $0.74 
Board [Ks 5s Ts]
Seat 1: Luck In Me collected ($15.76)
Seat 2: Lujan87 (button) folded before Flop (didn't bet)
Seat 3: chauyeuba (small blind) folded before Flop
Seat 4: Sweden_Pound (big blind) folded before Flop
Seat 5: Effort92 folded before Flop (didn't bet)
Seat 6: FluentFlows folded on the Flop
Seat 7: hurtNCYDE folded before Flop (didn't bet)
Seat 8: matiko09 folded before Flop (didn't bet)
Seat 9: mrfoldcall folded before Flop (didn't bet)





PokerStars Hand #148607532185:  Hold'em Pot Limit ($0.25/$0.50 USD) - 2016/02/11 12:30:08 CET [2016/02/11 6:30:08 ET]
Table 'Tinette' 9-max Seat #6 is the button
Seat 4: itzAddiction ($47.29 in chips) 
Seat 5: 50CandyJoe ($67.75 in chips) 
Seat 6: PokerAleman ($62.62 in chips) 
Seat 8: matiko09 ($52 in chips) 
Seat 9: Optimistic21 ($57.58 in chips) 
matiko09: posts small blind $0.25
Optimistic21: posts big blind $0.50
*** HOLE CARDS ***
Dealt to matiko09 [Js Jh]
itzAddiction: folds 
50CandyJoe: folds 
PokerAleman: raises $0.50 to $1
matiko09: raises $2.50 to $3.50
Optimistic21: folds 
PokerAleman: folds 
Uncalled bet ($2.50) returned to matiko09
matiko09 collected $2.50 from pot
matiko09: doesn't show hand 
*** SUMMARY ***
Total pot $2.50 | Rake $0 
Seat 4: itzAddiction folded before Flop (didn't bet)
Seat 5: 50CandyJoe folded before Flop (didn't bet)
Seat 6: PokerAleman (button) folded before Flop
Seat 8: matiko09 (small blind) collected ($2.50)
Seat 9: Optimistic21 (big blind) folded before Flop





PokerStars Hand #148607533625:  Hold'em No Limit ($0.25/$0.50 USD) - 2016/02/11 12:30:11 CET [2016/02/11 6:30:11 ET]
Table 'Stereoskopia' 9-max Seat #4 is the button
Seat 2: Optimistic21 ($50.50 in chips) 
Seat 3: Donko jr ($13.65 in chips) 
Seat 4: King brid ($68.22 in chips) 
Seat 5: ReinisRNS ($30.13 in chips) 
Seat 6: matiko09 ($53.82 in chips) 
Seat 7: tallonn88 ($99.25 in chips) 
Seat 8: banit7 ($84.03 in chips) 
Seat 9: anubis4455 ($42.42 in chips) 
ReinisRNS: posts small blind $0.25
matiko09: posts big blind $0.50
50CandyJoe: sits out 
*** HOLE CARDS ***
Dealt to matiko09 [8d 5h]
tallonn88: folds 
banit7: folds 
anubis4455: folds 
Optimistic21: folds 
Donko jr: folds 
King brid: calls $0.50
ReinisRNS: folds 
matiko09: checks 
*** FLOP *** [Qd Jh 9c]
matiko09: checks 
King brid: bets $0.50
matiko09: folds 
Uncalled bet ($0.50) returned to King brid
anubis4455 leaves the table
King brid collected $1.19 from pot
King brid: doesn't show hand 
*** SUMMARY ***
Total pot $1.25 | Rake $0.06 
Board [Qd Jh 9c]
Seat 2: Optimistic21 folded before Flop (didn't bet)
Seat 3: Donko jr folded before Flop (didn't bet)
Seat 4: King brid (button) collected ($1.19)
Seat 5: ReinisRNS (small blind) folded before Flop
Seat 6: matiko09 (big blind) folded on the Flop
Seat 7: tallonn88 folded before Flop (didn't bet)
Seat 8: banit7 folded before Flop (didn't bet)
Seat 9: anubis4455 folded before Flop (didn't bet)





PokerStars Hand #148607540498:  Hold'em No Limit ($0.25/$0.50 USD) - 2016/02/11 12:30:24 CET [2016/02/11 6:30:24 ET]
Table 'Algedi' 9-max Seat #7 is the button
Seat 1: vlad11122007 ($50.97 in chips) 
Seat 4: Effort92 ($55.88 in chips) 
Seat 6: TonnaMunz ($126.26 in chips) 
Seat 7: hoedtrob ($59.92 in chips) 
Seat 8: matiko09 ($50 in chips) 
Seat 9: Kud3 ($127.12 in chips) 
matiko09: posts small blind $0.25
Kud3: posts big blind $0.50
vlad11122007: posts the ante $0.10
Effort92: posts the ante $0.10
TonnaMunz: posts the ante $0.10
hoedtrob: posts the ante $0.10
matiko09: posts the ante $0.10
Kud3: posts the ante $0.10
*** HOLE CARDS ***
Dealt to matiko09 [Qs Kh]
vlad11122007: folds 
Effort92: folds 
TonnaMunz: folds 
hoedtrob: folds 
matiko09: raises $1 to $1.50
Kud3: folds 
Uncalled bet ($1) returned to matiko09
matiko09 collected $1.60 from pot
matiko09: doesn't show hand 
*** SUMMARY ***
Total pot $1.60 | Rake $0 
Seat 1: vlad11122007 folded before Flop (didn't bet)
Seat 4: Effort92 folded before Flop (didn't bet)
Seat 6: TonnaMunz folded before Flop (didn't bet)
Seat 7: hoedtrob (button) folded before Flop (didn't bet)
Seat 8: matiko09 (small blind) collected ($1.60)
Seat 9: Kud3 (big blind) folded before Flop





PokerStars Hand #148607541059:  Hold'em No Limit ($0.25/$0.50 USD) - 2016/02/11 12:30:25 CET [2016/02/11 6:30:25 ET]
Table 'Sylvania II' 9-max Seat #4 is the button
Seat 1: mexx1234 ($199.33 in chips) 
Seat 2: Effort92 ($50.44 in chips) 
Seat 3: ruyingren ($185.63 in chips) 
Seat 4: matiko09 ($150.45 in chips) 
Seat 5: vlad11122007 ($49.10 in chips) 
Seat 6: TonnaMunz ($121.40 in chips) 
Seat 7: i L00K great ($52.93 in chips) 
Seat 8: Optimistic21 ($50 in chips) 
vlad11122007: posts small blind $0.25
TonnaMunz: posts big blind $0.50
Kud3: sits out 
mexx1234: posts the ante $0.10
Effort92: posts the ante $0.10
ruyingren: posts the ante $0.10
matiko09: posts the ante $0.10
vlad11122007: posts the ante $0.10
TonnaMunz: posts the ante $0.10
i L00K great: posts the ante $0.10
Optimistic21: posts the ante $0.10
*** HOLE CARDS ***
Dealt to matiko09 [8s 7d]
i L00K great: folds 
Optimistic21: folds 
mexx1234: folds 
Effort92: folds 
ruyingren: folds 
matiko09: folds 
vlad11122007: folds 
Uncalled bet ($0.25) returned to TonnaMunz
TonnaMunz collected $1.30 from pot
TonnaMunz: doesn't show hand 
*** SUMMARY ***
Total pot $1.30 | Rake $0 
Seat 1: mexx1234 folded before Flop (didn't bet)
Seat 2: Effort92 folded before Flop (didn't bet)
Seat 3: ruyingren folded before Flop (didn't bet)
Seat 4: matiko09 (button) folded before Flop (didn't bet)
Seat 5: vlad11122007 (small blind) folded before Flop
Seat 6: TonnaMunz (big blind) collected ($1.30)
Seat 7: i L00K great folded before Flop (didn't bet)
Seat 8: Optimistic21 folded before Flop (didn't bet)





PokerStars Hand #148607547303:  Hold'em No Limit ($0.25/$0.50 USD) - 2016/02/11 12:30:36 CET [2016/02/11 6:30:36 ET]
Table 'Ambrosia II' 9-max Seat #2 is the button
Seat 1: matiko09 ($50 in chips) 
Seat 2: TheMinion ($115.94 in chips) 
Seat 3: make6a ($50.25 in chips) 
Seat 4: huudk2016 ($11.40 in chips) 
Seat 5: smirnoff993 ($63.11 in chips) 
Seat 6: Reven9er ($61.87 in chips) 
Seat 7: mexx1234 ($56.62 in chips) 
Seat 8: tallonn88 ($53.31 in chips) 
Seat 9: arctur17 ($61.47 in chips) 
make6a: posts small blind $0.25
huudk2016: posts big blind $0.50
*** HOLE CARDS ***
Dealt to matiko09 [Qh 2c]
smirnoff993: folds 
Reven9er: folds 
mexx1234: folds 
tallonn88: folds 
arctur17: raises $0.50 to $1
matiko09: folds 
TheMinion: folds 
make6a: folds 
huudk2016: calls $0.50
*** FLOP *** [5h Ah Ad]
huudk2016: checks 
arctur17: checks 
*** TURN *** [5h Ah Ad] [9s]
huudk2016: checks 
arctur17: bets $1
huudk2016: folds 
Uncalled bet ($1) returned to arctur17
arctur17 collected $2.15 from pot
arctur17: doesn't show hand 
*** SUMMARY ***
Total pot $2.25 | Rake $0.10 
Board [5h Ah Ad 9s]
Seat 1: matiko09 folded before Flop (didn't bet)
Seat 2: TheMinion (button) folded before Flop (didn't bet)
Seat 3: make6a (small blind) folded before Flop
Seat 4: huudk2016 (big blind) folded on the Turn
Seat 5: smirnoff993 folded before Flop (didn't bet)
Seat 6: Reven9er folded before Flop (didn't bet)
Seat 7: mexx1234 folded before Flop (didn't bet)
Seat 8: tallonn88 folded before Flop (didn't bet)
Seat 9: arctur17 collected ($2.15)





PokerStars Hand #148607550137:  Hold'em Pot Limit ($0.25/$0.50 USD) - 2016/02/11 12:30:41 CET [2016/02/11 6:30:41 ET]
Table 'Tinette' 9-max Seat #8 is the button
Seat 4: itzAddiction ($47.29 in chips) 
Seat 5: 50CandyJoe ($67.75 in chips) 
Seat 6: PokerAleman ($61.62 in chips) 
Seat 8: matiko09 ($53.50 in chips) 
Seat 9: Optimistic21 ($57.08 in chips) 
Optimistic21: posts small blind $0.25
itzAddiction: posts big blind $0.50
*** HOLE CARDS ***
Dealt to matiko09 [Th 4h]
50CandyJoe: folds 
PokerAleman: folds 
matiko09: folds 
Optimistic21: folds 
Uncalled bet ($0.25) returned to itzAddiction
itzAddiction collected $0.50 from pot
itzAddiction: doesn't show hand 
*** SUMMARY ***
Total pot $0.50 | Rake $0 
Seat 4: itzAddiction (big blind) collected ($0.50)
Seat 5: 50CandyJoe folded before Flop (didn't bet)
Seat 6: PokerAleman folded before Flop (didn't bet)
Seat 8: matiko09 (button) folded before Flop (didn't bet)
Seat 9: Optimistic21 (small blind) folded before Flop





PokerStars Hand #148607553497:  Hold'em No Limit ($0.25/$0.50 USD) - 2016/02/11 12:30:48 CET [2016/02/11 6:30:48 ET]
Table 'Stereoskopia' 9-max Seat #5 is the button
Seat 2: Optimistic21 ($50.50 in chips) 
Seat 3: Donko jr ($13.65 in chips) 
Seat 4: King brid ($68.91 in chips) 
Seat 5: ReinisRNS ($29.88 in chips) 
Seat 6: matiko09 ($53.32 in chips) 
Seat 7: tallonn88 ($99.25 in chips) 
Seat 8: banit7 ($84.03 in chips) 
matiko09: posts small blind $0.25
tallonn88: posts big blind $0.50
50CandyJoe: sits out 
*** HOLE CARDS ***
Dealt to matiko09 [As 6d]
banit7: folds 
apfush joins the table at seat #9 
Optimistic21: folds 
Donko jr: folds 
King brid: folds 
ReinisRNS: folds 
matiko09: raises $1 to $1.50
tallonn88: calls $1
*** FLOP *** [2h Ks 6h]
matiko09: bets $1.50
tallonn88: calls $1.50
*** TURN *** [2h Ks 6h] [2d]
matiko09: checks 
tallonn88: bets $3.50
matiko09: calls $3.50
*** RIVER *** [2h Ks 6h 2d] [4c]
matiko09: checks 
tallonn88: checks 
*** SHOW DOWN ***
matiko09: shows [As 6d] (two pair, Sixes and Deuces)
tallonn88: shows [Kc 9c] (two pair, Kings and Deuces)
tallonn88 collected $12.42 from pot
*** SUMMARY ***
Total pot $13 | Rake $0.58 
Board [2h Ks 6h 2d 4c]
Seat 2: Optimistic21 folded before Flop (didn't bet)
Seat 3: Donko jr folded before Flop (didn't bet)
Seat 4: King brid folded before Flop (didn't bet)
Seat 5: ReinisRNS (button) folded before Flop (didn't bet)
Seat 6: matiko09 (small blind) showed [As 6d] and lost with two pair, Sixes and Deuces
Seat 7: tallonn88 (big blind) showed [Kc 9c] and won ($12.42) with two pair, Kings and Deuces
Seat 8: banit7 folded before Flop (didn't bet)





PokerStars Hand #148607554004:  Hold'em No Limit ($0.50/$1.00 USD) - 2016/02/11 12:30:49 CET [2016/02/11 6:30:49 ET]
Table 'Sycorax II' 9-max Seat #3 is the button
Seat 1: Luck In Me ($118.02 in chips) 
Seat 2: Lujan87 ($100 in chips) 
Seat 3: chauyeuba ($48.50 in chips) 
Seat 4: Sweden_Pound ($144.74 in chips) 
Seat 5: Effort92 ($100 in chips) 
Seat 6: FluentFlows ($42 in chips) 
Seat 7: hurtNCYDE ($117.38 in chips) 
Seat 8: matiko09 ($127.87 in chips) 
Seat 9: mrfoldcall ($107.74 in chips) 
Sweden_Pound: posts small blind $0.50
Effort92: posts big blind $1
*** HOLE CARDS ***
Dealt to matiko09 [8s 2d]
FluentFlows: folds 
hurtNCYDE: raises $1.50 to $2.50
matiko09: folds 
mrfoldcall: folds 
Luck In Me: folds 
Lujan87: folds 
chauyeuba: folds 
Sweden_Pound: folds 
Effort92: folds 
Uncalled bet ($1.50) returned to hurtNCYDE
hurtNCYDE collected $2.50 from pot
hurtNCYDE: doesn't show hand 
*** SUMMARY ***
Total pot $2.50 | Rake $0 
Seat 1: Luck In Me folded before Flop (didn't bet)
Seat 2: Lujan87 folded before Flop (didn't bet)
Seat 3: chauyeuba (button) folded before Flop (didn't bet)
Seat 4: Sweden_Pound (small blind) folded before Flop
Seat 5: Effort92 (big blind) folded before Flop
Seat 6: FluentFlows folded before Flop (didn't bet)
Seat 7: hurtNCYDE collected ($2.50)
Seat 8: matiko09 folded before Flop (didn't bet)
Seat 9: mrfoldcall folded before Flop (didn't bet)





PokerStars Hand #148607554145:  Hold'em No Limit ($0.25/$0.50 USD) - 2016/02/11 12:30:49 CET [2016/02/11 6:30:49 ET]
Table 'Algedi' 9-max Seat #8 is the button
Seat 1: vlad11122007 ($50.87 in chips) 
Seat 4: Effort92 ($55.78 in chips) 
Seat 6: TonnaMunz ($126.16 in chips) 
Seat 7: hoedtrob ($59.82 in chips) 
Seat 8: matiko09 ($51 in chips) 
Seat 9: Kud3 ($126.52 in chips) 
Kud3: posts small blind $0.25
vlad11122007: posts big blind $0.50
vlad11122007: posts the ante $0.10
Effort92: posts the ante $0.10
TonnaMunz: posts the ante $0.10
hoedtrob: posts the ante $0.10
matiko09: posts the ante $0.10
Kud3: posts the ante $0.10
*** HOLE CARDS ***
Dealt to matiko09 [8h Ah]
Effort92: folds 
TonnaMunz: folds 
hoedtrob: raises $1 to $1.50
matiko09: raises $3.50 to $5
Kud3: folds 
vlad11122007: folds 
hoedtrob: calls $3.50
*** FLOP *** [Jc 5c 6c]
hoedtrob: checks 
matiko09: checks 
*** TURN *** [Jc 5c 6c] [Td]
hoedtrob: bets $2
matiko09: folds 
Uncalled bet ($2) returned to hoedtrob
hoedtrob collected $10.84 from pot
hoedtrob: doesn't show hand 
*** SUMMARY ***
Total pot $11.35 | Rake $0.51 
Board [Jc 5c 6c Td]
Seat 1: vlad11122007 (big blind) folded before Flop
Seat 4: Effort92 folded before Flop (didn't bet)
Seat 6: TonnaMunz folded before Flop (didn't bet)
Seat 7: hoedtrob collected ($10.84)
Seat 8: matiko09 (button) folded on the Turn
Seat 9: Kud3 (small blind) folded before Flop





PokerStars Hand #148607556523:  Hold'em No Limit ($0.25/$0.50 USD) - 2016/02/11 12:30:53 CET [2016/02/11 6:30:53 ET]
Table 'Hunan' 9-max Seat #7 is the button
Seat 1: matiko09 ($52 in chips) 
Seat 2: smirnoff993 ($143.07 in chips) 
Seat 3: TheMinion ($59.11 in chips) 
Seat 4: banit7 ($50.50 in chips) 
Seat 5: Honk115 ($59.98 in chips) 
Seat 6: i L00K great ($58.91 in chips) 
Seat 7: SForces33 ($26.30 in chips) 
Seat 8: Reven9er ($54.70 in chips) 
Seat 9: Optimistic21 ($50 in chips) 
Reven9er: posts small blind $0.25
Optimistic21: posts big blind $0.50
*** HOLE CARDS ***
Dealt to matiko09 [9d Js]
matiko09: folds 
smirnoff993: folds 
TheMinion: folds 
banit7: folds 
Honk115: folds 
i L00K great: folds 
SForces33: folds 
Reven9er: folds 
Uncalled bet ($0.25) returned to Optimistic21
Optimistic21 collected $0.50 from pot
*** SUMMARY ***
Total pot $0.50 | Rake $0 
Seat 1: matiko09 folded before Flop (didn't bet)
Seat 2: smirnoff993 folded before Flop (didn't bet)
Seat 3: TheMinion folded before Flop (didn't bet)
Seat 4: banit7 folded before Flop (didn't bet)
Seat 5: Honk115 folded before Flop (didn't bet)
Seat 6: i L00K great folded before Flop (didn't bet)
Seat 7: SForces33 (button) folded before Flop (didn't bet)
Seat 8: Reven9er (small blind) folded before Flop
Seat 9: Optimistic21 (big blind) collected ($0.50)





PokerStars Hand #148607557984:  Hold'em No Limit ($0.25/$0.50 USD) - 2016/02/11 12:30:56 CET [2016/02/11 6:30:56 ET]
Table 'Sylvania II' 9-max Seat #5 is the button
Seat 1: mexx1234 ($199.23 in chips) 
Seat 2: Effort92 ($50.34 in chips) 
Seat 3: ruyingren ($185.53 in chips) 
Seat 4: matiko09 ($150.35 in chips) 
Seat 5: vlad11122007 ($48.75 in chips) 
Seat 6: TonnaMunz ($122.35 in chips) 
Seat 7: i L00K great ($52.83 in chips) 
Seat 8: Optimistic21 ($50 in chips) 
TonnaMunz: posts small blind $0.25
i L00K great: posts big blind $0.50
Kud3: sits out 
mexx1234: posts the ante $0.10
Effort92: posts the ante $0.10
ruyingren: posts the ante $0.10
matiko09: posts the ante $0.10
vlad11122007: posts the ante $0.10
TonnaMunz: posts the ante $0.10
i L00K great: posts the ante $0.10
Optimistic21: posts the ante $0.10
*** HOLE CARDS ***
Dealt to matiko09 [Kc 5d]
Optimistic21: folds 
mexx1234: folds 
Effort92: folds 
ruyingren: raises $1 to $1.50
matiko09: folds 
vlad11122007: folds 
TonnaMunz: folds 
i L00K great: folds 
Uncalled bet ($1) returned to ruyingren
ruyingren collected $2.05 from pot
ruyingren: doesn't show hand 
*** SUMMARY ***
Total pot $2.05 | Rake $0 
Seat 1: mexx1234 folded before Flop (didn't bet)
Seat 2: Effort92 folded before Flop (didn't bet)
Seat 3: ruyingren collected ($2.05)
Seat 4: matiko09 folded before Flop (didn't bet)
Seat 5: vlad11122007 (button) folded before Flop (didn't bet)
Seat 6: TonnaMunz (small blind) folded before Flop
Seat 7: i L00K great (big blind) folded before Flop
Seat 8: Optimistic21 folded before Flop (didn't bet)





PokerStars Hand #148607564530:  Hold'em No Limit (€0.25/€0.50 EUR) - 2016/02/11 12:31:08 CET [2016/02/11 6:31:08 ET]
Table 'Otero II' 9-max Seat #3 is the button
Seat 1: Nacho2556 (€41 in chips) 
Seat 3: chaogoose82 (€71.03 in chips) 
Seat 5: vlad11122007 (€50 in chips) 
Seat 6: TonnaMunz (€53.44 in chips) 
Seat 7: PacPacBum (€50.18 in chips) 
Seat 8: matiko09 (€64.58 in chips) 
Seat 9: Optimistic21 (€59.29 in chips) 
vlad11122007: posts small blind €0.25
TonnaMunz: posts big blind €0.50
*** HOLE CARDS ***
Dealt to matiko09 [2h 5c]
PacPacBum: folds 
matiko09: folds 
Optimistic21: folds 
Nacho2556: folds 
chaogoose82: raises €1 to €1.50
vlad11122007: folds 
TonnaMunz: folds 
Uncalled bet (€1) returned to chaogoose82
chaogoose82 collected €1.25 from pot
chaogoose82: doesn't show hand 
*** SUMMARY ***
Total pot €1.25 | Rake €0 
Seat 1: Nacho2556 folded before Flop (didn't bet)
Seat 3: chaogoose82 (button) collected (€1.25)
Seat 5: vlad11122007 (small blind) folded before Flop
Seat 6: TonnaMunz (big blind) folded before Flop
Seat 7: PacPacBum folded before Flop (didn't bet)
Seat 8: matiko09 folded before Flop (didn't bet)
Seat 9: Optimistic21 folded before Flop (didn't bet)





PokerStars Hand #148607567421:  Hold'em No Limit ($0.50/$1.00 USD) - 2016/02/11 12:31:13 CET [2016/02/11 6:31:13 ET]
Table 'Sycorax II' 9-max Seat #4 is the button
Seat 1: Luck In Me ($118.02 in chips) 
Seat 2: Lujan87 ($100 in chips) 
Seat 3: chauyeuba ($48.50 in chips) 
Seat 4: Sweden_Pound ($144.24 in chips) 
Seat 5: Effort92 ($100 in chips) 
Seat 6: FluentFlows ($42 in chips) 
Seat 7: hurtNCYDE ($118.88 in chips) 
Seat 8: matiko09 ($127.87 in chips) 
Seat 9: mrfoldcall ($107.74 in chips) 
Effort92: posts small blind $0.50
FluentFlows: posts big blind $1
*** HOLE CARDS ***
Dealt to matiko09 [5c Kh]
hurtNCYDE: folds 
matiko09: folds 
mrfoldcall is disconnected 
mrfoldcall is connected 
mrfoldcall: raises $2 to $3
Luck In Me: raises $6 to $9
Lujan87: folds 
chauyeuba: folds 
Sweden_Pound: folds 
Effort92: folds 
FluentFlows: folds 
mrfoldcall: calls $6
*** FLOP *** [Ac Qd 6d]
mrfoldcall: checks 
Luck In Me: checks 
*** TURN *** [Ac Qd 6d] [2s]
mrfoldcall: checks 
Luck In Me: bets $9.50
mrfoldcall: calls $9.50
*** RIVER *** [Ac Qd 6d 2s] [Tc]
mrfoldcall: checks 
Luck In Me: bets $20
mrfoldcall: calls $20
*** SHOW DOWN ***
Luck In Me: shows [Ts As] (two pair, Aces and Tens)
mrfoldcall: mucks hand 
Luck In Me collected $75.70 from pot
*** SUMMARY ***
Total pot $78.50 | Rake $2.80 
Board [Ac Qd 6d 2s Tc]
Seat 1: Luck In Me showed [Ts As] and won ($75.70) with two pair, Aces and Tens
Seat 2: Lujan87 folded before Flop (didn't bet)
Seat 3: chauyeuba folded before Flop (didn't bet)
Seat 4: Sweden_Pound (button) folded before Flop (didn't bet)
Seat 5: Effort92 (small blind) folded before Flop
Seat 6: FluentFlows (big blind) folded before Flop
Seat 7: hurtNCYDE folded before Flop (didn't bet)
Seat 8: matiko09 folded before Flop (didn't bet)
Seat 9: mrfoldcall mucked [Ad 8h]





PokerStars Hand #148607575018:  Hold'em No Limit ($0.50/$1.00 USD) - 2016/02/11 12:31:27 CET [2016/02/11 6:31:27 ET]
Table 'Regor' 9-max Seat #5 is the button
Seat 1: matiko09 ($125.11 in chips) 
Seat 2: Luck In Me ($104 in chips) 
Seat 3: oscarleon ($101 in chips) 
Seat 5: chauyeuba ($47 in chips) 
Seat 7: gwwsb ($55.51 in chips) 
Seat 8: R3NZONIT3 ($57.58 in chips) 
Seat 9: CoolFireX ($100 in chips) 
Dachish will be allowed to play after the button
gwwsb: posts small blind $0.50
R3NZONIT3: posts big blind $1
Filojoes: sits out 
*** HOLE CARDS ***
Dealt to matiko09 [8d Th]
CoolFireX: raises $2 to $3
matiko09: folds 
Luck In Me: folds 
oscarleon: calls $3
chauyeuba: folds 
gwwsb: folds 
R3NZONIT3: calls $2
*** FLOP *** [Ks Qc 9s]
R3NZONIT3: checks 
CoolFireX: checks 
oscarleon: bets $7
R3NZONIT3: folds 
CoolFireX: calls $7
*** TURN *** [Ks Qc 9s] [Jd]
CoolFireX: checks 
oscarleon: checks 
*** RIVER *** [Ks Qc 9s Jd] [7c]
CoolFireX: bets $16.83
oscarleon: folds 
Uncalled bet ($16.83) returned to CoolFireX
CoolFireX collected $22.44 from pot
CoolFireX: doesn't show hand 
*** SUMMARY ***
Total pot $23.50 | Rake $1.06 
Board [Ks Qc 9s Jd 7c]
Seat 1: matiko09 folded before Flop (didn't bet)
Seat 2: Luck In Me folded before Flop (didn't bet)
Seat 3: oscarleon folded on the River
Seat 5: chauyeuba (button) folded before Flop (didn't bet)
Seat 7: gwwsb (small blind) folded before Flop
Seat 8: R3NZONIT3 (big blind) folded on the Flop
Seat 9: CoolFireX collected ($22.44)





PokerStars Hand #148607576052:  Hold'em No Limit ($0.25/$0.50 USD) - 2016/02/11 12:31:29 CET [2016/02/11 6:31:29 ET]
Table 'Hunan' 9-max Seat #8 is the button
Seat 1: matiko09 ($52 in chips) 
Seat 2: smirnoff993 ($143.07 in chips) 
Seat 3: TheMinion ($59.11 in chips) 
Seat 4: banit7 ($50.50 in chips) 
Seat 5: Honk115 ($59.98 in chips) 
Seat 6: i L00K great ($58.91 in chips) 
Seat 7: SForces33 ($26.30 in chips) 
Seat 8: Reven9er ($54.45 in chips) 
Seat 9: Optimistic21 ($50.25 in chips) 
Optimistic21: posts small blind $0.25
matiko09: posts big blind $0.50
*** HOLE CARDS ***
Dealt to matiko09 [6h Ks]
smirnoff993: folds 
TheMinion: folds 
banit7: folds 
Honk115: folds 
i L00K great: folds 
SForces33: raises $1 to $1.50
Reven9er: folds 
Optimistic21: raises $3.50 to $5
matiko09: folds 
SForces33: calls $3.50
*** FLOP *** [Ad 6c 3h]
Optimistic21: bets $5.01
SForces33: folds 
Uncalled bet ($5.01) returned to Optimistic21
Optimistic21 collected $10.03 from pot
*** SUMMARY ***
Total pot $10.50 | Rake $0.47 
Board [Ad 6c 3h]
Seat 1: matiko09 (big blind) folded before Flop
Seat 2: smirnoff993 folded before Flop (didn't bet)
Seat 3: TheMinion folded before Flop (didn't bet)
Seat 4: banit7 folded before Flop (didn't bet)
Seat 5: Honk115 folded before Flop (didn't bet)
Seat 6: i L00K great folded before Flop (didn't bet)
Seat 7: SForces33 folded on the Flop
Seat 8: Reven9er (button) folded before Flop (didn't bet)
Seat 9: Optimistic21 (small blind) collected ($10.03)





PokerStars Hand #148607580335:  Hold'em No Limit ($0.25/$0.50 USD) - 2016/02/11 12:31:37 CET [2016/02/11 6:31:37 ET]
Table 'Sylvania II' 9-max Seat #6 is the button
Seat 1: mexx1234 ($199.13 in chips) 
Seat 2: Effort92 ($50.24 in chips) 
Seat 3: ruyingren ($186.98 in chips) 
Seat 4: matiko09 ($150.25 in chips) 
Seat 5: vlad11122007 ($48.65 in chips) 
Seat 6: TonnaMunz ($122 in chips) 
Seat 7: i L00K great ($52.23 in chips) 
Seat 8: Optimistic21 ($50 in chips) 
i L00K great: posts small blind $0.25
Optimistic21: posts big blind $0.50
Kud3: sits out 
mexx1234: posts the ante $0.10
Effort92: posts the ante $0.10
ruyingren: posts the ante $0.10
matiko09: posts the ante $0.10
vlad11122007: posts the ante $0.10
TonnaMunz: posts the ante $0.10
i L00K great: posts the ante $0.10
Optimistic21: posts the ante $0.10
*** HOLE CARDS ***
Dealt to matiko09 [Jd 7c]
mexx1234: folds 
Effort92: folds 
ruyingren: raises $1 to $1.50
matiko09: folds 
vlad11122007: folds 
TonnaMunz: folds 
i L00K great: folds 
Optimistic21: folds 
Uncalled bet ($1) returned to ruyingren
ruyingren collected $2.05 from pot
ruyingren: doesn't show hand 
*** SUMMARY ***
Total pot $2.05 | Rake $0 
Seat 1: mexx1234 folded before Flop (didn't bet)
Seat 2: Effort92 folded before Flop (didn't bet)
Seat 3: ruyingren collected ($2.05)
Seat 4: matiko09 folded before Flop (didn't bet)
Seat 5: vlad11122007 folded before Flop (didn't bet)
Seat 6: TonnaMunz (button) folded before Flop (didn't bet)
Seat 7: i L00K great (small blind) folded before Flop
Seat 8: Optimistic21 (big blind) folded before Flop





PokerStars Hand #148607585465:  Hold'em No Limit (€0.25/€0.50 EUR) - 2016/02/11 12:31:46 CET [2016/02/11 6:31:46 ET]
Table 'Otero II' 9-max Seat #5 is the button
Seat 1: Nacho2556 (€41 in chips) 
Seat 3: chaogoose82 (€71.78 in chips) 
Seat 5: vlad11122007 (€49.75 in chips) 
Seat 6: TonnaMunz (€52.94 in chips) 
Seat 7: PacPacBum (€50.18 in chips) 
Seat 8: matiko09 (€64.58 in chips) 
Seat 9: Optimistic21 (€59.29 in chips) 
TonnaMunz: posts small blind €0.25
PacPacBum: posts big blind €0.50
*** HOLE CARDS ***
Dealt to matiko09 [Ah Kc]
matiko09: raises €1 to €1.50
Optimistic21: folds 
Nacho2556: folds 
chaogoose82: folds 
vlad11122007: folds 
TonnaMunz: folds 
PacPacBum: folds 
Uncalled bet (€1) returned to matiko09
matiko09 collected €1.25 from pot
matiko09: doesn't show hand 
*** SUMMARY ***
Total pot €1.25 | Rake €0 
Seat 1: Nacho2556 folded before Flop (didn't bet)
Seat 3: chaogoose82 folded before Flop (didn't bet)
Seat 5: vlad11122007 (button) folded before Flop (didn't bet)
Seat 6: TonnaMunz (small blind) folded before Flop
Seat 7: PacPacBum (big blind) folded before Flop
Seat 8: matiko09 collected (€1.25)
Seat 9: Optimistic21 folded before Flop (didn't bet)





PokerStars Hand #148607585751:  Hold'em No Limit ($0.25/$0.50 USD) - 2016/02/11 12:31:47 CET [2016/02/11 6:31:47 ET]
Table 'Ambrosia II' 9-max Seat #3 is the button
Seat 1: matiko09 ($50 in chips) 
Seat 2: TheMinion ($115.94 in chips) 
Seat 3: make6a ($50 in chips) 
Seat 4: huudk2016 ($10.40 in chips) 
Seat 6: Reven9er ($61.87 in chips) 
Seat 7: mexx1234 ($56.62 in chips) 
Seat 8: tallonn88 ($53.31 in chips) 
Seat 9: arctur17 ($62.62 in chips) 
huudk2016: posts small blind $0.25
smirnoff993: is sitting out 
Reven9er: posts big blind $0.50
*** HOLE CARDS ***
Dealt to matiko09 [2s 4d]
mexx1234: folds 
smirnoff993 leaves the table
tallonn88: folds 
arctur17: folds 
matiko09: folds 
TheMinion: folds 
make6a: raises $0.50 to $1
huudk2016: calls $0.75
Reven9er: calls $0.50
*** FLOP *** [9h 6d Qc]
huudk2016: checks 
Reven9er: bets $1.50
make6a: folds 
RICKA16 joins the table at seat #5 
huudk2016: folds 
Uncalled bet ($1.50) returned to Reven9er
Reven9er collected $2.86 from pot
Reven9er: doesn't show hand 
*** SUMMARY ***
Total pot $3 | Rake $0.14 
Board [9h 6d Qc]
Seat 1: matiko09 folded before Flop (didn't bet)
Seat 2: TheMinion folded before Flop (didn't bet)
Seat 3: make6a (button) folded on the Flop
Seat 4: huudk2016 (small blind) folded on the Flop
Seat 6: Reven9er (big blind) collected ($2.86)
Seat 7: mexx1234 folded before Flop (didn't bet)
Seat 8: tallonn88 folded before Flop (didn't bet)
Seat 9: arctur17 folded before Flop (didn't bet)





PokerStars Hand #148607589084:  Hold'em No Limit ($0.25/$0.50 USD) - 2016/02/11 12:31:53 CET [2016/02/11 6:31:53 ET]
Table 'Amor II' 9-max Seat #1 is the button
Seat 1: Kud3 ($50 in chips) 
Seat 2: GusenokRUS ($83.12 in chips) 
Seat 3: TheMinion ($59.47 in chips) 
Seat 4: Larzdog29 ($48.02 in chips) 
Seat 5: Optimistic21 ($50 in chips) 
Seat 6: matiko09 ($50 in chips) 
Seat 7: banit7 ($50.86 in chips) 
Seat 8: Reven9er ($61.43 in chips) 
Seat 9: tallonn88 ($106 in chips) 
GusenokRUS: posts small blind $0.25
TheMinion: posts big blind $0.50
*** HOLE CARDS ***
Dealt to matiko09 [Js 8c]
Larzdog29: folds 
Optimistic21: folds 
matiko09: folds 
banit7: folds 
Reven9er: folds 
tallonn88: raises $0.75 to $1.25
Kud3: calls $1.25
GusenokRUS: folds 
TheMinion: calls $0.75
*** FLOP *** [7c 7d 7h]
TheMinion: checks 
tallonn88: bets $2.52
Kud3: calls $2.52
TheMinion: folds 
*** TURN *** [7c 7d 7h] [Qs]
tallonn88: bets $5.50
Kud3: folds 
Uncalled bet ($5.50) returned to tallonn88
tallonn88 collected $8.63 from pot
tallonn88: doesn't show hand 
*** SUMMARY ***
Total pot $9.04 | Rake $0.41 
Board [7c 7d 7h Qs]
Seat 1: Kud3 (button) folded on the Turn
Seat 2: GusenokRUS (small blind) folded before Flop
Seat 3: TheMinion (big blind) folded on the Flop
Seat 4: Larzdog29 folded before Flop (didn't bet)
Seat 5: Optimistic21 folded before Flop (didn't bet)
Seat 6: matiko09 folded before Flop (didn't bet)
Seat 7: banit7 folded before Flop (didn't bet)
Seat 8: Reven9er folded before Flop (didn't bet)
Seat 9: tallonn88 collected ($8.63)





PokerStars Hand #148607594547:  Hold'em No Limit ($0.25/$0.50 USD) - 2016/02/11 12:32:03 CET [2016/02/11 6:32:03 ET]
Table 'Hunan' 9-max Seat #9 is the button
Seat 1: matiko09 ($51.50 in chips) 
Seat 2: smirnoff993 ($143.07 in chips) 
Seat 3: TheMinion ($59.11 in chips) 
Seat 4: banit7 ($50.50 in chips) 
Seat 5: Honk115 ($59.98 in chips) 
Seat 6: i L00K great ($58.91 in chips) 
Seat 7: SForces33 ($21.30 in chips) 
Seat 8: Reven9er ($54.45 in chips) 
Seat 9: Optimistic21 ($55.28 in chips) 
matiko09: posts small blind $0.25
smirnoff993: posts big blind $0.50
*** HOLE CARDS ***
Dealt to matiko09 [8d 9s]
TheMinion: folds 
banit7: folds 
Honk115: folds 
i L00K great: folds 
SForces33: folds 
Reven9er: folds 
Optimistic21: raises $0.50 to $1
matiko09: folds 
smirnoff993: folds 
Uncalled bet ($0.50) returned to Optimistic21
Optimistic21 collected $1.25 from pot
*** SUMMARY ***
Total pot $1.25 | Rake $0 
Seat 1: matiko09 (small blind) folded before Flop
Seat 2: smirnoff993 (big blind) folded before Flop
Seat 3: TheMinion folded before Flop (didn't bet)
Seat 4: banit7 folded before Flop (didn't bet)
Seat 5: Honk115 folded before Flop (didn't bet)
Seat 6: i L00K great folded before Flop (didn't bet)
Seat 7: SForces33 folded before Flop (didn't bet)
Seat 8: Reven9er folded before Flop (didn't bet)
Seat 9: Optimistic21 (button) collected ($1.25)





PokerStars Hand #148607595550:  Hold'em No Limit ($0.25/$0.50 USD) - 2016/02/11 12:32:05 CET [2016/02/11 6:32:05 ET]
Table 'Stereoskopia' 9-max Seat #6 is the button
Seat 2: Optimistic21 ($50.50 in chips) 
Seat 3: Donko jr ($13.65 in chips) 
Seat 4: King brid ($68.91 in chips) 
Seat 5: ReinisRNS ($29.88 in chips) 
Seat 6: matiko09 ($50 in chips) 
Seat 7: tallonn88 ($105.17 in chips) 
Seat 8: banit7 ($84.03 in chips) 
tallonn88: posts small blind $0.25
banit7: posts big blind $0.50
apfush: sits out 
50CandyJoe: sits out 
*** HOLE CARDS ***
Dealt to matiko09 [Td 9d]
Optimistic21: folds 
Donko jr: folds 
King brid: folds 
ReinisRNS: raises $1.25 to $1.75
matiko09: folds 
tallonn88: folds 
banit7: folds 
Uncalled bet ($1.25) returned to ReinisRNS
ReinisRNS collected $1.25 from pot
ReinisRNS: doesn't show hand 
*** SUMMARY ***
Total pot $1.25 | Rake $0 
Seat 2: Optimistic21 folded before Flop (didn't bet)
Seat 3: Donko jr folded before Flop (didn't bet)
Seat 4: King brid folded before Flop (didn't bet)
Seat 5: ReinisRNS collected ($1.25)
Seat 6: matiko09 (button) folded before Flop (didn't bet)
Seat 7: tallonn88 (small blind) folded before Flop
Seat 8: banit7 (big blind) folded before Flop





PokerStars Hand #148607596120:  Hold'em No Limit ($0.25/$0.50 USD) - 2016/02/11 12:32:06 CET [2016/02/11 6:32:06 ET]
Table 'Algedi' 9-max Seat #9 is the button
Seat 1: vlad11122007 ($50.27 in chips) 
Seat 4: Effort92 ($55.68 in chips) 
Seat 6: TonnaMunz ($126.06 in chips) 
Seat 7: hoedtrob ($65.56 in chips) 
Seat 8: matiko09 ($50 in chips) 
Seat 9: Kud3 ($126.17 in chips) 
vlad11122007: posts small blind $0.25
Effort92: posts big blind $0.50
vlad11122007: posts the ante $0.10
Effort92: posts the ante $0.10
TonnaMunz: posts the ante $0.10
hoedtrob: posts the ante $0.10
matiko09: posts the ante $0.10
Kud3: posts the ante $0.10
*** HOLE CARDS ***
Dealt to matiko09 [4h 8h]
TonnaMunz: folds 
hoedtrob: raises $1 to $1.50
matiko09: folds 
Kud3: folds 
vlad11122007: raises $3.50 to $5
Effort92: folds 
hoedtrob: folds 
Uncalled bet ($3.50) returned to vlad11122007
vlad11122007 collected $4.10 from pot
vlad11122007: doesn't show hand 
*** SUMMARY ***
Total pot $4.10 | Rake $0 
Seat 1: vlad11122007 (small blind) collected ($4.10)
Seat 4: Effort92 (big blind) folded before Flop
Seat 6: TonnaMunz folded before Flop (didn't bet)
Seat 7: hoedtrob folded before Flop
Seat 8: matiko09 folded before Flop (didn't bet)
Seat 9: Kud3 (button) folded before Flop (didn't bet)





PokerStars Hand #148607602375:  Hold'em No Limit ($0.25/$0.50 USD) - 2016/02/11 12:32:17 CET [2016/02/11 6:32:17 ET]
Table 'Sylvania II' 9-max Seat #7 is the button
Seat 1: mexx1234 ($199.03 in chips) 
Seat 2: Effort92 ($50.14 in chips) 
Seat 3: ruyingren ($188.43 in chips) 
Seat 4: matiko09 ($150.15 in chips) 
Seat 5: vlad11122007 ($48.55 in chips) 
Seat 6: TonnaMunz ($121.90 in chips) 
Seat 7: i L00K great ($51.88 in chips) 
Seat 8: Optimistic21 ($50 in chips) 
Seat 9: Kud3 ($152.26 in chips) 
Optimistic21: posts small blind $0.25
Kud3: posts big blind $0.50
mexx1234: posts the ante $0.10
Effort92: posts the ante $0.10
ruyingren: posts the ante $0.10
matiko09: posts the ante $0.10
vlad11122007: posts the ante $0.10
TonnaMunz: posts the ante $0.10
i L00K great: posts the ante $0.10
Optimistic21: posts the ante $0.10
Kud3: posts the ante $0.10
*** HOLE CARDS ***
Dealt to matiko09 [Js 8h]
mexx1234: folds 
Effort92: folds 
ruyingren: raises $1 to $1.50
matiko09: folds 
vlad11122007: raises $3 to $4.50
TonnaMunz: folds 
i L00K great: folds 
Optimistic21: folds 
Kud3: calls $4
ruyingren: calls $3
*** FLOP *** [7h 8s 5d]
Kud3: checks 
ruyingren: checks 
vlad11122007: bets $6
Kud3: calls $6
ruyingren: calls $6
*** TURN *** [7h 8s 5d] [Jc]
Kud3: checks 
ruyingren: checks 
vlad11122007: bets $37.95 and is all-in
Kud3: folds 
ruyingren: folds 
Uncalled bet ($37.95) returned to vlad11122007
Kud3 said, "lol :D"
vlad11122007 collected $31.18 from pot
vlad11122007: doesn't show hand 
*** SUMMARY ***
Total pot $32.65 | Rake $1.47 
Board [7h 8s 5d Jc]
Seat 1: mexx1234 folded before Flop (didn't bet)
Seat 2: Effort92 folded before Flop (didn't bet)
Seat 3: ruyingren folded on the Turn
Seat 4: matiko09 folded before Flop (didn't bet)
Seat 5: vlad11122007 collected ($31.18)
Seat 6: TonnaMunz folded before Flop (didn't bet)
Seat 7: i L00K great (button) folded before Flop (didn't bet)
Seat 8: Optimistic21 (small blind) folded before Flop
Seat 9: Kud3 (big blind) folded on the Turn





PokerStars Hand #148607605566:  Hold'em No Limit (€0.25/€0.50 EUR) - 2016/02/11 12:32:23 CET [2016/02/11 6:32:23 ET]
Table 'Otero II' 9-max Seat #6 is the button
Seat 1: Nacho2556 (€41 in chips) 
Seat 3: chaogoose82 (€71.78 in chips) 
Seat 5: vlad11122007 (€49.75 in chips) 
Seat 6: TonnaMunz (€52.69 in chips) 
Seat 7: PacPacBum (€50 in chips) 
Seat 8: matiko09 (€65.33 in chips) 
Seat 9: Optimistic21 (€59.29 in chips) 
PacPacBum: posts small blind €0.25
matiko09: posts big blind €0.50
*** HOLE CARDS ***
Dealt to matiko09 [Ts 3d]
Optimistic21: folds 
Nacho2556: calls €0.50
chaogoose82: calls €0.50
vlad11122007: folds 
TonnaMunz: calls €0.50
PacPacBum: folds 
matiko09: checks 
*** FLOP *** [9c Th Kd]
100+x leaves the table
matiko09: checks 
Nacho2556: bets €4.50
chaogoose82: folds 
TonnaMunz: folds 
matiko09: folds 
Uncalled bet (€4.50) returned to Nacho2556
Nacho2556 collected €2.15 from pot
*** SUMMARY ***
Total pot €2.25 | Rake €0.10 
Board [9c Th Kd]
Seat 1: Nacho2556 collected (€2.15)
Seat 3: chaogoose82 folded on the Flop
Seat 5: vlad11122007 folded before Flop (didn't bet)
Seat 6: TonnaMunz (button) folded on the Flop
Seat 7: PacPacBum (small blind) folded before Flop
Seat 8: matiko09 (big blind) folded on the Flop
Seat 9: Optimistic21 folded before Flop (didn't bet)





PokerStars Hand #148607607532:  Hold'em No Limit ($0.25/$0.50 USD) - 2016/02/11 12:32:27 CET [2016/02/11 6:32:27 ET]
Table 'Hunan' 9-max Seat #1 is the button
Seat 1: matiko09 ($51.25 in chips) 
Seat 2: smirnoff993 ($142.57 in chips) 
Seat 3: TheMinion ($59.11 in chips) 
Seat 4: banit7 ($50.50 in chips) 
Seat 5: Honk115 ($59.98 in chips) 
Seat 6: i L00K great ($58.91 in chips) 
Seat 7: SForces33 ($21.30 in chips) 
Seat 8: Reven9er ($54.45 in chips) 
Seat 9: Optimistic21 ($56.03 in chips) 
smirnoff993: posts small blind $0.25
TheMinion: posts big blind $0.50
*** HOLE CARDS ***
Dealt to matiko09 [Jc Td]
banit7: folds 
Honk115: folds 
banit7 leaves the table
i L00K great: raises $1 to $1.50
SForces33: folds 
Reven9er: folds 
Optimistic21: folds 
matiko09: folds 
smirnoff993: folds 
TheMinion: folds 
Uncalled bet ($1) returned to i L00K great
i L00K great collected $1.25 from pot
i L00K great: doesn't show hand 
RICKA16 joins the table at seat #4 
*** SUMMARY ***
Total pot $1.25 | Rake $0 
Seat 1: matiko09 (button) folded before Flop (didn't bet)
Seat 2: smirnoff993 (small blind) folded before Flop
Seat 3: TheMinion (big blind) folded before Flop
Seat 4: banit7 folded before Flop (didn't bet)
Seat 5: Honk115 folded before Flop (didn't bet)
Seat 6: i L00K great collected ($1.25)
Seat 7: SForces33 folded before Flop (didn't bet)
Seat 8: Reven9er folded before Flop (didn't bet)
Seat 9: Optimistic21 folded before Flop (didn't bet)





PokerStars Hand #148607612268:  Hold'em No Limit ($0.25/$0.50 USD) - 2016/02/11 12:32:35 CET [2016/02/11 6:32:35 ET]
Table 'Stereoskopia' 9-max Seat #7 is the button
Seat 2: Optimistic21 ($50.50 in chips) 
Seat 3: Donko jr ($13.65 in chips) 
Seat 4: King brid ($68.91 in chips) 
Seat 5: ReinisRNS ($30.63 in chips) 
Seat 6: matiko09 ($50 in chips) 
Seat 7: tallonn88 ($104.92 in chips) 
Seat 8: banit7 ($83.53 in chips) 
Seat 9: apfush ($50 in chips) 
banit7: posts small blind $0.25
apfush: posts big blind $0.50
50CandyJoe: sits out 
*** HOLE CARDS ***
Dealt to matiko09 [6d Ah]
Optimistic21: folds 
Donko jr: folds 
King brid: raises $1 to $1.50
ReinisRNS: folds 
matiko09: folds 
tallonn88: folds 
banit7: folds 
apfush: folds 
Uncalled bet ($1) returned to King brid
King brid collected $1.25 from pot
King brid: doesn't show hand 
*** SUMMARY ***
Total pot $1.25 | Rake $0 
Seat 2: Optimistic21 folded before Flop (didn't bet)
Seat 3: Donko jr folded before Flop (didn't bet)
Seat 4: King brid collected ($1.25)
Seat 5: ReinisRNS folded before Flop (didn't bet)
Seat 6: matiko09 folded before Flop (didn't bet)
Seat 7: tallonn88 (button) folded before Flop (didn't bet)
Seat 8: banit7 (small blind) folded before Flop
Seat 9: apfush (big blind) folded before Flop





PokerStars Hand #148607613920:  Hold'em No Limit ($0.25/$0.50 USD) - 2016/02/11 12:32:38 CET [2016/02/11 6:32:38 ET]
Table 'Algedi' 9-max Seat #1 is the button
Seat 1: vlad11122007 ($52.77 in chips) 
Seat 4: Effort92 ($55.08 in chips) 
Seat 6: TonnaMunz ($125.96 in chips) 
Seat 7: hoedtrob ($63.96 in chips) 
Seat 8: matiko09 ($50 in chips) 
Seat 9: Kud3 ($126.07 in chips) 
Effort92: posts small blind $0.25
TonnaMunz: posts big blind $0.50
vlad11122007: posts the ante $0.10
Effort92: posts the ante $0.10
TonnaMunz: posts the ante $0.10
hoedtrob: posts the ante $0.10
matiko09: posts the ante $0.10
Kud3: posts the ante $0.10
*** HOLE CARDS ***
Dealt to matiko09 [2h 2d]
hoedtrob: folds 
matiko09: folds 
Kud3: raises $1 to $1.50
vlad11122007: folds 
Effort92: folds 
hoedtrob said, "how can he block others from opening a table?"
Reffypaul joins the table at seat #2 
TonnaMunz: calls $1
*** FLOP *** [Ad 3d 7c]
Saggitaurus joins the table at seat #3 
Kud3 said, "people see him sitouting all time"
TonnaMunz has timed out
TonnaMunz: checks 
Kud3: bets $1.95
TonnaMunz: folds 
Uncalled bet ($1.95) returned to Kud3
Kud3 collected $3.68 from pot
Kud3: doesn't show hand 
*** SUMMARY ***
Total pot $3.85 | Rake $0.17 
Board [Ad 3d 7c]
Seat 1: vlad11122007 (button) folded before Flop (didn't bet)
Seat 4: Effort92 (small blind) folded before Flop
Seat 6: TonnaMunz (big blind) folded on the Flop
Seat 7: hoedtrob folded before Flop (didn't bet)
Seat 8: matiko09 folded before Flop (didn't bet)
Seat 9: Kud3 collected ($3.68)





PokerStars Hand #148607621277:  Hold'em No Limit ($0.25/$0.50 USD) - 2016/02/11 12:32:52 CET [2016/02/11 6:32:52 ET]
Table 'Hunan' 9-max Seat #2 is the button
Seat 1: matiko09 ($51.25 in chips) 
Seat 2: smirnoff993 ($142.32 in chips) 
Seat 3: TheMinion ($58.61 in chips) 
Seat 4: RICKA16 ($50 in chips) 
Seat 5: Honk115 ($59.98 in chips) 
Seat 6: i L00K great ($59.66 in chips) 
Seat 7: SForces33 ($21.30 in chips) 
Seat 8: Reven9er ($54.45 in chips) 
Seat 9: Optimistic21 ($56.03 in chips) 
TheMinion: posts small blind $0.25
RICKA16: posts big blind $0.50
*** HOLE CARDS ***
Dealt to matiko09 [Qd Kh]
Honk115: folds 
i L00K great: folds 
SForces33: folds 
Reven9er: folds 
Optimistic21: folds 
matiko09: raises $1 to $1.50
smirnoff993: folds 
TheMinion: folds 
RICKA16: folds 
Uncalled bet ($1) returned to matiko09
matiko09 collected $1.25 from pot
matiko09: doesn't show hand 
*** SUMMARY ***
Total pot $1.25 | Rake $0 
Seat 1: matiko09 collected ($1.25)
Seat 2: smirnoff993 (button) folded before Flop (didn't bet)
Seat 3: TheMinion (small blind) folded before Flop
Seat 4: RICKA16 (big blind) folded before Flop
Seat 5: Honk115 folded before Flop (didn't bet)
Seat 6: i L00K great folded before Flop (didn't bet)
Seat 7: SForces33 folded before Flop (didn't bet)
Seat 8: Reven9er folded before Flop (didn't bet)
Seat 9: Optimistic21 folded before Flop (didn't bet)





PokerStars Hand #148607626908:  Hold'em No Limit ($0.50/$1.00 USD) - 2016/02/11 12:33:02 CET [2016/02/11 6:33:02 ET]
Table 'Sycorax II' 9-max Seat #5 is the button
Seat 1: Luck In Me ($155.22 in chips) 
Seat 2: Lujan87 ($100 in chips) 
Seat 3: chauyeuba ($48.50 in chips) 
Seat 4: Sweden_Pound ($144.24 in chips) 
Seat 5: Effort92 ($100 in chips) 
Seat 6: FluentFlows ($41 in chips) 
Seat 7: hurtNCYDE ($118.88 in chips) 
Seat 8: matiko09 ($127.87 in chips) 
Seat 9: mrfoldcall ($69.24 in chips) 
FluentFlows: posts small blind $0.50
hurtNCYDE: posts big blind $1
*** HOLE CARDS ***
Dealt to matiko09 [7d 2h]
matiko09: folds 
mrfoldcall: raises $2 to $3
Luck In Me: folds 
Lujan87: folds 
chauyeuba: folds 
Sweden_Pound: calls $3
Effort92: raises $8 to $11
FluentFlows: folds 
hurtNCYDE: folds 
mrfoldcall: raises $58.24 to $69.24 and is all-in
Sweden_Pound: folds 
Effort92: calls $58.24
*** FLOP *** [Js Qs Th]
*** TURN *** [Js Qs Th] [8s]
*** RIVER *** [Js Qs Th 8s] [Jc]
*** SHOW DOWN ***
mrfoldcall: shows [6h 3s] (a pair of Jacks)
Effort92: shows [As Kc] (a straight, Ten to Ace)
Effort92 collected $140.18 from pot
*** SUMMARY ***
Total pot $142.98 | Rake $2.80 
Board [Js Qs Th 8s Jc]
Seat 1: Luck In Me folded before Flop (didn't bet)
Seat 2: Lujan87 folded before Flop (didn't bet)
Seat 3: chauyeuba folded before Flop (didn't bet)
Seat 4: Sweden_Pound folded before Flop
Seat 5: Effort92 (button) showed [As Kc] and won ($140.18) with a straight, Ten to Ace
Seat 6: FluentFlows (small blind) folded before Flop
Seat 7: hurtNCYDE (big blind) folded before Flop
Seat 8: matiko09 folded before Flop (didn't bet)
Seat 9: mrfoldcall showed [6h 3s] and lost with a pair of Jacks





PokerStars Hand #148607627693:  Hold'em No Limit ($0.25/$0.50 USD) - 2016/02/11 12:33:04 CET [2016/02/11 6:33:04 ET]
Table 'Ambrosia II' 9-max Seat #4 is the button
Seat 1: matiko09 ($50 in chips) 
Seat 2: TheMinion ($115.94 in chips) 
Seat 3: make6a ($49 in chips) 
Seat 4: huudk2016 ($9.40 in chips) 
Seat 6: Reven9er ($63.73 in chips) 
Seat 7: mexx1234 ($56.62 in chips) 
Seat 8: tallonn88 ($53.31 in chips) 
Seat 9: arctur17 ($62.62 in chips) 
RICKA16 will be allowed to play after the button
Reven9er: posts small blind $0.25
mexx1234: posts big blind $0.50
*** HOLE CARDS ***
Dealt to matiko09 [8s 9s]
tallonn88: folds 
arctur17: calls $0.50
matiko09: raises $1.50 to $2
TheMinion: folds 
make6a: folds 
huudk2016: calls $2
Reven9er: folds 
mexx1234: folds 
arctur17: calls $1.50
*** FLOP *** [Qc Ad 5d]
arctur17: bets $3.50
matiko09: folds 
huudk2016: folds 
Uncalled bet ($3.50) returned to arctur17
arctur17 collected $6.45 from pot
arctur17: doesn't show hand 
*** SUMMARY ***
Total pot $6.75 | Rake $0.30 
Board [Qc Ad 5d]
Seat 1: matiko09 folded on the Flop
Seat 2: TheMinion folded before Flop (didn't bet)
Seat 3: make6a folded before Flop (didn't bet)
Seat 4: huudk2016 (button) folded on the Flop
Seat 6: Reven9er (small blind) folded before Flop
Seat 7: mexx1234 (big blind) folded before Flop
Seat 8: tallonn88 folded before Flop (didn't bet)
Seat 9: arctur17 collected ($6.45)





PokerStars Hand #148607631337:  Hold'em No Limit ($0.25/$0.50 USD) - 2016/02/11 12:33:10 CET [2016/02/11 6:33:10 ET]
Table 'Stereoskopia' 9-max Seat #8 is the button
Seat 1: 50CandyJoe ($53.83 in chips) 
Seat 2: Optimistic21 ($50.50 in chips) 
Seat 3: Donko jr ($13.65 in chips) 
Seat 4: King brid ($69.66 in chips) 
Seat 5: ReinisRNS ($30.63 in chips) 
Seat 6: matiko09 ($50 in chips) 
Seat 7: tallonn88 ($104.92 in chips) 
Seat 8: banit7 ($83.28 in chips) 
Seat 9: apfush ($50 in chips) 
apfush: posts small blind $0.25
50CandyJoe: posts big blind $0.50
*** HOLE CARDS ***
Dealt to matiko09 [4d 4c]
Optimistic21: folds 
Donko jr: folds 
King brid: calls $0.50
ReinisRNS: folds 
matiko09: raises $1 to $1.50
tallonn88: folds 
banit7: folds 
apfush: folds 
50CandyJoe: folds 
King brid: calls $1
*** FLOP *** [Ts 2s 3c]
King brid: checks 
matiko09: bets $2
King brid: calls $2
*** TURN *** [Ts 2s 3c] [9h]
King brid: checks 
matiko09: checks 
*** RIVER *** [Ts 2s 3c 9h] [Ad]
King brid: checks 
matiko09: checks 
*** SHOW DOWN ***
King brid: shows [Tc Jd] (a pair of Tens)
matiko09: mucks hand 
King brid collected $7.40 from pot
*** SUMMARY ***
Total pot $7.75 | Rake $0.35 
Board [Ts 2s 3c 9h Ad]
Seat 1: 50CandyJoe (big blind) folded before Flop
Seat 2: Optimistic21 folded before Flop (didn't bet)
Seat 3: Donko jr folded before Flop (didn't bet)
Seat 4: King brid showed [Tc Jd] and won ($7.40) with a pair of Tens
Seat 5: ReinisRNS folded before Flop (didn't bet)
Seat 6: matiko09 mucked [4d 4c]
Seat 7: tallonn88 folded before Flop (didn't bet)
Seat 8: banit7 (button) folded before Flop (didn't bet)
Seat 9: apfush (small blind) folded before Flop





PokerStars Hand #148607631053:  Hold'em No Limit ($0.25/$0.50 USD) - 2016/02/11 12:33:10 CET [2016/02/11 6:33:10 ET]
Table 'Amor II' 9-max Seat #2 is the button
Seat 1: Kud3 ($50 in chips) 
Seat 2: GusenokRUS ($82.87 in chips) 
Seat 3: TheMinion ($58.22 in chips) 
Seat 4: Larzdog29 ($48.02 in chips) 
Seat 5: Optimistic21 ($50 in chips) 
Seat 6: matiko09 ($50 in chips) 
Seat 7: banit7 ($50.86 in chips) 
Seat 8: Reven9er ($61.43 in chips) 
Seat 9: tallonn88 ($110.86 in chips) 
TheMinion: posts small blind $0.25
Larzdog29: posts big blind $0.50
*** HOLE CARDS ***
Dealt to matiko09 [Jc 6s]
Optimistic21: folds 
matiko09: folds 
banit7: folds 
Reven9er: folds 
tallonn88: raises $1 to $1.50
Kud3: folds 
GusenokRUS: folds 
TheMinion: folds 
Larzdog29: folds 
Uncalled bet ($1) returned to tallonn88
tallonn88 collected $1.25 from pot
tallonn88: doesn't show hand 
*** SUMMARY ***
Total pot $1.25 | Rake $0 
Seat 1: Kud3 folded before Flop (didn't bet)
Seat 2: GusenokRUS (button) folded before Flop (didn't bet)
Seat 3: TheMinion (small blind) folded before Flop
Seat 4: Larzdog29 (big blind) folded before Flop
Seat 5: Optimistic21 folded before Flop (didn't bet)
Seat 6: matiko09 folded before Flop (didn't bet)
Seat 7: banit7 folded before Flop (didn't bet)
Seat 8: Reven9er folded before Flop (didn't bet)
Seat 9: tallonn88 collected ($1.25)





PokerStars Hand #148607637082:  Hold'em No Limit ($0.25/$0.50 USD) - 2016/02/11 12:33:21 CET [2016/02/11 6:33:21 ET]
Table 'Hunan' 9-max Seat #3 is the button
Seat 1: matiko09 ($52 in chips) 
Seat 2: smirnoff993 ($142.32 in chips) 
Seat 3: TheMinion ($58.36 in chips) 
Seat 4: RICKA16 ($49.50 in chips) 
Seat 5: Honk115 ($59.98 in chips) 
Seat 6: i L00K great ($59.66 in chips) 
Seat 7: SForces33 ($21.30 in chips) 
Seat 8: Reven9er ($54.45 in chips) 
Seat 9: Optimistic21 ($56.03 in chips) 
RICKA16: posts small blind $0.25
Honk115: posts big blind $0.50
*** HOLE CARDS ***
Dealt to matiko09 [7s 9h]
i L00K great: folds 
SForces33: folds 
Reven9er: raises $0.50 to $1
Optimistic21: folds 
matiko09: folds 
smirnoff993: folds 
TheMinion: raises $3 to $4
RICKA16: folds 
Honk115: folds 
Reven9er: raises $4 to $8
TheMinion: folds 
Uncalled bet ($4) returned to Reven9er
Reven9er collected $8.75 from pot
Reven9er: doesn't show hand 
*** SUMMARY ***
Total pot $8.75 | Rake $0 
Seat 1: matiko09 folded before Flop (didn't bet)
Seat 2: smirnoff993 folded before Flop (didn't bet)
Seat 3: TheMinion (button) folded before Flop
Seat 4: RICKA16 (small blind) folded before Flop
Seat 5: Honk115 (big blind) folded before Flop
Seat 6: i L00K great folded before Flop (didn't bet)
Seat 7: SForces33 folded before Flop (didn't bet)
Seat 8: Reven9er collected ($8.75)
Seat 9: Optimistic21 folded before Flop (didn't bet)





PokerStars Hand #148607637493:  Hold'em No Limit ($0.25/$0.50 USD) - 2016/02/11 12:33:21 CET [2016/02/11 6:33:21 ET]
Table 'Sylvania II' 9-max Seat #8 is the button
Seat 1: mexx1234 ($198.93 in chips) 
Seat 2: Effort92 ($50.04 in chips) 
Seat 3: ruyingren ($177.83 in chips) 
Seat 4: matiko09 ($150.05 in chips) 
Seat 5: vlad11122007 ($69.13 in chips) 
Seat 6: TonnaMunz ($121.80 in chips) 
Seat 7: i L00K great ($51.78 in chips) 
Seat 8: Optimistic21 ($50 in chips) 
Seat 9: Kud3 ($141.66 in chips) 
Kud3: posts small blind $0.25
mexx1234: posts big blind $0.50
mexx1234: posts the ante $0.10
Effort92: posts the ante $0.10
ruyingren: posts the ante $0.10
matiko09: posts the ante $0.10
vlad11122007: posts the ante $0.10
TonnaMunz: posts the ante $0.10
i L00K great: posts the ante $0.10
Optimistic21: posts the ante $0.10
Kud3: posts the ante $0.10
*** HOLE CARDS ***
Dealt to matiko09 [4c 6s]
Effort92: folds 
Kud3 said, "this shortstack moron :D"
ruyingren: raises $1 to $1.50
matiko09: folds 
vlad11122007: folds 
TonnaMunz: folds 
i L00K great: folds 
Optimistic21: folds 
Kud3: folds 
mexx1234: folds 
Uncalled bet ($1) returned to ruyingren
ruyingren collected $2.15 from pot
ruyingren: doesn't show hand 
*** SUMMARY ***
Total pot $2.15 | Rake $0 
Seat 1: mexx1234 (big blind) folded before Flop
Seat 2: Effort92 folded before Flop (didn't bet)
Seat 3: ruyingren collected ($2.15)
Seat 4: matiko09 folded before Flop (didn't bet)
Seat 5: vlad11122007 folded before Flop (didn't bet)
Seat 6: TonnaMunz folded before Flop (didn't bet)
Seat 7: i L00K great folded before Flop (didn't bet)
Seat 8: Optimistic21 (button) folded before Flop (didn't bet)
Seat 9: Kud3 (small blind) folded before Flop





PokerStars Hand #148607642231:  Hold'em No Limit ($0.50/$1.00 USD) - 2016/02/11 12:33:30 CET [2016/02/11 6:33:30 ET]
Table 'Regor' 9-max Seat #7 is the button
Seat 1: matiko09 ($125.11 in chips) 
Seat 2: Luck In Me ($104 in chips) 
Seat 3: oscarleon ($100 in chips) 
Seat 5: chauyeuba ($47 in chips) 
Seat 7: gwwsb ($55.01 in chips) 
Seat 8: R3NZONIT3 ($54.58 in chips) 
Seat 9: CoolFireX ($112.44 in chips) 
R3NZONIT3: posts small blind $0.50
CoolFireX: posts big blind $1
Filojoes: sits out 
Dachish: sits out 
*** HOLE CARDS ***
Dealt to matiko09 [Qs Kd]
matiko09: raises $2 to $3
Luck In Me: folds 
oscarleon: calls $3
chauyeuba: folds 
gwwsb: folds 
R3NZONIT3: folds 
CoolFireX: folds 
*** FLOP *** [Ad Th Jc]
matiko09: bets $5
oscarleon: folds 
Uncalled bet ($5) returned to matiko09
matiko09 collected $7.16 from pot
matiko09: doesn't show hand 
*** SUMMARY ***
Total pot $7.50 | Rake $0.34 
Board [Ad Th Jc]
Seat 1: matiko09 collected ($7.16)
Seat 2: Luck In Me folded before Flop (didn't bet)
Seat 3: oscarleon folded on the Flop
Seat 5: chauyeuba folded before Flop (didn't bet)
Seat 7: gwwsb (button) folded before Flop (didn't bet)
Seat 8: R3NZONIT3 (small blind) folded before Flop
Seat 9: CoolFireX (big blind) folded before Flop





PokerStars Hand #148607652251:  Hold'em No Limit ($0.25/$0.50 USD) - 2016/02/11 12:33:48 CET [2016/02/11 6:33:48 ET]
Table 'Amor II' 9-max Seat #3 is the button
Seat 1: Kud3 ($50 in chips) 
Seat 2: GusenokRUS ($82.87 in chips) 
Seat 3: TheMinion ($57.97 in chips) 
Seat 4: Larzdog29 ($47.52 in chips) 
Seat 5: Optimistic21 ($50 in chips) 
Seat 6: matiko09 ($50 in chips) 
Seat 7: banit7 ($50.86 in chips) 
Seat 8: Reven9er ($61.43 in chips) 
Seat 9: tallonn88 ($111.61 in chips) 
Larzdog29: posts small blind $0.25
Optimistic21: posts big blind $0.50
*** HOLE CARDS ***
Dealt to matiko09 [Jd 5d]
matiko09: folds 
banit7: folds 
Reven9er: folds 
tallonn88: folds 
Kud3: folds 
GusenokRUS: folds 
TheMinion: folds 
Larzdog29: calls $0.25
Optimistic21: raises $0.50 to $1
Larzdog29: calls $0.50
*** FLOP *** [Qc 4c Th]
Larzdog29: checks 
Optimistic21: bets $1
Larzdog29: folds 
Uncalled bet ($1) returned to Optimistic21
Optimistic21 collected $1.91 from pot
*** SUMMARY ***
Total pot $2 | Rake $0.09 
Board [Qc 4c Th]
Seat 1: Kud3 folded before Flop (didn't bet)
Seat 2: GusenokRUS folded before Flop (didn't bet)
Seat 3: TheMinion (button) folded before Flop (didn't bet)
Seat 4: Larzdog29 (small blind) folded on the Flop
Seat 5: Optimistic21 (big blind) collected ($1.91)
Seat 6: matiko09 folded before Flop (didn't bet)
Seat 7: banit7 folded before Flop (didn't bet)
Seat 8: Reven9er folded before Flop (didn't bet)
Seat 9: tallonn88 folded before Flop (didn't bet)





PokerStars Hand #148607654660:  Hold'em No Limit ($0.25/$0.50 USD) - 2016/02/11 12:33:53 CET [2016/02/11 6:33:53 ET]
Table 'Ambrosia II' 9-max Seat #6 is the button
Seat 1: matiko09 ($50 in chips) 
Seat 2: TheMinion ($115.94 in chips) 
Seat 3: make6a ($49 in chips) 
Seat 4: huudk2016 ($7.40 in chips) 
Seat 6: Reven9er ($63.48 in chips) 
Seat 7: mexx1234 ($56.12 in chips) 
Seat 8: tallonn88 ($53.31 in chips) 
Seat 9: arctur17 ($67.07 in chips) 
mexx1234: posts small blind $0.25
tallonn88: posts big blind $0.50
RICKA16: sits out 
*** HOLE CARDS ***
Dealt to matiko09 [Td 8s]
arctur17: folds 
matiko09: folds 
TheMinion: folds 
make6a: folds 
huudk2016: calls $0.50
Reven9er: folds 
mexx1234: calls $0.25
tallonn88: checks 
*** FLOP *** [2c 5d 4d]
mexx1234: bets $0.50
tallonn88: folds 
huudk2016: raises $2 to $2.50
mexx1234: calls $2
*** TURN *** [2c 5d 4d] [3d]
mexx1234: checks 
huudk2016: bets $4.40 and is all-in
mexx1234: calls $4.40
*** RIVER *** [2c 5d 4d 3d] [2s]
*** SHOW DOWN ***
mexx1234: shows [As 5h] (a straight, Ace to Five)
huudk2016: shows [7s 7d] (two pair, Sevens and Deuces)
mexx1234 collected $14.61 from pot
*** SUMMARY ***
Total pot $15.30 | Rake $0.69 
Board [2c 5d 4d 3d 2s]
Seat 1: matiko09 folded before Flop (didn't bet)
Seat 2: TheMinion folded before Flop (didn't bet)
Seat 3: make6a folded before Flop (didn't bet)
Seat 4: huudk2016 showed [7s 7d] and lost with two pair, Sevens and Deuces
Seat 6: Reven9er (button) folded before Flop (didn't bet)
Seat 7: mexx1234 (small blind) showed [As 5h] and won ($14.61) with a straight, Ace to Five
Seat 8: tallonn88 (big blind) folded on the Flop
Seat 9: arctur17 folded before Flop (didn't bet)





PokerStars Hand #148607655874:  Hold'em No Limit (€0.25/€0.50 EUR) - 2016/02/11 12:33:55 CET [2016/02/11 6:33:55 ET]
Table 'Otero II' 9-max Seat #7 is the button
Seat 1: Nacho2556 (€42.65 in chips) 
Seat 3: chaogoose82 (€71.28 in chips) 
Seat 5: vlad11122007 (€49.75 in chips) 
Seat 6: TonnaMunz (€52.19 in chips) 
Seat 7: PacPacBum (€50 in chips) 
Seat 8: matiko09 (€64.83 in chips) 
Seat 9: Optimistic21 (€59.29 in chips) 
matiko09: posts small blind €0.25
Optimistic21: posts big blind €0.50
*** HOLE CARDS ***
Dealt to matiko09 [6d Kd]
Nacho2556: folds 
chaogoose82: folds 
vlad11122007: folds 
TonnaMunz: raises €0.68 to €1.18
PacPacBum: folds 
matiko09: folds 
Optimistic21: folds 
Uncalled bet (€0.68) returned to TonnaMunz
TonnaMunz collected €1.25 from pot
TonnaMunz: doesn't show hand 
*** SUMMARY ***
Total pot €1.25 | Rake €0 
Seat 1: Nacho2556 folded before Flop (didn't bet)
Seat 3: chaogoose82 folded before Flop (didn't bet)
Seat 5: vlad11122007 folded before Flop (didn't bet)
Seat 6: TonnaMunz collected (€1.25)
Seat 7: PacPacBum (button) folded before Flop (didn't bet)
Seat 8: matiko09 (small blind) folded before Flop
Seat 9: Optimistic21 (big blind) folded before Flop





PokerStars Hand #148607657087:  Hold'em No Limit ($0.25/$0.50 USD) - 2016/02/11 12:33:57 CET [2016/02/11 6:33:57 ET]
Table 'Sylvania II' 9-max Seat #9 is the button
Seat 1: mexx1234 ($198.33 in chips) 
Seat 2: Effort92 ($50 in chips) 
Seat 3: ruyingren ($179.38 in chips) 
Seat 4: matiko09 ($149.95 in chips) 
Seat 5: vlad11122007 ($69.03 in chips) 
Seat 6: TonnaMunz ($121.70 in chips) 
Seat 7: i L00K great ($51.68 in chips) 
Seat 8: Optimistic21 ($50 in chips) 
Seat 9: Kud3 ($141.31 in chips) 
mexx1234: posts small blind $0.25
Effort92: posts big blind $0.50
mexx1234: posts the ante $0.10
Effort92: posts the ante $0.10
ruyingren: posts the ante $0.10
matiko09: posts the ante $0.10
vlad11122007: posts the ante $0.10
TonnaMunz: posts the ante $0.10
i L00K great: posts the ante $0.10
Optimistic21: posts the ante $0.10
Kud3: posts the ante $0.10
*** HOLE CARDS ***
Dealt to matiko09 [Qc 8s]
ruyingren: folds 
matiko09: folds 
vlad11122007: folds 
TonnaMunz: folds 
i L00K great: folds 
Optimistic21: raises $1 to $1.50
Kud3: folds 
mexx1234: folds 
Effort92: folds 
Uncalled bet ($1) returned to Optimistic21
Optimistic21 collected $2.15 from pot
*** SUMMARY ***
Total pot $2.15 | Rake $0 
Seat 1: mexx1234 (small blind) folded before Flop
Seat 2: Effort92 (big blind) folded before Flop
Seat 3: ruyingren folded before Flop (didn't bet)
Seat 4: matiko09 folded before Flop (didn't bet)
Seat 5: vlad11122007 folded before Flop (didn't bet)
Seat 6: TonnaMunz folded before Flop (didn't bet)
Seat 7: i L00K great folded before Flop (didn't bet)
Seat 8: Optimistic21 collected ($2.15)
Seat 9: Kud3 (button) folded before Flop (didn't bet)





PokerStars Hand #148607661118:  Hold'em No Limit ($0.50/$1.00 USD) - 2016/02/11 12:34:04 CET [2016/02/11 6:34:04 ET]
Table 'Regor' 9-max Seat #8 is the button
Seat 1: matiko09 ($129.27 in chips) 
Seat 2: Luck In Me ($104 in chips) 
Seat 3: oscarleon ($100 in chips) 
Seat 5: chauyeuba ($47 in chips) 
Seat 7: gwwsb ($55.01 in chips) 
Seat 8: R3NZONIT3 ($54.08 in chips) 
Seat 9: CoolFireX ($111.44 in chips) 
CoolFireX: posts small blind $0.50
matiko09: posts big blind $1
Filojoes: sits out 
Dachish: sits out 
*** HOLE CARDS ***
Dealt to matiko09 [Ks 4d]
Luck In Me: folds 
oscarleon: raises $2 to $3
chauyeuba: folds 
gwwsb: folds 
R3NZONIT3: folds 
CoolFireX: folds 
matiko09: folds 
Uncalled bet ($2) returned to oscarleon
oscarleon collected $2.50 from pot
oscarleon: doesn't show hand 
*** SUMMARY ***
Total pot $2.50 | Rake $0 
Seat 1: matiko09 (big blind) folded before Flop
Seat 2: Luck In Me folded before Flop (didn't bet)
Seat 3: oscarleon collected ($2.50)
Seat 5: chauyeuba folded before Flop (didn't bet)
Seat 7: gwwsb folded before Flop (didn't bet)
Seat 8: R3NZONIT3 (button) folded before Flop (didn't bet)
Seat 9: CoolFireX (small blind) folded before Flop





PokerStars Hand #148607661406:  Hold'em No Limit ($0.50/$1.00 USD) - 2016/02/11 12:34:05 CET [2016/02/11 6:34:05 ET]
Table 'Sycorax II' 9-max Seat #6 is the button
Seat 1: Luck In Me ($155.22 in chips) 
Seat 2: Lujan87 ($100 in chips) 
Seat 3: chauyeuba ($48.50 in chips) 
Seat 4: Sweden_Pound ($141.24 in chips) 
Seat 5: Effort92 ($170.94 in chips) 
Seat 6: FluentFlows ($40.50 in chips) 
Seat 7: hurtNCYDE ($117.88 in chips) 
Seat 8: matiko09 ($127.87 in chips) 
hurtNCYDE: posts small blind $0.50
matiko09: posts big blind $1
*** HOLE CARDS ***
Dealt to matiko09 [2h 7d]
Luck In Me: raises $2 to $3
Lujan87: folds 
chauyeuba: folds 
Sweden_Pound: folds 
Effort92: folds 
FluentFlows: folds 
hurtNCYDE: folds 
matiko09: folds 
Uncalled bet ($2) returned to Luck In Me
Luck In Me collected $2.50 from pot
Luck In Me: doesn't show hand 
*** SUMMARY ***
Total pot $2.50 | Rake $0 
Seat 1: Luck In Me collected ($2.50)
Seat 2: Lujan87 folded before Flop (didn't bet)
Seat 3: chauyeuba folded before Flop (didn't bet)
Seat 4: Sweden_Pound folded before Flop (didn't bet)
Seat 5: Effort92 folded before Flop (didn't bet)
Seat 6: FluentFlows (button) folded before Flop (didn't bet)
Seat 7: hurtNCYDE (small blind) folded before Flop
Seat 8: matiko09 (big blind) folded before Flop





PokerStars Hand #148607667755:  Hold'em No Limit (€0.25/€0.50 EUR) - 2016/02/11 12:34:16 CET [2016/02/11 6:34:16 ET]
Table 'Otero II' 9-max Seat #8 is the button
Seat 1: Nacho2556 (€42.65 in chips) 
Seat 3: chaogoose82 (€71.28 in chips) 
Seat 5: vlad11122007 (€49.75 in chips) 
Seat 6: TonnaMunz (€52.94 in chips) 
Seat 7: PacPacBum (€50 in chips) 
Seat 8: matiko09 (€64.58 in chips) 
Seat 9: Optimistic21 (€58.79 in chips) 
Optimistic21: posts small blind €0.25
Nacho2556: posts big blind €0.50
*** HOLE CARDS ***
Dealt to matiko09 [Ah Ts]
chaogoose82: raises €1 to €1.50
vlad11122007: calls €1.50
TonnaMunz: calls €1.50
PacPacBum: calls €1.50
kram0909 joins the table at seat #4 
make6a joins the table at seat #2 
matiko09: raises €5.50 to €7
Optimistic21: folds 
Nacho2556: folds 
chaogoose82: folds 
vlad11122007: calls €5.50
TonnaMunz: folds 
PacPacBum: folds 
*** FLOP *** [Th 7s 7d]
vlad11122007: checks 
matiko09: bets €6.50
vlad11122007: folds 
Uncalled bet (€6.50) returned to matiko09
matiko09 collected €18.38 from pot
matiko09: doesn't show hand 
*** SUMMARY ***
Total pot €19.25 | Rake €0.87 
Board [Th 7s 7d]
Seat 1: Nacho2556 (big blind) folded before Flop
Seat 3: chaogoose82 folded before Flop
Seat 5: vlad11122007 folded on the Flop
Seat 6: TonnaMunz folded before Flop
Seat 7: PacPacBum folded before Flop
Seat 8: matiko09 (button) collected (€18.38)
Seat 9: Optimistic21 (small blind) folded before Flop





PokerStars Hand #148607670112:  Hold'em No Limit ($0.25/$0.50 USD) - 2016/02/11 12:34:21 CET [2016/02/11 6:34:21 ET]
Table 'Stereoskopia' 9-max Seat #9 is the button
Seat 1: 50CandyJoe ($53.33 in chips) 
Seat 2: Optimistic21 ($50.50 in chips) 
Seat 3: Donko jr ($13.65 in chips) 
Seat 4: King brid ($73.56 in chips) 
Seat 5: ReinisRNS ($30.63 in chips) 
Seat 6: matiko09 ($50 in chips) 
Seat 7: tallonn88 ($104.92 in chips) 
Seat 8: banit7 ($83.28 in chips) 
Seat 9: apfush ($50 in chips) 
50CandyJoe: posts small blind $0.25
Optimistic21: posts big blind $0.50
*** HOLE CARDS ***
Dealt to matiko09 [7s Jh]
Donko jr: calls $0.50
King brid: calls $0.50
ReinisRNS: folds 
matiko09: folds 
tallonn88: folds 
banit7: raises $2 to $2.50
apfush: calls $2.50
50CandyJoe: folds 
Optimistic21: raises $8 to $10.50
Donko jr: folds 
King brid: folds 
banit7: folds 
apfush: folds 
Uncalled bet ($8) returned to Optimistic21
Optimistic21 collected $8.75 from pot
*** SUMMARY ***
Total pot $8.75 | Rake $0 
Seat 1: 50CandyJoe (small blind) folded before Flop
Seat 2: Optimistic21 (big blind) collected ($8.75)
Seat 3: Donko jr folded before Flop
Seat 4: King brid folded before Flop
Seat 5: ReinisRNS folded before Flop (didn't bet)
Seat 6: matiko09 folded before Flop (didn't bet)
Seat 7: tallonn88 folded before Flop (didn't bet)
Seat 8: banit7 folded before Flop
Seat 9: apfush (button) folded before Flop





PokerStars Hand #148607671237:  Hold'em No Limit ($0.50/$1.00 USD) - 2016/02/11 12:34:23 CET [2016/02/11 6:34:23 ET]
Table 'Regor' 9-max Seat #9 is the button
Seat 1: matiko09 ($128.27 in chips) 
Seat 2: Luck In Me ($104 in chips) 
Seat 3: oscarleon ($101.50 in chips) 
Seat 5: chauyeuba ($47 in chips) 
Seat 7: gwwsb ($55.01 in chips) 
Seat 8: R3NZONIT3 ($54.08 in chips) 
Seat 9: CoolFireX ($110.94 in chips) 
matiko09: posts small blind $0.50
Luck In Me: posts big blind $1
Filojoes: sits out 
Dachish: sits out 
*** HOLE CARDS ***
Dealt to matiko09 [7h 4s]
oscarleon: folds 
chauyeuba: folds 
gwwsb: folds 
R3NZONIT3: folds 
CoolFireX: raises $1.50 to $2.50
matiko09: folds 
Luck In Me: folds 
Uncalled bet ($1.50) returned to CoolFireX
CoolFireX collected $2.50 from pot
CoolFireX: doesn't show hand 
*** SUMMARY ***
Total pot $2.50 | Rake $0 
Seat 1: matiko09 (small blind) folded before Flop
Seat 2: Luck In Me (big blind) folded before Flop
Seat 3: oscarleon folded before Flop (didn't bet)
Seat 5: chauyeuba folded before Flop (didn't bet)
Seat 7: gwwsb folded before Flop (didn't bet)
Seat 8: R3NZONIT3 folded before Flop (didn't bet)
Seat 9: CoolFireX (button) collected ($2.50)





PokerStars Hand #148607672157:  Hold'em No Limit ($0.25/$0.50 USD) - 2016/02/11 12:34:24 CET [2016/02/11 6:34:24 ET]
Table 'Hunan' 9-max Seat #4 is the button
Seat 1: matiko09 ($52 in chips) 
Seat 2: smirnoff993 ($142.32 in chips) 
Seat 3: TheMinion ($54.36 in chips) 
Seat 4: RICKA16 ($50 in chips) 
Seat 5: Honk115 ($59.48 in chips) 
Seat 6: i L00K great ($59.66 in chips) 
Seat 7: SForces33 ($21.30 in chips) 
Seat 8: Reven9er ($59.20 in chips) 
Seat 9: Optimistic21 ($56.03 in chips) 
Honk115: posts small blind $0.25
i L00K great: posts big blind $0.50
*** HOLE CARDS ***
Dealt to matiko09 [8d 7h]
SForces33: folds 
Reven9er: folds 
Optimistic21: folds 
matiko09: folds 
smirnoff993: raises $1 to $1.50
TheMinion: folds 
RICKA16: folds 
Honk115: folds 
i L00K great: folds 
Uncalled bet ($1) returned to smirnoff993
smirnoff993 collected $1.25 from pot
smirnoff993: doesn't show hand 
*** SUMMARY ***
Total pot $1.25 | Rake $0 
Seat 1: matiko09 folded before Flop (didn't bet)
Seat 2: smirnoff993 collected ($1.25)
Seat 3: TheMinion folded before Flop (didn't bet)
Seat 4: RICKA16 (button) folded before Flop (didn't bet)
Seat 5: Honk115 (small blind) folded before Flop
Seat 6: i L00K great (big blind) folded before Flop
Seat 7: SForces33 folded before Flop (didn't bet)
Seat 8: Reven9er folded before Flop (didn't bet)
Seat 9: Optimistic21 folded before Flop (didn't bet)





PokerStars Hand #148607673994:  Hold'em No Limit ($0.25/$0.50 USD) - 2016/02/11 12:34:28 CET [2016/02/11 6:34:28 ET]
Table 'Algedi' 9-max Seat #4 is the button
Seat 1: vlad11122007 ($52.67 in chips) 
Seat 2: Reffypaul ($78 in chips) 
Seat 4: Effort92 ($54.73 in chips) 
Seat 6: TonnaMunz ($124.36 in chips) 
Seat 7: hoedtrob ($63.86 in chips) 
Seat 8: matiko09 ($50 in chips) 
Seat 9: Kud3 ($128.15 in chips) 
TonnaMunz: posts small blind $0.25
hoedtrob: posts big blind $0.50
Reffypaul: posts big blind $0.50
Saggitaurus: sits out 
vlad11122007: posts the ante $0.10
Reffypaul: posts the ante $0.10
Effort92: posts the ante $0.10
TonnaMunz: posts the ante $0.10
hoedtrob: posts the ante $0.10
matiko09: posts the ante $0.10
Kud3: posts the ante $0.10
*** HOLE CARDS ***
Dealt to matiko09 [9c 8c]
matiko09: raises $1.50 to $2
Kud3: folds 
vlad11122007: folds 
Reffypaul: calls $1.50
Effort92: folds 
TonnaMunz: folds 
hoedtrob: folds 
*** FLOP *** [Kc Qd 4s]
matiko09: checks 
Reffypaul: bets $1
matiko09: folds 
Uncalled bet ($1) returned to Reffypaul
Reffypaul collected $5.20 from pot
*** SUMMARY ***
Total pot $5.45 | Rake $0.25 
Board [Kc Qd 4s]
Seat 1: vlad11122007 folded before Flop (didn't bet)
Seat 2: Reffypaul collected ($5.20)
Seat 4: Effort92 (button) folded before Flop (didn't bet)
Seat 6: TonnaMunz (small blind) folded before Flop
Seat 7: hoedtrob (big blind) folded before Flop
Seat 8: matiko09 folded on the Flop
Seat 9: Kud3 folded before Flop (didn't bet)





PokerStars Hand #148607675160:  Hold'em No Limit ($0.25/$0.50 USD) - 2016/02/11 12:34:30 CET [2016/02/11 6:34:30 ET]
Table 'Sylvania II' 9-max Seat #1 is the button
Seat 1: mexx1234 ($197.98 in chips) 
Seat 2: Effort92 ($50 in chips) 
Seat 3: ruyingren ($179.28 in chips) 
Seat 4: matiko09 ($149.85 in chips) 
Seat 5: vlad11122007 ($68.93 in chips) 
Seat 6: TonnaMunz ($121.60 in chips) 
Seat 7: i L00K great ($51.58 in chips) 
Seat 8: Optimistic21 ($51.55 in chips) 
Seat 9: Kud3 ($141.21 in chips) 
Effort92: posts small blind $0.25
ruyingren: posts big blind $0.50
mexx1234: posts the ante $0.10
Effort92: posts the ante $0.10
ruyingren: posts the ante $0.10
matiko09: posts the ante $0.10
vlad11122007: posts the ante $0.10
TonnaMunz: posts the ante $0.10
i L00K great: posts the ante $0.10
Optimistic21: posts the ante $0.10
Kud3: posts the ante $0.10
*** HOLE CARDS ***
Dealt to matiko09 [9h 7s]
matiko09: folds 
vlad11122007: folds 
TonnaMunz: folds 
i L00K great: folds 
Optimistic21: folds 
Kud3: folds 
mexx1234: raises $0.75 to $1.25
Effort92: calls $1
ruyingren: calls $0.75
*** FLOP *** [3s 5c 6d]
Effort92: checks 
ruyingren: bets $3
mexx1234: folds 
Effort92: folds 
Uncalled bet ($3) returned to ruyingren
ruyingren collected $4.44 from pot
ruyingren: doesn't show hand 
*** SUMMARY ***
Total pot $4.65 | Rake $0.21 
Board [3s 5c 6d]
Seat 1: mexx1234 (button) folded on the Flop
Seat 2: Effort92 (small blind) folded on the Flop
Seat 3: ruyingren (big blind) collected ($4.44)
Seat 4: matiko09 folded before Flop (didn't bet)
Seat 5: vlad11122007 folded before Flop (didn't bet)
Seat 6: TonnaMunz folded before Flop (didn't bet)
Seat 7: i L00K great folded before Flop (didn't bet)
Seat 8: Optimistic21 folded before Flop (didn't bet)
Seat 9: Kud3 folded before Flop (didn't bet)





PokerStars Hand #148607677347:  Hold'em No Limit ($0.25/$0.50 USD) - 2016/02/11 12:34:34 CET [2016/02/11 6:34:34 ET]
Table 'Amor II' 9-max Seat #4 is the button
Seat 1: Kud3 ($50 in chips) 
Seat 2: GusenokRUS ($82.87 in chips) 
Seat 3: TheMinion ($57.97 in chips) 
Seat 4: Larzdog29 ($46.52 in chips) 
Seat 5: Optimistic21 ($50.91 in chips) 
Seat 6: matiko09 ($50 in chips) 
Seat 7: banit7 ($50.86 in chips) 
Seat 8: Reven9er ($61.43 in chips) 
Seat 9: tallonn88 ($111.61 in chips) 
Optimistic21: posts small blind $0.25
matiko09: posts big blind $0.50
*** HOLE CARDS ***
Dealt to matiko09 [6s 5s]
banit7: folds 
Reven9er: folds 
tallonn88: folds 
Kud3: folds 
GusenokRUS: folds 
TheMinion: folds 
Larzdog29: folds 
Optimistic21: folds 
Uncalled bet ($0.25) returned to matiko09
matiko09 collected $0.50 from pot
matiko09: doesn't show hand 
*** SUMMARY ***
Total pot $0.50 | Rake $0 
Seat 1: Kud3 folded before Flop (didn't bet)
Seat 2: GusenokRUS folded before Flop (didn't bet)
Seat 3: TheMinion folded before Flop (didn't bet)
Seat 4: Larzdog29 (button) folded before Flop (didn't bet)
Seat 5: Optimistic21 (small blind) folded before Flop
Seat 6: matiko09 (big blind) collected ($0.50)
Seat 7: banit7 folded before Flop (didn't bet)
Seat 8: Reven9er folded before Flop (didn't bet)
Seat 9: tallonn88 folded before Flop (didn't bet)





PokerStars Hand #148607681121:  Hold'em No Limit ($0.50/$1.00 USD) - 2016/02/11 12:34:40 CET [2016/02/11 6:34:40 ET]
Table 'Sycorax II' 9-max Seat #7 is the button
Seat 1: Luck In Me ($156.72 in chips) 
Seat 2: Lujan87 ($100 in chips) 
Seat 3: chauyeuba ($48.50 in chips) 
Seat 4: Sweden_Pound ($141.24 in chips) 
Seat 5: Effort92 ($170.94 in chips) 
Seat 6: FluentFlows ($40.50 in chips) 
Seat 7: hurtNCYDE ($117.38 in chips) 
Seat 8: matiko09 ($126.87 in chips) 
Seat 9: mrfoldcall ($100 in chips) 
matiko09: posts small blind $0.50
mrfoldcall: posts big blind $1
*** HOLE CARDS ***
Dealt to matiko09 [Qh Qc]
Luck In Me: folds 
Lujan87: folds 
chauyeuba: folds 
Sweden_Pound: folds 
Effort92: raises $2 to $3
FluentFlows: calls $3
hurtNCYDE: folds 
matiko09: raises $9 to $12
mrfoldcall: folds 
Effort92: folds 
FluentFlows: folds 
Uncalled bet ($9) returned to matiko09
matiko09 collected $10 from pot
matiko09: doesn't show hand 
*** SUMMARY ***
Total pot $10 | Rake $0 
Seat 1: Luck In Me folded before Flop (didn't bet)
Seat 2: Lujan87 folded before Flop (didn't bet)
Seat 3: chauyeuba folded before Flop (didn't bet)
Seat 4: Sweden_Pound folded before Flop (didn't bet)
Seat 5: Effort92 folded before Flop
Seat 6: FluentFlows folded before Flop
Seat 7: hurtNCYDE (button) folded before Flop (didn't bet)
Seat 8: matiko09 (small blind) collected ($10)
Seat 9: mrfoldcall (big blind) folded before Flop





PokerStars Hand #148607686043:  Hold'em No Limit ($0.25/$0.50 USD) - 2016/02/11 12:34:49 CET [2016/02/11 6:34:49 ET]
Table 'Amor II' 9-max Seat #5 is the button
Seat 1: Kud3 ($50 in chips) 
Seat 2: GusenokRUS ($82.87 in chips) 
Seat 3: TheMinion ($57.97 in chips) 
Seat 4: Larzdog29 ($46.52 in chips) 
Seat 5: Optimistic21 ($50.66 in chips) 
Seat 6: matiko09 ($50.25 in chips) 
Seat 8: Reven9er ($61.43 in chips) 
Seat 9: tallonn88 ($111.61 in chips) 
matiko09: posts small blind $0.25
banit7: is sitting out 
Reven9er: posts big blind $0.50
*** HOLE CARDS ***
Dealt to matiko09 [9h 6d]
tallonn88: folds 
Kud3: folds 
banit7 leaves the table
Serhent joins the table at seat #7 
GusenokRUS has timed out
GusenokRUS: folds 
TheMinion: folds 
Larzdog29: folds 
Optimistic21: folds 
matiko09: folds 
Uncalled bet ($0.25) returned to Reven9er
Reven9er collected $0.50 from pot
Reven9er: doesn't show hand 
*** SUMMARY ***
Total pot $0.50 | Rake $0 
Seat 1: Kud3 folded before Flop (didn't bet)
Seat 2: GusenokRUS folded before Flop (didn't bet)
Seat 3: TheMinion folded before Flop (didn't bet)
Seat 4: Larzdog29 folded before Flop (didn't bet)
Seat 5: Optimistic21 (button) folded before Flop (didn't bet)
Seat 6: matiko09 (small blind) folded before Flop
Seat 8: Reven9er (big blind) collected ($0.50)
Seat 9: tallonn88 folded before Flop (didn't bet)





PokerStars Hand #148607687107:  Hold'em No Limit ($0.50/$1.00 USD) - 2016/02/11 12:34:51 CET [2016/02/11 6:34:51 ET]
Table 'Regor' 9-max Seat #1 is the button
Seat 1: matiko09 ($127.77 in chips) 
Seat 2: Luck In Me ($103 in chips) 
Seat 3: oscarleon ($101.50 in chips) 
Seat 5: chauyeuba ($47 in chips) 
Seat 7: gwwsb ($55.01 in chips) 
Seat 8: R3NZONIT3 ($54.08 in chips) 
Seat 9: CoolFireX ($112.44 in chips) 
Luck In Me: posts small blind $0.50
oscarleon: posts big blind $1
Filojoes: sits out 
Dachish: sits out 
*** HOLE CARDS ***
Dealt to matiko09 [9d 7s]
chauyeuba: raises $1.50 to $2.50
gwwsb: calls $2.50
R3NZONIT3: calls $2.50
CoolFireX: folds 
matiko09: folds 
Luck In Me: calls $2
oscarleon: calls $1.50
*** FLOP *** [3h Kd 5h]
Luck In Me: checks 
oscarleon: checks 
chauyeuba: checks 
gwwsb: bets $5.97
R3NZONIT3: calls $5.97
Luck In Me: folds 
oscarleon: folds 
chauyeuba: folds 
*** TURN *** [3h Kd 5h] [6s]
gwwsb: checks 
R3NZONIT3: bets $7
gwwsb: calls $7
*** RIVER *** [3h Kd 5h 6s] [Qs]
gwwsb: checks 
R3NZONIT3: checks 
*** SHOW DOWN ***
gwwsb: shows [8s 8d] (a pair of Eights)
R3NZONIT3: shows [Ks Js] (a pair of Kings)
R3NZONIT3 collected $36.71 from pot
*** SUMMARY ***
Total pot $38.44 | Rake $1.73 
Board [3h Kd 5h 6s Qs]
Seat 1: matiko09 (button) folded before Flop (didn't bet)
Seat 2: Luck In Me (small blind) folded on the Flop
Seat 3: oscarleon (big blind) folded on the Flop
Seat 5: chauyeuba folded on the Flop
Seat 7: gwwsb showed [8s 8d] and lost with a pair of Eights
Seat 8: R3NZONIT3 showed [Ks Js] and won ($36.71) with a pair of Kings
Seat 9: CoolFireX folded before Flop (didn't bet)





PokerStars Hand #148607691882:  Hold'em No Limit ($0.25/$0.50 USD) - 2016/02/11 12:35:00 CET [2016/02/11 6:35:00 ET]
Table 'Hunan' 9-max Seat #5 is the button
Seat 1: matiko09 ($52 in chips) 
Seat 2: smirnoff993 ($143.07 in chips) 
Seat 3: TheMinion ($54.36 in chips) 
Seat 4: RICKA16 ($50 in chips) 
Seat 5: Honk115 ($59.23 in chips) 
Seat 6: i L00K great ($59.16 in chips) 
Seat 7: SForces33 ($21.30 in chips) 
Seat 8: Reven9er ($59.20 in chips) 
Seat 9: Optimistic21 ($56.03 in chips) 
i L00K great: posts small blind $0.25
SForces33: posts big blind $0.50
*** HOLE CARDS ***
Dealt to matiko09 [7h Ts]
Reven9er: folds 
Optimistic21: folds 
matiko09: folds 
smirnoff993: folds 
TheMinion: folds 
RICKA16: raises $1 to $1.50
Honk115: folds 
i L00K great: folds 
SForces33: folds 
Uncalled bet ($1) returned to RICKA16
RICKA16 collected $1.25 from pot
RICKA16: doesn't show hand 
*** SUMMARY ***
Total pot $1.25 | Rake $0 
Seat 1: matiko09 folded before Flop (didn't bet)
Seat 2: smirnoff993 folded before Flop (didn't bet)
Seat 3: TheMinion folded before Flop (didn't bet)
Seat 4: RICKA16 collected ($1.25)
Seat 5: Honk115 (button) folded before Flop (didn't bet)
Seat 6: i L00K great (small blind) folded before Flop
Seat 7: SForces33 (big blind) folded before Flop
Seat 8: Reven9er folded before Flop (didn't bet)
Seat 9: Optimistic21 folded before Flop (didn't bet)





PokerStars Hand #148607698275:  Hold'em No Limit ($0.25/$0.50 USD) - 2016/02/11 12:35:11 CET [2016/02/11 6:35:11 ET]
Table 'Ambrosia II' 9-max Seat #7 is the button
Seat 1: matiko09 ($50 in chips) 
Seat 2: TheMinion ($115.94 in chips) 
Seat 3: make6a ($49 in chips) 
Seat 6: Reven9er ($63.48 in chips) 
Seat 7: mexx1234 ($63.33 in chips) 
Seat 8: tallonn88 ($52.81 in chips) 
tallonn88: posts small blind $0.25
matiko09: posts big blind $0.50
RICKA16: sits out 
*** HOLE CARDS ***
Dealt to matiko09 [6c 4d]
TheMinion: folds 
make6a: folds 
Reven9er: folds 
mexx1234: raises $0.75 to $1.25
tallonn88: folds 
matiko09: folds 
Uncalled bet ($0.75) returned to mexx1234
mexx1234 collected $1.25 from pot
mexx1234: doesn't show hand 
*** SUMMARY ***
Total pot $1.25 | Rake $0 
Seat 1: matiko09 (big blind) folded before Flop
Seat 2: TheMinion folded before Flop (didn't bet)
Seat 3: make6a folded before Flop (didn't bet)
Seat 6: Reven9er folded before Flop (didn't bet)
Seat 7: mexx1234 (button) collected ($1.25)
Seat 8: tallonn88 (small blind) folded before Flop





PokerStars Hand #148607699510:  Hold'em No Limit ($0.25/$0.50 USD) - 2016/02/11 12:35:14 CET [2016/02/11 6:35:14 ET]
Table 'Algedi' 9-max Seat #6 is the button
Seat 1: vlad11122007 ($52.57 in chips) 
Seat 2: Reffypaul ($81.10 in chips) 
Seat 4: Effort92 ($54.63 in chips) 
Seat 6: TonnaMunz ($124.01 in chips) 
Seat 7: hoedtrob ($63.26 in chips) 
Seat 8: matiko09 ($50 in chips) 
Seat 9: Kud3 ($128.05 in chips) 
hoedtrob: posts small blind $0.25
matiko09: posts big blind $0.50
Saggitaurus: sits out 
vlad11122007: posts the ante $0.10
Reffypaul: posts the ante $0.10
Effort92: posts the ante $0.10
TonnaMunz: posts the ante $0.10
hoedtrob: posts the ante $0.10
matiko09: posts the ante $0.10
Kud3: posts the ante $0.10
*** HOLE CARDS ***
Dealt to matiko09 [2h Ks]
Kud3: folds 
vlad11122007: folds 
Reffypaul is connected 
Reffypaul: folds 
Effort92: folds 
TonnaMunz: folds 
hoedtrob: folds 
Uncalled bet ($0.25) returned to matiko09
matiko09 collected $1.20 from pot
matiko09: doesn't show hand 
*** SUMMARY ***
Total pot $1.20 | Rake $0 
Seat 1: vlad11122007 folded before Flop (didn't bet)
Seat 2: Reffypaul folded before Flop (didn't bet)
Seat 4: Effort92 folded before Flop (didn't bet)
Seat 6: TonnaMunz (button) folded before Flop (didn't bet)
Seat 7: hoedtrob (small blind) folded before Flop
Seat 8: matiko09 (big blind) collected ($1.20)
Seat 9: Kud3 folded before Flop (didn't bet)





PokerStars Hand #148607705045:  Hold'em No Limit ($0.25/$0.50 USD) - 2016/02/11 12:35:24 CET [2016/02/11 6:35:24 ET]
Table 'Amor II' 9-max Seat #6 is the button
Seat 1: Kud3 ($50 in chips) 
Seat 3: TheMinion ($57.97 in chips) 
Seat 4: Larzdog29 ($46.52 in chips) 
Seat 5: Optimistic21 ($50.66 in chips) 
Seat 6: matiko09 ($50 in chips) 
Seat 8: Reven9er ($61.68 in chips) 
Seat 9: tallonn88 ($111.61 in chips) 
Serhent will be allowed to play after the button
Reven9er: posts small blind $0.25
tallonn88: posts big blind $0.50
*** HOLE CARDS ***
Dealt to matiko09 [Ad Th]
Kud3: raises $1 to $1.50
TheMinion: folds 
Larzdog29: folds 
Optimistic21: folds 
matiko09: folds 
Reven9er: folds 
tallonn88: folds 
Uncalled bet ($1) returned to Kud3
Kud3 collected $1.25 from pot
Kud3: doesn't show hand 
*** SUMMARY ***
Total pot $1.25 | Rake $0 
Seat 1: Kud3 collected ($1.25)
Seat 3: TheMinion folded before Flop (didn't bet)
Seat 4: Larzdog29 folded before Flop (didn't bet)
Seat 5: Optimistic21 folded before Flop (didn't bet)
Seat 6: matiko09 (button) folded before Flop (didn't bet)
Seat 8: Reven9er (small blind) folded before Flop
Seat 9: tallonn88 (big blind) folded before Flop





PokerStars Hand #148607707305:  Hold'em No Limit ($0.25/$0.50 USD) - 2016/02/11 12:35:28 CET [2016/02/11 6:35:28 ET]
Table 'Hunan' 9-max Seat #6 is the button
Seat 1: matiko09 ($52 in chips) 
Seat 2: smirnoff993 ($143.07 in chips) 
Seat 3: TheMinion ($54.36 in chips) 
Seat 4: RICKA16 ($50.75 in chips) 
Seat 5: Honk115 ($59.23 in chips) 
Seat 6: i L00K great ($58.91 in chips) 
Seat 7: SForces33 ($20.80 in chips) 
Seat 8: Reven9er ($59.20 in chips) 
Seat 9: Optimistic21 ($56.03 in chips) 
SForces33: posts small blind $0.25
Reven9er: posts big blind $0.50
*** HOLE CARDS ***
Dealt to matiko09 [As 6s]
Optimistic21: folds 
matiko09: folds 
smirnoff993: folds 
TheMinion: folds 
RICKA16: folds 
Honk115: folds 
i L00K great: raises $0.50 to $1
SForces33: folds 
Reven9er: folds 
Uncalled bet ($0.50) returned to i L00K great
i L00K great collected $1.25 from pot
i L00K great: doesn't show hand 
*** SUMMARY ***
Total pot $1.25 | Rake $0 
Seat 1: matiko09 folded before Flop (didn't bet)
Seat 2: smirnoff993 folded before Flop (didn't bet)
Seat 3: TheMinion folded before Flop (didn't bet)
Seat 4: RICKA16 folded before Flop (didn't bet)
Seat 5: Honk115 folded before Flop (didn't bet)
Seat 6: i L00K great (button) collected ($1.25)
Seat 7: SForces33 (small blind) folded before Flop
Seat 8: Reven9er (big blind) folded before Flop
Seat 9: Optimistic21 folded before Flop (didn't bet)





PokerStars Hand #148607711208:  Hold'em No Limit ($0.50/$1.00 USD) - 2016/02/11 12:35:35 CET [2016/02/11 6:35:35 ET]
Table 'Sycorax II' 9-max Seat #8 is the button
Seat 1: Luck In Me ($156.72 in chips) 
Seat 2: Lujan87 ($100 in chips) 
Seat 3: chauyeuba ($48.50 in chips) 
Seat 4: Sweden_Pound ($141.24 in chips) 
Seat 5: Effort92 ($167.94 in chips) 
Seat 6: FluentFlows ($37.50 in chips) 
Seat 7: hurtNCYDE ($117.38 in chips) 
Seat 8: matiko09 ($133.87 in chips) 
Seat 9: mrfoldcall ($99 in chips) 
mrfoldcall: posts small blind $0.50
Luck In Me: posts big blind $1
*** HOLE CARDS ***
Dealt to matiko09 [7h 2c]
Lujan87: folds 
chauyeuba: folds 
Sweden_Pound: folds 
Effort92: folds 
FluentFlows: folds 
hurtNCYDE: raises $1.50 to $2.50
matiko09: folds 
mrfoldcall: raises $5.50 to $8
Luck In Me: folds 
hurtNCYDE: calls $5.50
*** FLOP *** [9d Th 5c]
mrfoldcall: checks 
hurtNCYDE: checks 
*** TURN *** [9d Th 5c] [2d]
mrfoldcall: bets $11
hurtNCYDE: folds 
Uncalled bet ($11) returned to mrfoldcall
mrfoldcall collected $16.24 from pot
mrfoldcall: doesn't show hand 
*** SUMMARY ***
Total pot $17 | Rake $0.76 
Board [9d Th 5c 2d]
Seat 1: Luck In Me (big blind) folded before Flop
Seat 2: Lujan87 folded before Flop (didn't bet)
Seat 3: chauyeuba folded before Flop (didn't bet)
Seat 4: Sweden_Pound folded before Flop (didn't bet)
Seat 5: Effort92 folded before Flop (didn't bet)
Seat 6: FluentFlows folded before Flop (didn't bet)
Seat 7: hurtNCYDE folded on the Turn
Seat 8: matiko09 (button) folded before Flop (didn't bet)
Seat 9: mrfoldcall (small blind) collected ($16.24)





PokerStars Hand #148607711675:  Hold'em No Limit ($0.25/$0.50 USD) - 2016/02/11 12:35:35 CET [2016/02/11 6:35:35 ET]
Table 'Ambrosia II' 9-max Seat #8 is the button
Seat 1: matiko09 ($50 in chips) 
Seat 2: TheMinion ($115.94 in chips) 
Seat 3: make6a ($49 in chips) 
Seat 6: Reven9er ($63.48 in chips) 
Seat 7: mexx1234 ($64.08 in chips) 
Seat 8: tallonn88 ($52.56 in chips) 
matiko09: posts small blind $0.25
TheMinion: posts big blind $0.50
RICKA16: sits out 
*** HOLE CARDS ***
Dealt to matiko09 [6c 5c]
make6a: folds 
Reven9er: folds 
mexx1234: folds 
tallonn88: raises $0.50 to $1
matiko09: folds 
TheMinion: raises $3 to $4
tallonn88: folds 
Uncalled bet ($3) returned to TheMinion
TheMinion collected $2.25 from pot
TheMinion: doesn't show hand 
*** SUMMARY ***
Total pot $2.25 | Rake $0 
Seat 1: matiko09 (small blind) folded before Flop
Seat 2: TheMinion (big blind) collected ($2.25)
Seat 3: make6a folded before Flop (didn't bet)
Seat 6: Reven9er folded before Flop (didn't bet)
Seat 7: mexx1234 folded before Flop (didn't bet)
Seat 8: tallonn88 (button) folded before Flop





PokerStars Hand #148607714126:  Hold'em No Limit ($0.25/$0.50 USD) - 2016/02/11 12:35:40 CET [2016/02/11 6:35:40 ET]
Table 'Amor II' 9-max Seat #8 is the button
Seat 1: Kud3 ($50.75 in chips) 
Seat 3: TheMinion ($57.97 in chips) 
Seat 4: Larzdog29 ($46.52 in chips) 
Seat 5: Optimistic21 ($50.66 in chips) 
Seat 6: matiko09 ($50 in chips) 
Seat 8: Reven9er ($61.43 in chips) 
Seat 9: tallonn88 ($111.11 in chips) 
tallonn88: posts small blind $0.25
Kud3: posts big blind $0.50
Serhent: sits out 
*** HOLE CARDS ***
Dealt to matiko09 [Qh 4d]
TheMinion: folds 
Larzdog29: folds 
Optimistic21: folds 
matiko09: folds 
Reven9er: raises $0.50 to $1
tallonn88: folds 
Kud3: calls $0.50
*** FLOP *** [9h 5d 8d]
Kud3: checks 
Reven9er: checks 
*** TURN *** [9h 5d 8d] [Ac]
Kud3: checks 
Reven9er: checks 
*** RIVER *** [9h 5d 8d Ac] [Ad]
Kud3: checks 
Reven9er: bets $1.07
Kud3: calls $1.07
*** SHOW DOWN ***
Reven9er: shows [Js 3s] (a pair of Aces)
Kud3: shows [Kh Td] (a pair of Aces - King kicker)
Kud3 collected $4.19 from pot
*** SUMMARY ***
Total pot $4.39 | Rake $0.20 
Board [9h 5d 8d Ac Ad]
Seat 1: Kud3 (big blind) showed [Kh Td] and won ($4.19) with a pair of Aces
Seat 3: TheMinion folded before Flop (didn't bet)
Seat 4: Larzdog29 folded before Flop (didn't bet)
Seat 5: Optimistic21 folded before Flop (didn't bet)
Seat 6: matiko09 folded before Flop (didn't bet)
Seat 8: Reven9er (button) showed [Js 3s] and lost with a pair of Aces
Seat 9: tallonn88 (small blind) folded before Flop





PokerStars Hand #148607716826:  Hold'em No Limit ($0.25/$0.50 USD) - 2016/02/11 12:35:44 CET [2016/02/11 6:35:44 ET]
Table 'Stereoskopia' 9-max Seat #1 is the button
Seat 1: 50CandyJoe ($53.08 in chips) 
Seat 2: Optimistic21 ($56.75 in chips) 
Seat 3: Donko jr ($13.15 in chips) 
Seat 4: King brid ($73.06 in chips) 
Seat 5: ReinisRNS ($30.63 in chips) 
Seat 6: matiko09 ($50 in chips) 
Seat 7: tallonn88 ($104.92 in chips) 
Seat 8: banit7 ($80.78 in chips) 
Seat 9: apfush ($50 in chips) 
Optimistic21: posts small blind $0.25
Donko jr: posts big blind $0.50
*** HOLE CARDS ***
Dealt to matiko09 [7c 6s]
King brid: raises $0.50 to $1
ReinisRNS: folds 
matiko09: folds 
tallonn88: folds 
banit7: calls $1
apfush: folds 
50CandyJoe: folds 
Optimistic21: folds 
Donko jr: calls $0.50
*** FLOP *** [5d 5s Qd]
Donko jr: checks 
King brid: checks 
banit7: bets $2.06
Donko jr: folds 
King brid: calls $2.06
*** TURN *** [5d 5s Qd] [3d]
King brid: checks 
banit7: checks 
*** RIVER *** [5d 5s Qd 3d] [3s]
King brid: checks 
banit7: checks 
*** SHOW DOWN ***
King brid: shows [Ac Qh] (two pair, Queens and Fives)
banit7: mucks hand 
King brid collected $7.04 from pot
*** SUMMARY ***
Total pot $7.37 | Rake $0.33 
Board [5d 5s Qd 3d 3s]
Seat 1: 50CandyJoe (button) folded before Flop (didn't bet)
Seat 2: Optimistic21 (small blind) folded before Flop
Seat 3: Donko jr (big blind) folded on the Flop
Seat 4: King brid showed [Ac Qh] and won ($7.04) with two pair, Queens and Fives
Seat 5: ReinisRNS folded before Flop (didn't bet)
Seat 6: matiko09 folded before Flop (didn't bet)
Seat 7: tallonn88 folded before Flop (didn't bet)
Seat 8: banit7 mucked [As Js]
Seat 9: apfush folded before Flop (didn't bet)





PokerStars Hand #148607724698:  Hold'em No Limit ($0.25/$0.50 USD) - 2016/02/11 12:35:59 CET [2016/02/11 6:35:59 ET]
Table 'Sylvania II' 9-max Seat #2 is the button
Seat 1: mexx1234 ($196.63 in chips) 
Seat 2: Effort92 ($50 in chips) 
Seat 3: ruyingren ($182.37 in chips) 
Seat 4: matiko09 ($149.75 in chips) 
Seat 5: vlad11122007 ($68.83 in chips) 
Seat 6: TonnaMunz ($121.50 in chips) 
Seat 7: i L00K great ($51.48 in chips) 
Seat 8: Optimistic21 ($51.45 in chips) 
Seat 9: Kud3 ($141.11 in chips) 
ruyingren: posts small blind $0.25
matiko09: posts big blind $0.50
mexx1234: posts the ante $0.10
Effort92: posts the ante $0.10
ruyingren: posts the ante $0.10
matiko09: posts the ante $0.10
vlad11122007: posts the ante $0.10
TonnaMunz: posts the ante $0.10
i L00K great: posts the ante $0.10
Optimistic21: posts the ante $0.10
Kud3: posts the ante $0.10
*** HOLE CARDS ***
Dealt to matiko09 [2s 7h]
vlad11122007: folds 
TonnaMunz: folds 
i L00K great: folds 
Optimistic21 has timed out
Optimistic21: folds 
Kud3: folds 
mexx1234: folds 
Effort92: raises $0.75 to $1.25
ruyingren: calls $1
matiko09: folds 
*** FLOP *** [9d Ah 4h]
ruyingren: checks 
Effort92: checks 
*** TURN *** [9d Ah 4h] [7s]
ruyingren: bets $2.50
Effort92: calls $2.50
*** RIVER *** [9d Ah 4h 7s] [Jh]
ruyingren: checks 
Effort92: checks 
*** SHOW DOWN ***
ruyingren: shows [8d Kh] (high card Ace)
Effort92: shows [9h Qs] (a pair of Nines)
Effort92 collected $8.50 from pot
*** SUMMARY ***
Total pot $8.90 | Rake $0.40 
Board [9d Ah 4h 7s Jh]
Seat 1: mexx1234 folded before Flop (didn't bet)
Seat 2: Effort92 (button) showed [9h Qs] and won ($8.50) with a pair of Nines
Seat 3: ruyingren (small blind) showed [8d Kh] and lost with high card Ace
Seat 4: matiko09 (big blind) folded before Flop
Seat 5: vlad11122007 folded before Flop (didn't bet)
Seat 6: TonnaMunz folded before Flop (didn't bet)
Seat 7: i L00K great folded before Flop (didn't bet)
Seat 8: Optimistic21 folded before Flop (didn't bet)
Seat 9: Kud3 folded before Flop (didn't bet)





PokerStars Hand #148607726042:  Hold'em No Limit ($0.25/$0.50 USD) - 2016/02/11 12:36:01 CET [2016/02/11 6:36:01 ET]
Table 'Ambrosia II' 9-max Seat #1 is the button
Seat 1: matiko09 ($50 in chips) 
Seat 2: TheMinion ($117.19 in chips) 
Seat 4: huudk2016 ($28.07 in chips) 
Seat 6: Reven9er ($63.48 in chips) 
Seat 7: mexx1234 ($64.08 in chips) 
Seat 8: tallonn88 ($51.56 in chips) 
TheMinion: posts small blind $0.25
make6a: is sitting out 
huudk2016: posts big blind $0.50
RICKA16: sits out 
*** HOLE CARDS ***
Dealt to matiko09 [5s 2c]
Reven9er: folds 
mexx1234: raises $0.75 to $1.25
tallonn88: folds 
matiko09: folds 
TheMinion: folds 
huudk2016: calls $0.75
*** FLOP *** [9d 7d 4s]
huudk2016: checks 
mexx1234: bets $0.92
huudk2016: calls $0.92
*** TURN *** [9d 7d 4s] [7c]
huudk2016: checks 
mexx1234: checks 
*** RIVER *** [9d 7d 4s 7c] [5c]
huudk2016: checks 
mexx1234: checks 
*** SHOW DOWN ***
huudk2016: shows [Td Qc] (a pair of Sevens)
mexx1234: shows [8s 8c] (two pair, Eights and Sevens)
mexx1234 collected $4.38 from pot
*** SUMMARY ***
Total pot $4.59 | Rake $0.21 
Board [9d 7d 4s 7c 5c]
Seat 1: matiko09 (button) folded before Flop (didn't bet)
Seat 2: TheMinion (small blind) folded before Flop
Seat 4: huudk2016 (big blind) showed [Td Qc] and lost with a pair of Sevens
Seat 6: Reven9er folded before Flop (didn't bet)
Seat 7: mexx1234 showed [8s 8c] and won ($4.38) with two pair, Eights and Sevens
Seat 8: tallonn88 folded before Flop (didn't bet)





PokerStars Hand #148607730378:  Hold'em No Limit ($0.25/$0.50 USD) - 2016/02/11 12:36:09 CET [2016/02/11 6:36:09 ET]
Table 'Algedi' 9-max Seat #7 is the button
Seat 1: vlad11122007 ($52.47 in chips) 
Seat 2: Reffypaul ($81 in chips) 
Seat 4: Effort92 ($54.53 in chips) 
Seat 6: TonnaMunz ($123.91 in chips) 
Seat 7: hoedtrob ($62.91 in chips) 
Seat 8: matiko09 ($50.85 in chips) 
Seat 9: Kud3 ($127.95 in chips) 
matiko09: posts small blind $0.25
Kud3: posts big blind $0.50
Saggitaurus: sits out 
vlad11122007: posts the ante $0.10
Reffypaul: posts the ante $0.10
Effort92: posts the ante $0.10
TonnaMunz: posts the ante $0.10
hoedtrob: posts the ante $0.10
matiko09: posts the ante $0.10
Kud3: posts the ante $0.10
*** HOLE CARDS ***
Dealt to matiko09 [2h 3h]
vlad11122007: raises $1 to $1.50
Reffypaul is disconnected 
Reffypaul is connected 
Reffypaul: folds 
Effort92: folds 
TonnaMunz: folds 
hoedtrob: folds 
matiko09: folds 
Kud3: folds 
Uncalled bet ($1) returned to vlad11122007
vlad11122007 collected $1.95 from pot
vlad11122007: doesn't show hand 
*** SUMMARY ***
Total pot $1.95 | Rake $0 
Seat 1: vlad11122007 collected ($1.95)
Seat 2: Reffypaul folded before Flop (didn't bet)
Seat 4: Effort92 folded before Flop (didn't bet)
Seat 6: TonnaMunz folded before Flop (didn't bet)
Seat 7: hoedtrob (button) folded before Flop (didn't bet)
Seat 8: matiko09 (small blind) folded before Flop
Seat 9: Kud3 (big blind) folded before Flop





PokerStars Hand #148607730807:  Hold'em No Limit ($0.25/$0.50 USD) - 2016/02/11 12:36:10 CET [2016/02/11 6:36:10 ET]
Table 'Hunan' 9-max Seat #7 is the button
Seat 1: matiko09 ($52 in chips) 
Seat 2: smirnoff993 ($143.07 in chips) 
Seat 3: TheMinion ($54.36 in chips) 
Seat 4: RICKA16 ($50.75 in chips) 
Seat 5: Honk115 ($59.23 in chips) 
Seat 6: i L00K great ($59.66 in chips) 
Seat 7: SForces33 ($20.55 in chips) 
Seat 8: Reven9er ($58.70 in chips) 
Seat 9: Optimistic21 ($56.03 in chips) 
Reven9er: posts small blind $0.25
Optimistic21: posts big blind $0.50
*** HOLE CARDS ***
Dealt to matiko09 [9d 2h]
matiko09: folds 
smirnoff993: raises $1 to $1.50
TheMinion: folds 
RICKA16: folds 
Honk115: folds 
i L00K great: folds 
SForces33: folds 
Reven9er: folds 
Optimistic21: folds 
Uncalled bet ($1) returned to smirnoff993
smirnoff993 collected $1.25 from pot
smirnoff993: doesn't show hand 
*** SUMMARY ***
Total pot $1.25 | Rake $0 
Seat 1: matiko09 folded before Flop (didn't bet)
Seat 2: smirnoff993 collected ($1.25)
Seat 3: TheMinion folded before Flop (didn't bet)
Seat 4: RICKA16 folded before Flop (didn't bet)
Seat 5: Honk115 folded before Flop (didn't bet)
Seat 6: i L00K great folded before Flop (didn't bet)
Seat 7: SForces33 (button) folded before Flop (didn't bet)
Seat 8: Reven9er (small blind) folded before Flop
Seat 9: Optimistic21 (big blind) folded before Flop





PokerStars Hand #148607731006:  Hold'em No Limit (€0.25/€0.50 EUR) - 2016/02/11 12:36:10 CET [2016/02/11 6:36:10 ET]
Table 'Otero II' 9-max Seat #9 is the button
Seat 1: Nacho2556 (€42.15 in chips) 
Seat 2: make6a (€50 in chips) 
Seat 3: chaogoose82 (€69.78 in chips) 
Seat 4: kram0909 (€30.80 in chips) 
Seat 5: vlad11122007 (€50 in chips) 
Seat 6: TonnaMunz (€51.44 in chips) 
Seat 7: PacPacBum (€50 in chips) 
Seat 8: matiko09 (€75.96 in chips) 
Seat 9: Optimistic21 (€58.54 in chips) 
Nacho2556: posts small blind €0.25
make6a: posts big blind €0.50
kram0909: posts big blind €0.50
*** HOLE CARDS ***
Dealt to matiko09 [9c 5d]
chaogoose82: folds 
kram0909: raises €0.50 to €1
vlad11122007: folds 
TonnaMunz: folds 
PacPacBum: raises €3 to €4
matiko09: folds 
Optimistic21 has timed out
Optimistic21: folds 
Nacho2556: folds 
make6a: folds 
kram0909: calls €3
*** FLOP *** [2c As Tc]
kram0909: bets €1
PacPacBum: calls €1
*** TURN *** [2c As Tc] [Ah]
kram0909: bets €2.50
PacPacBum: calls €2.50
*** RIVER *** [2c As Tc Ah] [Jc]
kram0909: bets €3
PacPacBum: calls €3
*** SHOW DOWN ***
kram0909: shows [4c 4s] (two pair, Aces and Fours)
PacPacBum: shows [Qc Qs] (two pair, Aces and Queens)
PacPacBum collected €20.77 from pot
*** SUMMARY ***
Total pot €21.75 | Rake €0.98 
Board [2c As Tc Ah Jc]
Seat 1: Nacho2556 (small blind) folded before Flop
Seat 2: make6a (big blind) folded before Flop
Seat 3: chaogoose82 folded before Flop (didn't bet)
Seat 4: kram0909 showed [4c 4s] and lost with two pair, Aces and Fours
Seat 5: vlad11122007 folded before Flop (didn't bet)
Seat 6: TonnaMunz folded before Flop (didn't bet)
Seat 7: PacPacBum showed [Qc Qs] and won (€20.77) with two pair, Aces and Queens
Seat 8: matiko09 folded before Flop (didn't bet)
Seat 9: Optimistic21 (button) folded before Flop (didn't bet)





PokerStars Hand #148607736511:  Hold'em No Limit ($0.50/$1.00 USD) - 2016/02/11 12:36:20 CET [2016/02/11 6:36:20 ET]
Table 'Regor' 9-max Seat #2 is the button
Seat 1: matiko09 ($127.77 in chips) 
Seat 2: Luck In Me ($100.50 in chips) 
Seat 3: oscarleon ($100 in chips) 
Seat 4: Filojoes ($100 in chips) 
Seat 5: chauyeuba ($44.50 in chips) 
Seat 7: gwwsb ($39.54 in chips) 
Seat 8: R3NZONIT3 ($75.32 in chips) 
Seat 9: CoolFireX ($112.44 in chips) 
oscarleon: posts small blind $0.50
Filojoes: posts big blind $1
Dachish: sits out 
*** HOLE CARDS ***
Dealt to matiko09 [4c 7h]
chauyeuba: folds 
gwwsb: raises $2 to $3
R3NZONIT3: raises $3 to $6
CoolFireX: folds 
matiko09: folds 
Luck In Me: folds 
oscarleon: folds 
Filojoes: folds 
gwwsb: calls $3
*** FLOP *** [8d 6c 9s]
gwwsb: checks 
R3NZONIT3: bets $6.44
gwwsb: calls $6.44
*** TURN *** [8d 6c 9s] [4h]
gwwsb: checks 
R3NZONIT3: bets $25.19
gwwsb: folds 
Uncalled bet ($25.19) returned to R3NZONIT3
R3NZONIT3 collected $25.19 from pot
R3NZONIT3: doesn't show hand 
*** SUMMARY ***
Total pot $26.38 | Rake $1.19 
Board [8d 6c 9s 4h]
Seat 1: matiko09 folded before Flop (didn't bet)
Seat 2: Luck In Me (button) folded before Flop (didn't bet)
Seat 3: oscarleon (small blind) folded before Flop
Seat 4: Filojoes (big blind) folded before Flop
Seat 5: chauyeuba folded before Flop (didn't bet)
Seat 7: gwwsb folded on the Turn
Seat 8: R3NZONIT3 collected ($25.19)
Seat 9: CoolFireX folded before Flop (didn't bet)





PokerStars Hand #148607737931:  Hold'em No Limit ($0.50/$1.00 USD) - 2016/02/11 12:36:23 CET [2016/02/11 6:36:23 ET]
Table 'Sycorax II' 9-max Seat #9 is the button
Seat 1: Luck In Me ($155.72 in chips) 
Seat 2: Lujan87 ($100 in chips) 
Seat 3: chauyeuba ($48.50 in chips) 
Seat 4: Sweden_Pound ($141.24 in chips) 
Seat 5: Effort92 ($167.94 in chips) 
Seat 6: FluentFlows ($37.50 in chips) 
Seat 7: hurtNCYDE ($109.38 in chips) 
Seat 8: matiko09 ($133.87 in chips) 
Seat 9: mrfoldcall ($107.24 in chips) 
Luck In Me: posts small blind $0.50
Lujan87: posts big blind $1
*** HOLE CARDS ***
Dealt to matiko09 [Ah 7s]
chauyeuba: raises $1.50 to $2.50
Sweden_Pound: folds 
Effort92: folds 
FluentFlows: folds 
hurtNCYDE: calls $2.50
matiko09: folds 
mrfoldcall: folds 
Luck In Me: folds 
Lujan87: folds 
*** FLOP *** [Ks Td Jd]
chauyeuba: checks 
hurtNCYDE: bets $4.28
chauyeuba: calls $4.28
*** TURN *** [Ks Td Jd] [6d]
chauyeuba: checks 
hurtNCYDE: bets $10.92
chauyeuba: calls $10.92
*** RIVER *** [Ks Td Jd 6d] [8d]
chauyeuba: checks 
hurtNCYDE: checks 
*** SHOW DOWN ***
chauyeuba: shows [Kh Kd] (a flush, King high)
hurtNCYDE: mucks hand 
chauyeuba collected $35.24 from pot
*** SUMMARY ***
Total pot $36.90 | Rake $1.66 
Board [Ks Td Jd 6d 8d]
Seat 1: Luck In Me (small blind) folded before Flop
Seat 2: Lujan87 (big blind) folded before Flop
Seat 3: chauyeuba showed [Kh Kd] and won ($35.24) with a flush, King high
Seat 4: Sweden_Pound folded before Flop (didn't bet)
Seat 5: Effort92 folded before Flop (didn't bet)
Seat 6: FluentFlows folded before Flop (didn't bet)
Seat 7: hurtNCYDE mucked [Qs As]
Seat 8: matiko09 folded before Flop (didn't bet)
Seat 9: mrfoldcall (button) folded before Flop (didn't bet)





PokerStars Hand #148607740339:  Hold'em No Limit ($0.25/$0.50 USD) - 2016/02/11 12:36:27 CET [2016/02/11 6:36:27 ET]
Table 'Amor II' 9-max Seat #9 is the button
Seat 1: Kud3 ($52.87 in chips) 
Seat 2: GusenokRUS ($82.87 in chips) 
Seat 3: TheMinion ($57.97 in chips) 
Seat 4: Larzdog29 ($46.52 in chips) 
Seat 5: Optimistic21 ($50.66 in chips) 
Seat 6: matiko09 ($50 in chips) 
Seat 8: Reven9er ($59.36 in chips) 
Seat 9: tallonn88 ($110.86 in chips) 
Kud3: posts small blind $0.25
GusenokRUS: posts big blind $0.50
Serhent: sits out 
*** HOLE CARDS ***
Dealt to matiko09 [4c 4s]
TheMinion: folds 
Larzdog29: folds 
Optimistic21 has timed out
Optimistic21: folds 
matiko09: raises $1 to $1.50
Reven9er: folds 
tallonn88: folds 
Kud3: folds 
GusenokRUS: folds 
Uncalled bet ($1) returned to matiko09
matiko09 collected $1.25 from pot
matiko09: doesn't show hand 
*** SUMMARY ***
Total pot $1.25 | Rake $0 
Seat 1: Kud3 (small blind) folded before Flop
Seat 2: GusenokRUS (big blind) folded before Flop
Seat 3: TheMinion folded before Flop (didn't bet)
Seat 4: Larzdog29 folded before Flop (didn't bet)
Seat 5: Optimistic21 folded before Flop (didn't bet)
Seat 6: matiko09 collected ($1.25)
Seat 8: Reven9er folded before Flop (didn't bet)
Seat 9: tallonn88 (button) folded before Flop (didn't bet)





PokerStars Hand #148607751087:  Hold'em No Limit ($0.25/$0.50 USD) - 2016/02/11 12:36:46 CET [2016/02/11 6:36:46 ET]
Table 'Stereoskopia' 9-max Seat #2 is the button
Seat 1: 50CandyJoe ($53.08 in chips) 
Seat 2: Optimistic21 ($56.50 in chips) 
Seat 3: Donko jr ($12.15 in chips) 
Seat 4: King brid ($77.04 in chips) 
Seat 5: ReinisRNS ($30.63 in chips) 
Seat 6: matiko09 ($50 in chips) 
Seat 7: tallonn88 ($104.92 in chips) 
Seat 8: banit7 ($77.72 in chips) 
Seat 9: apfush ($50 in chips) 
Donko jr: posts small blind $0.25
King brid: posts big blind $0.50
*** HOLE CARDS ***
Dealt to matiko09 [8s Th]
ReinisRNS: folds 
matiko09: folds 
tallonn88: folds 
banit7: raises $1 to $1.50
apfush: folds 
50CandyJoe: folds 
Optimistic21: folds 
Donko jr: calls $1.25
King brid: folds 
*** FLOP *** [Ks Kc 9h]
Donko jr: checks 
banit7: bets $2
Donko jr: folds 
Uncalled bet ($2) returned to banit7
banit7 collected $3.34 from pot
banit7: doesn't show hand 
*** SUMMARY ***
Total pot $3.50 | Rake $0.16 
Board [Ks Kc 9h]
Seat 1: 50CandyJoe folded before Flop (didn't bet)
Seat 2: Optimistic21 (button) folded before Flop (didn't bet)
Seat 3: Donko jr (small blind) folded on the Flop
Seat 4: King brid (big blind) folded before Flop
Seat 5: ReinisRNS folded before Flop (didn't bet)
Seat 6: matiko09 folded before Flop (didn't bet)
Seat 7: tallonn88 folded before Flop (didn't bet)
Seat 8: banit7 collected ($3.34)
Seat 9: apfush folded before Flop (didn't bet)





PokerStars Hand #148607763663:  Hold'em No Limit ($0.25/$0.50 USD) - 2016/02/11 12:37:08 CET [2016/02/11 6:37:08 ET]
Table 'Amor II' 9-max Seat #1 is the button
Seat 1: Kud3 ($52.62 in chips) 
Seat 2: GusenokRUS ($82.37 in chips) 
Seat 3: TheMinion ($57.97 in chips) 
Seat 4: Larzdog29 ($46.52 in chips) 
Seat 6: matiko09 ($50.75 in chips) 
Seat 8: Reven9er ($59.36 in chips) 
Seat 9: tallonn88 ($110.86 in chips) 
GusenokRUS: posts small blind $0.25
TheMinion: posts big blind $0.50
Serhent: sits out 
*** HOLE CARDS ***
Dealt to matiko09 [3c Jd]
Larzdog29: raises $1.50 to $2
matiko09: folds 
Reven9er: folds 
tallonn88: calls $2
Kud3: folds 
GusenokRUS: calls $1.75
TheMinion: folds 
*** FLOP *** [4h Kd 3d]
GusenokRUS: checks 
Larzdog29: bets $3.50
tallonn88: folds 
GusenokRUS: folds 
Uncalled bet ($3.50) returned to Larzdog29
Larzdog29 collected $6.21 from pot
Larzdog29: doesn't show hand 
*** SUMMARY ***
Total pot $6.50 | Rake $0.29 
Board [4h Kd 3d]
Seat 1: Kud3 (button) folded before Flop (didn't bet)
Seat 2: GusenokRUS (small blind) folded on the Flop
Seat 3: TheMinion (big blind) folded before Flop
Seat 4: Larzdog29 collected ($6.21)
Seat 6: matiko09 folded before Flop (didn't bet)
Seat 8: Reven9er folded before Flop (didn't bet)
Seat 9: tallonn88 folded on the Flop





PokerStars Hand #148607763853:  Hold'em No Limit ($0.25/$0.50 USD) - 2016/02/11 12:37:09 CET [2016/02/11 6:37:09 ET]
Table 'Ambrosia II' 9-max Seat #2 is the button
Seat 1: matiko09 ($50 in chips) 
Seat 2: TheMinion ($116.94 in chips) 
Seat 4: huudk2016 ($25.90 in chips) 
Seat 6: Reven9er ($63.48 in chips) 
Seat 7: mexx1234 ($66.29 in chips) 
Seat 8: tallonn88 ($51.56 in chips) 
make6a will be allowed to play after the button
huudk2016: posts small blind $0.25
Reven9er: posts big blind $0.50
*** HOLE CARDS ***
Dealt to matiko09 [Js 2s]
mexx1234: raises $0.75 to $1.25
tallonn88: folds 
matiko09: folds 
TheMinion: folds 
huudk2016: folds 
Reven9er: calls $0.75
*** FLOP *** [6h Ts 5c]
Reven9er: checks 
mexx1234: bets $1.31
Reven9er: calls $1.31
*** TURN *** [6h Ts 5c] [Jc]
Reven9er: checks 
mexx1234: checks 
*** RIVER *** [6h Ts 5c Jc] [7h]
Reven9er: bets $3.50
mexx1234: folds 
Uncalled bet ($3.50) returned to Reven9er
Reven9er collected $5.13 from pot
Reven9er: doesn't show hand 
*** SUMMARY ***
Total pot $5.37 | Rake $0.24 
Board [6h Ts 5c Jc 7h]
Seat 1: matiko09 folded before Flop (didn't bet)
Seat 2: TheMinion (button) folded before Flop (didn't bet)
Seat 4: huudk2016 (small blind) folded before Flop
Seat 6: Reven9er (big blind) collected ($5.13)
Seat 7: mexx1234 folded on the River
Seat 8: tallonn88 folded before Flop (didn't bet)





PokerStars Hand #148607769228:  Hold'em No Limit ($0.25/$0.50 USD) - 2016/02/11 12:37:18 CET [2016/02/11 6:37:18 ET]
Table 'Algedi' 9-max Seat #8 is the button
Seat 1: vlad11122007 ($53.82 in chips) 
Seat 2: Reffypaul ($80.90 in chips) 
Seat 4: Effort92 ($54.43 in chips) 
Seat 6: TonnaMunz ($123.81 in chips) 
Seat 7: hoedtrob ($62.81 in chips) 
Seat 8: matiko09 ($50.50 in chips) 
Seat 9: Kud3 ($127.35 in chips) 
Kud3: posts small blind $0.25
vlad11122007: posts big blind $0.50
Saggitaurus: sits out 
vlad11122007: posts the ante $0.10
Reffypaul: posts the ante $0.10
Effort92: posts the ante $0.10
TonnaMunz: posts the ante $0.10
hoedtrob: posts the ante $0.10
matiko09: posts the ante $0.10
Kud3: posts the ante $0.10
*** HOLE CARDS ***
Dealt to matiko09 [Jd 6c]
Reffypaul is disconnected 
Reffypaul is connected 
Reffypaul: folds 
Effort92: folds 
TonnaMunz: folds 
hoedtrob: raises $1 to $1.50
matiko09: folds 
Kud3: calls $1.25
vlad11122007: folds 
*** FLOP *** [7d Kd 7s]
Kud3: checks 
hoedtrob: bets $2.50
Kud3: calls $2.50
*** TURN *** [7d Kd 7s] [8d]
Kud3: checks 
hoedtrob: bets $5.50
Kud3: folds 
Uncalled bet ($5.50) returned to hoedtrob
hoedtrob collected $8.79 from pot
hoedtrob: doesn't show hand 
*** SUMMARY ***
Total pot $9.20 | Rake $0.41 
Board [7d Kd 7s 8d]
Seat 1: vlad11122007 (big blind) folded before Flop
Seat 2: Reffypaul folded before Flop (didn't bet)
Seat 4: Effort92 folded before Flop (didn't bet)
Seat 6: TonnaMunz folded before Flop (didn't bet)
Seat 7: hoedtrob collected ($8.79)
Seat 8: matiko09 (button) folded before Flop (didn't bet)
Seat 9: Kud3 (small blind) folded on the Turn





PokerStars Hand #148607770169:  Hold'em No Limit ($0.50/$1.00 USD) - 2016/02/11 12:37:20 CET [2016/02/11 6:37:20 ET]
Table 'Regor' 9-max Seat #3 is the button
Seat 1: matiko09 ($127.77 in chips) 
Seat 2: Luck In Me ($100.50 in chips) 
Seat 3: oscarleon ($100 in chips) 
Seat 4: Filojoes ($100 in chips) 
Seat 5: chauyeuba ($44.50 in chips) 
Seat 7: gwwsb ($27.10 in chips) 
Seat 8: R3NZONIT3 ($88.07 in chips) 
Seat 9: CoolFireX ($112.44 in chips) 
Filojoes: posts small blind $0.50
chauyeuba: posts big blind $1
Dachish: sits out 
*** HOLE CARDS ***
Dealt to matiko09 [2c 8h]
gwwsb: folds 
R3NZONIT3: folds 
CoolFireX: folds 
matiko09: folds 
Luck In Me: folds 
oscarleon: folds 
Filojoes: folds 
Uncalled bet ($0.50) returned to chauyeuba
chauyeuba collected $1 from pot
chauyeuba: doesn't show hand 
*** SUMMARY ***
Total pot $1 | Rake $0 
Seat 1: matiko09 folded before Flop (didn't bet)
Seat 2: Luck In Me folded before Flop (didn't bet)
Seat 3: oscarleon (button) folded before Flop (didn't bet)
Seat 4: Filojoes (small blind) folded before Flop
Seat 5: chauyeuba (big blind) collected ($1)
Seat 7: gwwsb folded before Flop (didn't bet)
Seat 8: R3NZONIT3 folded before Flop (didn't bet)
Seat 9: CoolFireX folded before Flop (didn't bet)





PokerStars Hand #148607774973:  Hold'em No Limit ($0.25/$0.50 USD) - 2016/02/11 12:37:29 CET [2016/02/11 6:37:29 ET]
Table 'Hunan' 9-max Seat #8 is the button
Seat 1: matiko09 ($52 in chips) 
Seat 2: smirnoff993 ($143.82 in chips) 
Seat 3: TheMinion ($54.36 in chips) 
Seat 4: RICKA16 ($50.75 in chips) 
Seat 5: Honk115 ($59.23 in chips) 
Seat 6: i L00K great ($59.66 in chips) 
Seat 7: SForces33 ($20.55 in chips) 
Seat 8: Reven9er ($58.45 in chips) 
Seat 9: Optimistic21 ($55.53 in chips) 
Optimistic21: posts small blind $0.25
matiko09: posts big blind $0.50
*** HOLE CARDS ***
Dealt to matiko09 [2d 3c]
smirnoff993: raises $1 to $1.50
TheMinion: folds 
RICKA16: folds 
Honk115: folds 
i L00K great: folds 
SForces33: folds 
Reven9er: folds 
Optimistic21: folds 
matiko09: folds 
Uncalled bet ($1) returned to smirnoff993
smirnoff993 collected $1.25 from pot
smirnoff993: doesn't show hand 
*** SUMMARY ***
Total pot $1.25 | Rake $0 
Seat 1: matiko09 (big blind) folded before Flop
Seat 2: smirnoff993 collected ($1.25)
Seat 3: TheMinion folded before Flop (didn't bet)
Seat 4: RICKA16 folded before Flop (didn't bet)
Seat 5: Honk115 folded before Flop (didn't bet)
Seat 6: i L00K great folded before Flop (didn't bet)
Seat 7: SForces33 folded before Flop (didn't bet)
Seat 8: Reven9er (button) folded before Flop (didn't bet)
Seat 9: Optimistic21 (small blind) folded before Flop





PokerStars Hand #148607782613:  Hold'em No Limit ($0.50/$1.00 USD) - 2016/02/11 12:37:42 CET [2016/02/11 6:37:42 ET]
Table 'Sycorax II' 9-max Seat #1 is the button
Seat 1: Luck In Me ($155.22 in chips) 
Seat 2: Lujan87 ($100 in chips) 
Seat 3: chauyeuba ($66.04 in chips) 
Seat 4: Sweden_Pound ($141.24 in chips) 
Seat 5: Effort92 ($167.94 in chips) 
Seat 6: FluentFlows ($37.50 in chips) 
Seat 7: hurtNCYDE ($100 in chips) 
Seat 8: matiko09 ($133.87 in chips) 
Seat 9: mrfoldcall ($107.24 in chips) 
Lujan87: posts small blind $0.50
chauyeuba: posts big blind $1
*** HOLE CARDS ***
Dealt to matiko09 [Ks 3d]
Sweden_Pound: folds 
Effort92: folds 
FluentFlows: folds 
hurtNCYDE: folds 
matiko09: folds 
mrfoldcall: raises $2 to $3
Luck In Me: folds 
Lujan87: folds 
chauyeuba: calls $2
*** FLOP *** [4h 2c 2s]
chauyeuba: checks 
mrfoldcall: checks 
*** TURN *** [4h 2c 2s] [As]
chauyeuba: checks 
mrfoldcall: checks 
*** RIVER *** [4h 2c 2s As] [Jh]
chauyeuba: bets $4
mrfoldcall: raises $4 to $8
chauyeuba: calls $4
*** SHOW DOWN ***
mrfoldcall: shows [Ad 8s] (two pair, Aces and Deuces)
chauyeuba: shows [Qd Ah] (two pair, Aces and Deuces - Queen kicker)
chauyeuba collected $21.49 from pot
*** SUMMARY ***
Total pot $22.50 | Rake $1.01 
Board [4h 2c 2s As Jh]
Seat 1: Luck In Me (button) folded before Flop (didn't bet)
Seat 2: Lujan87 (small blind) folded before Flop
Seat 3: chauyeuba (big blind) showed [Qd Ah] and won ($21.49) with two pair, Aces and Deuces
Seat 4: Sweden_Pound folded before Flop (didn't bet)
Seat 5: Effort92 folded before Flop (didn't bet)
Seat 6: FluentFlows folded before Flop (didn't bet)
Seat 7: hurtNCYDE folded before Flop (didn't bet)
Seat 8: matiko09 folded before Flop (didn't bet)
Seat 9: mrfoldcall showed [Ad 8s] and lost with two pair, Aces and Deuces





PokerStars Hand #148607783533:  Hold'em No Limit ($0.25/$0.50 USD) - 2016/02/11 12:37:44 CET [2016/02/11 6:37:44 ET]
Table 'Stereoskopia' 9-max Seat #3 is the button
Seat 1: 50CandyJoe ($53.08 in chips) 
Seat 2: Optimistic21 ($56.50 in chips) 
Seat 3: Donko jr ($10.65 in chips) 
Seat 4: King brid ($76.54 in chips) 
Seat 5: ReinisRNS ($30.63 in chips) 
Seat 6: matiko09 ($50 in chips) 
Seat 7: tallonn88 ($104.92 in chips) 
Seat 8: banit7 ($79.56 in chips) 
Seat 9: apfush ($50 in chips) 
King brid: posts small blind $0.25
ReinisRNS: posts big blind $0.50
*** HOLE CARDS ***
Dealt to matiko09 [5d 9c]
matiko09: folds 
tallonn88: folds 
banit7: folds 
apfush: folds 
50CandyJoe: raises $1 to $1.50
Optimistic21: folds 
Donko jr: folds 
King brid: folds 
ReinisRNS: calls $1
*** FLOP *** [Qd 3c 9s]
ReinisRNS: checks 
50CandyJoe: bets $1.50
ReinisRNS: folds 
Uncalled bet ($1.50) returned to 50CandyJoe
50CandyJoe collected $3.10 from pot
50CandyJoe: doesn't show hand 
*** SUMMARY ***
Total pot $3.25 | Rake $0.15 
Board [Qd 3c 9s]
Seat 1: 50CandyJoe collected ($3.10)
Seat 2: Optimistic21 folded before Flop (didn't bet)
Seat 3: Donko jr (button) folded before Flop (didn't bet)
Seat 4: King brid (small blind) folded before Flop
Seat 5: ReinisRNS (big blind) folded on the Flop
Seat 6: matiko09 folded before Flop (didn't bet)
Seat 7: tallonn88 folded before Flop (didn't bet)
Seat 8: banit7 folded before Flop (didn't bet)
Seat 9: apfush folded before Flop (didn't bet)





PokerStars Hand #148607785868:  Hold'em No Limit ($0.50/$1.00 USD) - 2016/02/11 12:37:48 CET [2016/02/11 6:37:48 ET]
Table 'Regor' 9-max Seat #4 is the button
Seat 1: matiko09 ($127.77 in chips) 
Seat 2: Luck In Me ($100.50 in chips) 
Seat 3: oscarleon ($100 in chips) 
Seat 4: Filojoes ($100 in chips) 
Seat 5: chauyeuba ($45 in chips) 
Seat 6: Dachish ($93.95 in chips) 
Seat 7: gwwsb ($27.10 in chips) 
Seat 8: R3NZONIT3 ($88.07 in chips) 
Seat 9: CoolFireX ($112.44 in chips) 
chauyeuba: posts small blind $0.50
Dachish: posts big blind $1
*** HOLE CARDS ***
Dealt to matiko09 [3c Tc]
gwwsb: raises $2 to $3
R3NZONIT3: folds 
CoolFireX: folds 
matiko09: folds 
Luck In Me: folds 
oscarleon: raises $6 to $9
Filojoes: folds 
chauyeuba: calls $8.50
Dachish: folds 
gwwsb: calls $6
*** FLOP *** [Kd Kc 4d]
chauyeuba: checks 
gwwsb: checks 
oscarleon: checks 
*** TURN *** [Kd Kc 4d] [2c]
chauyeuba: bets $3.74
gwwsb: raises $14.36 to $18.10 and is all-in
oscarleon: calls $18.10
chauyeuba: calls $14.36
*** RIVER *** [Kd Kc 4d 2c] [7h]
chauyeuba: checks 
oscarleon: checks 
*** SHOW DOWN ***
chauyeuba: shows [Qc Ac] (a pair of Kings)
gwwsb: mucks hand 
oscarleon: shows [9c 9s] (two pair, Kings and Nines)
oscarleon collected $79.50 from pot
*** SUMMARY ***
Total pot $82.30 | Rake $2.80 
Board [Kd Kc 4d 2c 7h]
Seat 1: matiko09 folded before Flop (didn't bet)
Seat 2: Luck In Me folded before Flop (didn't bet)
Seat 3: oscarleon showed [9c 9s] and won ($79.50) with two pair, Kings and Nines
Seat 4: Filojoes (button) folded before Flop (didn't bet)
Seat 5: chauyeuba (small blind) showed [Qc Ac] and lost with a pair of Kings
Seat 6: Dachish (big blind) folded before Flop
Seat 7: gwwsb mucked [Ad Jd]
Seat 8: R3NZONIT3 folded before Flop (didn't bet)
Seat 9: CoolFireX folded before Flop (didn't bet)





PokerStars Hand #148607795842:  Hold'em No Limit ($0.25/$0.50 USD) - 2016/02/11 12:38:06 CET [2016/02/11 6:38:06 ET]
Table 'Hunan' 9-max Seat #9 is the button
Seat 1: matiko09 ($51.50 in chips) 
Seat 3: TheMinion ($54.36 in chips) 
Seat 4: RICKA16 ($50.75 in chips) 
Seat 5: Honk115 ($59.23 in chips) 
Seat 6: i L00K great ($59.66 in chips) 
Seat 7: SForces33 ($20.55 in chips) 
Seat 8: Reven9er ($58.45 in chips) 
Seat 9: Optimistic21 ($55.28 in chips) 
matiko09: posts small blind $0.25
smirnoff993: is sitting out 
TheMinion: posts big blind $0.50
*** HOLE CARDS ***
Dealt to matiko09 [Kh 4c]
RICKA16: folds 
Honk115: folds 
smirnoff993 leaves the table
i L00K great: folds 
Serhent joins the table at seat #2 
SForces33: folds 
Reven9er: folds 
Optimistic21: folds 
matiko09: folds 
Uncalled bet ($0.25) returned to TheMinion
TheMinion collected $0.50 from pot
TheMinion: doesn't show hand 
*** SUMMARY ***
Total pot $0.50 | Rake $0 
Seat 1: matiko09 (small blind) folded before Flop
Seat 3: TheMinion (big blind) collected ($0.50)
Seat 4: RICKA16 folded before Flop (didn't bet)
Seat 5: Honk115 folded before Flop (didn't bet)
Seat 6: i L00K great folded before Flop (didn't bet)
Seat 7: SForces33 folded before Flop (didn't bet)
Seat 8: Reven9er folded before Flop (didn't bet)
Seat 9: Optimistic21 (button) folded before Flop (didn't bet)





PokerStars Hand #148607797755:  Hold'em No Limit ($0.25/$0.50 USD) - 2016/02/11 12:38:09 CET [2016/02/11 6:38:09 ET]
Table 'Amor II' 9-max Seat #2 is the button
Seat 1: Kud3 ($52.62 in chips) 
Seat 2: GusenokRUS ($80.37 in chips) 
Seat 3: TheMinion ($57.47 in chips) 
Seat 4: Larzdog29 ($50.73 in chips) 
Seat 5: Optimistic21 ($50.66 in chips) 
Seat 6: matiko09 ($50.75 in chips) 
Seat 8: Reven9er ($59.36 in chips) 
Seat 9: tallonn88 ($108.86 in chips) 
TheMinion: posts small blind $0.25
Larzdog29: posts big blind $0.50
Serhent: sits out 
*** HOLE CARDS ***
Dealt to matiko09 [4d 3c]
Optimistic21: folds 
matiko09: folds 
Reven9er: folds 
tallonn88: folds 
Kud3: raises $1 to $1.50
GusenokRUS: folds 
TheMinion: folds 
Larzdog29: folds 
Uncalled bet ($1) returned to Kud3
Kud3 collected $1.25 from pot
Kud3: doesn't show hand 
*** SUMMARY ***
Total pot $1.25 | Rake $0 
Seat 1: Kud3 collected ($1.25)
Seat 2: GusenokRUS (button) folded before Flop (didn't bet)
Seat 3: TheMinion (small blind) folded before Flop
Seat 4: Larzdog29 (big blind) folded before Flop
Seat 5: Optimistic21 folded before Flop (didn't bet)
Seat 6: matiko09 folded before Flop (didn't bet)
Seat 8: Reven9er folded before Flop (didn't bet)
Seat 9: tallonn88 folded before Flop (didn't bet)





PokerStars Hand #148607798506:  Hold'em No Limit ($0.25/$0.50 USD) - 2016/02/11 12:38:11 CET [2016/02/11 6:38:11 ET]
Table 'Sylvania II' 9-max Seat #3 is the button
Seat 1: mexx1234 ($196.53 in chips) 
Seat 2: Effort92 ($54.65 in chips) 
Seat 3: ruyingren ($178.52 in chips) 
Seat 4: matiko09 ($149.15 in chips) 
Seat 5: vlad11122007 ($68.73 in chips) 
Seat 6: TonnaMunz ($121.40 in chips) 
Seat 7: i L00K great ($51.38 in chips) 
Seat 8: Optimistic21 ($51.35 in chips) 
Seat 9: Kud3 ($141.01 in chips) 
matiko09: posts small blind $0.25
vlad11122007: posts big blind $0.50
mexx1234: posts the ante $0.10
Effort92: posts the ante $0.10
ruyingren: posts the ante $0.10
matiko09: posts the ante $0.10
vlad11122007: posts the ante $0.10
TonnaMunz: posts the ante $0.10
i L00K great: posts the ante $0.10
Optimistic21: posts the ante $0.10
Kud3: posts the ante $0.10
*** HOLE CARDS ***
Dealt to matiko09 [Qh 7h]
TonnaMunz: folds 
i L00K great: folds 
Optimistic21 has timed out
Optimistic21: folds 
Kud3: raises $1 to $1.50
mexx1234: folds 
Effort92: folds 
ruyingren: raises $4.50 to $6
matiko09: folds 
vlad11122007: folds 
Kud3: calls $4.50
*** FLOP *** [5d Kc As]
Kud3: checks 
ruyingren: bets $7.50
Kud3: folds 
Uncalled bet ($7.50) returned to ruyingren
ruyingren collected $13.04 from pot
ruyingren: doesn't show hand 
*** SUMMARY ***
Total pot $13.65 | Rake $0.61 
Board [5d Kc As]
Seat 1: mexx1234 folded before Flop (didn't bet)
Seat 2: Effort92 folded before Flop (didn't bet)
Seat 3: ruyingren (button) collected ($13.04)
Seat 4: matiko09 (small blind) folded before Flop
Seat 5: vlad11122007 (big blind) folded before Flop
Seat 6: TonnaMunz folded before Flop (didn't bet)
Seat 7: i L00K great folded before Flop (didn't bet)
Seat 8: Optimistic21 folded before Flop (didn't bet)
Seat 9: Kud3 folded on the Flop





PokerStars Hand #148607800823:  Hold'em No Limit ($0.25/$0.50 USD) - 2016/02/11 12:38:15 CET [2016/02/11 6:38:15 ET]
Table 'Ambrosia II' 9-max Seat #4 is the button
Seat 1: matiko09 ($50 in chips) 
Seat 2: TheMinion ($116.94 in chips) 
Seat 4: huudk2016 ($25.65 in chips) 
Seat 6: Reven9er ($66.05 in chips) 
Seat 7: mexx1234 ($63.73 in chips) 
Seat 8: tallonn88 ($51.56 in chips) 
Reven9er: posts small blind $0.25
mexx1234: posts big blind $0.50
make6a: sits out 
*** HOLE CARDS ***
Dealt to matiko09 [3s 3d]
tallonn88: folds 
matiko09: raises $1 to $1.50
TheMinion: folds 
huudk2016: folds 
Reven9er: raises $2.75 to $4.25
mexx1234: folds 
matiko09: folds 
Uncalled bet ($2.75) returned to Reven9er
Reven9er collected $3.50 from pot
Reven9er: doesn't show hand 
*** SUMMARY ***
Total pot $3.50 | Rake $0 
Seat 1: matiko09 folded before Flop
Seat 2: TheMinion folded before Flop (didn't bet)
Seat 4: huudk2016 (button) folded before Flop (didn't bet)
Seat 6: Reven9er (small blind) collected ($3.50)
Seat 7: mexx1234 (big blind) folded before Flop
Seat 8: tallonn88 folded before Flop (didn't bet)





PokerStars Hand #148607807613:  Hold'em No Limit (€0.25/€0.50 EUR) - 2016/02/11 12:38:27 CET [2016/02/11 6:38:27 ET]
Table 'Otero II' 9-max Seat #1 is the button
Seat 1: Nacho2556 (€41.90 in chips) 
Seat 2: make6a (€49.50 in chips) 
Seat 3: chaogoose82 (€69.78 in chips) 
Seat 4: kram0909 (€20.30 in chips) 
Seat 5: vlad11122007 (€50 in chips) 
Seat 6: TonnaMunz (€51.44 in chips) 
Seat 7: PacPacBum (€60.27 in chips) 
Seat 8: matiko09 (€75.96 in chips) 
Seat 9: Optimistic21 (€58.54 in chips) 
make6a: posts small blind €0.25
chaogoose82: posts big blind €0.50
*** HOLE CARDS ***
Dealt to matiko09 [Qh 5s]
kram0909 has timed out
kram0909: folds 
vlad11122007: folds 
TonnaMunz: folds 
PacPacBum: raises €1 to €1.50
matiko09: folds 
Optimistic21: folds 
Nacho2556: calls €1.50
make6a: folds 
chaogoose82: folds 
*** FLOP *** [3c Kc 6c]
PacPacBum has timed out
PacPacBum: checks 
Nacho2556: bets €3.50
PacPacBum has timed out
PacPacBum: folds 
Uncalled bet (€3.50) returned to Nacho2556
Nacho2556 collected €3.58 from pot
*** SUMMARY ***
Total pot €3.75 | Rake €0.17 
Board [3c Kc 6c]
Seat 1: Nacho2556 (button) collected (€3.58)
Seat 2: make6a (small blind) folded before Flop
Seat 3: chaogoose82 (big blind) folded before Flop
Seat 4: kram0909 folded before Flop (didn't bet)
Seat 5: vlad11122007 folded before Flop (didn't bet)
Seat 6: TonnaMunz folded before Flop (didn't bet)
Seat 7: PacPacBum folded on the Flop
Seat 8: matiko09 folded before Flop (didn't bet)
Seat 9: Optimistic21 folded before Flop (didn't bet)





PokerStars Hand #148607812403:  Hold'em No Limit ($0.25/$0.50 USD) - 2016/02/11 12:38:35 CET [2016/02/11 6:38:35 ET]
Table 'Algedi' 9-max Seat #9 is the button
Seat 1: vlad11122007 ($53.22 in chips) 
Seat 2: Reffypaul ($80.80 in chips) 
Seat 4: Effort92 ($54.33 in chips) 
Seat 6: TonnaMunz ($123.71 in chips) 
Seat 7: hoedtrob ($67.50 in chips) 
Seat 8: matiko09 ($50.40 in chips) 
Seat 9: Kud3 ($125 in chips) 
vlad11122007: posts small blind $0.25
Reffypaul: posts big blind $0.50
Saggitaurus: sits out 
vlad11122007: posts the ante $0.10
Reffypaul: posts the ante $0.10
Effort92: posts the ante $0.10
TonnaMunz: posts the ante $0.10
hoedtrob: posts the ante $0.10
matiko09: posts the ante $0.10
Kud3: posts the ante $0.10
*** HOLE CARDS ***
Dealt to matiko09 [4c 6d]
Effort92: raises $1 to $1.50
TonnaMunz: folds 
hoedtrob: folds 
matiko09: folds 
Kud3: folds 
vlad11122007: folds 
Reffypaul: calls $1
*** FLOP *** [6h 3s 7d]
Reffypaul: bets $1.88
Effort92: calls $1.88
*** TURN *** [6h 3s 7d] [9d]
Reffypaul: bets $3.68
Effort92: calls $3.68
*** RIVER *** [6h 3s 7d 9d] [Qc]
Reffypaul: checks 
Effort92: bets $9.59
Reffypaul: folds 
Uncalled bet ($9.59) returned to Effort92
Effort92 collected $14.39 from pot
Effort92: doesn't show hand 
*** SUMMARY ***
Total pot $15.07 | Rake $0.68 
Board [6h 3s 7d 9d Qc]
Seat 1: vlad11122007 (small blind) folded before Flop
Seat 2: Reffypaul (big blind) folded on the River
Seat 4: Effort92 collected ($14.39)
Seat 6: TonnaMunz folded before Flop (didn't bet)
Seat 7: hoedtrob folded before Flop (didn't bet)
Seat 8: matiko09 folded before Flop (didn't bet)
Seat 9: Kud3 (button) folded before Flop (didn't bet)





PokerStars Hand #148607813002:  Hold'em No Limit ($0.25/$0.50 USD) - 2016/02/11 12:38:36 CET [2016/02/11 6:38:36 ET]
Table 'Stereoskopia' 9-max Seat #4 is the button
Seat 1: 50CandyJoe ($54.68 in chips) 
Seat 2: Optimistic21 ($56.50 in chips) 
Seat 3: Donko jr ($10.65 in chips) 
Seat 4: King brid ($76.29 in chips) 
Seat 5: ReinisRNS ($29.13 in chips) 
Seat 6: matiko09 ($50 in chips) 
Seat 7: tallonn88 ($104.92 in chips) 
Seat 8: banit7 ($79.56 in chips) 
Seat 9: apfush ($50 in chips) 
ReinisRNS: posts small blind $0.25
matiko09: posts big blind $0.50
*** HOLE CARDS ***
Dealt to matiko09 [Kh Ah]
tallonn88: folds 
banit7: folds 
apfush: folds 
50CandyJoe: folds 
Optimistic21: folds 
Donko jr: folds 
King brid has timed out
King brid: folds 
ReinisRNS: folds 
Uncalled bet ($0.25) returned to matiko09
matiko09 collected $0.50 from pot
matiko09: doesn't show hand 
*** SUMMARY ***
Total pot $0.50 | Rake $0 
Seat 1: 50CandyJoe folded before Flop (didn't bet)
Seat 2: Optimistic21 folded before Flop (didn't bet)
Seat 3: Donko jr folded before Flop (didn't bet)
Seat 4: King brid (button) folded before Flop (didn't bet)
Seat 5: ReinisRNS (small blind) folded before Flop
Seat 6: matiko09 (big blind) collected ($0.50)
Seat 7: tallonn88 folded before Flop (didn't bet)
Seat 8: banit7 folded before Flop (didn't bet)
Seat 9: apfush folded before Flop (didn't bet)





PokerStars Hand #148607816151:  Hold'em No Limit ($0.25/$0.50 USD) - 2016/02/11 12:38:42 CET [2016/02/11 6:38:42 ET]
Table 'Hunan' 9-max Seat #1 is the button
Seat 1: matiko09 ($51.25 in chips) 
Seat 3: TheMinion ($54.61 in chips) 
Seat 4: RICKA16 ($50.75 in chips) 
Seat 5: Honk115 ($59.23 in chips) 
Seat 6: i L00K great ($59.66 in chips) 
Seat 7: SForces33 ($20.55 in chips) 
Seat 8: Reven9er ($58.45 in chips) 
Seat 9: Optimistic21 ($55.28 in chips) 
Serhent will be allowed to play after the button
TheMinion: posts small blind $0.25
RICKA16: posts big blind $0.50
*** HOLE CARDS ***
Dealt to matiko09 [Ah Tc]
Honk115: folds 
i L00K great: folds 
SForces33: folds 
Reven9er: folds 
Optimistic21: raises $0.75 to $1.25
matiko09: folds 
TheMinion: folds 
RICKA16: folds 
Uncalled bet ($0.75) returned to Optimistic21
Optimistic21 collected $1.25 from pot
*** SUMMARY ***
Total pot $1.25 | Rake $0 
Seat 1: matiko09 (button) folded before Flop (didn't bet)
Seat 3: TheMinion (small blind) folded before Flop
Seat 4: RICKA16 (big blind) folded before Flop
Seat 5: Honk115 folded before Flop (didn't bet)
Seat 6: i L00K great folded before Flop (didn't bet)
Seat 7: SForces33 folded before Flop (didn't bet)
Seat 8: Reven9er folded before Flop (didn't bet)
Seat 9: Optimistic21 collected ($1.25)





PokerStars Hand #148607815877:  Hold'em No Limit ($0.50/$1.00 USD) - 2016/02/11 12:38:42 CET [2016/02/11 6:38:42 ET]
Table 'Sycorax II' 9-max Seat #2 is the button
Seat 1: Luck In Me ($155.22 in chips) 
Seat 2: Lujan87 ($100 in chips) 
Seat 3: chauyeuba ($76.53 in chips) 
Seat 4: Sweden_Pound ($141.24 in chips) 
Seat 5: Effort92 ($167.94 in chips) 
Seat 6: FluentFlows ($37.50 in chips) 
Seat 7: hurtNCYDE ($100 in chips) 
Seat 8: matiko09 ($133.87 in chips) 
Seat 9: mrfoldcall ($96.24 in chips) 
chauyeuba: posts small blind $0.50
Sweden_Pound: posts big blind $1
*** HOLE CARDS ***
Dealt to matiko09 [Ts 9s]
Effort92: folds 
FluentFlows: folds 
hurtNCYDE: folds 
matiko09: raises $2 to $3
mrfoldcall: raises $6 to $9
Luck In Me: folds 
Lujan87: folds 
chauyeuba: folds 
Sweden_Pound: raises $14 to $23
matiko09: folds 
mrfoldcall: calls $14
*** FLOP *** [6h 8h 7c]
Sweden_Pound: checks 
mrfoldcall: bets $8
Sweden_Pound: folds 
Uncalled bet ($8) returned to mrfoldcall
mrfoldcall collected $47.27 from pot
mrfoldcall: doesn't show hand 
*** SUMMARY ***
Total pot $49.50 | Rake $2.23 
Board [6h 8h 7c]
Seat 1: Luck In Me folded before Flop (didn't bet)
Seat 2: Lujan87 (button) folded before Flop (didn't bet)
Seat 3: chauyeuba (small blind) folded before Flop
Seat 4: Sweden_Pound (big blind) folded on the Flop
Seat 5: Effort92 folded before Flop (didn't bet)
Seat 6: FluentFlows folded before Flop (didn't bet)
Seat 7: hurtNCYDE folded before Flop (didn't bet)
Seat 8: matiko09 folded before Flop
Seat 9: mrfoldcall collected ($47.27)





PokerStars Hand #148607818941:  Hold'em No Limit ($0.25/$0.50 USD) - 2016/02/11 12:38:47 CET [2016/02/11 6:38:47 ET]
Table 'Amor II' 9-max Seat #3 is the button
Seat 1: Kud3 ($53.37 in chips) 
Seat 2: GusenokRUS ($80.37 in chips) 
Seat 3: TheMinion ($57.22 in chips) 
Seat 4: Larzdog29 ($50.23 in chips) 
Seat 5: Optimistic21 ($50.66 in chips) 
Seat 6: matiko09 ($50.75 in chips) 
Seat 8: Reven9er ($59.36 in chips) 
Seat 9: tallonn88 ($108.86 in chips) 
Larzdog29: posts small blind $0.25
Optimistic21: posts big blind $0.50
Serhent: sits out 
*** HOLE CARDS ***
Dealt to matiko09 [8d 5d]
matiko09: folds 
Reven9er: folds 
tallonn88: folds 
Kud3: raises $1 to $1.50
GusenokRUS: folds 
TheMinion: folds 
Larzdog29: folds 
Optimistic21: folds 
Uncalled bet ($1) returned to Kud3
Kud3 collected $1.25 from pot
Kud3: doesn't show hand 
*** SUMMARY ***
Total pot $1.25 | Rake $0 
Seat 1: Kud3 collected ($1.25)
Seat 2: GusenokRUS folded before Flop (didn't bet)
Seat 3: TheMinion (button) folded before Flop (didn't bet)
Seat 4: Larzdog29 (small blind) folded before Flop
Seat 5: Optimistic21 (big blind) folded before Flop
Seat 6: matiko09 folded before Flop (didn't bet)
Seat 8: Reven9er folded before Flop (didn't bet)
Seat 9: tallonn88 folded before Flop (didn't bet)





PokerStars Hand #148607821745:  Hold'em No Limit ($0.25/$0.50 USD) - 2016/02/11 12:38:52 CET [2016/02/11 6:38:52 ET]
Table 'Ambrosia II' 9-max Seat #6 is the button
Seat 1: matiko09 ($50 in chips) 
Seat 2: TheMinion ($116.94 in chips) 
Seat 4: huudk2016 ($25.65 in chips) 
Seat 6: Reven9er ($68.05 in chips) 
Seat 7: mexx1234 ($63.23 in chips) 
Seat 8: tallonn88 ($51.56 in chips) 
mexx1234: posts small blind $0.25
tallonn88: posts big blind $0.50
make6a: sits out 
*** HOLE CARDS ***
Dealt to matiko09 [2c Th]
matiko09: folds 
TheMinion: folds 
huudk2016: folds 
Reven9er: folds 
mexx1234: raises $0.75 to $1.25
tallonn88: calls $0.75
*** FLOP *** [6h 4d 7c]
mexx1234: checks 
tallonn88: bets $1.31
mexx1234: folds 
Uncalled bet ($1.31) returned to tallonn88
tallonn88 collected $2.39 from pot
tallonn88: doesn't show hand 
*** SUMMARY ***
Total pot $2.50 | Rake $0.11 
Board [6h 4d 7c]
Seat 1: matiko09 folded before Flop (didn't bet)
Seat 2: TheMinion folded before Flop (didn't bet)
Seat 4: huudk2016 folded before Flop (didn't bet)
Seat 6: Reven9er (button) folded before Flop (didn't bet)
Seat 7: mexx1234 (small blind) folded on the Flop
Seat 8: tallonn88 (big blind) collected ($2.39)





PokerStars Hand #148607828940:  Hold'em No Limit ($0.25/$0.50 USD) - 2016/02/11 12:39:05 CET [2016/02/11 6:39:05 ET]
Table 'Hunan' 9-max Seat #3 is the button
Seat 1: matiko09 ($51.25 in chips) 
Seat 3: TheMinion ($54.36 in chips) 
Seat 4: RICKA16 ($50.25 in chips) 
Seat 5: Honk115 ($59.23 in chips) 
Seat 6: i L00K great ($59.66 in chips) 
Seat 7: SForces33 ($20.55 in chips) 
Seat 8: Reven9er ($58.45 in chips) 
Seat 9: Optimistic21 ($56.03 in chips) 
RICKA16: posts small blind $0.25
Honk115: posts big blind $0.50
Serhent: sits out 
*** HOLE CARDS ***
Dealt to matiko09 [Qc Ad]
i L00K great: folds 
SForces33: folds 
Reven9er: folds 
Optimistic21: folds 
matiko09: raises $1 to $1.50
TheMinion: folds 
RICKA16: folds 
Honk115: folds 
Uncalled bet ($1) returned to matiko09
matiko09 collected $1.25 from pot
matiko09: doesn't show hand 
*** SUMMARY ***
Total pot $1.25 | Rake $0 
Seat 1: matiko09 collected ($1.25)
Seat 3: TheMinion (button) folded before Flop (didn't bet)
Seat 4: RICKA16 (small blind) folded before Flop
Seat 5: Honk115 (big blind) folded before Flop
Seat 6: i L00K great folded before Flop (didn't bet)
Seat 7: SForces33 folded before Flop (didn't bet)
Seat 8: Reven9er folded before Flop (didn't bet)
Seat 9: Optimistic21 folded before Flop (didn't bet)





PokerStars Hand #148607834089:  Hold'em No Limit ($0.25/$0.50 USD) - 2016/02/11 12:39:14 CET [2016/02/11 6:39:14 ET]
Table 'Sylvania II' 9-max Seat #4 is the button
Seat 1: mexx1234 ($196.43 in chips) 
Seat 2: Effort92 ($54.55 in chips) 
Seat 3: ruyingren ($185.46 in chips) 
Seat 4: matiko09 ($148.80 in chips) 
Seat 5: vlad11122007 ($68.13 in chips) 
Seat 6: TonnaMunz ($121.30 in chips) 
Seat 7: i L00K great ($51.28 in chips) 
Seat 8: Optimistic21 ($51.25 in chips) 
Seat 9: Kud3 ($134.91 in chips) 
vlad11122007: posts small blind $0.25
TonnaMunz: posts big blind $0.50
mexx1234: posts the ante $0.10
Effort92: posts the ante $0.10
ruyingren: posts the ante $0.10
matiko09: posts the ante $0.10
vlad11122007: posts the ante $0.10
TonnaMunz: posts the ante $0.10
i L00K great: posts the ante $0.10
Optimistic21: posts the ante $0.10
Kud3: posts the ante $0.10
*** HOLE CARDS ***
Dealt to matiko09 [5h Qh]
i L00K great: folds 
Optimistic21: folds 
Kud3: folds 
mexx1234: folds 
Effort92: folds 
ruyingren: folds 
matiko09: raises $1 to $1.50
vlad11122007: folds 
TonnaMunz: folds 
Uncalled bet ($1) returned to matiko09
matiko09 collected $2.15 from pot
matiko09: doesn't show hand 
*** SUMMARY ***
Total pot $2.15 | Rake $0 
Seat 1: mexx1234 folded before Flop (didn't bet)
Seat 2: Effort92 folded before Flop (didn't bet)
Seat 3: ruyingren folded before Flop (didn't bet)
Seat 4: matiko09 (button) collected ($2.15)
Seat 5: vlad11122007 (small blind) folded before Flop
Seat 6: TonnaMunz (big blind) folded before Flop
Seat 7: i L00K great folded before Flop (didn't bet)
Seat 8: Optimistic21 folded before Flop (didn't bet)
Seat 9: Kud3 folded before Flop (didn't bet)





PokerStars Hand #148607834409:  Hold'em No Limit ($0.25/$0.50 USD) - 2016/02/11 12:39:15 CET [2016/02/11 6:39:15 ET]
Table 'Amor II' 9-max Seat #4 is the button
Seat 1: Kud3 ($54.12 in chips) 
Seat 2: GusenokRUS ($80.37 in chips) 
Seat 3: TheMinion ($57.22 in chips) 
Seat 4: Larzdog29 ($49.98 in chips) 
Seat 5: Optimistic21 ($50.16 in chips) 
Seat 6: matiko09 ($50.75 in chips) 
Seat 8: Reven9er ($59.36 in chips) 
Seat 9: tallonn88 ($108.86 in chips) 
Optimistic21: posts small blind $0.25
matiko09: posts big blind $0.50
Serhent: sits out 
*** HOLE CARDS ***
Dealt to matiko09 [4c Tc]
Reven9er: folds 
tallonn88: folds 
Kud3: raises $1 to $1.50
GusenokRUS: folds 
TheMinion: folds 
Larzdog29: raises $2.50 to $4
Optimistic21: folds 
matiko09: folds 
Kud3: folds 
Uncalled bet ($2.50) returned to Larzdog29
Larzdog29 collected $3.75 from pot
Larzdog29: doesn't show hand 
*** SUMMARY ***
Total pot $3.75 | Rake $0 
Seat 1: Kud3 folded before Flop
Seat 2: GusenokRUS folded before Flop (didn't bet)
Seat 3: TheMinion folded before Flop (didn't bet)
Seat 4: Larzdog29 (button) collected ($3.75)
Seat 5: Optimistic21 (small blind) folded before Flop
Seat 6: matiko09 (big blind) folded before Flop
Seat 8: Reven9er folded before Flop (didn't bet)
Seat 9: tallonn88 folded before Flop (didn't bet)





PokerStars Hand #148607839430:  Hold'em No Limit ($0.25/$0.50 USD) - 2016/02/11 12:39:24 CET [2016/02/11 6:39:24 ET]
Table 'Stereoskopia' 9-max Seat #5 is the button
Seat 1: 50CandyJoe ($54.68 in chips) 
Seat 2: Optimistic21 ($56.50 in chips) 
Seat 3: Donko jr ($10.65 in chips) 
Seat 5: ReinisRNS ($28.88 in chips) 
Seat 6: matiko09 ($50.25 in chips) 
Seat 7: tallonn88 ($104.92 in chips) 
Seat 8: banit7 ($79.56 in chips) 
Seat 9: apfush ($50 in chips) 
matiko09: posts small blind $0.25
tallonn88: posts big blind $0.50
*** HOLE CARDS ***
Dealt to matiko09 [Jh 7h]
banit7: folds 
apfush: raises $1 to $1.50
50CandyJoe: folds 
Optimistic21: raises $3 to $4.50
Donko jr: folds 
ReinisRNS: folds 
matiko09: folds 
tallonn88: folds 
apfush: folds 
Uncalled bet ($3) returned to Optimistic21
Optimistic21 collected $3.75 from pot
*** SUMMARY ***
Total pot $3.75 | Rake $0 
Seat 1: 50CandyJoe folded before Flop (didn't bet)
Seat 2: Optimistic21 collected ($3.75)
Seat 3: Donko jr folded before Flop (didn't bet)
Seat 5: ReinisRNS (button) folded before Flop (didn't bet)
Seat 6: matiko09 (small blind) folded before Flop
Seat 7: tallonn88 (big blind) folded before Flop
Seat 8: banit7 folded before Flop (didn't bet)
Seat 9: apfush folded before Flop





PokerStars Hand #148607846302:  Hold'em No Limit ($0.25/$0.50 USD) - 2016/02/11 12:39:36 CET [2016/02/11 6:39:36 ET]
Table 'Hunan' 9-max Seat #4 is the button
Seat 1: matiko09 ($52 in chips) 
Seat 3: TheMinion ($54.36 in chips) 
Seat 4: RICKA16 ($50 in chips) 
Seat 5: Honk115 ($58.73 in chips) 
Seat 6: i L00K great ($59.66 in chips) 
Seat 7: SForces33 ($20.55 in chips) 
Seat 8: Reven9er ($58.45 in chips) 
Seat 9: Optimistic21 ($56.03 in chips) 
Honk115: posts small blind $0.25
i L00K great: posts big blind $0.50
Serhent: sits out 
*** HOLE CARDS ***
Dealt to matiko09 [9d 7d]
SForces33: folds 
Reven9er: folds 
Optimistic21: folds 
matiko09: raises $1 to $1.50
TheMinion: folds 
RICKA16: folds 
Honk115: folds 
i L00K great: raises $4 to $5.50
matiko09: folds 
Uncalled bet ($4) returned to i L00K great
i L00K great collected $3.25 from pot
i L00K great: doesn't show hand 
*** SUMMARY ***
Total pot $3.25 | Rake $0 
Seat 1: matiko09 folded before Flop
Seat 3: TheMinion folded before Flop (didn't bet)
Seat 4: RICKA16 (button) folded before Flop (didn't bet)
Seat 5: Honk115 (small blind) folded before Flop
Seat 6: i L00K great (big blind) collected ($3.25)
Seat 7: SForces33 folded before Flop (didn't bet)
Seat 8: Reven9er folded before Flop (didn't bet)
Seat 9: Optimistic21 folded before Flop (didn't bet)





PokerStars Hand #148607846167:  Hold'em No Limit ($0.25/$0.50 USD) - 2016/02/11 12:39:36 CET [2016/02/11 6:39:36 ET]
Table 'Ambrosia II' 9-max Seat #7 is the button
Seat 1: matiko09 ($50 in chips) 
Seat 2: TheMinion ($116.94 in chips) 
Seat 4: huudk2016 ($25.65 in chips) 
Seat 6: Reven9er ($68.05 in chips) 
Seat 7: mexx1234 ($61.98 in chips) 
Seat 8: tallonn88 ($52.70 in chips) 
tallonn88: posts small blind $0.25
matiko09: posts big blind $0.50
make6a: sits out 
*** HOLE CARDS ***
Dealt to matiko09 [2s 5s]
TheMinion: folds 
huudk2016: calls $0.50
Reven9er: calls $0.50
mexx1234: calls $0.50
tallonn88: folds 
matiko09: checks 
*** FLOP *** [8h Qc 2h]
matiko09: checks 
huudk2016: checks 
Reven9er: bets $1.50
mexx1234: folds 
matiko09: folds 
huudk2016 is disconnected 
huudk2016 is connected 
huudk2016: folds 
Uncalled bet ($1.50) returned to Reven9er
Reven9er collected $2.15 from pot
Reven9er: doesn't show hand 
*** SUMMARY ***
Total pot $2.25 | Rake $0.10 
Board [8h Qc 2h]
Seat 1: matiko09 (big blind) folded on the Flop
Seat 2: TheMinion folded before Flop (didn't bet)
Seat 4: huudk2016 folded on the Flop
Seat 6: Reven9er collected ($2.15)
Seat 7: mexx1234 (button) folded on the Flop
Seat 8: tallonn88 (small blind) folded before Flop





PokerStars Hand #148607849654:  Hold'em No Limit ($0.50/$1.00 USD) - 2016/02/11 12:39:42 CET [2016/02/11 6:39:42 ET]
Table 'Sycorax II' 9-max Seat #3 is the button
Seat 1: Luck In Me ($155.22 in chips) 
Seat 2: Lujan87 ($100 in chips) 
Seat 3: chauyeuba ($76.03 in chips) 
Seat 4: Sweden_Pound ($118.24 in chips) 
Seat 5: Effort92 ($167.94 in chips) 
Seat 6: FluentFlows ($37.50 in chips) 
Seat 7: hurtNCYDE ($100 in chips) 
Seat 8: matiko09 ($130.87 in chips) 
Seat 9: mrfoldcall ($120.51 in chips) 
Sweden_Pound: posts small blind $0.50
Effort92: posts big blind $1
*** HOLE CARDS ***
Dealt to matiko09 [Tc Th]
FluentFlows: folds 
hurtNCYDE: folds 
matiko09: raises $2 to $3
mrfoldcall: folds 
Luck In Me: folds 
Lujan87: folds 
chauyeuba: folds 
Sweden_Pound: raises $8 to $11
Effort92: folds 
matiko09: calls $8
*** FLOP *** [Ts 2h 4h]
Sweden_Pound: bets $14.27
matiko09: calls $14.27
*** TURN *** [Ts 2h 4h] [Qs]
Sweden_Pound: bets $32
matiko09: calls $32
*** RIVER *** [Ts 2h 4h Qs] [5s]
Sweden_Pound: bets $60.97 and is all-in
matiko09: calls $60.97
*** SHOW DOWN ***
Sweden_Pound: shows [Ah As] (a pair of Aces)
matiko09: shows [Tc Th] (three of a kind, Tens)
matiko09 collected $234.68 from pot
*** SUMMARY ***
Total pot $237.48 | Rake $2.80 
Board [Ts 2h 4h Qs 5s]
Seat 1: Luck In Me folded before Flop (didn't bet)
Seat 2: Lujan87 folded before Flop (didn't bet)
Seat 3: chauyeuba (button) folded before Flop (didn't bet)
Seat 4: Sweden_Pound (small blind) showed [Ah As] and lost with a pair of Aces
Seat 5: Effort92 (big blind) folded before Flop
Seat 6: FluentFlows folded before Flop (didn't bet)
Seat 7: hurtNCYDE folded before Flop (didn't bet)
Seat 8: matiko09 showed [Tc Th] and won ($234.68) with three of a kind, Tens
Seat 9: mrfoldcall folded before Flop (didn't bet)





PokerStars Hand #148607849998:  Hold'em No Limit ($0.25/$0.50 USD) - 2016/02/11 12:39:43 CET [2016/02/11 6:39:43 ET]
Table 'Sylvania II' 9-max Seat #5 is the button
Seat 1: mexx1234 ($196.33 in chips) 
Seat 2: Effort92 ($54.45 in chips) 
Seat 3: ruyingren ($185.36 in chips) 
Seat 4: matiko09 ($150.35 in chips) 
Seat 5: vlad11122007 ($67.78 in chips) 
Seat 6: TonnaMunz ($120.70 in chips) 
Seat 7: i L00K great ($51.18 in chips) 
Seat 8: Optimistic21 ($51.15 in chips) 
Seat 9: Kud3 ($134.81 in chips) 
TonnaMunz: posts small blind $0.25
i L00K great: posts big blind $0.50
mexx1234: posts the ante $0.10
Effort92: posts the ante $0.10
ruyingren: posts the ante $0.10
matiko09: posts the ante $0.10
vlad11122007: posts the ante $0.10
TonnaMunz: posts the ante $0.10
i L00K great: posts the ante $0.10
Optimistic21: posts the ante $0.10
Kud3: posts the ante $0.10
*** HOLE CARDS ***
Dealt to matiko09 [Kd 5h]
Optimistic21: folds 
Kud3: folds 
mexx1234: raises $0.75 to $1.25
Effort92: folds 
ruyingren: folds 
matiko09: folds 
vlad11122007: folds 
TonnaMunz: folds 
i L00K great: folds 
Uncalled bet ($0.75) returned to mexx1234
mexx1234 collected $2.15 from pot
mexx1234: doesn't show hand 
*** SUMMARY ***
Total pot $2.15 | Rake $0 
Seat 1: mexx1234 collected ($2.15)
Seat 2: Effort92 folded before Flop (didn't bet)
Seat 3: ruyingren folded before Flop (didn't bet)
Seat 4: matiko09 folded before Flop (didn't bet)
Seat 5: vlad11122007 (button) folded before Flop (didn't bet)
Seat 6: TonnaMunz (small blind) folded before Flop
Seat 7: i L00K great (big blind) folded before Flop
Seat 8: Optimistic21 folded before Flop (didn't bet)
Seat 9: Kud3 folded before Flop (didn't bet)





PokerStars Hand #148607851049:  Hold'em No Limit ($0.50/$1.00 USD) - 2016/02/11 12:39:45 CET [2016/02/11 6:39:45 ET]
Table 'Regor' 9-max Seat #5 is the button
Seat 1: matiko09 ($127.77 in chips) 
Seat 2: Luck In Me ($100.50 in chips) 
Seat 3: oscarleon ($152.40 in chips) 
Seat 4: Filojoes ($100 in chips) 
Seat 5: chauyeuba ($17.90 in chips) 
Seat 6: Dachish ($92.95 in chips) 
Seat 8: R3NZONIT3 ($88.07 in chips) 
Seat 9: CoolFireX ($112.44 in chips) 
Dachish: posts small blind $0.50
R3NZONIT3: posts big blind $1
*** HOLE CARDS ***
Dealt to matiko09 [6h 5d]
CoolFireX: folds 
matiko09: folds 
Luck In Me: folds 
gwwsb leaves the table
oscarleon: folds 
Filojoes: raises $1.50 to $2.50
chauyeuba: folds 
Dachish: folds 
R3NZONIT3: calls $1.50
*** FLOP *** [5c 8d Ks]
R3NZONIT3: checks 
Filojoes: checks 
*** TURN *** [5c 8d Ks] [Qh]
Sweden_Pound joins the table at seat #7 
R3NZONIT3: checks 
Filojoes: checks 
*** RIVER *** [5c 8d Ks Qh] [4h]
R3NZONIT3: checks 
Filojoes: checks 
*** SHOW DOWN ***
R3NZONIT3: shows [5s Ad] (a pair of Fives)
Filojoes: mucks hand 
R3NZONIT3 collected $5.25 from pot
*** SUMMARY ***
Total pot $5.50 | Rake $0.25 
Board [5c 8d Ks Qh 4h]
Seat 1: matiko09 folded before Flop (didn't bet)
Seat 2: Luck In Me folded before Flop (didn't bet)
Seat 3: oscarleon folded before Flop (didn't bet)
Seat 4: Filojoes mucked [9s Jd]
Seat 5: chauyeuba (button) folded before Flop (didn't bet)
Seat 6: Dachish (small blind) folded before Flop
Seat 8: R3NZONIT3 (big blind) showed [5s Ad] and won ($5.25) with a pair of Fives
Seat 9: CoolFireX folded before Flop (didn't bet)





PokerStars Hand #148607852061:  Hold'em No Limit ($0.25/$0.50 USD) - 2016/02/11 12:39:46 CET [2016/02/11 6:39:46 ET]
Table 'Amor II' 9-max Seat #5 is the button
Seat 1: Kud3 ($52.62 in chips) 
Seat 2: GusenokRUS ($80.37 in chips) 
Seat 3: TheMinion ($57.22 in chips) 
Seat 4: Larzdog29 ($52.23 in chips) 
Seat 5: Optimistic21 ($50 in chips) 
Seat 6: matiko09 ($50.25 in chips) 
Seat 7: Serhent ($52.25 in chips) 
Seat 8: Reven9er ($59.36 in chips) 
Seat 9: tallonn88 ($108.86 in chips) 
matiko09: posts small blind $0.25
Serhent: posts big blind $0.50
*** HOLE CARDS ***
Dealt to matiko09 [4h 7c]
Reven9er: folds 
tallonn88: folds 
Kud3: folds 
GusenokRUS: folds 
TheMinion: folds 
Larzdog29: folds 
Optimistic21: raises $0.50 to $1
matiko09: folds 
Serhent: calls $0.50
*** FLOP *** [2h 9s 6c]
Serhent: checks 
Optimistic21: checks 
*** TURN *** [2h 9s 6c] [5d]
Serhent: checks 
Optimistic21: checks 
*** RIVER *** [2h 9s 6c 5d] [8h]
Serhent: checks 
Optimistic21: checks 
*** SHOW DOWN ***
Serhent: shows [Ks Jd] (high card King)
Optimistic21: shows [Qd Kc] (high card King - Queen kicker)
Optimistic21 collected $2.15 from pot
*** SUMMARY ***
Total pot $2.25 | Rake $0.10 
Board [2h 9s 6c 5d 8h]
Seat 1: Kud3 folded before Flop (didn't bet)
Seat 2: GusenokRUS folded before Flop (didn't bet)
Seat 3: TheMinion folded before Flop (didn't bet)
Seat 4: Larzdog29 folded before Flop (didn't bet)
Seat 5: Optimistic21 (button) showed [Qd Kc] and won ($2.15) with high card King
Seat 6: matiko09 (small blind) folded before Flop
Seat 7: Serhent (big blind) showed [Ks Jd] and lost with high card King
Seat 8: Reven9er folded before Flop (didn't bet)
Seat 9: tallonn88 folded before Flop (didn't bet)





PokerStars Hand #148607856448:  Hold'em No Limit ($0.25/$0.50 USD) - 2016/02/11 12:39:54 CET [2016/02/11 6:39:54 ET]
Table 'Stereoskopia' 9-max Seat #6 is the button
Seat 1: 50CandyJoe ($54.68 in chips) 
Seat 2: Optimistic21 ($58.75 in chips) 
Seat 3: Donko jr ($10.65 in chips) 
Seat 5: ReinisRNS ($28.88 in chips) 
Seat 6: matiko09 ($50 in chips) 
Seat 7: tallonn88 ($104.42 in chips) 
Seat 9: apfush ($50 in chips) 
tallonn88: posts small blind $0.25
banit7: is sitting out 
apfush: posts big blind $0.50
*** HOLE CARDS ***
Dealt to matiko09 [7d 8d]
50CandyJoe: folds 
Optimistic21: folds 
banit7 leaves the table
vlad11122007 joins the table at seat #8 
Donko jr: calls $0.50
ReinisRNS: folds 
matiko09: raises $1 to $1.50
ReinisRNS is disconnected 
tallonn88: folds 
apfush: folds 
Donko jr: calls $1
*** FLOP *** [5c 6s 3c]
Donko jr: checks 
matiko09: bets $1.86
Donko jr: raises $3.65 to $5.51
matiko09: raises $9.16 to $14.67
Donko jr: calls $3.64 and is all-in
Uncalled bet ($5.52) returned to matiko09
*** TURN *** [5c 6s 3c] [5s]
*** RIVER *** [5c 6s 3c 5s] [8c]
*** SHOW DOWN ***
Donko jr: shows [5h 6c] (a full house, Fives full of Sixes)
matiko09: mucks hand 
Donko jr collected $21.06 from pot
*** SUMMARY ***
Total pot $22.05 | Rake $0.99 
Board [5c 6s 3c 5s 8c]
Seat 1: 50CandyJoe folded before Flop (didn't bet)
Seat 2: Optimistic21 folded before Flop (didn't bet)
Seat 3: Donko jr showed [5h 6c] and won ($21.06) with a full house, Fives full of Sixes
Seat 5: ReinisRNS folded before Flop (didn't bet)
Seat 6: matiko09 (button) mucked [7d 8d]
Seat 7: tallonn88 (small blind) folded before Flop
Seat 9: apfush (big blind) folded before Flop





PokerStars Hand #148607862351:  Hold'em No Limit ($0.25/$0.50 USD) - 2016/02/11 12:40:05 CET [2016/02/11 6:40:05 ET]
Table 'Algedi' 9-max Seat #1 is the button
Seat 1: vlad11122007 ($52.87 in chips) 
Seat 2: Reffypaul ($73.64 in chips) 
Seat 3: Saggitaurus ($100 in chips) 
Seat 4: Effort92 ($61.56 in chips) 
Seat 6: TonnaMunz ($123.61 in chips) 
Seat 7: hoedtrob ($67.40 in chips) 
Seat 8: matiko09 ($50.30 in chips) 
Seat 9: Kud3 ($125 in chips) 
Reffypaul: posts small blind $0.25
Saggitaurus: posts big blind $0.50
vlad11122007: posts the ante $0.10
Reffypaul: posts the ante $0.10
Saggitaurus: posts the ante $0.10
Effort92: posts the ante $0.10
TonnaMunz: posts the ante $0.10
hoedtrob: posts the ante $0.10
matiko09: posts the ante $0.10
Kud3: posts the ante $0.10
*** HOLE CARDS ***
Dealt to matiko09 [Kh 5d]
Effort92: folds 
TonnaMunz: folds 
hoedtrob: raises $1 to $1.50
matiko09: folds 
Kud3: folds 
vlad11122007: raises $3.50 to $5
Reffypaul: folds 
Saggitaurus: folds 
hoedtrob: folds 
Uncalled bet ($3.50) returned to vlad11122007
vlad11122007 collected $4.55 from pot
vlad11122007: doesn't show hand 
*** SUMMARY ***
Total pot $4.55 | Rake $0 
Seat 1: vlad11122007 (button) collected ($4.55)
Seat 2: Reffypaul (small blind) folded before Flop
Seat 3: Saggitaurus (big blind) folded before Flop
Seat 4: Effort92 folded before Flop (didn't bet)
Seat 6: TonnaMunz folded before Flop (didn't bet)
Seat 7: hoedtrob folded before Flop
Seat 8: matiko09 folded before Flop (didn't bet)
Seat 9: Kud3 folded before Flop (didn't bet)





PokerStars Hand #148607864813:  Hold'em No Limit ($0.25/$0.50 USD) - 2016/02/11 12:40:09 CET [2016/02/11 6:40:09 ET]
Table 'Hunan' 9-max Seat #5 is the button
Seat 1: matiko09 ($50.50 in chips) 
Seat 3: TheMinion ($54.36 in chips) 
Seat 4: RICKA16 ($50 in chips) 
Seat 5: Honk115 ($58.48 in chips) 
Seat 6: i L00K great ($61.41 in chips) 
Seat 7: SForces33 ($20.55 in chips) 
Seat 8: Reven9er ($58.45 in chips) 
Seat 9: Optimistic21 ($56.03 in chips) 
i L00K great: posts small blind $0.25
SForces33: posts big blind $0.50
Serhent: sits out 
*** HOLE CARDS ***
Dealt to matiko09 [7d Ts]
Reven9er: folds 
Optimistic21: folds 
matiko09: folds 
TheMinion: raises $0.75 to $1.25
RICKA16: folds 
Honk115: calls $1.25
i L00K great: folds 
SForces33: folds 
*** FLOP *** [6c 3d Jd]
TheMinion: bets $1.98
Honk115: calls $1.98
*** TURN *** [6c 3d Jd] [Tc]
TheMinion: bets $4.53
Honk115: calls $4.53
*** RIVER *** [6c 3d Jd Tc] [5d]
TheMinion: checks 
Honk115: checks 
*** SHOW DOWN ***
TheMinion: shows [Qs Ac] (high card Ace)
Honk115: shows [Th 9h] (a pair of Tens)
Honk115 collected $15.54 from pot
*** SUMMARY ***
Total pot $16.27 | Rake $0.73 
Board [6c 3d Jd Tc 5d]
Seat 1: matiko09 folded before Flop (didn't bet)
Seat 3: TheMinion showed [Qs Ac] and lost with high card Ace
Seat 4: RICKA16 folded before Flop (didn't bet)
Seat 5: Honk115 (button) showed [Th 9h] and won ($15.54) with a pair of Tens
Seat 6: i L00K great (small blind) folded before Flop
Seat 7: SForces33 (big blind) folded before Flop
Seat 8: Reven9er folded before Flop (didn't bet)
Seat 9: Optimistic21 folded before Flop (didn't bet)





PokerStars Hand #148607883192:  Hold'em No Limit (€0.25/€0.50 EUR) - 2016/02/11 12:40:42 CET [2016/02/11 6:40:42 ET]
Table 'Otero II' 9-max Seat #2 is the button
Seat 1: Nacho2556 (€43.98 in chips) 
Seat 2: make6a (€49.25 in chips) 
Seat 3: chaogoose82 (€69.28 in chips) 
Seat 4: kram0909 (€20.30 in chips) 
Seat 5: vlad11122007 (€50 in chips) 
Seat 6: TonnaMunz (€51.44 in chips) 
Seat 8: matiko09 (€75.96 in chips) 
Seat 9: Optimistic21 (€58.54 in chips) 
chaogoose82: posts small blind €0.25
kram0909: posts big blind €0.50
*** HOLE CARDS ***
Dealt to matiko09 [4d 2s]
vlad11122007: folds 
TonnaMunz: raises €1 to €1.50
matiko09: folds 
Optimistic21: folds 
Nacho2556: folds 
make6a: calls €1.50
chaogoose82: folds 
kram0909: folds 
*** FLOP *** [3c 6d 2d]
TonnaMunz: checks 
make6a: bets €2.22
TonnaMunz: calls €2.22
*** TURN *** [3c 6d 2d] [Ad]
TonnaMunz: checks 
make6a: checks 
*** RIVER *** [3c 6d 2d Ad] [8c]
TonnaMunz: bets €5.50
make6a: folds 
Uncalled bet (€5.50) returned to TonnaMunz
TonnaMunz collected €7.82 from pot
TonnaMunz: doesn't show hand 
*** SUMMARY ***
Total pot €8.19 | Rake €0.37 
Board [3c 6d 2d Ad 8c]
Seat 1: Nacho2556 folded before Flop (didn't bet)
Seat 2: make6a (button) folded on the River
Seat 3: chaogoose82 (small blind) folded before Flop
Seat 4: kram0909 (big blind) folded before Flop
Seat 5: vlad11122007 folded before Flop (didn't bet)
Seat 6: TonnaMunz collected (€7.82)
Seat 8: matiko09 folded before Flop (didn't bet)
Seat 9: Optimistic21 folded before Flop (didn't bet)





PokerStars Hand #148607883439:  Hold'em No Limit ($0.25/$0.50 USD) - 2016/02/11 12:40:43 CET [2016/02/11 6:40:43 ET]
Table 'Sylvania II' 9-max Seat #6 is the button
Seat 1: mexx1234 ($197.88 in chips) 
Seat 2: Effort92 ($54.35 in chips) 
Seat 3: ruyingren ($185.26 in chips) 
Seat 4: matiko09 ($150.25 in chips) 
Seat 5: vlad11122007 ($67.68 in chips) 
Seat 6: TonnaMunz ($120.35 in chips) 
Seat 7: i L00K great ($50.58 in chips) 
Seat 8: Optimistic21 ($51.05 in chips) 
Seat 9: Kud3 ($134.71 in chips) 
i L00K great: posts small blind $0.25
Optimistic21: posts big blind $0.50
mexx1234: posts the ante $0.10
Effort92: posts the ante $0.10
ruyingren: posts the ante $0.10
matiko09: posts the ante $0.10
vlad11122007: posts the ante $0.10
TonnaMunz: posts the ante $0.10
i L00K great: posts the ante $0.10
Optimistic21: posts the ante $0.10
Kud3: posts the ante $0.10
*** HOLE CARDS ***
Dealt to matiko09 [7c 6h]
Kud3: raises $1 to $1.50
mexx1234: calls $1.50
Effort92: folds 
ruyingren: folds 
matiko09: folds 
vlad11122007: folds 
TonnaMunz: calls $1.50
i L00K great: folds 
Optimistic21: folds 
*** FLOP *** [4c Ts 3c]
Kud3: bets $4.22
mexx1234: folds 
TonnaMunz: raises $11.28 to $15.50
Kud3: folds 
Uncalled bet ($11.28) returned to TonnaMunz
TonnaMunz collected $13.93 from pot
TonnaMunz: doesn't show hand 
*** SUMMARY ***
Total pot $14.59 | Rake $0.66 
Board [4c Ts 3c]
Seat 1: mexx1234 folded on the Flop
Seat 2: Effort92 folded before Flop (didn't bet)
Seat 3: ruyingren folded before Flop (didn't bet)
Seat 4: matiko09 folded before Flop (didn't bet)
Seat 5: vlad11122007 folded before Flop (didn't bet)
Seat 6: TonnaMunz (button) collected ($13.93)
Seat 7: i L00K great (small blind) folded before Flop
Seat 8: Optimistic21 (big blind) folded before Flop
Seat 9: Kud3 folded on the Flop





PokerStars Hand #148607884741:  Hold'em No Limit ($0.25/$0.50 USD) - 2016/02/11 12:40:45 CET [2016/02/11 6:40:45 ET]
Table 'Amor II' 9-max Seat #6 is the button
Seat 1: Kud3 ($52.62 in chips) 
Seat 2: GusenokRUS ($80.37 in chips) 
Seat 3: TheMinion ($57.22 in chips) 
Seat 4: Larzdog29 ($52.23 in chips) 
Seat 5: Optimistic21 ($51.15 in chips) 
Seat 6: matiko09 ($50 in chips) 
Seat 7: Serhent ($51.25 in chips) 
Seat 8: Reven9er ($59.36 in chips) 
Seat 9: tallonn88 ($108.86 in chips) 
Serhent: posts small blind $0.25
Reven9er: posts big blind $0.50
*** HOLE CARDS ***
Dealt to matiko09 [Jh 7d]
tallonn88: folds 
Kud3: folds 
GusenokRUS: raises $1 to $1.50
TheMinion: folds 
Larzdog29: calls $1.50
Optimistic21: folds 
matiko09: folds 
Serhent: folds 
Reven9er: folds 
*** FLOP *** [Ts Kd 9c]
GusenokRUS: bets $2
Larzdog29: calls $2
*** TURN *** [Ts Kd 9c] [3h]
GusenokRUS: bets $4
Larzdog29: calls $4
*** RIVER *** [Ts Kd 9c 3h] [2d]
GusenokRUS: bets $7
Larzdog29: calls $7
*** SHOW DOWN ***
GusenokRUS: shows [Qh Th] (a pair of Tens)
Larzdog29: shows [Kc Ad] (a pair of Kings)
Larzdog29 collected $28.41 from pot
*** SUMMARY ***
Total pot $29.75 | Rake $1.34 
Board [Ts Kd 9c 3h 2d]
Seat 1: Kud3 folded before Flop (didn't bet)
Seat 2: GusenokRUS showed [Qh Th] and lost with a pair of Tens
Seat 3: TheMinion folded before Flop (didn't bet)
Seat 4: Larzdog29 showed [Kc Ad] and won ($28.41) with a pair of Kings
Seat 5: Optimistic21 folded before Flop (didn't bet)
Seat 6: matiko09 (button) folded before Flop (didn't bet)
Seat 7: Serhent (small blind) folded before Flop
Seat 8: Reven9er (big blind) folded before Flop
Seat 9: tallonn88 folded before Flop (didn't bet)





PokerStars Hand #148607886083:  Hold'em No Limit ($0.50/$1.00 USD) - 2016/02/11 12:40:48 CET [2016/02/11 6:40:48 ET]
Table 'Regor' 9-max Seat #6 is the button
Seat 1: matiko09 ($127.77 in chips) 
Seat 2: Luck In Me ($100.50 in chips) 
Seat 3: oscarleon ($152.40 in chips) 
Seat 4: Filojoes ($100 in chips) 
Seat 5: chauyeuba ($55.76 in chips) 
Seat 6: Dachish ($92.45 in chips) 
Seat 8: R3NZONIT3 ($90.82 in chips) 
Seat 9: CoolFireX ($112.44 in chips) 
Sweden_Pound will be allowed to play after the button
R3NZONIT3: posts small blind $0.50
CoolFireX: posts big blind $1
*** HOLE CARDS ***
Dealt to matiko09 [3d 3h]
matiko09: folds 
Luck In Me: folds 
oscarleon: raises $2 to $3
Filojoes: folds 
chauyeuba: folds 
Dachish: folds 
R3NZONIT3: calls $2.50
CoolFireX: folds 
*** FLOP *** [As 8s Ts]
R3NZONIT3: checks 
oscarleon: bets $5
R3NZONIT3: calls $5
*** TURN *** [As 8s Ts] [Kh]
R3NZONIT3: checks 
oscarleon: checks 
*** RIVER *** [As 8s Ts Kh] [5s]
R3NZONIT3: checks 
oscarleon: checks 
*** SHOW DOWN ***
R3NZONIT3: shows [Ah 7d] (a pair of Aces)
oscarleon: shows [7s 7h] (a flush, Ace high)
oscarleon collected $16.24 from pot
*** SUMMARY ***
Total pot $17 | Rake $0.76 
Board [As 8s Ts Kh 5s]
Seat 1: matiko09 folded before Flop (didn't bet)
Seat 2: Luck In Me folded before Flop (didn't bet)
Seat 3: oscarleon showed [7s 7h] and won ($16.24) with a flush, Ace high
Seat 4: Filojoes folded before Flop (didn't bet)
Seat 5: chauyeuba folded before Flop (didn't bet)
Seat 6: Dachish (button) folded before Flop (didn't bet)
Seat 8: R3NZONIT3 (small blind) showed [Ah 7d] and lost with a pair of Aces
Seat 9: CoolFireX (big blind) folded before Flop





PokerStars Hand #148607887993:  Hold'em No Limit ($0.25/$0.50 USD) - 2016/02/11 12:40:51 CET [2016/02/11 6:40:51 ET]
Table 'Algedi' 9-max Seat #2 is the button
Seat 1: vlad11122007 ($55.82 in chips) 
Seat 2: Reffypaul ($73.29 in chips) 
Seat 3: Saggitaurus ($99.40 in chips) 
Seat 4: Effort92 ($61.46 in chips) 
Seat 6: TonnaMunz ($123.51 in chips) 
Seat 7: hoedtrob ($65.80 in chips) 
Seat 8: matiko09 ($50.20 in chips) 
Seat 9: Kud3 ($125 in chips) 
Saggitaurus: posts small blind $0.25
Effort92: posts big blind $0.50
vlad11122007: posts the ante $0.10
Reffypaul: posts the ante $0.10
Saggitaurus: posts the ante $0.10
Effort92: posts the ante $0.10
TonnaMunz: posts the ante $0.10
hoedtrob: posts the ante $0.10
matiko09: posts the ante $0.10
Kud3: posts the ante $0.10
*** HOLE CARDS ***
Dealt to matiko09 [Qd 4h]
TonnaMunz: raises $1 to $1.50
hoedtrob: folds 
matiko09: folds 
Kud3: folds 
vlad11122007: raises $3 to $4.50
Reffypaul: folds 
Saggitaurus: folds 
Effort92: folds 
TonnaMunz: calls $3
*** FLOP *** [7s 9c 8s]
TonnaMunz: checks 
vlad11122007: checks 
*** TURN *** [7s 9c 8s] [Th]
TonnaMunz: bets $10
vlad11122007: folds 
Uncalled bet ($10) returned to TonnaMunz
TonnaMunz collected $10.08 from pot
*** SUMMARY ***
Total pot $10.55 | Rake $0.47 
Board [7s 9c 8s Th]
Seat 1: vlad11122007 folded on the Turn
Seat 2: Reffypaul (button) folded before Flop (didn't bet)
Seat 3: Saggitaurus (small blind) folded before Flop
Seat 4: Effort92 (big blind) folded before Flop
Seat 6: TonnaMunz collected ($10.08)
Seat 7: hoedtrob folded before Flop (didn't bet)
Seat 8: matiko09 folded before Flop (didn't bet)
Seat 9: Kud3 folded before Flop (didn't bet)





PokerStars Hand #148607893533:  Hold'em No Limit ($0.25/$0.50 USD) - 2016/02/11 12:41:01 CET [2016/02/11 6:41:01 ET]
Table 'Stereoskopia' 9-max Seat #7 is the button
Seat 1: 50CandyJoe ($54.68 in chips) 
Seat 2: Optimistic21 ($58.75 in chips) 
Seat 3: Donko jr ($21.06 in chips) 
Seat 4: King brid ($76.29 in chips) 
Seat 5: ReinisRNS ($28.88 in chips) 
Seat 6: matiko09 ($50 in chips) 
Seat 7: tallonn88 ($104.17 in chips) 
Seat 9: apfush ($50 in chips) 
vlad11122007 will be allowed to play after the button
apfush: posts small blind $0.25
50CandyJoe: posts big blind $0.50
*** HOLE CARDS ***
Dealt to matiko09 [8c 4h]
Optimistic21: folds 
Donko jr: folds 
King brid: calls $0.50
ReinisRNS: folds 
matiko09: folds 
tallonn88: folds 
apfush: folds 
50CandyJoe: raises $1.50 to $2
King brid: calls $1.50
*** FLOP *** [Td 3s 7s]
50CandyJoe: checks 
King brid: bets $2
50CandyJoe: calls $2
*** TURN *** [Td 3s 7s] [3c]
50CandyJoe: checks 
King brid: checks 
*** RIVER *** [Td 3s 7s 3c] [5s]
50CandyJoe: bets $5.50
King brid: calls $5.50
*** SHOW DOWN ***
50CandyJoe: shows [Ah Jc] (a pair of Threes)
King brid: shows [Qh 7h] (two pair, Sevens and Threes)
King brid collected $18.38 from pot
*** SUMMARY ***
Total pot $19.25 | Rake $0.87 
Board [Td 3s 7s 3c 5s]
Seat 1: 50CandyJoe (big blind) showed [Ah Jc] and lost with a pair of Threes
Seat 2: Optimistic21 folded before Flop (didn't bet)
Seat 3: Donko jr folded before Flop (didn't bet)
Seat 4: King brid showed [Qh 7h] and won ($18.38) with two pair, Sevens and Threes
Seat 5: ReinisRNS folded before Flop (didn't bet)
Seat 6: matiko09 folded before Flop (didn't bet)
Seat 7: tallonn88 (button) folded before Flop (didn't bet)
Seat 9: apfush (small blind) folded before Flop





PokerStars Hand #148607901666:  Hold'em No Limit ($0.25/$0.50 USD) - 2016/02/11 12:41:16 CET [2016/02/11 6:41:16 ET]
Table 'Hunan' 9-max Seat #6 is the button
Seat 1: matiko09 ($50.50 in chips) 
Seat 3: TheMinion ($50 in chips) 
Seat 4: RICKA16 ($50 in chips) 
Seat 5: Honk115 ($66.26 in chips) 
Seat 6: i L00K great ($61.16 in chips) 
Seat 7: SForces33 ($20.05 in chips) 
Seat 8: Reven9er ($58.45 in chips) 
Seat 9: Optimistic21 ($56.03 in chips) 
SForces33: posts small blind $0.25
Reven9er: posts big blind $0.50
Serhent: sits out 
*** HOLE CARDS ***
Dealt to matiko09 [7c 9d]
Optimistic21: folds 
matiko09: folds 
TheMinion: folds 
Optimistic21 leaves the table
RICKA16: folds 
Honk115: folds 
i L00K great: folds 
SForces33: raises $1 to $1.50
Reven9er: calls $1
*** FLOP *** [9s 5c 3s]
SForces33: bets $1.43
Reven9er: calls $1.43
*** TURN *** [9s 5c 3s] [As]
banit7 joins the table at seat #9 
SForces33: bets $1.50
banit7 leaves the table
Reven9er: calls $1.50
*** RIVER *** [9s 5c 3s As] [8c]
MiltoSappa joins the table at seat #9 
SForces33: bets $2
Reven9er: calls $2
*** SHOW DOWN ***
SForces33: shows [Qc Kc] (high card Ace)
Reven9er: shows [8h 6h] (a pair of Eights)
Reven9er collected $12.28 from pot
*** SUMMARY ***
Total pot $12.86 | Rake $0.58 
Board [9s 5c 3s As 8c]
Seat 1: matiko09 folded before Flop (didn't bet)
Seat 3: TheMinion folded before Flop (didn't bet)
Seat 4: RICKA16 folded before Flop (didn't bet)
Seat 5: Honk115 folded before Flop (didn't bet)
Seat 6: i L00K great (button) folded before Flop (didn't bet)
Seat 7: SForces33 (small blind) showed [Qc Kc] and lost with high card Ace
Seat 8: Reven9er (big blind) showed [8h 6h] and won ($12.28) with a pair of Eights
Seat 9: Optimistic21 folded before Flop (didn't bet)





PokerStars Hand #148607904215:  Hold'em No Limit ($0.50/$1.00 USD) - 2016/02/11 12:41:20 CET [2016/02/11 6:41:20 ET]
Table 'Sycorax II' 9-max Seat #4 is the button
Seat 1: Luck In Me ($155.22 in chips) 
Seat 2: Lujan87 ($100 in chips) 
Seat 3: chauyeuba ($76.03 in chips) 
Seat 4: Sweden_Pound ($100 in chips) 
Seat 5: Effort92 ($166.94 in chips) 
Seat 6: FluentFlows ($37.50 in chips) 
Seat 7: hurtNCYDE ($100 in chips) 
Seat 8: matiko09 ($247.31 in chips) 
Seat 9: mrfoldcall ($120.51 in chips) 
Effort92: posts small blind $0.50
FluentFlows: posts big blind $1
*** HOLE CARDS ***
Dealt to matiko09 [8h Jc]
hurtNCYDE: folds 
matiko09: folds 
mrfoldcall: raises $2 to $3
Luck In Me: folds 
Lujan87: folds 
chauyeuba: folds 
Sweden_Pound: folds 
Effort92: folds 
FluentFlows: raises $5 to $8
mrfoldcall: calls $5
*** FLOP *** [6d 6c Th]
FluentFlows: bets $29.50 and is all-in
mrfoldcall: folds 
Uncalled bet ($29.50) returned to FluentFlows
FluentFlows collected $15.76 from pot
*** SUMMARY ***
Total pot $16.50 | Rake $0.74 
Board [6d 6c Th]
Seat 1: Luck In Me folded before Flop (didn't bet)
Seat 2: Lujan87 folded before Flop (didn't bet)
Seat 3: chauyeuba folded before Flop (didn't bet)
Seat 4: Sweden_Pound (button) folded before Flop (didn't bet)
Seat 5: Effort92 (small blind) folded before Flop
Seat 6: FluentFlows (big blind) collected ($15.76)
Seat 7: hurtNCYDE folded before Flop (didn't bet)
Seat 8: matiko09 folded before Flop (didn't bet)
Seat 9: mrfoldcall folded on the Flop





PokerStars Hand #148607905997:  Hold'em No Limit ($0.25/$0.50 USD) - 2016/02/11 12:41:23 CET [2016/02/11 6:41:23 ET]
Table 'Ambrosia II' 9-max Seat #8 is the button
Seat 1: matiko09 ($50 in chips) 
Seat 2: TheMinion ($116.94 in chips) 
Seat 4: huudk2016 ($25.15 in chips) 
Seat 6: Reven9er ($69.70 in chips) 
Seat 7: mexx1234 ($61.48 in chips) 
Seat 8: tallonn88 ($52.45 in chips) 
arctur17 will be allowed to play after the button
matiko09: posts small blind $0.25
TheMinion: posts big blind $0.50
make6a: sits out 
RICKA16: sits out 
*** HOLE CARDS ***
Dealt to matiko09 [6h 7s]
huudk2016: folds 
Reven9er: folds 
mexx1234: folds 
tallonn88: folds 
matiko09: folds 
Uncalled bet ($0.25) returned to TheMinion
TheMinion collected $0.50 from pot
TheMinion: doesn't show hand 
*** SUMMARY ***
Total pot $0.50 | Rake $0 
Seat 1: matiko09 (small blind) folded before Flop
Seat 2: TheMinion (big blind) collected ($0.50)
Seat 4: huudk2016 folded before Flop (didn't bet)
Seat 6: Reven9er folded before Flop (didn't bet)
Seat 7: mexx1234 folded before Flop (didn't bet)
Seat 8: tallonn88 (button) folded before Flop (didn't bet)





PokerStars Hand #148607917587:  Hold'em No Limit ($0.25/$0.50 USD) - 2016/02/11 12:41:44 CET [2016/02/11 6:41:44 ET]
Table 'Amor II' 9-max Seat #7 is the button
Seat 1: Kud3 ($52.62 in chips) 
Seat 2: GusenokRUS ($65.87 in chips) 
Seat 3: TheMinion ($57.22 in chips) 
Seat 4: Larzdog29 ($66.14 in chips) 
Seat 5: Optimistic21 ($51.15 in chips) 
Seat 6: matiko09 ($50 in chips) 
Seat 7: Serhent ($51 in chips) 
Seat 8: Reven9er ($58.86 in chips) 
Seat 9: tallonn88 ($108.86 in chips) 
Reven9er: posts small blind $0.25
tallonn88: posts big blind $0.50
*** HOLE CARDS ***
Dealt to matiko09 [Ad Kh]
Kud3: folds 
GusenokRUS: folds 
TheMinion: folds 
Larzdog29: folds 
Optimistic21: folds 
matiko09: raises $1 to $1.50
Serhent: folds 
GusenokRUS leaves the table
Reven9er: folds 
tallonn88: folds 
Uncalled bet ($1) returned to matiko09
matiko09 collected $1.25 from pot
matiko09: doesn't show hand 
*** SUMMARY ***
Total pot $1.25 | Rake $0 
Seat 1: Kud3 folded before Flop (didn't bet)
Seat 2: GusenokRUS folded before Flop (didn't bet)
Seat 3: TheMinion folded before Flop (didn't bet)
Seat 4: Larzdog29 folded before Flop (didn't bet)
Seat 5: Optimistic21 folded before Flop (didn't bet)
Seat 6: matiko09 collected ($1.25)
Seat 7: Serhent (button) folded before Flop (didn't bet)
Seat 8: Reven9er (small blind) folded before Flop
Seat 9: tallonn88 (big blind) folded before Flop





PokerStars Hand #148607918035:  Hold'em No Limit ($0.25/$0.50 USD) - 2016/02/11 12:41:45 CET [2016/02/11 6:41:45 ET]
Table 'Algedi' 9-max Seat #3 is the button
Seat 1: vlad11122007 ($51.22 in chips) 
Seat 2: Reffypaul ($73.19 in chips) 
Seat 3: Saggitaurus ($99.05 in chips) 
Seat 4: Effort92 ($60.86 in chips) 
Seat 6: TonnaMunz ($128.99 in chips) 
Seat 7: hoedtrob ($65.70 in chips) 
Seat 8: matiko09 ($50.10 in chips) 
Seat 9: Kud3 ($125 in chips) 
Effort92: posts small blind $0.25
TonnaMunz: posts big blind $0.50
vlad11122007: posts the ante $0.10
Reffypaul: posts the ante $0.10
Saggitaurus: posts the ante $0.10
Effort92: posts the ante $0.10
TonnaMunz: posts the ante $0.10
hoedtrob: posts the ante $0.10
matiko09: posts the ante $0.10
Kud3: posts the ante $0.10
*** HOLE CARDS ***
Dealt to matiko09 [5c 6c]
hoedtrob: raises $0.50 to $1
matiko09: folds 
Kud3: folds 
vlad11122007: folds 
Reffypaul: raises $0.50 to $1.50
Saggitaurus: folds 
Effort92: folds 
andyjensen14 leaves the table
TonnaMunz: folds 
Optimistic21 joins the table at seat #5 
hoedtrob: calls $0.50
*** FLOP *** [7d 8c Qd]
hoedtrob: checks 
Reffypaul: bets $1.50
hoedtrob: raises $2 to $3.50
Reffypaul: calls $2
*** TURN *** [7d 8c Qd] [Ad]
hoedtrob: checks 
Reffypaul is disconnected 
Reffypaul is connected 
Reffypaul: checks 
*** RIVER *** [7d 8c Qd Ad] [2d]
hoedtrob: checks 
Reffypaul: bets $1
hoedtrob: calls $1
*** SHOW DOWN ***
Reffypaul: shows [4c 7c] (a pair of Sevens)
hoedtrob: shows [Qs Js] (a pair of Queens)
hoedtrob collected $12.94 from pot
*** SUMMARY ***
Total pot $13.55 | Rake $0.61 
Board [7d 8c Qd Ad 2d]
Seat 1: vlad11122007 folded before Flop (didn't bet)
Seat 2: Reffypaul showed [4c 7c] and lost with a pair of Sevens
Seat 3: Saggitaurus (button) folded before Flop (didn't bet)
Seat 4: Effort92 (small blind) folded before Flop
Seat 6: TonnaMunz (big blind) folded before Flop
Seat 7: hoedtrob showed [Qs Js] and won ($12.94) with a pair of Queens
Seat 8: matiko09 folded before Flop (didn't bet)
Seat 9: Kud3 folded before Flop (didn't bet)





PokerStars Hand #148607918086:  Hold'em No Limit ($0.25/$0.50 USD) - 2016/02/11 12:41:45 CET [2016/02/11 6:41:45 ET]
Table 'Ambrosia II' 9-max Seat #1 is the button
Seat 1: matiko09 ($50 in chips) 
Seat 2: TheMinion ($117.19 in chips) 
Seat 3: make6a ($49 in chips) 
Seat 4: huudk2016 ($25.15 in chips) 
Seat 6: Reven9er ($69.70 in chips) 
Seat 7: mexx1234 ($61.48 in chips) 
Seat 8: tallonn88 ($52.45 in chips) 
TheMinion: posts small blind $0.25
make6a: posts big blind $0.50
RICKA16: sits out 
arctur17: sits out 
*** HOLE CARDS ***
Dealt to matiko09 [4h 5s]
huudk2016: calls $0.50
Reven9er: folds 
mexx1234: folds 
tallonn88: folds 
matiko09: folds 
TheMinion: folds 
make6a: raises $1.50 to $2
huudk2016: calls $1.50
*** FLOP *** [6c Qh 8s]
make6a: checks 
huudk2016: bets $2.50
make6a: folds 
Uncalled bet ($2.50) returned to huudk2016
huudk2016 collected $4.06 from pot
huudk2016: doesn't show hand 
*** SUMMARY ***
Total pot $4.25 | Rake $0.19 
Board [6c Qh 8s]
Seat 1: matiko09 (button) folded before Flop (didn't bet)
Seat 2: TheMinion (small blind) folded before Flop
Seat 3: make6a (big blind) folded on the Flop
Seat 4: huudk2016 collected ($4.06)
Seat 6: Reven9er folded before Flop (didn't bet)
Seat 7: mexx1234 folded before Flop (didn't bet)
Seat 8: tallonn88 folded before Flop (didn't bet)





PokerStars Hand #148607919733:  Hold'em No Limit ($0.25/$0.50 USD) - 2016/02/11 12:41:48 CET [2016/02/11 6:41:48 ET]
Table 'Stereoskopia' 9-max Seat #9 is the button
Seat 1: 50CandyJoe ($50 in chips) 
Seat 2: Optimistic21 ($58.75 in chips) 
Seat 3: Donko jr ($21.06 in chips) 
Seat 4: King brid ($85.17 in chips) 
Seat 5: ReinisRNS ($28.88 in chips) 
Seat 6: matiko09 ($50 in chips) 
Seat 7: tallonn88 ($104.17 in chips) 
Seat 9: apfush ($50 in chips) 
50CandyJoe: posts small blind $0.25
Optimistic21: posts big blind $0.50
vlad11122007: sits out 
*** HOLE CARDS ***
Dealt to matiko09 [9h Ts]
Donko jr: folds 
King brid: raises $1 to $1.50
ReinisRNS: folds 
matiko09: folds 
tallonn88: calls $1.50
apfush: calls $1.50
50CandyJoe: folds 
Optimistic21: calls $1
*** FLOP *** [4s Qs Ks]
Optimistic21: checks 
King brid: checks 
tallonn88: bets $3.75
apfush: calls $3.75
Optimistic21: folds 
King brid: folds 
*** TURN *** [4s Qs Ks] [5d]
tallonn88: bets $8.50
apfush: calls $8.50
*** RIVER *** [4s Qs Ks 5d] [8c]
tallonn88: bets $17
apfush: raises $19.25 to $36.25 and is all-in
tallonn88: calls $19.25
*** SHOW DOWN ***
apfush: shows [3s As] (a flush, Ace high)
tallonn88: mucks hand 
apfush collected $100.75 from pot
*** SUMMARY ***
Total pot $103.25 | Rake $2.50 
Board [4s Qs Ks 5d 8c]
Seat 1: 50CandyJoe (small blind) folded before Flop
Seat 2: Optimistic21 (big blind) folded on the Flop
Seat 3: Donko jr folded before Flop (didn't bet)
Seat 4: King brid folded on the Flop
Seat 5: ReinisRNS folded before Flop (didn't bet)
Seat 6: matiko09 folded before Flop (didn't bet)
Seat 7: tallonn88 mucked [7s 8s]
Seat 9: apfush (button) showed [3s As] and won ($100.75) with a flush, Ace high





PokerStars Hand #148607923914:  Hold'em No Limit ($0.50/$1.00 USD) - 2016/02/11 12:41:55 CET [2016/02/11 6:41:55 ET]
Table 'Regor' 9-max Seat #8 is the button
Seat 1: matiko09 ($127.77 in chips) 
Seat 2: Luck In Me ($100.50 in chips) 
Seat 3: oscarleon ($160.64 in chips) 
Seat 4: Filojoes ($100 in chips) 
Seat 5: chauyeuba ($55.76 in chips) 
Seat 6: Dachish ($92.45 in chips) 
Seat 8: R3NZONIT3 ($82.82 in chips) 
Seat 9: CoolFireX ($111.44 in chips) 
CoolFireX: posts small blind $0.50
matiko09: posts big blind $1
Sweden_Pound: sits out 
*** HOLE CARDS ***
Dealt to matiko09 [Tc Td]
Luck In Me: folds 
oscarleon: folds 
Filojoes: folds 
chauyeuba: raises $2 to $3
Dachish: folds 
R3NZONIT3: folds 
CoolFireX: folds 
matiko09: calls $2
*** FLOP *** [6h Qh Ah]
matiko09: checks 
chauyeuba: bets $5
matiko09: folds 
Uncalled bet ($5) returned to chauyeuba
chauyeuba collected $6.21 from pot
chauyeuba: doesn't show hand 
*** SUMMARY ***
Total pot $6.50 | Rake $0.29 
Board [6h Qh Ah]
Seat 1: matiko09 (big blind) folded on the Flop
Seat 2: Luck In Me folded before Flop (didn't bet)
Seat 3: oscarleon folded before Flop (didn't bet)
Seat 4: Filojoes folded before Flop (didn't bet)
Seat 5: chauyeuba collected ($6.21)
Seat 6: Dachish folded before Flop (didn't bet)
Seat 8: R3NZONIT3 (button) folded before Flop (didn't bet)
Seat 9: CoolFireX (small blind) folded before Flop





PokerStars Hand #148607932247:  Hold'em No Limit ($0.25/$0.50 USD) - 2016/02/11 12:42:10 CET [2016/02/11 6:42:10 ET]
Table 'Sylvania II' 9-max Seat #7 is the button
Seat 1: mexx1234 ($196.28 in chips) 
Seat 2: Effort92 ($54.25 in chips) 
Seat 3: ruyingren ($185.16 in chips) 
Seat 4: matiko09 ($150.15 in chips) 
Seat 5: vlad11122007 ($67.58 in chips) 
Seat 6: TonnaMunz ($128.46 in chips) 
Seat 7: i L00K great ($50.23 in chips) 
Seat 8: Optimistic21 ($50.45 in chips) 
Seat 9: Kud3 ($128.89 in chips) 
Optimistic21: posts small blind $0.25
Kud3: posts big blind $0.50
mexx1234: posts the ante $0.10
Effort92: posts the ante $0.10
ruyingren: posts the ante $0.10
matiko09: posts the ante $0.10
vlad11122007: posts the ante $0.10
TonnaMunz: posts the ante $0.10
i L00K great: posts the ante $0.10
Optimistic21: posts the ante $0.10
Kud3: posts the ante $0.10
*** HOLE CARDS ***
Dealt to matiko09 [9c 5h]
mexx1234: folds 
Effort92: raises $1 to $1.50
ruyingren: folds 
matiko09: folds 
vlad11122007: folds 
TonnaMunz: folds 
i L00K great: folds 
Optimistic21: folds 
Kud3: calls $1
*** FLOP *** [7d Kd Td]
Kud3: checks 
Effort92: checks 
*** TURN *** [7d Kd Td] [7c]
Kud3: bets $2.85
Effort92: folds 
Uncalled bet ($2.85) returned to Kud3
Kud3 collected $3.96 from pot
Kud3: doesn't show hand 
*** SUMMARY ***
Total pot $4.15 | Rake $0.19 
Board [7d Kd Td 7c]
Seat 1: mexx1234 folded before Flop (didn't bet)
Seat 2: Effort92 folded on the Turn
Seat 3: ruyingren folded before Flop (didn't bet)
Seat 4: matiko09 folded before Flop (didn't bet)
Seat 5: vlad11122007 folded before Flop (didn't bet)
Seat 6: TonnaMunz folded before Flop (didn't bet)
Seat 7: i L00K great (button) folded before Flop (didn't bet)
Seat 8: Optimistic21 (small blind) folded before Flop
Seat 9: Kud3 (big blind) collected ($3.96)





PokerStars Hand #148607943910:  Hold'em No Limit ($0.25/$0.50 USD) - 2016/02/11 12:42:31 CET [2016/02/11 6:42:31 ET]
Table 'Hunan' 9-max Seat #7 is the button
Seat 1: matiko09 ($50.50 in chips) 
Seat 3: TheMinion ($50 in chips) 
Seat 4: RICKA16 ($50 in chips) 
Seat 5: Honk115 ($66.26 in chips) 
Seat 6: i L00K great ($61.16 in chips) 
Seat 7: SForces33 ($13.62 in chips) 
Seat 8: Reven9er ($64.30 in chips) 
Seat 9: MiltoSappa ($50 in chips) 
Reven9er: posts small blind $0.25
MiltoSappa: posts big blind $0.50
Serhent: sits out 
*** HOLE CARDS ***
Dealt to matiko09 [4c 9s]
matiko09: folds 
TheMinion: folds 
RICKA16: folds 
Honk115: folds 
i L00K great: folds 
SForces33: raises $1 to $1.50
Reven9er: folds 
MiltoSappa: folds 
Uncalled bet ($1) returned to SForces33
SForces33 collected $1.25 from pot
SForces33: doesn't show hand 
*** SUMMARY ***
Total pot $1.25 | Rake $0 
Seat 1: matiko09 folded before Flop (didn't bet)
Seat 3: TheMinion folded before Flop (didn't bet)
Seat 4: RICKA16 folded before Flop (didn't bet)
Seat 5: Honk115 folded before Flop (didn't bet)
Seat 6: i L00K great folded before Flop (didn't bet)
Seat 7: SForces33 (button) collected ($1.25)
Seat 8: Reven9er (small blind) folded before Flop
Seat 9: MiltoSappa (big blind) folded before Flop





PokerStars Hand #148607947544:  Hold'em No Limit ($0.50/$1.00 USD) - 2016/02/11 12:42:37 CET [2016/02/11 6:42:37 ET]
Table 'Regor' 9-max Seat #9 is the button
Seat 1: matiko09 ($124.77 in chips) 
Seat 2: Luck In Me ($100.50 in chips) 
Seat 3: oscarleon ($160.64 in chips) 
Seat 4: Filojoes ($100 in chips) 
Seat 5: chauyeuba ($58.97 in chips) 
Seat 6: Dachish ($92.45 in chips) 
Seat 8: R3NZONIT3 ($82.82 in chips) 
Seat 9: CoolFireX ($110.94 in chips) 
matiko09: posts small blind $0.50
Luck In Me: posts big blind $1
Sweden_Pound: sits out 
*** HOLE CARDS ***
Dealt to matiko09 [7s Qh]
oscarleon: folds 
Filojoes: folds 
chauyeuba: folds 
Dachish: folds 
R3NZONIT3: folds 
CoolFireX has timed out
CoolFireX: folds 
matiko09: folds 
Uncalled bet ($0.50) returned to Luck In Me
Luck In Me collected $1 from pot
Luck In Me: doesn't show hand 
*** SUMMARY ***
Total pot $1 | Rake $0 
Seat 1: matiko09 (small blind) folded before Flop
Seat 2: Luck In Me (big blind) collected ($1)
Seat 3: oscarleon folded before Flop (didn't bet)
Seat 4: Filojoes folded before Flop (didn't bet)
Seat 5: chauyeuba folded before Flop (didn't bet)
Seat 6: Dachish folded before Flop (didn't bet)
Seat 8: R3NZONIT3 folded before Flop (didn't bet)
Seat 9: CoolFireX (button) folded before Flop (didn't bet)





PokerStars Hand #148607948820:  Hold'em No Limit ($0.25/$0.50 USD) - 2016/02/11 12:42:39 CET [2016/02/11 6:42:39 ET]
Table 'Amor II' 9-max Seat #8 is the button
Seat 1: Kud3 ($52.62 in chips) 
Seat 3: TheMinion ($57.22 in chips) 
Seat 4: Larzdog29 ($66.14 in chips) 
Seat 5: Optimistic21 ($51.15 in chips) 
Seat 6: matiko09 ($50.75 in chips) 
Seat 7: Serhent ($51 in chips) 
Seat 8: Reven9er ($58.61 in chips) 
Seat 9: tallonn88 ($108.36 in chips) 
tallonn88: posts small blind $0.25
Kud3: posts big blind $0.50
*** HOLE CARDS ***
Dealt to matiko09 [3d 2h]
TheMinion: folds 
Larzdog29: folds 
Optimistic21: folds 
matiko09: folds 
Fesch88 joins the table at seat #2 
Serhent: folds 
Reven9er: raises $0.50 to $1
tallonn88: folds 
Kud3: calls $0.50
*** FLOP *** [Qs 3s 4h]
Kud3: checks 
Reven9er: bets $0.75
Kud3: calls $0.75
*** TURN *** [Qs 3s 4h] [8s]
Kud3: bets $2.57
Reven9er: raises $4.93 to $7.50
Kud3: calls $4.93
*** RIVER *** [Qs 3s 4h 8s] [Ts]
Kud3: checks 
Reven9er: bets $11.50
Kud3: folds 
Uncalled bet ($11.50) returned to Reven9er
Reven9er collected $17.91 from pot
Reven9er: doesn't show hand 
*** SUMMARY ***
Total pot $18.75 | Rake $0.84 
Board [Qs 3s 4h 8s Ts]
Seat 1: Kud3 (big blind) folded on the River
Seat 3: TheMinion folded before Flop (didn't bet)
Seat 4: Larzdog29 folded before Flop (didn't bet)
Seat 5: Optimistic21 folded before Flop (didn't bet)
Seat 6: matiko09 folded before Flop (didn't bet)
Seat 7: Serhent folded before Flop (didn't bet)
Seat 8: Reven9er (button) collected ($17.91)
Seat 9: tallonn88 (small blind) folded before Flop





PokerStars Hand #148607949157:  Hold'em No Limit ($0.50/$1.00 USD) - 2016/02/11 12:42:40 CET [2016/02/11 6:42:40 ET]
Table 'Sycorax II' 9-max Seat #5 is the button
Seat 1: Luck In Me ($155.22 in chips) 
Seat 2: Lujan87 ($100 in chips) 
Seat 3: chauyeuba ($76.03 in chips) 
Seat 4: Sweden_Pound ($100 in chips) 
Seat 5: Effort92 ($166.44 in chips) 
Seat 6: FluentFlows ($45.26 in chips) 
Seat 8: matiko09 ($247.31 in chips) 
Seat 9: mrfoldcall ($112.51 in chips) 
FluentFlows: posts small blind $0.50
hurtNCYDE: is sitting out 
matiko09: posts big blind $1
*** HOLE CARDS ***
Dealt to matiko09 [Qc 2c]
hurtNCYDE leaves the table
mrfoldcall: folds 
Luck In Me: folds 
PacPacBum joins the table at seat #7 
Lujan87: folds 
chauyeuba: folds 
Sweden_Pound has timed out
Sweden_Pound: folds 
Effort92: raises $1 to $2
FluentFlows: folds 
matiko09: calls $1
*** FLOP *** [Qs 6s 7d]
matiko09: checks 
Effort92: bets $2.70
matiko09: calls $2.70
*** TURN *** [Qs 6s 7d] [7c]
matiko09: checks 
Effort92: bets $6
matiko09: calls $6
*** RIVER *** [Qs 6s 7d 7c] [Kd]
matiko09: checks 
Effort92: checks 
*** SHOW DOWN ***
matiko09: shows [Qc 2c] (two pair, Queens and Sevens)
Effort92: shows [Qh Ts] (two pair, Queens and Sevens)
matiko09 collected $10.46 from pot
Effort92 collected $10.45 from pot
*** SUMMARY ***
Total pot $21.90 | Rake $0.99 
Board [Qs 6s 7d 7c Kd]
Seat 1: Luck In Me folded before Flop (didn't bet)
Seat 2: Lujan87 folded before Flop (didn't bet)
Seat 3: chauyeuba folded before Flop (didn't bet)
Seat 4: Sweden_Pound folded before Flop (didn't bet)
Seat 5: Effort92 (button) showed [Qh Ts] and won ($10.45) with two pair, Queens and Sevens
Seat 6: FluentFlows (small blind) folded before Flop
Seat 8: matiko09 (big blind) showed [Qc 2c] and won ($10.46) with two pair, Queens and Sevens
Seat 9: mrfoldcall folded before Flop (didn't bet)





PokerStars Hand #148607950679:  Hold'em No Limit ($0.25/$0.50 USD) - 2016/02/11 12:42:43 CET [2016/02/11 6:42:43 ET]
Table 'Ambrosia II' 9-max Seat #2 is the button
Seat 1: matiko09 ($50 in chips) 
Seat 2: TheMinion ($116.94 in chips) 
Seat 3: make6a ($47 in chips) 
Seat 4: huudk2016 ($27.21 in chips) 
Seat 6: Reven9er ($69.70 in chips) 
Seat 7: mexx1234 ($61.48 in chips) 
Seat 8: tallonn88 ($52.45 in chips) 
make6a: posts small blind $0.25
huudk2016: posts big blind $0.50
RICKA16: sits out 
arctur17: sits out 
*** HOLE CARDS ***
Dealt to matiko09 [3d Jd]
Reven9er: folds 
mexx1234: raises $0.75 to $1.25
tallonn88: folds 
matiko09: folds 
TheMinion: folds 
make6a: folds 
huudk2016: raises $1.75 to $3
mexx1234: raises $4.25 to $7.25
huudk2016: calls $4.25
*** FLOP *** [Th 6s Kd]
huudk2016: checks 
mexx1234: checks 
*** TURN *** [Th 6s Kd] [6h]
huudk2016: checks 
mexx1234: bets $4
huudk2016: calls $4
*** RIVER *** [Th 6s Kd 6h] [8s]
huudk2016: bets $15.96 and is all-in
mexx1234: calls $15.96
*** SHOW DOWN ***
huudk2016: shows [8h 8d] (a full house, Eights full of Sixes)
mexx1234: shows [Ts Tc] (a full house, Tens full of Sixes)
mexx1234 collected $52.21 from pot
*** SUMMARY ***
Total pot $54.67 | Rake $2.46 
Board [Th 6s Kd 6h 8s]
Seat 1: matiko09 folded before Flop (didn't bet)
Seat 2: TheMinion (button) folded before Flop (didn't bet)
Seat 3: make6a (small blind) folded before Flop
Seat 4: huudk2016 (big blind) showed [8h 8d] and lost with a full house, Eights full of Sixes
Seat 6: Reven9er folded before Flop (didn't bet)
Seat 7: mexx1234 showed [Ts Tc] and won ($52.21) with a full house, Tens full of Sixes
Seat 8: tallonn88 folded before Flop (didn't bet)





PokerStars Hand #148607951214:  Hold'em No Limit (€0.25/€0.50 EUR) - 2016/02/11 12:42:44 CET [2016/02/11 6:42:44 ET]
Table 'Otero II' 9-max Seat #3 is the button
Seat 1: Nacho2556 (€43.98 in chips) 
Seat 2: make6a (€45.53 in chips) 
Seat 3: chaogoose82 (€69.03 in chips) 
Seat 4: kram0909 (€19.80 in chips) 
Seat 5: vlad11122007 (€50 in chips) 
Seat 6: TonnaMunz (€55.54 in chips) 
Seat 7: PacPacBum (€58.77 in chips) 
Seat 8: matiko09 (€75.96 in chips) 
Seat 9: Optimistic21 (€58.54 in chips) 
kram0909: posts small blind €0.25
vlad11122007: posts big blind €0.50
*** HOLE CARDS ***
Dealt to matiko09 [6s Jd]
TonnaMunz: folds 
PacPacBum: folds 
matiko09: folds 
Optimistic21: folds 
Nacho2556: folds 
make6a: raises €0.55 to €1.05
chaogoose82: folds 
chaogoose82 leaves the table
kram0909: folds 
vlad11122007: calls €0.55
*** FLOP *** [5d Qd 3c]
vlad11122007: checks 
make6a: checks 
*** TURN *** [5d Qd 3c] [6c]
vlad11122007: bets €1.52
make6a: folds 
Uncalled bet (€1.52) returned to vlad11122007
vlad11122007 collected €2.24 from pot
vlad11122007: doesn't show hand 
*** SUMMARY ***
Total pot €2.35 | Rake €0.11 
Board [5d Qd 3c 6c]
Seat 1: Nacho2556 folded before Flop (didn't bet)
Seat 2: make6a folded on the Turn
Seat 3: chaogoose82 (button) folded before Flop (didn't bet)
Seat 4: kram0909 (small blind) folded before Flop
Seat 5: vlad11122007 (big blind) collected (€2.24)
Seat 6: TonnaMunz folded before Flop (didn't bet)
Seat 7: PacPacBum folded before Flop (didn't bet)
Seat 8: matiko09 folded before Flop (didn't bet)
Seat 9: Optimistic21 folded before Flop (didn't bet)





PokerStars Hand #148607964781:  Hold'em No Limit ($0.25/$0.50 USD) - 2016/02/11 12:43:08 CET [2016/02/11 6:43:08 ET]
Table 'Sylvania II' 9-max Seat #8 is the button
Seat 1: mexx1234 ($196.18 in chips) 
Seat 2: Effort92 ($52.65 in chips) 
Seat 3: ruyingren ($185.06 in chips) 
Seat 4: matiko09 ($150.05 in chips) 
Seat 5: vlad11122007 ($67.48 in chips) 
Seat 6: TonnaMunz ($128.36 in chips) 
Seat 7: i L00K great ($50.13 in chips) 
Seat 8: Optimistic21 ($50.10 in chips) 
Seat 9: Kud3 ($131.25 in chips) 
Kud3: posts small blind $0.25
mexx1234: posts big blind $0.50
mexx1234: posts the ante $0.10
Effort92: posts the ante $0.10
ruyingren: posts the ante $0.10
matiko09: posts the ante $0.10
vlad11122007: posts the ante $0.10
TonnaMunz: posts the ante $0.10
i L00K great: posts the ante $0.10
Optimistic21: posts the ante $0.10
Kud3: posts the ante $0.10
*** HOLE CARDS ***
Dealt to matiko09 [Qc Kd]
Effort92: folds 
ruyingren: folds 
matiko09: raises $1 to $1.50
vlad11122007: folds 
TonnaMunz: folds 
i L00K great: folds 
Optimistic21: folds 
Kud3: folds 
mexx1234: folds 
Uncalled bet ($1) returned to matiko09
matiko09 collected $2.15 from pot
matiko09: doesn't show hand 
*** SUMMARY ***
Total pot $2.15 | Rake $0 
Seat 1: mexx1234 (big blind) folded before Flop
Seat 2: Effort92 folded before Flop (didn't bet)
Seat 3: ruyingren folded before Flop (didn't bet)
Seat 4: matiko09 collected ($2.15)
Seat 5: vlad11122007 folded before Flop (didn't bet)
Seat 6: TonnaMunz folded before Flop (didn't bet)
Seat 7: i L00K great folded before Flop (didn't bet)
Seat 8: Optimistic21 (button) folded before Flop (didn't bet)
Seat 9: Kud3 (small blind) folded before Flop





PokerStars Hand #148607973711:  Hold'em No Limit ($0.50/$1.00 USD) - 2016/02/11 12:43:23 CET [2016/02/11 6:43:23 ET]
Table 'Regor' 9-max Seat #1 is the button
Seat 1: matiko09 ($124.27 in chips) 
Seat 2: Luck In Me ($101 in chips) 
Seat 3: oscarleon ($160.64 in chips) 
Seat 4: Filojoes ($100 in chips) 
Seat 5: chauyeuba ($58.97 in chips) 
Seat 6: Dachish ($92.45 in chips) 
Seat 8: R3NZONIT3 ($82.82 in chips) 
Seat 9: CoolFireX ($110.94 in chips) 
Luck In Me: posts small blind $0.50
oscarleon: posts big blind $1
Sweden_Pound: sits out 
*** HOLE CARDS ***
Dealt to matiko09 [4h 3h]
Filojoes: folds 
chauyeuba: folds 
Dachish has timed out
Dachish: folds 
R3NZONIT3: raises $1 to $2
CoolFireX: raises $6 to $8
matiko09: folds 
Luck In Me: folds 
oscarleon: folds 
R3NZONIT3: calls $6
*** FLOP *** [2s 2d 7h]
R3NZONIT3: checks 
CoolFireX: bets $9
R3NZONIT3: calls $9
*** TURN *** [2s 2d 7h] [Qc]
R3NZONIT3: checks 
CoolFireX: bets $18.50
R3NZONIT3: calls $18.50
*** RIVER *** [2s 2d 7h Qc] [Kd]
R3NZONIT3: checks 
CoolFireX: bets $69.70
R3NZONIT3: folds [9s 9d]
Uncalled bet ($69.70) returned to CoolFireX
CoolFireX collected $69.70 from pot
CoolFireX: doesn't show hand 
*** SUMMARY ***
Total pot $72.50 | Rake $2.80 
Board [2s 2d 7h Qc Kd]
Seat 1: matiko09 (button) folded before Flop (didn't bet)
Seat 2: Luck In Me (small blind) folded before Flop
Seat 3: oscarleon (big blind) folded before Flop
Seat 4: Filojoes folded before Flop (didn't bet)
Seat 5: chauyeuba folded before Flop (didn't bet)
Seat 6: Dachish folded before Flop (didn't bet)
Seat 8: R3NZONIT3 folded on the River
Seat 9: CoolFireX collected ($69.70)





PokerStars Hand #148607984316:  Hold'em No Limit (€0.25/€0.50 EUR) - 2016/02/11 12:43:42 CET [2016/02/11 6:43:42 ET]
Table 'Otero II' 9-max Seat #4 is the button
Seat 1: Nacho2556 (€43.98 in chips) 
Seat 2: make6a (€44.48 in chips) 
Seat 4: kram0909 (€19.55 in chips) 
Seat 5: vlad11122007 (€51.19 in chips) 
Seat 6: TonnaMunz (€55.54 in chips) 
Seat 7: PacPacBum (€58.77 in chips) 
Seat 8: matiko09 (€75.96 in chips) 
Seat 9: Optimistic21 (€58.54 in chips) 
vlad11122007: posts small blind €0.25
TonnaMunz: posts big blind €0.50
*** HOLE CARDS ***
Dealt to matiko09 [3s 4c]
PacPacBum: folds 
matiko09: folds 
Optimistic21: folds 
Nacho2556: calls €0.50
make6a: folds 
kram0909: calls €0.50
vlad11122007: folds 
TonnaMunz: checks 
*** FLOP *** [Kc As 6h]
TonnaMunz: checks 
Nacho2556: checks 
kram0909: bets €1
TonnaMunz: folds 
Nacho2556: folds 
Uncalled bet (€1) returned to kram0909
kram0909 collected €1.67 from pot
kram0909: doesn't show hand 
*** SUMMARY ***
Total pot €1.75 | Rake €0.08 
Board [Kc As 6h]
Seat 1: Nacho2556 folded on the Flop
Seat 2: make6a folded before Flop (didn't bet)
Seat 4: kram0909 (button) collected (€1.67)
Seat 5: vlad11122007 (small blind) folded before Flop
Seat 6: TonnaMunz (big blind) folded on the Flop
Seat 7: PacPacBum folded before Flop (didn't bet)
Seat 8: matiko09 folded before Flop (didn't bet)
Seat 9: Optimistic21 folded before Flop (didn't bet)





PokerStars Hand #148607991213:  Hold'em No Limit ($0.25/$0.50 USD) - 2016/02/11 12:43:54 CET [2016/02/11 6:43:54 ET]
Table 'Sylvania II' 9-max Seat #9 is the button
Seat 1: mexx1234 ($195.58 in chips) 
Seat 2: Effort92 ($52.55 in chips) 
Seat 3: ruyingren ($184.96 in chips) 
Seat 4: matiko09 ($151.60 in chips) 
Seat 5: vlad11122007 ($67.38 in chips) 
Seat 6: TonnaMunz ($128.26 in chips) 
Seat 7: i L00K great ($50.03 in chips) 
Seat 8: Optimistic21 ($50 in chips) 
Seat 9: Kud3 ($130.90 in chips) 
mexx1234: posts small blind $0.25
Effort92: posts big blind $0.50
mexx1234: posts the ante $0.10
Effort92: posts the ante $0.10
ruyingren: posts the ante $0.10
matiko09: posts the ante $0.10
vlad11122007: posts the ante $0.10
TonnaMunz: posts the ante $0.10
i L00K great: posts the ante $0.10
Optimistic21: posts the ante $0.10
Kud3: posts the ante $0.10
*** HOLE CARDS ***
Dealt to matiko09 [5d 5h]
ruyingren: folds 
matiko09: folds 
vlad11122007: folds 
TonnaMunz: folds 
i L00K great: folds 
Optimistic21: folds 
Kud3: raises $1 to $1.50
mexx1234: folds 
Effort92: folds 
Uncalled bet ($1) returned to Kud3
Kud3 collected $2.15 from pot
Kud3: doesn't show hand 
*** SUMMARY ***
Total pot $2.15 | Rake $0 
Seat 1: mexx1234 (small blind) folded before Flop
Seat 2: Effort92 (big blind) folded before Flop
Seat 3: ruyingren folded before Flop (didn't bet)
Seat 4: matiko09 folded before Flop (didn't bet)
Seat 5: vlad11122007 folded before Flop (didn't bet)
Seat 6: TonnaMunz folded before Flop (didn't bet)
Seat 7: i L00K great folded before Flop (didn't bet)
Seat 8: Optimistic21 folded before Flop (didn't bet)
Seat 9: Kud3 (button) collected ($2.15)





PokerStars Hand #148608001593:  Hold'em No Limit ($0.50/$1.00 USD) - 2016/02/11 12:44:13 CET [2016/02/11 6:44:13 ET]
Table 'Sycorax II' 9-max Seat #6 is the button
Seat 1: Luck In Me ($155.22 in chips) 
Seat 2: Lujan87 ($100 in chips) 
Seat 3: chauyeuba ($76.03 in chips) 
Seat 4: Sweden_Pound ($100 in chips) 
Seat 5: Effort92 ($166.19 in chips) 
Seat 6: FluentFlows ($44.76 in chips) 
Seat 8: matiko09 ($247.07 in chips) 
Seat 9: mrfoldcall ($112.51 in chips) 
PacPacBum will be allowed to play after the button
matiko09: posts small blind $0.50
mrfoldcall: posts big blind $1
*** HOLE CARDS ***
Dealt to matiko09 [8h Jc]
Luck In Me: folds 
Lujan87: raises $2 to $3
chauyeuba: calls $3
Sweden_Pound: folds 
Effort92: folds 
FluentFlows: folds 
matiko09: folds 
mrfoldcall: calls $2
*** FLOP *** [9d Kh Ks]
mrfoldcall: checks 
Lujan87: bets $4
chauyeuba: folds 
mrfoldcall: raises $8 to $12
Lujan87: calls $8
*** TURN *** [9d Kh Ks] [6d]
mrfoldcall: checks 
Lujan87: bets $12
mrfoldcall: folds 
Uncalled bet ($12) returned to Lujan87
Lujan87 collected $31.99 from pot
Lujan87: doesn't show hand 
*** SUMMARY ***
Total pot $33.50 | Rake $1.51 
Board [9d Kh Ks 6d]
Seat 1: Luck In Me folded before Flop (didn't bet)
Seat 2: Lujan87 collected ($31.99)
Seat 3: chauyeuba folded on the Flop
Seat 4: Sweden_Pound folded before Flop (didn't bet)
Seat 5: Effort92 folded before Flop (didn't bet)
Seat 6: FluentFlows (button) folded before Flop (didn't bet)
Seat 8: matiko09 (small blind) folded before Flop
Seat 9: mrfoldcall (big blind) folded on the Turn





PokerStars Hand #148608002718:  Hold'em No Limit ($0.25/$0.50 USD) - 2016/02/11 12:44:15 CET [2016/02/11 6:44:15 ET]
Table 'Amor II' 9-max Seat #9 is the button
Seat 1: Kud3 ($50 in chips) 
Seat 2: Fesch88 ($50 in chips) 
Seat 3: TheMinion ($57.22 in chips) 
Seat 4: Larzdog29 ($66.14 in chips) 
Seat 5: Optimistic21 ($51.15 in chips) 
Seat 6: matiko09 ($50.75 in chips) 
Seat 7: Serhent ($51 in chips) 
Seat 8: Reven9er ($67.27 in chips) 
Seat 9: tallonn88 ($108.11 in chips) 
Kud3: posts small blind $0.25
Fesch88: posts big blind $0.50
*** HOLE CARDS ***
Dealt to matiko09 [6h 7h]
TheMinion: folds 
Larzdog29: folds 
Optimistic21: folds 
matiko09: folds 
Serhent: folds 
Reven9er: folds 
tallonn88: folds 
Kud3: folds 
Uncalled bet ($0.25) returned to Fesch88
Fesch88 collected $0.50 from pot
Fesch88: doesn't show hand 
*** SUMMARY ***
Total pot $0.50 | Rake $0 
Seat 1: Kud3 (small blind) folded before Flop
Seat 2: Fesch88 (big blind) collected ($0.50)
Seat 3: TheMinion folded before Flop (didn't bet)
Seat 4: Larzdog29 folded before Flop (didn't bet)
Seat 5: Optimistic21 folded before Flop (didn't bet)
Seat 6: matiko09 folded before Flop (didn't bet)
Seat 7: Serhent folded before Flop (didn't bet)
Seat 8: Reven9er folded before Flop (didn't bet)
Seat 9: tallonn88 (button) folded before Flop (didn't bet)





PokerStars Hand #148608005435:  Hold'em No Limit (€0.25/€0.50 EUR) - 2016/02/11 12:44:20 CET [2016/02/11 6:44:20 ET]
Table 'Otero II' 9-max Seat #5 is the button
Seat 1: Nacho2556 (€43.48 in chips) 
Seat 2: make6a (€44.48 in chips) 
Seat 4: kram0909 (€20.72 in chips) 
Seat 5: vlad11122007 (€50.94 in chips) 
Seat 6: TonnaMunz (€55.04 in chips) 
Seat 7: PacPacBum (€58.77 in chips) 
Seat 8: matiko09 (€75.96 in chips) 
Seat 9: Optimistic21 (€58.54 in chips) 
TonnaMunz: posts small blind €0.25
PacPacBum: posts big blind €0.50
*** HOLE CARDS ***
Dealt to matiko09 [5c 3s]
matiko09: folds 
Optimistic21: raises €1 to €1.50
Nacho2556: folds 
make6a: folds 
kram0909: calls €1.50
vlad11122007: folds 
Szevasztopol joins the table at seat #3 
TonnaMunz: folds 
PacPacBum: folds 
*** FLOP *** [4c Qh Kc]
Optimistic21: bets €2
kram0909: calls €2
*** TURN *** [4c Qh Kc] [8h]
Optimistic21: bets €5
kram0909: calls €5
*** RIVER *** [4c Qh Kc 8h] [7s]
Optimistic21: checks 
kram0909: bets €5.50
Optimistic21: calls €5.50
*** SHOW DOWN ***
kram0909: shows [9c Tc] (high card King)
Optimistic21: shows [Ts Ks] (a pair of Kings)
Optimistic21 collected €27.46 from pot
*** SUMMARY ***
Total pot €28.75 | Rake €1.29 
Board [4c Qh Kc 8h 7s]
Seat 1: Nacho2556 folded before Flop (didn't bet)
Seat 2: make6a folded before Flop (didn't bet)
Seat 4: kram0909 showed [9c Tc] and lost with high card King
Seat 5: vlad11122007 (button) folded before Flop (didn't bet)
Seat 6: TonnaMunz (small blind) folded before Flop
Seat 7: PacPacBum (big blind) folded before Flop
Seat 8: matiko09 folded before Flop (didn't bet)
Seat 9: Optimistic21 showed [Ts Ks] and won (€27.46) with a pair of Kings





PokerStars Hand #148608007075:  Hold'em No Limit ($0.25/$0.50 USD) - 2016/02/11 12:44:22 CET [2016/02/11 6:44:22 ET]
Table 'Sylvania II' 9-max Seat #1 is the button
Seat 1: mexx1234 ($195.23 in chips) 
Seat 2: Effort92 ($51.95 in chips) 
Seat 3: ruyingren ($184.86 in chips) 
Seat 4: matiko09 ($151.50 in chips) 
Seat 5: vlad11122007 ($67.28 in chips) 
Seat 6: TonnaMunz ($128.16 in chips) 
Seat 7: i L00K great ($50 in chips) 
Seat 8: Optimistic21 ($50 in chips) 
Seat 9: Kud3 ($132.45 in chips) 
Effort92: posts small blind $0.25
ruyingren: posts big blind $0.50
mexx1234: posts the ante $0.10
Effort92: posts the ante $0.10
ruyingren: posts the ante $0.10
matiko09: posts the ante $0.10
vlad11122007: posts the ante $0.10
TonnaMunz: posts the ante $0.10
i L00K great: posts the ante $0.10
Optimistic21: posts the ante $0.10
Kud3: posts the ante $0.10
*** HOLE CARDS ***
Dealt to matiko09 [9c Kh]
matiko09: folds 
vlad11122007: folds 
TonnaMunz: folds 
i L00K great: folds 
Optimistic21: folds 
Kud3: folds 
mexx1234: raises $0.75 to $1.25
Effort92: folds 
ruyingren: folds 
Uncalled bet ($0.75) returned to mexx1234
mexx1234 collected $2.15 from pot
mexx1234: doesn't show hand 
*** SUMMARY ***
Total pot $2.15 | Rake $0 
Seat 1: mexx1234 (button) collected ($2.15)
Seat 2: Effort92 (small blind) folded before Flop
Seat 3: ruyingren (big blind) folded before Flop
Seat 4: matiko09 folded before Flop (didn't bet)
Seat 5: vlad11122007 folded before Flop (didn't bet)
Seat 6: TonnaMunz folded before Flop (didn't bet)
Seat 7: i L00K great folded before Flop (didn't bet)
Seat 8: Optimistic21 folded before Flop (didn't bet)
Seat 9: Kud3 folded before Flop (didn't bet)





PokerStars Hand #148608007615:  Hold'em No Limit ($0.25/$0.50 USD) - 2016/02/11 12:44:23 CET [2016/02/11 6:44:23 ET]
Table 'Stereoskopia' 9-max Seat #1 is the button
Seat 1: 50CandyJoe ($50 in chips) 
Seat 2: Optimistic21 ($57.25 in chips) 
Seat 3: Donko jr ($21.06 in chips) 
Seat 4: King brid ($83.67 in chips) 
Seat 5: ReinisRNS ($28.88 in chips) 
Seat 6: matiko09 ($50 in chips) 
Seat 7: tallonn88 ($54.17 in chips) 
Seat 9: apfush ($100.75 in chips) 
Optimistic21: posts small blind $0.25
Donko jr: posts big blind $0.50
vlad11122007: sits out 
*** HOLE CARDS ***
Dealt to matiko09 [Ah 8s]
King brid: folds 
ReinisRNS: folds 
matiko09: folds 
tallonn88: folds 
apfush: folds 
50CandyJoe: raises $0.50 to $1
Optimistic21: folds 
Donko jr: calls $0.50
*** FLOP *** [5c 5d Th]
Donko jr: checks 
50CandyJoe: bets $1
Donko jr: folds 
Uncalled bet ($1) returned to 50CandyJoe
50CandyJoe collected $2.15 from pot
50CandyJoe: doesn't show hand 
*** SUMMARY ***
Total pot $2.25 | Rake $0.10 
Board [5c 5d Th]
Seat 1: 50CandyJoe (button) collected ($2.15)
Seat 2: Optimistic21 (small blind) folded before Flop
Seat 3: Donko jr (big blind) folded on the Flop
Seat 4: King brid folded before Flop (didn't bet)
Seat 5: ReinisRNS folded before Flop (didn't bet)
Seat 6: matiko09 folded before Flop (didn't bet)
Seat 7: tallonn88 folded before Flop (didn't bet)
Seat 9: apfush folded before Flop (didn't bet)





PokerStars Hand #148608014541:  Hold'em No Limit ($0.25/$0.50 USD) - 2016/02/11 12:44:36 CET [2016/02/11 6:44:36 ET]
Table 'Amor II' 9-max Seat #1 is the button
Seat 1: Kud3 ($50 in chips) 
Seat 2: Fesch88 ($50.25 in chips) 
Seat 3: TheMinion ($57.22 in chips) 
Seat 4: Larzdog29 ($66.14 in chips) 
Seat 5: Optimistic21 ($51.15 in chips) 
Seat 6: matiko09 ($50.75 in chips) 
Seat 7: Serhent ($51 in chips) 
Seat 8: Reven9er ($67.27 in chips) 
Seat 9: tallonn88 ($108.11 in chips) 
Fesch88: posts small blind $0.25
TheMinion: posts big blind $0.50
*** HOLE CARDS ***
Dealt to matiko09 [Jd 4d]
Larzdog29: calls $0.50
Optimistic21: folds 
matiko09: folds 
Serhent: folds 
Reven9er: raises $0.75 to $1.25
tallonn88: raises $3.75 to $5
Kud3: folds 
Fesch88: folds 
TheMinion: folds 
Larzdog29: folds 
Reven9er: folds 
Uncalled bet ($3.75) returned to tallonn88
tallonn88 collected $3.75 from pot
tallonn88: doesn't show hand 
*** SUMMARY ***
Total pot $3.75 | Rake $0 
Seat 1: Kud3 (button) folded before Flop (didn't bet)
Seat 2: Fesch88 (small blind) folded before Flop
Seat 3: TheMinion (big blind) folded before Flop
Seat 4: Larzdog29 folded before Flop
Seat 5: Optimistic21 folded before Flop (didn't bet)
Seat 6: matiko09 folded before Flop (didn't bet)
Seat 7: Serhent folded before Flop (didn't bet)
Seat 8: Reven9er folded before Flop
Seat 9: tallonn88 collected ($3.75)





PokerStars Hand #148608016845:  Hold'em No Limit ($0.25/$0.50 USD) - 2016/02/11 12:44:40 CET [2016/02/11 6:44:40 ET]
Table 'Algedi' 9-max Seat #4 is the button
Seat 1: vlad11122007 ($51.12 in chips) 
Seat 2: Reffypaul ($67.09 in chips) 
Seat 3: Saggitaurus ($98.95 in chips) 
Seat 4: Effort92 ($60.51 in chips) 
Seat 6: TonnaMunz ($128.39 in chips) 
Seat 7: hoedtrob ($72.54 in chips) 
Seat 8: matiko09 ($50 in chips) 
Seat 9: Kud3 ($125 in chips) 
Optimistic21 will be allowed to play after the button
TonnaMunz: posts small blind $0.25
hoedtrob: posts big blind $0.50
vlad11122007: posts the ante $0.10
Reffypaul: posts the ante $0.10
Saggitaurus: posts the ante $0.10
Effort92: posts the ante $0.10
TonnaMunz: posts the ante $0.10
hoedtrob: posts the ante $0.10
matiko09: posts the ante $0.10
Kud3: posts the ante $0.10
*** HOLE CARDS ***
Dealt to matiko09 [6h Qd]
matiko09: folds 
Kud3: raises $1 to $1.50
vlad11122007: folds 
Reffypaul: folds 
Saggitaurus: calls $1.50
Effort92: folds 
TonnaMunz: folds 
hoedtrob: folds 
*** FLOP *** [8c Jh 8d]
Kud3: bets $2.30
Saggitaurus: folds 
Uncalled bet ($2.30) returned to Kud3
Kud3 collected $4.35 from pot
Kud3: doesn't show hand 
*** SUMMARY ***
Total pot $4.55 | Rake $0.20 
Board [8c Jh 8d]
Seat 1: vlad11122007 folded before Flop (didn't bet)
Seat 2: Reffypaul folded before Flop (didn't bet)
Seat 3: Saggitaurus folded on the Flop
Seat 4: Effort92 (button) folded before Flop (didn't bet)
Seat 6: TonnaMunz (small blind) folded before Flop
Seat 7: hoedtrob (big blind) folded before Flop
Seat 8: matiko09 folded before Flop (didn't bet)
Seat 9: Kud3 collected ($4.35)





PokerStars Hand #148608018557:  Hold'em No Limit ($0.25/$0.50 USD) - 2016/02/11 12:44:43 CET [2016/02/11 6:44:43 ET]
Table 'Ambrosia II' 9-max Seat #3 is the button
Seat 1: matiko09 ($50 in chips) 
Seat 2: TheMinion ($116.94 in chips) 
Seat 3: make6a ($46.75 in chips) 
Seat 6: Reven9er ($69.70 in chips) 
Seat 7: mexx1234 ($86.48 in chips) 
Seat 8: tallonn88 ($52.45 in chips) 
Seat 9: arctur17 ($67.07 in chips) 
RICKA16 will be allowed to play after the button
Reven9er: posts small blind $0.25
mexx1234: posts big blind $0.50
arctur17: posts small & big blinds $0.75
*** HOLE CARDS ***
Dealt to matiko09 [2h 6c]
tallonn88: folds 
huudk2016 is disconnected 
arctur17: checks 
matiko09: folds 
TheMinion: folds 
make6a: folds 
Reven9er: folds 
mexx1234: checks 
*** FLOP *** [8s Qc 5c]
mexx1234: checks 
arctur17: checks 
*** TURN *** [8s Qc 5c] [4s]
mexx1234: checks 
arctur17: checks 
*** RIVER *** [8s Qc 5c 4s] [Kh]
mexx1234: checks 
arctur17: bets $1
mexx1234: folds 
Uncalled bet ($1) returned to arctur17
arctur17 collected $1.43 from pot
arctur17: doesn't show hand 
*** SUMMARY ***
Total pot $1.50 | Rake $0.07 
Board [8s Qc 5c 4s Kh]
Seat 1: matiko09 folded before Flop (didn't bet)
Seat 2: TheMinion folded before Flop (didn't bet)
Seat 3: make6a (button) folded before Flop (didn't bet)
Seat 6: Reven9er (small blind) folded before Flop
Seat 7: mexx1234 (big blind) folded on the River
Seat 8: tallonn88 folded before Flop (didn't bet)
Seat 9: arctur17 collected ($1.43)





PokerStars Hand #148608028493:  Hold'em No Limit ($0.25/$0.50 USD) - 2016/02/11 12:45:00 CET [2016/02/11 6:45:00 ET]
Table 'Sylvania II' 9-max Seat #2 is the button
Seat 1: mexx1234 ($196.78 in chips) 
Seat 2: Effort92 ($51.60 in chips) 
Seat 3: ruyingren ($184.26 in chips) 
Seat 4: matiko09 ($151.40 in chips) 
Seat 5: vlad11122007 ($67.18 in chips) 
Seat 6: TonnaMunz ($128.06 in chips) 
Seat 7: i L00K great ($50 in chips) 
Seat 8: Optimistic21 ($50 in chips) 
Seat 9: Kud3 ($132.35 in chips) 
ruyingren: posts small blind $0.25
matiko09: posts big blind $0.50
mexx1234: posts the ante $0.10
Effort92: posts the ante $0.10
ruyingren: posts the ante $0.10
matiko09: posts the ante $0.10
vlad11122007: posts the ante $0.10
TonnaMunz: posts the ante $0.10
i L00K great: posts the ante $0.10
Optimistic21: posts the ante $0.10
Kud3: posts the ante $0.10
*** HOLE CARDS ***
Dealt to matiko09 [Qd Qc]
vlad11122007: folds 
TonnaMunz: folds 
i L00K great: raises $1 to $1.50
Optimistic21: folds 
Kud3: folds 
mexx1234: folds 
Effort92: folds 
ruyingren: folds 
matiko09: raises $3 to $4.50
i L00K great: calls $3
*** FLOP *** [Kh 7d Jc]
matiko09: checks 
i L00K great: checks 
*** TURN *** [Kh 7d Jc] [Ks]
matiko09: bets $4.50
i L00K great: folds 
Uncalled bet ($4.50) returned to matiko09
matiko09 collected $9.69 from pot
matiko09: doesn't show hand 
*** SUMMARY ***
Total pot $10.15 | Rake $0.46 
Board [Kh 7d Jc Ks]
Seat 1: mexx1234 folded before Flop (didn't bet)
Seat 2: Effort92 (button) folded before Flop (didn't bet)
Seat 3: ruyingren (small blind) folded before Flop
Seat 4: matiko09 (big blind) collected ($9.69)
Seat 5: vlad11122007 folded before Flop (didn't bet)
Seat 6: TonnaMunz folded before Flop (didn't bet)
Seat 7: i L00K great folded on the Turn
Seat 8: Optimistic21 folded before Flop (didn't bet)
Seat 9: Kud3 folded before Flop (didn't bet)





PokerStars Hand #148608028923:  Hold'em No Limit ($0.50/$1.00 USD) - 2016/02/11 12:45:01 CET [2016/02/11 6:45:01 ET]
Table 'Rasalas' 9-max Seat #4 is the button
Seat 2: azzad2007 ($100 in chips) 
Seat 3: Luck In Me ($100 in chips) 
Seat 4: Sweden_Pound ($100 in chips) 
Seat 6: DUkalisUA ($100 in chips) 
Seat 7: matiko09 ($100 in chips) 
Seat 8: gwwsb ($78.90 in chips) 
Seat 9: maxxmeister ($100 in chips) 
DUkalisUA: posts small blind $0.50
matiko09: posts big blind $1
*** HOLE CARDS ***
Dealt to matiko09 [Td 3d]
gwwsb: folds 
maxxmeister: folds 
azzad2007: folds 
Luck In Me: folds 
Sweden_Pound: raises $1 to $2
DUkalisUA: folds 
matiko09: folds 
Uncalled bet ($1) returned to Sweden_Pound
Sweden_Pound collected $2.50 from pot
Sweden_Pound: doesn't show hand 
*** SUMMARY ***
Total pot $2.50 | Rake $0 
Seat 2: azzad2007 folded before Flop (didn't bet)
Seat 3: Luck In Me folded before Flop (didn't bet)
Seat 4: Sweden_Pound (button) collected ($2.50)
Seat 6: DUkalisUA (small blind) folded before Flop
Seat 7: matiko09 (big blind) folded before Flop
Seat 8: gwwsb folded before Flop (didn't bet)
Seat 9: maxxmeister folded before Flop (didn't bet)





PokerStars Hand #148608033704:  Hold'em No Limit ($0.25/$0.50 USD) - 2016/02/11 12:45:10 CET [2016/02/11 6:45:10 ET]
Table 'Stereoskopia' 9-max Seat #2 is the button
Seat 1: 50CandyJoe ($51.15 in chips) 
Seat 2: Optimistic21 ($57 in chips) 
Seat 3: Donko jr ($20.06 in chips) 
Seat 4: King brid ($83.67 in chips) 
Seat 5: ReinisRNS ($28.88 in chips) 
Seat 6: matiko09 ($50 in chips) 
Seat 7: tallonn88 ($54.17 in chips) 
Seat 9: apfush ($100.75 in chips) 
Donko jr: posts small blind $0.25
King brid: posts big blind $0.50
vlad11122007: sits out 
*** HOLE CARDS ***
Dealt to matiko09 [9c 2s]
ReinisRNS: folds 
matiko09: folds 
tallonn88: raises $1 to $1.50
apfush: folds 
50CandyJoe: folds 
Optimistic21: folds 
Donko jr: calls $1.25
King brid: calls $1
*** FLOP *** [3d 7c Kh]
Donko jr: checks 
King brid: checks 
tallonn88: bets $2.75
Donko jr: folds 
King brid: folds 
Uncalled bet ($2.75) returned to tallonn88
tallonn88 collected $4.30 from pot
tallonn88: doesn't show hand 
*** SUMMARY ***
Total pot $4.50 | Rake $0.20 
Board [3d 7c Kh]
Seat 1: 50CandyJoe folded before Flop (didn't bet)
Seat 2: Optimistic21 (button) folded before Flop (didn't bet)
Seat 3: Donko jr (small blind) folded on the Flop
Seat 4: King brid (big blind) folded on the Flop
Seat 5: ReinisRNS folded before Flop (didn't bet)
Seat 6: matiko09 folded before Flop (didn't bet)
Seat 7: tallonn88 collected ($4.30)
Seat 9: apfush folded before Flop (didn't bet)





PokerStars Hand #148608035426:  Hold'em No Limit ($0.25/$0.50 USD) - 2016/02/11 12:45:13 CET [2016/02/11 6:45:13 ET]
Table 'Amor II' 9-max Seat #2 is the button
Seat 1: Kud3 ($50 in chips) 
Seat 2: Fesch88 ($50 in chips) 
Seat 3: TheMinion ($56.72 in chips) 
Seat 4: Larzdog29 ($65.64 in chips) 
Seat 5: Optimistic21 ($51.15 in chips) 
Seat 6: matiko09 ($50.75 in chips) 
Seat 7: Serhent ($51 in chips) 
Seat 8: Reven9er ($66.02 in chips) 
Seat 9: tallonn88 ($110.61 in chips) 
TheMinion: posts small blind $0.25
Larzdog29: posts big blind $0.50
*** HOLE CARDS ***
Dealt to matiko09 [9d Ks]
Optimistic21: raises $1 to $1.50
matiko09: folds 
Serhent: folds 
Reven9er: folds 
tallonn88: folds 
Kud3: calls $1.50
Fesch88: folds 
TheMinion: folds 
Larzdog29: folds 
*** FLOP *** [2h Jc 7h]
Optimistic21: bets $2.50
Kud3: folds 
Uncalled bet ($2.50) returned to Optimistic21
Optimistic21 collected $3.58 from pot
*** SUMMARY ***
Total pot $3.75 | Rake $0.17 
Board [2h Jc 7h]
Seat 1: Kud3 folded on the Flop
Seat 2: Fesch88 (button) folded before Flop (didn't bet)
Seat 3: TheMinion (small blind) folded before Flop
Seat 4: Larzdog29 (big blind) folded before Flop
Seat 5: Optimistic21 collected ($3.58)
Seat 6: matiko09 folded before Flop (didn't bet)
Seat 7: Serhent folded before Flop (didn't bet)
Seat 8: Reven9er folded before Flop (didn't bet)
Seat 9: tallonn88 folded before Flop (didn't bet)





PokerStars Hand #148608037759:  Hold'em No Limit ($0.25/$0.50 USD) - 2016/02/11 12:45:17 CET [2016/02/11 6:45:17 ET]
Table 'Algedi' 9-max Seat #6 is the button
Seat 1: vlad11122007 ($51.02 in chips) 
Seat 2: Reffypaul ($66.99 in chips) 
Seat 3: Saggitaurus ($97.35 in chips) 
Seat 4: Effort92 ($60.41 in chips) 
Seat 6: TonnaMunz ($128.04 in chips) 
Seat 7: hoedtrob ($71.94 in chips) 
Seat 8: matiko09 ($50 in chips) 
Seat 9: Kud3 ($127.75 in chips) 
hoedtrob: posts small blind $0.25
matiko09: posts big blind $0.50
Optimistic21: sits out 
vlad11122007: posts the ante $0.10
Reffypaul: posts the ante $0.10
Saggitaurus: posts the ante $0.10
Effort92: posts the ante $0.10
TonnaMunz: posts the ante $0.10
hoedtrob: posts the ante $0.10
matiko09: posts the ante $0.10
Kud3: posts the ante $0.10
*** HOLE CARDS ***
Dealt to matiko09 [7d 9s]
Kud3: folds 
vlad11122007: folds 
Reffypaul: folds 
Saggitaurus: folds 
Effort92: folds 
TonnaMunz: folds 
hoedtrob: folds 
Uncalled bet ($0.25) returned to matiko09
matiko09 collected $1.30 from pot
matiko09: doesn't show hand 
*** SUMMARY ***
Total pot $1.30 | Rake $0 
Seat 1: vlad11122007 folded before Flop (didn't bet)
Seat 2: Reffypaul folded before Flop (didn't bet)
Seat 3: Saggitaurus folded before Flop (didn't bet)
Seat 4: Effort92 folded before Flop (didn't bet)
Seat 6: TonnaMunz (button) folded before Flop (didn't bet)
Seat 7: hoedtrob (small blind) folded before Flop
Seat 8: matiko09 (big blind) collected ($1.30)
Seat 9: Kud3 folded before Flop (didn't bet)





PokerStars Hand #148608044042:  Hold'em No Limit ($0.25/$0.50 USD) - 2016/02/11 12:45:28 CET [2016/02/11 6:45:28 ET]
Table 'Risha' 9-max Seat #1 is the button
Seat 1: Kud3 ($138.45 in chips) 
Seat 3: TuaaL ($72.02 in chips) 
Seat 4: matiko09 ($50 in chips) 
Seat 6: TonnaMunz ($68.90 in chips) 
TuaaL: posts small blind $0.25
matiko09: posts big blind $0.50
Kud3: posts the ante $0.10
TuaaL: posts the ante $0.10
matiko09: posts the ante $0.10
TonnaMunz: posts the ante $0.10
*** HOLE CARDS ***
Dealt to matiko09 [3s 7h]
TonnaMunz: folds 
Kud3: folds 
TuaaL: calls $0.25
matiko09: checks 
*** FLOP *** [5c 4d 6s]
TuaaL: bets $1.50
matiko09: raises $3 to $4.50
TuaaL: calls $3
*** TURN *** [5c 4d 6s] [6d]
TuaaL: bets $1.50
matiko09: raises $8.40 to $9.90
TuaaL: calls $8.40
*** RIVER *** [5c 4d 6s 6d] [8h]
TuaaL: bets $2
matiko09: calls $2
*** SHOW DOWN ***
TuaaL: shows [Jh Jc] (two pair, Jacks and Sixes)
matiko09: shows [3s 7h] (a straight, Four to Eight)
matiko09 collected $32.70 from pot
*** SUMMARY ***
Total pot $34.20 | Rake $1.50 
Board [5c 4d 6s 6d 8h]
Seat 1: Kud3 (button) folded before Flop (didn't bet)
Seat 3: TuaaL (small blind) showed [Jh Jc] and lost with two pair, Jacks and Sixes
Seat 4: matiko09 (big blind) showed [3s 7h] and won ($32.70) with a straight, Four to Eight
Seat 6: TonnaMunz folded before Flop (didn't bet)





PokerStars Hand #148608044943:  Hold'em No Limit ($0.25/$0.50 USD) - 2016/02/11 12:45:30 CET [2016/02/11 6:45:30 ET]
Table 'Ambrosia II' 9-max Seat #6 is the button
Seat 1: matiko09 ($50 in chips) 
Seat 2: TheMinion ($116.94 in chips) 
Seat 3: make6a ($46.75 in chips) 
Seat 6: Reven9er ($69.45 in chips) 
Seat 7: mexx1234 ($85.98 in chips) 
Seat 8: tallonn88 ($52.45 in chips) 
Seat 9: arctur17 ($67.75 in chips) 
mexx1234: posts small blind $0.25
tallonn88: posts big blind $0.50
RICKA16: sits out 
*** HOLE CARDS ***
Dealt to matiko09 [3h Qh]
arctur17: calls $0.50
matiko09: folds 
TheMinion: folds 
make6a: folds 
Reven9er: folds 
mexx1234: folds 
huudk2016 leaves the table
tallonn88: checks 
*** FLOP *** [5d 5h 6h]
tallonn88: checks 
arctur17: bets $1
tallonn88: folds 
Uncalled bet ($1) returned to arctur17
arctur17 collected $1.19 from pot
arctur17: doesn't show hand 
*** SUMMARY ***
Total pot $1.25 | Rake $0.06 
Board [5d 5h 6h]
Seat 1: matiko09 folded before Flop (didn't bet)
Seat 2: TheMinion folded before Flop (didn't bet)
Seat 3: make6a folded before Flop (didn't bet)
Seat 6: Reven9er (button) folded before Flop (didn't bet)
Seat 7: mexx1234 (small blind) folded before Flop
Seat 8: tallonn88 (big blind) folded on the Flop
Seat 9: arctur17 collected ($1.19)





PokerStars Hand #148608048195:  Hold'em No Limit ($0.25/$0.50 USD) - 2016/02/11 12:45:35 CET [2016/02/11 6:45:35 ET]
Table 'Algedi' 9-max Seat #7 is the button
Seat 1: vlad11122007 ($50.92 in chips) 
Seat 2: Reffypaul ($66.89 in chips) 
Seat 3: Saggitaurus ($97.25 in chips) 
Seat 4: Effort92 ($60.31 in chips) 
Seat 6: TonnaMunz ($127.94 in chips) 
Seat 7: hoedtrob ($71.59 in chips) 
Seat 8: matiko09 ($50.95 in chips) 
Seat 9: Kud3 ($127.65 in chips) 
matiko09: posts small blind $0.25
Kud3: posts big blind $0.50
Optimistic21: sits out 
vlad11122007: posts the ante $0.10
Reffypaul: posts the ante $0.10
Saggitaurus: posts the ante $0.10
Effort92: posts the ante $0.10
TonnaMunz: posts the ante $0.10
hoedtrob: posts the ante $0.10
matiko09: posts the ante $0.10
Kud3: posts the ante $0.10
*** HOLE CARDS ***
Dealt to matiko09 [9d 6c]
vlad11122007: raises $1 to $1.50
Reffypaul: calls $1.50
Saggitaurus: folds 
Effort92: folds 
TonnaMunz: folds 
hoedtrob: folds 
matiko09: folds 
Kud3: folds 
*** FLOP *** [Ah Ts Kh]
vlad11122007: bets $3
Reffypaul: calls $3
*** TURN *** [Ah Ts Kh] [Ac]
vlad11122007: bets $6
Reffypaul: folds 
Uncalled bet ($6) returned to vlad11122007
vlad11122007 collected $10.08 from pot
vlad11122007: doesn't show hand 
*** SUMMARY ***
Total pot $10.55 | Rake $0.47 
Board [Ah Ts Kh Ac]
Seat 1: vlad11122007 collected ($10.08)
Seat 2: Reffypaul folded on the Turn
Seat 3: Saggitaurus folded before Flop (didn't bet)
Seat 4: Effort92 folded before Flop (didn't bet)
Seat 6: TonnaMunz folded before Flop (didn't bet)
Seat 7: hoedtrob (button) folded before Flop (didn't bet)
Seat 8: matiko09 (small blind) folded before Flop
Seat 9: Kud3 (big blind) folded before Flop





PokerStars Hand #148608052472:  Hold'em No Limit ($0.50/$1.00 USD) - 2016/02/11 12:45:43 CET [2016/02/11 6:45:43 ET]
Table 'Regor' 9-max Seat #2 is the button
Seat 1: matiko09 ($124.27 in chips) 
Seat 2: Luck In Me ($100.50 in chips) 
Seat 3: oscarleon ($159.64 in chips) 
Seat 4: Filojoes ($100 in chips) 
Seat 5: chauyeuba ($58.97 in chips) 
Seat 6: Dachish ($92.45 in chips) 
Seat 8: R3NZONIT3 ($47.32 in chips) 
Seat 9: CoolFireX ($145.14 in chips) 
oscarleon: posts small blind $0.50
Filojoes: posts big blind $1
Sweden_Pound: sits out 
*** HOLE CARDS ***
Dealt to matiko09 [5c 7c]
chauyeuba: folds 
Dachish: folds 
R3NZONIT3: calls $1
CoolFireX: folds 
matiko09: folds 
Luck In Me: folds 
oscarleon: calls $0.50
Filojoes: checks 
*** FLOP *** [9s Td 2h]
oscarleon: bets $2
Filojoes: folds 
R3NZONIT3: calls $2
*** TURN *** [9s Td 2h] [4h]
oscarleon: bets $3.47
R3NZONIT3: calls $3.47
*** RIVER *** [9s Td 2h 4h] [Ad]
oscarleon: checks 
R3NZONIT3: bets $6.65
oscarleon: folds 
Uncalled bet ($6.65) returned to R3NZONIT3
R3NZONIT3 collected $13.31 from pot
R3NZONIT3: doesn't show hand 
*** SUMMARY ***
Total pot $13.94 | Rake $0.63 
Board [9s Td 2h 4h Ad]
Seat 1: matiko09 folded before Flop (didn't bet)
Seat 2: Luck In Me (button) folded before Flop (didn't bet)
Seat 3: oscarleon (small blind) folded on the River
Seat 4: Filojoes (big blind) folded on the Flop
Seat 5: chauyeuba folded before Flop (didn't bet)
Seat 6: Dachish folded before Flop (didn't bet)
Seat 8: R3NZONIT3 collected ($13.31)
Seat 9: CoolFireX folded before Flop (didn't bet)





PokerStars Hand #148608054582:  Hold'em No Limit ($0.50/$1.00 USD) - 2016/02/11 12:45:46 CET [2016/02/11 6:45:46 ET]
Table 'Rasalas' 9-max Seat #6 is the button
Seat 2: azzad2007 ($100 in chips) 
Seat 3: Luck In Me ($100 in chips) 
Seat 4: Sweden_Pound ($101.50 in chips) 
Seat 6: DUkalisUA ($100 in chips) 
Seat 7: matiko09 ($100 in chips) 
Seat 8: gwwsb ($78.90 in chips) 
Seat 9: maxxmeister ($100 in chips) 
matiko09: posts small blind $0.50
gwwsb: posts big blind $1
*** HOLE CARDS ***
Dealt to matiko09 [7h Qs]
maxxmeister: folds 
azzad2007: folds 
Luck In Me: folds 
Sweden_Pound: raises $1.50 to $2.50
DUkalisUA: folds 
matiko09: folds 
gwwsb: folds 
Uncalled bet ($1.50) returned to Sweden_Pound
Sweden_Pound collected $2.50 from pot
Sweden_Pound: doesn't show hand 
*** SUMMARY ***
Total pot $2.50 | Rake $0 
Seat 2: azzad2007 folded before Flop (didn't bet)
Seat 3: Luck In Me folded before Flop (didn't bet)
Seat 4: Sweden_Pound collected ($2.50)
Seat 6: DUkalisUA (button) folded before Flop (didn't bet)
Seat 7: matiko09 (small blind) folded before Flop
Seat 8: gwwsb (big blind) folded before Flop
Seat 9: maxxmeister folded before Flop (didn't bet)





PokerStars Hand #148608055838:  Hold'em No Limit (€0.25/€0.50 EUR) - 2016/02/11 12:45:49 CET [2016/02/11 6:45:49 ET]
Table 'Otero II' 9-max Seat #6 is the button
Seat 1: Nacho2556 (€43.48 in chips) 
Seat 2: make6a (€44.48 in chips) 
Seat 4: kram0909 (€6.72 in chips) 
Seat 5: vlad11122007 (€50.94 in chips) 
Seat 6: TonnaMunz (€54.79 in chips) 
Seat 7: PacPacBum (€58.27 in chips) 
Seat 8: matiko09 (€75.96 in chips) 
Seat 9: Optimistic21 (€72 in chips) 
PacPacBum: posts small blind €0.25
matiko09: posts big blind €0.50
Szevasztopol: sits out 
*** HOLE CARDS ***
Dealt to matiko09 [5d 7c]
Optimistic21: folds 
Nacho2556: folds 
make6a: raises €0.82 to €1.32
kram0909: folds 
vlad11122007: folds 
TonnaMunz: folds 
PacPacBum: folds 
matiko09: folds 
Uncalled bet (€0.82) returned to make6a
make6a collected €1.25 from pot
make6a: doesn't show hand 
*** SUMMARY ***
Total pot €1.25 | Rake €0 
Seat 1: Nacho2556 folded before Flop (didn't bet)
Seat 2: make6a collected (€1.25)
Seat 4: kram0909 folded before Flop (didn't bet)
Seat 5: vlad11122007 folded before Flop (didn't bet)
Seat 6: TonnaMunz (button) folded before Flop (didn't bet)
Seat 7: PacPacBum (small blind) folded before Flop
Seat 8: matiko09 (big blind) folded before Flop
Seat 9: Optimistic21 folded before Flop (didn't bet)





PokerStars Hand #148608055858:  Hold'em No Limit ($0.50/$1.00 USD) - 2016/02/11 12:45:49 CET [2016/02/11 6:45:49 ET]
Table 'Sycorax II' 9-max Seat #8 is the button
Seat 1: Luck In Me ($155.22 in chips) 
Seat 2: Lujan87 ($116.99 in chips) 
Seat 3: chauyeuba ($73.03 in chips) 
Seat 4: Sweden_Pound ($100 in chips) 
Seat 5: Effort92 ($166.19 in chips) 
Seat 6: FluentFlows ($44.76 in chips) 
Seat 8: matiko09 ($246.57 in chips) 
Seat 9: mrfoldcall ($97.51 in chips) 
mrfoldcall: posts small blind $0.50
Luck In Me: posts big blind $1
PacPacBum: sits out 
*** HOLE CARDS ***
Dealt to matiko09 [Qc Ah]
Lujan87: folds 
chauyeuba: folds 
Sweden_Pound: folds 
Effort92: raises $2 to $3
FluentFlows: folds 
matiko09: calls $3
mrfoldcall: folds 
Luck In Me: folds 
*** FLOP *** [Ks Qs 7s]
Effort92: checks 
matiko09: checks 
*** TURN *** [Ks Qs 7s] [8d]
Effort92: checks 
matiko09: bets $4.65
Effort92: calls $4.65
*** RIVER *** [Ks Qs 7s 8d] [6d]
Effort92: checks 
matiko09: checks 
*** SHOW DOWN ***
Effort92: shows [Jd Jc] (a pair of Jacks)
matiko09: shows [Qc Ah] (a pair of Queens)
matiko09 collected $16.04 from pot
*** SUMMARY ***
Total pot $16.80 | Rake $0.76 
Board [Ks Qs 7s 8d 6d]
Seat 1: Luck In Me (big blind) folded before Flop
Seat 2: Lujan87 folded before Flop (didn't bet)
Seat 3: chauyeuba folded before Flop (didn't bet)
Seat 4: Sweden_Pound folded before Flop (didn't bet)
Seat 5: Effort92 showed [Jd Jc] and lost with a pair of Jacks
Seat 6: FluentFlows folded before Flop (didn't bet)
Seat 8: matiko09 (button) showed [Qc Ah] and won ($16.04) with a pair of Queens
Seat 9: mrfoldcall (small blind) folded before Flop





PokerStars Hand #148608061595:  Hold'em No Limit ($0.25/$0.50 USD) - 2016/02/11 12:45:59 CET [2016/02/11 6:45:59 ET]
Table 'Stereoskopia' 9-max Seat #3 is the button
Seat 1: 50CandyJoe ($51.15 in chips) 
Seat 2: Optimistic21 ($57 in chips) 
Seat 3: Donko jr ($18.56 in chips) 
Seat 4: King brid ($82.17 in chips) 
Seat 5: ReinisRNS ($28.88 in chips) 
Seat 6: matiko09 ($50 in chips) 
Seat 7: tallonn88 ($56.97 in chips) 
Seat 9: apfush ($100.75 in chips) 
King brid: posts small blind $0.25
ReinisRNS: posts big blind $0.50
vlad11122007: sits out 
*** HOLE CARDS ***
Dealt to matiko09 [7s 8s]
matiko09: raises $1 to $1.50
tallonn88: folds 
apfush: folds 
50CandyJoe: folds 
Optimistic21: folds 
Donko jr: folds 
King brid: folds 
ReinisRNS: calls $1
*** FLOP *** [Js Kd Ah]
ReinisRNS: checks 
matiko09: checks 
*** TURN *** [Js Kd Ah] [Kc]
ReinisRNS: checks 
matiko09: checks 
*** RIVER *** [Js Kd Ah Kc] [9c]
ReinisRNS: bets $1.55
matiko09: folds 
Uncalled bet ($1.55) returned to ReinisRNS
ReinisRNS collected $3.10 from pot
ReinisRNS: doesn't show hand 
*** SUMMARY ***
Total pot $3.25 | Rake $0.15 
Board [Js Kd Ah Kc 9c]
Seat 1: 50CandyJoe folded before Flop (didn't bet)
Seat 2: Optimistic21 folded before Flop (didn't bet)
Seat 3: Donko jr (button) folded before Flop (didn't bet)
Seat 4: King brid (small blind) folded before Flop
Seat 5: ReinisRNS (big blind) collected ($3.10)
Seat 6: matiko09 folded on the River
Seat 7: tallonn88 folded before Flop (didn't bet)
Seat 9: apfush folded before Flop (didn't bet)





PokerStars Hand #148608063951:  Hold'em No Limit ($0.50/$1.00 USD) - 2016/02/11 12:46:03 CET [2016/02/11 6:46:03 ET]
Table 'Rasalas' 9-max Seat #7 is the button
Seat 2: azzad2007 ($100 in chips) 
Seat 3: Luck In Me ($100 in chips) 
Seat 4: Sweden_Pound ($103 in chips) 
Seat 6: DUkalisUA ($100 in chips) 
Seat 7: matiko09 ($100 in chips) 
Seat 8: gwwsb ($77.90 in chips) 
gwwsb: posts small blind $0.50
maxxmeister: is sitting out 
azzad2007: posts big blind $1
*** HOLE CARDS ***
Dealt to matiko09 [5d 8c]
Luck In Me: folds 
Sweden_Pound: folds 
DUkalisUA: folds 
matiko09: folds 
gwwsb: raises $1 to $2
azzad2007: calls $1
*** FLOP *** [Qc 3h 6h]
gwwsb: checks 
azzad2007: checks 
*** TURN *** [Qc 3h 6h] [2s]
gwwsb: checks 
azzad2007: checks 
*** RIVER *** [Qc 3h 6h 2s] [5h]
gwwsb: checks 
azzad2007: bets $3.05
gwwsb: folds 
Uncalled bet ($3.05) returned to azzad2007
azzad2007 collected $3.82 from pot
azzad2007: doesn't show hand 
*** SUMMARY ***
Total pot $4 | Rake $0.18 
Board [Qc 3h 6h 2s 5h]
Seat 2: azzad2007 (big blind) collected ($3.82)
Seat 3: Luck In Me folded before Flop (didn't bet)
Seat 4: Sweden_Pound folded before Flop (didn't bet)
Seat 6: DUkalisUA folded before Flop (didn't bet)
Seat 7: matiko09 (button) folded before Flop (didn't bet)
Seat 8: gwwsb (small blind) folded on the River





PokerStars Hand #148608070986:  Hold'em No Limit (€0.25/€0.50 EUR) - 2016/02/11 12:46:15 CET [2016/02/11 6:46:15 ET]
Table 'Otero II' 9-max Seat #7 is the button
Seat 1: Nacho2556 (€43.48 in chips) 
Seat 2: make6a (€45.23 in chips) 
Seat 4: kram0909 (€6.72 in chips) 
Seat 5: vlad11122007 (€50.94 in chips) 
Seat 6: TonnaMunz (€54.79 in chips) 
Seat 7: PacPacBum (€58.02 in chips) 
Seat 8: matiko09 (€75.46 in chips) 
Seat 9: Optimistic21 (€72 in chips) 
matiko09: posts small blind €0.25
Optimistic21: posts big blind €0.50
Szevasztopol: sits out 
*** HOLE CARDS ***
Dealt to matiko09 [Jc Jh]
Nacho2556: calls €0.50
make6a: folds 
kram0909: folds 
vlad11122007: folds 
TonnaMunz: folds 
PacPacBum: folds 
matiko09: raises €2 to €2.50
Optimistic21: folds 
Nacho2556: calls €2
*** FLOP *** [9h 8h 6c]
matiko09: bets €3.41
Nacho2556: raises €6.41 to €9.82
matiko09: folds 
Uncalled bet (€6.41) returned to Nacho2556
Nacho2556 collected €11.77 from pot
*** SUMMARY ***
Total pot €12.32 | Rake €0.55 
Board [9h 8h 6c]
Seat 1: Nacho2556 collected (€11.77)
Seat 2: make6a folded before Flop (didn't bet)
Seat 4: kram0909 folded before Flop (didn't bet)
Seat 5: vlad11122007 folded before Flop (didn't bet)
Seat 6: TonnaMunz folded before Flop (didn't bet)
Seat 7: PacPacBum (button) folded before Flop (didn't bet)
Seat 8: matiko09 (small blind) folded on the Flop
Seat 9: Optimistic21 (big blind) folded before Flop





PokerStars Hand #148608071191:  Hold'em No Limit ($0.25/$0.50 USD) - 2016/02/11 12:46:16 CET [2016/02/11 6:46:16 ET]
Table 'Algedi' 9-max Seat #8 is the button
Seat 1: vlad11122007 ($56.40 in chips) 
Seat 2: Reffypaul ($62.29 in chips) 
Seat 3: Saggitaurus ($97.15 in chips) 
Seat 4: Effort92 ($60.21 in chips) 
Seat 6: TonnaMunz ($127.84 in chips) 
Seat 7: hoedtrob ($71.49 in chips) 
Seat 8: matiko09 ($50.60 in chips) 
Seat 9: Kud3 ($127.05 in chips) 
Kud3: posts small blind $0.25
vlad11122007: posts big blind $0.50
Optimistic21: sits out 
vlad11122007: posts the ante $0.10
Reffypaul: posts the ante $0.10
Saggitaurus: posts the ante $0.10
Effort92: posts the ante $0.10
TonnaMunz: posts the ante $0.10
hoedtrob: posts the ante $0.10
matiko09: posts the ante $0.10
Kud3: posts the ante $0.10
*** HOLE CARDS ***
Dealt to matiko09 [Ad 7s]
Reffypaul: raises $1 to $1.50
Saggitaurus: folds 
Effort92: folds 
TonnaMunz: folds 
hoedtrob: folds 
matiko09: folds 
Kud3: folds 
vlad11122007: folds 
Uncalled bet ($1) returned to Reffypaul
Reffypaul collected $2.05 from pot
*** SUMMARY ***
Total pot $2.05 | Rake $0 
Seat 1: vlad11122007 (big blind) folded before Flop
Seat 2: Reffypaul collected ($2.05)
Seat 3: Saggitaurus folded before Flop (didn't bet)
Seat 4: Effort92 folded before Flop (didn't bet)
Seat 6: TonnaMunz folded before Flop (didn't bet)
Seat 7: hoedtrob folded before Flop (didn't bet)
Seat 8: matiko09 (button) folded before Flop (didn't bet)
Seat 9: Kud3 (small blind) folded before Flop





PokerStars Hand #148608081897:  Hold'em No Limit ($0.25/$0.50 USD) - 2016/02/11 12:46:35 CET [2016/02/11 6:46:35 ET]
Table 'Ambrosia II' 9-max Seat #7 is the button
Seat 1: matiko09 ($50 in chips) 
Seat 2: TheMinion ($116.94 in chips) 
Seat 3: make6a ($46.75 in chips) 
Seat 6: Reven9er ($69.45 in chips) 
Seat 7: mexx1234 ($85.73 in chips) 
Seat 8: tallonn88 ($51.95 in chips) 
Seat 9: arctur17 ($68.44 in chips) 
tallonn88: posts small blind $0.25
arctur17: posts big blind $0.50
RICKA16: sits out 
*** HOLE CARDS ***
Dealt to matiko09 [Ts 2h]
matiko09: folds 
TheMinion: folds 
make6a: raises $0.60 to $1.10
Reven9er: folds 
mexx1234: folds 
tallonn88: folds 
arctur17: calls $0.60
*** FLOP *** [8h Qh 4h]
arctur17: checks 
make6a: bets $1.45
arctur17: folds 
Uncalled bet ($1.45) returned to make6a
make6a collected $2.34 from pot
make6a: doesn't show hand 
*** SUMMARY ***
Total pot $2.45 | Rake $0.11 
Board [8h Qh 4h]
Seat 1: matiko09 folded before Flop (didn't bet)
Seat 2: TheMinion folded before Flop (didn't bet)
Seat 3: make6a collected ($2.34)
Seat 6: Reven9er folded before Flop (didn't bet)
Seat 7: mexx1234 (button) folded before Flop (didn't bet)
Seat 8: tallonn88 (small blind) folded before Flop
Seat 9: arctur17 (big blind) folded on the Flop





PokerStars Hand #148608084554:  Hold'em No Limit ($0.25/$0.50 USD) - 2016/02/11 12:46:39 CET [2016/02/11 6:46:39 ET]
Table 'Risha' 9-max Seat #3 is the button
Seat 1: Kud3 ($138.35 in chips) 
Seat 3: TuaaL ($55.02 in chips) 
Seat 4: matiko09 ($65.70 in chips) 
Seat 6: TonnaMunz ($68.80 in chips) 
matiko09: posts small blind $0.25
TonnaMunz: posts big blind $0.50
Kud3: posts the ante $0.10
TuaaL: posts the ante $0.10
matiko09: posts the ante $0.10
TonnaMunz: posts the ante $0.10
*** HOLE CARDS ***
Dealt to matiko09 [7d 2c]
Kud3: folds 
TuaaL: calls $0.50
matiko09: folds 
TonnaMunz: checks 
*** FLOP *** [7h 6c Ac]
TonnaMunz: checks 
TuaaL: checks 
*** TURN *** [7h 6c Ac] [6d]
TonnaMunz: bets $1.50
TuaaL: calls $1.50
*** RIVER *** [7h 6c Ac 6d] [Ks]
TonnaMunz: bets $4.50
TuaaL: folds 
Uncalled bet ($4.50) returned to TonnaMunz
TonnaMunz collected $4.44 from pot
TonnaMunz: doesn't show hand 
*** SUMMARY ***
Total pot $4.65 | Rake $0.21 
Board [7h 6c Ac 6d Ks]
Seat 1: Kud3 folded before Flop (didn't bet)
Seat 3: TuaaL (button) folded on the River
Seat 4: matiko09 (small blind) folded before Flop
Seat 6: TonnaMunz (big blind) collected ($4.44)





PokerStars Hand #148608085555:  Hold'em No Limit ($0.25/$0.50 USD) - 2016/02/11 12:46:41 CET [2016/02/11 6:46:41 ET]
Table 'Sylvania II' 9-max Seat #3 is the button
Seat 1: mexx1234 ($196.68 in chips) 
Seat 2: Effort92 ($51.50 in chips) 
Seat 3: ruyingren ($183.91 in chips) 
Seat 4: matiko09 ($156.49 in chips) 
Seat 5: vlad11122007 ($67.08 in chips) 
Seat 6: TonnaMunz ($127.96 in chips) 
Seat 7: i L00K great ($50 in chips) 
Seat 8: Optimistic21 ($50 in chips) 
Seat 9: Kud3 ($132.25 in chips) 
matiko09: posts small blind $0.25
vlad11122007: posts big blind $0.50
mexx1234: posts the ante $0.10
Effort92: posts the ante $0.10
ruyingren: posts the ante $0.10
matiko09: posts the ante $0.10
vlad11122007: posts the ante $0.10
TonnaMunz: posts the ante $0.10
i L00K great: posts the ante $0.10
Optimistic21: posts the ante $0.10
Kud3: posts the ante $0.10
*** HOLE CARDS ***
Dealt to matiko09 [7s 4s]
TonnaMunz: folds 
i L00K great: folds 
ruyingren is disconnected 
Optimistic21: folds 
Kud3: folds 
mexx1234: folds 
Effort92: folds 
ruyingren is connected 
ruyingren: raises $1 to $1.50
matiko09: folds 
vlad11122007: calls $1
*** FLOP *** [9c Td 4d]
vlad11122007: checks 
ruyingren: bets $2.50
vlad11122007: calls $2.50
*** TURN *** [9c Td 4d] [3d]
vlad11122007: checks 
ruyingren: checks 
*** RIVER *** [9c Td 4d 3d] [2c]
vlad11122007: bets $6
ruyingren: calls $6
*** SHOW DOWN ***
vlad11122007: shows [Kc Js] (high card King)
ruyingren: shows [Ac 5c] (a straight, Ace to Five)
ruyingren collected $20.20 from pot
*** SUMMARY ***
Total pot $21.15 | Rake $0.95 
Board [9c Td 4d 3d 2c]
Seat 1: mexx1234 folded before Flop (didn't bet)
Seat 2: Effort92 folded before Flop (didn't bet)
Seat 3: ruyingren (button) showed [Ac 5c] and won ($20.20) with a straight, Ace to Five
Seat 4: matiko09 (small blind) folded before Flop
Seat 5: vlad11122007 (big blind) showed [Kc Js] and lost with high card King
Seat 6: TonnaMunz folded before Flop (didn't bet)
Seat 7: i L00K great folded before Flop (didn't bet)
Seat 8: Optimistic21 folded before Flop (didn't bet)
Seat 9: Kud3 folded before Flop (didn't bet)





PokerStars Hand #148608088317:  Hold'em No Limit ($0.50/$1.00 USD) - 2016/02/11 12:46:46 CET [2016/02/11 6:46:46 ET]
Table 'Sycorax II' 9-max Seat #9 is the button
Seat 1: Luck In Me ($154.22 in chips) 
Seat 2: Lujan87 ($116.99 in chips) 
Seat 3: chauyeuba ($73.03 in chips) 
Seat 4: Sweden_Pound ($100 in chips) 
Seat 5: Effort92 ($158.54 in chips) 
Seat 6: FluentFlows ($44.76 in chips) 
Seat 8: matiko09 ($254.96 in chips) 
Seat 9: mrfoldcall ($97.01 in chips) 
Luck In Me: posts small blind $0.50
Lujan87: posts big blind $1
PacPacBum: sits out 
*** HOLE CARDS ***
Dealt to matiko09 [9d Td]
chauyeuba: folds 
Sweden_Pound: folds 
Effort92: folds 
FluentFlows: folds 
matiko09: raises $2 to $3
mrfoldcall: folds 
Luck In Me: folds 
Lujan87: folds 
Uncalled bet ($2) returned to matiko09
matiko09 collected $2.50 from pot
matiko09: doesn't show hand 
*** SUMMARY ***
Total pot $2.50 | Rake $0 
Seat 1: Luck In Me (small blind) folded before Flop
Seat 2: Lujan87 (big blind) folded before Flop
Seat 3: chauyeuba folded before Flop (didn't bet)
Seat 4: Sweden_Pound folded before Flop (didn't bet)
Seat 5: Effort92 folded before Flop (didn't bet)
Seat 6: FluentFlows folded before Flop (didn't bet)
Seat 8: matiko09 collected ($2.50)
Seat 9: mrfoldcall (button) folded before Flop (didn't bet)





PokerStars Hand #148608093138:  Hold'em No Limit ($0.25/$0.50 USD) - 2016/02/11 12:46:54 CET [2016/02/11 6:46:54 ET]
Table 'Algedi' 9-max Seat #9 is the button
Seat 1: vlad11122007 ($55.80 in chips) 
Seat 2: Reffypaul ($63.74 in chips) 
Seat 3: Saggitaurus ($97.05 in chips) 
Seat 4: Effort92 ($60.11 in chips) 
Seat 6: TonnaMunz ($127.74 in chips) 
Seat 7: hoedtrob ($71.39 in chips) 
Seat 8: matiko09 ($50.50 in chips) 
Seat 9: Kud3 ($126.70 in chips) 
vlad11122007: posts small blind $0.25
Reffypaul: posts big blind $0.50
Optimistic21: sits out 
vlad11122007: posts the ante $0.10
Reffypaul: posts the ante $0.10
Saggitaurus: posts the ante $0.10
Effort92: posts the ante $0.10
TonnaMunz: posts the ante $0.10
hoedtrob: posts the ante $0.10
matiko09: posts the ante $0.10
Kud3: posts the ante $0.10
*** HOLE CARDS ***
Dealt to matiko09 [2c 2s]
Saggitaurus: raises $1 to $1.50
Effort92: folds 
TonnaMunz: folds 
hoedtrob: calls $1.50
matiko09: calls $1.50
Kud3: calls $1.50
vlad11122007: folds 
Reffypaul: calls $1
*** FLOP *** [Th 5h Qc]
Reffypaul: checks 
Saggitaurus: checks 
hoedtrob: bets $2
matiko09: folds 
Kud3: calls $2
Reffypaul: folds 
Saggitaurus: calls $2
*** TURN *** [Th 5h Qc] [Ah]
Saggitaurus: checks 
hoedtrob: bets $3.50
Kud3: folds 
Saggitaurus: raises $6 to $9.50
hoedtrob: calls $6
*** RIVER *** [Th 5h Qc Ah] [Qh]
Saggitaurus: bets $21.50
hoedtrob: folds 
Uncalled bet ($21.50) returned to Saggitaurus
Saggitaurus collected $32.04 from pot
Saggitaurus: doesn't show hand 
*** SUMMARY ***
Total pot $33.55 | Rake $1.51 
Board [Th 5h Qc Ah Qh]
Seat 1: vlad11122007 (small blind) folded before Flop
Seat 2: Reffypaul (big blind) folded on the Flop
Seat 3: Saggitaurus collected ($32.04)
Seat 4: Effort92 folded before Flop (didn't bet)
Seat 6: TonnaMunz folded before Flop (didn't bet)
Seat 7: hoedtrob folded on the River
Seat 8: matiko09 folded on the Flop
Seat 9: Kud3 (button) folded on the Turn





PokerStars Hand #148608098701:  Hold'em No Limit ($0.25/$0.50 USD) - 2016/02/11 12:47:04 CET [2016/02/11 6:47:04 ET]
Table 'Stereoskopia' 9-max Seat #4 is the button
Seat 1: 50CandyJoe ($51.15 in chips) 
Seat 2: Optimistic21 ($57 in chips) 
Seat 3: Donko jr ($18.56 in chips) 
Seat 4: King brid ($81.92 in chips) 
Seat 5: ReinisRNS ($30.48 in chips) 
Seat 6: matiko09 ($50 in chips) 
Seat 7: tallonn88 ($56.97 in chips) 
Seat 9: apfush ($100.75 in chips) 
ReinisRNS: posts small blind $0.25
matiko09: posts big blind $0.50
vlad11122007: sits out 
*** HOLE CARDS ***
Dealt to matiko09 [7s 7c]
tallonn88: folds 
apfush: folds 
50CandyJoe: folds 
Optimistic21: folds 
Donko jr: folds 
King brid has timed out
King brid: folds 
ReinisRNS: folds 
Uncalled bet ($0.25) returned to matiko09
matiko09 collected $0.50 from pot
matiko09: doesn't show hand 
*** SUMMARY ***
Total pot $0.50 | Rake $0 
Seat 1: 50CandyJoe folded before Flop (didn't bet)
Seat 2: Optimistic21 folded before Flop (didn't bet)
Seat 3: Donko jr folded before Flop (didn't bet)
Seat 4: King brid (button) folded before Flop (didn't bet)
Seat 5: ReinisRNS (small blind) folded before Flop
Seat 6: matiko09 (big blind) collected ($0.50)
Seat 7: tallonn88 folded before Flop (didn't bet)
Seat 9: apfush folded before Flop (didn't bet)





PokerStars Hand #148608100731:  Hold'em No Limit ($0.50/$1.00 USD) - 2016/02/11 12:47:08 CET [2016/02/11 6:47:08 ET]
Table 'Rasalas' 9-max Seat #8 is the button
Seat 2: azzad2007 ($101.82 in chips) 
Seat 3: Luck In Me ($100 in chips) 
Seat 4: Sweden_Pound ($103 in chips) 
Seat 6: DUkalisUA ($100 in chips) 
Seat 7: matiko09 ($100 in chips) 
Seat 8: gwwsb ($75.90 in chips) 
Tissue51 will be allowed to play after the button
azzad2007: posts small blind $0.50
Luck In Me: posts big blind $1
*** HOLE CARDS ***
Dealt to matiko09 [8s 3c]
Saggitaurus joins the table at seat #5 
Sweden_Pound: folds 
DUkalisUA: folds 
matiko09: folds 
gwwsb: folds 
maxxmeister leaves the table
hurtNCYDE joins the table at seat #9 
azzad2007: folds 
Uncalled bet ($0.50) returned to Luck In Me
Luck In Me collected $1 from pot
Luck In Me: doesn't show hand 
*** SUMMARY ***
Total pot $1 | Rake $0 
Seat 2: azzad2007 (small blind) folded before Flop
Seat 3: Luck In Me (big blind) collected ($1)
Seat 4: Sweden_Pound folded before Flop (didn't bet)
Seat 6: DUkalisUA folded before Flop (didn't bet)
Seat 7: matiko09 folded before Flop (didn't bet)
Seat 8: gwwsb (button) folded before Flop (didn't bet)





PokerStars Hand #148608100880:  Hold'em No Limit ($0.50/$1.00 USD) - 2016/02/11 12:47:08 CET [2016/02/11 6:47:08 ET]
Table 'Regor' 9-max Seat #3 is the button
Seat 1: matiko09 ($124.27 in chips) 
Seat 2: Luck In Me ($100.50 in chips) 
Seat 3: oscarleon ($153.17 in chips) 
Seat 4: Filojoes ($100 in chips) 
Seat 6: Dachish ($92.45 in chips) 
Seat 8: R3NZONIT3 ($54.16 in chips) 
Seat 9: CoolFireX ($145.14 in chips) 
Filojoes: posts small blind $0.50
chauyeuba: is sitting out 
Dachish: posts big blind $1
Sweden_Pound: sits out 
*** HOLE CARDS ***
Dealt to matiko09 [Qc 7h]
R3NZONIT3: folds 
CoolFireX: folds 
matiko09: folds 
Luck In Me: folds 
oscarleon: raises $2 to $3
Filojoes: folds 
Dachish: folds 
Uncalled bet ($2) returned to oscarleon
oscarleon collected $2.50 from pot
oscarleon: doesn't show hand 
*** SUMMARY ***
Total pot $2.50 | Rake $0 
Seat 1: matiko09 folded before Flop (didn't bet)
Seat 2: Luck In Me folded before Flop (didn't bet)
Seat 3: oscarleon (button) collected ($2.50)
Seat 4: Filojoes (small blind) folded before Flop
Seat 6: Dachish (big blind) folded before Flop
Seat 8: R3NZONIT3 folded before Flop (didn't bet)
Seat 9: CoolFireX folded before Flop (didn't bet)





PokerStars Hand #148608102663:  Hold'em No Limit ($0.50/$1.00 USD) - 2016/02/11 12:47:11 CET [2016/02/11 6:47:11 ET]
Table 'Sycorax II' 9-max Seat #1 is the button
Seat 1: Luck In Me ($153.72 in chips) 
Seat 2: Lujan87 ($115.99 in chips) 
Seat 4: Sweden_Pound ($100 in chips) 
Seat 5: Effort92 ($158.54 in chips) 
Seat 6: FluentFlows ($44.76 in chips) 
Seat 8: matiko09 ($256.46 in chips) 
Seat 9: mrfoldcall ($97.01 in chips) 
Lujan87: posts small blind $0.50
chauyeuba: is sitting out 
Sweden_Pound: posts big blind $1
PacPacBum: sits out 
*** HOLE CARDS ***
Dealt to matiko09 [6s Tc]
Effort92: folds 
FluentFlows: folds 
matiko09: folds 
mrfoldcall: folds 
Luck In Me: raises $1.50 to $2.50
Lujan87: folds 
Sweden_Pound: folds 
Uncalled bet ($1.50) returned to Luck In Me
Luck In Me collected $2.50 from pot
Luck In Me: doesn't show hand 
*** SUMMARY ***
Total pot $2.50 | Rake $0 
Seat 1: Luck In Me (button) collected ($2.50)
Seat 2: Lujan87 (small blind) folded before Flop
Seat 4: Sweden_Pound (big blind) folded before Flop
Seat 5: Effort92 folded before Flop (didn't bet)
Seat 6: FluentFlows folded before Flop (didn't bet)
Seat 8: matiko09 folded before Flop (didn't bet)
Seat 9: mrfoldcall folded before Flop (didn't bet)





PokerStars Hand #148608103425:  Hold'em No Limit ($0.25/$0.50 USD) - 2016/02/11 12:47:12 CET [2016/02/11 6:47:12 ET]
Table 'Ambrosia II' 9-max Seat #8 is the button
Seat 1: matiko09 ($50 in chips) 
Seat 2: TheMinion ($116.94 in chips) 
Seat 3: make6a ($47.99 in chips) 
Seat 6: Reven9er ($69.45 in chips) 
Seat 7: mexx1234 ($85.73 in chips) 
Seat 8: tallonn88 ($51.70 in chips) 
Seat 9: arctur17 ($67.34 in chips) 
arctur17: posts small blind $0.25
matiko09: posts big blind $0.50
RICKA16: sits out 
*** HOLE CARDS ***
Dealt to matiko09 [6d 8s]
TheMinion: folds 
make6a: raises $0.75 to $1.25
Reven9er: folds 
mexx1234: folds 
tallonn88: folds 
arctur17: folds 
matiko09: folds 
Uncalled bet ($0.75) returned to make6a
make6a collected $1.25 from pot
make6a: doesn't show hand 
*** SUMMARY ***
Total pot $1.25 | Rake $0 
Seat 1: matiko09 (big blind) folded before Flop
Seat 2: TheMinion folded before Flop (didn't bet)
Seat 3: make6a collected ($1.25)
Seat 6: Reven9er folded before Flop (didn't bet)
Seat 7: mexx1234 folded before Flop (didn't bet)
Seat 8: tallonn88 (button) folded before Flop (didn't bet)
Seat 9: arctur17 (small blind) folded before Flop





PokerStars Hand #148608104318:  Hold'em No Limit ($0.25/$0.50 USD) - 2016/02/11 12:47:14 CET [2016/02/11 6:47:14 ET]
Table 'Risha' 9-max Seat #4 is the button
Seat 1: Kud3 ($138.25 in chips) 
Seat 3: TuaaL ($52.92 in chips) 
Seat 4: matiko09 ($65.35 in chips) 
Seat 6: TonnaMunz ($71.14 in chips) 
TonnaMunz: posts small blind $0.25
Kud3: posts big blind $0.50
Kud3: posts the ante $0.10
TuaaL: posts the ante $0.10
matiko09: posts the ante $0.10
TonnaMunz: posts the ante $0.10
*** HOLE CARDS ***
Dealt to matiko09 [Ts Th]
TuaaL: calls $0.50
matiko09: raises $1.50 to $2
TonnaMunz: folds 
Kud3: calls $1.50
TuaaL: calls $1.50
*** FLOP *** [Qd Js As]
Kud3: checks 
TuaaL: bets $2.50
matiko09: folds 
Kud3: folds 
Uncalled bet ($2.50) returned to TuaaL
TuaaL collected $6.35 from pot
TuaaL: doesn't show hand 
*** SUMMARY ***
Total pot $6.65 | Rake $0.30 
Board [Qd Js As]
Seat 1: Kud3 (big blind) folded on the Flop
Seat 3: TuaaL collected ($6.35)
Seat 4: matiko09 (button) folded on the Flop
Seat 6: TonnaMunz (small blind) folded before Flop





PokerStars Hand #148608116746:  Hold'em No Limit (€0.25/€0.50 EUR) - 2016/02/11 12:47:36 CET [2016/02/11 6:47:36 ET]
Table 'Otero II' 9-max Seat #8 is the button
Seat 1: Nacho2556 (€49.34 in chips) 
Seat 2: make6a (€45.23 in chips) 
Seat 4: kram0909 (€6.72 in chips) 
Seat 5: vlad11122007 (€50.94 in chips) 
Seat 6: TonnaMunz (€54.79 in chips) 
Seat 7: PacPacBum (€58.02 in chips) 
Seat 8: matiko09 (€69.55 in chips) 
Seat 9: Optimistic21 (€71.50 in chips) 
Optimistic21: posts small blind €0.25
Nacho2556: posts big blind €0.50
Szevasztopol: sits out 
*** HOLE CARDS ***
Dealt to matiko09 [8s Kh]
make6a: folds 
kram0909: folds 
vlad11122007: folds 
TonnaMunz: folds 
PacPacBum: folds 
matiko09: raises €0.63 to €1.13
Optimistic21: folds 
Nacho2556: calls €0.63
*** FLOP *** [9d Ac 7h]
Nacho2556: bets €0.50
matiko09: folds 
Uncalled bet (€0.50) returned to Nacho2556
Nacho2556 collected €2.40 from pot
*** SUMMARY ***
Total pot €2.51 | Rake €0.11 
Board [9d Ac 7h]
Seat 1: Nacho2556 (big blind) collected (€2.40)
Seat 2: make6a folded before Flop (didn't bet)
Seat 4: kram0909 folded before Flop (didn't bet)
Seat 5: vlad11122007 folded before Flop (didn't bet)
Seat 6: TonnaMunz folded before Flop (didn't bet)
Seat 7: PacPacBum folded before Flop (didn't bet)
Seat 8: matiko09 (button) folded on the Flop
Seat 9: Optimistic21 (small blind) folded before Flop





PokerStars Hand #148608117374:  Hold'em No Limit ($0.25/$0.50 USD) - 2016/02/11 12:47:37 CET [2016/02/11 6:47:37 ET]
Table 'Ambrosia II' 9-max Seat #9 is the button
Seat 1: matiko09 ($50 in chips) 
Seat 2: TheMinion ($116.94 in chips) 
Seat 3: make6a ($48.74 in chips) 
Seat 6: Reven9er ($69.45 in chips) 
Seat 7: mexx1234 ($85.73 in chips) 
Seat 8: tallonn88 ($51.70 in chips) 
Seat 9: arctur17 ($67.09 in chips) 
matiko09: posts small blind $0.25
TheMinion: posts big blind $0.50
RICKA16: sits out 
*** HOLE CARDS ***
Dealt to matiko09 [Jh 7h]
make6a: raises $0.82 to $1.32
Reven9er: folds 
Ana.Satravca joins the table at seat #4 
Ana.Satravca leaves the table
mexx1234: folds 
tallonn88: folds 
arctur17: calls $1.32
matiko09: folds 
TheMinion: calls $0.82
*** FLOP *** [4h 5d 9c]
TheMinion: checks 
make6a: checks 
arctur17: checks 
*** TURN *** [4h 5d 9c] [8c]
TheMinion: checks 
make6a: checks 
arctur17: bets $2.50
huudk2016 joins the table at seat #4 
TheMinion: folds 
make6a: folds 
Uncalled bet ($2.50) returned to arctur17
arctur17 collected $4.02 from pot
arctur17: doesn't show hand 
*** SUMMARY ***
Total pot $4.21 | Rake $0.19 
Board [4h 5d 9c 8c]
Seat 1: matiko09 (small blind) folded before Flop
Seat 2: TheMinion (big blind) folded on the Turn
Seat 3: make6a folded on the Turn
Seat 6: Reven9er folded before Flop (didn't bet)
Seat 7: mexx1234 folded before Flop (didn't bet)
Seat 8: tallonn88 folded before Flop (didn't bet)
Seat 9: arctur17 (button) collected ($4.02)





PokerStars Hand #148608118273:  Hold'em No Limit ($0.50/$1.00 USD) - 2016/02/11 12:47:39 CET [2016/02/11 6:47:39 ET]
Table 'Sycorax II' 9-max Seat #2 is the button
Seat 1: Luck In Me ($155.22 in chips) 
Seat 2: Lujan87 ($115.49 in chips) 
Seat 4: Sweden_Pound ($100 in chips) 
Seat 5: Effort92 ($158.54 in chips) 
Seat 6: FluentFlows ($44.76 in chips) 
Seat 8: matiko09 ($256.46 in chips) 
Seat 9: mrfoldcall ($97.01 in chips) 
Sweden_Pound: posts small blind $0.50
Effort92: posts big blind $1
PacPacBum: sits out 
*** HOLE CARDS ***
Dealt to matiko09 [4c Th]
FluentFlows: folds 
matiko09: folds 
mrfoldcall: raises $2 to $3
Luck In Me: folds 
Lujan87: folds 
Sweden_Pound: folds 
Effort92: folds 
Uncalled bet ($2) returned to mrfoldcall
mrfoldcall collected $2.50 from pot
mrfoldcall: doesn't show hand 
*** SUMMARY ***
Total pot $2.50 | Rake $0 
Seat 1: Luck In Me folded before Flop (didn't bet)
Seat 2: Lujan87 (button) folded before Flop (didn't bet)
Seat 4: Sweden_Pound (small blind) folded before Flop
Seat 5: Effort92 (big blind) folded before Flop
Seat 6: FluentFlows folded before Flop (didn't bet)
Seat 8: matiko09 folded before Flop (didn't bet)
Seat 9: mrfoldcall collected ($2.50)





PokerStars Hand #148608120575:  Hold'em No Limit ($0.50/$1.00 USD) - 2016/02/11 12:47:43 CET [2016/02/11 6:47:43 ET]
Table 'Rasalas' 9-max Seat #2 is the button
Seat 2: azzad2007 ($101.32 in chips) 
Seat 3: Luck In Me ($100.50 in chips) 
Seat 4: Sweden_Pound ($103 in chips) 
Seat 6: DUkalisUA ($100 in chips) 
Seat 7: matiko09 ($100 in chips) 
Seat 8: gwwsb ($75.90 in chips) 
Luck In Me: posts small blind $0.50
Sweden_Pound: posts big blind $1
Saggitaurus: sits out 
hurtNCYDE: sits out 
Tissue51: sits out 
*** HOLE CARDS ***
Dealt to matiko09 [8d 2d]
DUkalisUA: folds 
matiko09: folds 
gwwsb: folds 
azzad2007: raises $1 to $2
Luck In Me: folds 
Sweden_Pound: calls $1
*** FLOP *** [4d 3s 7h]
Sweden_Pound: checks 
azzad2007: checks 
*** TURN *** [4d 3s 7h] [4s]
Sweden_Pound: checks 
azzad2007: checks 
*** RIVER *** [4d 3s 7h 4s] [Jh]
Sweden_Pound: checks 
azzad2007: bets $2.50
Sweden_Pound: folds 
Uncalled bet ($2.50) returned to azzad2007
azzad2007 collected $4.30 from pot
azzad2007: doesn't show hand 
*** SUMMARY ***
Total pot $4.50 | Rake $0.20 
Board [4d 3s 7h 4s Jh]
Seat 2: azzad2007 (button) collected ($4.30)
Seat 3: Luck In Me (small blind) folded before Flop
Seat 4: Sweden_Pound (big blind) folded on the River
Seat 6: DUkalisUA folded before Flop (didn't bet)
Seat 7: matiko09 folded before Flop (didn't bet)
Seat 8: gwwsb folded before Flop (didn't bet)





PokerStars Hand #148608124804:  Hold'em No Limit ($0.25/$0.50 USD) - 2016/02/11 12:47:50 CET [2016/02/11 6:47:50 ET]
Table 'Risha' 9-max Seat #6 is the button
Seat 1: Kud3 ($136.15 in chips) 
Seat 3: TuaaL ($57.17 in chips) 
Seat 4: matiko09 ($63.25 in chips) 
Seat 6: TonnaMunz ($70.79 in chips) 
Kud3: posts small blind $0.25
TuaaL: posts big blind $0.50
Kud3: posts the ante $0.10
TuaaL: posts the ante $0.10
matiko09: posts the ante $0.10
TonnaMunz: posts the ante $0.10
*** HOLE CARDS ***
Dealt to matiko09 [Kd 8h]
matiko09: folds 
TonnaMunz: raises $0.68 to $1.18
Kud3: folds 
TuaaL: calls $0.68
*** FLOP *** [Qc 7d Jh]
TuaaL: checks 
TonnaMunz: checks 
*** TURN *** [Qc 7d Jh] [Ad]
TuaaL: checks 
TonnaMunz: checks 
*** RIVER *** [Qc 7d Jh Ad] [Th]
TuaaL: checks 
TonnaMunz: bets $2.75
TuaaL: folds 
Uncalled bet ($2.75) returned to TonnaMunz
TonnaMunz collected $2.87 from pot
TonnaMunz: doesn't show hand 
*** SUMMARY ***
Total pot $3.01 | Rake $0.14 
Board [Qc 7d Jh Ad Th]
Seat 1: Kud3 (small blind) folded before Flop
Seat 3: TuaaL (big blind) folded on the River
Seat 4: matiko09 folded before Flop (didn't bet)
Seat 6: TonnaMunz (button) collected ($2.87)





PokerStars Hand #148608128178:  Hold'em No Limit ($0.50/$1.00 USD) - 2016/02/11 12:47:56 CET [2016/02/11 6:47:56 ET]
Table 'Regor' 9-max Seat #4 is the button
Seat 1: matiko09 ($124.27 in chips) 
Seat 2: Luck In Me ($100.50 in chips) 
Seat 3: oscarleon ($154.67 in chips) 
Seat 4: Filojoes ($100 in chips) 
Seat 6: Dachish ($91.45 in chips) 
Seat 7: Sweden_Pound ($100 in chips) 
Seat 8: R3NZONIT3 ($54.16 in chips) 
Seat 9: CoolFireX ($145.14 in chips) 
Dachish: posts small blind $0.50
Sweden_Pound: posts big blind $1
*** HOLE CARDS ***
Dealt to matiko09 [Ts 7s]
R3NZONIT3: folds 
CoolFireX: folds 
matiko09: folds 
Luck In Me: folds 
oscarleon: folds 
Filojoes: raises $1 to $2
Dachish: folds 
Sweden_Pound: folds 
Uncalled bet ($1) returned to Filojoes
Filojoes collected $2.50 from pot
Filojoes: doesn't show hand 
*** SUMMARY ***
Total pot $2.50 | Rake $0 
Seat 1: matiko09 folded before Flop (didn't bet)
Seat 2: Luck In Me folded before Flop (didn't bet)
Seat 3: oscarleon folded before Flop (didn't bet)
Seat 4: Filojoes (button) collected ($2.50)
Seat 6: Dachish (small blind) folded before Flop
Seat 7: Sweden_Pound (big blind) folded before Flop
Seat 8: R3NZONIT3 folded before Flop (didn't bet)
Seat 9: CoolFireX folded before Flop (didn't bet)





PokerStars Hand #148608137025:  Hold'em No Limit ($0.25/$0.50 USD) - 2016/02/11 12:48:12 CET [2016/02/11 6:48:12 ET]
Table 'Sylvania II' 9-max Seat #4 is the button
Seat 1: mexx1234 ($196.58 in chips) 
Seat 2: Effort92 ($51.40 in chips) 
Seat 3: ruyingren ($194.01 in chips) 
Seat 4: matiko09 ($156.14 in chips) 
Seat 5: vlad11122007 ($56.98 in chips) 
Seat 6: TonnaMunz ($127.86 in chips) 
Seat 7: i L00K great ($50 in chips) 
Seat 8: Optimistic21 ($50 in chips) 
Seat 9: Kud3 ($132.15 in chips) 
vlad11122007: posts small blind $0.25
TonnaMunz: posts big blind $0.50
mexx1234: posts the ante $0.10
Effort92: posts the ante $0.10
ruyingren: posts the ante $0.10
matiko09: posts the ante $0.10
vlad11122007: posts the ante $0.10
TonnaMunz: posts the ante $0.10
i L00K great: posts the ante $0.10
Optimistic21: posts the ante $0.10
Kud3: posts the ante $0.10
*** HOLE CARDS ***
Dealt to matiko09 [Js 6d]
i L00K great: folds 
Optimistic21: folds 
Kud3: folds 
mexx1234: folds 
Effort92: folds 
ruyingren: folds 
matiko09: folds 
vlad11122007: folds 
Uncalled bet ($0.25) returned to TonnaMunz
TonnaMunz collected $1.40 from pot
TonnaMunz: doesn't show hand 
*** SUMMARY ***
Total pot $1.40 | Rake $0 
Seat 1: mexx1234 folded before Flop (didn't bet)
Seat 2: Effort92 folded before Flop (didn't bet)
Seat 3: ruyingren folded before Flop (didn't bet)
Seat 4: matiko09 (button) folded before Flop (didn't bet)
Seat 5: vlad11122007 (small blind) folded before Flop
Seat 6: TonnaMunz (big blind) collected ($1.40)
Seat 7: i L00K great folded before Flop (didn't bet)
Seat 8: Optimistic21 folded before Flop (didn't bet)
Seat 9: Kud3 folded before Flop (didn't bet)





PokerStars Hand #148608137026:  Hold'em No Limit ($0.25/$0.50 USD) - 2016/02/11 12:48:12 CET [2016/02/11 6:48:12 ET]
Table 'Stereoskopia' 9-max Seat #5 is the button
Seat 1: 50CandyJoe ($51.15 in chips) 
Seat 2: Optimistic21 ($57 in chips) 
Seat 3: Donko jr ($18.56 in chips) 
Seat 5: ReinisRNS ($30.23 in chips) 
Seat 6: matiko09 ($50.25 in chips) 
Seat 7: tallonn88 ($56.97 in chips) 
Seat 9: apfush ($100.75 in chips) 
matiko09: posts small blind $0.25
tallonn88: posts big blind $0.50
vlad11122007: sits out 
*** HOLE CARDS ***
Dealt to matiko09 [5d 8c]
apfush: folds 
50CandyJoe: folds 
Optimistic21: folds 
Donko jr: raises $1 to $1.50
ReinisRNS: folds 
matiko09: folds 
tallonn88: folds 
Uncalled bet ($1) returned to Donko jr
Donko jr collected $1.25 from pot
*** SUMMARY ***
Total pot $1.25 | Rake $0 
Seat 1: 50CandyJoe folded before Flop (didn't bet)
Seat 2: Optimistic21 folded before Flop (didn't bet)
Seat 3: Donko jr collected ($1.25)
Seat 5: ReinisRNS (button) folded before Flop (didn't bet)
Seat 6: matiko09 (small blind) folded before Flop
Seat 7: tallonn88 (big blind) folded before Flop
Seat 9: apfush folded before Flop (didn't bet)





PokerStars Hand #148608142111:  Hold'em No Limit ($0.50/$1.00 USD) - 2016/02/11 12:48:21 CET [2016/02/11 6:48:21 ET]
Table 'Sycorax II' 9-max Seat #4 is the button
Seat 1: Luck In Me ($155.22 in chips) 
Seat 2: Lujan87 ($115.49 in chips) 
Seat 4: Sweden_Pound ($100 in chips) 
Seat 5: Effort92 ($157.54 in chips) 
Seat 6: FluentFlows ($44.76 in chips) 
Seat 8: matiko09 ($256.46 in chips) 
Seat 9: mrfoldcall ($98.51 in chips) 
Effort92: posts small blind $0.50
FluentFlows: posts big blind $1
PacPacBum: sits out 
*** HOLE CARDS ***
Dealt to matiko09 [5c Ts]
matiko09: folds 
mrfoldcall: folds 
Luck In Me: raises $2 to $3
Lujan87: folds 
Sweden_Pound: calls $3
Effort92: folds 
FluentFlows: folds 
*** FLOP *** [6h 4h 4d]
Luck In Me: bets $5
Sweden_Pound: calls $5
*** TURN *** [6h 4h 4d] [2c]
Luck In Me: bets $11.50
Sweden_Pound: folds 
Uncalled bet ($11.50) returned to Luck In Me
Luck In Me collected $16.71 from pot
Luck In Me: doesn't show hand 
*** SUMMARY ***
Total pot $17.50 | Rake $0.79 
Board [6h 4h 4d 2c]
Seat 1: Luck In Me collected ($16.71)
Seat 2: Lujan87 folded before Flop (didn't bet)
Seat 4: Sweden_Pound (button) folded on the Turn
Seat 5: Effort92 (small blind) folded before Flop
Seat 6: FluentFlows (big blind) folded before Flop
Seat 8: matiko09 folded before Flop (didn't bet)
Seat 9: mrfoldcall folded before Flop (didn't bet)





PokerStars Hand #148608148954:  Hold'em No Limit (€0.25/€0.50 EUR) - 2016/02/11 12:48:33 CET [2016/02/11 6:48:33 ET]
Table 'Otero II' 9-max Seat #9 is the button
Seat 1: Nacho2556 (€50.61 in chips) 
Seat 2: make6a (€45.23 in chips) 
Seat 4: kram0909 (€6.72 in chips) 
Seat 5: vlad11122007 (€50.94 in chips) 
Seat 6: TonnaMunz (€54.79 in chips) 
Seat 7: PacPacBum (€58.02 in chips) 
Seat 8: matiko09 (€68.42 in chips) 
Seat 9: Optimistic21 (€71.25 in chips) 
Nacho2556: posts small blind €0.25
make6a: posts big blind €0.50
Szevasztopol: sits out 
*** HOLE CARDS ***
Dealt to matiko09 [Qh 8d]
kram0909: folds 
vlad11122007: folds 
TonnaMunz: folds 
PacPacBum: folds 
matiko09: folds 
Optimistic21: folds 
Nacho2556: folds 
Uncalled bet (€0.25) returned to make6a
make6a collected €0.50 from pot
make6a: doesn't show hand 
*** SUMMARY ***
Total pot €0.50 | Rake €0 
Seat 1: Nacho2556 (small blind) folded before Flop
Seat 2: make6a (big blind) collected (€0.50)
Seat 4: kram0909 folded before Flop (didn't bet)
Seat 5: vlad11122007 folded before Flop (didn't bet)
Seat 6: TonnaMunz folded before Flop (didn't bet)
Seat 7: PacPacBum folded before Flop (didn't bet)
Seat 8: matiko09 folded before Flop (didn't bet)
Seat 9: Optimistic21 (button) folded before Flop (didn't bet)





PokerStars Hand #148608149271:  Hold'em No Limit ($0.25/$0.50 USD) - 2016/02/11 12:48:33 CET [2016/02/11 6:48:33 ET]
Table 'Ambrosia II' 9-max Seat #1 is the button
Seat 1: matiko09 ($50 in chips) 
Seat 2: TheMinion ($115.62 in chips) 
Seat 4: huudk2016 ($50 in chips) 
Seat 6: Reven9er ($69.45 in chips) 
Seat 7: mexx1234 ($85.73 in chips) 
Seat 8: tallonn88 ($51.70 in chips) 
Seat 9: arctur17 ($69.79 in chips) 
TheMinion: posts small blind $0.25
make6a: is sitting out 
huudk2016: posts big blind $0.50
RICKA16: sits out 
*** HOLE CARDS ***
Dealt to matiko09 [2d 2c]
Reven9er: folds 
mexx1234: folds 
tallonn88: raises $1 to $1.50
arctur17: folds 
matiko09: calls $1.50
TheMinion: folds 
huudk2016: calls $1
*** FLOP *** [9s 7h 5h]
huudk2016: bets $2.50
tallonn88: calls $2.50
matiko09: folds 
*** TURN *** [9s 7h 5h] [Kh]
huudk2016: checks 
tallonn88: bets $6.14
huudk2016: folds 
Uncalled bet ($6.14) returned to tallonn88
tallonn88 collected $9.31 from pot
tallonn88: doesn't show hand 
*** SUMMARY ***
Total pot $9.75 | Rake $0.44 
Board [9s 7h 5h Kh]
Seat 1: matiko09 (button) folded on the Flop
Seat 2: TheMinion (small blind) folded before Flop
Seat 4: huudk2016 (big blind) folded on the Turn
Seat 6: Reven9er folded before Flop (didn't bet)
Seat 7: mexx1234 folded before Flop (didn't bet)
Seat 8: tallonn88 collected ($9.31)
Seat 9: arctur17 folded before Flop (didn't bet)





PokerStars Hand #148608153521:  Hold'em No Limit ($0.25/$0.50 USD) - 2016/02/11 12:48:41 CET [2016/02/11 6:48:41 ET]
Table 'Risha' 9-max Seat #1 is the button
Seat 1: Kud3 ($135.80 in chips) 
Seat 3: TuaaL ($55.89 in chips) 
Seat 4: matiko09 ($63.15 in chips) 
Seat 6: TonnaMunz ($72.38 in chips) 
TuaaL: posts small blind $0.25
matiko09: posts big blind $0.50
Kud3: posts the ante $0.10
TuaaL: posts the ante $0.10
matiko09: posts the ante $0.10
TonnaMunz: posts the ante $0.10
*** HOLE CARDS ***
Dealt to matiko09 [3s Ac]
TonnaMunz: folds 
Kud3: folds 
TuaaL: calls $0.25
matiko09: checks 
*** FLOP *** [Ad 9h 4s]
TuaaL: checks 
matiko09: checks 
*** TURN *** [Ad 9h 4s] [Jh]
TuaaL: checks 
matiko09: bets $1
TuaaL: calls $1
*** RIVER *** [Ad 9h 4s Jh] [Js]
TuaaL: checks 
matiko09: checks 
*** SHOW DOWN ***
TuaaL: shows [5c 3h] (a pair of Jacks)
matiko09: shows [3s Ac] (two pair, Aces and Jacks)
matiko09 collected $3.25 from pot
*** SUMMARY ***
Total pot $3.40 | Rake $0.15 
Board [Ad 9h 4s Jh Js]
Seat 1: Kud3 (button) folded before Flop (didn't bet)
Seat 3: TuaaL (small blind) showed [5c 3h] and lost with a pair of Jacks
Seat 4: matiko09 (big blind) showed [3s Ac] and won ($3.25) with two pair, Aces and Jacks
Seat 6: TonnaMunz folded before Flop (didn't bet)





PokerStars Hand #148608154423:  Hold'em No Limit ($0.50/$1.00 USD) - 2016/02/11 12:48:42 CET [2016/02/11 6:48:42 ET]
Table 'Regor' 9-max Seat #6 is the button
Seat 1: matiko09 ($124.27 in chips) 
Seat 2: Luck In Me ($100.50 in chips) 
Seat 3: oscarleon ($154.67 in chips) 
Seat 4: Filojoes ($101.50 in chips) 
Seat 6: Dachish ($90.95 in chips) 
Seat 7: Sweden_Pound ($100 in chips) 
Seat 8: R3NZONIT3 ($54.16 in chips) 
Seat 9: CoolFireX ($145.14 in chips) 
Sweden_Pound: posts small blind $0.50
R3NZONIT3: posts big blind $1
*** HOLE CARDS ***
Dealt to matiko09 [Qd 3d]
CoolFireX: folds 
matiko09: folds 
Luck In Me: folds 
oscarleon: raises $2 to $3
Filojoes: folds 
Dachish: folds 
Sweden_Pound: folds 
R3NZONIT3: calls $2
*** FLOP *** [Th 7d Td]
R3NZONIT3: checks 
oscarleon: bets $5
R3NZONIT3: folds 
Uncalled bet ($5) returned to oscarleon
oscarleon collected $6.21 from pot
oscarleon: doesn't show hand 
*** SUMMARY ***
Total pot $6.50 | Rake $0.29 
Board [Th 7d Td]
Seat 1: matiko09 folded before Flop (didn't bet)
Seat 2: Luck In Me folded before Flop (didn't bet)
Seat 3: oscarleon collected ($6.21)
Seat 4: Filojoes folded before Flop (didn't bet)
Seat 6: Dachish (button) folded before Flop (didn't bet)
Seat 7: Sweden_Pound (small blind) folded before Flop
Seat 8: R3NZONIT3 (big blind) folded on the Flop
Seat 9: CoolFireX folded before Flop (didn't bet)





PokerStars Hand #148608154777:  Hold'em No Limit ($0.25/$0.50 USD) - 2016/02/11 12:48:43 CET [2016/02/11 6:48:43 ET]
Table 'Sylvania II' 9-max Seat #5 is the button
Seat 1: mexx1234 ($196.48 in chips) 
Seat 2: Effort92 ($51.30 in chips) 
Seat 3: ruyingren ($193.91 in chips) 
Seat 4: matiko09 ($156.04 in chips) 
Seat 5: vlad11122007 ($56.63 in chips) 
Seat 6: TonnaMunz ($128.91 in chips) 
Seat 7: i L00K great ($50 in chips) 
Seat 8: Optimistic21 ($50 in chips) 
Seat 9: Kud3 ($132.05 in chips) 
TonnaMunz: posts small blind $0.25
i L00K great: posts big blind $0.50
mexx1234: posts the ante $0.10
Effort92: posts the ante $0.10
ruyingren: posts the ante $0.10
matiko09: posts the ante $0.10
vlad11122007: posts the ante $0.10
TonnaMunz: posts the ante $0.10
i L00K great: posts the ante $0.10
Optimistic21: posts the ante $0.10
Kud3: posts the ante $0.10
*** HOLE CARDS ***
Dealt to matiko09 [Kc Tc]
Optimistic21: folds 
Kud3: folds 
mexx1234: folds 
Effort92: raises $1 to $1.50
ruyingren: folds 
matiko09: folds 
vlad11122007: raises $3 to $4.50
TonnaMunz: folds 
i L00K great: folds 
Effort92: calls $3
*** FLOP *** [3d 4c Kd]
Effort92: checks 
vlad11122007: bets $6.25
Effort92: calls $6.25
*** TURN *** [3d 4c Kd] [Qc]
Effort92: checks 
vlad11122007: checks 
*** RIVER *** [3d 4c Kd Qc] [Th]
Effort92: checks 
vlad11122007: checks 
*** SHOW DOWN ***
Effort92: shows [9d 9h] (a pair of Nines)
vlad11122007: shows [Js Qs] (a pair of Queens)
vlad11122007 collected $22.11 from pot
*** SUMMARY ***
Total pot $23.15 | Rake $1.04 
Board [3d 4c Kd Qc Th]
Seat 1: mexx1234 folded before Flop (didn't bet)
Seat 2: Effort92 showed [9d 9h] and lost with a pair of Nines
Seat 3: ruyingren folded before Flop (didn't bet)
Seat 4: matiko09 folded before Flop (didn't bet)
Seat 5: vlad11122007 (button) showed [Js Qs] and won ($22.11) with a pair of Queens
Seat 6: TonnaMunz (small blind) folded before Flop
Seat 7: i L00K great (big blind) folded before Flop
Seat 8: Optimistic21 folded before Flop (didn't bet)
Seat 9: Kud3 folded before Flop (didn't bet)





PokerStars Hand #148608162121:  Hold'em No Limit ($0.25/$0.50 USD) - 2016/02/11 12:48:56 CET [2016/02/11 6:48:56 ET]
Table 'Stereoskopia' 9-max Seat #6 is the button
Seat 1: 50CandyJoe ($51.15 in chips) 
Seat 2: Optimistic21 ($57 in chips) 
Seat 3: Donko jr ($19.31 in chips) 
Seat 5: ReinisRNS ($30.23 in chips) 
Seat 6: matiko09 ($50 in chips) 
Seat 7: tallonn88 ($56.47 in chips) 
Seat 8: vlad11122007 ($50 in chips) 
Seat 9: apfush ($100.75 in chips) 
tallonn88: posts small blind $0.25
vlad11122007: posts big blind $0.50
*** HOLE CARDS ***
Dealt to matiko09 [Ts 2c]
apfush: raises $1 to $1.50
50CandyJoe: folds 
Optimistic21: folds 
Donko jr: folds 
ReinisRNS: folds 
matiko09: folds 
tallonn88: folds 
vlad11122007: folds 
Uncalled bet ($1) returned to apfush
apfush collected $1.25 from pot
apfush: doesn't show hand 
*** SUMMARY ***
Total pot $1.25 | Rake $0 
Seat 1: 50CandyJoe folded before Flop (didn't bet)
Seat 2: Optimistic21 folded before Flop (didn't bet)
Seat 3: Donko jr folded before Flop (didn't bet)
Seat 5: ReinisRNS folded before Flop (didn't bet)
Seat 6: matiko09 (button) folded before Flop (didn't bet)
Seat 7: tallonn88 (small blind) folded before Flop
Seat 8: vlad11122007 (big blind) folded before Flop
Seat 9: apfush collected ($1.25)





PokerStars Hand #148608170007:  Hold'em No Limit (€0.25/€0.50 EUR) - 2016/02/11 12:49:10 CET [2016/02/11 6:49:10 ET]
Table 'Otero II' 9-max Seat #1 is the button
Seat 1: Nacho2556 (€50.36 in chips) 
Seat 2: make6a (€45.48 in chips) 
Seat 3: Szevasztopol (€50 in chips) 
Seat 4: kram0909 (€6.72 in chips) 
Seat 5: vlad11122007 (€50.94 in chips) 
Seat 6: TonnaMunz (€54.79 in chips) 
Seat 7: PacPacBum (€58.02 in chips) 
Seat 8: matiko09 (€68.42 in chips) 
Seat 9: Optimistic21 (€71.25 in chips) 
make6a: posts small blind €0.25
Szevasztopol: posts big blind €0.50
*** HOLE CARDS ***
Dealt to matiko09 [9s 8d]
kram0909 is disconnected 
kram0909 is connected 
kram0909: folds 
vlad11122007: raises €1 to €1.50
TonnaMunz: folds 
PacPacBum: folds 
matiko09: folds 
Optimistic21: folds 
Nacho2556: folds 
make6a: folds 
Szevasztopol: folds 
Uncalled bet (€1) returned to vlad11122007
vlad11122007 collected €1.25 from pot
vlad11122007: doesn't show hand 
*** SUMMARY ***
Total pot €1.25 | Rake €0 
Seat 1: Nacho2556 (button) folded before Flop (didn't bet)
Seat 2: make6a (small blind) folded before Flop
Seat 3: Szevasztopol (big blind) folded before Flop
Seat 4: kram0909 folded before Flop (didn't bet)
Seat 5: vlad11122007 collected (€1.25)
Seat 6: TonnaMunz folded before Flop (didn't bet)
Seat 7: PacPacBum folded before Flop (didn't bet)
Seat 8: matiko09 folded before Flop (didn't bet)
Seat 9: Optimistic21 folded before Flop (didn't bet)





PokerStars Hand #148608170853:  Hold'em No Limit ($0.50/$1.00 USD) - 2016/02/11 12:49:11 CET [2016/02/11 6:49:11 ET]
Table 'Rasalas' 9-max Seat #3 is the button
Seat 2: azzad2007 ($103.62 in chips) 
Seat 3: Luck In Me ($100 in chips) 
Seat 4: Sweden_Pound ($101 in chips) 
Seat 5: Saggitaurus ($100 in chips) 
Seat 6: DUkalisUA ($100 in chips) 
Seat 7: matiko09 ($100 in chips) 
Seat 8: gwwsb ($75.90 in chips) 
Sweden_Pound: posts small blind $0.50
Saggitaurus: posts big blind $1
hurtNCYDE: sits out 
Tissue51: sits out 
*** HOLE CARDS ***
Dealt to matiko09 [4h 7c]
DUkalisUA: folds 
matiko09: folds 
gwwsb: raises $1 to $2
azzad2007: folds 
Luck In Me: folds 
Sweden_Pound: folds 
Saggitaurus: folds 
Uncalled bet ($1) returned to gwwsb
gwwsb collected $2.50 from pot
gwwsb: doesn't show hand 
*** SUMMARY ***
Total pot $2.50 | Rake $0 
Seat 2: azzad2007 folded before Flop (didn't bet)
Seat 3: Luck In Me (button) folded before Flop (didn't bet)
Seat 4: Sweden_Pound (small blind) folded before Flop
Seat 5: Saggitaurus (big blind) folded before Flop
Seat 6: DUkalisUA folded before Flop (didn't bet)
Seat 7: matiko09 folded before Flop (didn't bet)
Seat 8: gwwsb collected ($2.50)





PokerStars Hand #148608175869:  Hold'em No Limit ($0.25/$0.50 USD) - 2016/02/11 12:49:20 CET [2016/02/11 6:49:20 ET]
Table 'Stereoskopia' 9-max Seat #7 is the button
Seat 1: 50CandyJoe ($51.15 in chips) 
Seat 2: Optimistic21 ($57 in chips) 
Seat 3: Donko jr ($19.31 in chips) 
Seat 5: ReinisRNS ($30.23 in chips) 
Seat 6: matiko09 ($50 in chips) 
Seat 7: tallonn88 ($56.22 in chips) 
Seat 8: vlad11122007 ($49.50 in chips) 
Seat 9: apfush ($101.50 in chips) 
vlad11122007: posts small blind $0.25
apfush: posts big blind $0.50
*** HOLE CARDS ***
Dealt to matiko09 [7d 8h]
50CandyJoe: folds 
Optimistic21: folds 
Donko jr: raises $1 to $1.50
ReinisRNS: folds 
matiko09: folds 
tallonn88: folds 
vlad11122007: folds 
apfush: raises $7 to $8.50
Donko jr: raises $10.81 to $19.31 and is all-in
apfush: calls $10.81
*** FLOP *** [6d Jc Qs]
*** TURN *** [6d Jc Qs] [8d]
*** RIVER *** [6d Jc Qs 8d] [4d]
*** SHOW DOWN ***
apfush: shows [As Kd] (high card Ace)
Donko jr: shows [6c 6h] (three of a kind, Sixes)
Donko jr collected $37.12 from pot
*** SUMMARY ***
Total pot $38.87 | Rake $1.75 
Board [6d Jc Qs 8d 4d]
Seat 1: 50CandyJoe folded before Flop (didn't bet)
Seat 2: Optimistic21 folded before Flop (didn't bet)
Seat 3: Donko jr showed [6c 6h] and won ($37.12) with three of a kind, Sixes
Seat 5: ReinisRNS folded before Flop (didn't bet)
Seat 6: matiko09 folded before Flop (didn't bet)
Seat 7: tallonn88 (button) folded before Flop (didn't bet)
Seat 8: vlad11122007 (small blind) folded before Flop
Seat 9: apfush (big blind) showed [As Kd] and lost with high card Ace





PokerStars Hand #148608178810:  Hold'em No Limit ($0.25/$0.50 USD) - 2016/02/11 12:49:25 CET [2016/02/11 6:49:25 ET]
Table 'Risha' 9-max Seat #3 is the button
Seat 1: Kud3 ($135.70 in chips) 
Seat 3: TuaaL ($54.29 in chips) 
Seat 4: matiko09 ($64.80 in chips) 
Seat 6: TonnaMunz ($72.28 in chips) 
matiko09: posts small blind $0.25
TonnaMunz: posts big blind $0.50
Kud3: posts the ante $0.10
TuaaL: posts the ante $0.10
matiko09: posts the ante $0.10
TonnaMunz: posts the ante $0.10
*** HOLE CARDS ***
Dealt to matiko09 [8s Jc]
Kud3: raises $1 to $1.50
TuaaL: calls $1.50
matiko09: folds 
TonnaMunz: folds 
*** FLOP *** [Qd Jd 7d]
Kud3: checks 
TuaaL: bets $2.50
Kud3: calls $2.50
*** TURN *** [Qd Jd 7d] [Kd]
Kud3: checks 
TuaaL: bets $3
Kud3: calls $3
*** RIVER *** [Qd Jd 7d Kd] [3d]
Kud3: checks 
TuaaL: bets $4.50
Kud3: calls $4.50
*** SHOW DOWN ***
TuaaL: shows [Qs Qh] (a flush, King high)
Kud3: shows [6d 6h] (a flush, King high - Six higher)
Kud3 collected $23.06 from pot
*** SUMMARY ***
Total pot $24.15 | Rake $1.09 
Board [Qd Jd 7d Kd 3d]
Seat 1: Kud3 showed [6d 6h] and won ($23.06) with a flush, King high
Seat 3: TuaaL (button) showed [Qs Qh] and lost with a flush, King high
Seat 4: matiko09 (small blind) folded before Flop
Seat 6: TonnaMunz (big blind) folded before Flop





PokerStars Hand #148608193586:  Hold'em No Limit ($0.50/$1.00 USD) - 2016/02/11 12:49:51 CET [2016/02/11 6:49:51 ET]
Table 'Sycorax II' 9-max Seat #5 is the button
Seat 1: Luck In Me ($163.93 in chips) 
Seat 2: Lujan87 ($115.49 in chips) 
Seat 4: Sweden_Pound ($100 in chips) 
Seat 5: Effort92 ($157.04 in chips) 
Seat 6: FluentFlows ($43.76 in chips) 
Seat 7: PacPacBum ($116.71 in chips) 
Seat 8: matiko09 ($256.46 in chips) 
Seat 9: mrfoldcall ($98.51 in chips) 
FluentFlows: posts small blind $0.50
PacPacBum: posts big blind $1
*** HOLE CARDS ***
Dealt to matiko09 [4s Ks]
matiko09: folds 
mrfoldcall: folds 
Luck In Me: raises $2 to $3
Lujan87: folds 
Sweden_Pound: folds 
Effort92: folds 
FluentFlows: folds 
PacPacBum: folds 
Uncalled bet ($2) returned to Luck In Me
Luck In Me collected $2.50 from pot
Luck In Me: doesn't show hand 
*** SUMMARY ***
Total pot $2.50 | Rake $0 
Seat 1: Luck In Me collected ($2.50)
Seat 2: Lujan87 folded before Flop (didn't bet)
Seat 4: Sweden_Pound folded before Flop (didn't bet)
Seat 5: Effort92 (button) folded before Flop (didn't bet)
Seat 6: FluentFlows (small blind) folded before Flop
Seat 7: PacPacBum (big blind) folded before Flop
Seat 8: matiko09 folded before Flop (didn't bet)
Seat 9: mrfoldcall folded before Flop (didn't bet)





PokerStars Hand #148608194280:  Hold'em No Limit ($0.50/$1.00 USD) - 2016/02/11 12:49:52 CET [2016/02/11 6:49:52 ET]
Table 'Rasalas' 9-max Seat #4 is the button
Seat 2: azzad2007 ($103.62 in chips) 
Seat 3: Luck In Me ($100 in chips) 
Seat 4: Sweden_Pound ($100.50 in chips) 
Seat 5: Saggitaurus ($99 in chips) 
Seat 6: DUkalisUA ($100 in chips) 
Seat 7: matiko09 ($100 in chips) 
Seat 8: gwwsb ($77.40 in chips) 
Saggitaurus: posts small blind $0.50
DUkalisUA: posts big blind $1
hurtNCYDE: sits out 
Tissue51: sits out 
*** HOLE CARDS ***
Dealt to matiko09 [3s 6s]
matiko09: folds 
gwwsb: folds 
azzad2007: folds 
Luck In Me: folds 
Sweden_Pound: folds 
Saggitaurus: folds 
Uncalled bet ($0.50) returned to DUkalisUA
DUkalisUA collected $1 from pot
DUkalisUA: doesn't show hand 
*** SUMMARY ***
Total pot $1 | Rake $0 
Seat 2: azzad2007 folded before Flop (didn't bet)
Seat 3: Luck In Me folded before Flop (didn't bet)
Seat 4: Sweden_Pound (button) folded before Flop (didn't bet)
Seat 5: Saggitaurus (small blind) folded before Flop
Seat 6: DUkalisUA (big blind) collected ($1)
Seat 7: matiko09 folded before Flop (didn't bet)
Seat 8: gwwsb folded before Flop (didn't bet)





PokerStars Hand #148608194056:  Hold'em No Limit ($0.50/$1.00 USD) - 2016/02/11 12:49:52 CET [2016/02/11 6:49:52 ET]
Table 'Regor' 9-max Seat #7 is the button
Seat 1: matiko09 ($124.27 in chips) 
Seat 2: Luck In Me ($100.50 in chips) 
Seat 3: oscarleon ($157.88 in chips) 
Seat 4: Filojoes ($101.50 in chips) 
Seat 6: Dachish ($90.95 in chips) 
Seat 7: Sweden_Pound ($100 in chips) 
Seat 8: R3NZONIT3 ($51.16 in chips) 
Seat 9: CoolFireX ($145.14 in chips) 
R3NZONIT3: posts small blind $0.50
CoolFireX: posts big blind $1
*** HOLE CARDS ***
Dealt to matiko09 [8s Kd]
matiko09: folds 
Luck In Me: folds 
oscarleon: folds 
Filojoes: folds 
Dachish: raises $1 to $2
Sweden_Pound: folds 
R3NZONIT3: folds 
CoolFireX: raises $7 to $9
Dachish: folds 
Uncalled bet ($7) returned to CoolFireX
CoolFireX collected $4.50 from pot
CoolFireX: doesn't show hand 
*** SUMMARY ***
Total pot $4.50 | Rake $0 
Seat 1: matiko09 folded before Flop (didn't bet)
Seat 2: Luck In Me folded before Flop (didn't bet)
Seat 3: oscarleon folded before Flop (didn't bet)
Seat 4: Filojoes folded before Flop (didn't bet)
Seat 6: Dachish folded before Flop
Seat 7: Sweden_Pound (button) folded before Flop (didn't bet)
Seat 8: R3NZONIT3 (small blind) folded before Flop
Seat 9: CoolFireX (big blind) collected ($4.50)





PokerStars Hand #148608196709:  Hold'em No Limit ($0.25/$0.50 USD) - 2016/02/11 12:49:57 CET [2016/02/11 6:49:57 ET]
Table 'Algedi' 9-max Seat #1 is the button
Seat 1: vlad11122007 ($55.45 in chips) 
Seat 2: Reffypaul ($62.14 in chips) 
Seat 3: Saggitaurus ($115.99 in chips) 
Seat 4: Effort92 ($60.01 in chips) 
Seat 6: TonnaMunz ($127.64 in chips) 
Seat 7: hoedtrob ($58.29 in chips) 
Seat 8: matiko09 ($50 in chips) 
Seat 9: Kud3 ($125 in chips) 
Reffypaul: posts small blind $0.25
Saggitaurus: posts big blind $0.50
Optimistic21: sits out 
vlad11122007: posts the ante $0.10
Reffypaul: posts the ante $0.10
Saggitaurus: posts the ante $0.10
Effort92: posts the ante $0.10
TonnaMunz: posts the ante $0.10
hoedtrob: posts the ante $0.10
matiko09: posts the ante $0.10
Kud3: posts the ante $0.10
*** HOLE CARDS ***
Dealt to matiko09 [4h 7h]
Effort92: folds 
TonnaMunz: folds 
hoedtrob: folds 
hoedtrob said, "QA?"
matiko09: folds 
Kud3: raises $1 to $1.50
vlad11122007: folds 
Reffypaul: folds 
Saggitaurus: folds 
Uncalled bet ($1) returned to Kud3
Kud3 collected $2.05 from pot
Kud3: doesn't show hand 
*** SUMMARY ***
Total pot $2.05 | Rake $0 
Seat 1: vlad11122007 (button) folded before Flop (didn't bet)
Seat 2: Reffypaul (small blind) folded before Flop
Seat 3: Saggitaurus (big blind) folded before Flop
Seat 4: Effort92 folded before Flop (didn't bet)
Seat 6: TonnaMunz folded before Flop (didn't bet)
Seat 7: hoedtrob folded before Flop (didn't bet)
Seat 8: matiko09 folded before Flop (didn't bet)
Seat 9: Kud3 collected ($2.05)





PokerStars Hand #148608197700:  Hold'em No Limit ($0.25/$0.50 USD) - 2016/02/11 12:49:58 CET [2016/02/11 6:49:58 ET]
Table 'Risha' 9-max Seat #4 is the button
Seat 1: Kud3 ($147.16 in chips) 
Seat 3: TuaaL ($42.69 in chips) 
Seat 4: matiko09 ($64.45 in chips) 
Seat 6: TonnaMunz ($71.68 in chips) 
TonnaMunz: posts small blind $0.25
Kud3: posts big blind $0.50
Kud3: posts the ante $0.10
TuaaL: posts the ante $0.10
matiko09: posts the ante $0.10
TonnaMunz: posts the ante $0.10
*** HOLE CARDS ***
Dealt to matiko09 [9s 8s]
TuaaL: raises $42.09 to $42.59 and is all-in
matiko09: folds 
TonnaMunz: folds 
Kud3: folds 
Uncalled bet ($42.09) returned to TuaaL
TuaaL collected $1.65 from pot
TuaaL: doesn't show hand 
*** SUMMARY ***
Total pot $1.65 | Rake $0 
Seat 1: Kud3 (big blind) folded before Flop
Seat 3: TuaaL collected ($1.65)
Seat 4: matiko09 (button) folded before Flop (didn't bet)
Seat 6: TonnaMunz (small blind) folded before Flop





PokerStars Hand #148608197274:  Hold'em No Limit ($0.25/$0.50 USD) - 2016/02/11 12:49:58 CET [2016/02/11 6:49:58 ET]
Table 'Ambrosia II' 9-max Seat #2 is the button
Seat 1: matiko09 ($50 in chips) 
Seat 2: TheMinion ($115.37 in chips) 
Seat 4: huudk2016 ($46 in chips) 
Seat 5: RICKA16 ($50 in chips) 
Seat 6: Reven9er ($69.45 in chips) 
Seat 7: mexx1234 ($85.73 in chips) 
Seat 8: tallonn88 ($57.01 in chips) 
Seat 9: arctur17 ($69.79 in chips) 
make6a will be allowed to play after the button
huudk2016: posts small blind $0.25
RICKA16: posts big blind $0.50
*** HOLE CARDS ***
Dealt to matiko09 [3d 6s]
Reven9er: folds 
mexx1234: folds 
tallonn88: raises $1 to $1.50
arctur17: folds 
matiko09: folds 
TheMinion: folds 
huudk2016: folds 
RICKA16: folds 
Uncalled bet ($1) returned to tallonn88
tallonn88 collected $1.25 from pot
tallonn88: doesn't show hand 
*** SUMMARY ***
Total pot $1.25 | Rake $0 
Seat 1: matiko09 folded before Flop (didn't bet)
Seat 2: TheMinion (button) folded before Flop (didn't bet)
Seat 4: huudk2016 (small blind) folded before Flop
Seat 5: RICKA16 (big blind) folded before Flop
Seat 6: Reven9er folded before Flop (didn't bet)
Seat 7: mexx1234 folded before Flop (didn't bet)
Seat 8: tallonn88 collected ($1.25)
Seat 9: arctur17 folded before Flop (didn't bet)





PokerStars Hand #148608205327:  Hold'em No Limit ($0.25/$0.50 USD) - 2016/02/11 12:50:12 CET [2016/02/11 6:50:12 ET]
Table 'Risha' 9-max Seat #6 is the button
Seat 1: Kud3 ($146.56 in chips) 
Seat 3: TuaaL ($43.74 in chips) 
Seat 4: matiko09 ($64.35 in chips) 
Seat 6: TonnaMunz ($71.33 in chips) 
Kud3: posts small blind $0.25
TuaaL: posts big blind $0.50
Kud3: posts the ante $0.10
TuaaL: posts the ante $0.10
matiko09: posts the ante $0.10
TonnaMunz: posts the ante $0.10
*** HOLE CARDS ***
Dealt to matiko09 [Td 6d]
matiko09: folds 
TonnaMunz: raises $0.68 to $1.18
Kud3: folds 
TuaaL: folds 
Uncalled bet ($0.68) returned to TonnaMunz
TonnaMunz collected $1.65 from pot
TonnaMunz: doesn't show hand 
*** SUMMARY ***
Total pot $1.65 | Rake $0 
Seat 1: Kud3 (small blind) folded before Flop
Seat 3: TuaaL (big blind) folded before Flop
Seat 4: matiko09 folded before Flop (didn't bet)
Seat 6: TonnaMunz (button) collected ($1.65)





PokerStars Hand #148608205352:  Hold'em No Limit ($0.25/$0.50 USD) - 2016/02/11 12:50:12 CET [2016/02/11 6:50:12 ET]
Table 'Sylvania II' 9-max Seat #6 is the button
Seat 1: mexx1234 ($196.38 in chips) 
Seat 2: Effort92 ($50 in chips) 
Seat 3: ruyingren ($193.81 in chips) 
Seat 4: matiko09 ($155.94 in chips) 
Seat 5: vlad11122007 ($67.89 in chips) 
Seat 6: TonnaMunz ($128.56 in chips) 
Seat 7: i L00K great ($50 in chips) 
Seat 8: Optimistic21 ($50 in chips) 
Seat 9: Kud3 ($131.95 in chips) 
i L00K great: posts small blind $0.25
Optimistic21: posts big blind $0.50
mexx1234: posts the ante $0.10
Effort92: posts the ante $0.10
ruyingren: posts the ante $0.10
matiko09: posts the ante $0.10
vlad11122007: posts the ante $0.10
TonnaMunz: posts the ante $0.10
i L00K great: posts the ante $0.10
Optimistic21: posts the ante $0.10
Kud3: posts the ante $0.10
*** HOLE CARDS ***
Dealt to matiko09 [Qd 5d]
Kud3: folds 
mexx1234: folds 
Effort92: raises $1 to $1.50
ruyingren: calls $1.50
matiko09: folds 
vlad11122007: folds 
TonnaMunz: folds 
i L00K great: folds 
Optimistic21: raises $6 to $7.50
Effort92: raises $6 to $13.50
ruyingren: folds 
Optimistic21: folds 
Uncalled bet ($6) returned to Effort92
Effort92 collected $17.65 from pot
Effort92: doesn't show hand 
*** SUMMARY ***
Total pot $17.65 | Rake $0 
Seat 1: mexx1234 folded before Flop (didn't bet)
Seat 2: Effort92 collected ($17.65)
Seat 3: ruyingren folded before Flop
Seat 4: matiko09 folded before Flop (didn't bet)
Seat 5: vlad11122007 folded before Flop (didn't bet)
Seat 6: TonnaMunz (button) folded before Flop (didn't bet)
Seat 7: i L00K great (small blind) folded before Flop
Seat 8: Optimistic21 (big blind) folded before Flop
Seat 9: Kud3 folded before Flop (didn't bet)





PokerStars Hand #148608206598:  Hold'em No Limit ($0.50/$1.00 USD) - 2016/02/11 12:50:14 CET [2016/02/11 6:50:14 ET]
Table 'Rasalas' 9-max Seat #5 is the button
Seat 2: azzad2007 ($103.62 in chips) 
Seat 3: Luck In Me ($100 in chips) 
Seat 4: Sweden_Pound ($100.50 in chips) 
Seat 5: Saggitaurus ($98.50 in chips) 
Seat 6: DUkalisUA ($100.50 in chips) 
Seat 7: matiko09 ($100 in chips) 
Seat 8: gwwsb ($77.40 in chips) 
DUkalisUA: posts small blind $0.50
matiko09: posts big blind $1
hurtNCYDE: sits out 
Tissue51: sits out 
*** HOLE CARDS ***
Dealt to matiko09 [Kh Tc]
gwwsb: folds 
azzad2007: folds 
Luck In Me: folds 
Sweden_Pound: folds 
Saggitaurus: raises $1.50 to $2.50
DUkalisUA: folds 
matiko09: calls $1.50
*** FLOP *** [2h Ac Kd]
matiko09: checks 
Saggitaurus: bets $2.62
matiko09: calls $2.62
*** TURN *** [2h Ac Kd] [5h]
matiko09: checks 
Saggitaurus: bets $7
matiko09: folds 
Uncalled bet ($7) returned to Saggitaurus
Saggitaurus collected $10.26 from pot
Saggitaurus: doesn't show hand 
*** SUMMARY ***
Total pot $10.74 | Rake $0.48 
Board [2h Ac Kd 5h]
Seat 2: azzad2007 folded before Flop (didn't bet)
Seat 3: Luck In Me folded before Flop (didn't bet)
Seat 4: Sweden_Pound folded before Flop (didn't bet)
Seat 5: Saggitaurus (button) collected ($10.26)
Seat 6: DUkalisUA (small blind) folded before Flop
Seat 7: matiko09 (big blind) folded on the Turn
Seat 8: gwwsb folded before Flop (didn't bet)





PokerStars Hand #148608208779:  Hold'em No Limit (€0.25/€0.50 EUR) - 2016/02/11 12:50:18 CET [2016/02/11 6:50:18 ET]
Table 'Otero II' 9-max Seat #2 is the button
Seat 1: Nacho2556 (€50.36 in chips) 
Seat 2: make6a (€45.23 in chips) 
Seat 3: Szevasztopol (€50 in chips) 
Seat 4: kram0909 (€6.72 in chips) 
Seat 5: vlad11122007 (€51.69 in chips) 
Seat 6: TonnaMunz (€54.79 in chips) 
Seat 7: PacPacBum (€58.02 in chips) 
Seat 8: matiko09 (€68.42 in chips) 
Seat 9: Optimistic21 (€71.25 in chips) 
Szevasztopol: posts small blind €0.25
kram0909: posts big blind €0.50
*** HOLE CARDS ***
Dealt to matiko09 [Qc Tc]
vlad11122007: folds 
TonnaMunz: folds 
PacPacBum: folds 
matiko09: raises €1 to €1.50
Optimistic21: folds 
Nacho2556: folds 
make6a: folds 
Szevasztopol: folds 
kram0909: calls €1
*** FLOP *** [6h 2d Js]
kram0909: checks 
matiko09: checks 
*** TURN *** [6h 2d Js] [Td]
kram0909: bets €0.50
matiko09: calls €0.50
*** RIVER *** [6h 2d Js Td] [Jc]
kram0909: bets €0.50
matiko09: calls €0.50
*** SHOW DOWN ***
kram0909: shows [Ah 4d] (a pair of Jacks)
matiko09: shows [Qc Tc] (two pair, Jacks and Tens)
matiko09 collected €5.01 from pot
*** SUMMARY ***
Total pot €5.25 | Rake €0.24 
Board [6h 2d Js Td Jc]
Seat 1: Nacho2556 folded before Flop (didn't bet)
Seat 2: make6a (button) folded before Flop (didn't bet)
Seat 3: Szevasztopol (small blind) folded before Flop
Seat 4: kram0909 (big blind) showed [Ah 4d] and lost with a pair of Jacks
Seat 5: vlad11122007 folded before Flop (didn't bet)
Seat 6: TonnaMunz folded before Flop (didn't bet)
Seat 7: PacPacBum folded before Flop (didn't bet)
Seat 8: matiko09 showed [Qc Tc] and won (€5.01) with two pair, Jacks and Tens
Seat 9: Optimistic21 folded before Flop (didn't bet)





PokerStars Hand #148608211514:  Hold'em No Limit ($0.25/$0.50 USD) - 2016/02/11 12:50:23 CET [2016/02/11 6:50:23 ET]
Table 'Risha' 9-max Seat #1 is the button
Seat 1: Kud3 ($146.21 in chips) 
Seat 3: TuaaL ($43.14 in chips) 
Seat 4: matiko09 ($64.25 in chips) 
Seat 6: TonnaMunz ($72.38 in chips) 
TuaaL: posts small blind $0.25
matiko09: posts big blind $0.50
Kud3: posts the ante $0.10
TuaaL: posts the ante $0.10
matiko09: posts the ante $0.10
TonnaMunz: posts the ante $0.10
*** HOLE CARDS ***
Dealt to matiko09 [3d 8c]
TonnaMunz: folds 
Kud3: raises $0.75 to $1.25
TuaaL: calls $1
matiko09: folds 
*** FLOP *** [Jh 4d 2c]
TuaaL: checks 
Kud3: bets $1.72
TuaaL: folds 
Uncalled bet ($1.72) returned to Kud3
Kud3 collected $3.25 from pot
Kud3: doesn't show hand 
*** SUMMARY ***
Total pot $3.40 | Rake $0.15 
Board [Jh 4d 2c]
Seat 1: Kud3 (button) collected ($3.25)
Seat 3: TuaaL (small blind) folded on the Flop
Seat 4: matiko09 (big blind) folded before Flop
Seat 6: TonnaMunz folded before Flop (didn't bet)





PokerStars Hand #148608213000:  Hold'em No Limit ($0.50/$1.00 USD) - 2016/02/11 12:50:25 CET [2016/02/11 6:50:25 ET]
Table 'Sycorax II' 9-max Seat #6 is the button
Seat 1: Luck In Me ($165.43 in chips) 
Seat 2: Lujan87 ($115.49 in chips) 
Seat 4: Sweden_Pound ($100 in chips) 
Seat 5: Effort92 ($157.04 in chips) 
Seat 6: FluentFlows ($43.26 in chips) 
Seat 7: PacPacBum ($115.71 in chips) 
Seat 8: matiko09 ($256.46 in chips) 
Seat 9: mrfoldcall ($98.51 in chips) 
PacPacBum: posts small blind $0.50
matiko09: posts big blind $1
*** HOLE CARDS ***
Dealt to matiko09 [2d 2s]
mrfoldcall: folds 
Luck In Me: folds 
Lujan87: raises $2 to $3
Sweden_Pound: folds 
Effort92: calls $3
FluentFlows: folds 
PacPacBum: raises $9 to $12
matiko09: folds 
Lujan87: folds 
Effort92: folds 
Uncalled bet ($9) returned to PacPacBum
PacPacBum collected $10 from pot
PacPacBum: doesn't show hand 
*** SUMMARY ***
Total pot $10 | Rake $0 
Seat 1: Luck In Me folded before Flop (didn't bet)
Seat 2: Lujan87 folded before Flop
Seat 4: Sweden_Pound folded before Flop (didn't bet)
Seat 5: Effort92 folded before Flop
Seat 6: FluentFlows (button) folded before Flop (didn't bet)
Seat 7: PacPacBum (small blind) collected ($10)
Seat 8: matiko09 (big blind) folded before Flop
Seat 9: mrfoldcall folded before Flop (didn't bet)





PokerStars Hand #148608216744:  Hold'em No Limit ($0.25/$0.50 USD) - 2016/02/11 12:50:32 CET [2016/02/11 6:50:32 ET]
Table 'Ambrosia II' 9-max Seat #4 is the button
Seat 1: matiko09 ($50 in chips) 
Seat 2: TheMinion ($115.37 in chips) 
Seat 4: huudk2016 ($45.75 in chips) 
Seat 5: RICKA16 ($49.50 in chips) 
Seat 6: Reven9er ($69.45 in chips) 
Seat 7: mexx1234 ($85.73 in chips) 
Seat 8: tallonn88 ($57.76 in chips) 
Seat 9: arctur17 ($69.79 in chips) 
RICKA16: posts small blind $0.25
Reven9er: posts big blind $0.50
make6a: sits out 
*** HOLE CARDS ***
Dealt to matiko09 [Js 7c]
mexx1234: folds 
tallonn88: folds 
arctur17: folds 
matiko09: folds 
TheMinion: raises $0.75 to $1.25
huudk2016: calls $1.25
RICKA16: folds 
Reven9er: calls $0.75
*** FLOP *** [Tc Qh 5h]
Reven9er: checks 
TheMinion: checks 
huudk2016: checks 
*** TURN *** [Tc Qh 5h] [Qc]
Reven9er: checks 
TheMinion: checks 
huudk2016: checks 
*** RIVER *** [Tc Qh 5h Qc] [8c]
Reven9er: checks 
TheMinion: checks 
huudk2016: checks 
*** SHOW DOWN ***
Reven9er: shows [Qs 2s] (three of a kind, Queens)
TheMinion: mucks hand 
huudk2016: mucks hand 
Reven9er collected $3.82 from pot
*** SUMMARY ***
Total pot $4 | Rake $0.18 
Board [Tc Qh 5h Qc 8c]
Seat 1: matiko09 folded before Flop (didn't bet)
Seat 2: TheMinion mucked [3s As]
Seat 4: huudk2016 (button) mucked [2h 2c]
Seat 5: RICKA16 (small blind) folded before Flop
Seat 6: Reven9er (big blind) showed [Qs 2s] and won ($3.82) with three of a kind, Queens
Seat 7: mexx1234 folded before Flop (didn't bet)
Seat 8: tallonn88 folded before Flop (didn't bet)
Seat 9: arctur17 folded before Flop (didn't bet)





PokerStars Hand #148608217849:  Hold'em No Limit ($0.25/$0.50 USD) - 2016/02/11 12:50:34 CET [2016/02/11 6:50:34 ET]
Table 'Algedi' 9-max Seat #2 is the button
Seat 1: vlad11122007 ($55.35 in chips) 
Seat 2: Reffypaul ($61.79 in chips) 
Seat 3: Saggitaurus ($115.39 in chips) 
Seat 4: Effort92 ($59.91 in chips) 
Seat 6: TonnaMunz ($127.54 in chips) 
Seat 7: hoedtrob ($58.19 in chips) 
Seat 8: matiko09 ($50 in chips) 
Seat 9: Kud3 ($126.45 in chips) 
Saggitaurus: posts small blind $0.25
Effort92: posts big blind $0.50
Optimistic21: sits out 
vlad11122007: posts the ante $0.10
Reffypaul: posts the ante $0.10
Saggitaurus: posts the ante $0.10
Effort92: posts the ante $0.10
TonnaMunz: posts the ante $0.10
hoedtrob: posts the ante $0.10
matiko09: posts the ante $0.10
Kud3: posts the ante $0.10
*** HOLE CARDS ***
Dealt to matiko09 [2s Qs]
TonnaMunz: folds 
hoedtrob: folds 
matiko09: folds 
Kud3: folds 
vlad11122007: folds 
Reffypaul: folds 
Saggitaurus: folds 
Uncalled bet ($0.25) returned to Effort92
Effort92 collected $1.30 from pot
Effort92: doesn't show hand 
*** SUMMARY ***
Total pot $1.30 | Rake $0 
Seat 1: vlad11122007 folded before Flop (didn't bet)
Seat 2: Reffypaul (button) folded before Flop (didn't bet)
Seat 3: Saggitaurus (small blind) folded before Flop
Seat 4: Effort92 (big blind) collected ($1.30)
Seat 6: TonnaMunz folded before Flop (didn't bet)
Seat 7: hoedtrob folded before Flop (didn't bet)
Seat 8: matiko09 folded before Flop (didn't bet)
Seat 9: Kud3 folded before Flop (didn't bet)





PokerStars Hand #148608223916:  Hold'em No Limit ($0.50/$1.00 USD) - 2016/02/11 12:50:45 CET [2016/02/11 6:50:45 ET]
Table 'Regor' 9-max Seat #8 is the button
Seat 1: matiko09 ($124.27 in chips) 
Seat 2: Luck In Me ($100.50 in chips) 
Seat 3: oscarleon ($157.88 in chips) 
Seat 4: Filojoes ($101.50 in chips) 
Seat 6: Dachish ($88.95 in chips) 
Seat 7: Sweden_Pound ($100 in chips) 
Seat 8: R3NZONIT3 ($50.66 in chips) 
Seat 9: CoolFireX ($147.64 in chips) 
CoolFireX: posts small blind $0.50
matiko09: posts big blind $1
*** HOLE CARDS ***
Dealt to matiko09 [9d 5h]
Luck In Me: folds 
oscarleon: folds 
Filojoes: folds 
Dachish: folds 
Sweden_Pound: folds 
R3NZONIT3: folds 
CoolFireX: raises $2 to $3
matiko09: folds 
Uncalled bet ($2) returned to CoolFireX
CoolFireX collected $2 from pot
CoolFireX: doesn't show hand 
*** SUMMARY ***
Total pot $2 | Rake $0 
Seat 1: matiko09 (big blind) folded before Flop
Seat 2: Luck In Me folded before Flop (didn't bet)
Seat 3: oscarleon folded before Flop (didn't bet)
Seat 4: Filojoes folded before Flop (didn't bet)
Seat 6: Dachish folded before Flop (didn't bet)
Seat 7: Sweden_Pound folded before Flop (didn't bet)
Seat 8: R3NZONIT3 (button) folded before Flop (didn't bet)
Seat 9: CoolFireX (small blind) collected ($2)





PokerStars Hand #148608224964:  Hold'em No Limit ($0.25/$0.50 USD) - 2016/02/11 12:50:47 CET [2016/02/11 6:50:47 ET]
Table 'Stereoskopia' 9-max Seat #8 is the button
Seat 1: 50CandyJoe ($51.15 in chips) 
Seat 2: Optimistic21 ($57 in chips) 
Seat 3: Donko jr ($37.12 in chips) 
Seat 5: ReinisRNS ($30.23 in chips) 
Seat 6: matiko09 ($50 in chips) 
Seat 7: tallonn88 ($56.22 in chips) 
Seat 8: vlad11122007 ($49.25 in chips) 
Seat 9: apfush ($82.19 in chips) 
apfush: posts small blind $0.25
50CandyJoe: posts big blind $0.50
*** HOLE CARDS ***
Dealt to matiko09 [Qs 6d]
Optimistic21: folds 
Donko jr: folds 
ReinisRNS: folds 
matiko09: folds 
tallonn88: folds 
vlad11122007: raises $0.50 to $1
apfush: folds 
50CandyJoe: folds 
Uncalled bet ($0.50) returned to vlad11122007
vlad11122007 collected $1.25 from pot
vlad11122007: doesn't show hand 
*** SUMMARY ***
Total pot $1.25 | Rake $0 
Seat 1: 50CandyJoe (big blind) folded before Flop
Seat 2: Optimistic21 folded before Flop (didn't bet)
Seat 3: Donko jr folded before Flop (didn't bet)
Seat 5: ReinisRNS folded before Flop (didn't bet)
Seat 6: matiko09 folded before Flop (didn't bet)
Seat 7: tallonn88 folded before Flop (didn't bet)
Seat 8: vlad11122007 (button) collected ($1.25)
Seat 9: apfush (small blind) folded before Flop





PokerStars Hand #148608230946:  Hold'em No Limit ($0.25/$0.50 USD) - 2016/02/11 12:50:57 CET [2016/02/11 6:50:57 ET]
Table 'Algedi' 9-max Seat #3 is the button
Seat 1: vlad11122007 ($55.25 in chips) 
Seat 2: Reffypaul ($61.69 in chips) 
Seat 3: Saggitaurus ($115.04 in chips) 
Seat 4: Effort92 ($60.86 in chips) 
Seat 5: Optimistic21 ($50 in chips) 
Seat 6: TonnaMunz ($127.44 in chips) 
Seat 7: hoedtrob ($58.09 in chips) 
Seat 8: matiko09 ($50 in chips) 
Seat 9: Kud3 ($126.35 in chips) 
Effort92: posts small blind $0.25
Optimistic21: posts big blind $0.50
vlad11122007: posts the ante $0.10
Reffypaul: posts the ante $0.10
Saggitaurus: posts the ante $0.10
Effort92: posts the ante $0.10
Optimistic21: posts the ante $0.10
TonnaMunz: posts the ante $0.10
hoedtrob: posts the ante $0.10
matiko09: posts the ante $0.10
Kud3: posts the ante $0.10
*** HOLE CARDS ***
Dealt to matiko09 [Js 9s]
TonnaMunz: folds 
hoedtrob: folds 
matiko09: folds 
Kud3: folds 
vlad11122007: raises $1 to $1.50
Reffypaul: raises $1 to $2.50
Saggitaurus: folds 
Effort92: folds 
Optimistic21: raises $7 to $9.50
vlad11122007: folds 
Reffypaul: calls $7
*** FLOP *** [6d 3s 5s]
Optimistic21: bets $13.78
Reffypaul: folds 
Uncalled bet ($13.78) returned to Optimistic21
Optimistic21 collected $20.68 from pot
*** SUMMARY ***
Total pot $21.65 | Rake $0.97 
Board [6d 3s 5s]
Seat 1: vlad11122007 folded before Flop
Seat 2: Reffypaul folded on the Flop
Seat 3: Saggitaurus (button) folded before Flop (didn't bet)
Seat 4: Effort92 (small blind) folded before Flop
Seat 5: Optimistic21 (big blind) collected ($20.68)
Seat 6: TonnaMunz folded before Flop (didn't bet)
Seat 7: hoedtrob folded before Flop (didn't bet)
Seat 8: matiko09 folded before Flop (didn't bet)
Seat 9: Kud3 folded before Flop (didn't bet)





PokerStars Hand #148608233433:  Hold'em No Limit ($0.25/$0.50 USD) - 2016/02/11 12:51:02 CET [2016/02/11 6:51:02 ET]
Table 'Risha' 9-max Seat #3 is the button
Seat 1: Kud3 ($148.11 in chips) 
Seat 3: TuaaL ($41.79 in chips) 
Seat 4: matiko09 ($63.65 in chips) 
Seat 6: TonnaMunz ($72.28 in chips) 
matiko09: posts small blind $0.25
TonnaMunz: posts big blind $0.50
Kud3: posts the ante $0.10
TuaaL: posts the ante $0.10
matiko09: posts the ante $0.10
TonnaMunz: posts the ante $0.10
*** HOLE CARDS ***
Dealt to matiko09 [Qd Ac]
Kud3: folds 
TuaaL: folds 
matiko09: raises $1 to $1.50
TonnaMunz: folds 
Uncalled bet ($1) returned to matiko09
matiko09 collected $1.40 from pot
matiko09: doesn't show hand 
*** SUMMARY ***
Total pot $1.40 | Rake $0 
Seat 1: Kud3 folded before Flop (didn't bet)
Seat 3: TuaaL (button) folded before Flop (didn't bet)
Seat 4: matiko09 (small blind) collected ($1.40)
Seat 6: TonnaMunz (big blind) folded before Flop





PokerStars Hand #148608240078:  Hold'em No Limit ($0.25/$0.50 USD) - 2016/02/11 12:51:13 CET [2016/02/11 6:51:13 ET]
Table 'Risha' 9-max Seat #4 is the button
Seat 1: Kud3 ($148.01 in chips) 
Seat 3: TuaaL ($41.69 in chips) 
Seat 4: matiko09 ($64.45 in chips) 
Seat 6: TonnaMunz ($71.68 in chips) 
TonnaMunz: posts small blind $0.25
Kud3: posts big blind $0.50
Kud3: posts the ante $0.10
TuaaL: posts the ante $0.10
matiko09: posts the ante $0.10
TonnaMunz: posts the ante $0.10
*** HOLE CARDS ***
Dealt to matiko09 [7s Ac]
TuaaL: calls $0.50
matiko09: raises $1.50 to $2
TonnaMunz: folds 
Kud3: folds 
TuaaL: raises $39.59 to $41.59 and is all-in
matiko09: folds 
Uncalled bet ($39.59) returned to TuaaL
TuaaL collected $5.15 from pot
TuaaL: doesn't show hand 
*** SUMMARY ***
Total pot $5.15 | Rake $0 
Seat 1: Kud3 (big blind) folded before Flop
Seat 3: TuaaL collected ($5.15)
Seat 4: matiko09 (button) folded before Flop
Seat 6: TonnaMunz (small blind) folded before Flop





PokerStars Hand #148608241825:  Hold'em No Limit ($0.25/$0.50 USD) - 2016/02/11 12:51:16 CET [2016/02/11 6:51:16 ET]
Table 'Sylvania II' 9-max Seat #7 is the button
Seat 1: mexx1234 ($196.28 in chips) 
Seat 2: Effort92 ($60.05 in chips) 
Seat 3: ruyingren ($192.21 in chips) 
Seat 4: matiko09 ($155.84 in chips) 
Seat 5: vlad11122007 ($67.79 in chips) 
Seat 6: TonnaMunz ($128.46 in chips) 
Seat 7: i L00K great ($50 in chips) 
Seat 8: Optimistic21 ($50 in chips) 
Seat 9: Kud3 ($131.85 in chips) 
Optimistic21: posts small blind $0.25
Kud3: posts big blind $0.50
mexx1234: posts the ante $0.10
Effort92: posts the ante $0.10
ruyingren: posts the ante $0.10
matiko09: posts the ante $0.10
vlad11122007: posts the ante $0.10
TonnaMunz: posts the ante $0.10
i L00K great: posts the ante $0.10
Optimistic21: posts the ante $0.10
Kud3: posts the ante $0.10
*** HOLE CARDS ***
Dealt to matiko09 [9c 7h]
mexx1234: folds 
Effort92: raises $1 to $1.50
ruyingren: folds 
matiko09: folds 
vlad11122007: folds 
TonnaMunz: folds 
i L00K great: calls $1.50
Optimistic21: folds 
Kud3: folds 
*** FLOP *** [7s Jd Kc]
Effort92: bets $2.70
i L00K great: folds 
Uncalled bet ($2.70) returned to Effort92
Effort92 collected $4.44 from pot
Effort92: doesn't show hand 
*** SUMMARY ***
Total pot $4.65 | Rake $0.21 
Board [7s Jd Kc]
Seat 1: mexx1234 folded before Flop (didn't bet)
Seat 2: Effort92 collected ($4.44)
Seat 3: ruyingren folded before Flop (didn't bet)
Seat 4: matiko09 folded before Flop (didn't bet)
Seat 5: vlad11122007 folded before Flop (didn't bet)
Seat 6: TonnaMunz folded before Flop (didn't bet)
Seat 7: i L00K great (button) folded on the Flop
Seat 8: Optimistic21 (small blind) folded before Flop
Seat 9: Kud3 (big blind) folded before Flop





PokerStars Hand #148608242885:  Hold'em No Limit ($0.50/$1.00 USD) - 2016/02/11 12:51:18 CET [2016/02/11 6:51:18 ET]
Table 'Kleopatra II' 9-max Seat #7 is the button
Seat 1: torkkdnm ($100 in chips) 
Seat 2: Troll8989 ($139.13 in chips) 
Seat 3: Effort92 ($132.90 in chips) 
Seat 5: CoolFireX ($132.81 in chips) 
Seat 6: PizzaEcki ($60.52 in chips) 
Seat 7: PacPacBum ($120.49 in chips) 
Seat 8: oscarleon ($103 in chips) 
Seat 9: matiko09 ($100 in chips) 
oscarleon: posts small blind $0.50
matiko09: posts big blind $1
Filojoes: sits out 
*** HOLE CARDS ***
Dealt to matiko09 [Qd Td]
torkkdnm: folds 
Troll8989: folds 
Effort92: folds 
CoolFireX: raises $2 to $3
PizzaEcki: folds 
PacPacBum: folds 
oscarleon: folds 
matiko09: folds 
Uncalled bet ($2) returned to CoolFireX
CoolFireX collected $2.50 from pot
CoolFireX: doesn't show hand 
*** SUMMARY ***
Total pot $2.50 | Rake $0 
Seat 1: torkkdnm folded before Flop (didn't bet)
Seat 2: Troll8989 folded before Flop (didn't bet)
Seat 3: Effort92 folded before Flop (didn't bet)
Seat 5: CoolFireX collected ($2.50)
Seat 6: PizzaEcki folded before Flop (didn't bet)
Seat 7: PacPacBum (button) folded before Flop (didn't bet)
Seat 8: oscarleon (small blind) folded before Flop
Seat 9: matiko09 (big blind) folded before Flop





PokerStars Hand #148608243510:  Hold'em No Limit ($0.25/$0.50 USD) - 2016/02/11 12:51:19 CET [2016/02/11 6:51:19 ET]
Table 'Stereoskopia' 9-max Seat #9 is the button
Seat 1: 50CandyJoe ($50.65 in chips) 
Seat 2: Optimistic21 ($57 in chips) 
Seat 3: Donko jr ($37.12 in chips) 
Seat 5: ReinisRNS ($30.23 in chips) 
Seat 6: matiko09 ($50 in chips) 
Seat 7: tallonn88 ($56.22 in chips) 
Seat 8: vlad11122007 ($50 in chips) 
Seat 9: apfush ($81.94 in chips) 
50CandyJoe: posts small blind $0.25
Optimistic21: posts big blind $0.50
*** HOLE CARDS ***
Dealt to matiko09 [Ks 7d]
Donko jr: folds 
ReinisRNS: folds 
matiko09: folds 
tallonn88: folds 
vlad11122007: folds 
apfush: raises $0.60 to $1.10
50CandyJoe: folds 
Optimistic21: folds 
Uncalled bet ($0.60) returned to apfush
apfush collected $1.25 from pot
apfush: doesn't show hand 
*** SUMMARY ***
Total pot $1.25 | Rake $0 
Seat 1: 50CandyJoe (small blind) folded before Flop
Seat 2: Optimistic21 (big blind) folded before Flop
Seat 3: Donko jr folded before Flop (didn't bet)
Seat 5: ReinisRNS folded before Flop (didn't bet)
Seat 6: matiko09 folded before Flop (didn't bet)
Seat 7: tallonn88 folded before Flop (didn't bet)
Seat 8: vlad11122007 folded before Flop (didn't bet)
Seat 9: apfush (button) collected ($1.25)





PokerStars Hand #148608243651:  Hold'em No Limit ($0.50/$1.00 USD) - 2016/02/11 12:51:20 CET [2016/02/11 6:51:20 ET]
Table 'Rasalas' 9-max Seat #6 is the button
Seat 2: azzad2007 ($103.62 in chips) 
Seat 3: Luck In Me ($100 in chips) 
Seat 4: Sweden_Pound ($100.50 in chips) 
Seat 5: Saggitaurus ($103.64 in chips) 
Seat 6: DUkalisUA ($100 in chips) 
Seat 7: matiko09 ($100 in chips) 
Seat 8: gwwsb ($77.40 in chips) 
matiko09: posts small blind $0.50
gwwsb: posts big blind $1
hurtNCYDE: sits out 
Tissue51: sits out 
*** HOLE CARDS ***
Dealt to matiko09 [Tc 2h]
azzad2007: folds 
Luck In Me: folds 
Sweden_Pound: raises $2 to $3
Saggitaurus: folds 
DUkalisUA: folds 
matiko09: folds 
gwwsb: folds 
Uncalled bet ($2) returned to Sweden_Pound
Sweden_Pound collected $2.50 from pot
Sweden_Pound: doesn't show hand 
*** SUMMARY ***
Total pot $2.50 | Rake $0 
Seat 2: azzad2007 folded before Flop (didn't bet)
Seat 3: Luck In Me folded before Flop (didn't bet)
Seat 4: Sweden_Pound collected ($2.50)
Seat 5: Saggitaurus folded before Flop (didn't bet)
Seat 6: DUkalisUA (button) folded before Flop (didn't bet)
Seat 7: matiko09 (small blind) folded before Flop
Seat 8: gwwsb (big blind) folded before Flop





PokerStars Hand #148608248089:  Hold'em No Limit ($0.50/$1.00 USD) - 2016/02/11 12:51:28 CET [2016/02/11 6:51:28 ET]
Table 'Sycorax II' 9-max Seat #7 is the button
Seat 1: Luck In Me ($165.43 in chips) 
Seat 2: Lujan87 ($112.49 in chips) 
Seat 4: Sweden_Pound ($100 in chips) 
Seat 5: Effort92 ($154.04 in chips) 
Seat 6: FluentFlows ($43.26 in chips) 
Seat 7: PacPacBum ($122.71 in chips) 
Seat 8: matiko09 ($255.46 in chips) 
Seat 9: mrfoldcall ($98.51 in chips) 
matiko09: posts small blind $0.50
mrfoldcall: posts big blind $1
*** HOLE CARDS ***
Dealt to matiko09 [2c 6s]
Luck In Me: folds 
Lujan87: folds 
Sweden_Pound: folds 
Effort92: folds 
FluentFlows: raises $2 to $3
PacPacBum: folds 
matiko09: folds 
mrfoldcall: folds 
Uncalled bet ($2) returned to FluentFlows
FluentFlows collected $2.50 from pot
FluentFlows: doesn't show hand 
*** SUMMARY ***
Total pot $2.50 | Rake $0 
Seat 1: Luck In Me folded before Flop (didn't bet)
Seat 2: Lujan87 folded before Flop (didn't bet)
Seat 4: Sweden_Pound folded before Flop (didn't bet)
Seat 5: Effort92 folded before Flop (didn't bet)
Seat 6: FluentFlows collected ($2.50)
Seat 7: PacPacBum (button) folded before Flop (didn't bet)
Seat 8: matiko09 (small blind) folded before Flop
Seat 9: mrfoldcall (big blind) folded before Flop





PokerStars Hand #148608251219:  Hold'em No Limit ($0.50/$1.00 USD) - 2016/02/11 12:51:33 CET [2016/02/11 6:51:33 ET]
Table 'Regor' 9-max Seat #9 is the button
Seat 1: matiko09 ($123.27 in chips) 
Seat 2: Luck In Me ($100.50 in chips) 
Seat 3: oscarleon ($157.88 in chips) 
Seat 4: Filojoes ($101.50 in chips) 
Seat 6: Dachish ($88.95 in chips) 
Seat 7: Sweden_Pound ($100 in chips) 
Seat 8: R3NZONIT3 ($50.66 in chips) 
Seat 9: CoolFireX ($148.64 in chips) 
matiko09: posts small blind $0.50
Luck In Me: posts big blind $1
*** HOLE CARDS ***
Dealt to matiko09 [Kh Ad]
oscarleon: folds 
Filojoes: folds 
Dachish: folds 
Sweden_Pound: folds 
R3NZONIT3: folds 
CoolFireX: raises $1.50 to $2.50
matiko09: raises $6.50 to $9
Luck In Me: folds 
CoolFireX: calls $6.50
*** FLOP *** [Kc Ac 9s]
matiko09: bets $9.43
CoolFireX: calls $9.43
*** TURN *** [Kc Ac 9s] [Jd]
matiko09: bets $23
CoolFireX: folds 
Uncalled bet ($23) returned to matiko09
matiko09 collected $36.16 from pot
matiko09: doesn't show hand 
*** SUMMARY ***
Total pot $37.86 | Rake $1.70 
Board [Kc Ac 9s Jd]
Seat 1: matiko09 (small blind) collected ($36.16)
Seat 2: Luck In Me (big blind) folded before Flop
Seat 3: oscarleon folded before Flop (didn't bet)
Seat 4: Filojoes folded before Flop (didn't bet)
Seat 6: Dachish folded before Flop (didn't bet)
Seat 7: Sweden_Pound folded before Flop (didn't bet)
Seat 8: R3NZONIT3 folded before Flop (didn't bet)
Seat 9: CoolFireX (button) folded on the Turn





PokerStars Hand #148608254872:  Hold'em No Limit ($0.25/$0.50 USD) - 2016/02/11 12:51:39 CET [2016/02/11 6:51:39 ET]
Table 'Risha' 9-max Seat #6 is the button
Seat 1: Kud3 ($147.41 in chips) 
Seat 3: TuaaL ($44.74 in chips) 
Seat 4: matiko09 ($62.35 in chips) 
Seat 6: TonnaMunz ($71.33 in chips) 
Kud3: posts small blind $0.25
TuaaL: posts big blind $0.50
Kud3: posts the ante $0.10
TuaaL: posts the ante $0.10
matiko09: posts the ante $0.10
TonnaMunz: posts the ante $0.10
*** HOLE CARDS ***
Dealt to matiko09 [6s Td]
matiko09: folds 
TonnaMunz: raises $0.68 to $1.18
Kud3: calls $0.93
TuaaL: calls $0.68
*** FLOP *** [3s 3d 4c]
Kud3: checks 
TuaaL: checks 
TonnaMunz: bets $2
Kud3: folds 
TuaaL has timed out
TuaaL: folds 
Uncalled bet ($2) returned to TonnaMunz
TonnaMunz collected $3.76 from pot
TonnaMunz: doesn't show hand 
*** SUMMARY ***
Total pot $3.94 | Rake $0.18 
Board [3s 3d 4c]
Seat 1: Kud3 (small blind) folded on the Flop
Seat 3: TuaaL (big blind) folded on the Flop
Seat 4: matiko09 folded before Flop (didn't bet)
Seat 6: TonnaMunz (button) collected ($3.76)





PokerStars Hand #148608255574:  Hold'em No Limit ($0.50/$1.00 USD) - 2016/02/11 12:51:41 CET [2016/02/11 6:51:41 ET]
Table 'Rasalas' 9-max Seat #7 is the button
Seat 2: azzad2007 ($103.62 in chips) 
Seat 3: Luck In Me ($100 in chips) 
Seat 4: Sweden_Pound ($102 in chips) 
Seat 5: Saggitaurus ($103.64 in chips) 
Seat 6: DUkalisUA ($100 in chips) 
Seat 7: matiko09 ($100 in chips) 
Seat 8: gwwsb ($76.40 in chips) 
Seat 9: hurtNCYDE ($100 in chips) 
gwwsb: posts small blind $0.50
hurtNCYDE: posts big blind $1
Tissue51: sits out 
*** HOLE CARDS ***
Dealt to matiko09 [2d Ac]
azzad2007: raises $1.50 to $2.50
Luck In Me: folds 
Sweden_Pound: folds 
Saggitaurus: folds 
DUkalisUA: folds 
matiko09: folds 
gwwsb: calls $2
hurtNCYDE: folds 
*** FLOP *** [9c 4s 6c]
gwwsb: checks 
azzad2007: bets $2.86
gwwsb: calls $2.86
*** TURN *** [9c 4s 6c] [4d]
gwwsb: checks 
azzad2007: bets $7
gwwsb: folds 
Uncalled bet ($7) returned to azzad2007
azzad2007 collected $11.19 from pot
azzad2007: doesn't show hand 
*** SUMMARY ***
Total pot $11.72 | Rake $0.53 
Board [9c 4s 6c 4d]
Seat 2: azzad2007 collected ($11.19)
Seat 3: Luck In Me folded before Flop (didn't bet)
Seat 4: Sweden_Pound folded before Flop (didn't bet)
Seat 5: Saggitaurus folded before Flop (didn't bet)
Seat 6: DUkalisUA folded before Flop (didn't bet)
Seat 7: matiko09 (button) folded before Flop (didn't bet)
Seat 8: gwwsb (small blind) folded on the Turn
Seat 9: hurtNCYDE (big blind) folded before Flop





PokerStars Hand #148608255692:  Hold'em No Limit (€0.25/€0.50 EUR) - 2016/02/11 12:51:41 CET [2016/02/11 6:51:41 ET]
Table 'Otero II' 9-max Seat #3 is the button
Seat 1: Nacho2556 (€50.36 in chips) 
Seat 2: make6a (€45.23 in chips) 
Seat 3: Szevasztopol (€50 in chips) 
Seat 4: kram0909 (€4.22 in chips) 
Seat 5: vlad11122007 (€51.69 in chips) 
Seat 6: TonnaMunz (€54.79 in chips) 
Seat 7: PacPacBum (€58.02 in chips) 
Seat 8: matiko09 (€70.93 in chips) 
Seat 9: Optimistic21 (€71.25 in chips) 
kram0909: posts small blind €0.25
vlad11122007: posts big blind €0.50
*** HOLE CARDS ***
Dealt to matiko09 [Kd 5s]
TonnaMunz: folds 
PacPacBum: folds 
matiko09: folds 
Optimistic21: folds 
Nacho2556: folds 
make6a: folds 
Szevasztopol: raises €0.50 to €1
kram0909: folds 
vlad11122007: folds 
Uncalled bet (€0.50) returned to Szevasztopol
Szevasztopol collected €1.25 from pot
Szevasztopol: doesn't show hand 
*** SUMMARY ***
Total pot €1.25 | Rake €0 
Seat 1: Nacho2556 folded before Flop (didn't bet)
Seat 2: make6a folded before Flop (didn't bet)
Seat 3: Szevasztopol (button) collected (€1.25)
Seat 4: kram0909 (small blind) folded before Flop
Seat 5: vlad11122007 (big blind) folded before Flop
Seat 6: TonnaMunz folded before Flop (didn't bet)
Seat 7: PacPacBum folded before Flop (didn't bet)
Seat 8: matiko09 folded before Flop (didn't bet)
Seat 9: Optimistic21 folded before Flop (didn't bet)





PokerStars Hand #148608256310:  Hold'em No Limit ($0.25/$0.50 USD) - 2016/02/11 12:51:42 CET [2016/02/11 6:51:42 ET]
Table 'Ambrosia II' 9-max Seat #5 is the button
Seat 1: matiko09 ($50 in chips) 
Seat 2: TheMinion ($114.12 in chips) 
Seat 4: huudk2016 ($44.50 in chips) 
Seat 5: RICKA16 ($49.25 in chips) 
Seat 6: Reven9er ($72.02 in chips) 
Seat 7: mexx1234 ($85.73 in chips) 
Seat 8: tallonn88 ($57.76 in chips) 
Seat 9: arctur17 ($69.79 in chips) 
Reven9er: posts small blind $0.25
mexx1234: posts big blind $0.50
make6a: sits out 
*** HOLE CARDS ***
Dealt to matiko09 [3d Ts]
tallonn88: folds 
arctur17: folds 
matiko09: folds 
TheMinion: raises $0.75 to $1.25
huudk2016: folds 
RICKA16: folds 
Reven9er: folds 
mexx1234: folds 
Uncalled bet ($0.75) returned to TheMinion
TheMinion collected $1.25 from pot
TheMinion: doesn't show hand 
*** SUMMARY ***
Total pot $1.25 | Rake $0 
Seat 1: matiko09 folded before Flop (didn't bet)
Seat 2: TheMinion collected ($1.25)
Seat 4: huudk2016 folded before Flop (didn't bet)
Seat 5: RICKA16 (button) folded before Flop (didn't bet)
Seat 6: Reven9er (small blind) folded before Flop
Seat 7: mexx1234 (big blind) folded before Flop
Seat 8: tallonn88 folded before Flop (didn't bet)
Seat 9: arctur17 folded before Flop (didn't bet)





PokerStars Hand #148608257708:  Hold'em No Limit ($0.50/$1.00 USD) - 2016/02/11 12:51:44 CET [2016/02/11 6:51:44 ET]
Table 'Kleopatra II' 9-max Seat #8 is the button
Seat 1: torkkdnm ($100 in chips) 
Seat 2: Troll8989 ($139.13 in chips) 
Seat 3: Effort92 ($132.90 in chips) 
Seat 5: CoolFireX ($134.31 in chips) 
Seat 6: PizzaEcki ($60.52 in chips) 
Seat 7: PacPacBum ($120.49 in chips) 
Seat 8: oscarleon ($102.50 in chips) 
Seat 9: matiko09 ($100 in chips) 
matiko09: posts small blind $0.50
torkkdnm: posts big blind $1
Filojoes: sits out 
*** HOLE CARDS ***
Dealt to matiko09 [Kc Ac]
Troll8989: folds 
Effort92: folds 
CoolFireX: folds 
PizzaEcki: folds 
Troll8989 leaves the table
PizzaEcki leaves the table
hurtNCYDE joins the table at seat #2 
PacPacBum: folds 
oscarleon: raises $2 to $3
hurtNCYDE leaves the table
matiko09: raises $7 to $10
torkkdnm: folds 
oscarleon: folds 
Uncalled bet ($7) returned to matiko09
matiko09 collected $7 from pot
matiko09: doesn't show hand 
*** SUMMARY ***
Total pot $7 | Rake $0 
Seat 1: torkkdnm (big blind) folded before Flop
Seat 2: Troll8989 folded before Flop (didn't bet)
Seat 3: Effort92 folded before Flop (didn't bet)
Seat 5: CoolFireX folded before Flop (didn't bet)
Seat 6: PizzaEcki folded before Flop (didn't bet)
Seat 7: PacPacBum folded before Flop (didn't bet)
Seat 8: oscarleon (button) folded before Flop
Seat 9: matiko09 (small blind) collected ($7)





PokerStars Hand #148608262306:  Hold'em No Limit ($0.25/$0.50 USD) - 2016/02/11 12:51:52 CET [2016/02/11 6:51:52 ET]
Table 'Algedi' 9-max Seat #4 is the button
Seat 1: vlad11122007 ($53.65 in chips) 
Seat 2: Reffypaul ($52.09 in chips) 
Seat 3: Saggitaurus ($114.94 in chips) 
Seat 4: Effort92 ($60.51 in chips) 
Seat 5: Optimistic21 ($61.08 in chips) 
Seat 6: TonnaMunz ($127.34 in chips) 
Seat 7: hoedtrob ($57.99 in chips) 
Seat 8: matiko09 ($50 in chips) 
Seat 9: Kud3 ($126.25 in chips) 
Optimistic21: posts small blind $0.25
TonnaMunz: posts big blind $0.50
vlad11122007: posts the ante $0.10
Reffypaul: posts the ante $0.10
Saggitaurus: posts the ante $0.10
Effort92: posts the ante $0.10
Optimistic21: posts the ante $0.10
TonnaMunz: posts the ante $0.10
hoedtrob: posts the ante $0.10
matiko09: posts the ante $0.10
Kud3: posts the ante $0.10
*** HOLE CARDS ***
Dealt to matiko09 [Ad 9s]
hoedtrob: folds 
Saggitaurus said, "no"
matiko09: folds 
Kud3: raises $1 to $1.50
vlad11122007: folds 
Reffypaul: raises $1.50 to $3
Saggitaurus: folds 
Effort92: folds 
hoedtrob said, "hmmm"
Optimistic21: folds 
TonnaMunz: folds 
Kud3: calls $1.50
*** FLOP *** [Ac Kc 9d]
Kud3: checks 
hoedtrob said, "i can go on guessing...."
Reffypaul: bets $3
Kud3: folds 
Uncalled bet ($3) returned to Reffypaul
Reffypaul collected $7.31 from pot
*** SUMMARY ***
Total pot $7.65 | Rake $0.34 
Board [Ac Kc 9d]
Seat 1: vlad11122007 folded before Flop (didn't bet)
Seat 2: Reffypaul collected ($7.31)
Seat 3: Saggitaurus folded before Flop (didn't bet)
Seat 4: Effort92 (button) folded before Flop (didn't bet)
Seat 5: Optimistic21 (small blind) folded before Flop
Seat 6: TonnaMunz (big blind) folded before Flop
Seat 7: hoedtrob folded before Flop (didn't bet)
Seat 8: matiko09 folded before Flop (didn't bet)
Seat 9: Kud3 folded on the Flop





PokerStars Hand #148608266049:  Hold'em No Limit ($0.25/$0.50 USD) - 2016/02/11 12:51:59 CET [2016/02/11 6:51:59 ET]
Table 'Stereoskopia' 9-max Seat #1 is the button
Seat 1: 50CandyJoe ($50.40 in chips) 
Seat 2: Optimistic21 ($56.50 in chips) 
Seat 3: Donko jr ($37.12 in chips) 
Seat 5: ReinisRNS ($30.23 in chips) 
Seat 6: matiko09 ($50 in chips) 
Seat 7: tallonn88 ($56.22 in chips) 
Seat 8: vlad11122007 ($50 in chips) 
Seat 9: apfush ($82.69 in chips) 
Optimistic21: posts small blind $0.25
Donko jr: posts big blind $0.50
*** HOLE CARDS ***
Dealt to matiko09 [Ah Ts]
ReinisRNS: folds 
matiko09: folds 
tallonn88: folds 
vlad11122007: raises $1 to $1.50
apfush: folds 
50CandyJoe: folds 
Optimistic21: folds 
Donko jr: calls $1
*** FLOP *** [6d 5h 7c]
Donko jr: checks 
vlad11122007: bets $2.50
Donko jr: calls $2.50
*** TURN *** [6d 5h 7c] [3d]
Donko jr: checks 
vlad11122007: bets $6
Donko jr: calls $6
*** RIVER *** [6d 5h 7c 3d] [Jc]
Donko jr: checks 
vlad11122007: bets $10.50
Donko jr: calls $10.50
*** SHOW DOWN ***
vlad11122007: shows [Jh Jd] (three of a kind, Jacks)
Donko jr: shows [4c Kc] (a straight, Three to Seven)
Donko jr collected $39.39 from pot
*** SUMMARY ***
Total pot $41.25 | Rake $1.86 
Board [6d 5h 7c 3d Jc]
Seat 1: 50CandyJoe (button) folded before Flop (didn't bet)
Seat 2: Optimistic21 (small blind) folded before Flop
Seat 3: Donko jr (big blind) showed [4c Kc] and won ($39.39) with a straight, Three to Seven
Seat 5: ReinisRNS folded before Flop (didn't bet)
Seat 6: matiko09 folded before Flop (didn't bet)
Seat 7: tallonn88 folded before Flop (didn't bet)
Seat 8: vlad11122007 showed [Jh Jd] and lost with three of a kind, Jacks
Seat 9: apfush folded before Flop (didn't bet)





PokerStars Hand #148608267604:  Hold'em No Limit ($0.50/$1.00 USD) - 2016/02/11 12:52:02 CET [2016/02/11 6:52:02 ET]
Table 'Sycorax II' 9-max Seat #8 is the button
Seat 1: Luck In Me ($165.43 in chips) 
Seat 2: Lujan87 ($112.49 in chips) 
Seat 4: Sweden_Pound ($100 in chips) 
Seat 5: Effort92 ($154.04 in chips) 
Seat 6: FluentFlows ($44.76 in chips) 
Seat 7: PacPacBum ($122.71 in chips) 
Seat 8: matiko09 ($254.96 in chips) 
Seat 9: mrfoldcall ($97.51 in chips) 
mrfoldcall: posts small blind $0.50
Luck In Me: posts big blind $1
*** HOLE CARDS ***
Dealt to matiko09 [Jd 5h]
Lujan87: folds 
Lujan87 leaves the table
Sweden_Pound: folds 
Sweden_Pound leaves the table
Filojoes joins the table at seat #2 
Effort92: folds 
FluentFlows: folds 
PacPacBum: folds 
matiko09: folds 
mrfoldcall: folds 
Uncalled bet ($0.50) returned to Luck In Me
Luck In Me collected $1 from pot
Luck In Me: doesn't show hand 
*** SUMMARY ***
Total pot $1 | Rake $0 
Seat 1: Luck In Me (big blind) collected ($1)
Seat 2: Lujan87 folded before Flop (didn't bet)
Seat 4: Sweden_Pound folded before Flop (didn't bet)
Seat 5: Effort92 folded before Flop (didn't bet)
Seat 6: FluentFlows folded before Flop (didn't bet)
Seat 7: PacPacBum folded before Flop (didn't bet)
Seat 8: matiko09 (button) folded before Flop (didn't bet)
Seat 9: mrfoldcall (small blind) folded before Flop





PokerStars Hand #148608269443:  Hold'em No Limit ($0.25/$0.50 USD) - 2016/02/11 12:52:05 CET [2016/02/11 6:52:05 ET]
Table 'Sylvania II' 9-max Seat #8 is the button
Seat 1: mexx1234 ($196.18 in chips) 
Seat 2: Effort92 ($62.89 in chips) 
Seat 3: ruyingren ($192.11 in chips) 
Seat 4: matiko09 ($155.74 in chips) 
Seat 5: vlad11122007 ($67.69 in chips) 
Seat 6: TonnaMunz ($128.36 in chips) 
Seat 7: i L00K great ($50 in chips) 
Seat 8: Optimistic21 ($50 in chips) 
Seat 9: Kud3 ($131.25 in chips) 
Kud3: posts small blind $0.25
mexx1234: posts big blind $0.50
mexx1234: posts the ante $0.10
Effort92: posts the ante $0.10
ruyingren: posts the ante $0.10
matiko09: posts the ante $0.10
vlad11122007: posts the ante $0.10
TonnaMunz: posts the ante $0.10
i L00K great: posts the ante $0.10
Optimistic21: posts the ante $0.10
Kud3: posts the ante $0.10
*** HOLE CARDS ***
Dealt to matiko09 [2d Qs]
Effort92: raises $1 to $1.50
ruyingren: folds 
matiko09: folds 
vlad11122007: folds 
TonnaMunz: folds 
i L00K great: folds 
Optimistic21: folds 
Kud3: folds 
mexx1234: folds 
Uncalled bet ($1) returned to Effort92
Effort92 collected $2.15 from pot
Effort92: doesn't show hand 
*** SUMMARY ***
Total pot $2.15 | Rake $0 
Seat 1: mexx1234 (big blind) folded before Flop
Seat 2: Effort92 collected ($2.15)
Seat 3: ruyingren folded before Flop (didn't bet)
Seat 4: matiko09 folded before Flop (didn't bet)
Seat 5: vlad11122007 folded before Flop (didn't bet)
Seat 6: TonnaMunz folded before Flop (didn't bet)
Seat 7: i L00K great folded before Flop (didn't bet)
Seat 8: Optimistic21 (button) folded before Flop (didn't bet)
Seat 9: Kud3 (small blind) folded before Flop





PokerStars Hand #148608272822:  Hold'em No Limit ($0.25/$0.50 USD) - 2016/02/11 12:52:11 CET [2016/02/11 6:52:11 ET]
Table 'Ambrosia II' 9-max Seat #6 is the button
Seat 1: matiko09 ($50 in chips) 
Seat 2: TheMinion ($114.87 in chips) 
Seat 4: huudk2016 ($44.50 in chips) 
Seat 5: RICKA16 ($49.25 in chips) 
Seat 6: Reven9er ($71.77 in chips) 
Seat 7: mexx1234 ($85.23 in chips) 
Seat 8: tallonn88 ($57.76 in chips) 
Seat 9: arctur17 ($69.79 in chips) 
mexx1234: posts small blind $0.25
tallonn88: posts big blind $0.50
make6a: sits out 
*** HOLE CARDS ***
Dealt to matiko09 [3h Jh]
arctur17: folds 
matiko09: folds 
TheMinion: folds 
huudk2016: calls $0.50
RICKA16: folds 
Reven9er: folds 
mexx1234: folds 
tallonn88: checks 
*** FLOP *** [Kh Qc Tc]
tallonn88: checks 
huudk2016: bets $1.50
tallonn88: folds 
Uncalled bet ($1.50) returned to huudk2016
huudk2016 collected $1.19 from pot
huudk2016: doesn't show hand 
*** SUMMARY ***
Total pot $1.25 | Rake $0.06 
Board [Kh Qc Tc]
Seat 1: matiko09 folded before Flop (didn't bet)
Seat 2: TheMinion folded before Flop (didn't bet)
Seat 4: huudk2016 collected ($1.19)
Seat 5: RICKA16 folded before Flop (didn't bet)
Seat 6: Reven9er (button) folded before Flop (didn't bet)
Seat 7: mexx1234 (small blind) folded before Flop
Seat 8: tallonn88 (big blind) folded on the Flop
Seat 9: arctur17 folded before Flop (didn't bet)





PokerStars Hand #148608273345:  Hold'em No Limit (€0.25/€0.50 EUR) - 2016/02/11 12:52:12 CET [2016/02/11 6:52:12 ET]
Table 'Otero II' 9-max Seat #4 is the button
Seat 1: Nacho2556 (€50.36 in chips) 
Seat 2: make6a (€45.23 in chips) 
Seat 3: Szevasztopol (€50.75 in chips) 
Seat 4: kram0909 (€3.97 in chips) 
Seat 5: vlad11122007 (€51.19 in chips) 
Seat 6: TonnaMunz (€54.79 in chips) 
Seat 7: PacPacBum (€58.02 in chips) 
Seat 8: matiko09 (€70.93 in chips) 
Seat 9: Optimistic21 (€71.25 in chips) 
vlad11122007: posts small blind €0.25
TonnaMunz: posts big blind €0.50
*** HOLE CARDS ***
Dealt to matiko09 [Kc 2h]
PacPacBum: folds 
matiko09: folds 
Optimistic21: folds 
Nacho2556: folds 
make6a: raises €0.75 to €1.25
Szevasztopol: folds 
kram0909: folds 
vlad11122007: folds 
TonnaMunz: folds 
Uncalled bet (€0.75) returned to make6a
make6a collected €1.25 from pot
make6a: doesn't show hand 
*** SUMMARY ***
Total pot €1.25 | Rake €0 
Seat 1: Nacho2556 folded before Flop (didn't bet)
Seat 2: make6a collected (€1.25)
Seat 3: Szevasztopol folded before Flop (didn't bet)
Seat 4: kram0909 (button) folded before Flop (didn't bet)
Seat 5: vlad11122007 (small blind) folded before Flop
Seat 6: TonnaMunz (big blind) folded before Flop
Seat 7: PacPacBum folded before Flop (didn't bet)
Seat 8: matiko09 folded before Flop (didn't bet)
Seat 9: Optimistic21 folded before Flop (didn't bet)





PokerStars Hand #148608275709:  Hold'em No Limit ($0.50/$1.00 USD) - 2016/02/11 12:52:16 CET [2016/02/11 6:52:16 ET]
Table 'Kleopatra II' 9-max Seat #9 is the button
Seat 1: torkkdnm ($100 in chips) 
Seat 4: Filojoes ($104.65 in chips) 
Seat 5: CoolFireX ($134.31 in chips) 
Seat 7: PacPacBum ($120.49 in chips) 
Seat 8: oscarleon ($100 in chips) 
Seat 9: matiko09 ($104 in chips) 
torkkdnm: posts small blind $0.50
Effort92: is sitting out 
Filojoes: posts big blind $1
*** HOLE CARDS ***
Dealt to matiko09 [Qc Ks]
CoolFireX: folds 
DUkalisUA joins the table at seat #6 
PacPacBum: folds 
oscarleon: folds 
matiko09: raises $1.27 to $2.27
torkkdnm: raises $5.73 to $8
Filojoes: folds 
matiko09: calls $5.73
*** FLOP *** [5d 3h 4c]
713123 joins the table at seat #2 
torkkdnm: checks 
matiko09: checks 
*** TURN *** [5d 3h 4c] [2s]
torkkdnm: checks 
matiko09: checks 
*** RIVER *** [5d 3h 4c 2s] [Kd]
torkkdnm: bets $10
matiko09: folds 
Uncalled bet ($10) returned to torkkdnm
torkkdnm collected $16.24 from pot
*** SUMMARY ***
Total pot $17 | Rake $0.76 
Board [5d 3h 4c 2s Kd]
Seat 1: torkkdnm (small blind) collected ($16.24)
Seat 4: Filojoes (big blind) folded before Flop
Seat 5: CoolFireX folded before Flop (didn't bet)
Seat 7: PacPacBum folded before Flop (didn't bet)
Seat 8: oscarleon folded before Flop (didn't bet)
Seat 9: matiko09 (button) folded on the River





PokerStars Hand #148608283315:  Hold'em No Limit ($0.25/$0.50 USD) - 2016/02/11 12:52:30 CET [2016/02/11 6:52:30 ET]
Table 'Sylvania II' 9-max Seat #9 is the button
Seat 1: mexx1234 ($195.58 in chips) 
Seat 3: ruyingren ($192.01 in chips) 
Seat 4: matiko09 ($155.64 in chips) 
Seat 5: vlad11122007 ($67.59 in chips) 
Seat 6: TonnaMunz ($128.26 in chips) 
Seat 7: i L00K great ($50 in chips) 
Seat 8: Optimistic21 ($50 in chips) 
Seat 9: Kud3 ($130.90 in chips) 
mexx1234: posts small blind $0.25
Effort92: is sitting out 
ruyingren: posts big blind $0.50
mexx1234: posts the ante $0.10
ruyingren: posts the ante $0.10
matiko09: posts the ante $0.10
vlad11122007: posts the ante $0.10
TonnaMunz: posts the ante $0.10
i L00K great: posts the ante $0.10
Optimistic21: posts the ante $0.10
Kud3: posts the ante $0.10
*** HOLE CARDS ***
Dealt to matiko09 [Ah Kd]
matiko09: raises $1 to $1.50
vlad11122007: folds 
TonnaMunz: folds 
i L00K great: folds 
Optimistic21: folds 
Kud3: raises $3.50 to $5
mexx1234: folds 
ruyingren: folds 
matiko09: calls $3.50
*** FLOP *** [Qs 3d 7s]
matiko09: checks 
Kud3: bets $7.94
matiko09: folds 
Uncalled bet ($7.94) returned to Kud3
Kud3 collected $11.03 from pot
Kud3: doesn't show hand 
*** SUMMARY ***
Total pot $11.55 | Rake $0.52 
Board [Qs 3d 7s]
Seat 1: mexx1234 (small blind) folded before Flop
Seat 3: ruyingren (big blind) folded before Flop
Seat 4: matiko09 folded on the Flop
Seat 5: vlad11122007 folded before Flop (didn't bet)
Seat 6: TonnaMunz folded before Flop (didn't bet)
Seat 7: i L00K great folded before Flop (didn't bet)
Seat 8: Optimistic21 folded before Flop (didn't bet)
Seat 9: Kud3 (button) collected ($11.03)





PokerStars Hand #148608284400:  Hold'em No Limit ($0.50/$1.00 USD) - 2016/02/11 12:52:32 CET [2016/02/11 6:52:32 ET]
Table 'Rasalas' 9-max Seat #8 is the button
Seat 1: Tissue51 ($100 in chips) 
Seat 2: azzad2007 ($109.45 in chips) 
Seat 3: Luck In Me ($100 in chips) 
Seat 4: Sweden_Pound ($102 in chips) 
Seat 5: Saggitaurus ($103.64 in chips) 
Seat 6: DUkalisUA ($100 in chips) 
Seat 7: matiko09 ($100 in chips) 
Seat 8: gwwsb ($71.04 in chips) 
Seat 9: hurtNCYDE ($100 in chips) 
hurtNCYDE: posts small blind $0.50
Tissue51: posts big blind $1
*** HOLE CARDS ***
Dealt to matiko09 [Qh 7d]
azzad2007: folds 
Luck In Me: folds 
Sweden_Pound: folds 
Saggitaurus: folds 
DUkalisUA: folds 
matiko09: folds 
gwwsb: raises $1 to $2
hurtNCYDE: folds 
Tissue51: calls $1
*** FLOP *** [Ah 3d Ad]
Tissue51: checks 
gwwsb: checks 
*** TURN *** [Ah 3d Ad] [2d]
Tissue51: checks 
gwwsb: checks 
*** RIVER *** [Ah 3d Ad 2d] [4c]
Tissue51: checks 
gwwsb: bets $3
Tissue51: folds 
Uncalled bet ($3) returned to gwwsb
gwwsb collected $4.30 from pot
gwwsb: doesn't show hand 
*** SUMMARY ***
Total pot $4.50 | Rake $0.20 
Board [Ah 3d Ad 2d 4c]
Seat 1: Tissue51 (big blind) folded on the River
Seat 2: azzad2007 folded before Flop (didn't bet)
Seat 3: Luck In Me folded before Flop (didn't bet)
Seat 4: Sweden_Pound folded before Flop (didn't bet)
Seat 5: Saggitaurus folded before Flop (didn't bet)
Seat 6: DUkalisUA folded before Flop (didn't bet)
Seat 7: matiko09 folded before Flop (didn't bet)
Seat 8: gwwsb (button) collected ($4.30)
Seat 9: hurtNCYDE (small blind) folded before Flop





PokerStars Hand #148608288261:  Hold'em No Limit ($0.50/$1.00 USD) - 2016/02/11 12:52:38 CET [2016/02/11 6:52:38 ET]
Table 'Sycorax II' 9-max Seat #9 is the button
Seat 1: Luck In Me ($165.93 in chips) 
Seat 2: Filojoes ($100 in chips) 
Seat 5: Effort92 ($154.04 in chips) 
Seat 6: FluentFlows ($44.76 in chips) 
Seat 7: PacPacBum ($122.71 in chips) 
Seat 8: matiko09 ($254.96 in chips) 
Seat 9: mrfoldcall ($97.01 in chips) 
Luck In Me: posts small blind $0.50
Filojoes: posts big blind $1
*** HOLE CARDS ***
Dealt to matiko09 [6c 9s]
Effort92: folds 
FluentFlows: folds 
PacPacBum: folds 
matiko09: folds 
mrfoldcall: folds 
Luck In Me: folds 
Uncalled bet ($0.50) returned to Filojoes
Filojoes collected $1 from pot
Filojoes: doesn't show hand 
*** SUMMARY ***
Total pot $1 | Rake $0 
Seat 1: Luck In Me (small blind) folded before Flop
Seat 2: Filojoes (big blind) collected ($1)
Seat 5: Effort92 folded before Flop (didn't bet)
Seat 6: FluentFlows folded before Flop (didn't bet)
Seat 7: PacPacBum folded before Flop (didn't bet)
Seat 8: matiko09 folded before Flop (didn't bet)
Seat 9: mrfoldcall (button) folded before Flop (didn't bet)





PokerStars Hand #148608290225:  Hold'em No Limit (€0.25/€0.50 EUR) - 2016/02/11 12:52:42 CET [2016/02/11 6:52:42 ET]
Table 'Otero II' 9-max Seat #5 is the button
Seat 1: Nacho2556 (€50.36 in chips) 
Seat 2: make6a (€45.98 in chips) 
Seat 3: Szevasztopol (€50.75 in chips) 
Seat 4: kram0909 (€3.97 in chips) 
Seat 5: vlad11122007 (€50.94 in chips) 
Seat 6: TonnaMunz (€54.29 in chips) 
Seat 8: matiko09 (€70.93 in chips) 
Seat 9: Optimistic21 (€71.25 in chips) 
TonnaMunz: posts small blind €0.25
PacPacBum: is sitting out 
matiko09: posts big blind €0.50
*** HOLE CARDS ***
Dealt to matiko09 [Ac 4d]
PacPacBum leaves the table
Optimistic21: folds 
Dflingern95 joins the table at seat #7 
Nacho2556: calls €0.50
make6a: folds 
Szevasztopol: folds 
kram0909: folds 
vlad11122007: folds 
TonnaMunz: raises €1.50 to €2
matiko09: folds 
Nacho2556: calls €1.50
*** FLOP *** [8c 6d Qc]
TonnaMunz: bets €2.25
Nacho2556: raises €5.75 to €8
TonnaMunz: folds 
Uncalled bet (€5.75) returned to Nacho2556
kram0909 is disconnected 
Nacho2556 collected €8.60 from pot
*** SUMMARY ***
Total pot €9 | Rake €0.40 
Board [8c 6d Qc]
Seat 1: Nacho2556 collected (€8.60)
Seat 2: make6a folded before Flop (didn't bet)
Seat 3: Szevasztopol folded before Flop (didn't bet)
Seat 4: kram0909 folded before Flop (didn't bet)
Seat 5: vlad11122007 (button) folded before Flop (didn't bet)
Seat 6: TonnaMunz (small blind) folded on the Flop
Seat 8: matiko09 (big blind) folded before Flop
Seat 9: Optimistic21 folded before Flop (didn't bet)





PokerStars Hand #148608296045:  Hold'em No Limit ($0.25/$0.50 USD) - 2016/02/11 12:52:52 CET [2016/02/11 6:52:52 ET]
Table 'Ambrosia II' 9-max Seat #7 is the button
Seat 1: matiko09 ($50 in chips) 
Seat 2: TheMinion ($114.87 in chips) 
Seat 4: huudk2016 ($45.19 in chips) 
Seat 5: RICKA16 ($49.25 in chips) 
Seat 6: Reven9er ($71.77 in chips) 
Seat 7: mexx1234 ($84.98 in chips) 
Seat 8: tallonn88 ($57.26 in chips) 
Seat 9: arctur17 ($69.79 in chips) 
tallonn88: posts small blind $0.25
arctur17: posts big blind $0.50
make6a: sits out 
*** HOLE CARDS ***
Dealt to matiko09 [5d 9s]
matiko09: folds 
TheMinion: folds 
huudk2016: calls $0.50
RICKA16: folds 
Reven9er: folds 
mexx1234: folds 
tallonn88: folds 
arctur17: checks 
*** FLOP *** [7d 2c 7h]
arctur17: checks 
huudk2016: bets $2
arctur17: calls $2
*** TURN *** [7d 2c 7h] [7c]
arctur17: checks 
huudk2016: bets $2.50
arctur17: calls $2.50
*** RIVER *** [7d 2c 7h 7c] [Ts]
arctur17: checks 
huudk2016: checks 
*** SHOW DOWN ***
arctur17: shows [7s 8h] (four of a kind, Sevens)
huudk2016: mucks hand 
arctur17 collected $9.79 from pot
*** SUMMARY ***
Total pot $10.25 | Rake $0.46 
Board [7d 2c 7h 7c Ts]
Seat 1: matiko09 folded before Flop (didn't bet)
Seat 2: TheMinion folded before Flop (didn't bet)
Seat 4: huudk2016 mucked [6h 5s]
Seat 5: RICKA16 folded before Flop (didn't bet)
Seat 6: Reven9er folded before Flop (didn't bet)
Seat 7: mexx1234 (button) folded before Flop (didn't bet)
Seat 8: tallonn88 (small blind) folded before Flop
Seat 9: arctur17 (big blind) showed [7s 8h] and won ($9.79) with four of a kind, Sevens





PokerStars Hand #148608297421:  Hold'em No Limit ($0.50/$1.00 USD) - 2016/02/11 12:52:54 CET [2016/02/11 6:52:54 ET]
Table 'Sycorax II' 9-max Seat #1 is the button
Seat 1: Luck In Me ($165.43 in chips) 
Seat 2: Filojoes ($100.50 in chips) 
Seat 6: FluentFlows ($44.76 in chips) 
Seat 7: PacPacBum ($122.71 in chips) 
Seat 8: matiko09 ($254.96 in chips) 
Seat 9: mrfoldcall ($97.01 in chips) 
Filojoes: posts small blind $0.50
Effort92: is sitting out 
FluentFlows: posts big blind $1
*** HOLE CARDS ***
Dealt to matiko09 [2c Qs]
PacPacBum: folds 
hurtNCYDE joins the table at seat #4 
matiko09: folds 
mrfoldcall: folds 
hurtNCYDE leaves the table
oscarleon joins the table at seat #4 
Luck In Me: folds 
Filojoes: folds 
Uncalled bet ($0.50) returned to FluentFlows
FluentFlows collected $1 from pot
FluentFlows: doesn't show hand 
*** SUMMARY ***
Total pot $1 | Rake $0 
Seat 1: Luck In Me (button) folded before Flop (didn't bet)
Seat 2: Filojoes (small blind) folded before Flop
Seat 6: FluentFlows (big blind) collected ($1)
Seat 7: PacPacBum folded before Flop (didn't bet)
Seat 8: matiko09 folded before Flop (didn't bet)
Seat 9: mrfoldcall folded before Flop (didn't bet)





PokerStars Hand #148608301376:  Hold'em No Limit ($0.50/$1.00 USD) - 2016/02/11 12:53:01 CET [2016/02/11 6:53:01 ET]
Table 'Regor' 9-max Seat #1 is the button
Seat 1: matiko09 ($141 in chips) 
Seat 2: Luck In Me ($100 in chips) 
Seat 3: oscarleon ($157.88 in chips) 
Seat 4: Filojoes ($101.50 in chips) 
Seat 6: Dachish ($88.95 in chips) 
Seat 7: Sweden_Pound ($100 in chips) 
Seat 8: R3NZONIT3 ($50.66 in chips) 
Seat 9: CoolFireX ($130.21 in chips) 
Luck In Me: posts small blind $0.50
oscarleon: posts big blind $1
*** HOLE CARDS ***
Dealt to matiko09 [8d 4h]
Filojoes: folds 
Dachish: folds 
Sweden_Pound: folds 
R3NZONIT3 has timed out
R3NZONIT3: folds 
CoolFireX: folds 
matiko09: folds 
Luck In Me: raises $2 to $3
oscarleon: folds 
Uncalled bet ($2) returned to Luck In Me
Luck In Me collected $2 from pot
Luck In Me: doesn't show hand 
*** SUMMARY ***
Total pot $2 | Rake $0 
Seat 1: matiko09 (button) folded before Flop (didn't bet)
Seat 2: Luck In Me (small blind) collected ($2)
Seat 3: oscarleon (big blind) folded before Flop
Seat 4: Filojoes folded before Flop (didn't bet)
Seat 6: Dachish folded before Flop (didn't bet)
Seat 7: Sweden_Pound folded before Flop (didn't bet)
Seat 8: R3NZONIT3 folded before Flop (didn't bet)
Seat 9: CoolFireX folded before Flop (didn't bet)





PokerStars Hand #148608301285:  Hold'em No Limit ($0.25/$0.50 USD) - 2016/02/11 12:53:01 CET [2016/02/11 6:53:01 ET]
Table 'Stereoskopia' 9-max Seat #2 is the button
Seat 1: 50CandyJoe ($50.40 in chips) 
Seat 2: Optimistic21 ($56.25 in chips) 
Seat 3: Donko jr ($56.01 in chips) 
Seat 5: ReinisRNS ($30.23 in chips) 
Seat 6: matiko09 ($50 in chips) 
Seat 7: tallonn88 ($56.22 in chips) 
Seat 8: vlad11122007 ($50 in chips) 
Seat 9: apfush ($82.69 in chips) 
Donko jr: posts small blind $0.25
ReinisRNS: posts big blind $0.50
*** HOLE CARDS ***
Dealt to matiko09 [8h Kd]
matiko09: folds 
tallonn88: folds 
vlad11122007: folds 
apfush: folds 
50CandyJoe: folds 
Optimistic21: raises $0.50 to $1
Donko jr: folds 
ReinisRNS: folds 
Uncalled bet ($0.50) returned to Optimistic21
Optimistic21 collected $1.25 from pot
*** SUMMARY ***
Total pot $1.25 | Rake $0 
Seat 1: 50CandyJoe folded before Flop (didn't bet)
Seat 2: Optimistic21 (button) collected ($1.25)
Seat 3: Donko jr (small blind) folded before Flop
Seat 5: ReinisRNS (big blind) folded before Flop
Seat 6: matiko09 folded before Flop (didn't bet)
Seat 7: tallonn88 folded before Flop (didn't bet)
Seat 8: vlad11122007 folded before Flop (didn't bet)
Seat 9: apfush folded before Flop (didn't bet)





PokerStars Hand #148608305923:  Hold'em No Limit ($0.25/$0.50 USD) - 2016/02/11 12:53:10 CET [2016/02/11 6:53:10 ET]
Table 'Algedi' 9-max Seat #5 is the button
Seat 1: vlad11122007 ($53.55 in chips) 
Seat 2: Reffypaul ($56.30 in chips) 
Seat 3: Saggitaurus ($114.84 in chips) 
Seat 4: Effort92 ($60.41 in chips) 
Seat 5: Optimistic21 ($60.73 in chips) 
Seat 6: TonnaMunz ($126.74 in chips) 
Seat 7: hoedtrob ($57.89 in chips) 
Seat 8: matiko09 ($50 in chips) 
Seat 9: Kud3 ($125 in chips) 
TonnaMunz: posts small blind $0.25
hoedtrob: posts big blind $0.50
vlad11122007: posts the ante $0.10
Reffypaul: posts the ante $0.10
Saggitaurus: posts the ante $0.10
Effort92: posts the ante $0.10
Optimistic21: posts the ante $0.10
TonnaMunz: posts the ante $0.10
hoedtrob: posts the ante $0.10
matiko09: posts the ante $0.10
Kud3: posts the ante $0.10
*** HOLE CARDS ***
Dealt to matiko09 [3d 7c]
matiko09: folds 
Kud3: folds 
vlad11122007: folds 
Reffypaul: calls $0.50
Saggitaurus: raises $2 to $2.50
Effort92: folds 
hoedtrob said, "or, if u dont care, u can tell me what u had"
Optimistic21: folds 
TonnaMunz: raises $5 to $7.50
hoedtrob: folds 
Reffypaul: folds 
hoedtrob said, "at least a flush"
hoedtrob said, "K"
hoedtrob said, "or better"
Saggitaurus: raises $15 to $22.50
TonnaMunz: folds 
Uncalled bet ($15) returned to Saggitaurus
Saggitaurus collected $16.90 from pot
Saggitaurus: doesn't show hand 
*** SUMMARY ***
Total pot $16.90 | Rake $0 
Seat 1: vlad11122007 folded before Flop (didn't bet)
Seat 2: Reffypaul folded before Flop
Seat 3: Saggitaurus collected ($16.90)
Seat 4: Effort92 folded before Flop (didn't bet)
Seat 5: Optimistic21 (button) folded before Flop (didn't bet)
Seat 6: TonnaMunz (small blind) folded before Flop
Seat 7: hoedtrob (big blind) folded before Flop
Seat 8: matiko09 folded before Flop (didn't bet)
Seat 9: Kud3 folded before Flop (didn't bet)





PokerStars Hand #148608311633:  Hold'em No Limit ($0.50/$1.00 USD) - 2016/02/11 12:53:20 CET [2016/02/11 6:53:20 ET]
Table 'Sycorax II' 9-max Seat #2 is the button
Seat 1: Luck In Me ($165.43 in chips) 
Seat 2: Filojoes ($100 in chips) 
Seat 6: FluentFlows ($45.26 in chips) 
Seat 8: matiko09 ($254.96 in chips) 
Seat 9: mrfoldcall ($97.01 in chips) 
oscarleon will be allowed to play after the button
FluentFlows: posts small blind $0.50
PacPacBum: is sitting out 
matiko09: posts big blind $1
*** HOLE CARDS ***
Dealt to matiko09 [6d 8d]
PacPacBum leaves the table
mrfoldcall: folds 
Luck In Me: folds 
Filojoes: folds 
FluentFlows: folds 
Uncalled bet ($0.50) returned to matiko09
matiko09 collected $1 from pot
matiko09: doesn't show hand 
aseban11 joins the table at seat #7 
*** SUMMARY ***
Total pot $1 | Rake $0 
Seat 1: Luck In Me folded before Flop (didn't bet)
Seat 2: Filojoes (button) folded before Flop (didn't bet)
Seat 6: FluentFlows (small blind) folded before Flop
Seat 8: matiko09 (big blind) collected ($1)
Seat 9: mrfoldcall folded before Flop (didn't bet)





PokerStars Hand #148608317489:  Hold'em No Limit ($0.25/$0.50 USD) - 2016/02/11 12:53:30 CET [2016/02/11 6:53:30 ET]
Table 'Stereoskopia' 9-max Seat #3 is the button
Seat 1: 50CandyJoe ($50.40 in chips) 
Seat 2: Optimistic21 ($57 in chips) 
Seat 3: Donko jr ($55.76 in chips) 
Seat 5: ReinisRNS ($29.73 in chips) 
Seat 6: matiko09 ($50 in chips) 
Seat 7: tallonn88 ($56.22 in chips) 
Seat 8: vlad11122007 ($50 in chips) 
Seat 9: apfush ($82.69 in chips) 
ReinisRNS: posts small blind $0.25
matiko09: posts big blind $0.50
*** HOLE CARDS ***
Dealt to matiko09 [7c Jh]
tallonn88: folds 
vlad11122007: folds 
apfush: folds 
50CandyJoe: raises $1 to $1.50
Optimistic21: folds 
Donko jr: folds 
ReinisRNS: folds 
matiko09: folds 
Uncalled bet ($1) returned to 50CandyJoe
50CandyJoe collected $1.25 from pot
50CandyJoe: doesn't show hand 
*** SUMMARY ***
Total pot $1.25 | Rake $0 
Seat 1: 50CandyJoe collected ($1.25)
Seat 2: Optimistic21 folded before Flop (didn't bet)
Seat 3: Donko jr (button) folded before Flop (didn't bet)
Seat 5: ReinisRNS (small blind) folded before Flop
Seat 6: matiko09 (big blind) folded before Flop
Seat 7: tallonn88 folded before Flop (didn't bet)
Seat 8: vlad11122007 folded before Flop (didn't bet)
Seat 9: apfush folded before Flop (didn't bet)





PokerStars Hand #148608317692:  Hold'em No Limit ($0.50/$1.00 USD) - 2016/02/11 12:53:30 CET [2016/02/11 6:53:30 ET]
Table 'Sycorax II' 9-max Seat #6 is the button
Seat 1: Luck In Me ($165.43 in chips) 
Seat 2: Filojoes ($100 in chips) 
Seat 6: FluentFlows ($44.76 in chips) 
Seat 8: matiko09 ($255.46 in chips) 
Seat 9: mrfoldcall ($97.01 in chips) 
aseban11 will be allowed to play after the button
matiko09: posts small blind $0.50
mrfoldcall: posts big blind $1
oscarleon: sits out 
*** HOLE CARDS ***
Dealt to matiko09 [7c 3c]
Luck In Me: folds 
Filojoes: folds 
FluentFlows: folds 
matiko09: folds 
Uncalled bet ($0.50) returned to mrfoldcall
mrfoldcall collected $1 from pot
mrfoldcall: doesn't show hand 
*** SUMMARY ***
Total pot $1 | Rake $0 
Seat 1: Luck In Me folded before Flop (didn't bet)
Seat 2: Filojoes folded before Flop (didn't bet)
Seat 6: FluentFlows (button) folded before Flop (didn't bet)
Seat 8: matiko09 (small blind) folded before Flop
Seat 9: mrfoldcall (big blind) collected ($1)





PokerStars Hand #148608317407:  Hold'em No Limit ($0.25/$0.50 USD) - 2016/02/11 12:53:30 CET [2016/02/11 6:53:30 ET]
Table 'Risha' 9-max Seat #1 is the button
Seat 1: Kud3 ($146.13 in chips) 
Seat 4: matiko09 ($62.25 in chips) 
Seat 6: TonnaMunz ($73.81 in chips) 
matiko09: posts small blind $0.25
TonnaMunz: posts big blind $0.50
Kud3: posts the ante $0.10
matiko09: posts the ante $0.10
TonnaMunz: posts the ante $0.10
*** HOLE CARDS ***
Dealt to matiko09 [Jc 6d]
Kud3: raises $0.75 to $1.25
matiko09: folds 
TuaaL leaves the table
TonnaMunz: calls $0.75
*** FLOP *** [6h 4s Jh]
TonnaMunz: checks 
Kud3: checks 
*** TURN *** [6h 4s Jh] [Tc]
TonnaMunz: checks 
Kud3: checks 
*** RIVER *** [6h 4s Jh Tc] [3s]
TonnaMunz: checks 
Kud3: checks 
*** SHOW DOWN ***
TonnaMunz: shows [Qh As] (high card Ace)
Kud3: mucks hand 
TonnaMunz collected $2.91 from pot
*** SUMMARY ***
Total pot $3.05 | Rake $0.14 
Board [6h 4s Jh Tc 3s]
Seat 1: Kud3 (button) mucked [5s Ks]
Seat 4: matiko09 (small blind) folded before Flop
Seat 6: TonnaMunz (big blind) showed [Qh As] and won ($2.91) with high card Ace





PokerStars Hand #148608321437:  Hold'em No Limit ($0.50/$1.00 USD) - 2016/02/11 12:53:37 CET [2016/02/11 6:53:37 ET]
Table 'Rasalas' 9-max Seat #9 is the button
Seat 1: Tissue51 ($100 in chips) 
Seat 2: azzad2007 ($109.45 in chips) 
Seat 3: Luck In Me ($100 in chips) 
Seat 4: Sweden_Pound ($102 in chips) 
Seat 5: Saggitaurus ($103.64 in chips) 
Seat 6: DUkalisUA ($100 in chips) 
Seat 7: matiko09 ($100 in chips) 
Seat 8: gwwsb ($73.34 in chips) 
Seat 9: hurtNCYDE ($100 in chips) 
Tissue51: posts small blind $0.50
azzad2007: posts big blind $1
*** HOLE CARDS ***
Dealt to matiko09 [4d 5s]
Luck In Me: folds 
Sweden_Pound: folds 
Saggitaurus: folds 
DUkalisUA: folds 
matiko09: folds 
gwwsb: folds 
hurtNCYDE: raises $1.50 to $2.50
Tissue51: folds 
azzad2007: calls $1.50
*** FLOP *** [Ah 5h Kd]
azzad2007: checks 
hurtNCYDE: bets $1.78
azzad2007: calls $1.78
*** TURN *** [Ah 5h Kd] [8h]
azzad2007: checks 
hurtNCYDE: bets $8.13
azzad2007: folds 
Uncalled bet ($8.13) returned to hurtNCYDE
hurtNCYDE collected $8.65 from pot
*** SUMMARY ***
Total pot $9.06 | Rake $0.41 
Board [Ah 5h Kd 8h]
Seat 1: Tissue51 (small blind) folded before Flop
Seat 2: azzad2007 (big blind) folded on the Turn
Seat 3: Luck In Me folded before Flop (didn't bet)
Seat 4: Sweden_Pound folded before Flop (didn't bet)
Seat 5: Saggitaurus folded before Flop (didn't bet)
Seat 6: DUkalisUA folded before Flop (didn't bet)
Seat 7: matiko09 folded before Flop (didn't bet)
Seat 8: gwwsb folded before Flop (didn't bet)
Seat 9: hurtNCYDE (button) collected ($8.65)





PokerStars Hand #148608325691:  Hold'em No Limit ($0.25/$0.50 USD) - 2016/02/11 12:53:44 CET [2016/02/11 6:53:44 ET]
Table 'Sylvania II' 9-max Seat #1 is the button
Seat 1: mexx1234 ($195.23 in chips) 
Seat 3: ruyingren ($191.41 in chips) 
Seat 4: matiko09 ($150.54 in chips) 
Seat 5: vlad11122007 ($67.49 in chips) 
Seat 6: TonnaMunz ($128.16 in chips) 
Seat 7: i L00K great ($50 in chips) 
Seat 8: Optimistic21 ($50 in chips) 
Seat 9: Kud3 ($136.83 in chips) 
ruyingren: posts small blind $0.25
matiko09: posts big blind $0.50
mexx1234: posts the ante $0.10
ruyingren: posts the ante $0.10
matiko09: posts the ante $0.10
vlad11122007: posts the ante $0.10
TonnaMunz: posts the ante $0.10
i L00K great: posts the ante $0.10
Optimistic21: posts the ante $0.10
Kud3: posts the ante $0.10
*** HOLE CARDS ***
Dealt to matiko09 [4c 7s]
vlad11122007: folds 
TonnaMunz: folds 
i L00K great: folds 
Optimistic21: folds 
Kud3: folds 
mexx1234: raises $0.75 to $1.25
ruyingren: raises $4.75 to $6
matiko09: folds 
mexx1234: folds 
Uncalled bet ($4.75) returned to ruyingren
ruyingren collected $3.80 from pot
*** SUMMARY ***
Total pot $3.80 | Rake $0 
Seat 1: mexx1234 (button) folded before Flop
Seat 3: ruyingren (small blind) collected ($3.80)
Seat 4: matiko09 (big blind) folded before Flop
Seat 5: vlad11122007 folded before Flop (didn't bet)
Seat 6: TonnaMunz folded before Flop (didn't bet)
Seat 7: i L00K great folded before Flop (didn't bet)
Seat 8: Optimistic21 folded before Flop (didn't bet)
Seat 9: Kud3 folded before Flop (didn't bet)





PokerStars Hand #148608329965:  Hold'em No Limit ($0.50/$1.00 USD) - 2016/02/11 12:53:52 CET [2016/02/11 6:53:52 ET]
Table 'Kleopatra II' 9-max Seat #1 is the button
Seat 1: torkkdnm ($108.24 in chips) 
Seat 4: Filojoes ($103.65 in chips) 
Seat 6: DUkalisUA ($100 in chips) 
Seat 7: PacPacBum ($120.49 in chips) 
Seat 8: oscarleon ($100 in chips) 
Seat 9: matiko09 ($100 in chips) 
713123 will be allowed to play after the button
Filojoes: posts small blind $0.50
CoolFireX: is sitting out 
DUkalisUA: posts big blind $1
*** HOLE CARDS ***
Dealt to matiko09 [3d Kd]
CoolFireX leaves the table
Sweden_Pound joins the table at seat #5 
PacPacBum: raises $1.04 to $2.04
oscarleon: folds 
matiko09: folds 
torkkdnm: folds 
Filojoes: folds 
DUkalisUA: folds 
Uncalled bet ($1.04) returned to PacPacBum
PacPacBum collected $2.50 from pot
PacPacBum: doesn't show hand 
*** SUMMARY ***
Total pot $2.50 | Rake $0 
Seat 1: torkkdnm (button) folded before Flop (didn't bet)
Seat 4: Filojoes (small blind) folded before Flop
Seat 6: DUkalisUA (big blind) folded before Flop
Seat 7: PacPacBum collected ($2.50)
Seat 8: oscarleon folded before Flop (didn't bet)
Seat 9: matiko09 folded before Flop (didn't bet)





PokerStars Hand #148608331301:  Hold'em No Limit ($0.50/$1.00 USD) - 2016/02/11 12:53:54 CET [2016/02/11 6:53:54 ET]
Table 'Sycorax II' 9-max Seat #8 is the button
Seat 1: Luck In Me ($165.43 in chips) 
Seat 2: Filojoes ($100 in chips) 
Seat 6: FluentFlows ($44.76 in chips) 
Seat 8: matiko09 ($254.96 in chips) 
Seat 9: mrfoldcall ($97.51 in chips) 
mrfoldcall: posts small blind $0.50
Luck In Me: posts big blind $1
oscarleon: sits out 
*** HOLE CARDS ***
Dealt to matiko09 [6s 2h]
Filojoes: folds 
FluentFlows: folds 
matiko09: folds 
mrfoldcall: folds 
Uncalled bet ($0.50) returned to Luck In Me
Luck In Me collected $1 from pot
Luck In Me: doesn't show hand 
*** SUMMARY ***
Total pot $1 | Rake $0 
Seat 1: Luck In Me (big blind) collected ($1)
Seat 2: Filojoes folded before Flop (didn't bet)
Seat 6: FluentFlows folded before Flop (didn't bet)
Seat 8: matiko09 (button) folded before Flop (didn't bet)
Seat 9: mrfoldcall (small blind) folded before Flop





PokerStars Hand #148608334692:  Hold'em No Limit ($0.25/$0.50 USD) - 2016/02/11 12:54:00 CET [2016/02/11 6:54:00 ET]
Table 'Stereoskopia' 9-max Seat #5 is the button
Seat 1: 50CandyJoe ($51.15 in chips) 
Seat 2: Optimistic21 ($57 in chips) 
Seat 3: Donko jr ($55.76 in chips) 
Seat 5: ReinisRNS ($29.48 in chips) 
Seat 6: matiko09 ($50 in chips) 
Seat 7: tallonn88 ($56.22 in chips) 
Seat 8: vlad11122007 ($50 in chips) 
Seat 9: apfush ($82.69 in chips) 
matiko09: posts small blind $0.25
tallonn88: posts big blind $0.50
*** HOLE CARDS ***
Dealt to matiko09 [7c 8s]
vlad11122007: folds 
apfush: folds 
50CandyJoe: folds 
Optimistic21: raises $1 to $1.50
Donko jr: folds 
ReinisRNS: folds 
matiko09: folds 
tallonn88: folds 
Uncalled bet ($1) returned to Optimistic21
Optimistic21 collected $1.25 from pot
*** SUMMARY ***
Total pot $1.25 | Rake $0 
Seat 1: 50CandyJoe folded before Flop (didn't bet)
Seat 2: Optimistic21 collected ($1.25)
Seat 3: Donko jr folded before Flop (didn't bet)
Seat 5: ReinisRNS (button) folded before Flop (didn't bet)
Seat 6: matiko09 (small blind) folded before Flop
Seat 7: tallonn88 (big blind) folded before Flop
Seat 8: vlad11122007 folded before Flop (didn't bet)
Seat 9: apfush folded before Flop (didn't bet)





PokerStars Hand #148608334423:  Hold'em No Limit ($0.50/$1.00 USD) - 2016/02/11 12:54:00 CET [2016/02/11 6:54:00 ET]
Table 'Regor' 9-max Seat #2 is the button
Seat 1: matiko09 ($141 in chips) 
Seat 2: Luck In Me ($101 in chips) 
Seat 3: oscarleon ($156.88 in chips) 
Seat 4: Filojoes ($101.50 in chips) 
Seat 6: Dachish ($88.95 in chips) 
Seat 7: Sweden_Pound ($100 in chips) 
Seat 9: CoolFireX ($130.21 in chips) 
oscarleon: posts small blind $0.50
Filojoes: posts big blind $1
*** HOLE CARDS ***
Dealt to matiko09 [Ac Qh]
Dachish: folds 
Sweden_Pound: folds 
CoolFireX: folds 
matiko09: raises $1.50 to $2.50
Luck In Me: folds 
oscarleon: folds 
Filojoes: folds 
Uncalled bet ($1.50) returned to matiko09
matiko09 collected $2.50 from pot
matiko09: doesn't show hand 
*** SUMMARY ***
Total pot $2.50 | Rake $0 
Seat 1: matiko09 collected ($2.50)
Seat 2: Luck In Me (button) folded before Flop (didn't bet)
Seat 3: oscarleon (small blind) folded before Flop
Seat 4: Filojoes (big blind) folded before Flop
Seat 6: Dachish folded before Flop (didn't bet)
Seat 7: Sweden_Pound folded before Flop (didn't bet)
Seat 9: CoolFireX folded before Flop (didn't bet)





PokerStars Hand #148608338463:  Hold'em No Limit (€0.25/€0.50 EUR) - 2016/02/11 12:54:07 CET [2016/02/11 6:54:07 ET]
Table 'Otero II' 9-max Seat #6 is the button
Seat 1: Nacho2556 (€54.71 in chips) 
Seat 2: make6a (€45.98 in chips) 
Seat 3: Szevasztopol (€50.75 in chips) 
Seat 4: kram0909 (€3.97 in chips) 
Seat 5: vlad11122007 (€50.94 in chips) 
Seat 6: TonnaMunz (€50.04 in chips) 
Seat 8: matiko09 (€70.43 in chips) 
Seat 9: Optimistic21 (€71.25 in chips) 
Dflingern95 will be allowed to play after the button
matiko09: posts small blind €0.25
Optimistic21: posts big blind €0.50
*** HOLE CARDS ***
Dealt to matiko09 [6d 6c]
Nacho2556: folds 
make6a: folds 
Szevasztopol: folds 
kram0909: folds 
vlad11122007: folds 
TonnaMunz: raises €0.68 to €1.18
matiko09: folds 
Optimistic21: calls €0.68
*** FLOP *** [Td Qd Ac]
Optimistic21: checks 
kram0909 is disconnected 
TonnaMunz: bets €1.75
Optimistic21: folds 
Uncalled bet (€1.75) returned to TonnaMunz
TonnaMunz collected €2.49 from pot
*** SUMMARY ***
Total pot €2.61 | Rake €0.12 
Board [Td Qd Ac]
Seat 1: Nacho2556 folded before Flop (didn't bet)
Seat 2: make6a folded before Flop (didn't bet)
Seat 3: Szevasztopol folded before Flop (didn't bet)
Seat 4: kram0909 folded before Flop (didn't bet)
Seat 5: vlad11122007 folded before Flop (didn't bet)
Seat 6: TonnaMunz (button) collected (€2.49)
Seat 8: matiko09 (small blind) folded before Flop
Seat 9: Optimistic21 (big blind) folded on the Flop





PokerStars Hand #148608340400:  Hold'em No Limit ($0.50/$1.00 USD) - 2016/02/11 12:54:10 CET [2016/02/11 6:54:10 ET]
Table 'Sycorax II' 9-max Seat #9 is the button
Seat 1: Luck In Me ($165.93 in chips) 
Seat 2: Filojoes ($100 in chips) 
Seat 6: FluentFlows ($44.76 in chips) 
Seat 8: matiko09 ($254.96 in chips) 
Seat 9: mrfoldcall ($97.01 in chips) 
Luck In Me: posts small blind $0.50
Filojoes: posts big blind $1
oscarleon: sits out 
*** HOLE CARDS ***
Dealt to matiko09 [6s Qc]
FluentFlows: folds 
matiko09: folds 
mrfoldcall: raises $2 to $3
Luck In Me: folds 
Filojoes: folds 
Uncalled bet ($2) returned to mrfoldcall
mrfoldcall collected $2.50 from pot
mrfoldcall: doesn't show hand 
*** SUMMARY ***
Total pot $2.50 | Rake $0 
Seat 1: Luck In Me (small blind) folded before Flop
Seat 2: Filojoes (big blind) folded before Flop
Seat 6: FluentFlows folded before Flop (didn't bet)
Seat 8: matiko09 folded before Flop (didn't bet)
Seat 9: mrfoldcall (button) collected ($2.50)





PokerStars Hand #148608344742:  Hold'em No Limit ($0.50/$1.00 USD) - 2016/02/11 12:54:18 CET [2016/02/11 6:54:18 ET]
Table 'Kleopatra II' 9-max Seat #4 is the button
Seat 1: torkkdnm ($108.24 in chips) 
Seat 4: Filojoes ($103.15 in chips) 
Seat 6: DUkalisUA ($100 in chips) 
Seat 8: oscarleon ($100 in chips) 
Seat 9: matiko09 ($100 in chips) 
Sweden_Pound will be allowed to play after the button
DUkalisUA: posts small blind $0.50
PacPacBum: is sitting out 
oscarleon: posts big blind $1
713123: sits out 
*** HOLE CARDS ***
Dealt to matiko09 [Jh Ks]
PacPacBum leaves the table
Zeeshka joins the table at seat #7 
matiko09: folds 
torkkdnm: folds 
Filojoes: raises $1 to $2
DUkalisUA: folds 
oscarleon: calls $1
*** FLOP *** [5d 4h 6s]
oscarleon: checks 
Filojoes: bets $2.58
oscarleon: calls $2.58
*** TURN *** [5d 4h 6s] [2d]
oscarleon: checks 
Filojoes: checks 
*** RIVER *** [5d 4h 6s 2d] [9h]
oscarleon: checks 
Filojoes: checks 
*** SHOW DOWN ***
oscarleon: shows [Ah 4s] (a pair of Fours)
Filojoes: shows [As 6d] (a pair of Sixes)
Filojoes collected $9.23 from pot
*** SUMMARY ***
Total pot $9.66 | Rake $0.43 
Board [5d 4h 6s 2d 9h]
Seat 1: torkkdnm folded before Flop (didn't bet)
Seat 4: Filojoes (button) showed [As 6d] and won ($9.23) with a pair of Sixes
Seat 6: DUkalisUA (small blind) folded before Flop
Seat 8: oscarleon (big blind) showed [Ah 4s] and lost with a pair of Fours
Seat 9: matiko09 folded before Flop (didn't bet)





PokerStars Hand #148608350490:  Hold'em No Limit ($0.25/$0.50 USD) - 2016/02/11 12:54:28 CET [2016/02/11 6:54:28 ET]
Table 'Ambrosia II' 9-max Seat #8 is the button
Seat 1: matiko09 ($50 in chips) 
Seat 2: TheMinion ($114.87 in chips) 
Seat 4: huudk2016 ($40.19 in chips) 
Seat 5: RICKA16 ($49.25 in chips) 
Seat 6: Reven9er ($71.77 in chips) 
Seat 7: mexx1234 ($84.98 in chips) 
Seat 8: tallonn88 ($57.01 in chips) 
Seat 9: arctur17 ($74.58 in chips) 
arctur17: posts small blind $0.25
matiko09: posts big blind $0.50
make6a: sits out 
*** HOLE CARDS ***
Dealt to matiko09 [9c Tc]
TheMinion: folds 
huudk2016: calls $0.50
RICKA16: folds 
Reven9er: folds 
mexx1234: folds 
tallonn88: folds 
arctur17: folds 
matiko09: raises $2 to $2.50
huudk2016: folds 
Uncalled bet ($2) returned to matiko09
matiko09 collected $1.25 from pot
matiko09: doesn't show hand 
*** SUMMARY ***
Total pot $1.25 | Rake $0 
Seat 1: matiko09 (big blind) collected ($1.25)
Seat 2: TheMinion folded before Flop (didn't bet)
Seat 4: huudk2016 folded before Flop
Seat 5: RICKA16 folded before Flop (didn't bet)
Seat 6: Reven9er folded before Flop (didn't bet)
Seat 7: mexx1234 folded before Flop (didn't bet)
Seat 8: tallonn88 (button) folded before Flop (didn't bet)
Seat 9: arctur17 (small blind) folded before Flop





PokerStars Hand #148608354939:  Hold'em No Limit ($0.25/$0.50 USD) - 2016/02/11 12:54:36 CET [2016/02/11 6:54:36 ET]
Table 'Algedi' 9-max Seat #6 is the button
Seat 1: vlad11122007 ($53.45 in chips) 
Seat 2: Reffypaul ($55.70 in chips) 
Seat 3: Saggitaurus ($124.14 in chips) 
Seat 4: Effort92 ($60.31 in chips) 
Seat 5: Optimistic21 ($60.63 in chips) 
Seat 6: TonnaMunz ($119.14 in chips) 
Seat 7: hoedtrob ($57.29 in chips) 
Seat 8: matiko09 ($50 in chips) 
Seat 9: Kud3 ($125 in chips) 
hoedtrob: posts small blind $0.25
matiko09: posts big blind $0.50
vlad11122007: posts the ante $0.10
Reffypaul: posts the ante $0.10
Saggitaurus: posts the ante $0.10
Effort92: posts the ante $0.10
Optimistic21: posts the ante $0.10
TonnaMunz: posts the ante $0.10
hoedtrob: posts the ante $0.10
matiko09: posts the ante $0.10
Kud3: posts the ante $0.10
*** HOLE CARDS ***
Dealt to matiko09 [2c Qh]
Kud3: folds 
vlad11122007: folds 
Reffypaul: folds 
Saggitaurus: folds 
Effort92: raises $1 to $1.50
Optimistic21: folds 
Saggitaurus said, "J J"
TonnaMunz: folds 
hoedtrob: folds 
matiko09: folds 
Uncalled bet ($1) returned to Effort92
Effort92 collected $2.15 from pot
Effort92: doesn't show hand 
*** SUMMARY ***
Total pot $2.15 | Rake $0 
Seat 1: vlad11122007 folded before Flop (didn't bet)
Seat 2: Reffypaul folded before Flop (didn't bet)
Seat 3: Saggitaurus folded before Flop (didn't bet)
Seat 4: Effort92 collected ($2.15)
Seat 5: Optimistic21 folded before Flop (didn't bet)
Seat 6: TonnaMunz (button) folded before Flop (didn't bet)
Seat 7: hoedtrob (small blind) folded before Flop
Seat 8: matiko09 (big blind) folded before Flop
Seat 9: Kud3 folded before Flop (didn't bet)





PokerStars Hand #148608355301:  Hold'em No Limit ($0.50/$1.00 USD) - 2016/02/11 12:54:37 CET [2016/02/11 6:54:37 ET]
Table 'Regor' 9-max Seat #3 is the button
Seat 1: matiko09 ($142.50 in chips) 
Seat 2: Luck In Me ($101 in chips) 
Seat 3: oscarleon ($156.38 in chips) 
Seat 4: Filojoes ($100.50 in chips) 
Seat 6: Dachish ($88.95 in chips) 
Seat 7: Sweden_Pound ($100 in chips) 
Seat 9: CoolFireX ($130.21 in chips) 
Filojoes: posts small blind $0.50
Dachish: posts big blind $1
*** HOLE CARDS ***
Dealt to matiko09 [8c 8s]
Sweden_Pound: folds 
Sweden_Pound leaves the table
CoolFireX: folds 
matiko09: raises $2 to $3
Luck In Me: folds 
oscarleon: calls $3
hurtNCYDE joins the table at seat #7 
Filojoes: folds 
hurtNCYDE leaves the table
Dachish: calls $2
*** FLOP *** [Jh Qd 2h]
Dachish: checks 
matiko09: checks 
oscarleon: bets $6
Dachish: folds 
matiko09: folds 
Uncalled bet ($6) returned to oscarleon
oscarleon collected $9.07 from pot
oscarleon: doesn't show hand 
*** SUMMARY ***
Total pot $9.50 | Rake $0.43 
Board [Jh Qd 2h]
Seat 1: matiko09 folded on the Flop
Seat 2: Luck In Me folded before Flop (didn't bet)
Seat 3: oscarleon (button) collected ($9.07)
Seat 4: Filojoes (small blind) folded before Flop
Seat 6: Dachish (big blind) folded on the Flop
Seat 7: Sweden_Pound folded before Flop (didn't bet)
Seat 9: CoolFireX folded before Flop (didn't bet)





PokerStars Hand #148608356796:  Hold'em No Limit ($0.50/$1.00 USD) - 2016/02/11 12:54:39 CET [2016/02/11 6:54:39 ET]
Table 'Sycorax II' 9-max Seat #1 is the button
Seat 1: Luck In Me ($165.43 in chips) 
Seat 2: Filojoes ($100 in chips) 
Seat 4: oscarleon ($101.50 in chips) 
Seat 6: FluentFlows ($44.76 in chips) 
Seat 8: matiko09 ($254.96 in chips) 
Seat 9: mrfoldcall ($98.51 in chips) 
Filojoes: posts small blind $0.50
oscarleon: posts big blind $1
*** HOLE CARDS ***
Dealt to matiko09 [8d 7h]
FluentFlows: folds 
matiko09: folds 
mrfoldcall: raises $2 to $3
Luck In Me: folds 
Filojoes: folds 
oscarleon: folds 
Uncalled bet ($2) returned to mrfoldcall
mrfoldcall collected $2.50 from pot
mrfoldcall: doesn't show hand 
*** SUMMARY ***
Total pot $2.50 | Rake $0 
Seat 1: Luck In Me (button) folded before Flop (didn't bet)
Seat 2: Filojoes (small blind) folded before Flop
Seat 4: oscarleon (big blind) folded before Flop
Seat 6: FluentFlows folded before Flop (didn't bet)
Seat 8: matiko09 folded before Flop (didn't bet)
Seat 9: mrfoldcall collected ($2.50)





PokerStars Hand #148608363412:  Hold'em No Limit ($0.25/$0.50 USD) - 2016/02/11 12:54:51 CET [2016/02/11 6:54:51 ET]
Table 'Stereoskopia' 9-max Seat #6 is the button
Seat 1: 50CandyJoe ($51.15 in chips) 
Seat 2: Optimistic21 ($57.75 in chips) 
Seat 3: Donko jr ($55.76 in chips) 
Seat 5: ReinisRNS ($50 in chips) 
Seat 6: matiko09 ($50 in chips) 
Seat 7: tallonn88 ($55.72 in chips) 
Seat 8: vlad11122007 ($50 in chips) 
Seat 9: apfush ($82.69 in chips) 
tallonn88: posts small blind $0.25
vlad11122007: posts big blind $0.50
*** HOLE CARDS ***
Dealt to matiko09 [3s Jh]
apfush: folds 
50CandyJoe: folds 
Optimistic21: folds 
Donko jr: folds 
ReinisRNS: folds 
matiko09: folds 
tallonn88: folds 
Uncalled bet ($0.25) returned to vlad11122007
vlad11122007 collected $0.50 from pot
vlad11122007: doesn't show hand 
*** SUMMARY ***
Total pot $0.50 | Rake $0 
Seat 1: 50CandyJoe folded before Flop (didn't bet)
Seat 2: Optimistic21 folded before Flop (didn't bet)
Seat 3: Donko jr folded before Flop (didn't bet)
Seat 5: ReinisRNS folded before Flop (didn't bet)
Seat 6: matiko09 (button) folded before Flop (didn't bet)
Seat 7: tallonn88 (small blind) folded before Flop
Seat 8: vlad11122007 (big blind) collected ($0.50)
Seat 9: apfush folded before Flop (didn't bet)





PokerStars Hand #148608364463:  Hold'em No Limit ($0.25/$0.50 USD) - 2016/02/11 12:54:53 CET [2016/02/11 6:54:53 ET]
Table 'Sylvania II' 9-max Seat #3 is the button
Seat 1: mexx1234 ($193.88 in chips) 
Seat 3: ruyingren ($193.86 in chips) 
Seat 4: matiko09 ($149.94 in chips) 
Seat 5: vlad11122007 ($67.39 in chips) 
Seat 6: TonnaMunz ($128.06 in chips) 
Seat 7: i L00K great ($50 in chips) 
Seat 8: Optimistic21 ($50 in chips) 
Seat 9: Kud3 ($136.73 in chips) 
matiko09: posts small blind $0.25
vlad11122007: posts big blind $0.50
mexx1234: posts the ante $0.10
ruyingren: posts the ante $0.10
matiko09: posts the ante $0.10
vlad11122007: posts the ante $0.10
TonnaMunz: posts the ante $0.10
i L00K great: posts the ante $0.10
Optimistic21: posts the ante $0.10
Kud3: posts the ante $0.10
*** HOLE CARDS ***
Dealt to matiko09 [Qh 4d]
TonnaMunz has timed out
TonnaMunz: folds 
i L00K great: folds 
Optimistic21: folds 
Kud3: folds 
mexx1234: raises $0.75 to $1.25
ruyingren: calls $1.25
matiko09: folds 
vlad11122007: folds 
*** FLOP *** [8c 3s Qc]
mexx1234: checks 
ruyingren: bets $2.50
mexx1234: calls $2.50
*** TURN *** [8c 3s Qc] [5h]
mexx1234: checks 
ruyingren: checks 
*** RIVER *** [8c 3s Qc 5h] [Ad]
mexx1234: checks 
ruyingren: checks 
*** SHOW DOWN ***
mexx1234: shows [Js 8s] (a pair of Eights)
ruyingren: mucks hand 
mexx1234 collected $8.64 from pot
*** SUMMARY ***
Total pot $9.05 | Rake $0.41 
Board [8c 3s Qc 5h Ad]
Seat 1: mexx1234 showed [Js 8s] and won ($8.64) with a pair of Eights
Seat 3: ruyingren (button) mucked [8d 6d]
Seat 4: matiko09 (small blind) folded before Flop
Seat 5: vlad11122007 (big blind) folded before Flop
Seat 6: TonnaMunz folded before Flop (didn't bet)
Seat 7: i L00K great folded before Flop (didn't bet)
Seat 8: Optimistic21 folded before Flop (didn't bet)
Seat 9: Kud3 folded before Flop (didn't bet)





PokerStars Hand #148608370059:  Hold'em No Limit ($0.50/$1.00 USD) - 2016/02/11 12:55:03 CET [2016/02/11 6:55:03 ET]
Table 'Rasalas' 9-max Seat #1 is the button
Seat 1: Tissue51 ($100 in chips) 
Seat 2: azzad2007 ($105.17 in chips) 
Seat 3: Luck In Me ($100 in chips) 
Seat 4: Sweden_Pound ($102 in chips) 
Seat 5: Saggitaurus ($103.64 in chips) 
Seat 6: DUkalisUA ($100 in chips) 
Seat 7: matiko09 ($100 in chips) 
Seat 8: gwwsb ($73.34 in chips) 
Seat 9: hurtNCYDE ($104.37 in chips) 
azzad2007: posts small blind $0.50
Luck In Me: posts big blind $1
*** HOLE CARDS ***
Dealt to matiko09 [2h 2d]
Sweden_Pound: folds 
Saggitaurus: folds 
DUkalisUA: folds 
matiko09: raises $2 to $3
gwwsb: calls $3
hurtNCYDE: folds 
Tissue51: folds 
azzad2007: folds 
Luck In Me: folds 
*** FLOP *** [Ah Ac Jc]
matiko09: checks 
gwwsb: checks 
*** TURN *** [Ah Ac Jc] [6d]
matiko09: checks 
gwwsb: checks 
*** RIVER *** [Ah Ac Jc 6d] [Kd]
matiko09: checks 
gwwsb: checks 
*** SHOW DOWN ***
matiko09: shows [2h 2d] (two pair, Aces and Deuces)
gwwsb: shows [Ks 7s] (two pair, Aces and Kings)
gwwsb collected $7.16 from pot
*** SUMMARY ***
Total pot $7.50 | Rake $0.34 
Board [Ah Ac Jc 6d Kd]
Seat 1: Tissue51 (button) folded before Flop (didn't bet)
Seat 2: azzad2007 (small blind) folded before Flop
Seat 3: Luck In Me (big blind) folded before Flop
Seat 4: Sweden_Pound folded before Flop (didn't bet)
Seat 5: Saggitaurus folded before Flop (didn't bet)
Seat 6: DUkalisUA folded before Flop (didn't bet)
Seat 7: matiko09 showed [2h 2d] and lost with two pair, Aces and Deuces
Seat 8: gwwsb showed [Ks 7s] and won ($7.16) with two pair, Aces and Kings
Seat 9: hurtNCYDE folded before Flop (didn't bet)





PokerStars Hand #148608370552:  Hold'em No Limit ($0.50/$1.00 USD) - 2016/02/11 12:55:04 CET [2016/02/11 6:55:04 ET]
Table 'Sycorax II' 9-max Seat #2 is the button
Seat 1: Luck In Me ($165.43 in chips) 
Seat 2: Filojoes ($100 in chips) 
Seat 4: oscarleon ($100.50 in chips) 
Seat 6: FluentFlows ($44.76 in chips) 
Seat 8: matiko09 ($254.96 in chips) 
Seat 9: mrfoldcall ($100.01 in chips) 
oscarleon: posts small blind $0.50
FluentFlows: posts big blind $1
*** HOLE CARDS ***
Dealt to matiko09 [Th 2d]
matiko09: folds 
mrfoldcall: folds 
Luck In Me: folds 
Filojoes: raises $1 to $2
oscarleon: folds 
FluentFlows: calls $1
*** FLOP *** [7s Qd 7d]
FluentFlows: checks 
Filojoes: checks 
*** TURN *** [7s Qd 7d] [5c]
FluentFlows: checks 
Filojoes: checks 
*** RIVER *** [7s Qd 7d 5c] [6c]
FluentFlows: checks 
Filojoes: checks 
*** SHOW DOWN ***
FluentFlows: shows [Ac 3c] (a pair of Sevens)
Filojoes: shows [8d Ah] (a pair of Sevens - Ace+Queen+Eight kicker)
Filojoes collected $4.30 from pot
*** SUMMARY ***
Total pot $4.50 | Rake $0.20 
Board [7s Qd 7d 5c 6c]
Seat 1: Luck In Me folded before Flop (didn't bet)
Seat 2: Filojoes (button) showed [8d Ah] and won ($4.30) with a pair of Sevens
Seat 4: oscarleon (small blind) folded before Flop
Seat 6: FluentFlows (big blind) showed [Ac 3c] and lost with a pair of Sevens
Seat 8: matiko09 folded before Flop (didn't bet)
Seat 9: mrfoldcall folded before Flop (didn't bet)





PokerStars Hand #148608373538:  Hold'em No Limit ($0.25/$0.50 USD) - 2016/02/11 12:55:09 CET [2016/02/11 6:55:09 ET]
Table 'Algedi' 9-max Seat #7 is the button
Seat 1: vlad11122007 ($53.35 in chips) 
Seat 2: Reffypaul ($55.60 in chips) 
Seat 3: Saggitaurus ($124.04 in chips) 
Seat 4: Effort92 ($61.86 in chips) 
Seat 5: Optimistic21 ($60.53 in chips) 
Seat 6: TonnaMunz ($119.04 in chips) 
Seat 7: hoedtrob ($56.94 in chips) 
Seat 8: matiko09 ($50 in chips) 
Seat 9: Kud3 ($125 in chips) 
matiko09: posts small blind $0.25
Kud3: posts big blind $0.50
vlad11122007: posts the ante $0.10
Reffypaul: posts the ante $0.10
Saggitaurus: posts the ante $0.10
Effort92: posts the ante $0.10
Optimistic21: posts the ante $0.10
TonnaMunz: posts the ante $0.10
hoedtrob: posts the ante $0.10
matiko09: posts the ante $0.10
Kud3: posts the ante $0.10
*** HOLE CARDS ***
Dealt to matiko09 [Js 6s]
vlad11122007: folds 
Reffypaul: calls $0.50
Saggitaurus: folds 
Effort92: folds 
Optimistic21: folds 
TonnaMunz: folds 
hoedtrob: folds 
matiko09: folds 
hoedtrob said, "hmmm"
Kud3: checks 
*** FLOP *** [Ts 9d 8s]
Kud3: checks 
Reffypaul: bets $0.50
Kud3: calls $0.50
*** TURN *** [Ts 9d 8s] [Kd]
Kud3: checks 
Reffypaul: bets $0.50
Kud3: calls $0.50
*** RIVER *** [Ts 9d 8s Kd] [7c]
Kud3: checks 
Reffypaul: bets $1.98
Kud3: folds 
Uncalled bet ($1.98) returned to Reffypaul
Reffypaul collected $3.96 from pot
*** SUMMARY ***
Total pot $4.15 | Rake $0.19 
Board [Ts 9d 8s Kd 7c]
Seat 1: vlad11122007 folded before Flop (didn't bet)
Seat 2: Reffypaul collected ($3.96)
Seat 3: Saggitaurus folded before Flop (didn't bet)
Seat 4: Effort92 folded before Flop (didn't bet)
Seat 5: Optimistic21 folded before Flop (didn't bet)
Seat 6: TonnaMunz folded before Flop (didn't bet)
Seat 7: hoedtrob (button) folded before Flop (didn't bet)
Seat 8: matiko09 (small blind) folded before Flop
Seat 9: Kud3 (big blind) folded on the River





PokerStars Hand #148608373387:  Hold'em No Limit ($0.25/$0.50 USD) - 2016/02/11 12:55:09 CET [2016/02/11 6:55:09 ET]
Table 'Ambrosia II' 9-max Seat #9 is the button
Seat 1: matiko09 ($50.75 in chips) 
Seat 2: TheMinion ($114.87 in chips) 
Seat 4: huudk2016 ($39.69 in chips) 
Seat 5: RICKA16 ($49.25 in chips) 
Seat 6: Reven9er ($71.77 in chips) 
Seat 7: mexx1234 ($84.98 in chips) 
Seat 8: tallonn88 ($57.01 in chips) 
Seat 9: arctur17 ($74.33 in chips) 
matiko09: posts small blind $0.25
TheMinion: posts big blind $0.50
make6a: sits out 
*** HOLE CARDS ***
Dealt to matiko09 [Js Qs]
huudk2016: calls $0.50
RICKA16: raises $1.50 to $2
Reven9er: calls $2
mexx1234: folds 
tallonn88: folds 
arctur17: folds 
matiko09: calls $1.75
TheMinion: folds 
huudk2016: calls $1.50
*** FLOP *** [3d Jd As]
matiko09: checks 
huudk2016: checks 
RICKA16: bets $5
Reven9er: calls $5
matiko09: folds 
huudk2016: folds 
*** TURN *** [3d Jd As] [Kh]
RICKA16: bets $10
Reven9er: calls $10
*** RIVER *** [3d Jd As Kh] [Tc]
RICKA16: bets $9
Reven9er: raises $23.75 to $32.75
RICKA16: calls $23.25 and is all-in
Uncalled bet ($0.50) returned to Reven9er
*** SHOW DOWN ***
Reven9er: shows [Qd Ah] (a straight, Ten to Ace)
RICKA16: shows [Ad Qc] (a straight, Ten to Ace)
RICKA16 collected $50.25 from pot
Reven9er collected $50.25 from pot
*** SUMMARY ***
Total pot $103 | Rake $2.50 
Board [3d Jd As Kh Tc]
Seat 1: matiko09 (small blind) folded on the Flop
Seat 2: TheMinion (big blind) folded before Flop
Seat 4: huudk2016 folded on the Flop
Seat 5: RICKA16 showed [Ad Qc] and won ($50.25) with a straight, Ten to Ace
Seat 6: Reven9er showed [Qd Ah] and won ($50.25) with a straight, Ten to Ace
Seat 7: mexx1234 folded before Flop (didn't bet)
Seat 8: tallonn88 folded before Flop (didn't bet)
Seat 9: arctur17 (button) folded before Flop (didn't bet)





PokerStars Hand #148608391227:  Hold'em No Limit (€0.25/€0.50 EUR) - 2016/02/11 12:55:44 CET [2016/02/11 6:55:44 ET]
Table 'Otero II' 9-max Seat #8 is the button
Seat 1: Nacho2556 (€54.71 in chips) 
Seat 2: make6a (€45.98 in chips) 
Seat 3: Szevasztopol (€50.75 in chips) 
Seat 4: kram0909 (€3.97 in chips) 
Seat 5: vlad11122007 (€50.94 in chips) 
Seat 6: TonnaMunz (€51.35 in chips) 
Seat 8: matiko09 (€70.18 in chips) 
Seat 9: Optimistic21 (€70.07 in chips) 
Optimistic21: posts small blind €0.25
Nacho2556: posts big blind €0.50
Dflingern95: sits out 
*** HOLE CARDS ***
Dealt to matiko09 [Kd 2c]
make6a: folds 
Szevasztopol: raises €1 to €1.50
kram0909: folds 
vlad11122007: folds 
TonnaMunz: folds 
matiko09: folds 
Optimistic21: folds 
Nacho2556: folds 
Uncalled bet (€1) returned to Szevasztopol
Szevasztopol collected €1.25 from pot
Szevasztopol: doesn't show hand 
*** SUMMARY ***
Total pot €1.25 | Rake €0 
Seat 1: Nacho2556 (big blind) folded before Flop
Seat 2: make6a folded before Flop (didn't bet)
Seat 3: Szevasztopol collected (€1.25)
Seat 4: kram0909 folded before Flop (didn't bet)
Seat 5: vlad11122007 folded before Flop (didn't bet)
Seat 6: TonnaMunz folded before Flop (didn't bet)
Seat 8: matiko09 (button) folded before Flop (didn't bet)
Seat 9: Optimistic21 (small blind) folded before Flop





PokerStars Hand #148608392046:  Hold'em No Limit ($0.25/$0.50 USD) - 2016/02/11 12:55:46 CET [2016/02/11 6:55:46 ET]
Table 'Stereoskopia' 9-max Seat #7 is the button
Seat 1: 50CandyJoe ($51.15 in chips) 
Seat 2: Optimistic21 ($57.75 in chips) 
Seat 3: Donko jr ($55.76 in chips) 
Seat 5: ReinisRNS ($50 in chips) 
Seat 6: matiko09 ($50 in chips) 
Seat 7: tallonn88 ($55.47 in chips) 
Seat 8: vlad11122007 ($50.25 in chips) 
Seat 9: apfush ($82.69 in chips) 
vlad11122007: posts small blind $0.25
apfush: posts big blind $0.50
*** HOLE CARDS ***
Dealt to matiko09 [5h Ts]
50CandyJoe: folds 
Optimistic21: raises $1 to $1.50
Donko jr: folds 
ReinisRNS: folds 
matiko09: folds 
tallonn88: folds 
vlad11122007: folds 
apfush: folds 
Uncalled bet ($1) returned to Optimistic21
Optimistic21 collected $1.25 from pot
*** SUMMARY ***
Total pot $1.25 | Rake $0 
Seat 1: 50CandyJoe folded before Flop (didn't bet)
Seat 2: Optimistic21 collected ($1.25)
Seat 3: Donko jr folded before Flop (didn't bet)
Seat 5: ReinisRNS folded before Flop (didn't bet)
Seat 6: matiko09 folded before Flop (didn't bet)
Seat 7: tallonn88 (button) folded before Flop (didn't bet)
Seat 8: vlad11122007 (small blind) folded before Flop
Seat 9: apfush (big blind) folded before Flop





PokerStars Hand #148608394411:  Hold'em No Limit ($0.50/$1.00 USD) - 2016/02/11 12:55:51 CET [2016/02/11 6:55:51 ET]
Table 'Sycorax II' 9-max Seat #4 is the button
Seat 1: Luck In Me ($165.43 in chips) 
Seat 2: Filojoes ($102.30 in chips) 
Seat 4: oscarleon ($100 in chips) 
Seat 8: matiko09 ($254.96 in chips) 
Seat 9: mrfoldcall ($100.01 in chips) 
matiko09: posts small blind $0.50
mrfoldcall: posts big blind $1
*** HOLE CARDS ***
Dealt to matiko09 [9d Ad]
Luck In Me: folds 
FluentFlows leaves the table
Filojoes: raises $1.50 to $2.50
AlKatrone joins the table at seat #6 
oscarleon: raises $6.50 to $9
AlKatrone leaves the table
matiko09: folds 
Sweden_Pound joins the table at seat #6 
mrfoldcall: calls $8
Filojoes: folds 
*** FLOP *** [Qh 7s 3c]
mrfoldcall: checks 
oscarleon: checks 
*** TURN *** [Qh 7s 3c] [3d]
mrfoldcall: checks 
oscarleon: bets $13
mrfoldcall: raises $13 to $26
oscarleon: calls $13
*** RIVER *** [Qh 7s 3c 3d] [Jd]
mrfoldcall: bets $65.01 and is all-in
oscarleon: folds 
Uncalled bet ($65.01) returned to mrfoldcall
mrfoldcall collected $70.20 from pot
mrfoldcall: doesn't show hand 
*** SUMMARY ***
Total pot $73 | Rake $2.80 
Board [Qh 7s 3c 3d Jd]
Seat 1: Luck In Me folded before Flop (didn't bet)
Seat 2: Filojoes folded before Flop
Seat 4: oscarleon (button) folded on the River
Seat 8: matiko09 (small blind) folded before Flop
Seat 9: mrfoldcall (big blind) collected ($70.20)





PokerStars Hand #148608395720:  Hold'em No Limit ($0.50/$1.00 USD) - 2016/02/11 12:55:53 CET [2016/02/11 6:55:53 ET]
Table 'Aoluta' 9-max Seat #9 is the button
Seat 1: sebaaastian ($100 in chips) 
Seat 2: matiko09 ($100 in chips) 
Seat 6: Luck In Me ($100 in chips) 
Seat 7: Mukhin1 ($101.50 in chips) 
Seat 9: DanHoffm ($54.96 in chips) 
sebaaastian: posts small blind $0.50
matiko09: posts big blind $1
Zeeshka: sits out 
apfush: sits out 
hammerwife: sits out 
*** HOLE CARDS ***
Dealt to matiko09 [2d Qd]
Luck In Me: folds 
Mukhin1: folds 
DanHoffm: folds 
aseban11 joins the table at seat #5 
DanHoffm leaves the table
sebaaastian: raises $1.50 to $2.50
Sweden_Pound joins the table at seat #9 
matiko09: folds 
Uncalled bet ($1.50) returned to sebaaastian
sebaaastian collected $2 from pot
apfush leaves the table
sebaaastian: doesn't show hand 
*** SUMMARY ***
Total pot $2 | Rake $0 
Seat 1: sebaaastian (small blind) collected ($2)
Seat 2: matiko09 (big blind) folded before Flop
Seat 6: Luck In Me folded before Flop (didn't bet)
Seat 7: Mukhin1 folded before Flop (didn't bet)
Seat 9: DanHoffm (button) folded before Flop (didn't bet)





PokerStars Hand #148608395573:  Hold'em No Limit ($0.50/$1.00 USD) - 2016/02/11 12:55:53 CET [2016/02/11 6:55:53 ET]
Table 'Regor' 9-max Seat #4 is the button
Seat 1: matiko09 ($139.50 in chips) 
Seat 2: Luck In Me ($101 in chips) 
Seat 3: oscarleon ($162.45 in chips) 
Seat 4: Filojoes ($100 in chips) 
Seat 6: Dachish ($85.95 in chips) 
Seat 8: R3NZONIT3 ($50.66 in chips) 
Seat 9: CoolFireX ($130.21 in chips) 
Dachish: posts small blind $0.50
R3NZONIT3: posts big blind $1
*** HOLE CARDS ***
Dealt to matiko09 [Jc 2s]
CoolFireX: raises $2 to $3
matiko09: folds 
Luck In Me: folds 
oscarleon: folds 
Filojoes: folds 
Dachish: folds 
JJJ-K9 joins the table at seat #7 
R3NZONIT3: folds 
Uncalled bet ($2) returned to CoolFireX
CoolFireX collected $2.50 from pot
CoolFireX: doesn't show hand 
*** SUMMARY ***
Total pot $2.50 | Rake $0 
Seat 1: matiko09 folded before Flop (didn't bet)
Seat 2: Luck In Me folded before Flop (didn't bet)
Seat 3: oscarleon folded before Flop (didn't bet)
Seat 4: Filojoes (button) folded before Flop (didn't bet)
Seat 6: Dachish (small blind) folded before Flop
Seat 8: R3NZONIT3 (big blind) folded before Flop
Seat 9: CoolFireX collected ($2.50)





PokerStars Hand #148608395326:  Hold'em No Limit ($0.25/$0.50 USD) - 2016/02/11 12:55:53 CET [2016/02/11 6:55:53 ET]
Table 'Sylvania II' 9-max Seat #4 is the button
Seat 1: mexx1234 ($198.67 in chips) 
Seat 3: ruyingren ($190.01 in chips) 
Seat 4: matiko09 ($149.59 in chips) 
Seat 5: vlad11122007 ($66.79 in chips) 
Seat 6: TonnaMunz ($127.96 in chips) 
Seat 7: i L00K great ($50 in chips) 
Seat 8: Optimistic21 ($50 in chips) 
Seat 9: Kud3 ($136.63 in chips) 
vlad11122007: posts small blind $0.25
TonnaMunz: posts big blind $0.50
mexx1234: posts the ante $0.10
ruyingren: posts the ante $0.10
matiko09: posts the ante $0.10
vlad11122007: posts the ante $0.10
TonnaMunz: posts the ante $0.10
i L00K great: posts the ante $0.10
Optimistic21: posts the ante $0.10
Kud3: posts the ante $0.10
*** HOLE CARDS ***
Dealt to matiko09 [6c 7h]
i L00K great: folds 
Optimistic21: folds 
Kud3: folds 
mexx1234: folds 
ruyingren: folds 
matiko09: folds 
vlad11122007: raises $1 to $1.50
TonnaMunz: calls $1
*** FLOP *** [As 8d 2s]
vlad11122007: checks 
TonnaMunz has timed out
TonnaMunz: checks 
*** TURN *** [As 8d 2s] [Qs]
vlad11122007: checks 
TonnaMunz: bets $2.50
vlad11122007: calls $2.50
*** RIVER *** [As 8d 2s Qs] [2h]
vlad11122007: checks 
ruyingren is disconnected 
TonnaMunz is disconnected 
TonnaMunz is connected 
ruyingren is disconnected 
TonnaMunz has timed out while being disconnected
TonnaMunz: checks 
*** SHOW DOWN ***
vlad11122007: shows [Qc Kh] (two pair, Queens and Deuces)
TonnaMunz: shows [Tc Ac] (two pair, Aces and Deuces)
TonnaMunz collected $8.40 from pot
*** SUMMARY ***
Total pot $8.80 | Rake $0.40 
Board [As 8d 2s Qs 2h]
Seat 1: mexx1234 folded before Flop (didn't bet)
Seat 3: ruyingren folded before Flop (didn't bet)
Seat 4: matiko09 (button) folded before Flop (didn't bet)
Seat 5: vlad11122007 (small blind) showed [Qc Kh] and lost with two pair, Queens and Deuces
Seat 6: TonnaMunz (big blind) showed [Tc Ac] and won ($8.40) with two pair, Aces and Deuces
Seat 7: i L00K great folded before Flop (didn't bet)
Seat 8: Optimistic21 folded before Flop (didn't bet)
Seat 9: Kud3 folded before Flop (didn't bet)





PokerStars Hand #148608396332:  Hold'em No Limit ($0.25/$0.50 USD) - 2016/02/11 12:55:55 CET [2016/02/11 6:55:55 ET]
Table 'Algedi' 9-max Seat #8 is the button
Seat 1: vlad11122007 ($53.25 in chips) 
Seat 2: Reffypaul ($57.96 in chips) 
Seat 3: Saggitaurus ($123.94 in chips) 
Seat 4: Effort92 ($61.76 in chips) 
Seat 5: Optimistic21 ($60.43 in chips) 
Seat 6: TonnaMunz ($118.94 in chips) 
Seat 7: hoedtrob ($56.84 in chips) 
Seat 8: matiko09 ($50 in chips) 
Seat 9: Kud3 ($125 in chips) 
Kud3: posts small blind $0.25
vlad11122007: posts big blind $0.50
vlad11122007: posts the ante $0.10
Reffypaul: posts the ante $0.10
Saggitaurus: posts the ante $0.10
Effort92: posts the ante $0.10
Optimistic21: posts the ante $0.10
TonnaMunz: posts the ante $0.10
hoedtrob: posts the ante $0.10
matiko09: posts the ante $0.10
Kud3: posts the ante $0.10
*** HOLE CARDS ***
Dealt to matiko09 [2h Kd]
Reffypaul: calls $0.50
Saggitaurus: folds 
Saggitaurus said, "or A A"
Effort92 has timed out
Effort92: folds 
Optimistic21: folds 
TonnaMunz: raises $2 to $2.50
hoedtrob: folds 
matiko09: folds 
Kud3: folds 
vlad11122007: raises $3.75 to $6.25
hoedtrob said, "your bet on river says:"
Reffypaul: folds 
TonnaMunz: calls $3.75
*** FLOP *** [4c 4s Tc]
vlad11122007: bets $5.50
hoedtrob said, "i dont really care what my opponent has"
TonnaMunz: calls $5.50
*** TURN *** [4c 4s Tc] [3h]
vlad11122007: bets $10.50
hoedtrob said, "not JJ i dont think"
Saggitaurus said, "what your have"
TonnaMunz: calls $10.50
*** RIVER *** [4c 4s Tc 3h] [6s]
vlad11122007: bets $30.90 and is all-in
hoedtrob said, "AK"
Saggitaurus said, "king of hart"
Saggitaurus said, "heart"
TonnaMunz is disconnected 
hoedtrob said, "not my king"
TonnaMunz is connected 
hoedtrob said, "u had Kh?"
Saggitaurus said, "Jacs"
Saggitaurus said, "Jh"
TonnaMunz: folds 
Uncalled bet ($30.90) returned to vlad11122007
hoedtrob said, "Ok"
vlad11122007 collected $44.07 from pot
vlad11122007: doesn't show hand 
*** SUMMARY ***
Total pot $46.15 | Rake $2.08 
Board [4c 4s Tc 3h 6s]
Seat 1: vlad11122007 (big blind) collected ($44.07)
Seat 2: Reffypaul folded before Flop
Seat 3: Saggitaurus folded before Flop (didn't bet)
Seat 4: Effort92 folded before Flop (didn't bet)
Seat 5: Optimistic21 folded before Flop (didn't bet)
Seat 6: TonnaMunz folded on the River
Seat 7: hoedtrob folded before Flop (didn't bet)
Seat 8: matiko09 (button) folded before Flop (didn't bet)
Seat 9: Kud3 (small blind) folded before Flop





PokerStars Hand #148608401549:  Hold'em No Limit ($0.50/$1.00 USD) - 2016/02/11 12:56:05 CET [2016/02/11 6:56:05 ET]
Table 'Rasalas' 9-max Seat #2 is the button
Seat 1: Tissue51 ($100 in chips) 
Seat 2: azzad2007 ($104.67 in chips) 
Seat 3: Luck In Me ($100 in chips) 
Seat 4: Sweden_Pound ($102 in chips) 
Seat 5: Saggitaurus ($103.64 in chips) 
Seat 6: DUkalisUA ($100 in chips) 
Seat 7: matiko09 ($100 in chips) 
Seat 8: gwwsb ($77.50 in chips) 
Seat 9: hurtNCYDE ($104.37 in chips) 
Luck In Me: posts small blind $0.50
Sweden_Pound: posts big blind $1
*** HOLE CARDS ***
Dealt to matiko09 [Ah 5s]
Saggitaurus: folds 
DUkalisUA: folds 
matiko09: folds 
gwwsb: folds 
hurtNCYDE: folds 
Tissue51: folds 
azzad2007: folds 
Luck In Me: folds 
Uncalled bet ($0.50) returned to Sweden_Pound
Sweden_Pound collected $1 from pot
Sweden_Pound: doesn't show hand 
*** SUMMARY ***
Total pot $1 | Rake $0 
Seat 1: Tissue51 folded before Flop (didn't bet)
Seat 2: azzad2007 (button) folded before Flop (didn't bet)
Seat 3: Luck In Me (small blind) folded before Flop
Seat 4: Sweden_Pound (big blind) collected ($1)
Seat 5: Saggitaurus folded before Flop (didn't bet)
Seat 6: DUkalisUA folded before Flop (didn't bet)
Seat 7: matiko09 folded before Flop (didn't bet)
Seat 8: gwwsb folded before Flop (didn't bet)
Seat 9: hurtNCYDE folded before Flop (didn't bet)





PokerStars Hand #148608405799:  Hold'em No Limit ($0.50/$1.00 USD) - 2016/02/11 12:56:14 CET [2016/02/11 6:56:14 ET]
Table 'Aoluta' 9-max Seat #1 is the button
Seat 1: sebaaastian ($101 in chips) 
Seat 2: matiko09 ($100 in chips) 
Seat 3: Zeeshka ($100 in chips) 
Seat 6: Luck In Me ($100 in chips) 
Seat 7: Mukhin1 ($101.50 in chips) 
matiko09: posts small blind $0.50
Zeeshka: posts big blind $1
hammerwife: sits out 
Sweden_Pound: sits out 
*** HOLE CARDS ***
Dealt to matiko09 [Js Jd]
Luck In Me: folds 
Mukhin1: raises $2.02 to $3.02
AlKatrone joins the table at seat #4 
AlKatrone leaves the table
oscarleon joins the table at seat #4 
hammerwife leaves the table
sebaaastian: folds 
matiko09: raises $6.98 to $10
Zeeshka: folds 
hurtNCYDE joins the table at seat #8 
hurtNCYDE leaves the table
Mukhin1: folds 
Uncalled bet ($6.98) returned to matiko09
matiko09 collected $7.04 from pot
matiko09: doesn't show hand 
*** SUMMARY ***
Total pot $7.04 | Rake $0 
Seat 1: sebaaastian (button) folded before Flop (didn't bet)
Seat 2: matiko09 (small blind) collected ($7.04)
Seat 3: Zeeshka (big blind) folded before Flop
Seat 6: Luck In Me folded before Flop (didn't bet)
Seat 7: Mukhin1 folded before Flop





PokerStars Hand #148608407646:  Hold'em No Limit ($0.50/$1.00 USD) - 2016/02/11 12:56:18 CET [2016/02/11 6:56:18 ET]
Table 'Regor' 9-max Seat #6 is the button
Seat 1: matiko09 ($139.50 in chips) 
Seat 2: Luck In Me ($101 in chips) 
Seat 3: oscarleon ($162.45 in chips) 
Seat 4: Filojoes ($100 in chips) 
Seat 6: Dachish ($85.45 in chips) 
Seat 8: R3NZONIT3 ($49.66 in chips) 
JJJ-K9 will be allowed to play after the button
R3NZONIT3: posts small blind $0.50
CoolFireX: is sitting out 
matiko09: posts big blind $1
*** HOLE CARDS ***
Dealt to matiko09 [5s 5h]
CoolFireX leaves the table
Luck In Me: folds 
Sweden_Pound joins the table at seat #9 
oscarleon: raises $2 to $3
Filojoes: folds 
Dachish: folds 
R3NZONIT3: calls $2.50
matiko09: calls $2
*** FLOP *** [9c Qh 7h]
R3NZONIT3: checks 
matiko09: checks 
oscarleon: bets $6
R3NZONIT3: calls $6
matiko09: folds 
*** TURN *** [9c Qh 7h] [6d]
R3NZONIT3: checks 
oscarleon: bets $15
R3NZONIT3: calls $15
*** RIVER *** [9c Qh 7h 6d] [5d]
R3NZONIT3: bets $25.66 and is all-in
oscarleon: calls $25.66
*** SHOW DOWN ***
R3NZONIT3: shows [8s 8d] (a straight, Five to Nine)
oscarleon: mucks hand 
R3NZONIT3 collected $99.52 from pot
*** SUMMARY ***
Total pot $102.32 | Rake $2.80 
Board [9c Qh 7h 6d 5d]
Seat 1: matiko09 (big blind) folded on the Flop
Seat 2: Luck In Me folded before Flop (didn't bet)
Seat 3: oscarleon mucked [Tc Qc]
Seat 4: Filojoes folded before Flop (didn't bet)
Seat 6: Dachish (button) folded before Flop (didn't bet)
Seat 8: R3NZONIT3 (small blind) showed [8s 8d] and won ($99.52) with a straight, Five to Nine





PokerStars Hand #148608414624:  Hold'em No Limit ($0.50/$1.00 USD) - 2016/02/11 12:56:32 CET [2016/02/11 6:56:32 ET]
Table 'Rasalas' 9-max Seat #3 is the button
Seat 1: Tissue51 ($100 in chips) 
Seat 2: azzad2007 ($104.67 in chips) 
Seat 3: Luck In Me ($100 in chips) 
Seat 4: Sweden_Pound ($102.50 in chips) 
Seat 5: Saggitaurus ($103.64 in chips) 
Seat 6: DUkalisUA ($100 in chips) 
Seat 7: matiko09 ($100 in chips) 
Seat 8: gwwsb ($77.50 in chips) 
Seat 9: hurtNCYDE ($104.37 in chips) 
Sweden_Pound: posts small blind $0.50
Saggitaurus: posts big blind $1
*** HOLE CARDS ***
Dealt to matiko09 [4s 5s]
DUkalisUA: folds 
matiko09: folds 
gwwsb: raises $1 to $2
hurtNCYDE: raises $6 to $8
Tissue51: folds 
azzad2007: folds 
Luck In Me: folds 
Sweden_Pound: folds 
Saggitaurus: folds 
gwwsb: folds 
Uncalled bet ($6) returned to hurtNCYDE
hurtNCYDE collected $5.50 from pot
*** SUMMARY ***
Total pot $5.50 | Rake $0 
Seat 1: Tissue51 folded before Flop (didn't bet)
Seat 2: azzad2007 folded before Flop (didn't bet)
Seat 3: Luck In Me (button) folded before Flop (didn't bet)
Seat 4: Sweden_Pound (small blind) folded before Flop
Seat 5: Saggitaurus (big blind) folded before Flop
Seat 6: DUkalisUA folded before Flop (didn't bet)
Seat 7: matiko09 folded before Flop (didn't bet)
Seat 8: gwwsb folded before Flop
Seat 9: hurtNCYDE collected ($5.50)





PokerStars Hand #148608418263:  Hold'em No Limit ($0.25/$0.50 USD) - 2016/02/11 12:56:39 CET [2016/02/11 6:56:39 ET]
Table 'Stereoskopia' 9-max Seat #8 is the button
Seat 1: 50CandyJoe ($51.15 in chips) 
Seat 2: Optimistic21 ($58.50 in chips) 
Seat 3: Donko jr ($55.76 in chips) 
Seat 5: ReinisRNS ($50 in chips) 
Seat 6: matiko09 ($50 in chips) 
Seat 8: vlad11122007 ($50 in chips) 
Seat 9: apfush ($82.19 in chips) 
apfush: posts small blind $0.25
50CandyJoe: posts big blind $0.50
*** HOLE CARDS ***
Dealt to matiko09 [9s Kh]
Optimistic21: folds 
Donko jr: folds 
ReinisRNS: raises $1.25 to $1.75
Donko jr leaves the table
matiko09: folds 
vlad11122007: folds 
apfush: folds 
50CandyJoe: folds 
Uncalled bet ($1.25) returned to ReinisRNS
ReinisRNS collected $1.25 from pot
ReinisRNS: doesn't show hand 
*** SUMMARY ***
Total pot $1.25 | Rake $0 
Seat 1: 50CandyJoe (big blind) folded before Flop
Seat 2: Optimistic21 folded before Flop (didn't bet)
Seat 3: Donko jr folded before Flop (didn't bet)
Seat 5: ReinisRNS collected ($1.25)
Seat 6: matiko09 folded before Flop (didn't bet)
Seat 8: vlad11122007 (button) folded before Flop (didn't bet)
Seat 9: apfush (small blind) folded before Flop





PokerStars Hand #148608426980:  Hold'em No Limit (€0.25/€0.50 EUR) - 2016/02/11 12:56:56 CET [2016/02/11 6:56:56 ET]
Table 'Otero II' 9-max Seat #9 is the button
Seat 1: Nacho2556 (€54.21 in chips) 
Seat 3: Szevasztopol (€51.50 in chips) 
Seat 4: kram0909 (€3.97 in chips) 
Seat 5: vlad11122007 (€50.94 in chips) 
Seat 6: TonnaMunz (€51.35 in chips) 
Seat 8: matiko09 (€70.18 in chips) 
Seat 9: Optimistic21 (€69.82 in chips) 
Nacho2556: posts small blind €0.25
make6a: is sitting out 
Szevasztopol: posts big blind €0.50
Dflingern95: sits out 
*** HOLE CARDS ***
Dealt to matiko09 [Jd 2h]
make6a leaves the table
kram0909: folds 
vlad11122007: folds 
Dantist1122 joins the table at seat #2 
TonnaMunz: folds 
matiko09: folds 
Optimistic21: raises €0.50 to €1
Nacho2556: folds 
Szevasztopol: calls €0.50
*** FLOP *** [Qd 3s 6h]
Szevasztopol: checks 
Optimistic21: bets €1
Szevasztopol: calls €1
*** TURN *** [Qd 3s 6h] [Td]
Szevasztopol: checks 
Optimistic21: checks 
*** RIVER *** [Qd 3s 6h Td] [Qc]
Szevasztopol: checks 
Optimistic21: bets €1
Szevasztopol: folds 
Uncalled bet (€1) returned to Optimistic21
Optimistic21 collected €4.06 from pot
*** SUMMARY ***
Total pot €4.25 | Rake €0.19 
Board [Qd 3s 6h Td Qc]
Seat 1: Nacho2556 (small blind) folded before Flop
Seat 3: Szevasztopol (big blind) folded on the River
Seat 4: kram0909 folded before Flop (didn't bet)
Seat 5: vlad11122007 folded before Flop (didn't bet)
Seat 6: TonnaMunz folded before Flop (didn't bet)
Seat 8: matiko09 folded before Flop (didn't bet)
Seat 9: Optimistic21 (button) collected (€4.06)





PokerStars Hand #148608428955:  Hold'em No Limit ($0.50/$1.00 USD) - 2016/02/11 12:57:00 CET [2016/02/11 6:57:00 ET]
Table 'Rasalas' 9-max Seat #4 is the button
Seat 1: Tissue51 ($100 in chips) 
Seat 2: azzad2007 ($104.67 in chips) 
Seat 3: Luck In Me ($100 in chips) 
Seat 4: Sweden_Pound ($102 in chips) 
Seat 5: Saggitaurus ($102.64 in chips) 
Seat 6: DUkalisUA ($100 in chips) 
Seat 7: matiko09 ($100 in chips) 
Seat 8: gwwsb ($75.50 in chips) 
Seat 9: hurtNCYDE ($107.87 in chips) 
Saggitaurus: posts small blind $0.50
DUkalisUA: posts big blind $1
*** HOLE CARDS ***
Dealt to matiko09 [As Js]
matiko09: raises $2 to $3
gwwsb: folds 
hurtNCYDE: folds 
Tissue51: folds 
azzad2007: folds 
Luck In Me: folds 
Sweden_Pound: folds 
Saggitaurus: folds 
DUkalisUA: folds 
Uncalled bet ($2) returned to matiko09
matiko09 collected $2.50 from pot
matiko09: doesn't show hand 
*** SUMMARY ***
Total pot $2.50 | Rake $0 
Seat 1: Tissue51 folded before Flop (didn't bet)
Seat 2: azzad2007 folded before Flop (didn't bet)
Seat 3: Luck In Me folded before Flop (didn't bet)
Seat 4: Sweden_Pound (button) folded before Flop (didn't bet)
Seat 5: Saggitaurus (small blind) folded before Flop
Seat 6: DUkalisUA (big blind) folded before Flop
Seat 7: matiko09 collected ($2.50)
Seat 8: gwwsb folded before Flop (didn't bet)
Seat 9: hurtNCYDE folded before Flop (didn't bet)





PokerStars Hand #148608429166:  Hold'em No Limit ($0.50/$1.00 USD) - 2016/02/11 12:57:01 CET [2016/02/11 6:57:01 ET]
Table 'Aoluta' 9-max Seat #2 is the button
Seat 1: sebaaastian ($101 in chips) 
Seat 2: matiko09 ($104.02 in chips) 
Seat 3: Zeeshka ($100 in chips) 
Seat 4: oscarleon ($163.04 in chips) 
Seat 6: Luck In Me ($100 in chips) 
Seat 7: Mukhin1 ($100 in chips) 
Zeeshka: posts small blind $0.50
oscarleon: posts big blind $1
Sweden_Pound: sits out 
*** HOLE CARDS ***
Dealt to matiko09 [Js 2c]
Luck In Me: folds 
Mukhin1: raises $2.02 to $3.02
sebaaastian: folds 
matiko09: folds 
Zeeshka: folds 
oscarleon: folds 
Uncalled bet ($2.02) returned to Mukhin1
Mukhin1 collected $2.50 from pot
Mukhin1: doesn't show hand 
*** SUMMARY ***
Total pot $2.50 | Rake $0 
Seat 1: sebaaastian folded before Flop (didn't bet)
Seat 2: matiko09 (button) folded before Flop (didn't bet)
Seat 3: Zeeshka (small blind) folded before Flop
Seat 4: oscarleon (big blind) folded before Flop
Seat 6: Luck In Me folded before Flop (didn't bet)
Seat 7: Mukhin1 collected ($2.50)





PokerStars Hand #148608436652:  Hold'em No Limit ($0.50/$1.00 USD) - 2016/02/11 12:57:16 CET [2016/02/11 6:57:16 ET]
Table 'Regor' 9-max Seat #8 is the button
Seat 1: matiko09 ($136.50 in chips) 
Seat 2: Luck In Me ($101 in chips) 
Seat 3: oscarleon ($112.79 in chips) 
Seat 4: Filojoes ($100 in chips) 
Seat 6: Dachish ($85.45 in chips) 
Seat 8: R3NZONIT3 ($99.52 in chips) 
Sweden_Pound will be allowed to play after the button
matiko09: posts small blind $0.50
Luck In Me: posts big blind $1
chauyeuba: sits out 
JJJ-K9: sits out 
*** HOLE CARDS ***
Dealt to matiko09 [5h Js]
oscarleon: folds 
Filojoes: folds 
Dachish: folds 
R3NZONIT3 has timed out
R3NZONIT3: folds 
matiko09: folds 
Uncalled bet ($0.50) returned to Luck In Me
Luck In Me collected $1 from pot
Luck In Me: doesn't show hand 
*** SUMMARY ***
Total pot $1 | Rake $0 
Seat 1: matiko09 (small blind) folded before Flop
Seat 2: Luck In Me (big blind) collected ($1)
Seat 3: oscarleon folded before Flop (didn't bet)
Seat 4: Filojoes folded before Flop (didn't bet)
Seat 6: Dachish folded before Flop (didn't bet)
Seat 8: R3NZONIT3 (button) folded before Flop (didn't bet)





PokerStars Hand #148608439927:  Hold'em No Limit ($0.50/$1.00 USD) - 2016/02/11 12:57:23 CET [2016/02/11 6:57:23 ET]
Table 'Rasalas' 9-max Seat #5 is the button
Seat 1: Tissue51 ($100 in chips) 
Seat 2: azzad2007 ($104.67 in chips) 
Seat 3: Luck In Me ($100 in chips) 
Seat 4: Sweden_Pound ($102 in chips) 
Seat 5: Saggitaurus ($102.14 in chips) 
Seat 6: DUkalisUA ($100 in chips) 
Seat 7: matiko09 ($101.50 in chips) 
Seat 8: gwwsb ($75.50 in chips) 
Seat 9: hurtNCYDE ($107.87 in chips) 
DUkalisUA: posts small blind $0.50
matiko09: posts big blind $1
*** HOLE CARDS ***
Dealt to matiko09 [8c 4s]
gwwsb: folds 
hurtNCYDE: raises $1.50 to $2.50
Tissue51: folds 
azzad2007: folds 
Luck In Me: calls $2.50
Sweden_Pound: folds 
Saggitaurus: folds 
DUkalisUA: folds 
matiko09: folds 
*** FLOP *** [6d 7h Qh]
hurtNCYDE: checks 
Luck In Me: checks 
*** TURN *** [6d 7h Qh] [8h]
hurtNCYDE: bets $4.28
Luck In Me: folds 
Uncalled bet ($4.28) returned to hurtNCYDE
hurtNCYDE collected $6.21 from pot
*** SUMMARY ***
Total pot $6.50 | Rake $0.29 
Board [6d 7h Qh 8h]
Seat 1: Tissue51 folded before Flop (didn't bet)
Seat 2: azzad2007 folded before Flop (didn't bet)
Seat 3: Luck In Me folded on the Turn
Seat 4: Sweden_Pound folded before Flop (didn't bet)
Seat 5: Saggitaurus (button) folded before Flop (didn't bet)
Seat 6: DUkalisUA (small blind) folded before Flop
Seat 7: matiko09 (big blind) folded before Flop
Seat 8: gwwsb folded before Flop (didn't bet)
Seat 9: hurtNCYDE collected ($6.21)





PokerStars Hand #148608440861:  Hold'em No Limit ($0.50/$1.00 USD) - 2016/02/11 12:57:25 CET [2016/02/11 6:57:25 ET]
Table 'Sycorax II' 9-max Seat #8 is the button
Seat 1: Luck In Me ($165.43 in chips) 
Seat 2: Filojoes ($100 in chips) 
Seat 4: oscarleon ($100 in chips) 
Seat 8: matiko09 ($254.46 in chips) 
Seat 9: mrfoldcall ($135.21 in chips) 
mrfoldcall: posts small blind $0.50
Luck In Me: posts big blind $1
chauyeuba: sits out 
Sweden_Pound: sits out 
aseban11: sits out 
*** HOLE CARDS ***
Dealt to matiko09 [4h 2s]
Filojoes: folds 
oscarleon: folds 
matiko09: folds 
mrfoldcall: folds 
Uncalled bet ($0.50) returned to Luck In Me
Luck In Me collected $1 from pot
Luck In Me: doesn't show hand 
*** SUMMARY ***
Total pot $1 | Rake $0 
Seat 1: Luck In Me (big blind) collected ($1)
Seat 2: Filojoes folded before Flop (didn't bet)
Seat 4: oscarleon folded before Flop (didn't bet)
Seat 8: matiko09 (button) folded before Flop (didn't bet)
Seat 9: mrfoldcall (small blind) folded before Flop





PokerStars Hand #148608441275:  Hold'em No Limit ($0.50/$1.00 USD) - 2016/02/11 12:57:26 CET [2016/02/11 6:57:26 ET]
Table 'Aoluta' 9-max Seat #3 is the button
Seat 1: sebaaastian ($101 in chips) 
Seat 2: matiko09 ($104.02 in chips) 
Seat 3: Zeeshka ($100 in chips) 
Seat 4: oscarleon ($162.04 in chips) 
Seat 6: Luck In Me ($100 in chips) 
Seat 7: Mukhin1 ($101.50 in chips) 
oscarleon: posts small blind $0.50
Luck In Me: posts big blind $1
Sweden_Pound: sits out 
*** HOLE CARDS ***
Dealt to matiko09 [6c 4c]
Mukhin1: folds 
sebaaastian: folds 
matiko09: folds 
Zeeshka: folds 
oscarleon: raises $2 to $3
Luck In Me: folds 
Uncalled bet ($2) returned to oscarleon
oscarleon collected $2 from pot
oscarleon: doesn't show hand 
*** SUMMARY ***
Total pot $2 | Rake $0 
Seat 1: sebaaastian folded before Flop (didn't bet)
Seat 2: matiko09 folded before Flop (didn't bet)
Seat 3: Zeeshka (button) folded before Flop (didn't bet)
Seat 4: oscarleon (small blind) collected ($2)
Seat 6: Luck In Me (big blind) folded before Flop
Seat 7: Mukhin1 folded before Flop (didn't bet)





PokerStars Hand #148608441802:  Hold'em No Limit ($0.25/$0.50 USD) - 2016/02/11 12:57:27 CET [2016/02/11 6:57:27 ET]
Table 'Ambrosia II' 9-max Seat #1 is the button
Seat 1: matiko09 ($50 in chips) 
Seat 2: TheMinion ($114.37 in chips) 
Seat 3: make6a ($47.42 in chips) 
Seat 4: huudk2016 ($37.69 in chips) 
Seat 5: RICKA16 ($50.25 in chips) 
Seat 6: Reven9er ($72.77 in chips) 
Seat 7: mexx1234 ($84.98 in chips) 
Seat 9: arctur17 ($74.33 in chips) 
TheMinion: posts small blind $0.25
make6a: posts big blind $0.50
*** HOLE CARDS ***
Dealt to matiko09 [5h Ks]
huudk2016: folds 
RICKA16: folds 
Reven9er: folds 
mexx1234: raises $1 to $1.50
arctur17: calls $1.50
matiko09: folds 
TheMinion: folds 
make6a: calls $1
*** FLOP *** [Ah 5c Js]
make6a: checks 
mexx1234: checks 
arctur17: checks 
*** TURN *** [Ah 5c Js] [7c]
make6a: bets $3.50
mexx1234: folds 
arctur17: calls $3.50
*** RIVER *** [Ah 5c Js 7c] [9c]
make6a: checks 
arctur17: checks 
*** SHOW DOWN ***
make6a: shows [Jh Jc] (three of a kind, Jacks)
arctur17: mucks hand 
make6a collected $11.22 from pot
*** SUMMARY ***
Total pot $11.75 | Rake $0.53 
Board [Ah 5c Js 7c 9c]
Seat 1: matiko09 (button) folded before Flop (didn't bet)
Seat 2: TheMinion (small blind) folded before Flop
Seat 3: make6a (big blind) showed [Jh Jc] and won ($11.22) with three of a kind, Jacks
Seat 4: huudk2016 folded before Flop (didn't bet)
Seat 5: RICKA16 folded before Flop (didn't bet)
Seat 6: Reven9er folded before Flop (didn't bet)
Seat 7: mexx1234 folded on the Turn
Seat 9: arctur17 mucked [5s 3s]





PokerStars Hand #148608443007:  Hold'em No Limit ($0.25/$0.50 USD) - 2016/02/11 12:57:29 CET [2016/02/11 6:57:29 ET]
Table 'Stereoskopia' 9-max Seat #9 is the button
Seat 1: 50CandyJoe ($50.65 in chips) 
Seat 2: Optimistic21 ($58.50 in chips) 
Seat 5: ReinisRNS ($50.75 in chips) 
Seat 6: matiko09 ($50 in chips) 
Seat 8: vlad11122007 ($50 in chips) 
Seat 9: apfush ($81.94 in chips) 
50CandyJoe: posts small blind $0.25
Optimistic21: posts big blind $0.50
*** HOLE CARDS ***
Dealt to matiko09 [2h 6c]
ReinisRNS: raises $0.50 to $1
matiko09: folds 
vlad11122007: folds 
apfush: folds 
50CandyJoe: folds 
Optimistic21: folds 
Uncalled bet ($0.50) returned to ReinisRNS
50CandyJoe leaves the table
ReinisRNS collected $1.25 from pot
ReinisRNS: doesn't show hand 
*** SUMMARY ***
Total pot $1.25 | Rake $0 
Seat 1: 50CandyJoe (small blind) folded before Flop
Seat 2: Optimistic21 (big blind) folded before Flop
Seat 5: ReinisRNS collected ($1.25)
Seat 6: matiko09 folded before Flop (didn't bet)
Seat 8: vlad11122007 folded before Flop (didn't bet)
Seat 9: apfush (button) folded before Flop (didn't bet)





PokerStars Hand #148608445293:  Hold'em No Limit ($0.50/$1.00 USD) - 2016/02/11 12:57:34 CET [2016/02/11 6:57:34 ET]
Table 'Sycorax II' 9-max Seat #9 is the button
Seat 1: Luck In Me ($165.93 in chips) 
Seat 3: chauyeuba ($73.03 in chips) 
Seat 4: oscarleon ($100 in chips) 
Seat 8: matiko09 ($254.46 in chips) 
Seat 9: mrfoldcall ($134.71 in chips) 
Luck In Me: posts small blind $0.50
Filojoes: is sitting out 
Filojoes leaves the table
chauyeuba: posts big blind $1
Sweden_Pound: sits out 
aseban11: sits out 
*** HOLE CARDS ***
Dealt to matiko09 [Ts 2h]
hurtNCYDE joins the table at seat #2 
hurtNCYDE leaves the table
oscarleon: folds 
matiko09: folds 
mrfoldcall: folds 
Luck In Me: raises $2 to $3
chauyeuba: calls $2
*** FLOP *** [6c 6d 9d]
Luck In Me: bets $4
chauyeuba: folds 
Uncalled bet ($4) returned to Luck In Me
Luck In Me collected $5.73 from pot
Luck In Me: doesn't show hand 
*** SUMMARY ***
Total pot $6 | Rake $0.27 
Board [6c 6d 9d]
Seat 1: Luck In Me (small blind) collected ($5.73)
Seat 3: chauyeuba (big blind) folded on the Flop
Seat 4: oscarleon folded before Flop (didn't bet)
Seat 8: matiko09 folded before Flop (didn't bet)
Seat 9: mrfoldcall (button) folded before Flop (didn't bet)





PokerStars Hand #148608454609:  Hold'em No Limit ($0.50/$1.00 USD) - 2016/02/11 12:57:53 CET [2016/02/11 6:57:53 ET]
Table 'Aoluta' 9-max Seat #4 is the button
Seat 1: sebaaastian ($101 in chips) 
Seat 2: matiko09 ($104.02 in chips) 
Seat 3: Zeeshka ($100 in chips) 
Seat 4: oscarleon ($163.04 in chips) 
Seat 6: Luck In Me ($100 in chips) 
Seat 9: Sweden_Pound ($115.64 in chips) 
Luck In Me: posts small blind $0.50
Mukhin1: is sitting out 
Sweden_Pound: posts big blind $1
*** HOLE CARDS ***
Dealt to matiko09 [7h Ac]
Mukhin1 leaves the table
sebaaastian: folds 
matiko09: folds 
Zeeshka: folds 
oscarleon: folds 
Luck In Me: folds 
Uncalled bet ($0.50) returned to Sweden_Pound
Sweden_Pound collected $1 from pot
Sweden_Pound: doesn't show hand 
*** SUMMARY ***
Total pot $1 | Rake $0 
Seat 1: sebaaastian folded before Flop (didn't bet)
Seat 2: matiko09 folded before Flop (didn't bet)
Seat 3: Zeeshka folded before Flop (didn't bet)
Seat 4: oscarleon (button) folded before Flop (didn't bet)
Seat 6: Luck In Me (small blind) folded before Flop
Seat 9: Sweden_Pound (big blind) collected ($1)





PokerStars Hand #148608456994:  Hold'em No Limit ($0.50/$1.00 USD) - 2016/02/11 12:57:58 CET [2016/02/11 6:57:58 ET]
Table 'Regor' 9-max Seat #1 is the button
Seat 1: matiko09 ($136 in chips) 
Seat 2: Luck In Me ($101.50 in chips) 
Seat 3: oscarleon ($112.79 in chips) 
Seat 4: Filojoes ($100 in chips) 
Seat 6: Dachish ($85.45 in chips) 
Luck In Me: posts small blind $0.50
oscarleon: posts big blind $1
chauyeuba: sits out 
JJJ-K9: sits out 
Sweden_Pound: sits out 
*** HOLE CARDS ***
Dealt to matiko09 [5c 6c]
Filojoes: folds 
Dachish: raises $1 to $2
matiko09: folds 
Luck In Me: folds 
oscarleon: folds 
Uncalled bet ($1) returned to Dachish
Dachish collected $2.50 from pot
Dachish: doesn't show hand 
*** SUMMARY ***
Total pot $2.50 | Rake $0 
Seat 1: matiko09 (button) folded before Flop (didn't bet)
Seat 2: Luck In Me (small blind) folded before Flop
Seat 3: oscarleon (big blind) folded before Flop
Seat 4: Filojoes folded before Flop (didn't bet)
Seat 6: Dachish collected ($2.50)





PokerStars Hand #148608463775:  Hold'em No Limit ($0.25/$0.50 USD) - 2016/02/11 12:58:03 CET [2016/02/11 6:58:03 ET]
Table 'Stereoskopia' 9-max Seat #2 is the button
Seat 2: Optimistic21 ($58 in chips) 
Seat 5: ReinisRNS ($51.50 in chips) 
Seat 6: matiko09 ($50 in chips) 
Seat 8: vlad11122007 ($50 in chips) 
Seat 9: apfush ($81.94 in chips) 
ReinisRNS: posts small blind $0.25
matiko09: posts big blind $0.50
*** HOLE CARDS ***
Dealt to matiko09 [As Th]
vlad11122007: folds 
apfush: folds 
Optimistic21: folds 
ReinisRNS: folds 
Uncalled bet ($0.25) returned to matiko09
matiko09 collected $0.50 from pot
matiko09: doesn't show hand 
*** SUMMARY ***
Total pot $0.50 | Rake $0 
Seat 2: Optimistic21 (button) folded before Flop (didn't bet)
Seat 5: ReinisRNS (small blind) folded before Flop
Seat 6: matiko09 (big blind) collected ($0.50)
Seat 8: vlad11122007 folded before Flop (didn't bet)
Seat 9: apfush folded before Flop (didn't bet)





PokerStars Hand #148608464090:  Hold'em No Limit ($0.50/$1.00 USD) - 2016/02/11 12:58:04 CET [2016/02/11 6:58:04 ET]
Table 'Sycorax II' 9-max Seat #1 is the button
Seat 1: Luck In Me ($168.66 in chips) 
Seat 3: chauyeuba ($70.03 in chips) 
Seat 4: oscarleon ($100 in chips) 
Seat 8: matiko09 ($254.46 in chips) 
Seat 9: mrfoldcall ($134.71 in chips) 
chauyeuba: posts small blind $0.50
oscarleon: posts big blind $1
Sweden_Pound: sits out 
aseban11: sits out 
*** HOLE CARDS ***
Dealt to matiko09 [9h Td]
matiko09: folds 
mrfoldcall: folds 
Luck In Me: folds 
rasenganxtcz joins the table at seat #2 
chauyeuba: folds 
Uncalled bet ($0.50) returned to oscarleon
oscarleon collected $1 from pot
oscarleon: doesn't show hand 
*** SUMMARY ***
Total pot $1 | Rake $0 
Seat 1: Luck In Me (button) folded before Flop (didn't bet)
Seat 3: chauyeuba (small blind) folded before Flop
Seat 4: oscarleon (big blind) collected ($1)
Seat 8: matiko09 folded before Flop (didn't bet)
Seat 9: mrfoldcall folded before Flop (didn't bet)





PokerStars Hand #148608466677:  Hold'em No Limit ($0.50/$1.00 USD) - 2016/02/11 12:58:09 CET [2016/02/11 6:58:09 ET]
Table 'Aoluta' 9-max Seat #6 is the button
Seat 1: sebaaastian ($101 in chips) 
Seat 2: matiko09 ($104.02 in chips) 
Seat 3: Zeeshka ($100 in chips) 
Seat 4: oscarleon ($163.04 in chips) 
Seat 6: Luck In Me ($100 in chips) 
Seat 9: Sweden_Pound ($116.14 in chips) 
Sweden_Pound: posts small blind $0.50
sebaaastian: posts big blind $1
*** HOLE CARDS ***
Dealt to matiko09 [9h 2h]
matiko09: folds 
grigy197 joins the table at seat #7 
Zeeshka: folds 
oscarleon: folds 
Luck In Me: folds 
mrspecial1 joins the table at seat #8 
Sweden_Pound: folds 
Uncalled bet ($0.50) returned to sebaaastian
sebaaastian collected $1 from pot
sebaaastian: doesn't show hand 
*** SUMMARY ***
Total pot $1 | Rake $0 
Seat 1: sebaaastian (big blind) collected ($1)
Seat 2: matiko09 folded before Flop (didn't bet)
Seat 3: Zeeshka folded before Flop (didn't bet)
Seat 4: oscarleon folded before Flop (didn't bet)
Seat 6: Luck In Me (button) folded before Flop (didn't bet)
Seat 9: Sweden_Pound (small blind) folded before Flop





PokerStars Hand #148608467971:  Hold'em No Limit ($0.50/$1.00 USD) - 2016/02/11 12:58:12 CET [2016/02/11 6:58:12 ET]
Table 'Rasalas' 9-max Seat #6 is the button
Seat 1: Tissue51 ($100 in chips) 
Seat 2: azzad2007 ($104.67 in chips) 
Seat 3: Luck In Me ($100 in chips) 
Seat 4: Sweden_Pound ($102 in chips) 
Seat 5: Saggitaurus ($102.14 in chips) 
Seat 6: DUkalisUA ($100 in chips) 
Seat 7: matiko09 ($100.50 in chips) 
Seat 8: gwwsb ($75.50 in chips) 
Seat 9: hurtNCYDE ($111.58 in chips) 
matiko09: posts small blind $0.50
gwwsb: posts big blind $1
*** HOLE CARDS ***
Dealt to matiko09 [6c 4d]
hurtNCYDE: folds 
Tissue51: folds 
azzad2007: raises $2 to $3
Luck In Me: folds 
Sweden_Pound: folds 
Saggitaurus: folds 
DUkalisUA: folds 
matiko09: folds 
gwwsb: calls $2
*** FLOP *** [5c 2s 9h]
gwwsb: checks 
azzad2007: bets $4
gwwsb: folds 
Uncalled bet ($4) returned to azzad2007
azzad2007 collected $6.21 from pot
azzad2007: doesn't show hand 
*** SUMMARY ***
Total pot $6.50 | Rake $0.29 
Board [5c 2s 9h]
Seat 1: Tissue51 folded before Flop (didn't bet)
Seat 2: azzad2007 collected ($6.21)
Seat 3: Luck In Me folded before Flop (didn't bet)
Seat 4: Sweden_Pound folded before Flop (didn't bet)
Seat 5: Saggitaurus folded before Flop (didn't bet)
Seat 6: DUkalisUA (button) folded before Flop (didn't bet)
Seat 7: matiko09 (small blind) folded before Flop
Seat 8: gwwsb (big blind) folded on the Flop
Seat 9: hurtNCYDE folded before Flop (didn't bet)





PokerStars Hand #148608470440:  Hold'em No Limit ($0.25/$0.50 USD) - 2016/02/11 12:58:14 CET [2016/02/11 6:58:14 ET]
Table 'Biela' 9-max Seat #3 is the button
Seat 2: Serhent ($51.43 in chips) 
Seat 3: Larzdog29 ($49.75 in chips) 
Seat 4: Miss_S_Dior ($56.46 in chips) 
Seat 5: matiko09 ($50 in chips) 
Seat 6: Honk115 ($56.59 in chips) 
Seat 7: Kud3 ($50 in chips) 
Seat 8: vlad11122007 ($99.40 in chips) 
Miss_S_Dior: posts small blind $0.25
matiko09: posts big blind $0.50
RICKA16: sits out 
*** HOLE CARDS ***
Dealt to matiko09 [3c Ac]
Honk115: folds 
Kud3: raises $1 to $1.50
vlad11122007: folds 
Serhent: folds 
Larzdog29: folds 
Miss_S_Dior: calls $1.25
matiko09: folds 
*** FLOP *** [2s 4h 5s]
Miss_S_Dior: checks 
Kud3: checks 
*** TURN *** [2s 4h 5s] [Kc]
Miss_S_Dior: checks 
Kud3: checks 
*** RIVER *** [2s 4h 5s Kc] [4d]
Miss_S_Dior: bets $1.50
Kud3: calls $1.50
*** SHOW DOWN ***
Miss_S_Dior: shows [Jc Qc] (a pair of Fours)
Kud3: shows [Jh Ad] (a pair of Fours - Ace kicker)
Kud3 collected $6.21 from pot
*** SUMMARY ***
Total pot $6.50 | Rake $0.29 
Board [2s 4h 5s Kc 4d]
Seat 2: Serhent folded before Flop (didn't bet)
Seat 3: Larzdog29 (button) folded before Flop (didn't bet)
Seat 4: Miss_S_Dior (small blind) showed [Jc Qc] and lost with a pair of Fours
Seat 5: matiko09 (big blind) folded before Flop
Seat 6: Honk115 folded before Flop (didn't bet)
Seat 7: Kud3 showed [Jh Ad] and won ($6.21) with a pair of Fours
Seat 8: vlad11122007 folded before Flop (didn't bet)





PokerStars Hand #148608473061:  Hold'em No Limit ($0.50/$1.00 USD) - 2016/02/11 12:58:15 CET [2016/02/11 6:58:15 ET]
Table 'Sycorax II' 9-max Seat #3 is the button
Seat 1: Luck In Me ($168.66 in chips) 
Seat 3: chauyeuba ($69.53 in chips) 
Seat 4: oscarleon ($100.50 in chips) 
Seat 6: Sweden_Pound ($100 in chips) 
Seat 8: matiko09 ($254.46 in chips) 
Seat 9: mrfoldcall ($134.71 in chips) 
oscarleon: posts small blind $0.50
Sweden_Pound: posts big blind $1
aseban11: sits out 
rasenganxtcz: sits out 
*** HOLE CARDS ***
Dealt to matiko09 [7c Qs]
matiko09: folds 
mrfoldcall: folds 
Luck In Me: folds 
chauyeuba: folds 
oscarleon: raises $2 to $3
Sweden_Pound: calls $2
*** FLOP *** [8d Qc 2d]
oscarleon: checks 
Sweden_Pound: checks 
*** TURN *** [8d Qc 2d] [4d]
oscarleon: bets $4
Sweden_Pound: folds 
Uncalled bet ($4) returned to oscarleon
oscarleon collected $5.73 from pot
oscarleon: doesn't show hand 
*** SUMMARY ***
Total pot $6 | Rake $0.27 
Board [8d Qc 2d 4d]
Seat 1: Luck In Me folded before Flop (didn't bet)
Seat 3: chauyeuba (button) folded before Flop (didn't bet)
Seat 4: oscarleon (small blind) collected ($5.73)
Seat 6: Sweden_Pound (big blind) folded on the Turn
Seat 8: matiko09 folded before Flop (didn't bet)
Seat 9: mrfoldcall folded before Flop (didn't bet)





PokerStars Hand #148608474264:  Hold'em No Limit ($0.25/$0.50 USD) - 2016/02/11 12:58:16 CET [2016/02/11 6:58:16 ET]
Table 'Stereoskopia' 9-max Seat #5 is the button
Seat 2: Optimistic21 ($58 in chips) 
Seat 5: ReinisRNS ($51.25 in chips) 
Seat 6: matiko09 ($50.25 in chips) 
Seat 8: vlad11122007 ($50 in chips) 
Seat 9: apfush ($81.94 in chips) 
matiko09: posts small blind $0.25
vlad11122007: posts big blind $0.50
*** HOLE CARDS ***
Dealt to matiko09 [2h Qc]
apfush: folds 
Optimistic21: folds 
JJJ-K9 joins the table at seat #1 
ReinisRNS: folds 
matiko09: folds 
Uncalled bet ($0.25) returned to vlad11122007
vlad11122007 collected $0.50 from pot
vlad11122007: doesn't show hand 
*** SUMMARY ***
Total pot $0.50 | Rake $0 
Seat 2: Optimistic21 folded before Flop (didn't bet)
Seat 5: ReinisRNS (button) folded before Flop (didn't bet)
Seat 6: matiko09 (small blind) folded before Flop
Seat 8: vlad11122007 (big blind) collected ($0.50)
Seat 9: apfush folded before Flop (didn't bet)





PokerStars Hand #148608474180:  Hold'em No Limit ($0.25/$0.50 USD) - 2016/02/11 12:58:16 CET [2016/02/11 6:58:16 ET]
Table 'Ambrosia II' 9-max Seat #2 is the button
Seat 1: matiko09 ($50 in chips) 
Seat 2: TheMinion ($114.12 in chips) 
Seat 3: make6a ($53.64 in chips) 
Seat 4: huudk2016 ($37.69 in chips) 
Seat 5: RICKA16 ($50.25 in chips) 
Seat 6: Reven9er ($72.77 in chips) 
Seat 7: mexx1234 ($83.48 in chips) 
Seat 9: arctur17 ($69.33 in chips) 
make6a: posts small blind $0.25
huudk2016: posts big blind $0.50
*** HOLE CARDS ***
Dealt to matiko09 [6s 9s]
RICKA16: folds 
Reven9er: folds 
mexx1234: raises $0.75 to $1.25
arctur17: calls $1.25
matiko09: folds 
TheMinion: folds 
make6a: folds 
huudk2016: folds 
*** FLOP *** [9c 3c 8s]
mexx1234: checks 
arctur17: bets $2.50
mexx1234: folds 
Uncalled bet ($2.50) returned to arctur17
arctur17 collected $3.10 from pot
arctur17: doesn't show hand 
*** SUMMARY ***
Total pot $3.25 | Rake $0.15 
Board [9c 3c 8s]
Seat 1: matiko09 folded before Flop (didn't bet)
Seat 2: TheMinion (button) folded before Flop (didn't bet)
Seat 3: make6a (small blind) folded before Flop
Seat 4: huudk2016 (big blind) folded before Flop
Seat 5: RICKA16 folded before Flop (didn't bet)
Seat 6: Reven9er folded before Flop (didn't bet)
Seat 7: mexx1234 folded on the Flop
Seat 9: arctur17 collected ($3.10)





PokerStars Hand #148608478004:  Hold'em No Limit ($0.50/$1.00 USD) - 2016/02/11 12:58:24 CET [2016/02/11 6:58:24 ET]
Table 'Regor' 9-max Seat #2 is the button
Seat 1: matiko09 ($136 in chips) 
Seat 2: Luck In Me ($101 in chips) 
Seat 3: oscarleon ($111.79 in chips) 
Seat 5: chauyeuba ($58.97 in chips) 
Seat 6: Dachish ($86.95 in chips) 
oscarleon: posts small blind $0.50
Filojoes: is sitting out 
chauyeuba: posts big blind $1
Filojoes leaves the table
JJJ-K9: sits out 
Sweden_Pound: sits out 
*** HOLE CARDS ***
Dealt to matiko09 [8h Th]
Dachish: folds 
hurtNCYDE joins the table at seat #4 
matiko09: raises $1.50 to $2.50
hurtNCYDE leaves the table
Luck In Me: folds 
oscarleon: folds 
chauyeuba: folds 
Uncalled bet ($1.50) returned to matiko09
matiko09 collected $2.50 from pot
matiko09: doesn't show hand 
*** SUMMARY ***
Total pot $2.50 | Rake $0 
Seat 1: matiko09 collected ($2.50)
Seat 2: Luck In Me (button) folded before Flop (didn't bet)
Seat 3: oscarleon (small blind) folded before Flop
Seat 5: chauyeuba (big blind) folded before Flop
Seat 6: Dachish folded before Flop (didn't bet)





PokerStars Hand #148608487506:  Hold'em No Limit ($0.25/$0.50 USD) - 2016/02/11 12:58:36 CET [2016/02/11 6:58:36 ET]
Table 'Stereoskopia' 9-max Seat #6 is the button
Seat 1: JJJ-K9 ($50 in chips) 
Seat 2: Optimistic21 ($58 in chips) 
Seat 5: ReinisRNS ($51.25 in chips) 
Seat 6: matiko09 ($50 in chips) 
Seat 8: vlad11122007 ($50.25 in chips) 
vlad11122007: posts small blind $0.25
apfush: is sitting out 
apfush leaves the table
JJJ-K9: posts big blind $0.50
*** HOLE CARDS ***
Dealt to matiko09 [7h 7d]
Optimistic21: folds 
Szevasztopol joins the table at seat #3 
ReinisRNS: folds 
banit7 joins the table at seat #9 
banit7 leaves the table
matiko09: raises $0.63 to $1.13
vlad11122007: folds 
JJJ-K9: folds 
Uncalled bet ($0.63) returned to matiko09
matiko09 collected $1.25 from pot
matiko09: doesn't show hand 
*** SUMMARY ***
Total pot $1.25 | Rake $0 
Seat 1: JJJ-K9 (big blind) folded before Flop
Seat 2: Optimistic21 folded before Flop (didn't bet)
Seat 5: ReinisRNS folded before Flop (didn't bet)
Seat 6: matiko09 (button) collected ($1.25)
Seat 8: vlad11122007 (small blind) folded before Flop





PokerStars Hand #148608488662:  Hold'em No Limit ($0.50/$1.00 USD) - 2016/02/11 12:58:39 CET [2016/02/11 6:58:39 ET]
Table 'Aoluta' 9-max Seat #9 is the button
Seat 1: sebaaastian ($101.50 in chips) 
Seat 2: matiko09 ($104.02 in chips) 
Seat 3: Zeeshka ($100 in chips) 
Seat 4: oscarleon ($163.04 in chips) 
Seat 6: Luck In Me ($100 in chips) 
Seat 7: grigy197 ($40 in chips) 
Seat 8: mrspecial1 ($100 in chips) 
Seat 9: Sweden_Pound ($115.64 in chips) 
sebaaastian: posts small blind $0.50
matiko09: posts big blind $1
aseban11: sits out 
grigy197: posts big blind $1
mrspecial1: posts big blind $1
*** HOLE CARDS ***
Dealt to matiko09 [Qc 2d]
Zeeshka: raises $3.90 to $4.90
oscarleon: folds 
Luck In Me: folds 
grigy197: calls $3.90
mrspecial1: calls $3.90
Sweden_Pound: folds 
sebaaastian: folds 
matiko09: folds 
*** FLOP *** [Ts 6c As]
Zeeshka: checks 
grigy197: checks 
mrspecial1: bets $9
Zeeshka: folds 
grigy197: raises $26.10 to $35.10 and is all-in
mrspecial1: calls $26.10
*** TURN *** [Ts 6c As] [4d]
*** RIVER *** [Ts 6c As 4d] [5d]
*** SHOW DOWN ***
grigy197: shows [6s 6d] (three of a kind, Sixes)
mrspecial1: shows [Ah 6h] (two pair, Aces and Sixes)
grigy197 collected $83.60 from pot
*** SUMMARY ***
Total pot $86.40 | Rake $2.80 
Board [Ts 6c As 4d 5d]
Seat 1: sebaaastian (small blind) folded before Flop
Seat 2: matiko09 (big blind) folded before Flop
Seat 3: Zeeshka folded on the Flop
Seat 4: oscarleon folded before Flop (didn't bet)
Seat 6: Luck In Me folded before Flop (didn't bet)
Seat 7: grigy197 showed [6s 6d] and won ($83.60) with three of a kind, Sixes
Seat 8: mrspecial1 showed [Ah 6h] and lost with two pair, Aces and Sixes
Seat 9: Sweden_Pound (button) folded before Flop (didn't bet)





PokerStars Hand #148608496026:  Hold'em No Limit ($0.50/$1.00 USD) - 2016/02/11 12:58:52 CET [2016/02/11 6:58:52 ET]
Table 'Regor' 9-max Seat #3 is the button
Seat 1: matiko09 ($137.50 in chips) 
Seat 2: Luck In Me ($101 in chips) 
Seat 3: oscarleon ($111.29 in chips) 
Seat 5: chauyeuba ($57.97 in chips) 
Seat 7: JJJ-K9 ($80 in chips) 
chauyeuba: posts small blind $0.50
Dachish: is sitting out 
JJJ-K9: posts big blind $1
Sweden_Pound: sits out 
*** HOLE CARDS ***
Dealt to matiko09 [Js Td]
R3NZONIT3 leaves the table
matiko09: folds 
Luck In Me: raises $1.50 to $2.50
oscarleon: folds 
chauyeuba: folds 
Dachish leaves the table
JJJ-K9: calls $1.50
*** FLOP *** [3d 2s Ks]
JJJ-K9: checks 
Luck In Me: bets $2.80
JJJ-K9: calls $2.80
*** TURN *** [3d 2s Ks] [Qd]
JJJ-K9: checks 
Luck In Me: bets $7.40
JJJ-K9: folds 
Uncalled bet ($7.40) returned to Luck In Me
Luck In Me collected $10.60 from pot
*** SUMMARY ***
Total pot $11.10 | Rake $0.50 
Board [3d 2s Ks Qd]
Seat 1: matiko09 folded before Flop (didn't bet)
Seat 2: Luck In Me collected ($10.60)
Seat 3: oscarleon (button) folded before Flop (didn't bet)
Seat 5: chauyeuba (small blind) folded before Flop
Seat 7: JJJ-K9 (big blind) folded on the Turn





PokerStars Hand #148608497145:  Hold'em No Limit ($0.25/$0.50 USD) - 2016/02/11 12:58:54 CET [2016/02/11 6:58:54 ET]
Table 'Ambrosia II' 9-max Seat #3 is the button
Seat 1: matiko09 ($50 in chips) 
Seat 2: TheMinion ($114.12 in chips) 
Seat 3: make6a ($53.39 in chips) 
Seat 4: huudk2016 ($37.19 in chips) 
Seat 5: RICKA16 ($50.25 in chips) 
Seat 6: Reven9er ($72.77 in chips) 
Seat 7: mexx1234 ($82.23 in chips) 
Seat 9: arctur17 ($71.18 in chips) 
huudk2016: posts small blind $0.25
RICKA16: posts big blind $0.50
*** HOLE CARDS ***
Dealt to matiko09 [6c Ac]
Reven9er: folds 
mexx1234: folds 
arctur17: raises $0.50 to $1
matiko09: folds 
TheMinion: folds 
make6a: folds 
huudk2016: raises $1.50 to $2.50
RICKA16: folds 
arctur17: calls $1.50
*** FLOP *** [Ts 3c 9h]
huudk2016: checks 
arctur17: bets $2.50
huudk2016: raises $3 to $5.50
arctur17: calls $3
*** TURN *** [Ts 3c 9h] [8c]
huudk2016: bets $8.50
arctur17: calls $8.50
*** RIVER *** [Ts 3c 9h 8c] [Ah]
huudk2016: checks 
arctur17: checks 
*** SHOW DOWN ***
huudk2016: shows [Kh Ks] (a pair of Kings)
arctur17: mucks hand 
huudk2016 collected $31.99 from pot
*** SUMMARY ***
Total pot $33.50 | Rake $1.51 
Board [Ts 3c 9h 8c Ah]
Seat 1: matiko09 folded before Flop (didn't bet)
Seat 2: TheMinion folded before Flop (didn't bet)
Seat 3: make6a (button) folded before Flop (didn't bet)
Seat 4: huudk2016 (small blind) showed [Kh Ks] and won ($31.99) with a pair of Kings
Seat 5: RICKA16 (big blind) folded before Flop
Seat 6: Reven9er folded before Flop (didn't bet)
Seat 7: mexx1234 folded before Flop (didn't bet)
Seat 9: arctur17 mucked [7d 7c]





PokerStars Hand #148608499435:  Hold'em No Limit (€0.25/€0.50 EUR) - 2016/02/11 12:58:58 CET [2016/02/11 6:58:58 ET]
Table 'Otero II' 9-max Seat #1 is the button
Seat 1: Nacho2556 (€53.96 in chips) 
Seat 3: Szevasztopol (€50 in chips) 
Seat 4: kram0909 (€3.97 in chips) 
Seat 5: vlad11122007 (€50.94 in chips) 
Seat 6: TonnaMunz (€51.35 in chips) 
Seat 8: matiko09 (€70.18 in chips) 
Seat 9: Optimistic21 (€71.88 in chips) 
Dantist1122 will be allowed to play after the button
Szevasztopol: posts small blind €0.25
kram0909: posts big blind €0.50
Dflingern95: sits out 
*** HOLE CARDS ***
Dealt to matiko09 [2d 8c]
vlad11122007: folds 
TonnaMunz is disconnected 
TonnaMunz has timed out while disconnected
TonnaMunz: folds 
matiko09: folds 
Optimistic21: folds 
Nacho2556: folds 
Szevasztopol: raises €1 to €1.50
kram0909: calls €1
*** FLOP *** [2s Qs 4h]
Szevasztopol: checks 
kram0909: bets €2.47 and is all-in
Szevasztopol: folds 
Uncalled bet (€2.47) returned to kram0909
kram0909 collected €2.86 from pot
kram0909: doesn't show hand 
*** SUMMARY ***
Total pot €3 | Rake €0.14 
Board [2s Qs 4h]
Seat 1: Nacho2556 (button) folded before Flop (didn't bet)
Seat 3: Szevasztopol (small blind) folded on the Flop
Seat 4: kram0909 (big blind) collected (€2.86)
Seat 5: vlad11122007 folded before Flop (didn't bet)
Seat 6: TonnaMunz folded before Flop (didn't bet)
Seat 8: matiko09 folded before Flop (didn't bet)
Seat 9: Optimistic21 folded before Flop (didn't bet)





PokerStars Hand #148608499615:  Hold'em No Limit ($0.25/$0.50 USD) - 2016/02/11 12:58:59 CET [2016/02/11 6:58:59 ET]
Table 'Stereoskopia' 9-max Seat #8 is the button
Seat 1: JJJ-K9 ($49.50 in chips) 
Seat 2: Optimistic21 ($58 in chips) 
Seat 5: ReinisRNS ($51.25 in chips) 
Seat 6: matiko09 ($50.75 in chips) 
Seat 8: vlad11122007 ($50 in chips) 
JJJ-K9: posts small blind $0.25
Optimistic21: posts big blind $0.50
Szevasztopol: sits out 
*** HOLE CARDS ***
Dealt to matiko09 [3d 5s]
ReinisRNS: raises $1.25 to $1.75
matiko09: folds 
vlad11122007: folds 
JJJ-K9: folds 
Optimistic21: folds 
Uncalled bet ($1.25) returned to ReinisRNS
ReinisRNS collected $1.25 from pot
ReinisRNS: doesn't show hand 
*** SUMMARY ***
Total pot $1.25 | Rake $0 
Seat 1: JJJ-K9 (small blind) folded before Flop
Seat 2: Optimistic21 (big blind) folded before Flop
Seat 5: ReinisRNS collected ($1.25)
Seat 6: matiko09 folded before Flop (didn't bet)
Seat 8: vlad11122007 (button) folded before Flop (didn't bet)





PokerStars Hand #148608501948:  Hold'em No Limit ($0.50/$1.00 USD) - 2016/02/11 12:59:03 CET [2016/02/11 6:59:03 ET]
Table 'Rasalas' 9-max Seat #7 is the button
Seat 1: Tissue51 ($100 in chips) 
Seat 2: azzad2007 ($107.88 in chips) 
Seat 3: Luck In Me ($100 in chips) 
Seat 4: Sweden_Pound ($102 in chips) 
Seat 5: Saggitaurus ($102.14 in chips) 
Seat 6: DUkalisUA ($100 in chips) 
Seat 7: matiko09 ($100 in chips) 
Seat 8: gwwsb ($72.50 in chips) 
Seat 9: hurtNCYDE ($111.58 in chips) 
gwwsb: posts small blind $0.50
hurtNCYDE: posts big blind $1
*** HOLE CARDS ***
Dealt to matiko09 [4d Jd]
Tissue51: folds 
azzad2007: folds 
azzad2007 leaves the table
Luck In Me: folds 
Zeeshka joins the table at seat #2 
Sweden_Pound: folds 
Saggitaurus: folds 
DUkalisUA: folds 
matiko09: folds 
gwwsb: raises $2 to $3
hurtNCYDE: folds 
Uncalled bet ($2) returned to gwwsb
gwwsb collected $2 from pot
gwwsb: doesn't show hand 
*** SUMMARY ***
Total pot $2 | Rake $0 
Seat 1: Tissue51 folded before Flop (didn't bet)
Seat 2: azzad2007 folded before Flop (didn't bet)
Seat 3: Luck In Me folded before Flop (didn't bet)
Seat 4: Sweden_Pound folded before Flop (didn't bet)
Seat 5: Saggitaurus folded before Flop (didn't bet)
Seat 6: DUkalisUA folded before Flop (didn't bet)
Seat 7: matiko09 (button) folded before Flop (didn't bet)
Seat 8: gwwsb (small blind) collected ($2)
Seat 9: hurtNCYDE (big blind) folded before Flop





PokerStars Hand #148608510079:  Hold'em No Limit ($0.25/$0.50 USD) - 2016/02/11 12:59:19 CET [2016/02/11 6:59:19 ET]
Table 'Stereoskopia' 9-max Seat #1 is the button
Seat 1: JJJ-K9 ($49.25 in chips) 
Seat 2: Optimistic21 ($57.50 in chips) 
Seat 3: Szevasztopol ($50 in chips) 
Seat 5: ReinisRNS ($52 in chips) 
Seat 6: matiko09 ($50.75 in chips) 
Seat 8: vlad11122007 ($50 in chips) 
Optimistic21: posts small blind $0.25
Szevasztopol: posts big blind $0.50
*** HOLE CARDS ***
Dealt to matiko09 [4c 3d]
ReinisRNS: folds 
matiko09: folds 
vlad11122007: folds 
JJJ-K9: folds 
Optimistic21: folds 
Uncalled bet ($0.25) returned to Szevasztopol
Szevasztopol collected $0.50 from pot
Szevasztopol: doesn't show hand 
*** SUMMARY ***
Total pot $0.50 | Rake $0 
Seat 1: JJJ-K9 (button) folded before Flop (didn't bet)
Seat 2: Optimistic21 (small blind) folded before Flop
Seat 3: Szevasztopol (big blind) collected ($0.50)
Seat 5: ReinisRNS folded before Flop (didn't bet)
Seat 6: matiko09 folded before Flop (didn't bet)
Seat 8: vlad11122007 folded before Flop (didn't bet)





PokerStars Hand #148608519015:  Hold'em No Limit ($0.50/$1.00 USD) - 2016/02/11 12:59:37 CET [2016/02/11 6:59:37 ET]
Table 'Rasalas' 9-max Seat #8 is the button
Seat 1: Tissue51 ($100 in chips) 
Seat 3: Luck In Me ($100 in chips) 
Seat 4: Sweden_Pound ($102 in chips) 
Seat 5: Saggitaurus ($102.14 in chips) 
Seat 6: DUkalisUA ($100 in chips) 
Seat 7: matiko09 ($100 in chips) 
Seat 8: gwwsb ($73.50 in chips) 
Seat 9: hurtNCYDE ($110.58 in chips) 
hurtNCYDE: posts small blind $0.50
Tissue51: posts big blind $1
Zeeshka: sits out 
*** HOLE CARDS ***
Dealt to matiko09 [3s 3h]
Luck In Me: folds 
Sweden_Pound: folds 
Saggitaurus: folds 
DUkalisUA: folds 
matiko09: raises $1.50 to $2.50
gwwsb: folds 
hurtNCYDE: folds 
Tissue51: folds 
Uncalled bet ($1.50) returned to matiko09
matiko09 collected $2.50 from pot
matiko09: doesn't show hand 
*** SUMMARY ***
Total pot $2.50 | Rake $0 
Seat 1: Tissue51 (big blind) folded before Flop
Seat 3: Luck In Me folded before Flop (didn't bet)
Seat 4: Sweden_Pound folded before Flop (didn't bet)
Seat 5: Saggitaurus folded before Flop (didn't bet)
Seat 6: DUkalisUA folded before Flop (didn't bet)
Seat 7: matiko09 collected ($2.50)
Seat 8: gwwsb (button) folded before Flop (didn't bet)
Seat 9: hurtNCYDE (small blind) folded before Flop





PokerStars Hand #148608519260:  Hold'em No Limit ($0.25/$0.50 USD) - 2016/02/11 12:59:38 CET [2016/02/11 6:59:38 ET]
Table 'Biela' 9-max Seat #4 is the button
Seat 2: Serhent ($51.43 in chips) 
Seat 3: Larzdog29 ($49.75 in chips) 
Seat 4: Miss_S_Dior ($53.46 in chips) 
Seat 5: matiko09 ($50 in chips) 
Seat 6: Honk115 ($56.59 in chips) 
Seat 7: Kud3 ($53.21 in chips) 
Seat 8: vlad11122007 ($99.40 in chips) 
matiko09: posts small blind $0.25
Honk115: posts big blind $0.50
RICKA16: sits out 
*** HOLE CARDS ***
Dealt to matiko09 [Ah 3d]
Kud3: folds 
vlad11122007: raises $1 to $1.50
Serhent: folds 
Larzdog29: folds 
Miss_S_Dior: folds 
matiko09: folds 
Honk115: calls $1
*** FLOP *** [Th As Kd]
Honk115: checks 
vlad11122007: checks 
*** TURN *** [Th As Kd] [4s]
Honk115: bets $3
vlad11122007: folds 
Uncalled bet ($3) returned to Honk115
Honk115 collected $3.10 from pot
Honk115: doesn't show hand 
*** SUMMARY ***
Total pot $3.25 | Rake $0.15 
Board [Th As Kd 4s]
Seat 2: Serhent folded before Flop (didn't bet)
Seat 3: Larzdog29 folded before Flop (didn't bet)
Seat 4: Miss_S_Dior (button) folded before Flop (didn't bet)
Seat 5: matiko09 (small blind) folded before Flop
Seat 6: Honk115 (big blind) collected ($3.10)
Seat 7: Kud3 folded before Flop (didn't bet)
Seat 8: vlad11122007 folded on the Turn





PokerStars Hand #148608519937:  Hold'em No Limit ($0.25/$0.50 USD) - 2016/02/11 12:59:39 CET [2016/02/11 6:59:39 ET]
Table 'Stereoskopia' 9-max Seat #2 is the button
Seat 1: JJJ-K9 ($49.25 in chips) 
Seat 2: Optimistic21 ($57.25 in chips) 
Seat 3: Szevasztopol ($50.25 in chips) 
Seat 5: ReinisRNS ($52 in chips) 
Seat 6: matiko09 ($50.75 in chips) 
Seat 8: vlad11122007 ($50 in chips) 
Szevasztopol: posts small blind $0.25
ReinisRNS: posts big blind $0.50
*** HOLE CARDS ***
Dealt to matiko09 [6c Ac]
matiko09: folds 
vlad11122007: folds 
JJJ-K9: folds 
Optimistic21: folds 
Szevasztopol: raises $1 to $1.50
ReinisRNS: calls $1
*** FLOP *** [9s 2h 4h]
Szevasztopol: bets $2.23
ReinisRNS: calls $2.23
*** TURN *** [9s 2h 4h] [Th]
Szevasztopol: checks 
ReinisRNS: checks 
*** RIVER *** [9s 2h 4h Th] [7d]
Szevasztopol: checks 
ReinisRNS: checks 
*** SHOW DOWN ***
Szevasztopol: shows [9h Ks] (a pair of Nines)
ReinisRNS: mucks hand 
Szevasztopol collected $7.12 from pot
*** SUMMARY ***
Total pot $7.46 | Rake $0.34 
Board [9s 2h 4h Th 7d]
Seat 1: JJJ-K9 folded before Flop (didn't bet)
Seat 2: Optimistic21 (button) folded before Flop (didn't bet)
Seat 3: Szevasztopol (small blind) showed [9h Ks] and won ($7.12) with a pair of Nines
Seat 5: ReinisRNS (big blind) mucked [4c 3h]
Seat 6: matiko09 folded before Flop (didn't bet)
Seat 8: vlad11122007 folded before Flop (didn't bet)





PokerStars Hand #148608528599:  Hold'em No Limit ($0.50/$1.00 USD) - 2016/02/11 12:59:56 CET [2016/02/11 6:59:56 ET]
Table 'Aoluta' 9-max Seat #1 is the button
Seat 1: sebaaastian ($101 in chips) 
Seat 2: matiko09 ($103.02 in chips) 
Seat 3: Zeeshka ($100 in chips) 
Seat 4: oscarleon ($163.04 in chips) 
Seat 6: Luck In Me ($100 in chips) 
Seat 7: grigy197 ($83.60 in chips) 
Seat 8: mrspecial1 ($60 in chips) 
Seat 9: Sweden_Pound ($115.64 in chips) 
matiko09: posts small blind $0.50
Zeeshka: posts big blind $1
aseban11: sits out 
*** HOLE CARDS ***
Dealt to matiko09 [3d Ah]
oscarleon: folds 
Luck In Me: folds 
grigy197: folds 
mrspecial1: raises $2 to $3
Sweden_Pound: folds 
sebaaastian: folds 
matiko09: folds 
Zeeshka: folds 
Uncalled bet ($2) returned to mrspecial1
mrspecial1 collected $2.50 from pot
*** SUMMARY ***
Total pot $2.50 | Rake $0 
Seat 1: sebaaastian (button) folded before Flop (didn't bet)
Seat 2: matiko09 (small blind) folded before Flop
Seat 3: Zeeshka (big blind) folded before Flop
Seat 4: oscarleon folded before Flop (didn't bet)
Seat 6: Luck In Me folded before Flop (didn't bet)
Seat 7: grigy197 folded before Flop (didn't bet)
Seat 8: mrspecial1 collected ($2.50)
Seat 9: Sweden_Pound folded before Flop (didn't bet)





PokerStars Hand #148608529363:  Hold'em No Limit ($0.25/$0.50 USD) - 2016/02/11 12:59:58 CET [2016/02/11 6:59:58 ET]
Table 'Sylvania II' 9-max Seat #5 is the button
Seat 1: mexx1234 ($198.57 in chips) 
Seat 3: ruyingren ($189.91 in chips) 
Seat 4: matiko09 ($149.49 in chips) 
Seat 5: vlad11122007 ($62.69 in chips) 
Seat 8: Optimistic21 ($50 in chips) 
Seat 9: Kud3 ($136.53 in chips) 
TonnaMunz has timed out while being disconnected
TonnaMunz: is sitting out 
i L00K great: is sitting out 
i L00K great leaves the table
Optimistic21: posts small blind $0.25
Kud3: posts big blind $0.50
Effort92: sits out 
mexx1234: posts the ante $0.10
ruyingren: posts the ante $0.10
matiko09: posts the ante $0.10
vlad11122007: posts the ante $0.10
Optimistic21: posts the ante $0.10
Kud3: posts the ante $0.10
*** HOLE CARDS ***
Dealt to matiko09 [3s Ac]
mexx1234: folds 
mexx1234 leaves the table
ruyingren: raises $1 to $1.50
matiko09: folds 
vlad11122007: folds 
Optimistic21: folds 
Kud3: folds 
Uncalled bet ($1) returned to ruyingren
ruyingren collected $1.85 from pot
*** SUMMARY ***
Total pot $1.85 | Rake $0 
Seat 1: mexx1234 folded before Flop (didn't bet)
Seat 3: ruyingren collected ($1.85)
Seat 4: matiko09 folded before Flop (didn't bet)
Seat 5: vlad11122007 (button) folded before Flop (didn't bet)
Seat 8: Optimistic21 (small blind) folded before Flop
Seat 9: Kud3 (big blind) folded before Flop





PokerStars Hand #148608537307:  Hold'em No Limit ($0.50/$1.00 USD) - 2016/02/11 13:00:14 CET [2016/02/11 7:00:14 ET]
Table 'Rasalas' 9-max Seat #9 is the button
Seat 1: Tissue51 ($100 in chips) 
Seat 2: Zeeshka ($100 in chips) 
Seat 3: Luck In Me ($100 in chips) 
Seat 4: Sweden_Pound ($102 in chips) 
Seat 5: Saggitaurus ($102.14 in chips) 
Seat 6: DUkalisUA ($100 in chips) 
Seat 7: matiko09 ($101.50 in chips) 
Seat 8: gwwsb ($73.50 in chips) 
Seat 9: hurtNCYDE ($110.08 in chips) 
Tissue51: posts small blind $0.50
Zeeshka: posts big blind $1
*** HOLE CARDS ***
Dealt to matiko09 [Jd Kd]
Luck In Me: folds 
Sweden_Pound: folds 
Saggitaurus: raises $1.50 to $2.50
DUkalisUA: folds 
matiko09: folds 
gwwsb: folds 
hurtNCYDE: folds 
Tissue51: folds 
Zeeshka: folds 
Uncalled bet ($1.50) returned to Saggitaurus
Saggitaurus collected $2.50 from pot
*** SUMMARY ***
Total pot $2.50 | Rake $0 
Seat 1: Tissue51 (small blind) folded before Flop
Seat 2: Zeeshka (big blind) folded before Flop
Seat 3: Luck In Me folded before Flop (didn't bet)
Seat 4: Sweden_Pound folded before Flop (didn't bet)
Seat 5: Saggitaurus collected ($2.50)
Seat 6: DUkalisUA folded before Flop (didn't bet)
Seat 7: matiko09 folded before Flop (didn't bet)
Seat 8: gwwsb folded before Flop (didn't bet)
Seat 9: hurtNCYDE (button) folded before Flop (didn't bet)





PokerStars Hand #148608541717:  Hold'em No Limit ($0.25/$0.50 USD) - 2016/02/11 13:00:22 CET [2016/02/11 7:00:22 ET]
Table 'Biela' 9-max Seat #5 is the button
Seat 2: Serhent ($51.43 in chips) 
Seat 3: Larzdog29 ($49.75 in chips) 
Seat 4: Miss_S_Dior ($53.46 in chips) 
Seat 5: matiko09 ($50 in chips) 
Seat 6: Honk115 ($58.19 in chips) 
Seat 7: Kud3 ($53.21 in chips) 
Seat 8: vlad11122007 ($97.90 in chips) 
Honk115: posts small blind $0.25
Kud3: posts big blind $0.50
RICKA16: sits out 
*** HOLE CARDS ***
Dealt to matiko09 [Kh 5d]
vlad11122007: folds 
Serhent: raises $1 to $1.50
Larzdog29: folds 
Miss_S_Dior: folds 
matiko09: folds 
Honk115: calls $1.25
Kud3: calls $1
*** FLOP *** [6d 5c 4d]
Honk115: checks 
Kud3: checks 
Serhent: bets $3
Honk115: calls $3
Kud3: calls $3
*** TURN *** [6d 5c 4d] [7d]
Honk115: checks 
Kud3: checks 
Serhent: checks 
*** RIVER *** [6d 5c 4d 7d] [6s]
Honk115: bets $13
Kud3: folds 
Serhent: raises $33.93 to $46.93 and is all-in
Honk115: calls $33.93
*** SHOW DOWN ***
Serhent: shows [7s 7c] (a full house, Sevens full of Sixes)
Honk115: shows [Kd 8d] (a flush, King high)
Serhent collected $104.86 from pot
*** SUMMARY ***
Total pot $107.36 | Rake $2.50 
Board [6d 5c 4d 7d 6s]
Seat 2: Serhent showed [7s 7c] and won ($104.86) with a full house, Sevens full of Sixes
Seat 3: Larzdog29 folded before Flop (didn't bet)
Seat 4: Miss_S_Dior folded before Flop (didn't bet)
Seat 5: matiko09 (button) folded before Flop (didn't bet)
Seat 6: Honk115 (small blind) showed [Kd 8d] and lost with a flush, King high
Seat 7: Kud3 (big blind) folded on the River
Seat 8: vlad11122007 folded before Flop (didn't bet)





PokerStars Hand #148608544104:  Hold'em No Limit (€0.25/€0.50 EUR) - 2016/02/11 13:00:27 CET [2016/02/11 7:00:27 ET]
Table 'Otero II' 9-max Seat #3 is the button
Seat 1: Nacho2556 (€53.96 in chips) 
Seat 2: Dantist1122 (€50 in chips) 
Seat 3: Szevasztopol (€50 in chips) 
Seat 4: kram0909 (€5.33 in chips) 
Seat 5: vlad11122007 (€50.94 in chips) 
Seat 6: TonnaMunz (€51.35 in chips) 
Seat 8: matiko09 (€70.18 in chips) 
Seat 9: Optimistic21 (€71.88 in chips) 
kram0909: posts small blind €0.25
vlad11122007: posts big blind €0.50
Dflingern95: sits out 
Dantist1122: posts big blind €0.50
*** HOLE CARDS ***
Dealt to matiko09 [8s 9s]
TonnaMunz has timed out while being disconnected
TonnaMunz: folds 
matiko09: raises €1.50 to €2
Optimistic21: folds 
Nacho2556: folds 
Nacho2556 leaves the table
make6a joins the table at seat #1 
Dantist1122: folds 
Szevasztopol: folds 
kram0909: folds 
vlad11122007: folds 
Uncalled bet (€1.50) returned to matiko09
matiko09 collected €1.75 from pot
matiko09: doesn't show hand 
*** SUMMARY ***
Total pot €1.75 | Rake €0 
Seat 1: Nacho2556 folded before Flop (didn't bet)
Seat 2: Dantist1122 folded before Flop
Seat 3: Szevasztopol (button) folded before Flop (didn't bet)
Seat 4: kram0909 (small blind) folded before Flop
Seat 5: vlad11122007 (big blind) folded before Flop
Seat 6: TonnaMunz folded before Flop (didn't bet)
Seat 8: matiko09 collected (€1.75)
Seat 9: Optimistic21 folded before Flop (didn't bet)





PokerStars Hand #148608545299:  Hold'em No Limit ($0.25/$0.50 USD) - 2016/02/11 13:00:29 CET [2016/02/11 7:00:29 ET]
Table 'Algedi' 9-max Seat #9 is the button
Seat 1: vlad11122007 ($74.97 in chips) 
Seat 2: Reffypaul ($57.36 in chips) 
Seat 3: Saggitaurus ($123.84 in chips) 
Seat 4: Effort92 ($61.66 in chips) 
Seat 5: Optimistic21 ($60.33 in chips) 
Seat 6: TonnaMunz ($96.59 in chips) 
Seat 7: hoedtrob ($56.74 in chips) 
Seat 8: matiko09 ($50 in chips) 
Seat 9: Kud3 ($125 in chips) 
vlad11122007: posts small blind $0.25
Reffypaul: posts big blind $0.50
vlad11122007: posts the ante $0.10
Reffypaul: posts the ante $0.10
Saggitaurus: posts the ante $0.10
Effort92: posts the ante $0.10
Optimistic21: posts the ante $0.10
TonnaMunz: posts the ante $0.10
hoedtrob: posts the ante $0.10
matiko09: posts the ante $0.10
Kud3: posts the ante $0.10
*** HOLE CARDS ***
Dealt to matiko09 [Qc Js]
hoedtrob said, "nu"
Saggitaurus: folds 
hoedtrob said, "nh"
Effort92: folds 
Optimistic21: raises $1 to $1.50
TonnaMunz: folds 
hoedtrob: calls $1.50
matiko09: folds 
Kud3: folds 
vlad11122007: folds 
Reffypaul: folds 
*** FLOP *** [5d Qd 2d]
Optimistic21: bets $2.50
hoedtrob: calls $2.50
*** TURN *** [5d Qd 2d] [4c]
Optimistic21: checks 
hoedtrob: bets $5
Optimistic21: folds 
Uncalled bet ($5) returned to hoedtrob
hoedtrob collected $9.22 from pot
hoedtrob: doesn't show hand 
*** SUMMARY ***
Total pot $9.65 | Rake $0.43 
Board [5d Qd 2d 4c]
Seat 1: vlad11122007 (small blind) folded before Flop
Seat 2: Reffypaul (big blind) folded before Flop
Seat 3: Saggitaurus folded before Flop (didn't bet)
Seat 4: Effort92 folded before Flop (didn't bet)
Seat 5: Optimistic21 folded on the Turn
Seat 6: TonnaMunz folded before Flop (didn't bet)
Seat 7: hoedtrob collected ($9.22)
Seat 8: matiko09 folded before Flop (didn't bet)
Seat 9: Kud3 (button) folded before Flop (didn't bet)





PokerStars Hand #148608548685:  Hold'em No Limit ($0.25/$0.50 USD) - 2016/02/11 13:00:36 CET [2016/02/11 7:00:36 ET]
Table 'Stereoskopia' 9-max Seat #3 is the button
Seat 1: JJJ-K9 ($49.25 in chips) 
Seat 2: Optimistic21 ($57.25 in chips) 
Seat 3: Szevasztopol ($53.64 in chips) 
Seat 5: ReinisRNS ($48.27 in chips) 
Seat 6: matiko09 ($50.75 in chips) 
Seat 8: vlad11122007 ($50 in chips) 
ReinisRNS: posts small blind $0.25
matiko09: posts big blind $0.50
*** HOLE CARDS ***
Dealt to matiko09 [3d 4c]
vlad11122007: folds 
xxxibgdrgn joins the table at seat #9 
JJJ-K9: folds 
Optimistic21: folds 
Szevasztopol: raises $1 to $1.50
ReinisRNS: folds 
matiko09: folds 
Uncalled bet ($1) returned to Szevasztopol
Szevasztopol collected $1.25 from pot
Szevasztopol: doesn't show hand 
*** SUMMARY ***
Total pot $1.25 | Rake $0 
Seat 1: JJJ-K9 folded before Flop (didn't bet)
Seat 2: Optimistic21 folded before Flop (didn't bet)
Seat 3: Szevasztopol (button) collected ($1.25)
Seat 5: ReinisRNS (small blind) folded before Flop
Seat 6: matiko09 (big blind) folded before Flop
Seat 8: vlad11122007 folded before Flop (didn't bet)





PokerStars Hand #148608554039:  Hold'em No Limit ($0.25/$0.50 USD) - 2016/02/11 13:00:46 CET [2016/02/11 7:00:46 ET]
Table 'Ambrosia II' 9-max Seat #4 is the button
Seat 1: matiko09 ($50 in chips) 
Seat 2: TheMinion ($114.12 in chips) 
Seat 3: make6a ($53.39 in chips) 
Seat 4: huudk2016 ($52.68 in chips) 
Seat 5: RICKA16 ($49.75 in chips) 
Seat 6: Reven9er ($72.77 in chips) 
Seat 7: mexx1234 ($82.23 in chips) 
Seat 9: arctur17 ($54.68 in chips) 
RICKA16: posts small blind $0.25
Reven9er: posts big blind $0.50
*** HOLE CARDS ***
Dealt to matiko09 [Ah 2s]
mexx1234: folds 
arctur17: folds 
matiko09: folds 
mexx1234 leaves the table
TheMinion: folds 
make6a: folds 
Ana.Satravca joins the table at seat #7 
huudk2016: calls $0.50
RICKA16: folds 
Reven9er: checks 
*** FLOP *** [7s Ac Ad]
Reven9er: checks 
huudk2016: bets $1.50
Reven9er: folds 
Uncalled bet ($1.50) returned to huudk2016
huudk2016 collected $1.19 from pot
huudk2016: doesn't show hand 
*** SUMMARY ***
Total pot $1.25 | Rake $0.06 
Board [7s Ac Ad]
Seat 1: matiko09 folded before Flop (didn't bet)
Seat 2: TheMinion folded before Flop (didn't bet)
Seat 3: make6a folded before Flop (didn't bet)
Seat 4: huudk2016 (button) collected ($1.19)
Seat 5: RICKA16 (small blind) folded before Flop
Seat 6: Reven9er (big blind) folded on the Flop
Seat 7: mexx1234 folded before Flop (didn't bet)
Seat 9: arctur17 folded before Flop (didn't bet)





PokerStars Hand #148608554966:  Hold'em No Limit ($0.50/$1.00 USD) - 2016/02/11 13:00:48 CET [2016/02/11 7:00:48 ET]
Table 'Aoluta' 9-max Seat #2 is the button
Seat 1: sebaaastian ($101 in chips) 
Seat 2: matiko09 ($102.52 in chips) 
Seat 3: Zeeshka ($100 in chips) 
Seat 4: oscarleon ($163.04 in chips) 
Seat 6: Luck In Me ($100 in chips) 
Seat 7: grigy197 ($83.60 in chips) 
Seat 8: mrspecial1 ($61.50 in chips) 
Seat 9: Sweden_Pound ($115.64 in chips) 
Zeeshka: posts small blind $0.50
oscarleon: posts big blind $1
aseban11: sits out 
*** HOLE CARDS ***
Dealt to matiko09 [6h Ac]
Luck In Me: folds 
grigy197: folds 
mrspecial1 is disconnected 
mrspecial1 has timed out while disconnected
mrspecial1: folds 
Sweden_Pound: folds 
sebaaastian: folds 
matiko09: raises $1.27 to $2.27
Zeeshka: folds 
oscarleon: folds 
Uncalled bet ($1.27) returned to matiko09
matiko09 collected $2.50 from pot
matiko09: doesn't show hand 
*** SUMMARY ***
Total pot $2.50 | Rake $0 
Seat 1: sebaaastian folded before Flop (didn't bet)
Seat 2: matiko09 (button) collected ($2.50)
Seat 3: Zeeshka (small blind) folded before Flop
Seat 4: oscarleon (big blind) folded before Flop
Seat 6: Luck In Me folded before Flop (didn't bet)
Seat 7: grigy197 folded before Flop (didn't bet)
Seat 8: mrspecial1 folded before Flop (didn't bet)
Seat 9: Sweden_Pound folded before Flop (didn't bet)





PokerStars Hand #148608556628:  Hold'em No Limit ($0.50/$1.00 USD) - 2016/02/11 13:00:51 CET [2016/02/11 7:00:51 ET]
Table 'Rasalas' 9-max Seat #1 is the button
Seat 1: Tissue51 ($100 in chips) 
Seat 2: Zeeshka ($100 in chips) 
Seat 3: Luck In Me ($100 in chips) 
Seat 4: Sweden_Pound ($102 in chips) 
Seat 5: Saggitaurus ($103.64 in chips) 
Seat 6: DUkalisUA ($100 in chips) 
Seat 7: matiko09 ($101.50 in chips) 
Seat 8: gwwsb ($73.50 in chips) 
Seat 9: hurtNCYDE ($110.08 in chips) 
Zeeshka: posts small blind $0.50
Luck In Me: posts big blind $1
*** HOLE CARDS ***
Dealt to matiko09 [5h Kd]
Sweden_Pound: folds 
Saggitaurus: folds 
DUkalisUA: raises $2 to $3
matiko09: folds 
gwwsb: calls $3
hurtNCYDE: folds 
Tissue51: folds 
Zeeshka: folds 
Luck In Me: raises $10 to $13
DUkalisUA: folds 
gwwsb: folds 
Uncalled bet ($10) returned to Luck In Me
Luck In Me collected $9.50 from pot
Luck In Me: doesn't show hand 
*** SUMMARY ***
Total pot $9.50 | Rake $0 
Seat 1: Tissue51 (button) folded before Flop (didn't bet)
Seat 2: Zeeshka (small blind) folded before Flop
Seat 3: Luck In Me (big blind) collected ($9.50)
Seat 4: Sweden_Pound folded before Flop (didn't bet)
Seat 5: Saggitaurus folded before Flop (didn't bet)
Seat 6: DUkalisUA folded before Flop
Seat 7: matiko09 folded before Flop (didn't bet)
Seat 8: gwwsb folded before Flop
Seat 9: hurtNCYDE folded before Flop (didn't bet)





PokerStars Hand #148608558335:  Hold'em No Limit ($0.25/$0.50 USD) - 2016/02/11 13:00:54 CET [2016/02/11 7:00:54 ET]
Table 'Stereoskopia' 9-max Seat #5 is the button
Seat 1: JJJ-K9 ($49.25 in chips) 
Seat 2: Optimistic21 ($57.25 in chips) 
Seat 3: Szevasztopol ($54.39 in chips) 
Seat 5: ReinisRNS ($48.02 in chips) 
Seat 6: matiko09 ($50.25 in chips) 
Seat 8: vlad11122007 ($50 in chips) 
matiko09: posts small blind $0.25
vlad11122007: posts big blind $0.50
xxxibgdrgn: sits out 
*** HOLE CARDS ***
Dealt to matiko09 [9h 8s]
JJJ-K9: folds 
Optimistic21: folds 
Szevasztopol: folds 
ReinisRNS: folds 
matiko09: raises $1 to $1.50
vlad11122007: folds 
Uncalled bet ($1) returned to matiko09
matiko09 collected $1 from pot
matiko09: doesn't show hand 
*** SUMMARY ***
Total pot $1 | Rake $0 
Seat 1: JJJ-K9 folded before Flop (didn't bet)
Seat 2: Optimistic21 folded before Flop (didn't bet)
Seat 3: Szevasztopol folded before Flop (didn't bet)
Seat 5: ReinisRNS (button) folded before Flop (didn't bet)
Seat 6: matiko09 (small blind) collected ($1)
Seat 8: vlad11122007 (big blind) folded before Flop





PokerStars Hand #148608558516:  Hold'em No Limit ($0.25/$0.50 USD) - 2016/02/11 13:00:55 CET [2016/02/11 7:00:55 ET]
Table 'Sylvania II' 9-max Seat #8 is the button
Seat 2: Effort92 ($64.44 in chips) 
Seat 3: ruyingren ($191.16 in chips) 
Seat 4: matiko09 ($149.39 in chips) 
Seat 5: vlad11122007 ($62.59 in chips) 
Seat 8: Optimistic21 ($50 in chips) 
Seat 9: Kud3 ($135.93 in chips) 
Kud3: posts small blind $0.25
Effort92: posts big blind $0.50
Effort92: posts the ante $0.10
ruyingren: posts the ante $0.10
matiko09: posts the ante $0.10
vlad11122007: posts the ante $0.10
Optimistic21: posts the ante $0.10
Kud3: posts the ante $0.10
*** HOLE CARDS ***
Dealt to matiko09 [Jc Jd]
ruyingren: folds 
matiko09: raises $1 to $1.50
vlad11122007: folds 
Optimistic21: folds 
Kud3: folds 
2lefthand75 joins the table at seat #7 
Effort92: folds 
Uncalled bet ($1) returned to matiko09
matiko09 collected $1.85 from pot
matiko09: doesn't show hand 
*** SUMMARY ***
Total pot $1.85 | Rake $0 
Seat 2: Effort92 (big blind) folded before Flop
Seat 3: ruyingren folded before Flop (didn't bet)
Seat 4: matiko09 collected ($1.85)
Seat 5: vlad11122007 folded before Flop (didn't bet)
Seat 8: Optimistic21 (button) folded before Flop (didn't bet)
Seat 9: Kud3 (small blind) folded before Flop





PokerStars Hand #148608572052:  Hold'em No Limit ($0.25/$0.50 USD) - 2016/02/11 13:01:19 CET [2016/02/11 7:01:19 ET]
Table 'Stereoskopia' 9-max Seat #6 is the button
Seat 1: JJJ-K9 ($49.25 in chips) 
Seat 2: Optimistic21 ($57.25 in chips) 
Seat 3: Szevasztopol ($54.39 in chips) 
Seat 5: ReinisRNS ($48.02 in chips) 
Seat 6: matiko09 ($50.75 in chips) 
Seat 8: vlad11122007 ($49.50 in chips) 
Seat 9: xxxibgdrgn ($50 in chips) 
vlad11122007: posts small blind $0.25
xxxibgdrgn: posts big blind $0.50
*** HOLE CARDS ***
Dealt to matiko09 [2d Td]
JJJ-K9: folds 
Optimistic21: folds 
Szevasztopol: folds 
ReinisRNS: folds 
matiko09: folds 
vlad11122007: folds 
Uncalled bet ($0.25) returned to xxxibgdrgn
xxxibgdrgn collected $0.50 from pot
xxxibgdrgn: doesn't show hand 
*** SUMMARY ***
Total pot $0.50 | Rake $0 
Seat 1: JJJ-K9 folded before Flop (didn't bet)
Seat 2: Optimistic21 folded before Flop (didn't bet)
Seat 3: Szevasztopol folded before Flop (didn't bet)
Seat 5: ReinisRNS folded before Flop (didn't bet)
Seat 6: matiko09 (button) folded before Flop (didn't bet)
Seat 8: vlad11122007 (small blind) folded before Flop
Seat 9: xxxibgdrgn (big blind) collected ($0.50)





PokerStars Hand #148608572983:  Hold'em No Limit (€0.25/€0.50 EUR) - 2016/02/11 13:01:21 CET [2016/02/11 7:01:21 ET]
Table 'Otero II' 9-max Seat #4 is the button
Seat 2: Dantist1122 (€50 in chips) 
Seat 3: Szevasztopol (€50 in chips) 
Seat 4: kram0909 (€5.08 in chips) 
Seat 5: vlad11122007 (€50.44 in chips) 
Seat 6: TonnaMunz (€51.35 in chips) 
Seat 8: matiko09 (€71.43 in chips) 
Seat 9: Optimistic21 (€71.88 in chips) 
vlad11122007: posts small blind €0.25
TonnaMunz: posts big blind €0.50
Dflingern95: sits out 
make6a: sits out 
*** HOLE CARDS ***
Dealt to matiko09 [9c Th]
matiko09: folds 
Optimistic21: folds 
Dantist1122: folds 
Szevasztopol: folds 
kram0909: raises €4.58 to €5.08 and is all-in
vlad11122007: folds 
TonnaMunz: folds 
Uncalled bet (€4.58) returned to kram0909
kram0909 collected €1.25 from pot
kram0909: doesn't show hand 
*** SUMMARY ***
Total pot €1.25 | Rake €0 
Seat 2: Dantist1122 folded before Flop (didn't bet)
Seat 3: Szevasztopol folded before Flop (didn't bet)
Seat 4: kram0909 (button) collected (€1.25)
Seat 5: vlad11122007 (small blind) folded before Flop
Seat 6: TonnaMunz (big blind) folded before Flop
Seat 8: matiko09 folded before Flop (didn't bet)
Seat 9: Optimistic21 folded before Flop (didn't bet)





PokerStars Hand #148608575878:  Hold'em No Limit ($0.25/$0.50 USD) - 2016/02/11 13:01:26 CET [2016/02/11 7:01:26 ET]
Table 'Ambrosia II' 9-max Seat #5 is the button
Seat 1: matiko09 ($50 in chips) 
Seat 2: TheMinion ($114.12 in chips) 
Seat 3: make6a ($53.39 in chips) 
Seat 4: huudk2016 ($53.37 in chips) 
Seat 5: RICKA16 ($49.50 in chips) 
Seat 6: Reven9er ($72.27 in chips) 
Seat 7: Ana.Satravca ($50 in chips) 
Seat 9: arctur17 ($54.68 in chips) 
Reven9er: posts small blind $0.25
Ana.Satravca: posts big blind $0.50
*** HOLE CARDS ***
Dealt to matiko09 [3d 7s]
arctur17: calls $0.50
matiko09: folds 
TheMinion: folds 
make6a: raises $1.50 to $2
huudk2016: folds 
RICKA16: folds 
Reven9er: folds 
Ana.Satravca: folds 
arctur17: calls $1.50
*** FLOP *** [5h Th Qs]
arctur17: bets $2.50
make6a: raises $4.25 to $6.75
arctur17: calls $4.25
*** TURN *** [5h Th Qs] [3c]
arctur17: bets $2.50
make6a: raises $14.50 to $17
huudk2016 is disconnected 
arctur17: folds 
Uncalled bet ($14.50) returned to make6a
make6a collected $22.20 from pot
make6a: doesn't show hand 
*** SUMMARY ***
Total pot $23.25 | Rake $1.05 
Board [5h Th Qs 3c]
Seat 1: matiko09 folded before Flop (didn't bet)
Seat 2: TheMinion folded before Flop (didn't bet)
Seat 3: make6a collected ($22.20)
Seat 4: huudk2016 folded before Flop (didn't bet)
Seat 5: RICKA16 (button) folded before Flop (didn't bet)
Seat 6: Reven9er (small blind) folded before Flop
Seat 7: Ana.Satravca (big blind) folded before Flop
Seat 9: arctur17 folded on the Turn





PokerStars Hand #148608577494:  Hold'em No Limit ($0.25/$0.50 USD) - 2016/02/11 13:01:29 CET [2016/02/11 7:01:29 ET]
Table 'Sylvania II' 9-max Seat #9 is the button
Seat 2: Effort92 ($63.84 in chips) 
Seat 4: matiko09 ($150.64 in chips) 
Seat 5: vlad11122007 ($62.49 in chips) 
Seat 7: 2lefthand75 ($67.92 in chips) 
Seat 8: Optimistic21 ($50 in chips) 
Seat 9: Kud3 ($135.58 in chips) 
Effort92: posts small blind $0.25
tw0315 joins the table at seat #1 
ruyingren has timed out while being disconnected
ruyingren: is sitting out 
matiko09: posts big blind $0.50
2lefthand75: posts big blind $0.50
Effort92: posts the ante $0.10
matiko09: posts the ante $0.10
vlad11122007: posts the ante $0.10
2lefthand75: posts the ante $0.10
Optimistic21: posts the ante $0.10
Kud3: posts the ante $0.10
*** HOLE CARDS ***
Dealt to matiko09 [Jh 6s]
vlad11122007: folds 
2lefthand75: checks 
Optimistic21: folds 
Kud3: raises $1.50 to $2
Effort92: folds 
matiko09: folds 
2lefthand75: calls $1.50
*** FLOP *** [6h 4c Qs]
2lefthand75: checks 
Kud3: bets $2.70
2lefthand75: folds 
Uncalled bet ($2.70) returned to Kud3
Kud3 collected $5.11 from pot
Kud3: doesn't show hand 
*** SUMMARY ***
Total pot $5.35 | Rake $0.24 
Board [6h 4c Qs]
Seat 2: Effort92 (small blind) folded before Flop
Seat 4: matiko09 (big blind) folded before Flop
Seat 5: vlad11122007 folded before Flop (didn't bet)
Seat 7: 2lefthand75 folded on the Flop
Seat 8: Optimistic21 folded before Flop (didn't bet)
Seat 9: Kud3 (button) collected ($5.11)





PokerStars Hand #148608583210:  Hold'em No Limit ($0.25/$0.50 USD) - 2016/02/11 13:01:40 CET [2016/02/11 7:01:40 ET]
Table 'Stereoskopia' 9-max Seat #8 is the button
Seat 1: JJJ-K9 ($49.25 in chips) 
Seat 2: Optimistic21 ($57.25 in chips) 
Seat 3: Szevasztopol ($54.39 in chips) 
Seat 5: ReinisRNS ($48.02 in chips) 
Seat 6: matiko09 ($50.75 in chips) 
Seat 8: vlad11122007 ($49.25 in chips) 
Seat 9: xxxibgdrgn ($50.25 in chips) 
xxxibgdrgn: posts small blind $0.25
JJJ-K9: posts big blind $0.50
*** HOLE CARDS ***
Dealt to matiko09 [4h 6s]
Optimistic21: raises $1 to $1.50
Szevasztopol: calls $1.50
ReinisRNS: folds 
matiko09: folds 
vlad11122007: folds 
xxxibgdrgn: folds 
JJJ-K9: folds 
*** FLOP *** [Ts Qs 3c]
Optimistic21: bets $2
Szevasztopol: calls $2
*** TURN *** [Ts Qs 3c] [7c]
Optimistic21: checks 
Szevasztopol: checks 
*** RIVER *** [Ts Qs 3c 7c] [Th]
Optimistic21: checks 
Szevasztopol: checks 
*** SHOW DOWN ***
Optimistic21: shows [Ad Kc] (a pair of Tens)
Szevasztopol: shows [Js Jc] (two pair, Jacks and Tens)
Szevasztopol collected $7.40 from pot
*** SUMMARY ***
Total pot $7.75 | Rake $0.35 
Board [Ts Qs 3c 7c Th]
Seat 1: JJJ-K9 (big blind) folded before Flop
Seat 2: Optimistic21 showed [Ad Kc] and lost with a pair of Tens
Seat 3: Szevasztopol showed [Js Jc] and won ($7.40) with two pair, Jacks and Tens
Seat 5: ReinisRNS folded before Flop (didn't bet)
Seat 6: matiko09 folded before Flop (didn't bet)
Seat 8: vlad11122007 (button) folded before Flop (didn't bet)
Seat 9: xxxibgdrgn (small blind) folded before Flop





PokerStars Hand #148608587439:  Hold'em No Limit ($0.25/$0.50 USD) - 2016/02/11 13:01:47 CET [2016/02/11 7:01:47 ET]
Table 'Biela' 9-max Seat #6 is the button
Seat 2: Serhent ($104.86 in chips) 
Seat 3: Larzdog29 ($49.75 in chips) 
Seat 4: Miss_S_Dior ($53.46 in chips) 
Seat 5: matiko09 ($50 in chips) 
Seat 6: Honk115 ($6.76 in chips) 
Seat 7: Kud3 ($50 in chips) 
Seat 8: vlad11122007 ($97.90 in chips) 
Kud3: posts small blind $0.25
vlad11122007: posts big blind $0.50
RICKA16: sits out 
*** HOLE CARDS ***
Dealt to matiko09 [7h 9c]
Serhent: folds 
Larzdog29: folds 
Miss_S_Dior: folds 
matiko09: folds 
Honk115: folds 
Kud3: raises $1 to $1.50
vlad11122007: raises $3 to $4.50
Kud3: calls $3
*** FLOP *** [Jd 8h 8d]
Kud3: checks 
vlad11122007: bets $5.50
Kud3: raises $10.38 to $15.88
vlad11122007: calls $10.38
*** TURN *** [Jd 8h 8d] [7s]
Kud3: bets $29.62 and is all-in
vlad11122007: calls $29.62
*** FIRST RIVER *** [Jd 8h 8d 7s] [9d]
*** SECOND RIVER *** [Jd 8h 8d 7s] [4d]
*** FIRST SHOW DOWN ***
Kud3: shows [Js 6s] (two pair, Jacks and Eights)
vlad11122007: shows [8c 4c] (three of a kind, Eights)
vlad11122007 collected $48.75 from pot
*** SECOND SHOW DOWN ***
Kud3: shows [Js 6s] (two pair, Jacks and Eights)
vlad11122007: shows [8c 4c] (a full house, Eights full of Fours)
vlad11122007 collected $48.75 from pot
*** SUMMARY ***
Total pot $100 | Rake $2.50 
Hand was run twice
FIRST Board [Jd 8h 8d 7s 9d]
SECOND Board [Jd 8h 8d 7s 4d]
Seat 2: Serhent folded before Flop (didn't bet)
Seat 3: Larzdog29 folded before Flop (didn't bet)
Seat 4: Miss_S_Dior folded before Flop (didn't bet)
Seat 5: matiko09 folded before Flop (didn't bet)
Seat 6: Honk115 (button) folded before Flop (didn't bet)
Seat 7: Kud3 (small blind) showed [Js 6s] and lost with two pair, Jacks and Eights, and lost with two pair, Jacks and Eights
Seat 8: vlad11122007 (big blind) showed [8c 4c] and won ($48.75) with three of a kind, Eights, and won ($48.75) with a full house, Eights full of Fours





PokerStars Hand #148608588184:  Hold'em No Limit ($0.50/$1.00 USD) - 2016/02/11 13:01:48 CET [2016/02/11 7:01:48 ET]
Table 'Rasalas' 9-max Seat #2 is the button
Seat 1: Tissue51 ($100 in chips) 
Seat 2: Zeeshka ($100 in chips) 
Seat 3: Luck In Me ($106.50 in chips) 
Seat 4: Sweden_Pound ($102 in chips) 
Seat 5: Saggitaurus ($103.64 in chips) 
Seat 6: DUkalisUA ($100 in chips) 
Seat 7: matiko09 ($101.50 in chips) 
Seat 8: gwwsb ($70.50 in chips) 
Seat 9: hurtNCYDE ($110.08 in chips) 
Luck In Me: posts small blind $0.50
Sweden_Pound: posts big blind $1
*** HOLE CARDS ***
Dealt to matiko09 [Ts 3d]
Saggitaurus: folds 
DUkalisUA: folds 
matiko09: folds 
gwwsb: folds 
hurtNCYDE: folds 
Tissue51: raises $2 to $3
Zeeshka: folds 
Luck In Me: folds 
Sweden_Pound: folds 
Uncalled bet ($2) returned to Tissue51
Tissue51 collected $2.50 from pot
*** SUMMARY ***
Total pot $2.50 | Rake $0 
Seat 1: Tissue51 collected ($2.50)
Seat 2: Zeeshka (button) folded before Flop (didn't bet)
Seat 3: Luck In Me (small blind) folded before Flop
Seat 4: Sweden_Pound (big blind) folded before Flop
Seat 5: Saggitaurus folded before Flop (didn't bet)
Seat 6: DUkalisUA folded before Flop (didn't bet)
Seat 7: matiko09 folded before Flop (didn't bet)
Seat 8: gwwsb folded before Flop (didn't bet)
Seat 9: hurtNCYDE folded before Flop (didn't bet)





PokerStars Hand #148608589281:  Hold'em No Limit ($0.50/$1.00 USD) - 2016/02/11 13:01:50 CET [2016/02/11 7:01:50 ET]
Table 'Aoluta' 9-max Seat #3 is the button
Seat 1: sebaaastian ($101 in chips) 
Seat 2: matiko09 ($104.02 in chips) 
Seat 3: Zeeshka ($100 in chips) 
Seat 4: oscarleon ($162.04 in chips) 
Seat 5: aseban11 ($100 in chips) 
Seat 6: Luck In Me ($100 in chips) 
Seat 7: grigy197 ($83.60 in chips) 
Seat 8: mrspecial1 ($61.50 in chips) 
Seat 9: Sweden_Pound ($115.64 in chips) 
oscarleon: posts small blind $0.50
aseban11: posts big blind $1
*** HOLE CARDS ***
Dealt to matiko09 [6h 9h]
Luck In Me: folds 
grigy197: folds 
mrspecial1: folds 
Sweden_Pound: folds 
sebaaastian: folds 
matiko09: folds 
Zeeshka: folds 
oscarleon: folds 
Uncalled bet ($0.50) returned to aseban11
aseban11 collected $1 from pot
aseban11: doesn't show hand 
*** SUMMARY ***
Total pot $1 | Rake $0 
Seat 1: sebaaastian folded before Flop (didn't bet)
Seat 2: matiko09 folded before Flop (didn't bet)
Seat 3: Zeeshka (button) folded before Flop (didn't bet)
Seat 4: oscarleon (small blind) folded before Flop
Seat 5: aseban11 (big blind) collected ($1)
Seat 6: Luck In Me folded before Flop (didn't bet)
Seat 7: grigy197 folded before Flop (didn't bet)
Seat 8: mrspecial1 folded before Flop (didn't bet)
Seat 9: Sweden_Pound folded before Flop (didn't bet)





PokerStars Hand #148608598822:  Hold'em No Limit ($0.25/$0.50 USD) - 2016/02/11 13:02:07 CET [2016/02/11 7:02:07 ET]
Table 'Algedi' 9-max Seat #1 is the button
Seat 1: vlad11122007 ($74.62 in chips) 
Seat 2: Reffypaul ($56.76 in chips) 
Seat 3: Saggitaurus ($123.74 in chips) 
Seat 4: Effort92 ($61.56 in chips) 
Seat 5: Optimistic21 ($56.23 in chips) 
Seat 6: TonnaMunz ($96.49 in chips) 
Seat 7: hoedtrob ($61.86 in chips) 
Seat 8: matiko09 ($50 in chips) 
Seat 9: Kud3 ($125 in chips) 
Reffypaul: posts small blind $0.25
Saggitaurus: posts big blind $0.50
vlad11122007: posts the ante $0.10
Reffypaul: posts the ante $0.10
Saggitaurus: posts the ante $0.10
Effort92: posts the ante $0.10
Optimistic21: posts the ante $0.10
TonnaMunz: posts the ante $0.10
hoedtrob: posts the ante $0.10
matiko09: posts the ante $0.10
Kud3: posts the ante $0.10
*** HOLE CARDS ***
Dealt to matiko09 [4s Jd]
Effort92: folds 
Optimistic21: folds 
TonnaMunz: folds 
hoedtrob: folds 
matiko09: folds 
Kud3: raises $1 to $1.50
vlad11122007: calls $1.50
Reffypaul: folds 
Saggitaurus: calls $1
*** FLOP *** [9h 9d 9c]
Saggitaurus: checks 
Kud3: checks 
vlad11122007: checks 
*** TURN *** [9h 9d 9c] [5d]
Saggitaurus: bets $2.70
Kud3: folds 
vlad11122007: folds 
Uncalled bet ($2.70) returned to Saggitaurus
Saggitaurus collected $5.40 from pot
Saggitaurus: doesn't show hand 
*** SUMMARY ***
Total pot $5.65 | Rake $0.25 
Board [9h 9d 9c 5d]
Seat 1: vlad11122007 (button) folded on the Turn
Seat 2: Reffypaul (small blind) folded before Flop
Seat 3: Saggitaurus (big blind) collected ($5.40)
Seat 4: Effort92 folded before Flop (didn't bet)
Seat 5: Optimistic21 folded before Flop (didn't bet)
Seat 6: TonnaMunz folded before Flop (didn't bet)
Seat 7: hoedtrob folded before Flop (didn't bet)
Seat 8: matiko09 folded before Flop (didn't bet)
Seat 9: Kud3 folded on the Turn





PokerStars Hand #148608602264:  Hold'em No Limit (€0.25/€0.50 EUR) - 2016/02/11 13:02:13 CET [2016/02/11 7:02:13 ET]
Table 'Otero II' 9-max Seat #5 is the button
Seat 2: Dantist1122 (€50 in chips) 
Seat 3: Szevasztopol (€50 in chips) 
Seat 4: kram0909 (€5.83 in chips) 
Seat 5: vlad11122007 (€50.19 in chips) 
Seat 6: TonnaMunz (€50.85 in chips) 
Seat 7: Dflingern95 (€50 in chips) 
Seat 8: matiko09 (€71.43 in chips) 
Seat 9: Optimistic21 (€71.88 in chips) 
TonnaMunz: posts small blind €0.25
Dflingern95: posts big blind €0.50
make6a: sits out 
*** HOLE CARDS ***
Dealt to matiko09 [2d 6d]
matiko09: folds 
Optimistic21: raises €1 to €1.50
Dantist1122: folds 
Szevasztopol: folds 
kram0909: folds 
vlad11122007: folds 
TonnaMunz: folds 
Dflingern95: folds 
Uncalled bet (€1) returned to Optimistic21
Optimistic21 collected €1.25 from pot
*** SUMMARY ***
Total pot €1.25 | Rake €0 
Seat 2: Dantist1122 folded before Flop (didn't bet)
Seat 3: Szevasztopol folded before Flop (didn't bet)
Seat 4: kram0909 folded before Flop (didn't bet)
Seat 5: vlad11122007 (button) folded before Flop (didn't bet)
Seat 6: TonnaMunz (small blind) folded before Flop
Seat 7: Dflingern95 (big blind) folded before Flop
Seat 8: matiko09 folded before Flop (didn't bet)
Seat 9: Optimistic21 collected (€1.25)





PokerStars Hand #148608610436:  Hold'em No Limit ($0.50/$1.00 USD) - 2016/02/11 13:02:28 CET [2016/02/11 7:02:28 ET]
Table 'Stephano V' 9-max Seat #9 is the button
Seat 1: hammerwife ($108.60 in chips) 
Seat 2: matiko09 ($100 in chips) 
Seat 3: sebaaastian ($100 in chips) 
Seat 4: Filojoes ($126.04 in chips) 
Seat 5: n2call ($175.40 in chips) 
Seat 6: Sweden_Pound ($102 in chips) 
Seat 7: hurtNCYDE ($123.04 in chips) 
Seat 8: oscarleon ($206.78 in chips) 
Seat 9: IcocaynaI ($30.92 in chips) 
hammerwife: posts small blind $0.50
matiko09: posts big blind $1
*** HOLE CARDS ***
Dealt to matiko09 [2d 8h]
sebaaastian: raises $2 to $3
Filojoes: calls $3
n2call: folds 
Sweden_Pound: folds 
hurtNCYDE: folds 
oscarleon: folds 
IcocaynaI: folds 
hammerwife: folds 
matiko09: folds 
*** FLOP *** [9h Kh 3h]
sebaaastian: checks 
Filojoes: bets $4.30
sebaaastian: folds 
Uncalled bet ($4.30) returned to Filojoes
Filojoes collected $7.16 from pot
Filojoes: doesn't show hand 
*** SUMMARY ***
Total pot $7.50 | Rake $0.34 
Board [9h Kh 3h]
Seat 1: hammerwife (small blind) folded before Flop
Seat 2: matiko09 (big blind) folded before Flop
Seat 3: sebaaastian folded on the Flop
Seat 4: Filojoes collected ($7.16)
Seat 5: n2call folded before Flop (didn't bet)
Seat 6: Sweden_Pound folded before Flop (didn't bet)
Seat 7: hurtNCYDE folded before Flop (didn't bet)
Seat 8: oscarleon folded before Flop (didn't bet)
Seat 9: IcocaynaI (button) folded before Flop (didn't bet)





PokerStars Hand #148608612573:  Hold'em No Limit ($0.25/$0.50 USD) - 2016/02/11 13:02:32 CET [2016/02/11 7:02:32 ET]
Table 'Sylvania II' 9-max Seat #2 is the button
Seat 1: tw0315 ($100 in chips) 
Seat 2: Effort92 ($63.49 in chips) 
Seat 4: matiko09 ($150.04 in chips) 
Seat 5: vlad11122007 ($62.39 in chips) 
Seat 7: 2lefthand75 ($65.82 in chips) 
Seat 8: Optimistic21 ($50 in chips) 
Seat 9: Kud3 ($138.59 in chips) 
ruyingren will be allowed to play after the button
matiko09: posts small blind $0.25
vlad11122007: posts big blind $0.50
TonnaMunz: sits out 
tw0315: posts big blind $0.50
tw0315: posts the ante $0.10
Effort92: posts the ante $0.10
matiko09: posts the ante $0.10
vlad11122007: posts the ante $0.10
2lefthand75: posts the ante $0.10
Optimistic21: posts the ante $0.10
Kud3: posts the ante $0.10
*** HOLE CARDS ***
Dealt to matiko09 [8s Td]
2lefthand75: folds 
Optimistic21: folds 
Kud3: folds 
tw0315: raises $0.50 to $1
Effort92: folds 
matiko09: folds 
vlad11122007: folds 
Uncalled bet ($0.50) returned to tw0315
ruyingren is disconnected 
tw0315 collected $1.95 from pot
*** SUMMARY ***
Total pot $1.95 | Rake $0 
Seat 1: tw0315 collected ($1.95)
Seat 2: Effort92 (button) folded before Flop (didn't bet)
Seat 4: matiko09 (small blind) folded before Flop
Seat 5: vlad11122007 (big blind) folded before Flop
Seat 7: 2lefthand75 folded before Flop (didn't bet)
Seat 8: Optimistic21 folded before Flop (didn't bet)
Seat 9: Kud3 folded before Flop (didn't bet)





PokerStars Hand #148608616306:  Hold'em No Limit ($0.50/$1.00 USD) - 2016/02/11 13:02:38 CET [2016/02/11 7:02:38 ET]
Table 'Rasalas' 9-max Seat #3 is the button
Seat 1: Tissue51 ($101.50 in chips) 
Seat 2: Zeeshka ($100 in chips) 
Seat 3: Luck In Me ($106 in chips) 
Seat 4: Sweden_Pound ($101 in chips) 
Seat 5: Saggitaurus ($103.64 in chips) 
Seat 6: DUkalisUA ($100 in chips) 
Seat 7: matiko09 ($101.50 in chips) 
Seat 8: gwwsb ($70.50 in chips) 
Seat 9: hurtNCYDE ($110.08 in chips) 
Sweden_Pound: posts small blind $0.50
Saggitaurus: posts big blind $1
*** HOLE CARDS ***
Dealt to matiko09 [2h Qh]
DUkalisUA: raises $2 to $3
matiko09: folds 
gwwsb: folds 
hurtNCYDE: folds 
Tissue51: calls $3
Zeeshka: folds 
Luck In Me: folds 
Sweden_Pound: folds 
Saggitaurus: folds 
*** FLOP *** [Td 3c Ks]
DUkalisUA: checks 
Tissue51: bets $3.58
DUkalisUA: folds 
Uncalled bet ($3.58) returned to Tissue51
Tissue51 collected $7.16 from pot
*** SUMMARY ***
Total pot $7.50 | Rake $0.34 
Board [Td 3c Ks]
Seat 1: Tissue51 collected ($7.16)
Seat 2: Zeeshka folded before Flop (didn't bet)
Seat 3: Luck In Me (button) folded before Flop (didn't bet)
Seat 4: Sweden_Pound (small blind) folded before Flop
Seat 5: Saggitaurus (big blind) folded before Flop
Seat 6: DUkalisUA folded on the Flop
Seat 7: matiko09 folded before Flop (didn't bet)
Seat 8: gwwsb folded before Flop (didn't bet)
Seat 9: hurtNCYDE folded before Flop (didn't bet)





PokerStars Hand #148608616414:  Hold'em No Limit ($0.50/$1.00 USD) - 2016/02/11 13:02:38 CET [2016/02/11 7:02:38 ET]
Table 'Aoluta' 9-max Seat #4 is the button
Seat 1: sebaaastian ($101 in chips) 
Seat 2: matiko09 ($104.02 in chips) 
Seat 3: Zeeshka ($100 in chips) 
Seat 4: oscarleon ($161.54 in chips) 
Seat 5: aseban11 ($100.50 in chips) 
Seat 6: Luck In Me ($100 in chips) 
Seat 7: grigy197 ($83.60 in chips) 
Seat 8: mrspecial1 ($61.50 in chips) 
Seat 9: Sweden_Pound ($115.64 in chips) 
aseban11: posts small blind $0.50
Luck In Me: posts big blind $1
*** HOLE CARDS ***
Dealt to matiko09 [Qc 8s]
grigy197: folds 
mrspecial1: folds 
Sweden_Pound: folds 
sebaaastian: folds 
matiko09: folds 
Zeeshka: raises $2 to $3
oscarleon: calls $3
aseban11: folds 
Luck In Me: folds 
*** FLOP *** [7s 3d 4s]
Zeeshka: bets $4.79
oscarleon: raises $11.21 to $16
Zeeshka: calls $11.21
*** TURN *** [7s 3d 4s] [5h]
Zeeshka: checks 
oscarleon: checks 
*** RIVER *** [7s 3d 4s 5h] [As]
Zeeshka: checks 
oscarleon: bets $28
Zeeshka: folds 
Uncalled bet ($28) returned to oscarleon
oscarleon collected $37.72 from pot
oscarleon: doesn't show hand 
*** SUMMARY ***
Total pot $39.50 | Rake $1.78 
Board [7s 3d 4s 5h As]
Seat 1: sebaaastian folded before Flop (didn't bet)
Seat 2: matiko09 folded before Flop (didn't bet)
Seat 3: Zeeshka folded on the River
Seat 4: oscarleon (button) collected ($37.72)
Seat 5: aseban11 (small blind) folded before Flop
Seat 6: Luck In Me (big blind) folded before Flop
Seat 7: grigy197 folded before Flop (didn't bet)
Seat 8: mrspecial1 folded before Flop (didn't bet)
Seat 9: Sweden_Pound folded before Flop (didn't bet)





PokerStars Hand #148608617442:  Hold'em No Limit (€0.25/€0.50 EUR) - 2016/02/11 13:02:40 CET [2016/02/11 7:02:40 ET]
Table 'Otero II' 9-max Seat #6 is the button
Seat 2: Dantist1122 (€50 in chips) 
Seat 3: Szevasztopol (€50 in chips) 
Seat 4: kram0909 (€5.83 in chips) 
Seat 5: vlad11122007 (€50.19 in chips) 
Seat 6: TonnaMunz (€50.60 in chips) 
Seat 7: Dflingern95 (€49.50 in chips) 
Seat 8: matiko09 (€71.43 in chips) 
Seat 9: Optimistic21 (€72.63 in chips) 
Dflingern95: posts small blind €0.25
matiko09: posts big blind €0.50
make6a: sits out 
*** HOLE CARDS ***
Dealt to matiko09 [4s As]
Optimistic21: folds 
Dantist1122: folds 
Szevasztopol: folds 
kram0909: calls €0.50
vlad11122007: folds 
TonnaMunz: folds 
Dflingern95: calls €0.25
matiko09: raises €2.50 to €3
kram0909: folds 
Dflingern95: folds 
Uncalled bet (€2.50) returned to matiko09
matiko09 collected €1.50 from pot
matiko09: doesn't show hand 
*** SUMMARY ***
Total pot €1.50 | Rake €0 
Seat 2: Dantist1122 folded before Flop (didn't bet)
Seat 3: Szevasztopol folded before Flop (didn't bet)
Seat 4: kram0909 folded before Flop
Seat 5: vlad11122007 folded before Flop (didn't bet)
Seat 6: TonnaMunz (button) folded before Flop (didn't bet)
Seat 7: Dflingern95 (small blind) folded before Flop
Seat 8: matiko09 (big blind) collected (€1.50)
Seat 9: Optimistic21 folded before Flop (didn't bet)





PokerStars Hand #148608627028:  Hold'em No Limit ($0.25/$0.50 USD) - 2016/02/11 13:02:57 CET [2016/02/11 7:02:57 ET]
Table 'Oenone' 9-max Seat #4 is the button
Seat 2: Reven9er ($50 in chips) 
Seat 3: Crazy_Giant1 ($42.09 in chips) 
Seat 4: Serhent ($50 in chips) 
Seat 5: ReinisRNS ($48.19 in chips) 
Seat 6: matiko09 ($50 in chips) 
Seat 7: banit7 ($52.50 in chips) 
Seat 8: vlad11122007 ($81.20 in chips) 
Seat 9: TheMinion ($140.88 in chips) 
ReinisRNS: posts small blind $0.25
matiko09: posts big blind $0.50
*** HOLE CARDS ***
Dealt to matiko09 [5c 8c]
banit7: raises $1 to $1.50
vlad11122007: folds 
TheMinion: folds 
Reven9er: folds 
Crazy_Giant1: folds 
Serhent: folds 
ReinisRNS: folds 
matiko09: folds 
Uncalled bet ($1) returned to banit7
banit7 collected $1.25 from pot
banit7: doesn't show hand 
*** SUMMARY ***
Total pot $1.25 | Rake $0 
Seat 2: Reven9er folded before Flop (didn't bet)
Seat 3: Crazy_Giant1 folded before Flop (didn't bet)
Seat 4: Serhent (button) folded before Flop (didn't bet)
Seat 5: ReinisRNS (small blind) folded before Flop
Seat 6: matiko09 (big blind) folded before Flop
Seat 7: banit7 collected ($1.25)
Seat 8: vlad11122007 folded before Flop (didn't bet)
Seat 9: TheMinion folded before Flop (didn't bet)





PokerStars Hand #148608630019:  Hold'em No Limit ($0.25/$0.50 USD) - 2016/02/11 13:03:02 CET [2016/02/11 7:03:02 ET]
Table 'Sylvania II' 9-max Seat #4 is the button
Seat 1: tw0315 ($101.35 in chips) 
Seat 2: Effort92 ($63.39 in chips) 
Seat 4: matiko09 ($149.69 in chips) 
Seat 5: vlad11122007 ($61.79 in chips) 
Seat 6: TonnaMunz ($132.26 in chips) 
Seat 7: 2lefthand75 ($65.72 in chips) 
Seat 8: Optimistic21 ($50 in chips) 
Seat 9: Kud3 ($138.49 in chips) 
vlad11122007: posts small blind $0.25
TonnaMunz: posts big blind $0.50
ruyingren: sits out 
tw0315: posts the ante $0.10
Effort92: posts the ante $0.10
matiko09: posts the ante $0.10
vlad11122007: posts the ante $0.10
TonnaMunz: posts the ante $0.10
2lefthand75: posts the ante $0.10
Optimistic21: posts the ante $0.10
Kud3: posts the ante $0.10
*** HOLE CARDS ***
Dealt to matiko09 [6h Ad]
2lefthand75: calls $0.50
Optimistic21: folds 
Kud3: folds 
tw0315: calls $0.50
Effort92: folds 
matiko09: folds 
vlad11122007: raises $2 to $2.50
TonnaMunz: folds 
2lefthand75: folds 
tw0315: calls $2
*** FLOP *** [9d 8h 7s]
vlad11122007: checks 
tw0315: bets $3.24
vlad11122007: folds 
Uncalled bet ($3.24) returned to tw0315
tw0315 collected $6.49 from pot
*** SUMMARY ***
Total pot $6.80 | Rake $0.31 
Board [9d 8h 7s]
Seat 1: tw0315 collected ($6.49)
Seat 2: Effort92 folded before Flop (didn't bet)
Seat 4: matiko09 (button) folded before Flop (didn't bet)
Seat 5: vlad11122007 (small blind) folded on the Flop
Seat 6: TonnaMunz (big blind) folded before Flop
Seat 7: 2lefthand75 folded before Flop
Seat 8: Optimistic21 folded before Flop (didn't bet)
Seat 9: Kud3 folded before Flop (didn't bet)





PokerStars Hand #148608638486:  Hold'em No Limit ($0.25/$0.50 USD) - 2016/02/11 13:03:17 CET [2016/02/11 7:03:17 ET]
Table 'Stereoskopia' 9-max Seat #9 is the button
Seat 1: JJJ-K9 ($48.75 in chips) 
Seat 2: Optimistic21 ($53.75 in chips) 
Seat 3: Szevasztopol ($58.29 in chips) 
Seat 5: ReinisRNS ($48.02 in chips) 
Seat 6: matiko09 ($50.75 in chips) 
Seat 8: vlad11122007 ($49.25 in chips) 
Seat 9: xxxibgdrgn ($50 in chips) 
JJJ-K9: posts small blind $0.25
Optimistic21: posts big blind $0.50
*** HOLE CARDS ***
Dealt to matiko09 [9h 3h]
Szevasztopol: folds 
ReinisRNS: folds 
matiko09: folds 
vlad11122007: raises $1 to $1.50
xxxibgdrgn: calls $1.50
JJJ-K9: raises $4.50 to $6
Optimistic21: folds 
vlad11122007: folds 
xxxibgdrgn: folds 
Uncalled bet ($4.50) returned to JJJ-K9
JJJ-K9 collected $5 from pot
JJJ-K9: doesn't show hand 
*** SUMMARY ***
Total pot $5 | Rake $0 
Seat 1: JJJ-K9 (small blind) collected ($5)
Seat 2: Optimistic21 (big blind) folded before Flop
Seat 3: Szevasztopol folded before Flop (didn't bet)
Seat 5: ReinisRNS folded before Flop (didn't bet)
Seat 6: matiko09 folded before Flop (didn't bet)
Seat 8: vlad11122007 folded before Flop
Seat 9: xxxibgdrgn (button) folded before Flop





PokerStars Hand #148608641377:  Hold'em No Limit ($0.25/$0.50 USD) - 2016/02/11 13:03:22 CET [2016/02/11 7:03:22 ET]
Table 'Biela' 9-max Seat #7 is the button
Seat 1: RICKA16 ($50 in chips) 
Seat 2: Serhent ($104.86 in chips) 
Seat 3: Larzdog29 ($49.75 in chips) 
Seat 4: Miss_S_Dior ($53.46 in chips) 
Seat 5: matiko09 ($50 in chips) 
Seat 6: Honk115 ($46.48 in chips) 
Seat 7: Kud3 ($50 in chips) 
Seat 8: vlad11122007 ($145.40 in chips) 
vlad11122007: posts small blind $0.25
RICKA16: posts big blind $0.50
*** HOLE CARDS ***
Dealt to matiko09 [Ac 4s]
Kud3 said, "lol"
Serhent: folds 
Larzdog29: folds 
Kud3 said, "patehtic cant run so hot all day"
Miss_S_Dior: folds 
matiko09: folds 
Kud3 said, "just insane"
Honk115: folds 
Kud3: raises $0.75 to $1.25
vlad11122007: folds 
RICKA16: folds 
Uncalled bet ($0.75) returned to Kud3
Kud3 collected $1.25 from pot
Kud3: doesn't show hand 
*** SUMMARY ***
Total pot $1.25 | Rake $0 
Seat 1: RICKA16 (big blind) folded before Flop
Seat 2: Serhent folded before Flop (didn't bet)
Seat 3: Larzdog29 folded before Flop (didn't bet)
Seat 4: Miss_S_Dior folded before Flop (didn't bet)
Seat 5: matiko09 folded before Flop (didn't bet)
Seat 6: Honk115 folded before Flop (didn't bet)
Seat 7: Kud3 (button) collected ($1.25)
Seat 8: vlad11122007 (small blind) folded before Flop





PokerStars Hand #148608643957:  Hold'em No Limit ($0.25/$0.50 USD) - 2016/02/11 13:03:27 CET [2016/02/11 7:03:27 ET]
Table 'Ambrosia II' 9-max Seat #6 is the button
Seat 1: matiko09 ($50 in chips) 
Seat 2: TheMinion ($114.12 in chips) 
Seat 3: make6a ($64.34 in chips) 
Seat 4: huudk2016 ($53.37 in chips) 
Seat 5: RICKA16 ($49.50 in chips) 
Seat 6: Reven9er ($72.02 in chips) 
Seat 7: Ana.Satravca ($50 in chips) 
Seat 9: arctur17 ($43.43 in chips) 
Ana.Satravca: posts small blind $0.25
arctur17: posts big blind $0.50
*** HOLE CARDS ***
Dealt to matiko09 [9h Qd]
matiko09: folds 
TheMinion: raises $1 to $1.50
make6a: folds 
huudk2016: folds 
RICKA16: folds 
Reven9er: folds 
Ana.Satravca: folds 
arctur17: calls $1
*** FLOP *** [3h 9d Tc]
arctur17: bets $2.50
TheMinion: calls $2.50
*** TURN *** [3h 9d Tc] [4d]
arctur17: bets $4.50
TheMinion: raises $10.13 to $14.63
arctur17: calls $10.13
*** RIVER *** [3h 9d Tc 4d] [Js]
arctur17: checks 
TheMinion: bets $36.50
arctur17: folds 
Uncalled bet ($36.50) returned to TheMinion
TheMinion collected $35.82 from pot
TheMinion: doesn't show hand 
*** SUMMARY ***
Total pot $37.51 | Rake $1.69 
Board [3h 9d Tc 4d Js]
Seat 1: matiko09 folded before Flop (didn't bet)
Seat 2: TheMinion collected ($35.82)
Seat 3: make6a folded before Flop (didn't bet)
Seat 4: huudk2016 folded before Flop (didn't bet)
Seat 5: RICKA16 folded before Flop (didn't bet)
Seat 6: Reven9er (button) folded before Flop (didn't bet)
Seat 7: Ana.Satravca (small blind) folded before Flop
Seat 9: arctur17 (big blind) folded on the River





PokerStars Hand #148608654109:  Hold'em No Limit ($0.25/$0.50 USD) - 2016/02/11 13:03:44 CET [2016/02/11 7:03:44 ET]
Table 'Algedi' 9-max Seat #2 is the button
Seat 1: vlad11122007 ($73.02 in chips) 
Seat 2: Reffypaul ($56.41 in chips) 
Seat 3: Saggitaurus ($127.54 in chips) 
Seat 4: Effort92 ($61.46 in chips) 
Seat 5: Optimistic21 ($56.13 in chips) 
Seat 6: TonnaMunz ($96.39 in chips) 
Seat 7: hoedtrob ($61.76 in chips) 
Seat 8: matiko09 ($50 in chips) 
Seat 9: Kud3 ($125 in chips) 
Saggitaurus: posts small blind $0.25
Effort92: posts big blind $0.50
vlad11122007: posts the ante $0.10
Reffypaul: posts the ante $0.10
Saggitaurus: posts the ante $0.10
Effort92: posts the ante $0.10
Optimistic21: posts the ante $0.10
TonnaMunz: posts the ante $0.10
hoedtrob: posts the ante $0.10
matiko09: posts the ante $0.10
Kud3: posts the ante $0.10
*** HOLE CARDS ***
Dealt to matiko09 [Ts 9c]
Optimistic21: folds 
TonnaMunz: folds 
hoedtrob: folds 
matiko09: folds 
Kud3: folds 
vlad11122007: folds 
Reffypaul: folds 
Saggitaurus: folds 
Uncalled bet ($0.25) returned to Effort92
Effort92 collected $1.40 from pot
Effort92: doesn't show hand 
*** SUMMARY ***
Total pot $1.40 | Rake $0 
Seat 1: vlad11122007 folded before Flop (didn't bet)
Seat 2: Reffypaul (button) folded before Flop (didn't bet)
Seat 3: Saggitaurus (small blind) folded before Flop
Seat 4: Effort92 (big blind) collected ($1.40)
Seat 5: Optimistic21 folded before Flop (didn't bet)
Seat 6: TonnaMunz folded before Flop (didn't bet)
Seat 7: hoedtrob folded before Flop (didn't bet)
Seat 8: matiko09 folded before Flop (didn't bet)
Seat 9: Kud3 folded before Flop (didn't bet)





PokerStars Hand #148608654953:  Hold'em No Limit ($0.50/$1.00 USD) - 2016/02/11 13:03:46 CET [2016/02/11 7:03:46 ET]
Table 'Stephano V' 9-max Seat #1 is the button
Seat 1: hammerwife ($108.10 in chips) 
Seat 2: matiko09 ($100 in chips) 
Seat 3: sebaaastian ($100 in chips) 
Seat 4: Filojoes ($130.20 in chips) 
Seat 5: n2call ($175.40 in chips) 
Seat 6: Sweden_Pound ($102 in chips) 
Seat 7: hurtNCYDE ($123.04 in chips) 
Seat 8: oscarleon ($206.78 in chips) 
Seat 9: IcocaynaI ($30.92 in chips) 
matiko09: posts small blind $0.50
sebaaastian: posts big blind $1
*** HOLE CARDS ***
Dealt to matiko09 [Tc 5s]
Filojoes: folds 
Filojoes leaves the table
Zeeshka joins the table at seat #4 
n2call: folds 
Sweden_Pound: folds 
hurtNCYDE: folds 
oscarleon: raises $2 to $3
IcocaynaI: folds 
hammerwife: raises $5 to $8
matiko09: folds 
sebaaastian: folds 
oscarleon: calls $5
*** FLOP *** [3s 3h 3c]
oscarleon: checks 
hammerwife: bets $8.50
oscarleon: calls $8.50
*** TURN *** [3s 3h 3c] [Ad]
oscarleon: checks 
hammerwife: checks 
*** RIVER *** [3s 3h 3c Ad] [7s]
oscarleon: bets $24
hammerwife: folds 
Uncalled bet ($24) returned to oscarleon
oscarleon collected $32.95 from pot
oscarleon: doesn't show hand 
*** SUMMARY ***
Total pot $34.50 | Rake $1.55 
Board [3s 3h 3c Ad 7s]
Seat 1: hammerwife (button) folded on the River
Seat 2: matiko09 (small blind) folded before Flop
Seat 3: sebaaastian (big blind) folded before Flop
Seat 4: Filojoes folded before Flop (didn't bet)
Seat 5: n2call folded before Flop (didn't bet)
Seat 6: Sweden_Pound folded before Flop (didn't bet)
Seat 7: hurtNCYDE folded before Flop (didn't bet)
Seat 8: oscarleon collected ($32.95)
Seat 9: IcocaynaI folded before Flop (didn't bet)





PokerStars Hand #148608655344:  Hold'em No Limit ($0.25/$0.50 USD) - 2016/02/11 13:03:46 CET [2016/02/11 7:03:46 ET]
Table 'Biela' 9-max Seat #8 is the button
Seat 1: RICKA16 ($49.50 in chips) 
Seat 3: Larzdog29 ($49.75 in chips) 
Seat 4: Miss_S_Dior ($53.46 in chips) 
Seat 5: matiko09 ($50 in chips) 
Seat 6: Honk115 ($46.48 in chips) 
Seat 7: Kud3 ($50.75 in chips) 
Seat 8: vlad11122007 ($145.15 in chips) 
tallonn88 will be allowed to play after the button
RICKA16: posts small blind $0.25
Serhent: is sitting out 
Larzdog29: posts big blind $0.50
*** HOLE CARDS ***
Dealt to matiko09 [Qs Jh]
Serhent leaves the table
Miss_S_Dior has timed out
Miss_S_Dior: folds 
matiko09: folds 
Honk115: folds 
Kud3: folds 
vlad11122007: raises $0.50 to $1
RICKA16: folds 
Larzdog29: calls $0.50
*** FLOP *** [8d Qd 3d]
Optimistic21 joins the table at seat #2 
Larzdog29: checks 
vlad11122007: checks 
*** TURN *** [8d Qd 3d] [Ks]
Larzdog29: bets $1.50
vlad11122007: folds 
Uncalled bet ($1.50) returned to Larzdog29
Larzdog29 collected $2.15 from pot
Larzdog29: doesn't show hand 
*** SUMMARY ***
Total pot $2.25 | Rake $0.10 
Board [8d Qd 3d Ks]
Seat 1: RICKA16 (small blind) folded before Flop
Seat 3: Larzdog29 (big blind) collected ($2.15)
Seat 4: Miss_S_Dior folded before Flop (didn't bet)
Seat 5: matiko09 folded before Flop (didn't bet)
Seat 6: Honk115 folded before Flop (didn't bet)
Seat 7: Kud3 folded before Flop (didn't bet)
Seat 8: vlad11122007 (button) folded on the Turn





PokerStars Hand #148608659605:  Hold'em No Limit (€0.25/€0.50 EUR) - 2016/02/11 13:03:54 CET [2016/02/11 7:03:54 ET]
Table 'Otero II' 9-max Seat #7 is the button
Seat 2: Dantist1122 (€50 in chips) 
Seat 3: Szevasztopol (€50 in chips) 
Seat 4: kram0909 (€5.33 in chips) 
Seat 5: vlad11122007 (€50.19 in chips) 
Seat 6: TonnaMunz (€50.60 in chips) 
Seat 7: Dflingern95 (€49 in chips) 
Seat 8: matiko09 (€72.43 in chips) 
Seat 9: Optimistic21 (€72.63 in chips) 
matiko09: posts small blind €0.25
Optimistic21: posts big blind €0.50
*** HOLE CARDS ***
Dealt to matiko09 [2d 2h]
Dantist1122: folds 
Szevasztopol: raises €1 to €1.50
kram0909: folds 
vlad11122007: folds 
TonnaMunz: folds 
Dflingern95: folds 
matiko09: folds 
Optimistic21: folds 
Uncalled bet (€1) returned to Szevasztopol
Szevasztopol collected €1.25 from pot
Szevasztopol: doesn't show hand 
*** SUMMARY ***
Total pot €1.25 | Rake €0 
Seat 2: Dantist1122 folded before Flop (didn't bet)
Seat 3: Szevasztopol collected (€1.25)
Seat 4: kram0909 folded before Flop (didn't bet)
Seat 5: vlad11122007 folded before Flop (didn't bet)
Seat 6: TonnaMunz folded before Flop (didn't bet)
Seat 7: Dflingern95 (button) folded before Flop (didn't bet)
Seat 8: matiko09 (small blind) folded before Flop
Seat 9: Optimistic21 (big blind) folded before Flop





PokerStars Hand #148608659540:  Hold'em No Limit ($0.25/$0.50 USD) - 2016/02/11 13:03:54 CET [2016/02/11 7:03:54 ET]
Table 'Oenone' 9-max Seat #5 is the button
Seat 2: Reven9er ($50 in chips) 
Seat 3: Crazy_Giant1 ($42.09 in chips) 
Seat 4: Serhent ($50 in chips) 
Seat 5: ReinisRNS ($47.94 in chips) 
Seat 6: matiko09 ($50 in chips) 
Seat 7: banit7 ($53.25 in chips) 
Seat 8: vlad11122007 ($81.20 in chips) 
Seat 9: TheMinion ($140.88 in chips) 
matiko09: posts small blind $0.25
banit7: posts big blind $0.50
tallonn88: sits out 
*** HOLE CARDS ***
Dealt to matiko09 [Qs 9s]
vlad11122007: folds 
TheMinion: folds 
Reven9er: folds 
Crazy_Giant1 has timed out
Crazy_Giant1: folds 
Serhent: calls $0.50
ReinisRNS: folds 
matiko09: raises $2 to $2.50
banit7: folds 
Serhent: folds 
Uncalled bet ($2) returned to matiko09
matiko09 collected $1.50 from pot
matiko09: doesn't show hand 
*** SUMMARY ***
Total pot $1.50 | Rake $0 
Seat 2: Reven9er folded before Flop (didn't bet)
Seat 3: Crazy_Giant1 folded before Flop (didn't bet)
Seat 4: Serhent folded before Flop
Seat 5: ReinisRNS (button) folded before Flop (didn't bet)
Seat 6: matiko09 (small blind) collected ($1.50)
Seat 7: banit7 (big blind) folded before Flop
Seat 8: vlad11122007 folded before Flop (didn't bet)
Seat 9: TheMinion folded before Flop (didn't bet)





PokerStars Hand #148608664451:  Hold'em No Limit ($0.25/$0.50 USD) - 2016/02/11 13:04:02 CET [2016/02/11 7:04:02 ET]
Table 'Stereoskopia' 9-max Seat #1 is the button
Seat 1: JJJ-K9 ($52.25 in chips) 
Seat 2: Optimistic21 ($53.25 in chips) 
Seat 3: Szevasztopol ($58.29 in chips) 
Seat 5: ReinisRNS ($48.02 in chips) 
Seat 6: matiko09 ($50.75 in chips) 
Seat 8: vlad11122007 ($47.75 in chips) 
Seat 9: xxxibgdrgn ($50 in chips) 
Optimistic21: posts small blind $0.25
Szevasztopol: posts big blind $0.50
tallonn88: sits out 
*** HOLE CARDS ***
Dealt to matiko09 [2c Td]
ReinisRNS: folds 
matiko09: folds 
vlad11122007: folds 
xxxibgdrgn: folds 
JJJ-K9: folds 
Optimistic21: folds 
Uncalled bet ($0.25) returned to Szevasztopol
Szevasztopol collected $0.50 from pot
Szevasztopol: doesn't show hand 
*** SUMMARY ***
Total pot $0.50 | Rake $0 
Seat 1: JJJ-K9 (button) folded before Flop (didn't bet)
Seat 2: Optimistic21 (small blind) folded before Flop
Seat 3: Szevasztopol (big blind) collected ($0.50)
Seat 5: ReinisRNS folded before Flop (didn't bet)
Seat 6: matiko09 folded before Flop (didn't bet)
Seat 8: vlad11122007 folded before Flop (didn't bet)
Seat 9: xxxibgdrgn folded before Flop (didn't bet)





PokerStars Hand #148608664959:  Hold'em No Limit ($0.50/$1.00 USD) - 2016/02/11 13:04:03 CET [2016/02/11 7:04:03 ET]
Table 'Gianfar' 9-max Seat #2 is the button
Seat 1: sebaaastian ($231.31 in chips) 
Seat 2: bilukm ($96.50 in chips) 
Seat 3: AlKatrone ($100.14 in chips) 
Seat 4: matiko09 ($100 in chips) 
Seat 5: hammerwife ($158.93 in chips) 
Seat 6: Sweden_Pound ($107.52 in chips) 
Seat 7: Rikti ($41.50 in chips) 
Seat 9: oscarleon ($148.16 in chips) 
AlKatrone: posts small blind $0.50
matiko09: posts big blind $1
Zeeshka: sits out 
*** HOLE CARDS ***
Dealt to matiko09 [Ts Jd]
hammerwife: folds 
Sweden_Pound: folds 
Rikti: raises $1 to $2
oscarleon: folds 
sebaaastian: folds 
bilukm: raises $5.50 to $7.50
AlKatrone: folds 
matiko09: folds 
Rikti: folds 
Uncalled bet ($5.50) returned to bilukm
bilukm collected $5.50 from pot
bilukm: doesn't show hand 
*** SUMMARY ***
Total pot $5.50 | Rake $0 
Seat 1: sebaaastian folded before Flop (didn't bet)
Seat 2: bilukm (button) collected ($5.50)
Seat 3: AlKatrone (small blind) folded before Flop
Seat 4: matiko09 (big blind) folded before Flop
Seat 5: hammerwife folded before Flop (didn't bet)
Seat 6: Sweden_Pound folded before Flop (didn't bet)
Seat 7: Rikti folded before Flop
Seat 9: oscarleon folded before Flop (didn't bet)





PokerStars Hand #148608680135:  Hold'em No Limit ($0.25/$0.50 USD) - 2016/02/11 13:04:29 CET [2016/02/11 7:04:29 ET]
Table 'Stereoskopia' 9-max Seat #2 is the button
Seat 1: JJJ-K9 ($52.25 in chips) 
Seat 2: Optimistic21 ($53 in chips) 
Seat 3: Szevasztopol ($58.54 in chips) 
Seat 5: ReinisRNS ($48.02 in chips) 
Seat 6: matiko09 ($50.75 in chips) 
Seat 8: vlad11122007 ($47.75 in chips) 
Seat 9: xxxibgdrgn ($50 in chips) 
Szevasztopol: posts small blind $0.25
ReinisRNS: posts big blind $0.50
tallonn88: sits out 
*** HOLE CARDS ***
Dealt to matiko09 [Kh 2c]
matiko09: folds 
vlad11122007: raises $1 to $1.50
xxxibgdrgn: folds 
JJJ-K9: folds 
Optimistic21: folds 
Szevasztopol: folds 
ReinisRNS: folds 
Uncalled bet ($1) returned to vlad11122007
vlad11122007 collected $1.25 from pot
vlad11122007: doesn't show hand 
*** SUMMARY ***
Total pot $1.25 | Rake $0 
Seat 1: JJJ-K9 folded before Flop (didn't bet)
Seat 2: Optimistic21 (button) folded before Flop (didn't bet)
Seat 3: Szevasztopol (small blind) folded before Flop
Seat 5: ReinisRNS (big blind) folded before Flop
Seat 6: matiko09 folded before Flop (didn't bet)
Seat 8: vlad11122007 collected ($1.25)
Seat 9: xxxibgdrgn folded before Flop (didn't bet)





PokerStars Hand #148608684487:  Hold'em No Limit ($0.50/$1.00 USD) - 2016/02/11 13:04:37 CET [2016/02/11 7:04:37 ET]
Table 'Aoluta' 9-max Seat #5 is the button
Seat 1: sebaaastian ($101 in chips) 
Seat 2: matiko09 ($104.02 in chips) 
Seat 3: Zeeshka ($100 in chips) 
Seat 4: oscarleon ($180.26 in chips) 
Seat 5: aseban11 ($100 in chips) 
Seat 6: Luck In Me ($100 in chips) 
Seat 7: grigy197 ($83.60 in chips) 
Seat 8: mrspecial1 ($61.50 in chips) 
Seat 9: Sweden_Pound ($115.64 in chips) 
Luck In Me: posts small blind $0.50
grigy197: posts big blind $1
*** HOLE CARDS ***
Dealt to matiko09 [9c 9s]
mrspecial1: folds 
Sweden_Pound: folds 
sebaaastian: folds 
matiko09: raises $2 to $3
Zeeshka: folds 
oscarleon: folds 
aseban11: calls $3
Luck In Me: raises $10 to $13
grigy197: folds 
matiko09: folds 
aseban11: folds 
Uncalled bet ($10) returned to Luck In Me
Luck In Me collected $10 from pot
Luck In Me: doesn't show hand 
*** SUMMARY ***
Total pot $10 | Rake $0 
Seat 1: sebaaastian folded before Flop (didn't bet)
Seat 2: matiko09 folded before Flop
Seat 3: Zeeshka folded before Flop (didn't bet)
Seat 4: oscarleon folded before Flop (didn't bet)
Seat 5: aseban11 (button) folded before Flop
Seat 6: Luck In Me (small blind) collected ($10)
Seat 7: grigy197 (big blind) folded before Flop
Seat 8: mrspecial1 folded before Flop (didn't bet)
Seat 9: Sweden_Pound folded before Flop (didn't bet)





PokerStars Hand #148608685635:  Hold'em No Limit ($0.25/$0.50 USD) - 2016/02/11 13:04:39 CET [2016/02/11 7:04:39 ET]
Table 'Sylvania II' 9-max Seat #5 is the button
Seat 1: tw0315 ($105.24 in chips) 
Seat 2: Effort92 ($63.29 in chips) 
Seat 3: ruyingren ($191.06 in chips) 
Seat 4: matiko09 ($149.59 in chips) 
Seat 5: vlad11122007 ($59.19 in chips) 
Seat 6: TonnaMunz ($131.66 in chips) 
Seat 7: 2lefthand75 ($65.12 in chips) 
Seat 8: Optimistic21 ($50 in chips) 
Seat 9: Kud3 ($138.39 in chips) 
TonnaMunz: posts small blind $0.25
2lefthand75: posts big blind $0.50
ruyingren: posts small & big blinds $0.75
tw0315: posts the ante $0.10
Effort92: posts the ante $0.10
ruyingren: posts the ante $0.10
matiko09: posts the ante $0.10
vlad11122007: posts the ante $0.10
TonnaMunz: posts the ante $0.10
2lefthand75: posts the ante $0.10
Optimistic21: posts the ante $0.10
Kud3: posts the ante $0.10
*** HOLE CARDS ***
Dealt to matiko09 [Qs 8c]
Optimistic21: folds 
Kud3: raises $1.50 to $2
tw0315: folds 
Effort92: folds 
ruyingren: calls $1.50
matiko09: folds 
vlad11122007: folds 
TonnaMunz: folds 
2lefthand75: calls $1.50
*** FLOP *** [4d 3h Qd]
2lefthand75: checks 
Kud3: checks 
ruyingren: bets $4
2lefthand75: folds 
Kud3: folds 
Uncalled bet ($4) returned to ruyingren
ruyingren collected $7.07 from pot
ruyingren: doesn't show hand 
*** SUMMARY ***
Total pot $7.40 | Rake $0.33 
Board [4d 3h Qd]
Seat 1: tw0315 folded before Flop (didn't bet)
Seat 2: Effort92 folded before Flop (didn't bet)
Seat 3: ruyingren collected ($7.07)
Seat 4: matiko09 folded before Flop (didn't bet)
Seat 5: vlad11122007 (button) folded before Flop (didn't bet)
Seat 6: TonnaMunz (small blind) folded before Flop
Seat 7: 2lefthand75 (big blind) folded on the Flop
Seat 8: Optimistic21 folded before Flop (didn't bet)
Seat 9: Kud3 folded on the Flop





PokerStars Hand #148608690883:  Hold'em No Limit ($0.25/$0.50 USD) - 2016/02/11 13:04:48 CET [2016/02/11 7:04:48 ET]
Table 'Algedi' 9-max Seat #3 is the button
Seat 1: vlad11122007 ($72.92 in chips) 
Seat 2: Reffypaul ($56.31 in chips) 
Seat 3: Saggitaurus ($127.19 in chips) 
Seat 4: Effort92 ($62.51 in chips) 
Seat 5: Optimistic21 ($56.03 in chips) 
Seat 6: TonnaMunz ($96.29 in chips) 
Seat 7: hoedtrob ($61.66 in chips) 
Seat 8: matiko09 ($50 in chips) 
Seat 9: Kud3 ($125 in chips) 
Effort92: posts small blind $0.25
Optimistic21: posts big blind $0.50
vlad11122007: posts the ante $0.10
Reffypaul: posts the ante $0.10
Saggitaurus: posts the ante $0.10
Effort92: posts the ante $0.10
Optimistic21: posts the ante $0.10
TonnaMunz: posts the ante $0.10
hoedtrob: posts the ante $0.10
matiko09: posts the ante $0.10
Kud3: posts the ante $0.10
*** HOLE CARDS ***
Dealt to matiko09 [2d 7s]
TonnaMunz: folds 
hoedtrob: folds 
matiko09: folds 
Kud3: folds 
vlad11122007: raises $1 to $1.50
Reffypaul: folds 
Saggitaurus: folds 
Effort92: folds 
Optimistic21: folds 
Uncalled bet ($1) returned to vlad11122007
vlad11122007 collected $2.15 from pot
vlad11122007: doesn't show hand 
*** SUMMARY ***
Total pot $2.15 | Rake $0 
Seat 1: vlad11122007 collected ($2.15)
Seat 2: Reffypaul folded before Flop (didn't bet)
Seat 3: Saggitaurus (button) folded before Flop (didn't bet)
Seat 4: Effort92 (small blind) folded before Flop
Seat 5: Optimistic21 (big blind) folded before Flop
Seat 6: TonnaMunz folded before Flop (didn't bet)
Seat 7: hoedtrob folded before Flop (didn't bet)
Seat 8: matiko09 folded before Flop (didn't bet)
Seat 9: Kud3 folded before Flop (didn't bet)





PokerStars Hand #148608693832:  Hold'em No Limit (€0.25/€0.50 EUR) - 2016/02/11 13:04:53 CET [2016/02/11 7:04:53 ET]
Table 'Otero II' 9-max Seat #8 is the button
Seat 2: Dantist1122 (€50 in chips) 
Seat 3: Szevasztopol (€50.75 in chips) 
Seat 4: kram0909 (€5.33 in chips) 
Seat 5: vlad11122007 (€50.19 in chips) 
Seat 6: TonnaMunz (€50.60 in chips) 
Seat 7: Dflingern95 (€49 in chips) 
Seat 8: matiko09 (€72.18 in chips) 
Seat 9: Optimistic21 (€72.13 in chips) 
Optimistic21: posts small blind €0.25
Dantist1122: posts big blind €0.50
*** HOLE CARDS ***
Dealt to matiko09 [5c Jh]
Szevasztopol: folds 
kram0909: folds 
vlad11122007: folds 
TonnaMunz: folds 
Dflingern95: folds 
matiko09: folds 
Optimistic21: raises €1 to €1.50
Dantist1122: folds 
Uncalled bet (€1) returned to Optimistic21
Optimistic21 collected €1 from pot
*** SUMMARY ***
Total pot €1 | Rake €0 
Seat 2: Dantist1122 (big blind) folded before Flop
Seat 3: Szevasztopol folded before Flop (didn't bet)
Seat 4: kram0909 folded before Flop (didn't bet)
Seat 5: vlad11122007 folded before Flop (didn't bet)
Seat 6: TonnaMunz folded before Flop (didn't bet)
Seat 7: Dflingern95 folded before Flop (didn't bet)
Seat 8: matiko09 (button) folded before Flop (didn't bet)
Seat 9: Optimistic21 (small blind) collected (€1)





PokerStars Hand #148608694225:  Hold'em No Limit ($0.25/$0.50 USD) - 2016/02/11 13:04:54 CET [2016/02/11 7:04:54 ET]
Table 'Oenone' 9-max Seat #6 is the button
Seat 2: Reven9er ($50 in chips) 
Seat 3: Crazy_Giant1 ($42.09 in chips) 
Seat 4: Serhent ($50 in chips) 
Seat 5: ReinisRNS ($47.94 in chips) 
Seat 6: matiko09 ($51 in chips) 
Seat 7: banit7 ($52.75 in chips) 
Seat 8: vlad11122007 ($81.20 in chips) 
Seat 9: TheMinion ($140.88 in chips) 
banit7: posts small blind $0.25
vlad11122007: posts big blind $0.50
tallonn88: sits out 
*** HOLE CARDS ***
Dealt to matiko09 [Qc 7s]
TheMinion: folds 
Reven9er: folds 
Crazy_Giant1: calls $0.50
Serhent: raises $1.50 to $2
ReinisRNS: calls $2
matiko09: folds 
banit7: folds 
vlad11122007: folds 
Crazy_Giant1: folds 
*** FLOP *** [8h 8c 5h]
Serhent: checks 
ReinisRNS: checks 
*** TURN *** [8h 8c 5h] [6d]
Serhent: checks 
ReinisRNS: checks 
*** RIVER *** [8h 8c 5h 6d] [5c]
Serhent: checks 
ReinisRNS: bets $2.50
Serhent: calls $2.50
*** SHOW DOWN ***
ReinisRNS: shows [4s 6s] (two pair, Eights and Sixes)
Serhent: mucks hand 
ReinisRNS collected $9.79 from pot
*** SUMMARY ***
Total pot $10.25 | Rake $0.46 
Board [8h 8c 5h 6d 5c]
Seat 2: Reven9er folded before Flop (didn't bet)
Seat 3: Crazy_Giant1 folded before Flop
Seat 4: Serhent mucked [Kd As]
Seat 5: ReinisRNS showed [4s 6s] and won ($9.79) with two pair, Eights and Sixes
Seat 6: matiko09 (button) folded before Flop (didn't bet)
Seat 7: banit7 (small blind) folded before Flop
Seat 8: vlad11122007 (big blind) folded before Flop
Seat 9: TheMinion folded before Flop (didn't bet)





PokerStars Hand #148608695199:  Hold'em No Limit ($0.50/$1.00 USD) - 2016/02/11 13:04:55 CET [2016/02/11 7:04:55 ET]
Table 'Gianfar' 9-max Seat #3 is the button
Seat 1: sebaaastian ($231.31 in chips) 
Seat 2: bilukm ($100 in chips) 
Seat 3: AlKatrone ($100 in chips) 
Seat 4: matiko09 ($100 in chips) 
Seat 5: hammerwife ($158.93 in chips) 
Seat 6: Sweden_Pound ($107.52 in chips) 
Seat 7: Rikti ($39.50 in chips) 
Seat 9: oscarleon ($148.16 in chips) 
matiko09: posts small blind $0.50
hammerwife: posts big blind $1
Zeeshka: sits out 
*** HOLE CARDS ***
Dealt to matiko09 [8h Qc]
Sweden_Pound: folds 
Rikti: folds 
oscarleon: folds 
sebaaastian: raises $2 to $3
bilukm: folds 
AlKatrone: folds 
matiko09: folds 
hammerwife: folds 
Uncalled bet ($2) returned to sebaaastian
sebaaastian collected $2.50 from pot
sebaaastian: doesn't show hand 
*** SUMMARY ***
Total pot $2.50 | Rake $0 
Seat 1: sebaaastian collected ($2.50)
Seat 2: bilukm folded before Flop (didn't bet)
Seat 3: AlKatrone (button) folded before Flop (didn't bet)
Seat 4: matiko09 (small blind) folded before Flop
Seat 5: hammerwife (big blind) folded before Flop
Seat 6: Sweden_Pound folded before Flop (didn't bet)
Seat 7: Rikti folded before Flop (didn't bet)
Seat 9: oscarleon folded before Flop (didn't bet)





PokerStars Hand #148608695972:  Hold'em No Limit ($0.25/$0.50 USD) - 2016/02/11 13:04:57 CET [2016/02/11 7:04:57 ET]
Table 'Stereoskopia' 9-max Seat #3 is the button
Seat 1: JJJ-K9 ($52.25 in chips) 
Seat 2: Optimistic21 ($53 in chips) 
Seat 3: Szevasztopol ($58.29 in chips) 
Seat 5: ReinisRNS ($47.52 in chips) 
Seat 6: matiko09 ($50.75 in chips) 
Seat 8: vlad11122007 ($48.50 in chips) 
Seat 9: xxxibgdrgn ($50 in chips) 
ReinisRNS: posts small blind $0.25
matiko09: posts big blind $0.50
tallonn88: sits out 
*** HOLE CARDS ***
Dealt to matiko09 [7s 3c]
vlad11122007: folds 
xxxibgdrgn: folds 
JJJ-K9: folds 
Optimistic21: folds 
Szevasztopol: folds 
ReinisRNS: folds 
Uncalled bet ($0.25) returned to matiko09
matiko09 collected $0.50 from pot
matiko09: doesn't show hand 
*** SUMMARY ***
Total pot $0.50 | Rake $0 
Seat 1: JJJ-K9 folded before Flop (didn't bet)
Seat 2: Optimistic21 folded before Flop (didn't bet)
Seat 3: Szevasztopol (button) folded before Flop (didn't bet)
Seat 5: ReinisRNS (small blind) folded before Flop
Seat 6: matiko09 (big blind) collected ($0.50)
Seat 8: vlad11122007 folded before Flop (didn't bet)
Seat 9: xxxibgdrgn folded before Flop (didn't bet)





PokerStars Hand #148608706508:  Hold'em No Limit ($0.25/$0.50 USD) - 2016/02/11 13:05:15 CET [2016/02/11 7:05:15 ET]
Table 'Ambrosia II' 9-max Seat #7 is the button
Seat 1: matiko09 ($50 in chips) 
Seat 2: TheMinion ($131.31 in chips) 
Seat 3: make6a ($64.34 in chips) 
Seat 4: huudk2016 ($53.37 in chips) 
Seat 5: RICKA16 ($49.50 in chips) 
Seat 6: Reven9er ($72.02 in chips) 
Seat 7: Ana.Satravca ($50 in chips) 
Seat 9: arctur17 ($24.80 in chips) 
tallonn88 will be allowed to play after the button
arctur17: posts small blind $0.25
matiko09: posts big blind $0.50
*** HOLE CARDS ***
Dealt to matiko09 [4d 2h]
TheMinion: folds 
make6a: raises $0.82 to $1.32
huudk2016: calls $1.32
RICKA16: folds 
Reven9er: calls $1.32
Ana.Satravca: raises $3.68 to $5
arctur17: folds 
matiko09: folds 
make6a: calls $3.68
huudk2016: folds 
Reven9er: calls $3.68
*** FLOP *** [9h 7c 2c]
make6a: checks 
Reven9er: checks 
Ana.Satravca: checks 
*** TURN *** [9h 7c 2c] [Kd]
make6a: checks 
Reven9er: checks 
Ana.Satravca: checks 
*** RIVER *** [9h 7c 2c Kd] [Jc]
make6a: checks 
Reven9er: bets $7
Ana.Satravca: folds 
make6a: calls $7
*** SHOW DOWN ***
Reven9er: shows [7h 7d] (three of a kind, Sevens)
make6a: shows [9c 9s] (three of a kind, Nines)
make6a collected $29.67 from pot
*** SUMMARY ***
Total pot $31.07 | Rake $1.40 
Board [9h 7c 2c Kd Jc]
Seat 1: matiko09 (big blind) folded before Flop
Seat 2: TheMinion folded before Flop (didn't bet)
Seat 3: make6a showed [9c 9s] and won ($29.67) with three of a kind, Nines
Seat 4: huudk2016 folded before Flop
Seat 5: RICKA16 folded before Flop (didn't bet)
Seat 6: Reven9er showed [7h 7d] and lost with three of a kind, Sevens
Seat 7: Ana.Satravca (button) folded on the River
Seat 9: arctur17 (small blind) folded before Flop





PokerStars Hand #148608712134:  Hold'em No Limit ($0.50/$1.00 USD) - 2016/02/11 13:05:24 CET [2016/02/11 7:05:24 ET]
Table 'Stephano V' 9-max Seat #2 is the button
Seat 1: hammerwife ($100 in chips) 
Seat 2: matiko09 ($100 in chips) 
Seat 3: sebaaastian ($100 in chips) 
Seat 4: Zeeshka ($100 in chips) 
Seat 5: n2call ($175.40 in chips) 
Seat 6: Sweden_Pound ($102 in chips) 
Seat 7: hurtNCYDE ($123.04 in chips) 
Seat 8: oscarleon ($223.23 in chips) 
Seat 9: IcocaynaI ($30.92 in chips) 
sebaaastian: posts small blind $0.50
Zeeshka: posts big blind $1
*** HOLE CARDS ***
Dealt to matiko09 [5h 7h]
n2call: folds 
Sweden_Pound: folds 
hurtNCYDE: folds 
oscarleon: folds 
IcocaynaI: calls $1
hammerwife: folds 
matiko09: folds 
sebaaastian: folds 
Zeeshka: checks 
*** FLOP *** [Td Ac 4c]
Zeeshka: checks 
IcocaynaI: bets $1
Zeeshka: folds 
Uncalled bet ($1) returned to IcocaynaI
IcocaynaI collected $2.39 from pot
IcocaynaI: doesn't show hand 
*** SUMMARY ***
Total pot $2.50 | Rake $0.11 
Board [Td Ac 4c]
Seat 1: hammerwife folded before Flop (didn't bet)
Seat 2: matiko09 (button) folded before Flop (didn't bet)
Seat 3: sebaaastian (small blind) folded before Flop
Seat 4: Zeeshka (big blind) folded on the Flop
Seat 5: n2call folded before Flop (didn't bet)
Seat 6: Sweden_Pound folded before Flop (didn't bet)
Seat 7: hurtNCYDE folded before Flop (didn't bet)
Seat 8: oscarleon folded before Flop (didn't bet)
Seat 9: IcocaynaI collected ($2.39)





PokerStars Hand #148608713279:  Hold'em No Limit ($0.25/$0.50 USD) - 2016/02/11 13:05:26 CET [2016/02/11 7:05:26 ET]
Table 'Algedi' 9-max Seat #4 is the button
Seat 1: vlad11122007 ($74.47 in chips) 
Seat 2: Reffypaul ($56.21 in chips) 
Seat 3: Saggitaurus ($127.09 in chips) 
Seat 4: Effort92 ($62.16 in chips) 
Seat 5: Optimistic21 ($55.43 in chips) 
Seat 6: TonnaMunz ($96.19 in chips) 
Seat 7: hoedtrob ($61.56 in chips) 
Seat 8: matiko09 ($50 in chips) 
Seat 9: Kud3 ($125 in chips) 
Optimistic21: posts small blind $0.25
TonnaMunz: posts big blind $0.50
vlad11122007: posts the ante $0.10
Reffypaul: posts the ante $0.10
Saggitaurus: posts the ante $0.10
Effort92: posts the ante $0.10
Optimistic21: posts the ante $0.10
TonnaMunz: posts the ante $0.10
hoedtrob: posts the ante $0.10
matiko09: posts the ante $0.10
Kud3: posts the ante $0.10
*** HOLE CARDS ***
Dealt to matiko09 [5s Qs]
hoedtrob: folds 
matiko09: folds 
Kud3: folds 
vlad11122007: folds 
Reffypaul: raises $0.50 to $1
Saggitaurus: folds 
Effort92: raises $2 to $3
Optimistic21: folds 
TonnaMunz: raises $7.75 to $10.75
Reffypaul: folds 
Effort92: folds 
Uncalled bet ($7.75) returned to TonnaMunz
TonnaMunz collected $8.15 from pot
TonnaMunz: doesn't show hand 
*** SUMMARY ***
Total pot $8.15 | Rake $0 
Seat 1: vlad11122007 folded before Flop (didn't bet)
Seat 2: Reffypaul folded before Flop
Seat 3: Saggitaurus folded before Flop (didn't bet)
Seat 4: Effort92 (button) folded before Flop
Seat 5: Optimistic21 (small blind) folded before Flop
Seat 6: TonnaMunz (big blind) collected ($8.15)
Seat 7: hoedtrob folded before Flop (didn't bet)
Seat 8: matiko09 folded before Flop (didn't bet)
Seat 9: Kud3 folded before Flop (didn't bet)





PokerStars Hand #148608719119:  Hold'em No Limit ($0.25/$0.50 USD) - 2016/02/11 13:05:36 CET [2016/02/11 7:05:36 ET]
Table 'Sylvania II' 9-max Seat #6 is the button
Seat 1: tw0315 ($105.14 in chips) 
Seat 2: Effort92 ($63.19 in chips) 
Seat 3: ruyingren ($195.78 in chips) 
Seat 4: matiko09 ($149.49 in chips) 
Seat 5: vlad11122007 ($59.09 in chips) 
Seat 6: TonnaMunz ($131.31 in chips) 
Seat 7: 2lefthand75 ($63.02 in chips) 
Seat 8: Optimistic21 ($50 in chips) 
Seat 9: Kud3 ($136.29 in chips) 
2lefthand75: posts small blind $0.25
Optimistic21: posts big blind $0.50
tw0315: posts the ante $0.10
Effort92: posts the ante $0.10
ruyingren: posts the ante $0.10
matiko09: posts the ante $0.10
vlad11122007: posts the ante $0.10
TonnaMunz: posts the ante $0.10
2lefthand75: posts the ante $0.10
Optimistic21: posts the ante $0.10
Kud3: posts the ante $0.10
*** HOLE CARDS ***
Dealt to matiko09 [9c Kc]
Kud3: raises $1 to $1.50
tw0315: folds 
Effort92: folds 
ruyingren: folds 
matiko09: folds 
vlad11122007: folds 
TonnaMunz: folds 
2lefthand75: calls $1.25
Optimistic21: folds 
*** FLOP *** [4d 8c 9s]
2lefthand75: bets $2.10
Kud3: calls $2.10
*** TURN *** [4d 8c 9s] [4h]
2lefthand75: bets $8.21
Kud3: folds 
Uncalled bet ($8.21) returned to 2lefthand75
2lefthand75 collected $8.21 from pot
*** SUMMARY ***
Total pot $8.60 | Rake $0.39 
Board [4d 8c 9s 4h]
Seat 1: tw0315 folded before Flop (didn't bet)
Seat 2: Effort92 folded before Flop (didn't bet)
Seat 3: ruyingren folded before Flop (didn't bet)
Seat 4: matiko09 folded before Flop (didn't bet)
Seat 5: vlad11122007 folded before Flop (didn't bet)
Seat 6: TonnaMunz (button) folded before Flop (didn't bet)
Seat 7: 2lefthand75 (small blind) collected ($8.21)
Seat 8: Optimistic21 (big blind) folded before Flop
Seat 9: Kud3 folded on the Turn





PokerStars Hand #148608719801:  Hold'em No Limit ($0.25/$0.50 USD) - 2016/02/11 13:05:38 CET [2016/02/11 7:05:38 ET]
Table 'Stereoskopia' 9-max Seat #5 is the button
Seat 1: JJJ-K9 ($52.25 in chips) 
Seat 2: Optimistic21 ($53 in chips) 
Seat 3: Szevasztopol ($58.29 in chips) 
Seat 5: ReinisRNS ($47.27 in chips) 
Seat 6: matiko09 ($51 in chips) 
Seat 7: tallonn88 ($55.47 in chips) 
Seat 8: vlad11122007 ($48.50 in chips) 
Seat 9: xxxibgdrgn ($50 in chips) 
matiko09: posts small blind $0.25
tallonn88: posts big blind $0.50
*** HOLE CARDS ***
Dealt to matiko09 [Kc 3s]
King brid is disconnected 
vlad11122007: folds 
xxxibgdrgn: folds 
JJJ-K9: folds 
Optimistic21: folds 
Szevasztopol: folds 
ReinisRNS: folds 
matiko09: folds 
Uncalled bet ($0.25) returned to tallonn88
tallonn88 collected $0.50 from pot
tallonn88: doesn't show hand 
*** SUMMARY ***
Total pot $0.50 | Rake $0 
Seat 1: JJJ-K9 folded before Flop (didn't bet)
Seat 2: Optimistic21 folded before Flop (didn't bet)
Seat 3: Szevasztopol folded before Flop (didn't bet)
Seat 5: ReinisRNS (button) folded before Flop (didn't bet)
Seat 6: matiko09 (small blind) folded before Flop
Seat 7: tallonn88 (big blind) collected ($0.50)
Seat 8: vlad11122007 folded before Flop (didn't bet)
Seat 9: xxxibgdrgn folded before Flop (didn't bet)





PokerStars Hand #148608722161:  Hold'em No Limit ($0.50/$1.00 USD) - 2016/02/11 13:05:42 CET [2016/02/11 7:05:42 ET]
Table 'Gianfar' 9-max Seat #4 is the button
Seat 1: sebaaastian ($232.81 in chips) 
Seat 2: bilukm ($100 in chips) 
Seat 3: AlKatrone ($100 in chips) 
Seat 4: matiko09 ($100 in chips) 
Seat 5: hammerwife ($157.93 in chips) 
Seat 7: Rikti ($39.50 in chips) 
Seat 9: oscarleon ($148.16 in chips) 
hammerwife: posts small blind $0.50
Sweden_Pound: is sitting out 
Rikti: posts big blind $1
Zeeshka: sits out 
*** HOLE CARDS ***
Dealt to matiko09 [2d 5h]
oscarleon: folds 
sebaaastian: folds 
bilukm: calls $1
AlKatrone: raises $3 to $4
matiko09: folds 
hammerwife: raises $8 to $12
Rikti: folds 
bilukm: folds 
AlKatrone: calls $8
*** FLOP *** [6c 4c 6s]
hammerwife: checks 
AlKatrone: bets $8.44
hammerwife: folds 
Uncalled bet ($8.44) returned to AlKatrone
AlKatrone collected $24.83 from pot
AlKatrone: doesn't show hand 
*** SUMMARY ***
Total pot $26 | Rake $1.17 
Board [6c 4c 6s]
Seat 1: sebaaastian folded before Flop (didn't bet)
Seat 2: bilukm folded before Flop
Seat 3: AlKatrone collected ($24.83)
Seat 4: matiko09 (button) folded before Flop (didn't bet)
Seat 5: hammerwife (small blind) folded on the Flop
Seat 7: Rikti (big blind) folded before Flop
Seat 9: oscarleon folded before Flop (didn't bet)





PokerStars Hand #148608728393:  Hold'em No Limit (€0.25/€0.50 EUR) - 2016/02/11 13:05:52 CET [2016/02/11 7:05:52 ET]
Table 'Otero II' 9-max Seat #9 is the button
Seat 2: Dantist1122 (€50 in chips) 
Seat 3: Szevasztopol (€50.75 in chips) 
Seat 4: kram0909 (€5.33 in chips) 
Seat 5: vlad11122007 (€50.19 in chips) 
Seat 6: TonnaMunz (€50.60 in chips) 
Seat 7: Dflingern95 (€49 in chips) 
Seat 8: matiko09 (€72.18 in chips) 
Seat 9: Optimistic21 (€72.63 in chips) 
Dantist1122: posts small blind €0.25
Szevasztopol: posts big blind €0.50
*** HOLE CARDS ***
Dealt to matiko09 [5h 7h]
kram0909: folds 
vlad11122007: folds 
TonnaMunz: folds 
Dflingern95: folds 
matiko09: folds 
Optimistic21: raises €0.50 to €1
Dantist1122: folds 
Szevasztopol: calls €0.50
*** FLOP *** [4d Ac Td]
Szevasztopol: checks 
Optimistic21: bets €1.50
Szevasztopol: folds 
Uncalled bet (€1.50) returned to Optimistic21
Optimistic21 collected €2.15 from pot
*** SUMMARY ***
Total pot €2.25 | Rake €0.10 
Board [4d Ac Td]
Seat 2: Dantist1122 (small blind) folded before Flop
Seat 3: Szevasztopol (big blind) folded on the Flop
Seat 4: kram0909 folded before Flop (didn't bet)
Seat 5: vlad11122007 folded before Flop (didn't bet)
Seat 6: TonnaMunz folded before Flop (didn't bet)
Seat 7: Dflingern95 folded before Flop (didn't bet)
Seat 8: matiko09 folded before Flop (didn't bet)
Seat 9: Optimistic21 (button) collected (€2.15)





PokerStars Hand #148608731326:  Hold'em No Limit ($0.25/$0.50 USD) - 2016/02/11 13:05:57 CET [2016/02/11 7:05:57 ET]
Table 'Stereoskopia' 9-max Seat #6 is the button
Seat 1: JJJ-K9 ($52.25 in chips) 
Seat 2: Optimistic21 ($53 in chips) 
Seat 3: Szevasztopol ($58.29 in chips) 
Seat 5: ReinisRNS ($47.27 in chips) 
Seat 6: matiko09 ($50.75 in chips) 
Seat 7: tallonn88 ($55.72 in chips) 
Seat 8: vlad11122007 ($48.50 in chips) 
Seat 9: xxxibgdrgn ($50 in chips) 
tallonn88: posts small blind $0.25
vlad11122007: posts big blind $0.50
*** HOLE CARDS ***
Dealt to matiko09 [Ah Qh]
xxxibgdrgn: raises $1 to $1.50
JJJ-K9: folds 
Optimistic21: folds 
Szevasztopol: folds 
ReinisRNS: folds 
matiko09: calls $1.50
tallonn88: folds 
vlad11122007: folds 
*** FLOP *** [6h Tc 7h]
xxxibgdrgn: checks 
matiko09: bets $2.33
xxxibgdrgn: folds 
Uncalled bet ($2.33) returned to matiko09
matiko09 collected $3.58 from pot
matiko09: doesn't show hand 
*** SUMMARY ***
Total pot $3.75 | Rake $0.17 
Board [6h Tc 7h]
Seat 1: JJJ-K9 folded before Flop (didn't bet)
Seat 2: Optimistic21 folded before Flop (didn't bet)
Seat 3: Szevasztopol folded before Flop (didn't bet)
Seat 5: ReinisRNS folded before Flop (didn't bet)
Seat 6: matiko09 (button) collected ($3.58)
Seat 7: tallonn88 (small blind) folded before Flop
Seat 8: vlad11122007 (big blind) folded before Flop
Seat 9: xxxibgdrgn folded on the Flop





PokerStars Hand #148608732839:  Hold'em No Limit ($0.50/$1.00 USD) - 2016/02/11 13:06:00 CET [2016/02/11 7:06:00 ET]
Table 'Aoluta' 9-max Seat #6 is the button
Seat 1: sebaaastian ($101 in chips) 
Seat 2: matiko09 ($101.02 in chips) 
Seat 3: Zeeshka ($100 in chips) 
Seat 4: oscarleon ($180.26 in chips) 
Seat 5: aseban11 ($100 in chips) 
Seat 6: Luck In Me ($107 in chips) 
Seat 7: grigy197 ($82.60 in chips) 
Seat 8: mrspecial1 ($61.50 in chips) 
Seat 9: Sweden_Pound ($115.64 in chips) 
grigy197: posts small blind $0.50
mrspecial1: posts big blind $1
*** HOLE CARDS ***
Dealt to matiko09 [Jd Qh]
Sweden_Pound: folds 
sebaaastian: folds 
matiko09: folds 
Zeeshka: raises $2 to $3
oscarleon: folds 
aseban11: folds 
Luck In Me: folds 
grigy197: calls $2.50
mrspecial1: calls $2
*** FLOP *** [5h 9h Ac]
grigy197: checks 
mrspecial1: checks 
Zeeshka: bets $5.76
grigy197: folds 
mrspecial1: folds 
Uncalled bet ($5.76) returned to Zeeshka
Zeeshka collected $8.60 from pot
Zeeshka: doesn't show hand 
*** SUMMARY ***
Total pot $9 | Rake $0.40 
Board [5h 9h Ac]
Seat 1: sebaaastian folded before Flop (didn't bet)
Seat 2: matiko09 folded before Flop (didn't bet)
Seat 3: Zeeshka collected ($8.60)
Seat 4: oscarleon folded before Flop (didn't bet)
Seat 5: aseban11 folded before Flop (didn't bet)
Seat 6: Luck In Me (button) folded before Flop (didn't bet)
Seat 7: grigy197 (small blind) folded on the Flop
Seat 8: mrspecial1 (big blind) folded on the Flop
Seat 9: Sweden_Pound folded before Flop (didn't bet)





PokerStars Hand #148608740579:  Hold'em No Limit ($0.25/$0.50 USD) - 2016/02/11 13:06:14 CET [2016/02/11 7:06:14 ET]
Table 'Oenone' 9-max Seat #7 is the button
Seat 2: Reven9er ($50 in chips) 
Seat 3: Crazy_Giant1 ($41.59 in chips) 
Seat 4: Serhent ($50 in chips) 
Seat 5: ReinisRNS ($53.23 in chips) 
Seat 6: matiko09 ($51 in chips) 
Seat 7: banit7 ($52.50 in chips) 
Seat 8: vlad11122007 ($80.70 in chips) 
Seat 9: TheMinion ($140.88 in chips) 
vlad11122007: posts small blind $0.25
TheMinion: posts big blind $0.50
tallonn88: sits out 
*** HOLE CARDS ***
Dealt to matiko09 [5c 8s]
Reven9er: folds 
Crazy_Giant1: folds 
Serhent: folds 
ReinisRNS: folds 
matiko09: folds 
banit7: raises $0.75 to $1.25
vlad11122007: folds 
TheMinion: folds 
Uncalled bet ($0.75) returned to banit7
banit7 collected $1.25 from pot
banit7: doesn't show hand 
*** SUMMARY ***
Total pot $1.25 | Rake $0 
Seat 2: Reven9er folded before Flop (didn't bet)
Seat 3: Crazy_Giant1 folded before Flop (didn't bet)
Seat 4: Serhent folded before Flop (didn't bet)
Seat 5: ReinisRNS folded before Flop (didn't bet)
Seat 6: matiko09 folded before Flop (didn't bet)
Seat 7: banit7 (button) collected ($1.25)
Seat 8: vlad11122007 (small blind) folded before Flop
Seat 9: TheMinion (big blind) folded before Flop





PokerStars Hand #148608745329:  Hold'em No Limit ($0.25/$0.50 USD) - 2016/02/11 13:06:22 CET [2016/02/11 7:06:22 ET]
Table 'Algedi' 9-max Seat #5 is the button
Seat 1: vlad11122007 ($74.37 in chips) 
Seat 2: Reffypaul ($55.11 in chips) 
Seat 3: Saggitaurus ($126.99 in chips) 
Seat 4: Effort92 ($59.06 in chips) 
Seat 5: Optimistic21 ($55.08 in chips) 
Seat 6: TonnaMunz ($101.24 in chips) 
Seat 7: hoedtrob ($61.46 in chips) 
Seat 8: matiko09 ($50 in chips) 
Seat 9: Kud3 ($125 in chips) 
TonnaMunz: posts small blind $0.25
hoedtrob: posts big blind $0.50
vlad11122007: posts the ante $0.10
Reffypaul: posts the ante $0.10
Saggitaurus: posts the ante $0.10
Effort92: posts the ante $0.10
Optimistic21: posts the ante $0.10
TonnaMunz: posts the ante $0.10
hoedtrob: posts the ante $0.10
matiko09: posts the ante $0.10
Kud3: posts the ante $0.10
*** HOLE CARDS ***
Dealt to matiko09 [Ts Qc]
matiko09: folds 
Kud3: folds 
vlad11122007: folds 
Reffypaul: folds 
Saggitaurus: folds 
Effort92: folds 
Optimistic21: folds 
TonnaMunz: raises $0.97 to $1.47
hoedtrob: folds 
Uncalled bet ($0.97) returned to TonnaMunz
TonnaMunz collected $1.90 from pot
*** SUMMARY ***
Total pot $1.90 | Rake $0 
Seat 1: vlad11122007 folded before Flop (didn't bet)
Seat 2: Reffypaul folded before Flop (didn't bet)
Seat 3: Saggitaurus folded before Flop (didn't bet)
Seat 4: Effort92 folded before Flop (didn't bet)
Seat 5: Optimistic21 (button) folded before Flop (didn't bet)
Seat 6: TonnaMunz (small blind) collected ($1.90)
Seat 7: hoedtrob (big blind) folded before Flop
Seat 8: matiko09 folded before Flop (didn't bet)
Seat 9: Kud3 folded before Flop (didn't bet)





PokerStars Hand #148608746226:  Hold'em No Limit ($0.50/$1.00 USD) - 2016/02/11 13:06:23 CET [2016/02/11 7:06:23 ET]
Table 'Stephano V' 9-max Seat #3 is the button
Seat 1: hammerwife ($100 in chips) 
Seat 2: matiko09 ($100 in chips) 
Seat 3: sebaaastian ($100 in chips) 
Seat 4: Zeeshka ($100 in chips) 
Seat 5: n2call ($175.40 in chips) 
Seat 6: Sweden_Pound ($102 in chips) 
Seat 7: hurtNCYDE ($123.04 in chips) 
Seat 8: oscarleon ($223.23 in chips) 
Seat 9: IcocaynaI ($32.31 in chips) 
Zeeshka: posts small blind $0.50
n2call: posts big blind $1
*** HOLE CARDS ***
Dealt to matiko09 [Qd Kd]
Sweden_Pound: folds 
hurtNCYDE: folds 
oscarleon: raises $2 to $3
IcocaynaI: calls $3
hammerwife: folds 
matiko09: raises $7 to $10
sebaaastian: folds 
Zeeshka: folds 
n2call: folds 
oscarleon: folds 
IcocaynaI: raises $22.31 to $32.31 and is all-in
matiko09: calls $22.31
*** FLOP *** [Ks 4h 4d]
*** TURN *** [Ks 4h 4d] [3c]
*** RIVER *** [Ks 4h 4d 3c] [6c]
*** SHOW DOWN ***
IcocaynaI: shows [Th Qh] (a pair of Fours)
matiko09: shows [Qd Kd] (two pair, Kings and Fours)
matiko09 collected $66.32 from pot
*** SUMMARY ***
Total pot $69.12 | Rake $2.80 
Board [Ks 4h 4d 3c 6c]
Seat 1: hammerwife folded before Flop (didn't bet)
Seat 2: matiko09 showed [Qd Kd] and won ($66.32) with two pair, Kings and Fours
Seat 3: sebaaastian (button) folded before Flop (didn't bet)
Seat 4: Zeeshka (small blind) folded before Flop
Seat 5: n2call (big blind) folded before Flop
Seat 6: Sweden_Pound folded before Flop (didn't bet)
Seat 7: hurtNCYDE folded before Flop (didn't bet)
Seat 8: oscarleon folded before Flop
Seat 9: IcocaynaI showed [Th Qh] and lost with a pair of Fours





PokerStars Hand #148608757274:  Hold'em No Limit ($0.25/$0.50 USD) - 2016/02/11 13:06:42 CET [2016/02/11 7:06:42 ET]
Table 'Stereoskopia' 9-max Seat #7 is the button
Seat 1: JJJ-K9 ($52.25 in chips) 
Seat 2: Optimistic21 ($53 in chips) 
Seat 3: Szevasztopol ($58.29 in chips) 
Seat 5: ReinisRNS ($47.27 in chips) 
Seat 6: matiko09 ($52.83 in chips) 
Seat 7: tallonn88 ($55.47 in chips) 
Seat 8: vlad11122007 ($48 in chips) 
Seat 9: xxxibgdrgn ($50 in chips) 
vlad11122007: posts small blind $0.25
xxxibgdrgn: posts big blind $0.50
*** HOLE CARDS ***
Dealt to matiko09 [5s Qs]
JJJ-K9: folds 
Optimistic21: folds 
Szevasztopol: folds 
ReinisRNS: folds 
matiko09: folds 
tallonn88: folds 
vlad11122007: folds 
Uncalled bet ($0.25) returned to xxxibgdrgn
xxxibgdrgn collected $0.50 from pot
xxxibgdrgn: doesn't show hand 
*** SUMMARY ***
Total pot $0.50 | Rake $0 
Seat 1: JJJ-K9 folded before Flop (didn't bet)
Seat 2: Optimistic21 folded before Flop (didn't bet)
Seat 3: Szevasztopol folded before Flop (didn't bet)
Seat 5: ReinisRNS folded before Flop (didn't bet)
Seat 6: matiko09 folded before Flop (didn't bet)
Seat 7: tallonn88 (button) folded before Flop (didn't bet)
Seat 8: vlad11122007 (small blind) folded before Flop
Seat 9: xxxibgdrgn (big blind) collected ($0.50)





PokerStars Hand #148608762216:  Hold'em No Limit ($0.25/$0.50 USD) - 2016/02/11 13:06:51 CET [2016/02/11 7:06:51 ET]
Table 'Oenone' 9-max Seat #8 is the button
Seat 1: tallonn88 ($50 in chips) 
Seat 2: Reven9er ($50 in chips) 
Seat 3: Crazy_Giant1 ($41.59 in chips) 
Seat 4: Serhent ($50 in chips) 
Seat 5: ReinisRNS ($53.23 in chips) 
Seat 6: matiko09 ($51 in chips) 
Seat 7: banit7 ($53.25 in chips) 
Seat 8: vlad11122007 ($80.45 in chips) 
Seat 9: TheMinion ($140.38 in chips) 
TheMinion: posts small blind $0.25
tallonn88: posts big blind $0.50
*** HOLE CARDS ***
Dealt to matiko09 [Td 3s]
Reven9er: folds 
Crazy_Giant1: folds 
Serhent: folds 
ReinisRNS: folds 
matiko09: folds 
banit7: folds 
vlad11122007: folds 
TheMinion: raises $0.75 to $1.25
tallonn88: folds 
Uncalled bet ($0.75) returned to TheMinion
TheMinion collected $1 from pot
TheMinion: doesn't show hand 
*** SUMMARY ***
Total pot $1 | Rake $0 
Seat 1: tallonn88 (big blind) folded before Flop
Seat 2: Reven9er folded before Flop (didn't bet)
Seat 3: Crazy_Giant1 folded before Flop (didn't bet)
Seat 4: Serhent folded before Flop (didn't bet)
Seat 5: ReinisRNS folded before Flop (didn't bet)
Seat 6: matiko09 folded before Flop (didn't bet)
Seat 7: banit7 folded before Flop (didn't bet)
Seat 8: vlad11122007 (button) folded before Flop (didn't bet)
Seat 9: TheMinion (small blind) collected ($1)





PokerStars Hand #148608763096:  Hold'em No Limit ($0.25/$0.50 USD) - 2016/02/11 13:06:52 CET [2016/02/11 7:06:52 ET]
Table 'Algedi' 9-max Seat #6 is the button
Seat 1: vlad11122007 ($74.27 in chips) 
Seat 2: Reffypaul ($55.01 in chips) 
Seat 3: Saggitaurus ($126.89 in chips) 
Seat 4: Effort92 ($58.96 in chips) 
Seat 5: Optimistic21 ($54.98 in chips) 
Seat 6: TonnaMunz ($102.54 in chips) 
Seat 7: hoedtrob ($60.86 in chips) 
Seat 8: matiko09 ($50 in chips) 
Seat 9: Kud3 ($125 in chips) 
hoedtrob: posts small blind $0.25
matiko09: posts big blind $0.50
vlad11122007: posts the ante $0.10
Reffypaul: posts the ante $0.10
Saggitaurus: posts the ante $0.10
Effort92: posts the ante $0.10
Optimistic21: posts the ante $0.10
TonnaMunz: posts the ante $0.10
hoedtrob: posts the ante $0.10
matiko09: posts the ante $0.10
Kud3: posts the ante $0.10
*** HOLE CARDS ***
Dealt to matiko09 [7s Qs]
Kud3: folds 
vlad11122007: folds 
Reffypaul: folds 
Saggitaurus: folds 
Effort92: folds 
Optimistic21: raises $1 to $1.50
TonnaMunz: folds 
hoedtrob: folds 
matiko09: folds 
Uncalled bet ($1) returned to Optimistic21
Optimistic21 collected $2.15 from pot
*** SUMMARY ***
Total pot $2.15 | Rake $0 
Seat 1: vlad11122007 folded before Flop (didn't bet)
Seat 2: Reffypaul folded before Flop (didn't bet)
Seat 3: Saggitaurus folded before Flop (didn't bet)
Seat 4: Effort92 folded before Flop (didn't bet)
Seat 5: Optimistic21 collected ($2.15)
Seat 6: TonnaMunz (button) folded before Flop (didn't bet)
Seat 7: hoedtrob (small blind) folded before Flop
Seat 8: matiko09 (big blind) folded before Flop
Seat 9: Kud3 folded before Flop (didn't bet)





PokerStars Hand #148608766165:  Hold'em No Limit ($0.25/$0.50 USD) - 2016/02/11 13:06:57 CET [2016/02/11 7:06:57 ET]
Table 'Sylvania II' 9-max Seat #7 is the button
Seat 1: tw0315 ($105.04 in chips) 
Seat 2: Effort92 ($63.09 in chips) 
Seat 3: ruyingren ($195.68 in chips) 
Seat 4: matiko09 ($149.39 in chips) 
Seat 5: vlad11122007 ($58.99 in chips) 
Seat 6: TonnaMunz ($131.21 in chips) 
Seat 7: 2lefthand75 ($67.53 in chips) 
Seat 8: Optimistic21 ($50 in chips) 
Optimistic21: posts small blind $0.25
Kud3: is sitting out 
Kud3 leaves the table
tw0315: posts big blind $0.50
tw0315: posts the ante $0.10
Effort92: posts the ante $0.10
ruyingren: posts the ante $0.10
matiko09: posts the ante $0.10
vlad11122007: posts the ante $0.10
TonnaMunz: posts the ante $0.10
2lefthand75: posts the ante $0.10
Optimistic21: posts the ante $0.10
*** HOLE CARDS ***
Dealt to matiko09 [3s 2c]
Effort92: folds 
ruyingren: folds 
matiko09: folds 
vlad11122007: folds 
TonnaMunz: folds 
2lefthand75: raises $1 to $1.50
Optimistic21: folds 
tw0315: calls $1
*** FLOP *** [2s 7s 6d]
ruyingren is disconnected 
tw0315: bets $2
2lefthand75: raises $3.93 to $5.93
tw0315: calls $3.93
*** TURN *** [2s 7s 6d] [8d]
tw0315: checks 
2lefthand75: bets $15.19
tw0315: calls $15.19
*** RIVER *** [2s 7s 6d 8d] [Jc]
tw0315: checks 
2lefthand75: bets $44.21
tw0315: folds 
Uncalled bet ($44.21) returned to 2lefthand75
2lefthand75 collected $44.21 from pot
*** SUMMARY ***
Total pot $46.29 | Rake $2.08 
Board [2s 7s 6d 8d Jc]
Seat 1: tw0315 (big blind) folded on the River
Seat 2: Effort92 folded before Flop (didn't bet)
Seat 3: ruyingren folded before Flop (didn't bet)
Seat 4: matiko09 folded before Flop (didn't bet)
Seat 5: vlad11122007 folded before Flop (didn't bet)
Seat 6: TonnaMunz folded before Flop (didn't bet)
Seat 7: 2lefthand75 (button) collected ($44.21)
Seat 8: Optimistic21 (small blind) folded before Flop





PokerStars Hand #148608768297:  Hold'em No Limit ($0.50/$1.00 USD) - 2016/02/11 13:07:01 CET [2016/02/11 7:07:01 ET]
Table 'Aoluta' 9-max Seat #7 is the button
Seat 1: sebaaastian ($101 in chips) 
Seat 2: matiko09 ($101.02 in chips) 
Seat 3: Zeeshka ($105.60 in chips) 
Seat 4: oscarleon ($180.26 in chips) 
Seat 5: aseban11 ($100 in chips) 
Seat 6: Luck In Me ($107 in chips) 
Seat 7: grigy197 ($79.60 in chips) 
Seat 8: mrspecial1 ($58.50 in chips) 
mrspecial1: posts small blind $0.50
Sweden_Pound: is sitting out 
sebaaastian: posts big blind $1
*** HOLE CARDS ***
Dealt to matiko09 [6c 8c]
matiko09: folds 
Zeeshka: folds 
oscarleon: folds 
aseban11: folds 
Luck In Me: raises $1.50 to $2.50
grigy197: folds 
mrspecial1: folds 
sebaaastian: folds 
Uncalled bet ($1.50) returned to Luck In Me
Luck In Me collected $2.50 from pot
Luck In Me: doesn't show hand 
*** SUMMARY ***
Total pot $2.50 | Rake $0 
Seat 1: sebaaastian (big blind) folded before Flop
Seat 2: matiko09 folded before Flop (didn't bet)
Seat 3: Zeeshka folded before Flop (didn't bet)
Seat 4: oscarleon folded before Flop (didn't bet)
Seat 5: aseban11 folded before Flop (didn't bet)
Seat 6: Luck In Me collected ($2.50)
Seat 7: grigy197 (button) folded before Flop (didn't bet)
Seat 8: mrspecial1 (small blind) folded before Flop





PokerStars Hand #148608769665:  Hold'em No Limit ($0.25/$0.50 USD) - 2016/02/11 13:07:03 CET [2016/02/11 7:07:03 ET]
Table 'Ambrosia II' 9-max Seat #9 is the button
Seat 1: matiko09 ($50 in chips) 
Seat 2: TheMinion ($131.31 in chips) 
Seat 3: make6a ($82.01 in chips) 
Seat 4: huudk2016 ($52.05 in chips) 
Seat 5: RICKA16 ($49.50 in chips) 
Seat 6: Reven9er ($60.02 in chips) 
Seat 7: Ana.Satravca ($50 in chips) 
Seat 9: arctur17 ($50 in chips) 
matiko09: posts small blind $0.25
TheMinion: posts big blind $0.50
tallonn88: sits out 
*** HOLE CARDS ***
Dealt to matiko09 [4d Th]
make6a: folds 
huudk2016: calls $0.50
RICKA16: folds 
Reven9er: raises $0.75 to $1.25
Ana.Satravca: folds 
arctur17: calls $1.25
matiko09: folds 
TheMinion: folds 
huudk2016: calls $0.75
*** FLOP *** [Tc Ad 3h]
huudk2016: checks 
Reven9er: checks 
arctur17: bets $2.50
huudk2016: calls $2.50
Reven9er: folds 
*** TURN *** [Tc Ad 3h] [8c]
huudk2016: checks 
arctur17: bets $2.50
huudk2016: folds 
Uncalled bet ($2.50) returned to arctur17
arctur17 collected $9.07 from pot
arctur17: doesn't show hand 
*** SUMMARY ***
Total pot $9.50 | Rake $0.43 
Board [Tc Ad 3h 8c]
Seat 1: matiko09 (small blind) folded before Flop
Seat 2: TheMinion (big blind) folded before Flop
Seat 3: make6a folded before Flop (didn't bet)
Seat 4: huudk2016 folded on the Turn
Seat 5: RICKA16 folded before Flop (didn't bet)
Seat 6: Reven9er folded on the Flop
Seat 7: Ana.Satravca folded before Flop (didn't bet)
Seat 9: arctur17 (button) collected ($9.07)





PokerStars Hand #148608769200:  Hold'em No Limit ($0.50/$1.00 USD) - 2016/02/11 13:07:03 CET [2016/02/11 7:07:03 ET]
Table 'Clorinde' 9-max Seat #2 is the button
Seat 1: matiko09 ($100 in chips) 
Seat 2: 19SERGE74 ($80 in chips) 
Seat 3: gabi_igna ($100 in chips) 
Seat 4: Sweden_Pound ($100 in chips) 
Seat 5: Mukhin1 ($100 in chips) 
Seat 6: Gcroc52 ($40 in chips) 
Seat 7: Zeeshka ($100 in chips) 
Seat 8: aseban11 ($100 in chips) 
Seat 9: buttonlife ($40 in chips) 
gabi_igna: posts small blind $0.50
Sweden_Pound: posts big blind $1
*** HOLE CARDS ***
Dealt to matiko09 [Kd 4d]
Mukhin1: folds 
Gcroc52: folds 
Zeeshka: folds 
aseban11: folds 
buttonlife: folds 
matiko09: folds 
19SERGE74 has timed out
19SERGE74: folds 
gabi_igna: raises $2 to $3
Sweden_Pound: folds 
Uncalled bet ($2) returned to gabi_igna
gabi_igna collected $2 from pot
gabi_igna: doesn't show hand 
*** SUMMARY ***
Total pot $2 | Rake $0 
Seat 1: matiko09 folded before Flop (didn't bet)
Seat 2: 19SERGE74 (button) folded before Flop (didn't bet)
Seat 3: gabi_igna (small blind) collected ($2)
Seat 4: Sweden_Pound (big blind) folded before Flop
Seat 5: Mukhin1 folded before Flop (didn't bet)
Seat 6: Gcroc52 folded before Flop (didn't bet)
Seat 7: Zeeshka folded before Flop (didn't bet)
Seat 8: aseban11 folded before Flop (didn't bet)
Seat 9: buttonlife folded before Flop (didn't bet)





PokerStars Hand #148608771121:  Hold'em No Limit ($0.50/$1.00 USD) - 2016/02/11 13:07:06 CET [2016/02/11 7:07:06 ET]
Table 'Gianfar' 9-max Seat #5 is the button
Seat 1: sebaaastian ($232.81 in chips) 
Seat 2: bilukm ($99 in chips) 
Seat 3: AlKatrone ($112.83 in chips) 
Seat 4: matiko09 ($100 in chips) 
Seat 5: hammerwife ($145.93 in chips) 
Seat 7: Rikti ($38.50 in chips) 
Seat 8: Zeeshka ($100 in chips) 
Seat 9: oscarleon ($148.16 in chips) 
Rikti: posts small blind $0.50
Zeeshka: posts big blind $1
*** HOLE CARDS ***
Dealt to matiko09 [Qh 8s]
oscarleon: folds 
sebaaastian: folds 
bilukm: folds 
AlKatrone: folds 
matiko09: folds 
hammerwife: raises $1.01 to $2.01
Rikti: folds 
Zeeshka: raises $5.99 to $8
hammerwife: calls $5.99
*** FLOP *** [8d 8c Ac]
Zeeshka: checks 
hammerwife: checks 
*** TURN *** [8d 8c Ac] [Jh]
Zeeshka: bets $8.66
hammerwife: calls $8.66
*** RIVER *** [8d 8c Ac Jh] [Ts]
Zeeshka: checks 
hammerwife: bets $15.50
Zeeshka: calls $15.50
*** SHOW DOWN ***
hammerwife: shows [Ad Td] (two pair, Aces and Tens)
Zeeshka: mucks hand 
hammerwife collected $62.02 from pot
*** SUMMARY ***
Total pot $64.82 | Rake $2.80 
Board [8d 8c Ac Jh Ts]
Seat 1: sebaaastian folded before Flop (didn't bet)
Seat 2: bilukm folded before Flop (didn't bet)
Seat 3: AlKatrone folded before Flop (didn't bet)
Seat 4: matiko09 folded before Flop (didn't bet)
Seat 5: hammerwife (button) showed [Ad Td] and won ($62.02) with two pair, Aces and Tens
Seat 7: Rikti (small blind) folded before Flop
Seat 8: Zeeshka (big blind) mucked [As Qs]
Seat 9: oscarleon folded before Flop (didn't bet)





PokerStars Hand #148608772483:  Hold'em No Limit (€0.25/€0.50 EUR) - 2016/02/11 13:07:08 CET [2016/02/11 7:07:08 ET]
Table 'Otero II' 9-max Seat #2 is the button
Seat 2: Dantist1122 (€50 in chips) 
Seat 3: Szevasztopol (€50 in chips) 
Seat 4: kram0909 (€5.33 in chips) 
Seat 5: vlad11122007 (€50.19 in chips) 
Seat 6: TonnaMunz (€50.60 in chips) 
Seat 7: Dflingern95 (€49 in chips) 
Seat 8: matiko09 (€72.18 in chips) 
Seat 9: Optimistic21 (€73.78 in chips) 
Szevasztopol: posts small blind €0.25
kram0909: posts big blind €0.50
*** HOLE CARDS ***
Dealt to matiko09 [3d 4d]
vlad11122007: folds 
TonnaMunz: folds 
Dflingern95: folds 
matiko09: folds 
Optimistic21: raises €0.75 to €1.25
Dantist1122: folds 
Szevasztopol: folds 
kram0909: calls €0.75
*** FLOP *** [8d Jh 4c]
kram0909: checks 
Optimistic21: checks 
*** TURN *** [8d Jh 4c] [Qh]
kram0909: checks 
Optimistic21: bets €2
kram0909: folds 
Uncalled bet (€2) returned to Optimistic21
Optimistic21 collected €2.63 from pot
*** SUMMARY ***
Total pot €2.75 | Rake €0.12 
Board [8d Jh 4c Qh]
Seat 2: Dantist1122 (button) folded before Flop (didn't bet)
Seat 3: Szevasztopol (small blind) folded before Flop
Seat 4: kram0909 (big blind) folded on the Turn
Seat 5: vlad11122007 folded before Flop (didn't bet)
Seat 6: TonnaMunz folded before Flop (didn't bet)
Seat 7: Dflingern95 folded before Flop (didn't bet)
Seat 8: matiko09 folded before Flop (didn't bet)
Seat 9: Optimistic21 collected (€2.63)





PokerStars Hand #148608779201:  Hold'em No Limit ($0.25/$0.50 USD) - 2016/02/11 13:07:20 CET [2016/02/11 7:07:20 ET]
Table 'Stereoskopia' 9-max Seat #8 is the button
Seat 1: JJJ-K9 ($52.25 in chips) 
Seat 2: Optimistic21 ($53 in chips) 
Seat 3: Szevasztopol ($58.29 in chips) 
Seat 5: ReinisRNS ($47.27 in chips) 
Seat 6: matiko09 ($52.83 in chips) 
Seat 7: tallonn88 ($55.47 in chips) 
Seat 8: vlad11122007 ($47.75 in chips) 
Seat 9: xxxibgdrgn ($50.25 in chips) 
xxxibgdrgn: posts small blind $0.25
JJJ-K9: posts big blind $0.50
*** HOLE CARDS ***
Dealt to matiko09 [Ks 7d]
Optimistic21: folds 
Szevasztopol: folds 
ReinisRNS: folds 
matiko09: folds 
tallonn88: folds 
vlad11122007: raises $0.50 to $1
xxxibgdrgn: folds 
JJJ-K9: calls $0.50
*** FLOP *** [6h 9d 4h]
JJJ-K9: checks 
vlad11122007: bets $1.50
JJJ-K9: calls $1.50
*** TURN *** [6h 9d 4h] [Td]
JJJ-K9: checks 
vlad11122007: checks 
*** RIVER *** [6h 9d 4h Td] [Ah]
JJJ-K9: checks 
vlad11122007: checks 
*** SHOW DOWN ***
JJJ-K9: shows [3d 5d] (high card Ace)
vlad11122007: shows [5c 6d] (a pair of Sixes)
vlad11122007 collected $5.01 from pot
*** SUMMARY ***
Total pot $5.25 | Rake $0.24 
Board [6h 9d 4h Td Ah]
Seat 1: JJJ-K9 (big blind) showed [3d 5d] and lost with high card Ace
Seat 2: Optimistic21 folded before Flop (didn't bet)
Seat 3: Szevasztopol folded before Flop (didn't bet)
Seat 5: ReinisRNS folded before Flop (didn't bet)
Seat 6: matiko09 folded before Flop (didn't bet)
Seat 7: tallonn88 folded before Flop (didn't bet)
Seat 8: vlad11122007 (button) showed [5c 6d] and won ($5.01) with a pair of Sixes
Seat 9: xxxibgdrgn (small blind) folded before Flop





PokerStars Hand #148608782395:  Hold'em No Limit ($0.25/$0.50 USD) - 2016/02/11 13:07:26 CET [2016/02/11 7:07:26 ET]
Table 'Oenone' 9-max Seat #9 is the button
Seat 1: tallonn88 ($50 in chips) 
Seat 2: Reven9er ($50 in chips) 
Seat 3: Crazy_Giant1 ($41.59 in chips) 
Seat 4: Serhent ($50 in chips) 
Seat 5: ReinisRNS ($53.23 in chips) 
Seat 6: matiko09 ($51 in chips) 
Seat 7: banit7 ($53.25 in chips) 
Seat 8: vlad11122007 ($80.45 in chips) 
Seat 9: TheMinion ($140.88 in chips) 
tallonn88: posts small blind $0.25
Reven9er: posts big blind $0.50
*** HOLE CARDS ***
Dealt to matiko09 [5d 2s]
Crazy_Giant1: folds 
Serhent: folds 
ReinisRNS: folds 
matiko09: folds 
banit7: folds 
vlad11122007: folds 
TheMinion: raises $0.52 to $1.02
tallonn88: folds 
Reven9er: folds 
Uncalled bet ($0.52) returned to TheMinion
TheMinion collected $1.25 from pot
TheMinion: doesn't show hand 
*** SUMMARY ***
Total pot $1.25 | Rake $0 
Seat 1: tallonn88 (small blind) folded before Flop
Seat 2: Reven9er (big blind) folded before Flop
Seat 3: Crazy_Giant1 folded before Flop (didn't bet)
Seat 4: Serhent folded before Flop (didn't bet)
Seat 5: ReinisRNS folded before Flop (didn't bet)
Seat 6: matiko09 folded before Flop (didn't bet)
Seat 7: banit7 folded before Flop (didn't bet)
Seat 8: vlad11122007 folded before Flop (didn't bet)
Seat 9: TheMinion (button) collected ($1.25)





PokerStars Hand #148608789806:  Hold'em No Limit ($0.25/$0.50 USD) - 2016/02/11 13:07:38 CET [2016/02/11 7:07:38 ET]
Table 'Algedi' 9-max Seat #7 is the button
Seat 1: vlad11122007 ($74.17 in chips) 
Seat 2: Reffypaul ($54.91 in chips) 
Seat 3: Saggitaurus ($126.79 in chips) 
Seat 4: Effort92 ($58.86 in chips) 
Seat 5: Optimistic21 ($56.53 in chips) 
Seat 6: TonnaMunz ($102.44 in chips) 
Seat 7: hoedtrob ($60.51 in chips) 
Seat 8: matiko09 ($50 in chips) 
matiko09: posts small blind $0.25
Kud3: is sitting out 
Kud3 leaves the table
vlad11122007: posts big blind $0.50
vlad11122007: posts the ante $0.10
Reffypaul: posts the ante $0.10
Saggitaurus: posts the ante $0.10
Effort92: posts the ante $0.10
Optimistic21: posts the ante $0.10
TonnaMunz: posts the ante $0.10
hoedtrob: posts the ante $0.10
matiko09: posts the ante $0.10
*** HOLE CARDS ***
Dealt to matiko09 [Kc 5s]
Reffypaul: raises $0.50 to $1
Saggitaurus: folds 
Effort92: folds 
Optimistic21: folds 
TonnaMunz: raises $3.50 to $4.50
hoedtrob: folds 
matiko09: folds 
vlad11122007: folds 
Reffypaul: calls $3.50
*** FLOP *** [2d Qd Tc]
Reffypaul: checks 
TonnaMunz: bets $5
Reffypaul: folds 
Uncalled bet ($5) returned to TonnaMunz
TonnaMunz collected $10.08 from pot
*** SUMMARY ***
Total pot $10.55 | Rake $0.47 
Board [2d Qd Tc]
Seat 1: vlad11122007 (big blind) folded before Flop
Seat 2: Reffypaul folded on the Flop
Seat 3: Saggitaurus folded before Flop (didn't bet)
Seat 4: Effort92 folded before Flop (didn't bet)
Seat 5: Optimistic21 folded before Flop (didn't bet)
Seat 6: TonnaMunz collected ($10.08)
Seat 7: hoedtrob (button) folded before Flop (didn't bet)
Seat 8: matiko09 (small blind) folded before Flop





PokerStars Hand #148608791849:  Hold'em No Limit ($0.50/$1.00 USD) - 2016/02/11 13:07:42 CET [2016/02/11 7:07:42 ET]
Table 'Aoluta' 9-max Seat #8 is the button
Seat 1: sebaaastian ($100 in chips) 
Seat 2: matiko09 ($101.02 in chips) 
Seat 3: Zeeshka ($105.60 in chips) 
Seat 4: oscarleon ($180.26 in chips) 
Seat 5: aseban11 ($100 in chips) 
Seat 6: Luck In Me ($108.50 in chips) 
Seat 7: grigy197 ($79.60 in chips) 
Seat 8: mrspecial1 ($58 in chips) 
sebaaastian: posts small blind $0.50
matiko09: posts big blind $1
*** HOLE CARDS ***
Dealt to matiko09 [4s 4h]
Zeeshka: folds 
oscarleon: folds 
aseban11: folds 
Luck In Me: folds 
grigy197: raises $1 to $2
mrspecial1: folds 
sebaaastian: folds 
matiko09: calls $1
*** FLOP *** [9d Qs 3c]
matiko09: checks 
grigy197: bets $3
matiko09: folds 
Uncalled bet ($3) returned to grigy197
grigy197 collected $4.30 from pot
*** SUMMARY ***
Total pot $4.50 | Rake $0.20 
Board [9d Qs 3c]
Seat 1: sebaaastian (small blind) folded before Flop
Seat 2: matiko09 (big blind) folded on the Flop
Seat 3: Zeeshka folded before Flop (didn't bet)
Seat 4: oscarleon folded before Flop (didn't bet)
Seat 5: aseban11 folded before Flop (didn't bet)
Seat 6: Luck In Me folded before Flop (didn't bet)
Seat 7: grigy197 collected ($4.30)
Seat 8: mrspecial1 (button) folded before Flop (didn't bet)





PokerStars Hand #148608793921:  Hold'em No Limit ($0.50/$1.00 USD) - 2016/02/11 13:07:45 CET [2016/02/11 7:07:45 ET]
Table 'Stephano V' 9-max Seat #4 is the button
Seat 1: hammerwife ($100 in chips) 
Seat 2: matiko09 ($134.01 in chips) 
Seat 3: sebaaastian ($100 in chips) 
Seat 4: Zeeshka ($100 in chips) 
Seat 5: n2call ($174.40 in chips) 
Seat 7: hurtNCYDE ($123.04 in chips) 
Seat 8: oscarleon ($220.23 in chips) 
n2call: posts small blind $0.50
Sweden_Pound: is sitting out 
hurtNCYDE: posts big blind $1
*** HOLE CARDS ***
Dealt to matiko09 [Kc 4h]
oscarleon: folds 
hammerwife: folds 
matiko09: folds 
sebaaastian: folds 
Zeeshka: raises $1.50 to $2.50
n2call: raises $6 to $8.50
hurtNCYDE: calls $7.50
Zeeshka: calls $6
*** FLOP *** [Jc Jh Qd]
n2call: checks 
hurtNCYDE: bets $11.50
Zeeshka: calls $11.50
n2call: folds 
*** TURN *** [Jc Jh Qd] [7c]
hurtNCYDE: checks 
Zeeshka: checks 
*** RIVER *** [Jc Jh Qd 7c] [4s]
hurtNCYDE: checks 
Zeeshka: bets $21.50
hurtNCYDE: folds 
Uncalled bet ($21.50) returned to Zeeshka
Zeeshka collected $46.32 from pot
Zeeshka: doesn't show hand 
*** SUMMARY ***
Total pot $48.50 | Rake $2.18 
Board [Jc Jh Qd 7c 4s]
Seat 1: hammerwife folded before Flop (didn't bet)
Seat 2: matiko09 folded before Flop (didn't bet)
Seat 3: sebaaastian folded before Flop (didn't bet)
Seat 4: Zeeshka (button) collected ($46.32)
Seat 5: n2call (small blind) folded on the Flop
Seat 7: hurtNCYDE (big blind) folded on the River
Seat 8: oscarleon folded before Flop (didn't bet)





PokerStars Hand #148608807629:  Hold'em No Limit ($0.50/$1.00 USD) - 2016/02/11 13:08:09 CET [2016/02/11 7:08:09 ET]
Table 'Marion' 9-max Seat #2 is the button
Seat 1: aseban11 ($100 in chips) 
Seat 2: GusenokRUS ($97.05 in chips) 
Seat 3: TimStone ($106.46 in chips) 
Seat 4: matiko09 ($100 in chips) 
Seat 5: Rikti ($50.01 in chips) 
Seat 7: oscarleon ($101.50 in chips) 
Seat 9: Zeeshka ($100 in chips) 
TimStone: posts small blind $0.50
matiko09: posts big blind $1
19SERGE74: sits out 
*** HOLE CARDS ***
Dealt to matiko09 [Ah 3s]
Rikti: folds 
oscarleon: folds 
Zeeshka: folds 
aseban11: folds 
GusenokRUS: raises $2 to $3
TimStone: folds 
matiko09: folds 
Uncalled bet ($2) returned to GusenokRUS
GusenokRUS collected $2.50 from pot
GusenokRUS: doesn't show hand 
*** SUMMARY ***
Total pot $2.50 | Rake $0 
Seat 1: aseban11 folded before Flop (didn't bet)
Seat 2: GusenokRUS (button) collected ($2.50)
Seat 3: TimStone (small blind) folded before Flop
Seat 4: matiko09 (big blind) folded before Flop
Seat 5: Rikti folded before Flop (didn't bet)
Seat 7: oscarleon folded before Flop (didn't bet)
Seat 9: Zeeshka folded before Flop (didn't bet)





PokerStars Hand #148608808616:  Hold'em No Limit ($0.25/$0.50 USD) - 2016/02/11 13:08:11 CET [2016/02/11 7:08:11 ET]
Table 'Oenone' 9-max Seat #1 is the button
Seat 1: tallonn88 ($50 in chips) 
Seat 2: Reven9er ($50 in chips) 
Seat 3: Crazy_Giant1 ($41.59 in chips) 
Seat 4: Serhent ($50 in chips) 
Seat 5: ReinisRNS ($53.23 in chips) 
Seat 6: matiko09 ($51 in chips) 
Seat 7: banit7 ($53.25 in chips) 
Seat 8: vlad11122007 ($80.45 in chips) 
Seat 9: TheMinion ($141.63 in chips) 
Reven9er: posts small blind $0.25
Crazy_Giant1: posts big blind $0.50
*** HOLE CARDS ***
Dealt to matiko09 [5s 4c]
Serhent: raises $1 to $1.50
ReinisRNS: calls $1.50
matiko09: folds 
banit7: folds 
vlad11122007: folds 
TheMinion: folds 
tallonn88: raises $4.50 to $6
Reven9er: folds 
Crazy_Giant1: folds 
Serhent: folds 
ReinisRNS: folds 
Uncalled bet ($4.50) returned to tallonn88
tallonn88 collected $5.25 from pot
tallonn88: doesn't show hand 
*** SUMMARY ***
Total pot $5.25 | Rake $0 
Seat 1: tallonn88 (button) collected ($5.25)
Seat 2: Reven9er (small blind) folded before Flop
Seat 3: Crazy_Giant1 (big blind) folded before Flop
Seat 4: Serhent folded before Flop
Seat 5: ReinisRNS folded before Flop
Seat 6: matiko09 folded before Flop (didn't bet)
Seat 7: banit7 folded before Flop (didn't bet)
Seat 8: vlad11122007 folded before Flop (didn't bet)
Seat 9: TheMinion folded before Flop (didn't bet)





PokerStars Hand #148608815171:  Hold'em No Limit (€0.25/€0.50 EUR) - 2016/02/11 13:08:22 CET [2016/02/11 7:08:22 ET]
Table 'Otero II' 9-max Seat #3 is the button
Seat 2: Dantist1122 (€50 in chips) 
Seat 3: Szevasztopol (€50 in chips) 
Seat 4: kram0909 (€4.08 in chips) 
Seat 5: vlad11122007 (€50.19 in chips) 
Seat 6: TonnaMunz (€50.60 in chips) 
Seat 7: Dflingern95 (€49 in chips) 
Seat 8: matiko09 (€72.18 in chips) 
Seat 9: Optimistic21 (€75.16 in chips) 
kram0909: posts small blind €0.25
vlad11122007: posts big blind €0.50
*** HOLE CARDS ***
Dealt to matiko09 [7c Kc]
TonnaMunz: folds 
Dflingern95: calls €0.50
matiko09: folds 
Optimistic21: raises €1.50 to €2
Dantist1122: folds 
Szevasztopol: folds 
kram0909: folds 
vlad11122007: folds 
Dflingern95: calls €1.50
*** FLOP *** [9c 7h Qs]
Dflingern95: bets €2.50
Optimistic21: calls €2.50
*** TURN *** [9c 7h Qs] [2d]
Dflingern95: bets €5.50
Optimistic21: calls €5.50
*** RIVER *** [9c 7h Qs 2d] [3d]
Dflingern95: checks 
Optimistic21: checks 
*** SHOW DOWN ***
Dflingern95: shows [Qd Ad] (a pair of Queens)
Optimistic21: mucks hand 
Dflingern95 collected €19.82 from pot
*** SUMMARY ***
Total pot €20.75 | Rake €0.93 
Board [9c 7h Qs 2d 3d]
Seat 2: Dantist1122 folded before Flop (didn't bet)
Seat 3: Szevasztopol (button) folded before Flop (didn't bet)
Seat 4: kram0909 (small blind) folded before Flop
Seat 5: vlad11122007 (big blind) folded before Flop
Seat 6: TonnaMunz folded before Flop (didn't bet)
Seat 7: Dflingern95 showed [Qd Ad] and won (€19.82) with a pair of Queens
Seat 8: matiko09 folded before Flop (didn't bet)
Seat 9: Optimistic21 mucked [Qh Jh]





PokerStars Hand #148608819328:  Hold'em No Limit ($0.50/$1.00 USD) - 2016/02/11 13:08:30 CET [2016/02/11 7:08:30 ET]
Table 'Aoluta' 9-max Seat #1 is the button
Seat 1: sebaaastian ($100 in chips) 
Seat 2: matiko09 ($100 in chips) 
Seat 3: Zeeshka ($105.60 in chips) 
Seat 4: oscarleon ($180.26 in chips) 
Seat 5: aseban11 ($100 in chips) 
Seat 6: Luck In Me ($108.50 in chips) 
Seat 7: grigy197 ($81.90 in chips) 
Seat 8: mrspecial1 ($58 in chips) 
matiko09: posts small blind $0.50
Zeeshka: posts big blind $1
*** HOLE CARDS ***
Dealt to matiko09 [Qc 5h]
oscarleon: folds 
aseban11: folds 
Luck In Me: folds 
grigy197: folds 
mrspecial1: folds 
sebaaastian: raises $1.50 to $2.50
matiko09: folds 
Zeeshka: folds 
Uncalled bet ($1.50) returned to sebaaastian
sebaaastian collected $2.50 from pot
sebaaastian: doesn't show hand 
*** SUMMARY ***
Total pot $2.50 | Rake $0 
Seat 1: sebaaastian (button) collected ($2.50)
Seat 2: matiko09 (small blind) folded before Flop
Seat 3: Zeeshka (big blind) folded before Flop
Seat 4: oscarleon folded before Flop (didn't bet)
Seat 5: aseban11 folded before Flop (didn't bet)
Seat 6: Luck In Me folded before Flop (didn't bet)
Seat 7: grigy197 folded before Flop (didn't bet)
Seat 8: mrspecial1 folded before Flop (didn't bet)





PokerStars Hand #148608826457:  Hold'em No Limit ($0.25/$0.50 USD) - 2016/02/11 13:08:42 CET [2016/02/11 7:08:42 ET]
Table 'Algedi' 9-max Seat #8 is the button
Seat 1: vlad11122007 ($73.57 in chips) 
Seat 2: Reffypaul ($50.31 in chips) 
Seat 3: Saggitaurus ($126.69 in chips) 
Seat 4: Effort92 ($58.76 in chips) 
Seat 5: Optimistic21 ($56.43 in chips) 
Seat 6: TonnaMunz ($107.92 in chips) 
Seat 7: hoedtrob ($60.41 in chips) 
Seat 8: matiko09 ($50 in chips) 
vlad11122007: posts small blind $0.25
Reffypaul: posts big blind $0.50
vlad11122007: posts the ante $0.10
Reffypaul: posts the ante $0.10
Saggitaurus: posts the ante $0.10
Effort92: posts the ante $0.10
Optimistic21: posts the ante $0.10
TonnaMunz: posts the ante $0.10
hoedtrob: posts the ante $0.10
matiko09: posts the ante $0.10
*** HOLE CARDS ***
Dealt to matiko09 [Qd Qs]
Saggitaurus: folds 
Effort92: folds 
Optimistic21: folds 
TonnaMunz: calls $0.50
hoedtrob: folds 
matiko09: raises $1.50 to $2
vlad11122007: raises $3.75 to $5.75
Reffypaul: calls $5.25
TonnaMunz: folds 
matiko09: raises $8.75 to $14.50
vlad11122007: folds 
Reffypaul: calls $8.75
*** FLOP *** [Ad 4h 3c]
Reffypaul: checks 
matiko09: checks 
*** TURN *** [Ad 4h 3c] [Qc]
Reffypaul: bets $17.21
matiko09: calls $17.21
*** RIVER *** [Ad 4h 3c Qc] [Jd]
Reffypaul: checks 
matiko09: bets $18.19 and is all-in
Reffypaul: calls $18.19
*** SHOW DOWN ***
matiko09: shows [Qd Qs] (three of a kind, Queens)
Reffypaul: mucks hand 
matiko09 collected $104.35 from pot
*** SUMMARY ***
Total pot $106.85 | Rake $2.50 
Board [Ad 4h 3c Qc Jd]
Seat 1: vlad11122007 (small blind) folded before Flop
Seat 2: Reffypaul (big blind) mucked [Qh Kd]
Seat 3: Saggitaurus folded before Flop (didn't bet)
Seat 4: Effort92 folded before Flop (didn't bet)
Seat 5: Optimistic21 folded before Flop (didn't bet)
Seat 6: TonnaMunz folded before Flop
Seat 7: hoedtrob folded before Flop (didn't bet)
Seat 8: matiko09 (button) showed [Qd Qs] and won ($104.35) with three of a kind, Queens





PokerStars Hand #148608829626:  Hold'em No Limit ($0.25/$0.50 USD) - 2016/02/11 13:08:47 CET [2016/02/11 7:08:47 ET]
Table 'Ambrosia II' 9-max Seat #1 is the button
Seat 1: matiko09 ($50 in chips) 
Seat 2: TheMinion ($130.81 in chips) 
Seat 3: make6a ($82.01 in chips) 
Seat 4: huudk2016 ($48.30 in chips) 
Seat 5: RICKA16 ($49.50 in chips) 
Seat 6: Reven9er ($58.77 in chips) 
Seat 7: Ana.Satravca ($50 in chips) 
Seat 9: arctur17 ($55.32 in chips) 
TheMinion: posts small blind $0.25
make6a: posts big blind $0.50
tallonn88: sits out 
*** HOLE CARDS ***
Dealt to matiko09 [Ad Qc]
huudk2016: calls $0.50
RICKA16: folds 
Reven9er: folds 
Ana.Satravca: folds 
arctur17: folds 
matiko09: raises $1.50 to $2
TheMinion: folds 
make6a: folds 
huudk2016: calls $1.50
*** FLOP *** [As Jd 2c]
huudk2016: checks 
matiko09: bets $2.95
huudk2016: folds 
Uncalled bet ($2.95) returned to matiko09
matiko09 collected $4.54 from pot
matiko09: doesn't show hand 
*** SUMMARY ***
Total pot $4.75 | Rake $0.21 
Board [As Jd 2c]
Seat 1: matiko09 (button) collected ($4.54)
Seat 2: TheMinion (small blind) folded before Flop
Seat 3: make6a (big blind) folded before Flop
Seat 4: huudk2016 folded on the Flop
Seat 5: RICKA16 folded before Flop (didn't bet)
Seat 6: Reven9er folded before Flop (didn't bet)
Seat 7: Ana.Satravca folded before Flop (didn't bet)
Seat 9: arctur17 folded before Flop (didn't bet)





PokerStars Hand #148608830759:  Hold'em No Limit ($0.50/$1.00 USD) - 2016/02/11 13:08:49 CET [2016/02/11 7:08:49 ET]
Table 'Gianfar' 9-max Seat #7 is the button
Seat 1: sebaaastian ($232.81 in chips) 
Seat 2: bilukm ($99 in chips) 
Seat 3: AlKatrone ($112.83 in chips) 
Seat 4: matiko09 ($100 in chips) 
Seat 5: hammerwife ($175.79 in chips) 
Seat 7: Rikti ($38 in chips) 
Seat 8: Zeeshka ($100 in chips) 
Seat 9: oscarleon ($148.16 in chips) 
Zeeshka: posts small blind $0.50
oscarleon: posts big blind $1
*** HOLE CARDS ***
Dealt to matiko09 [Ac 2h]
sebaaastian: raises $2 to $3
bilukm: folds 
AlKatrone: folds 
matiko09: folds 
hammerwife: folds 
Rikti: folds 
Zeeshka: folds 
oscarleon: folds 
Uncalled bet ($2) returned to sebaaastian
sebaaastian collected $2.50 from pot
sebaaastian: doesn't show hand 
*** SUMMARY ***
Total pot $2.50 | Rake $0 
Seat 1: sebaaastian collected ($2.50)
Seat 2: bilukm folded before Flop (didn't bet)
Seat 3: AlKatrone folded before Flop (didn't bet)
Seat 4: matiko09 folded before Flop (didn't bet)
Seat 5: hammerwife folded before Flop (didn't bet)
Seat 7: Rikti (button) folded before Flop (didn't bet)
Seat 8: Zeeshka (small blind) folded before Flop
Seat 9: oscarleon (big blind) folded before Flop





PokerStars Hand #148608831348:  Hold'em No Limit ($0.25/$0.50 USD) - 2016/02/11 13:08:50 CET [2016/02/11 7:08:50 ET]
Table 'Sylvania II' 9-max Seat #8 is the button
Seat 1: tw0315 ($82.32 in chips) 
Seat 2: Effort92 ($62.99 in chips) 
Seat 3: ruyingren ($195.58 in chips) 
Seat 4: matiko09 ($149.29 in chips) 
Seat 5: vlad11122007 ($58.89 in chips) 
Seat 6: TonnaMunz ($131.11 in chips) 
Seat 7: 2lefthand75 ($89.02 in chips) 
Seat 8: Optimistic21 ($50 in chips) 
tw0315: posts small blind $0.25
Effort92: posts big blind $0.50
tw0315: posts the ante $0.10
Effort92: posts the ante $0.10
ruyingren: posts the ante $0.10
matiko09: posts the ante $0.10
vlad11122007: posts the ante $0.10
TonnaMunz: posts the ante $0.10
2lefthand75: posts the ante $0.10
Optimistic21: posts the ante $0.10
*** HOLE CARDS ***
Dealt to matiko09 [Ac 8h]
ruyingren: folds 
matiko09: folds 
vlad11122007: folds 
TonnaMunz: folds 
2lefthand75: folds 
Optimistic21: folds 
tw0315: folds 
Uncalled bet ($0.25) returned to Effort92
Effort92 collected $1.30 from pot
Yippiebeans joins the table at seat #9 
Effort92: doesn't show hand 
*** SUMMARY ***
Total pot $1.30 | Rake $0 
Seat 1: tw0315 (small blind) folded before Flop
Seat 2: Effort92 (big blind) collected ($1.30)
Seat 3: ruyingren folded before Flop (didn't bet)
Seat 4: matiko09 folded before Flop (didn't bet)
Seat 5: vlad11122007 folded before Flop (didn't bet)
Seat 6: TonnaMunz folded before Flop (didn't bet)
Seat 7: 2lefthand75 folded before Flop (didn't bet)
Seat 8: Optimistic21 (button) folded before Flop (didn't bet)





PokerStars Hand #148608831716:  Hold'em No Limit ($0.50/$1.00 USD) - 2016/02/11 13:08:51 CET [2016/02/11 7:08:51 ET]
Table 'Aoluta' 9-max Seat #2 is the button
Seat 1: sebaaastian ($101.50 in chips) 
Seat 2: matiko09 ($100 in chips) 
Seat 3: Zeeshka ($104.60 in chips) 
Seat 4: oscarleon ($180.26 in chips) 
Seat 5: aseban11 ($100 in chips) 
Seat 6: Luck In Me ($108.50 in chips) 
Seat 7: grigy197 ($81.90 in chips) 
Seat 8: mrspecial1 ($58 in chips) 
Zeeshka: posts small blind $0.50
oscarleon: posts big blind $1
*** HOLE CARDS ***
Dealt to matiko09 [7d Ah]
aseban11: folds 
Luck In Me: folds 
grigy197: calls $1
mrspecial1: folds 
sebaaastian: folds 
matiko09: raises $3 to $4
Zeeshka: folds 
oscarleon: folds 
grigy197: calls $3
*** FLOP *** [As 3c 3s]
grigy197: checks 
matiko09: bets $5.90
grigy197: calls $5.90
*** TURN *** [As 3c 3s] [Kc]
grigy197: checks 
matiko09: checks 
*** RIVER *** [As 3c 3s Kc] [Kd]
grigy197: bets $1
matiko09: calls $1
*** SHOW DOWN ***
grigy197: shows [3d Ad] (a full house, Threes full of Aces)
matiko09: mucks hand 
grigy197 collected $22.25 from pot
*** SUMMARY ***
Total pot $23.30 | Rake $1.05 
Board [As 3c 3s Kc Kd]
Seat 1: sebaaastian folded before Flop (didn't bet)
Seat 2: matiko09 (button) mucked [7d Ah]
Seat 3: Zeeshka (small blind) folded before Flop
Seat 4: oscarleon (big blind) folded before Flop
Seat 5: aseban11 folded before Flop (didn't bet)
Seat 6: Luck In Me folded before Flop (didn't bet)
Seat 7: grigy197 showed [3d Ad] and won ($22.25) with a full house, Threes full of Aces
Seat 8: mrspecial1 folded before Flop (didn't bet)





PokerStars Hand #148608832184:  Hold'em No Limit ($0.50/$1.00 USD) - 2016/02/11 13:08:52 CET [2016/02/11 7:08:52 ET]
Table 'Marion' 9-max Seat #3 is the button
Seat 1: aseban11 ($100 in chips) 
Seat 2: GusenokRUS ($98.55 in chips) 
Seat 3: TimStone ($105.96 in chips) 
Seat 4: matiko09 ($100 in chips) 
Seat 5: Rikti ($50.01 in chips) 
Seat 7: oscarleon ($101.50 in chips) 
Seat 9: Zeeshka ($100 in chips) 
matiko09: posts small blind $0.50
Rikti: posts big blind $1
19SERGE74: sits out 
*** HOLE CARDS ***
Dealt to matiko09 [4h 9c]
oscarleon: folds 
Zeeshka: folds 
aseban11: folds 
GusenokRUS: folds 
TimStone: folds 
matiko09: folds 
Uncalled bet ($0.50) returned to Rikti
Rikti collected $1 from pot
Rikti: doesn't show hand 
*** SUMMARY ***
Total pot $1 | Rake $0 
Seat 1: aseban11 folded before Flop (didn't bet)
Seat 2: GusenokRUS folded before Flop (didn't bet)
Seat 3: TimStone (button) folded before Flop (didn't bet)
Seat 4: matiko09 (small blind) folded before Flop
Seat 5: Rikti (big blind) collected ($1)
Seat 7: oscarleon folded before Flop (didn't bet)
Seat 9: Zeeshka folded before Flop (didn't bet)





PokerStars Hand #148608833693:  Hold'em No Limit ($0.25/$0.50 USD) - 2016/02/11 13:08:54 CET [2016/02/11 7:08:54 ET]
Table 'Oenone' 9-max Seat #2 is the button
Seat 1: tallonn88 ($53.75 in chips) 
Seat 2: Reven9er ($50 in chips) 
Seat 3: Crazy_Giant1 ($41.09 in chips) 
Seat 4: Serhent ($50 in chips) 
Seat 5: ReinisRNS ($51.73 in chips) 
Seat 6: matiko09 ($51 in chips) 
Seat 7: banit7 ($53.25 in chips) 
Seat 8: vlad11122007 ($80.45 in chips) 
Seat 9: TheMinion ($141.63 in chips) 
Crazy_Giant1: posts small blind $0.25
Serhent: posts big blind $0.50
*** HOLE CARDS ***
Dealt to matiko09 [9d 6s]
ReinisRNS: calls $0.50
matiko09: folds 
banit7: folds 
vlad11122007: folds 
TheMinion: folds 
tallonn88: folds 
Reven9er: raises $0.75 to $1.25
Crazy_Giant1: calls $1
Serhent: folds 
ReinisRNS: calls $0.75
*** FLOP *** [Qc Qh 9h]
Crazy_Giant1: bets $1.50
ReinisRNS: calls $1.50
Reven9er: calls $1.50
*** TURN *** [Qc Qh 9h] [7c]
Crazy_Giant1: checks 
ReinisRNS: bets $2.50
Reven9er: folds 
Crazy_Giant1: folds 
Uncalled bet ($2.50) returned to ReinisRNS
ReinisRNS collected $8.36 from pot
ReinisRNS: doesn't show hand 
*** SUMMARY ***
Total pot $8.75 | Rake $0.39 
Board [Qc Qh 9h 7c]
Seat 1: tallonn88 folded before Flop (didn't bet)
Seat 2: Reven9er (button) folded on the Turn
Seat 3: Crazy_Giant1 (small blind) folded on the Turn
Seat 4: Serhent (big blind) folded before Flop
Seat 5: ReinisRNS collected ($8.36)
Seat 6: matiko09 folded before Flop (didn't bet)
Seat 7: banit7 folded before Flop (didn't bet)
Seat 8: vlad11122007 folded before Flop (didn't bet)
Seat 9: TheMinion folded before Flop (didn't bet)





PokerStars Hand #148608833671:  Hold'em No Limit ($0.50/$1.00 USD) - 2016/02/11 13:08:54 CET [2016/02/11 7:08:54 ET]
Table 'Clorinde' 9-max Seat #3 is the button
Seat 1: matiko09 ($100 in chips) 
Seat 2: 19SERGE74 ($80 in chips) 
Seat 3: gabi_igna ($101 in chips) 
Seat 5: Mukhin1 ($100 in chips) 
Seat 6: Gcroc52 ($40 in chips) 
Seat 7: Zeeshka ($100 in chips) 
Seat 8: aseban11 ($100 in chips) 
Seat 9: buttonlife ($40 in chips) 
Mukhin1: posts small blind $0.50
Gcroc52: posts big blind $1
*** HOLE CARDS ***
Dealt to matiko09 [4d 8d]
Zeeshka: folds 
aseban11: folds 
buttonlife: folds 
matiko09: folds 
19SERGE74: folds 
gabi_igna: raises $1.50 to $2.50
Mukhin1: folds 
Gcroc52: folds 
Uncalled bet ($1.50) returned to gabi_igna
gabi_igna collected $2.50 from pot
gabi_igna: doesn't show hand 
*** SUMMARY ***
Total pot $2.50 | Rake $0 
Seat 1: matiko09 folded before Flop (didn't bet)
Seat 2: 19SERGE74 folded before Flop (didn't bet)
Seat 3: gabi_igna (button) collected ($2.50)
Seat 5: Mukhin1 (small blind) folded before Flop
Seat 6: Gcroc52 (big blind) folded before Flop
Seat 7: Zeeshka folded before Flop (didn't bet)
Seat 8: aseban11 folded before Flop (didn't bet)
Seat 9: buttonlife folded before Flop (didn't bet)





PokerStars Hand #148608837608:  Hold'em No Limit ($0.25/$0.50 USD) - 2016/02/11 13:09:01 CET [2016/02/11 7:09:01 ET]
Table 'Stereoskopia' 9-max Seat #9 is the button
Seat 1: JJJ-K9 ($49.75 in chips) 
Seat 2: Optimistic21 ($53 in chips) 
Seat 3: Szevasztopol ($58.29 in chips) 
Seat 5: ReinisRNS ($47.27 in chips) 
Seat 6: matiko09 ($52.83 in chips) 
Seat 7: tallonn88 ($55.47 in chips) 
Seat 8: vlad11122007 ($50.26 in chips) 
Seat 9: xxxibgdrgn ($50 in chips) 
JJJ-K9: posts small blind $0.25
Optimistic21: posts big blind $0.50
*** HOLE CARDS ***
Dealt to matiko09 [5d Jh]
Szevasztopol: folds 
ReinisRNS: folds 
matiko09: folds 
tallonn88: folds 
vlad11122007: raises $1 to $1.50
xxxibgdrgn: folds 
JJJ-K9: folds 
Optimistic21: folds 
Uncalled bet ($1) returned to vlad11122007
vlad11122007 collected $1.25 from pot
vlad11122007: doesn't show hand 
*** SUMMARY ***
Total pot $1.25 | Rake $0 
Seat 1: JJJ-K9 (small blind) folded before Flop
Seat 2: Optimistic21 (big blind) folded before Flop
Seat 3: Szevasztopol folded before Flop (didn't bet)
Seat 5: ReinisRNS folded before Flop (didn't bet)
Seat 6: matiko09 folded before Flop (didn't bet)
Seat 7: tallonn88 folded before Flop (didn't bet)
Seat 8: vlad11122007 collected ($1.25)
Seat 9: xxxibgdrgn (button) folded before Flop (didn't bet)





PokerStars Hand #148608842849:  Hold'em No Limit ($0.50/$1.00 USD) - 2016/02/11 13:09:10 CET [2016/02/11 7:09:10 ET]
Table 'Gianfar' 9-max Seat #8 is the button
Seat 1: sebaaastian ($234.31 in chips) 
Seat 2: bilukm ($99 in chips) 
Seat 3: AlKatrone ($112.83 in chips) 
Seat 4: matiko09 ($100 in chips) 
Seat 5: hammerwife ($175.79 in chips) 
Seat 7: Rikti ($38 in chips) 
Seat 8: Zeeshka ($100 in chips) 
Seat 9: oscarleon ($147.16 in chips) 
oscarleon: posts small blind $0.50
sebaaastian: posts big blind $1
*** HOLE CARDS ***
Dealt to matiko09 [Qd 9c]
bilukm: calls $1
AlKatrone: folds 
matiko09: folds 
hammerwife: folds 
Rikti: folds 
Zeeshka: folds 
oscarleon: folds 
sebaaastian: checks 
*** FLOP *** [Jd 7s Td]
sebaaastian: checks 
bilukm: checks 
*** TURN *** [Jd 7s Td] [8d]
sebaaastian: checks 
bilukm: bets $1
sebaaastian: folds 
Uncalled bet ($1) returned to bilukm
bilukm collected $2.39 from pot
bilukm: doesn't show hand 
*** SUMMARY ***
Total pot $2.50 | Rake $0.11 
Board [Jd 7s Td 8d]
Seat 1: sebaaastian (big blind) folded on the Turn
Seat 2: bilukm collected ($2.39)
Seat 3: AlKatrone folded before Flop (didn't bet)
Seat 4: matiko09 folded before Flop (didn't bet)
Seat 5: hammerwife folded before Flop (didn't bet)
Seat 7: Rikti folded before Flop (didn't bet)
Seat 8: Zeeshka (button) folded before Flop (didn't bet)
Seat 9: oscarleon (small blind) folded before Flop





PokerStars Hand #148608848210:  Hold'em No Limit ($0.50/$1.00 USD) - 2016/02/11 13:09:20 CET [2016/02/11 7:09:20 ET]
Table 'Marion' 9-max Seat #4 is the button
Seat 1: aseban11 ($100 in chips) 
Seat 2: GusenokRUS ($98.55 in chips) 
Seat 3: TimStone ($105.96 in chips) 
Seat 4: matiko09 ($100 in chips) 
Seat 5: Rikti ($50.51 in chips) 
Seat 6: 19SERGE74 ($80 in chips) 
Seat 7: oscarleon ($101.50 in chips) 
Seat 9: Zeeshka ($100 in chips) 
Rikti: posts small blind $0.50
19SERGE74: posts big blind $1
*** HOLE CARDS ***
Dealt to matiko09 [As Jd]
oscarleon: folds 
Zeeshka: raises $2 to $3
aseban11: folds 
GusenokRUS: folds 
TimStone: folds 
matiko09: folds 
Rikti: folds 
19SERGE74: folds 
Uncalled bet ($2) returned to Zeeshka
Zeeshka collected $2.50 from pot
Zeeshka: doesn't show hand 
*** SUMMARY ***
Total pot $2.50 | Rake $0 
Seat 1: aseban11 folded before Flop (didn't bet)
Seat 2: GusenokRUS folded before Flop (didn't bet)
Seat 3: TimStone folded before Flop (didn't bet)
Seat 4: matiko09 (button) folded before Flop (didn't bet)
Seat 5: Rikti (small blind) folded before Flop
Seat 6: 19SERGE74 (big blind) folded before Flop
Seat 7: oscarleon folded before Flop (didn't bet)
Seat 9: Zeeshka collected ($2.50)





PokerStars Hand #148608850213:  Hold'em No Limit ($0.25/$0.50 USD) - 2016/02/11 13:09:23 CET [2016/02/11 7:09:23 ET]
Table 'Sylvania II' 9-max Seat #1 is the button
Seat 1: tw0315 ($81.97 in chips) 
Seat 2: Effort92 ($63.94 in chips) 
Seat 3: ruyingren ($195.48 in chips) 
Seat 4: matiko09 ($149.19 in chips) 
Seat 5: vlad11122007 ($58.79 in chips) 
Seat 6: TonnaMunz ($131.01 in chips) 
Seat 7: 2lefthand75 ($88.92 in chips) 
Seat 8: Optimistic21 ($50 in chips) 
Effort92: posts small blind $0.25
ruyingren: posts big blind $0.50
Yippiebeans: sits out 
tw0315: posts the ante $0.10
Effort92: posts the ante $0.10
ruyingren: posts the ante $0.10
matiko09: posts the ante $0.10
vlad11122007: posts the ante $0.10
TonnaMunz: posts the ante $0.10
2lefthand75: posts the ante $0.10
Optimistic21: posts the ante $0.10
*** HOLE CARDS ***
Dealt to matiko09 [Ah 6h]
matiko09: folds 
vlad11122007: folds 
TonnaMunz: folds 
2lefthand75: calls $0.50
Optimistic21: folds 
tw0315: calls $0.50
Effort92: folds 
ruyingren: checks 
*** FLOP *** [8c Th 7c]
ruyingren: checks 
2lefthand75: bets $1.22
tw0315: calls $1.22
ruyingren: calls $1.22
*** TURN *** [8c Th 7c] [3h]
ruyingren: checks 
2lefthand75: checks 
tw0315: checks 
*** RIVER *** [8c Th 7c 3h] [9c]
ruyingren: checks 
2lefthand75: checks 
tw0315: checks 
*** SHOW DOWN ***
ruyingren: shows [Js 5d] (a straight, Seven to Jack)
2lefthand75: mucks hand 
tw0315: shows [8h Jh] (a straight, Seven to Jack)
ruyingren collected $2.97 from pot
tw0315 collected $2.96 from pot
*** SUMMARY ***
Total pot $6.21 | Rake $0.28 
Board [8c Th 7c 3h 9c]
Seat 1: tw0315 (button) showed [8h Jh] and won ($2.96) with a straight, Seven to Jack
Seat 2: Effort92 (small blind) folded before Flop
Seat 3: ruyingren (big blind) showed [Js 5d] and won ($2.97) with a straight, Seven to Jack
Seat 4: matiko09 folded before Flop (didn't bet)
Seat 5: vlad11122007 folded before Flop (didn't bet)
Seat 6: TonnaMunz folded before Flop (didn't bet)
Seat 7: 2lefthand75 mucked [8s 4s]
Seat 8: Optimistic21 folded before Flop (didn't bet)





PokerStars Hand #148608862012:  Hold'em No Limit ($0.50/$1.00 USD) - 2016/02/11 13:09:44 CET [2016/02/11 7:09:44 ET]
Table 'Stephano V' 9-max Seat #5 is the button
Seat 1: hammerwife ($100 in chips) 
Seat 2: matiko09 ($134.01 in chips) 
Seat 3: sebaaastian ($100 in chips) 
Seat 4: Zeeshka ($126.32 in chips) 
Seat 5: n2call ($165.90 in chips) 
Seat 7: hurtNCYDE ($103.04 in chips) 
Seat 8: oscarleon ($220.23 in chips) 
Seat 9: IcocaynaI ($100 in chips) 
hurtNCYDE: posts small blind $0.50
oscarleon: posts big blind $1
*** HOLE CARDS ***
Dealt to matiko09 [Tc Qc]
IcocaynaI: calls $1
hammerwife: folds 
matiko09: raises $3 to $4
sebaaastian: folds 
Zeeshka: folds 
n2call: folds 
hurtNCYDE: folds 
oscarleon: folds 
IcocaynaI: calls $3
*** FLOP *** [5s 2d 7h]
IcocaynaI: bets $5
matiko09: folds 
Uncalled bet ($5) returned to IcocaynaI
IcocaynaI collected $9.07 from pot
IcocaynaI: doesn't show hand 
*** SUMMARY ***
Total pot $9.50 | Rake $0.43 
Board [5s 2d 7h]
Seat 1: hammerwife folded before Flop (didn't bet)
Seat 2: matiko09 folded on the Flop
Seat 3: sebaaastian folded before Flop (didn't bet)
Seat 4: Zeeshka folded before Flop (didn't bet)
Seat 5: n2call (button) folded before Flop (didn't bet)
Seat 7: hurtNCYDE (small blind) folded before Flop
Seat 8: oscarleon (big blind) folded before Flop
Seat 9: IcocaynaI collected ($9.07)





PokerStars Hand #148608863853:  Hold'em No Limit ($0.50/$1.00 USD) - 2016/02/11 13:09:47 CET [2016/02/11 7:09:47 ET]
Table 'Clorinde' 9-max Seat #5 is the button
Seat 1: matiko09 ($100 in chips) 
Seat 2: 19SERGE74 ($80 in chips) 
Seat 3: gabi_igna ($102.50 in chips) 
Seat 5: Mukhin1 ($100 in chips) 
Seat 6: Gcroc52 ($39 in chips) 
Seat 7: Zeeshka ($100 in chips) 
Seat 8: aseban11 ($100 in chips) 
Seat 9: buttonlife ($40 in chips) 
Gcroc52: posts small blind $0.50
Zeeshka: posts big blind $1
*** HOLE CARDS ***
Dealt to matiko09 [6c 3h]
aseban11: raises $2 to $3
buttonlife: folds 
matiko09: folds 
19SERGE74: folds 
gabi_igna: raises $6 to $9
Mukhin1: folds 
Gcroc52: folds 
Zeeshka: folds 
aseban11: calls $6
*** FLOP *** [Kh 2s 8d]
aseban11: checks 
gabi_igna: bets $10
aseban11: calls $10
*** TURN *** [Kh 2s 8d] [4d]
aseban11: checks 
gabi_igna: checks 
*** RIVER *** [Kh 2s 8d 4d] [8h]
aseban11: bets $16.50
gabi_igna: folds 
Uncalled bet ($16.50) returned to aseban11
aseban11 collected $37.72 from pot
aseban11: doesn't show hand 
*** SUMMARY ***
Total pot $39.50 | Rake $1.78 
Board [Kh 2s 8d 4d 8h]
Seat 1: matiko09 folded before Flop (didn't bet)
Seat 2: 19SERGE74 folded before Flop (didn't bet)
Seat 3: gabi_igna folded on the River
Seat 5: Mukhin1 (button) folded before Flop (didn't bet)
Seat 6: Gcroc52 (small blind) folded before Flop
Seat 7: Zeeshka (big blind) folded before Flop
Seat 8: aseban11 collected ($37.72)
Seat 9: buttonlife folded before Flop (didn't bet)





PokerStars Hand #148608865786:  Hold'em No Limit ($0.50/$1.00 USD) - 2016/02/11 13:09:50 CET [2016/02/11 7:09:50 ET]
Table 'Gianfar' 9-max Seat #9 is the button
Seat 1: sebaaastian ($233.31 in chips) 
Seat 2: bilukm ($100.39 in chips) 
Seat 3: AlKatrone ($112.83 in chips) 
Seat 4: matiko09 ($100 in chips) 
Seat 5: hammerwife ($175.79 in chips) 
Seat 7: Rikti ($38 in chips) 
Seat 8: Zeeshka ($100 in chips) 
Seat 9: oscarleon ($146.66 in chips) 
sebaaastian: posts small blind $0.50
bilukm: posts big blind $1
*** HOLE CARDS ***
Dealt to matiko09 [Qh Qd]
AlKatrone: folds 
matiko09: raises $2 to $3
hammerwife: folds 
Rikti: folds 
Zeeshka: folds 
oscarleon: folds 
sebaaastian: folds 
bilukm: calls $2
*** FLOP *** [8h Js Ts]
bilukm: bets $3.10
matiko09: raises $6.90 to $10
bilukm: calls $6.90
*** TURN *** [8h Js Ts] [Qc]
bilukm: bets $12.65
matiko09: calls $12.65
*** RIVER *** [8h Js Ts Qc] [7c]
bilukm: checks 
matiko09: checks 
*** SHOW DOWN ***
bilukm: shows [7s 3s] (a pair of Sevens)
matiko09: shows [Qh Qd] (three of a kind, Queens)
matiko09 collected $49.47 from pot
*** SUMMARY ***
Total pot $51.80 | Rake $2.33 
Board [8h Js Ts Qc 7c]
Seat 1: sebaaastian (small blind) folded before Flop
Seat 2: bilukm (big blind) showed [7s 3s] and lost with a pair of Sevens
Seat 3: AlKatrone folded before Flop (didn't bet)
Seat 4: matiko09 showed [Qh Qd] and won ($49.47) with three of a kind, Queens
Seat 5: hammerwife folded before Flop (didn't bet)
Seat 7: Rikti folded before Flop (didn't bet)
Seat 8: Zeeshka folded before Flop (didn't bet)
Seat 9: oscarleon (button) folded before Flop (didn't bet)





PokerStars Hand #148608866613:  Hold'em No Limit ($0.50/$1.00 USD) - 2016/02/11 13:09:52 CET [2016/02/11 7:09:52 ET]
Table 'Aoluta' 9-max Seat #3 is the button
Seat 1: sebaaastian ($101.50 in chips) 
Seat 2: matiko09 ($100 in chips) 
Seat 3: Zeeshka ($104.10 in chips) 
Seat 4: oscarleon ($179.26 in chips) 
Seat 5: aseban11 ($100 in chips) 
Seat 6: Luck In Me ($108.50 in chips) 
Seat 7: grigy197 ($93.25 in chips) 
Seat 8: mrspecial1 ($58 in chips) 
oscarleon: posts small blind $0.50
aseban11: posts big blind $1
*** HOLE CARDS ***
Dealt to matiko09 [2h Qc]
Luck In Me: folds 
grigy197: calls $1
mrspecial1: folds 
sebaaastian: raises $2 to $3
matiko09: folds 
Zeeshka: folds 
oscarleon: folds 
aseban11: folds 
grigy197: calls $2
*** FLOP *** [3h 5c Kh]
grigy197: checks 
sebaaastian: bets $4.72
grigy197: folds 
Uncalled bet ($4.72) returned to sebaaastian
sebaaastian collected $7.16 from pot
sebaaastian: doesn't show hand 
*** SUMMARY ***
Total pot $7.50 | Rake $0.34 
Board [3h 5c Kh]
Seat 1: sebaaastian collected ($7.16)
Seat 2: matiko09 folded before Flop (didn't bet)
Seat 3: Zeeshka (button) folded before Flop (didn't bet)
Seat 4: oscarleon (small blind) folded before Flop
Seat 5: aseban11 (big blind) folded before Flop
Seat 6: Luck In Me folded before Flop (didn't bet)
Seat 7: grigy197 folded on the Flop
Seat 8: mrspecial1 folded before Flop (didn't bet)





PokerStars Hand #148608867086:  Hold'em No Limit ($0.50/$1.00 USD) - 2016/02/11 13:09:53 CET [2016/02/11 7:09:53 ET]
Table 'Marion' 9-max Seat #5 is the button
Seat 1: aseban11 ($100 in chips) 
Seat 2: GusenokRUS ($98.55 in chips) 
Seat 3: TimStone ($105.96 in chips) 
Seat 4: matiko09 ($100 in chips) 
Seat 5: Rikti ($50.01 in chips) 
Seat 6: 19SERGE74 ($82.67 in chips) 
Seat 7: oscarleon ($101.50 in chips) 
Seat 9: Zeeshka ($101.50 in chips) 
19SERGE74: posts small blind $0.50
oscarleon: posts big blind $1
*** HOLE CARDS ***
Dealt to matiko09 [9s 7c]
Zeeshka: raises $2 to $3
aseban11: folds 
GusenokRUS: folds 
TimStone: folds 
matiko09: folds 
Rikti: folds 
19SERGE74: folds 
oscarleon: folds 
Uncalled bet ($2) returned to Zeeshka
Zeeshka collected $2.50 from pot
Zeeshka: doesn't show hand 
*** SUMMARY ***
Total pot $2.50 | Rake $0 
Seat 1: aseban11 folded before Flop (didn't bet)
Seat 2: GusenokRUS folded before Flop (didn't bet)
Seat 3: TimStone folded before Flop (didn't bet)
Seat 4: matiko09 folded before Flop (didn't bet)
Seat 5: Rikti (button) folded before Flop (didn't bet)
Seat 6: 19SERGE74 (small blind) folded before Flop
Seat 7: oscarleon (big blind) folded before Flop
Seat 9: Zeeshka collected ($2.50)





PokerStars Hand #148608870584:  Hold'em No Limit (€0.25/€0.50 EUR) - 2016/02/11 13:09:59 CET [2016/02/11 7:09:59 ET]
Table 'Otero II' 9-max Seat #4 is the button
Seat 2: Dantist1122 (€50 in chips) 
Seat 3: Szevasztopol (€50 in chips) 
Seat 4: kram0909 (€3.83 in chips) 
Seat 5: vlad11122007 (€49.69 in chips) 
Seat 7: Dflingern95 (€58.82 in chips) 
Seat 8: matiko09 (€72.18 in chips) 
Seat 9: Optimistic21 (€65.16 in chips) 
vlad11122007: posts small blind €0.25
TonnaMunz: is sitting out 
Dflingern95: posts big blind €0.50
*** HOLE CARDS ***
Dealt to matiko09 [6c Th]
matiko09: folds 
Optimistic21: folds 
Dantist1122: folds 
Szevasztopol: folds 
kram0909: raises €3.33 to €3.83 and is all-in
vlad11122007: folds 
Dflingern95: calls €3.33
*** FLOP *** [Kc 5h Ah]
*** TURN *** [Kc 5h Ah] [7d]
*** RIVER *** [Kc 5h Ah 7d] [Qc]
*** SHOW DOWN ***
Dflingern95: shows [4h Kh] (a pair of Kings)
kram0909: shows [Ac 7s] (two pair, Aces and Sevens)
kram0909 collected €7.55 from pot
*** SUMMARY ***
Total pot €7.91 | Rake €0.36 
Board [Kc 5h Ah 7d Qc]
Seat 2: Dantist1122 folded before Flop (didn't bet)
Seat 3: Szevasztopol folded before Flop (didn't bet)
Seat 4: kram0909 (button) showed [Ac 7s] and won (€7.55) with two pair, Aces and Sevens
Seat 5: vlad11122007 (small blind) folded before Flop
Seat 7: Dflingern95 (big blind) showed [4h Kh] and lost with a pair of Kings
Seat 8: matiko09 folded before Flop (didn't bet)
Seat 9: Optimistic21 folded before Flop (didn't bet)





PokerStars Hand #148608871998:  Hold'em No Limit ($0.25/$0.50 USD) - 2016/02/11 13:10:01 CET [2016/02/11 7:10:01 ET]
Table 'Stereoskopia' 9-max Seat #1 is the button
Seat 1: JJJ-K9 ($49.50 in chips) 
Seat 2: Optimistic21 ($52.50 in chips) 
Seat 3: Szevasztopol ($58.29 in chips) 
Seat 5: ReinisRNS ($47.27 in chips) 
Seat 6: matiko09 ($52.83 in chips) 
Seat 7: tallonn88 ($55.47 in chips) 
Seat 8: vlad11122007 ($51.01 in chips) 
Seat 9: xxxibgdrgn ($50 in chips) 
Optimistic21: posts small blind $0.25
Szevasztopol: posts big blind $0.50
*** HOLE CARDS ***
Dealt to matiko09 [Qs 4s]
ReinisRNS: folds 
matiko09: folds 
tallonn88: folds 
vlad11122007: raises $1 to $1.50
xxxibgdrgn: folds 
JJJ-K9: folds 
Optimistic21: folds 
Szevasztopol: folds 
Uncalled bet ($1) returned to vlad11122007
vlad11122007 collected $1.25 from pot
vlad11122007: doesn't show hand 
*** SUMMARY ***
Total pot $1.25 | Rake $0 
Seat 1: JJJ-K9 (button) folded before Flop (didn't bet)
Seat 2: Optimistic21 (small blind) folded before Flop
Seat 3: Szevasztopol (big blind) folded before Flop
Seat 5: ReinisRNS folded before Flop (didn't bet)
Seat 6: matiko09 folded before Flop (didn't bet)
Seat 7: tallonn88 folded before Flop (didn't bet)
Seat 8: vlad11122007 collected ($1.25)
Seat 9: xxxibgdrgn folded before Flop (didn't bet)





PokerStars Hand #148608875466:  Hold'em No Limit ($0.25/$0.50 USD) - 2016/02/11 13:10:07 CET [2016/02/11 7:10:07 ET]
Table 'Ambrosia II' 9-max Seat #2 is the button
Seat 1: matiko09 ($52.54 in chips) 
Seat 2: TheMinion ($130.56 in chips) 
Seat 3: make6a ($81.51 in chips) 
Seat 4: huudk2016 ($46.30 in chips) 
Seat 5: RICKA16 ($49.50 in chips) 
Seat 6: Reven9er ($58.77 in chips) 
Seat 7: Ana.Satravca ($50 in chips) 
Seat 9: arctur17 ($55.32 in chips) 
make6a: posts small blind $0.25
huudk2016: posts big blind $0.50
tallonn88: sits out 
*** HOLE CARDS ***
Dealt to matiko09 [Kd 5d]
RICKA16: folds 
Reven9er: raises $0.50 to $1
Ana.Satravca: folds 
arctur17: calls $1
matiko09: folds 
TheMinion: folds 
make6a: folds 
huudk2016: calls $0.50
*** FLOP *** [Qs Ac 2h]
huudk2016: checks 
Reven9er: checks 
arctur17: bets $2.50
TheMinion leaves the table
huudk2016: folds 
JJJ-K9 joins the table at seat #2 
Reven9er: folds 
Uncalled bet ($2.50) returned to arctur17
arctur17 collected $3.10 from pot
arctur17: doesn't show hand 
*** SUMMARY ***
Total pot $3.25 | Rake $0.15 
Board [Qs Ac 2h]
Seat 1: matiko09 folded before Flop (didn't bet)
Seat 2: TheMinion (button) folded before Flop (didn't bet)
Seat 3: make6a (small blind) folded before Flop
Seat 4: huudk2016 (big blind) folded on the Flop
Seat 5: RICKA16 folded before Flop (didn't bet)
Seat 6: Reven9er folded on the Flop
Seat 7: Ana.Satravca folded before Flop (didn't bet)
Seat 9: arctur17 collected ($3.10)





PokerStars Hand #148608881678:  Hold'em No Limit ($0.25/$0.50 USD) - 2016/02/11 13:10:18 CET [2016/02/11 7:10:18 ET]
Table 'Oenone' 9-max Seat #3 is the button
Seat 1: tallonn88 ($53.75 in chips) 
Seat 2: Reven9er ($50 in chips) 
Seat 3: Crazy_Giant1 ($38.34 in chips) 
Seat 4: Serhent ($50 in chips) 
Seat 5: ReinisRNS ($57.34 in chips) 
Seat 6: matiko09 ($51 in chips) 
Seat 7: banit7 ($53.25 in chips) 
Seat 8: vlad11122007 ($80.45 in chips) 
Seat 9: TheMinion ($141.63 in chips) 
Serhent: posts small blind $0.25
ReinisRNS: posts big blind $0.50
*** HOLE CARDS ***
Dealt to matiko09 [Kd 4s]
matiko09: folds 
banit7: folds 
vlad11122007: folds 
TheMinion: folds 
tallonn88: folds 
Reven9er: folds 
Crazy_Giant1: folds 
Serhent: folds 
Uncalled bet ($0.25) returned to ReinisRNS
ReinisRNS collected $0.50 from pot
ReinisRNS: doesn't show hand 
*** SUMMARY ***
Total pot $0.50 | Rake $0 
Seat 1: tallonn88 folded before Flop (didn't bet)
Seat 2: Reven9er folded before Flop (didn't bet)
Seat 3: Crazy_Giant1 (button) folded before Flop (didn't bet)
Seat 4: Serhent (small blind) folded before Flop
Seat 5: ReinisRNS (big blind) collected ($0.50)
Seat 6: matiko09 folded before Flop (didn't bet)
Seat 7: banit7 folded before Flop (didn't bet)
Seat 8: vlad11122007 folded before Flop (didn't bet)
Seat 9: TheMinion folded before Flop (didn't bet)





PokerStars Hand #148608883599:  Hold'em No Limit ($0.25/$0.50 USD) - 2016/02/11 13:10:22 CET [2016/02/11 7:10:22 ET]
Table 'Stereoskopia' 9-max Seat #2 is the button
Seat 1: JJJ-K9 ($49.50 in chips) 
Seat 2: Optimistic21 ($52.25 in chips) 
Seat 3: Szevasztopol ($57.79 in chips) 
Seat 5: ReinisRNS ($47.27 in chips) 
Seat 6: matiko09 ($52.83 in chips) 
Seat 7: tallonn88 ($55.47 in chips) 
Seat 8: vlad11122007 ($51.76 in chips) 
Seat 9: xxxibgdrgn ($50 in chips) 
Szevasztopol: posts small blind $0.25
King brid was removed from the table for failing to post
ReinisRNS: posts big blind $0.50
*** HOLE CARDS ***
Dealt to matiko09 [2c 7h]
matiko09: folds 
tallonn88: folds 
vlad11122007: folds 
xxxibgdrgn: folds 
JJJ-K9: folds 
Optimistic21: folds 
Szevasztopol: folds 
Uncalled bet ($0.25) returned to ReinisRNS
ReinisRNS collected $0.50 from pot
ReinisRNS: doesn't show hand 
*** SUMMARY ***
Total pot $0.50 | Rake $0 
Seat 1: JJJ-K9 folded before Flop (didn't bet)
Seat 2: Optimistic21 (button) folded before Flop (didn't bet)
Seat 3: Szevasztopol (small blind) folded before Flop
Seat 5: ReinisRNS (big blind) collected ($0.50)
Seat 6: matiko09 folded before Flop (didn't bet)
Seat 7: tallonn88 folded before Flop (didn't bet)
Seat 8: vlad11122007 folded before Flop (didn't bet)
Seat 9: xxxibgdrgn folded before Flop (didn't bet)





PokerStars Hand #148608884518:  Hold'em No Limit ($0.50/$1.00 USD) - 2016/02/11 13:10:23 CET [2016/02/11 7:10:23 ET]
Table 'Stephano V' 9-max Seat #7 is the button
Seat 1: hammerwife ($100 in chips) 
Seat 2: matiko09 ($130.01 in chips) 
Seat 3: sebaaastian ($100 in chips) 
Seat 4: Zeeshka ($126.32 in chips) 
Seat 5: n2call ($165.90 in chips) 
Seat 7: hurtNCYDE ($102.54 in chips) 
Seat 8: oscarleon ($219.23 in chips) 
Seat 9: IcocaynaI ($105.07 in chips) 
oscarleon: posts small blind $0.50
IcocaynaI: posts big blind $1
*** HOLE CARDS ***
Dealt to matiko09 [Qs 6d]
hammerwife: folds 
matiko09: folds 
sebaaastian: folds 
Zeeshka: folds 
n2call: folds 
hurtNCYDE: raises $1.50 to $2.50
oscarleon: folds 
IcocaynaI: calls $1.50
*** FLOP *** [Th 5d Ad]
IcocaynaI: bets $1
hurtNCYDE: raises $3.77 to $4.77
IcocaynaI: folds 
Uncalled bet ($3.77) returned to hurtNCYDE
hurtNCYDE collected $7.16 from pot
*** SUMMARY ***
Total pot $7.50 | Rake $0.34 
Board [Th 5d Ad]
Seat 1: hammerwife folded before Flop (didn't bet)
Seat 2: matiko09 folded before Flop (didn't bet)
Seat 3: sebaaastian folded before Flop (didn't bet)
Seat 4: Zeeshka folded before Flop (didn't bet)
Seat 5: n2call folded before Flop (didn't bet)
Seat 7: hurtNCYDE (button) collected ($7.16)
Seat 8: oscarleon (small blind) folded before Flop
Seat 9: IcocaynaI (big blind) folded on the Flop





PokerStars Hand #148608885879:  Hold'em No Limit ($0.25/$0.50 USD) - 2016/02/11 13:10:25 CET [2016/02/11 7:10:25 ET]
Table 'Algedi' 9-max Seat #1 is the button
Seat 1: vlad11122007 ($67.72 in chips) 
Seat 3: Saggitaurus ($126.59 in chips) 
Seat 4: Effort92 ($58.66 in chips) 
Seat 5: Optimistic21 ($56.33 in chips) 
Seat 6: TonnaMunz ($125 in chips) 
Seat 7: hoedtrob ($60.31 in chips) 
Seat 8: matiko09 ($104.35 in chips) 
Saggitaurus: posts small blind $0.25
Effort92: posts big blind $0.50
vlad11122007: posts the ante $0.10
Saggitaurus: posts the ante $0.10
Effort92: posts the ante $0.10
Optimistic21: posts the ante $0.10
TonnaMunz: posts the ante $0.10
hoedtrob: posts the ante $0.10
matiko09: posts the ante $0.10
*** HOLE CARDS ***
Dealt to matiko09 [8d 5d]
Optimistic21: folds 
TonnaMunz: folds 
hoedtrob: folds 
Reffypaul said, "nh"
matiko09: folds 
vlad11122007: folds 
Saggitaurus: calls $0.25
1989jr1989 joins the table at seat #9 
Reffypaul said, "aq"
Effort92: checks 
*** FLOP *** [5s 9c Jh]
Saggitaurus: bets $0.81
Effort92: folds 
Uncalled bet ($0.81) returned to Saggitaurus
Saggitaurus collected $1.62 from pot
Saggitaurus: doesn't show hand 
*** SUMMARY ***
Total pot $1.70 | Rake $0.08 
Board [5s 9c Jh]
Seat 1: vlad11122007 (button) folded before Flop (didn't bet)
Seat 3: Saggitaurus (small blind) collected ($1.62)
Seat 4: Effort92 (big blind) folded on the Flop
Seat 5: Optimistic21 folded before Flop (didn't bet)
Seat 6: TonnaMunz folded before Flop (didn't bet)
Seat 7: hoedtrob folded before Flop (didn't bet)
Seat 8: matiko09 folded before Flop (didn't bet)





PokerStars Hand #148608891041:  Hold'em No Limit ($0.50/$1.00 USD) - 2016/02/11 13:10:35 CET [2016/02/11 7:10:35 ET]
Table 'Aoluta' 9-max Seat #4 is the button
Seat 1: sebaaastian ($105.66 in chips) 
Seat 2: matiko09 ($100 in chips) 
Seat 3: Zeeshka ($104.10 in chips) 
Seat 4: oscarleon ($178.76 in chips) 
Seat 5: aseban11 ($100 in chips) 
Seat 6: Luck In Me ($108.50 in chips) 
Seat 7: grigy197 ($90.25 in chips) 
Seat 8: mrspecial1 ($58 in chips) 
aseban11: posts small blind $0.50
Luck In Me: posts big blind $1
*** HOLE CARDS ***
Dealt to matiko09 [6h Qd]
grigy197: calls $1
mrspecial1: folds 
sebaaastian: folds 
matiko09: folds 
Zeeshka: folds 
oscarleon: folds 
aseban11: folds 
Luck In Me: checks 
*** FLOP *** [8c 7c 5s]
Luck In Me: checks 
grigy197: bets $2
Luck In Me: folds 
Uncalled bet ($2) returned to grigy197
grigy197 collected $2.39 from pot
*** SUMMARY ***
Total pot $2.50 | Rake $0.11 
Board [8c 7c 5s]
Seat 1: sebaaastian folded before Flop (didn't bet)
Seat 2: matiko09 folded before Flop (didn't bet)
Seat 3: Zeeshka folded before Flop (didn't bet)
Seat 4: oscarleon (button) folded before Flop (didn't bet)
Seat 5: aseban11 (small blind) folded before Flop
Seat 6: Luck In Me (big blind) folded on the Flop
Seat 7: grigy197 collected ($2.39)
Seat 8: mrspecial1 folded before Flop (didn't bet)





PokerStars Hand #148608895783:  Hold'em No Limit ($0.25/$0.50 USD) - 2016/02/11 13:10:43 CET [2016/02/11 7:10:43 ET]
Table 'Sylvania II' 9-max Seat #2 is the button
Seat 1: tw0315 ($83.11 in chips) 
Seat 2: Effort92 ($63.59 in chips) 
Seat 3: ruyingren ($196.63 in chips) 
Seat 4: matiko09 ($149.09 in chips) 
Seat 5: vlad11122007 ($58.69 in chips) 
Seat 6: TonnaMunz ($130.91 in chips) 
Seat 7: 2lefthand75 ($87.10 in chips) 
Seat 8: Optimistic21 ($50 in chips) 
ruyingren: posts small blind $0.25
matiko09: posts big blind $0.50
Yippiebeans: sits out 
tw0315: posts the ante $0.10
Effort92: posts the ante $0.10
ruyingren: posts the ante $0.10
matiko09: posts the ante $0.10
vlad11122007: posts the ante $0.10
TonnaMunz: posts the ante $0.10
2lefthand75: posts the ante $0.10
Optimistic21: posts the ante $0.10
*** HOLE CARDS ***
Dealt to matiko09 [9s 9h]
vlad11122007: folds 
TonnaMunz has timed out while being disconnected
TonnaMunz: folds 
2lefthand75: calls $0.50
Optimistic21: raises $1.50 to $2
tw0315: folds 
Effort92: calls $2
ruyingren: calls $1.75
matiko09: raises $6.50 to $8.50
2lefthand75: folds 
Optimistic21: folds 
Effort92: folds 
ruyingren: raises $10 to $18.50
matiko09: calls $10
*** FLOP *** [3s Ks Jc]
ruyingren: bets $28
matiko09: folds 
Uncalled bet ($28) returned to ruyingren
ruyingren collected $40.40 from pot
ruyingren: doesn't show hand 
*** SUMMARY ***
Total pot $42.30 | Rake $1.90 
Board [3s Ks Jc]
Seat 1: tw0315 folded before Flop (didn't bet)
Seat 2: Effort92 (button) folded before Flop
Seat 3: ruyingren (small blind) collected ($40.40)
Seat 4: matiko09 (big blind) folded on the Flop
Seat 5: vlad11122007 folded before Flop (didn't bet)
Seat 6: TonnaMunz folded before Flop (didn't bet)
Seat 7: 2lefthand75 folded before Flop
Seat 8: Optimistic21 folded before Flop





PokerStars Hand #148608901944:  Hold'em No Limit ($0.25/$0.50 USD) - 2016/02/11 13:10:53 CET [2016/02/11 7:10:53 ET]
Table 'Stereoskopia' 9-max Seat #3 is the button
Seat 1: JJJ-K9 ($49.50 in chips) 
Seat 2: Optimistic21 ($52.25 in chips) 
Seat 3: Szevasztopol ($57.54 in chips) 
Seat 5: ReinisRNS ($47.52 in chips) 
Seat 6: matiko09 ($52.83 in chips) 
Seat 7: tallonn88 ($55.47 in chips) 
Seat 8: vlad11122007 ($51.76 in chips) 
Seat 9: xxxibgdrgn ($50 in chips) 
ReinisRNS: posts small blind $0.25
matiko09: posts big blind $0.50
*** HOLE CARDS ***
Dealt to matiko09 [8s 6c]
tallonn88: folds 
vlad11122007: folds 
xxxibgdrgn: folds 
JJJ-K9: folds 
Optimistic21: folds 
Szevasztopol: raises $0.50 to $1
ReinisRNS: folds 
matiko09: folds 
Uncalled bet ($0.50) returned to Szevasztopol
Szevasztopol collected $1.25 from pot
Szevasztopol: doesn't show hand 
*** SUMMARY ***
Total pot $1.25 | Rake $0 
Seat 1: JJJ-K9 folded before Flop (didn't bet)
Seat 2: Optimistic21 folded before Flop (didn't bet)
Seat 3: Szevasztopol (button) collected ($1.25)
Seat 5: ReinisRNS (small blind) folded before Flop
Seat 6: matiko09 (big blind) folded before Flop
Seat 7: tallonn88 folded before Flop (didn't bet)
Seat 8: vlad11122007 folded before Flop (didn't bet)
Seat 9: xxxibgdrgn folded before Flop (didn't bet)





PokerStars Hand #148608901688:  Hold'em No Limit ($0.50/$1.00 USD) - 2016/02/11 13:10:53 CET [2016/02/11 7:10:53 ET]
Table 'Marion' 9-max Seat #6 is the button
Seat 1: aseban11 ($100 in chips) 
Seat 2: GusenokRUS ($98.55 in chips) 
Seat 3: TimStone ($105.96 in chips) 
Seat 4: matiko09 ($100 in chips) 
Seat 5: Rikti ($50.01 in chips) 
Seat 6: 19SERGE74 ($82.17 in chips) 
Seat 7: oscarleon ($100.50 in chips) 
Seat 9: Zeeshka ($103 in chips) 
oscarleon: posts small blind $0.50
Zeeshka: posts big blind $1
*** HOLE CARDS ***
Dealt to matiko09 [8s 3c]
aseban11: raises $2 to $3
GusenokRUS has timed out
GusenokRUS: folds 
TimStone: folds 
matiko09: folds 
Rikti: folds 
19SERGE74: folds 
oscarleon: folds 
Zeeshka: folds 
Uncalled bet ($2) returned to aseban11
aseban11 collected $2.50 from pot
aseban11: doesn't show hand 
*** SUMMARY ***
Total pot $2.50 | Rake $0 
Seat 1: aseban11 collected ($2.50)
Seat 2: GusenokRUS folded before Flop (didn't bet)
Seat 3: TimStone folded before Flop (didn't bet)
Seat 4: matiko09 folded before Flop (didn't bet)
Seat 5: Rikti folded before Flop (didn't bet)
Seat 6: 19SERGE74 (button) folded before Flop (didn't bet)
Seat 7: oscarleon (small blind) folded before Flop
Seat 9: Zeeshka (big blind) folded before Flop





PokerStars Hand #148608906265:  Hold'em No Limit ($0.25/$0.50 USD) - 2016/02/11 13:11:01 CET [2016/02/11 7:11:01 ET]
Table 'Oenone' 9-max Seat #4 is the button
Seat 1: tallonn88 ($53.75 in chips) 
Seat 2: Reven9er ($50 in chips) 
Seat 3: Crazy_Giant1 ($38.34 in chips) 
Seat 4: Serhent ($50 in chips) 
Seat 5: ReinisRNS ($57.59 in chips) 
Seat 6: matiko09 ($51 in chips) 
Seat 7: banit7 ($53.25 in chips) 
Seat 8: vlad11122007 ($80.45 in chips) 
Seat 9: TheMinion ($141.63 in chips) 
ReinisRNS: posts small blind $0.25
matiko09: posts big blind $0.50
*** HOLE CARDS ***
Dealt to matiko09 [3d 2h]
banit7: folds 
vlad11122007: folds 
TheMinion: folds 
TheMinion leaves the table
tallonn88: folds 
Reven9er: folds 
Crazy_Giant1: calls $0.50
Serhent: folds 
ReinisRNS: folds 
matiko09: checks 
*** FLOP *** [Qh As Qs]
matiko09: checks 
Crazy_Giant1: checks 
*** TURN *** [Qh As Qs] [Tc]
matiko09: checks 
Crazy_Giant1: bets $1
matiko09: folds 
Uncalled bet ($1) returned to Crazy_Giant1
Crazy_Giant1 collected $1.19 from pot
Crazy_Giant1: doesn't show hand 
*** SUMMARY ***
Total pot $1.25 | Rake $0.06 
Board [Qh As Qs Tc]
Seat 1: tallonn88 folded before Flop (didn't bet)
Seat 2: Reven9er folded before Flop (didn't bet)
Seat 3: Crazy_Giant1 collected ($1.19)
Seat 4: Serhent (button) folded before Flop (didn't bet)
Seat 5: ReinisRNS (small blind) folded before Flop
Seat 6: matiko09 (big blind) folded on the Turn
Seat 7: banit7 folded before Flop (didn't bet)
Seat 8: vlad11122007 folded before Flop (didn't bet)
Seat 9: TheMinion folded before Flop (didn't bet)





PokerStars Hand #148608908301:  Hold'em No Limit (€0.25/€0.50 EUR) - 2016/02/11 13:11:04 CET [2016/02/11 7:11:04 ET]
Table 'Otero II' 9-max Seat #5 is the button
Seat 2: Dantist1122 (€50 in chips) 
Seat 3: Szevasztopol (€50 in chips) 
Seat 4: kram0909 (€7.55 in chips) 
Seat 5: vlad11122007 (€49.44 in chips) 
Seat 7: Dflingern95 (€54.99 in chips) 
Seat 8: matiko09 (€72.18 in chips) 
Seat 9: Optimistic21 (€65.16 in chips) 
Dflingern95: posts small blind €0.25
matiko09: posts big blind €0.50
*** HOLE CARDS ***
Dealt to matiko09 [6c Ts]
Optimistic21: raises €1 to €1.50
Dantist1122: folds 
make6a leaves the table
Szevasztopol: folds 
kram0909: folds 
Effort92 joins the table at seat #1 
vlad11122007: folds 
Dflingern95: calls €1.25
matiko09: folds 
*** FLOP *** [4c 6d 4s]
Dflingern95: bets €1.50
Optimistic21: calls €1.50
*** TURN *** [4c 6d 4s] [2c]
Dflingern95: bets €5.50
Optimistic21: folds 
Uncalled bet (€5.50) returned to Dflingern95
Dflingern95 collected €6.21 from pot
*** SUMMARY ***
Total pot €6.50 | Rake €0.29 
Board [4c 6d 4s 2c]
Seat 2: Dantist1122 folded before Flop (didn't bet)
Seat 3: Szevasztopol folded before Flop (didn't bet)
Seat 4: kram0909 folded before Flop (didn't bet)
Seat 5: vlad11122007 (button) folded before Flop (didn't bet)
Seat 7: Dflingern95 (small blind) collected (€6.21)
Seat 8: matiko09 (big blind) folded before Flop
Seat 9: Optimistic21 folded on the Turn





PokerStars Hand #148608908832:  Hold'em No Limit ($0.50/$1.00 USD) - 2016/02/11 13:11:05 CET [2016/02/11 7:11:05 ET]
Table 'Stephano V' 9-max Seat #8 is the button
Seat 1: hammerwife ($100 in chips) 
Seat 2: matiko09 ($130.01 in chips) 
Seat 3: sebaaastian ($100 in chips) 
Seat 4: Zeeshka ($126.32 in chips) 
Seat 5: n2call ($165.90 in chips) 
Seat 7: hurtNCYDE ($106.20 in chips) 
Seat 8: oscarleon ($218.73 in chips) 
Seat 9: IcocaynaI ($101.57 in chips) 
IcocaynaI: posts small blind $0.50
hammerwife: posts big blind $1
*** HOLE CARDS ***
Dealt to matiko09 [7d 4h]
matiko09: folds 
sebaaastian: folds 
Zeeshka: folds 
n2call: folds 
hurtNCYDE: raises $1.50 to $2.50
oscarleon: folds 
IcocaynaI: calls $2
hammerwife: folds 
*** FLOP *** [6c 6s Qd]
IcocaynaI: bets $1
hurtNCYDE: folds 
Uncalled bet ($1) returned to IcocaynaI
IcocaynaI collected $5.73 from pot
IcocaynaI: doesn't show hand 
*** SUMMARY ***
Total pot $6 | Rake $0.27 
Board [6c 6s Qd]
Seat 1: hammerwife (big blind) folded before Flop
Seat 2: matiko09 folded before Flop (didn't bet)
Seat 3: sebaaastian folded before Flop (didn't bet)
Seat 4: Zeeshka folded before Flop (didn't bet)
Seat 5: n2call folded before Flop (didn't bet)
Seat 7: hurtNCYDE folded on the Flop
Seat 8: oscarleon (button) folded before Flop (didn't bet)
Seat 9: IcocaynaI (small blind) collected ($5.73)





PokerStars Hand #148608909099:  Hold'em No Limit ($0.50/$1.00 USD) - 2016/02/11 13:11:06 CET [2016/02/11 7:11:06 ET]
Table 'Gianfar' 9-max Seat #1 is the button
Seat 1: sebaaastian ($232.81 in chips) 
Seat 2: bilukm ($74.74 in chips) 
Seat 3: AlKatrone ($112.83 in chips) 
Seat 4: matiko09 ($123.82 in chips) 
Seat 5: hammerwife ($175.79 in chips) 
Seat 7: Rikti ($38 in chips) 
Seat 8: Zeeshka ($100 in chips) 
Seat 9: oscarleon ($146.66 in chips) 
bilukm: posts small blind $0.50
AlKatrone: posts big blind $1
*** HOLE CARDS ***
Dealt to matiko09 [8c Qc]
matiko09: folds 
hammerwife: folds 
Rikti: folds 
Zeeshka: folds 
oscarleon: folds 
sebaaastian: raises $2 to $3
bilukm: folds 
AlKatrone: folds 
Uncalled bet ($2) returned to sebaaastian
sebaaastian collected $2.50 from pot
sebaaastian: doesn't show hand 
*** SUMMARY ***
Total pot $2.50 | Rake $0 
Seat 1: sebaaastian (button) collected ($2.50)
Seat 2: bilukm (small blind) folded before Flop
Seat 3: AlKatrone (big blind) folded before Flop
Seat 4: matiko09 folded before Flop (didn't bet)
Seat 5: hammerwife folded before Flop (didn't bet)
Seat 7: Rikti folded before Flop (didn't bet)
Seat 8: Zeeshka folded before Flop (didn't bet)
Seat 9: oscarleon folded before Flop (didn't bet)





PokerStars Hand #148608916135:  Hold'em No Limit ($0.50/$1.00 USD) - 2016/02/11 13:11:18 CET [2016/02/11 7:11:18 ET]
Table 'Clorinde' 9-max Seat #6 is the button
Seat 1: matiko09 ($100 in chips) 
Seat 2: 19SERGE74 ($80 in chips) 
Seat 3: gabi_igna ($100 in chips) 
Seat 5: Mukhin1 ($100 in chips) 
Seat 6: Gcroc52 ($38.50 in chips) 
Seat 7: Zeeshka ($100 in chips) 
Seat 8: aseban11 ($118.72 in chips) 
Seat 9: buttonlife ($40 in chips) 
Zeeshka: posts small blind $0.50
aseban11: posts big blind $1
*** HOLE CARDS ***
Dealt to matiko09 [7c Ad]
buttonlife: folds 
matiko09: folds 
19SERGE74: calls $1
gabi_igna: folds 
Mukhin1: calls $1
Gcroc52: folds 
Zeeshka: folds 
aseban11: checks 
*** FLOP *** [As 8d Qc]
aseban11: checks 
19SERGE74: bets $2
Mukhin1: folds 
aseban11: folds 
Uncalled bet ($2) returned to 19SERGE74
19SERGE74 collected $3.34 from pot
19SERGE74: doesn't show hand 
*** SUMMARY ***
Total pot $3.50 | Rake $0.16 
Board [As 8d Qc]
Seat 1: matiko09 folded before Flop (didn't bet)
Seat 2: 19SERGE74 collected ($3.34)
Seat 3: gabi_igna folded before Flop (didn't bet)
Seat 5: Mukhin1 folded on the Flop
Seat 6: Gcroc52 (button) folded before Flop (didn't bet)
Seat 7: Zeeshka (small blind) folded before Flop
Seat 8: aseban11 (big blind) folded on the Flop
Seat 9: buttonlife folded before Flop (didn't bet)





PokerStars Hand #148608916935:  Hold'em No Limit ($0.25/$0.50 USD) - 2016/02/11 13:11:19 CET [2016/02/11 7:11:19 ET]
Table 'Ambrosia II' 9-max Seat #3 is the button
Seat 1: matiko09 ($52.54 in chips) 
Seat 3: make6a ($81.26 in chips) 
Seat 4: huudk2016 ($45.30 in chips) 
Seat 6: Reven9er ($57.77 in chips) 
Seat 7: Ana.Satravca ($50 in chips) 
Seat 9: arctur17 ($57.42 in chips) 
huudk2016: posts small blind $0.25
RICKA16: is sitting out 
Reven9er: posts big blind $0.50
tallonn88: sits out 
JJJ-K9: sits out 
*** HOLE CARDS ***
Dealt to matiko09 [8c 2c]
Ana.Satravca: folds 
arctur17: folds 
matiko09: folds 
make6a: raises $0.50 to $1
huudk2016: calls $0.75
Reven9er: folds 
*** FLOP *** [6d 5s 6h]
huudk2016: checks 
make6a: bets $1.48
huudk2016: calls $1.48
*** TURN *** [6d 5s 6h] [As]
huudk2016: checks 
make6a: checks 
*** RIVER *** [6d 5s 6h As] [Qh]
huudk2016: bets $3.50
make6a: calls $3.50
*** SHOW DOWN ***
huudk2016: shows [7d 9d] (a pair of Sixes)
make6a: shows [Ac 3d] (two pair, Aces and Sixes)
make6a collected $11.90 from pot
*** SUMMARY ***
Total pot $12.46 | Rake $0.56 
Board [6d 5s 6h As Qh]
Seat 1: matiko09 folded before Flop (didn't bet)
Seat 3: make6a (button) showed [Ac 3d] and won ($11.90) with two pair, Aces and Sixes
Seat 4: huudk2016 (small blind) showed [7d 9d] and lost with a pair of Sixes
Seat 6: Reven9er (big blind) folded before Flop
Seat 7: Ana.Satravca folded before Flop (didn't bet)
Seat 9: arctur17 folded before Flop (didn't bet)





PokerStars Hand #148608921787:  Hold'em No Limit ($0.25/$0.50 USD) - 2016/02/11 13:11:28 CET [2016/02/11 7:11:28 ET]
Table 'Stereoskopia' 9-max Seat #5 is the button
Seat 1: JJJ-K9 ($49.50 in chips) 
Seat 2: Optimistic21 ($52.25 in chips) 
Seat 3: Szevasztopol ($58.29 in chips) 
Seat 5: ReinisRNS ($47.27 in chips) 
Seat 6: matiko09 ($52.33 in chips) 
Seat 7: tallonn88 ($55.47 in chips) 
Seat 8: vlad11122007 ($51.76 in chips) 
Seat 9: xxxibgdrgn ($50 in chips) 
matiko09: posts small blind $0.25
tallonn88: posts big blind $0.50
*** HOLE CARDS ***
Dealt to matiko09 [5d Qc]
TPACHCI7OPT joins the table at seat #4 
vlad11122007: folds 
xxxibgdrgn: folds 
vlad11122007 leaves the table
JJJ-K9: folds 
Optimistic21: folds 
Szevasztopol: folds 
ReinisRNS: folds 
matiko09: folds 
Uncalled bet ($0.25) returned to tallonn88
tallonn88 collected $0.50 from pot
tallonn88: doesn't show hand 
*** SUMMARY ***
Total pot $0.50 | Rake $0 
Seat 1: JJJ-K9 folded before Flop (didn't bet)
Seat 2: Optimistic21 folded before Flop (didn't bet)
Seat 3: Szevasztopol folded before Flop (didn't bet)
Seat 5: ReinisRNS (button) folded before Flop (didn't bet)
Seat 6: matiko09 (small blind) folded before Flop
Seat 7: tallonn88 (big blind) collected ($0.50)
Seat 8: vlad11122007 folded before Flop (didn't bet)
Seat 9: xxxibgdrgn folded before Flop (didn't bet)





PokerStars Hand #148608922277:  Hold'em No Limit ($0.50/$1.00 USD) - 2016/02/11 13:11:29 CET [2016/02/11 7:11:29 ET]
Table 'Aoluta' 9-max Seat #5 is the button
Seat 1: sebaaastian ($105.66 in chips) 
Seat 2: matiko09 ($100 in chips) 
Seat 3: Zeeshka ($104.10 in chips) 
Seat 4: oscarleon ($178.76 in chips) 
Seat 5: aseban11 ($100 in chips) 
Seat 6: Luck In Me ($107.50 in chips) 
Seat 7: grigy197 ($91.64 in chips) 
Seat 8: mrspecial1 ($58 in chips) 
Luck In Me: posts small blind $0.50
grigy197: posts big blind $1
*** HOLE CARDS ***
Dealt to matiko09 [Kd 5h]
mrspecial1: folds 
sebaaastian: folds 
matiko09: folds 
Zeeshka: folds 
oscarleon: raises $2 to $3
aseban11: folds 
Luck In Me: folds 
grigy197: calls $2
*** FLOP *** [2s Ad 8c]
grigy197: checks 
oscarleon: bets $5
grigy197: folds 
Uncalled bet ($5) returned to oscarleon
oscarleon collected $6.21 from pot
oscarleon: doesn't show hand 
*** SUMMARY ***
Total pot $6.50 | Rake $0.29 
Board [2s Ad 8c]
Seat 1: sebaaastian folded before Flop (didn't bet)
Seat 2: matiko09 folded before Flop (didn't bet)
Seat 3: Zeeshka folded before Flop (didn't bet)
Seat 4: oscarleon collected ($6.21)
Seat 5: aseban11 (button) folded before Flop (didn't bet)
Seat 6: Luck In Me (small blind) folded before Flop
Seat 7: grigy197 (big blind) folded on the Flop
Seat 8: mrspecial1 folded before Flop (didn't bet)





PokerStars Hand #148608924115:  Hold'em No Limit ($0.25/$0.50 USD) - 2016/02/11 13:11:32 CET [2016/02/11 7:11:32 ET]
Table 'Algedi' 9-max Seat #3 is the button
Seat 1: vlad11122007 ($67.62 in chips) 
Seat 3: Saggitaurus ($127.61 in chips) 
Seat 4: Effort92 ($58.06 in chips) 
Seat 6: TonnaMunz ($124.90 in chips) 
Seat 7: hoedtrob ($60.21 in chips) 
Seat 8: matiko09 ($104.25 in chips) 
Seat 9: 1989jr1989 ($51.19 in chips) 
Effort92: posts small blind $0.25
Optimistic21: is sitting out 
Optimistic21 leaves the table
KoWaiKai129 joins the table at seat #5 
TonnaMunz: posts big blind $0.50
1989jr1989: posts big blind $0.50
vlad11122007: posts the ante $0.10
Saggitaurus: posts the ante $0.10
Effort92: posts the ante $0.10
TonnaMunz: posts the ante $0.10
hoedtrob: posts the ante $0.10
matiko09: posts the ante $0.10
1989jr1989: posts the ante $0.10
*** HOLE CARDS ***
Dealt to matiko09 [7c 9d]
hoedtrob: folds 
matiko09: folds 
1989jr1989: checks 
vlad11122007: folds 
Saggitaurus: folds 
Reffypaul leaves the table
Effort92: folds 
TonnaMunz: raises $2 to $2.50
1989jr1989: calls $2
*** FLOP *** [9s Tc Qh]
TonnaMunz: bets $2.75
KoWaiKai129 leaves the table
1989jr1989: raises $5.75 to $8.50
KoWaiKai129 joins the table at seat #2 
TonnaMunz: calls $5.75
*** TURN *** [9s Tc Qh] [5s]
TonnaMunz: checks 
1989jr1989: bets $40.09 and is all-in
TonnaMunz: folds 
Uncalled bet ($40.09) returned to 1989jr1989
1989jr1989 collected $21.92 from pot
*** SUMMARY ***
Total pot $22.95 | Rake $1.03 
Board [9s Tc Qh 5s]
Seat 1: vlad11122007 folded before Flop (didn't bet)
Seat 3: Saggitaurus (button) folded before Flop (didn't bet)
Seat 4: Effort92 (small blind) folded before Flop
Seat 6: TonnaMunz (big blind) folded on the Turn
Seat 7: hoedtrob folded before Flop (didn't bet)
Seat 8: matiko09 folded before Flop (didn't bet)
Seat 9: 1989jr1989 collected ($21.92)





PokerStars Hand #148608929816:  Hold'em No Limit (€0.25/€0.50 EUR) - 2016/02/11 13:11:42 CET [2016/02/11 7:11:42 ET]
Table 'Otero II' 9-max Seat #7 is the button
Seat 1: Effort92 (€50 in chips) 
Seat 2: Dantist1122 (€50 in chips) 
Seat 3: Szevasztopol (€50 in chips) 
Seat 4: kram0909 (€7.55 in chips) 
Seat 5: vlad11122007 (€49.44 in chips) 
Seat 7: Dflingern95 (€58.20 in chips) 
Seat 8: matiko09 (€71.68 in chips) 
matiko09: posts small blind €0.25
Optimistic21: is sitting out 
Effort92: posts big blind €0.50
*** HOLE CARDS ***
Dealt to matiko09 [Js Ad]
Optimistic21 leaves the table
Dantist1122: folds 
Szevasztopol: folds 
FoRvvArD_go joins the table at seat #9 
kram0909: folds 
vlad11122007: folds 
Dflingern95: calls €0.50
matiko09: raises €2 to €2.50
Effort92: folds 
Dflingern95: folds 
Uncalled bet (€2) returned to matiko09
matiko09 collected €1.50 from pot
matiko09: doesn't show hand 
*** SUMMARY ***
Total pot €1.50 | Rake €0 
Seat 1: Effort92 (big blind) folded before Flop
Seat 2: Dantist1122 folded before Flop (didn't bet)
Seat 3: Szevasztopol folded before Flop (didn't bet)
Seat 4: kram0909 folded before Flop (didn't bet)
Seat 5: vlad11122007 folded before Flop (didn't bet)
Seat 7: Dflingern95 (button) folded before Flop
Seat 8: matiko09 (small blind) collected (€1.50)





PokerStars Hand #148608932887:  Hold'em No Limit ($0.50/$1.00 USD) - 2016/02/11 13:11:47 CET [2016/02/11 7:11:47 ET]
Table 'Stephano V' 9-max Seat #9 is the button
Seat 1: hammerwife ($100 in chips) 
Seat 2: matiko09 ($130.01 in chips) 
Seat 3: sebaaastian ($100 in chips) 
Seat 4: Zeeshka ($126.32 in chips) 
Seat 5: n2call ($165.90 in chips) 
Seat 7: hurtNCYDE ($103.70 in chips) 
Seat 8: oscarleon ($218.73 in chips) 
Seat 9: IcocaynaI ($104.80 in chips) 
hammerwife: posts small blind $0.50
matiko09: posts big blind $1
*** HOLE CARDS ***
Dealt to matiko09 [Jh Ah]
sebaaastian: raises $2 to $3
Zeeshka: folds 
n2call: calls $3
hurtNCYDE: folds 
oscarleon: calls $3
IcocaynaI: folds 
hammerwife: folds 
matiko09: calls $2
*** FLOP *** [Ac 9s Ad]
matiko09: checks 
sebaaastian: checks 
n2call: checks 
oscarleon: checks 
*** TURN *** [Ac 9s Ad] [2d]
matiko09: bets $6.20
sebaaastian: folds 
n2call: folds 
oscarleon: folds 
Uncalled bet ($6.20) returned to matiko09
matiko09 collected $11.94 from pot
matiko09: doesn't show hand 
*** SUMMARY ***
Total pot $12.50 | Rake $0.56 
Board [Ac 9s Ad 2d]
Seat 1: hammerwife (small blind) folded before Flop
Seat 2: matiko09 (big blind) collected ($11.94)
Seat 3: sebaaastian folded on the Turn
Seat 4: Zeeshka folded before Flop (didn't bet)
Seat 5: n2call folded on the Turn
Seat 7: hurtNCYDE folded before Flop (didn't bet)
Seat 8: oscarleon folded on the Turn
Seat 9: IcocaynaI (button) folded before Flop (didn't bet)





PokerStars Hand #148608934624:  Hold'em No Limit ($0.25/$0.50 USD) - 2016/02/11 13:11:50 CET [2016/02/11 7:11:50 ET]
Table 'Oenone' 9-max Seat #5 is the button
Seat 1: tallonn88 ($53.75 in chips) 
Seat 2: Reven9er ($50 in chips) 
Seat 3: Crazy_Giant1 ($39.03 in chips) 
Seat 4: Serhent ($50 in chips) 
Seat 5: ReinisRNS ($57.34 in chips) 
Seat 6: matiko09 ($50.50 in chips) 
Seat 7: banit7 ($53.25 in chips) 
Seat 8: vlad11122007 ($80.45 in chips) 
matiko09: posts small blind $0.25
banit7: posts big blind $0.50
*** HOLE CARDS ***
Dealt to matiko09 [Kc Qh]
vlad11122007: raises $1 to $1.50
tallonn88: calls $1.50
Reven9er: folds 
Crazy_Giant1: folds 
Crazy_Giant1 leaves the table
Serhent: folds 
ReinisRNS: folds 
matiko09: folds 
banit7: folds 
*** FLOP *** [3c Jh Qd]
xxxibgdrgn joins the table at seat #9 
vlad11122007: bets $2.25
fandorin2005 joins the table at seat #3 
fandorin2005 leaves the table
tallonn88: calls $2.25
*** TURN *** [3c Jh Qd] [8d]
TPACHCI7OPT joins the table at seat #3 
vlad11122007: checks 
tallonn88: checks 
*** RIVER *** [3c Jh Qd 8d] [Kh]
vlad11122007: checks 
tallonn88: checks 
*** SHOW DOWN ***
vlad11122007: shows [As Ks] (a pair of Kings)
tallonn88: mucks hand 
vlad11122007 collected $7.88 from pot
*** SUMMARY ***
Total pot $8.25 | Rake $0.37 
Board [3c Jh Qd 8d Kh]
Seat 1: tallonn88 mucked [Td Tc]
Seat 2: Reven9er folded before Flop (didn't bet)
Seat 3: Crazy_Giant1 folded before Flop (didn't bet)
Seat 4: Serhent folded before Flop (didn't bet)
Seat 5: ReinisRNS (button) folded before Flop (didn't bet)
Seat 6: matiko09 (small blind) folded before Flop
Seat 7: banit7 (big blind) folded before Flop
Seat 8: vlad11122007 showed [As Ks] and won ($7.88) with a pair of Kings





PokerStars Hand #148608934988:  Hold'em No Limit ($0.50/$1.00 USD) - 2016/02/11 13:11:51 CET [2016/02/11 7:11:51 ET]
Table 'Gianfar' 9-max Seat #2 is the button
Seat 1: sebaaastian ($234.31 in chips) 
Seat 2: bilukm ($100 in chips) 
Seat 3: AlKatrone ($111.83 in chips) 
Seat 4: matiko09 ($123.82 in chips) 
Seat 5: hammerwife ($175.79 in chips) 
Seat 7: Rikti ($38 in chips) 
Seat 8: Zeeshka ($100 in chips) 
Seat 9: oscarleon ($146.66 in chips) 
AlKatrone: posts small blind $0.50
matiko09: posts big blind $1
*** HOLE CARDS ***
Dealt to matiko09 [8h 9s]
hammerwife: folds 
Rikti: folds 
Zeeshka: folds 
oscarleon: folds 
sebaaastian: folds 
bilukm: calls $1
AlKatrone: calls $0.50
matiko09: checks 
*** FLOP *** [Qd Js Kh]
AlKatrone: checks 
matiko09: checks 
bilukm: checks 
*** TURN *** [Qd Js Kh] [7d]
AlKatrone: checks 
matiko09: checks 
bilukm: checks 
*** RIVER *** [Qd Js Kh 7d] [4h]
AlKatrone: checks 
matiko09: checks 
bilukm: checks 
*** SHOW DOWN ***
AlKatrone: shows [5s 5d] (a pair of Fives)
matiko09: mucks hand 
bilukm: mucks hand 
AlKatrone collected $2.86 from pot
*** SUMMARY ***
Total pot $3 | Rake $0.14 
Board [Qd Js Kh 7d 4h]
Seat 1: sebaaastian folded before Flop (didn't bet)
Seat 2: bilukm (button) mucked [3h 5h]
Seat 3: AlKatrone (small blind) showed [5s 5d] and won ($2.86) with a pair of Fives
Seat 4: matiko09 (big blind) mucked [8h 9s]
Seat 5: hammerwife folded before Flop (didn't bet)
Seat 7: Rikti folded before Flop (didn't bet)
Seat 8: Zeeshka folded before Flop (didn't bet)
Seat 9: oscarleon folded before Flop (didn't bet)





PokerStars Hand #148608940373:  Hold'em No Limit ($0.25/$0.50 USD) - 2016/02/11 13:12:00 CET [2016/02/11 7:12:00 ET]
Table 'Stereoskopia' 9-max Seat #6 is the button
Seat 1: JJJ-K9 ($49.50 in chips) 
Seat 2: Optimistic21 ($52.25 in chips) 
Seat 3: Szevasztopol ($58.29 in chips) 
Seat 5: ReinisRNS ($47.27 in chips) 
Seat 6: matiko09 ($52.08 in chips) 
Seat 7: tallonn88 ($55.72 in chips) 
Seat 9: xxxibgdrgn ($50 in chips) 
tallonn88: posts small blind $0.25
xxxibgdrgn: posts big blind $0.50
TPACHCI7OPT: sits out 
*** HOLE CARDS ***
Dealt to matiko09 [9c Ks]
JJJ-K9: folds 
Optimistic21: folds 
Jo_Medici joins the table at seat #8 
Szevasztopol has timed out
Szevasztopol: folds 
ReinisRNS: folds 
matiko09: raises $0.63 to $1.13
tallonn88: folds 
xxxibgdrgn: calls $0.63
*** FLOP *** [Qd Qh 6d]
xxxibgdrgn: checks 
matiko09: checks 
*** TURN *** [Qd Qh 6d] [4d]
xxxibgdrgn: bets $1.50
matiko09: folds 
Uncalled bet ($1.50) returned to xxxibgdrgn
xxxibgdrgn collected $2.40 from pot
xxxibgdrgn: doesn't show hand 
*** SUMMARY ***
Total pot $2.51 | Rake $0.11 
Board [Qd Qh 6d 4d]
Seat 1: JJJ-K9 folded before Flop (didn't bet)
Seat 2: Optimistic21 folded before Flop (didn't bet)
Seat 3: Szevasztopol folded before Flop (didn't bet)
Seat 5: ReinisRNS folded before Flop (didn't bet)
Seat 6: matiko09 (button) folded on the Turn
Seat 7: tallonn88 (small blind) folded before Flop
Seat 9: xxxibgdrgn (big blind) collected ($2.40)





PokerStars Hand #148608940117:  Hold'em No Limit ($0.50/$1.00 USD) - 2016/02/11 13:12:00 CET [2016/02/11 7:12:00 ET]
Table 'Marion' 9-max Seat #7 is the button
Seat 1: aseban11 ($101.50 in chips) 
Seat 3: TimStone ($105.96 in chips) 
Seat 4: matiko09 ($100 in chips) 
Seat 5: Rikti ($50.01 in chips) 
Seat 6: 19SERGE74 ($82.17 in chips) 
Seat 7: oscarleon ($100 in chips) 
Seat 9: Zeeshka ($102 in chips) 
Zeeshka: posts small blind $0.50
aseban11: posts big blind $1
*** HOLE CARDS ***
Dealt to matiko09 [Tc Ah]
TimStone: folds 
matiko09: folds 
Rikti: folds 
19SERGE74: calls $1
oscarleon: raises $3 to $4
Zeeshka: folds 
aseban11: folds 
19SERGE74: folds 
Uncalled bet ($3) returned to oscarleon
oscarleon collected $3.50 from pot
oscarleon: doesn't show hand 
*** SUMMARY ***
Total pot $3.50 | Rake $0 
Seat 1: aseban11 (big blind) folded before Flop
Seat 3: TimStone folded before Flop (didn't bet)
Seat 4: matiko09 folded before Flop (didn't bet)
Seat 5: Rikti folded before Flop (didn't bet)
Seat 6: 19SERGE74 folded before Flop
Seat 7: oscarleon (button) collected ($3.50)
Seat 9: Zeeshka (small blind) folded before Flop





PokerStars Hand #148608944166:  Hold'em No Limit ($0.50/$1.00 USD) - 2016/02/11 13:12:07 CET [2016/02/11 7:12:07 ET]
Table 'Aoluta' 9-max Seat #6 is the button
Seat 1: sebaaastian ($105.66 in chips) 
Seat 2: matiko09 ($100 in chips) 
Seat 3: Zeeshka ($104.10 in chips) 
Seat 4: oscarleon ($181.97 in chips) 
Seat 5: aseban11 ($100 in chips) 
Seat 6: Luck In Me ($107 in chips) 
Seat 7: grigy197 ($88.64 in chips) 
Seat 8: mrspecial1 ($58 in chips) 
grigy197: posts small blind $0.50
mrspecial1: posts big blind $1
*** HOLE CARDS ***
Dealt to matiko09 [6c 7d]
sebaaastian: folds 
matiko09: folds 
Zeeshka: folds 
oscarleon: folds 
aseban11: folds 
Luck In Me: folds 
grigy197: calls $0.50
mrspecial1: raises $4 to $5
grigy197: folds 
Uncalled bet ($4) returned to mrspecial1
mrspecial1 collected $2 from pot
mrspecial1: doesn't show hand 
*** SUMMARY ***
Total pot $2 | Rake $0 
Seat 1: sebaaastian folded before Flop (didn't bet)
Seat 2: matiko09 folded before Flop (didn't bet)
Seat 3: Zeeshka folded before Flop (didn't bet)
Seat 4: oscarleon folded before Flop (didn't bet)
Seat 5: aseban11 folded before Flop (didn't bet)
Seat 6: Luck In Me (button) folded before Flop (didn't bet)
Seat 7: grigy197 (small blind) folded before Flop
Seat 8: mrspecial1 (big blind) collected ($2)





PokerStars Hand #148608945523:  Hold'em No Limit (€0.25/€0.50 EUR) - 2016/02/11 13:12:09 CET [2016/02/11 7:12:09 ET]
Table 'Otero II' 9-max Seat #8 is the button
Seat 1: Effort92 (€50 in chips) 
Seat 2: Dantist1122 (€50 in chips) 
Seat 3: Szevasztopol (€50 in chips) 
Seat 4: kram0909 (€7.55 in chips) 
Seat 5: vlad11122007 (€49.44 in chips) 
Seat 7: Dflingern95 (€57.70 in chips) 
Seat 8: matiko09 (€72.68 in chips) 
Effort92: posts small blind €0.25
Dantist1122: posts big blind €0.50
*** HOLE CARDS ***
Dealt to matiko09 [8s 2s]
Szevasztopol: raises €1 to €1.50
kram0909: folds 
vlad11122007: folds 
Dflingern95: folds 
matiko09: folds 
Effort92: folds 
Dantist1122: folds 
Uncalled bet (€1) returned to Szevasztopol
Szevasztopol collected €1.25 from pot
Szevasztopol: doesn't show hand 
*** SUMMARY ***
Total pot €1.25 | Rake €0 
Seat 1: Effort92 (small blind) folded before Flop
Seat 2: Dantist1122 (big blind) folded before Flop
Seat 3: Szevasztopol collected (€1.25)
Seat 4: kram0909 folded before Flop (didn't bet)
Seat 5: vlad11122007 folded before Flop (didn't bet)
Seat 7: Dflingern95 folded before Flop (didn't bet)
Seat 8: matiko09 (button) folded before Flop (didn't bet)





PokerStars Hand #148608946002:  Hold'em No Limit ($0.50/$1.00 USD) - 2016/02/11 13:12:10 CET [2016/02/11 7:12:10 ET]
Table 'Clorinde' 9-max Seat #7 is the button
Seat 1: matiko09 ($100 in chips) 
Seat 2: 19SERGE74 ($82.34 in chips) 
Seat 3: gabi_igna ($100 in chips) 
Seat 5: Mukhin1 ($100 in chips) 
Seat 6: Gcroc52 ($38.50 in chips) 
Seat 7: Zeeshka ($100 in chips) 
Seat 8: aseban11 ($117.72 in chips) 
aseban11: posts small blind $0.50
matiko09: posts big blind $1
*** HOLE CARDS ***
Dealt to matiko09 [4c 5h]
19SERGE74: folds 
gabi_igna: folds 
Mukhin1: folds 
Gcroc52: raises $3 to $4
Zeeshka: folds 
aseban11: calls $3.50
matiko09: folds 
*** FLOP *** [3c 9d 3d]
aseban11: checks 
Gcroc52: bets $4.30
aseban11: folds 
Uncalled bet ($4.30) returned to Gcroc52
Gcroc52 collected $8.60 from pot
*** SUMMARY ***
Total pot $9 | Rake $0.40 
Board [3c 9d 3d]
Seat 1: matiko09 (big blind) folded before Flop
Seat 2: 19SERGE74 folded before Flop (didn't bet)
Seat 3: gabi_igna folded before Flop (didn't bet)
Seat 5: Mukhin1 folded before Flop (didn't bet)
Seat 6: Gcroc52 collected ($8.60)
Seat 7: Zeeshka (button) folded before Flop (didn't bet)
Seat 8: aseban11 (small blind) folded on the Flop





PokerStars Hand #148608954993:  Hold'em No Limit ($0.50/$1.00 USD) - 2016/02/11 13:12:26 CET [2016/02/11 7:12:26 ET]
Table 'Marion' 9-max Seat #9 is the button
Seat 1: aseban11 ($100.50 in chips) 
Seat 2: GusenokRUS ($98.55 in chips) 
Seat 3: TimStone ($105.96 in chips) 
Seat 4: matiko09 ($100 in chips) 
Seat 5: Rikti ($50.01 in chips) 
Seat 6: 19SERGE74 ($81.17 in chips) 
Seat 7: oscarleon ($102.50 in chips) 
Seat 9: Zeeshka ($101.50 in chips) 
aseban11: posts small blind $0.50
GusenokRUS: posts big blind $1
*** HOLE CARDS ***
Dealt to matiko09 [Ks 6s]
TimStone: folds 
matiko09: folds 
Rikti: folds 
19SERGE74: calls $1
oscarleon: folds 
Zeeshka: folds 
aseban11: folds 
GusenokRUS: checks 
*** FLOP *** [8d Jc Ad]
GusenokRUS: checks 
19SERGE74: bets $1.19
GusenokRUS: calls $1.19
*** TURN *** [8d Jc Ad] [7h]
GusenokRUS: checks 
19SERGE74: bets $3.10
GusenokRUS: calls $3.10
*** RIVER *** [8d Jc Ad 7h] [5s]
GusenokRUS: checks 
19SERGE74: bets $6
GusenokRUS: calls $6
*** SHOW DOWN ***
19SERGE74: shows [4d 4h] (a pair of Fours)
GusenokRUS: shows [9h Jd] (a pair of Jacks)
GusenokRUS collected $22.04 from pot
*** SUMMARY ***
Total pot $23.08 | Rake $1.04 
Board [8d Jc Ad 7h 5s]
Seat 1: aseban11 (small blind) folded before Flop
Seat 2: GusenokRUS (big blind) showed [9h Jd] and won ($22.04) with a pair of Jacks
Seat 3: TimStone folded before Flop (didn't bet)
Seat 4: matiko09 folded before Flop (didn't bet)
Seat 5: Rikti folded before Flop (didn't bet)
Seat 6: 19SERGE74 showed [4d 4h] and lost with a pair of Fours
Seat 7: oscarleon folded before Flop (didn't bet)
Seat 9: Zeeshka (button) folded before Flop (didn't bet)





PokerStars Hand #148608965231:  Hold'em No Limit ($0.50/$1.00 USD) - 2016/02/11 13:12:43 CET [2016/02/11 7:12:43 ET]
Table 'Aoluta' 9-max Seat #7 is the button
Seat 1: sebaaastian ($105.66 in chips) 
Seat 2: matiko09 ($100 in chips) 
Seat 3: Zeeshka ($104.10 in chips) 
Seat 4: oscarleon ($181.97 in chips) 
Seat 5: aseban11 ($100 in chips) 
Seat 6: Luck In Me ($107 in chips) 
Seat 7: grigy197 ($87.64 in chips) 
Seat 8: mrspecial1 ($59 in chips) 
mrspecial1: posts small blind $0.50
sebaaastian: posts big blind $1
*** HOLE CARDS ***
Dealt to matiko09 [Th Kh]
matiko09: raises $2 to $3
Zeeshka: folds 
oscarleon: folds 
aseban11: calls $3
Luck In Me: folds 
grigy197: folds 
mrspecial1: calls $2.50
sebaaastian: folds 
*** FLOP *** [Qc Tc Qs]
mrspecial1: checks 
matiko09: bets $4.96
aseban11: folds 
mrspecial1: folds 
Uncalled bet ($4.96) returned to matiko09
matiko09 collected $9.55 from pot
matiko09: doesn't show hand 
*** SUMMARY ***
Total pot $10 | Rake $0.45 
Board [Qc Tc Qs]
Seat 1: sebaaastian (big blind) folded before Flop
Seat 2: matiko09 collected ($9.55)
Seat 3: Zeeshka folded before Flop (didn't bet)
Seat 4: oscarleon folded before Flop (didn't bet)
Seat 5: aseban11 folded on the Flop
Seat 6: Luck In Me folded before Flop (didn't bet)
Seat 7: grigy197 (button) folded before Flop (didn't bet)
Seat 8: mrspecial1 (small blind) folded on the Flop





PokerStars Hand #148608967130:  Hold'em No Limit (€0.25/€0.50 EUR) - 2016/02/11 13:12:47 CET [2016/02/11 7:12:47 ET]
Table 'Otero II' 9-max Seat #1 is the button
Seat 1: Effort92 (€50 in chips) 
Seat 2: Dantist1122 (€50 in chips) 
Seat 3: Szevasztopol (€50.75 in chips) 
Seat 4: kram0909 (€7.55 in chips) 
Seat 5: vlad11122007 (€49.44 in chips) 
Seat 7: Dflingern95 (€57.70 in chips) 
Seat 8: matiko09 (€72.68 in chips) 
Dantist1122: posts small blind €0.25
Szevasztopol: posts big blind €0.50
*** HOLE CARDS ***
Dealt to matiko09 [Qd Jc]
kram0909: calls €0.50
vlad11122007: folds 
Dflingern95: folds 
matiko09: raises €1 to €1.50
Effort92: folds 
Dantist1122: folds 
Szevasztopol: folds 
kram0909: calls €1
*** FLOP *** [Js 7d 9h]
kram0909: bets €6.05 and is all-in
matiko09: calls €6.05
*** TURN *** [Js 7d 9h] [9d]
*** RIVER *** [Js 7d 9h 9d] [3h]
*** SHOW DOWN ***
kram0909: shows [Jd Kd] (two pair, Jacks and Nines)
matiko09: mucks hand 
kram0909 collected €15.14 from pot
*** SUMMARY ***
Total pot €15.85 | Rake €0.71 
Board [Js 7d 9h 9d 3h]
Seat 1: Effort92 (button) folded before Flop (didn't bet)
Seat 2: Dantist1122 (small blind) folded before Flop
Seat 3: Szevasztopol (big blind) folded before Flop
Seat 4: kram0909 showed [Jd Kd] and won (€15.14) with two pair, Jacks and Nines
Seat 5: vlad11122007 folded before Flop (didn't bet)
Seat 7: Dflingern95 folded before Flop (didn't bet)
Seat 8: matiko09 mucked [Qd Jc]





PokerStars Hand #148608968605:  Hold'em No Limit ($0.25/$0.50 USD) - 2016/02/11 13:12:49 CET [2016/02/11 7:12:49 ET]
Table 'Ambrosia II' 9-max Seat #4 is the button
Seat 1: matiko09 ($52.54 in chips) 
Seat 3: make6a ($87.18 in chips) 
Seat 4: huudk2016 ($39.32 in chips) 
Seat 6: Reven9er ($57.27 in chips) 
Seat 7: Ana.Satravca ($50 in chips) 
Seat 9: arctur17 ($57.42 in chips) 
RICKA16 will be allowed to play after the button
Reven9er: posts small blind $0.25
Ana.Satravca: posts big blind $0.50
tallonn88: sits out 
JJJ-K9: sits out 
*** HOLE CARDS ***
Dealt to matiko09 [7s 4d]
arctur17: folds 
matiko09: folds 
make6a: raises $0.55 to $1.05
huudk2016: folds 
Reven9er: folds 
Ana.Satravca: raises $2.45 to $3.50
make6a: calls $2.45
*** FLOP *** [3h 2c 3d]
Ana.Satravca: bets $4.50
make6a: folds 
Uncalled bet ($4.50) returned to Ana.Satravca
Ana.Satravca collected $6.92 from pot
Ana.Satravca: doesn't show hand 
*** SUMMARY ***
Total pot $7.25 | Rake $0.33 
Board [3h 2c 3d]
Seat 1: matiko09 folded before Flop (didn't bet)
Seat 3: make6a folded on the Flop
Seat 4: huudk2016 (button) folded before Flop (didn't bet)
Seat 6: Reven9er (small blind) folded before Flop
Seat 7: Ana.Satravca (big blind) collected ($6.92)
Seat 9: arctur17 folded before Flop (didn't bet)





PokerStars Hand #148608970772:  Hold'em No Limit ($0.25/$0.50 USD) - 2016/02/11 13:12:53 CET [2016/02/11 7:12:53 ET]
Table 'Sylvania II' 9-max Seat #3 is the button
Seat 1: tw0315 ($83.01 in chips) 
Seat 2: Effort92 ($61.49 in chips) 
Seat 3: ruyingren ($218.43 in chips) 
Seat 4: matiko09 ($130.49 in chips) 
Seat 5: vlad11122007 ($58.59 in chips) 
Seat 6: TonnaMunz ($130.81 in chips) 
Seat 7: 2lefthand75 ($86.50 in chips) 
Seat 8: Optimistic21 ($50 in chips) 
matiko09: posts small blind $0.25
vlad11122007: posts big blind $0.50
Yippiebeans: sits out 
tw0315: posts the ante $0.10
Effort92: posts the ante $0.10
ruyingren: posts the ante $0.10
matiko09: posts the ante $0.10
vlad11122007: posts the ante $0.10
TonnaMunz: posts the ante $0.10
2lefthand75: posts the ante $0.10
Optimistic21: posts the ante $0.10
*** HOLE CARDS ***
Dealt to matiko09 [9s 7s]
TonnaMunz: folds 
2lefthand75: folds 
Optimistic21: raises $1 to $1.50
tw0315: raises $1.50 to $3
Effort92: folds 
ruyingren: calls $3
matiko09: folds 
vlad11122007: folds 
Optimistic21: calls $1.50
*** FLOP *** [9d As 3d]
Optimistic21: checks 
tw0315: bets $5.04
ruyingren: calls $5.04
Optimistic21: folds 
*** TURN *** [9d As 3d] [4d]
tw0315: checks 
ruyingren: checks 
*** RIVER *** [9d As 3d 4d] [6c]
tw0315: checks 
ruyingren: checks 
*** SHOW DOWN ***
tw0315: shows [7d 9c] (a pair of Nines)
ruyingren: shows [Qd Ac] (a pair of Aces)
ruyingren collected $19.70 from pot
*** SUMMARY ***
Total pot $20.63 | Rake $0.93 
Board [9d As 3d 4d 6c]
Seat 1: tw0315 showed [7d 9c] and lost with a pair of Nines
Seat 2: Effort92 folded before Flop (didn't bet)
Seat 3: ruyingren (button) showed [Qd Ac] and won ($19.70) with a pair of Aces
Seat 4: matiko09 (small blind) folded before Flop
Seat 5: vlad11122007 (big blind) folded before Flop
Seat 6: TonnaMunz folded before Flop (didn't bet)
Seat 7: 2lefthand75 folded before Flop (didn't bet)
Seat 8: Optimistic21 folded on the Flop





PokerStars Hand #148608980651:  Hold'em No Limit ($0.50/$1.00 USD) - 2016/02/11 13:13:10 CET [2016/02/11 7:13:10 ET]
Table 'Clorinde' 9-max Seat #8 is the button
Seat 1: matiko09 ($100 in chips) 
Seat 2: 19SERGE74 ($82.34 in chips) 
Seat 3: gabi_igna ($100 in chips) 
Seat 5: Mukhin1 ($100 in chips) 
Seat 6: Gcroc52 ($43.10 in chips) 
Seat 7: Zeeshka ($100 in chips) 
Seat 8: aseban11 ($113.72 in chips) 
matiko09: posts small blind $0.50
19SERGE74: posts big blind $1
*** HOLE CARDS ***
Dealt to matiko09 [7h 9s]
gabi_igna: folds 
Mukhin1: folds 
Gcroc52: raises $1 to $2
Zeeshka: folds 
aseban11: raises $4.50 to $6.50
matiko09: folds 
19SERGE74: folds 
Gcroc52: folds 
Uncalled bet ($4.50) returned to aseban11
aseban11 collected $5.50 from pot
aseban11: doesn't show hand 
*** SUMMARY ***
Total pot $5.50 | Rake $0 
Seat 1: matiko09 (small blind) folded before Flop
Seat 2: 19SERGE74 (big blind) folded before Flop
Seat 3: gabi_igna folded before Flop (didn't bet)
Seat 5: Mukhin1 folded before Flop (didn't bet)
Seat 6: Gcroc52 folded before Flop
Seat 7: Zeeshka folded before Flop (didn't bet)
Seat 8: aseban11 (button) collected ($5.50)





PokerStars Hand #148608984172:  Hold'em No Limit ($0.50/$1.00 USD) - 2016/02/11 13:13:16 CET [2016/02/11 7:13:16 ET]
Table 'Marion' 9-max Seat #1 is the button
Seat 1: aseban11 ($100 in chips) 
Seat 2: GusenokRUS ($109.30 in chips) 
Seat 3: TimStone ($105.96 in chips) 
Seat 4: matiko09 ($100 in chips) 
Seat 5: Rikti ($50.01 in chips) 
Seat 6: 19SERGE74 ($69.88 in chips) 
Seat 7: oscarleon ($102.50 in chips) 
Seat 9: Zeeshka ($101.50 in chips) 
GusenokRUS: posts small blind $0.50
TimStone: posts big blind $1
*** HOLE CARDS ***
Dealt to matiko09 [4s 4d]
matiko09: folds 
Rikti: folds 
19SERGE74: calls $1
oscarleon: folds 
Zeeshka: raises $2.95 to $3.95
aseban11: calls $3.95
GusenokRUS: calls $3.45
TimStone: folds 
19SERGE74: raises $65.93 to $69.88 and is all-in
Zeeshka: folds 
aseban11: folds 
GusenokRUS: folds 
Uncalled bet ($65.93) returned to 19SERGE74
19SERGE74 collected $16.80 from pot
19SERGE74: doesn't show hand 
*** SUMMARY ***
Total pot $16.80 | Rake $0 
Seat 1: aseban11 (button) folded before Flop
Seat 2: GusenokRUS (small blind) folded before Flop
Seat 3: TimStone (big blind) folded before Flop
Seat 4: matiko09 folded before Flop (didn't bet)
Seat 5: Rikti folded before Flop (didn't bet)
Seat 6: 19SERGE74 collected ($16.80)
Seat 7: oscarleon folded before Flop (didn't bet)
Seat 9: Zeeshka folded before Flop





PokerStars Hand #148608989132:  Hold'em No Limit ($0.25/$0.50 USD) - 2016/02/11 13:13:24 CET [2016/02/11 7:13:24 ET]
Table 'Oenone' 9-max Seat #6 is the button
Seat 1: tallonn88 ($50 in chips) 
Seat 2: Reven9er ($50 in chips) 
Seat 4: Serhent ($50 in chips) 
Seat 5: ReinisRNS ($57.34 in chips) 
Seat 6: matiko09 ($50.25 in chips) 
Seat 7: banit7 ($52.75 in chips) 
Seat 8: vlad11122007 ($84.58 in chips) 
banit7: posts small blind $0.25
vlad11122007: posts big blind $0.50
xxxibgdrgn: sits out 
TPACHCI7OPT: sits out 
*** HOLE CARDS ***
Dealt to matiko09 [Qh 9s]
tallonn88: folds 
Reven9er: folds 
Serhent: folds 
ReinisRNS: folds 
matiko09: raises $0.63 to $1.13
banit7: folds 
vlad11122007: calls $0.63
*** FLOP *** [Qd 5s 7h]
vlad11122007: checks 
matiko09: bets $1.56
vlad11122007: calls $1.56
*** TURN *** [Qd 5s 7h] [6c]
vlad11122007: checks 
matiko09: checks 
*** RIVER *** [Qd 5s 7h 6c] [Ad]
vlad11122007: checks 
matiko09: checks 
*** SHOW DOWN ***
vlad11122007: shows [5h Kh] (a pair of Fives)
matiko09: shows [Qh 9s] (a pair of Queens)
matiko09 collected $5.38 from pot
*** SUMMARY ***
Total pot $5.63 | Rake $0.25 
Board [Qd 5s 7h 6c Ad]
Seat 1: tallonn88 folded before Flop (didn't bet)
Seat 2: Reven9er folded before Flop (didn't bet)
Seat 4: Serhent folded before Flop (didn't bet)
Seat 5: ReinisRNS folded before Flop (didn't bet)
Seat 6: matiko09 (button) showed [Qh 9s] and won ($5.38) with a pair of Queens
Seat 7: banit7 (small blind) folded before Flop
Seat 8: vlad11122007 (big blind) showed [5h Kh] and lost with a pair of Fives





PokerStars Hand #148608990684:  Hold'em No Limit ($0.50/$1.00 USD) - 2016/02/11 13:13:27 CET [2016/02/11 7:13:27 ET]
Table 'Aoluta' 9-max Seat #8 is the button
Seat 1: sebaaastian ($104.66 in chips) 
Seat 2: matiko09 ($106.55 in chips) 
Seat 3: Zeeshka ($104.10 in chips) 
Seat 4: oscarleon ($181.97 in chips) 
Seat 5: aseban11 ($100 in chips) 
Seat 6: Luck In Me ($107 in chips) 
Seat 7: grigy197 ($87.64 in chips) 
Seat 8: mrspecial1 ($56 in chips) 
sebaaastian: posts small blind $0.50
matiko09: posts big blind $1
*** HOLE CARDS ***
Dealt to matiko09 [8d 2s]
Zeeshka: raises $2 to $3
oscarleon: folds 
aseban11: folds 
Luck In Me: folds 
grigy197: folds 
mrspecial1: raises $7 to $10
sebaaastian: folds 
matiko09: folds 
Zeeshka: folds 
Uncalled bet ($7) returned to mrspecial1
mrspecial1 collected $7.50 from pot
mrspecial1: doesn't show hand 
*** SUMMARY ***
Total pot $7.50 | Rake $0 
Seat 1: sebaaastian (small blind) folded before Flop
Seat 2: matiko09 (big blind) folded before Flop
Seat 3: Zeeshka folded before Flop
Seat 4: oscarleon folded before Flop (didn't bet)
Seat 5: aseban11 folded before Flop (didn't bet)
Seat 6: Luck In Me folded before Flop (didn't bet)
Seat 7: grigy197 folded before Flop (didn't bet)
Seat 8: mrspecial1 (button) collected ($7.50)





PokerStars Hand #148608994574:  Hold'em No Limit ($0.50/$1.00 USD) - 2016/02/11 13:13:34 CET [2016/02/11 7:13:34 ET]
Table 'Gianfar' 9-max Seat #3 is the button
Seat 1: sebaaastian ($234.31 in chips) 
Seat 2: bilukm ($99 in chips) 
Seat 3: AlKatrone ($113.69 in chips) 
Seat 4: matiko09 ($122.82 in chips) 
Seat 5: hammerwife ($175.79 in chips) 
Seat 7: Rikti ($38 in chips) 
Seat 8: Zeeshka ($100 in chips) 
Seat 9: oscarleon ($146.66 in chips) 
matiko09: posts small blind $0.50
hammerwife: posts big blind $1
*** HOLE CARDS ***
Dealt to matiko09 [3c Ad]
Rikti: folds 
Zeeshka: folds 
oscarleon: folds 
sebaaastian: folds 
bilukm: folds 
AlKatrone: raises $1 to $2
matiko09: folds 
hammerwife: folds 
Uncalled bet ($1) returned to AlKatrone
AlKatrone collected $2.50 from pot
AlKatrone: doesn't show hand 
*** SUMMARY ***
Total pot $2.50 | Rake $0 
Seat 1: sebaaastian folded before Flop (didn't bet)
Seat 2: bilukm folded before Flop (didn't bet)
Seat 3: AlKatrone (button) collected ($2.50)
Seat 4: matiko09 (small blind) folded before Flop
Seat 5: hammerwife (big blind) folded before Flop
Seat 7: Rikti folded before Flop (didn't bet)
Seat 8: Zeeshka folded before Flop (didn't bet)
Seat 9: oscarleon folded before Flop (didn't bet)





PokerStars Hand #148608995838:  Hold'em No Limit (€0.25/€0.50 EUR) - 2016/02/11 13:13:36 CET [2016/02/11 7:13:36 ET]
Table 'Otero II' 9-max Seat #2 is the button
Seat 1: Effort92 (€50 in chips) 
Seat 2: Dantist1122 (€50 in chips) 
Seat 3: Szevasztopol (€50.25 in chips) 
Seat 4: kram0909 (€15.14 in chips) 
Seat 5: vlad11122007 (€49.44 in chips) 
Seat 7: Dflingern95 (€57.70 in chips) 
Seat 8: matiko09 (€65.13 in chips) 
Szevasztopol: posts small blind €0.25
kram0909: posts big blind €0.50
*** HOLE CARDS ***
Dealt to matiko09 [9s Ac]
vlad11122007: folds 
Dflingern95: folds 
matiko09: folds 
Effort92: folds 
Dantist1122: folds 
Szevasztopol: raises €1 to €1.50
kram0909: folds 
Uncalled bet (€1) returned to Szevasztopol
Szevasztopol collected €1 from pot
Szevasztopol: doesn't show hand 
*** SUMMARY ***
Total pot €1 | Rake €0 
Seat 1: Effort92 folded before Flop (didn't bet)
Seat 2: Dantist1122 (button) folded before Flop (didn't bet)
Seat 3: Szevasztopol (small blind) collected (€1)
Seat 4: kram0909 (big blind) folded before Flop
Seat 5: vlad11122007 folded before Flop (didn't bet)
Seat 7: Dflingern95 folded before Flop (didn't bet)
Seat 8: matiko09 folded before Flop (didn't bet)





PokerStars Hand #148608997079:  Hold'em No Limit ($0.50/$1.00 USD) - 2016/02/11 13:13:38 CET [2016/02/11 7:13:38 ET]
Table 'Stephano V' 9-max Seat #1 is the button
Seat 1: hammerwife ($100 in chips) 
Seat 2: matiko09 ($138.95 in chips) 
Seat 3: sebaaastian ($100 in chips) 
Seat 4: Zeeshka ($126.32 in chips) 
Seat 5: n2call ($162.90 in chips) 
Seat 7: hurtNCYDE ($103.70 in chips) 
Seat 8: oscarleon ($215.73 in chips) 
Seat 9: IcocaynaI ($104.80 in chips) 
matiko09: posts small blind $0.50
sebaaastian: posts big blind $1
*** HOLE CARDS ***
Dealt to matiko09 [3c Ac]
Zeeshka: folds 
n2call: folds 
hurtNCYDE: folds 
oscarleon: folds 
IcocaynaI: folds 
hammerwife: folds 
matiko09: raises $1.50 to $2.50
sebaaastian: folds 
Uncalled bet ($1.50) returned to matiko09
matiko09 collected $2 from pot
matiko09: doesn't show hand 
*** SUMMARY ***
Total pot $2 | Rake $0 
Seat 1: hammerwife (button) folded before Flop (didn't bet)
Seat 2: matiko09 (small blind) collected ($2)
Seat 3: sebaaastian (big blind) folded before Flop
Seat 4: Zeeshka folded before Flop (didn't bet)
Seat 5: n2call folded before Flop (didn't bet)
Seat 7: hurtNCYDE folded before Flop (didn't bet)
Seat 8: oscarleon folded before Flop (didn't bet)
Seat 9: IcocaynaI folded before Flop (didn't bet)





PokerStars Hand #148608997058:  Hold'em No Limit ($0.25/$0.50 USD) - 2016/02/11 13:13:38 CET [2016/02/11 7:13:38 ET]
Table 'Stereoskopia' 9-max Seat #7 is the button
Seat 1: JJJ-K9 ($49.50 in chips) 
Seat 2: Optimistic21 ($52.25 in chips) 
Seat 5: ReinisRNS ($47.27 in chips) 
Seat 6: matiko09 ($50.95 in chips) 
Seat 7: tallonn88 ($55.47 in chips) 
Seat 9: xxxibgdrgn ($51.27 in chips) 
Jo_Medici will be allowed to play after the button
xxxibgdrgn: posts small blind $0.25
JJJ-K9: posts big blind $0.50
TPACHCI7OPT: sits out 
*** HOLE CARDS ***
Dealt to matiko09 [6s Ts]
Optimistic21: folds 
ReinisRNS: folds 
matiko09: folds 
tallonn88: folds 
xxxibgdrgn: raises $1 to $1.50
JJJ-K9: raises $3 to $4.50
xxxibgdrgn: calls $3
*** FLOP *** [Qc 4d Jc]
xxxibgdrgn: checks 
JJJ-K9: bets $4.50
xxxibgdrgn: folds 
Uncalled bet ($4.50) returned to JJJ-K9
JJJ-K9 collected $8.60 from pot
JJJ-K9: doesn't show hand 
*** SUMMARY ***
Total pot $9 | Rake $0.40 
Board [Qc 4d Jc]
Seat 1: JJJ-K9 (big blind) collected ($8.60)
Seat 2: Optimistic21 folded before Flop (didn't bet)
Seat 5: ReinisRNS folded before Flop (didn't bet)
Seat 6: matiko09 folded before Flop (didn't bet)
Seat 7: tallonn88 (button) folded before Flop (didn't bet)
Seat 9: xxxibgdrgn (small blind) folded on the Flop





PokerStars Hand #148609000542:  Hold'em No Limit ($0.25/$0.50 USD) - 2016/02/11 13:13:44 CET [2016/02/11 7:13:44 ET]
Table 'Ambrosia II' 9-max Seat #6 is the button
Seat 1: matiko09 ($52.54 in chips) 
Seat 3: make6a ($83.68 in chips) 
Seat 4: huudk2016 ($39.32 in chips) 
Seat 6: Reven9er ($57.02 in chips) 
Seat 7: Ana.Satravca ($53.42 in chips) 
Seat 8: tallonn88 ($57.01 in chips) 
Seat 9: arctur17 ($57.42 in chips) 
Ana.Satravca: posts small blind $0.25
tallonn88: posts big blind $0.50
JJJ-K9: sits out 
RICKA16: sits out 
*** HOLE CARDS ***
Dealt to matiko09 [As Tc]
arctur17: folds 
matiko09: folds 
make6a: raises $0.82 to $1.32
huudk2016: folds 
Reven9er: folds 
Ana.Satravca: folds 
tallonn88: folds 
Uncalled bet ($0.82) returned to make6a
make6a collected $1.25 from pot
make6a: doesn't show hand 
*** SUMMARY ***
Total pot $1.25 | Rake $0 
Seat 1: matiko09 folded before Flop (didn't bet)
Seat 3: make6a collected ($1.25)
Seat 4: huudk2016 folded before Flop (didn't bet)
Seat 6: Reven9er (button) folded before Flop (didn't bet)
Seat 7: Ana.Satravca (small blind) folded before Flop
Seat 8: tallonn88 (big blind) folded before Flop
Seat 9: arctur17 folded before Flop (didn't bet)





PokerStars Hand #148609008748:  Hold'em No Limit ($0.50/$1.00 USD) - 2016/02/11 13:13:58 CET [2016/02/11 7:13:58 ET]
Table 'Clorinde' 9-max Seat #1 is the button
Seat 1: matiko09 ($100 in chips) 
Seat 2: 19SERGE74 ($81.34 in chips) 
Seat 3: gabi_igna ($100 in chips) 
Seat 5: Mukhin1 ($100 in chips) 
Seat 6: Gcroc52 ($41.10 in chips) 
Seat 7: Zeeshka ($100 in chips) 
Seat 8: aseban11 ($117.22 in chips) 
19SERGE74: posts small blind $0.50
gabi_igna: posts big blind $1
*** HOLE CARDS ***
Dealt to matiko09 [9c Jh]
Mukhin1: folds 
Gcroc52: folds 
Zeeshka: folds 
aseban11: raises $1.50 to $2.50
matiko09: folds 
19SERGE74: folds 
gabi_igna: calls $1.50
*** FLOP *** [Tc 4c 5s]
gabi_igna: checks 
aseban11: checks 
*** TURN *** [Tc 4c 5s] [Qs]
gabi_igna: bets $5.25
aseban11: folds 
Uncalled bet ($5.25) returned to gabi_igna
gabi_igna collected $5.25 from pot
gabi_igna: doesn't show hand 
*** SUMMARY ***
Total pot $5.50 | Rake $0.25 
Board [Tc 4c 5s Qs]
Seat 1: matiko09 (button) folded before Flop (didn't bet)
Seat 2: 19SERGE74 (small blind) folded before Flop
Seat 3: gabi_igna (big blind) collected ($5.25)
Seat 5: Mukhin1 folded before Flop (didn't bet)
Seat 6: Gcroc52 folded before Flop (didn't bet)
Seat 7: Zeeshka folded before Flop (didn't bet)
Seat 8: aseban11 folded on the Turn





PokerStars Hand #148609015102:  Hold'em No Limit ($0.50/$1.00 USD) - 2016/02/11 13:14:09 CET [2016/02/11 7:14:09 ET]
Table 'Aoluta' 9-max Seat #1 is the button
Seat 1: sebaaastian ($104.16 in chips) 
Seat 2: matiko09 ($105.55 in chips) 
Seat 3: Zeeshka ($101.10 in chips) 
Seat 4: oscarleon ($181.97 in chips) 
Seat 5: aseban11 ($100 in chips) 
Seat 6: Luck In Me ($107 in chips) 
Seat 7: grigy197 ($87.64 in chips) 
Seat 8: mrspecial1 ($60.50 in chips) 
matiko09: posts small blind $0.50
Zeeshka: posts big blind $1
*** HOLE CARDS ***
Dealt to matiko09 [6h Tc]
oscarleon: raises $2 to $3
aseban11: folds 
Luck In Me: folds 
grigy197: calls $3
mrspecial1: folds 
sebaaastian: calls $3
matiko09: folds 
Zeeshka: folds 
*** FLOP *** [2s Qc 7d]
oscarleon: bets $5.21
grigy197: raises $5.21 to $10.42
sebaaastian: folds 
oscarleon: folds 
Uncalled bet ($5.21) returned to grigy197
grigy197 collected $19.98 from pot
*** SUMMARY ***
Total pot $20.92 | Rake $0.94 
Board [2s Qc 7d]
Seat 1: sebaaastian (button) folded on the Flop
Seat 2: matiko09 (small blind) folded before Flop
Seat 3: Zeeshka (big blind) folded before Flop
Seat 4: oscarleon folded on the Flop
Seat 5: aseban11 folded before Flop (didn't bet)
Seat 6: Luck In Me folded before Flop (didn't bet)
Seat 7: grigy197 collected ($19.98)
Seat 8: mrspecial1 folded before Flop (didn't bet)





PokerStars Hand #148609016125:  Hold'em No Limit (€0.25/€0.50 EUR) - 2016/02/11 13:14:10 CET [2016/02/11 7:14:10 ET]
Table 'Otero II' 9-max Seat #3 is the button
Seat 1: Effort92 (€50 in chips) 
Seat 2: Dantist1122 (€50 in chips) 
Seat 3: Szevasztopol (€50.75 in chips) 
Seat 4: kram0909 (€14.64 in chips) 
Seat 5: vlad11122007 (€49.44 in chips) 
Seat 7: Dflingern95 (€57.70 in chips) 
Seat 8: matiko09 (€65.13 in chips) 
kram0909: posts small blind €0.25
vlad11122007: posts big blind €0.50
*** HOLE CARDS ***
Dealt to matiko09 [6d Ts]
Dflingern95: folds 
matiko09: folds 
Effort92: folds 
Dantist1122: raises €0.85 to €1.35
Szevasztopol: folds 
kram0909: calls €1.10
vlad11122007: folds 
*** FLOP *** [4s 5s Kd]
kram0909: bets €0.50
Dantist1122: calls €0.50
*** TURN *** [4s 5s Kd] [7h]
kram0909: checks 
Dantist1122: checks 
*** RIVER *** [4s 5s Kd 7h] [7c]
kram0909: bets €0.50
TonnaMunz is disconnected 
Dantist1122: folds 
Uncalled bet (€0.50) returned to kram0909
kram0909 collected €4.01 from pot
*** SUMMARY ***
Total pot €4.20 | Rake €0.19 
Board [4s 5s Kd 7h 7c]
Seat 1: Effort92 folded before Flop (didn't bet)
Seat 2: Dantist1122 folded on the River
Seat 3: Szevasztopol (button) folded before Flop (didn't bet)
Seat 4: kram0909 (small blind) collected (€4.01)
Seat 5: vlad11122007 (big blind) folded before Flop
Seat 7: Dflingern95 folded before Flop (didn't bet)
Seat 8: matiko09 folded before Flop (didn't bet)





PokerStars Hand #148609017889:  Hold'em No Limit ($0.25/$0.50 USD) - 2016/02/11 13:14:13 CET [2016/02/11 7:14:13 ET]
Table 'Ambrosia II' 9-max Seat #7 is the button
Seat 1: matiko09 ($52.54 in chips) 
Seat 3: make6a ($84.43 in chips) 
Seat 4: huudk2016 ($39.32 in chips) 
Seat 6: Reven9er ($57.02 in chips) 
Seat 7: Ana.Satravca ($53.17 in chips) 
Seat 8: tallonn88 ($56.51 in chips) 
Seat 9: arctur17 ($57.42 in chips) 
tallonn88: posts small blind $0.25
arctur17: posts big blind $0.50
JJJ-K9: sits out 
RICKA16: sits out 
*** HOLE CARDS ***
Dealt to matiko09 [3d 4s]
matiko09: folds 
make6a: folds 
huudk2016: folds 
Reven9er: raises $0.50 to $1
Ana.Satravca: folds 
tallonn88: folds 
arctur17: calls $0.50
*** FLOP *** [7h Js Jd]
arctur17: bets $1.50
Reven9er: calls $1.50
*** TURN *** [7h Js Jd] [Ts]
arctur17: bets $1.50
Reven9er: calls $1.50
*** RIVER *** [7h Js Jd Ts] [4d]
arctur17: bets $1.50
Reven9er: calls $1.50
*** SHOW DOWN ***
arctur17: shows [2s 2h] (two pair, Jacks and Deuces)
Reven9er: shows [9c 9d] (two pair, Jacks and Nines)
Reven9er collected $10.74 from pot
*** SUMMARY ***
Total pot $11.25 | Rake $0.51 
Board [7h Js Jd Ts 4d]
Seat 1: matiko09 folded before Flop (didn't bet)
Seat 3: make6a folded before Flop (didn't bet)
Seat 4: huudk2016 folded before Flop (didn't bet)
Seat 6: Reven9er showed [9c 9d] and won ($10.74) with two pair, Jacks and Nines
Seat 7: Ana.Satravca (button) folded before Flop (didn't bet)
Seat 8: tallonn88 (small blind) folded before Flop
Seat 9: arctur17 (big blind) showed [2s 2h] and lost with two pair, Jacks and Deuces





PokerStars Hand #148609017869:  Hold'em No Limit ($0.50/$1.00 USD) - 2016/02/11 13:14:13 CET [2016/02/11 7:14:13 ET]
Table 'Marion' 9-max Seat #2 is the button
Seat 1: aseban11 ($100 in chips) 
Seat 2: GusenokRUS ($105.35 in chips) 
Seat 3: TimStone ($104.96 in chips) 
Seat 4: matiko09 ($100 in chips) 
Seat 5: Rikti ($50.01 in chips) 
Seat 6: 19SERGE74 ($82.73 in chips) 
Seat 7: oscarleon ($102.50 in chips) 
Seat 9: Zeeshka ($100 in chips) 
TimStone: posts small blind $0.50
matiko09: posts big blind $1
*** HOLE CARDS ***
Dealt to matiko09 [5c Ad]
Rikti: folds 
19SERGE74: calls $1
oscarleon: raises $2.50 to $3.50
Zeeshka: folds 
aseban11: folds 
GusenokRUS: folds 
TimStone: folds 
matiko09: folds 
19SERGE74: calls $2.50
*** FLOP *** [8d 2h 4h]
19SERGE74: checks 
oscarleon: bets $6
19SERGE74: calls $6
*** TURN *** [8d 2h 4h] [Jd]
19SERGE74: checks 
oscarleon: bets $14
19SERGE74: folds 
Uncalled bet ($14) returned to oscarleon
oscarleon collected $19.58 from pot
oscarleon: doesn't show hand 
*** SUMMARY ***
Total pot $20.50 | Rake $0.92 
Board [8d 2h 4h Jd]
Seat 1: aseban11 folded before Flop (didn't bet)
Seat 2: GusenokRUS (button) folded before Flop (didn't bet)
Seat 3: TimStone (small blind) folded before Flop
Seat 4: matiko09 (big blind) folded before Flop
Seat 5: Rikti folded before Flop (didn't bet)
Seat 6: 19SERGE74 folded on the Turn
Seat 7: oscarleon collected ($19.58)
Seat 9: Zeeshka folded before Flop (didn't bet)





PokerStars Hand #148609018316:  Hold'em No Limit ($0.25/$0.50 USD) - 2016/02/11 13:14:14 CET [2016/02/11 7:14:14 ET]
Table 'Oenone' 9-max Seat #7 is the button
Seat 1: tallonn88 ($50 in chips) 
Seat 2: Reven9er ($50 in chips) 
Seat 4: Serhent ($50 in chips) 
Seat 5: ReinisRNS ($57.34 in chips) 
Seat 6: matiko09 ($52.94 in chips) 
Seat 7: banit7 ($52.50 in chips) 
Seat 8: vlad11122007 ($81.89 in chips) 
Seat 9: xxxibgdrgn ($50 in chips) 
vlad11122007: posts small blind $0.25
xxxibgdrgn: posts big blind $0.50
TPACHCI7OPT: sits out 
*** HOLE CARDS ***
Dealt to matiko09 [2h 8s]
tallonn88: folds 
Reven9er: raises $0.50 to $1
Serhent: folds 
ReinisRNS: calls $1
matiko09: folds 
banit7: folds 
vlad11122007: folds 
xxxibgdrgn: folds 
*** FLOP *** [4c 8c Qd]
Reven9er: checks 
ReinisRNS: checks 
*** TURN *** [4c 8c Qd] [4d]
Reven9er: bets $2
ReinisRNS: folds 
Uncalled bet ($2) returned to Reven9er
Reven9er collected $2.63 from pot
Reven9er: doesn't show hand 
*** SUMMARY ***
Total pot $2.75 | Rake $0.12 
Board [4c 8c Qd 4d]
Seat 1: tallonn88 folded before Flop (didn't bet)
Seat 2: Reven9er collected ($2.63)
Seat 4: Serhent folded before Flop (didn't bet)
Seat 5: ReinisRNS folded on the Turn
Seat 6: matiko09 folded before Flop (didn't bet)
Seat 7: banit7 (button) folded before Flop (didn't bet)
Seat 8: vlad11122007 (small blind) folded before Flop
Seat 9: xxxibgdrgn (big blind) folded before Flop





PokerStars Hand #148609019947:  Hold'em No Limit ($0.50/$1.00 USD) - 2016/02/11 13:14:17 CET [2016/02/11 7:14:17 ET]
Table 'Stephano V' 9-max Seat #2 is the button
Seat 1: hammerwife ($100 in chips) 
Seat 2: matiko09 ($139.95 in chips) 
Seat 3: sebaaastian ($100 in chips) 
Seat 4: Zeeshka ($126.32 in chips) 
Seat 5: n2call ($162.90 in chips) 
Seat 7: hurtNCYDE ($103.70 in chips) 
Seat 8: oscarleon ($215.73 in chips) 
Seat 9: IcocaynaI ($104.80 in chips) 
sebaaastian: posts small blind $0.50
Zeeshka: posts big blind $1
*** HOLE CARDS ***
Dealt to matiko09 [7s 8h]
n2call: folds 
hurtNCYDE: folds 
oscarleon: folds 
IcocaynaI: folds 
hammerwife: raises $1.50 to $2.50
matiko09: folds 
sebaaastian: folds 
Zeeshka: calls $1.50
*** FLOP *** [Ac Qh 2s]
Zeeshka: checks 
hammerwife: bets $4
Zeeshka: folds 
Uncalled bet ($4) returned to hammerwife
hammerwife collected $5.25 from pot
hammerwife: doesn't show hand 
*** SUMMARY ***
Total pot $5.50 | Rake $0.25 
Board [Ac Qh 2s]
Seat 1: hammerwife collected ($5.25)
Seat 2: matiko09 (button) folded before Flop (didn't bet)
Seat 3: sebaaastian (small blind) folded before Flop
Seat 4: Zeeshka (big blind) folded on the Flop
Seat 5: n2call folded before Flop (didn't bet)
Seat 7: hurtNCYDE folded before Flop (didn't bet)
Seat 8: oscarleon folded before Flop (didn't bet)
Seat 9: IcocaynaI folded before Flop (didn't bet)





PokerStars Hand #148609021854:  Hold'em No Limit ($0.50/$1.00 USD) - 2016/02/11 13:14:20 CET [2016/02/11 7:14:20 ET]
Table 'Gianfar' 9-max Seat #4 is the button
Seat 1: sebaaastian ($234.31 in chips) 
Seat 2: bilukm ($99 in chips) 
Seat 3: AlKatrone ($115.19 in chips) 
Seat 4: matiko09 ($122.32 in chips) 
Seat 5: hammerwife ($174.79 in chips) 
Seat 7: Rikti ($38 in chips) 
Seat 8: Zeeshka ($100 in chips) 
Seat 9: oscarleon ($146.66 in chips) 
hammerwife: posts small blind $0.50
Rikti: posts big blind $1
*** HOLE CARDS ***
Dealt to matiko09 [5h Js]
Zeeshka: folds 
oscarleon: folds 
sebaaastian: folds 
bilukm: folds 
AlKatrone: folds 
matiko09: folds 
hammerwife: folds 
Uncalled bet ($0.50) returned to Rikti
Rikti collected $1 from pot
Rikti: doesn't show hand 
*** SUMMARY ***
Total pot $1 | Rake $0 
Seat 1: sebaaastian folded before Flop (didn't bet)
Seat 2: bilukm folded before Flop (didn't bet)
Seat 3: AlKatrone folded before Flop (didn't bet)
Seat 4: matiko09 (button) folded before Flop (didn't bet)
Seat 5: hammerwife (small blind) folded before Flop
Seat 7: Rikti (big blind) collected ($1)
Seat 8: Zeeshka folded before Flop (didn't bet)
Seat 9: oscarleon folded before Flop (didn't bet)





PokerStars Hand #148609026065:  Hold'em No Limit ($0.25/$0.50 USD) - 2016/02/11 13:14:28 CET [2016/02/11 7:14:28 ET]
Table 'Stereoskopia' 9-max Seat #9 is the button
Seat 1: JJJ-K9 ($53.60 in chips) 
Seat 4: TPACHCI7OPT ($44.99 in chips) 
Seat 5: ReinisRNS ($47.27 in chips) 
Seat 6: matiko09 ($50.95 in chips) 
Seat 7: tallonn88 ($55.47 in chips) 
Seat 9: xxxibgdrgn ($50 in chips) 
JJJ-K9: posts small blind $0.25
Optimistic21: is sitting out 
Optimistic21 leaves the table
TPACHCI7OPT: posts big blind $0.50
Jo_Medici: sits out 
*** HOLE CARDS ***
Dealt to matiko09 [Kh Kd]
ReinisRNS: folds 
matiko09: raises $1 to $1.50
tallonn88: folds 
xxxibgdrgn: folds 
JJJ-K9: folds 
TPACHCI7OPT: folds 
Uncalled bet ($1) returned to matiko09
matiko09 collected $1.25 from pot
matiko09: doesn't show hand 
*** SUMMARY ***
Total pot $1.25 | Rake $0 
Seat 1: JJJ-K9 (small blind) folded before Flop
Seat 4: TPACHCI7OPT (big blind) folded before Flop
Seat 5: ReinisRNS folded before Flop (didn't bet)
Seat 6: matiko09 collected ($1.25)
Seat 7: tallonn88 folded before Flop (didn't bet)
Seat 9: xxxibgdrgn (button) folded before Flop (didn't bet)





PokerStars Hand #148609027479:  Hold'em No Limit ($0.25/$0.50 USD) - 2016/02/11 13:14:30 CET [2016/02/11 7:14:30 ET]
Table 'Sylvania II' 9-max Seat #4 is the button
Seat 1: tw0315 ($74.87 in chips) 
Seat 2: Effort92 ($61.39 in chips) 
Seat 3: ruyingren ($229.99 in chips) 
Seat 4: matiko09 ($130.14 in chips) 
Seat 5: vlad11122007 ($57.99 in chips) 
Seat 7: 2lefthand75 ($86.40 in chips) 
Seat 8: Optimistic21 ($50 in chips) 
vlad11122007: posts small blind $0.25
2lefthand75: posts big blind $0.50
Yippiebeans: sits out 
tw0315: posts the ante $0.10
Effort92: posts the ante $0.10
ruyingren: posts the ante $0.10
matiko09: posts the ante $0.10
vlad11122007: posts the ante $0.10
2lefthand75: posts the ante $0.10
Optimistic21: posts the ante $0.10
*** HOLE CARDS ***
Dealt to matiko09 [9c Ac]
Optimistic21: folds 
tw0315: calls $0.50
Effort92: raises $1.50 to $2
ruyingren: calls $2
matiko09: raises $6.50 to $8.50
vlad11122007: folds 
2lefthand75: folds 
TonnaMunz is disconnected 
tw0315: calls $8
Effort92: raises $11.50 to $20
ruyingren: folds 
matiko09: folds 
tw0315: calls $11.50
*** FLOP *** [Jh Kd 7s]
tw0315: checks 
Effort92: checks 
*** TURN *** [Jh Kd 7s] [5h]
tw0315: checks 
Effort92: bets $21
tw0315: calls $21
*** RIVER *** [Jh Kd 7s 5h] [3h]
tw0315: bets $33.77 and is all-in
Effort92: calls $20.29 and is all-in
Uncalled bet ($13.48) returned to tw0315
*** SHOW DOWN ***
tw0315: shows [6s 4s] (a straight, Three to Seven)
Effort92: mucks hand 
tw0315 collected $132.03 from pot
*** SUMMARY ***
Total pot $134.53 | Rake $2.50 
Board [Jh Kd 7s 5h 3h]
Seat 1: tw0315 showed [6s 4s] and won ($132.03) with a straight, Three to Seven
Seat 2: Effort92 mucked [Kc Ks]
Seat 3: ruyingren folded before Flop
Seat 4: matiko09 (button) folded before Flop
Seat 5: vlad11122007 (small blind) folded before Flop
Seat 7: 2lefthand75 (big blind) folded before Flop
Seat 8: Optimistic21 folded before Flop (didn't bet)





PokerStars Hand #148609040019:  Hold'em No Limit ($0.50/$1.00 USD) - 2016/02/11 13:14:52 CET [2016/02/11 7:14:52 ET]
Table 'Gianfar' 9-max Seat #5 is the button
Seat 1: sebaaastian ($234.31 in chips) 
Seat 2: bilukm ($99 in chips) 
Seat 3: AlKatrone ($115.19 in chips) 
Seat 4: matiko09 ($122.32 in chips) 
Seat 5: hammerwife ($174.29 in chips) 
Seat 7: Rikti ($38.50 in chips) 
Seat 8: Zeeshka ($100 in chips) 
Seat 9: oscarleon ($146.66 in chips) 
Rikti: posts small blind $0.50
Zeeshka: posts big blind $1
*** HOLE CARDS ***
Dealt to matiko09 [7d Ad]
oscarleon: folds 
sebaaastian: folds 
bilukm: raises $1 to $2
AlKatrone: folds 
matiko09: folds 
hammerwife: folds 
Rikti: folds 
Zeeshka: folds 
Uncalled bet ($1) returned to bilukm
bilukm collected $2.50 from pot
bilukm: doesn't show hand 
*** SUMMARY ***
Total pot $2.50 | Rake $0 
Seat 1: sebaaastian folded before Flop (didn't bet)
Seat 2: bilukm collected ($2.50)
Seat 3: AlKatrone folded before Flop (didn't bet)
Seat 4: matiko09 folded before Flop (didn't bet)
Seat 5: hammerwife (button) folded before Flop (didn't bet)
Seat 7: Rikti (small blind) folded before Flop
Seat 8: Zeeshka (big blind) folded before Flop
Seat 9: oscarleon folded before Flop (didn't bet)





PokerStars Hand #148609041550:  Hold'em No Limit ($0.50/$1.00 USD) - 2016/02/11 13:14:54 CET [2016/02/11 7:14:54 ET]
Table 'Aoluta' 9-max Seat #2 is the button
Seat 1: sebaaastian ($101.16 in chips) 
Seat 2: matiko09 ($105.05 in chips) 
Seat 3: Zeeshka ($100.10 in chips) 
Seat 4: oscarleon ($173.76 in chips) 
Seat 5: aseban11 ($100 in chips) 
Seat 6: Luck In Me ($107 in chips) 
Seat 7: grigy197 ($99.41 in chips) 
Seat 8: mrspecial1 ($60.50 in chips) 
Zeeshka: posts small blind $0.50
oscarleon: posts big blind $1
*** HOLE CARDS ***
Dealt to matiko09 [Ac Qd]
aseban11: folds 
Luck In Me: folds 
grigy197: calls $1
mrspecial1: folds 
sebaaastian: folds 
matiko09: raises $3 to $4
Zeeshka: folds 
oscarleon: folds 
grigy197: calls $3
*** FLOP *** [Tc 9c Ah]
grigy197: checks 
matiko09: bets $5.90
grigy197: calls $5.90
*** TURN *** [Tc 9c Ah] [4d]
grigy197: checks 
matiko09: bets $14
grigy197: calls $14
*** RIVER *** [Tc 9c Ah 4d] [Ks]
grigy197: bets $1
matiko09: raises $15 to $16
grigy197: calls $15
*** SHOW DOWN ***
matiko09: shows [Ac Qd] (a pair of Aces)
grigy197: mucks hand 
matiko09 collected $78.50 from pot
*** SUMMARY ***
Total pot $81.30 | Rake $2.80 
Board [Tc 9c Ah 4d Ks]
Seat 1: sebaaastian folded before Flop (didn't bet)
Seat 2: matiko09 (button) showed [Ac Qd] and won ($78.50) with a pair of Aces
Seat 3: Zeeshka (small blind) folded before Flop
Seat 4: oscarleon (big blind) folded before Flop
Seat 5: aseban11 folded before Flop (didn't bet)
Seat 6: Luck In Me folded before Flop (didn't bet)
Seat 7: grigy197 mucked [8h As]
Seat 8: mrspecial1 folded before Flop (didn't bet)





PokerStars Hand #148609043424:  Hold'em No Limit ($0.50/$1.00 USD) - 2016/02/11 13:14:57 CET [2016/02/11 7:14:57 ET]
Table 'Marion' 9-max Seat #3 is the button
Seat 1: aseban11 ($100 in chips) 
Seat 2: GusenokRUS ($105.35 in chips) 
Seat 3: TimStone ($104.46 in chips) 
Seat 4: matiko09 ($100 in chips) 
Seat 5: Rikti ($50.01 in chips) 
Seat 6: 19SERGE74 ($73.23 in chips) 
Seat 7: oscarleon ($112.58 in chips) 
Seat 9: Zeeshka ($100 in chips) 
matiko09: posts small blind $0.50
Rikti: posts big blind $1
*** HOLE CARDS ***
Dealt to matiko09 [3c 6s]
19SERGE74: folds 
oscarleon: folds 
Zeeshka: folds 
aseban11: folds 
GusenokRUS: raises $2 to $3
TimStone: folds 
matiko09: folds 
Rikti: raises $5 to $8
GusenokRUS: folds 
Uncalled bet ($5) returned to Rikti
Rikti collected $6.50 from pot
Rikti: doesn't show hand 
*** SUMMARY ***
Total pot $6.50 | Rake $0 
Seat 1: aseban11 folded before Flop (didn't bet)
Seat 2: GusenokRUS folded before Flop
Seat 3: TimStone (button) folded before Flop (didn't bet)
Seat 4: matiko09 (small blind) folded before Flop
Seat 5: Rikti (big blind) collected ($6.50)
Seat 6: 19SERGE74 folded before Flop (didn't bet)
Seat 7: oscarleon folded before Flop (didn't bet)
Seat 9: Zeeshka folded before Flop (didn't bet)





PokerStars Hand #148609045269:  Hold'em No Limit ($0.25/$0.50 USD) - 2016/02/11 13:15:00 CET [2016/02/11 7:15:00 ET]
Table 'Stereoskopia' 9-max Seat #1 is the button
Seat 1: JJJ-K9 ($53.35 in chips) 
Seat 4: TPACHCI7OPT ($44.49 in chips) 
Seat 6: matiko09 ($51.70 in chips) 
Seat 7: tallonn88 ($55.47 in chips) 
Seat 9: xxxibgdrgn ($50 in chips) 
TPACHCI7OPT: posts small blind $0.25
ReinisRNS: is sitting out 
matiko09: posts big blind $0.50
Jo_Medici: sits out 
*** HOLE CARDS ***
Dealt to matiko09 [Ts Jh]
tallonn88: folds 
xxxibgdrgn: raises $0.75 to $1.25
JJJ-K9: folds 
TPACHCI7OPT: folds 
matiko09: folds 
Uncalled bet ($0.75) returned to xxxibgdrgn
xxxibgdrgn collected $1.25 from pot
xxxibgdrgn: doesn't show hand 
*** SUMMARY ***
Total pot $1.25 | Rake $0 
Seat 1: JJJ-K9 (button) folded before Flop (didn't bet)
Seat 4: TPACHCI7OPT (small blind) folded before Flop
Seat 6: matiko09 (big blind) folded before Flop
Seat 7: tallonn88 folded before Flop (didn't bet)
Seat 9: xxxibgdrgn collected ($1.25)





PokerStars Hand #148609047784:  Hold'em No Limit ($0.25/$0.50 USD) - 2016/02/11 13:15:05 CET [2016/02/11 7:15:05 ET]
Table 'Oenone' 9-max Seat #8 is the button
Seat 1: tallonn88 ($50 in chips) 
Seat 2: Reven9er ($51.63 in chips) 
Seat 4: Serhent ($50 in chips) 
Seat 5: ReinisRNS ($56.34 in chips) 
Seat 6: matiko09 ($52.94 in chips) 
Seat 7: banit7 ($52.50 in chips) 
Seat 8: vlad11122007 ($81.64 in chips) 
Seat 9: xxxibgdrgn ($50 in chips) 
xxxibgdrgn: posts small blind $0.25
tallonn88: posts big blind $0.50
TPACHCI7OPT: sits out 
*** HOLE CARDS ***
Dealt to matiko09 [Ks 5d]
Reven9er: folds 
Serhent: folds 
ReinisRNS: folds 
matiko09: folds 
banit7: folds 
vlad11122007: folds 
xxxibgdrgn: raises $1 to $1.50
tallonn88: calls $1
*** FLOP *** [4s Ad Jd]
xxxibgdrgn: checks 
tallonn88: bets $1.75
xxxibgdrgn: calls $1.75
*** TURN *** [4s Ad Jd] [8s]
xxxibgdrgn: checks 
tallonn88: checks 
*** RIVER *** [4s Ad Jd 8s] [2h]
xxxibgdrgn: checks 
tallonn88: checks 
*** SHOW DOWN ***
xxxibgdrgn: shows [Jc Qd] (a pair of Jacks)
tallonn88: mucks hand 
xxxibgdrgn collected $6.21 from pot
*** SUMMARY ***
Total pot $6.50 | Rake $0.29 
Board [4s Ad Jd 8s 2h]
Seat 1: tallonn88 (big blind) mucked [Th Kd]
Seat 2: Reven9er folded before Flop (didn't bet)
Seat 4: Serhent folded before Flop (didn't bet)
Seat 5: ReinisRNS folded before Flop (didn't bet)
Seat 6: matiko09 folded before Flop (didn't bet)
Seat 7: banit7 folded before Flop (didn't bet)
Seat 8: vlad11122007 (button) folded before Flop (didn't bet)
Seat 9: xxxibgdrgn (small blind) showed [Jc Qd] and won ($6.21) with a pair of Jacks





PokerStars Hand #148609055018:  Hold'em No Limit ($0.50/$1.00 USD) - 2016/02/11 13:15:17 CET [2016/02/11 7:15:17 ET]
Table 'Gianfar' 9-max Seat #7 is the button
Seat 1: sebaaastian ($234.31 in chips) 
Seat 2: bilukm ($100.50 in chips) 
Seat 3: AlKatrone ($115.19 in chips) 
Seat 4: matiko09 ($122.32 in chips) 
Seat 5: hammerwife ($174.29 in chips) 
Seat 7: Rikti ($38 in chips) 
Seat 8: Zeeshka ($100 in chips) 
Seat 9: oscarleon ($146.66 in chips) 
Zeeshka: posts small blind $0.50
oscarleon: posts big blind $1
*** HOLE CARDS ***
Dealt to matiko09 [Js 9d]
sebaaastian: folds 
bilukm: folds 
AlKatrone: folds 
matiko09: folds 
hammerwife: raises $1.50 to $2.50
Rikti: folds 
Zeeshka: raises $6.50 to $9
oscarleon: folds 
hammerwife: calls $6.50
*** FLOP *** [2c As 9h]
Zeeshka: checks 
hammerwife: checks 
*** TURN *** [2c As 9h] [Qs]
Zeeshka: checks 
hammerwife: checks 
*** RIVER *** [2c As 9h Qs] [Qc]
Zeeshka: checks 
hammerwife: checks 
*** SHOW DOWN ***
Zeeshka: shows [3c Ac] (two pair, Aces and Queens)
hammerwife: mucks hand 
Zeeshka collected $18.14 from pot
*** SUMMARY ***
Total pot $19 | Rake $0.86 
Board [2c As 9h Qs Qc]
Seat 1: sebaaastian folded before Flop (didn't bet)
Seat 2: bilukm folded before Flop (didn't bet)
Seat 3: AlKatrone folded before Flop (didn't bet)
Seat 4: matiko09 folded before Flop (didn't bet)
Seat 5: hammerwife mucked [Ts 9s]
Seat 7: Rikti (button) folded before Flop (didn't bet)
Seat 8: Zeeshka (small blind) showed [3c Ac] and won ($18.14) with two pair, Aces and Queens
Seat 9: oscarleon (big blind) folded before Flop





PokerStars Hand #148609055708:  Hold'em No Limit ($0.25/$0.50 USD) - 2016/02/11 13:15:19 CET [2016/02/11 7:15:19 ET]
Table 'Stereoskopia' 9-max Seat #4 is the button
Seat 1: JJJ-K9 ($53.35 in chips) 
Seat 4: TPACHCI7OPT ($44.24 in chips) 
Seat 6: matiko09 ($51.20 in chips) 
Seat 7: tallonn88 ($55.47 in chips) 
Seat 9: xxxibgdrgn ($50.75 in chips) 
matiko09: posts small blind $0.25
tallonn88: posts big blind $0.50
Jo_Medici: sits out 
*** HOLE CARDS ***
Dealt to matiko09 [Kd 5c]
xxxibgdrgn: raises $1 to $1.50
JJJ-K9: folds 
TPACHCI7OPT: folds 
ReinisRNS leaves the table
matiko09: folds 
tallonn88: folds 
Uncalled bet ($1) returned to xxxibgdrgn
xxxibgdrgn collected $1.25 from pot
xxxibgdrgn: doesn't show hand 
*** SUMMARY ***
Total pot $1.25 | Rake $0 
Seat 1: JJJ-K9 folded before Flop (didn't bet)
Seat 4: TPACHCI7OPT (button) folded before Flop (didn't bet)
Seat 6: matiko09 (small blind) folded before Flop
Seat 7: tallonn88 (big blind) folded before Flop
Seat 9: xxxibgdrgn collected ($1.25)





PokerStars Hand #148609055844:  Hold'em No Limit ($0.50/$1.00 USD) - 2016/02/11 13:15:19 CET [2016/02/11 7:15:19 ET]
Table 'Clorinde' 9-max Seat #2 is the button
Seat 1: matiko09 ($100 in chips) 
Seat 2: 19SERGE74 ($80.84 in chips) 
Seat 3: gabi_igna ($102.75 in chips) 
Seat 5: Mukhin1 ($100 in chips) 
Seat 6: Gcroc52 ($41.10 in chips) 
Seat 7: Zeeshka ($100 in chips) 
Seat 8: aseban11 ($114.72 in chips) 
gabi_igna: posts small blind $0.50
Mukhin1: posts big blind $1
*** HOLE CARDS ***
Dealt to matiko09 [2d 6c]
Gcroc52: folds 
Zeeshka: raises $2 to $3
aseban11: raises $6 to $9
matiko09: folds 
19SERGE74: folds 
gabi_igna: folds 
Mukhin1: folds 
Zeeshka: folds 
Uncalled bet ($6) returned to aseban11
buttonlife leaves the table
aseban11 collected $7.50 from pot
aseban11: doesn't show hand 
*** SUMMARY ***
Total pot $7.50 | Rake $0 
Seat 1: matiko09 folded before Flop (didn't bet)
Seat 2: 19SERGE74 (button) folded before Flop (didn't bet)
Seat 3: gabi_igna (small blind) folded before Flop
Seat 5: Mukhin1 (big blind) folded before Flop
Seat 6: Gcroc52 folded before Flop (didn't bet)
Seat 7: Zeeshka folded before Flop
Seat 8: aseban11 collected ($7.50)





PokerStars Hand #148609060024:  Hold'em No Limit ($0.50/$1.00 USD) - 2016/02/11 13:15:26 CET [2016/02/11 7:15:26 ET]
Table 'Stephano V' 9-max Seat #3 is the button
Seat 1: hammerwife ($102.75 in chips) 
Seat 2: matiko09 ($139.95 in chips) 
Seat 3: sebaaastian ($100 in chips) 
Seat 4: Zeeshka ($123.82 in chips) 
Seat 5: n2call ($162.90 in chips) 
Seat 7: hurtNCYDE ($103.70 in chips) 
Seat 8: oscarleon ($215.73 in chips) 
Seat 9: IcocaynaI ($104.80 in chips) 
Zeeshka: posts small blind $0.50
n2call: posts big blind $1
*** HOLE CARDS ***
Dealt to matiko09 [3d Ah]
hurtNCYDE: folds 
oscarleon: folds 
IcocaynaI: calls $1
hammerwife: folds 
matiko09: folds 
sebaaastian: folds 
Zeeshka: folds 
n2call: checks 
*** FLOP *** [8d Td 8c]
n2call: checks 
IcocaynaI: bets $1
n2call: folds 
Uncalled bet ($1) returned to IcocaynaI
IcocaynaI collected $2.39 from pot
IcocaynaI: doesn't show hand 
*** SUMMARY ***
Total pot $2.50 | Rake $0.11 
Board [8d Td 8c]
Seat 1: hammerwife folded before Flop (didn't bet)
Seat 2: matiko09 folded before Flop (didn't bet)
Seat 3: sebaaastian (button) folded before Flop (didn't bet)
Seat 4: Zeeshka (small blind) folded before Flop
Seat 5: n2call (big blind) folded on the Flop
Seat 7: hurtNCYDE folded before Flop (didn't bet)
Seat 8: oscarleon folded before Flop (didn't bet)
Seat 9: IcocaynaI collected ($2.39)





PokerStars Hand #148609061334:  Hold'em No Limit ($0.25/$0.50 USD) - 2016/02/11 13:15:28 CET [2016/02/11 7:15:28 ET]
Table 'Ambrosia II' 9-max Seat #8 is the button
Seat 1: matiko09 ($52.54 in chips) 
Seat 3: make6a ($84.43 in chips) 
Seat 4: huudk2016 ($39.32 in chips) 
Seat 6: Reven9er ($62.26 in chips) 
Seat 7: Ana.Satravca ($53.17 in chips) 
Seat 8: tallonn88 ($56.26 in chips) 
Seat 9: arctur17 ($51.92 in chips) 
arctur17: posts small blind $0.25
matiko09: posts big blind $0.50
JJJ-K9: sits out 
RICKA16: sits out 
*** HOLE CARDS ***
Dealt to matiko09 [Qd 2c]
make6a: folds 
huudk2016: folds 
Reven9er: folds 
Ana.Satravca: folds 
tallonn88: folds 
arctur17: raises $0.50 to $1
matiko09: folds 
Uncalled bet ($0.50) returned to arctur17
arctur17 collected $1 from pot
arctur17: doesn't show hand 
*** SUMMARY ***
Total pot $1 | Rake $0 
Seat 1: matiko09 (big blind) folded before Flop
Seat 3: make6a folded before Flop (didn't bet)
Seat 4: huudk2016 folded before Flop (didn't bet)
Seat 6: Reven9er folded before Flop (didn't bet)
Seat 7: Ana.Satravca folded before Flop (didn't bet)
Seat 8: tallonn88 (button) folded before Flop (didn't bet)
Seat 9: arctur17 (small blind) collected ($1)





PokerStars Hand #148609063743:  Hold'em No Limit (€0.25/€0.50 EUR) - 2016/02/11 13:15:32 CET [2016/02/11 7:15:32 ET]
Table 'Otero II' 9-max Seat #4 is the button
Seat 1: Effort92 (€50 in chips) 
Seat 2: Dantist1122 (€50 in chips) 
Seat 3: Szevasztopol (€50.75 in chips) 
Seat 4: kram0909 (€16.80 in chips) 
Seat 5: vlad11122007 (€48.94 in chips) 
Seat 7: Dflingern95 (€57.70 in chips) 
Seat 8: matiko09 (€65.13 in chips) 
vlad11122007: posts small blind €0.25
Dflingern95: posts big blind €0.50
*** HOLE CARDS ***
Dealt to matiko09 [Ah Th]
matiko09: raises €1 to €1.50
Effort92: folds 
Dantist1122: folds 
Szevasztopol: folds 
kram0909: folds 
vlad11122007: folds 
Dflingern95: calls €1
*** FLOP *** [7h 5d Ts]
Dflingern95: bets €2.50
matiko09: raises €4.50 to €7
Dflingern95: folds 
Uncalled bet (€4.50) returned to matiko09
matiko09 collected €7.88 from pot
matiko09: doesn't show hand 
*** SUMMARY ***
Total pot €8.25 | Rake €0.37 
Board [7h 5d Ts]
Seat 1: Effort92 folded before Flop (didn't bet)
Seat 2: Dantist1122 folded before Flop (didn't bet)
Seat 3: Szevasztopol folded before Flop (didn't bet)
Seat 4: kram0909 (button) folded before Flop (didn't bet)
Seat 5: vlad11122007 (small blind) folded before Flop
Seat 7: Dflingern95 (big blind) folded on the Flop
Seat 8: matiko09 collected (€7.88)





PokerStars Hand #148609070706:  Hold'em No Limit ($0.50/$1.00 USD) - 2016/02/11 13:15:44 CET [2016/02/11 7:15:44 ET]
Table 'Marion' 9-max Seat #4 is the button
Seat 1: aseban11 ($100 in chips) 
Seat 2: GusenokRUS ($102.35 in chips) 
Seat 3: TimStone ($104.46 in chips) 
Seat 4: matiko09 ($100 in chips) 
Seat 5: Rikti ($53.51 in chips) 
Seat 6: 19SERGE74 ($73.23 in chips) 
Seat 7: oscarleon ($112.58 in chips) 
Seat 9: Zeeshka ($100 in chips) 
Rikti: posts small blind $0.50
19SERGE74: posts big blind $1
*** HOLE CARDS ***
Dealt to matiko09 [4s Jc]
oscarleon: folds 
Zeeshka: folds 
aseban11: folds 
GusenokRUS: raises $2 to $3
TimStone: folds 
matiko09: folds 
Rikti: folds 
19SERGE74: folds 
Uncalled bet ($2) returned to GusenokRUS
GusenokRUS collected $2.50 from pot
GusenokRUS: doesn't show hand 
*** SUMMARY ***
Total pot $2.50 | Rake $0 
Seat 1: aseban11 folded before Flop (didn't bet)
Seat 2: GusenokRUS collected ($2.50)
Seat 3: TimStone folded before Flop (didn't bet)
Seat 4: matiko09 (button) folded before Flop (didn't bet)
Seat 5: Rikti (small blind) folded before Flop
Seat 6: 19SERGE74 (big blind) folded before Flop
Seat 7: oscarleon folded before Flop (didn't bet)
Seat 9: Zeeshka folded before Flop (didn't bet)





PokerStars Hand #148609071145:  Hold'em No Limit ($0.25/$0.50 USD) - 2016/02/11 13:15:45 CET [2016/02/11 7:15:45 ET]
Table 'Stereoskopia' 9-max Seat #6 is the button
Seat 1: JJJ-K9 ($53.35 in chips) 
Seat 4: TPACHCI7OPT ($44.24 in chips) 
Seat 6: matiko09 ($50.95 in chips) 
Seat 7: tallonn88 ($54.97 in chips) 
Seat 8: Jo_Medici ($50 in chips) 
Seat 9: xxxibgdrgn ($51.50 in chips) 
tallonn88: posts small blind $0.25
Jo_Medici: posts big blind $0.50
*** HOLE CARDS ***
Dealt to matiko09 [7h Ah]
xxxibgdrgn: folds 
JJJ-K9: folds 
TPACHCI7OPT: raises $1 to $1.50
matiko09: folds 
tallonn88: folds 
Jo_Medici: folds 
Uncalled bet ($1) returned to TPACHCI7OPT
TPACHCI7OPT collected $1.25 from pot
TPACHCI7OPT: doesn't show hand 
*** SUMMARY ***
Total pot $1.25 | Rake $0 
Seat 1: JJJ-K9 folded before Flop (didn't bet)
Seat 4: TPACHCI7OPT collected ($1.25)
Seat 6: matiko09 (button) folded before Flop (didn't bet)
Seat 7: tallonn88 (small blind) folded before Flop
Seat 8: Jo_Medici (big blind) folded before Flop
Seat 9: xxxibgdrgn folded before Flop (didn't bet)





PokerStars Hand #148609076841:  Hold'em No Limit ($0.25/$0.50 USD) - 2016/02/11 13:15:55 CET [2016/02/11 7:15:55 ET]
Table 'Ambrosia II' 9-max Seat #9 is the button
Seat 1: matiko09 ($52.04 in chips) 
Seat 2: JJJ-K9 ($50 in chips) 
Seat 3: make6a ($84.43 in chips) 
Seat 4: huudk2016 ($39.32 in chips) 
Seat 6: Reven9er ($62.26 in chips) 
Seat 7: Ana.Satravca ($53.17 in chips) 
Seat 8: tallonn88 ($56.26 in chips) 
Seat 9: arctur17 ($52.42 in chips) 
matiko09: posts small blind $0.25
JJJ-K9: posts big blind $0.50
RICKA16: sits out 
*** HOLE CARDS ***
Dealt to matiko09 [9h Kc]
make6a: folds 
huudk2016: calls $0.50
Reven9er: folds 
Ana.Satravca: raises $1.75 to $2.25
tallonn88: folds 
arctur17: folds 
matiko09: folds 
JJJ-K9: folds 
huudk2016: calls $1.75
*** FLOP *** [2h 4s Jh]
huudk2016: bets $2.50
Ana.Satravca: raises $5.50 to $8
huudk2016: calls $5.50
*** TURN *** [2h 4s Jh] [Js]
huudk2016: checks 
Ana.Satravca: checks 
*** RIVER *** [2h 4s Jh Js] [8c]
huudk2016: checks 
Ana.Satravca: checks 
*** SHOW DOWN ***
huudk2016: shows [Kh Qh] (a pair of Jacks)
Ana.Satravca: shows [As Ac] (two pair, Aces and Jacks)
Ana.Satravca collected $20.29 from pot
*** SUMMARY ***
Total pot $21.25 | Rake $0.96 
Board [2h 4s Jh Js 8c]
Seat 1: matiko09 (small blind) folded before Flop
Seat 2: JJJ-K9 (big blind) folded before Flop
Seat 3: make6a folded before Flop (didn't bet)
Seat 4: huudk2016 showed [Kh Qh] and lost with a pair of Jacks
Seat 6: Reven9er folded before Flop (didn't bet)
Seat 7: Ana.Satravca showed [As Ac] and won ($20.29) with two pair, Aces and Jacks
Seat 8: tallonn88 folded before Flop (didn't bet)
Seat 9: arctur17 (button) folded before Flop (didn't bet)





PokerStars Hand #148609082270:  Hold'em No Limit ($0.50/$1.00 USD) - 2016/02/11 13:16:04 CET [2016/02/11 7:16:04 ET]
Table 'Clorinde' 9-max Seat #3 is the button
Seat 1: matiko09 ($100 in chips) 
Seat 2: 19SERGE74 ($80.84 in chips) 
Seat 3: gabi_igna ($102.25 in chips) 
Seat 5: Mukhin1 ($100 in chips) 
Seat 6: Gcroc52 ($41.10 in chips) 
Seat 7: Zeeshka ($100 in chips) 
Seat 8: aseban11 ($119.22 in chips) 
Mukhin1: posts small blind $0.50
Gcroc52: posts big blind $1
*** HOLE CARDS ***
Dealt to matiko09 [5s 2c]
sebaaastian joins the table at seat #9 
Zeeshka: folds 
aseban11: folds 
matiko09: folds 
19SERGE74: raises $2 to $3
gabi_igna: folds 
Mukhin1: folds 
Gcroc52: folds 
Uncalled bet ($2) returned to 19SERGE74
19SERGE74 collected $2.50 from pot
19SERGE74: doesn't show hand 
*** SUMMARY ***
Total pot $2.50 | Rake $0 
Seat 1: matiko09 folded before Flop (didn't bet)
Seat 2: 19SERGE74 collected ($2.50)
Seat 3: gabi_igna (button) folded before Flop (didn't bet)
Seat 5: Mukhin1 (small blind) folded before Flop
Seat 6: Gcroc52 (big blind) folded before Flop
Seat 7: Zeeshka folded before Flop (didn't bet)
Seat 8: aseban11 folded before Flop (didn't bet)





PokerStars Hand #148609085004:  Hold'em No Limit ($0.25/$0.50 USD) - 2016/02/11 13:16:09 CET [2016/02/11 7:16:09 ET]
Table 'Stereoskopia' 9-max Seat #7 is the button
Seat 1: JJJ-K9 ($53.35 in chips) 
Seat 4: TPACHCI7OPT ($44.99 in chips) 
Seat 6: matiko09 ($50.95 in chips) 
Seat 7: tallonn88 ($54.72 in chips) 
Seat 8: Jo_Medici ($50 in chips) 
Jo_Medici: posts small blind $0.25
xxxibgdrgn: is sitting out 
JJJ-K9: posts big blind $0.50
*** HOLE CARDS ***
Dealt to matiko09 [9d Kc]
TPACHCI7OPT: folds 
matiko09: folds 
xxxibgdrgn leaves the table
tallonn88: folds 
Jo_Medici: folds 
Uncalled bet ($0.25) returned to JJJ-K9
JJJ-K9 collected $0.50 from pot
JJJ-K9: doesn't show hand 
*** SUMMARY ***
Total pot $0.50 | Rake $0 
Seat 1: JJJ-K9 (big blind) collected ($0.50)
Seat 4: TPACHCI7OPT folded before Flop (didn't bet)
Seat 6: matiko09 folded before Flop (didn't bet)
Seat 7: tallonn88 (button) folded before Flop (didn't bet)
Seat 8: Jo_Medici (small blind) folded before Flop





PokerStars Hand #148609086783:  Hold'em No Limit ($0.50/$1.00 USD) - 2016/02/11 13:16:12 CET [2016/02/11 7:16:12 ET]
Table 'Marion' 9-max Seat #5 is the button
Seat 1: aseban11 ($100 in chips) 
Seat 2: GusenokRUS ($103.85 in chips) 
Seat 3: TimStone ($104.46 in chips) 
Seat 4: matiko09 ($100 in chips) 
Seat 5: Rikti ($53.01 in chips) 
Seat 6: 19SERGE74 ($72.23 in chips) 
Seat 7: oscarleon ($112.58 in chips) 
Seat 9: Zeeshka ($100 in chips) 
19SERGE74: posts small blind $0.50
oscarleon: posts big blind $1
*** HOLE CARDS ***
Dealt to matiko09 [Kh 5c]
Zeeshka: folds 
aseban11: folds 
GusenokRUS: folds 
TimStone: folds 
matiko09: folds 
Rikti: folds 
19SERGE74: folds 
Uncalled bet ($0.50) returned to oscarleon
oscarleon collected $1 from pot
oscarleon: doesn't show hand 
*** SUMMARY ***
Total pot $1 | Rake $0 
Seat 1: aseban11 folded before Flop (didn't bet)
Seat 2: GusenokRUS folded before Flop (didn't bet)
Seat 3: TimStone folded before Flop (didn't bet)
Seat 4: matiko09 folded before Flop (didn't bet)
Seat 5: Rikti (button) folded before Flop (didn't bet)
Seat 6: 19SERGE74 (small blind) folded before Flop
Seat 7: oscarleon (big blind) collected ($1)
Seat 9: Zeeshka folded before Flop (didn't bet)





PokerStars Hand #148609087891:  Hold'em No Limit ($0.50/$1.00 USD) - 2016/02/11 13:16:14 CET [2016/02/11 7:16:14 ET]
Table 'Aoluta' 9-max Seat #3 is the button
Seat 1: sebaaastian ($101.16 in chips) 
Seat 2: matiko09 ($143.65 in chips) 
Seat 3: Zeeshka ($100 in chips) 
Seat 4: oscarleon ($172.76 in chips) 
Seat 5: aseban11 ($100 in chips) 
Seat 6: Luck In Me ($107 in chips) 
Seat 7: grigy197 ($59.51 in chips) 
Seat 8: mrspecial1 ($60.50 in chips) 
oscarleon: posts small blind $0.50
aseban11: posts big blind $1
*** HOLE CARDS ***
Dealt to matiko09 [5s 7c]
Luck In Me: folds 
grigy197: folds 
grigy197 leaves the table
mrspecial1: folds 
sebaaastian: folds 
matiko09: folds 
Zeeshka: raises $1.50 to $2.50
oscarleon: folds 
aseban11: calls $1.50
*** FLOP *** [Ad Kc 3s]
aseban11: checks 
Zeeshka: checks 
*** TURN *** [Ad Kc 3s] [Kd]
aseban11: checks 
Zeeshka: checks 
*** RIVER *** [Ad Kc 3s Kd] [Qc]
aseban11: checks 
Zeeshka: checks 
*** SHOW DOWN ***
aseban11: shows [9d Ts] (a pair of Kings)
Zeeshka: shows [8d Ah] (two pair, Aces and Kings)
Zeeshka collected $5.25 from pot
*** SUMMARY ***
Total pot $5.50 | Rake $0.25 
Board [Ad Kc 3s Kd Qc]
Seat 1: sebaaastian folded before Flop (didn't bet)
Seat 2: matiko09 folded before Flop (didn't bet)
Seat 3: Zeeshka (button) showed [8d Ah] and won ($5.25) with two pair, Aces and Kings
Seat 4: oscarleon (small blind) folded before Flop
Seat 5: aseban11 (big blind) showed [9d Ts] and lost with a pair of Kings
Seat 6: Luck In Me folded before Flop (didn't bet)
Seat 7: grigy197 folded before Flop (didn't bet)
Seat 8: mrspecial1 folded before Flop (didn't bet)





PokerStars Hand #148609093264:  Hold'em No Limit ($0.50/$1.00 USD) - 2016/02/11 13:16:23 CET [2016/02/11 7:16:23 ET]
Table 'Stephano V' 9-max Seat #4 is the button
Seat 1: hammerwife ($102.75 in chips) 
Seat 2: matiko09 ($139.95 in chips) 
Seat 3: sebaaastian ($100 in chips) 
Seat 4: Zeeshka ($123.32 in chips) 
Seat 5: n2call ($161.90 in chips) 
Seat 7: hurtNCYDE ($103.70 in chips) 
Seat 8: oscarleon ($215.73 in chips) 
Seat 9: IcocaynaI ($106.19 in chips) 
n2call: posts small blind $0.50
hurtNCYDE: posts big blind $1
*** HOLE CARDS ***
Dealt to matiko09 [9s Qh]
oscarleon: folds 
IcocaynaI: calls $1
hammerwife: folds 
matiko09: folds 
sebaaastian: folds 
Zeeshka: folds 
n2call: folds 
hurtNCYDE: checks 
*** FLOP *** [Qs 3s 5s]
hurtNCYDE: checks 
IcocaynaI: bets $1
hurtNCYDE: raises $3.02 to $4.02
IcocaynaI: folds 
Uncalled bet ($3.02) returned to hurtNCYDE
hurtNCYDE collected $4.30 from pot
*** SUMMARY ***
Total pot $4.50 | Rake $0.20 
Board [Qs 3s 5s]
Seat 1: hammerwife folded before Flop (didn't bet)
Seat 2: matiko09 folded before Flop (didn't bet)
Seat 3: sebaaastian folded before Flop (didn't bet)
Seat 4: Zeeshka (button) folded before Flop (didn't bet)
Seat 5: n2call (small blind) folded before Flop
Seat 7: hurtNCYDE (big blind) collected ($4.30)
Seat 8: oscarleon folded before Flop (didn't bet)
Seat 9: IcocaynaI folded on the Flop





PokerStars Hand #148609095149:  Hold'em No Limit (€0.25/€0.50 EUR) - 2016/02/11 13:16:26 CET [2016/02/11 7:16:26 ET]
Table 'Otero II' 9-max Seat #5 is the button
Seat 1: Effort92 (€50 in chips) 
Seat 2: Dantist1122 (€50 in chips) 
Seat 3: Szevasztopol (€50.75 in chips) 
Seat 4: kram0909 (€16.80 in chips) 
Seat 5: vlad11122007 (€48.69 in chips) 
Seat 7: Dflingern95 (€53.70 in chips) 
Seat 8: matiko09 (€69.01 in chips) 
Dflingern95: posts small blind €0.25
matiko09: posts big blind €0.50
*** HOLE CARDS ***
Dealt to matiko09 [6c Ah]
Effort92: folds 
Dantist1122: raises €1 to €1.50
Szevasztopol: folds 
kram0909: folds 
vlad11122007: folds 
Dflingern95: folds 
matiko09: folds 
Uncalled bet (€1) returned to Dantist1122
Dantist1122 collected €1.25 from pot
Dantist1122: doesn't show hand 
*** SUMMARY ***
Total pot €1.25 | Rake €0 
Seat 1: Effort92 folded before Flop (didn't bet)
Seat 2: Dantist1122 collected (€1.25)
Seat 3: Szevasztopol folded before Flop (didn't bet)
Seat 4: kram0909 folded before Flop (didn't bet)
Seat 5: vlad11122007 (button) folded before Flop (didn't bet)
Seat 7: Dflingern95 (small blind) folded before Flop
Seat 8: matiko09 (big blind) folded before Flop





PokerStars Hand #148609097606:  Hold'em No Limit ($0.50/$1.00 USD) - 2016/02/11 13:16:30 CET [2016/02/11 7:16:30 ET]
Table 'Marion' 9-max Seat #6 is the button
Seat 1: aseban11 ($100 in chips) 
Seat 2: GusenokRUS ($103.85 in chips) 
Seat 3: TimStone ($104.46 in chips) 
Seat 4: matiko09 ($100 in chips) 
Seat 5: Rikti ($53.01 in chips) 
Seat 6: 19SERGE74 ($71.73 in chips) 
Seat 7: oscarleon ($113.08 in chips) 
Seat 9: Zeeshka ($100 in chips) 
oscarleon: posts small blind $0.50
Zeeshka: posts big blind $1
*** HOLE CARDS ***
Dealt to matiko09 [4d 9s]
aseban11: folds 
GusenokRUS: folds 
TimStone: raises $2.01 to $3.01
matiko09: folds 
Rikti: folds 
19SERGE74: folds 
oscarleon: folds 
Zeeshka: folds 
Uncalled bet ($2.01) returned to TimStone
TimStone collected $2.50 from pot
TimStone: doesn't show hand 
*** SUMMARY ***
Total pot $2.50 | Rake $0 
Seat 1: aseban11 folded before Flop (didn't bet)
Seat 2: GusenokRUS folded before Flop (didn't bet)
Seat 3: TimStone collected ($2.50)
Seat 4: matiko09 folded before Flop (didn't bet)
Seat 5: Rikti folded before Flop (didn't bet)
Seat 6: 19SERGE74 (button) folded before Flop (didn't bet)
Seat 7: oscarleon (small blind) folded before Flop
Seat 9: Zeeshka (big blind) folded before Flop





PokerStars Hand #148609099141:  Hold'em No Limit ($0.50/$1.00 USD) - 2016/02/11 13:16:33 CET [2016/02/11 7:16:33 ET]
Table 'Clorinde' 9-max Seat #5 is the button
Seat 1: matiko09 ($100 in chips) 
Seat 2: 19SERGE74 ($82.34 in chips) 
Seat 3: gabi_igna ($102.25 in chips) 
Seat 5: Mukhin1 ($100 in chips) 
Seat 6: Gcroc52 ($40.10 in chips) 
Seat 7: Zeeshka ($100 in chips) 
Seat 8: aseban11 ($119.22 in chips) 
Gcroc52: posts small blind $0.50
Zeeshka: posts big blind $1
sebaaastian: sits out 
*** HOLE CARDS ***
Dealt to matiko09 [Qs Ad]
aseban11: folds 
matiko09: raises $2 to $3
19SERGE74: folds 
gabi_igna: folds 
Mukhin1: folds 
Gcroc52: folds 
Zeeshka: folds 
Uncalled bet ($2) returned to matiko09
matiko09 collected $2.50 from pot
matiko09: doesn't show hand 
*** SUMMARY ***
Total pot $2.50 | Rake $0 
Seat 1: matiko09 collected ($2.50)
Seat 2: 19SERGE74 folded before Flop (didn't bet)
Seat 3: gabi_igna folded before Flop (didn't bet)
Seat 5: Mukhin1 (button) folded before Flop (didn't bet)
Seat 6: Gcroc52 (small blind) folded before Flop
Seat 7: Zeeshka (big blind) folded before Flop
Seat 8: aseban11 folded before Flop (didn't bet)





PokerStars Hand #148609099812:  Hold'em No Limit ($0.25/$0.50 USD) - 2016/02/11 13:16:34 CET [2016/02/11 7:16:34 ET]
Table 'Oenone' 9-max Seat #9 is the button
Seat 1: tallonn88 ($50 in chips) 
Seat 2: Reven9er ($51.63 in chips) 
Seat 4: Serhent ($50 in chips) 
Seat 5: ReinisRNS ($56.34 in chips) 
Seat 6: matiko09 ($52.94 in chips) 
Seat 7: banit7 ($52.50 in chips) 
Seat 8: vlad11122007 ($81.64 in chips) 
Seat 9: xxxibgdrgn ($52.96 in chips) 
tallonn88: posts small blind $0.25
Reven9er: posts big blind $0.50
TPACHCI7OPT: sits out 
*** HOLE CARDS ***
Dealt to matiko09 [3c 4c]
Serhent: folds 
ReinisRNS: folds 
matiko09: folds 
banit7: folds 
vlad11122007: folds 
xxxibgdrgn: folds 
tallonn88: raises $0.75 to $1.25
Reven9er: calls $0.75
*** FLOP *** [Ad 3h 8d]
tallonn88: checks 
Reven9er: checks 
*** TURN *** [Ad 3h 8d] [Qd]
tallonn88: bets $1.50
Reven9er: folds 
Uncalled bet ($1.50) returned to tallonn88
tallonn88 collected $2.39 from pot
tallonn88: doesn't show hand 
*** SUMMARY ***
Total pot $2.50 | Rake $0.11 
Board [Ad 3h 8d Qd]
Seat 1: tallonn88 (small blind) collected ($2.39)
Seat 2: Reven9er (big blind) folded on the Turn
Seat 4: Serhent folded before Flop (didn't bet)
Seat 5: ReinisRNS folded before Flop (didn't bet)
Seat 6: matiko09 folded before Flop (didn't bet)
Seat 7: banit7 folded before Flop (didn't bet)
Seat 8: vlad11122007 folded before Flop (didn't bet)
Seat 9: xxxibgdrgn (button) folded before Flop (didn't bet)





PokerStars Hand #148609104105:  Hold'em No Limit ($0.25/$0.50 USD) - 2016/02/11 13:16:42 CET [2016/02/11 7:16:42 ET]
Table 'Sylvania II' 9-max Seat #5 is the button
Seat 1: tw0315 ($145.51 in chips) 
Seat 2: Effort92 ($50 in chips) 
Seat 3: ruyingren ($227.89 in chips) 
Seat 4: matiko09 ($121.54 in chips) 
Seat 5: vlad11122007 ($57.64 in chips) 
Seat 7: 2lefthand75 ($85.80 in chips) 
Seat 9: Yippiebeans ($65.92 in chips) 
2lefthand75: posts small blind $0.25
Optimistic21: is sitting out 
Optimistic21 leaves the table
Yippiebeans: posts big blind $0.50
tw0315: posts the ante $0.10
Effort92: posts the ante $0.10
ruyingren: posts the ante $0.10
matiko09: posts the ante $0.10
vlad11122007: posts the ante $0.10
2lefthand75: posts the ante $0.10
Yippiebeans: posts the ante $0.10
*** HOLE CARDS ***
Dealt to matiko09 [7d Ts]
Effort92 said, ""
Effort92 said, "nh :)"
Apparat888 joins the table at seat #8 
tw0315: calls $0.50
Effort92: raises $1.50 to $2
ruyingren: folds 
matiko09: folds 
vlad11122007: folds 
2lefthand75: calls $1.75
Yippiebeans: folds 
tw0315: calls $1.50
*** FLOP *** [5d 5s 5h]
2lefthand75: checks 
tw0315: checks 
Effort92: checks 
*** TURN *** [5d 5s 5h] [Jh]
2lefthand75: checks 
tw0315: checks 
Effort92: checks 
*** RIVER *** [5d 5s 5h Jh] [Qd]
2lefthand75: checks 
tw0315: bets $3.44
Effort92: folds 
2lefthand75: folds 
Uncalled bet ($3.44) returned to tw0315
tw0315 collected $6.88 from pot
*** SUMMARY ***
Total pot $7.20 | Rake $0.32 
Board [5d 5s 5h Jh Qd]
Seat 1: tw0315 collected ($6.88)
Seat 2: Effort92 folded on the River
Seat 3: ruyingren folded before Flop (didn't bet)
Seat 4: matiko09 folded before Flop (didn't bet)
Seat 5: vlad11122007 (button) folded before Flop (didn't bet)
Seat 7: 2lefthand75 (small blind) folded on the River
Seat 9: Yippiebeans (big blind) folded before Flop





PokerStars Hand #148609106079:  Hold'em No Limit ($0.25/$0.50 USD) - 2016/02/11 13:16:45 CET [2016/02/11 7:16:45 ET]
Table 'Stereoskopia' 9-max Seat #8 is the button
Seat 1: JJJ-K9 ($53.60 in chips) 
Seat 4: TPACHCI7OPT ($44.99 in chips) 
Seat 6: matiko09 ($50.95 in chips) 
Seat 7: tallonn88 ($54.72 in chips) 
Seat 8: Jo_Medici ($50 in chips) 
JJJ-K9: posts small blind $0.25
TPACHCI7OPT: posts big blind $0.50
*** HOLE CARDS ***
Dealt to matiko09 [2h 8d]
matiko09: folds 
tallonn88: folds 
Jo_Medici: raises $0.50 to $1
JJJ-K9: folds 
TPACHCI7OPT: folds 
Uncalled bet ($0.50) returned to Jo_Medici
Jo_Medici collected $1.25 from pot
Jo_Medici: doesn't show hand 
afrodit71 joins the table at seat #5 
*** SUMMARY ***
Total pot $1.25 | Rake $0 
Seat 1: JJJ-K9 (small blind) folded before Flop
Seat 4: TPACHCI7OPT (big blind) folded before Flop
Seat 6: matiko09 folded before Flop (didn't bet)
Seat 7: tallonn88 folded before Flop (didn't bet)
Seat 8: Jo_Medici (button) collected ($1.25)





PokerStars Hand #148609115405:  Hold'em No Limit ($0.50/$1.00 USD) - 2016/02/11 13:17:01 CET [2016/02/11 7:17:01 ET]
Table 'Clorinde' 9-max Seat #6 is the button
Seat 1: matiko09 ($101.50 in chips) 
Seat 2: 19SERGE74 ($82.34 in chips) 
Seat 3: gabi_igna ($102.25 in chips) 
Seat 5: Mukhin1 ($100 in chips) 
Seat 6: Gcroc52 ($39.60 in chips) 
Seat 7: Zeeshka ($100 in chips) 
Seat 8: aseban11 ($119.22 in chips) 
Zeeshka: posts small blind $0.50
aseban11: posts big blind $1
sebaaastian: sits out 
*** HOLE CARDS ***
Dealt to matiko09 [6s 8s]
sebaaastian leaves the table
matiko09: folds 
19SERGE74: folds 
gabi_igna: folds 
Mukhin1: folds 
Gcroc52: folds 
Zeeshka: folds 
Uncalled bet ($0.50) returned to aseban11
aseban11 collected $1 from pot
aseban11: doesn't show hand 
*** SUMMARY ***
Total pot $1 | Rake $0 
Seat 1: matiko09 folded before Flop (didn't bet)
Seat 2: 19SERGE74 folded before Flop (didn't bet)
Seat 3: gabi_igna folded before Flop (didn't bet)
Seat 5: Mukhin1 folded before Flop (didn't bet)
Seat 6: Gcroc52 (button) folded before Flop (didn't bet)
Seat 7: Zeeshka (small blind) folded before Flop
Seat 8: aseban11 (big blind) collected ($1)





PokerStars Hand #148609117432:  Hold'em No Limit ($0.50/$1.00 USD) - 2016/02/11 13:17:04 CET [2016/02/11 7:17:04 ET]
Table 'Marion' 9-max Seat #7 is the button
Seat 1: aseban11 ($100 in chips) 
Seat 2: GusenokRUS ($103.85 in chips) 
Seat 3: TimStone ($105.96 in chips) 
Seat 4: matiko09 ($100 in chips) 
Seat 5: Rikti ($53.01 in chips) 
Seat 6: 19SERGE74 ($71.73 in chips) 
Seat 7: oscarleon ($112.58 in chips) 
Seat 9: Zeeshka ($100 in chips) 
Zeeshka: posts small blind $0.50
aseban11: posts big blind $1
*** HOLE CARDS ***
Dealt to matiko09 [As 5d]
GusenokRUS: folds 
TimStone: folds 
matiko09: folds 
Rikti: folds 
19SERGE74: raises $2 to $3
oscarleon: folds 
Zeeshka: folds 
aseban11: folds 
Uncalled bet ($2) returned to 19SERGE74
19SERGE74 collected $2.50 from pot
19SERGE74: doesn't show hand 
*** SUMMARY ***
Total pot $2.50 | Rake $0 
Seat 1: aseban11 (big blind) folded before Flop
Seat 2: GusenokRUS folded before Flop (didn't bet)
Seat 3: TimStone folded before Flop (didn't bet)
Seat 4: matiko09 folded before Flop (didn't bet)
Seat 5: Rikti folded before Flop (didn't bet)
Seat 6: 19SERGE74 collected ($2.50)
Seat 7: oscarleon (button) folded before Flop (didn't bet)
Seat 9: Zeeshka (small blind) folded before Flop





PokerStars Hand #148609118891:  Hold'em No Limit (€0.25/€0.50 EUR) - 2016/02/11 13:17:07 CET [2016/02/11 7:17:07 ET]
Table 'Otero II' 9-max Seat #7 is the button
Seat 1: Effort92 (€50 in chips) 
Seat 2: Dantist1122 (€50.75 in chips) 
Seat 3: Szevasztopol (€50.75 in chips) 
Seat 4: kram0909 (€16.80 in chips) 
Seat 5: vlad11122007 (€48.69 in chips) 
Seat 7: Dflingern95 (€53.45 in chips) 
Seat 8: matiko09 (€68.51 in chips) 
matiko09: posts small blind €0.25
Effort92: posts big blind €0.50
*** HOLE CARDS ***
Dealt to matiko09 [4d 5c]
Dantist1122: raises €1 to €1.50
Szevasztopol: folds 
kram0909: calls €1.50
vlad11122007: folds 
Dflingern95: folds 
matiko09: folds 
Effort92: folds 
*** FLOP *** [3d Kh 7d]
Dantist1122: bets €2.76
kram0909: folds 
Uncalled bet (€2.76) returned to Dantist1122
Dantist1122 collected €3.58 from pot
Dantist1122: doesn't show hand 
*** SUMMARY ***
Total pot €3.75 | Rake €0.17 
Board [3d Kh 7d]
Seat 1: Effort92 (big blind) folded before Flop
Seat 2: Dantist1122 collected (€3.58)
Seat 3: Szevasztopol folded before Flop (didn't bet)
Seat 4: kram0909 folded on the Flop
Seat 5: vlad11122007 folded before Flop (didn't bet)
Seat 7: Dflingern95 (button) folded before Flop (didn't bet)
Seat 8: matiko09 (small blind) folded before Flop





PokerStars Hand #148609119820:  Hold'em No Limit ($0.25/$0.50 USD) - 2016/02/11 13:17:09 CET [2016/02/11 7:17:09 ET]
Table 'Stereoskopia' 9-max Seat #1 is the button
Seat 1: JJJ-K9 ($53.35 in chips) 
Seat 4: TPACHCI7OPT ($44.49 in chips) 
Seat 5: afrodit71 ($31.50 in chips) 
Seat 6: matiko09 ($50.95 in chips) 
Seat 7: tallonn88 ($54.72 in chips) 
Seat 8: Jo_Medici ($50.75 in chips) 
TPACHCI7OPT: posts small blind $0.25
afrodit71: posts big blind $0.50
*** HOLE CARDS ***
Dealt to matiko09 [2d Th]
Szevasztopol leaves the table
matiko09: folds 
Luoyi-yiwa joins the table at seat #9 
tallonn88: folds 
Jo_Medici: folds 
JJJ-K9: raises $0.75 to $1.25
TPACHCI7OPT: folds 
afrodit71: folds 
Uncalled bet ($0.75) returned to JJJ-K9
TPACHCI7OPT leaves the table
JJJ-K9 collected $1.25 from pot
JJJ-K9: doesn't show hand 
*** SUMMARY ***
Total pot $1.25 | Rake $0 
Seat 1: JJJ-K9 (button) collected ($1.25)
Seat 4: TPACHCI7OPT (small blind) folded before Flop
Seat 5: afrodit71 (big blind) folded before Flop
Seat 6: matiko09 folded before Flop (didn't bet)
Seat 7: tallonn88 folded before Flop (didn't bet)
Seat 8: Jo_Medici folded before Flop (didn't bet)





PokerStars Hand #148609120844:  Hold'em No Limit ($0.50/$1.00 USD) - 2016/02/11 13:17:10 CET [2016/02/11 7:17:10 ET]
Table 'Stephano V' 9-max Seat #5 is the button
Seat 1: hammerwife ($102.75 in chips) 
Seat 2: matiko09 ($139.95 in chips) 
Seat 3: sebaaastian ($100 in chips) 
Seat 4: Zeeshka ($123.32 in chips) 
Seat 5: n2call ($161.40 in chips) 
Seat 7: hurtNCYDE ($106 in chips) 
Seat 8: oscarleon ($215.73 in chips) 
Seat 9: IcocaynaI ($104.19 in chips) 
hurtNCYDE: posts small blind $0.50
oscarleon: posts big blind $1
*** HOLE CARDS ***
Dealt to matiko09 [9d 6d]
IcocaynaI: folds 
hammerwife: folds 
matiko09: folds 
sebaaastian: folds 
Zeeshka: folds 
n2call: folds 
hurtNCYDE: raises $1.50 to $2.50
oscarleon: raises $5.50 to $8
hurtNCYDE: raises $11.50 to $19.50
oscarleon: calls $11.50
*** FLOP *** [7s 6c 8h]
hurtNCYDE: bets $12.66
oscarleon: calls $12.66
*** TURN *** [7s 6c 8h] [Ts]
hurtNCYDE: checks 
oscarleon: checks 
*** RIVER *** [7s 6c 8h Ts] [5h]
hurtNCYDE: checks 
oscarleon: checks 
*** SHOW DOWN ***
hurtNCYDE: shows [Qs Tc] (a pair of Tens)
oscarleon: shows [6h 6s] (three of a kind, Sixes)
oscarleon collected $61.52 from pot
*** SUMMARY ***
Total pot $64.32 | Rake $2.80 
Board [7s 6c 8h Ts 5h]
Seat 1: hammerwife folded before Flop (didn't bet)
Seat 2: matiko09 folded before Flop (didn't bet)
Seat 3: sebaaastian folded before Flop (didn't bet)
Seat 4: Zeeshka folded before Flop (didn't bet)
Seat 5: n2call (button) folded before Flop (didn't bet)
Seat 7: hurtNCYDE (small blind) showed [Qs Tc] and lost with a pair of Tens
Seat 8: oscarleon (big blind) showed [6h 6s] and won ($61.52) with three of a kind, Sixes
Seat 9: IcocaynaI folded before Flop (didn't bet)





PokerStars Hand #148609121629:  Hold'em No Limit ($0.50/$1.00 USD) - 2016/02/11 13:17:12 CET [2016/02/11 7:17:12 ET]
Table 'Gianfar' 9-max Seat #8 is the button
Seat 2: bilukm ($100.50 in chips) 
Seat 3: AlKatrone ($115.19 in chips) 
Seat 4: matiko09 ($122.32 in chips) 
Seat 5: hammerwife ($165.29 in chips) 
Seat 7: Rikti ($38 in chips) 
Seat 8: Zeeshka ($109.14 in chips) 
Seat 9: oscarleon ($145.66 in chips) 
oscarleon: posts small blind $0.50
sebaaastian: is sitting out 
bilukm: posts big blind $1
*** HOLE CARDS ***
Dealt to matiko09 [5d 6d]
sebaaastian leaves the table
AlKatrone: folds 
matiko09: folds 
hammerwife: folds 
Rikti: folds 
Zeeshka: raises $1.50 to $2.50
oscarleon: folds 
bilukm: folds 
Uncalled bet ($1.50) returned to Zeeshka
Zeeshka collected $2.50 from pot
Zeeshka: doesn't show hand 
*** SUMMARY ***
Total pot $2.50 | Rake $0 
Seat 2: bilukm (big blind) folded before Flop
Seat 3: AlKatrone folded before Flop (didn't bet)
Seat 4: matiko09 folded before Flop (didn't bet)
Seat 5: hammerwife folded before Flop (didn't bet)
Seat 7: Rikti folded before Flop (didn't bet)
Seat 8: Zeeshka (button) collected ($2.50)
Seat 9: oscarleon (small blind) folded before Flop





PokerStars Hand #148609124321:  Hold'em No Limit ($0.50/$1.00 USD) - 2016/02/11 13:17:16 CET [2016/02/11 7:17:16 ET]
Table 'Aoluta' 9-max Seat #4 is the button
Seat 1: sebaaastian ($101.16 in chips) 
Seat 2: matiko09 ($143.65 in chips) 
Seat 3: Zeeshka ($102.75 in chips) 
Seat 4: oscarleon ($172.26 in chips) 
Seat 5: aseban11 ($100 in chips) 
Seat 8: mrspecial1 ($60.50 in chips) 
aseban11: posts small blind $0.50
Luck In Me: is sitting out 
mrspecial1: posts big blind $1
*** HOLE CARDS ***
Dealt to matiko09 [Th Ks]
sebaaastian: folds 
hurtNCYDE joins the table at seat #7 
hurtNCYDE leaves the table
matiko09: folds 
vrnMike joins the table at seat #7 
Zeeshka: folds 
oscarleon: folds 
aseban11: raises $2 to $3
mrspecial1: folds 
Uncalled bet ($2) returned to aseban11
aseban11 collected $2 from pot
aseban11: doesn't show hand 
*** SUMMARY ***
Total pot $2 | Rake $0 
Seat 1: sebaaastian folded before Flop (didn't bet)
Seat 2: matiko09 folded before Flop (didn't bet)
Seat 3: Zeeshka folded before Flop (didn't bet)
Seat 4: oscarleon (button) folded before Flop (didn't bet)
Seat 5: aseban11 (small blind) collected ($2)
Seat 8: mrspecial1 (big blind) folded before Flop





PokerStars Hand #148609127578:  Hold'em No Limit ($0.50/$1.00 USD) - 2016/02/11 13:17:22 CET [2016/02/11 7:17:22 ET]
Table 'Clorinde' 9-max Seat #7 is the button
Seat 1: matiko09 ($101.50 in chips) 
Seat 2: 19SERGE74 ($82.34 in chips) 
Seat 3: gabi_igna ($102.25 in chips) 
Seat 5: Mukhin1 ($100 in chips) 
Seat 6: Gcroc52 ($39.60 in chips) 
Seat 7: Zeeshka ($100 in chips) 
Seat 8: aseban11 ($119.72 in chips) 
aseban11: posts small blind $0.50
matiko09: posts big blind $1
*** HOLE CARDS ***
Dealt to matiko09 [7h 8d]
19SERGE74: calls $1
gabi_igna: folds 
Mukhin1: folds 
Gcroc52: folds 
hammerwife joins the table at seat #9 
Zeeshka: folds 
aseban11: folds 
matiko09: checks 
*** FLOP *** [3s Td 5c]
matiko09: checks 
19SERGE74: bets $1.19
matiko09: folds 
Uncalled bet ($1.19) returned to 19SERGE74
19SERGE74 collected $2.39 from pot
19SERGE74: doesn't show hand 
*** SUMMARY ***
Total pot $2.50 | Rake $0.11 
Board [3s Td 5c]
Seat 1: matiko09 (big blind) folded on the Flop
Seat 2: 19SERGE74 collected ($2.39)
Seat 3: gabi_igna folded before Flop (didn't bet)
Seat 5: Mukhin1 folded before Flop (didn't bet)
Seat 6: Gcroc52 folded before Flop (didn't bet)
Seat 7: Zeeshka (button) folded before Flop (didn't bet)
Seat 8: aseban11 (small blind) folded before Flop





PokerStars Hand #148609133491:  Hold'em No Limit ($0.25/$0.50 USD) - 2016/02/11 13:17:32 CET [2016/02/11 7:17:32 ET]
Table 'Oenone' 9-max Seat #1 is the button
Seat 1: tallonn88 ($51.14 in chips) 
Seat 2: Reven9er ($50.38 in chips) 
Seat 3: TPACHCI7OPT ($49.02 in chips) 
Seat 4: Serhent ($50 in chips) 
Seat 5: ReinisRNS ($56.34 in chips) 
Seat 6: matiko09 ($52.94 in chips) 
Seat 7: banit7 ($52.50 in chips) 
Seat 8: vlad11122007 ($81.64 in chips) 
Seat 9: xxxibgdrgn ($52.96 in chips) 
Reven9er: posts small blind $0.25
TPACHCI7OPT: posts big blind $0.50
*** HOLE CARDS ***
Dealt to matiko09 [8c Td]
Serhent: folds 
ReinisRNS: folds 
matiko09: folds 
banit7: raises $1 to $1.50
vlad11122007: folds 
xxxibgdrgn: folds 
tallonn88: folds 
Reven9er: folds 
TPACHCI7OPT: folds 
Uncalled bet ($1) returned to banit7
banit7 collected $1.25 from pot
banit7: doesn't show hand 
*** SUMMARY ***
Total pot $1.25 | Rake $0 
Seat 1: tallonn88 (button) folded before Flop (didn't bet)
Seat 2: Reven9er (small blind) folded before Flop
Seat 3: TPACHCI7OPT (big blind) folded before Flop
Seat 4: Serhent folded before Flop (didn't bet)
Seat 5: ReinisRNS folded before Flop (didn't bet)
Seat 6: matiko09 folded before Flop (didn't bet)
Seat 7: banit7 collected ($1.25)
Seat 8: vlad11122007 folded before Flop (didn't bet)
Seat 9: xxxibgdrgn folded before Flop (didn't bet)





PokerStars Hand #148609137134:  Hold'em No Limit ($0.50/$1.00 USD) - 2016/02/11 13:17:38 CET [2016/02/11 7:17:38 ET]
Table 'Gianfar' 9-max Seat #9 is the button
Seat 2: bilukm ($99.50 in chips) 
Seat 3: AlKatrone ($115.19 in chips) 
Seat 4: matiko09 ($122.32 in chips) 
Seat 5: hammerwife ($165.29 in chips) 
Seat 7: Rikti ($38 in chips) 
Seat 8: Zeeshka ($110.64 in chips) 
Seat 9: oscarleon ($145.16 in chips) 
bilukm: posts small blind $0.50
AlKatrone: posts big blind $1
*** HOLE CARDS ***
Dealt to matiko09 [5s Ah]
matiko09: folds 
hammerwife: folds 
Rikti: folds 
Zeeshka: folds 
oscarleon: folds 
bilukm: raises $1 to $2
AlKatrone: calls $1
*** FLOP *** [4c 2s 9c]
bilukm: bets $1.91
AlKatrone: folds 
Uncalled bet ($1.91) returned to bilukm
bilukm collected $3.82 from pot
bilukm: doesn't show hand 
*** SUMMARY ***
Total pot $4 | Rake $0.18 
Board [4c 2s 9c]
Seat 2: bilukm (small blind) collected ($3.82)
Seat 3: AlKatrone (big blind) folded on the Flop
Seat 4: matiko09 folded before Flop (didn't bet)
Seat 5: hammerwife folded before Flop (didn't bet)
Seat 7: Rikti folded before Flop (didn't bet)
Seat 8: Zeeshka folded before Flop (didn't bet)
Seat 9: oscarleon (button) folded before Flop (didn't bet)





PokerStars Hand #148609141061:  Hold'em No Limit ($0.25/$0.50 USD) - 2016/02/11 13:17:45 CET [2016/02/11 7:17:45 ET]
Table 'Ambrosia II' 9-max Seat #1 is the button
Seat 1: matiko09 ($51.79 in chips) 
Seat 2: JJJ-K9 ($49.50 in chips) 
Seat 3: make6a ($84.43 in chips) 
Seat 4: huudk2016 ($29.07 in chips) 
Seat 6: Reven9er ($62.26 in chips) 
Seat 7: Ana.Satravca ($63.21 in chips) 
Seat 8: tallonn88 ($56.26 in chips) 
Seat 9: arctur17 ($52.42 in chips) 
JJJ-K9: posts small blind $0.25
make6a: posts big blind $0.50
RICKA16: sits out 
*** HOLE CARDS ***
Dealt to matiko09 [5h 9h]
huudk2016: folds 
Reven9er: folds 
Ana.Satravca: folds 
tallonn88: folds 
arctur17: raises $0.50 to $1
matiko09: folds 
JJJ-K9: folds 
make6a: folds 
Uncalled bet ($0.50) returned to arctur17
arctur17 collected $1.25 from pot
arctur17: doesn't show hand 
*** SUMMARY ***
Total pot $1.25 | Rake $0 
Seat 1: matiko09 (button) folded before Flop (didn't bet)
Seat 2: JJJ-K9 (small blind) folded before Flop
Seat 3: make6a (big blind) folded before Flop
Seat 4: huudk2016 folded before Flop (didn't bet)
Seat 6: Reven9er folded before Flop (didn't bet)
Seat 7: Ana.Satravca folded before Flop (didn't bet)
Seat 8: tallonn88 folded before Flop (didn't bet)
Seat 9: arctur17 collected ($1.25)





PokerStars Hand #148609144606:  Hold'em No Limit ($0.50/$1.00 USD) - 2016/02/11 13:17:51 CET [2016/02/11 7:17:51 ET]
Table 'Marion' 9-max Seat #9 is the button
Seat 1: aseban11 ($100 in chips) 
Seat 2: GusenokRUS ($103.85 in chips) 
Seat 3: TimStone ($105.96 in chips) 
Seat 4: matiko09 ($100 in chips) 
Seat 5: Rikti ($53.01 in chips) 
Seat 6: 19SERGE74 ($73.23 in chips) 
Seat 7: oscarleon ($112.58 in chips) 
Seat 9: Zeeshka ($100 in chips) 
aseban11: posts small blind $0.50
GusenokRUS: posts big blind $1
*** HOLE CARDS ***
Dealt to matiko09 [Ah Kc]
TimStone: folds 
matiko09: raises $2 to $3
Rikti: folds 
19SERGE74: calls $3
oscarleon: folds 
Zeeshka: folds 
aseban11: calls $2.50
GusenokRUS: folds 
*** FLOP *** [5s 5d Tc]
aseban11: bets $7.16
matiko09: folds 
19SERGE74: folds 
Uncalled bet ($7.16) returned to aseban11
aseban11 collected $9.55 from pot
aseban11: doesn't show hand 
*** SUMMARY ***
Total pot $10 | Rake $0.45 
Board [5s 5d Tc]
Seat 1: aseban11 (small blind) collected ($9.55)
Seat 2: GusenokRUS (big blind) folded before Flop
Seat 3: TimStone folded before Flop (didn't bet)
Seat 4: matiko09 folded on the Flop
Seat 5: Rikti folded before Flop (didn't bet)
Seat 6: 19SERGE74 folded on the Flop
Seat 7: oscarleon folded before Flop (didn't bet)
Seat 9: Zeeshka (button) folded before Flop (didn't bet)





PokerStars Hand #148609144793:  Hold'em No Limit ($0.25/$0.50 USD) - 2016/02/11 13:17:51 CET [2016/02/11 7:17:51 ET]
Table 'Stereoskopia' 9-max Seat #5 is the button
Seat 1: JJJ-K9 ($54.10 in chips) 
Seat 5: afrodit71 ($31 in chips) 
Seat 6: matiko09 ($50.95 in chips) 
Seat 7: tallonn88 ($54.72 in chips) 
Seat 8: Jo_Medici ($50.75 in chips) 
Seat 9: Luoyi-yiwa ($50 in chips) 
matiko09: posts small blind $0.25
tallonn88: posts big blind $0.50
Luoyi-yiwa: posts big blind $0.50
*** HOLE CARDS ***
Dealt to matiko09 [2s 5c]
Anikin44 joins the table at seat #4 
Jo_Medici: folds 
Luoyi-yiwa: checks 
JJJ-K9: folds 
afrodit71: folds 
matiko09: folds 
tallonn88: checks 
*** FLOP *** [Jd Ts 7s]
Dantist1122 joins the table at seat #2 
tallonn88: checks 
Luoyi-yiwa: checks 
*** TURN *** [Jd Ts 7s] [3h]
tallonn88: bets $1
fandorin2005 joins the table at seat #3 
Luoyi-yiwa: calls $1
*** RIVER *** [Jd Ts 7s 3h] [2d]
tallonn88: checks 
Luoyi-yiwa: checks 
*** SHOW DOWN ***
tallonn88: shows [Ks Qd] (high card King)
Luoyi-yiwa: shows [7d As] (a pair of Sevens)
Luoyi-yiwa collected $3.10 from pot
*** SUMMARY ***
Total pot $3.25 | Rake $0.15 
Board [Jd Ts 7s 3h 2d]
Seat 1: JJJ-K9 folded before Flop (didn't bet)
Seat 5: afrodit71 (button) folded before Flop (didn't bet)
Seat 6: matiko09 (small blind) folded before Flop
Seat 7: tallonn88 (big blind) showed [Ks Qd] and lost with high card King
Seat 8: Jo_Medici folded before Flop (didn't bet)
Seat 9: Luoyi-yiwa showed [7d As] and won ($3.10) with a pair of Sevens





PokerStars Hand #148609144573:  Hold'em No Limit ($0.25/$0.50 USD) - 2016/02/11 13:17:51 CET [2016/02/11 7:17:51 ET]
Table 'Sylvania II' 9-max Seat #7 is the button
Seat 1: tw0315 ($150.29 in chips) 
Seat 2: Effort92 ($50 in chips) 
Seat 3: ruyingren ($227.79 in chips) 
Seat 4: matiko09 ($121.44 in chips) 
Seat 5: vlad11122007 ($57.54 in chips) 
Seat 7: 2lefthand75 ($83.70 in chips) 
Seat 9: Yippiebeans ($65.32 in chips) 
Apparat888 will be allowed to play after the button
Yippiebeans: posts small blind $0.25
tw0315: posts big blind $0.50
tw0315: posts the ante $0.10
Effort92: posts the ante $0.10
ruyingren: posts the ante $0.10
matiko09: posts the ante $0.10
vlad11122007: posts the ante $0.10
2lefthand75: posts the ante $0.10
Yippiebeans: posts the ante $0.10
*** HOLE CARDS ***
Dealt to matiko09 [3d Td]
Effort92: raises $1 to $1.50
ruyingren: calls $1.50
matiko09: folds 
vlad11122007: folds 
2lefthand75: folds 
Yippiebeans: folds 
tw0315: raises $1 to $2.50
Effort92: calls $1
ruyingren: calls $1
*** FLOP *** [4s 5h Qd]
tw0315: bets $4.03
Effort92: folds 
ruyingren: raises $6.53 to $10.56
tw0315: calls $6.53
*** TURN *** [4s 5h Qd] [Ac]
tw0315: bets $14.12
ruyingren: calls $14.12
*** RIVER *** [4s 5h Qd Ac] [9h]
tw0315: checks 
ruyingren: checks 
*** SHOW DOWN ***
tw0315: shows [Jh Jd] (a pair of Jacks)
ruyingren: mucks hand 
tw0315 collected $55.31 from pot
*** SUMMARY ***
Total pot $57.81 | Rake $2.50 
Board [4s 5h Qd Ac 9h]
Seat 1: tw0315 (big blind) showed [Jh Jd] and won ($55.31) with a pair of Jacks
Seat 2: Effort92 folded on the Flop
Seat 3: ruyingren mucked [5c 3c]
Seat 4: matiko09 folded before Flop (didn't bet)
Seat 5: vlad11122007 folded before Flop (didn't bet)
Seat 7: 2lefthand75 (button) folded before Flop (didn't bet)
Seat 9: Yippiebeans (small blind) folded before Flop





PokerStars Hand #148609147972:  Hold'em No Limit ($0.50/$1.00 USD) - 2016/02/11 13:17:57 CET [2016/02/11 7:17:57 ET]
Table 'Clorinde' 9-max Seat #8 is the button
Seat 1: matiko09 ($100.50 in chips) 
Seat 2: 19SERGE74 ($83.73 in chips) 
Seat 3: gabi_igna ($102.25 in chips) 
Seat 5: Mukhin1 ($100 in chips) 
Seat 6: Gcroc52 ($39.60 in chips) 
Seat 7: Zeeshka ($100 in chips) 
Seat 8: aseban11 ($119.22 in chips) 
matiko09: posts small blind $0.50
19SERGE74: posts big blind $1
*** HOLE CARDS ***
Dealt to matiko09 [Tc Js]
gabi_igna: folds 
Mukhin1: folds 
Gcroc52: raises $2 to $3
Zeeshka: folds 
aseban11: folds 
matiko09: folds 
19SERGE74: raises $6.50 to $9.50
Gcroc52: calls $6.50
*** FLOP *** [5d Ks Qd]
19SERGE74: bets $9
Gcroc52: folds 
Uncalled bet ($9) returned to 19SERGE74
19SERGE74 collected $18.62 from pot
19SERGE74: doesn't show hand 
*** SUMMARY ***
Total pot $19.50 | Rake $0.88 
Board [5d Ks Qd]
Seat 1: matiko09 (small blind) folded before Flop
Seat 2: 19SERGE74 (big blind) collected ($18.62)
Seat 3: gabi_igna folded before Flop (didn't bet)
Seat 5: Mukhin1 folded before Flop (didn't bet)
Seat 6: Gcroc52 folded on the Flop
Seat 7: Zeeshka folded before Flop (didn't bet)
Seat 8: aseban11 (button) folded before Flop (didn't bet)





PokerStars Hand #148609149880:  Hold'em No Limit ($0.25/$0.50 USD) - 2016/02/11 13:18:00 CET [2016/02/11 7:18:00 ET]
Table 'Oenone' 9-max Seat #2 is the button
Seat 1: tallonn88 ($51.14 in chips) 
Seat 2: Reven9er ($50.13 in chips) 
Seat 3: TPACHCI7OPT ($48.52 in chips) 
Seat 4: Serhent ($50 in chips) 
Seat 5: ReinisRNS ($56.34 in chips) 
Seat 6: matiko09 ($52.94 in chips) 
Seat 7: banit7 ($53.25 in chips) 
Seat 8: vlad11122007 ($81.64 in chips) 
Seat 9: xxxibgdrgn ($52.96 in chips) 
TPACHCI7OPT: posts small blind $0.25
Serhent: posts big blind $0.50
*** HOLE CARDS ***
Dealt to matiko09 [4h Ah]
ReinisRNS: calls $0.50
matiko09: folds 
banit7: folds 
vlad11122007: folds 
xxxibgdrgn: folds 
tallonn88: folds 
Reven9er: folds 
TPACHCI7OPT: folds 
Serhent: checks 
*** FLOP *** [Ac Kh Ts]
Serhent: checks 
ReinisRNS: bets $0.50
Serhent: folds 
Uncalled bet ($0.50) returned to ReinisRNS
ReinisRNS collected $1.19 from pot
ReinisRNS: doesn't show hand 
*** SUMMARY ***
Total pot $1.25 | Rake $0.06 
Board [Ac Kh Ts]
Seat 1: tallonn88 folded before Flop (didn't bet)
Seat 2: Reven9er (button) folded before Flop (didn't bet)
Seat 3: TPACHCI7OPT (small blind) folded before Flop
Seat 4: Serhent (big blind) folded on the Flop
Seat 5: ReinisRNS collected ($1.19)
Seat 6: matiko09 folded before Flop (didn't bet)
Seat 7: banit7 folded before Flop (didn't bet)
Seat 8: vlad11122007 folded before Flop (didn't bet)
Seat 9: xxxibgdrgn folded before Flop (didn't bet)





PokerStars Hand #148609150818:  Hold'em No Limit (€0.25/€0.50 EUR) - 2016/02/11 13:18:02 CET [2016/02/11 7:18:02 ET]
Table 'Otero II' 9-max Seat #8 is the button
Seat 1: Effort92 (€50 in chips) 
Seat 2: Dantist1122 (€52.83 in chips) 
Seat 3: Szevasztopol (€50.75 in chips) 
Seat 4: kram0909 (€15.30 in chips) 
Seat 5: vlad11122007 (€48.69 in chips) 
Seat 7: Dflingern95 (€53.45 in chips) 
Seat 8: matiko09 (€68.26 in chips) 
Effort92: posts small blind €0.25
Dantist1122: posts big blind €0.50
*** HOLE CARDS ***
Dealt to matiko09 [Kh 6c]
Szevasztopol: folds 
kram0909: folds 
vlad11122007: folds 
Dflingern95: calls €0.50
matiko09: folds 
Effort92: folds 
Dantist1122: checks 
*** FLOP *** [5d Jh 2h]
Dantist1122: checks 
Dflingern95: checks 
*** TURN *** [5d Jh 2h] [As]
Dantist1122: bets €0.95
Dflingern95: folds 
Uncalled bet (€0.95) returned to Dantist1122
Dantist1122 collected €1.19 from pot
Dantist1122: doesn't show hand 
*** SUMMARY ***
Total pot €1.25 | Rake €0.06 
Board [5d Jh 2h As]
Seat 1: Effort92 (small blind) folded before Flop
Seat 2: Dantist1122 (big blind) collected (€1.19)
Seat 3: Szevasztopol folded before Flop (didn't bet)
Seat 4: kram0909 folded before Flop (didn't bet)
Seat 5: vlad11122007 folded before Flop (didn't bet)
Seat 7: Dflingern95 folded on the Turn
Seat 8: matiko09 (button) folded before Flop (didn't bet)





PokerStars Hand #148609161729:  Hold'em No Limit ($0.25/$0.50 USD) - 2016/02/11 13:18:20 CET [2016/02/11 7:18:20 ET]
Table 'Ambrosia II' 9-max Seat #2 is the button
Seat 1: matiko09 ($51.79 in chips) 
Seat 2: JJJ-K9 ($49.25 in chips) 
Seat 3: make6a ($83.93 in chips) 
Seat 4: huudk2016 ($29.07 in chips) 
Seat 6: Reven9er ($62.26 in chips) 
Seat 7: Ana.Satravca ($63.21 in chips) 
Seat 8: tallonn88 ($56.26 in chips) 
Seat 9: arctur17 ($53.17 in chips) 
make6a: posts small blind $0.25
huudk2016: posts big blind $0.50
RICKA16: sits out 
*** HOLE CARDS ***
Dealt to matiko09 [4c 2c]
Reven9er: folds 
Ana.Satravca: folds 
tallonn88: folds 
arctur17: folds 
matiko09: folds 
JJJ-K9: raises $0.75 to $1.25
make6a: calls $1
huudk2016: calls $0.75
*** FLOP *** [7d 5d 8h]
make6a: checks 
huudk2016: checks 
JJJ-K9: bets $2
make6a: calls $2
huudk2016: raises $3.50 to $5.50
JJJ-K9: folds 
make6a: calls $3.50
*** TURN *** [7d 5d 8h] [Ac]
make6a: checks 
huudk2016: checks 
*** RIVER *** [7d 5d 8h Ac] [2h]
make6a: checks 
huudk2016: bets $4.50
make6a: folds 
Uncalled bet ($4.50) returned to huudk2016
huudk2016 collected $16 from pot
huudk2016: doesn't show hand 
*** SUMMARY ***
Total pot $16.75 | Rake $0.75 
Board [7d 5d 8h Ac 2h]
Seat 1: matiko09 folded before Flop (didn't bet)
Seat 2: JJJ-K9 (button) folded on the Flop
Seat 3: make6a (small blind) folded on the River
Seat 4: huudk2016 (big blind) collected ($16)
Seat 6: Reven9er folded before Flop (didn't bet)
Seat 7: Ana.Satravca folded before Flop (didn't bet)
Seat 8: tallonn88 folded before Flop (didn't bet)
Seat 9: arctur17 folded before Flop (didn't bet)





PokerStars Hand #148609173633:  Hold'em No Limit (€0.25/€0.50 EUR) - 2016/02/11 13:18:41 CET [2016/02/11 7:18:41 ET]
Table 'Otero II' 9-max Seat #1 is the button
Seat 1: Effort92 (€50 in chips) 
Seat 2: Dantist1122 (€53.52 in chips) 
Seat 3: Szevasztopol (€50.75 in chips) 
Seat 4: kram0909 (€15.30 in chips) 
Seat 5: vlad11122007 (€48.69 in chips) 
Seat 7: Dflingern95 (€52.95 in chips) 
Seat 8: matiko09 (€68.26 in chips) 
Dantist1122: posts small blind €0.25
Szevasztopol: posts big blind €0.50
*** HOLE CARDS ***
Dealt to matiko09 [Th 7c]
kram0909: folds 
vlad11122007: folds 
Dflingern95: folds 
matiko09: folds 
Effort92: raises €0.50 to €1
Dantist1122: folds 
Szevasztopol: folds 
Uncalled bet (€0.50) returned to Effort92
Effort92 collected €1.25 from pot
Effort92: doesn't show hand 
*** SUMMARY ***
Total pot €1.25 | Rake €0 
Seat 1: Effort92 (button) collected (€1.25)
Seat 2: Dantist1122 (small blind) folded before Flop
Seat 3: Szevasztopol (big blind) folded before Flop
Seat 4: kram0909 folded before Flop (didn't bet)
Seat 5: vlad11122007 folded before Flop (didn't bet)
Seat 7: Dflingern95 folded before Flop (didn't bet)
Seat 8: matiko09 folded before Flop (didn't bet)





PokerStars Hand #148609174743:  Hold'em No Limit ($0.50/$1.00 USD) - 2016/02/11 13:18:43 CET [2016/02/11 7:18:43 ET]
Table 'Gianfar' 9-max Seat #2 is the button
Seat 2: bilukm ($101.32 in chips) 
Seat 3: AlKatrone ($113.19 in chips) 
Seat 4: matiko09 ($122.32 in chips) 
Seat 5: hammerwife ($165.29 in chips) 
Seat 7: Rikti ($38 in chips) 
Seat 8: Zeeshka ($110.64 in chips) 
Seat 9: oscarleon ($145.16 in chips) 
AlKatrone: posts small blind $0.50
matiko09: posts big blind $1
*** HOLE CARDS ***
Dealt to matiko09 [7d 7c]
hammerwife: folds 
Rikti: folds 
hurtNCYDE joins the table at seat #1 
Zeeshka: folds 
oscarleon: folds 
bilukm: calls $1
hurtNCYDE leaves the table
AlKatrone: calls $0.50
matiko09: raises $4 to $5
bilukm: folds 
AlKatrone: folds 
Uncalled bet ($4) returned to matiko09
matiko09 collected $3 from pot
matiko09: doesn't show hand 
*** SUMMARY ***
Total pot $3 | Rake $0 
Seat 2: bilukm (button) folded before Flop
Seat 3: AlKatrone (small blind) folded before Flop
Seat 4: matiko09 (big blind) collected ($3)
Seat 5: hammerwife folded before Flop (didn't bet)
Seat 7: Rikti folded before Flop (didn't bet)
Seat 8: Zeeshka folded before Flop (didn't bet)
Seat 9: oscarleon folded before Flop (didn't bet)





PokerStars Hand #148609178028:  Hold'em No Limit ($0.50/$1.00 USD) - 2016/02/11 13:18:48 CET [2016/02/11 7:18:48 ET]
Table 'Stephano V' 9-max Seat #7 is the button
Seat 1: hammerwife ($102.75 in chips) 
Seat 2: matiko09 ($139.95 in chips) 
Seat 3: sebaaastian ($100 in chips) 
Seat 4: Zeeshka ($123.32 in chips) 
Seat 5: n2call ($161.40 in chips) 
Seat 7: hurtNCYDE ($100 in chips) 
Seat 8: oscarleon ($245.09 in chips) 
Seat 9: IcocaynaI ($104.19 in chips) 
oscarleon: posts small blind $0.50
IcocaynaI: posts big blind $1
*** HOLE CARDS ***
Dealt to matiko09 [Jh 6c]
hammerwife: raises $2 to $3
matiko09: folds 
sebaaastian: folds 
Zeeshka: folds 
n2call: folds 
hurtNCYDE: folds 
oscarleon: calls $2.50
IcocaynaI: calls $2
*** FLOP *** [Jc 4h 3h]
oscarleon: checks 
IcocaynaI: bets $1
hammerwife: raises $5.50 to $6.50
oscarleon: folds 
IcocaynaI: folds 
Uncalled bet ($5.50) returned to hammerwife
hammerwife collected $10.50 from pot
hammerwife: doesn't show hand 
*** SUMMARY ***
Total pot $11 | Rake $0.50 
Board [Jc 4h 3h]
Seat 1: hammerwife collected ($10.50)
Seat 2: matiko09 folded before Flop (didn't bet)
Seat 3: sebaaastian folded before Flop (didn't bet)
Seat 4: Zeeshka folded before Flop (didn't bet)
Seat 5: n2call folded before Flop (didn't bet)
Seat 7: hurtNCYDE (button) folded before Flop (didn't bet)
Seat 8: oscarleon (small blind) folded on the Flop
Seat 9: IcocaynaI (big blind) folded on the Flop





PokerStars Hand #148609181162:  Hold'em No Limit ($0.50/$1.00 USD) - 2016/02/11 13:18:54 CET [2016/02/11 7:18:54 ET]
Table 'Marion' 9-max Seat #1 is the button
Seat 1: aseban11 ($106.55 in chips) 
Seat 2: GusenokRUS ($102.85 in chips) 
Seat 3: TimStone ($105.96 in chips) 
Seat 4: matiko09 ($100 in chips) 
Seat 5: Rikti ($53.01 in chips) 
Seat 6: 19SERGE74 ($70.23 in chips) 
Seat 7: oscarleon ($112.58 in chips) 
Seat 9: Zeeshka ($100 in chips) 
GusenokRUS: posts small blind $0.50
TimStone: posts big blind $1
*** HOLE CARDS ***
Dealt to matiko09 [6c 2h]
matiko09: folds 
Rikti: folds 
19SERGE74: folds 
oscarleon: folds 
Zeeshka: raises $2 to $3
aseban11: folds 
GusenokRUS: folds 
TimStone: folds 
Uncalled bet ($2) returned to Zeeshka
Zeeshka collected $2.50 from pot
Zeeshka: doesn't show hand 
*** SUMMARY ***
Total pot $2.50 | Rake $0 
Seat 1: aseban11 (button) folded before Flop (didn't bet)
Seat 2: GusenokRUS (small blind) folded before Flop
Seat 3: TimStone (big blind) folded before Flop
Seat 4: matiko09 folded before Flop (didn't bet)
Seat 5: Rikti folded before Flop (didn't bet)
Seat 6: 19SERGE74 folded before Flop (didn't bet)
Seat 7: oscarleon folded before Flop (didn't bet)
Seat 9: Zeeshka collected ($2.50)





PokerStars Hand #148609192309:  Hold'em No Limit ($0.25/$0.50 USD) - 2016/02/11 13:19:13 CET [2016/02/11 7:19:13 ET]
Table 'Stereoskopia' 9-max Seat #6 is the button
Seat 1: JJJ-K9 ($54.10 in chips) 
Seat 5: afrodit71 ($31 in chips) 
Seat 6: matiko09 ($50.70 in chips) 
Seat 7: tallonn88 ($53.22 in chips) 
Seat 9: Luoyi-yiwa ($51.60 in chips) 
tallonn88: posts small blind $0.25
Jo_Medici: is sitting out 
Luoyi-yiwa: posts big blind $0.50
Jo_Medici leaves the table
Dantist1122: sits out 
fandorin2005: sits out 
Anikin44: sits out 
*** HOLE CARDS ***
Dealt to matiko09 [7s Kh]
JJJ-K9: raises $0.75 to $1.25
afrodit71: calls $1.25
matiko09: folds 
tallonn88: folds 
Luoyi-yiwa: folds 
*** FLOP *** [2c 7d Qh]
JJJ-K9: bets $1.55
afrodit71: folds 
Uncalled bet ($1.55) returned to JJJ-K9
JJJ-K9 collected $3.10 from pot
JJJ-K9: doesn't show hand 
*** SUMMARY ***
Total pot $3.25 | Rake $0.15 
Board [2c 7d Qh]
Seat 1: JJJ-K9 collected ($3.10)
Seat 5: afrodit71 folded on the Flop
Seat 6: matiko09 (button) folded before Flop (didn't bet)
Seat 7: tallonn88 (small blind) folded before Flop
Seat 9: Luoyi-yiwa (big blind) folded before Flop





PokerStars Hand #148609193761:  Hold'em No Limit ($0.50/$1.00 USD) - 2016/02/11 13:19:15 CET [2016/02/11 7:19:15 ET]
Table 'Gianfar' 9-max Seat #3 is the button
Seat 2: bilukm ($100.32 in chips) 
Seat 3: AlKatrone ($112.19 in chips) 
Seat 4: matiko09 ($124.32 in chips) 
Seat 5: hammerwife ($165.29 in chips) 
Seat 7: Rikti ($38 in chips) 
Seat 8: Zeeshka ($110.64 in chips) 
Seat 9: oscarleon ($145.16 in chips) 
matiko09: posts small blind $0.50
hammerwife: posts big blind $1
*** HOLE CARDS ***
Dealt to matiko09 [Qh As]
Rikti: folds 
Zeeshka: folds 
oscarleon: raises $2 to $3
bilukm: calls $3
AlKatrone: folds 
matiko09: raises $10 to $13
hammerwife: folds 
oscarleon: folds 
bilukm: folds 
Uncalled bet ($10) returned to matiko09
matiko09 collected $10 from pot
matiko09: doesn't show hand 
*** SUMMARY ***
Total pot $10 | Rake $0 
Seat 2: bilukm folded before Flop
Seat 3: AlKatrone (button) folded before Flop (didn't bet)
Seat 4: matiko09 (small blind) collected ($10)
Seat 5: hammerwife (big blind) folded before Flop
Seat 7: Rikti folded before Flop (didn't bet)
Seat 8: Zeeshka folded before Flop (didn't bet)
Seat 9: oscarleon folded before Flop





PokerStars Hand #148609194006:  Hold'em No Limit ($0.50/$1.00 USD) - 2016/02/11 13:19:16 CET [2016/02/11 7:19:16 ET]
Table 'Clorinde' 9-max Seat #1 is the button
Seat 1: matiko09 ($100 in chips) 
Seat 2: 19SERGE74 ($92.85 in chips) 
Seat 3: gabi_igna ($102.25 in chips) 
Seat 5: Mukhin1 ($100 in chips) 
Seat 6: Gcroc52 ($30.10 in chips) 
Seat 7: Zeeshka ($100 in chips) 
Seat 8: aseban11 ($119.22 in chips) 
19SERGE74: posts small blind $0.50
gabi_igna: posts big blind $1
hammerwife: sits out 
*** HOLE CARDS ***
Dealt to matiko09 [6h As]
Mukhin1: raises $2.02 to $3.02
Gcroc52: folds 
Zeeshka: folds 
aseban11: folds 
matiko09: folds 
19SERGE74: folds 
gabi_igna: folds 
Uncalled bet ($2.02) returned to Mukhin1
Mukhin1 collected $2.50 from pot
Mukhin1: doesn't show hand 
*** SUMMARY ***
Total pot $2.50 | Rake $0 
Seat 1: matiko09 (button) folded before Flop (didn't bet)
Seat 2: 19SERGE74 (small blind) folded before Flop
Seat 3: gabi_igna (big blind) folded before Flop
Seat 5: Mukhin1 collected ($2.50)
Seat 6: Gcroc52 folded before Flop (didn't bet)
Seat 7: Zeeshka folded before Flop (didn't bet)
Seat 8: aseban11 folded before Flop (didn't bet)





PokerStars Hand #148609195259:  Hold'em No Limit (€0.25/€0.50 EUR) - 2016/02/11 13:19:18 CET [2016/02/11 7:19:18 ET]
Table 'Otero II' 9-max Seat #2 is the button
Seat 1: Effort92 (€50.75 in chips) 
Seat 2: Dantist1122 (€53.27 in chips) 
Seat 3: Szevasztopol (€50.25 in chips) 
Seat 4: kram0909 (€15.30 in chips) 
Seat 5: vlad11122007 (€48.69 in chips) 
Seat 7: Dflingern95 (€52.95 in chips) 
Seat 8: matiko09 (€68.26 in chips) 
Szevasztopol: posts small blind €0.25
kram0909: posts big blind €0.50
*** HOLE CARDS ***
Dealt to matiko09 [5d Kd]
vlad11122007: folds 
Dflingern95: calls €0.50
matiko09: folds 
Effort92: folds 
Dantist1122: folds 
Szevasztopol: raises €2.50 to €3
kram0909: folds 
Dflingern95: calls €2.50
*** FLOP *** [2s Qs Qc]
Szevasztopol: checks 
Dflingern95: bets €1.50
Szevasztopol: calls €1.50
*** TURN *** [2s Qs Qc] [8s]
Szevasztopol: checks 
Dflingern95: bets €1.50
Szevasztopol: calls €1.50
*** RIVER *** [2s Qs Qc 8s] [6s]
Szevasztopol: checks 
Dflingern95: bets €6.50
Szevasztopol: folds 
Uncalled bet (€6.50) returned to Dflingern95
Dflingern95 collected €11.94 from pot
*** SUMMARY ***
Total pot €12.50 | Rake €0.56 
Board [2s Qs Qc 8s 6s]
Seat 1: Effort92 folded before Flop (didn't bet)
Seat 2: Dantist1122 (button) folded before Flop (didn't bet)
Seat 3: Szevasztopol (small blind) folded on the River
Seat 4: kram0909 (big blind) folded before Flop
Seat 5: vlad11122007 folded before Flop (didn't bet)
Seat 7: Dflingern95 collected (€11.94)
Seat 8: matiko09 folded before Flop (didn't bet)





PokerStars Hand #148609199552:  Hold'em No Limit ($0.50/$1.00 USD) - 2016/02/11 13:19:25 CET [2016/02/11 7:19:25 ET]
Table 'Marion' 9-max Seat #2 is the button
Seat 1: aseban11 ($106.55 in chips) 
Seat 2: GusenokRUS ($102.35 in chips) 
Seat 3: TimStone ($104.96 in chips) 
Seat 4: matiko09 ($100 in chips) 
Seat 5: Rikti ($53.01 in chips) 
Seat 6: 19SERGE74 ($70.23 in chips) 
Seat 7: oscarleon ($112.58 in chips) 
Seat 9: Zeeshka ($101.50 in chips) 
TimStone: posts small blind $0.50
matiko09: posts big blind $1
*** HOLE CARDS ***
Dealt to matiko09 [7s Qd]
Rikti: folds 
19SERGE74: calls $1
oscarleon: folds 
Zeeshka: folds 
aseban11: folds 
GusenokRUS: raises $5 to $6
TimStone: folds 
matiko09: folds 
19SERGE74: calls $5
*** FLOP *** [3h Qs 6d]
19SERGE74: checks 
GusenokRUS: bets $7
19SERGE74: folds 
Uncalled bet ($7) returned to GusenokRUS
GusenokRUS collected $12.89 from pot
GusenokRUS: doesn't show hand 
*** SUMMARY ***
Total pot $13.50 | Rake $0.61 
Board [3h Qs 6d]
Seat 1: aseban11 folded before Flop (didn't bet)
Seat 2: GusenokRUS (button) collected ($12.89)
Seat 3: TimStone (small blind) folded before Flop
Seat 4: matiko09 (big blind) folded before Flop
Seat 5: Rikti folded before Flop (didn't bet)
Seat 6: 19SERGE74 folded on the Flop
Seat 7: oscarleon folded before Flop (didn't bet)
Seat 9: Zeeshka folded before Flop (didn't bet)





PokerStars Hand #148609200180:  Hold'em No Limit ($0.25/$0.50 USD) - 2016/02/11 13:19:26 CET [2016/02/11 7:19:26 ET]
Table 'Sylvania II' 9-max Seat #9 is the button
Seat 1: tw0315 ($178.32 in chips) 
Seat 2: Effort92 ($50 in chips) 
Seat 3: ruyingren ($200.51 in chips) 
Seat 4: matiko09 ($121.34 in chips) 
Seat 5: vlad11122007 ($57.44 in chips) 
Seat 7: 2lefthand75 ($83.60 in chips) 
Seat 9: Yippiebeans ($64.97 in chips) 
tw0315: posts small blind $0.25
Effort92: posts big blind $0.50
Apparat888: sits out 
tw0315: posts the ante $0.10
Effort92: posts the ante $0.10
ruyingren: posts the ante $0.10
matiko09: posts the ante $0.10
vlad11122007: posts the ante $0.10
2lefthand75: posts the ante $0.10
Yippiebeans: posts the ante $0.10
*** HOLE CARDS ***
Dealt to matiko09 [9d 4h]
ruyingren: folds 
matiko09: folds 
vlad11122007: folds 
2lefthand75: calls $0.50
Yippiebeans: folds 
Yippiebeans leaves the table
tw0315: raises $0.50 to $1
Effort92: folds 
2lefthand75: calls $0.50
*** FLOP *** [2c 7h 7d]
tw0315: bets $1.53
2lefthand75: calls $1.53
*** TURN *** [2c 7h 7d] [As]
ruyingren is disconnected 
tw0315: bets $2.50
2lefthand75: calls $2.50
*** RIVER *** [2c 7h 7d As] [7s]
tw0315: bets $173.19 and is all-in
2lefthand75: folds 
Uncalled bet ($173.19) returned to tw0315
tw0315 collected $10.75 from pot
*** SUMMARY ***
Total pot $11.26 | Rake $0.51 
Board [2c 7h 7d As 7s]
Seat 1: tw0315 (small blind) collected ($10.75)
Seat 2: Effort92 (big blind) folded before Flop
Seat 3: ruyingren folded before Flop (didn't bet)
Seat 4: matiko09 folded before Flop (didn't bet)
Seat 5: vlad11122007 folded before Flop (didn't bet)
Seat 7: 2lefthand75 folded on the River
Seat 9: Yippiebeans (button) folded before Flop (didn't bet)





PokerStars Hand #148609200658:  Hold'em No Limit ($0.50/$1.00 USD) - 2016/02/11 13:19:27 CET [2016/02/11 7:19:27 ET]
Table 'Kleopatra II' 9-max Seat #1 is the button
Seat 1: gwwsb ($60.99 in chips) 
Seat 2: azvazdam ($77 in chips) 
Seat 3: matiko09 ($100 in chips) 
Seat 4: sebaaastian ($100 in chips) 
Seat 7: Zeeshka ($100 in chips) 
Seat 8: oscarleon ($107.14 in chips) 
Seat 9: vrnMike ($112.17 in chips) 
azvazdam: posts small blind $0.50
matiko09: posts big blind $1
hammerwife: sits out 
*** HOLE CARDS ***
Dealt to matiko09 [8d 6s]
sebaaastian: folds 
Zeeshka: folds 
oscarleon: folds 
vrnMike: folds 
gwwsb: folds 
azvazdam: raises $2 to $3
matiko09: folds 
Uncalled bet ($2) returned to azvazdam
azvazdam collected $2 from pot
azvazdam: doesn't show hand 
*** SUMMARY ***
Total pot $2 | Rake $0 
Seat 1: gwwsb (button) folded before Flop (didn't bet)
Seat 2: azvazdam (small blind) collected ($2)
Seat 3: matiko09 (big blind) folded before Flop
Seat 4: sebaaastian folded before Flop (didn't bet)
Seat 7: Zeeshka folded before Flop (didn't bet)
Seat 8: oscarleon folded before Flop (didn't bet)
Seat 9: vrnMike folded before Flop (didn't bet)





PokerStars Hand #148609210793:  Hold'em No Limit ($0.50/$1.00 USD) - 2016/02/11 13:19:44 CET [2016/02/11 7:19:44 ET]
Table 'Clorinde' 9-max Seat #2 is the button
Seat 1: matiko09 ($100 in chips) 
Seat 2: 19SERGE74 ($92.35 in chips) 
Seat 3: gabi_igna ($101.25 in chips) 
Seat 5: Mukhin1 ($101.50 in chips) 
Seat 6: Gcroc52 ($30.10 in chips) 
Seat 7: Zeeshka ($100 in chips) 
Seat 8: aseban11 ($119.22 in chips) 
gabi_igna: posts small blind $0.50
Mukhin1: posts big blind $1
hammerwife: sits out 
*** HOLE CARDS ***
Dealt to matiko09 [9d 8c]
Gcroc52: raises $1 to $2
Zeeshka: folds 
aseban11: folds 
matiko09: folds 
19SERGE74: calls $2
gabi_igna: folds 
Mukhin1: folds 
*** FLOP *** [5c Ad Qc]
Gcroc52: checks 
19SERGE74: checks 
*** TURN *** [5c Ad Qc] [6d]
Gcroc52: bets $2
19SERGE74: raises $3 to $5
Gcroc52: calls $3
*** RIVER *** [5c Ad Qc 6d] [7s]
Gcroc52: checks 
19SERGE74: bets $9.86
Gcroc52: folds 
Uncalled bet ($9.86) returned to 19SERGE74
19SERGE74 collected $14.80 from pot
19SERGE74: doesn't show hand 
*** SUMMARY ***
Total pot $15.50 | Rake $0.70 
Board [5c Ad Qc 6d 7s]
Seat 1: matiko09 folded before Flop (didn't bet)
Seat 2: 19SERGE74 (button) collected ($14.80)
Seat 3: gabi_igna (small blind) folded before Flop
Seat 5: Mukhin1 (big blind) folded before Flop
Seat 6: Gcroc52 folded on the River
Seat 7: Zeeshka folded before Flop (didn't bet)
Seat 8: aseban11 folded before Flop (didn't bet)





PokerStars Hand #148609214087:  Hold'em No Limit ($0.50/$1.00 USD) - 2016/02/11 13:19:50 CET [2016/02/11 7:19:50 ET]
Table 'Stephano V' 9-max Seat #8 is the button
Seat 1: hammerwife ($109.25 in chips) 
Seat 2: matiko09 ($139.95 in chips) 
Seat 3: sebaaastian ($100 in chips) 
Seat 4: Zeeshka ($123.32 in chips) 
Seat 5: n2call ($161.40 in chips) 
Seat 7: hurtNCYDE ($100 in chips) 
Seat 8: oscarleon ($242.09 in chips) 
Seat 9: IcocaynaI ($100.19 in chips) 
IcocaynaI: posts small blind $0.50
hammerwife: posts big blind $1
*** HOLE CARDS ***
Dealt to matiko09 [7s 8s]
matiko09: raises $2 to $3
sebaaastian: folds 
Zeeshka: folds 
n2call: raises $6 to $9
hurtNCYDE: folds 
oscarleon: folds 
IcocaynaI: calls $8.50
hammerwife: folds 
matiko09: calls $6
*** FLOP *** [Ad Kc Qh]
IcocaynaI: bets $8
matiko09: folds 
n2call: calls $8
*** TURN *** [Ad Kc Qh] [2c]
IcocaynaI: bets $9
n2call: calls $9
*** RIVER *** [Ad Kc Qh 2c] [6s]
IcocaynaI: bets $12
n2call: raises $32 to $44
IcocaynaI: calls $32
*** SHOW DOWN ***
n2call: shows [Ks As] (two pair, Aces and Kings)
IcocaynaI: mucks hand 
n2call collected $147.20 from pot
*** SUMMARY ***
Total pot $150 | Rake $2.80 
Board [Ad Kc Qh 2c 6s]
Seat 1: hammerwife (big blind) folded before Flop
Seat 2: matiko09 folded on the Flop
Seat 3: sebaaastian folded before Flop (didn't bet)
Seat 4: Zeeshka folded before Flop (didn't bet)
Seat 5: n2call showed [Ks As] and won ($147.20) with two pair, Aces and Kings
Seat 7: hurtNCYDE folded before Flop (didn't bet)
Seat 8: oscarleon (button) folded before Flop (didn't bet)
Seat 9: IcocaynaI (small blind) mucked [Js Ac]





PokerStars Hand #148609215888:  Hold'em No Limit ($0.50/$1.00 USD) - 2016/02/11 13:19:53 CET [2016/02/11 7:19:53 ET]
Table 'Gianfar' 9-max Seat #4 is the button
Seat 2: bilukm ($97.32 in chips) 
Seat 3: AlKatrone ($112.19 in chips) 
Seat 4: matiko09 ($131.32 in chips) 
Seat 5: hammerwife ($164.29 in chips) 
Seat 7: Rikti ($38 in chips) 
Seat 8: Zeeshka ($110.64 in chips) 
Seat 9: oscarleon ($142.16 in chips) 
hammerwife: posts small blind $0.50
Rikti: posts big blind $1
*** HOLE CARDS ***
Dealt to matiko09 [Qd 6h]
Zeeshka: folds 
oscarleon: folds 
Vikulja1993 joins the table at seat #1 
bilukm: calls $1
AlKatrone: folds 
matiko09: folds 
hammerwife: raises $3 to $4
Rikti: folds 
bilukm: calls $3
*** FLOP *** [Tc 4s 7d]
hammerwife: checks 
bilukm: bets $4.30
hammerwife: folds 
Uncalled bet ($4.30) returned to bilukm
bilukm collected $8.60 from pot
bilukm: doesn't show hand 
*** SUMMARY ***
Total pot $9 | Rake $0.40 
Board [Tc 4s 7d]
Seat 2: bilukm collected ($8.60)
Seat 3: AlKatrone folded before Flop (didn't bet)
Seat 4: matiko09 (button) folded before Flop (didn't bet)
Seat 5: hammerwife (small blind) folded on the Flop
Seat 7: Rikti (big blind) folded before Flop
Seat 8: Zeeshka folded before Flop (didn't bet)
Seat 9: oscarleon folded before Flop (didn't bet)





PokerStars Hand #148609218268:  Hold'em No Limit ($0.50/$1.00 USD) - 2016/02/11 13:19:57 CET [2016/02/11 7:19:57 ET]
Table 'Kleopatra II' 9-max Seat #2 is the button
Seat 1: gwwsb ($60.99 in chips) 
Seat 2: azvazdam ($78 in chips) 
Seat 3: matiko09 ($100 in chips) 
Seat 6: hammerwife ($175.85 in chips) 
Seat 7: Zeeshka ($100 in chips) 
Seat 8: oscarleon ($107.14 in chips) 
Seat 9: vrnMike ($112.17 in chips) 
matiko09: posts small blind $0.50
sebaaastian: is sitting out 
sebaaastian leaves the table
hammerwife: posts big blind $1
*** HOLE CARDS ***
Dealt to matiko09 [2d 7h]
Zeeshka: folds 
TimStone joins the table at seat #4 
oscarleon: folds 
vrnMike: folds 
gwwsb: folds 
azvazdam: raises $1 to $2
matiko09: folds 
hammerwife: folds 
Uncalled bet ($1) returned to azvazdam
azvazdam collected $2.50 from pot
azvazdam: doesn't show hand 
*** SUMMARY ***
Total pot $2.50 | Rake $0 
Seat 1: gwwsb folded before Flop (didn't bet)
Seat 2: azvazdam (button) collected ($2.50)
Seat 3: matiko09 (small blind) folded before Flop
Seat 6: hammerwife (big blind) folded before Flop
Seat 7: Zeeshka folded before Flop (didn't bet)
Seat 8: oscarleon folded before Flop (didn't bet)
Seat 9: vrnMike folded before Flop (didn't bet)





PokerStars Hand #148609221800:  Hold'em No Limit ($0.25/$0.50 USD) - 2016/02/11 13:20:03 CET [2016/02/11 7:20:03 ET]
Table 'Stereoskopia' 9-max Seat #7 is the button
Seat 2: Dantist1122 ($50 in chips) 
Seat 5: afrodit71 ($29.75 in chips) 
Seat 6: matiko09 ($50.70 in chips) 
Seat 7: tallonn88 ($52.97 in chips) 
Seat 9: Luoyi-yiwa ($51.10 in chips) 
Luoyi-yiwa: posts small blind $0.25
JJJ-K9: is sitting out 
Dantist1122: posts big blind $0.50
fandorin2005: sits out 
Anikin44: sits out 
*** HOLE CARDS ***
Dealt to matiko09 [9h Tc]
afrodit71: calls $0.50
matiko09: folds 
tallonn88: folds 
Luoyi-yiwa: folds 
Dantist1122: checks 
*** FLOP *** [As 6s 2s]
Dantist1122: checks 
afrodit71: bets $2
Dantist1122: folds 
Uncalled bet ($2) returned to afrodit71
afrodit71 collected $1.19 from pot
afrodit71: doesn't show hand 
*** SUMMARY ***
Total pot $1.25 | Rake $0.06 
Board [As 6s 2s]
Seat 2: Dantist1122 (big blind) folded on the Flop
Seat 5: afrodit71 collected ($1.19)
Seat 6: matiko09 folded before Flop (didn't bet)
Seat 7: tallonn88 (button) folded before Flop (didn't bet)
Seat 9: Luoyi-yiwa (small blind) folded before Flop





PokerStars Hand #148609225939:  Hold'em No Limit ($0.25/$0.50 USD) - 2016/02/11 13:20:10 CET [2016/02/11 7:20:10 ET]
Table 'Ambrosia II' 9-max Seat #3 is the button
Seat 1: matiko09 ($51.79 in chips) 
Seat 2: JJJ-K9 ($46 in chips) 
Seat 3: make6a ($77.18 in chips) 
Seat 4: huudk2016 ($38.32 in chips) 
Seat 5: RICKA16 ($49.50 in chips) 
Seat 6: Reven9er ($62.26 in chips) 
Seat 7: Ana.Satravca ($63.21 in chips) 
Seat 8: tallonn88 ($56.26 in chips) 
Seat 9: arctur17 ($53.17 in chips) 
huudk2016: posts small blind $0.25
RICKA16: posts big blind $0.50
*** HOLE CARDS ***
Dealt to matiko09 [Kc 2h]
Reven9er: folds 
Ana.Satravca: folds 
tallonn88: folds 
arctur17: raises $0.50 to $1
matiko09: folds 
JJJ-K9: raises $2.75 to $3.75
make6a: folds 
huudk2016: folds 
RICKA16: folds 
arctur17: calls $2.75
*** FLOP *** [Jd Ah 4s]
arctur17: checks 
JJJ-K9: bets $4.50
arctur17: calls $4.50
*** TURN *** [Jd Ah 4s] [Ts]
arctur17: checks 
JJJ-K9: checks 
*** RIVER *** [Jd Ah 4s Ts] [Ac]
arctur17: bets $8.50
JJJ-K9: calls $8.50
*** SHOW DOWN ***
arctur17: shows [Jh Ks] (two pair, Aces and Jacks)
JJJ-K9: shows [Ad Kh] (three of a kind, Aces)
JJJ-K9 collected $32.71 from pot
*** SUMMARY ***
Total pot $34.25 | Rake $1.54 
Board [Jd Ah 4s Ts Ac]
Seat 1: matiko09 folded before Flop (didn't bet)
Seat 2: JJJ-K9 showed [Ad Kh] and won ($32.71) with three of a kind, Aces
Seat 3: make6a (button) folded before Flop (didn't bet)
Seat 4: huudk2016 (small blind) folded before Flop
Seat 5: RICKA16 (big blind) folded before Flop
Seat 6: Reven9er folded before Flop (didn't bet)
Seat 7: Ana.Satravca folded before Flop (didn't bet)
Seat 8: tallonn88 folded before Flop (didn't bet)
Seat 9: arctur17 showed [Jh Ks] and lost with two pair, Aces and Jacks





PokerStars Hand #148609235205:  Hold'em No Limit ($0.50/$1.00 USD) - 2016/02/11 13:20:26 CET [2016/02/11 7:20:26 ET]
Table 'Kleopatra II' 9-max Seat #3 is the button
Seat 1: gwwsb ($60.99 in chips) 
Seat 2: azvazdam ($79.50 in chips) 
Seat 3: matiko09 ($100 in chips) 
Seat 6: hammerwife ($174.85 in chips) 
Seat 7: Zeeshka ($100 in chips) 
Seat 8: oscarleon ($107.14 in chips) 
Seat 9: vrnMike ($112.17 in chips) 
TimStone will be allowed to play after the button
hammerwife: posts small blind $0.50
Zeeshka: posts big blind $1
*** HOLE CARDS ***
Dealt to matiko09 [2c 4d]
oscarleon: folds 
vrnMike: folds 
gwwsb: folds 
azvazdam: folds 
matiko09: folds 
hammerwife: folds 
Uncalled bet ($0.50) returned to Zeeshka
Zeeshka collected $1 from pot
Zeeshka: doesn't show hand 
*** SUMMARY ***
Total pot $1 | Rake $0 
Seat 1: gwwsb folded before Flop (didn't bet)
Seat 2: azvazdam folded before Flop (didn't bet)
Seat 3: matiko09 (button) folded before Flop (didn't bet)
Seat 6: hammerwife (small blind) folded before Flop
Seat 7: Zeeshka (big blind) collected ($1)
Seat 8: oscarleon folded before Flop (didn't bet)
Seat 9: vrnMike folded before Flop (didn't bet)





PokerStars Hand #148609236037:  Hold'em No Limit ($0.50/$1.00 USD) - 2016/02/11 13:20:27 CET [2016/02/11 7:20:27 ET]
Table 'Gianfar' 9-max Seat #5 is the button
Seat 2: bilukm ($101.92 in chips) 
Seat 3: AlKatrone ($112.19 in chips) 
Seat 4: matiko09 ($131.32 in chips) 
Seat 5: hammerwife ($160.29 in chips) 
Seat 7: Rikti ($37 in chips) 
Seat 8: Zeeshka ($110.64 in chips) 
Seat 9: oscarleon ($142.16 in chips) 
Rikti: posts small blind $0.50
Zeeshka: posts big blind $1
Vikulja1993: sits out 
*** HOLE CARDS ***
Dealt to matiko09 [8h 2s]
oscarleon: folds 
bilukm: folds 
AlKatrone: folds 
matiko09: folds 
hammerwife: raises $1.01 to $2.01
Rikti: folds 
Zeeshka: folds 
Uncalled bet ($1.01) returned to hammerwife
hammerwife collected $2.50 from pot
hammerwife: doesn't show hand 
*** SUMMARY ***
Total pot $2.50 | Rake $0 
Seat 2: bilukm folded before Flop (didn't bet)
Seat 3: AlKatrone folded before Flop (didn't bet)
Seat 4: matiko09 folded before Flop (didn't bet)
Seat 5: hammerwife (button) collected ($2.50)
Seat 7: Rikti (small blind) folded before Flop
Seat 8: Zeeshka (big blind) folded before Flop
Seat 9: oscarleon folded before Flop (didn't bet)





PokerStars Hand #148609238464:  Hold'em No Limit ($0.25/$0.50 USD) - 2016/02/11 13:20:32 CET [2016/02/11 7:20:32 ET]
Table 'Sylvania II' 9-max Seat #1 is the button
Seat 1: tw0315 ($183.94 in chips) 
Seat 2: Effort92 ($50 in chips) 
Seat 4: matiko09 ($121.24 in chips) 
Seat 5: vlad11122007 ($57.34 in chips) 
Seat 7: 2lefthand75 ($78.47 in chips) 
Effort92: posts small blind $0.25
ruyingren has timed out while disconnected
ruyingren: is sitting out 
matiko09: posts big blind $0.50
Apparat888: sits out 
tw0315: posts the ante $0.10
Effort92: posts the ante $0.10
matiko09: posts the ante $0.10
vlad11122007: posts the ante $0.10
2lefthand75: posts the ante $0.10
*** HOLE CARDS ***
Dealt to matiko09 [5d 7d]
vlad11122007: folds 
2lefthand75: calls $0.50
tw0315: folds 
Effort92: folds 
matiko09: checks 
*** FLOP *** [Jh Qd Th]
matiko09: checks 
2lefthand75: checks 
*** TURN *** [Jh Qd Th] [4h]
matiko09: checks 
2lefthand75: checks 
*** RIVER *** [Jh Qd Th 4h] [9h]
matiko09: checks 
2lefthand75: checks 
*** SHOW DOWN ***
matiko09: shows [5d 7d] (high card Queen)
2lefthand75: shows [3d Ac] (high card Ace)
2lefthand75 collected $1.67 from pot
*** SUMMARY ***
Total pot $1.75 | Rake $0.08 
Board [Jh Qd Th 4h 9h]
Seat 1: tw0315 (button) folded before Flop (didn't bet)
Seat 2: Effort92 (small blind) folded before Flop
Seat 4: matiko09 (big blind) showed [5d 7d] and lost with high card Queen
Seat 5: vlad11122007 folded before Flop (didn't bet)
Seat 7: 2lefthand75 showed [3d Ac] and won ($1.67) with high card Ace





PokerStars Hand #148609240433:  Hold'em No Limit ($0.50/$1.00 USD) - 2016/02/11 13:20:35 CET [2016/02/11 7:20:35 ET]
Table 'Marion' 9-max Seat #3 is the button
Seat 1: aseban11 ($106.55 in chips) 
Seat 2: GusenokRUS ($109.24 in chips) 
Seat 3: TimStone ($104.46 in chips) 
Seat 4: matiko09 ($100 in chips) 
Seat 5: Rikti ($53.01 in chips) 
Seat 6: 19SERGE74 ($64.23 in chips) 
Seat 7: oscarleon ($112.58 in chips) 
Seat 9: Zeeshka ($101.50 in chips) 
matiko09: posts small blind $0.50
Rikti: posts big blind $1
*** HOLE CARDS ***
Dealt to matiko09 [9c Qd]
19SERGE74: calls $1
oscarleon: folds 
Zeeshka: folds 
aseban11: folds 
GusenokRUS: folds 
TimStone: folds 
matiko09: calls $0.50
Rikti: checks 
*** FLOP *** [3c 5s 2s]
matiko09: checks 
Rikti: bets $2
19SERGE74: calls $2
matiko09: folds 
*** TURN *** [3c 5s 2s] [7c]
Rikti: bets $5
19SERGE74: calls $5
*** RIVER *** [3c 5s 2s 7c] [Jc]
Rikti: checks 
19SERGE74: checks 
*** SHOW DOWN ***
Rikti: shows [5h Qc] (a pair of Fives)
19SERGE74: mucks hand 
Rikti collected $16.24 from pot
*** SUMMARY ***
Total pot $17 | Rake $0.76 
Board [3c 5s 2s 7c Jc]
Seat 1: aseban11 folded before Flop (didn't bet)
Seat 2: GusenokRUS folded before Flop (didn't bet)
Seat 3: TimStone (button) folded before Flop (didn't bet)
Seat 4: matiko09 (small blind) folded on the Flop
Seat 5: Rikti (big blind) showed [5h Qc] and won ($16.24) with a pair of Fives
Seat 6: 19SERGE74 mucked [Qs As]
Seat 7: oscarleon folded before Flop (didn't bet)
Seat 9: Zeeshka folded before Flop (didn't bet)





PokerStars Hand #148609245819:  Hold'em No Limit ($0.50/$1.00 USD) - 2016/02/11 13:20:44 CET [2016/02/11 7:20:44 ET]
Table 'Clorinde' 9-max Seat #3 is the button
Seat 1: matiko09 ($100 in chips) 
Seat 2: 19SERGE74 ($100.15 in chips) 
Seat 3: gabi_igna ($100.75 in chips) 
Seat 5: Mukhin1 ($100.50 in chips) 
Seat 6: Gcroc52 ($23.10 in chips) 
Seat 7: Zeeshka ($100 in chips) 
Seat 8: aseban11 ($119.22 in chips) 
Mukhin1: posts small blind $0.50
Gcroc52: posts big blind $1
hammerwife: sits out 
*** HOLE CARDS ***
Dealt to matiko09 [Kh 3s]
Zeeshka: folds 
aseban11: raises $2.50 to $3.50
matiko09: folds 
19SERGE74: folds 
gabi_igna: folds 
Mukhin1: folds 
Gcroc52: folds 
Uncalled bet ($2.50) returned to aseban11
aseban11 collected $2.50 from pot
aseban11: doesn't show hand 
*** SUMMARY ***
Total pot $2.50 | Rake $0 
Seat 1: matiko09 folded before Flop (didn't bet)
Seat 2: 19SERGE74 folded before Flop (didn't bet)
Seat 3: gabi_igna (button) folded before Flop (didn't bet)
Seat 5: Mukhin1 (small blind) folded before Flop
Seat 6: Gcroc52 (big blind) folded before Flop
Seat 7: Zeeshka folded before Flop (didn't bet)
Seat 8: aseban11 collected ($2.50)





PokerStars Hand #148609246801:  Hold'em No Limit ($0.50/$1.00 USD) - 2016/02/11 13:20:46 CET [2016/02/11 7:20:46 ET]
Table 'Kleopatra II' 9-max Seat #6 is the button
Seat 1: gwwsb ($60.99 in chips) 
Seat 2: azvazdam ($79.50 in chips) 
Seat 3: matiko09 ($100 in chips) 
Seat 6: hammerwife ($174.35 in chips) 
Seat 7: Zeeshka ($100.50 in chips) 
Seat 8: oscarleon ($107.14 in chips) 
Seat 9: vrnMike ($112.17 in chips) 
Zeeshka: posts small blind $0.50
oscarleon: posts big blind $1
TimStone: sits out 
*** HOLE CARDS ***
Dealt to matiko09 [4d 6d]
vrnMike: folds 
gwwsb: folds 
azvazdam: folds 
matiko09: folds 
hammerwife: folds 
Zeeshka: folds 
Uncalled bet ($0.50) returned to oscarleon
oscarleon collected $1 from pot
oscarleon: doesn't show hand 
*** SUMMARY ***
Total pot $1 | Rake $0 
Seat 1: gwwsb folded before Flop (didn't bet)
Seat 2: azvazdam folded before Flop (didn't bet)
Seat 3: matiko09 folded before Flop (didn't bet)
Seat 6: hammerwife (button) folded before Flop (didn't bet)
Seat 7: Zeeshka (small blind) folded before Flop
Seat 8: oscarleon (big blind) collected ($1)
Seat 9: vrnMike folded before Flop (didn't bet)





PokerStars Hand #148609247990:  Hold'em No Limit ($0.25/$0.50 USD) - 2016/02/11 13:20:48 CET [2016/02/11 7:20:48 ET]
Table 'Stereoskopia' 9-max Seat #9 is the button
Seat 2: Dantist1122 ($50 in chips) 
Seat 3: fandorin2005 ($50 in chips) 
Seat 5: afrodit71 ($30.44 in chips) 
Seat 6: matiko09 ($50.70 in chips) 
Seat 7: tallonn88 ($52.97 in chips) 
Seat 9: Luoyi-yiwa ($50.85 in chips) 
Dantist1122: posts small blind $0.25
fandorin2005: posts big blind $0.50
Anikin44: sits out 
*** HOLE CARDS ***
Dealt to matiko09 [As 5h]
afrodit71: folds 
matiko09: folds 
tallonn88: raises $1 to $1.50
Luoyi-yiwa: calls $1.50
Dantist1122: folds 
fandorin2005: folds 
*** FLOP *** [Qs Ts 4h]
tallonn88: bets $2.25
Luoyi-yiwa: folds 
Uncalled bet ($2.25) returned to tallonn88
tallonn88 collected $3.58 from pot
tallonn88: doesn't show hand 
*** SUMMARY ***
Total pot $3.75 | Rake $0.17 
Board [Qs Ts 4h]
Seat 2: Dantist1122 (small blind) folded before Flop
Seat 3: fandorin2005 (big blind) folded before Flop
Seat 5: afrodit71 folded before Flop (didn't bet)
Seat 6: matiko09 folded before Flop (didn't bet)
Seat 7: tallonn88 collected ($3.58)
Seat 9: Luoyi-yiwa (button) folded on the Flop





PokerStars Hand #148609253901:  Hold'em No Limit ($0.50/$1.00 USD) - 2016/02/11 13:20:58 CET [2016/02/11 7:20:58 ET]
Table 'Gianfar' 9-max Seat #7 is the button
Seat 2: bilukm ($101.92 in chips) 
Seat 3: AlKatrone ($112.19 in chips) 
Seat 4: matiko09 ($131.32 in chips) 
Seat 5: hammerwife ($161.79 in chips) 
Seat 7: Rikti ($36.50 in chips) 
Seat 8: Zeeshka ($109.64 in chips) 
Seat 9: oscarleon ($142.16 in chips) 
Zeeshka: posts small blind $0.50
oscarleon: posts big blind $1
Vikulja1993: sits out 
*** HOLE CARDS ***
Dealt to matiko09 [8d Ts]
bilukm: raises $2 to $3
AlKatrone: folds 
matiko09: folds 
hammerwife: raises $6 to $9
Rikti: folds 
Zeeshka: folds 
oscarleon: folds 
bilukm: calls $6
*** FLOP *** [4c 5d Ac]
bilukm: bets $9.31
hammerwife: folds 
Uncalled bet ($9.31) returned to bilukm
bilukm collected $18.62 from pot
bilukm: doesn't show hand 
*** SUMMARY ***
Total pot $19.50 | Rake $0.88 
Board [4c 5d Ac]
Seat 2: bilukm collected ($18.62)
Seat 3: AlKatrone folded before Flop (didn't bet)
Seat 4: matiko09 folded before Flop (didn't bet)
Seat 5: hammerwife folded on the Flop
Seat 7: Rikti (button) folded before Flop (didn't bet)
Seat 8: Zeeshka (small blind) folded before Flop
Seat 9: oscarleon (big blind) folded before Flop





PokerStars Hand #148609255685:  Hold'em No Limit ($0.50/$1.00 USD) - 2016/02/11 13:21:01 CET [2016/02/11 7:21:01 ET]
Table 'Clorinde' 9-max Seat #5 is the button
Seat 1: matiko09 ($100 in chips) 
Seat 2: 19SERGE74 ($100.15 in chips) 
Seat 3: gabi_igna ($100.75 in chips) 
Seat 5: Mukhin1 ($100 in chips) 
Seat 6: Gcroc52 ($22.10 in chips) 
Seat 7: Zeeshka ($100 in chips) 
Seat 8: aseban11 ($120.72 in chips) 
Gcroc52: posts small blind $0.50
Zeeshka: posts big blind $1
hammerwife: sits out 
*** HOLE CARDS ***
Dealt to matiko09 [Qh 2s]
aseban11: folds 
matiko09: folds 
19SERGE74: calls $1
gabi_igna: folds 
Mukhin1: folds 
Gcroc52: calls $0.50
Zeeshka: checks 
*** FLOP *** [3c Kc 4d]
Gcroc52: checks 
Zeeshka: checks 
19SERGE74: checks 
*** TURN *** [3c Kc 4d] [7s]
Gcroc52: checks 
Zeeshka: checks 
19SERGE74: checks 
*** RIVER *** [3c Kc 4d 7s] [5h]
Gcroc52: checks 
Zeeshka: bets $2.14
19SERGE74: folds 
Gcroc52: calls $2.14
*** SHOW DOWN ***
Zeeshka: shows [6d 2h] (a straight, Three to Seven)
Gcroc52: mucks hand 
Zeeshka collected $6.95 from pot
*** SUMMARY ***
Total pot $7.28 | Rake $0.33 
Board [3c Kc 4d 7s 5h]
Seat 1: matiko09 folded before Flop (didn't bet)
Seat 2: 19SERGE74 folded on the River
Seat 3: gabi_igna folded before Flop (didn't bet)
Seat 5: Mukhin1 (button) folded before Flop (didn't bet)
Seat 6: Gcroc52 (small blind) mucked [As 5s]
Seat 7: Zeeshka (big blind) showed [6d 2h] and won ($6.95) with a straight, Three to Seven
Seat 8: aseban11 folded before Flop (didn't bet)





PokerStars Hand #148609256994:  Hold'em No Limit ($0.50/$1.00 USD) - 2016/02/11 13:21:03 CET [2016/02/11 7:21:03 ET]
Table 'Kleopatra II' 9-max Seat #7 is the button
Seat 1: gwwsb ($60.99 in chips) 
Seat 2: azvazdam ($79.50 in chips) 
Seat 3: matiko09 ($100 in chips) 
Seat 6: hammerwife ($174.35 in chips) 
Seat 7: Zeeshka ($100 in chips) 
Seat 8: oscarleon ($107.64 in chips) 
Seat 9: vrnMike ($112.17 in chips) 
oscarleon: posts small blind $0.50
vrnMike: posts big blind $1
TimStone: sits out 
*** HOLE CARDS ***
Dealt to matiko09 [6c 7h]
gwwsb: folds 
azvazdam: folds 
matiko09: folds 
hammerwife: folds 
Zeeshka: folds 
oscarleon: raises $2 to $3
vrnMike: folds 
Uncalled bet ($2) returned to oscarleon
oscarleon collected $2 from pot
oscarleon: doesn't show hand 
*** SUMMARY ***
Total pot $2 | Rake $0 
Seat 1: gwwsb folded before Flop (didn't bet)
Seat 2: azvazdam folded before Flop (didn't bet)
Seat 3: matiko09 folded before Flop (didn't bet)
Seat 6: hammerwife folded before Flop (didn't bet)
Seat 7: Zeeshka (button) folded before Flop (didn't bet)
Seat 8: oscarleon (small blind) collected ($2)
Seat 9: vrnMike (big blind) folded before Flop





PokerStars Hand #148609259562:  Hold'em No Limit (€0.25/€0.50 EUR) - 2016/02/11 13:21:08 CET [2016/02/11 7:21:08 ET]
Table 'Otero II' 9-max Seat #3 is the button
Seat 1: Effort92 (€50.75 in chips) 
Seat 2: Dantist1122 (€53.27 in chips) 
Seat 3: Szevasztopol (€50 in chips) 
Seat 4: kram0909 (€14.80 in chips) 
Seat 5: vlad11122007 (€48.69 in chips) 
Seat 7: Dflingern95 (€58.89 in chips) 
Seat 8: matiko09 (€68.26 in chips) 
kram0909: posts small blind €0.25
vlad11122007: posts big blind €0.50
*** HOLE CARDS ***
Dealt to matiko09 [9c Jh]
Dflingern95: folds 
Dflingern95 leaves the table
matiko09: folds 
Effort92: folds 
Dantist1122: folds 
make6a joins the table at seat #7 
Szevasztopol: folds 
kram0909: raises €0.50 to €1
vlad11122007: folds 
Uncalled bet (€0.50) returned to kram0909
kram0909 collected €1 from pot
kram0909: doesn't show hand 
*** SUMMARY ***
Total pot €1 | Rake €0 
Seat 1: Effort92 folded before Flop (didn't bet)
Seat 2: Dantist1122 folded before Flop (didn't bet)
Seat 3: Szevasztopol (button) folded before Flop (didn't bet)
Seat 4: kram0909 (small blind) collected (€1)
Seat 5: vlad11122007 (big blind) folded before Flop
Seat 7: Dflingern95 folded before Flop (didn't bet)
Seat 8: matiko09 folded before Flop (didn't bet)





PokerStars Hand #148609271427:  Hold'em No Limit ($0.25/$0.50 USD) - 2016/02/11 13:21:28 CET [2016/02/11 7:21:28 ET]
Table 'Sylvania II' 9-max Seat #2 is the button
Seat 1: tw0315 ($183.84 in chips) 
Seat 2: Effort92 ($50 in chips) 
Seat 4: matiko09 ($120.64 in chips) 
Seat 5: vlad11122007 ($57.24 in chips) 
Seat 7: 2lefthand75 ($79.54 in chips) 
matiko09: posts small blind $0.25
vlad11122007: posts big blind $0.50
Apparat888: sits out 
tw0315: posts the ante $0.10
Effort92: posts the ante $0.10
matiko09: posts the ante $0.10
vlad11122007: posts the ante $0.10
2lefthand75: posts the ante $0.10
*** HOLE CARDS ***
Dealt to matiko09 [Tc 6d]
2lefthand75: calls $0.50
tw0315: calls $0.50
Effort92: folds 
matiko09: folds 
vlad11122007: checks 
*** FLOP *** [Ts 7s Kd]
vlad11122007: checks 
2lefthand75: bets $1.07
tw0315: folds 
vlad11122007: calls $1.07
*** TURN *** [Ts 7s Kd] [9c]
vlad11122007: checks 
2lefthand75: checks 
*** RIVER *** [Ts 7s Kd 9c] [4s]
vlad11122007: checks 
2lefthand75: checks 
*** SHOW DOWN ***
vlad11122007: shows [8h Th] (a pair of Tens)
2lefthand75: mucks hand 
vlad11122007 collected $4.19 from pot
*** SUMMARY ***
Total pot $4.39 | Rake $0.20 
Board [Ts 7s Kd 9c 4s]
Seat 1: tw0315 folded on the Flop
Seat 2: Effort92 (button) folded before Flop (didn't bet)
Seat 4: matiko09 (small blind) folded before Flop
Seat 5: vlad11122007 (big blind) showed [8h Th] and won ($4.19) with a pair of Tens
Seat 7: 2lefthand75 mucked [6h 7h]





PokerStars Hand #148609272089:  Hold'em No Limit ($0.50/$1.00 USD) - 2016/02/11 13:21:29 CET [2016/02/11 7:21:29 ET]
Table 'Stephano V' 9-max Seat #9 is the button
Seat 1: hammerwife ($108.25 in chips) 
Seat 2: matiko09 ($130.95 in chips) 
Seat 3: sebaaastian ($100 in chips) 
Seat 4: Zeeshka ($123.32 in chips) 
Seat 5: n2call ($238.60 in chips) 
Seat 7: hurtNCYDE ($100 in chips) 
Seat 8: oscarleon ($242.09 in chips) 
Seat 9: IcocaynaI ($30.19 in chips) 
hammerwife: posts small blind $0.50
matiko09: posts big blind $1
*** HOLE CARDS ***
Dealt to matiko09 [8d Kc]
sebaaastian: folds 
sebaaastian leaves the table
Zeeshka: folds 
n2call: folds 
hurtNCYDE: folds 
oscarleon: folds 
IcocaynaI: raises $1 to $2
hammerwife: folds 
matiko09: calls $1
*** FLOP *** [7d Th Qc]
matiko09: checks 
IcocaynaI: bets $1
AlKatrone joins the table at seat #3 
matiko09: folds 
Uncalled bet ($1) returned to IcocaynaI
IcocaynaI collected $4.30 from pot
IcocaynaI: doesn't show hand 
*** SUMMARY ***
Total pot $4.50 | Rake $0.20 
Board [7d Th Qc]
Seat 1: hammerwife (small blind) folded before Flop
Seat 2: matiko09 (big blind) folded on the Flop
Seat 3: sebaaastian folded before Flop (didn't bet)
Seat 4: Zeeshka folded before Flop (didn't bet)
Seat 5: n2call folded before Flop (didn't bet)
Seat 7: hurtNCYDE folded before Flop (didn't bet)
Seat 8: oscarleon folded before Flop (didn't bet)
Seat 9: IcocaynaI (button) collected ($4.30)





PokerStars Hand #148609276867:  Hold'em No Limit ($0.50/$1.00 USD) - 2016/02/11 13:21:37 CET [2016/02/11 7:21:37 ET]
Table 'Kleopatra II' 9-max Seat #8 is the button
Seat 1: gwwsb ($60.99 in chips) 
Seat 2: azvazdam ($79.50 in chips) 
Seat 3: matiko09 ($100 in chips) 
Seat 6: hammerwife ($174.35 in chips) 
Seat 7: Zeeshka ($100 in chips) 
Seat 8: oscarleon ($108.64 in chips) 
Seat 9: vrnMike ($111.17 in chips) 
vrnMike: posts small blind $0.50
gwwsb: posts big blind $1
TimStone: sits out 
*** HOLE CARDS ***
Dealt to matiko09 [2h 7h]
azvazdam: folds 
matiko09: folds 
hammerwife: folds 
Zeeshka: raises $2 to $3
oscarleon: folds 
vrnMike: folds 
gwwsb: raises $5 to $8
Zeeshka: raises $10 to $18
gwwsb: calls $10
*** FLOP *** [6h 6d 5d]
gwwsb: bets $17.43
Zeeshka: folds 
Uncalled bet ($17.43) returned to gwwsb
gwwsb collected $34.86 from pot
gwwsb: doesn't show hand 
*** SUMMARY ***
Total pot $36.50 | Rake $1.64 
Board [6h 6d 5d]
Seat 1: gwwsb (big blind) collected ($34.86)
Seat 2: azvazdam folded before Flop (didn't bet)
Seat 3: matiko09 folded before Flop (didn't bet)
Seat 6: hammerwife folded before Flop (didn't bet)
Seat 7: Zeeshka folded on the Flop
Seat 8: oscarleon (button) folded before Flop (didn't bet)
Seat 9: vrnMike (small blind) folded before Flop





PokerStars Hand #148609278100:  Hold'em No Limit ($0.50/$1.00 USD) - 2016/02/11 13:21:39 CET [2016/02/11 7:21:39 ET]
Table 'Marion' 9-max Seat #4 is the button
Seat 1: aseban11 ($106.55 in chips) 
Seat 2: GusenokRUS ($109.24 in chips) 
Seat 3: TimStone ($104.46 in chips) 
Seat 4: matiko09 ($100 in chips) 
Seat 5: Rikti ($61.25 in chips) 
Seat 6: 19SERGE74 ($56.23 in chips) 
Seat 7: oscarleon ($112.58 in chips) 
Seat 9: Zeeshka ($101.50 in chips) 
Rikti: posts small blind $0.50
19SERGE74: posts big blind $1
*** HOLE CARDS ***
Dealt to matiko09 [2d Kc]
oscarleon: folds 
Zeeshka: folds 
aseban11: folds 
GusenokRUS: folds 
TimStone: raises $1.52 to $2.52
matiko09: folds 
Rikti: folds 
19SERGE74: calls $1.52
*** FLOP *** [7c Kd 9s]
19SERGE74: checks 
TimStone: bets $3.99
19SERGE74: raises $3.99 to $7.98
TimStone: calls $3.99
*** TURN *** [7c Kd 9s] [8d]
19SERGE74: checks 
TimStone: checks 
*** RIVER *** [7c Kd 9s 8d] [9h]
19SERGE74: bets $20.53
TimStone: folds 
Uncalled bet ($20.53) returned to 19SERGE74
19SERGE74 collected $20.53 from pot
19SERGE74: doesn't show hand 
*** SUMMARY ***
Total pot $21.50 | Rake $0.97 
Board [7c Kd 9s 8d 9h]
Seat 1: aseban11 folded before Flop (didn't bet)
Seat 2: GusenokRUS folded before Flop (didn't bet)
Seat 3: TimStone folded on the River
Seat 4: matiko09 (button) folded before Flop (didn't bet)
Seat 5: Rikti (small blind) folded before Flop
Seat 6: 19SERGE74 (big blind) collected ($20.53)
Seat 7: oscarleon folded before Flop (didn't bet)
Seat 9: Zeeshka folded before Flop (didn't bet)





PokerStars Hand #148609280773:  Hold'em No Limit ($0.25/$0.50 USD) - 2016/02/11 13:21:44 CET [2016/02/11 7:21:44 ET]
Table 'Stereoskopia' 9-max Seat #2 is the button
Seat 2: Dantist1122 ($50 in chips) 
Seat 3: fandorin2005 ($50 in chips) 
Seat 4: Anikin44 ($40 in chips) 
Seat 5: afrodit71 ($30.44 in chips) 
Seat 6: matiko09 ($50.70 in chips) 
Seat 7: tallonn88 ($55.05 in chips) 
Seat 9: Luoyi-yiwa ($49.35 in chips) 
fandorin2005: posts small blind $0.25
Anikin44: posts big blind $0.50
*** HOLE CARDS ***
Dealt to matiko09 [8s 3s]
afrodit71: calls $0.50
matiko09: folds 
tallonn88: raises $1 to $1.50
Luoyi-yiwa: folds 
Dantist1122: folds 
fandorin2005: folds 
Anikin44: folds 
Reven9er joins the table at seat #8 
afrodit71: calls $1
*** FLOP *** [Kh Jh 9d]
afrodit71: bets $2
tallonn88: folds 
Uncalled bet ($2) returned to afrodit71
afrodit71 collected $3.58 from pot
afrodit71: doesn't show hand 
*** SUMMARY ***
Total pot $3.75 | Rake $0.17 
Board [Kh Jh 9d]
Seat 2: Dantist1122 (button) folded before Flop (didn't bet)
Seat 3: fandorin2005 (small blind) folded before Flop
Seat 4: Anikin44 (big blind) folded before Flop
Seat 5: afrodit71 collected ($3.58)
Seat 6: matiko09 folded before Flop (didn't bet)
Seat 7: tallonn88 folded on the Flop
Seat 9: Luoyi-yiwa folded before Flop (didn't bet)





PokerStars Hand #148609282718:  Hold'em No Limit ($0.50/$1.00 USD) - 2016/02/11 13:21:47 CET [2016/02/11 7:21:47 ET]
Table 'Gianfar' 9-max Seat #8 is the button
Seat 1: Vikulja1993 ($100 in chips) 
Seat 2: bilukm ($111.54 in chips) 
Seat 3: AlKatrone ($112.19 in chips) 
Seat 4: matiko09 ($131.32 in chips) 
Seat 5: hammerwife ($152.79 in chips) 
Seat 7: Rikti ($36.50 in chips) 
Seat 8: Zeeshka ($109.14 in chips) 
Seat 9: oscarleon ($141.16 in chips) 
oscarleon: posts small blind $0.50
Vikulja1993: posts big blind $1
*** HOLE CARDS ***
Dealt to matiko09 [6d 4c]
bilukm: calls $1
AlKatrone: folds 
matiko09: folds 
hammerwife: folds 
Rikti: raises $2.50 to $3.50
Zeeshka: folds 
oscarleon: folds 
Vikulja1993: folds 
bilukm: folds 
Uncalled bet ($2.50) returned to Rikti
Rikti collected $3.50 from pot
Rikti: doesn't show hand 
*** SUMMARY ***
Total pot $3.50 | Rake $0 
Seat 1: Vikulja1993 (big blind) folded before Flop
Seat 2: bilukm folded before Flop
Seat 3: AlKatrone folded before Flop (didn't bet)
Seat 4: matiko09 folded before Flop (didn't bet)
Seat 5: hammerwife folded before Flop (didn't bet)
Seat 7: Rikti collected ($3.50)
Seat 8: Zeeshka (button) folded before Flop (didn't bet)
Seat 9: oscarleon (small blind) folded before Flop





PokerStars Hand #148609285265:  Hold'em No Limit ($0.50/$1.00 USD) - 2016/02/11 13:21:52 CET [2016/02/11 7:21:52 ET]
Table 'Clorinde' 9-max Seat #6 is the button
Seat 1: matiko09 ($100 in chips) 
Seat 2: 19SERGE74 ($99.15 in chips) 
Seat 3: gabi_igna ($100.75 in chips) 
Seat 5: Mukhin1 ($100 in chips) 
Seat 6: Gcroc52 ($18.96 in chips) 
Seat 7: Zeeshka ($103.81 in chips) 
Seat 8: aseban11 ($120.72 in chips) 
Zeeshka: posts small blind $0.50
aseban11: posts big blind $1
hammerwife: sits out 
*** HOLE CARDS ***
Dealt to matiko09 [Jd 7d]
matiko09: folds 
19SERGE74: folds 
gabi_igna: folds 
Mukhin1: folds 
Gcroc52: folds 
Zeeshka: folds 
Uncalled bet ($0.50) returned to aseban11
aseban11 collected $1 from pot
aseban11: doesn't show hand 
*** SUMMARY ***
Total pot $1 | Rake $0 
Seat 1: matiko09 folded before Flop (didn't bet)
Seat 2: 19SERGE74 folded before Flop (didn't bet)
Seat 3: gabi_igna folded before Flop (didn't bet)
Seat 5: Mukhin1 folded before Flop (didn't bet)
Seat 6: Gcroc52 (button) folded before Flop (didn't bet)
Seat 7: Zeeshka (small blind) folded before Flop
Seat 8: aseban11 (big blind) collected ($1)





PokerStars Hand #148609288466:  Hold'em No Limit (€0.25/€0.50 EUR) - 2016/02/11 13:21:57 CET [2016/02/11 7:21:57 ET]
Table 'Otero II' 9-max Seat #4 is the button
Seat 1: Effort92 (€50.75 in chips) 
Seat 2: Dantist1122 (€53.27 in chips) 
Seat 3: Szevasztopol (€50 in chips) 
Seat 4: kram0909 (€15.30 in chips) 
Seat 5: vlad11122007 (€48.19 in chips) 
Seat 7: make6a (€50 in chips) 
Seat 8: matiko09 (€68.26 in chips) 
vlad11122007: posts small blind €0.25
make6a: posts big blind €0.50
*** HOLE CARDS ***
Dealt to matiko09 [Jc 6c]
matiko09: folds 
Effort92: folds 
Dantist1122: folds 
Szevasztopol: folds 
kram0909: folds 
vlad11122007: folds 
Uncalled bet (€0.25) returned to make6a
make6a collected €0.50 from pot
make6a: doesn't show hand 
*** SUMMARY ***
Total pot €0.50 | Rake €0 
Seat 1: Effort92 folded before Flop (didn't bet)
Seat 2: Dantist1122 folded before Flop (didn't bet)
Seat 3: Szevasztopol folded before Flop (didn't bet)
Seat 4: kram0909 (button) folded before Flop (didn't bet)
Seat 5: vlad11122007 (small blind) folded before Flop
Seat 7: make6a (big blind) collected (€0.50)
Seat 8: matiko09 folded before Flop (didn't bet)





PokerStars Hand #148609294665:  Hold'em No Limit ($0.50/$1.00 USD) - 2016/02/11 13:22:07 CET [2016/02/11 7:22:07 ET]
Table 'Clorinde' 9-max Seat #7 is the button
Seat 1: matiko09 ($100 in chips) 
Seat 2: 19SERGE74 ($99.15 in chips) 
Seat 3: gabi_igna ($100.75 in chips) 
Seat 5: Mukhin1 ($100 in chips) 
Seat 6: Gcroc52 ($18.96 in chips) 
Seat 7: Zeeshka ($103.31 in chips) 
Seat 8: aseban11 ($121.22 in chips) 
Seat 9: hammerwife ($100 in chips) 
aseban11: posts small blind $0.50
hammerwife: posts big blind $1
*** HOLE CARDS ***
Dealt to matiko09 [Kc 9d]
matiko09: folds 
19SERGE74: folds 
gabi_igna: folds 
Mukhin1: folds 
Gcroc52: folds 
Zeeshka: raises $1.50 to $2.50
aseban11: folds 
hammerwife: folds 
Uncalled bet ($1.50) returned to Zeeshka
Zeeshka collected $2.50 from pot
Zeeshka: doesn't show hand 
*** SUMMARY ***
Total pot $2.50 | Rake $0 
Seat 1: matiko09 folded before Flop (didn't bet)
Seat 2: 19SERGE74 folded before Flop (didn't bet)
Seat 3: gabi_igna folded before Flop (didn't bet)
Seat 5: Mukhin1 folded before Flop (didn't bet)
Seat 6: Gcroc52 folded before Flop (didn't bet)
Seat 7: Zeeshka (button) collected ($2.50)
Seat 8: aseban11 (small blind) folded before Flop
Seat 9: hammerwife (big blind) folded before Flop





PokerStars Hand #148609296630:  Hold'em No Limit ($0.25/$0.50 USD) - 2016/02/11 13:22:10 CET [2016/02/11 7:22:10 ET]
Table 'Ambrosia II' 9-max Seat #4 is the button
Seat 1: matiko09 ($51.79 in chips) 
Seat 2: JJJ-K9 ($61.96 in chips) 
Seat 3: make6a ($77.18 in chips) 
Seat 4: huudk2016 ($38.07 in chips) 
Seat 5: RICKA16 ($49 in chips) 
Seat 6: Reven9er ($62.26 in chips) 
Seat 7: Ana.Satravca ($63.21 in chips) 
Seat 8: tallonn88 ($56.26 in chips) 
Seat 9: arctur17 ($36.42 in chips) 
RICKA16: posts small blind $0.25
Reven9er: posts big blind $0.50
*** HOLE CARDS ***
Dealt to matiko09 [Ks 3d]
Ana.Satravca: folds 
tallonn88: folds 
arctur17: raises $0.50 to $1
matiko09: folds 
JJJ-K9: folds 
make6a: folds 
huudk2016: raises $1 to $2
RICKA16: folds 
Reven9er: folds 
arctur17: calls $1
*** FLOP *** [9c Qc 2h]
arctur17: checks 
huudk2016: bets $2.50
arctur17: folds 
Uncalled bet ($2.50) returned to huudk2016
huudk2016 collected $4.54 from pot
huudk2016: doesn't show hand 
*** SUMMARY ***
Total pot $4.75 | Rake $0.21 
Board [9c Qc 2h]
Seat 1: matiko09 folded before Flop (didn't bet)
Seat 2: JJJ-K9 folded before Flop (didn't bet)
Seat 3: make6a folded before Flop (didn't bet)
Seat 4: huudk2016 (button) collected ($4.54)
Seat 5: RICKA16 (small blind) folded before Flop
Seat 6: Reven9er (big blind) folded before Flop
Seat 7: Ana.Satravca folded before Flop (didn't bet)
Seat 8: tallonn88 folded before Flop (didn't bet)
Seat 9: arctur17 folded on the Flop





PokerStars Hand #148609297761:  Hold'em No Limit ($0.50/$1.00 USD) - 2016/02/11 13:22:12 CET [2016/02/11 7:22:12 ET]
Table 'Stephano V' 9-max Seat #1 is the button
Seat 1: hammerwife ($107.75 in chips) 
Seat 2: matiko09 ($128.95 in chips) 
Seat 3: AlKatrone ($100 in chips) 
Seat 4: Zeeshka ($123.32 in chips) 
Seat 5: n2call ($238.60 in chips) 
Seat 7: hurtNCYDE ($100 in chips) 
Seat 8: oscarleon ($242.09 in chips) 
Seat 9: IcocaynaI ($32.49 in chips) 
matiko09: posts small blind $0.50
AlKatrone: posts big blind $1
*** HOLE CARDS ***
Dealt to matiko09 [As Ah]
Zeeshka: folds 
n2call: folds 
hurtNCYDE: folds 
oscarleon: raises $2 to $3
IcocaynaI: folds 
hammerwife: folds 
matiko09: raises $7.50 to $10.50
AlKatrone: folds 
oscarleon: calls $7.50
*** FLOP *** [9h 8s 3c]
matiko09: bets $12
oscarleon: calls $12
*** TURN *** [9h 8s 3c] [9c]
matiko09: bets $26
oscarleon: folds 
Uncalled bet ($26) returned to matiko09
matiko09 collected $43.93 from pot
matiko09: doesn't show hand 
*** SUMMARY ***
Total pot $46 | Rake $2.07 
Board [9h 8s 3c 9c]
Seat 1: hammerwife (button) folded before Flop (didn't bet)
Seat 2: matiko09 (small blind) collected ($43.93)
Seat 3: AlKatrone (big blind) folded before Flop
Seat 4: Zeeshka folded before Flop (didn't bet)
Seat 5: n2call folded before Flop (didn't bet)
Seat 7: hurtNCYDE folded before Flop (didn't bet)
Seat 8: oscarleon folded on the Turn
Seat 9: IcocaynaI folded before Flop (didn't bet)





PokerStars Hand #148609301100:  Hold'em No Limit (€0.25/€0.50 EUR) - 2016/02/11 13:22:18 CET [2016/02/11 7:22:18 ET]
Table 'Otero II' 9-max Seat #5 is the button
Seat 1: Effort92 (€50.75 in chips) 
Seat 2: Dantist1122 (€53.27 in chips) 
Seat 3: Szevasztopol (€50 in chips) 
Seat 4: kram0909 (€15.30 in chips) 
Seat 5: vlad11122007 (€47.94 in chips) 
Seat 7: make6a (€50.25 in chips) 
Seat 8: matiko09 (€68.26 in chips) 
TonnaMunz will be allowed to play after the button
make6a: posts small blind €0.25
matiko09: posts big blind €0.50
*** HOLE CARDS ***
Dealt to matiko09 [Qd 7c]
Effort92: folds 
Dantist1122: raises €1 to €1.50
Szevasztopol: folds 
kram0909: folds 
vlad11122007: folds 
make6a: folds 
matiko09: folds 
Uncalled bet (€1) returned to Dantist1122
Dantist1122 collected €1.25 from pot
Dantist1122: doesn't show hand 
*** SUMMARY ***
Total pot €1.25 | Rake €0 
Seat 1: Effort92 folded before Flop (didn't bet)
Seat 2: Dantist1122 collected (€1.25)
Seat 3: Szevasztopol folded before Flop (didn't bet)
Seat 4: kram0909 folded before Flop (didn't bet)
Seat 5: vlad11122007 (button) folded before Flop (didn't bet)
Seat 7: make6a (small blind) folded before Flop
Seat 8: matiko09 (big blind) folded before Flop





PokerStars Hand #148609302407:  Hold'em No Limit ($0.25/$0.50 USD) - 2016/02/11 13:22:20 CET [2016/02/11 7:22:20 ET]
Table 'Sylvania II' 9-max Seat #4 is the button
Seat 1: tw0315 ($183.24 in chips) 
Seat 2: Effort92 ($50 in chips) 
Seat 4: matiko09 ($120.29 in chips) 
Seat 5: vlad11122007 ($59.76 in chips) 
Seat 6: TonnaMunz ($130.71 in chips) 
Seat 7: 2lefthand75 ($77.87 in chips) 
vlad11122007: posts small blind $0.25
TonnaMunz: posts big blind $0.50
Apparat888: sits out 
tw0315: posts the ante $0.10
Effort92: posts the ante $0.10
matiko09: posts the ante $0.10
vlad11122007: posts the ante $0.10
TonnaMunz: posts the ante $0.10
2lefthand75: posts the ante $0.10
*** HOLE CARDS ***
Dealt to matiko09 [Td 7d]
2lefthand75: folds 
tw0315: calls $0.50
Effort92: folds 
matiko09: raises $1.50 to $2
vlad11122007: calls $1.75
TonnaMunz: folds 
tw0315: calls $1.50
*** FLOP *** [4h 8d Ac]
vlad11122007: checks 
tw0315: checks 
matiko09: bets $4
vlad11122007: folds 
tw0315: folds 
Uncalled bet ($4) returned to matiko09
matiko09 collected $6.78 from pot
matiko09: doesn't show hand 
*** SUMMARY ***
Total pot $7.10 | Rake $0.32 
Board [4h 8d Ac]
Seat 1: tw0315 folded on the Flop
Seat 2: Effort92 folded before Flop (didn't bet)
Seat 4: matiko09 (button) collected ($6.78)
Seat 5: vlad11122007 (small blind) folded on the Flop
Seat 6: TonnaMunz (big blind) folded before Flop
Seat 7: 2lefthand75 folded before Flop (didn't bet)





PokerStars Hand #148609308981:  Hold'em No Limit ($0.50/$1.00 USD) - 2016/02/11 13:22:32 CET [2016/02/11 7:22:32 ET]
Table 'Clorinde' 9-max Seat #8 is the button
Seat 1: matiko09 ($100 in chips) 
Seat 2: 19SERGE74 ($99.15 in chips) 
Seat 3: gabi_igna ($100.75 in chips) 
Seat 5: Mukhin1 ($100 in chips) 
Seat 6: Gcroc52 ($18.96 in chips) 
Seat 7: Zeeshka ($104.81 in chips) 
Seat 8: aseban11 ($120.72 in chips) 
Seat 9: hammerwife ($100 in chips) 
hammerwife: posts small blind $0.50
matiko09: posts big blind $1
*** HOLE CARDS ***
Dealt to matiko09 [2h 9d]
19SERGE74: folds 
gabi_igna: folds 
Mukhin1: raises $2.02 to $3.02
Gcroc52: calls $3.02
Zeeshka: folds 
aseban11: folds 
hammerwife: folds 
matiko09: folds 
*** FLOP *** [Ad 8c Kd]
Mukhin1: checks 
Gcroc52: bets $3.60
Mukhin1: folds 
Uncalled bet ($3.60) returned to Gcroc52
Gcroc52 collected $7.20 from pot
*** SUMMARY ***
Total pot $7.54 | Rake $0.34 
Board [Ad 8c Kd]
Seat 1: matiko09 (big blind) folded before Flop
Seat 2: 19SERGE74 folded before Flop (didn't bet)
Seat 3: gabi_igna folded before Flop (didn't bet)
Seat 5: Mukhin1 folded on the Flop
Seat 6: Gcroc52 collected ($7.20)
Seat 7: Zeeshka folded before Flop (didn't bet)
Seat 8: aseban11 (button) folded before Flop (didn't bet)
Seat 9: hammerwife (small blind) folded before Flop





PokerStars Hand #148609313236:  Hold'em No Limit ($0.25/$0.50 USD) - 2016/02/11 13:22:39 CET [2016/02/11 7:22:39 ET]
Table 'Stereoskopia' 9-max Seat #3 is the button
Seat 2: Dantist1122 ($50 in chips) 
Seat 3: fandorin2005 ($50 in chips) 
Seat 4: Anikin44 ($39.50 in chips) 
Seat 5: afrodit71 ($32.52 in chips) 
Seat 6: matiko09 ($50.70 in chips) 
Seat 7: tallonn88 ($53.55 in chips) 
Seat 9: Luoyi-yiwa ($49.35 in chips) 
Anikin44: posts small blind $0.25
afrodit71: posts big blind $0.50
Reven9er: sits out 
*** HOLE CARDS ***
Dealt to matiko09 [2h 5h]
matiko09: folds 
tallonn88: folds 
Luoyi-yiwa: folds 
Dantist1122: raises $0.85 to $1.35
fandorin2005: folds 
Anikin44: calls $1.10
afrodit71: calls $0.85
*** FLOP *** [5c 7h 3h]
Anikin44: checks 
afrodit71: checks 
Dantist1122: bets $3
Anikin44: folds 
afrodit71: calls $3
*** TURN *** [5c 7h 3h] [Qd]
afrodit71: checks 
Dantist1122: bets $7.75
afrodit71: folds 
Uncalled bet ($7.75) returned to Dantist1122
Dantist1122 collected $9.60 from pot
Dantist1122: doesn't show hand 
*** SUMMARY ***
Total pot $10.05 | Rake $0.45 
Board [5c 7h 3h Qd]
Seat 2: Dantist1122 collected ($9.60)
Seat 3: fandorin2005 (button) folded before Flop (didn't bet)
Seat 4: Anikin44 (small blind) folded on the Flop
Seat 5: afrodit71 (big blind) folded on the Turn
Seat 6: matiko09 folded before Flop (didn't bet)
Seat 7: tallonn88 folded before Flop (didn't bet)
Seat 9: Luoyi-yiwa folded before Flop (didn't bet)





PokerStars Hand #148609314387:  Hold'em No Limit ($0.50/$1.00 USD) - 2016/02/11 13:22:41 CET [2016/02/11 7:22:41 ET]
Table 'Marion' 9-max Seat #5 is the button
Seat 1: aseban11 ($106.55 in chips) 
Seat 2: GusenokRUS ($109.24 in chips) 
Seat 3: TimStone ($100 in chips) 
Seat 4: matiko09 ($100 in chips) 
Seat 5: Rikti ($60.75 in chips) 
Seat 6: 19SERGE74 ($66.26 in chips) 
Seat 7: oscarleon ($112.58 in chips) 
Seat 9: Zeeshka ($101.50 in chips) 
19SERGE74: posts small blind $0.50
oscarleon: posts big blind $1
*** HOLE CARDS ***
Dealt to matiko09 [9s 3c]
Zeeshka: folds 
aseban11: folds 
GusenokRUS: raises $2 to $3
TimStone: folds 
matiko09: folds 
Rikti: folds 
19SERGE74: folds 
oscarleon: calls $2
*** FLOP *** [7d 2h 4h]
oscarleon: checks 
GusenokRUS: bets $3
oscarleon: folds 
Uncalled bet ($3) returned to GusenokRUS
GusenokRUS collected $6.21 from pot
GusenokRUS: doesn't show hand 
*** SUMMARY ***
Total pot $6.50 | Rake $0.29 
Board [7d 2h 4h]
Seat 1: aseban11 folded before Flop (didn't bet)
Seat 2: GusenokRUS collected ($6.21)
Seat 3: TimStone folded before Flop (didn't bet)
Seat 4: matiko09 folded before Flop (didn't bet)
Seat 5: Rikti (button) folded before Flop (didn't bet)
Seat 6: 19SERGE74 (small blind) folded before Flop
Seat 7: oscarleon (big blind) folded on the Flop
Seat 9: Zeeshka folded before Flop (didn't bet)





PokerStars Hand #148609314273:  Hold'em No Limit ($0.50/$1.00 USD) - 2016/02/11 13:22:41 CET [2016/02/11 7:22:41 ET]
Table 'Gianfar' 9-max Seat #9 is the button
Seat 1: Vikulja1993 ($100 in chips) 
Seat 2: bilukm ($110.54 in chips) 
Seat 3: AlKatrone ($112.19 in chips) 
Seat 4: matiko09 ($131.32 in chips) 
Seat 5: hammerwife ($152.79 in chips) 
Seat 7: Rikti ($39 in chips) 
Seat 8: Zeeshka ($109.14 in chips) 
Seat 9: oscarleon ($140.66 in chips) 
Vikulja1993: posts small blind $0.50
bilukm: posts big blind $1
*** HOLE CARDS ***
Dealt to matiko09 [2c Kd]
AlKatrone: raises $2 to $3
matiko09: folds 
hammerwife: folds 
Rikti: folds 
Zeeshka: raises $6 to $9
oscarleon: folds 
Vikulja1993: folds 
bilukm: folds 
AlKatrone: calls $6
*** FLOP *** [7s Th 9d]
AlKatrone: bets $6.33
Zeeshka: raises $13.67 to $20
AlKatrone: calls $13.67
*** TURN *** [7s Th 9d] [2d]
AlKatrone: checks 
Zeeshka: bets $24
AlKatrone: calls $24
*** RIVER *** [7s Th 9d 2d] [8c]
AlKatrone: bets $59.19 and is all-in
Zeeshka said, "(y)"
Zeeshka: folds 
Uncalled bet ($59.19) returned to AlKatrone
AlKatrone collected $104.70 from pot
AlKatrone: doesn't show hand 
*** SUMMARY ***
Total pot $107.50 | Rake $2.80 
Board [7s Th 9d 2d 8c]
Seat 1: Vikulja1993 (small blind) folded before Flop
Seat 2: bilukm (big blind) folded before Flop
Seat 3: AlKatrone collected ($104.70)
Seat 4: matiko09 folded before Flop (didn't bet)
Seat 5: hammerwife folded before Flop (didn't bet)
Seat 7: Rikti folded before Flop (didn't bet)
Seat 8: Zeeshka folded on the River
Seat 9: oscarleon (button) folded before Flop (didn't bet)





PokerStars Hand #148609319493:  Hold'em No Limit ($0.50/$1.00 USD) - 2016/02/11 13:22:49 CET [2016/02/11 7:22:49 ET]
Table 'Kleopatra II' 9-max Seat #9 is the button
Seat 1: gwwsb ($77.85 in chips) 
Seat 2: azvazdam ($79.50 in chips) 
Seat 3: matiko09 ($100 in chips) 
Seat 6: hammerwife ($174.35 in chips) 
Seat 7: Zeeshka ($100 in chips) 
Seat 8: oscarleon ($108.64 in chips) 
Seat 9: vrnMike ($110.67 in chips) 
gwwsb: posts small blind $0.50
azvazdam: posts big blind $1
TimStone: sits out 
*** HOLE CARDS ***
Dealt to matiko09 [9h Jc]
matiko09: folds 
hammerwife: folds 
Zeeshka: folds 
oscarleon: folds 
vrnMike: raises $2 to $3
gwwsb: calls $2.50
azvazdam: folds 
*** FLOP *** [8d Qh Ac]
gwwsb: checks 
vrnMike: checks 
*** TURN *** [8d Qh Ac] [2h]
gwwsb: checks 
vrnMike: checks 
*** RIVER *** [8d Qh Ac 2h] [6c]
gwwsb: bets $5
vrnMike: folds 
Uncalled bet ($5) returned to gwwsb
gwwsb collected $6.68 from pot
gwwsb: doesn't show hand 
*** SUMMARY ***
Total pot $7 | Rake $0.32 
Board [8d Qh Ac 2h 6c]
Seat 1: gwwsb (small blind) collected ($6.68)
Seat 2: azvazdam (big blind) folded before Flop
Seat 3: matiko09 folded before Flop (didn't bet)
Seat 6: hammerwife folded before Flop (didn't bet)
Seat 7: Zeeshka folded before Flop (didn't bet)
Seat 8: oscarleon folded before Flop (didn't bet)
Seat 9: vrnMike (button) folded on the River





PokerStars Hand #148609331609:  Hold'em No Limit (€0.25/€0.50 EUR) - 2016/02/11 13:23:10 CET [2016/02/11 7:23:10 ET]
Table 'Otero II' 9-max Seat #7 is the button
Seat 1: Effort92 (€50.75 in chips) 
Seat 2: Dantist1122 (€54.02 in chips) 
Seat 3: Szevasztopol (€50 in chips) 
Seat 4: kram0909 (€15.30 in chips) 
Seat 5: vlad11122007 (€47.94 in chips) 
Seat 7: make6a (€50 in chips) 
Seat 8: matiko09 (€67.76 in chips) 
matiko09: posts small blind €0.25
Effort92: posts big blind €0.50
TonnaMunz: sits out 
*** HOLE CARDS ***
Dealt to matiko09 [Td 6d]
Dantist1122: folds 
Szevasztopol: folds 
kram0909: raises €0.50 to €1
vlad11122007: folds 
make6a: folds 
matiko09: folds 
Effort92: raises €15 to €16
kram0909: folds 
Uncalled bet (€15) returned to Effort92
Effort92 collected €2.25 from pot
Effort92: doesn't show hand 
*** SUMMARY ***
Total pot €2.25 | Rake €0 
Seat 1: Effort92 (big blind) collected (€2.25)
Seat 2: Dantist1122 folded before Flop (didn't bet)
Seat 3: Szevasztopol folded before Flop (didn't bet)
Seat 4: kram0909 folded before Flop
Seat 5: vlad11122007 folded before Flop (didn't bet)
Seat 7: make6a (button) folded before Flop (didn't bet)
Seat 8: matiko09 (small blind) folded before Flop





PokerStars Hand #148609331553:  Hold'em No Limit ($0.25/$0.50 USD) - 2016/02/11 13:23:10 CET [2016/02/11 7:23:10 ET]
Table 'Ambrosia II' 9-max Seat #5 is the button
Seat 1: matiko09 ($51.79 in chips) 
Seat 2: JJJ-K9 ($61.96 in chips) 
Seat 3: make6a ($77.18 in chips) 
Seat 4: huudk2016 ($40.61 in chips) 
Seat 5: RICKA16 ($48.75 in chips) 
Seat 6: Reven9er ($61.76 in chips) 
Seat 7: Ana.Satravca ($63.21 in chips) 
Seat 8: tallonn88 ($56.26 in chips) 
Seat 9: arctur17 ($50 in chips) 
Reven9er: posts small blind $0.25
Ana.Satravca: posts big blind $0.50
*** HOLE CARDS ***
Dealt to matiko09 [8c Ks]
tallonn88: folds 
arctur17: folds 
matiko09: folds 
tallonn88 leaves the table
Dantist1122 joins the table at seat #8 
JJJ-K9: folds 
make6a: folds 
huudk2016: calls $0.50
RICKA16: folds 
Reven9er: folds 
Ana.Satravca: checks 
*** FLOP *** [2s 4s 8s]
Ana.Satravca: bets $0.79
huudk2016: calls $0.79
*** TURN *** [2s 4s 8s] [6d]
Ana.Satravca: bets $1.79
huudk2016: calls $1.79
*** RIVER *** [2s 4s 8s 6d] [Kc]
Ana.Satravca: bets $3
huudk2016: folds 
Uncalled bet ($3) returned to Ana.Satravca
Ana.Satravca collected $6.12 from pot
Ana.Satravca: doesn't show hand 
*** SUMMARY ***
Total pot $6.41 | Rake $0.29 
Board [2s 4s 8s 6d Kc]
Seat 1: matiko09 folded before Flop (didn't bet)
Seat 2: JJJ-K9 folded before Flop (didn't bet)
Seat 3: make6a folded before Flop (didn't bet)
Seat 4: huudk2016 folded on the River
Seat 5: RICKA16 (button) folded before Flop (didn't bet)
Seat 6: Reven9er (small blind) folded before Flop
Seat 7: Ana.Satravca (big blind) collected ($6.12)
Seat 8: tallonn88 folded before Flop (didn't bet)
Seat 9: arctur17 folded before Flop (didn't bet)





PokerStars Hand #148609339082:  Hold'em No Limit ($0.25/$0.50 USD) - 2016/02/11 13:23:23 CET [2016/02/11 7:23:23 ET]
Table 'Sylvania II' 9-max Seat #5 is the button
Seat 1: tw0315 ($181.14 in chips) 
Seat 2: Effort92 ($50 in chips) 
Seat 3: ruyingren ($200.41 in chips) 
Seat 4: matiko09 ($124.97 in chips) 
Seat 5: vlad11122007 ($57.66 in chips) 
Seat 6: TonnaMunz ($130.11 in chips) 
Seat 7: 2lefthand75 ($77.77 in chips) 
TonnaMunz: posts small blind $0.25
2lefthand75: posts big blind $0.50
Apparat888: sits out 
ruyingren: posts small & big blinds $0.75
tw0315: posts the ante $0.10
Effort92: posts the ante $0.10
ruyingren: posts the ante $0.10
matiko09: posts the ante $0.10
vlad11122007: posts the ante $0.10
TonnaMunz: posts the ante $0.10
2lefthand75: posts the ante $0.10
*** HOLE CARDS ***
Dealt to matiko09 [Kh 3s]
tw0315: calls $0.50
Effort92: folds 
ruyingren: checks 
matiko09: folds 
vlad11122007: folds 
TonnaMunz: calls $0.25
2lefthand75: raises $1 to $1.50
tw0315: calls $1
ruyingren: calls $1
TonnaMunz: calls $1
*** FLOP *** [Qc Jh 9h]
TonnaMunz: checks 
2lefthand75: checks 
tw0315: checks 
ruyingren: bets $6.50
TonnaMunz: folds 
2lefthand75: calls $6.50
tw0315: folds 
*** TURN *** [Qc Jh 9h] [4d]
2lefthand75: checks 
ruyingren: bets $24
2lefthand75: folds 
Uncalled bet ($24) returned to ruyingren
ruyingren collected $19.05 from pot
ruyingren: doesn't show hand 
*** SUMMARY ***
Total pot $19.95 | Rake $0.90 
Board [Qc Jh 9h 4d]
Seat 1: tw0315 folded on the Flop
Seat 2: Effort92 folded before Flop (didn't bet)
Seat 3: ruyingren collected ($19.05)
Seat 4: matiko09 folded before Flop (didn't bet)
Seat 5: vlad11122007 (button) folded before Flop (didn't bet)
Seat 6: TonnaMunz (small blind) folded on the Flop
Seat 7: 2lefthand75 (big blind) folded on the Turn





PokerStars Hand #148609344521:  Hold'em No Limit ($0.50/$1.00 USD) - 2016/02/11 13:23:32 CET [2016/02/11 7:23:32 ET]
Table 'Clorinde' 9-max Seat #9 is the button
Seat 1: matiko09 ($100 in chips) 
Seat 2: 19SERGE74 ($99.15 in chips) 
Seat 3: gabi_igna ($100.75 in chips) 
Seat 5: Mukhin1 ($100 in chips) 
Seat 6: Gcroc52 ($23.14 in chips) 
Seat 7: Zeeshka ($104.81 in chips) 
Seat 8: aseban11 ($120.72 in chips) 
Seat 9: hammerwife ($100 in chips) 
matiko09: posts small blind $0.50
19SERGE74: posts big blind $1
Sweden_Pound: sits out 
*** HOLE CARDS ***
Dealt to matiko09 [Ah Qd]
gabi_igna: raises $2 to $3
Mukhin1: folds 
Gcroc52: folds 
Zeeshka: folds 
aseban11: folds 
hammerwife: folds 
matiko09: raises $7 to $10
19SERGE74: folds 
gabi_igna: raises $11 to $21
matiko09: folds 
Uncalled bet ($11) returned to gabi_igna
gabi_igna collected $21 from pot
gabi_igna: doesn't show hand 
*** SUMMARY ***
Total pot $21 | Rake $0 
Seat 1: matiko09 (small blind) folded before Flop
Seat 2: 19SERGE74 (big blind) folded before Flop
Seat 3: gabi_igna collected ($21)
Seat 5: Mukhin1 folded before Flop (didn't bet)
Seat 6: Gcroc52 folded before Flop (didn't bet)
Seat 7: Zeeshka folded before Flop (didn't bet)
Seat 8: aseban11 folded before Flop (didn't bet)
Seat 9: hammerwife (button) folded before Flop (didn't bet)





PokerStars Hand #148609345164:  Hold'em No Limit ($0.50/$1.00 USD) - 2016/02/11 13:23:33 CET [2016/02/11 7:23:33 ET]
Table 'Stephano V' 9-max Seat #2 is the button
Seat 1: hammerwife ($107.75 in chips) 
Seat 2: matiko09 ($150.38 in chips) 
Seat 3: AlKatrone ($100 in chips) 
Seat 4: Zeeshka ($123.32 in chips) 
Seat 5: n2call ($238.60 in chips) 
Seat 7: hurtNCYDE ($100 in chips) 
Seat 8: oscarleon ($219.59 in chips) 
Seat 9: IcocaynaI ($32.49 in chips) 
AlKatrone: posts small blind $0.50
Zeeshka: posts big blind $1
Sweden_Pound: sits out 
*** HOLE CARDS ***
Dealt to matiko09 [5c Qc]
n2call: folds 
hurtNCYDE: folds 
oscarleon: raises $2 to $3
IcocaynaI: calls $3
hammerwife: folds 
matiko09: folds 
AlKatrone: folds 
Zeeshka: folds 
*** FLOP *** [7c Ah Jh]
oscarleon: bets $5
IcocaynaI: folds 
Uncalled bet ($5) returned to oscarleon
oscarleon collected $7.16 from pot
oscarleon: doesn't show hand 
*** SUMMARY ***
Total pot $7.50 | Rake $0.34 
Board [7c Ah Jh]
Seat 1: hammerwife folded before Flop (didn't bet)
Seat 2: matiko09 (button) folded before Flop (didn't bet)
Seat 3: AlKatrone (small blind) folded before Flop
Seat 4: Zeeshka (big blind) folded before Flop
Seat 5: n2call folded before Flop (didn't bet)
Seat 7: hurtNCYDE folded before Flop (didn't bet)
Seat 8: oscarleon collected ($7.16)
Seat 9: IcocaynaI folded on the Flop





PokerStars Hand #148609348539:  Hold'em No Limit ($0.50/$1.00 USD) - 2016/02/11 13:23:39 CET [2016/02/11 7:23:39 ET]
Table 'Marion' 9-max Seat #6 is the button
Seat 1: aseban11 ($106.55 in chips) 
Seat 2: GusenokRUS ($112.45 in chips) 
Seat 3: TimStone ($100 in chips) 
Seat 4: matiko09 ($100 in chips) 
Seat 5: Rikti ($60.75 in chips) 
Seat 6: 19SERGE74 ($65.76 in chips) 
Seat 7: oscarleon ($109.58 in chips) 
Seat 8: Sweden_Pound ($100 in chips) 
Seat 9: Zeeshka ($101.50 in chips) 
oscarleon: posts small blind $0.50
Sweden_Pound: posts big blind $1
*** HOLE CARDS ***
Dealt to matiko09 [7d Qc]
Zeeshka: folds 
aseban11: raises $2 to $3
GusenokRUS: folds 
TimStone: folds 
matiko09: folds 
Rikti: folds 
19SERGE74: calls $3
oscarleon: folds 
Sweden_Pound: folds 
*** FLOP *** [4c Ks 6h]
aseban11: checks 
19SERGE74: checks 
*** TURN *** [4c Ks 6h] [Ad]
aseban11: bets $5.37
19SERGE74: calls $5.37
*** RIVER *** [4c Ks 6h Ad] [2h]
aseban11: checks 
19SERGE74: bets $9
aseban11: folds 
Uncalled bet ($9) returned to 19SERGE74
19SERGE74 collected $17.42 from pot
19SERGE74: doesn't show hand 
*** SUMMARY ***
Total pot $18.24 | Rake $0.82 
Board [4c Ks 6h Ad 2h]
Seat 1: aseban11 folded on the River
Seat 2: GusenokRUS folded before Flop (didn't bet)
Seat 3: TimStone folded before Flop (didn't bet)
Seat 4: matiko09 folded before Flop (didn't bet)
Seat 5: Rikti folded before Flop (didn't bet)
Seat 6: 19SERGE74 (button) collected ($17.42)
Seat 7: oscarleon (small blind) folded before Flop
Seat 8: Sweden_Pound (big blind) folded before Flop
Seat 9: Zeeshka folded before Flop (didn't bet)





PokerStars Hand #148609348953:  Hold'em No Limit ($0.50/$1.00 USD) - 2016/02/11 13:23:40 CET [2016/02/11 7:23:40 ET]
Table 'Kleopatra II' 9-max Seat #1 is the button
Seat 1: gwwsb ($81.53 in chips) 
Seat 2: azvazdam ($78.50 in chips) 
Seat 3: matiko09 ($100 in chips) 
Seat 6: hammerwife ($174.35 in chips) 
Seat 7: Zeeshka ($100 in chips) 
Seat 8: oscarleon ($108.64 in chips) 
Seat 9: vrnMike ($107.67 in chips) 
azvazdam: posts small blind $0.50
matiko09: posts big blind $1
TimStone: sits out 
Sweden_Pound: sits out 
*** HOLE CARDS ***
Dealt to matiko09 [Qs 5c]
hammerwife: folds 
Zeeshka: folds 
oscarleon: folds 
vrnMike: raises $2 to $3
gwwsb: folds 
azvazdam: folds 
matiko09: folds 
Uncalled bet ($2) returned to vrnMike
vrnMike collected $2.50 from pot
*** SUMMARY ***
Total pot $2.50 | Rake $0 
Seat 1: gwwsb (button) folded before Flop (didn't bet)
Seat 2: azvazdam (small blind) folded before Flop
Seat 3: matiko09 (big blind) folded before Flop
Seat 6: hammerwife folded before Flop (didn't bet)
Seat 7: Zeeshka folded before Flop (didn't bet)
Seat 8: oscarleon folded before Flop (didn't bet)
Seat 9: vrnMike collected ($2.50)





PokerStars Hand #148609352560:  Hold'em No Limit (€0.25/€0.50 EUR) - 2016/02/11 13:23:46 CET [2016/02/11 7:23:46 ET]
Table 'Otero II' 9-max Seat #8 is the button
Seat 1: Effort92 (€52 in chips) 
Seat 2: Dantist1122 (€54.02 in chips) 
Seat 3: Szevasztopol (€50 in chips) 
Seat 4: kram0909 (€14.30 in chips) 
Seat 5: vlad11122007 (€47.94 in chips) 
Seat 7: make6a (€50 in chips) 
Seat 8: matiko09 (€67.51 in chips) 
Effort92: posts small blind €0.25
Dantist1122: posts big blind €0.50
TonnaMunz: sits out 
*** HOLE CARDS ***
Dealt to matiko09 [4c 2h]
Szevasztopol: folds 
kram0909: calls €0.50
vlad11122007: folds 
make6a: folds 
matiko09: folds 
Effort92: folds 
Dantist1122: checks 
*** FLOP *** [Jh 9s Kh]
Dantist1122: checks 
kram0909: bets €0.50
Dantist1122: folds 
Uncalled bet (€0.50) returned to kram0909
kram0909 collected €1.19 from pot
kram0909: doesn't show hand 
*** SUMMARY ***
Total pot €1.25 | Rake €0.06 
Board [Jh 9s Kh]
Seat 1: Effort92 (small blind) folded before Flop
Seat 2: Dantist1122 (big blind) folded on the Flop
Seat 3: Szevasztopol folded before Flop (didn't bet)
Seat 4: kram0909 collected (€1.19)
Seat 5: vlad11122007 folded before Flop (didn't bet)
Seat 7: make6a folded before Flop (didn't bet)
Seat 8: matiko09 (button) folded before Flop (didn't bet)





PokerStars Hand #148609363529:  Hold'em No Limit ($0.50/$1.00 USD) - 2016/02/11 13:24:04 CET [2016/02/11 7:24:04 ET]
Table 'Kleopatra II' 9-max Seat #2 is the button
Seat 1: gwwsb ($81.53 in chips) 
Seat 2: azvazdam ($78 in chips) 
Seat 3: matiko09 ($100 in chips) 
Seat 4: TimStone ($100 in chips) 
Seat 6: hammerwife ($174.35 in chips) 
Seat 7: Zeeshka ($100 in chips) 
Seat 8: oscarleon ($108.64 in chips) 
Seat 9: vrnMike ($109.17 in chips) 
matiko09: posts small blind $0.50
TimStone: posts big blind $1
Sweden_Pound: sits out 
*** HOLE CARDS ***
Dealt to matiko09 [Ah Th]
hammerwife: folds 
Zeeshka: raises $2 to $3
oscarleon: folds 
vrnMike: calls $3
gwwsb: folds 
azvazdam: folds 
matiko09: folds 
TimStone: folds 
*** FLOP *** [7h 9s 3c]
Zeeshka: checks 
vrnMike: bets $4.50
Zeeshka: calls $4.50
*** TURN *** [7h 9s 3c] [Ad]
Zeeshka: checks 
vrnMike: bets $10
Zeeshka: folds 
Uncalled bet ($10) returned to vrnMike
vrnMike collected $15.76 from pot
*** SUMMARY ***
Total pot $16.50 | Rake $0.74 
Board [7h 9s 3c Ad]
Seat 1: gwwsb folded before Flop (didn't bet)
Seat 2: azvazdam (button) folded before Flop (didn't bet)
Seat 3: matiko09 (small blind) folded before Flop
Seat 4: TimStone (big blind) folded before Flop
Seat 6: hammerwife folded before Flop (didn't bet)
Seat 7: Zeeshka folded on the Turn
Seat 8: oscarleon folded before Flop (didn't bet)
Seat 9: vrnMike collected ($15.76)





PokerStars Hand #148609369994:  Hold'em No Limit ($0.50/$1.00 USD) - 2016/02/11 13:24:15 CET [2016/02/11 7:24:15 ET]
Table 'Clorinde' 9-max Seat #1 is the button
Seat 1: matiko09 ($100 in chips) 
Seat 2: 19SERGE74 ($98.15 in chips) 
Seat 3: gabi_igna ($111.75 in chips) 
Seat 5: Mukhin1 ($100 in chips) 
Seat 6: Gcroc52 ($23.14 in chips) 
Seat 7: Zeeshka ($104.81 in chips) 
Seat 8: aseban11 ($120.72 in chips) 
Seat 9: hammerwife ($100 in chips) 
19SERGE74: posts small blind $0.50
gabi_igna: posts big blind $1
Sweden_Pound: sits out 
*** HOLE CARDS ***
Dealt to matiko09 [As Ah]
Mukhin1: folds 
Gcroc52: folds 
Zeeshka: folds 
aseban11: folds 
hammerwife: folds 
matiko09: raises $1.27 to $2.27
19SERGE74: calls $1.77
gabi_igna: calls $1.27
*** FLOP *** [2s 4d Kh]
19SERGE74: checks 
gabi_igna: checks 
matiko09: bets $4.23
19SERGE74: calls $4.23
gabi_igna: calls $4.23
*** TURN *** [2s 4d Kh] [Tc]
19SERGE74: checks 
gabi_igna: checks 
matiko09: bets $12
19SERGE74: calls $12
gabi_igna: folds 
*** RIVER *** [2s 4d Kh Tc] [3c]
19SERGE74: checks 
matiko09: bets $23
19SERGE74: calls $23
*** SHOW DOWN ***
matiko09: shows [As Ah] (a pair of Aces)
19SERGE74: mucks hand 
matiko09 collected $86.70 from pot
*** SUMMARY ***
Total pot $89.50 | Rake $2.80 
Board [2s 4d Kh Tc 3c]
Seat 1: matiko09 (button) showed [As Ah] and won ($86.70) with a pair of Aces
Seat 2: 19SERGE74 (small blind) mucked [Ks Qs]
Seat 3: gabi_igna (big blind) folded on the Turn
Seat 5: Mukhin1 folded before Flop (didn't bet)
Seat 6: Gcroc52 folded before Flop (didn't bet)
Seat 7: Zeeshka folded before Flop (didn't bet)
Seat 8: aseban11 folded before Flop (didn't bet)
Seat 9: hammerwife folded before Flop (didn't bet)





PokerStars Hand #148609370769:  Hold'em No Limit ($0.50/$1.00 USD) - 2016/02/11 13:24:17 CET [2016/02/11 7:24:17 ET]
Table 'Stephano V' 9-max Seat #3 is the button
Seat 1: hammerwife ($107.75 in chips) 
Seat 2: matiko09 ($150.38 in chips) 
Seat 3: AlKatrone ($100 in chips) 
Seat 4: Zeeshka ($122.32 in chips) 
Seat 5: n2call ($238.60 in chips) 
Seat 7: hurtNCYDE ($100 in chips) 
Seat 8: oscarleon ($223.75 in chips) 
Seat 9: IcocaynaI ($29.49 in chips) 
Zeeshka: posts small blind $0.50
n2call: posts big blind $1
Sweden_Pound: sits out 
*** HOLE CARDS ***
Dealt to matiko09 [9c 4h]
hurtNCYDE: folds 
oscarleon: folds 
IcocaynaI: calls $1
hammerwife: folds 
matiko09: folds 
AlKatrone: folds 
Zeeshka: folds 
n2call: checks 
*** FLOP *** [Qd 8h 7c]
n2call: checks 
IcocaynaI: bets $1
n2call: folds 
Uncalled bet ($1) returned to IcocaynaI
IcocaynaI collected $2.39 from pot
IcocaynaI: doesn't show hand 
*** SUMMARY ***
Total pot $2.50 | Rake $0.11 
Board [Qd 8h 7c]
Seat 1: hammerwife folded before Flop (didn't bet)
Seat 2: matiko09 folded before Flop (didn't bet)
Seat 3: AlKatrone (button) folded before Flop (didn't bet)
Seat 4: Zeeshka (small blind) folded before Flop
Seat 5: n2call (big blind) folded on the Flop
Seat 7: hurtNCYDE folded before Flop (didn't bet)
Seat 8: oscarleon folded before Flop (didn't bet)
Seat 9: IcocaynaI collected ($2.39)





PokerStars Hand #148609376628:  Hold'em No Limit (€0.25/€0.50 EUR) - 2016/02/11 13:24:26 CET [2016/02/11 7:24:26 ET]
Table 'Otero II' 9-max Seat #1 is the button
Seat 1: Effort92 (€51.75 in chips) 
Seat 2: Dantist1122 (€53.52 in chips) 
Seat 3: Szevasztopol (€50 in chips) 
Seat 4: kram0909 (€14.99 in chips) 
Seat 5: vlad11122007 (€47.94 in chips) 
Seat 7: make6a (€50 in chips) 
Seat 8: matiko09 (€67.51 in chips) 
Dantist1122: posts small blind €0.25
Szevasztopol: posts big blind €0.50
TonnaMunz: sits out 
*** HOLE CARDS ***
Dealt to matiko09 [Th 7h]
kram0909: folds 
vlad11122007: folds 
make6a: raises €0.75 to €1.25
matiko09: folds 
Effort92: folds 
Dantist1122: raises €3 to €4.25
Szevasztopol: folds 
make6a: raises €5 to €9.25
Dantist1122: folds 
Uncalled bet (€5) returned to make6a
make6a collected €9 from pot
make6a: doesn't show hand 
*** SUMMARY ***
Total pot €9 | Rake €0 
Seat 1: Effort92 (button) folded before Flop (didn't bet)
Seat 2: Dantist1122 (small blind) folded before Flop
Seat 3: Szevasztopol (big blind) folded before Flop
Seat 4: kram0909 folded before Flop (didn't bet)
Seat 5: vlad11122007 folded before Flop (didn't bet)
Seat 7: make6a collected (€9)
Seat 8: matiko09 folded before Flop (didn't bet)





PokerStars Hand #148609390288:  Hold'em No Limit ($0.50/$1.00 USD) - 2016/02/11 13:24:49 CET [2016/02/11 7:24:49 ET]
Table 'Marion' 9-max Seat #7 is the button
Seat 1: aseban11 ($100 in chips) 
Seat 2: GusenokRUS ($112.45 in chips) 
Seat 3: TimStone ($100 in chips) 
Seat 4: matiko09 ($100 in chips) 
Seat 5: Rikti ($60.75 in chips) 
Seat 6: 19SERGE74 ($74.81 in chips) 
Seat 7: oscarleon ($109.08 in chips) 
Seat 8: Sweden_Pound ($100 in chips) 
Seat 9: Zeeshka ($101.50 in chips) 
Sweden_Pound: posts small blind $0.50
Zeeshka: posts big blind $1
*** HOLE CARDS ***
Dealt to matiko09 [3h As]
aseban11: raises $2 to $3
GusenokRUS: folds 
TimStone: folds 
matiko09: folds 
Rikti: folds 
19SERGE74: folds 
oscarleon: folds 
Sweden_Pound: folds 
Zeeshka: folds 
Uncalled bet ($2) returned to aseban11
aseban11 collected $2.50 from pot
aseban11: doesn't show hand 
*** SUMMARY ***
Total pot $2.50 | Rake $0 
Seat 1: aseban11 collected ($2.50)
Seat 2: GusenokRUS folded before Flop (didn't bet)
Seat 3: TimStone folded before Flop (didn't bet)
Seat 4: matiko09 folded before Flop (didn't bet)
Seat 5: Rikti folded before Flop (didn't bet)
Seat 6: 19SERGE74 folded before Flop (didn't bet)
Seat 7: oscarleon (button) folded before Flop (didn't bet)
Seat 8: Sweden_Pound (small blind) folded before Flop
Seat 9: Zeeshka (big blind) folded before Flop





PokerStars Hand #148609392852:  Hold'em No Limit ($0.25/$0.50 USD) - 2016/02/11 13:24:54 CET [2016/02/11 7:24:54 ET]
Table 'Ambrosia II' 9-max Seat #6 is the button
Seat 1: matiko09 ($51.79 in chips) 
Seat 2: JJJ-K9 ($61.96 in chips) 
Seat 3: make6a ($77.18 in chips) 
Seat 4: huudk2016 ($37.53 in chips) 
Seat 5: RICKA16 ($48.75 in chips) 
Seat 6: Reven9er ($61.51 in chips) 
Seat 7: Ana.Satravca ($66.25 in chips) 
Seat 8: Dantist1122 ($50 in chips) 
Seat 9: arctur17 ($50 in chips) 
Ana.Satravca: posts small blind $0.25
Dantist1122: posts big blind $0.50
*** HOLE CARDS ***
Dealt to matiko09 [9s 9d]
arctur17: folds 
matiko09: raises $1 to $1.50
JJJ-K9: folds 
make6a: folds 
huudk2016: calls $1.50
RICKA16: raises $4.50 to $6
Reven9er: folds 
Ana.Satravca: folds 
Dantist1122: folds 
matiko09: folds 
huudk2016: calls $4.50
*** FLOP *** [6c Td 5s]
huudk2016: checks 
RICKA16: bets $6
huudk2016 is disconnected 
huudk2016 is connected 
huudk2016: folds 
Uncalled bet ($6) returned to RICKA16
RICKA16 collected $13.61 from pot
RICKA16: doesn't show hand 
*** SUMMARY ***
Total pot $14.25 | Rake $0.64 
Board [6c Td 5s]
Seat 1: matiko09 folded before Flop
Seat 2: JJJ-K9 folded before Flop (didn't bet)
Seat 3: make6a folded before Flop (didn't bet)
Seat 4: huudk2016 folded on the Flop
Seat 5: RICKA16 collected ($13.61)
Seat 6: Reven9er (button) folded before Flop (didn't bet)
Seat 7: Ana.Satravca (small blind) folded before Flop
Seat 8: Dantist1122 (big blind) folded before Flop
Seat 9: arctur17 folded before Flop (didn't bet)





PokerStars Hand #148609396354:  Hold'em No Limit ($0.50/$1.00 USD) - 2016/02/11 13:24:59 CET [2016/02/11 7:24:59 ET]
Table 'Stephano V' 9-max Seat #4 is the button
Seat 1: hammerwife ($107.75 in chips) 
Seat 2: matiko09 ($150.38 in chips) 
Seat 3: AlKatrone ($100 in chips) 
Seat 4: Zeeshka ($121.82 in chips) 
Seat 5: n2call ($237.60 in chips) 
Seat 6: Sweden_Pound ($102 in chips) 
Seat 7: hurtNCYDE ($100 in chips) 
Seat 8: oscarleon ($223.75 in chips) 
Seat 9: IcocaynaI ($30.88 in chips) 
n2call: posts small blind $0.50
Sweden_Pound: posts big blind $1
*** HOLE CARDS ***
Dealt to matiko09 [4c Jd]
hurtNCYDE: raises $1.50 to $2.50
oscarleon: folds 
IcocaynaI: calls $2.50
hammerwife: folds 
matiko09: folds 
AlKatrone: folds 
Zeeshka: folds 
n2call: folds 
Sweden_Pound: folds 
*** FLOP *** [8d 9d 6d]
hurtNCYDE: checks 
IcocaynaI: bets $1
hurtNCYDE: folds 
Uncalled bet ($1) returned to IcocaynaI
IcocaynaI collected $6.21 from pot
IcocaynaI: doesn't show hand 
*** SUMMARY ***
Total pot $6.50 | Rake $0.29 
Board [8d 9d 6d]
Seat 1: hammerwife folded before Flop (didn't bet)
Seat 2: matiko09 folded before Flop (didn't bet)
Seat 3: AlKatrone folded before Flop (didn't bet)
Seat 4: Zeeshka (button) folded before Flop (didn't bet)
Seat 5: n2call (small blind) folded before Flop
Seat 6: Sweden_Pound (big blind) folded before Flop
Seat 7: hurtNCYDE folded on the Flop
Seat 8: oscarleon folded before Flop (didn't bet)
Seat 9: IcocaynaI collected ($6.21)





PokerStars Hand #148609399481:  Hold'em No Limit ($0.50/$1.00 USD) - 2016/02/11 13:25:05 CET [2016/02/11 7:25:05 ET]
Table 'Kleopatra II' 9-max Seat #3 is the button
Seat 1: gwwsb ($81.53 in chips) 
Seat 2: azvazdam ($78 in chips) 
Seat 3: matiko09 ($100 in chips) 
Seat 4: TimStone ($100 in chips) 
Seat 5: Sweden_Pound ($110.73 in chips) 
Seat 6: hammerwife ($174.35 in chips) 
Seat 7: Zeeshka ($100 in chips) 
Seat 8: oscarleon ($108.64 in chips) 
Seat 9: vrnMike ($117.43 in chips) 
TimStone: posts small blind $0.50
Sweden_Pound: posts big blind $1
*** HOLE CARDS ***
Dealt to matiko09 [6s Ad]
hammerwife: folds 
Zeeshka: folds 
oscarleon: folds 
vrnMike: folds 
gwwsb: calls $1
azvazdam: raises $1 to $2
matiko09: folds 
TimStone: folds 
Sweden_Pound: folds 
gwwsb: calls $1
*** FLOP *** [9h Kd 7c]
gwwsb: checks 
azvazdam: bets $3
gwwsb: calls $3
*** TURN *** [9h Kd 7c] [7h]
gwwsb: checks 
azvazdam: checks 
*** RIVER *** [9h Kd 7c 7h] [Kh]
gwwsb: checks 
azvazdam: checks 
*** SHOW DOWN ***
gwwsb: shows [8c Ac] (two pair, Kings and Sevens)
azvazdam: mucks hand 
gwwsb collected $10.98 from pot
*** SUMMARY ***
Total pot $11.50 | Rake $0.52 
Board [9h Kd 7c 7h Kh]
Seat 1: gwwsb showed [8c Ac] and won ($10.98) with two pair, Kings and Sevens
Seat 2: azvazdam mucked [Td Jd]
Seat 3: matiko09 (button) folded before Flop (didn't bet)
Seat 4: TimStone (small blind) folded before Flop
Seat 5: Sweden_Pound (big blind) folded before Flop
Seat 6: hammerwife folded before Flop (didn't bet)
Seat 7: Zeeshka folded before Flop (didn't bet)
Seat 8: oscarleon folded before Flop (didn't bet)
Seat 9: vrnMike folded before Flop (didn't bet)





PokerStars Hand #148609402726:  Hold'em No Limit ($0.25/$0.50 USD) - 2016/02/11 13:25:10 CET [2016/02/11 7:25:10 ET]
Table 'Stereoskopia' 9-max Seat #4 is the button
Seat 2: Dantist1122 ($55.25 in chips) 
Seat 3: fandorin2005 ($50 in chips) 
Seat 4: Anikin44 ($38.15 in chips) 
Seat 5: afrodit71 ($28.17 in chips) 
Seat 6: matiko09 ($50.70 in chips) 
Seat 7: tallonn88 ($53.55 in chips) 
Seat 9: Luoyi-yiwa ($49.35 in chips) 
afrodit71: posts small blind $0.25
matiko09: posts big blind $0.50
Reven9er: sits out 
*** HOLE CARDS ***
Dealt to matiko09 [Ts 7h]
tallonn88: folds 
tallonn88 leaves the table
Luoyi-yiwa: folds 
Dantist1122: folds 
fandorin2005: folds 
Anikin44: folds 
afrodit71: calls $0.25
matiko09: checks 
*** FLOP *** [Qs 7c 6s]
afrodit71: bets $1
matiko09: calls $1
*** TURN *** [Qs 7c 6s] [Tc]
Luoyi-yiwa leaves the table
Serhent joins the table at seat #7 
afrodit71: bets $2
matiko09: raises $4 to $6
afrodit71: folds 
Uncalled bet ($4) returned to matiko09
matiko09 collected $6.68 from pot
matiko09: doesn't show hand 
JJJ-K9 leaves the table
*** SUMMARY ***
Total pot $7 | Rake $0.32 
Board [Qs 7c 6s Tc]
Seat 2: Dantist1122 folded before Flop (didn't bet)
Seat 3: fandorin2005 folded before Flop (didn't bet)
Seat 4: Anikin44 (button) folded before Flop (didn't bet)
Seat 5: afrodit71 (small blind) folded on the Turn
Seat 6: matiko09 (big blind) collected ($6.68)
Seat 7: tallonn88 folded before Flop (didn't bet)
Seat 9: Luoyi-yiwa folded before Flop (didn't bet)





PokerStars Hand #148609406122:  Hold'em No Limit ($0.50/$1.00 USD) - 2016/02/11 13:25:16 CET [2016/02/11 7:25:16 ET]
Table 'Marion' 9-max Seat #8 is the button
Seat 1: aseban11 ($101.50 in chips) 
Seat 2: GusenokRUS ($112.45 in chips) 
Seat 3: TimStone ($100 in chips) 
Seat 4: matiko09 ($100 in chips) 
Seat 5: Rikti ($60.75 in chips) 
Seat 6: 19SERGE74 ($74.81 in chips) 
Seat 7: oscarleon ($109.08 in chips) 
Seat 8: Sweden_Pound ($100 in chips) 
Seat 9: Zeeshka ($100.50 in chips) 
Zeeshka: posts small blind $0.50
aseban11: posts big blind $1
*** HOLE CARDS ***
Dealt to matiko09 [Kh Jh]
GusenokRUS: folds 
TimStone: folds 
matiko09: raises $2 to $3
Rikti: folds 
19SERGE74: folds 
oscarleon: folds 
Sweden_Pound: folds 
Zeeshka: folds 
aseban11: folds 
Uncalled bet ($2) returned to matiko09
matiko09 collected $2.50 from pot
matiko09: doesn't show hand 
*** SUMMARY ***
Total pot $2.50 | Rake $0 
Seat 1: aseban11 (big blind) folded before Flop
Seat 2: GusenokRUS folded before Flop (didn't bet)
Seat 3: TimStone folded before Flop (didn't bet)
Seat 4: matiko09 collected ($2.50)
Seat 5: Rikti folded before Flop (didn't bet)
Seat 6: 19SERGE74 folded before Flop (didn't bet)
Seat 7: oscarleon folded before Flop (didn't bet)
Seat 8: Sweden_Pound (button) folded before Flop (didn't bet)
Seat 9: Zeeshka (small blind) folded before Flop





PokerStars Hand #148609413363:  Hold'em No Limit (€0.25/€0.50 EUR) - 2016/02/11 13:25:28 CET [2016/02/11 7:25:28 ET]
Table 'Otero II' 9-max Seat #2 is the button
Seat 1: Effort92 (€51.75 in chips) 
Seat 2: Dantist1122 (€50 in chips) 
Seat 3: Szevasztopol (€50 in chips) 
Seat 4: kram0909 (€14.99 in chips) 
Seat 5: vlad11122007 (€47.94 in chips) 
Seat 7: make6a (€54.75 in chips) 
Seat 8: matiko09 (€67.51 in chips) 
Szevasztopol: posts small blind €0.25
kram0909: posts big blind €0.50
TonnaMunz: sits out 
*** HOLE CARDS ***
Dealt to matiko09 [Qh 8h]
vlad11122007: folds 
make6a: folds 
matiko09: folds 
Effort92: folds 
Dantist1122: raises €0.75 to €1.25
Szevasztopol: folds 
kram0909: folds 
Uncalled bet (€0.75) returned to Dantist1122
FoRvvArD_go leaves the table
Dantist1122 collected €1.25 from pot
Dantist1122: doesn't show hand 
*** SUMMARY ***
Total pot €1.25 | Rake €0 
Seat 1: Effort92 folded before Flop (didn't bet)
Seat 2: Dantist1122 (button) collected (€1.25)
Seat 3: Szevasztopol (small blind) folded before Flop
Seat 4: kram0909 (big blind) folded before Flop
Seat 5: vlad11122007 folded before Flop (didn't bet)
Seat 7: make6a folded before Flop (didn't bet)
Seat 8: matiko09 folded before Flop (didn't bet)





PokerStars Hand #148609416429:  Hold'em No Limit ($0.50/$1.00 USD) - 2016/02/11 13:25:33 CET [2016/02/11 7:25:33 ET]
Table 'Gianfar' 9-max Seat #1 is the button
Seat 1: Vikulja1993 ($100 in chips) 
Seat 2: bilukm ($109.54 in chips) 
Seat 3: AlKatrone ($163.89 in chips) 
Seat 4: matiko09 ($131.32 in chips) 
Seat 5: hammerwife ($152.79 in chips) 
Seat 7: Rikti ($39 in chips) 
Seat 8: Zeeshka ($100 in chips) 
Seat 9: oscarleon ($140.66 in chips) 
bilukm: posts small blind $0.50
AlKatrone: posts big blind $1
Sweden_Pound: sits out 
*** HOLE CARDS ***
Dealt to matiko09 [7c 7h]
matiko09: raises $2 to $3
hammerwife: folds 
Rikti: calls $3
Zeeshka: folds 
oscarleon: folds 
Vikulja1993: folds 
bilukm: folds 
AlKatrone: folds 
*** FLOP *** [8c Jd 9d]
matiko09: checks 
Rikti: checks 
*** TURN *** [8c Jd 9d] [Ts]
matiko09: bets $3.72
Rikti: folds 
Uncalled bet ($3.72) returned to matiko09
matiko09 collected $7.16 from pot
matiko09: doesn't show hand 
*** SUMMARY ***
Total pot $7.50 | Rake $0.34 
Board [8c Jd 9d Ts]
Seat 1: Vikulja1993 (button) folded before Flop (didn't bet)
Seat 2: bilukm (small blind) folded before Flop
Seat 3: AlKatrone (big blind) folded before Flop
Seat 4: matiko09 collected ($7.16)
Seat 5: hammerwife folded before Flop (didn't bet)
Seat 7: Rikti folded on the Turn
Seat 8: Zeeshka folded before Flop (didn't bet)
Seat 9: oscarleon folded before Flop (didn't bet)





PokerStars Hand #148609420946:  Hold'em No Limit ($0.25/$0.50 USD) - 2016/02/11 13:25:41 CET [2016/02/11 7:25:41 ET]
Table 'Sylvania II' 9-max Seat #6 is the button
Seat 1: tw0315 ($179.54 in chips) 
Seat 2: Effort92 ($50 in chips) 
Seat 3: ruyingren ($211.11 in chips) 
Seat 4: matiko09 ($124.87 in chips) 
Seat 5: vlad11122007 ($57.56 in chips) 
Seat 6: TonnaMunz ($128.51 in chips) 
Seat 7: 2lefthand75 ($69.67 in chips) 
Seat 8: Apparat888 ($50 in chips) 
2lefthand75: posts small blind $0.25
Apparat888: posts big blind $0.50
tw0315: posts the ante $0.10
Effort92: posts the ante $0.10
ruyingren: posts the ante $0.10
matiko09: posts the ante $0.10
vlad11122007: posts the ante $0.10
TonnaMunz: posts the ante $0.10
2lefthand75: posts the ante $0.10
Apparat888: posts the ante $0.10
*** HOLE CARDS ***
Dealt to matiko09 [9c Qc]
tw0315: folds 
Effort92: folds 
ruyingren: folds 
udden82 joins the table at seat #9 
matiko09: folds 
vlad11122007: folds 
TonnaMunz: raises $0.68 to $1.18
2lefthand75: folds 
Apparat888: folds 
Uncalled bet ($0.68) returned to TonnaMunz
TonnaMunz collected $2.05 from pot
TonnaMunz: doesn't show hand 
*** SUMMARY ***
Total pot $2.05 | Rake $0 
Seat 1: tw0315 folded before Flop (didn't bet)
Seat 2: Effort92 folded before Flop (didn't bet)
Seat 3: ruyingren folded before Flop (didn't bet)
Seat 4: matiko09 folded before Flop (didn't bet)
Seat 5: vlad11122007 folded before Flop (didn't bet)
Seat 6: TonnaMunz (button) collected ($2.05)
Seat 7: 2lefthand75 (small blind) folded before Flop
Seat 8: Apparat888 (big blind) folded before Flop





PokerStars Hand #148609421376:  Hold'em No Limit ($0.50/$1.00 USD) - 2016/02/11 13:25:41 CET [2016/02/11 7:25:41 ET]
Table 'Marion' 9-max Seat #9 is the button
Seat 1: aseban11 ($100.50 in chips) 
Seat 2: GusenokRUS ($112.45 in chips) 
Seat 3: TimStone ($100 in chips) 
Seat 4: matiko09 ($101.50 in chips) 
Seat 5: Rikti ($60.75 in chips) 
Seat 6: 19SERGE74 ($74.81 in chips) 
Seat 7: oscarleon ($109.08 in chips) 
Seat 8: Sweden_Pound ($100 in chips) 
Seat 9: Zeeshka ($100 in chips) 
aseban11: posts small blind $0.50
GusenokRUS: posts big blind $1
*** HOLE CARDS ***
Dealt to matiko09 [4s 8c]
TimStone: folds 
matiko09: folds 
Rikti: folds 
19SERGE74: raises $2 to $3
oscarleon: calls $3
Sweden_Pound: folds 
Zeeshka: calls $3
aseban11: folds 
GusenokRUS: folds 
*** FLOP *** [6c 3h 9s]
19SERGE74: bets $5.01
oscarleon: folds 
Zeeshka: calls $5.01
*** TURN *** [6c 3h 9s] [Tc]
19SERGE74: checks 
Zeeshka: checks 
*** RIVER *** [6c 3h 9s Tc] [6d]
19SERGE74: checks 
Zeeshka: checks 
*** SHOW DOWN ***
19SERGE74: shows [8s 8h] (two pair, Eights and Sixes)
Zeeshka: mucks hand 
19SERGE74 collected $19.60 from pot
*** SUMMARY ***
Total pot $20.52 | Rake $0.92 
Board [6c 3h 9s Tc 6d]
Seat 1: aseban11 (small blind) folded before Flop
Seat 2: GusenokRUS (big blind) folded before Flop
Seat 3: TimStone folded before Flop (didn't bet)
Seat 4: matiko09 folded before Flop (didn't bet)
Seat 5: Rikti folded before Flop (didn't bet)
Seat 6: 19SERGE74 showed [8s 8h] and won ($19.60) with two pair, Eights and Sixes
Seat 7: oscarleon folded on the Flop
Seat 8: Sweden_Pound folded before Flop (didn't bet)
Seat 9: Zeeshka (button) mucked [7h 7s]





PokerStars Hand #148609423192:  Hold'em No Limit ($0.50/$1.00 USD) - 2016/02/11 13:25:44 CET [2016/02/11 7:25:44 ET]
Table 'Clorinde' 9-max Seat #2 is the button
Seat 1: matiko09 ($145.20 in chips) 
Seat 2: 19SERGE74 ($56.65 in chips) 
Seat 3: gabi_igna ($105.25 in chips) 
Seat 4: Sweden_Pound ($100 in chips) 
Seat 5: Mukhin1 ($100 in chips) 
Seat 6: Gcroc52 ($23.14 in chips) 
Seat 7: Zeeshka ($104.81 in chips) 
Seat 8: aseban11 ($120.72 in chips) 
Seat 9: hammerwife ($100 in chips) 
gabi_igna: posts small blind $0.50
Sweden_Pound: posts big blind $1
*** HOLE CARDS ***
Dealt to matiko09 [3d 2d]
Mukhin1: folds 
Gcroc52: calls $1
Zeeshka: raises $2.95 to $3.95
aseban11: folds 
hammerwife: folds 
matiko09: folds 
19SERGE74: folds 
gabi_igna: folds 
Sweden_Pound: folds 
Gcroc52: folds 
Uncalled bet ($2.95) returned to Zeeshka
Zeeshka collected $3.50 from pot
Zeeshka: doesn't show hand 
*** SUMMARY ***
Total pot $3.50 | Rake $0 
Seat 1: matiko09 folded before Flop (didn't bet)
Seat 2: 19SERGE74 (button) folded before Flop (didn't bet)
Seat 3: gabi_igna (small blind) folded before Flop
Seat 4: Sweden_Pound (big blind) folded before Flop
Seat 5: Mukhin1 folded before Flop (didn't bet)
Seat 6: Gcroc52 folded before Flop
Seat 7: Zeeshka collected ($3.50)
Seat 8: aseban11 folded before Flop (didn't bet)
Seat 9: hammerwife folded before Flop (didn't bet)





PokerStars Hand #148609430038:  Hold'em No Limit ($0.50/$1.00 USD) - 2016/02/11 13:25:56 CET [2016/02/11 7:25:56 ET]
Table 'Kleopatra II' 9-max Seat #4 is the button
Seat 1: gwwsb ($87.51 in chips) 
Seat 2: azvazdam ($73 in chips) 
Seat 3: matiko09 ($100 in chips) 
Seat 4: TimStone ($100 in chips) 
Seat 5: Sweden_Pound ($109.73 in chips) 
Seat 6: hammerwife ($174.35 in chips) 
Seat 7: Zeeshka ($100 in chips) 
Seat 8: oscarleon ($108.64 in chips) 
Seat 9: vrnMike ($117.43 in chips) 
Sweden_Pound: posts small blind $0.50
hammerwife: posts big blind $1
*** HOLE CARDS ***
Dealt to matiko09 [9c 7s]
Zeeshka: folds 
oscarleon: folds 
vrnMike: folds 
gwwsb: calls $1
azvazdam: folds 
matiko09: folds 
TimStone: raises $3.90 to $4.90
Sweden_Pound: folds 
hammerwife: folds 
gwwsb: folds 
Uncalled bet ($3.90) returned to TimStone
TimStone collected $3.50 from pot
TimStone: doesn't show hand 
*** SUMMARY ***
Total pot $3.50 | Rake $0 
Seat 1: gwwsb folded before Flop
Seat 2: azvazdam folded before Flop (didn't bet)
Seat 3: matiko09 folded before Flop (didn't bet)
Seat 4: TimStone (button) collected ($3.50)
Seat 5: Sweden_Pound (small blind) folded before Flop
Seat 6: hammerwife (big blind) folded before Flop
Seat 7: Zeeshka folded before Flop (didn't bet)
Seat 8: oscarleon folded before Flop (didn't bet)
Seat 9: vrnMike folded before Flop (didn't bet)





PokerStars Hand #148609432373:  Hold'em No Limit (€0.25/€0.50 EUR) - 2016/02/11 13:26:00 CET [2016/02/11 7:26:00 ET]
Table 'Otero II' 9-max Seat #3 is the button
Seat 1: Effort92 (€51.75 in chips) 
Seat 2: Dantist1122 (€50.75 in chips) 
Seat 3: Szevasztopol (€50 in chips) 
Seat 4: kram0909 (€14.49 in chips) 
Seat 6: TonnaMunz (€50.60 in chips) 
Seat 7: make6a (€54.75 in chips) 
Seat 8: matiko09 (€67.51 in chips) 
kram0909: posts small blind €0.25
vlad11122007: is sitting out 
TonnaMunz: posts big blind €0.50
*** HOLE CARDS ***
Dealt to matiko09 [8c Tc]
make6a: folds 
Apparat888 joins the table at seat #9 
matiko09: folds 
Effort92: folds 
Dantist1122: raises €0.85 to €1.35
Szevasztopol: folds 
kram0909: folds 
TonnaMunz: folds 
Uncalled bet (€0.85) returned to Dantist1122
Dantist1122 collected €1.25 from pot
Dantist1122: doesn't show hand 
*** SUMMARY ***
Total pot €1.25 | Rake €0 
Seat 1: Effort92 folded before Flop (didn't bet)
Seat 2: Dantist1122 collected (€1.25)
Seat 3: Szevasztopol (button) folded before Flop (didn't bet)
Seat 4: kram0909 (small blind) folded before Flop
Seat 6: TonnaMunz (big blind) folded before Flop
Seat 7: make6a folded before Flop (didn't bet)
Seat 8: matiko09 folded before Flop (didn't bet)





PokerStars Hand #148609435404:  Hold'em No Limit ($0.50/$1.00 USD) - 2016/02/11 13:26:05 CET [2016/02/11 7:26:05 ET]
Table 'Stephano V' 9-max Seat #5 is the button
Seat 1: hammerwife ($107.75 in chips) 
Seat 2: matiko09 ($150.38 in chips) 
Seat 3: AlKatrone ($100 in chips) 
Seat 4: Zeeshka ($121.82 in chips) 
Seat 5: n2call ($237.10 in chips) 
Seat 6: Sweden_Pound ($101 in chips) 
Seat 7: hurtNCYDE ($100 in chips) 
Seat 8: oscarleon ($223.75 in chips) 
Seat 9: IcocaynaI ($34.59 in chips) 
Sweden_Pound: posts small blind $0.50
hurtNCYDE: posts big blind $1
*** HOLE CARDS ***
Dealt to matiko09 [3s 3c]
oscarleon: folds 
IcocaynaI: calls $1
hammerwife: folds 
matiko09: folds 
AlKatrone: folds 
Zeeshka: folds 
n2call: raises $3.50 to $4.50
Sweden_Pound: folds 
hurtNCYDE: calls $3.50
IcocaynaI: folds 
*** FLOP *** [Qh 9h 8c]
hurtNCYDE: checks 
AlKatrone leaves the table
n2call: bets $6.68
hurtNCYDE: folds 
Uncalled bet ($6.68) returned to n2call
n2call collected $10.03 from pot
n2call: doesn't show hand 
*** SUMMARY ***
Total pot $10.50 | Rake $0.47 
Board [Qh 9h 8c]
Seat 1: hammerwife folded before Flop (didn't bet)
Seat 2: matiko09 folded before Flop (didn't bet)
Seat 3: AlKatrone folded before Flop (didn't bet)
Seat 4: Zeeshka folded before Flop (didn't bet)
Seat 5: n2call (button) collected ($10.03)
Seat 6: Sweden_Pound (small blind) folded before Flop
Seat 7: hurtNCYDE (big blind) folded on the Flop
Seat 8: oscarleon folded before Flop (didn't bet)
Seat 9: IcocaynaI folded before Flop





PokerStars Hand #148609437937:  Hold'em No Limit ($0.50/$1.00 USD) - 2016/02/11 13:26:09 CET [2016/02/11 7:26:09 ET]
Table 'Clorinde' 9-max Seat #3 is the button
Seat 1: matiko09 ($145.20 in chips) 
Seat 2: 19SERGE74 ($56.65 in chips) 
Seat 3: gabi_igna ($104.75 in chips) 
Seat 4: Sweden_Pound ($100 in chips) 
Seat 5: Mukhin1 ($100 in chips) 
Seat 6: Gcroc52 ($22.14 in chips) 
Seat 7: Zeeshka ($107.31 in chips) 
Seat 8: aseban11 ($120.72 in chips) 
Seat 9: hammerwife ($100 in chips) 
Sweden_Pound: posts small blind $0.50
Mukhin1: posts big blind $1
*** HOLE CARDS ***
Dealt to matiko09 [Kd 4s]
Gcroc52: folds 
Zeeshka: folds 
aseban11: folds 
hammerwife: folds 
matiko09: folds 
19SERGE74: folds 
gabi_igna: folds 
Sweden_Pound: raises $2 to $3
Mukhin1: folds 
Uncalled bet ($2) returned to Sweden_Pound
Sweden_Pound collected $2 from pot
Sweden_Pound: doesn't show hand 
*** SUMMARY ***
Total pot $2 | Rake $0 
Seat 1: matiko09 folded before Flop (didn't bet)
Seat 2: 19SERGE74 folded before Flop (didn't bet)
Seat 3: gabi_igna (button) folded before Flop (didn't bet)
Seat 4: Sweden_Pound (small blind) collected ($2)
Seat 5: Mukhin1 (big blind) folded before Flop
Seat 6: Gcroc52 folded before Flop (didn't bet)
Seat 7: Zeeshka folded before Flop (didn't bet)
Seat 8: aseban11 folded before Flop (didn't bet)
Seat 9: hammerwife folded before Flop (didn't bet)





PokerStars Hand #148609439720:  Hold'em No Limit ($0.25/$0.50 USD) - 2016/02/11 13:26:12 CET [2016/02/11 7:26:12 ET]
Table 'Sylvania II' 9-max Seat #7 is the button
Seat 1: tw0315 ($179.44 in chips) 
Seat 2: Effort92 ($50 in chips) 
Seat 3: ruyingren ($211.01 in chips) 
Seat 4: matiko09 ($124.77 in chips) 
Seat 5: vlad11122007 ($57.46 in chips) 
Seat 6: TonnaMunz ($129.96 in chips) 
Seat 7: 2lefthand75 ($69.32 in chips) 
Seat 8: Apparat888 ($49.40 in chips) 
Seat 9: udden82 ($55.50 in chips) 
Apparat888: posts small blind $0.25
udden82: posts big blind $0.50
tw0315: posts the ante $0.10
Effort92: posts the ante $0.10
ruyingren: posts the ante $0.10
matiko09: posts the ante $0.10
vlad11122007: posts the ante $0.10
TonnaMunz: posts the ante $0.10
2lefthand75: posts the ante $0.10
Apparat888: posts the ante $0.10
udden82: posts the ante $0.10
*** HOLE CARDS ***
Dealt to matiko09 [3d 3h]
tw0315: folds 
Effort92: raises $1 to $1.50
ruyingren: folds 
matiko09: folds 
vlad11122007: folds 
TonnaMunz: folds 
2lefthand75: calls $1.50
Apparat888: folds 
udden82: folds 
*** FLOP *** [Ts 5d 7h]
Effort92: checks 
2lefthand75: bets $2.22
Effort92: calls $2.22
*** TURN *** [Ts 5d 7h] [7d]
Effort92: checks 
2lefthand75: checks 
*** RIVER *** [Ts 5d 7h 7d] [9d]
Effort92: checks 
2lefthand75: checks 
*** SHOW DOWN ***
Effort92: shows [9c 9s] (a full house, Nines full of Sevens)
2lefthand75: mucks hand 
Effort92 collected $8.68 from pot
*** SUMMARY ***
Total pot $9.09 | Rake $0.41 
Board [Ts 5d 7h 7d 9d]
Seat 1: tw0315 folded before Flop (didn't bet)
Seat 2: Effort92 showed [9c 9s] and won ($8.68) with a full house, Nines full of Sevens
Seat 3: ruyingren folded before Flop (didn't bet)
Seat 4: matiko09 folded before Flop (didn't bet)
Seat 5: vlad11122007 folded before Flop (didn't bet)
Seat 6: TonnaMunz folded before Flop (didn't bet)
Seat 7: 2lefthand75 (button) mucked [Ad Qc]
Seat 8: Apparat888 (small blind) folded before Flop
Seat 9: udden82 (big blind) folded before Flop





PokerStars Hand #148609447210:  Hold'em No Limit ($0.50/$1.00 USD) - 2016/02/11 13:26:25 CET [2016/02/11 7:26:25 ET]
Table 'Kleopatra II' 9-max Seat #5 is the button
Seat 1: gwwsb ($86.51 in chips) 
Seat 2: azvazdam ($73 in chips) 
Seat 3: matiko09 ($100 in chips) 
Seat 4: TimStone ($102.50 in chips) 
Seat 5: Sweden_Pound ($109.23 in chips) 
Seat 6: hammerwife ($173.35 in chips) 
Seat 7: Zeeshka ($100 in chips) 
Seat 8: oscarleon ($108.64 in chips) 
Seat 9: vrnMike ($117.43 in chips) 
hammerwife: posts small blind $0.50
Zeeshka: posts big blind $1
*** HOLE CARDS ***
Dealt to matiko09 [2h 5h]
oscarleon: folds 
vrnMike: folds 
gwwsb: folds 
azvazdam: raises $1 to $2
matiko09: folds 
TimStone: folds 
Sweden_Pound: folds 
hammerwife: folds 
Zeeshka: folds 
Uncalled bet ($1) returned to azvazdam
azvazdam collected $2.50 from pot
azvazdam: doesn't show hand 
*** SUMMARY ***
Total pot $2.50 | Rake $0 
Seat 1: gwwsb folded before Flop (didn't bet)
Seat 2: azvazdam collected ($2.50)
Seat 3: matiko09 folded before Flop (didn't bet)
Seat 4: TimStone folded before Flop (didn't bet)
Seat 5: Sweden_Pound (button) folded before Flop (didn't bet)
Seat 6: hammerwife (small blind) folded before Flop
Seat 7: Zeeshka (big blind) folded before Flop
Seat 8: oscarleon folded before Flop (didn't bet)
Seat 9: vrnMike folded before Flop (didn't bet)





PokerStars Hand #148609449679:  Hold'em No Limit (€0.25/€0.50 EUR) - 2016/02/11 13:26:29 CET [2016/02/11 7:26:29 ET]
Table 'Otero II' 9-max Seat #4 is the button
Seat 1: Effort92 (€51.75 in chips) 
Seat 2: Dantist1122 (€51.50 in chips) 
Seat 3: Szevasztopol (€50 in chips) 
Seat 4: kram0909 (€14.24 in chips) 
Seat 6: TonnaMunz (€50.10 in chips) 
Seat 7: make6a (€54.75 in chips) 
Seat 8: matiko09 (€67.51 in chips) 
TonnaMunz: posts small blind €0.25
make6a: posts big blind €0.50
Apparat888: sits out 
*** HOLE CARDS ***
Dealt to matiko09 [9d 7s]
matiko09: folds 
Effort92: folds 
Dantist1122: folds 
Szevasztopol: raises €1 to €1.50
kram0909: calls €1.50
TonnaMunz: raises €3.75 to €5.25
make6a: folds 
Szevasztopol: folds 
kram0909: calls €3.75
*** FLOP *** [6s Jc 2h]
TonnaMunz: bets €2.75
kram0909: raises €6.24 to €8.99 and is all-in
TonnaMunz: calls €6.24
*** TURN *** [6s Jc 2h] [6h]
*** RIVER *** [6s Jc 2h 6h] [8c]
*** SHOW DOWN ***
TonnaMunz: shows [Ah Qs] (a pair of Sixes)
kram0909: shows [Jh As] (two pair, Jacks and Sixes)
kram0909 collected €29.11 from pot
*** SUMMARY ***
Total pot €30.48 | Rake €1.37 
Board [6s Jc 2h 6h 8c]
Seat 1: Effort92 folded before Flop (didn't bet)
Seat 2: Dantist1122 folded before Flop (didn't bet)
Seat 3: Szevasztopol folded before Flop
Seat 4: kram0909 (button) showed [Jh As] and won (€29.11) with two pair, Jacks and Sixes
Seat 6: TonnaMunz (small blind) showed [Ah Qs] and lost with a pair of Sixes
Seat 7: make6a (big blind) folded before Flop
Seat 8: matiko09 folded before Flop (didn't bet)





PokerStars Hand #148609449826:  Hold'em No Limit ($0.25/$0.50 USD) - 2016/02/11 13:26:30 CET [2016/02/11 7:26:30 ET]
Table 'Stereoskopia' 9-max Seat #5 is the button
Seat 2: Dantist1122 ($55.25 in chips) 
Seat 3: fandorin2005 ($50 in chips) 
Seat 4: Anikin44 ($38.15 in chips) 
Seat 5: afrodit71 ($24.67 in chips) 
Seat 6: matiko09 ($53.88 in chips) 
Seat 7: Serhent ($50 in chips) 
matiko09: posts small blind $0.25
Serhent: posts big blind $0.50
Reven9er: sits out 
*** HOLE CARDS ***
Dealt to matiko09 [Qd 9h]
Dantist1122: folds 
fandorin2005: folds 
Anikin44: folds 
FoRvvArD_go joins the table at seat #1 
afrodit71: calls $0.50
matiko09: folds 
Serhent: checks 
*** FLOP *** [9c Jc Kd]
Serhent: bets $1
afrodit71: calls $1
*** TURN *** [9c Jc Kd] [7c]
Serhent: bets $2.25
nastynate075 joins the table at seat #9 
afrodit71: calls $2.25
*** RIVER *** [9c Jc Kd 7c] [2d]
Serhent: bets $4.25
afrodit71: calls $4.25
*** SHOW DOWN ***
Serhent: shows [Jh 9s] (two pair, Jacks and Nines)
afrodit71: mucks hand 
Serhent collected $15.52 from pot
*** SUMMARY ***
Total pot $16.25 | Rake $0.73 
Board [9c Jc Kd 7c 2d]
Seat 2: Dantist1122 folded before Flop (didn't bet)
Seat 3: fandorin2005 folded before Flop (didn't bet)
Seat 4: Anikin44 folded before Flop (didn't bet)
Seat 5: afrodit71 (button) mucked [Ts Kc]
Seat 6: matiko09 (small blind) folded before Flop
Seat 7: Serhent (big blind) showed [Jh 9s] and won ($15.52) with two pair, Jacks and Nines





PokerStars Hand #148609455173:  Hold'em No Limit ($0.50/$1.00 USD) - 2016/02/11 13:26:39 CET [2016/02/11 7:26:39 ET]
Table 'Clorinde' 9-max Seat #4 is the button
Seat 1: matiko09 ($145.20 in chips) 
Seat 2: 19SERGE74 ($56.65 in chips) 
Seat 3: gabi_igna ($104.75 in chips) 
Seat 4: Sweden_Pound ($101 in chips) 
Seat 5: Mukhin1 ($100 in chips) 
Seat 6: Gcroc52 ($22.14 in chips) 
Seat 7: Zeeshka ($107.31 in chips) 
Seat 8: aseban11 ($120.72 in chips) 
Seat 9: hammerwife ($100 in chips) 
Mukhin1: posts small blind $0.50
Gcroc52: posts big blind $1
*** HOLE CARDS ***
Dealt to matiko09 [5d 8s]
Zeeshka: folds 
aseban11: raises $2 to $3
hammerwife: folds 
matiko09: folds 
19SERGE74: folds 
gabi_igna: folds 
Sweden_Pound: folds 
Mukhin1: folds 
Gcroc52: calls $2
*** FLOP *** [8h Qc Qh]
Gcroc52: checks 
aseban11: checks 
*** TURN *** [8h Qc Qh] [Th]
Gcroc52: checks 
aseban11: bets $6.21
Gcroc52: calls $6.21
*** RIVER *** [8h Qc Qh Th] [7h]
Gcroc52: checks 
aseban11: checks 
*** SHOW DOWN ***
Gcroc52: shows [8d 9s] (two pair, Queens and Eights)
aseban11: shows [Ks Kd] (two pair, Kings and Queens)
aseban11 collected $18.07 from pot
*** SUMMARY ***
Total pot $18.92 | Rake $0.85 
Board [8h Qc Qh Th 7h]
Seat 1: matiko09 folded before Flop (didn't bet)
Seat 2: 19SERGE74 folded before Flop (didn't bet)
Seat 3: gabi_igna folded before Flop (didn't bet)
Seat 4: Sweden_Pound (button) folded before Flop (didn't bet)
Seat 5: Mukhin1 (small blind) folded before Flop
Seat 6: Gcroc52 (big blind) showed [8d 9s] and lost with two pair, Queens and Eights
Seat 7: Zeeshka folded before Flop (didn't bet)
Seat 8: aseban11 showed [Ks Kd] and won ($18.07) with two pair, Kings and Queens
Seat 9: hammerwife folded before Flop (didn't bet)





PokerStars Hand #148609459303:  Hold'em No Limit ($0.50/$1.00 USD) - 2016/02/11 13:26:46 CET [2016/02/11 7:26:46 ET]
Table 'Gianfar' 9-max Seat #2 is the button
Seat 1: Vikulja1993 ($100 in chips) 
Seat 2: bilukm ($109.04 in chips) 
Seat 3: AlKatrone ($162.89 in chips) 
Seat 4: matiko09 ($135.48 in chips) 
Seat 5: hammerwife ($152.79 in chips) 
Seat 7: Rikti ($36 in chips) 
Seat 8: Zeeshka ($100 in chips) 
Seat 9: oscarleon ($140.66 in chips) 
AlKatrone: posts small blind $0.50
matiko09: posts big blind $1
Sweden_Pound: sits out 
*** HOLE CARDS ***
Dealt to matiko09 [4c 3c]
hammerwife: folds 
Rikti: folds 
Zeeshka: folds 
oscarleon: raises $2 to $3
Vikulja1993: folds 
bilukm: calls $3
AlKatrone: raises $10.50 to $13.50
matiko09: folds 
oscarleon: folds 
bilukm: folds 
Uncalled bet ($10.50) returned to AlKatrone
AlKatrone collected $10 from pot
AlKatrone: doesn't show hand 
*** SUMMARY ***
Total pot $10 | Rake $0 
Seat 1: Vikulja1993 folded before Flop (didn't bet)
Seat 2: bilukm (button) folded before Flop
Seat 3: AlKatrone (small blind) collected ($10)
Seat 4: matiko09 (big blind) folded before Flop
Seat 5: hammerwife folded before Flop (didn't bet)
Seat 7: Rikti folded before Flop (didn't bet)
Seat 8: Zeeshka folded before Flop (didn't bet)
Seat 9: oscarleon folded before Flop





PokerStars Hand #148609459924:  Hold'em No Limit ($0.25/$0.50 USD) - 2016/02/11 13:26:47 CET [2016/02/11 7:26:47 ET]
Table 'Ambrosia II' 9-max Seat #7 is the button
Seat 1: matiko09 ($50.29 in chips) 
Seat 2: JJJ-K9 ($61.96 in chips) 
Seat 3: make6a ($77.18 in chips) 
Seat 4: huudk2016 ($31.53 in chips) 
Seat 5: RICKA16 ($56.36 in chips) 
Seat 6: Reven9er ($61.51 in chips) 
Seat 7: Ana.Satravca ($66 in chips) 
Seat 8: Dantist1122 ($50 in chips) 
Dantist1122: posts small blind $0.25
matiko09: posts big blind $0.50
*** HOLE CARDS ***
Dealt to matiko09 [Ks 8c]
JJJ-K9: folds 
make6a: folds 
huudk2016: calls $0.50
RICKA16: folds 
Reven9er: folds 
Ana.Satravca: folds 
Dantist1122: folds 
matiko09: checks 
*** FLOP *** [3s 3d Qd]
matiko09: checks 
huudk2016: bets $1.50
matiko09: folds 
Uncalled bet ($1.50) returned to huudk2016
huudk2016 collected $1.19 from pot
huudk2016: doesn't show hand 
*** SUMMARY ***
Total pot $1.25 | Rake $0.06 
Board [3s 3d Qd]
Seat 1: matiko09 (big blind) folded on the Flop
Seat 2: JJJ-K9 folded before Flop (didn't bet)
Seat 3: make6a folded before Flop (didn't bet)
Seat 4: huudk2016 collected ($1.19)
Seat 5: RICKA16 folded before Flop (didn't bet)
Seat 6: Reven9er folded before Flop (didn't bet)
Seat 7: Ana.Satravca (button) folded before Flop (didn't bet)
Seat 8: Dantist1122 (small blind) folded before Flop





PokerStars Hand #148609464357:  Hold'em No Limit ($0.50/$1.00 USD) - 2016/02/11 13:26:54 CET [2016/02/11 7:26:54 ET]
Table 'Kleopatra II' 9-max Seat #6 is the button
Seat 1: gwwsb ($86.51 in chips) 
Seat 2: azvazdam ($74.50 in chips) 
Seat 3: matiko09 ($100 in chips) 
Seat 4: TimStone ($102.50 in chips) 
Seat 5: Sweden_Pound ($109.23 in chips) 
Seat 6: hammerwife ($172.85 in chips) 
Seat 7: Zeeshka ($100 in chips) 
Seat 8: oscarleon ($108.64 in chips) 
Seat 9: vrnMike ($117.43 in chips) 
Zeeshka: posts small blind $0.50
oscarleon: posts big blind $1
*** HOLE CARDS ***
Dealt to matiko09 [7d 9s]
vrnMike: folds 
gwwsb: folds 
azvazdam: folds 
matiko09: folds 
TimStone: folds 
Sweden_Pound: raises $1.50 to $2.50
hammerwife: folds 
Zeeshka: folds 
oscarleon: folds 
Uncalled bet ($1.50) returned to Sweden_Pound
Sweden_Pound collected $2.50 from pot
Sweden_Pound: doesn't show hand 
*** SUMMARY ***
Total pot $2.50 | Rake $0 
Seat 1: gwwsb folded before Flop (didn't bet)
Seat 2: azvazdam folded before Flop (didn't bet)
Seat 3: matiko09 folded before Flop (didn't bet)
Seat 4: TimStone folded before Flop (didn't bet)
Seat 5: Sweden_Pound collected ($2.50)
Seat 6: hammerwife (button) folded before Flop (didn't bet)
Seat 7: Zeeshka (small blind) folded before Flop
Seat 8: oscarleon (big blind) folded before Flop
Seat 9: vrnMike folded before Flop (didn't bet)





PokerStars Hand #148609465292:  Hold'em No Limit ($0.50/$1.00 USD) - 2016/02/11 13:26:56 CET [2016/02/11 7:26:56 ET]
Table 'Marion' 9-max Seat #1 is the button
Seat 1: aseban11 ($100 in chips) 
Seat 2: GusenokRUS ($111.45 in chips) 
Seat 3: TimStone ($100 in chips) 
Seat 4: matiko09 ($101.50 in chips) 
Seat 5: Rikti ($60.75 in chips) 
Seat 6: 19SERGE74 ($86.40 in chips) 
Seat 7: oscarleon ($106.08 in chips) 
Seat 8: Sweden_Pound ($100 in chips) 
Seat 9: Zeeshka ($100 in chips) 
GusenokRUS: posts small blind $0.50
TimStone: posts big blind $1
*** HOLE CARDS ***
Dealt to matiko09 [6s As]
matiko09: folds 
Rikti: folds 
19SERGE74: folds 
oscarleon: folds 
Sweden_Pound: folds 
Zeeshka: folds 
aseban11: folds 
GusenokRUS: raises $2 to $3
TimStone: folds 
Uncalled bet ($2) returned to GusenokRUS
GusenokRUS collected $2 from pot
GusenokRUS: doesn't show hand 
*** SUMMARY ***
Total pot $2 | Rake $0 
Seat 1: aseban11 (button) folded before Flop (didn't bet)
Seat 2: GusenokRUS (small blind) collected ($2)
Seat 3: TimStone (big blind) folded before Flop
Seat 4: matiko09 folded before Flop (didn't bet)
Seat 5: Rikti folded before Flop (didn't bet)
Seat 6: 19SERGE74 folded before Flop (didn't bet)
Seat 7: oscarleon folded before Flop (didn't bet)
Seat 8: Sweden_Pound folded before Flop (didn't bet)
Seat 9: Zeeshka folded before Flop (didn't bet)





PokerStars Hand #148609474375:  Hold'em No Limit ($0.50/$1.00 USD) - 2016/02/11 13:27:11 CET [2016/02/11 7:27:11 ET]
Table 'Stephano V' 9-max Seat #6 is the button
Seat 1: hammerwife ($107.75 in chips) 
Seat 2: matiko09 ($150.38 in chips) 
Seat 4: Zeeshka ($121.82 in chips) 
Seat 5: n2call ($242.63 in chips) 
Seat 6: Sweden_Pound ($100.50 in chips) 
Seat 7: hurtNCYDE ($100 in chips) 
Seat 8: oscarleon ($223.75 in chips) 
Seat 9: IcocaynaI ($33.59 in chips) 
hurtNCYDE: posts small blind $0.50
oscarleon: posts big blind $1
*** HOLE CARDS ***
Dealt to matiko09 [Tc Kc]
IcocaynaI: folds 
DUkalisUA joins the table at seat #3 
hammerwife: folds 
matiko09: raises $2 to $3
Zeeshka: folds 
n2call: folds 
Sweden_Pound: folds 
hurtNCYDE: folds 
oscarleon: calls $2
*** FLOP *** [Ad 2c 9h]
oscarleon: checks 
matiko09: bets $4.04
oscarleon: raises $7.43 to $11.47
matiko09: folds 
Uncalled bet ($7.43) returned to oscarleon
oscarleon collected $13.92 from pot
oscarleon: doesn't show hand 
*** SUMMARY ***
Total pot $14.58 | Rake $0.66 
Board [Ad 2c 9h]
Seat 1: hammerwife folded before Flop (didn't bet)
Seat 2: matiko09 folded on the Flop
Seat 4: Zeeshka folded before Flop (didn't bet)
Seat 5: n2call folded before Flop (didn't bet)
Seat 6: Sweden_Pound (button) folded before Flop (didn't bet)
Seat 7: hurtNCYDE (small blind) folded before Flop
Seat 8: oscarleon (big blind) collected ($13.92)
Seat 9: IcocaynaI folded before Flop (didn't bet)





PokerStars Hand #148609474108:  Hold'em No Limit ($0.25/$0.50 USD) - 2016/02/11 13:27:11 CET [2016/02/11 7:27:11 ET]
Table 'Sylvania II' 9-max Seat #8 is the button
Seat 2: Effort92 ($54.86 in chips) 
Seat 3: ruyingren ($210.91 in chips) 
Seat 4: matiko09 ($124.67 in chips) 
Seat 5: vlad11122007 ($57.36 in chips) 
Seat 6: TonnaMunz ($129.86 in chips) 
Seat 7: 2lefthand75 ($65.50 in chips) 
Seat 8: Apparat888 ($49.05 in chips) 
Seat 9: udden82 ($54.90 in chips) 
udden82: posts small blind $0.25
tw0315: is sitting out 
Effort92: posts big blind $0.50
Effort92: posts the ante $0.10
ruyingren: posts the ante $0.10
matiko09: posts the ante $0.10
vlad11122007: posts the ante $0.10
TonnaMunz: posts the ante $0.10
2lefthand75: posts the ante $0.10
Apparat888: posts the ante $0.10
udden82: posts the ante $0.10
*** HOLE CARDS ***
Dealt to matiko09 [Qd Kd]
ruyingren: raises $1 to $1.50
matiko09: raises $3.50 to $5
vlad11122007: folds 
TonnaMunz: folds 
2lefthand75: folds 
Apparat888: folds 
udden82: folds 
Effort92: calls $4.50
ruyingren: calls $3.50
*** FLOP *** [Qc 9d Jc]
Effort92: checks 
ruyingren: checks 
matiko09: checks 
*** TURN *** [Qc 9d Jc] [2h]
Effort92: bets $11.49
ruyingren: folds 
matiko09: folds 
Uncalled bet ($11.49) returned to Effort92
Effort92 collected $15.33 from pot
Effort92: doesn't show hand 
*** SUMMARY ***
Total pot $16.05 | Rake $0.72 
Board [Qc 9d Jc 2h]
Seat 2: Effort92 (big blind) collected ($15.33)
Seat 3: ruyingren folded on the Turn
Seat 4: matiko09 folded on the Turn
Seat 5: vlad11122007 folded before Flop (didn't bet)
Seat 6: TonnaMunz folded before Flop (didn't bet)
Seat 7: 2lefthand75 folded before Flop (didn't bet)
Seat 8: Apparat888 (button) folded before Flop (didn't bet)
Seat 9: udden82 (small blind) folded before Flop





PokerStars Hand #148609479588:  Hold'em No Limit ($0.50/$1.00 USD) - 2016/02/11 13:27:20 CET [2016/02/11 7:27:20 ET]
Table 'Gianfar' 9-max Seat #3 is the button
Seat 1: Vikulja1993 ($100 in chips) 
Seat 2: bilukm ($106.04 in chips) 
Seat 3: AlKatrone ($169.89 in chips) 
Seat 4: matiko09 ($134.48 in chips) 
Seat 5: hammerwife ($152.79 in chips) 
Seat 7: Rikti ($36 in chips) 
Seat 8: Zeeshka ($100 in chips) 
Seat 9: oscarleon ($137.66 in chips) 
matiko09: posts small blind $0.50
hammerwife: posts big blind $1
Sweden_Pound: sits out 
*** HOLE CARDS ***
Dealt to matiko09 [Qd 8s]
Rikti: folds 
Zeeshka: folds 
oscarleon: folds 
Vikulja1993: folds 
bilukm: folds 
AlKatrone: folds 
matiko09: folds 
Uncalled bet ($0.50) returned to hammerwife
hammerwife collected $1 from pot
hammerwife: doesn't show hand 
*** SUMMARY ***
Total pot $1 | Rake $0 
Seat 1: Vikulja1993 folded before Flop (didn't bet)
Seat 2: bilukm folded before Flop (didn't bet)
Seat 3: AlKatrone (button) folded before Flop (didn't bet)
Seat 4: matiko09 (small blind) folded before Flop
Seat 5: hammerwife (big blind) collected ($1)
Seat 7: Rikti folded before Flop (didn't bet)
Seat 8: Zeeshka folded before Flop (didn't bet)
Seat 9: oscarleon folded before Flop (didn't bet)





PokerStars Hand #148609480283:  Hold'em No Limit ($0.50/$1.00 USD) - 2016/02/11 13:27:21 CET [2016/02/11 7:27:21 ET]
Table 'Kleopatra II' 9-max Seat #7 is the button
Seat 1: gwwsb ($86.51 in chips) 
Seat 2: azvazdam ($74.50 in chips) 
Seat 3: matiko09 ($100 in chips) 
Seat 4: TimStone ($102.50 in chips) 
Seat 5: Sweden_Pound ($110.73 in chips) 
Seat 6: hammerwife ($172.85 in chips) 
Seat 7: Zeeshka ($100 in chips) 
Seat 8: oscarleon ($107.64 in chips) 
Seat 9: vrnMike ($117.43 in chips) 
oscarleon: posts small blind $0.50
vrnMike: posts big blind $1
*** HOLE CARDS ***
Dealt to matiko09 [Ad Jc]
gwwsb: folds 
azvazdam: raises $1 to $2
matiko09: raises $5 to $7
TimStone: folds 
Sweden_Pound: folds 
hammerwife: folds 
Zeeshka: folds 
oscarleon: folds 
vrnMike: folds 
azvazdam: folds 
Uncalled bet ($5) returned to matiko09
matiko09 collected $5.50 from pot
matiko09: doesn't show hand 
*** SUMMARY ***
Total pot $5.50 | Rake $0 
Seat 1: gwwsb folded before Flop (didn't bet)
Seat 2: azvazdam folded before Flop
Seat 3: matiko09 collected ($5.50)
Seat 4: TimStone folded before Flop (didn't bet)
Seat 5: Sweden_Pound folded before Flop (didn't bet)
Seat 6: hammerwife folded before Flop (didn't bet)
Seat 7: Zeeshka (button) folded before Flop (didn't bet)
Seat 8: oscarleon (small blind) folded before Flop
Seat 9: vrnMike (big blind) folded before Flop





PokerStars Hand #148609483805:  Hold'em No Limit ($0.25/$0.50 USD) - 2016/02/11 13:27:27 CET [2016/02/11 7:27:27 ET]
Table 'Ambrosia II' 9-max Seat #8 is the button
Seat 1: matiko09 ($50 in chips) 
Seat 2: JJJ-K9 ($61.96 in chips) 
Seat 3: make6a ($77.18 in chips) 
Seat 4: huudk2016 ($32.22 in chips) 
Seat 5: RICKA16 ($56.36 in chips) 
Seat 6: Reven9er ($61.51 in chips) 
Seat 7: Ana.Satravca ($66 in chips) 
Seat 8: Dantist1122 ($50 in chips) 
matiko09: posts small blind $0.25
JJJ-K9: posts big blind $0.50
*** HOLE CARDS ***
Dealt to matiko09 [8s 6c]
make6a: folds 
huudk2016: calls $0.50
RICKA16: raises $1.50 to $2
Reven9er: folds 
Ana.Satravca: folds 
Dantist1122: folds 
matiko09: folds 
JJJ-K9: folds 
huudk2016: calls $1.50
*** FLOP *** [9d Kh 2h]
huudk2016: checks 
RICKA16: bets $3
huudk2016: calls $3
*** TURN *** [9d Kh 2h] [Kc]
huudk2016: checks 
RICKA16: checks 
*** RIVER *** [9d Kh 2h Kc] [As]
huudk2016: checks 
RICKA16: checks 
*** SHOW DOWN ***
huudk2016: shows [7s 9c] (two pair, Kings and Nines)
RICKA16: shows [Qh Ac] (two pair, Aces and Kings)
RICKA16 collected $10.27 from pot
*** SUMMARY ***
Total pot $10.75 | Rake $0.48 
Board [9d Kh 2h Kc As]
Seat 1: matiko09 (small blind) folded before Flop
Seat 2: JJJ-K9 (big blind) folded before Flop
Seat 3: make6a folded before Flop (didn't bet)
Seat 4: huudk2016 showed [7s 9c] and lost with two pair, Kings and Nines
Seat 5: RICKA16 showed [Qh Ac] and won ($10.27) with two pair, Aces and Kings
Seat 6: Reven9er folded before Flop (didn't bet)
Seat 7: Ana.Satravca folded before Flop (didn't bet)
Seat 8: Dantist1122 (button) folded before Flop (didn't bet)





PokerStars Hand #148609490252:  Hold'em No Limit ($0.50/$1.00 USD) - 2016/02/11 13:27:38 CET [2016/02/11 7:27:38 ET]
Table 'Marion' 9-max Seat #2 is the button
Seat 1: aseban11 ($100 in chips) 
Seat 2: GusenokRUS ($112.45 in chips) 
Seat 3: TimStone ($100 in chips) 
Seat 4: matiko09 ($101.50 in chips) 
Seat 5: Rikti ($60.75 in chips) 
Seat 6: 19SERGE74 ($86.40 in chips) 
Seat 7: oscarleon ($106.08 in chips) 
Seat 8: Sweden_Pound ($100 in chips) 
Seat 9: Zeeshka ($100 in chips) 
TimStone: posts small blind $0.50
matiko09: posts big blind $1
*** HOLE CARDS ***
Dealt to matiko09 [6d 7c]
Rikti: folds 
19SERGE74: folds 
oscarleon: folds 
Sweden_Pound: folds 
Zeeshka: folds 
aseban11: folds 
GusenokRUS: folds 
TimStone: folds 
Uncalled bet ($0.50) returned to matiko09
matiko09 collected $1 from pot
matiko09: doesn't show hand 
*** SUMMARY ***
Total pot $1 | Rake $0 
Seat 1: aseban11 folded before Flop (didn't bet)
Seat 2: GusenokRUS (button) folded before Flop (didn't bet)
Seat 3: TimStone (small blind) folded before Flop
Seat 4: matiko09 (big blind) collected ($1)
Seat 5: Rikti folded before Flop (didn't bet)
Seat 6: 19SERGE74 folded before Flop (didn't bet)
Seat 7: oscarleon folded before Flop (didn't bet)
Seat 8: Sweden_Pound folded before Flop (didn't bet)
Seat 9: Zeeshka folded before Flop (didn't bet)





PokerStars Hand #148609496116:  Hold'em No Limit ($0.25/$0.50 USD) - 2016/02/11 13:27:48 CET [2016/02/11 7:27:48 ET]
Table 'Stereoskopia' 9-max Seat #6 is the button
Seat 2: Dantist1122 ($55.25 in chips) 
Seat 3: fandorin2005 ($50 in chips) 
Seat 4: Anikin44 ($38.15 in chips) 
Seat 5: afrodit71 ($16.67 in chips) 
Seat 6: matiko09 ($53.63 in chips) 
Seat 7: Serhent ($57.52 in chips) 
Seat 8: Reven9er ($50 in chips) 
Serhent: posts small blind $0.25
Reven9er: posts big blind $0.50
nastynate075: sits out 
FoRvvArD_go: sits out 
*** HOLE CARDS ***
Dealt to matiko09 [5h Tc]
Dantist1122: folds 
fandorin2005: raises $0.75 to $1.25
Anikin44: folds 
afrodit71: calls $1.25
matiko09: folds 
Serhent: folds 
Reven9er: folds 
*** FLOP *** [8c 9h 3h]
fandorin2005: bets $1.75
afrodit71: calls $1.75
*** TURN *** [8c 9h 3h] [4d]
fandorin2005: checks 
afrodit71: bets $5.50
fandorin2005: folds 
Uncalled bet ($5.50) returned to afrodit71
afrodit71 collected $6.45 from pot
afrodit71: doesn't show hand 
*** SUMMARY ***
Total pot $6.75 | Rake $0.30 
Board [8c 9h 3h 4d]
Seat 2: Dantist1122 folded before Flop (didn't bet)
Seat 3: fandorin2005 folded on the Turn
Seat 4: Anikin44 folded before Flop (didn't bet)
Seat 5: afrodit71 collected ($6.45)
Seat 6: matiko09 (button) folded before Flop (didn't bet)
Seat 7: Serhent (small blind) folded before Flop
Seat 8: Reven9er (big blind) folded before Flop





PokerStars Hand #148609501285:  Hold'em No Limit ($0.50/$1.00 USD) - 2016/02/11 13:27:57 CET [2016/02/11 7:27:57 ET]
Table 'Kleopatra II' 9-max Seat #8 is the button
Seat 1: gwwsb ($86.51 in chips) 
Seat 2: azvazdam ($72.50 in chips) 
Seat 3: matiko09 ($103.50 in chips) 
Seat 4: TimStone ($102.50 in chips) 
Seat 5: Sweden_Pound ($110.73 in chips) 
Seat 6: hammerwife ($172.85 in chips) 
Seat 7: Zeeshka ($100 in chips) 
Seat 8: oscarleon ($107.14 in chips) 
Seat 9: vrnMike ($116.43 in chips) 
vrnMike: posts small blind $0.50
gwwsb: posts big blind $1
*** HOLE CARDS ***
Dealt to matiko09 [Tc 8s]
azvazdam: raises $1 to $2
matiko09: folds 
TimStone: folds 
Sweden_Pound: folds 
hammerwife: folds 
Zeeshka: raises $7 to $9
oscarleon: folds 
vrnMike: folds 
gwwsb: raises $12 to $21
azvazdam: folds 
Zeeshka: raises $79 to $100 and is all-in
gwwsb: calls $65.51 and is all-in
Uncalled bet ($13.49) returned to Zeeshka
*** FLOP *** [3d Jd Js]
*** TURN *** [3d Jd Js] [2c]
*** RIVER *** [3d Jd Js 2c] [7c]
*** SHOW DOWN ***
gwwsb: shows [Kd Ad] (a pair of Jacks)
Zeeshka: shows [Ks Kh] (two pair, Kings and Jacks)
Zeeshka collected $172.72 from pot
*** SUMMARY ***
Total pot $175.52 | Rake $2.80 
Board [3d Jd Js 2c 7c]
Seat 1: gwwsb (big blind) showed [Kd Ad] and lost with a pair of Jacks
Seat 2: azvazdam folded before Flop
Seat 3: matiko09 folded before Flop (didn't bet)
Seat 4: TimStone folded before Flop (didn't bet)
Seat 5: Sweden_Pound folded before Flop (didn't bet)
Seat 6: hammerwife folded before Flop (didn't bet)
Seat 7: Zeeshka showed [Ks Kh] and won ($172.72) with two pair, Kings and Jacks
Seat 8: oscarleon (button) folded before Flop (didn't bet)
Seat 9: vrnMike (small blind) folded before Flop





PokerStars Hand #148609502126:  Hold'em No Limit ($0.50/$1.00 USD) - 2016/02/11 13:27:58 CET [2016/02/11 7:27:58 ET]
Table 'Clorinde' 9-max Seat #5 is the button
Seat 1: matiko09 ($145.20 in chips) 
Seat 2: 19SERGE74 ($56.65 in chips) 
Seat 3: gabi_igna ($104.75 in chips) 
Seat 4: Sweden_Pound ($101 in chips) 
Seat 5: Mukhin1 ($100 in chips) 
Seat 6: Gcroc52 ($12.93 in chips) 
Seat 7: Zeeshka ($107.31 in chips) 
Seat 8: aseban11 ($129.58 in chips) 
Seat 9: hammerwife ($100 in chips) 
Gcroc52: posts small blind $0.50
Zeeshka: posts big blind $1
*** HOLE CARDS ***
Dealt to matiko09 [Qd Tc]
aseban11: folds 
hammerwife: folds 
matiko09: folds 
19SERGE74: folds 
gabi_igna: folds 
Sweden_Pound: raises $1.50 to $2.50
Mukhin1: raises $5.50 to $8
Gcroc52: folds 
Zeeshka: folds 
Sweden_Pound: folds 
Uncalled bet ($5.50) returned to Mukhin1
Mukhin1 collected $6.50 from pot
Mukhin1: doesn't show hand 
*** SUMMARY ***
Total pot $6.50 | Rake $0 
Seat 1: matiko09 folded before Flop (didn't bet)
Seat 2: 19SERGE74 folded before Flop (didn't bet)
Seat 3: gabi_igna folded before Flop (didn't bet)
Seat 4: Sweden_Pound folded before Flop
Seat 5: Mukhin1 (button) collected ($6.50)
Seat 6: Gcroc52 (small blind) folded before Flop
Seat 7: Zeeshka (big blind) folded before Flop
Seat 8: aseban11 folded before Flop (didn't bet)
Seat 9: hammerwife folded before Flop (didn't bet)





PokerStars Hand #148609502217:  Hold'em No Limit (€0.25/€0.50 EUR) - 2016/02/11 13:27:58 CET [2016/02/11 7:27:58 ET]
Table 'Otero II' 9-max Seat #6 is the button
Seat 1: Effort92 (€51.75 in chips) 
Seat 2: Dantist1122 (€51.50 in chips) 
Seat 3: Szevasztopol (€50 in chips) 
Seat 4: kram0909 (€29.11 in chips) 
Seat 6: TonnaMunz (€50 in chips) 
Seat 7: make6a (€54.25 in chips) 
Seat 8: matiko09 (€67.51 in chips) 
make6a: posts small blind €0.25
matiko09: posts big blind €0.50
Apparat888: sits out 
*** HOLE CARDS ***
Dealt to matiko09 [Ac 5s]
Effort92: folds 
Dantist1122: folds 
Szevasztopol: folds 
kram0909: folds 
TonnaMunz: raises €0.68 to €1.18
make6a: calls €0.93
matiko09: calls €0.68
*** FLOP *** [7h Kh 8c]
make6a: checks 
matiko09: checks 
TonnaMunz: checks 
*** TURN *** [7h Kh 8c] [6s]
make6a: bets €2.54
matiko09: folds 
TonnaMunz: folds 
Uncalled bet (€2.54) returned to make6a
make6a collected €3.38 from pot
make6a: doesn't show hand 
*** SUMMARY ***
Total pot €3.54 | Rake €0.16 
Board [7h Kh 8c 6s]
Seat 1: Effort92 folded before Flop (didn't bet)
Seat 2: Dantist1122 folded before Flop (didn't bet)
Seat 3: Szevasztopol folded before Flop (didn't bet)
Seat 4: kram0909 folded before Flop (didn't bet)
Seat 6: TonnaMunz (button) folded on the Turn
Seat 7: make6a (small blind) collected (€3.38)
Seat 8: matiko09 (big blind) folded on the Turn





PokerStars Hand #148609503280:  Hold'em No Limit ($0.50/$1.00 USD) - 2016/02/11 13:28:00 CET [2016/02/11 7:28:00 ET]
Table 'Marion' 9-max Seat #3 is the button
Seat 1: aseban11 ($100 in chips) 
Seat 2: GusenokRUS ($112.45 in chips) 
Seat 3: TimStone ($100 in chips) 
Seat 4: matiko09 ($102 in chips) 
Seat 5: Rikti ($60.75 in chips) 
Seat 6: 19SERGE74 ($86.40 in chips) 
Seat 7: oscarleon ($106.08 in chips) 
Seat 8: Sweden_Pound ($100 in chips) 
Seat 9: Zeeshka ($100 in chips) 
matiko09: posts small blind $0.50
Rikti: posts big blind $1
*** HOLE CARDS ***
Dealt to matiko09 [Kc 3c]
19SERGE74: folds 
oscarleon: folds 
Sweden_Pound: folds 
Zeeshka: raises $2 to $3
aseban11: folds 
GusenokRUS: folds 
TimStone: folds 
matiko09: folds 
Rikti: folds 
Uncalled bet ($2) returned to Zeeshka
Zeeshka collected $2.50 from pot
Zeeshka: doesn't show hand 
*** SUMMARY ***
Total pot $2.50 | Rake $0 
Seat 1: aseban11 folded before Flop (didn't bet)
Seat 2: GusenokRUS folded before Flop (didn't bet)
Seat 3: TimStone (button) folded before Flop (didn't bet)
Seat 4: matiko09 (small blind) folded before Flop
Seat 5: Rikti (big blind) folded before Flop
Seat 6: 19SERGE74 folded before Flop (didn't bet)
Seat 7: oscarleon folded before Flop (didn't bet)
Seat 8: Sweden_Pound folded before Flop (didn't bet)
Seat 9: Zeeshka collected ($2.50)





PokerStars Hand #148609504295:  Hold'em No Limit ($0.50/$1.00 USD) - 2016/02/11 13:28:02 CET [2016/02/11 7:28:02 ET]
Table 'Gianfar' 9-max Seat #4 is the button
Seat 1: Vikulja1993 ($100 in chips) 
Seat 2: bilukm ($106.04 in chips) 
Seat 3: AlKatrone ($169.89 in chips) 
Seat 4: matiko09 ($133.98 in chips) 
Seat 5: hammerwife ($153.29 in chips) 
Seat 6: Sweden_Pound ($107.52 in chips) 
Seat 7: Rikti ($36 in chips) 
Seat 8: Zeeshka ($100 in chips) 
Seat 9: oscarleon ($137.66 in chips) 
hammerwife: posts small blind $0.50
Sweden_Pound: posts big blind $1
*** HOLE CARDS ***
Dealt to matiko09 [5d 8c]
Rikti: folds 
Zeeshka: folds 
oscarleon: folds 
Vikulja1993: folds 
bilukm: folds 
AlKatrone: raises $1.50 to $2.50
matiko09: folds 
hammerwife: folds 
Sweden_Pound: folds 
Uncalled bet ($1.50) returned to AlKatrone
AlKatrone collected $2.50 from pot
AlKatrone: doesn't show hand 
*** SUMMARY ***
Total pot $2.50 | Rake $0 
Seat 1: Vikulja1993 folded before Flop (didn't bet)
Seat 2: bilukm folded before Flop (didn't bet)
Seat 3: AlKatrone collected ($2.50)
Seat 4: matiko09 (button) folded before Flop (didn't bet)
Seat 5: hammerwife (small blind) folded before Flop
Seat 6: Sweden_Pound (big blind) folded before Flop
Seat 7: Rikti folded before Flop (didn't bet)
Seat 8: Zeeshka folded before Flop (didn't bet)
Seat 9: oscarleon folded before Flop (didn't bet)





PokerStars Hand #148609516672:  Hold'em No Limit ($0.50/$1.00 USD) - 2016/02/11 13:28:23 CET [2016/02/11 7:28:23 ET]
Table 'Stephano V' 9-max Seat #7 is the button
Seat 1: hammerwife ($107.75 in chips) 
Seat 2: matiko09 ($143.34 in chips) 
Seat 4: Zeeshka ($121.82 in chips) 
Seat 5: n2call ($242.63 in chips) 
Seat 6: Sweden_Pound ($100.50 in chips) 
Seat 7: hurtNCYDE ($100 in chips) 
Seat 8: oscarleon ($230.63 in chips) 
Seat 9: IcocaynaI ($33.59 in chips) 
oscarleon: posts small blind $0.50
IcocaynaI: posts big blind $1
DUkalisUA: sits out 
*** HOLE CARDS ***
Dealt to matiko09 [2s 8h]
hammerwife: folds 
matiko09: folds 
Zeeshka: folds 
n2call: folds 
Sweden_Pound: raises $1.50 to $2.50
hurtNCYDE: folds 
oscarleon: folds 
IcocaynaI: calls $1.50
*** FLOP *** [As Ac 7s]
IcocaynaI: bets $2
Sweden_Pound: folds 
Uncalled bet ($2) returned to IcocaynaI
IcocaynaI collected $5.25 from pot
IcocaynaI: doesn't show hand 
*** SUMMARY ***
Total pot $5.50 | Rake $0.25 
Board [As Ac 7s]
Seat 1: hammerwife folded before Flop (didn't bet)
Seat 2: matiko09 folded before Flop (didn't bet)
Seat 4: Zeeshka folded before Flop (didn't bet)
Seat 5: n2call folded before Flop (didn't bet)
Seat 6: Sweden_Pound folded on the Flop
Seat 7: hurtNCYDE (button) folded before Flop (didn't bet)
Seat 8: oscarleon (small blind) folded before Flop
Seat 9: IcocaynaI (big blind) collected ($5.25)





PokerStars Hand #148609534178:  Hold'em No Limit ($0.50/$1.00 USD) - 2016/02/11 13:28:52 CET [2016/02/11 7:28:52 ET]
Table 'Marion' 9-max Seat #4 is the button
Seat 1: aseban11 ($100 in chips) 
Seat 2: GusenokRUS ($112.45 in chips) 
Seat 3: TimStone ($100 in chips) 
Seat 4: matiko09 ($101.50 in chips) 
Seat 5: Rikti ($59.75 in chips) 
Seat 6: 19SERGE74 ($86.40 in chips) 
Seat 7: oscarleon ($106.08 in chips) 
Seat 8: Sweden_Pound ($100 in chips) 
Seat 9: Zeeshka ($101.50 in chips) 
Rikti: posts small blind $0.50
19SERGE74: posts big blind $1
*** HOLE CARDS ***
Dealt to matiko09 [7c 9d]
oscarleon: folds 
Sweden_Pound has timed out
Sweden_Pound: folds 
Zeeshka: folds 
aseban11: folds 
GusenokRUS: folds 
TimStone: folds 
matiko09: folds 
Rikti: raises $1.50 to $2.50
19SERGE74: calls $1.50
*** FLOP *** [3c 8s 2c]
Rikti: checks 
19SERGE74: checks 
*** TURN *** [3c 8s 2c] [Jd]
Rikti: checks 
19SERGE74: bets $3
Rikti: folds 
Uncalled bet ($3) returned to 19SERGE74
19SERGE74 collected $4.78 from pot
19SERGE74: doesn't show hand 
*** SUMMARY ***
Total pot $5 | Rake $0.22 
Board [3c 8s 2c Jd]
Seat 1: aseban11 folded before Flop (didn't bet)
Seat 2: GusenokRUS folded before Flop (didn't bet)
Seat 3: TimStone folded before Flop (didn't bet)
Seat 4: matiko09 (button) folded before Flop (didn't bet)
Seat 5: Rikti (small blind) folded on the Turn
Seat 6: 19SERGE74 (big blind) collected ($4.78)
Seat 7: oscarleon folded before Flop (didn't bet)
Seat 8: Sweden_Pound folded before Flop (didn't bet)
Seat 9: Zeeshka folded before Flop (didn't bet)





PokerStars Hand #148609537314:  Hold'em No Limit ($0.50/$1.00 USD) - 2016/02/11 13:28:57 CET [2016/02/11 7:28:57 ET]
Table 'Clorinde' 9-max Seat #6 is the button
Seat 1: matiko09 ($145.20 in chips) 
Seat 2: 19SERGE74 ($56.65 in chips) 
Seat 3: gabi_igna ($104.75 in chips) 
Seat 4: Sweden_Pound ($100 in chips) 
Seat 5: Mukhin1 ($104 in chips) 
Seat 6: Gcroc52 ($12.43 in chips) 
Seat 7: Zeeshka ($106.31 in chips) 
Seat 8: aseban11 ($129.58 in chips) 
Seat 9: hammerwife ($100 in chips) 
Zeeshka: posts small blind $0.50
aseban11: posts big blind $1
*** HOLE CARDS ***
Dealt to matiko09 [5s 9c]
hammerwife: raises $2 to $3
matiko09: folds 
19SERGE74: folds 
gabi_igna: folds 
Sweden_Pound: folds 
Mukhin1: folds 
Gcroc52: folds 
Zeeshka: folds 
aseban11: folds 
Uncalled bet ($2) returned to hammerwife
hammerwife collected $2.50 from pot
hammerwife: doesn't show hand 
*** SUMMARY ***
Total pot $2.50 | Rake $0 
Seat 1: matiko09 folded before Flop (didn't bet)
Seat 2: 19SERGE74 folded before Flop (didn't bet)
Seat 3: gabi_igna folded before Flop (didn't bet)
Seat 4: Sweden_Pound folded before Flop (didn't bet)
Seat 5: Mukhin1 folded before Flop (didn't bet)
Seat 6: Gcroc52 (button) folded before Flop (didn't bet)
Seat 7: Zeeshka (small blind) folded before Flop
Seat 8: aseban11 (big blind) folded before Flop
Seat 9: hammerwife collected ($2.50)





PokerStars Hand #148609538951:  Hold'em No Limit ($0.50/$1.00 USD) - 2016/02/11 13:29:00 CET [2016/02/11 7:29:00 ET]
Table 'Gianfar' 9-max Seat #5 is the button
Seat 1: Vikulja1993 ($100 in chips) 
Seat 2: bilukm ($106.04 in chips) 
Seat 3: AlKatrone ($171.39 in chips) 
Seat 4: matiko09 ($133.98 in chips) 
Seat 5: hammerwife ($152.79 in chips) 
Seat 6: Sweden_Pound ($106.52 in chips) 
Seat 7: Rikti ($36 in chips) 
Seat 8: Zeeshka ($100 in chips) 
Seat 9: oscarleon ($137.66 in chips) 
Sweden_Pound: posts small blind $0.50
Rikti: posts big blind $1
*** HOLE CARDS ***
Dealt to matiko09 [Td As]
Zeeshka: raises $2 to $3
oscarleon: folds 
Vikulja1993: folds 
bilukm: calls $3
AlKatrone: folds 
matiko09: folds 
hammerwife: folds 
Sweden_Pound: folds 
Rikti: folds 
*** FLOP *** [8h 6d 8d]
Zeeshka: checks 
bilukm: bets $3.58
Zeeshka: folds 
Uncalled bet ($3.58) returned to bilukm
bilukm collected $7.16 from pot
bilukm: doesn't show hand 
*** SUMMARY ***
Total pot $7.50 | Rake $0.34 
Board [8h 6d 8d]
Seat 1: Vikulja1993 folded before Flop (didn't bet)
Seat 2: bilukm collected ($7.16)
Seat 3: AlKatrone folded before Flop (didn't bet)
Seat 4: matiko09 folded before Flop (didn't bet)
Seat 5: hammerwife (button) folded before Flop (didn't bet)
Seat 6: Sweden_Pound (small blind) folded before Flop
Seat 7: Rikti (big blind) folded before Flop
Seat 8: Zeeshka folded on the Flop
Seat 9: oscarleon folded before Flop (didn't bet)





PokerStars Hand #148609540293:  Hold'em No Limit ($0.25/$0.50 USD) - 2016/02/11 13:29:02 CET [2016/02/11 7:29:02 ET]
Table 'Ambrosia II' 9-max Seat #1 is the button
Seat 1: matiko09 ($50 in chips) 
Seat 2: JJJ-K9 ($61.46 in chips) 
Seat 3: make6a ($77.18 in chips) 
Seat 4: huudk2016 ($27.22 in chips) 
Seat 5: RICKA16 ($61.63 in chips) 
Seat 6: Reven9er ($61.51 in chips) 
Seat 7: Ana.Satravca ($66 in chips) 
Seat 8: Dantist1122 ($50 in chips) 
Seat 9: arctur17 ($50 in chips) 
JJJ-K9: posts small blind $0.25
make6a: posts big blind $0.50
arctur17: posts small & big blinds $0.75
*** HOLE CARDS ***
Dealt to matiko09 [9d 3h]
huudk2016: calls $0.50
RICKA16: folds 
Reven9er: folds 
Ana.Satravca: folds 
Dantist1122: folds 
arctur17: checks 
matiko09: folds 
JJJ-K9: calls $0.25
make6a: raises $3 to $3.50
huudk2016: folds 
arctur17: calls $3
JJJ-K9: folds 
*** FLOP *** [As 5c 6s]
make6a: bets $5.25
arctur17: folds 
Uncalled bet ($5.25) returned to make6a
make6a collected $7.88 from pot
make6a: doesn't show hand 
*** SUMMARY ***
Total pot $8.25 | Rake $0.37 
Board [As 5c 6s]
Seat 1: matiko09 (button) folded before Flop (didn't bet)
Seat 2: JJJ-K9 (small blind) folded before Flop
Seat 3: make6a (big blind) collected ($7.88)
Seat 4: huudk2016 folded before Flop
Seat 5: RICKA16 folded before Flop (didn't bet)
Seat 6: Reven9er folded before Flop (didn't bet)
Seat 7: Ana.Satravca folded before Flop (didn't bet)
Seat 8: Dantist1122 folded before Flop (didn't bet)
Seat 9: arctur17 folded on the Flop





PokerStars Hand #148609543108:  Hold'em No Limit ($0.50/$1.00 USD) - 2016/02/11 13:29:07 CET [2016/02/11 7:29:07 ET]
Table 'Kleopatra II' 9-max Seat #9 is the button
Seat 2: azvazdam ($70.50 in chips) 
Seat 3: matiko09 ($103.50 in chips) 
Seat 4: TimStone ($102.50 in chips) 
Seat 5: Sweden_Pound ($110.73 in chips) 
Seat 6: hammerwife ($172.85 in chips) 
Seat 7: Zeeshka ($186.21 in chips) 
Seat 8: oscarleon ($107.14 in chips) 
Seat 9: vrnMike ($115.93 in chips) 
azvazdam: posts small blind $0.50
matiko09: posts big blind $1
*** HOLE CARDS ***
Dealt to matiko09 [8s 2s]
TimStone: folds 
gwwsb leaves the table
AlKatrone joins the table at seat #1 
AlKatrone leaves the table
DUkalisUA joins the table at seat #1 
Sweden_Pound: folds 
hammerwife: folds 
Zeeshka: raises $2 to $3
oscarleon: folds 
vrnMike: folds 
azvazdam: calls $2.50
matiko09: folds 
*** FLOP *** [Td 7s Ac]
azvazdam: checks 
Zeeshka: checks 
*** TURN *** [Td 7s Ac] [6c]
azvazdam: bets $2
Zeeshka: calls $2
*** RIVER *** [Td 7s Ac 6c] [Jc]
azvazdam: checks 
Zeeshka: bets $7.03
azvazdam: calls $7.03
*** SHOW DOWN ***
Zeeshka: shows [Qs Ks] (a straight, Ten to Ace)
azvazdam: mucks hand 
Zeeshka collected $23.93 from pot
*** SUMMARY ***
Total pot $25.06 | Rake $1.13 
Board [Td 7s Ac 6c Jc]
Seat 2: azvazdam (small blind) mucked [Kd Ts]
Seat 3: matiko09 (big blind) folded before Flop
Seat 4: TimStone folded before Flop (didn't bet)
Seat 5: Sweden_Pound folded before Flop (didn't bet)
Seat 6: hammerwife folded before Flop (didn't bet)
Seat 7: Zeeshka showed [Qs Ks] and won ($23.93) with a straight, Ten to Ace
Seat 8: oscarleon folded before Flop (didn't bet)
Seat 9: vrnMike (button) folded before Flop (didn't bet)





PokerStars Hand #148609543577:  Hold'em No Limit ($0.25/$0.50 USD) - 2016/02/11 13:29:08 CET [2016/02/11 7:29:08 ET]
Table 'Stereoskopia' 9-max Seat #7 is the button
Seat 2: Dantist1122 ($55.25 in chips) 
Seat 3: fandorin2005 ($50 in chips) 
Seat 4: Anikin44 ($38.15 in chips) 
Seat 5: afrodit71 ($20.12 in chips) 
Seat 6: matiko09 ($53.63 in chips) 
Seat 7: Serhent ($57.27 in chips) 
Seat 8: Reven9er ($50 in chips) 
Seat 9: nastynate075 ($20.43 in chips) 
Reven9er: posts small blind $0.25
nastynate075: posts big blind $0.50
FoRvvArD_go: sits out 
*** HOLE CARDS ***
Dealt to matiko09 [3s Qd]
Dantist1122: folds 
fandorin2005: folds 
Anikin44: folds 
afrodit71: folds 
matiko09: folds 
Serhent: raises $0.58 to $1.08
Reven9er: folds 
nastynate075: calls $0.58
*** FLOP *** [5s 3h 6d]
nastynate075: checks 
Serhent: bets $1.47
nastynate075: calls $1.47
*** TURN *** [5s 3h 6d] [Th]
nastynate075: checks 
Serhent: checks 
*** RIVER *** [5s 3h 6d Th] [Kd]
nastynate075: checks 
Serhent: bets $3.27
nastynate075: calls $3.27
*** SHOW DOWN ***
Serhent: shows [Qs Kc] (a pair of Kings)
nastynate075: mucks hand 
Serhent collected $11.35 from pot
*** SUMMARY ***
Total pot $11.89 | Rake $0.54 
Board [5s 3h 6d Th Kd]
Seat 2: Dantist1122 folded before Flop (didn't bet)
Seat 3: fandorin2005 folded before Flop (didn't bet)
Seat 4: Anikin44 folded before Flop (didn't bet)
Seat 5: afrodit71 folded before Flop (didn't bet)
Seat 6: matiko09 folded before Flop (didn't bet)
Seat 7: Serhent (button) showed [Qs Kc] and won ($11.35) with a pair of Kings
Seat 8: Reven9er (small blind) folded before Flop
Seat 9: nastynate075 (big blind) mucked [6s 4h]





PokerStars Hand #148609543808:  Hold'em No Limit (€0.25/€0.50 EUR) - 2016/02/11 13:29:08 CET [2016/02/11 7:29:08 ET]
Table 'Otero II' 9-max Seat #7 is the button
Seat 1: Effort92 (€51.75 in chips) 
Seat 2: Dantist1122 (€51.50 in chips) 
Seat 3: Szevasztopol (€50 in chips) 
Seat 4: kram0909 (€29.11 in chips) 
Seat 6: TonnaMunz (€50 in chips) 
Seat 7: make6a (€56.45 in chips) 
Seat 8: matiko09 (€66.33 in chips) 
Seat 9: Apparat888 (€26 in chips) 
matiko09: posts small blind €0.25
Apparat888: posts big blind €0.50
*** HOLE CARDS ***
Dealt to matiko09 [2h Th]
Effort92: folds 
Dantist1122: raises €1 to €1.50
Szevasztopol: calls €1.50
kram0909: folds 
TonnaMunz: calls €1.50
make6a: folds 
matiko09: folds 
Apparat888: folds 
*** FLOP *** [4s 6h Jh]
Dantist1122: checks 
Szevasztopol: bets €3
TonnaMunz: calls €3
Dantist1122: folds 
*** TURN *** [4s 6h Jh] [Kh]
Szevasztopol: bets €7
TonnaMunz: folds 
Uncalled bet (€7) returned to Szevasztopol
Szevasztopol collected €10.74 from pot
Szevasztopol: doesn't show hand 
*** SUMMARY ***
Total pot €11.25 | Rake €0.51 
Board [4s 6h Jh Kh]
Seat 1: Effort92 folded before Flop (didn't bet)
Seat 2: Dantist1122 folded on the Flop
Seat 3: Szevasztopol collected (€10.74)
Seat 4: kram0909 folded before Flop (didn't bet)
Seat 6: TonnaMunz folded on the Turn
Seat 7: make6a (button) folded before Flop (didn't bet)
Seat 8: matiko09 (small blind) folded before Flop
Seat 9: Apparat888 (big blind) folded before Flop





PokerStars Hand #148609545779:  Hold'em No Limit ($0.25/$0.50 USD) - 2016/02/11 13:29:12 CET [2016/02/11 7:29:12 ET]
Table 'Sylvania II' 9-max Seat #9 is the button
Seat 2: Effort92 ($65.09 in chips) 
Seat 3: ruyingren ($205.81 in chips) 
Seat 4: matiko09 ($119.57 in chips) 
Seat 5: vlad11122007 ($57.26 in chips) 
Seat 6: TonnaMunz ($129.76 in chips) 
Seat 7: 2lefthand75 ($65.40 in chips) 
Seat 8: Apparat888 ($48.95 in chips) 
Seat 9: udden82 ($54.55 in chips) 
tw0315 will be allowed to play after the button
Effort92: posts small blind $0.25
ruyingren: posts big blind $0.50
Effort92: posts the ante $0.10
ruyingren: posts the ante $0.10
matiko09: posts the ante $0.10
vlad11122007: posts the ante $0.10
TonnaMunz: posts the ante $0.10
2lefthand75: posts the ante $0.10
Apparat888: posts the ante $0.10
udden82: posts the ante $0.10
*** HOLE CARDS ***
Dealt to matiko09 [Ad 8h]
matiko09: folds 
vlad11122007: folds 
TonnaMunz: folds 
2lefthand75: calls $0.50
Apparat888: folds 
udden82: folds 
Effort92: folds 
ruyingren: raises $3 to $3.50
2lefthand75: calls $3
*** FLOP *** [7d 5s 3c]
ruyingren: bets $8
2lefthand75: folds 
Uncalled bet ($8) returned to ruyingren
ruyingren collected $7.69 from pot
ruyingren: doesn't show hand 
*** SUMMARY ***
Total pot $8.05 | Rake $0.36 
Board [7d 5s 3c]
Seat 2: Effort92 (small blind) folded before Flop
Seat 3: ruyingren (big blind) collected ($7.69)
Seat 4: matiko09 folded before Flop (didn't bet)
Seat 5: vlad11122007 folded before Flop (didn't bet)
Seat 6: TonnaMunz folded before Flop (didn't bet)
Seat 7: 2lefthand75 folded on the Flop
Seat 8: Apparat888 folded before Flop (didn't bet)
Seat 9: udden82 (button) folded before Flop (didn't bet)





PokerStars Hand #148609550803:  Hold'em No Limit ($0.50/$1.00 USD) - 2016/02/11 13:29:20 CET [2016/02/11 7:29:20 ET]
Table 'Stephano V' 9-max Seat #8 is the button
Seat 1: hammerwife ($107.75 in chips) 
Seat 2: matiko09 ($143.34 in chips) 
Seat 4: Zeeshka ($121.82 in chips) 
Seat 5: n2call ($242.63 in chips) 
Seat 6: Sweden_Pound ($100 in chips) 
Seat 7: hurtNCYDE ($100 in chips) 
Seat 8: oscarleon ($230.13 in chips) 
Seat 9: IcocaynaI ($36.34 in chips) 
IcocaynaI: posts small blind $0.50
hammerwife: posts big blind $1
DUkalisUA: sits out 
*** HOLE CARDS ***
Dealt to matiko09 [7h 2c]
matiko09: folds 
Zeeshka: folds 
n2call: folds 
Sweden_Pound: raises $2 to $3
hurtNCYDE: folds 
oscarleon: folds 
IcocaynaI: folds 
hammerwife: folds 
Uncalled bet ($2) returned to Sweden_Pound
Sweden_Pound collected $2.50 from pot
Sweden_Pound: doesn't show hand 
*** SUMMARY ***
Total pot $2.50 | Rake $0 
Seat 1: hammerwife (big blind) folded before Flop
Seat 2: matiko09 folded before Flop (didn't bet)
Seat 4: Zeeshka folded before Flop (didn't bet)
Seat 5: n2call folded before Flop (didn't bet)
Seat 6: Sweden_Pound collected ($2.50)
Seat 7: hurtNCYDE folded before Flop (didn't bet)
Seat 8: oscarleon (button) folded before Flop (didn't bet)
Seat 9: IcocaynaI (small blind) folded before Flop





PokerStars Hand #148609560944:  Hold'em No Limit ($0.50/$1.00 USD) - 2016/02/11 13:29:37 CET [2016/02/11 7:29:37 ET]
Table 'Clorinde' 9-max Seat #7 is the button
Seat 1: matiko09 ($145.20 in chips) 
Seat 2: 19SERGE74 ($56.65 in chips) 
Seat 3: gabi_igna ($104.75 in chips) 
Seat 4: Sweden_Pound ($100 in chips) 
Seat 5: Mukhin1 ($104 in chips) 
Seat 6: Gcroc52 ($12.43 in chips) 
Seat 7: Zeeshka ($105.81 in chips) 
Seat 8: aseban11 ($128.58 in chips) 
Seat 9: hammerwife ($101.50 in chips) 
aseban11: posts small blind $0.50
hammerwife: posts big blind $1
*** HOLE CARDS ***
Dealt to matiko09 [Ac 4c]
matiko09: folds 
19SERGE74: folds 
gabi_igna: folds 
Sweden_Pound: folds 
Mukhin1: folds 
Gcroc52: folds 
Zeeshka: raises $1.50 to $2.50
aseban11: raises $6.50 to $9
hammerwife: folds 
Zeeshka: calls $6.50
*** FLOP *** [6h 7c 5s]
aseban11: checks 
Zeeshka: checks 
*** TURN *** [6h 7c 5s] [Kc]
aseban11: bets $12.50
Zeeshka: calls $12.50
*** RIVER *** [6h 7c 5s Kc] [2h]
aseban11: checks 
Zeeshka: checks 
*** SHOW DOWN ***
aseban11: shows [8d 8c] (a pair of Eights)
Zeeshka: shows [Qd Kh] (a pair of Kings)
Zeeshka collected $42.02 from pot
*** SUMMARY ***
Total pot $44 | Rake $1.98 
Board [6h 7c 5s Kc 2h]
Seat 1: matiko09 folded before Flop (didn't bet)
Seat 2: 19SERGE74 folded before Flop (didn't bet)
Seat 3: gabi_igna folded before Flop (didn't bet)
Seat 4: Sweden_Pound folded before Flop (didn't bet)
Seat 5: Mukhin1 folded before Flop (didn't bet)
Seat 6: Gcroc52 folded before Flop (didn't bet)
Seat 7: Zeeshka (button) showed [Qd Kh] and won ($42.02) with a pair of Kings
Seat 8: aseban11 (small blind) showed [8d 8c] and lost with a pair of Eights
Seat 9: hammerwife (big blind) folded before Flop





PokerStars Hand #148609572212:  Hold'em No Limit ($0.25/$0.50 USD) - 2016/02/11 13:29:56 CET [2016/02/11 7:29:56 ET]
Table 'Sylvania II' 9-max Seat #2 is the button
Seat 1: tw0315 ($179.34 in chips) 
Seat 2: Effort92 ($64.74 in chips) 
Seat 3: ruyingren ($209.90 in chips) 
Seat 4: matiko09 ($124.90 in chips) 
Seat 5: vlad11122007 ($57.16 in chips) 
Seat 6: TonnaMunz ($129.66 in chips) 
Seat 7: 2lefthand75 ($61.80 in chips) 
Seat 8: Apparat888 ($48.85 in chips) 
Seat 9: udden82 ($54.45 in chips) 
ruyingren: posts small blind $0.25
matiko09: posts big blind $0.50
tw0315: posts small & big blinds $0.75
tw0315: posts the ante $0.10
Effort92: posts the ante $0.10
ruyingren: posts the ante $0.10
matiko09: posts the ante $0.10
vlad11122007: posts the ante $0.10
TonnaMunz: posts the ante $0.10
2lefthand75: posts the ante $0.10
Apparat888: posts the ante $0.10
udden82: posts the ante $0.10
*** HOLE CARDS ***
Dealt to matiko09 [3h Jd]
vlad11122007: folds 
TonnaMunz: folds 
2lefthand75: calls $0.50
Apparat888: folds 
udden82: folds 
tw0315: raises $0.50 to $1
Effort92: calls $1
ruyingren: folds 
matiko09: folds 
2lefthand75: calls $0.50
*** FLOP *** [Ad Jh Kc]
2lefthand75: checks 
tw0315: checks 
Effort92: checks 
*** TURN *** [Ad Jh Kc] [4h]
2lefthand75: checks 
tw0315: checks 
Effort92: bets $3.51
2lefthand75: calls $3.51
tw0315: calls $3.51
*** RIVER *** [Ad Jh Kc 4h] [3s]
2lefthand75: bets $7.37
tw0315: folds 
Effort92: raises $14.63 to $22
2lefthand75: calls $14.63
*** SHOW DOWN ***
Effort92: shows [4s As] (two pair, Aces and Fours)
2lefthand75: mucks hand 
Effort92 collected $56.93 from pot
*** SUMMARY ***
Total pot $59.43 | Rake $2.50 
Board [Ad Jh Kc 4h 3s]
Seat 1: tw0315 folded on the River
Seat 2: Effort92 (button) showed [4s As] and won ($56.93) with two pair, Aces and Fours
Seat 3: ruyingren (small blind) folded before Flop
Seat 4: matiko09 (big blind) folded before Flop
Seat 5: vlad11122007 folded before Flop (didn't bet)
Seat 6: TonnaMunz folded before Flop (didn't bet)
Seat 7: 2lefthand75 mucked [3d 4d]
Seat 8: Apparat888 folded before Flop (didn't bet)
Seat 9: udden82 folded before Flop (didn't bet)





PokerStars Hand #148609582540:  Hold'em No Limit ($0.50/$1.00 USD) - 2016/02/11 13:30:13 CET [2016/02/11 7:30:13 ET]
Table 'Stephano V' 9-max Seat #9 is the button
Seat 1: hammerwife ($106.75 in chips) 
Seat 2: matiko09 ($143.34 in chips) 
Seat 4: Zeeshka ($121.82 in chips) 
Seat 5: n2call ($242.63 in chips) 
Seat 6: Sweden_Pound ($101.50 in chips) 
Seat 7: hurtNCYDE ($100 in chips) 
Seat 8: oscarleon ($230.13 in chips) 
Seat 9: IcocaynaI ($35.84 in chips) 
hammerwife: posts small blind $0.50
matiko09: posts big blind $1
DUkalisUA: sits out 
*** HOLE CARDS ***
Dealt to matiko09 [3d Kh]
Zeeshka: folds 
n2call: folds 
Sweden_Pound: folds 
hurtNCYDE: folds 
oscarleon: folds 
IcocaynaI: folds 
hammerwife: raises $1.60 to $2.60
matiko09: folds 
Uncalled bet ($1.60) returned to hammerwife
hammerwife collected $2 from pot
hammerwife: doesn't show hand 
*** SUMMARY ***
Total pot $2 | Rake $0 
Seat 1: hammerwife (small blind) collected ($2)
Seat 2: matiko09 (big blind) folded before Flop
Seat 4: Zeeshka folded before Flop (didn't bet)
Seat 5: n2call folded before Flop (didn't bet)
Seat 6: Sweden_Pound folded before Flop (didn't bet)
Seat 7: hurtNCYDE folded before Flop (didn't bet)
Seat 8: oscarleon folded before Flop (didn't bet)
Seat 9: IcocaynaI (button) folded before Flop (didn't bet)





PokerStars Hand #148609581987:  Hold'em No Limit ($0.25/$0.50 USD) - 2016/02/11 13:30:13 CET [2016/02/11 7:30:13 ET]
Table 'Stereoskopia' 9-max Seat #8 is the button
Seat 1: FoRvvArD_go ($50 in chips) 
Seat 2: Dantist1122 ($55.25 in chips) 
Seat 3: fandorin2005 ($50 in chips) 
Seat 4: Anikin44 ($38.15 in chips) 
Seat 5: afrodit71 ($20.12 in chips) 
Seat 6: matiko09 ($53.63 in chips) 
Seat 7: Serhent ($62.80 in chips) 
Seat 8: Reven9er ($50 in chips) 
Seat 9: nastynate075 ($14.61 in chips) 
nastynate075: posts small blind $0.25
FoRvvArD_go: posts big blind $0.50
*** HOLE CARDS ***
Dealt to matiko09 [Kd 4d]
Dantist1122: folds 
fandorin2005: folds 
Anikin44: folds 
afrodit71: calls $0.50
matiko09: folds 
Serhent: folds 
Reven9er: raises $0.75 to $1.25
nastynate075: folds 
FoRvvArD_go: calls $0.75
afrodit71: calls $0.75
*** FLOP *** [4c Jc 5c]
FoRvvArD_go: checks 
afrodit71: checks 
Reven9er: bets $2
FoRvvArD_go: folds 
afrodit71: calls $2
*** TURN *** [4c Jc 5c] [As]
afrodit71: checks 
Reven9er: bets $3
afrodit71: calls $3
*** RIVER *** [4c Jc 5c As] [9d]
afrodit71: checks 
Reven9er: checks 
*** SHOW DOWN ***
afrodit71: shows [4s Ac] (two pair, Aces and Fours)
Reven9er: mucks hand 
afrodit71 collected $13.37 from pot
*** SUMMARY ***
Total pot $14 | Rake $0.63 
Board [4c Jc 5c As 9d]
Seat 1: FoRvvArD_go (big blind) folded on the Flop
Seat 2: Dantist1122 folded before Flop (didn't bet)
Seat 3: fandorin2005 folded before Flop (didn't bet)
Seat 4: Anikin44 folded before Flop (didn't bet)
Seat 5: afrodit71 showed [4s Ac] and won ($13.37) with two pair, Aces and Fours
Seat 6: matiko09 folded before Flop (didn't bet)
Seat 7: Serhent folded before Flop (didn't bet)
Seat 8: Reven9er (button) mucked [Jd 8d]
Seat 9: nastynate075 (small blind) folded before Flop





PokerStars Hand #148609590324:  Hold'em No Limit ($0.50/$1.00 USD) - 2016/02/11 13:30:26 CET [2016/02/11 7:30:26 ET]
Table 'Marion' 9-max Seat #5 is the button
Seat 1: aseban11 ($100 in chips) 
Seat 2: GusenokRUS ($112.45 in chips) 
Seat 3: TimStone ($100 in chips) 
Seat 4: matiko09 ($101.50 in chips) 
Seat 5: Rikti ($57.25 in chips) 
Seat 6: 19SERGE74 ($88.68 in chips) 
Seat 7: oscarleon ($106.08 in chips) 
Seat 8: Sweden_Pound ($100 in chips) 
Seat 9: Zeeshka ($101.50 in chips) 
19SERGE74: posts small blind $0.50
oscarleon: posts big blind $1
*** HOLE CARDS ***
Dealt to matiko09 [4c 4h]
Sweden_Pound: folds 
Zeeshka: folds 
aseban11: raises $1.50 to $2.50
GusenokRUS: folds 
TimStone: folds 
matiko09: folds 
Rikti: folds 
19SERGE74: folds 
oscarleon: folds 
Uncalled bet ($1.50) returned to aseban11
aseban11 collected $2.50 from pot
aseban11: doesn't show hand 
*** SUMMARY ***
Total pot $2.50 | Rake $0 
Seat 1: aseban11 collected ($2.50)
Seat 2: GusenokRUS folded before Flop (didn't bet)
Seat 3: TimStone folded before Flop (didn't bet)
Seat 4: matiko09 folded before Flop (didn't bet)
Seat 5: Rikti (button) folded before Flop (didn't bet)
Seat 6: 19SERGE74 (small blind) folded before Flop
Seat 7: oscarleon (big blind) folded before Flop
Seat 8: Sweden_Pound folded before Flop (didn't bet)
Seat 9: Zeeshka folded before Flop (didn't bet)





PokerStars Hand #148609590208:  Hold'em No Limit ($0.50/$1.00 USD) - 2016/02/11 13:30:26 CET [2016/02/11 7:30:26 ET]
Table 'Gianfar' 9-max Seat #6 is the button
Seat 1: Vikulja1993 ($100 in chips) 
Seat 2: bilukm ($110.20 in chips) 
Seat 3: AlKatrone ($171.39 in chips) 
Seat 4: matiko09 ($133.98 in chips) 
Seat 5: hammerwife ($152.79 in chips) 
Seat 6: Sweden_Pound ($106.02 in chips) 
Seat 7: Rikti ($35 in chips) 
Seat 8: Zeeshka ($100 in chips) 
Seat 9: oscarleon ($137.66 in chips) 
Rikti: posts small blind $0.50
Zeeshka: posts big blind $1
*** HOLE CARDS ***
Dealt to matiko09 [9c 6c]
oscarleon: folds 
Vikulja1993: folds 
bilukm: folds 
AlKatrone: folds 
matiko09: folds 
hammerwife: folds 
Sweden_Pound: raises $1 to $2
Rikti: folds 
Zeeshka: calls $1
*** FLOP *** [7d Ks 9h]
Zeeshka: checks 
Sweden_Pound: checks 
*** TURN *** [7d Ks 9h] [Ts]
Zeeshka: bets $3.22
Sweden_Pound: raises $7.78 to $11
Zeeshka: calls $7.78
*** RIVER *** [7d Ks 9h Ts] [As]
Zeeshka: checks 
Sweden_Pound: checks 
*** SHOW DOWN ***
Zeeshka: shows [8c 6h] (a straight, Six to Ten)
Sweden_Pound: mucks hand 
Zeeshka collected $25.31 from pot
*** SUMMARY ***
Total pot $26.50 | Rake $1.19 
Board [7d Ks 9h Ts As]
Seat 1: Vikulja1993 folded before Flop (didn't bet)
Seat 2: bilukm folded before Flop (didn't bet)
Seat 3: AlKatrone folded before Flop (didn't bet)
Seat 4: matiko09 folded before Flop (didn't bet)
Seat 5: hammerwife folded before Flop (didn't bet)
Seat 6: Sweden_Pound (button) mucked [7h Th]
Seat 7: Rikti (small blind) folded before Flop
Seat 8: Zeeshka (big blind) showed [8c 6h] and won ($25.31) with a straight, Six to Ten
Seat 9: oscarleon folded before Flop (didn't bet)





PokerStars Hand #148609593086:  Hold'em No Limit ($0.50/$1.00 USD) - 2016/02/11 13:30:31 CET [2016/02/11 7:30:31 ET]
Table 'Kleopatra II' 9-max Seat #2 is the button
Seat 2: azvazdam ($58.47 in chips) 
Seat 3: matiko09 ($102.50 in chips) 
Seat 4: TimStone ($102.50 in chips) 
Seat 5: Sweden_Pound ($110.73 in chips) 
Seat 6: hammerwife ($172.85 in chips) 
Seat 7: Zeeshka ($198.11 in chips) 
Seat 8: oscarleon ($107.14 in chips) 
Seat 9: vrnMike ($115.93 in chips) 
matiko09: posts small blind $0.50
TimStone: posts big blind $1
DUkalisUA: sits out 
*** HOLE CARDS ***
Dealt to matiko09 [Jd Ad]
Sweden_Pound: folds 
hammerwife: folds 
Zeeshka: folds 
oscarleon: folds 
vrnMike: folds 
azvazdam: folds 
matiko09: raises $1.50 to $2.50
TimStone: calls $1.50
*** FLOP *** [Jh Ts 9h]
matiko09: checks 
TimStone: bets $3.15
matiko09: calls $3.15
*** TURN *** [Jh Ts 9h] [9s]
matiko09: checks 
TimStone: checks 
*** RIVER *** [Jh Ts 9h 9s] [Jc]
matiko09: bets $5.61
TimStone: folds 
Uncalled bet ($5.61) returned to matiko09
matiko09 collected $10.79 from pot
matiko09: doesn't show hand 
*** SUMMARY ***
Total pot $11.30 | Rake $0.51 
Board [Jh Ts 9h 9s Jc]
Seat 2: azvazdam (button) folded before Flop (didn't bet)
Seat 3: matiko09 (small blind) collected ($10.79)
Seat 4: TimStone (big blind) folded on the River
Seat 5: Sweden_Pound folded before Flop (didn't bet)
Seat 6: hammerwife folded before Flop (didn't bet)
Seat 7: Zeeshka folded before Flop (didn't bet)
Seat 8: oscarleon folded before Flop (didn't bet)
Seat 9: vrnMike folded before Flop (didn't bet)





PokerStars Hand #148609595926:  Hold'em No Limit ($0.25/$0.50 USD) - 2016/02/11 13:30:36 CET [2016/02/11 7:30:36 ET]
Table 'Ambrosia II' 9-max Seat #2 is the button
Seat 1: matiko09 ($50 in chips) 
Seat 2: JJJ-K9 ($60.96 in chips) 
Seat 3: make6a ($81.56 in chips) 
Seat 4: huudk2016 ($26.72 in chips) 
Seat 5: RICKA16 ($61.63 in chips) 
Seat 6: Reven9er ($61.51 in chips) 
Seat 7: Ana.Satravca ($66 in chips) 
Seat 8: Dantist1122 ($50 in chips) 
Seat 9: arctur17 ($46.25 in chips) 
make6a: posts small blind $0.25
huudk2016: posts big blind $0.50
*** HOLE CARDS ***
Dealt to matiko09 [Kc 7d]
RICKA16: folds 
Reven9er: folds 
Ana.Satravca: folds 
Dantist1122: folds 
arctur17: folds 
matiko09: folds 
JJJ-K9: folds 
make6a: folds 
Uncalled bet ($0.25) returned to huudk2016
huudk2016 collected $0.50 from pot
huudk2016: doesn't show hand 
*** SUMMARY ***
Total pot $0.50 | Rake $0 
Seat 1: matiko09 folded before Flop (didn't bet)
Seat 2: JJJ-K9 (button) folded before Flop (didn't bet)
Seat 3: make6a (small blind) folded before Flop
Seat 4: huudk2016 (big blind) collected ($0.50)
Seat 5: RICKA16 folded before Flop (didn't bet)
Seat 6: Reven9er folded before Flop (didn't bet)
Seat 7: Ana.Satravca folded before Flop (didn't bet)
Seat 8: Dantist1122 folded before Flop (didn't bet)
Seat 9: arctur17 folded before Flop (didn't bet)





PokerStars Hand #148609601344:  Hold'em No Limit ($0.50/$1.00 USD) - 2016/02/11 13:30:45 CET [2016/02/11 7:30:45 ET]
Table 'Stephano V' 9-max Seat #1 is the button
Seat 1: hammerwife ($107.75 in chips) 
Seat 2: matiko09 ($142.34 in chips) 
Seat 3: DUkalisUA ($100 in chips) 
Seat 4: Zeeshka ($121.82 in chips) 
Seat 5: n2call ($242.63 in chips) 
Seat 6: Sweden_Pound ($101.50 in chips) 
Seat 7: hurtNCYDE ($100 in chips) 
Seat 8: oscarleon ($230.13 in chips) 
Seat 9: IcocaynaI ($35.84 in chips) 
matiko09: posts small blind $0.50
DUkalisUA: posts big blind $1
*** HOLE CARDS ***
Dealt to matiko09 [2h 4s]
Zeeshka: raises $2 to $3
n2call: folds 
Sweden_Pound: folds 
hurtNCYDE: folds 
oscarleon: folds 
IcocaynaI: calls $3
hammerwife: raises $9 to $12
matiko09: folds 
DUkalisUA: folds 
Zeeshka: folds 
IcocaynaI: folds 
Uncalled bet ($9) returned to hammerwife
hammerwife collected $10.50 from pot
hammerwife: doesn't show hand 
*** SUMMARY ***
Total pot $10.50 | Rake $0 
Seat 1: hammerwife (button) collected ($10.50)
Seat 2: matiko09 (small blind) folded before Flop
Seat 3: DUkalisUA (big blind) folded before Flop
Seat 4: Zeeshka folded before Flop
Seat 5: n2call folded before Flop (didn't bet)
Seat 6: Sweden_Pound folded before Flop (didn't bet)
Seat 7: hurtNCYDE folded before Flop (didn't bet)
Seat 8: oscarleon folded before Flop (didn't bet)
Seat 9: IcocaynaI folded before Flop





PokerStars Hand #148609610055:  Hold'em No Limit (€0.25/€0.50 EUR) - 2016/02/11 13:30:59 CET [2016/02/11 7:30:59 ET]
Table 'Otero II' 9-max Seat #8 is the button
Seat 1: Effort92 (€51.75 in chips) 
Seat 2: Dantist1122 (€50 in chips) 
Seat 3: Szevasztopol (€56.24 in chips) 
Seat 4: kram0909 (€29.11 in chips) 
Seat 6: TonnaMunz (€50 in chips) 
Seat 7: make6a (€56.45 in chips) 
Seat 8: matiko09 (€66.08 in chips) 
Seat 9: Apparat888 (€25.50 in chips) 
Apparat888: posts small blind €0.25
Effort92: posts big blind €0.50
*** HOLE CARDS ***
Dealt to matiko09 [5d 3c]
Dantist1122: folds 
Szevasztopol: folds 
kram0909: folds 
TonnaMunz: folds 
make6a: folds 
matiko09: folds 
Apparat888: folds 
Uncalled bet (€0.25) returned to Effort92
Effort92 collected €0.50 from pot
Effort92: doesn't show hand 
*** SUMMARY ***
Total pot €0.50 | Rake €0 
Seat 1: Effort92 (big blind) collected (€0.50)
Seat 2: Dantist1122 folded before Flop (didn't bet)
Seat 3: Szevasztopol folded before Flop (didn't bet)
Seat 4: kram0909 folded before Flop (didn't bet)
Seat 6: TonnaMunz folded before Flop (didn't bet)
Seat 7: make6a folded before Flop (didn't bet)
Seat 8: matiko09 (button) folded before Flop (didn't bet)
Seat 9: Apparat888 (small blind) folded before Flop





PokerStars Hand #148609610441:  Hold'em No Limit ($0.25/$0.50 USD) - 2016/02/11 13:31:00 CET [2016/02/11 7:31:00 ET]
Table 'Ambrosia II' 9-max Seat #3 is the button
Seat 1: matiko09 ($50 in chips) 
Seat 2: JJJ-K9 ($60.96 in chips) 
Seat 3: make6a ($81.31 in chips) 
Seat 4: huudk2016 ($26.97 in chips) 
Seat 5: RICKA16 ($61.63 in chips) 
Seat 6: Reven9er ($61.51 in chips) 
Seat 7: Ana.Satravca ($66 in chips) 
Seat 8: Dantist1122 ($50 in chips) 
Seat 9: arctur17 ($46.25 in chips) 
huudk2016: posts small blind $0.25
RICKA16: posts big blind $0.50
*** HOLE CARDS ***
Dealt to matiko09 [9h 7d]
Reven9er: folds 
Ana.Satravca: folds 
Dantist1122: folds 
arctur17: raises $0.50 to $1
matiko09: folds 
JJJ-K9: folds 
make6a: folds 
huudk2016: calls $0.75
RICKA16: calls $0.50
*** FLOP *** [6d 8d Ts]
huudk2016: checks 
RICKA16: checks 
arctur17: bets $2
huudk2016: folds 
RICKA16: folds 
Uncalled bet ($2) returned to arctur17
arctur17 collected $2.86 from pot
arctur17: doesn't show hand 
*** SUMMARY ***
Total pot $3 | Rake $0.14 
Board [6d 8d Ts]
Seat 1: matiko09 folded before Flop (didn't bet)
Seat 2: JJJ-K9 folded before Flop (didn't bet)
Seat 3: make6a (button) folded before Flop (didn't bet)
Seat 4: huudk2016 (small blind) folded on the Flop
Seat 5: RICKA16 (big blind) folded on the Flop
Seat 6: Reven9er folded before Flop (didn't bet)
Seat 7: Ana.Satravca folded before Flop (didn't bet)
Seat 8: Dantist1122 folded before Flop (didn't bet)
Seat 9: arctur17 collected ($2.86)





PokerStars Hand #148609610245:  Hold'em No Limit ($0.50/$1.00 USD) - 2016/02/11 13:31:00 CET [2016/02/11 7:31:00 ET]
Table 'Marion' 9-max Seat #6 is the button
Seat 1: aseban11 ($101.50 in chips) 
Seat 2: GusenokRUS ($112.45 in chips) 
Seat 3: TimStone ($100 in chips) 
Seat 4: matiko09 ($101.50 in chips) 
Seat 5: Rikti ($57.25 in chips) 
Seat 6: 19SERGE74 ($88.18 in chips) 
Seat 7: oscarleon ($105.08 in chips) 
Seat 8: Sweden_Pound ($100 in chips) 
Seat 9: Zeeshka ($101.50 in chips) 
oscarleon: posts small blind $0.50
Sweden_Pound: posts big blind $1
*** HOLE CARDS ***
Dealt to matiko09 [8h 3c]
Zeeshka: folds 
aseban11: raises $1.50 to $2.50
GusenokRUS: folds 
TimStone: folds 
matiko09: folds 
Rikti: folds 
19SERGE74: raises $6.50 to $9
oscarleon: folds 
Sweden_Pound: folds 
aseban11: folds 
Uncalled bet ($6.50) returned to 19SERGE74
19SERGE74 collected $6.50 from pot
19SERGE74: doesn't show hand 
*** SUMMARY ***
Total pot $6.50 | Rake $0 
Seat 1: aseban11 folded before Flop
Seat 2: GusenokRUS folded before Flop (didn't bet)
Seat 3: TimStone folded before Flop (didn't bet)
Seat 4: matiko09 folded before Flop (didn't bet)
Seat 5: Rikti folded before Flop (didn't bet)
Seat 6: 19SERGE74 (button) collected ($6.50)
Seat 7: oscarleon (small blind) folded before Flop
Seat 8: Sweden_Pound (big blind) folded before Flop
Seat 9: Zeeshka folded before Flop (didn't bet)





PokerStars Hand #148609617176:  Hold'em No Limit ($0.50/$1.00 USD) - 2016/02/11 13:31:11 CET [2016/02/11 7:31:11 ET]
Table 'Clorinde' 9-max Seat #8 is the button
Seat 1: matiko09 ($145.20 in chips) 
Seat 2: 19SERGE74 ($56.65 in chips) 
Seat 3: gabi_igna ($104.75 in chips) 
Seat 4: Sweden_Pound ($100 in chips) 
Seat 5: Mukhin1 ($104 in chips) 
Seat 6: Gcroc52 ($12.43 in chips) 
Seat 7: Zeeshka ($126.33 in chips) 
Seat 8: aseban11 ($107.08 in chips) 
Seat 9: hammerwife ($100.50 in chips) 
hammerwife: posts small blind $0.50
matiko09: posts big blind $1
*** HOLE CARDS ***
Dealt to matiko09 [3h 2d]
19SERGE74: folds 
gabi_igna: folds 
Sweden_Pound: folds 
Mukhin1: folds 
Gcroc52: raises $2 to $3
Zeeshka: folds 
aseban11: folds 
hammerwife: folds 
matiko09: folds 
Uncalled bet ($2) returned to Gcroc52
Gcroc52 collected $2.50 from pot
*** SUMMARY ***
Total pot $2.50 | Rake $0 
Seat 1: matiko09 (big blind) folded before Flop
Seat 2: 19SERGE74 folded before Flop (didn't bet)
Seat 3: gabi_igna folded before Flop (didn't bet)
Seat 4: Sweden_Pound folded before Flop (didn't bet)
Seat 5: Mukhin1 folded before Flop (didn't bet)
Seat 6: Gcroc52 collected ($2.50)
Seat 7: Zeeshka folded before Flop (didn't bet)
Seat 8: aseban11 (button) folded before Flop (didn't bet)
Seat 9: hammerwife (small blind) folded before Flop





PokerStars Hand #148609618464:  Hold'em No Limit (€0.25/€0.50 EUR) - 2016/02/11 13:31:14 CET [2016/02/11 7:31:14 ET]
Table 'Otero II' 9-max Seat #9 is the button
Seat 1: Effort92 (€52 in chips) 
Seat 2: Dantist1122 (€50 in chips) 
Seat 3: Szevasztopol (€56.24 in chips) 
Seat 6: TonnaMunz (€50 in chips) 
Seat 7: make6a (€56.45 in chips) 
Seat 8: matiko09 (€66.08 in chips) 
Seat 9: Apparat888 (€25.25 in chips) 
Effort92: posts small blind €0.25
Dantist1122: posts big blind €0.50
*** HOLE CARDS ***
Dealt to matiko09 [Qc 3c]
Szevasztopol: folds 
TonnaMunz: folds 
make6a: raises €0.82 to €1.32
matiko09: folds 
Apparat888: folds 
Effort92: folds 
Dantist1122: folds 
Uncalled bet (€0.82) returned to make6a
make6a collected €1.25 from pot
make6a: doesn't show hand 
kram0909 is disconnected 
*** SUMMARY ***
Total pot €1.25 | Rake €0 
Seat 1: Effort92 (small blind) folded before Flop
Seat 2: Dantist1122 (big blind) folded before Flop
Seat 3: Szevasztopol folded before Flop (didn't bet)
Seat 6: TonnaMunz folded before Flop (didn't bet)
Seat 7: make6a collected (€1.25)
Seat 8: matiko09 folded before Flop (didn't bet)
Seat 9: Apparat888 (button) folded before Flop (didn't bet)





PokerStars Hand #148609627037:  Hold'em No Limit ($0.25/$0.50 USD) - 2016/02/11 13:31:28 CET [2016/02/11 7:31:28 ET]
Table 'Sylvania II' 9-max Seat #3 is the button
Seat 1: tw0315 ($174.48 in chips) 
Seat 2: Effort92 ($95.06 in chips) 
Seat 3: ruyingren ($209.55 in chips) 
Seat 4: matiko09 ($124.30 in chips) 
Seat 6: TonnaMunz ($129.56 in chips) 
Seat 7: 2lefthand75 ($35.19 in chips) 
Seat 8: Apparat888 ($48.75 in chips) 
Seat 9: udden82 ($54.35 in chips) 
matiko09: posts small blind $0.25
vlad11122007: is sitting out 
TonnaMunz: posts big blind $0.50
tw0315: posts the ante $0.10
Effort92: posts the ante $0.10
ruyingren: posts the ante $0.10
matiko09: posts the ante $0.10
TonnaMunz: posts the ante $0.10
2lefthand75: posts the ante $0.10
Apparat888: posts the ante $0.10
udden82: posts the ante $0.10
*** HOLE CARDS ***
Dealt to matiko09 [4s 3h]
2lefthand75: folds 
Apparat888: folds 
udden82: raises $0.77 to $1.27
tw0315: folds 
Effort92: folds 
ruyingren: folds 
matiko09: folds 
TonnaMunz: folds 
Uncalled bet ($0.77) returned to udden82
udden82 collected $2.05 from pot
udden82: doesn't show hand 
*** SUMMARY ***
Total pot $2.05 | Rake $0 
Seat 1: tw0315 folded before Flop (didn't bet)
Seat 2: Effort92 folded before Flop (didn't bet)
Seat 3: ruyingren (button) folded before Flop (didn't bet)
Seat 4: matiko09 (small blind) folded before Flop
Seat 6: TonnaMunz (big blind) folded before Flop
Seat 7: 2lefthand75 folded before Flop (didn't bet)
Seat 8: Apparat888 folded before Flop (didn't bet)
Seat 9: udden82 collected ($2.05)





PokerStars Hand #148609634864:  Hold'em No Limit (€0.25/€0.50 EUR) - 2016/02/11 13:31:41 CET [2016/02/11 7:31:41 ET]
Table 'Otero II' 9-max Seat #1 is the button
Seat 1: Effort92 (€51.75 in chips) 
Seat 2: Dantist1122 (€50 in chips) 
Seat 3: Szevasztopol (€56.24 in chips) 
Seat 6: TonnaMunz (€50 in chips) 
Seat 7: make6a (€57.20 in chips) 
Seat 8: matiko09 (€66.08 in chips) 
Seat 9: Apparat888 (€25.25 in chips) 
Dantist1122: posts small blind €0.25
Szevasztopol: posts big blind €0.50
*** HOLE CARDS ***
Dealt to matiko09 [9d Qh]
TonnaMunz: folds 
make6a: folds 
matiko09: folds 
Apparat888: folds 
Effort92: folds 
Dantist1122: raises €0.52 to €1.02
Szevasztopol: folds 
Uncalled bet (€0.52) returned to Dantist1122
Dantist1122 collected €1 from pot
Dantist1122: doesn't show hand 
*** SUMMARY ***
Total pot €1 | Rake €0 
Seat 1: Effort92 (button) folded before Flop (didn't bet)
Seat 2: Dantist1122 (small blind) collected (€1)
Seat 3: Szevasztopol (big blind) folded before Flop
Seat 6: TonnaMunz folded before Flop (didn't bet)
Seat 7: make6a folded before Flop (didn't bet)
Seat 8: matiko09 folded before Flop (didn't bet)
Seat 9: Apparat888 folded before Flop (didn't bet)





PokerStars Hand #148609637784:  Hold'em No Limit ($0.50/$1.00 USD) - 2016/02/11 13:31:46 CET [2016/02/11 7:31:46 ET]
Table 'Marion' 9-max Seat #7 is the button
Seat 1: aseban11 ($100 in chips) 
Seat 2: GusenokRUS ($112.45 in chips) 
Seat 3: TimStone ($100 in chips) 
Seat 4: matiko09 ($101.50 in chips) 
Seat 5: Rikti ($57.25 in chips) 
Seat 6: 19SERGE74 ($92.18 in chips) 
Seat 7: oscarleon ($104.58 in chips) 
Seat 8: Sweden_Pound ($100 in chips) 
Seat 9: Zeeshka ($101.50 in chips) 
Sweden_Pound: posts small blind $0.50
Zeeshka: posts big blind $1
*** HOLE CARDS ***
Dealt to matiko09 [6d Td]
aseban11: folds 
GusenokRUS: folds 
TimStone: folds 
matiko09: folds 
Rikti: folds 
19SERGE74: folds 
oscarleon: raises $2 to $3
Sweden_Pound: folds 
Zeeshka: folds 
Uncalled bet ($2) returned to oscarleon
oscarleon collected $2.50 from pot
oscarleon: doesn't show hand 
*** SUMMARY ***
Total pot $2.50 | Rake $0 
Seat 1: aseban11 folded before Flop (didn't bet)
Seat 2: GusenokRUS folded before Flop (didn't bet)
Seat 3: TimStone folded before Flop (didn't bet)
Seat 4: matiko09 folded before Flop (didn't bet)
Seat 5: Rikti folded before Flop (didn't bet)
Seat 6: 19SERGE74 folded before Flop (didn't bet)
Seat 7: oscarleon (button) collected ($2.50)
Seat 8: Sweden_Pound (small blind) folded before Flop
Seat 9: Zeeshka (big blind) folded before Flop





PokerStars Hand #148609640736:  Hold'em No Limit ($0.50/$1.00 USD) - 2016/02/11 13:31:51 CET [2016/02/11 7:31:51 ET]
Table 'Kleopatra II' 9-max Seat #3 is the button
Seat 2: azvazdam ($58.47 in chips) 
Seat 3: matiko09 ($107.64 in chips) 
Seat 4: TimStone ($100 in chips) 
Seat 5: Sweden_Pound ($110.73 in chips) 
Seat 6: hammerwife ($172.85 in chips) 
Seat 7: Zeeshka ($198.11 in chips) 
Seat 8: oscarleon ($107.14 in chips) 
Seat 9: vrnMike ($115.93 in chips) 
TimStone: posts small blind $0.50
Sweden_Pound: posts big blind $1
DUkalisUA: sits out 
*** HOLE CARDS ***
Dealt to matiko09 [5c 8s]
hammerwife: folds 
Zeeshka: raises $2 to $3
oscarleon: folds 
vrnMike: folds 
azvazdam: folds 
matiko09: folds 
TimStone: folds 
Sweden_Pound: folds 
Uncalled bet ($2) returned to Zeeshka
Zeeshka collected $2.50 from pot
Zeeshka: doesn't show hand 
*** SUMMARY ***
Total pot $2.50 | Rake $0 
Seat 2: azvazdam folded before Flop (didn't bet)
Seat 3: matiko09 (button) folded before Flop (didn't bet)
Seat 4: TimStone (small blind) folded before Flop
Seat 5: Sweden_Pound (big blind) folded before Flop
Seat 6: hammerwife folded before Flop (didn't bet)
Seat 7: Zeeshka collected ($2.50)
Seat 8: oscarleon folded before Flop (didn't bet)
Seat 9: vrnMike folded before Flop (didn't bet)





PokerStars Hand #148609641115:  Hold'em No Limit ($0.25/$0.50 USD) - 2016/02/11 13:31:51 CET [2016/02/11 7:31:51 ET]
Table 'Stereoskopia' 9-max Seat #9 is the button
Seat 1: FoRvvArD_go ($50 in chips) 
Seat 2: Dantist1122 ($55.25 in chips) 
Seat 3: fandorin2005 ($50 in chips) 
Seat 4: Anikin44 ($38.15 in chips) 
Seat 5: afrodit71 ($27.24 in chips) 
Seat 6: matiko09 ($53.63 in chips) 
Seat 7: Serhent ($62.80 in chips) 
Seat 8: Reven9er ($50 in chips) 
Seat 9: nastynate075 ($14.36 in chips) 
FoRvvArD_go: posts small blind $0.25
Dantist1122: posts big blind $0.50
*** HOLE CARDS ***
Dealt to matiko09 [Ts Qh]
fandorin2005: folds 
Anikin44: folds 
afrodit71: folds 
matiko09: folds 
Serhent: folds 
Reven9er: raises $0.50 to $1
nastynate075: folds 
FoRvvArD_go: folds 
Dantist1122: folds 
Uncalled bet ($0.50) returned to Reven9er
Reven9er collected $1.25 from pot
Reven9er: doesn't show hand 
*** SUMMARY ***
Total pot $1.25 | Rake $0 
Seat 1: FoRvvArD_go (small blind) folded before Flop
Seat 2: Dantist1122 (big blind) folded before Flop
Seat 3: fandorin2005 folded before Flop (didn't bet)
Seat 4: Anikin44 folded before Flop (didn't bet)
Seat 5: afrodit71 folded before Flop (didn't bet)
Seat 6: matiko09 folded before Flop (didn't bet)
Seat 7: Serhent folded before Flop (didn't bet)
Seat 8: Reven9er collected ($1.25)
Seat 9: nastynate075 (button) folded before Flop (didn't bet)





PokerStars Hand #148609641418:  Hold'em No Limit ($0.50/$1.00 USD) - 2016/02/11 13:31:52 CET [2016/02/11 7:31:52 ET]
Table 'Clorinde' 9-max Seat #9 is the button
Seat 1: matiko09 ($144.20 in chips) 
Seat 2: 19SERGE74 ($56.65 in chips) 
Seat 3: gabi_igna ($104.75 in chips) 
Seat 4: Sweden_Pound ($100 in chips) 
Seat 5: Mukhin1 ($104 in chips) 
Seat 6: Gcroc52 ($13.93 in chips) 
Seat 7: Zeeshka ($126.33 in chips) 
Seat 8: aseban11 ($107.08 in chips) 
Seat 9: hammerwife ($100 in chips) 
matiko09: posts small blind $0.50
19SERGE74: posts big blind $1
*** HOLE CARDS ***
Dealt to matiko09 [Kh 3c]
gabi_igna: folds 
Sweden_Pound: folds 
Mukhin1: folds 
Gcroc52: folds 
Zeeshka: raises $2 to $3
aseban11: folds 
hammerwife: folds 
matiko09: folds 
19SERGE74: folds 
Uncalled bet ($2) returned to Zeeshka
Zeeshka collected $2.50 from pot
Zeeshka: doesn't show hand 
*** SUMMARY ***
Total pot $2.50 | Rake $0 
Seat 1: matiko09 (small blind) folded before Flop
Seat 2: 19SERGE74 (big blind) folded before Flop
Seat 3: gabi_igna folded before Flop (didn't bet)
Seat 4: Sweden_Pound folded before Flop (didn't bet)
Seat 5: Mukhin1 folded before Flop (didn't bet)
Seat 6: Gcroc52 folded before Flop (didn't bet)
Seat 7: Zeeshka collected ($2.50)
Seat 8: aseban11 folded before Flop (didn't bet)
Seat 9: hammerwife (button) folded before Flop (didn't bet)





PokerStars Hand #148609648674:  Hold'em No Limit ($0.25/$0.50 USD) - 2016/02/11 13:32:04 CET [2016/02/11 7:32:04 ET]
Table 'Sylvania II' 9-max Seat #4 is the button
Seat 2: Effort92 ($94.96 in chips) 
Seat 3: ruyingren ($209.45 in chips) 
Seat 4: matiko09 ($123.95 in chips) 
Seat 6: TonnaMunz ($128.96 in chips) 
Seat 7: 2lefthand75 ($35.09 in chips) 
Seat 8: Apparat888 ($48.65 in chips) 
Seat 9: udden82 ($55.80 in chips) 
TonnaMunz: posts small blind $0.25
2lefthand75: posts big blind $0.50
Effort92: posts the ante $0.10
ruyingren: posts the ante $0.10
matiko09: posts the ante $0.10
TonnaMunz: posts the ante $0.10
2lefthand75: posts the ante $0.10
Apparat888: posts the ante $0.10
udden82: posts the ante $0.10
*** HOLE CARDS ***
Dealt to matiko09 [As 7d]
Apparat888: folds 
udden82: folds 
Effort92: folds 
ruyingren: raises $1 to $1.50
matiko09: folds 
TonnaMunz: folds 
2lefthand75: calls $1
*** FLOP *** [Qs Kc Kd]
2lefthand75: checks 
ruyingren: bets $2
2lefthand75: folds 
Uncalled bet ($2) returned to ruyingren
ruyingren collected $3.77 from pot
ruyingren: doesn't show hand 
*** SUMMARY ***
Total pot $3.95 | Rake $0.18 
Board [Qs Kc Kd]
Seat 2: Effort92 folded before Flop (didn't bet)
Seat 3: ruyingren collected ($3.77)
Seat 4: matiko09 (button) folded before Flop (didn't bet)
Seat 6: TonnaMunz (small blind) folded before Flop
Seat 7: 2lefthand75 (big blind) folded on the Flop
Seat 8: Apparat888 folded before Flop (didn't bet)
Seat 9: udden82 folded before Flop (didn't bet)





PokerStars Hand #148609656620:  Hold'em No Limit ($0.50/$1.00 USD) - 2016/02/11 13:32:17 CET [2016/02/11 7:32:17 ET]
Table 'Stephano V' 9-max Seat #2 is the button
Seat 1: hammerwife ($115.25 in chips) 
Seat 2: matiko09 ($141.84 in chips) 
Seat 3: DUkalisUA ($100 in chips) 
Seat 4: Zeeshka ($118.82 in chips) 
Seat 5: n2call ($242.63 in chips) 
Seat 6: Sweden_Pound ($101.50 in chips) 
Seat 7: hurtNCYDE ($100 in chips) 
Seat 8: oscarleon ($230.13 in chips) 
Seat 9: IcocaynaI ($32.84 in chips) 
DUkalisUA: posts small blind $0.50
Zeeshka: posts big blind $1
*** HOLE CARDS ***
Dealt to matiko09 [8h 3h]
n2call has timed out
n2call: folds 
Sweden_Pound: folds 
hurtNCYDE: raises $1.50 to $2.50
oscarleon: folds 
IcocaynaI: calls $2.50
hammerwife: folds 
matiko09: folds 
DUkalisUA: folds 
Zeeshka: folds 
*** FLOP *** [Qd 6s 6c]
hurtNCYDE: checks 
IcocaynaI: checks 
*** TURN *** [Qd 6s 6c] [6d]
hurtNCYDE: bets $4.28
IcocaynaI: folds 
Uncalled bet ($4.28) returned to hurtNCYDE
hurtNCYDE collected $6.21 from pot
*** SUMMARY ***
Total pot $6.50 | Rake $0.29 
Board [Qd 6s 6c 6d]
Seat 1: hammerwife folded before Flop (didn't bet)
Seat 2: matiko09 (button) folded before Flop (didn't bet)
Seat 3: DUkalisUA (small blind) folded before Flop
Seat 4: Zeeshka (big blind) folded before Flop
Seat 5: n2call folded before Flop (didn't bet)
Seat 6: Sweden_Pound folded before Flop (didn't bet)
Seat 7: hurtNCYDE collected ($6.21)
Seat 8: oscarleon folded before Flop (didn't bet)
Seat 9: IcocaynaI folded on the Turn





PokerStars Hand #148609659501:  Hold'em No Limit (€0.25/€0.50 EUR) - 2016/02/11 13:32:22 CET [2016/02/11 7:32:22 ET]
Table 'Otero II' 9-max Seat #2 is the button
Seat 1: Effort92 (€51.75 in chips) 
Seat 2: Dantist1122 (€50.50 in chips) 
Seat 3: Szevasztopol (€55.74 in chips) 
Seat 6: TonnaMunz (€50 in chips) 
Seat 7: make6a (€57.20 in chips) 
Seat 8: matiko09 (€66.08 in chips) 
Seat 9: Apparat888 (€25.25 in chips) 
Szevasztopol: posts small blind €0.25
TonnaMunz: posts big blind €0.50
*** HOLE CARDS ***
Dealt to matiko09 [9c 6c]
make6a: folds 
matiko09: folds 
Apparat888: raises €1 to €1.50
Effort92: folds 
Dantist1122: folds 
Szevasztopol: folds 
TonnaMunz: folds 
Uncalled bet (€1) returned to Apparat888
Apparat888 collected €1.25 from pot
*** SUMMARY ***
Total pot €1.25 | Rake €0 
Seat 1: Effort92 folded before Flop (didn't bet)
Seat 2: Dantist1122 (button) folded before Flop (didn't bet)
Seat 3: Szevasztopol (small blind) folded before Flop
Seat 6: TonnaMunz (big blind) folded before Flop
Seat 7: make6a folded before Flop (didn't bet)
Seat 8: matiko09 folded before Flop (didn't bet)
Seat 9: Apparat888 collected (€1.25)





PokerStars Hand #148609661098:  Hold'em No Limit ($0.50/$1.00 USD) - 2016/02/11 13:32:24 CET [2016/02/11 7:32:24 ET]
Table 'Marion' 9-max Seat #8 is the button
Seat 1: aseban11 ($100 in chips) 
Seat 2: GusenokRUS ($112.45 in chips) 
Seat 3: TimStone ($100 in chips) 
Seat 4: matiko09 ($101.50 in chips) 
Seat 5: Rikti ($57.25 in chips) 
Seat 6: 19SERGE74 ($92.18 in chips) 
Seat 7: oscarleon ($106.08 in chips) 
Seat 8: Sweden_Pound ($100 in chips) 
Seat 9: Zeeshka ($100.50 in chips) 
Zeeshka: posts small blind $0.50
aseban11: posts big blind $1
*** HOLE CARDS ***
Dealt to matiko09 [Ah Js]
GusenokRUS: folds 
TimStone: folds 
matiko09: raises $2 to $3
Rikti: raises $4 to $7
19SERGE74: folds 
oscarleon: folds 
Sweden_Pound: folds 
Zeeshka: folds 
aseban11: folds 
matiko09: folds 
Uncalled bet ($4) returned to Rikti
Rikti collected $7.50 from pot
Rikti: doesn't show hand 
*** SUMMARY ***
Total pot $7.50 | Rake $0 
Seat 1: aseban11 (big blind) folded before Flop
Seat 2: GusenokRUS folded before Flop (didn't bet)
Seat 3: TimStone folded before Flop (didn't bet)
Seat 4: matiko09 folded before Flop
Seat 5: Rikti collected ($7.50)
Seat 6: 19SERGE74 folded before Flop (didn't bet)
Seat 7: oscarleon folded before Flop (didn't bet)
Seat 8: Sweden_Pound (button) folded before Flop (didn't bet)
Seat 9: Zeeshka (small blind) folded before Flop





PokerStars Hand #148609662867:  Hold'em No Limit ($0.50/$1.00 USD) - 2016/02/11 13:32:27 CET [2016/02/11 7:32:27 ET]
Table 'Kleopatra II' 9-max Seat #4 is the button
Seat 2: azvazdam ($58.47 in chips) 
Seat 3: matiko09 ($107.64 in chips) 
Seat 4: TimStone ($100 in chips) 
Seat 5: Sweden_Pound ($109.73 in chips) 
Seat 6: hammerwife ($172.85 in chips) 
Seat 7: Zeeshka ($199.61 in chips) 
Seat 8: oscarleon ($107.14 in chips) 
Seat 9: vrnMike ($115.93 in chips) 
Sweden_Pound: posts small blind $0.50
hammerwife: posts big blind $1
DUkalisUA: sits out 
*** HOLE CARDS ***
Dealt to matiko09 [4c 7d]
Zeeshka: folds 
oscarleon: folds 
vrnMike: folds 
azvazdam: raises $2 to $3
matiko09: folds 
TimStone: folds 
Sweden_Pound: folds 
hammerwife: folds 
Uncalled bet ($2) returned to azvazdam
azvazdam collected $2.50 from pot
azvazdam: doesn't show hand 
*** SUMMARY ***
Total pot $2.50 | Rake $0 
Seat 2: azvazdam collected ($2.50)
Seat 3: matiko09 folded before Flop (didn't bet)
Seat 4: TimStone (button) folded before Flop (didn't bet)
Seat 5: Sweden_Pound (small blind) folded before Flop
Seat 6: hammerwife (big blind) folded before Flop
Seat 7: Zeeshka folded before Flop (didn't bet)
Seat 8: oscarleon folded before Flop (didn't bet)
Seat 9: vrnMike folded before Flop (didn't bet)





PokerStars Hand #148609664461:  Hold'em No Limit ($0.50/$1.00 USD) - 2016/02/11 13:32:30 CET [2016/02/11 7:32:30 ET]
Table 'Gianfar' 9-max Seat #7 is the button
Seat 1: Vikulja1993 ($100 in chips) 
Seat 2: bilukm ($110.20 in chips) 
Seat 3: AlKatrone ($171.39 in chips) 
Seat 4: matiko09 ($133.98 in chips) 
Seat 5: hammerwife ($152.79 in chips) 
Seat 6: Sweden_Pound ($100 in chips) 
Seat 7: Rikti ($34.50 in chips) 
Seat 8: Zeeshka ($112.31 in chips) 
Seat 9: oscarleon ($137.66 in chips) 
Zeeshka: posts small blind $0.50
oscarleon: posts big blind $1
*** HOLE CARDS ***
Dealt to matiko09 [3c 6d]
Vikulja1993: folds 
bilukm: folds 
AlKatrone: folds 
matiko09: folds 
hammerwife: folds 
Sweden_Pound: folds 
Rikti: raises $1 to $2
Zeeshka: folds 
oscarleon: folds 
Uncalled bet ($1) returned to Rikti
Rikti collected $2.50 from pot
Rikti: doesn't show hand 
*** SUMMARY ***
Total pot $2.50 | Rake $0 
Seat 1: Vikulja1993 folded before Flop (didn't bet)
Seat 2: bilukm folded before Flop (didn't bet)
Seat 3: AlKatrone folded before Flop (didn't bet)
Seat 4: matiko09 folded before Flop (didn't bet)
Seat 5: hammerwife folded before Flop (didn't bet)
Seat 6: Sweden_Pound folded before Flop (didn't bet)
Seat 7: Rikti (button) collected ($2.50)
Seat 8: Zeeshka (small blind) folded before Flop
Seat 9: oscarleon (big blind) folded before Flop





PokerStars Hand #148609664938:  Hold'em No Limit ($0.50/$1.00 USD) - 2016/02/11 13:32:31 CET [2016/02/11 7:32:31 ET]
Table 'Clorinde' 9-max Seat #1 is the button
Seat 1: matiko09 ($143.70 in chips) 
Seat 2: 19SERGE74 ($55.65 in chips) 
Seat 3: gabi_igna ($104.75 in chips) 
Seat 4: Sweden_Pound ($100 in chips) 
Seat 5: Mukhin1 ($104 in chips) 
Seat 6: Gcroc52 ($13.93 in chips) 
Seat 7: Zeeshka ($127.83 in chips) 
Seat 8: aseban11 ($107.08 in chips) 
Seat 9: hammerwife ($100 in chips) 
19SERGE74: posts small blind $0.50
gabi_igna: posts big blind $1
*** HOLE CARDS ***
Dealt to matiko09 [Td 9c]
Sweden_Pound: folds 
Mukhin1: raises $2.02 to $3.02
Gcroc52: folds 
Zeeshka: folds 
aseban11: folds 
hammerwife: folds 
matiko09: folds 
19SERGE74: calls $2.52
gabi_igna: folds 
*** FLOP *** [Qc 9s 5s]
19SERGE74: checks 
Mukhin1: bets $3.49
19SERGE74: calls $3.49
*** TURN *** [Qc 9s 5s] [Ac]
19SERGE74: checks 
Mukhin1: bets $9.90
19SERGE74: folds 
Uncalled bet ($9.90) returned to Mukhin1
Mukhin1 collected $13.39 from pot
Mukhin1: doesn't show hand 
*** SUMMARY ***
Total pot $14.02 | Rake $0.63 
Board [Qc 9s 5s Ac]
Seat 1: matiko09 (button) folded before Flop (didn't bet)
Seat 2: 19SERGE74 (small blind) folded on the Turn
Seat 3: gabi_igna (big blind) folded before Flop
Seat 4: Sweden_Pound folded before Flop (didn't bet)
Seat 5: Mukhin1 collected ($13.39)
Seat 6: Gcroc52 folded before Flop (didn't bet)
Seat 7: Zeeshka folded before Flop (didn't bet)
Seat 8: aseban11 folded before Flop (didn't bet)
Seat 9: hammerwife folded before Flop (didn't bet)





PokerStars Hand #148609668427:  Hold'em No Limit ($0.25/$0.50 USD) - 2016/02/11 13:32:36 CET [2016/02/11 7:32:36 ET]
Table 'Ambrosia II' 9-max Seat #4 is the button
Seat 1: matiko09 ($50 in chips) 
Seat 2: JJJ-K9 ($60.96 in chips) 
Seat 3: make6a ($81.31 in chips) 
Seat 4: huudk2016 ($25.97 in chips) 
Seat 5: RICKA16 ($60.63 in chips) 
Seat 6: Reven9er ($61.51 in chips) 
Seat 7: Ana.Satravca ($66 in chips) 
Seat 8: Dantist1122 ($50 in chips) 
Seat 9: arctur17 ($48.11 in chips) 
RICKA16: posts small blind $0.25
Reven9er: posts big blind $0.50
*** HOLE CARDS ***
Dealt to matiko09 [Qc 8s]
Ana.Satravca: folds 
Dantist1122: folds 
arctur17: folds 
matiko09: folds 
JJJ-K9: folds 
make6a: folds 
huudk2016: raises $1 to $1.50
RICKA16: folds 
Reven9er: folds 
Uncalled bet ($1) returned to huudk2016
huudk2016 collected $1.25 from pot
huudk2016: doesn't show hand 
*** SUMMARY ***
Total pot $1.25 | Rake $0 
Seat 1: matiko09 folded before Flop (didn't bet)
Seat 2: JJJ-K9 folded before Flop (didn't bet)
Seat 3: make6a folded before Flop (didn't bet)
Seat 4: huudk2016 (button) collected ($1.25)
Seat 5: RICKA16 (small blind) folded before Flop
Seat 6: Reven9er (big blind) folded before Flop
Seat 7: Ana.Satravca folded before Flop (didn't bet)
Seat 8: Dantist1122 folded before Flop (didn't bet)
Seat 9: arctur17 folded before Flop (didn't bet)





PokerStars Hand #148609674826:  Hold'em No Limit ($0.25/$0.50 USD) - 2016/02/11 13:32:47 CET [2016/02/11 7:32:47 ET]
Table 'Sylvania II' 9-max Seat #6 is the button
Seat 2: Effort92 ($94.86 in chips) 
Seat 3: ruyingren ($211.62 in chips) 
Seat 4: matiko09 ($123.85 in chips) 
Seat 6: TonnaMunz ($128.61 in chips) 
Seat 7: 2lefthand75 ($33.49 in chips) 
Seat 8: Apparat888 ($48.55 in chips) 
Seat 9: udden82 ($55.70 in chips) 
2lefthand75: posts small blind $0.25
Apparat888: posts big blind $0.50
Effort92: posts the ante $0.10
ruyingren: posts the ante $0.10
matiko09: posts the ante $0.10
TonnaMunz: posts the ante $0.10
2lefthand75: posts the ante $0.10
Apparat888: posts the ante $0.10
udden82: posts the ante $0.10
*** HOLE CARDS ***
Dealt to matiko09 [5d 9c]
udden82: raises $0.77 to $1.27
Effort92: folds 
ruyingren: calls $1.27
matiko09: folds 
TonnaMunz: folds 
2lefthand75: calls $1.02
Apparat888: folds 
*** FLOP *** [4h Ah Jc]
2lefthand75: checks 
udden82: checks 
ruyingren: bets $2.50
2lefthand75: calls $2.50
udden82: folds 
*** TURN *** [4h Ah Jc] [6c]
2lefthand75: checks 
ruyingren: checks 
*** RIVER *** [4h Ah Jc 6c] [9s]
2lefthand75: bets $4.78
ruyingren: folds 
Uncalled bet ($4.78) returned to 2lefthand75
2lefthand75 collected $9.56 from pot
*** SUMMARY ***
Total pot $10.01 | Rake $0.45 
Board [4h Ah Jc 6c 9s]
Seat 2: Effort92 folded before Flop (didn't bet)
Seat 3: ruyingren folded on the River
Seat 4: matiko09 folded before Flop (didn't bet)
Seat 6: TonnaMunz (button) folded before Flop (didn't bet)
Seat 7: 2lefthand75 (small blind) collected ($9.56)
Seat 8: Apparat888 (big blind) folded before Flop
Seat 9: udden82 folded on the Flop





PokerStars Hand #148609681594:  Hold'em No Limit ($0.50/$1.00 USD) - 2016/02/11 13:32:58 CET [2016/02/11 7:32:58 ET]
Table 'Kleopatra II' 9-max Seat #5 is the button
Seat 2: azvazdam ($59.97 in chips) 
Seat 3: matiko09 ($107.64 in chips) 
Seat 4: TimStone ($100 in chips) 
Seat 5: Sweden_Pound ($109.23 in chips) 
Seat 6: hammerwife ($171.85 in chips) 
Seat 7: Zeeshka ($199.61 in chips) 
Seat 8: oscarleon ($107.14 in chips) 
Seat 9: vrnMike ($115.93 in chips) 
hammerwife: posts small blind $0.50
Zeeshka: posts big blind $1
DUkalisUA: sits out 
*** HOLE CARDS ***
Dealt to matiko09 [Th Td]
oscarleon: folds 
vrnMike: folds 
azvazdam: folds 
matiko09: raises $2 to $3
TimStone: folds 
Sweden_Pound: folds 
hammerwife: folds 
Zeeshka: calls $2
*** FLOP *** [Qh 7c Jd]
Zeeshka: checks 
matiko09: checks 
*** TURN *** [Qh 7c Jd] [Ah]
Zeeshka: checks 
matiko09: checks 
*** RIVER *** [Qh 7c Jd Ah] [Qs]
Zeeshka: checks 
matiko09: checks 
*** SHOW DOWN ***
Zeeshka: shows [8s As] (two pair, Aces and Queens)
matiko09: mucks hand 
Zeeshka collected $6.21 from pot
*** SUMMARY ***
Total pot $6.50 | Rake $0.29 
Board [Qh 7c Jd Ah Qs]
Seat 2: azvazdam folded before Flop (didn't bet)
Seat 3: matiko09 mucked [Th Td]
Seat 4: TimStone folded before Flop (didn't bet)
Seat 5: Sweden_Pound (button) folded before Flop (didn't bet)
Seat 6: hammerwife (small blind) folded before Flop
Seat 7: Zeeshka (big blind) showed [8s As] and won ($6.21) with two pair, Aces and Queens
Seat 8: oscarleon folded before Flop (didn't bet)
Seat 9: vrnMike folded before Flop (didn't bet)





PokerStars Hand #148609682720:  Hold'em No Limit ($0.50/$1.00 USD) - 2016/02/11 13:33:00 CET [2016/02/11 7:33:00 ET]
Table 'Gianfar' 9-max Seat #8 is the button
Seat 1: Vikulja1993 ($100 in chips) 
Seat 2: bilukm ($110.20 in chips) 
Seat 3: AlKatrone ($171.39 in chips) 
Seat 4: matiko09 ($133.98 in chips) 
Seat 5: hammerwife ($152.79 in chips) 
Seat 6: Sweden_Pound ($100 in chips) 
Seat 7: Rikti ($36 in chips) 
Seat 8: Zeeshka ($111.81 in chips) 
Seat 9: oscarleon ($136.66 in chips) 
oscarleon: posts small blind $0.50
Vikulja1993: posts big blind $1
*** HOLE CARDS ***
Dealt to matiko09 [7h 6h]
bilukm: folds 
AlKatrone: raises $2 to $3
matiko09: folds 
hammerwife: folds 
Sweden_Pound: folds 
Rikti: folds 
Zeeshka: folds 
oscarleon: raises $8 to $11
Vikulja1993: folds 
AlKatrone: calls $8
*** FLOP *** [9s 3h 3d]
oscarleon: bets $16
AlKatrone: folds 
Uncalled bet ($16) returned to oscarleon
oscarleon collected $21.96 from pot
oscarleon: doesn't show hand 
*** SUMMARY ***
Total pot $23 | Rake $1.04 
Board [9s 3h 3d]
Seat 1: Vikulja1993 (big blind) folded before Flop
Seat 2: bilukm folded before Flop (didn't bet)
Seat 3: AlKatrone folded on the Flop
Seat 4: matiko09 folded before Flop (didn't bet)
Seat 5: hammerwife folded before Flop (didn't bet)
Seat 6: Sweden_Pound folded before Flop (didn't bet)
Seat 7: Rikti folded before Flop (didn't bet)
Seat 8: Zeeshka (button) folded before Flop (didn't bet)
Seat 9: oscarleon (small blind) collected ($21.96)





PokerStars Hand #148609686968:  Hold'em No Limit (€0.25/€0.50 EUR) - 2016/02/11 13:33:07 CET [2016/02/11 7:33:07 ET]
Table 'Otero II' 9-max Seat #3 is the button
Seat 1: Effort92 (€51.75 in chips) 
Seat 2: Dantist1122 (€50.50 in chips) 
Seat 3: Szevasztopol (€55.49 in chips) 
Seat 6: TonnaMunz (€50 in chips) 
Seat 8: matiko09 (€66.08 in chips) 
Seat 9: Apparat888 (€26 in chips) 
TonnaMunz: posts small blind €0.25
make6a: is sitting out 
matiko09: posts big blind €0.50
*** HOLE CARDS ***
Dealt to matiko09 [9s 6d]
Apparat888: folds 
Effort92: folds 
Dantist1122: folds 
Szevasztopol: raises €0.50 to €1
make6a leaves the table
TonnaMunz: folds 
matiko09: folds 
Uncalled bet (€0.50) returned to Szevasztopol
Szevasztopol collected €1.25 from pot
Szevasztopol: doesn't show hand 
*** SUMMARY ***
Total pot €1.25 | Rake €0 
Seat 1: Effort92 folded before Flop (didn't bet)
Seat 2: Dantist1122 folded before Flop (didn't bet)
Seat 3: Szevasztopol (button) collected (€1.25)
Seat 6: TonnaMunz (small blind) folded before Flop
Seat 8: matiko09 (big blind) folded before Flop
Seat 9: Apparat888 folded before Flop (didn't bet)





PokerStars Hand #148609687325:  Hold'em No Limit ($0.25/$0.50 USD) - 2016/02/11 13:33:08 CET [2016/02/11 7:33:08 ET]
Table 'Stereoskopia' 9-max Seat #1 is the button
Seat 1: FoRvvArD_go ($50 in chips) 
Seat 2: Dantist1122 ($54.75 in chips) 
Seat 3: fandorin2005 ($50 in chips) 
Seat 4: Anikin44 ($38.15 in chips) 
Seat 5: afrodit71 ($27.24 in chips) 
Seat 6: matiko09 ($53.63 in chips) 
Seat 7: Serhent ($62.80 in chips) 
Seat 8: Reven9er ($50.75 in chips) 
Seat 9: nastynate075 ($14.36 in chips) 
Dantist1122: posts small blind $0.25
fandorin2005: posts big blind $0.50
*** HOLE CARDS ***
Dealt to matiko09 [6c Qd]
Anikin44: raises $1 to $1.50
afrodit71: folds 
matiko09: folds 
Serhent: folds 
Reven9er: folds 
nastynate075: folds 
FoRvvArD_go: folds 
Dantist1122: folds 
fandorin2005: folds 
Uncalled bet ($1) returned to Anikin44
Anikin44 collected $1.25 from pot
Anikin44: doesn't show hand 
*** SUMMARY ***
Total pot $1.25 | Rake $0 
Seat 1: FoRvvArD_go (button) folded before Flop (didn't bet)
Seat 2: Dantist1122 (small blind) folded before Flop
Seat 3: fandorin2005 (big blind) folded before Flop
Seat 4: Anikin44 collected ($1.25)
Seat 5: afrodit71 folded before Flop (didn't bet)
Seat 6: matiko09 folded before Flop (didn't bet)
Seat 7: Serhent folded before Flop (didn't bet)
Seat 8: Reven9er folded before Flop (didn't bet)
Seat 9: nastynate075 folded before Flop (didn't bet)





PokerStars Hand #148609692533:  Hold'em No Limit ($0.50/$1.00 USD) - 2016/02/11 13:33:16 CET [2016/02/11 7:33:16 ET]
Table 'Marion' 9-max Seat #9 is the button
Seat 1: aseban11 ($100 in chips) 
Seat 2: GusenokRUS ($112.45 in chips) 
Seat 3: TimStone ($100 in chips) 
Seat 4: matiko09 ($100 in chips) 
Seat 5: Rikti ($61.75 in chips) 
Seat 6: 19SERGE74 ($92.18 in chips) 
Seat 7: oscarleon ($106.08 in chips) 
Seat 8: Sweden_Pound ($100 in chips) 
Seat 9: Zeeshka ($100 in chips) 
aseban11: posts small blind $0.50
GusenokRUS: posts big blind $1
*** HOLE CARDS ***
Dealt to matiko09 [6h 8d]
TimStone: folds 
matiko09: folds 
Rikti: folds 
19SERGE74: folds 
oscarleon: folds 
Sweden_Pound: folds 
Zeeshka: folds 
aseban11: folds 
Uncalled bet ($0.50) returned to GusenokRUS
GusenokRUS collected $1 from pot
GusenokRUS: doesn't show hand 
*** SUMMARY ***
Total pot $1 | Rake $0 
Seat 1: aseban11 (small blind) folded before Flop
Seat 2: GusenokRUS (big blind) collected ($1)
Seat 3: TimStone folded before Flop (didn't bet)
Seat 4: matiko09 folded before Flop (didn't bet)
Seat 5: Rikti folded before Flop (didn't bet)
Seat 6: 19SERGE74 folded before Flop (didn't bet)
Seat 7: oscarleon folded before Flop (didn't bet)
Seat 8: Sweden_Pound folded before Flop (didn't bet)
Seat 9: Zeeshka (button) folded before Flop (didn't bet)





PokerStars Hand #148609694306:  Hold'em No Limit ($0.50/$1.00 USD) - 2016/02/11 13:33:19 CET [2016/02/11 7:33:19 ET]
Table 'Stephano V' 9-max Seat #3 is the button
Seat 1: hammerwife ($115.25 in chips) 
Seat 2: matiko09 ($141.84 in chips) 
Seat 3: DUkalisUA ($100 in chips) 
Seat 4: Zeeshka ($117.82 in chips) 
Seat 6: Sweden_Pound ($101.50 in chips) 
Seat 7: hurtNCYDE ($103.71 in chips) 
Seat 8: oscarleon ($230.13 in chips) 
Seat 9: IcocaynaI ($30.34 in chips) 
Zeeshka: posts small blind $0.50
Sweden_Pound: posts big blind $1
*** HOLE CARDS ***
Dealt to matiko09 [Qd 6h]
hurtNCYDE: folds 
oscarleon: folds 
IcocaynaI: folds 
hammerwife: folds 
matiko09: folds 
DUkalisUA: raises $1 to $2
Zeeshka: folds 
Sweden_Pound: folds 
Uncalled bet ($1) returned to DUkalisUA
DUkalisUA collected $2.50 from pot
DUkalisUA: doesn't show hand 
*** SUMMARY ***
Total pot $2.50 | Rake $0 
Seat 1: hammerwife folded before Flop (didn't bet)
Seat 2: matiko09 folded before Flop (didn't bet)
Seat 3: DUkalisUA (button) collected ($2.50)
Seat 4: Zeeshka (small blind) folded before Flop
Seat 6: Sweden_Pound (big blind) folded before Flop
Seat 7: hurtNCYDE folded before Flop (didn't bet)
Seat 8: oscarleon folded before Flop (didn't bet)
Seat 9: IcocaynaI folded before Flop (didn't bet)





PokerStars Hand #148609701875:  Hold'em No Limit (€0.25/€0.50 EUR) - 2016/02/11 13:33:32 CET [2016/02/11 7:33:32 ET]
Table 'Otero II' 9-max Seat #6 is the button
Seat 1: Effort92 (€51.75 in chips) 
Seat 2: Dantist1122 (€50.50 in chips) 
Seat 3: Szevasztopol (€56.24 in chips) 
Seat 6: TonnaMunz (€50 in chips) 
Seat 8: matiko09 (€65.58 in chips) 
Seat 9: Apparat888 (€26 in chips) 
matiko09: posts small blind €0.25
Apparat888: posts big blind €0.50
*** HOLE CARDS ***
Dealt to matiko09 [Qc Ad]
Effort92: folds 
Dantist1122: folds 
Szevasztopol: folds 
TonnaMunz: folds 
matiko09: raises €1 to €1.50
Apparat888: folds 
Uncalled bet (€1) returned to matiko09
matiko09 collected €1 from pot
matiko09: doesn't show hand 
*** SUMMARY ***
Total pot €1 | Rake €0 
Seat 1: Effort92 folded before Flop (didn't bet)
Seat 2: Dantist1122 folded before Flop (didn't bet)
Seat 3: Szevasztopol folded before Flop (didn't bet)
Seat 6: TonnaMunz (button) folded before Flop (didn't bet)
Seat 8: matiko09 (small blind) collected (€1)
Seat 9: Apparat888 (big blind) folded before Flop





PokerStars Hand #148609705297:  Hold'em No Limit ($0.25/$0.50 USD) - 2016/02/11 13:33:38 CET [2016/02/11 7:33:38 ET]
Table 'Stereoskopia' 9-max Seat #2 is the button
Seat 1: FoRvvArD_go ($50 in chips) 
Seat 2: Dantist1122 ($54.50 in chips) 
Seat 3: fandorin2005 ($50 in chips) 
Seat 4: Anikin44 ($38.90 in chips) 
Seat 5: afrodit71 ($27.24 in chips) 
Seat 6: matiko09 ($53.63 in chips) 
Seat 7: Serhent ($62.80 in chips) 
Seat 8: Reven9er ($50.75 in chips) 
Seat 9: nastynate075 ($14.36 in chips) 
fandorin2005: posts small blind $0.25
Anikin44: posts big blind $0.50
*** HOLE CARDS ***
Dealt to matiko09 [9s 6d]
afrodit71: calls $0.50
matiko09: folds 
Serhent: folds 
Reven9er: raises $0.75 to $1.25
nastynate075: calls $1.25
FoRvvArD_go: folds 
Dantist1122: folds 
fandorin2005: folds 
Anikin44: folds 
afrodit71: calls $0.75
*** FLOP *** [5d 6s 7d]
afrodit71: checks 
Reven9er: checks 
nastynate075: bets $2
afrodit71: raises $4.50 to $6.50
Reven9er: folds 
nastynate075: raises $6.61 to $13.11 and is all-in
afrodit71: calls $6.61
*** TURN *** [5d 6s 7d] [Ts]
*** RIVER *** [5d 6s 7d Ts] [4s]
*** SHOW DOWN ***
afrodit71: shows [3d 4d] (a straight, Three to Seven)
nastynate075: shows [5c 5s] (three of a kind, Fives)
afrodit71 collected $29.34 from pot
*** SUMMARY ***
Total pot $30.72 | Rake $1.38 
Board [5d 6s 7d Ts 4s]
Seat 1: FoRvvArD_go folded before Flop (didn't bet)
Seat 2: Dantist1122 (button) folded before Flop (didn't bet)
Seat 3: fandorin2005 (small blind) folded before Flop
Seat 4: Anikin44 (big blind) folded before Flop
Seat 5: afrodit71 showed [3d 4d] and won ($29.34) with a straight, Three to Seven
Seat 6: matiko09 folded before Flop (didn't bet)
Seat 7: Serhent folded before Flop (didn't bet)
Seat 8: Reven9er folded on the Flop
Seat 9: nastynate075 showed [5c 5s] and lost with three of a kind, Fives





PokerStars Hand #148609706912:  Hold'em No Limit ($0.25/$0.50 USD) - 2016/02/11 13:33:40 CET [2016/02/11 7:33:40 ET]
Table 'Ambrosia II' 9-max Seat #5 is the button
Seat 1: matiko09 ($50 in chips) 
Seat 2: JJJ-K9 ($60.96 in chips) 
Seat 3: make6a ($81.31 in chips) 
Seat 4: huudk2016 ($26.72 in chips) 
Seat 5: RICKA16 ($60.38 in chips) 
Seat 6: Reven9er ($61.01 in chips) 
Seat 7: Ana.Satravca ($66 in chips) 
Seat 8: Dantist1122 ($50 in chips) 
Seat 9: arctur17 ($48.11 in chips) 
Reven9er: posts small blind $0.25
Ana.Satravca: posts big blind $0.50
*** HOLE CARDS ***
Dealt to matiko09 [3d 3h]
Dantist1122: folds 
arctur17: folds 
matiko09: raises $1 to $1.50
JJJ-K9: folds 
make6a: folds 
huudk2016: calls $1.50
RICKA16: folds 
Reven9er: folds 
Ana.Satravca: folds 
*** FLOP *** [Qd 8h Qs]
matiko09: checks 
huudk2016: checks 
*** TURN *** [Qd 8h Qs] [5h]
matiko09: bets $1.86
huudk2016: calls $1.86
*** RIVER *** [Qd 8h Qs 5h] [Qc]
matiko09: checks 
huudk2016: bets $3.50
matiko09: calls $3.50
*** SHOW DOWN ***
huudk2016: shows [9s Jc] (three of a kind, Queens)
matiko09: shows [3d 3h] (a full house, Queens full of Threes)
matiko09 collected $13.82 from pot
*** SUMMARY ***
Total pot $14.47 | Rake $0.65 
Board [Qd 8h Qs 5h Qc]
Seat 1: matiko09 showed [3d 3h] and won ($13.82) with a full house, Queens full of Threes
Seat 2: JJJ-K9 folded before Flop (didn't bet)
Seat 3: make6a folded before Flop (didn't bet)
Seat 4: huudk2016 showed [9s Jc] and lost with three of a kind, Queens
Seat 5: RICKA16 (button) folded before Flop (didn't bet)
Seat 6: Reven9er (small blind) folded before Flop
Seat 7: Ana.Satravca (big blind) folded before Flop
Seat 8: Dantist1122 folded before Flop (didn't bet)
Seat 9: arctur17 folded before Flop (didn't bet)





PokerStars Hand #148609711346:  Hold'em No Limit ($0.25/$0.50 USD) - 2016/02/11 13:33:47 CET [2016/02/11 7:33:47 ET]
Table 'Sylvania II' 9-max Seat #7 is the button
Seat 2: Effort92 ($94.76 in chips) 
Seat 3: ruyingren ($207.75 in chips) 
Seat 4: matiko09 ($123.75 in chips) 
Seat 6: TonnaMunz ($128.51 in chips) 
Seat 7: 2lefthand75 ($39.18 in chips) 
Seat 8: Apparat888 ($47.95 in chips) 
Seat 9: udden82 ($54.33 in chips) 
Apparat888: posts small blind $0.25
udden82: posts big blind $0.50
Effort92: posts the ante $0.10
ruyingren: posts the ante $0.10
matiko09: posts the ante $0.10
TonnaMunz: posts the ante $0.10
2lefthand75: posts the ante $0.10
Apparat888: posts the ante $0.10
udden82: posts the ante $0.10
*** HOLE CARDS ***
Dealt to matiko09 [9c 6s]
Effort92: folds 
ruyingren: raises $1 to $1.50
matiko09: folds 
TonnaMunz: calls $1.50
2lefthand75: calls $1.50
Apparat888: folds 
udden82: folds 
*** FLOP *** [9d Qd Jd]
ruyingren: bets $2.50
TonnaMunz: folds 
2lefthand75: calls $2.50
*** TURN *** [9d Qd Jd] [8d]
ruyingren: checks 
2lefthand75: checks 
*** RIVER *** [9d Qd Jd 8d] [5h]
ruyingren: bets $10.50
2lefthand75: folds 
Uncalled bet ($10.50) returned to ruyingren
ruyingren collected $10.46 from pot
ruyingren: doesn't show hand 
*** SUMMARY ***
Total pot $10.95 | Rake $0.49 
Board [9d Qd Jd 8d 5h]
Seat 2: Effort92 folded before Flop (didn't bet)
Seat 3: ruyingren collected ($10.46)
Seat 4: matiko09 folded before Flop (didn't bet)
Seat 6: TonnaMunz folded on the Flop
Seat 7: 2lefthand75 (button) folded on the River
Seat 8: Apparat888 (small blind) folded before Flop
Seat 9: udden82 (big blind) folded before Flop





PokerStars Hand #148609714867:  Hold'em No Limit ($0.50/$1.00 USD) - 2016/02/11 13:33:53 CET [2016/02/11 7:33:53 ET]
Table 'Marion' 9-max Seat #1 is the button
Seat 1: aseban11 ($100 in chips) 
Seat 2: GusenokRUS ($112.95 in chips) 
Seat 3: TimStone ($100 in chips) 
Seat 4: matiko09 ($100 in chips) 
Seat 5: Rikti ($61.75 in chips) 
Seat 6: 19SERGE74 ($92.18 in chips) 
Seat 7: oscarleon ($106.08 in chips) 
Seat 8: Sweden_Pound ($100 in chips) 
Seat 9: Zeeshka ($100 in chips) 
GusenokRUS: posts small blind $0.50
TimStone: posts big blind $1
*** HOLE CARDS ***
Dealt to matiko09 [Kh 9s]
matiko09: folds 
Rikti: folds 
19SERGE74: calls $1
oscarleon: folds 
Sweden_Pound: folds 
Zeeshka: folds 
aseban11: folds 
GusenokRUS: calls $0.50
TimStone: checks 
*** FLOP *** [Ah Th Ac]
GusenokRUS: checks 
TimStone: bets $1.89
19SERGE74: calls $1.89
GusenokRUS: raises $4.11 to $6
TimStone: calls $4.11
19SERGE74: folds 
*** TURN *** [Ah Th Ac] [Ks]
GusenokRUS: bets $17
TimStone: folds 
Uncalled bet ($17) returned to GusenokRUS
GusenokRUS collected $16.13 from pot
GusenokRUS: doesn't show hand 
*** SUMMARY ***
Total pot $16.89 | Rake $0.76 
Board [Ah Th Ac Ks]
Seat 1: aseban11 (button) folded before Flop (didn't bet)
Seat 2: GusenokRUS (small blind) collected ($16.13)
Seat 3: TimStone (big blind) folded on the Turn
Seat 4: matiko09 folded before Flop (didn't bet)
Seat 5: Rikti folded before Flop (didn't bet)
Seat 6: 19SERGE74 folded on the Flop
Seat 7: oscarleon folded before Flop (didn't bet)
Seat 8: Sweden_Pound folded before Flop (didn't bet)
Seat 9: Zeeshka folded before Flop (didn't bet)





PokerStars Hand #148609715548:  Hold'em No Limit ($0.50/$1.00 USD) - 2016/02/11 13:33:54 CET [2016/02/11 7:33:54 ET]
Table 'Clorinde' 9-max Seat #2 is the button
Seat 1: matiko09 ($143.70 in chips) 
Seat 2: 19SERGE74 ($49.14 in chips) 
Seat 3: gabi_igna ($103.75 in chips) 
Seat 4: Sweden_Pound ($100 in chips) 
Seat 5: Mukhin1 ($110.88 in chips) 
Seat 6: Gcroc52 ($13.93 in chips) 
Seat 7: Zeeshka ($127.83 in chips) 
Seat 8: aseban11 ($107.08 in chips) 
Seat 9: hammerwife ($100 in chips) 
gabi_igna: posts small blind $0.50
Sweden_Pound: posts big blind $1
*** HOLE CARDS ***
Dealt to matiko09 [Qd 5s]
Mukhin1: folds 
Gcroc52: folds 
Zeeshka: folds 
aseban11: raises $1.50 to $2.50
hammerwife: folds 
matiko09: folds 
19SERGE74: calls $2.50
gabi_igna: folds 
Sweden_Pound: folds 
*** FLOP *** [3d Ad 2h]
aseban11: bets $4.65
19SERGE74: folds 
Uncalled bet ($4.65) returned to aseban11
aseban11 collected $6.21 from pot
aseban11: doesn't show hand 
*** SUMMARY ***
Total pot $6.50 | Rake $0.29 
Board [3d Ad 2h]
Seat 1: matiko09 folded before Flop (didn't bet)
Seat 2: 19SERGE74 (button) folded on the Flop
Seat 3: gabi_igna (small blind) folded before Flop
Seat 4: Sweden_Pound (big blind) folded before Flop
Seat 5: Mukhin1 folded before Flop (didn't bet)
Seat 6: Gcroc52 folded before Flop (didn't bet)
Seat 7: Zeeshka folded before Flop (didn't bet)
Seat 8: aseban11 collected ($6.21)
Seat 9: hammerwife folded before Flop (didn't bet)





PokerStars Hand #148609715891:  Hold'em No Limit ($0.50/$1.00 USD) - 2016/02/11 13:33:55 CET [2016/02/11 7:33:55 ET]
Table 'Stephano V' 9-max Seat #4 is the button
Seat 1: hammerwife ($115.25 in chips) 
Seat 2: matiko09 ($141.84 in chips) 
Seat 3: DUkalisUA ($101.50 in chips) 
Seat 4: Zeeshka ($117.32 in chips) 
Seat 6: Sweden_Pound ($100.50 in chips) 
Seat 8: oscarleon ($230.13 in chips) 
Seat 9: IcocaynaI ($30.34 in chips) 
n2call will be allowed to play after the button
Sweden_Pound: posts small blind $0.50
hurtNCYDE: is sitting out 
hurtNCYDE leaves the table
oscarleon: posts big blind $1
*** HOLE CARDS ***
Dealt to matiko09 [Jh 8s]
IcocaynaI: calls $1
hammerwife: folds 
Effort92 joins the table at seat #7 
matiko09: folds 
DUkalisUA: folds 
Zeeshka: folds 
Sweden_Pound: folds 
oscarleon: checks 
*** FLOP *** [Qd 4d Ks]
oscarleon: checks 
IcocaynaI: bets $1
oscarleon: folds 
Uncalled bet ($1) returned to IcocaynaI
IcocaynaI collected $2.39 from pot
IcocaynaI: doesn't show hand 
*** SUMMARY ***
Total pot $2.50 | Rake $0.11 
Board [Qd 4d Ks]
Seat 1: hammerwife folded before Flop (didn't bet)
Seat 2: matiko09 folded before Flop (didn't bet)
Seat 3: DUkalisUA folded before Flop (didn't bet)
Seat 4: Zeeshka (button) folded before Flop (didn't bet)
Seat 6: Sweden_Pound (small blind) folded before Flop
Seat 8: oscarleon (big blind) folded on the Flop
Seat 9: IcocaynaI collected ($2.39)





PokerStars Hand #148609731909:  Hold'em No Limit ($0.50/$1.00 USD) - 2016/02/11 13:34:21 CET [2016/02/11 7:34:21 ET]
Table 'Kleopatra II' 9-max Seat #6 is the button
Seat 2: azvazdam ($59.97 in chips) 
Seat 3: matiko09 ($104.64 in chips) 
Seat 4: TimStone ($100 in chips) 
Seat 5: Sweden_Pound ($109.23 in chips) 
Seat 6: hammerwife ($171.35 in chips) 
Seat 7: Zeeshka ($202.82 in chips) 
Seat 8: oscarleon ($107.14 in chips) 
Seat 9: vrnMike ($115.93 in chips) 
Zeeshka: posts small blind $0.50
oscarleon: posts big blind $1
DUkalisUA: sits out 
*** HOLE CARDS ***
Dealt to matiko09 [Jc 9d]
vrnMike: folds 
azvazdam: folds 
matiko09: folds 
TimStone: folds 
Sweden_Pound: folds 
hammerwife: raises $1.01 to $2.01
Zeeshka: folds 
oscarleon: folds 
Uncalled bet ($1.01) returned to hammerwife
hammerwife collected $2.50 from pot
hammerwife: doesn't show hand 
*** SUMMARY ***
Total pot $2.50 | Rake $0 
Seat 2: azvazdam folded before Flop (didn't bet)
Seat 3: matiko09 folded before Flop (didn't bet)
Seat 4: TimStone folded before Flop (didn't bet)
Seat 5: Sweden_Pound folded before Flop (didn't bet)
Seat 6: hammerwife (button) collected ($2.50)
Seat 7: Zeeshka (small blind) folded before Flop
Seat 8: oscarleon (big blind) folded before Flop
Seat 9: vrnMike folded before Flop (didn't bet)





PokerStars Hand #148609736041:  Hold'em No Limit (€0.25/€0.50 EUR) - 2016/02/11 13:34:28 CET [2016/02/11 7:34:28 ET]
Table 'Otero II' 9-max Seat #8 is the button
Seat 1: Effort92 (€51.75 in chips) 
Seat 2: Dantist1122 (€50.50 in chips) 
Seat 3: Szevasztopol (€56.24 in chips) 
Seat 6: TonnaMunz (€50 in chips) 
Seat 8: matiko09 (€66.08 in chips) 
Seat 9: Apparat888 (€25.50 in chips) 
Apparat888: posts small blind €0.25
Effort92: posts big blind €0.50
*** HOLE CARDS ***
Dealt to matiko09 [Kh 4d]
Dantist1122: folds 
Dantist1122 leaves the table
Szevasztopol: folds 
TonnaMunz: raises €0.68 to €1.18
matiko09: folds 
Apparat888: folds 
Effort92: folds 
Uncalled bet (€0.68) returned to TonnaMunz
TonnaMunz collected €1.25 from pot
CvMCvMCvM joins the table at seat #7 
TonnaMunz: doesn't show hand 
*** SUMMARY ***
Total pot €1.25 | Rake €0 
Seat 1: Effort92 (big blind) folded before Flop
Seat 2: Dantist1122 folded before Flop (didn't bet)
Seat 3: Szevasztopol folded before Flop (didn't bet)
Seat 6: TonnaMunz collected (€1.25)
Seat 8: matiko09 (button) folded before Flop (didn't bet)
Seat 9: Apparat888 (small blind) folded before Flop





PokerStars Hand #148609742134:  Hold'em No Limit ($0.50/$1.00 USD) - 2016/02/11 13:34:38 CET [2016/02/11 7:34:38 ET]
Table 'Gianfar' 9-max Seat #9 is the button
Seat 1: Vikulja1993 ($100 in chips) 
Seat 2: bilukm ($110.20 in chips) 
Seat 3: AlKatrone ($160.39 in chips) 
Seat 4: matiko09 ($133.98 in chips) 
Seat 5: hammerwife ($152.79 in chips) 
Seat 6: Sweden_Pound ($100 in chips) 
Seat 7: Rikti ($36 in chips) 
Seat 8: Zeeshka ($111.81 in chips) 
Seat 9: oscarleon ($147.62 in chips) 
Vikulja1993: posts small blind $0.50
bilukm: posts big blind $1
*** HOLE CARDS ***
Dealt to matiko09 [4h 7h]
AlKatrone: folds 
matiko09: folds 
hammerwife: folds 
Sweden_Pound: folds 
Rikti: folds 
Zeeshka: raises $2 to $3
oscarleon: folds 
Vikulja1993: folds 
bilukm: folds 
Uncalled bet ($2) returned to Zeeshka
Zeeshka collected $2.50 from pot
Zeeshka: doesn't show hand 
*** SUMMARY ***
Total pot $2.50 | Rake $0 
Seat 1: Vikulja1993 (small blind) folded before Flop
Seat 2: bilukm (big blind) folded before Flop
Seat 3: AlKatrone folded before Flop (didn't bet)
Seat 4: matiko09 folded before Flop (didn't bet)
Seat 5: hammerwife folded before Flop (didn't bet)
Seat 6: Sweden_Pound folded before Flop (didn't bet)
Seat 7: Rikti folded before Flop (didn't bet)
Seat 8: Zeeshka collected ($2.50)
Seat 9: oscarleon (button) folded before Flop (didn't bet)





PokerStars Hand #148609743296:  Hold'em No Limit ($0.25/$0.50 USD) - 2016/02/11 13:34:40 CET [2016/02/11 7:34:40 ET]
Table 'Sylvania II' 9-max Seat #8 is the button
Seat 2: Effort92 ($94.66 in chips) 
Seat 3: ruyingren ($214.11 in chips) 
Seat 4: matiko09 ($123.65 in chips) 
Seat 6: TonnaMunz ($126.91 in chips) 
Seat 7: 2lefthand75 ($35.08 in chips) 
Seat 8: Apparat888 ($47.60 in chips) 
Seat 9: udden82 ($53.73 in chips) 
udden82: posts small blind $0.25
Effort92: posts big blind $0.50
Effort92: posts the ante $0.10
ruyingren: posts the ante $0.10
matiko09: posts the ante $0.10
TonnaMunz: posts the ante $0.10
2lefthand75: posts the ante $0.10
Apparat888: posts the ante $0.10
udden82: posts the ante $0.10
*** HOLE CARDS ***
Dealt to matiko09 [8c 8s]
ruyingren: raises $1 to $1.50
matiko09: raises $3 to $4.50
TonnaMunz: folds 
2lefthand75: folds 
Apparat888: folds 
udden82: folds 
Effort92: folds 
ruyingren: calls $3
*** FLOP *** [5s Qc Kd]
ruyingren: checks 
matiko09: checks 
*** TURN *** [5s Qc Kd] [6h]
ruyingren: bets $5.50
matiko09: calls $5.50
*** RIVER *** [5s Qc Kd 6h] [3s]
ruyingren: checks 
matiko09: checks 
*** SHOW DOWN ***
ruyingren: shows [As Td] (high card Ace)
matiko09: shows [8c 8s] (a pair of Eights)
matiko09 collected $20.48 from pot
*** SUMMARY ***
Total pot $21.45 | Rake $0.97 
Board [5s Qc Kd 6h 3s]
Seat 2: Effort92 (big blind) folded before Flop
Seat 3: ruyingren showed [As Td] and lost with high card Ace
Seat 4: matiko09 showed [8c 8s] and won ($20.48) with a pair of Eights
Seat 6: TonnaMunz folded before Flop (didn't bet)
Seat 7: 2lefthand75 folded before Flop (didn't bet)
Seat 8: Apparat888 (button) folded before Flop (didn't bet)
Seat 9: udden82 (small blind) folded before Flop





PokerStars Hand #148609744776:  Hold'em No Limit ($0.50/$1.00 USD) - 2016/02/11 13:34:42 CET [2016/02/11 7:34:42 ET]
Table 'Clorinde' 9-max Seat #3 is the button
Seat 1: matiko09 ($143.70 in chips) 
Seat 2: 19SERGE74 ($46.64 in chips) 
Seat 3: gabi_igna ($103.25 in chips) 
Seat 4: Sweden_Pound ($100 in chips) 
Seat 5: Mukhin1 ($110.88 in chips) 
Seat 6: Gcroc52 ($13.93 in chips) 
Seat 7: Zeeshka ($127.83 in chips) 
Seat 8: aseban11 ($110.79 in chips) 
Seat 9: hammerwife ($100 in chips) 
Sweden_Pound: posts small blind $0.50
Mukhin1: posts big blind $1
*** HOLE CARDS ***
Dealt to matiko09 [5d Qh]
Gcroc52: folds 
Zeeshka: folds 
aseban11: folds 
hammerwife: folds 
matiko09: folds 
19SERGE74: raises $2 to $3
gabi_igna: folds 
Sweden_Pound: folds 
Mukhin1: folds 
Uncalled bet ($2) returned to 19SERGE74
19SERGE74 collected $2.50 from pot
19SERGE74: doesn't show hand 
*** SUMMARY ***
Total pot $2.50 | Rake $0 
Seat 1: matiko09 folded before Flop (didn't bet)
Seat 2: 19SERGE74 collected ($2.50)
Seat 3: gabi_igna (button) folded before Flop (didn't bet)
Seat 4: Sweden_Pound (small blind) folded before Flop
Seat 5: Mukhin1 (big blind) folded before Flop
Seat 6: Gcroc52 folded before Flop (didn't bet)
Seat 7: Zeeshka folded before Flop (didn't bet)
Seat 8: aseban11 folded before Flop (didn't bet)
Seat 9: hammerwife folded before Flop (didn't bet)





PokerStars Hand #148609745743:  Hold'em No Limit ($0.50/$1.00 USD) - 2016/02/11 13:34:44 CET [2016/02/11 7:34:44 ET]
Table 'Stephano V' 9-max Seat #6 is the button
Seat 1: hammerwife ($115.25 in chips) 
Seat 2: matiko09 ($141.84 in chips) 
Seat 3: DUkalisUA ($101.50 in chips) 
Seat 4: Zeeshka ($117.32 in chips) 
Seat 5: n2call ($242.63 in chips) 
Seat 6: Sweden_Pound ($100 in chips) 
Seat 8: oscarleon ($229.13 in chips) 
Seat 9: IcocaynaI ($31.73 in chips) 
Effort92 will be allowed to play after the button
oscarleon: posts small blind $0.50
IcocaynaI: posts big blind $1
n2call: posts small & big blinds $1.50
*** HOLE CARDS ***
Dealt to matiko09 [Jc 3h]
hammerwife: folds 
matiko09: folds 
DUkalisUA: folds 
Zeeshka: folds 
n2call: raises $2 to $3
Sweden_Pound: folds 
oscarleon: folds 
IcocaynaI: calls $2
*** FLOP *** [2h Ah 4d]
IcocaynaI: bets $1
n2call: raises $5.78 to $6.78
IcocaynaI: folds 
Uncalled bet ($5.78) returned to n2call
n2call collected $8.60 from pot
n2call: doesn't show hand 
*** SUMMARY ***
Total pot $9 | Rake $0.40 
Board [2h Ah 4d]
Seat 1: hammerwife folded before Flop (didn't bet)
Seat 2: matiko09 folded before Flop (didn't bet)
Seat 3: DUkalisUA folded before Flop (didn't bet)
Seat 4: Zeeshka folded before Flop (didn't bet)
Seat 5: n2call collected ($8.60)
Seat 6: Sweden_Pound (button) folded before Flop (didn't bet)
Seat 8: oscarleon (small blind) folded before Flop
Seat 9: IcocaynaI (big blind) folded on the Flop





PokerStars Hand #148609759736:  Hold'em No Limit (€0.25/€0.50 EUR) - 2016/02/11 13:35:07 CET [2016/02/11 7:35:07 ET]
Table 'Otero II' 9-max Seat #9 is the button
Seat 1: Effort92 (€51.25 in chips) 
Seat 6: TonnaMunz (€50.75 in chips) 
Seat 8: matiko09 (€66.08 in chips) 
Seat 9: Apparat888 (€25.25 in chips) 
Effort92: posts small blind €0.25
Szevasztopol: is sitting out 
TonnaMunz: posts big blind €0.50
CvMCvMCvM: sits out 
*** HOLE CARDS ***
Dealt to matiko09 [4d 4c]
matiko09: raises €0.75 to €1.25
Apparat888: folds 
Effort92: folds 
TonnaMunz: folds 
Uncalled bet (€0.75) returned to matiko09
matiko09 collected €1.25 from pot
matiko09: doesn't show hand 
*** SUMMARY ***
Total pot €1.25 | Rake €0 
Seat 1: Effort92 (small blind) folded before Flop
Seat 6: TonnaMunz (big blind) folded before Flop
Seat 8: matiko09 collected (€1.25)
Seat 9: Apparat888 (button) folded before Flop (didn't bet)





PokerStars Hand #148609766064:  Hold'em No Limit ($0.25/$0.50 USD) - 2016/02/11 13:35:17 CET [2016/02/11 7:35:17 ET]
Table 'Stereoskopia' 9-max Seat #3 is the button
Seat 1: FoRvvArD_go ($50 in chips) 
Seat 2: Dantist1122 ($54.50 in chips) 
Seat 3: fandorin2005 ($50 in chips) 
Seat 4: Anikin44 ($38.40 in chips) 
Seat 5: afrodit71 ($42.22 in chips) 
Seat 6: matiko09 ($53.63 in chips) 
Seat 7: Serhent ($62.80 in chips) 
Seat 8: Reven9er ($50 in chips) 
Anikin44: posts small blind $0.25
afrodit71: posts big blind $0.50
*** HOLE CARDS ***
Dealt to matiko09 [Tc 6c]
matiko09: folds 
Serhent: folds 
Reven9er: folds 
FoRvvArD_go: raises $1 to $1.50
Dantist1122: calls $1.50
fandorin2005: folds 
Anikin44: folds 
afrodit71: calls $1
*** FLOP *** [5s Qs As]
afrodit71: checks 
FoRvvArD_go: bets $3.25
Dantist1122: folds 
afrodit71: folds 
Uncalled bet ($3.25) returned to FoRvvArD_go
FoRvvArD_go collected $4.54 from pot
FoRvvArD_go: doesn't show hand 
*** SUMMARY ***
Total pot $4.75 | Rake $0.21 
Board [5s Qs As]
Seat 1: FoRvvArD_go collected ($4.54)
Seat 2: Dantist1122 folded on the Flop
Seat 3: fandorin2005 (button) folded before Flop (didn't bet)
Seat 4: Anikin44 (small blind) folded before Flop
Seat 5: afrodit71 (big blind) folded on the Flop
Seat 6: matiko09 folded before Flop (didn't bet)
Seat 7: Serhent folded before Flop (didn't bet)
Seat 8: Reven9er folded before Flop (didn't bet)





PokerStars Hand #148609768755:  Hold'em No Limit ($0.50/$1.00 USD) - 2016/02/11 13:35:22 CET [2016/02/11 7:35:22 ET]
Table 'Marion' 9-max Seat #2 is the button
Seat 1: aseban11 ($100 in chips) 
Seat 2: GusenokRUS ($122.08 in chips) 
Seat 3: TimStone ($100 in chips) 
Seat 4: matiko09 ($100 in chips) 
Seat 5: Rikti ($61.75 in chips) 
Seat 6: 19SERGE74 ($89.29 in chips) 
Seat 7: oscarleon ($106.08 in chips) 
Seat 8: Sweden_Pound ($100 in chips) 
Seat 9: Zeeshka ($100 in chips) 
TimStone: posts small blind $0.50
matiko09: posts big blind $1
*** HOLE CARDS ***
Dealt to matiko09 [Jh Qd]
Rikti: folds 
19SERGE74: calls $1
oscarleon: folds 
Sweden_Pound: folds 
Zeeshka: folds 
aseban11: folds 
GusenokRUS: folds 
TimStone: calls $0.50
matiko09: checks 
*** FLOP *** [3c As 2h]
TimStone: bets $1.89
matiko09: folds 
19SERGE74: calls $1.89
*** TURN *** [3c As 2h] [7d]
TimStone: checks 
19SERGE74: checks 
*** RIVER *** [3c As 2h 7d] [7c]
TimStone: checks 
19SERGE74: checks 
*** SHOW DOWN ***
TimStone: shows [6s 5s] (a pair of Sevens)
19SERGE74: shows [4d Ad] (two pair, Aces and Sevens)
19SERGE74 collected $6.47 from pot
*** SUMMARY ***
Total pot $6.78 | Rake $0.31 
Board [3c As 2h 7d 7c]
Seat 1: aseban11 folded before Flop (didn't bet)
Seat 2: GusenokRUS (button) folded before Flop (didn't bet)
Seat 3: TimStone (small blind) showed [6s 5s] and lost with a pair of Sevens
Seat 4: matiko09 (big blind) folded on the Flop
Seat 5: Rikti folded before Flop (didn't bet)
Seat 6: 19SERGE74 showed [4d Ad] and won ($6.47) with two pair, Aces and Sevens
Seat 7: oscarleon folded before Flop (didn't bet)
Seat 8: Sweden_Pound folded before Flop (didn't bet)
Seat 9: Zeeshka folded before Flop (didn't bet)





PokerStars Hand #148609769531:  Hold'em No Limit (€0.25/€0.50 EUR) - 2016/02/11 13:35:23 CET [2016/02/11 7:35:23 ET]
Table 'Otero II' 9-max Seat #1 is the button
Seat 1: Effort92 (€51 in chips) 
Seat 6: TonnaMunz (€50.25 in chips) 
Seat 7: CvMCvMCvM (€50 in chips) 
Seat 8: matiko09 (€66.83 in chips) 
Seat 9: Apparat888 (€25.25 in chips) 
TonnaMunz: posts small blind €0.25
CvMCvMCvM: posts big blind €0.50
*** HOLE CARDS ***
Dealt to matiko09 [8s Td]
matiko09: folds 
Apparat888: folds 
Effort92: folds 
TonnaMunz: raises €0.97 to €1.47
CvMCvMCvM: folds 
Uncalled bet (€0.97) returned to TonnaMunz
TonnaMunz collected €1 from pot
TonnaMunz: doesn't show hand 
*** SUMMARY ***
Total pot €1 | Rake €0 
Seat 1: Effort92 (button) folded before Flop (didn't bet)
Seat 6: TonnaMunz (small blind) collected (€1)
Seat 7: CvMCvMCvM (big blind) folded before Flop
Seat 8: matiko09 folded before Flop (didn't bet)
Seat 9: Apparat888 folded before Flop (didn't bet)





PokerStars Hand #148609775243:  Hold'em No Limit ($0.25/$0.50 USD) - 2016/02/11 13:35:33 CET [2016/02/11 7:35:33 ET]
Table 'Ambrosia II' 9-max Seat #6 is the button
Seat 1: matiko09 ($56.96 in chips) 
Seat 2: JJJ-K9 ($60.96 in chips) 
Seat 3: make6a ($81.31 in chips) 
Seat 4: huudk2016 ($19.86 in chips) 
Seat 5: RICKA16 ($60.38 in chips) 
Seat 6: Reven9er ($60.76 in chips) 
Seat 7: Ana.Satravca ($65.50 in chips) 
Seat 8: Dantist1122 ($50 in chips) 
Seat 9: arctur17 ($48.11 in chips) 
Ana.Satravca: posts small blind $0.25
Dantist1122: posts big blind $0.50
*** HOLE CARDS ***
Dealt to matiko09 [8d Jd]
arctur17: calls $0.50
matiko09: folds 
JJJ-K9: folds 
make6a: folds 
huudk2016: calls $0.50
RICKA16: folds 
Reven9er: calls $0.50
Ana.Satravca: folds 
Dantist1122: raises $2.50 to $3
arctur17: calls $2.50
huudk2016: folds 
Reven9er: folds 
*** FLOP *** [2s 9c Qd]
Dantist1122: checks 
arctur17: checks 
*** TURN *** [2s 9c Qd] [Js]
Dantist1122: bets $5.50
arctur17: calls $5.50
*** RIVER *** [2s 9c Qd Js] [2h]
Dantist1122: checks 
arctur17: checks 
*** SHOW DOWN ***
Dantist1122: shows [Td Ac] (a pair of Deuces)
arctur17: shows [Jc 8c] (two pair, Jacks and Deuces)
arctur17 collected $17.43 from pot
*** SUMMARY ***
Total pot $18.25 | Rake $0.82 
Board [2s 9c Qd Js 2h]
Seat 1: matiko09 folded before Flop (didn't bet)
Seat 2: JJJ-K9 folded before Flop (didn't bet)
Seat 3: make6a folded before Flop (didn't bet)
Seat 4: huudk2016 folded before Flop
Seat 5: RICKA16 folded before Flop (didn't bet)
Seat 6: Reven9er (button) folded before Flop
Seat 7: Ana.Satravca (small blind) folded before Flop
Seat 8: Dantist1122 (big blind) showed [Td Ac] and lost with a pair of Deuces
Seat 9: arctur17 showed [Jc 8c] and won ($17.43) with two pair, Jacks and Deuces





PokerStars Hand #148609778307:  Hold'em No Limit ($0.50/$1.00 USD) - 2016/02/11 13:35:38 CET [2016/02/11 7:35:38 ET]
Table 'Kleopatra II' 9-max Seat #7 is the button
Seat 2: azvazdam ($59.97 in chips) 
Seat 3: matiko09 ($104.64 in chips) 
Seat 4: TimStone ($100 in chips) 
Seat 5: Sweden_Pound ($109.23 in chips) 
Seat 6: hammerwife ($172.85 in chips) 
Seat 7: Zeeshka ($202.32 in chips) 
Seat 8: oscarleon ($106.14 in chips) 
Seat 9: vrnMike ($115.93 in chips) 
oscarleon: posts small blind $0.50
vrnMike: posts big blind $1
DUkalisUA: sits out 
*** HOLE CARDS ***
Dealt to matiko09 [Ah Kh]
azvazdam: folds 
matiko09: raises $2 to $3
TimStone: folds 
Sweden_Pound: folds 
hammerwife: folds 
Zeeshka: folds 
oscarleon: folds 
vrnMike: folds 
Uncalled bet ($2) returned to matiko09
matiko09 collected $2.50 from pot
matiko09: doesn't show hand 
*** SUMMARY ***
Total pot $2.50 | Rake $0 
Seat 2: azvazdam folded before Flop (didn't bet)
Seat 3: matiko09 collected ($2.50)
Seat 4: TimStone folded before Flop (didn't bet)
Seat 5: Sweden_Pound folded before Flop (didn't bet)
Seat 6: hammerwife folded before Flop (didn't bet)
Seat 7: Zeeshka (button) folded before Flop (didn't bet)
Seat 8: oscarleon (small blind) folded before Flop
Seat 9: vrnMike (big blind) folded before Flop





PokerStars Hand #148609779361:  Hold'em No Limit ($0.50/$1.00 USD) - 2016/02/11 13:35:39 CET [2016/02/11 7:35:39 ET]
Table 'Gianfar' 9-max Seat #1 is the button
Seat 1: Vikulja1993 ($100 in chips) 
Seat 2: bilukm ($109.20 in chips) 
Seat 3: AlKatrone ($160.39 in chips) 
Seat 4: matiko09 ($133.98 in chips) 
Seat 5: hammerwife ($152.79 in chips) 
Seat 6: Sweden_Pound ($100 in chips) 
Seat 7: Rikti ($36 in chips) 
Seat 8: Zeeshka ($113.31 in chips) 
Seat 9: oscarleon ($147.62 in chips) 
bilukm: posts small blind $0.50
AlKatrone: posts big blind $1
*** HOLE CARDS ***
Dealt to matiko09 [8d As]
matiko09: folds 
hammerwife: folds 
Sweden_Pound: folds 
Rikti: raises $1 to $2
Zeeshka: folds 
oscarleon: folds 
Vikulja1993: raises $4 to $6
bilukm: folds 
AlKatrone: folds 
Rikti: folds 
Uncalled bet ($4) returned to Vikulja1993
Vikulja1993 collected $5.50 from pot
Vikulja1993: doesn't show hand 
*** SUMMARY ***
Total pot $5.50 | Rake $0 
Seat 1: Vikulja1993 (button) collected ($5.50)
Seat 2: bilukm (small blind) folded before Flop
Seat 3: AlKatrone (big blind) folded before Flop
Seat 4: matiko09 folded before Flop (didn't bet)
Seat 5: hammerwife folded before Flop (didn't bet)
Seat 6: Sweden_Pound folded before Flop (didn't bet)
Seat 7: Rikti folded before Flop
Seat 8: Zeeshka folded before Flop (didn't bet)
Seat 9: oscarleon folded before Flop (didn't bet)





PokerStars Hand #148609781753:  Hold'em No Limit ($0.50/$1.00 USD) - 2016/02/11 13:35:43 CET [2016/02/11 7:35:43 ET]
Table 'Clorinde' 9-max Seat #4 is the button
Seat 1: matiko09 ($143.70 in chips) 
Seat 2: 19SERGE74 ($48.14 in chips) 
Seat 3: gabi_igna ($103.25 in chips) 
Seat 4: Sweden_Pound ($100 in chips) 
Seat 5: Mukhin1 ($109.88 in chips) 
Seat 6: Gcroc52 ($13.93 in chips) 
Seat 7: Zeeshka ($127.83 in chips) 
Seat 8: aseban11 ($110.79 in chips) 
Seat 9: hammerwife ($100 in chips) 
Mukhin1: posts small blind $0.50
Gcroc52: posts big blind $1
*** HOLE CARDS ***
Dealt to matiko09 [Jd Ac]
Zeeshka: folds 
aseban11: folds 
hammerwife: folds 
matiko09: raises $2 to $3
19SERGE74: folds 
gabi_igna: raises $6 to $9
Sweden_Pound: folds 
Mukhin1: folds 
Gcroc52: folds 
matiko09: raises $13 to $22
gabi_igna: raises $81.25 to $103.25 and is all-in
matiko09: folds 
Uncalled bet ($81.25) returned to gabi_igna
gabi_igna collected $45.50 from pot
gabi_igna: doesn't show hand 
*** SUMMARY ***
Total pot $45.50 | Rake $0 
Seat 1: matiko09 folded before Flop
Seat 2: 19SERGE74 folded before Flop (didn't bet)
Seat 3: gabi_igna collected ($45.50)
Seat 4: Sweden_Pound (button) folded before Flop (didn't bet)
Seat 5: Mukhin1 (small blind) folded before Flop
Seat 6: Gcroc52 (big blind) folded before Flop
Seat 7: Zeeshka folded before Flop (didn't bet)
Seat 8: aseban11 folded before Flop (didn't bet)
Seat 9: hammerwife folded before Flop (didn't bet)





PokerStars Hand #148609785196:  Hold'em No Limit ($0.25/$0.50 USD) - 2016/02/11 13:35:49 CET [2016/02/11 7:35:49 ET]
Table 'Sylvania II' 9-max Seat #9 is the button
Seat 2: Effort92 ($94.06 in chips) 
Seat 4: matiko09 ($134.03 in chips) 
Seat 6: TonnaMunz ($126.81 in chips) 
Seat 7: 2lefthand75 ($34.98 in chips) 
Seat 8: Apparat888 ($47.50 in chips) 
Seat 9: udden82 ($53.38 in chips) 
tw0315 will be allowed to play after the button
Effort92: posts small blind $0.25
ruyingren: is sitting out 
matiko09: posts big blind $0.50
Effort92: posts the ante $0.10
matiko09: posts the ante $0.10
TonnaMunz: posts the ante $0.10
2lefthand75: posts the ante $0.10
Apparat888: posts the ante $0.10
udden82: posts the ante $0.10
*** HOLE CARDS ***
Dealt to matiko09 [7s Tc]
TonnaMunz: folds 
2lefthand75: calls $0.50
Apparat888: folds 
udden82: folds 
Effort92: folds 
matiko09: checks 
*** FLOP *** [6h 5h 9d]
matiko09: checks 
2lefthand75: bets $1.77
matiko09: folds 
Uncalled bet ($1.77) returned to 2lefthand75
2lefthand75 collected $1.77 from pot
*** SUMMARY ***
Total pot $1.85 | Rake $0.08 
Board [6h 5h 9d]
Seat 2: Effort92 (small blind) folded before Flop
Seat 4: matiko09 (big blind) folded on the Flop
Seat 6: TonnaMunz folded before Flop (didn't bet)
Seat 7: 2lefthand75 collected ($1.77)
Seat 8: Apparat888 folded before Flop (didn't bet)
Seat 9: udden82 (button) folded before Flop (didn't bet)





PokerStars Hand #148609787520:  Hold'em No Limit (€0.25/€0.50 EUR) - 2016/02/11 13:35:53 CET [2016/02/11 7:35:53 ET]
Table 'Otero II' 9-max Seat #6 is the button
Seat 1: Effort92 (€51 in chips) 
Seat 6: TonnaMunz (€50.75 in chips) 
Seat 7: CvMCvMCvM (€50 in chips) 
Seat 8: matiko09 (€66.83 in chips) 
Seat 9: Apparat888 (€25.25 in chips) 
CvMCvMCvM: posts small blind €0.25
matiko09: posts big blind €0.50
*** HOLE CARDS ***
Dealt to matiko09 [4d 3s]
Apparat888: raises €1 to €1.50
Effort92: folds 
TonnaMunz: folds 
CvMCvMCvM: folds 
matiko09: folds 
Uncalled bet (€1) returned to Apparat888
Apparat888 collected €1.25 from pot
*** SUMMARY ***
Total pot €1.25 | Rake €0 
Seat 1: Effort92 folded before Flop (didn't bet)
Seat 6: TonnaMunz (button) folded before Flop (didn't bet)
Seat 7: CvMCvMCvM (small blind) folded before Flop
Seat 8: matiko09 (big blind) folded before Flop
Seat 9: Apparat888 collected (€1.25)





PokerStars Hand #148609792242:  Hold'em No Limit ($0.50/$1.00 USD) - 2016/02/11 13:36:00 CET [2016/02/11 7:36:00 ET]
Table 'Kleopatra II' 9-max Seat #8 is the button
Seat 1: DUkalisUA ($109.08 in chips) 
Seat 2: azvazdam ($59.97 in chips) 
Seat 3: matiko09 ($106.14 in chips) 
Seat 4: TimStone ($100 in chips) 
Seat 5: Sweden_Pound ($109.23 in chips) 
Seat 6: hammerwife ($172.85 in chips) 
Seat 7: Zeeshka ($202.32 in chips) 
Seat 8: oscarleon ($105.64 in chips) 
Seat 9: vrnMike ($114.93 in chips) 
vrnMike: posts small blind $0.50
DUkalisUA: posts big blind $1
*** HOLE CARDS ***
Dealt to matiko09 [Qc 9c]
azvazdam: folds 
matiko09: folds 
TimStone: raises $2.01 to $3.01
Sweden_Pound: folds 
hammerwife: folds 
Zeeshka: folds 
oscarleon: folds 
vrnMike: folds 
DUkalisUA: folds 
Uncalled bet ($2.01) returned to TimStone
TimStone collected $2.50 from pot
TimStone: doesn't show hand 
*** SUMMARY ***
Total pot $2.50 | Rake $0 
Seat 1: DUkalisUA (big blind) folded before Flop
Seat 2: azvazdam folded before Flop (didn't bet)
Seat 3: matiko09 folded before Flop (didn't bet)
Seat 4: TimStone collected ($2.50)
Seat 5: Sweden_Pound folded before Flop (didn't bet)
Seat 6: hammerwife folded before Flop (didn't bet)
Seat 7: Zeeshka folded before Flop (didn't bet)
Seat 8: oscarleon (button) folded before Flop (didn't bet)
Seat 9: vrnMike (small blind) folded before Flop





PokerStars Hand #148609797757:  Hold'em No Limit ($0.50/$1.00 USD) - 2016/02/11 13:36:09 CET [2016/02/11 7:36:09 ET]
Table 'Gianfar' 9-max Seat #2 is the button
Seat 1: Vikulja1993 ($103.50 in chips) 
Seat 2: bilukm ($108.70 in chips) 
Seat 3: AlKatrone ($159.39 in chips) 
Seat 4: matiko09 ($133.98 in chips) 
Seat 5: hammerwife ($152.79 in chips) 
Seat 6: Sweden_Pound ($100 in chips) 
Seat 7: Rikti ($34 in chips) 
Seat 8: Zeeshka ($113.31 in chips) 
Seat 9: oscarleon ($147.62 in chips) 
AlKatrone: posts small blind $0.50
matiko09: posts big blind $1
*** HOLE CARDS ***
Dealt to matiko09 [2d 2h]
hammerwife: folds 
Sweden_Pound: folds 
Rikti: raises $1 to $2
Zeeshka: folds 
oscarleon: folds 
Vikulja1993: folds 
bilukm: folds 
AlKatrone: folds 
matiko09: calls $1
*** FLOP *** [Td 7d Qh]
matiko09: checks 
Rikti: bets $3
matiko09: folds 
Uncalled bet ($3) returned to Rikti
Rikti collected $4.30 from pot
Rikti: doesn't show hand 
*** SUMMARY ***
Total pot $4.50 | Rake $0.20 
Board [Td 7d Qh]
Seat 1: Vikulja1993 folded before Flop (didn't bet)
Seat 2: bilukm (button) folded before Flop (didn't bet)
Seat 3: AlKatrone (small blind) folded before Flop
Seat 4: matiko09 (big blind) folded on the Flop
Seat 5: hammerwife folded before Flop (didn't bet)
Seat 6: Sweden_Pound folded before Flop (didn't bet)
Seat 7: Rikti collected ($4.30)
Seat 8: Zeeshka folded before Flop (didn't bet)
Seat 9: oscarleon folded before Flop (didn't bet)





PokerStars Hand #148609799459:  Hold'em No Limit ($0.25/$0.50 USD) - 2016/02/11 13:36:12 CET [2016/02/11 7:36:12 ET]
Table 'Stereoskopia' 9-max Seat #4 is the button
Seat 1: FoRvvArD_go ($53.04 in chips) 
Seat 2: Dantist1122 ($53 in chips) 
Seat 3: fandorin2005 ($50 in chips) 
Seat 4: Anikin44 ($38.15 in chips) 
Seat 5: afrodit71 ($40.72 in chips) 
Seat 6: matiko09 ($53.63 in chips) 
Seat 7: Serhent ($62.80 in chips) 
Seat 8: Reven9er ($50 in chips) 
Seat 9: nastynate075 ($21 in chips) 
afrodit71: posts small blind $0.25
matiko09: posts big blind $0.50
*** HOLE CARDS ***
Dealt to matiko09 [Qs 4d]
Serhent: folds 
Reven9er: folds 
nastynate075: calls $0.50
FoRvvArD_go: folds 
Dantist1122: folds 
fandorin2005: folds 
Anikin44: calls $0.50
afrodit71: raises $1.50 to $2
matiko09: folds 
nastynate075: calls $1.50
Anikin44: calls $1.50
*** FLOP *** [3d Ah 9h]
afrodit71: bets $2
nastynate075: folds 
Anikin44: calls $2
*** TURN *** [3d Ah 9h] [6s]
afrodit71: bets $3.50
Anikin44: calls $3.50
*** RIVER *** [3d Ah 9h 6s] [Jc]
afrodit71: bets $8.50
Anikin44: folds 
Uncalled bet ($8.50) returned to afrodit71
afrodit71 collected $16.71 from pot
afrodit71: doesn't show hand 
*** SUMMARY ***
Total pot $17.50 | Rake $0.79 
Board [3d Ah 9h 6s Jc]
Seat 1: FoRvvArD_go folded before Flop (didn't bet)
Seat 2: Dantist1122 folded before Flop (didn't bet)
Seat 3: fandorin2005 folded before Flop (didn't bet)
Seat 4: Anikin44 (button) folded on the River
Seat 5: afrodit71 (small blind) collected ($16.71)
Seat 6: matiko09 (big blind) folded before Flop
Seat 7: Serhent folded before Flop (didn't bet)
Seat 8: Reven9er folded before Flop (didn't bet)
Seat 9: nastynate075 folded on the Flop





PokerStars Hand #148609806434:  Hold'em No Limit ($0.25/$0.50 USD) - 2016/02/11 13:36:24 CET [2016/02/11 7:36:24 ET]
Table 'Sylvania II' 9-max Seat #2 is the button
Seat 1: tw0315 ($174.38 in chips) 
Seat 2: Effort92 ($93.71 in chips) 
Seat 4: matiko09 ($133.43 in chips) 
Seat 6: TonnaMunz ($126.71 in chips) 
Seat 7: 2lefthand75 ($36.15 in chips) 
Seat 8: Apparat888 ($47.40 in chips) 
Seat 9: udden82 ($53.28 in chips) 
matiko09: posts small blind $0.25
TonnaMunz: posts big blind $0.50
tw0315: posts small & big blinds $0.75
tw0315: posts the ante $0.10
Effort92: posts the ante $0.10
matiko09: posts the ante $0.10
TonnaMunz: posts the ante $0.10
2lefthand75: posts the ante $0.10
Apparat888: posts the ante $0.10
udden82: posts the ante $0.10
*** HOLE CARDS ***
Dealt to matiko09 [Kc 2h]
2lefthand75: folds 
Apparat888: folds 
udden82: folds 
tw0315: checks 
Effort92: raises $1.50 to $2
matiko09: folds 
ruyingren is disconnected 
TonnaMunz: folds 
tw0315: calls $1.50
*** FLOP *** [2s 5d Qh]
tw0315: checks 
Effort92: bets $3
tw0315: folds 
Uncalled bet ($3) returned to Effort92
Effort92 collected $5.44 from pot
Effort92: doesn't show hand 
*** SUMMARY ***
Total pot $5.70 | Rake $0.26 
Board [2s 5d Qh]
Seat 1: tw0315 folded on the Flop
Seat 2: Effort92 (button) collected ($5.44)
Seat 4: matiko09 (small blind) folded before Flop
Seat 6: TonnaMunz (big blind) folded before Flop
Seat 7: 2lefthand75 folded before Flop (didn't bet)
Seat 8: Apparat888 folded before Flop (didn't bet)
Seat 9: udden82 folded before Flop (didn't bet)





PokerStars Hand #148609810386:  Hold'em No Limit ($0.50/$1.00 USD) - 2016/02/11 13:36:30 CET [2016/02/11 7:36:30 ET]
Table 'Marion' 9-max Seat #3 is the button
Seat 1: aseban11 ($100 in chips) 
Seat 2: GusenokRUS ($122.08 in chips) 
Seat 3: TimStone ($100 in chips) 
Seat 4: matiko09 ($100 in chips) 
Seat 5: Rikti ($61.75 in chips) 
Seat 6: 19SERGE74 ($92.87 in chips) 
Seat 7: oscarleon ($106.08 in chips) 
Seat 8: Sweden_Pound ($100 in chips) 
Seat 9: Zeeshka ($100 in chips) 
matiko09: posts small blind $0.50
Rikti: posts big blind $1
*** HOLE CARDS ***
Dealt to matiko09 [7d 7c]
19SERGE74: folds 
oscarleon: folds 
Sweden_Pound: folds 
Zeeshka: raises $2 to $3
aseban11: folds 
GusenokRUS: folds 
TimStone: folds 
matiko09: folds 
Rikti: folds 
Uncalled bet ($2) returned to Zeeshka
Zeeshka collected $2.50 from pot
Zeeshka: doesn't show hand 
*** SUMMARY ***
Total pot $2.50 | Rake $0 
Seat 1: aseban11 folded before Flop (didn't bet)
Seat 2: GusenokRUS folded before Flop (didn't bet)
Seat 3: TimStone (button) folded before Flop (didn't bet)
Seat 4: matiko09 (small blind) folded before Flop
Seat 5: Rikti (big blind) folded before Flop
Seat 6: 19SERGE74 folded before Flop (didn't bet)
Seat 7: oscarleon folded before Flop (didn't bet)
Seat 8: Sweden_Pound folded before Flop (didn't bet)
Seat 9: Zeeshka collected ($2.50)





PokerStars Hand #148609814052:  Hold'em No Limit ($0.50/$1.00 USD) - 2016/02/11 13:36:36 CET [2016/02/11 7:36:36 ET]
Table 'Stephano V' 9-max Seat #8 is the button
Seat 1: hammerwife ($115.25 in chips) 
Seat 2: matiko09 ($141.84 in chips) 
Seat 3: DUkalisUA ($101.50 in chips) 
Seat 4: Zeeshka ($117.32 in chips) 
Seat 5: n2call ($246.73 in chips) 
Seat 6: Sweden_Pound ($100 in chips) 
Seat 8: oscarleon ($228.63 in chips) 
Seat 9: IcocaynaI ($27.73 in chips) 
IcocaynaI: posts small blind $0.50
hammerwife: posts big blind $1
Effort92: sits out 
*** HOLE CARDS ***
Dealt to matiko09 [4h 9d]
matiko09: folds 
DUkalisUA: folds 
Zeeshka: raises $2 to $3
n2call: folds 
Sweden_Pound: folds 
oscarleon: folds 
IcocaynaI: folds 
hammerwife: folds 
Uncalled bet ($2) returned to Zeeshka
Zeeshka collected $2.50 from pot
Zeeshka: doesn't show hand 
*** SUMMARY ***
Total pot $2.50 | Rake $0 
Seat 1: hammerwife (big blind) folded before Flop
Seat 2: matiko09 folded before Flop (didn't bet)
Seat 3: DUkalisUA folded before Flop (didn't bet)
Seat 4: Zeeshka collected ($2.50)
Seat 5: n2call folded before Flop (didn't bet)
Seat 6: Sweden_Pound folded before Flop (didn't bet)
Seat 8: oscarleon (button) folded before Flop (didn't bet)
Seat 9: IcocaynaI (small blind) folded before Flop





PokerStars Hand #148609819386:  Hold'em No Limit (€0.25/€0.50 EUR) - 2016/02/11 13:36:45 CET [2016/02/11 7:36:45 ET]
Table 'Otero II' 9-max Seat #7 is the button
Seat 1: Effort92 (€51 in chips) 
Seat 6: TonnaMunz (€50.75 in chips) 
Seat 7: CvMCvMCvM (€50 in chips) 
Seat 8: matiko09 (€66.33 in chips) 
Seat 9: Apparat888 (€26 in chips) 
matiko09: posts small blind €0.25
Apparat888: posts big blind €0.50
*** HOLE CARDS ***
Dealt to matiko09 [Js 3d]
Effort92: folds 
TonnaMunz: folds 
CvMCvMCvM: raises €0.88 to €1.38
matiko09: folds 
Apparat888: raises €2.12 to €3.50
CvMCvMCvM: folds 
Uncalled bet (€2.12) returned to Apparat888
Apparat888 collected €3.01 from pot
*** SUMMARY ***
Total pot €3.01 | Rake €0 
Seat 1: Effort92 folded before Flop (didn't bet)
Seat 6: TonnaMunz folded before Flop (didn't bet)
Seat 7: CvMCvMCvM (button) folded before Flop
Seat 8: matiko09 (small blind) folded before Flop
Seat 9: Apparat888 (big blind) collected (€3.01)





PokerStars Hand #148609819944:  Hold'em No Limit ($0.50/$1.00 USD) - 2016/02/11 13:36:46 CET [2016/02/11 7:36:46 ET]
Table 'Kleopatra II' 9-max Seat #9 is the button
Seat 1: DUkalisUA ($108.08 in chips) 
Seat 2: azvazdam ($59.97 in chips) 
Seat 3: matiko09 ($106.14 in chips) 
Seat 4: TimStone ($101.50 in chips) 
Seat 5: Sweden_Pound ($109.23 in chips) 
Seat 6: hammerwife ($172.85 in chips) 
Seat 7: Zeeshka ($202.32 in chips) 
Seat 8: oscarleon ($105.64 in chips) 
Seat 9: vrnMike ($114.43 in chips) 
DUkalisUA: posts small blind $0.50
azvazdam: posts big blind $1
*** HOLE CARDS ***
Dealt to matiko09 [7d 3c]
matiko09: folds 
TimStone: folds 
Sweden_Pound: folds 
hammerwife: folds 
Zeeshka: folds 
oscarleon: folds 
vrnMike: folds 
DUkalisUA: raises $1.50 to $2.50
azvazdam: calls $1.50
*** FLOP *** [Ad Th Kd]
DUkalisUA: bets $3.15
azvazdam: calls $3.15
*** TURN *** [Ad Th Kd] [3h]
DUkalisUA: bets $7.12
azvazdam: folds 
Uncalled bet ($7.12) returned to DUkalisUA
DUkalisUA collected $10.79 from pot
DUkalisUA: doesn't show hand 
*** SUMMARY ***
Total pot $11.30 | Rake $0.51 
Board [Ad Th Kd 3h]
Seat 1: DUkalisUA (small blind) collected ($10.79)
Seat 2: azvazdam (big blind) folded on the Turn
Seat 3: matiko09 folded before Flop (didn't bet)
Seat 4: TimStone folded before Flop (didn't bet)
Seat 5: Sweden_Pound folded before Flop (didn't bet)
Seat 6: hammerwife folded before Flop (didn't bet)
Seat 7: Zeeshka folded before Flop (didn't bet)
Seat 8: oscarleon folded before Flop (didn't bet)
Seat 9: vrnMike (button) folded before Flop (didn't bet)





PokerStars Hand #148609830025:  Hold'em No Limit ($0.50/$1.00 USD) - 2016/02/11 13:37:02 CET [2016/02/11 7:37:02 ET]
Table 'Gianfar' 9-max Seat #3 is the button
Seat 1: Vikulja1993 ($103.50 in chips) 
Seat 2: bilukm ($108.70 in chips) 
Seat 3: AlKatrone ($158.89 in chips) 
Seat 4: matiko09 ($131.98 in chips) 
Seat 5: hammerwife ($152.79 in chips) 
Seat 6: Sweden_Pound ($100 in chips) 
Seat 7: Rikti ($36.30 in chips) 
Seat 8: Zeeshka ($113.31 in chips) 
Seat 9: oscarleon ($147.62 in chips) 
matiko09: posts small blind $0.50
hammerwife: posts big blind $1
*** HOLE CARDS ***
Dealt to matiko09 [As Qc]
Sweden_Pound: folds 
Rikti: folds 
Zeeshka: folds 
oscarleon: folds 
Vikulja1993: folds 
bilukm: calls $1
AlKatrone: raises $2 to $3
matiko09: calls $2.50
hammerwife: folds 
bilukm: calls $2
*** FLOP *** [Kd 7d 2c]
matiko09: checks 
bilukm: checks 
AlKatrone: bets $5
matiko09: folds 
bilukm: calls $5
*** TURN *** [Kd 7d 2c] [9h]
bilukm: checks 
AlKatrone: bets $14
bilukm: folds 
Uncalled bet ($14) returned to AlKatrone
AlKatrone collected $19.10 from pot
AlKatrone: doesn't show hand 
*** SUMMARY ***
Total pot $20 | Rake $0.90 
Board [Kd 7d 2c 9h]
Seat 1: Vikulja1993 folded before Flop (didn't bet)
Seat 2: bilukm folded on the Turn
Seat 3: AlKatrone (button) collected ($19.10)
Seat 4: matiko09 (small blind) folded on the Flop
Seat 5: hammerwife (big blind) folded before Flop
Seat 6: Sweden_Pound folded before Flop (didn't bet)
Seat 7: Rikti folded before Flop (didn't bet)
Seat 8: Zeeshka folded before Flop (didn't bet)
Seat 9: oscarleon folded before Flop (didn't bet)





PokerStars Hand #148609831475:  Hold'em No Limit ($0.25/$0.50 USD) - 2016/02/11 13:37:05 CET [2016/02/11 7:37:05 ET]
Table 'Ambrosia II' 9-max Seat #7 is the button
Seat 1: matiko09 ($56.96 in chips) 
Seat 2: JJJ-K9 ($60.96 in chips) 
Seat 3: make6a ($81.31 in chips) 
Seat 4: huudk2016 ($19.36 in chips) 
Seat 5: RICKA16 ($60.38 in chips) 
Seat 6: Reven9er ($60.26 in chips) 
Seat 7: Ana.Satravca ($65.25 in chips) 
Seat 8: Dantist1122 ($50 in chips) 
Seat 9: arctur17 ($57.04 in chips) 
Dantist1122: posts small blind $0.25
arctur17: posts big blind $0.50
*** HOLE CARDS ***
Dealt to matiko09 [As 5d]
matiko09: folds 
JJJ-K9: folds 
make6a: raises $0.82 to $1.32
huudk2016: folds 
RICKA16: folds 
Reven9er: folds 
Ana.Satravca: folds 
Dantist1122: folds 
arctur17: folds 
Uncalled bet ($0.82) returned to make6a
make6a collected $1.25 from pot
make6a: doesn't show hand 
*** SUMMARY ***
Total pot $1.25 | Rake $0 
Seat 1: matiko09 folded before Flop (didn't bet)
Seat 2: JJJ-K9 folded before Flop (didn't bet)
Seat 3: make6a collected ($1.25)
Seat 4: huudk2016 folded before Flop (didn't bet)
Seat 5: RICKA16 folded before Flop (didn't bet)
Seat 6: Reven9er folded before Flop (didn't bet)
Seat 7: Ana.Satravca (button) folded before Flop (didn't bet)
Seat 8: Dantist1122 (small blind) folded before Flop
Seat 9: arctur17 (big blind) folded before Flop





PokerStars Hand #148609833315:  Hold'em No Limit ($0.50/$1.00 USD) - 2016/02/11 13:37:08 CET [2016/02/11 7:37:08 ET]
Table 'Clorinde' 9-max Seat #5 is the button
Seat 1: matiko09 ($121.70 in chips) 
Seat 2: 19SERGE74 ($48.14 in chips) 
Seat 3: gabi_igna ($126.75 in chips) 
Seat 4: Sweden_Pound ($100 in chips) 
Seat 5: Mukhin1 ($109.38 in chips) 
Seat 6: Gcroc52 ($12.93 in chips) 
Seat 7: Zeeshka ($127.83 in chips) 
Seat 8: aseban11 ($110.79 in chips) 
Seat 9: hammerwife ($100 in chips) 
Gcroc52: posts small blind $0.50
Zeeshka: posts big blind $1
*** HOLE CARDS ***
Dealt to matiko09 [2h 6c]
aseban11: folds 
hammerwife: folds 
matiko09: folds 
19SERGE74: folds 
gabi_igna: folds 
Sweden_Pound has timed out
Sweden_Pound: folds 
Mukhin1: raises $1.30 to $2.30
Gcroc52: folds 
Zeeshka: calls $1.30
*** FLOP *** [3h 3d Ts]
Zeeshka: checks 
Mukhin1: bets $2.53
Zeeshka: calls $2.53
*** TURN *** [3h 3d Ts] [Jc]
Zeeshka: checks 
Mukhin1: checks 
*** RIVER *** [3h 3d Ts Jc] [Qh]
Zeeshka: checks 
Mukhin1: bets $7.85
Zeeshka: calls $7.85
*** SHOW DOWN ***
Mukhin1: shows [As Kd] (a straight, Ten to Ace)
Zeeshka: mucks hand 
Mukhin1 collected $24.70 from pot
*** SUMMARY ***
Total pot $25.86 | Rake $1.16 
Board [3h 3d Ts Jc Qh]
Seat 1: matiko09 folded before Flop (didn't bet)
Seat 2: 19SERGE74 folded before Flop (didn't bet)
Seat 3: gabi_igna folded before Flop (didn't bet)
Seat 4: Sweden_Pound folded before Flop (didn't bet)
Seat 5: Mukhin1 (button) showed [As Kd] and won ($24.70) with a straight, Ten to Ace
Seat 6: Gcroc52 (small blind) folded before Flop
Seat 7: Zeeshka (big blind) mucked [Jh 9s]
Seat 8: aseban11 folded before Flop (didn't bet)
Seat 9: hammerwife folded before Flop (didn't bet)





PokerStars Hand #148609834218:  Hold'em No Limit ($0.50/$1.00 USD) - 2016/02/11 13:37:09 CET [2016/02/11 7:37:09 ET]
Table 'Marion' 9-max Seat #4 is the button
Seat 1: aseban11 ($100 in chips) 
Seat 2: GusenokRUS ($122.08 in chips) 
Seat 3: TimStone ($100 in chips) 
Seat 4: matiko09 ($100 in chips) 
Seat 5: Rikti ($60.75 in chips) 
Seat 6: 19SERGE74 ($92.87 in chips) 
Seat 7: oscarleon ($106.08 in chips) 
Seat 8: Sweden_Pound ($100 in chips) 
Seat 9: Zeeshka ($101.50 in chips) 
Rikti: posts small blind $0.50
19SERGE74: posts big blind $1
*** HOLE CARDS ***
Dealt to matiko09 [9c 8c]
oscarleon: folds 
Sweden_Pound has timed out
Sweden_Pound: folds 
Zeeshka: folds 
aseban11: folds 
GusenokRUS: folds 
TimStone: folds 
matiko09: raises $1.27 to $2.27
Rikti: folds 
19SERGE74: folds 
Uncalled bet ($1.27) returned to matiko09
matiko09 collected $2.50 from pot
matiko09: doesn't show hand 
*** SUMMARY ***
Total pot $2.50 | Rake $0 
Seat 1: aseban11 folded before Flop (didn't bet)
Seat 2: GusenokRUS folded before Flop (didn't bet)
Seat 3: TimStone folded before Flop (didn't bet)
Seat 4: matiko09 (button) collected ($2.50)
Seat 5: Rikti (small blind) folded before Flop
Seat 6: 19SERGE74 (big blind) folded before Flop
Seat 7: oscarleon folded before Flop (didn't bet)
Seat 8: Sweden_Pound folded before Flop (didn't bet)
Seat 9: Zeeshka folded before Flop (didn't bet)





PokerStars Hand #148609837504:  Hold'em No Limit ($0.25/$0.50 USD) - 2016/02/11 13:37:15 CET [2016/02/11 7:37:15 ET]
Table 'Sylvania II' 9-max Seat #4 is the button
Seat 1: tw0315 ($172.03 in chips) 
Seat 2: Effort92 ($97.05 in chips) 
Seat 4: matiko09 ($133.08 in chips) 
Seat 6: TonnaMunz ($126.11 in chips) 
Seat 7: 2lefthand75 ($36.05 in chips) 
Seat 8: Apparat888 ($47.30 in chips) 
Seat 9: udden82 ($53.18 in chips) 
TonnaMunz: posts small blind $0.25
2lefthand75: posts big blind $0.50
tw0315: posts the ante $0.10
Effort92: posts the ante $0.10
matiko09: posts the ante $0.10
TonnaMunz: posts the ante $0.10
2lefthand75: posts the ante $0.10
Apparat888: posts the ante $0.10
udden82: posts the ante $0.10
*** HOLE CARDS ***
Dealt to matiko09 [6c 2c]
Apparat888: raises $1 to $1.50
udden82: calls $1.50
tw0315: calls $1.50
Effort92: folds 
matiko09: folds 
TonnaMunz: folds 
2lefthand75: calls $1
*** FLOP *** [Js 6h 4h]
2lefthand75: checks 
Apparat888: checks 
udden82: checks 
tw0315: checks 
*** TURN *** [Js 6h 4h] [2h]
2lefthand75: bets $1.50
Apparat888: folds 
udden82: calls $1.50
tw0315: folds 
*** RIVER *** [Js 6h 4h 2h] [Qd]
2lefthand75: bets $2.50
udden82: calls $2.50
*** SHOW DOWN ***
2lefthand75: shows [Qh Ac] (a pair of Queens)
udden82: mucks hand 
2lefthand75 collected $14.28 from pot
*** SUMMARY ***
Total pot $14.95 | Rake $0.67 
Board [Js 6h 4h 2h Qd]
Seat 1: tw0315 folded on the Turn
Seat 2: Effort92 folded before Flop (didn't bet)
Seat 4: matiko09 (button) folded before Flop (didn't bet)
Seat 6: TonnaMunz (small blind) folded before Flop
Seat 7: 2lefthand75 (big blind) showed [Qh Ac] and won ($14.28) with a pair of Queens
Seat 8: Apparat888 folded on the Turn
Seat 9: udden82 mucked [5s 5h]





PokerStars Hand #148609838675:  Hold'em No Limit ($0.50/$1.00 USD) - 2016/02/11 13:37:17 CET [2016/02/11 7:37:17 ET]
Table 'Stephano V' 9-max Seat #9 is the button
Seat 1: hammerwife ($114.25 in chips) 
Seat 2: matiko09 ($141.84 in chips) 
Seat 3: DUkalisUA ($101.50 in chips) 
Seat 4: Zeeshka ($118.82 in chips) 
Seat 5: n2call ($246.73 in chips) 
Seat 6: Sweden_Pound ($100 in chips) 
Seat 8: oscarleon ($228.63 in chips) 
Seat 9: IcocaynaI ($27.23 in chips) 
hammerwife: posts small blind $0.50
matiko09: posts big blind $1
Effort92: sits out 
*** HOLE CARDS ***
Dealt to matiko09 [Kd Kh]
DUkalisUA: folds 
Zeeshka: folds 
n2call: folds 
Sweden_Pound: folds 
oscarleon: folds 
IcocaynaI: calls $1
hammerwife: calls $0.50
matiko09: raises $4 to $5
IcocaynaI: folds 
hammerwife: folds 
Uncalled bet ($4) returned to matiko09
matiko09 collected $3 from pot
matiko09: doesn't show hand 
*** SUMMARY ***
Total pot $3 | Rake $0 
Seat 1: hammerwife (small blind) folded before Flop
Seat 2: matiko09 (big blind) collected ($3)
Seat 3: DUkalisUA folded before Flop (didn't bet)
Seat 4: Zeeshka folded before Flop (didn't bet)
Seat 5: n2call folded before Flop (didn't bet)
Seat 6: Sweden_Pound folded before Flop (didn't bet)
Seat 8: oscarleon folded before Flop (didn't bet)
Seat 9: IcocaynaI (button) folded before Flop





PokerStars Hand #148609849612:  Hold'em No Limit ($0.50/$1.00 USD) - 2016/02/11 13:37:35 CET [2016/02/11 7:37:35 ET]
Table 'Kleopatra II' 9-max Seat #1 is the button
Seat 1: DUkalisUA ($113.22 in chips) 
Seat 2: azvazdam ($54.32 in chips) 
Seat 3: matiko09 ($106.14 in chips) 
Seat 4: TimStone ($101.50 in chips) 
Seat 5: Sweden_Pound ($109.23 in chips) 
Seat 6: hammerwife ($172.85 in chips) 
Seat 7: Zeeshka ($202.32 in chips) 
Seat 8: oscarleon ($105.64 in chips) 
Seat 9: vrnMike ($114.43 in chips) 
azvazdam: posts small blind $0.50
matiko09: posts big blind $1
*** HOLE CARDS ***
Dealt to matiko09 [6c 9h]
TimStone: folds 
Sweden_Pound: raises $2 to $3
hammerwife: folds 
Zeeshka: folds 
oscarleon: folds 
vrnMike: calls $3
DUkalisUA: folds 
azvazdam: folds 
matiko09: folds 
*** FLOP *** [Jc Ts As]
Sweden_Pound: bets $4.65
vrnMike: folds 
Uncalled bet ($4.65) returned to Sweden_Pound
Sweden_Pound collected $7.16 from pot
Sweden_Pound: doesn't show hand 
*** SUMMARY ***
Total pot $7.50 | Rake $0.34 
Board [Jc Ts As]
Seat 1: DUkalisUA (button) folded before Flop (didn't bet)
Seat 2: azvazdam (small blind) folded before Flop
Seat 3: matiko09 (big blind) folded before Flop
Seat 4: TimStone folded before Flop (didn't bet)
Seat 5: Sweden_Pound collected ($7.16)
Seat 6: hammerwife folded before Flop (didn't bet)
Seat 7: Zeeshka folded before Flop (didn't bet)
Seat 8: oscarleon folded before Flop (didn't bet)
Seat 9: vrnMike folded on the Flop





PokerStars Hand #148609850643:  Hold'em No Limit ($0.25/$0.50 USD) - 2016/02/11 13:37:36 CET [2016/02/11 7:37:36 ET]
Table 'Ambrosia II' 9-max Seat #8 is the button
Seat 1: matiko09 ($56.96 in chips) 
Seat 2: JJJ-K9 ($60.96 in chips) 
Seat 3: make6a ($82.06 in chips) 
Seat 4: huudk2016 ($19.36 in chips) 
Seat 5: RICKA16 ($60.38 in chips) 
Seat 6: Reven9er ($60.26 in chips) 
Seat 7: Ana.Satravca ($65.25 in chips) 
Seat 8: Dantist1122 ($50 in chips) 
Seat 9: arctur17 ($56.54 in chips) 
arctur17: posts small blind $0.25
matiko09: posts big blind $0.50
*** HOLE CARDS ***
Dealt to matiko09 [6c 4c]
JJJ-K9: folds 
make6a: raises $1 to $1.50
huudk2016: folds 
RICKA16: folds 
Reven9er: folds 
Ana.Satravca: raises $3 to $4.50
Dantist1122: folds 
arctur17: folds 
matiko09: folds 
make6a: calls $3
*** FLOP *** [7d Kc 8h]
make6a: checks 
Ana.Satravca: bets $6
make6a: folds 
Uncalled bet ($6) returned to Ana.Satravca
Ana.Satravca collected $9.31 from pot
*** SUMMARY ***
Total pot $9.75 | Rake $0.44 
Board [7d Kc 8h]
Seat 1: matiko09 (big blind) folded before Flop
Seat 2: JJJ-K9 folded before Flop (didn't bet)
Seat 3: make6a folded on the Flop
Seat 4: huudk2016 folded before Flop (didn't bet)
Seat 5: RICKA16 folded before Flop (didn't bet)
Seat 6: Reven9er folded before Flop (didn't bet)
Seat 7: Ana.Satravca collected ($9.31)
Seat 8: Dantist1122 (button) folded before Flop (didn't bet)
Seat 9: arctur17 (small blind) folded before Flop





PokerStars Hand #148609850661:  Hold'em No Limit (€0.25/€0.50 EUR) - 2016/02/11 13:37:36 CET [2016/02/11 7:37:36 ET]
Table 'Otero II' 9-max Seat #8 is the button
Seat 1: Effort92 (€51 in chips) 
Seat 6: TonnaMunz (€50.75 in chips) 
Seat 7: CvMCvMCvM (€50 in chips) 
Seat 8: matiko09 (€66.08 in chips) 
Seat 9: Apparat888 (€27.63 in chips) 
Apparat888: posts small blind €0.25
Effort92: posts big blind €0.50
*** HOLE CARDS ***
Dealt to matiko09 [Ks 6c]
TonnaMunz: folds 
CvMCvMCvM: raises €0.57 to €1.07
matiko09: folds 
Apparat888: folds 
Effort92: calls €0.57
*** FLOP *** [6s Ac 9s]
Effort92: checks 
CvMCvMCvM: bets €1.36
Effort92: calls €1.36
*** TURN *** [6s Ac 9s] [Kh]
Effort92: checks 
CvMCvMCvM: checks 
*** RIVER *** [6s Ac 9s Kh] [Js]
Effort92: checks 
CvMCvMCvM: bets €3.66
Effort92: calls €3.66
*** SHOW DOWN ***
CvMCvMCvM: shows [Kc Jh] (two pair, Kings and Jacks)
Effort92: mucks hand 
CvMCvMCvM collected €11.87 from pot
*** SUMMARY ***
Total pot €12.43 | Rake €0.56 
Board [6s Ac 9s Kh Js]
Seat 1: Effort92 (big blind) mucked [Ad 3c]
Seat 6: TonnaMunz folded before Flop (didn't bet)
Seat 7: CvMCvMCvM showed [Kc Jh] and won (€11.87) with two pair, Kings and Jacks
Seat 8: matiko09 (button) folded before Flop (didn't bet)
Seat 9: Apparat888 (small blind) folded before Flop





PokerStars Hand #148609853029:  Hold'em No Limit ($0.50/$1.00 USD) - 2016/02/11 13:37:40 CET [2016/02/11 7:37:40 ET]
Table 'Tama' 9-max Seat #5 is the button
Seat 1: aseban11 ($100 in chips) 
Seat 2: matiko09 ($100 in chips) 
Seat 3: gabi_igna ($100 in chips) 
Seat 4: Cogss ($100 in chips) 
Seat 5: Zeeshka ($100 in chips) 
Seat 6: vicdroopy ($100 in chips) 
Seat 7: GrishaPE ($40 in chips) 
Seat 8: er13to ($100 in chips) 
Seat 9: Edvendor ($80 in chips) 
vicdroopy: posts small blind $0.50
GrishaPE: posts big blind $1
*** HOLE CARDS ***
Dealt to matiko09 [4d 6h]
er13to: folds 
Edvendor: folds 
aseban11: folds 
matiko09: folds 
gabi_igna: folds 
Cogss: folds 
Zeeshka: folds 
vicdroopy: folds 
Uncalled bet ($0.50) returned to GrishaPE
GrishaPE collected $1 from pot
*** SUMMARY ***
Total pot $1 | Rake $0 
Seat 1: aseban11 folded before Flop (didn't bet)
Seat 2: matiko09 folded before Flop (didn't bet)
Seat 3: gabi_igna folded before Flop (didn't bet)
Seat 4: Cogss folded before Flop (didn't bet)
Seat 5: Zeeshka (button) folded before Flop (didn't bet)
Seat 6: vicdroopy (small blind) folded before Flop
Seat 7: GrishaPE (big blind) collected ($1)
Seat 8: er13to folded before Flop (didn't bet)
Seat 9: Edvendor folded before Flop (didn't bet)





PokerStars Hand #148609860344:  Hold'em No Limit ($0.50/$1.00 USD) - 2016/02/11 13:37:52 CET [2016/02/11 7:37:52 ET]
Table 'Marion' 9-max Seat #5 is the button
Seat 1: aseban11 ($100 in chips) 
Seat 2: GusenokRUS ($122.08 in chips) 
Seat 3: TimStone ($100 in chips) 
Seat 4: matiko09 ($101.50 in chips) 
Seat 5: Rikti ($60.25 in chips) 
Seat 6: 19SERGE74 ($91.87 in chips) 
Seat 7: oscarleon ($106.08 in chips) 
Seat 9: Zeeshka ($101.50 in chips) 
19SERGE74: posts small blind $0.50
oscarleon: posts big blind $1
*** HOLE CARDS ***
Dealt to matiko09 [2s 5s]
Zeeshka: folds 
aseban11: folds 
GusenokRUS: folds 
TimStone: folds 
matiko09: folds 
Rikti: folds 
19SERGE74: raises $2 to $3
oscarleon: folds 
Uncalled bet ($2) returned to 19SERGE74
19SERGE74 collected $2 from pot
19SERGE74: doesn't show hand 
*** SUMMARY ***
Total pot $2 | Rake $0 
Seat 1: aseban11 folded before Flop (didn't bet)
Seat 2: GusenokRUS folded before Flop (didn't bet)
Seat 3: TimStone folded before Flop (didn't bet)
Seat 4: matiko09 folded before Flop (didn't bet)
Seat 5: Rikti (button) folded before Flop (didn't bet)
Seat 6: 19SERGE74 (small blind) collected ($2)
Seat 7: oscarleon (big blind) folded before Flop
Seat 9: Zeeshka folded before Flop (didn't bet)





PokerStars Hand #148609870041:  Hold'em No Limit ($0.50/$1.00 USD) - 2016/02/11 13:38:08 CET [2016/02/11 7:38:08 ET]
Table 'Marion' 9-max Seat #6 is the button
Seat 1: aseban11 ($100 in chips) 
Seat 2: GusenokRUS ($122.08 in chips) 
Seat 3: TimStone ($100 in chips) 
Seat 4: matiko09 ($101.50 in chips) 
Seat 5: Rikti ($60.25 in chips) 
Seat 6: 19SERGE74 ($92.87 in chips) 
Seat 7: oscarleon ($105.08 in chips) 
Seat 9: Zeeshka ($101.50 in chips) 
oscarleon: posts small blind $0.50
Zeeshka: posts big blind $1
*** HOLE CARDS ***
Dealt to matiko09 [Ts 6s]
aseban11: folds 
GusenokRUS: raises $2 to $3
TimStone: folds 
matiko09: folds 
Rikti is disconnected 
Rikti has timed out while disconnected
Rikti: folds 
19SERGE74: folds 
oscarleon: folds 
Zeeshka: folds 
Uncalled bet ($2) returned to GusenokRUS
GusenokRUS collected $2.50 from pot
GusenokRUS: doesn't show hand 
*** SUMMARY ***
Total pot $2.50 | Rake $0 
Seat 1: aseban11 folded before Flop (didn't bet)
Seat 2: GusenokRUS collected ($2.50)
Seat 3: TimStone folded before Flop (didn't bet)
Seat 4: matiko09 folded before Flop (didn't bet)
Seat 5: Rikti folded before Flop (didn't bet)
Seat 6: 19SERGE74 (button) folded before Flop (didn't bet)
Seat 7: oscarleon (small blind) folded before Flop
Seat 9: Zeeshka (big blind) folded before Flop





PokerStars Hand #148609871347:  Hold'em No Limit ($0.25/$0.50 USD) - 2016/02/11 13:38:10 CET [2016/02/11 7:38:10 ET]
Table 'Sylvania II' 9-max Seat #6 is the button
Seat 1: tw0315 ($170.43 in chips) 
Seat 2: Effort92 ($96.95 in chips) 
Seat 4: matiko09 ($132.98 in chips) 
Seat 6: TonnaMunz ($125.76 in chips) 
Seat 7: 2lefthand75 ($44.73 in chips) 
Seat 8: Apparat888 ($45.70 in chips) 
Seat 9: udden82 ($47.58 in chips) 
2lefthand75: posts small blind $0.25
Apparat888: posts big blind $0.50
tw0315: posts the ante $0.10
Effort92: posts the ante $0.10
matiko09: posts the ante $0.10
TonnaMunz: posts the ante $0.10
2lefthand75: posts the ante $0.10
Apparat888: posts the ante $0.10
udden82: posts the ante $0.10
*** HOLE CARDS ***
Dealt to matiko09 [9d Ac]
udden82: folds 
tw0315: calls $0.50
Effort92: folds 
matiko09: raises $1.50 to $2
TonnaMunz: folds 
2lefthand75: calls $1.75
Apparat888: folds 
tw0315: calls $1.50
*** FLOP *** [6d 4h As]
2lefthand75: checks 
tw0315: checks 
matiko09: bets $4.47
2lefthand75: raises $15.82 to $20.29
tw0315: folds 
matiko09: folds 
Uncalled bet ($15.82) returned to 2lefthand75
2lefthand75 collected $15.41 from pot
*** SUMMARY ***
Total pot $16.14 | Rake $0.73 
Board [6d 4h As]
Seat 1: tw0315 folded on the Flop
Seat 2: Effort92 folded before Flop (didn't bet)
Seat 4: matiko09 folded on the Flop
Seat 6: TonnaMunz (button) folded before Flop (didn't bet)
Seat 7: 2lefthand75 (small blind) collected ($15.41)
Seat 8: Apparat888 (big blind) folded before Flop
Seat 9: udden82 folded before Flop (didn't bet)





PokerStars Hand #148609874159:  Hold'em No Limit ($0.25/$0.50 USD) - 2016/02/11 13:38:15 CET [2016/02/11 7:38:15 ET]
Table 'Stereoskopia' 9-max Seat #5 is the button
Seat 1: FoRvvArD_go ($53.04 in chips) 
Seat 2: Dantist1122 ($53 in chips) 
Seat 3: fandorin2005 ($50 in chips) 
Seat 4: Anikin44 ($40 in chips) 
Seat 5: afrodit71 ($49.93 in chips) 
Seat 6: matiko09 ($53.13 in chips) 
Seat 7: Serhent ($62.80 in chips) 
Seat 8: Reven9er ($50 in chips) 
Seat 9: nastynate075 ($19 in chips) 
matiko09: posts small blind $0.25
Serhent: posts big blind $0.50
*** HOLE CARDS ***
Dealt to matiko09 [4d Kd]
Reven9er: folds 
nastynate075: calls $0.50
FoRvvArD_go: folds 
Dantist1122: folds 
fandorin2005: folds 
Anikin44: raises $1 to $1.50
afrodit71: calls $1.50
matiko09: folds 
Serhent: folds 
nastynate075: calls $1
*** FLOP *** [Qd 5h 6d]
nastynate075: checks 
Anikin44: checks 
afrodit71: checks 
*** TURN *** [Qd 5h 6d] [Ah]
nastynate075: checks 
Anikin44: bets $3.50
afrodit71: folds 
nastynate075: folds 
Uncalled bet ($3.50) returned to Anikin44
Anikin44 collected $5.01 from pot
Anikin44: doesn't show hand 
*** SUMMARY ***
Total pot $5.25 | Rake $0.24 
Board [Qd 5h 6d Ah]
Seat 1: FoRvvArD_go folded before Flop (didn't bet)
Seat 2: Dantist1122 folded before Flop (didn't bet)
Seat 3: fandorin2005 folded before Flop (didn't bet)
Seat 4: Anikin44 collected ($5.01)
Seat 5: afrodit71 (button) folded on the Turn
Seat 6: matiko09 (small blind) folded before Flop
Seat 7: Serhent (big blind) folded before Flop
Seat 8: Reven9er folded before Flop (didn't bet)
Seat 9: nastynate075 folded on the Turn





PokerStars Hand #148609882800:  Hold'em No Limit ($0.50/$1.00 USD) - 2016/02/11 13:38:29 CET [2016/02/11 7:38:29 ET]
Table 'Gianfar' 9-max Seat #4 is the button
Seat 1: Vikulja1993 ($103.50 in chips) 
Seat 2: bilukm ($100.70 in chips) 
Seat 3: AlKatrone ($169.99 in chips) 
Seat 4: matiko09 ($128.98 in chips) 
Seat 5: hammerwife ($151.79 in chips) 
Seat 6: Sweden_Pound ($100 in chips) 
Seat 7: Rikti ($36.30 in chips) 
Seat 8: Zeeshka ($113.31 in chips) 
Seat 9: oscarleon ($147.62 in chips) 
hammerwife: posts small blind $0.50
Sweden_Pound: posts big blind $1
*** HOLE CARDS ***
Dealt to matiko09 [5h 5d]
Rikti is disconnected 
Rikti has timed out while disconnected
Rikti: folds 
Zeeshka: folds 
oscarleon: folds 
Vikulja1993: raises $2 to $3
bilukm: calls $3
AlKatrone: folds 
matiko09: calls $3
hammerwife: raises $12 to $15
Sweden_Pound: folds 
Vikulja1993: folds 
bilukm: calls $12
matiko09: folds 
*** FLOP *** [Jh 8c 7c]
hammerwife: bets $25
bilukm: calls $25
*** TURN *** [Jh 8c 7c] [3h]
hammerwife: bets $60.50
bilukm: folds 
Uncalled bet ($60.50) returned to hammerwife
hammerwife collected $84.20 from pot
*** SUMMARY ***
Total pot $87 | Rake $2.80 
Board [Jh 8c 7c 3h]
Seat 1: Vikulja1993 folded before Flop
Seat 2: bilukm folded on the Turn
Seat 3: AlKatrone folded before Flop (didn't bet)
Seat 4: matiko09 (button) folded before Flop
Seat 5: hammerwife (small blind) collected ($84.20)
Seat 6: Sweden_Pound (big blind) folded before Flop
Seat 7: Rikti folded before Flop (didn't bet)
Seat 8: Zeeshka folded before Flop (didn't bet)
Seat 9: oscarleon folded before Flop (didn't bet)





PokerStars Hand #148609886133:  Hold'em No Limit ($0.25/$0.50 USD) - 2016/02/11 13:38:35 CET [2016/02/11 7:38:35 ET]
Table 'Ambrosia II' 9-max Seat #9 is the button
Seat 1: matiko09 ($56.46 in chips) 
Seat 2: JJJ-K9 ($60.96 in chips) 
Seat 3: make6a ($77.56 in chips) 
Seat 4: huudk2016 ($19.36 in chips) 
Seat 5: RICKA16 ($60.38 in chips) 
Seat 6: Reven9er ($60.26 in chips) 
Seat 7: Ana.Satravca ($70.06 in chips) 
Seat 8: Dantist1122 ($50 in chips) 
Seat 9: arctur17 ($56.29 in chips) 
matiko09: posts small blind $0.25
JJJ-K9: posts big blind $0.50
*** HOLE CARDS ***
Dealt to matiko09 [6c Th]
make6a: folds 
huudk2016: calls $0.50
RICKA16: raises $1.50 to $2
Reven9er: folds 
Ana.Satravca: folds 
Dantist1122: folds 
arctur17: folds 
matiko09: folds 
JJJ-K9: folds 
huudk2016: calls $1.50
*** FLOP *** [Jd 4d 3h]
huudk2016: checks 
RICKA16: bets $3
huudk2016: folds 
Uncalled bet ($3) returned to RICKA16
RICKA16 collected $4.54 from pot
RICKA16: doesn't show hand 
*** SUMMARY ***
Total pot $4.75 | Rake $0.21 
Board [Jd 4d 3h]
Seat 1: matiko09 (small blind) folded before Flop
Seat 2: JJJ-K9 (big blind) folded before Flop
Seat 3: make6a folded before Flop (didn't bet)
Seat 4: huudk2016 folded on the Flop
Seat 5: RICKA16 collected ($4.54)
Seat 6: Reven9er folded before Flop (didn't bet)
Seat 7: Ana.Satravca folded before Flop (didn't bet)
Seat 8: Dantist1122 folded before Flop (didn't bet)
Seat 9: arctur17 (button) folded before Flop (didn't bet)





PokerStars Hand #148609888198:  Hold'em No Limit ($0.50/$1.00 USD) - 2016/02/11 13:38:38 CET [2016/02/11 7:38:38 ET]
Table 'Stephano V' 9-max Seat #1 is the button
Seat 1: hammerwife ($113.25 in chips) 
Seat 2: matiko09 ($143.84 in chips) 
Seat 3: DUkalisUA ($101.50 in chips) 
Seat 4: Zeeshka ($118.82 in chips) 
Seat 5: n2call ($246.73 in chips) 
Seat 6: Sweden_Pound ($100 in chips) 
Seat 8: oscarleon ($228.63 in chips) 
Seat 9: IcocaynaI ($26.23 in chips) 
matiko09: posts small blind $0.50
DUkalisUA: posts big blind $1
Effort92: sits out 
*** HOLE CARDS ***
Dealt to matiko09 [7h 5h]
Zeeshka: folds 
n2call: folds 
Sweden_Pound: raises $2 to $3
oscarleon: folds 
IcocaynaI: raises $2 to $5
hammerwife: folds 
matiko09: folds 
DUkalisUA: folds 
Sweden_Pound: raises $95 to $100 and is all-in
IcocaynaI: calls $21.23 and is all-in
Uncalled bet ($73.77) returned to Sweden_Pound
*** FLOP *** [Qd 2c 6h]
*** TURN *** [Qd 2c 6h] [Ks]
*** RIVER *** [Qd 2c 6h Ks] [Ac]
*** SHOW DOWN ***
Sweden_Pound: shows [Kc Kd] (three of a kind, Kings)
IcocaynaI: shows [Ad Td] (a pair of Aces)
Sweden_Pound collected $51.53 from pot
*** SUMMARY ***
Total pot $53.96 | Rake $2.43 
Board [Qd 2c 6h Ks Ac]
Seat 1: hammerwife (button) folded before Flop (didn't bet)
Seat 2: matiko09 (small blind) folded before Flop
Seat 3: DUkalisUA (big blind) folded before Flop
Seat 4: Zeeshka folded before Flop (didn't bet)
Seat 5: n2call folded before Flop (didn't bet)
Seat 6: Sweden_Pound showed [Kc Kd] and won ($51.53) with three of a kind, Kings
Seat 8: oscarleon folded before Flop (didn't bet)
Seat 9: IcocaynaI showed [Ad Td] and lost with a pair of Aces





PokerStars Hand #148609892113:  Hold'em No Limit ($0.50/$1.00 USD) - 2016/02/11 13:38:45 CET [2016/02/11 7:38:45 ET]
Table 'Kleopatra II' 9-max Seat #2 is the button
Seat 1: DUkalisUA ($113.22 in chips) 
Seat 2: azvazdam ($53.82 in chips) 
Seat 3: matiko09 ($105.14 in chips) 
Seat 4: TimStone ($101.50 in chips) 
Seat 5: Sweden_Pound ($113.39 in chips) 
Seat 6: hammerwife ($172.85 in chips) 
Seat 7: Zeeshka ($202.32 in chips) 
Seat 8: oscarleon ($105.64 in chips) 
Seat 9: vrnMike ($111.43 in chips) 
matiko09: posts small blind $0.50
TimStone: posts big blind $1
*** HOLE CARDS ***
Dealt to matiko09 [Kh 5d]
Sweden_Pound: folds 
hammerwife: folds 
Zeeshka: folds 
oscarleon: folds 
vrnMike: folds 
DUkalisUA: raises $1.50 to $2.50
azvazdam: folds 
matiko09: folds 
TimStone: folds 
Uncalled bet ($1.50) returned to DUkalisUA
DUkalisUA collected $2.50 from pot
DUkalisUA: doesn't show hand 
*** SUMMARY ***
Total pot $2.50 | Rake $0 
Seat 1: DUkalisUA collected ($2.50)
Seat 2: azvazdam (button) folded before Flop (didn't bet)
Seat 3: matiko09 (small blind) folded before Flop
Seat 4: TimStone (big blind) folded before Flop
Seat 5: Sweden_Pound folded before Flop (didn't bet)
Seat 6: hammerwife folded before Flop (didn't bet)
Seat 7: Zeeshka folded before Flop (didn't bet)
Seat 8: oscarleon folded before Flop (didn't bet)
Seat 9: vrnMike folded before Flop (didn't bet)





PokerStars Hand #148609894257:  Hold'em No Limit ($0.50/$1.00 USD) - 2016/02/11 13:38:48 CET [2016/02/11 7:38:48 ET]
Table 'Tama' 9-max Seat #6 is the button
Seat 1: aseban11 ($100 in chips) 
Seat 2: matiko09 ($100 in chips) 
Seat 3: gabi_igna ($100 in chips) 
Seat 4: Cogss ($100 in chips) 
Seat 5: Zeeshka ($100 in chips) 
Seat 6: vicdroopy ($100 in chips) 
Seat 7: GrishaPE ($40.50 in chips) 
Seat 8: er13to ($100 in chips) 
Seat 9: Edvendor ($80 in chips) 
GrishaPE: posts small blind $0.50
er13to: posts big blind $1
*** HOLE CARDS ***
Dealt to matiko09 [5d 8d]
Edvendor: folds 
aseban11: folds 
matiko09: folds 
gabi_igna: raises $2 to $3
Cogss: calls $3
Zeeshka: folds 
vicdroopy: folds 
GrishaPE: calls $2.50
er13to: calls $2
*** FLOP *** [Ks Td 8c]
GrishaPE: checks 
er13to: checks 
gabi_igna: checks 
Cogss: checks 
*** TURN *** [Ks Td 8c] [As]
GrishaPE: checks 
er13to: checks 
gabi_igna: checks 
Cogss: checks 
*** RIVER *** [Ks Td 8c As] [Qs]
GrishaPE: bets $3
er13to: folds 
gabi_igna: folds 
Cogss: folds 
Uncalled bet ($3) returned to GrishaPE
GrishaPE collected $11.46 from pot
*** SUMMARY ***
Total pot $12 | Rake $0.54 
Board [Ks Td 8c As Qs]
Seat 1: aseban11 folded before Flop (didn't bet)
Seat 2: matiko09 folded before Flop (didn't bet)
Seat 3: gabi_igna folded on the River
Seat 4: Cogss folded on the River
Seat 5: Zeeshka folded before Flop (didn't bet)
Seat 6: vicdroopy (button) folded before Flop (didn't bet)
Seat 7: GrishaPE (small blind) collected ($11.46)
Seat 8: er13to (big blind) folded on the River
Seat 9: Edvendor folded before Flop (didn't bet)





PokerStars Hand #148609903724:  Hold'em No Limit ($0.50/$1.00 USD) - 2016/02/11 13:39:04 CET [2016/02/11 7:39:04 ET]
Table 'Clorinde' 9-max Seat #6 is the button
Seat 1: matiko09 ($121.70 in chips) 
Seat 2: 19SERGE74 ($48.14 in chips) 
Seat 3: gabi_igna ($126.75 in chips) 
Seat 4: Sweden_Pound ($100 in chips) 
Seat 5: Mukhin1 ($121.40 in chips) 
Seat 6: Gcroc52 ($12.43 in chips) 
Seat 7: Zeeshka ($115.15 in chips) 
Seat 8: aseban11 ($110.79 in chips) 
Seat 9: hammerwife ($100 in chips) 
Zeeshka: posts small blind $0.50
aseban11: posts big blind $1
*** HOLE CARDS ***
Dealt to matiko09 [Ks 3c]
hammerwife: folds 
matiko09: folds 
19SERGE74: folds 
gabi_igna: folds 
Sweden_Pound: folds 
Mukhin1: folds 
Gcroc52: raises $2 to $3
Zeeshka: raises $6.90 to $9.90
aseban11: folds 
Gcroc52: raises $2.53 to $12.43 and is all-in
Zeeshka: calls $2.53
*** FLOP *** [Js Th 6d]
*** TURN *** [Js Th 6d] [Jh]
*** RIVER *** [Js Th 6d Jh] [Qh]
*** SHOW DOWN ***
Zeeshka: shows [Kh As] (a straight, Ten to Ace)
Gcroc52: mucks hand 
Zeeshka collected $24.70 from pot
*** SUMMARY ***
Total pot $25.86 | Rake $1.16 
Board [Js Th 6d Jh Qh]
Seat 1: matiko09 folded before Flop (didn't bet)
Seat 2: 19SERGE74 folded before Flop (didn't bet)
Seat 3: gabi_igna folded before Flop (didn't bet)
Seat 4: Sweden_Pound folded before Flop (didn't bet)
Seat 5: Mukhin1 folded before Flop (didn't bet)
Seat 6: Gcroc52 (button) mucked [7c 7d]
Seat 7: Zeeshka (small blind) showed [Kh As] and won ($24.70) with a straight, Ten to Ace
Seat 8: aseban11 (big blind) folded before Flop
Seat 9: hammerwife folded before Flop (didn't bet)





PokerStars Hand #148609903598:  Hold'em No Limit ($0.50/$1.00 USD) - 2016/02/11 13:39:04 CET [2016/02/11 7:39:04 ET]
Table 'Marion' 9-max Seat #7 is the button
Seat 1: aseban11 ($100 in chips) 
Seat 2: GusenokRUS ($123.58 in chips) 
Seat 3: TimStone ($100 in chips) 
Seat 4: matiko09 ($101.50 in chips) 
Seat 6: 19SERGE74 ($92.87 in chips) 
Seat 7: oscarleon ($104.58 in chips) 
Seat 9: Zeeshka ($100.50 in chips) 
Sweden_Pound will be allowed to play after the button
Zeeshka: posts small blind $0.50
aseban11: posts big blind $1
*** HOLE CARDS ***
Dealt to matiko09 [6c 8d]
GusenokRUS: raises $2 to $3
TimStone: folds 
matiko09: folds 
19SERGE74: folds 
oscarleon: folds 
Zeeshka: folds 
aseban11: folds 
Uncalled bet ($2) returned to GusenokRUS
GusenokRUS collected $2.50 from pot
GusenokRUS: doesn't show hand 
*** SUMMARY ***
Total pot $2.50 | Rake $0 
Seat 1: aseban11 (big blind) folded before Flop
Seat 2: GusenokRUS collected ($2.50)
Seat 3: TimStone folded before Flop (didn't bet)
Seat 4: matiko09 folded before Flop (didn't bet)
Seat 6: 19SERGE74 folded before Flop (didn't bet)
Seat 7: oscarleon (button) folded before Flop (didn't bet)
Seat 9: Zeeshka (small blind) folded before Flop





PokerStars Hand #148609906618:  Hold'em No Limit ($0.25/$0.50 USD) - 2016/02/11 13:39:08 CET [2016/02/11 7:39:08 ET]
Table 'Sylvania II' 9-max Seat #7 is the button
Seat 1: tw0315 ($168.33 in chips) 
Seat 2: Effort92 ($96.85 in chips) 
Seat 4: matiko09 ($126.41 in chips) 
Seat 6: TonnaMunz ($125.66 in chips) 
Seat 7: 2lefthand75 ($53.57 in chips) 
Seat 8: Apparat888 ($45.10 in chips) 
Seat 9: udden82 ($47.48 in chips) 
Apparat888: posts small blind $0.25
udden82: posts big blind $0.50
tw0315: posts the ante $0.10
Effort92: posts the ante $0.10
matiko09: posts the ante $0.10
TonnaMunz: posts the ante $0.10
2lefthand75: posts the ante $0.10
Apparat888: posts the ante $0.10
udden82: posts the ante $0.10
*** HOLE CARDS ***
Dealt to matiko09 [9d 6d]
tw0315: calls $0.50
Effort92: folds 
matiko09: folds 
TonnaMunz: folds 
2lefthand75: raises $1 to $1.50
Apparat888: calls $1.25
udden82: folds 
tw0315: calls $1
*** FLOP *** [5h Ks 2h]
Apparat888: checks 
tw0315: bets $2.72
2lefthand75: calls $2.72
Apparat888: calls $2.72
*** TURN *** [5h Ks 2h] [Td]
Apparat888: checks 
tw0315: checks 
2lefthand75: checks 
*** RIVER *** [5h Ks 2h Td] [Qs]
Apparat888: checks 
tw0315: checks 
2lefthand75: checks 
*** SHOW DOWN ***
Apparat888: shows [8h 7h] (high card King)
tw0315: shows [2c 2d] (three of a kind, Deuces)
2lefthand75: mucks hand 
tw0315 collected $13.24 from pot
*** SUMMARY ***
Total pot $13.86 | Rake $0.62 
Board [5h Ks 2h Td Qs]
Seat 1: tw0315 showed [2c 2d] and won ($13.24) with three of a kind, Deuces
Seat 2: Effort92 folded before Flop (didn't bet)
Seat 4: matiko09 folded before Flop (didn't bet)
Seat 6: TonnaMunz folded before Flop (didn't bet)
Seat 7: 2lefthand75 (button) mucked [4h Ac]
Seat 8: Apparat888 (small blind) showed [8h 7h] and lost with high card King
Seat 9: udden82 (big blind) folded before Flop





PokerStars Hand #148609912755:  Hold'em No Limit ($0.50/$1.00 USD) - 2016/02/11 13:39:18 CET [2016/02/11 7:39:18 ET]
Table 'Kleopatra II' 9-max Seat #3 is the button
Seat 1: DUkalisUA ($114.72 in chips) 
Seat 2: azvazdam ($53.82 in chips) 
Seat 3: matiko09 ($104.64 in chips) 
Seat 4: TimStone ($100.50 in chips) 
Seat 5: Sweden_Pound ($113.39 in chips) 
Seat 6: hammerwife ($172.85 in chips) 
Seat 7: Zeeshka ($202.32 in chips) 
Seat 8: oscarleon ($105.64 in chips) 
Seat 9: vrnMike ($111.43 in chips) 
TimStone: posts small blind $0.50
Sweden_Pound: posts big blind $1
*** HOLE CARDS ***
Dealt to matiko09 [Jd Js]
hammerwife: folds 
Zeeshka: folds 
oscarleon: folds 
vrnMike: folds 
DUkalisUA: raises $2 to $3
azvazdam: raises $6 to $9
matiko09: folds 
TimStone: folds 
Sweden_Pound: folds 
DUkalisUA: folds 
Uncalled bet ($6) returned to azvazdam
azvazdam collected $7.50 from pot
azvazdam: doesn't show hand 
*** SUMMARY ***
Total pot $7.50 | Rake $0 
Seat 1: DUkalisUA folded before Flop
Seat 2: azvazdam collected ($7.50)
Seat 3: matiko09 (button) folded before Flop (didn't bet)
Seat 4: TimStone (small blind) folded before Flop
Seat 5: Sweden_Pound (big blind) folded before Flop
Seat 6: hammerwife folded before Flop (didn't bet)
Seat 7: Zeeshka folded before Flop (didn't bet)
Seat 8: oscarleon folded before Flop (didn't bet)
Seat 9: vrnMike folded before Flop (didn't bet)





PokerStars Hand #148609919034:  Hold'em No Limit ($0.25/$0.50 USD) - 2016/02/11 13:39:29 CET [2016/02/11 7:39:29 ET]
Table 'Ambrosia II' 9-max Seat #1 is the button
Seat 1: matiko09 ($56.21 in chips) 
Seat 2: JJJ-K9 ($60.46 in chips) 
Seat 3: make6a ($77.56 in chips) 
Seat 4: huudk2016 ($17.36 in chips) 
Seat 5: RICKA16 ($62.92 in chips) 
Seat 6: Reven9er ($60.26 in chips) 
Seat 7: Ana.Satravca ($70.06 in chips) 
Seat 8: Dantist1122 ($50 in chips) 
Seat 9: arctur17 ($56.29 in chips) 
JJJ-K9: posts small blind $0.25
make6a: posts big blind $0.50
*** HOLE CARDS ***
Dealt to matiko09 [2d 9d]
huudk2016: folds 
RICKA16: folds 
Reven9er: folds 
Ana.Satravca: folds 
Dantist1122: raises $1 to $1.50
arctur17: folds 
matiko09: folds 
JJJ-K9: folds 
make6a: folds 
Uncalled bet ($1) returned to Dantist1122
Dantist1122 collected $1.25 from pot
Dantist1122: doesn't show hand 
*** SUMMARY ***
Total pot $1.25 | Rake $0 
Seat 1: matiko09 (button) folded before Flop (didn't bet)
Seat 2: JJJ-K9 (small blind) folded before Flop
Seat 3: make6a (big blind) folded before Flop
Seat 4: huudk2016 folded before Flop (didn't bet)
Seat 5: RICKA16 folded before Flop (didn't bet)
Seat 6: Reven9er folded before Flop (didn't bet)
Seat 7: Ana.Satravca folded before Flop (didn't bet)
Seat 8: Dantist1122 collected ($1.25)
Seat 9: arctur17 folded before Flop (didn't bet)





PokerStars Hand #148609925343:  Hold'em No Limit ($0.50/$1.00 USD) - 2016/02/11 13:39:39 CET [2016/02/11 7:39:39 ET]
Table 'Marion' 9-max Seat #9 is the button
Seat 1: aseban11 ($100 in chips) 
Seat 2: GusenokRUS ($125.08 in chips) 
Seat 3: TimStone ($100 in chips) 
Seat 4: matiko09 ($101.50 in chips) 
Seat 5: Rikti ($60.25 in chips) 
Seat 6: 19SERGE74 ($92.87 in chips) 
Seat 7: oscarleon ($104.58 in chips) 
Seat 9: Zeeshka ($100 in chips) 
aseban11: posts small blind $0.50
GusenokRUS: posts big blind $1
Sweden_Pound: sits out 
*** HOLE CARDS ***
Dealt to matiko09 [5d Ah]
TimStone: folds 
matiko09: folds 
Rikti: folds 
19SERGE74: folds 
oscarleon: folds 
Zeeshka: folds 
aseban11: folds 
Uncalled bet ($0.50) returned to GusenokRUS
GusenokRUS collected $1 from pot
GusenokRUS: doesn't show hand 
*** SUMMARY ***
Total pot $1 | Rake $0 
Seat 1: aseban11 (small blind) folded before Flop
Seat 2: GusenokRUS (big blind) collected ($1)
Seat 3: TimStone folded before Flop (didn't bet)
Seat 4: matiko09 folded before Flop (didn't bet)
Seat 5: Rikti folded before Flop (didn't bet)
Seat 6: 19SERGE74 folded before Flop (didn't bet)
Seat 7: oscarleon folded before Flop (didn't bet)
Seat 9: Zeeshka (button) folded before Flop (didn't bet)





PokerStars Hand #148609926656:  Hold'em No Limit ($0.25/$0.50 USD) - 2016/02/11 13:39:41 CET [2016/02/11 7:39:41 ET]
Table 'Stereoskopia' 9-max Seat #6 is the button
Seat 1: FoRvvArD_go ($53.04 in chips) 
Seat 2: Dantist1122 ($53 in chips) 
Seat 3: fandorin2005 ($50 in chips) 
Seat 4: Anikin44 ($43.51 in chips) 
Seat 5: afrodit71 ($48.43 in chips) 
Seat 6: matiko09 ($52.88 in chips) 
Seat 7: Serhent ($62.30 in chips) 
Seat 9: nastynate075 ($17.50 in chips) 
Serhent: posts small blind $0.25
Reven9er: is sitting out 
nastynate075: posts big blind $0.50
*** HOLE CARDS ***
Dealt to matiko09 [7c 8c]
Reven9er leaves the table
FoRvvArD_go: folds 
Dantist1122: folds 
fandorin2005: folds 
Anikin44: folds 
afrodit71: folds 
matiko09: raises $0.63 to $1.13
Serhent: folds 
nastynate075: calls $0.63
*** FLOP *** [8s Kh 2d]
nastynate075: checks 
matiko09: bets $1.56
nastynate075: folds 
Uncalled bet ($1.56) returned to matiko09
matiko09 collected $2.40 from pot
matiko09: doesn't show hand 
*** SUMMARY ***
Total pot $2.51 | Rake $0.11 
Board [8s Kh 2d]
Seat 1: FoRvvArD_go folded before Flop (didn't bet)
Seat 2: Dantist1122 folded before Flop (didn't bet)
Seat 3: fandorin2005 folded before Flop (didn't bet)
Seat 4: Anikin44 folded before Flop (didn't bet)
Seat 5: afrodit71 folded before Flop (didn't bet)
Seat 6: matiko09 (button) collected ($2.40)
Seat 7: Serhent (small blind) folded before Flop
Seat 9: nastynate075 (big blind) folded on the Flop





PokerStars Hand #148609931101:  Hold'em No Limit ($0.50/$1.00 USD) - 2016/02/11 13:39:49 CET [2016/02/11 7:39:49 ET]
Table 'Stephano V' 9-max Seat #2 is the button
Seat 1: hammerwife ($113.25 in chips) 
Seat 2: matiko09 ($143.34 in chips) 
Seat 3: DUkalisUA ($100.50 in chips) 
Seat 4: Zeeshka ($118.82 in chips) 
Seat 5: n2call ($246.73 in chips) 
Seat 6: Sweden_Pound ($125.30 in chips) 
Seat 8: oscarleon ($228.63 in chips) 
DUkalisUA: posts small blind $0.50
Zeeshka: posts big blind $1
Effort92: sits out 
*** HOLE CARDS ***
Dealt to matiko09 [7s As]
n2call: folds 
IcocaynaI leaves the table
Sweden_Pound: folds 
oscarleon: folds 
hammerwife: folds 
Rikti joins the table at seat #9 
matiko09: raises $1.27 to $2.27
Rikti leaves the table
DUkalisUA: folds 
Zeeshka: calls $1.27
*** FLOP *** [Js Kd Ac]
Zeeshka: checks 
matiko09: bets $3.13
Zeeshka: folds 
Uncalled bet ($3.13) returned to matiko09
matiko09 collected $4.81 from pot
matiko09: doesn't show hand 
*** SUMMARY ***
Total pot $5.04 | Rake $0.23 
Board [Js Kd Ac]
Seat 1: hammerwife folded before Flop (didn't bet)
Seat 2: matiko09 (button) collected ($4.81)
Seat 3: DUkalisUA (small blind) folded before Flop
Seat 4: Zeeshka (big blind) folded on the Flop
Seat 5: n2call folded before Flop (didn't bet)
Seat 6: Sweden_Pound folded before Flop (didn't bet)
Seat 8: oscarleon folded before Flop (didn't bet)





PokerStars Hand #148609935821:  Hold'em No Limit ($0.25/$0.50 USD) - 2016/02/11 13:39:56 CET [2016/02/11 7:39:56 ET]
Table 'Ambrosia II' 9-max Seat #2 is the button
Seat 1: matiko09 ($56.21 in chips) 
Seat 2: JJJ-K9 ($60.21 in chips) 
Seat 3: make6a ($77.06 in chips) 
Seat 4: huudk2016 ($17.36 in chips) 
Seat 5: RICKA16 ($62.92 in chips) 
Seat 6: Reven9er ($60.26 in chips) 
Seat 7: Ana.Satravca ($70.06 in chips) 
Seat 8: Dantist1122 ($50.75 in chips) 
Seat 9: arctur17 ($56.29 in chips) 
make6a: posts small blind $0.25
huudk2016: posts big blind $0.50
*** HOLE CARDS ***
Dealt to matiko09 [7h 4d]
RICKA16: folds 
Reven9er: folds 
Ana.Satravca: folds 
Dantist1122: raises $1 to $1.50
arctur17: calls $1.50
matiko09: folds 
JJJ-K9: folds 
make6a: folds 
huudk2016: raises $2 to $3.50
Dantist1122: calls $2
arctur17: calls $2
*** FLOP *** [6s 7s 9d]
huudk2016: bets $13.86 and is all-in
Dantist1122: folds 
arctur17: folds 
Uncalled bet ($13.86) returned to huudk2016
huudk2016 collected $10.27 from pot
huudk2016: doesn't show hand 
*** SUMMARY ***
Total pot $10.75 | Rake $0.48 
Board [6s 7s 9d]
Seat 1: matiko09 folded before Flop (didn't bet)
Seat 2: JJJ-K9 (button) folded before Flop (didn't bet)
Seat 3: make6a (small blind) folded before Flop
Seat 4: huudk2016 (big blind) collected ($10.27)
Seat 5: RICKA16 folded before Flop (didn't bet)
Seat 6: Reven9er folded before Flop (didn't bet)
Seat 7: Ana.Satravca folded before Flop (didn't bet)
Seat 8: Dantist1122 folded on the Flop
Seat 9: arctur17 folded on the Flop





PokerStars Hand #148609935925:  Hold'em No Limit ($0.50/$1.00 USD) - 2016/02/11 13:39:57 CET [2016/02/11 7:39:57 ET]
Table 'Clorinde' 9-max Seat #7 is the button
Seat 1: matiko09 ($121.70 in chips) 
Seat 2: 19SERGE74 ($48.14 in chips) 
Seat 3: gabi_igna ($126.75 in chips) 
Seat 4: Sweden_Pound ($100 in chips) 
Seat 5: Mukhin1 ($121.40 in chips) 
Seat 7: Zeeshka ($127.42 in chips) 
Seat 8: aseban11 ($109.79 in chips) 
Seat 9: hammerwife ($100 in chips) 
aseban11: posts small blind $0.50
hammerwife: posts big blind $1
*** HOLE CARDS ***
Dealt to matiko09 [Ah Ks]
matiko09: raises $2 to $3
Gcroc52 leaves the table
19SERGE74: calls $3
gabi_igna: folds 
Sweden_Pound: folds 
Mukhin1: folds 
Zeeshka: folds 
aseban11: folds 
vrnMike joins the table at seat #6 
hammerwife: folds 
*** FLOP *** [7c 4s 5s]
vrnMike leaves the table
Rikti joins the table at seat #6 
matiko09: checks 
Rikti leaves the table
19SERGE74: bets $3
matiko09: folds 
Uncalled bet ($3) returned to 19SERGE74
19SERGE74 collected $7.16 from pot
19SERGE74: doesn't show hand 
*** SUMMARY ***
Total pot $7.50 | Rake $0.34 
Board [7c 4s 5s]
Seat 1: matiko09 folded on the Flop
Seat 2: 19SERGE74 collected ($7.16)
Seat 3: gabi_igna folded before Flop (didn't bet)
Seat 4: Sweden_Pound folded before Flop (didn't bet)
Seat 5: Mukhin1 folded before Flop (didn't bet)
Seat 7: Zeeshka (button) folded before Flop (didn't bet)
Seat 8: aseban11 (small blind) folded before Flop
Seat 9: hammerwife (big blind) folded before Flop





PokerStars Hand #148609939627:  Hold'em No Limit ($0.50/$1.00 USD) - 2016/02/11 13:40:03 CET [2016/02/11 7:40:03 ET]
Table 'Tama' 9-max Seat #7 is the button
Seat 1: aseban11 ($100 in chips) 
Seat 2: matiko09 ($100 in chips) 
Seat 3: gabi_igna ($100 in chips) 
Seat 4: Cogss ($97 in chips) 
Seat 5: Zeeshka ($100 in chips) 
Seat 6: vicdroopy ($100 in chips) 
Seat 7: GrishaPE ($48.96 in chips) 
Seat 8: er13to ($100 in chips) 
Seat 9: Edvendor ($80 in chips) 
er13to: posts small blind $0.50
Edvendor: posts big blind $1
*** HOLE CARDS ***
Dealt to matiko09 [3c 4d]
aseban11: folds 
matiko09: folds 
gabi_igna: raises $2 to $3
Cogss: calls $3
Zeeshka: folds 
vicdroopy: folds 
GrishaPE: folds 
er13to: folds 
Edvendor: calls $2
*** FLOP *** [2d Th 4c]
Edvendor: checks 
gabi_igna: bets $6
Cogss: raises $6 to $12
Edvendor: folds 
gabi_igna: calls $6
*** TURN *** [2d Th 4c] [5d]
gabi_igna: checks 
Cogss: bets $15.99
gabi_igna: raises $23.01 to $39
Cogss: calls $23.01
*** RIVER *** [2d Th 4c 5d] [Td]
gabi_igna: checks 
Cogss: checks 
*** SHOW DOWN ***
gabi_igna: shows [Ac Ad] (two pair, Aces and Tens)
Cogss: shows [Tc Qd] (three of a kind, Tens)
Cogss collected $108.70 from pot
*** SUMMARY ***
Total pot $111.50 | Rake $2.80 
Board [2d Th 4c 5d Td]
Seat 1: aseban11 folded before Flop (didn't bet)
Seat 2: matiko09 folded before Flop (didn't bet)
Seat 3: gabi_igna showed [Ac Ad] and lost with two pair, Aces and Tens
Seat 4: Cogss showed [Tc Qd] and won ($108.70) with three of a kind, Tens
Seat 5: Zeeshka folded before Flop (didn't bet)
Seat 6: vicdroopy folded before Flop (didn't bet)
Seat 7: GrishaPE (button) folded before Flop (didn't bet)
Seat 8: er13to (small blind) folded before Flop
Seat 9: Edvendor (big blind) folded on the Flop





PokerStars Hand #148609940224:  Hold'em No Limit ($0.50/$1.00 USD) - 2016/02/11 13:40:04 CET [2016/02/11 7:40:04 ET]
Table 'Marion' 9-max Seat #1 is the button
Seat 1: aseban11 ($100 in chips) 
Seat 2: GusenokRUS ($125.58 in chips) 
Seat 3: TimStone ($100 in chips) 
Seat 4: matiko09 ($101.50 in chips) 
Seat 5: Rikti ($60.25 in chips) 
Seat 6: 19SERGE74 ($92.87 in chips) 
Seat 7: oscarleon ($104.58 in chips) 
Seat 9: Zeeshka ($100 in chips) 
GusenokRUS: posts small blind $0.50
TimStone: posts big blind $1
Sweden_Pound: sits out 
*** HOLE CARDS ***
Dealt to matiko09 [5c 9c]
matiko09: folds 
Rikti: folds 
19SERGE74: folds 
oscarleon: folds 
Zeeshka: folds 
aseban11: folds 
GusenokRUS: folds 
Uncalled bet ($0.50) returned to TimStone
TimStone collected $1 from pot
TimStone: doesn't show hand 
*** SUMMARY ***
Total pot $1 | Rake $0 
Seat 1: aseban11 (button) folded before Flop (didn't bet)
Seat 2: GusenokRUS (small blind) folded before Flop
Seat 3: TimStone (big blind) collected ($1)
Seat 4: matiko09 folded before Flop (didn't bet)
Seat 5: Rikti folded before Flop (didn't bet)
Seat 6: 19SERGE74 folded before Flop (didn't bet)
Seat 7: oscarleon folded before Flop (didn't bet)
Seat 9: Zeeshka folded before Flop (didn't bet)





PokerStars Hand #148609941272:  Hold'em No Limit (€0.25/€0.50 EUR) - 2016/02/11 13:40:05 CET [2016/02/11 7:40:05 ET]
Table 'Otero II' 9-max Seat #9 is the button
Seat 1: Effort92 (€50 in chips) 
Seat 6: TonnaMunz (€50.75 in chips) 
Seat 7: CvMCvMCvM (€55.78 in chips) 
Seat 8: matiko09 (€66.08 in chips) 
Seat 9: Apparat888 (€27.38 in chips) 
Effort92: posts small blind €0.25
TonnaMunz: posts big blind €0.50
*** HOLE CARDS ***
Dealt to matiko09 [Jc 8s]
CvMCvMCvM: raises €0.57 to €1.07
matiko09: folds 
Apparat888: folds 
Effort92: folds 
TonnaMunz: calls €0.57
*** FLOP *** [4h 9c 2h]
knauf1991 joins the table at seat #2 
TonnaMunz: checks 
CvMCvMCvM: bets €1.36
TonnaMunz: folds 
Uncalled bet (€1.36) returned to CvMCvMCvM
CvMCvMCvM collected €2.28 from pot
CvMCvMCvM: doesn't show hand 
*** SUMMARY ***
Total pot €2.39 | Rake €0.11 
Board [4h 9c 2h]
Seat 1: Effort92 (small blind) folded before Flop
Seat 6: TonnaMunz (big blind) folded on the Flop
Seat 7: CvMCvMCvM collected (€2.28)
Seat 8: matiko09 folded before Flop (didn't bet)
Seat 9: Apparat888 (button) folded before Flop (didn't bet)





PokerStars Hand #148609945405:  Hold'em No Limit ($0.25/$0.50 USD) - 2016/02/11 13:40:12 CET [2016/02/11 7:40:12 ET]
Table 'Stereoskopia' 9-max Seat #7 is the button
Seat 1: FoRvvArD_go ($53.04 in chips) 
Seat 2: Dantist1122 ($53 in chips) 
Seat 3: fandorin2005 ($50 in chips) 
Seat 4: Anikin44 ($43.51 in chips) 
Seat 5: afrodit71 ($48.43 in chips) 
Seat 6: matiko09 ($54.15 in chips) 
Seat 7: Serhent ($62.05 in chips) 
Seat 9: nastynate075 ($16.37 in chips) 
nastynate075: posts small blind $0.25
FoRvvArD_go: posts big blind $0.50
*** HOLE CARDS ***
Dealt to matiko09 [5d Jh]
WDW3 joins the table at seat #8 
Dantist1122: folds 
fandorin2005: folds 
Anikin44: folds 
afrodit71: raises $1 to $1.50
matiko09: folds 
Serhent: folds 
nastynate075: calls $1.25
FoRvvArD_go: folds 
*** FLOP *** [6h 4s Ad]
nastynate075: checks 
afrodit71: checks 
*** TURN *** [6h 4s Ad] [2h]
nastynate075: checks 
afrodit71: bets $1.50
nastynate075: calls $1.50
*** RIVER *** [6h 4s Ad 2h] [Qd]
nastynate075: checks 
afrodit71: bets $2.50
nastynate075: calls $2.50
*** SHOW DOWN ***
afrodit71: shows [7h Kh] (high card Ace)
nastynate075: shows [As 4h] (two pair, Aces and Fours)
nastynate075 collected $10.98 from pot
*** SUMMARY ***
Total pot $11.50 | Rake $0.52 
Board [6h 4s Ad 2h Qd]
Seat 1: FoRvvArD_go (big blind) folded before Flop
Seat 2: Dantist1122 folded before Flop (didn't bet)
Seat 3: fandorin2005 folded before Flop (didn't bet)
Seat 4: Anikin44 folded before Flop (didn't bet)
Seat 5: afrodit71 showed [7h Kh] and lost with high card Ace
Seat 6: matiko09 folded before Flop (didn't bet)
Seat 7: Serhent (button) folded before Flop (didn't bet)
Seat 9: nastynate075 (small blind) showed [As 4h] and won ($10.98) with two pair, Aces and Fours





PokerStars Hand #148609949307:  Hold'em No Limit ($0.50/$1.00 USD) - 2016/02/11 13:40:18 CET [2016/02/11 7:40:18 ET]
Table 'Kleopatra II' 9-max Seat #4 is the button
Seat 1: DUkalisUA ($111.72 in chips) 
Seat 2: azvazdam ($58.32 in chips) 
Seat 3: matiko09 ($104.64 in chips) 
Seat 4: TimStone ($100 in chips) 
Seat 5: Sweden_Pound ($112.39 in chips) 
Seat 6: hammerwife ($172.85 in chips) 
Seat 7: Zeeshka ($202.32 in chips) 
Seat 8: oscarleon ($105.64 in chips) 
Seat 9: vrnMike ($111.43 in chips) 
Sweden_Pound: posts small blind $0.50
hammerwife: posts big blind $1
*** HOLE CARDS ***
Dealt to matiko09 [6s 5s]
Zeeshka: folds 
oscarleon: folds 
vrnMike: folds 
DUkalisUA: folds 
azvazdam: raises $1 to $2
matiko09: folds 
TimStone: raises $7.10 to $9.10
Sweden_Pound: folds 
hammerwife: folds 
azvazdam: calls $7.10
*** FLOP *** [As 7s 3d]
azvazdam: checks 
TimStone: checks 
*** TURN *** [As 7s 3d] [2h]
azvazdam: checks 
TimStone: bets $13.64
azvazdam: calls $13.64
*** RIVER *** [As 7s 3d 2h] [3h]
azvazdam: checks 
TimStone: checks 
*** SHOW DOWN ***
azvazdam: shows [5d 7d] (two pair, Sevens and Threes)
TimStone: shows [Qh Qd] (two pair, Queens and Threes)
TimStone collected $44.87 from pot
*** SUMMARY ***
Total pot $46.98 | Rake $2.11 
Board [As 7s 3d 2h 3h]
Seat 1: DUkalisUA folded before Flop (didn't bet)
Seat 2: azvazdam showed [5d 7d] and lost with two pair, Sevens and Threes
Seat 3: matiko09 folded before Flop (didn't bet)
Seat 4: TimStone (button) showed [Qh Qd] and won ($44.87) with two pair, Queens and Threes
Seat 5: Sweden_Pound (small blind) folded before Flop
Seat 6: hammerwife (big blind) folded before Flop
Seat 7: Zeeshka folded before Flop (didn't bet)
Seat 8: oscarleon folded before Flop (didn't bet)
Seat 9: vrnMike folded before Flop (didn't bet)





PokerStars Hand #148609955476:  Hold'em No Limit ($0.50/$1.00 USD) - 2016/02/11 13:40:28 CET [2016/02/11 7:40:28 ET]
Table 'Marion' 9-max Seat #2 is the button
Seat 1: aseban11 ($100 in chips) 
Seat 2: GusenokRUS ($125.08 in chips) 
Seat 3: TimStone ($100.50 in chips) 
Seat 4: matiko09 ($101.50 in chips) 
Seat 5: Rikti ($60.25 in chips) 
Seat 6: 19SERGE74 ($92.87 in chips) 
Seat 7: oscarleon ($104.58 in chips) 
Seat 9: Zeeshka ($100 in chips) 
TimStone: posts small blind $0.50
matiko09: posts big blind $1
Sweden_Pound: sits out 
*** HOLE CARDS ***
Dealt to matiko09 [9s Jc]
Rikti: folds 
19SERGE74: calls $1
oscarleon: folds 
Zeeshka: folds 
aseban11: folds 
GusenokRUS: calls $1
TimStone: folds 
matiko09: checks 
*** FLOP *** [Ac 2d Kh]
matiko09: checks 
19SERGE74: checks 
GusenokRUS: bets $3
matiko09: folds 
19SERGE74: folds 
Uncalled bet ($3) returned to GusenokRUS
GusenokRUS collected $3.34 from pot
GusenokRUS: doesn't show hand 
*** SUMMARY ***
Total pot $3.50 | Rake $0.16 
Board [Ac 2d Kh]
Seat 1: aseban11 folded before Flop (didn't bet)
Seat 2: GusenokRUS (button) collected ($3.34)
Seat 3: TimStone (small blind) folded before Flop
Seat 4: matiko09 (big blind) folded on the Flop
Seat 5: Rikti folded before Flop (didn't bet)
Seat 6: 19SERGE74 folded on the Flop
Seat 7: oscarleon folded before Flop (didn't bet)
Seat 9: Zeeshka folded before Flop (didn't bet)





PokerStars Hand #148609958043:  Hold'em No Limit ($0.25/$0.50 USD) - 2016/02/11 13:40:33 CET [2016/02/11 7:40:33 ET]
Table 'Sylvania II' 9-max Seat #8 is the button
Seat 1: tw0315 ($177.25 in chips) 
Seat 2: Effort92 ($96.75 in chips) 
Seat 4: matiko09 ($126.31 in chips) 
Seat 6: TonnaMunz ($125.56 in chips) 
Seat 7: 2lefthand75 ($49.25 in chips) 
Seat 8: Apparat888 ($40.78 in chips) 
Seat 9: udden82 ($46.88 in chips) 
udden82: posts small blind $0.25
tw0315: posts big blind $0.50
tw0315: posts the ante $0.10
Effort92: posts the ante $0.10
matiko09: posts the ante $0.10
TonnaMunz: posts the ante $0.10
2lefthand75: posts the ante $0.10
Apparat888: posts the ante $0.10
udden82: posts the ante $0.10
*** HOLE CARDS ***
Dealt to matiko09 [3d 5c]
Effort92: folds 
matiko09: folds 
TonnaMunz: raises $0.74 to $1.24
2lefthand75: folds 
Apparat888: raises $2.26 to $3.50
udden82: folds 
tw0315: folds 
TonnaMunz: calls $2.26
*** FLOP *** [9d 6d Qd]
TonnaMunz: checks 
Apparat888: checks 
*** TURN *** [9d 6d Qd] [2h]
TonnaMunz: checks 
Apparat888: checks 
*** RIVER *** [9d 6d Qd 2h] [5d]
TonnaMunz: bets $5.25
Apparat888: folds 
Uncalled bet ($5.25) returned to TonnaMunz
TonnaMunz collected $8.07 from pot
TonnaMunz: doesn't show hand 
*** SUMMARY ***
Total pot $8.45 | Rake $0.38 
Board [9d 6d Qd 2h 5d]
Seat 1: tw0315 (big blind) folded before Flop
Seat 2: Effort92 folded before Flop (didn't bet)
Seat 4: matiko09 folded before Flop (didn't bet)
Seat 6: TonnaMunz collected ($8.07)
Seat 7: 2lefthand75 folded before Flop (didn't bet)
Seat 8: Apparat888 (button) folded on the River
Seat 9: udden82 (small blind) folded before Flop





PokerStars Hand #148609962496:  Hold'em No Limit ($0.50/$1.00 USD) - 2016/02/11 13:40:40 CET [2016/02/11 7:40:40 ET]
Table 'Stephano V' 9-max Seat #3 is the button
Seat 1: hammerwife ($113.25 in chips) 
Seat 2: matiko09 ($145.88 in chips) 
Seat 3: DUkalisUA ($100 in chips) 
Seat 4: Zeeshka ($116.55 in chips) 
Seat 5: n2call ($246.73 in chips) 
Seat 6: Sweden_Pound ($125.30 in chips) 
Seat 8: oscarleon ($228.63 in chips) 
Zeeshka: posts small blind $0.50
n2call: posts big blind $1
Effort92: sits out 
*** HOLE CARDS ***
Dealt to matiko09 [6h Kh]
Sweden_Pound: folds 
oscarleon: folds 
hammerwife: folds 
matiko09: folds 
DUkalisUA: raises $1 to $2
Zeeshka: folds 
Vikulja1993 joins the table at seat #9 
Vikulja1993 leaves the table
n2call: calls $1
*** FLOP *** [Qh 8c 2d]
aseban11 joins the table at seat #9 
n2call: checks 
aseban11 leaves the table
DUkalisUA: checks 
*** TURN *** [Qh 8c 2d] [Ac]
n2call: bets $2.86
DUkalisUA: calls $2.86
*** RIVER *** [Qh 8c 2d Ac] [6c]
n2call: checks 
DUkalisUA: checks 
*** SHOW DOWN ***
n2call: shows [Ts 7d] (high card Ace)
DUkalisUA: shows [Ks Td] (high card Ace - King kicker)
DUkalisUA collected $9.76 from pot
gabi_igna joins the table at seat #9 
*** SUMMARY ***
Total pot $10.22 | Rake $0.46 
Board [Qh 8c 2d Ac 6c]
Seat 1: hammerwife folded before Flop (didn't bet)
Seat 2: matiko09 folded before Flop (didn't bet)
Seat 3: DUkalisUA (button) showed [Ks Td] and won ($9.76) with high card Ace
Seat 4: Zeeshka (small blind) folded before Flop
Seat 5: n2call (big blind) showed [Ts 7d] and lost with high card Ace
Seat 6: Sweden_Pound folded before Flop (didn't bet)
Seat 8: oscarleon folded before Flop (didn't bet)





PokerStars Hand #148609973637:  Hold'em No Limit ($0.25/$0.50 USD) - 2016/02/11 13:40:58 CET [2016/02/11 7:40:58 ET]
Table 'Ambrosia II' 9-max Seat #3 is the button
Seat 1: matiko09 ($56.21 in chips) 
Seat 2: JJJ-K9 ($60.21 in chips) 
Seat 3: make6a ($76.81 in chips) 
Seat 4: huudk2016 ($24.13 in chips) 
Seat 5: RICKA16 ($62.92 in chips) 
Seat 6: Reven9er ($60.26 in chips) 
Seat 7: Ana.Satravca ($70.06 in chips) 
Seat 8: Dantist1122 ($50 in chips) 
Seat 9: arctur17 ($52.79 in chips) 
huudk2016: posts small blind $0.25
RICKA16: posts big blind $0.50
*** HOLE CARDS ***
Dealt to matiko09 [7h Kc]
Reven9er: folds 
Ana.Satravca: raises $1 to $1.50
Dantist1122: folds 
arctur17: folds 
matiko09: folds 
JJJ-K9: folds 
make6a: folds 
huudk2016: folds 
RICKA16: folds 
Uncalled bet ($1) returned to Ana.Satravca
Ana.Satravca collected $1.25 from pot
Ana.Satravca: doesn't show hand 
*** SUMMARY ***
Total pot $1.25 | Rake $0 
Seat 1: matiko09 folded before Flop (didn't bet)
Seat 2: JJJ-K9 folded before Flop (didn't bet)
Seat 3: make6a (button) folded before Flop (didn't bet)
Seat 4: huudk2016 (small blind) folded before Flop
Seat 5: RICKA16 (big blind) folded before Flop
Seat 6: Reven9er folded before Flop (didn't bet)
Seat 7: Ana.Satravca collected ($1.25)
Seat 8: Dantist1122 folded before Flop (didn't bet)
Seat 9: arctur17 folded before Flop (didn't bet)





PokerStars Hand #148609974699:  Hold'em No Limit ($0.25/$0.50 USD) - 2016/02/11 13:41:00 CET [2016/02/11 7:41:00 ET]
Table 'Stereoskopia' 9-max Seat #9 is the button
Seat 1: FoRvvArD_go ($52.54 in chips) 
Seat 2: Dantist1122 ($53 in chips) 
Seat 3: fandorin2005 ($50 in chips) 
Seat 4: Anikin44 ($43.51 in chips) 
Seat 5: afrodit71 ($42.93 in chips) 
Seat 6: matiko09 ($54.15 in chips) 
Seat 7: Serhent ($62.05 in chips) 
Seat 9: nastynate075 ($21.85 in chips) 
FoRvvArD_go: posts small blind $0.25
Dantist1122: posts big blind $0.50
WDW3: sits out 
*** HOLE CARDS ***
Dealt to matiko09 [8s 5h]
fandorin2005: folds 
Anikin44: raises $1.30 to $1.80
afrodit71: folds 
matiko09: folds 
Serhent: folds 
nastynate075: folds 
FoRvvArD_go: folds 
Dantist1122: folds 
Uncalled bet ($1.30) returned to Anikin44
Anikin44 collected $1.25 from pot
Anikin44: doesn't show hand 
*** SUMMARY ***
Total pot $1.25 | Rake $0 
Seat 1: FoRvvArD_go (small blind) folded before Flop
Seat 2: Dantist1122 (big blind) folded before Flop
Seat 3: fandorin2005 folded before Flop (didn't bet)
Seat 4: Anikin44 collected ($1.25)
Seat 5: afrodit71 folded before Flop (didn't bet)
Seat 6: matiko09 folded before Flop (didn't bet)
Seat 7: Serhent folded before Flop (didn't bet)
Seat 9: nastynate075 (button) folded before Flop (didn't bet)





PokerStars Hand #148609981495:  Hold'em No Limit ($0.50/$1.00 USD) - 2016/02/11 13:41:11 CET [2016/02/11 7:41:11 ET]
Table 'Gianfar' 9-max Seat #5 is the button
Seat 1: Vikulja1993 ($100.50 in chips) 
Seat 2: bilukm ($60.70 in chips) 
Seat 3: AlKatrone ($169.99 in chips) 
Seat 4: matiko09 ($125.98 in chips) 
Seat 5: hammerwife ($195.99 in chips) 
Seat 6: Sweden_Pound ($100 in chips) 
Seat 7: Rikti ($36.30 in chips) 
Seat 8: Zeeshka ($113.31 in chips) 
Seat 9: oscarleon ($147.62 in chips) 
Sweden_Pound: posts small blind $0.50
Rikti: posts big blind $1
*** HOLE CARDS ***
Dealt to matiko09 [Ad 4h]
Zeeshka: raises $2 to $3
oscarleon: calls $3
Vikulja1993: folds 
bilukm: folds 
AlKatrone: folds 
matiko09: folds 
hammerwife: folds 
Sweden_Pound: folds 
Rikti: calls $2
*** FLOP *** [Ks 6h 6c]
Rikti: checks 
Zeeshka: checks 
oscarleon: checks 
*** TURN *** [Ks 6h 6c] [7h]
Rikti: checks 
Zeeshka: bets $4.98
oscarleon: folds 
Rikti: folds 
Uncalled bet ($4.98) returned to Zeeshka
Zeeshka collected $9.07 from pot
Zeeshka: doesn't show hand 
*** SUMMARY ***
Total pot $9.50 | Rake $0.43 
Board [Ks 6h 6c 7h]
Seat 1: Vikulja1993 folded before Flop (didn't bet)
Seat 2: bilukm folded before Flop (didn't bet)
Seat 3: AlKatrone folded before Flop (didn't bet)
Seat 4: matiko09 folded before Flop (didn't bet)
Seat 5: hammerwife (button) folded before Flop (didn't bet)
Seat 6: Sweden_Pound (small blind) folded before Flop
Seat 7: Rikti (big blind) folded on the Turn
Seat 8: Zeeshka collected ($9.07)
Seat 9: oscarleon folded on the Turn





PokerStars Hand #148609983622:  Hold'em No Limit (€0.25/€0.50 EUR) - 2016/02/11 13:41:14 CET [2016/02/11 7:41:14 ET]
Table 'Otero II' 9-max Seat #1 is the button
Seat 1: Effort92 (€50 in chips) 
Seat 6: TonnaMunz (€50 in chips) 
Seat 7: CvMCvMCvM (€56.99 in chips) 
Seat 8: matiko09 (€66.08 in chips) 
Seat 9: Apparat888 (€27.38 in chips) 
knauf1991 will be allowed to play after the button
TonnaMunz: posts small blind €0.25
CvMCvMCvM: posts big blind €0.50
*** HOLE CARDS ***
Dealt to matiko09 [As Td]
matiko09: folds 
Apparat888: folds 
Effort92: raises €0.50 to €1
TonnaMunz: folds 
CvMCvMCvM: folds 
Uncalled bet (€0.50) returned to Effort92
Effort92 collected €1.25 from pot
Effort92: doesn't show hand 
*** SUMMARY ***
Total pot €1.25 | Rake €0 
Seat 1: Effort92 (button) collected (€1.25)
Seat 6: TonnaMunz (small blind) folded before Flop
Seat 7: CvMCvMCvM (big blind) folded before Flop
Seat 8: matiko09 folded before Flop (didn't bet)
Seat 9: Apparat888 folded before Flop (didn't bet)





PokerStars Hand #148609983942:  Hold'em No Limit ($0.50/$1.00 USD) - 2016/02/11 13:41:15 CET [2016/02/11 7:41:15 ET]
Table 'Tama' 9-max Seat #8 is the button
Seat 1: aseban11 ($100 in chips) 
Seat 2: matiko09 ($100 in chips) 
Seat 3: gabi_igna ($100 in chips) 
Seat 4: Cogss ($151.70 in chips) 
Seat 5: Zeeshka ($100 in chips) 
Seat 6: vicdroopy ($100 in chips) 
Seat 7: GrishaPE ($48.96 in chips) 
Seat 8: er13to ($100 in chips) 
Seat 9: Edvendor ($77 in chips) 
Edvendor: posts small blind $0.50
aseban11: posts big blind $1
*** HOLE CARDS ***
Dealt to matiko09 [9s 5d]
matiko09: folds 
gabi_igna: folds 
Cogss: folds 
Zeeshka: folds 
vicdroopy: folds 
GrishaPE: folds 
er13to: folds 
Edvendor: raises $2 to $3
aseban11: calls $2
*** FLOP *** [Jd 9d 7d]
Edvendor: bets $5.73
aseban11: folds 
Uncalled bet ($5.73) returned to Edvendor
Edvendor collected $5.73 from pot
Edvendor: doesn't show hand 
*** SUMMARY ***
Total pot $6 | Rake $0.27 
Board [Jd 9d 7d]
Seat 1: aseban11 (big blind) folded on the Flop
Seat 2: matiko09 folded before Flop (didn't bet)
Seat 3: gabi_igna folded before Flop (didn't bet)
Seat 4: Cogss folded before Flop (didn't bet)
Seat 5: Zeeshka folded before Flop (didn't bet)
Seat 6: vicdroopy folded before Flop (didn't bet)
Seat 7: GrishaPE folded before Flop (didn't bet)
Seat 8: er13to (button) folded before Flop (didn't bet)
Seat 9: Edvendor (small blind) collected ($5.73)





PokerStars Hand #148609985477:  Hold'em No Limit ($0.50/$1.00 USD) - 2016/02/11 13:41:17 CET [2016/02/11 7:41:17 ET]
Table 'Marion' 9-max Seat #3 is the button
Seat 1: aseban11 ($100 in chips) 
Seat 2: GusenokRUS ($127.42 in chips) 
Seat 3: TimStone ($100 in chips) 
Seat 4: matiko09 ($100.50 in chips) 
Seat 5: Rikti ($60.25 in chips) 
Seat 6: 19SERGE74 ($91.87 in chips) 
Seat 7: oscarleon ($104.58 in chips) 
Seat 9: Zeeshka ($100 in chips) 
matiko09: posts small blind $0.50
Rikti: posts big blind $1
Sweden_Pound: sits out 
*** HOLE CARDS ***
Dealt to matiko09 [3d Qh]
19SERGE74: folds 
oscarleon: folds 
Zeeshka: folds 
aseban11: folds 
GusenokRUS: folds 
TimStone: folds 
matiko09: folds 
Uncalled bet ($0.50) returned to Rikti
Rikti collected $1 from pot
Rikti: doesn't show hand 
*** SUMMARY ***
Total pot $1 | Rake $0 
Seat 1: aseban11 folded before Flop (didn't bet)
Seat 2: GusenokRUS folded before Flop (didn't bet)
Seat 3: TimStone (button) folded before Flop (didn't bet)
Seat 4: matiko09 (small blind) folded before Flop
Seat 5: Rikti (big blind) collected ($1)
Seat 6: 19SERGE74 folded before Flop (didn't bet)
Seat 7: oscarleon folded before Flop (didn't bet)
Seat 9: Zeeshka folded before Flop (didn't bet)





PokerStars Hand #148609988770:  Hold'em No Limit ($0.50/$1.00 USD) - 2016/02/11 13:41:23 CET [2016/02/11 7:41:23 ET]
Table 'Kleopatra II' 9-max Seat #5 is the button
Seat 1: DUkalisUA ($111.72 in chips) 
Seat 2: azvazdam ($35.58 in chips) 
Seat 3: matiko09 ($104.64 in chips) 
Seat 4: TimStone ($122.13 in chips) 
Seat 5: Sweden_Pound ($111.89 in chips) 
Seat 6: hammerwife ($171.85 in chips) 
Seat 7: Zeeshka ($202.32 in chips) 
Seat 8: oscarleon ($105.64 in chips) 
Seat 9: vrnMike ($111.43 in chips) 
hammerwife: posts small blind $0.50
Zeeshka: posts big blind $1
*** HOLE CARDS ***
Dealt to matiko09 [5s 7s]
oscarleon: folds 
vrnMike: folds 
DUkalisUA: folds 
azvazdam: folds 
matiko09: folds 
TimStone: folds 
Sweden_Pound: folds 
hammerwife: raises $1.60 to $2.60
Zeeshka: raises $6.40 to $9
hammerwife: folds 
Uncalled bet ($6.40) returned to Zeeshka
Zeeshka collected $5.20 from pot
Zeeshka: doesn't show hand 
*** SUMMARY ***
Total pot $5.20 | Rake $0 
Seat 1: DUkalisUA folded before Flop (didn't bet)
Seat 2: azvazdam folded before Flop (didn't bet)
Seat 3: matiko09 folded before Flop (didn't bet)
Seat 4: TimStone folded before Flop (didn't bet)
Seat 5: Sweden_Pound (button) folded before Flop (didn't bet)
Seat 6: hammerwife (small blind) folded before Flop
Seat 7: Zeeshka (big blind) collected ($5.20)
Seat 8: oscarleon folded before Flop (didn't bet)
Seat 9: vrnMike folded before Flop (didn't bet)





PokerStars Hand #148609997016:  Hold'em No Limit ($0.25/$0.50 USD) - 2016/02/11 13:41:36 CET [2016/02/11 7:41:36 ET]
Table 'Ambrosia II' 9-max Seat #4 is the button
Seat 1: matiko09 ($56.21 in chips) 
Seat 2: JJJ-K9 ($60.21 in chips) 
Seat 3: make6a ($76.81 in chips) 
Seat 4: huudk2016 ($23.88 in chips) 
Seat 5: RICKA16 ($62.42 in chips) 
Seat 8: Dantist1122 ($50 in chips) 
Seat 9: arctur17 ($52.79 in chips) 
RICKA16: posts small blind $0.25
Reven9er: is sitting out 
Ana.Satravca: is sitting out 
Reven9er leaves the table
Dantist1122: posts big blind $0.50
*** HOLE CARDS ***
Dealt to matiko09 [7c 5d]
arctur17: folds 
xxxibgdrgn joins the table at seat #6 
matiko09: folds 
JJJ-K9: folds 
make6a: folds 
huudk2016: calls $0.50
RICKA16: raises $1.50 to $2
Dantist1122: folds 
huudk2016: folds 
Uncalled bet ($1.50) returned to RICKA16
RICKA16 collected $1.50 from pot
RICKA16: doesn't show hand 
*** SUMMARY ***
Total pot $1.50 | Rake $0 
Seat 1: matiko09 folded before Flop (didn't bet)
Seat 2: JJJ-K9 folded before Flop (didn't bet)
Seat 3: make6a folded before Flop (didn't bet)
Seat 4: huudk2016 (button) folded before Flop
Seat 5: RICKA16 (small blind) collected ($1.50)
Seat 8: Dantist1122 (big blind) folded before Flop
Seat 9: arctur17 folded before Flop (didn't bet)





PokerStars Hand #148609999820:  Hold'em No Limit (€0.25/€0.50 EUR) - 2016/02/11 13:41:40 CET [2016/02/11 7:41:40 ET]
Table 'Otero II' 9-max Seat #6 is the button
Seat 1: Effort92 (€50.75 in chips) 
Seat 2: knauf1991 (€27.56 in chips) 
Seat 4: kram0909 (€29.11 in chips) 
Seat 6: TonnaMunz (€50 in chips) 
Seat 7: CvMCvMCvM (€56.49 in chips) 
Seat 8: matiko09 (€66.08 in chips) 
Seat 9: Apparat888 (€27.38 in chips) 
CvMCvMCvM: posts small blind €0.25
matiko09: posts big blind €0.50
knauf1991: posts big blind €0.50
kram0909: posts small & big blinds €0.75
*** HOLE CARDS ***
Dealt to matiko09 [4h Kh]
Apparat888: folds 
Effort92: folds 
knauf1991: checks 
kram0909: checks 
TonnaMunz: folds 
CvMCvMCvM: calls €0.25
matiko09: checks 
*** FLOP *** [Qc 6h Jh]
CvMCvMCvM: checks 
matiko09: bets €1.40
knauf1991: calls €1.40
kram0909: folds 
CvMCvMCvM: folds 
*** TURN *** [Qc 6h Jh] [Kc]
matiko09: checks 
knauf1991: checks 
*** RIVER *** [Qc 6h Jh Kc] [6s]
matiko09: bets €2
knauf1991: folds 
Uncalled bet (€2) returned to matiko09
matiko09 collected €4.82 from pot
matiko09: doesn't show hand 
*** SUMMARY ***
Total pot €5.05 | Rake €0.23 
Board [Qc 6h Jh Kc 6s]
Seat 1: Effort92 folded before Flop (didn't bet)
Seat 2: knauf1991 folded on the River
Seat 4: kram0909 folded on the Flop
Seat 6: TonnaMunz (button) folded before Flop (didn't bet)
Seat 7: CvMCvMCvM (small blind) folded on the Flop
Seat 8: matiko09 (big blind) collected (€4.82)
Seat 9: Apparat888 folded before Flop (didn't bet)





PokerStars Hand #148610001623:  Hold'em No Limit ($0.50/$1.00 USD) - 2016/02/11 13:41:43 CET [2016/02/11 7:41:43 ET]
Table 'Marion' 9-max Seat #4 is the button
Seat 1: aseban11 ($100 in chips) 
Seat 2: GusenokRUS ($127.42 in chips) 
Seat 3: TimStone ($100 in chips) 
Seat 4: matiko09 ($100 in chips) 
Seat 5: Rikti ($60.75 in chips) 
Seat 6: 19SERGE74 ($91.87 in chips) 
Seat 7: oscarleon ($104.58 in chips) 
Seat 9: Zeeshka ($100 in chips) 
Rikti: posts small blind $0.50
19SERGE74: posts big blind $1
Sweden_Pound: sits out 
*** HOLE CARDS ***
Dealt to matiko09 [4s Ks]
oscarleon: folds 
Zeeshka: folds 
aseban11 has timed out
aseban11: folds 
GusenokRUS: folds 
TimStone: raises $1.52 to $2.52
matiko09: folds 
Rikti: folds 
19SERGE74: folds 
Uncalled bet ($1.52) returned to TimStone
TimStone collected $2.50 from pot
TimStone: doesn't show hand 
*** SUMMARY ***
Total pot $2.50 | Rake $0 
Seat 1: aseban11 folded before Flop (didn't bet)
Seat 2: GusenokRUS folded before Flop (didn't bet)
Seat 3: TimStone collected ($2.50)
Seat 4: matiko09 (button) folded before Flop (didn't bet)
Seat 5: Rikti (small blind) folded before Flop
Seat 6: 19SERGE74 (big blind) folded before Flop
Seat 7: oscarleon folded before Flop (didn't bet)
Seat 9: Zeeshka folded before Flop (didn't bet)





PokerStars Hand #148610001624:  Hold'em No Limit ($0.25/$0.50 USD) - 2016/02/11 13:41:43 CET [2016/02/11 7:41:43 ET]
Table 'Sylvania II' 9-max Seat #9 is the button
Seat 1: tw0315 ($176.65 in chips) 
Seat 2: Effort92 ($96.65 in chips) 
Seat 4: matiko09 ($126.21 in chips) 
Seat 6: TonnaMunz ($130.03 in chips) 
Seat 7: 2lefthand75 ($49.15 in chips) 
Seat 8: Apparat888 ($37.18 in chips) 
Seat 9: udden82 ($46.53 in chips) 
tw0315: posts small blind $0.25
Effort92: posts big blind $0.50
tw0315: posts the ante $0.10
Effort92: posts the ante $0.10
matiko09: posts the ante $0.10
TonnaMunz: posts the ante $0.10
2lefthand75: posts the ante $0.10
Apparat888: posts the ante $0.10
udden82: posts the ante $0.10
*** HOLE CARDS ***
Dealt to matiko09 [5h 3h]
matiko09: folds 
TonnaMunz: folds 
2lefthand75: calls $0.50
Apparat888: folds 
udden82: folds 
tw0315: raises $0.50 to $1
Effort92: folds 
2lefthand75: calls $0.50
*** FLOP *** [Ac 8d 6d]
tw0315: checks 
2lefthand75: checks 
*** TURN *** [Ac 8d 6d] [Tc]
tw0315: checks 
2lefthand75: bets $1.53
tw0315: calls $1.53
*** RIVER *** [Ac 8d 6d Tc] [Ad]
tw0315: checks 
2lefthand75: checks 
*** SHOW DOWN ***
tw0315: shows [Qd Qc] (two pair, Aces and Queens)
2lefthand75: mucks hand 
tw0315 collected $5.98 from pot
*** SUMMARY ***
Total pot $6.26 | Rake $0.28 
Board [Ac 8d 6d Tc Ad]
Seat 1: tw0315 (small blind) showed [Qd Qc] and won ($5.98) with two pair, Aces and Queens
Seat 2: Effort92 (big blind) folded before Flop
Seat 4: matiko09 folded before Flop (didn't bet)
Seat 6: TonnaMunz folded before Flop (didn't bet)
Seat 7: 2lefthand75 mucked [Qh Ts]
Seat 8: Apparat888 folded before Flop (didn't bet)
Seat 9: udden82 (button) folded before Flop (didn't bet)





PokerStars Hand #148610001777:  Hold'em No Limit ($0.25/$0.50 USD) - 2016/02/11 13:41:44 CET [2016/02/11 7:41:44 ET]
Table 'Stereoskopia' 9-max Seat #1 is the button
Seat 1: FoRvvArD_go ($52.29 in chips) 
Seat 2: Dantist1122 ($52.50 in chips) 
Seat 3: fandorin2005 ($50 in chips) 
Seat 4: Anikin44 ($44.26 in chips) 
Seat 5: afrodit71 ($42.93 in chips) 
Seat 6: matiko09 ($54.15 in chips) 
Seat 7: Serhent ($62.05 in chips) 
Seat 9: nastynate075 ($21.85 in chips) 
Dantist1122: posts small blind $0.25
fandorin2005: posts big blind $0.50
WDW3: sits out 
*** HOLE CARDS ***
Dealt to matiko09 [3s 2h]
Anikin44: raises $1.10 to $1.60
afrodit71: calls $1.60
matiko09: folds 
Serhent: folds 
nastynate075: folds 
FoRvvArD_go: raises $4.40 to $6
Dantist1122: folds 
fandorin2005: folds 
Anikin44: calls $4.40
afrodit71: folds 
*** FLOP *** [9s 6s 8s]
Anikin44: checks 
FoRvvArD_go: checks 
*** TURN *** [9s 6s 8s] [Jh]
Anikin44: bets $5.50
FoRvvArD_go: folds 
Uncalled bet ($5.50) returned to Anikin44
Anikin44 collected $13.70 from pot
Anikin44: doesn't show hand 
*** SUMMARY ***
Total pot $14.35 | Rake $0.65 
Board [9s 6s 8s Jh]
Seat 1: FoRvvArD_go (button) folded on the Turn
Seat 2: Dantist1122 (small blind) folded before Flop
Seat 3: fandorin2005 (big blind) folded before Flop
Seat 4: Anikin44 collected ($13.70)
Seat 5: afrodit71 folded before Flop
Seat 6: matiko09 folded before Flop (didn't bet)
Seat 7: Serhent folded before Flop (didn't bet)
Seat 9: nastynate075 folded before Flop (didn't bet)





PokerStars Hand #148610008462:  Hold'em No Limit ($0.50/$1.00 USD) - 2016/02/11 13:41:54 CET [2016/02/11 7:41:54 ET]
Table 'Stephano V' 9-max Seat #4 is the button
Seat 1: hammerwife ($113.25 in chips) 
Seat 2: matiko09 ($145.88 in chips) 
Seat 3: DUkalisUA ($104.90 in chips) 
Seat 4: Zeeshka ($116.05 in chips) 
Seat 5: n2call ($241.87 in chips) 
Seat 6: Sweden_Pound ($125.30 in chips) 
Seat 8: oscarleon ($228.63 in chips) 
n2call: posts small blind $0.50
Sweden_Pound: posts big blind $1
Effort92: sits out 
gabi_igna: sits out 
*** HOLE CARDS ***
Dealt to matiko09 [9d 3c]
oscarleon: folds 
hammerwife: folds 
matiko09: folds 
DUkalisUA: raises $1.50 to $2.50
Zeeshka: folds 
n2call: calls $2
Sweden_Pound: folds 
*** FLOP *** [Qd 9h Td]
n2call: checks 
DUkalisUA: checks 
*** TURN *** [Qd 9h Td] [5s]
n2call: bets $6.87
DUkalisUA: folds 
Uncalled bet ($6.87) returned to n2call
n2call collected $5.73 from pot
n2call: doesn't show hand 
*** SUMMARY ***
Total pot $6 | Rake $0.27 
Board [Qd 9h Td 5s]
Seat 1: hammerwife folded before Flop (didn't bet)
Seat 2: matiko09 folded before Flop (didn't bet)
Seat 3: DUkalisUA folded on the Turn
Seat 4: Zeeshka (button) folded before Flop (didn't bet)
Seat 5: n2call (small blind) collected ($5.73)
Seat 6: Sweden_Pound (big blind) folded before Flop
Seat 8: oscarleon folded before Flop (didn't bet)





PokerStars Hand #148610020222:  Hold'em No Limit ($0.50/$1.00 USD) - 2016/02/11 13:42:14 CET [2016/02/11 7:42:14 ET]
Table 'Tama' 9-max Seat #9 is the button
Seat 1: aseban11 ($100 in chips) 
Seat 2: matiko09 ($100 in chips) 
Seat 3: gabi_igna ($100 in chips) 
Seat 4: Cogss ($151.70 in chips) 
Seat 5: Zeeshka ($100 in chips) 
Seat 6: vicdroopy ($100 in chips) 
Seat 7: GrishaPE ($48.96 in chips) 
Seat 8: er13to ($100 in chips) 
Seat 9: Edvendor ($79.73 in chips) 
aseban11: posts small blind $0.50
matiko09: posts big blind $1
*** HOLE CARDS ***
Dealt to matiko09 [8d 5c]
gabi_igna: folds 
Cogss: folds 
Zeeshka: folds 
vicdroopy: folds 
GrishaPE: folds 
er13to: folds 
Edvendor: folds 
aseban11: folds 
Uncalled bet ($0.50) returned to matiko09
matiko09 collected $1 from pot
matiko09: doesn't show hand 
*** SUMMARY ***
Total pot $1 | Rake $0 
Seat 1: aseban11 (small blind) folded before Flop
Seat 2: matiko09 (big blind) collected ($1)
Seat 3: gabi_igna folded before Flop (didn't bet)
Seat 4: Cogss folded before Flop (didn't bet)
Seat 5: Zeeshka folded before Flop (didn't bet)
Seat 6: vicdroopy folded before Flop (didn't bet)
Seat 7: GrishaPE folded before Flop (didn't bet)
Seat 8: er13to folded before Flop (didn't bet)
Seat 9: Edvendor (button) folded before Flop (didn't bet)





PokerStars Hand #148610022511:  Hold'em No Limit ($0.25/$0.50 USD) - 2016/02/11 13:42:18 CET [2016/02/11 7:42:18 ET]
Table 'Ambrosia II' 9-max Seat #5 is the button
Seat 1: matiko09 ($56.21 in chips) 
Seat 2: JJJ-K9 ($60.21 in chips) 
Seat 3: make6a ($76.81 in chips) 
Seat 4: huudk2016 ($23.38 in chips) 
Seat 5: RICKA16 ($63.42 in chips) 
Seat 8: Dantist1122 ($50 in chips) 
Seat 9: arctur17 ($52.79 in chips) 
xxxibgdrgn will be allowed to play after the button
Dantist1122: posts small blind $0.25
arctur17: posts big blind $0.50
*** HOLE CARDS ***
Dealt to matiko09 [6s Ts]
matiko09: folds 
JJJ-K9: folds 
make6a: folds 
huudk2016: calls $0.50
RICKA16: folds 
Dantist1122: folds 
arctur17: raises $2 to $2.50
huudk2016: folds 
Uncalled bet ($2) returned to arctur17
arctur17 collected $1.25 from pot
arctur17: doesn't show hand 
*** SUMMARY ***
Total pot $1.25 | Rake $0 
Seat 1: matiko09 folded before Flop (didn't bet)
Seat 2: JJJ-K9 folded before Flop (didn't bet)
Seat 3: make6a folded before Flop (didn't bet)
Seat 4: huudk2016 folded before Flop
Seat 5: RICKA16 (button) folded before Flop (didn't bet)
Seat 8: Dantist1122 (small blind) folded before Flop
Seat 9: arctur17 (big blind) collected ($1.25)





PokerStars Hand #148610029157:  Hold'em No Limit ($0.50/$1.00 USD) - 2016/02/11 13:42:28 CET [2016/02/11 7:42:28 ET]
Table 'Marion' 9-max Seat #5 is the button
Seat 1: aseban11 ($100 in chips) 
Seat 2: GusenokRUS ($127.42 in chips) 
Seat 3: TimStone ($101.50 in chips) 
Seat 4: matiko09 ($100 in chips) 
Seat 5: Rikti ($60.25 in chips) 
Seat 6: 19SERGE74 ($90.87 in chips) 
Seat 7: oscarleon ($104.58 in chips) 
Seat 9: Zeeshka ($100 in chips) 
19SERGE74: posts small blind $0.50
oscarleon: posts big blind $1
Sweden_Pound: sits out 
*** HOLE CARDS ***
Dealt to matiko09 [Qc Js]
Zeeshka: folds 
aseban11: folds 
GusenokRUS: folds 
TimStone: raises $1.62 to $2.62
matiko09: folds 
Rikti: folds 
19SERGE74: folds 
oscarleon: folds 
Uncalled bet ($1.62) returned to TimStone
TimStone collected $2.50 from pot
TimStone: doesn't show hand 
*** SUMMARY ***
Total pot $2.50 | Rake $0 
Seat 1: aseban11 folded before Flop (didn't bet)
Seat 2: GusenokRUS folded before Flop (didn't bet)
Seat 3: TimStone collected ($2.50)
Seat 4: matiko09 folded before Flop (didn't bet)
Seat 5: Rikti (button) folded before Flop (didn't bet)
Seat 6: 19SERGE74 (small blind) folded before Flop
Seat 7: oscarleon (big blind) folded before Flop
Seat 9: Zeeshka folded before Flop (didn't bet)





PokerStars Hand #148610034847:  Hold'em No Limit ($0.50/$1.00 USD) - 2016/02/11 13:42:37 CET [2016/02/11 7:42:37 ET]
Table 'Tama' 9-max Seat #1 is the button
Seat 1: aseban11 ($100 in chips) 
Seat 2: matiko09 ($100.50 in chips) 
Seat 3: gabi_igna ($100 in chips) 
Seat 4: Cogss ($151.70 in chips) 
Seat 5: Zeeshka ($100 in chips) 
Seat 6: vicdroopy ($100 in chips) 
Seat 7: GrishaPE ($48.96 in chips) 
Seat 8: er13to ($100 in chips) 
Seat 9: Edvendor ($79.73 in chips) 
matiko09: posts small blind $0.50
gabi_igna: posts big blind $1
*** HOLE CARDS ***
Dealt to matiko09 [8s Th]
Cogss: folds 
Zeeshka: folds 
vicdroopy: folds 
GrishaPE: folds 
er13to: folds 
Edvendor: calls $1
aseban11: raises $3.50 to $4.50
matiko09: folds 
gabi_igna: folds 
Edvendor: calls $3.50
*** FLOP *** [Kd 5h Qc]
Edvendor: checks 
aseban11: checks 
*** TURN *** [Kd 5h Qc] [7s]
Edvendor: checks 
aseban11: bets $4.50
Edvendor: calls $4.50
*** RIVER *** [Kd 5h Qc 7s] [5c]
Edvendor: checks 
aseban11: bets $3.50
Edvendor: calls $3.50
*** SHOW DOWN ***
aseban11: shows [Td Qh] (two pair, Queens and Fives)
Edvendor: mucks hand 
aseban11 collected $25.31 from pot
*** SUMMARY ***
Total pot $26.50 | Rake $1.19 
Board [Kd 5h Qc 7s 5c]
Seat 1: aseban11 (button) showed [Td Qh] and won ($25.31) with two pair, Queens and Fives
Seat 2: matiko09 (small blind) folded before Flop
Seat 3: gabi_igna (big blind) folded before Flop
Seat 4: Cogss folded before Flop (didn't bet)
Seat 5: Zeeshka folded before Flop (didn't bet)
Seat 6: vicdroopy folded before Flop (didn't bet)
Seat 7: GrishaPE folded before Flop (didn't bet)
Seat 8: er13to folded before Flop (didn't bet)
Seat 9: Edvendor mucked [8h 8c]





PokerStars Hand #148610034453:  Hold'em No Limit ($0.50/$1.00 USD) - 2016/02/11 13:42:37 CET [2016/02/11 7:42:37 ET]
Table 'Gianfar' 9-max Seat #6 is the button
Seat 1: Vikulja1993 ($100.50 in chips) 
Seat 2: bilukm ($60.70 in chips) 
Seat 3: AlKatrone ($169.99 in chips) 
Seat 4: matiko09 ($125.98 in chips) 
Seat 5: hammerwife ($195.99 in chips) 
Seat 6: Sweden_Pound ($100 in chips) 
Seat 7: Rikti ($33.30 in chips) 
Seat 8: Zeeshka ($119.38 in chips) 
Seat 9: oscarleon ($144.62 in chips) 
Rikti: posts small blind $0.50
Zeeshka: posts big blind $1
*** HOLE CARDS ***
Dealt to matiko09 [Th 2s]
oscarleon: folds 
Vikulja1993: folds 
bilukm: folds 
AlKatrone: folds 
matiko09: folds 
hammerwife: folds 
Sweden_Pound: folds 
Rikti: raises $1.50 to $2.50
Zeeshka: calls $1.50
*** FLOP *** [3d 8s Ad]
Rikti: checks 
Zeeshka: checks 
*** TURN *** [3d 8s Ad] [7s]
Rikti: bets $4
Zeeshka: calls $4
*** RIVER *** [3d 8s Ad 7s] [2h]
Rikti: bets $10
Zeeshka: folds 
Uncalled bet ($10) returned to Rikti
Rikti collected $12.42 from pot
Rikti: doesn't show hand 
*** SUMMARY ***
Total pot $13 | Rake $0.58 
Board [3d 8s Ad 7s 2h]
Seat 1: Vikulja1993 folded before Flop (didn't bet)
Seat 2: bilukm folded before Flop (didn't bet)
Seat 3: AlKatrone folded before Flop (didn't bet)
Seat 4: matiko09 folded before Flop (didn't bet)
Seat 5: hammerwife folded before Flop (didn't bet)
Seat 6: Sweden_Pound (button) folded before Flop (didn't bet)
Seat 7: Rikti (small blind) collected ($12.42)
Seat 8: Zeeshka (big blind) folded on the River
Seat 9: oscarleon folded before Flop (didn't bet)





PokerStars Hand #148610036509:  Hold'em No Limit ($0.25/$0.50 USD) - 2016/02/11 13:42:40 CET [2016/02/11 7:42:40 ET]
Table 'Sylvania II' 9-max Seat #1 is the button
Seat 1: tw0315 ($180 in chips) 
Seat 2: Effort92 ($96.05 in chips) 
Seat 4: matiko09 ($126.11 in chips) 
Seat 6: TonnaMunz ($129.93 in chips) 
Seat 7: 2lefthand75 ($46.52 in chips) 
Seat 8: Apparat888 ($37.08 in chips) 
Seat 9: udden82 ($46.43 in chips) 
Effort92: posts small blind $0.25
matiko09: posts big blind $0.50
vlad11122007: sits out 
tw0315: posts the ante $0.10
Effort92: posts the ante $0.10
matiko09: posts the ante $0.10
TonnaMunz: posts the ante $0.10
2lefthand75: posts the ante $0.10
Apparat888: posts the ante $0.10
udden82: posts the ante $0.10
*** HOLE CARDS ***
Dealt to matiko09 [2h Ks]
TonnaMunz: folds 
2lefthand75: folds 
Apparat888: folds 
udden82: folds 
tw0315: calls $0.50
Effort92: folds 
matiko09: checks 
*** FLOP *** [9d 8c 7s]
matiko09: checks 
tw0315: bets $1.50
matiko09: folds 
Uncalled bet ($1.50) returned to tw0315
tw0315 collected $1.86 from pot
*** SUMMARY ***
Total pot $1.95 | Rake $0.09 
Board [9d 8c 7s]
Seat 1: tw0315 (button) collected ($1.86)
Seat 2: Effort92 (small blind) folded before Flop
Seat 4: matiko09 (big blind) folded on the Flop
Seat 6: TonnaMunz folded before Flop (didn't bet)
Seat 7: 2lefthand75 folded before Flop (didn't bet)
Seat 8: Apparat888 folded before Flop (didn't bet)
Seat 9: udden82 folded before Flop (didn't bet)





PokerStars Hand #148610036379:  Hold'em No Limit (€0.25/€0.50 EUR) - 2016/02/11 13:42:40 CET [2016/02/11 7:42:40 ET]
Table 'Otero II' 9-max Seat #7 is the button
Seat 1: Effort92 (€50.75 in chips) 
Seat 2: knauf1991 (€25.66 in chips) 
Seat 4: kram0909 (€28.36 in chips) 
Seat 6: TonnaMunz (€50 in chips) 
Seat 7: CvMCvMCvM (€55.99 in chips) 
Seat 8: matiko09 (€69 in chips) 
Seat 9: Apparat888 (€27.38 in chips) 
matiko09: posts small blind €0.25
Apparat888: posts big blind €0.50
Szevasztopol: sits out 
vlad11122007: sits out 
*** HOLE CARDS ***
Dealt to matiko09 [Kc 2h]
Effort92: folds 
knauf1991: folds 
kram0909: folds 
TonnaMunz: folds 
CvMCvMCvM: raises €0.88 to €1.38
matiko09: folds 
Apparat888: folds 
Uncalled bet (€0.88) returned to CvMCvMCvM
CvMCvMCvM collected €1.25 from pot
CvMCvMCvM: doesn't show hand 
*** SUMMARY ***
Total pot €1.25 | Rake €0 
Seat 1: Effort92 folded before Flop (didn't bet)
Seat 2: knauf1991 folded before Flop (didn't bet)
Seat 4: kram0909 folded before Flop (didn't bet)
Seat 6: TonnaMunz folded before Flop (didn't bet)
Seat 7: CvMCvMCvM (button) collected (€1.25)
Seat 8: matiko09 (small blind) folded before Flop
Seat 9: Apparat888 (big blind) folded before Flop





PokerStars Hand #148610038506:  Hold'em No Limit ($0.50/$1.00 USD) - 2016/02/11 13:42:43 CET [2016/02/11 7:42:43 ET]
Table 'Kleopatra II' 9-max Seat #6 is the button
Seat 1: DUkalisUA ($111.72 in chips) 
Seat 2: azvazdam ($35.58 in chips) 
Seat 3: matiko09 ($104.64 in chips) 
Seat 4: TimStone ($122.13 in chips) 
Seat 5: Sweden_Pound ($111.89 in chips) 
Seat 6: hammerwife ($169.25 in chips) 
Seat 7: Zeeshka ($204.92 in chips) 
Seat 8: oscarleon ($105.64 in chips) 
Seat 9: vrnMike ($111.43 in chips) 
Zeeshka: posts small blind $0.50
oscarleon: posts big blind $1
*** HOLE CARDS ***
Dealt to matiko09 [3s 8h]
vrnMike: folds 
DUkalisUA: folds 
azvazdam: folds 
matiko09: folds 
TimStone: raises $1.62 to $2.62
Sweden_Pound: folds 
hammerwife: folds 
Zeeshka: folds 
oscarleon: folds 
Uncalled bet ($1.62) returned to TimStone
TimStone collected $2.50 from pot
TimStone: doesn't show hand 
*** SUMMARY ***
Total pot $2.50 | Rake $0 
Seat 1: DUkalisUA folded before Flop (didn't bet)
Seat 2: azvazdam folded before Flop (didn't bet)
Seat 3: matiko09 folded before Flop (didn't bet)
Seat 4: TimStone collected ($2.50)
Seat 5: Sweden_Pound folded before Flop (didn't bet)
Seat 6: hammerwife (button) folded before Flop (didn't bet)
Seat 7: Zeeshka (small blind) folded before Flop
Seat 8: oscarleon (big blind) folded before Flop
Seat 9: vrnMike folded before Flop (didn't bet)





PokerStars Hand #148610042993:  Hold'em No Limit ($0.50/$1.00 USD) - 2016/02/11 13:42:51 CET [2016/02/11 7:42:51 ET]
Table 'Marion' 9-max Seat #6 is the button
Seat 1: aseban11 ($100 in chips) 
Seat 2: GusenokRUS ($127.42 in chips) 
Seat 3: TimStone ($103 in chips) 
Seat 4: matiko09 ($100 in chips) 
Seat 5: Rikti ($60.25 in chips) 
Seat 6: 19SERGE74 ($90.37 in chips) 
Seat 7: oscarleon ($103.58 in chips) 
Seat 8: Sweden_Pound ($100 in chips) 
Seat 9: Zeeshka ($100 in chips) 
oscarleon: posts small blind $0.50
Sweden_Pound: posts big blind $1
*** HOLE CARDS ***
Dealt to matiko09 [Th Ad]
Zeeshka: folds 
aseban11: folds 
GusenokRUS: folds 
TimStone: raises $2.01 to $3.01
matiko09: folds 
Rikti: folds 
19SERGE74: calls $3.01
oscarleon: folds 
Sweden_Pound: folds 
*** FLOP *** [3c 4d 7c]
TimStone: checks 
19SERGE74: checks 
*** TURN *** [3c 4d 7c] [6d]
TimStone: checks 
19SERGE74: bets $4
TimStone: folds 
Uncalled bet ($4) returned to 19SERGE74
19SERGE74 collected $7.18 from pot
19SERGE74: doesn't show hand 
*** SUMMARY ***
Total pot $7.52 | Rake $0.34 
Board [3c 4d 7c 6d]
Seat 1: aseban11 folded before Flop (didn't bet)
Seat 2: GusenokRUS folded before Flop (didn't bet)
Seat 3: TimStone folded on the Turn
Seat 4: matiko09 folded before Flop (didn't bet)
Seat 5: Rikti folded before Flop (didn't bet)
Seat 6: 19SERGE74 (button) collected ($7.18)
Seat 7: oscarleon (small blind) folded before Flop
Seat 8: Sweden_Pound (big blind) folded before Flop
Seat 9: Zeeshka folded before Flop (didn't bet)





PokerStars Hand #148610053574:  Hold'em No Limit ($0.25/$0.50 USD) - 2016/02/11 13:43:08 CET [2016/02/11 7:43:08 ET]
Table 'Ambrosia II' 9-max Seat #8 is the button
Seat 1: matiko09 ($56.21 in chips) 
Seat 2: JJJ-K9 ($60.21 in chips) 
Seat 3: make6a ($76.81 in chips) 
Seat 4: huudk2016 ($22.88 in chips) 
Seat 5: RICKA16 ($63.42 in chips) 
Seat 8: Dantist1122 ($50 in chips) 
Seat 9: arctur17 ($53.54 in chips) 
arctur17: posts small blind $0.25
matiko09: posts big blind $0.50
xxxibgdrgn: sits out 
*** HOLE CARDS ***
Dealt to matiko09 [9h 3c]
JJJ-K9: folds 
make6a: folds 
huudk2016: raises $2 to $2.50
RICKA16: folds 
Dantist1122: folds 
arctur17: folds 
matiko09: folds 
Uncalled bet ($2) returned to huudk2016
huudk2016 collected $1.25 from pot
huudk2016: doesn't show hand 
*** SUMMARY ***
Total pot $1.25 | Rake $0 
Seat 1: matiko09 (big blind) folded before Flop
Seat 2: JJJ-K9 folded before Flop (didn't bet)
Seat 3: make6a folded before Flop (didn't bet)
Seat 4: huudk2016 collected ($1.25)
Seat 5: RICKA16 folded before Flop (didn't bet)
Seat 8: Dantist1122 (button) folded before Flop (didn't bet)
Seat 9: arctur17 (small blind) folded before Flop





PokerStars Hand #148610054325:  Hold'em No Limit ($0.50/$1.00 USD) - 2016/02/11 13:43:09 CET [2016/02/11 7:43:09 ET]
Table 'Stephano V' 9-max Seat #5 is the button
Seat 1: hammerwife ($113.25 in chips) 
Seat 2: matiko09 ($145.88 in chips) 
Seat 3: DUkalisUA ($102.40 in chips) 
Seat 4: Zeeshka ($116.05 in chips) 
Seat 5: n2call ($245.10 in chips) 
Seat 6: Sweden_Pound ($124.30 in chips) 
Seat 7: Effort92 ($100 in chips) 
Seat 8: oscarleon ($228.63 in chips) 
Sweden_Pound: posts small blind $0.50
Effort92: posts big blind $1
gabi_igna: sits out 
*** HOLE CARDS ***
Dealt to matiko09 [Th Qd]
oscarleon: folds 
hammerwife: folds 
matiko09: folds 
DUkalisUA: folds 
Zeeshka: raises $2 to $3
n2call: folds 
Sweden_Pound: raises $8 to $11
Effort92: folds 
Zeeshka: calls $8
*** FLOP *** [Ad Ts Kd]
Sweden_Pound: bets $14
Zeeshka: calls $14
*** TURN *** [Ad Ts Kd] [6d]
Sweden_Pound: checks 
Zeeshka: checks 
*** RIVER *** [Ad Ts Kd 6d] [5s]
Sweden_Pound: checks 
Zeeshka: checks 
*** SHOW DOWN ***
Sweden_Pound: shows [Qs Qc] (a pair of Queens)
Zeeshka: shows [Jc Ah] (a pair of Aces)
Zeeshka collected $48.70 from pot
*** SUMMARY ***
Total pot $51 | Rake $2.30 
Board [Ad Ts Kd 6d 5s]
Seat 1: hammerwife folded before Flop (didn't bet)
Seat 2: matiko09 folded before Flop (didn't bet)
Seat 3: DUkalisUA folded before Flop (didn't bet)
Seat 4: Zeeshka showed [Jc Ah] and won ($48.70) with a pair of Aces
Seat 5: n2call (button) folded before Flop (didn't bet)
Seat 6: Sweden_Pound (small blind) showed [Qs Qc] and lost with a pair of Queens
Seat 7: Effort92 (big blind) folded before Flop
Seat 8: oscarleon folded before Flop (didn't bet)





PokerStars Hand #148610058159:  Hold'em No Limit (€0.25/€0.50 EUR) - 2016/02/11 13:43:15 CET [2016/02/11 7:43:15 ET]
Table 'Otero II' 9-max Seat #8 is the button
Seat 1: Effort92 (€50.75 in chips) 
Seat 2: knauf1991 (€25.66 in chips) 
Seat 4: kram0909 (€28.36 in chips) 
Seat 6: TonnaMunz (€50 in chips) 
Seat 7: CvMCvMCvM (€56.74 in chips) 
Seat 8: matiko09 (€68.75 in chips) 
Seat 9: Apparat888 (€26.88 in chips) 
Apparat888: posts small blind €0.25
Effort92: posts big blind €0.50
Szevasztopol: sits out 
vlad11122007: sits out 
*** HOLE CARDS ***
Dealt to matiko09 [7h Qc]
knauf1991: raises €0.50 to €1
kram0909: folds 
TonnaMunz: folds 
CvMCvMCvM: calls €1
matiko09: folds 
Apparat888: folds 
Effort92: folds 
*** FLOP *** [As 2d 9c]
knauf1991: bets €1
CvMCvMCvM: calls €1
*** TURN *** [As 2d 9c] [7d]
knauf1991: bets €1
CvMCvMCvM: calls €1
*** RIVER *** [As 2d 9c 7d] [Js]
knauf1991: bets €1
CvMCvMCvM: calls €1
*** SHOW DOWN ***
knauf1991: shows [Ks Kh] (a pair of Kings)
CvMCvMCvM: shows [Ac 8c] (a pair of Aces)
CvMCvMCvM collected €8.36 from pot
*** SUMMARY ***
Total pot €8.75 | Rake €0.39 
Board [As 2d 9c 7d Js]
Seat 1: Effort92 (big blind) folded before Flop
Seat 2: knauf1991 showed [Ks Kh] and lost with a pair of Kings
Seat 4: kram0909 folded before Flop (didn't bet)
Seat 6: TonnaMunz folded before Flop (didn't bet)
Seat 7: CvMCvMCvM showed [Ac 8c] and won (€8.36) with a pair of Aces
Seat 8: matiko09 (button) folded before Flop (didn't bet)
Seat 9: Apparat888 (small blind) folded before Flop





PokerStars Hand #148610058783:  Hold'em No Limit ($0.50/$1.00 USD) - 2016/02/11 13:43:16 CET [2016/02/11 7:43:16 ET]
Table 'Kleopatra II' 9-max Seat #7 is the button
Seat 1: DUkalisUA ($111.72 in chips) 
Seat 2: azvazdam ($35.58 in chips) 
Seat 3: matiko09 ($104.64 in chips) 
Seat 4: TimStone ($123.63 in chips) 
Seat 5: Sweden_Pound ($111.89 in chips) 
Seat 6: hammerwife ($169.25 in chips) 
Seat 7: Zeeshka ($204.42 in chips) 
Seat 8: oscarleon ($104.64 in chips) 
Seat 9: vrnMike ($111.43 in chips) 
oscarleon: posts small blind $0.50
vrnMike: posts big blind $1
*** HOLE CARDS ***
Dealt to matiko09 [Ah 4d]
DUkalisUA: raises $2 to $3
azvazdam: folds 
matiko09: folds 
TimStone: folds 
Sweden_Pound: folds 
hammerwife: folds 
Zeeshka: folds 
oscarleon: calls $2.50
vrnMike: folds 
*** FLOP *** [2c Qc 5h]
oscarleon: checks 
DUkalisUA: bets $4.40
oscarleon: raises $11.60 to $16
DUkalisUA: calls $11.60
*** TURN *** [2c Qc 5h] [3d]
oscarleon: bets $26
DUkalisUA: raises $66.72 to $92.72 and is all-in
oscarleon: folds 
Uncalled bet ($66.72) returned to DUkalisUA
DUkalisUA collected $88.20 from pot
DUkalisUA: doesn't show hand 
*** SUMMARY ***
Total pot $91 | Rake $2.80 
Board [2c Qc 5h 3d]
Seat 1: DUkalisUA collected ($88.20)
Seat 2: azvazdam folded before Flop (didn't bet)
Seat 3: matiko09 folded before Flop (didn't bet)
Seat 4: TimStone folded before Flop (didn't bet)
Seat 5: Sweden_Pound folded before Flop (didn't bet)
Seat 6: hammerwife folded before Flop (didn't bet)
Seat 7: Zeeshka (button) folded before Flop (didn't bet)
Seat 8: oscarleon (small blind) folded on the Turn
Seat 9: vrnMike (big blind) folded before Flop





PokerStars Hand #148610060925:  Hold'em No Limit ($0.25/$0.50 USD) - 2016/02/11 13:43:20 CET [2016/02/11 7:43:20 ET]
Table 'Sylvania II' 9-max Seat #2 is the button
Seat 1: tw0315 ($181.26 in chips) 
Seat 2: Effort92 ($95.70 in chips) 
Seat 4: matiko09 ($125.51 in chips) 
Seat 5: vlad11122007 ($57.06 in chips) 
Seat 6: TonnaMunz ($129.83 in chips) 
Seat 7: 2lefthand75 ($46.42 in chips) 
Seat 8: Apparat888 ($36.98 in chips) 
Seat 9: udden82 ($46.33 in chips) 
matiko09: posts small blind $0.25
vlad11122007: posts big blind $0.50
tw0315: posts the ante $0.10
Effort92: posts the ante $0.10
matiko09: posts the ante $0.10
vlad11122007: posts the ante $0.10
TonnaMunz: posts the ante $0.10
2lefthand75: posts the ante $0.10
Apparat888: posts the ante $0.10
udden82: posts the ante $0.10
*** HOLE CARDS ***
Dealt to matiko09 [Jd Ad]
TonnaMunz: folds 
2lefthand75: folds 
Apparat888: raises $0.75 to $1.25
udden82: folds 
tw0315: calls $1.25
Effort92: calls $1.25
matiko09: raises $4.75 to $6
vlad11122007: folds 
Apparat888: folds 
tw0315: calls $4.75
Effort92: calls $4.75
*** FLOP *** [6d 3h Tc]
matiko09: bets $10
tw0315: calls $10
Effort92: folds 
*** TURN *** [6d 3h Tc] [7h]
matiko09: checks 
tw0315: checks 
*** RIVER *** [6d 3h Tc 7h] [5c]
matiko09: checks 
udden82 leaves the table
tw0315: checks 
*** SHOW DOWN ***
matiko09: shows [Jd Ad] (high card Ace)
tw0315: shows [Qc Th] (a pair of Tens)
tw0315 collected $38.73 from pot
*** SUMMARY ***
Total pot $40.55 | Rake $1.82 
Board [6d 3h Tc 7h 5c]
Seat 1: tw0315 showed [Qc Th] and won ($38.73) with a pair of Tens
Seat 2: Effort92 (button) folded on the Flop
Seat 4: matiko09 (small blind) showed [Jd Ad] and lost with high card Ace
Seat 5: vlad11122007 (big blind) folded before Flop
Seat 6: TonnaMunz folded before Flop (didn't bet)
Seat 7: 2lefthand75 folded before Flop (didn't bet)
Seat 8: Apparat888 folded before Flop
Seat 9: udden82 folded before Flop (didn't bet)





PokerStars Hand #148610062028:  Hold'em No Limit ($0.25/$0.50 USD) - 2016/02/11 13:43:22 CET [2016/02/11 7:43:22 ET]
Table 'Stereoskopia' 9-max Seat #2 is the button
Seat 1: FoRvvArD_go ($50 in chips) 
Seat 2: Dantist1122 ($52.25 in chips) 
Seat 3: fandorin2005 ($50 in chips) 
Seat 4: Anikin44 ($51.96 in chips) 
Seat 5: afrodit71 ($41.33 in chips) 
Seat 6: matiko09 ($54.15 in chips) 
Seat 7: Serhent ($62.05 in chips) 
Seat 9: nastynate075 ($21.85 in chips) 
fandorin2005: posts small blind $0.25
Anikin44: posts big blind $0.50
WDW3: sits out 
*** HOLE CARDS ***
Dealt to matiko09 [Ks Jd]
afrodit71: calls $0.50
matiko09: raises $2 to $2.50
Serhent: calls $2.50
nastynate075: calls $2.50
FoRvvArD_go: folds 
Dantist1122: folds 
fandorin2005: folds 
Anikin44: folds 
afrodit71: calls $2
*** FLOP *** [4d 8h 9s]
afrodit71: checks 
matiko09: checks 
Serhent: bets $6.57
nastynate075: folds 
afrodit71: folds 
matiko09: folds 
Uncalled bet ($6.57) returned to Serhent
Serhent collected $10.27 from pot
Serhent: doesn't show hand 
*** SUMMARY ***
Total pot $10.75 | Rake $0.48 
Board [4d 8h 9s]
Seat 1: FoRvvArD_go folded before Flop (didn't bet)
Seat 2: Dantist1122 (button) folded before Flop (didn't bet)
Seat 3: fandorin2005 (small blind) folded before Flop
Seat 4: Anikin44 (big blind) folded before Flop
Seat 5: afrodit71 folded on the Flop
Seat 6: matiko09 folded on the Flop
Seat 7: Serhent collected ($10.27)
Seat 9: nastynate075 folded on the Flop





PokerStars Hand #148610079049:  Hold'em No Limit ($0.50/$1.00 USD) - 2016/02/11 13:43:50 CET [2016/02/11 7:43:50 ET]
Table 'Tama' 9-max Seat #2 is the button
Seat 1: aseban11 ($112.81 in chips) 
Seat 2: matiko09 ($100 in chips) 
Seat 3: gabi_igna ($100 in chips) 
Seat 4: Cogss ($151.70 in chips) 
Seat 5: Zeeshka ($100 in chips) 
Seat 6: vicdroopy ($100 in chips) 
Seat 7: GrishaPE ($48.96 in chips) 
Seat 8: er13to ($100 in chips) 
Seat 9: Edvendor ($67.23 in chips) 
gabi_igna: posts small blind $0.50
Cogss: posts big blind $1
*** HOLE CARDS ***
Dealt to matiko09 [9h 6c]
Zeeshka: folds 
vicdroopy: folds 
GrishaPE: folds 
er13to: folds 
Edvendor: folds 
aseban11: folds 
matiko09: folds 
gabi_igna: raises $2 to $3
Cogss: calls $2
*** FLOP *** [5d 5h 8h]
gabi_igna: bets $3
Cogss: folds 
Uncalled bet ($3) returned to gabi_igna
gabi_igna collected $5.73 from pot
gabi_igna: doesn't show hand 
*** SUMMARY ***
Total pot $6 | Rake $0.27 
Board [5d 5h 8h]
Seat 1: aseban11 folded before Flop (didn't bet)
Seat 2: matiko09 (button) folded before Flop (didn't bet)
Seat 3: gabi_igna (small blind) collected ($5.73)
Seat 4: Cogss (big blind) folded on the Flop
Seat 5: Zeeshka folded before Flop (didn't bet)
Seat 6: vicdroopy folded before Flop (didn't bet)
Seat 7: GrishaPE folded before Flop (didn't bet)
Seat 8: er13to folded before Flop (didn't bet)
Seat 9: Edvendor folded before Flop (didn't bet)





PokerStars Hand #148610080460:  Hold'em No Limit ($0.50/$1.00 USD) - 2016/02/11 13:43:52 CET [2016/02/11 7:43:52 ET]
Table 'Marion' 9-max Seat #7 is the button
Seat 1: aseban11 ($100 in chips) 
Seat 2: GusenokRUS ($127.42 in chips) 
Seat 3: TimStone ($100 in chips) 
Seat 4: matiko09 ($100 in chips) 
Seat 5: Rikti ($60.25 in chips) 
Seat 6: 19SERGE74 ($94.54 in chips) 
Seat 7: oscarleon ($103.08 in chips) 
Seat 8: Sweden_Pound ($100 in chips) 
Seat 9: Zeeshka ($100 in chips) 
Sweden_Pound: posts small blind $0.50
Zeeshka: posts big blind $1
*** HOLE CARDS ***
Dealt to matiko09 [8d 3s]
aseban11: raises $1.50 to $2.50
GusenokRUS: folds 
TimStone: folds 
matiko09: folds 
Rikti: folds 
19SERGE74: folds 
oscarleon: folds 
Sweden_Pound: folds 
Zeeshka: folds 
Uncalled bet ($1.50) returned to aseban11
aseban11 collected $2.50 from pot
aseban11: doesn't show hand 
*** SUMMARY ***
Total pot $2.50 | Rake $0 
Seat 1: aseban11 collected ($2.50)
Seat 2: GusenokRUS folded before Flop (didn't bet)
Seat 3: TimStone folded before Flop (didn't bet)
Seat 4: matiko09 folded before Flop (didn't bet)
Seat 5: Rikti folded before Flop (didn't bet)
Seat 6: 19SERGE74 folded before Flop (didn't bet)
Seat 7: oscarleon (button) folded before Flop (didn't bet)
Seat 8: Sweden_Pound (small blind) folded before Flop
Seat 9: Zeeshka (big blind) folded before Flop





PokerStars Hand #148610084026:  Hold'em No Limit ($0.25/$0.50 USD) - 2016/02/11 13:43:58 CET [2016/02/11 7:43:58 ET]
Table 'Ambrosia II' 9-max Seat #9 is the button
Seat 1: matiko09 ($55.71 in chips) 
Seat 2: JJJ-K9 ($60.21 in chips) 
Seat 3: make6a ($76.81 in chips) 
Seat 4: huudk2016 ($23.63 in chips) 
Seat 5: RICKA16 ($63.42 in chips) 
Seat 8: Dantist1122 ($50 in chips) 
Seat 9: arctur17 ($53.29 in chips) 
matiko09: posts small blind $0.25
JJJ-K9: posts big blind $0.50
xxxibgdrgn: sits out 
*** HOLE CARDS ***
Dealt to matiko09 [2d 9s]
make6a: folds 
huudk2016: calls $0.50
RICKA16: folds 
Dantist1122: folds 
arctur17: folds 
matiko09: folds 
JJJ-K9: checks 
*** FLOP *** [Ad 5c 7c]
JJJ-K9: checks 
huudk2016: bets $1.50
JJJ-K9: folds 
Uncalled bet ($1.50) returned to huudk2016
huudk2016 collected $1.19 from pot
huudk2016: doesn't show hand 
*** SUMMARY ***
Total pot $1.25 | Rake $0.06 
Board [Ad 5c 7c]
Seat 1: matiko09 (small blind) folded before Flop
Seat 2: JJJ-K9 (big blind) folded on the Flop
Seat 3: make6a folded before Flop (didn't bet)
Seat 4: huudk2016 collected ($1.19)
Seat 5: RICKA16 folded before Flop (didn't bet)
Seat 8: Dantist1122 folded before Flop (didn't bet)
Seat 9: arctur17 (button) folded before Flop (didn't bet)





PokerStars Hand #148610085026:  Hold'em No Limit ($0.50/$1.00 USD) - 2016/02/11 13:43:59 CET [2016/02/11 7:43:59 ET]
Table 'Gianfar' 9-max Seat #7 is the button
Seat 1: Vikulja1993 ($100.50 in chips) 
Seat 2: bilukm ($60.70 in chips) 
Seat 3: AlKatrone ($169.99 in chips) 
Seat 4: matiko09 ($125.98 in chips) 
Seat 5: hammerwife ($195.99 in chips) 
Seat 6: Sweden_Pound ($100 in chips) 
Seat 7: Rikti ($39.22 in chips) 
Seat 8: Zeeshka ($112.88 in chips) 
Seat 9: oscarleon ($144.62 in chips) 
Zeeshka: posts small blind $0.50
oscarleon: posts big blind $1
*** HOLE CARDS ***
Dealt to matiko09 [Td Tc]
Vikulja1993: folds 
bilukm: folds 
AlKatrone: folds 
matiko09: raises $2 to $3
hammerwife: folds 
Sweden_Pound: folds 
Rikti: folds 
Zeeshka: folds 
oscarleon: folds 
Uncalled bet ($2) returned to matiko09
matiko09 collected $2.50 from pot
matiko09: doesn't show hand 
*** SUMMARY ***
Total pot $2.50 | Rake $0 
Seat 1: Vikulja1993 folded before Flop (didn't bet)
Seat 2: bilukm folded before Flop (didn't bet)
Seat 3: AlKatrone folded before Flop (didn't bet)
Seat 4: matiko09 collected ($2.50)
Seat 5: hammerwife folded before Flop (didn't bet)
Seat 6: Sweden_Pound folded before Flop (didn't bet)
Seat 7: Rikti (button) folded before Flop (didn't bet)
Seat 8: Zeeshka (small blind) folded before Flop
Seat 9: oscarleon (big blind) folded before Flop





PokerStars Hand #148610089129:  Hold'em No Limit (€0.25/€0.50 EUR) - 2016/02/11 13:44:06 CET [2016/02/11 7:44:06 ET]
Table 'Otero II' 9-max Seat #9 is the button
Seat 1: Effort92 (€50.25 in chips) 
Seat 2: knauf1991 (€21.66 in chips) 
Seat 4: kram0909 (€28.36 in chips) 
Seat 6: TonnaMunz (€50 in chips) 
Seat 7: CvMCvMCvM (€61.10 in chips) 
Seat 8: matiko09 (€68.75 in chips) 
Seat 9: Apparat888 (€26.63 in chips) 
Effort92: posts small blind €0.25
knauf1991: posts big blind €0.50
Szevasztopol: sits out 
vlad11122007: sits out 
*** HOLE CARDS ***
Dealt to matiko09 [Kd 2s]
kram0909: folds 
TonnaMunz: folds 
CvMCvMCvM: folds 
matiko09: folds 
Apparat888: folds 
Effort92: folds 
Uncalled bet (€0.25) returned to knauf1991
knauf1991 collected €0.50 from pot
knauf1991: doesn't show hand 
*** SUMMARY ***
Total pot €0.50 | Rake €0 
Seat 1: Effort92 (small blind) folded before Flop
Seat 2: knauf1991 (big blind) collected (€0.50)
Seat 4: kram0909 folded before Flop (didn't bet)
Seat 6: TonnaMunz folded before Flop (didn't bet)
Seat 7: CvMCvMCvM folded before Flop (didn't bet)
Seat 8: matiko09 folded before Flop (didn't bet)
Seat 9: Apparat888 (button) folded before Flop (didn't bet)





PokerStars Hand #148610097649:  Hold'em No Limit ($0.50/$1.00 USD) - 2016/02/11 13:44:20 CET [2016/02/11 7:44:20 ET]
Table 'Marion' 9-max Seat #8 is the button
Seat 1: aseban11 ($101.50 in chips) 
Seat 2: GusenokRUS ($127.42 in chips) 
Seat 3: TimStone ($100 in chips) 
Seat 4: matiko09 ($100 in chips) 
Seat 5: Rikti ($60.25 in chips) 
Seat 6: 19SERGE74 ($94.54 in chips) 
Seat 7: oscarleon ($103.08 in chips) 
Seat 8: Sweden_Pound ($100 in chips) 
Seat 9: Zeeshka ($100 in chips) 
Zeeshka: posts small blind $0.50
aseban11: posts big blind $1
*** HOLE CARDS ***
Dealt to matiko09 [3d 9d]
GusenokRUS: folds 
TimStone: folds 
matiko09: folds 
Rikti: folds 
19SERGE74: folds 
oscarleon: raises $2 to $3
Sweden_Pound: folds 
Zeeshka: folds 
aseban11: folds 
Uncalled bet ($2) returned to oscarleon
oscarleon collected $2.50 from pot
oscarleon: doesn't show hand 
*** SUMMARY ***
Total pot $2.50 | Rake $0 
Seat 1: aseban11 (big blind) folded before Flop
Seat 2: GusenokRUS folded before Flop (didn't bet)
Seat 3: TimStone folded before Flop (didn't bet)
Seat 4: matiko09 folded before Flop (didn't bet)
Seat 5: Rikti folded before Flop (didn't bet)
Seat 6: 19SERGE74 folded before Flop (didn't bet)
Seat 7: oscarleon collected ($2.50)
Seat 8: Sweden_Pound (button) folded before Flop (didn't bet)
Seat 9: Zeeshka (small blind) folded before Flop





PokerStars Hand #148610102997:  Hold'em No Limit (€0.25/€0.50 EUR) - 2016/02/11 13:44:28 CET [2016/02/11 7:44:28 ET]
Table 'Otero II' 9-max Seat #1 is the button
Seat 1: Effort92 (€50 in chips) 
Seat 2: knauf1991 (€21.91 in chips) 
Seat 3: Szevasztopol (€56.24 in chips) 
Seat 4: kram0909 (€28.36 in chips) 
Seat 6: TonnaMunz (€50 in chips) 
Seat 7: CvMCvMCvM (€61.10 in chips) 
Seat 8: matiko09 (€68.75 in chips) 
Seat 9: Apparat888 (€26.63 in chips) 
knauf1991: posts small blind €0.25
Szevasztopol: posts big blind €0.50
vlad11122007: sits out 
*** HOLE CARDS ***
Dealt to matiko09 [2s As]
kram0909: folds 
TonnaMunz: folds 
CvMCvMCvM: folds 
matiko09: raises €1 to €1.50
Apparat888: folds 
Effort92: folds 
knauf1991: folds 
Szevasztopol: folds 
Uncalled bet (€1) returned to matiko09
matiko09 collected €1.25 from pot
matiko09: doesn't show hand 
*** SUMMARY ***
Total pot €1.25 | Rake €0 
Seat 1: Effort92 (button) folded before Flop (didn't bet)
Seat 2: knauf1991 (small blind) folded before Flop
Seat 3: Szevasztopol (big blind) folded before Flop
Seat 4: kram0909 folded before Flop (didn't bet)
Seat 6: TonnaMunz folded before Flop (didn't bet)
Seat 7: CvMCvMCvM folded before Flop (didn't bet)
Seat 8: matiko09 collected (€1.25)
Seat 9: Apparat888 folded before Flop (didn't bet)





PokerStars Hand #148610103716:  Hold'em No Limit ($0.50/$1.00 USD) - 2016/02/11 13:44:30 CET [2016/02/11 7:44:30 ET]
Table 'Tama' 9-max Seat #3 is the button
Seat 1: aseban11 ($112.81 in chips) 
Seat 2: matiko09 ($100 in chips) 
Seat 3: gabi_igna ($102.73 in chips) 
Seat 4: Cogss ($148.70 in chips) 
Seat 5: Zeeshka ($100 in chips) 
Seat 6: vicdroopy ($100 in chips) 
Seat 7: GrishaPE ($48.96 in chips) 
Seat 8: er13to ($100 in chips) 
Seat 9: Edvendor ($67.23 in chips) 
Cogss: posts small blind $0.50
Zeeshka: posts big blind $1
*** HOLE CARDS ***
Dealt to matiko09 [2d 4d]
vicdroopy: folds 
GrishaPE: folds 
er13to: folds 
Edvendor: raises $2 to $3
aseban11: folds 
matiko09: folds 
gabi_igna: folds 
Cogss: folds 
Zeeshka: folds 
Uncalled bet ($2) returned to Edvendor
Edvendor collected $2.50 from pot
Edvendor: doesn't show hand 
*** SUMMARY ***
Total pot $2.50 | Rake $0 
Seat 1: aseban11 folded before Flop (didn't bet)
Seat 2: matiko09 folded before Flop (didn't bet)
Seat 3: gabi_igna (button) folded before Flop (didn't bet)
Seat 4: Cogss (small blind) folded before Flop
Seat 5: Zeeshka (big blind) folded before Flop
Seat 6: vicdroopy folded before Flop (didn't bet)
Seat 7: GrishaPE folded before Flop (didn't bet)
Seat 8: er13to folded before Flop (didn't bet)
Seat 9: Edvendor collected ($2.50)





PokerStars Hand #148610109970:  Hold'em No Limit ($0.50/$1.00 USD) - 2016/02/11 13:44:40 CET [2016/02/11 7:44:40 ET]
Table 'Stephano V' 9-max Seat #6 is the button
Seat 1: hammerwife ($113.25 in chips) 
Seat 2: matiko09 ($145.88 in chips) 
Seat 3: DUkalisUA ($102.40 in chips) 
Seat 4: Zeeshka ($139.75 in chips) 
Seat 5: n2call ($245.10 in chips) 
Seat 6: Sweden_Pound ($100 in chips) 
Seat 7: Effort92 ($100 in chips) 
Seat 8: oscarleon ($228.63 in chips) 
Effort92: posts small blind $0.50
oscarleon: posts big blind $1
gabi_igna: sits out 
*** HOLE CARDS ***
Dealt to matiko09 [2s Kh]
hammerwife: folds 
matiko09: folds 
DUkalisUA: folds 
Zeeshka: folds 
n2call: folds 
Sweden_Pound: folds 
Effort92: folds 
Uncalled bet ($0.50) returned to oscarleon
oscarleon collected $1 from pot
oscarleon: doesn't show hand 
*** SUMMARY ***
Total pot $1 | Rake $0 
Seat 1: hammerwife folded before Flop (didn't bet)
Seat 2: matiko09 folded before Flop (didn't bet)
Seat 3: DUkalisUA folded before Flop (didn't bet)
Seat 4: Zeeshka folded before Flop (didn't bet)
Seat 5: n2call folded before Flop (didn't bet)
Seat 6: Sweden_Pound (button) folded before Flop (didn't bet)
Seat 7: Effort92 (small blind) folded before Flop
Seat 8: oscarleon (big blind) collected ($1)





PokerStars Hand #148610110193:  Hold'em No Limit ($0.25/$0.50 USD) - 2016/02/11 13:44:40 CET [2016/02/11 7:44:40 ET]
Table 'Sylvania II' 9-max Seat #4 is the button
Seat 1: tw0315 ($203.89 in chips) 
Seat 2: Effort92 ($89.60 in chips) 
Seat 4: matiko09 ($109.41 in chips) 
Seat 5: vlad11122007 ($56.46 in chips) 
Seat 6: TonnaMunz ($129.73 in chips) 
Seat 7: 2lefthand75 ($46.32 in chips) 
Seat 8: Apparat888 ($50.63 in chips) 
CvMCvMCvM joins the table at seat #9 
vlad11122007: posts small blind $0.25
TonnaMunz: posts big blind $0.50
tw0315: posts the ante $0.10
Effort92: posts the ante $0.10
matiko09: posts the ante $0.10
vlad11122007: posts the ante $0.10
TonnaMunz: posts the ante $0.10
2lefthand75: posts the ante $0.10
Apparat888: posts the ante $0.10
*** HOLE CARDS ***
Dealt to matiko09 [3c Ad]
2lefthand75: folds 
Apparat888: folds 
tw0315: calls $0.50
Effort92: folds 
matiko09: raises $1.50 to $2
vlad11122007: folds 
TonnaMunz: folds 
tw0315: calls $1.50
*** FLOP *** [8d 2d 6c]
tw0315: checks 
matiko09: checks 
*** TURN *** [8d 2d 6c] [5s]
tw0315: checks 
matiko09: checks 
*** RIVER *** [8d 2d 6c 5s] [Tc]
tw0315: checks 
matiko09: checks 
*** SHOW DOWN ***
tw0315: shows [9h 4d] (high card Ten)
matiko09: shows [3c Ad] (high card Ace)
matiko09 collected $5.20 from pot
*** SUMMARY ***
Total pot $5.45 | Rake $0.25 
Board [8d 2d 6c 5s Tc]
Seat 1: tw0315 showed [9h 4d] and lost with high card Ten
Seat 2: Effort92 folded before Flop (didn't bet)
Seat 4: matiko09 (button) showed [3c Ad] and won ($5.20) with high card Ace
Seat 5: vlad11122007 (small blind) folded before Flop
Seat 6: TonnaMunz (big blind) folded before Flop
Seat 7: 2lefthand75 folded before Flop (didn't bet)
Seat 8: Apparat888 folded before Flop (didn't bet)





PokerStars Hand #148610111306:  Hold'em No Limit ($0.25/$0.50 USD) - 2016/02/11 13:44:42 CET [2016/02/11 7:44:42 ET]
Table 'Ambrosia II' 9-max Seat #1 is the button
Seat 1: matiko09 ($55.46 in chips) 
Seat 2: JJJ-K9 ($59.71 in chips) 
Seat 3: make6a ($76.81 in chips) 
Seat 4: huudk2016 ($24.32 in chips) 
Seat 5: RICKA16 ($63.42 in chips) 
Seat 8: Dantist1122 ($50 in chips) 
Seat 9: arctur17 ($53.29 in chips) 
JJJ-K9: posts small blind $0.25
make6a: posts big blind $0.50
xxxibgdrgn: sits out 
*** HOLE CARDS ***
Dealt to matiko09 [4c Qd]
huudk2016: folds 
RICKA16: raises $1 to $1.50
Dantist1122: folds 
arctur17: calls $1.50
matiko09: folds 
JJJ-K9: folds 
make6a: folds 
*** FLOP *** [3s 6h 7c]
RICKA16: checks 
arctur17: bets $2
RICKA16: folds 
Uncalled bet ($2) returned to arctur17
arctur17 collected $3.58 from pot
arctur17: doesn't show hand 
*** SUMMARY ***
Total pot $3.75 | Rake $0.17 
Board [3s 6h 7c]
Seat 1: matiko09 (button) folded before Flop (didn't bet)
Seat 2: JJJ-K9 (small blind) folded before Flop
Seat 3: make6a (big blind) folded before Flop
Seat 4: huudk2016 folded before Flop (didn't bet)
Seat 5: RICKA16 folded on the Flop
Seat 8: Dantist1122 folded before Flop (didn't bet)
Seat 9: arctur17 collected ($3.58)





PokerStars Hand #148610112206:  Hold'em No Limit ($0.50/$1.00 USD) - 2016/02/11 13:44:44 CET [2016/02/11 7:44:44 ET]
Table 'Gianfar' 9-max Seat #8 is the button
Seat 1: Vikulja1993 ($100.50 in chips) 
Seat 2: bilukm ($60.70 in chips) 
Seat 3: AlKatrone ($169.99 in chips) 
Seat 4: matiko09 ($127.48 in chips) 
Seat 5: hammerwife ($195.99 in chips) 
Seat 6: Sweden_Pound ($100 in chips) 
Seat 7: Rikti ($39.22 in chips) 
Seat 8: Zeeshka ($112.38 in chips) 
Seat 9: oscarleon ($143.62 in chips) 
oscarleon: posts small blind $0.50
Vikulja1993: posts big blind $1
*** HOLE CARDS ***
Dealt to matiko09 [Td Js]
bilukm: raises $1 to $2
AlKatrone: folds 
matiko09: folds 
hammerwife: folds 
Sweden_Pound: folds 
Rikti: folds 
Zeeshka: folds 
oscarleon: folds 
Vikulja1993: calls $1
*** FLOP *** [6c 8h Jd]
Vikulja1993: checks 
bilukm: checks 
*** TURN *** [6c 8h Jd] [Tc]
Vikulja1993: bets $2.25
bilukm: folds 
Uncalled bet ($2.25) returned to Vikulja1993
Vikulja1993 collected $4.30 from pot
Vikulja1993: doesn't show hand 
*** SUMMARY ***
Total pot $4.50 | Rake $0.20 
Board [6c 8h Jd Tc]
Seat 1: Vikulja1993 (big blind) collected ($4.30)
Seat 2: bilukm folded on the Turn
Seat 3: AlKatrone folded before Flop (didn't bet)
Seat 4: matiko09 folded before Flop (didn't bet)
Seat 5: hammerwife folded before Flop (didn't bet)
Seat 6: Sweden_Pound folded before Flop (didn't bet)
Seat 7: Rikti folded before Flop (didn't bet)
Seat 8: Zeeshka (button) folded before Flop (didn't bet)
Seat 9: oscarleon (small blind) folded before Flop





PokerStars Hand #148610117801:  Hold'em No Limit ($0.50/$1.00 USD) - 2016/02/11 13:44:53 CET [2016/02/11 7:44:53 ET]
Table 'Kleopatra II' 9-max Seat #8 is the button
Seat 1: DUkalisUA ($154.92 in chips) 
Seat 2: azvazdam ($35.58 in chips) 
Seat 3: matiko09 ($104.64 in chips) 
Seat 4: TimStone ($123.63 in chips) 
Seat 5: Sweden_Pound ($111.89 in chips) 
Seat 6: hammerwife ($169.25 in chips) 
Seat 7: Zeeshka ($204.42 in chips) 
Seat 8: oscarleon ($100 in chips) 
Seat 9: vrnMike ($110.43 in chips) 
vrnMike: posts small blind $0.50
DUkalisUA: posts big blind $1
*** HOLE CARDS ***
Dealt to matiko09 [Kd Ac]
azvazdam: folds 
matiko09: raises $2 to $3
TimStone: folds 
Sweden_Pound: raises $6 to $9
hammerwife: folds 
Zeeshka: folds 
oscarleon: folds 
vrnMike: folds 
DUkalisUA: folds 
matiko09: folds 
Uncalled bet ($6) returned to Sweden_Pound
Sweden_Pound collected $7.50 from pot
Sweden_Pound: doesn't show hand 
*** SUMMARY ***
Total pot $7.50 | Rake $0 
Seat 1: DUkalisUA (big blind) folded before Flop
Seat 2: azvazdam folded before Flop (didn't bet)
Seat 3: matiko09 folded before Flop
Seat 4: TimStone folded before Flop (didn't bet)
Seat 5: Sweden_Pound collected ($7.50)
Seat 6: hammerwife folded before Flop (didn't bet)
Seat 7: Zeeshka folded before Flop (didn't bet)
Seat 8: oscarleon (button) folded before Flop (didn't bet)
Seat 9: vrnMike (small blind) folded before Flop





PokerStars Hand #148610119112:  Hold'em No Limit (€0.25/€0.50 EUR) - 2016/02/11 13:44:55 CET [2016/02/11 7:44:55 ET]
Table 'Otero II' 9-max Seat #2 is the button
Seat 1: Effort92 (€50 in chips) 
Seat 2: knauf1991 (€21.66 in chips) 
Seat 3: Szevasztopol (€55.74 in chips) 
Seat 4: kram0909 (€28.36 in chips) 
Seat 6: TonnaMunz (€50 in chips) 
Seat 7: CvMCvMCvM (€61.10 in chips) 
Seat 8: matiko09 (€69.50 in chips) 
Seat 9: Apparat888 (€26.63 in chips) 
Szevasztopol: posts small blind €0.25
kram0909: posts big blind €0.50
vlad11122007: sits out 
*** HOLE CARDS ***
Dealt to matiko09 [3c Qc]
TonnaMunz: folds 
CvMCvMCvM: folds 
matiko09: folds 
Apparat888: folds 
Effort92: folds 
knauf1991: folds 
Szevasztopol: folds 
Uncalled bet (€0.25) returned to kram0909
kram0909 collected €0.50 from pot
kram0909: doesn't show hand 
*** SUMMARY ***
Total pot €0.50 | Rake €0 
Seat 1: Effort92 folded before Flop (didn't bet)
Seat 2: knauf1991 (button) folded before Flop (didn't bet)
Seat 3: Szevasztopol (small blind) folded before Flop
Seat 4: kram0909 (big blind) collected (€0.50)
Seat 6: TonnaMunz folded before Flop (didn't bet)
Seat 7: CvMCvMCvM folded before Flop (didn't bet)
Seat 8: matiko09 folded before Flop (didn't bet)
Seat 9: Apparat888 folded before Flop (didn't bet)





PokerStars Hand #148610121359:  Hold'em No Limit ($0.25/$0.50 USD) - 2016/02/11 13:44:59 CET [2016/02/11 7:44:59 ET]
Table 'Stereoskopia' 9-max Seat #3 is the button
Seat 1: FoRvvArD_go ($50 in chips) 
Seat 2: Dantist1122 ($52.25 in chips) 
Seat 3: fandorin2005 ($50 in chips) 
Seat 4: Anikin44 ($51.46 in chips) 
Seat 5: afrodit71 ($38.83 in chips) 
Seat 6: matiko09 ($51.65 in chips) 
Seat 7: Serhent ($69.82 in chips) 
Seat 9: nastynate075 ($19.35 in chips) 
Anikin44: posts small blind $0.25
afrodit71: posts big blind $0.50
WDW3: sits out 
*** HOLE CARDS ***
Dealt to matiko09 [Ac 7c]
matiko09: folds 
Serhent: folds 
nastynate075: folds 
FoRvvArD_go: raises $1 to $1.50
Dantist1122: folds 
fandorin2005: folds 
Anikin44: calls $1.25
afrodit71: calls $1
*** FLOP *** [7d 7s 2d]
Anikin44: checks 
afrodit71: bets $3
FoRvvArD_go: folds 
Anikin44: folds 
Uncalled bet ($3) returned to afrodit71
afrodit71 collected $4.30 from pot
afrodit71: doesn't show hand 
*** SUMMARY ***
Total pot $4.50 | Rake $0.20 
Board [7d 7s 2d]
Seat 1: FoRvvArD_go folded on the Flop
Seat 2: Dantist1122 folded before Flop (didn't bet)
Seat 3: fandorin2005 (button) folded before Flop (didn't bet)
Seat 4: Anikin44 (small blind) folded on the Flop
Seat 5: afrodit71 (big blind) collected ($4.30)
Seat 6: matiko09 folded before Flop (didn't bet)
Seat 7: Serhent folded before Flop (didn't bet)
Seat 9: nastynate075 folded before Flop (didn't bet)





PokerStars Hand #148610123577:  Hold'em No Limit ($0.50/$1.00 USD) - 2016/02/11 13:45:02 CET [2016/02/11 7:45:02 ET]
Table 'Marion' 9-max Seat #9 is the button
Seat 1: aseban11 ($100.50 in chips) 
Seat 2: GusenokRUS ($127.42 in chips) 
Seat 3: TimStone ($100 in chips) 
Seat 4: matiko09 ($100 in chips) 
Seat 5: Rikti ($60.25 in chips) 
Seat 6: 19SERGE74 ($94.54 in chips) 
Seat 7: oscarleon ($104.58 in chips) 
Seat 8: Sweden_Pound ($100 in chips) 
Seat 9: Zeeshka ($100 in chips) 
aseban11: posts small blind $0.50
GusenokRUS: posts big blind $1
*** HOLE CARDS ***
Dealt to matiko09 [6d 8d]
TimStone: folds 
matiko09: folds 
Rikti: folds 
19SERGE74: folds 
oscarleon: folds 
Sweden_Pound: raises $1.50 to $2.50
Zeeshka: folds 
aseban11: folds 
GusenokRUS: folds 
Uncalled bet ($1.50) returned to Sweden_Pound
Sweden_Pound collected $2.50 from pot
Sweden_Pound: doesn't show hand 
*** SUMMARY ***
Total pot $2.50 | Rake $0 
Seat 1: aseban11 (small blind) folded before Flop
Seat 2: GusenokRUS (big blind) folded before Flop
Seat 3: TimStone folded before Flop (didn't bet)
Seat 4: matiko09 folded before Flop (didn't bet)
Seat 5: Rikti folded before Flop (didn't bet)
Seat 6: 19SERGE74 folded before Flop (didn't bet)
Seat 7: oscarleon folded before Flop (didn't bet)
Seat 8: Sweden_Pound collected ($2.50)
Seat 9: Zeeshka (button) folded before Flop (didn't bet)





PokerStars Hand #148610127169:  Hold'em No Limit ($0.50/$1.00 USD) - 2016/02/11 13:45:08 CET [2016/02/11 7:45:08 ET]
Table 'Tama' 9-max Seat #4 is the button
Seat 1: aseban11 ($112.81 in chips) 
Seat 2: matiko09 ($100 in chips) 
Seat 3: gabi_igna ($102.73 in chips) 
Seat 4: Cogss ($148.20 in chips) 
Seat 5: Zeeshka ($100 in chips) 
Seat 6: vicdroopy ($100 in chips) 
Seat 7: GrishaPE ($48.96 in chips) 
Seat 8: er13to ($100 in chips) 
Seat 9: Edvendor ($68.73 in chips) 
Zeeshka: posts small blind $0.50
vicdroopy: posts big blind $1
*** HOLE CARDS ***
Dealt to matiko09 [4h Ts]
GrishaPE: folds 
er13to: folds 
Edvendor: folds 
aseban11: folds 
matiko09: folds 
gabi_igna: folds 
Cogss: folds 
Zeeshka: raises $2 to $3
vicdroopy: calls $2
*** FLOP *** [Ad 6d 2s]
Zeeshka: checks 
vicdroopy: checks 
*** TURN *** [Ad 6d 2s] [9d]
Zeeshka: bets $3.15
vicdroopy: folds 
Uncalled bet ($3.15) returned to Zeeshka
Zeeshka collected $5.73 from pot
Zeeshka: doesn't show hand 
*** SUMMARY ***
Total pot $6 | Rake $0.27 
Board [Ad 6d 2s 9d]
Seat 1: aseban11 folded before Flop (didn't bet)
Seat 2: matiko09 folded before Flop (didn't bet)
Seat 3: gabi_igna folded before Flop (didn't bet)
Seat 4: Cogss (button) folded before Flop (didn't bet)
Seat 5: Zeeshka (small blind) collected ($5.73)
Seat 6: vicdroopy (big blind) folded on the Turn
Seat 7: GrishaPE folded before Flop (didn't bet)
Seat 8: er13to folded before Flop (didn't bet)
Seat 9: Edvendor folded before Flop (didn't bet)





PokerStars Hand #148610132641:  Hold'em No Limit ($0.50/$1.00 USD) - 2016/02/11 13:45:17 CET [2016/02/11 7:45:17 ET]
Table 'Stephano V' 9-max Seat #7 is the button
Seat 1: hammerwife ($113.25 in chips) 
Seat 2: matiko09 ($145.88 in chips) 
Seat 3: DUkalisUA ($102.40 in chips) 
Seat 4: Zeeshka ($139.75 in chips) 
Seat 5: n2call ($245.10 in chips) 
Seat 6: Sweden_Pound ($100 in chips) 
Seat 7: Effort92 ($100 in chips) 
Seat 8: oscarleon ($229.13 in chips) 
Seat 9: gabi_igna ($100 in chips) 
oscarleon: posts small blind $0.50
gabi_igna: posts big blind $1
*** HOLE CARDS ***
Dealt to matiko09 [8h 9d]
hammerwife: folds 
matiko09: folds 
DUkalisUA: folds 
Zeeshka: folds 
n2call: folds 
Sweden_Pound: raises $1.50 to $2.50
Effort92: folds 
oscarleon: raises $8.50 to $11
gabi_igna: folds 
Sweden_Pound: folds 
Uncalled bet ($8.50) returned to oscarleon
oscarleon collected $6 from pot
oscarleon: doesn't show hand 
*** SUMMARY ***
Total pot $6 | Rake $0 
Seat 1: hammerwife folded before Flop (didn't bet)
Seat 2: matiko09 folded before Flop (didn't bet)
Seat 3: DUkalisUA folded before Flop (didn't bet)
Seat 4: Zeeshka folded before Flop (didn't bet)
Seat 5: n2call folded before Flop (didn't bet)
Seat 6: Sweden_Pound folded before Flop
Seat 7: Effort92 (button) folded before Flop (didn't bet)
Seat 8: oscarleon (small blind) collected ($6)
Seat 9: gabi_igna (big blind) folded before Flop





PokerStars Hand #148610143075:  Hold'em No Limit (€0.25/€0.50 EUR) - 2016/02/11 13:45:34 CET [2016/02/11 7:45:34 ET]
Table 'Otero II' 9-max Seat #3 is the button
Seat 1: Effort92 (€50 in chips) 
Seat 2: knauf1991 (€21.66 in chips) 
Seat 3: Szevasztopol (€55.49 in chips) 
Seat 4: kram0909 (€28.61 in chips) 
Seat 5: vlad11122007 (€47.94 in chips) 
Seat 6: TonnaMunz (€50 in chips) 
Seat 7: CvMCvMCvM (€61.10 in chips) 
Seat 8: matiko09 (€69.50 in chips) 
Seat 9: Apparat888 (€26.63 in chips) 
kram0909: posts small blind €0.25
vlad11122007: posts big blind €0.50
*** HOLE CARDS ***
Dealt to matiko09 [2h 4c]
TonnaMunz: folds 
CvMCvMCvM: folds 
matiko09: folds 
Apparat888: folds 
Effort92: folds 
knauf1991: calls €0.50
Szevasztopol: raises €2 to €2.50
kram0909: folds 
vlad11122007: folds 
knauf1991: calls €2
*** FLOP *** [Jc 2c 7h]
knauf1991: checks 
Szevasztopol: bets €3
knauf1991: folds 
Uncalled bet (€3) returned to Szevasztopol
Szevasztopol collected €5.49 from pot
Szevasztopol: doesn't show hand 
*** SUMMARY ***
Total pot €5.75 | Rake €0.26 
Board [Jc 2c 7h]
Seat 1: Effort92 folded before Flop (didn't bet)
Seat 2: knauf1991 folded on the Flop
Seat 3: Szevasztopol (button) collected (€5.49)
Seat 4: kram0909 (small blind) folded before Flop
Seat 5: vlad11122007 (big blind) folded before Flop
Seat 6: TonnaMunz folded before Flop (didn't bet)
Seat 7: CvMCvMCvM folded before Flop (didn't bet)
Seat 8: matiko09 folded before Flop (didn't bet)
Seat 9: Apparat888 folded before Flop (didn't bet)





PokerStars Hand #148610143136:  Hold'em No Limit ($0.50/$1.00 USD) - 2016/02/11 13:45:34 CET [2016/02/11 7:45:34 ET]
Table 'Gianfar' 9-max Seat #9 is the button
Seat 1: Vikulja1993 ($102.80 in chips) 
Seat 3: AlKatrone ($169.99 in chips) 
Seat 4: matiko09 ($127.48 in chips) 
Seat 5: hammerwife ($195.99 in chips) 
Seat 6: Sweden_Pound ($100 in chips) 
Seat 7: Rikti ($39.22 in chips) 
Seat 8: Zeeshka ($112.38 in chips) 
Seat 9: oscarleon ($143.12 in chips) 
Vikulja1993: posts small blind $0.50
bilukm: is sitting out 
AlKatrone: posts big blind $1
*** HOLE CARDS ***
Dealt to matiko09 [2h Jd]
matiko09: folds 
hammerwife: folds 
Sweden_Pound: folds 
Rikti: raises $1 to $2
Zeeshka: folds 
oscarleon: folds 
Vikulja1993: folds 
AlKatrone: calls $1
*** FLOP *** [Qd Ad Qh]
hammerwife is disconnected 
AlKatrone: checks 
Rikti: checks 
*** TURN *** [Qd Ad Qh] [4h]
AlKatrone: bets $4
Rikti: folds 
Uncalled bet ($4) returned to AlKatrone
AlKatrone collected $4.30 from pot
AlKatrone: doesn't show hand 
*** SUMMARY ***
Total pot $4.50 | Rake $0.20 
Board [Qd Ad Qh 4h]
Seat 1: Vikulja1993 (small blind) folded before Flop
Seat 3: AlKatrone (big blind) collected ($4.30)
Seat 4: matiko09 folded before Flop (didn't bet)
Seat 5: hammerwife folded before Flop (didn't bet)
Seat 6: Sweden_Pound folded before Flop (didn't bet)
Seat 7: Rikti folded on the Turn
Seat 8: Zeeshka folded before Flop (didn't bet)
Seat 9: oscarleon (button) folded before Flop (didn't bet)





PokerStars Hand #148610148215:  Hold'em No Limit ($0.50/$1.00 USD) - 2016/02/11 13:45:42 CET [2016/02/11 7:45:42 ET]
Table 'Kleopatra II' 9-max Seat #9 is the button
Seat 1: DUkalisUA ($153.92 in chips) 
Seat 2: azvazdam ($35.58 in chips) 
Seat 3: matiko09 ($101.64 in chips) 
Seat 4: TimStone ($123.63 in chips) 
Seat 5: Sweden_Pound ($116.39 in chips) 
Seat 6: hammerwife ($169.25 in chips) 
Seat 7: Zeeshka ($204.42 in chips) 
Seat 8: oscarleon ($100 in chips) 
Seat 9: vrnMike ($109.93 in chips) 
DUkalisUA: posts small blind $0.50
azvazdam: posts big blind $1
*** HOLE CARDS ***
Dealt to matiko09 [Kd 2s]
matiko09: folds 
TimStone: folds 
Sweden_Pound: folds 
hammerwife has timed out while being disconnected
hammerwife: folds 
hammerwife is disconnected 
Zeeshka: folds 
oscarleon: folds 
vrnMike: raises $2 to $3
DUkalisUA: folds 
azvazdam: folds 
Uncalled bet ($2) returned to vrnMike
vrnMike collected $2.50 from pot
*** SUMMARY ***
Total pot $2.50 | Rake $0 
Seat 1: DUkalisUA (small blind) folded before Flop
Seat 2: azvazdam (big blind) folded before Flop
Seat 3: matiko09 folded before Flop (didn't bet)
Seat 4: TimStone folded before Flop (didn't bet)
Seat 5: Sweden_Pound folded before Flop (didn't bet)
Seat 6: hammerwife folded before Flop (didn't bet)
Seat 7: Zeeshka folded before Flop (didn't bet)
Seat 8: oscarleon folded before Flop (didn't bet)
Seat 9: vrnMike (button) collected ($2.50)





PokerStars Hand #148610148745:  Hold'em No Limit ($0.25/$0.50 USD) - 2016/02/11 13:45:43 CET [2016/02/11 7:45:43 ET]
Table 'Sylvania II' 9-max Seat #5 is the button
Seat 1: tw0315 ($201.79 in chips) 
Seat 2: Effort92 ($89.50 in chips) 
Seat 4: matiko09 ($125 in chips) 
Seat 5: vlad11122007 ($56.11 in chips) 
Seat 6: TonnaMunz ($129.13 in chips) 
Seat 7: 2lefthand75 ($46.22 in chips) 
Seat 8: Apparat888 ($50.53 in chips) 
TonnaMunz: posts small blind $0.25
2lefthand75: posts big blind $0.50
CvMCvMCvM: sits out 
tw0315: posts the ante $0.10
Effort92: posts the ante $0.10
matiko09: posts the ante $0.10
vlad11122007: posts the ante $0.10
TonnaMunz: posts the ante $0.10
2lefthand75: posts the ante $0.10
Apparat888: posts the ante $0.10
*** HOLE CARDS ***
Dealt to matiko09 [2s Ts]
Apparat888: folds 
tw0315: folds 
Effort92: folds 
matiko09: folds 
vlad11122007: folds 
TonnaMunz: raises $0.97 to $1.47
2lefthand75: calls $0.97
*** FLOP *** [3h Jh 9c]
TonnaMunz: checks 
2lefthand75: bets $1.74
TonnaMunz: folds 
Uncalled bet ($1.74) returned to 2lefthand75
2lefthand75 collected $3.48 from pot
*** SUMMARY ***
Total pot $3.64 | Rake $0.16 
Board [3h Jh 9c]
Seat 1: tw0315 folded before Flop (didn't bet)
Seat 2: Effort92 folded before Flop (didn't bet)
Seat 4: matiko09 folded before Flop (didn't bet)
Seat 5: vlad11122007 (button) folded before Flop (didn't bet)
Seat 6: TonnaMunz (small blind) folded on the Flop
Seat 7: 2lefthand75 (big blind) collected ($3.48)
Seat 8: Apparat888 folded before Flop (didn't bet)





PokerStars Hand #148610148763:  Hold'em No Limit ($0.25/$0.50 USD) - 2016/02/11 13:45:43 CET [2016/02/11 7:45:43 ET]
Table 'Ambrosia II' 9-max Seat #2 is the button
Seat 1: matiko09 ($55.46 in chips) 
Seat 2: JJJ-K9 ($59.46 in chips) 
Seat 3: make6a ($76.31 in chips) 
Seat 4: huudk2016 ($24.32 in chips) 
Seat 5: RICKA16 ($61.92 in chips) 
Seat 8: Dantist1122 ($50 in chips) 
Seat 9: arctur17 ($55.37 in chips) 
make6a: posts small blind $0.25
huudk2016: posts big blind $0.50
xxxibgdrgn: sits out 
*** HOLE CARDS ***
Dealt to matiko09 [5h As]
RICKA16: folds 
Dantist1122: folds 
arctur17: folds 
matiko09: folds 
JJJ-K9: folds 
make6a: raises $0.55 to $1.05
huudk2016: calls $0.55
*** FLOP *** [Ts 7s 7d]
make6a: checks 
huudk2016: bets $2.50
make6a: folds 
Uncalled bet ($2.50) returned to huudk2016
huudk2016 collected $2.01 from pot
huudk2016: doesn't show hand 
*** SUMMARY ***
Total pot $2.10 | Rake $0.09 
Board [Ts 7s 7d]
Seat 1: matiko09 folded before Flop (didn't bet)
Seat 2: JJJ-K9 (button) folded before Flop (didn't bet)
Seat 3: make6a (small blind) folded on the Flop
Seat 4: huudk2016 (big blind) collected ($2.01)
Seat 5: RICKA16 folded before Flop (didn't bet)
Seat 8: Dantist1122 folded before Flop (didn't bet)
Seat 9: arctur17 folded before Flop (didn't bet)





PokerStars Hand #148610150382:  Hold'em No Limit ($0.50/$1.00 USD) - 2016/02/11 13:45:46 CET [2016/02/11 7:45:46 ET]
Table 'Marion' 9-max Seat #1 is the button
Seat 1: aseban11 ($100 in chips) 
Seat 2: GusenokRUS ($126.42 in chips) 
Seat 3: TimStone ($100 in chips) 
Seat 4: matiko09 ($100 in chips) 
Seat 5: Rikti ($60.25 in chips) 
Seat 6: 19SERGE74 ($94.54 in chips) 
Seat 7: oscarleon ($104.58 in chips) 
Seat 8: Sweden_Pound ($101.50 in chips) 
Seat 9: Zeeshka ($100 in chips) 
GusenokRUS: posts small blind $0.50
TimStone: posts big blind $1
*** HOLE CARDS ***
Dealt to matiko09 [Qc 6d]
matiko09: folds 
Rikti: folds 
19SERGE74: folds 
oscarleon: folds 
Sweden_Pound: folds 
Zeeshka: folds 
aseban11: folds 
GusenokRUS: raises $2 to $3
TimStone: calls $2
*** FLOP *** [2d 6h Qd]
GusenokRUS: bets $4
TimStone: folds 
Uncalled bet ($4) returned to GusenokRUS
GusenokRUS collected $5.73 from pot
GusenokRUS: doesn't show hand 
*** SUMMARY ***
Total pot $6 | Rake $0.27 
Board [2d 6h Qd]
Seat 1: aseban11 (button) folded before Flop (didn't bet)
Seat 2: GusenokRUS (small blind) collected ($5.73)
Seat 3: TimStone (big blind) folded on the Flop
Seat 4: matiko09 folded before Flop (didn't bet)
Seat 5: Rikti folded before Flop (didn't bet)
Seat 6: 19SERGE74 folded before Flop (didn't bet)
Seat 7: oscarleon folded before Flop (didn't bet)
Seat 8: Sweden_Pound folded before Flop (didn't bet)
Seat 9: Zeeshka folded before Flop (didn't bet)





PokerStars Hand #148610160084:  Hold'em No Limit ($0.50/$1.00 USD) - 2016/02/11 13:46:01 CET [2016/02/11 7:46:01 ET]
Table 'Tama' 9-max Seat #5 is the button
Seat 1: aseban11 ($112.81 in chips) 
Seat 2: matiko09 ($100 in chips) 
Seat 3: gabi_igna ($102.73 in chips) 
Seat 4: Cogss ($148.20 in chips) 
Seat 5: Zeeshka ($102.73 in chips) 
Seat 6: vicdroopy ($100 in chips) 
Seat 7: GrishaPE ($48.96 in chips) 
Seat 8: er13to ($100 in chips) 
Seat 9: Edvendor ($68.73 in chips) 
vicdroopy: posts small blind $0.50
GrishaPE: posts big blind $1
*** HOLE CARDS ***
Dealt to matiko09 [5h Kc]
er13to: folds 
Edvendor: calls $1
aseban11: folds 
matiko09: folds 
gabi_igna: folds 
Cogss: raises $1 to $2
Zeeshka: raises $8 to $10
vicdroopy: folds 
GrishaPE: folds 
Edvendor: calls $9
Cogss: calls $8
*** FLOP *** [3s Tc Js]
Edvendor: checks 
Cogss: checks 
Zeeshka: bets $20.15
Edvendor: raises $38.58 to $58.73 and is all-in
Cogss: folds 
Zeeshka: calls $38.58
*** TURN *** [3s Tc Js] [3c]
*** RIVER *** [3s Tc Js 3c] [4d]
*** SHOW DOWN ***
Edvendor: shows [Ad Ah] (two pair, Aces and Threes)
Zeeshka: mucks hand 
Edvendor collected $146.16 from pot
*** SUMMARY ***
Total pot $148.96 | Rake $2.80 
Board [3s Tc Js 3c 4d]
Seat 1: aseban11 folded before Flop (didn't bet)
Seat 2: matiko09 folded before Flop (didn't bet)
Seat 3: gabi_igna folded before Flop (didn't bet)
Seat 4: Cogss folded on the Flop
Seat 5: Zeeshka (button) mucked [Qh Qd]
Seat 6: vicdroopy (small blind) folded before Flop
Seat 7: GrishaPE (big blind) folded before Flop
Seat 8: er13to folded before Flop (didn't bet)
Seat 9: Edvendor showed [Ad Ah] and won ($146.16) with two pair, Aces and Threes





PokerStars Hand #148610163148:  Hold'em No Limit ($0.25/$0.50 USD) - 2016/02/11 13:46:06 CET [2016/02/11 7:46:06 ET]
Table 'Stereoskopia' 9-max Seat #4 is the button
Seat 1: FoRvvArD_go ($50 in chips) 
Seat 2: Dantist1122 ($52.25 in chips) 
Seat 3: fandorin2005 ($50 in chips) 
Seat 4: Anikin44 ($49.96 in chips) 
Seat 5: afrodit71 ($41.63 in chips) 
Seat 6: matiko09 ($51.65 in chips) 
Seat 7: Serhent ($69.82 in chips) 
Seat 9: nastynate075 ($19.35 in chips) 
afrodit71: posts small blind $0.25
matiko09: posts big blind $0.50
WDW3: sits out 
*** HOLE CARDS ***
Dealt to matiko09 [8d 6d]
Serhent: raises $1 to $1.50
nastynate075: calls $1.50
FoRvvArD_go: folds 
Dantist1122: folds 
fandorin2005: folds 
Anikin44: folds 
afrodit71: calls $1.25
matiko09: calls $1
*** FLOP *** [6c Tc Ac]
afrodit71: bets $1.50
matiko09: folds 
Serhent: folds 
nastynate075: calls $1.50
*** TURN *** [6c Tc Ac] [As]
afrodit71: checks 
nastynate075: checks 
*** RIVER *** [6c Tc Ac As] [5s]
afrodit71: bets $3
nastynate075: folds 
Uncalled bet ($3) returned to afrodit71
afrodit71 collected $8.60 from pot
afrodit71: doesn't show hand 
*** SUMMARY ***
Total pot $9 | Rake $0.40 
Board [6c Tc Ac As 5s]
Seat 1: FoRvvArD_go folded before Flop (didn't bet)
Seat 2: Dantist1122 folded before Flop (didn't bet)
Seat 3: fandorin2005 folded before Flop (didn't bet)
Seat 4: Anikin44 (button) folded before Flop (didn't bet)
Seat 5: afrodit71 (small blind) collected ($8.60)
Seat 6: matiko09 (big blind) folded on the Flop
Seat 7: Serhent folded on the Flop
Seat 9: nastynate075 folded on the River





PokerStars Hand #148610166933:  Hold'em No Limit ($0.50/$1.00 USD) - 2016/02/11 13:46:12 CET [2016/02/11 7:46:12 ET]
Table 'Stephano V' 9-max Seat #8 is the button
Seat 1: hammerwife ($113.25 in chips) 
Seat 2: matiko09 ($145.88 in chips) 
Seat 3: DUkalisUA ($102.40 in chips) 
Seat 4: Zeeshka ($139.75 in chips) 
Seat 5: n2call ($245.10 in chips) 
Seat 6: Sweden_Pound ($100 in chips) 
Seat 7: Effort92 ($100 in chips) 
Seat 8: oscarleon ($232.63 in chips) 
Seat 9: gabi_igna ($100 in chips) 
gabi_igna: posts small blind $0.50
hammerwife is disconnected 
hammerwife is connected 
hammerwife: posts big blind $1
*** HOLE CARDS ***
Dealt to matiko09 [2h Jh]
matiko09: folds 
DUkalisUA: raises $2 to $3
Zeeshka: folds 
n2call: folds 
Sweden_Pound: folds 
Effort92: folds 
oscarleon: folds 
gabi_igna: folds 
hammerwife: folds 
Uncalled bet ($2) returned to DUkalisUA
DUkalisUA collected $2.50 from pot
DUkalisUA: doesn't show hand 
*** SUMMARY ***
Total pot $2.50 | Rake $0 
Seat 1: hammerwife (big blind) folded before Flop
Seat 2: matiko09 folded before Flop (didn't bet)
Seat 3: DUkalisUA collected ($2.50)
Seat 4: Zeeshka folded before Flop (didn't bet)
Seat 5: n2call folded before Flop (didn't bet)
Seat 6: Sweden_Pound folded before Flop (didn't bet)
Seat 7: Effort92 folded before Flop (didn't bet)
Seat 8: oscarleon (button) folded before Flop (didn't bet)
Seat 9: gabi_igna (small blind) folded before Flop





PokerStars Hand #148610176531:  Hold'em No Limit (€0.25/€0.50 EUR) - 2016/02/11 13:46:28 CET [2016/02/11 7:46:28 ET]
Table 'Otero II' 9-max Seat #4 is the button
Seat 1: Effort92 (€50 in chips) 
Seat 2: knauf1991 (€19.16 in chips) 
Seat 3: Szevasztopol (€58.48 in chips) 
Seat 4: kram0909 (€28.36 in chips) 
Seat 5: vlad11122007 (€50 in chips) 
Seat 6: TonnaMunz (€50 in chips) 
Seat 7: CvMCvMCvM (€61.10 in chips) 
Seat 8: matiko09 (€69.50 in chips) 
Seat 9: Apparat888 (€26.63 in chips) 
vlad11122007: posts small blind €0.25
TonnaMunz: posts big blind €0.50
*** HOLE CARDS ***
Dealt to matiko09 [As Jh]
CvMCvMCvM: folds 
matiko09: raises €1 to €1.50
Apparat888: folds 
Effort92: folds 
knauf1991: folds 
Szevasztopol: folds 
kram0909: folds 
vlad11122007: folds 
TonnaMunz: folds 
Uncalled bet (€1) returned to matiko09
matiko09 collected €1.25 from pot
matiko09: doesn't show hand 
*** SUMMARY ***
Total pot €1.25 | Rake €0 
Seat 1: Effort92 folded before Flop (didn't bet)
Seat 2: knauf1991 folded before Flop (didn't bet)
Seat 3: Szevasztopol folded before Flop (didn't bet)
Seat 4: kram0909 (button) folded before Flop (didn't bet)
Seat 5: vlad11122007 (small blind) folded before Flop
Seat 6: TonnaMunz (big blind) folded before Flop
Seat 7: CvMCvMCvM folded before Flop (didn't bet)
Seat 8: matiko09 collected (€1.25)
Seat 9: Apparat888 folded before Flop (didn't bet)





PokerStars Hand #148610177499:  Hold'em No Limit ($0.25/$0.50 USD) - 2016/02/11 13:46:30 CET [2016/02/11 7:46:30 ET]
Table 'Ambrosia II' 9-max Seat #3 is the button
Seat 1: matiko09 ($55.46 in chips) 
Seat 2: JJJ-K9 ($59.46 in chips) 
Seat 3: make6a ($75.26 in chips) 
Seat 4: huudk2016 ($25.28 in chips) 
Seat 5: RICKA16 ($61.92 in chips) 
Seat 8: Dantist1122 ($50 in chips) 
Seat 9: arctur17 ($55.37 in chips) 
huudk2016: posts small blind $0.25
RICKA16: posts big blind $0.50
xxxibgdrgn: sits out 
*** HOLE CARDS ***
Dealt to matiko09 [5d Jh]
Dantist1122: folds 
arctur17: folds 
matiko09: folds 
JJJ-K9: folds 
make6a: raises $0.50 to $1
huudk2016: folds 
RICKA16: folds 
Uncalled bet ($0.50) returned to make6a
make6a collected $1.25 from pot
make6a: doesn't show hand 
*** SUMMARY ***
Total pot $1.25 | Rake $0 
Seat 1: matiko09 folded before Flop (didn't bet)
Seat 2: JJJ-K9 folded before Flop (didn't bet)
Seat 3: make6a (button) collected ($1.25)
Seat 4: huudk2016 (small blind) folded before Flop
Seat 5: RICKA16 (big blind) folded before Flop
Seat 8: Dantist1122 folded before Flop (didn't bet)
Seat 9: arctur17 folded before Flop (didn't bet)





PokerStars Hand #148610177959:  Hold'em No Limit ($0.50/$1.00 USD) - 2016/02/11 13:46:30 CET [2016/02/11 7:46:30 ET]
Table 'Marion' 9-max Seat #2 is the button
Seat 1: aseban11 ($100 in chips) 
Seat 2: GusenokRUS ($129.15 in chips) 
Seat 3: TimStone ($100 in chips) 
Seat 4: matiko09 ($100 in chips) 
Seat 5: Rikti ($60.25 in chips) 
Seat 6: 19SERGE74 ($94.54 in chips) 
Seat 7: oscarleon ($104.58 in chips) 
Seat 8: Sweden_Pound ($101.50 in chips) 
Seat 9: Zeeshka ($100 in chips) 
TimStone: posts small blind $0.50
matiko09: posts big blind $1
*** HOLE CARDS ***
Dealt to matiko09 [3c Jd]
Rikti: folds 
19SERGE74: folds 
oscarleon: folds 
Sweden_Pound has timed out
Sweden_Pound: folds 
Zeeshka: folds 
aseban11: raises $1.50 to $2.50
GusenokRUS: folds 
TimStone: folds 
matiko09: folds 
Uncalled bet ($1.50) returned to aseban11
aseban11 collected $2.50 from pot
aseban11: doesn't show hand 
*** SUMMARY ***
Total pot $2.50 | Rake $0 
Seat 1: aseban11 collected ($2.50)
Seat 2: GusenokRUS (button) folded before Flop (didn't bet)
Seat 3: TimStone (small blind) folded before Flop
Seat 4: matiko09 (big blind) folded before Flop
Seat 5: Rikti folded before Flop (didn't bet)
Seat 6: 19SERGE74 folded before Flop (didn't bet)
Seat 7: oscarleon folded before Flop (didn't bet)
Seat 8: Sweden_Pound folded before Flop (didn't bet)
Seat 9: Zeeshka folded before Flop (didn't bet)





PokerStars Hand #148610178609:  Hold'em No Limit ($0.50/$1.00 USD) - 2016/02/11 13:46:31 CET [2016/02/11 7:46:31 ET]
Table 'Kleopatra II' 9-max Seat #1 is the button
Seat 1: DUkalisUA ($153.42 in chips) 
Seat 2: azvazdam ($34.58 in chips) 
Seat 3: matiko09 ($101.64 in chips) 
Seat 4: TimStone ($123.63 in chips) 
Seat 5: Sweden_Pound ($116.39 in chips) 
Seat 7: Zeeshka ($204.42 in chips) 
Seat 8: oscarleon ($100 in chips) 
Seat 9: vrnMike ($111.43 in chips) 
azvazdam: posts small blind $0.50
matiko09: posts big blind $1
*** HOLE CARDS ***
Dealt to matiko09 [Kh 7s]
TimStone: folds 
Sweden_Pound: folds 
Zeeshka: folds 
oscarleon: folds 
vrnMike: folds 
DUkalisUA: raises $1 to $2
azvazdam: folds 
matiko09: calls $1
*** FLOP *** [Ts Kd 5c]
matiko09: checks 
DUkalisUA: checks 
*** TURN *** [Ts Kd 5c] [2s]
matiko09: bets $2.80
DUkalisUA: folds 
Uncalled bet ($2.80) returned to matiko09
matiko09 collected $4.30 from pot
matiko09: doesn't show hand 
*** SUMMARY ***
Total pot $4.50 | Rake $0.20 
Board [Ts Kd 5c 2s]
Seat 1: DUkalisUA (button) folded on the Turn
Seat 2: azvazdam (small blind) folded before Flop
Seat 3: matiko09 (big blind) collected ($4.30)
Seat 4: TimStone folded before Flop (didn't bet)
Seat 5: Sweden_Pound folded before Flop (didn't bet)
Seat 7: Zeeshka folded before Flop (didn't bet)
Seat 8: oscarleon folded before Flop (didn't bet)
Seat 9: vrnMike folded before Flop (didn't bet)





PokerStars Hand #148610181995:  Hold'em No Limit ($0.25/$0.50 USD) - 2016/02/11 13:46:37 CET [2016/02/11 7:46:37 ET]
Table 'Sylvania II' 9-max Seat #6 is the button
Seat 1: tw0315 ($201.69 in chips) 
Seat 2: Effort92 ($89.40 in chips) 
Seat 4: matiko09 ($124.90 in chips) 
Seat 5: vlad11122007 ($56.01 in chips) 
Seat 6: TonnaMunz ($127.56 in chips) 
Seat 7: 2lefthand75 ($48.13 in chips) 
Seat 8: Apparat888 ($50.43 in chips) 
2lefthand75: posts small blind $0.25
Apparat888: posts big blind $0.50
CvMCvMCvM: sits out 
tw0315: posts the ante $0.10
Effort92: posts the ante $0.10
matiko09: posts the ante $0.10
vlad11122007: posts the ante $0.10
TonnaMunz: posts the ante $0.10
2lefthand75: posts the ante $0.10
Apparat888: posts the ante $0.10
*** HOLE CARDS ***
Dealt to matiko09 [Qc Kh]
tw0315: folds 
Effort92: raises $1.50 to $2
matiko09: folds 
vlad11122007: folds 
TonnaMunz: folds 
2lefthand75: folds 
Apparat888: folds 
Uncalled bet ($1.50) returned to Effort92
Effort92 collected $1.95 from pot
Effort92: doesn't show hand 
*** SUMMARY ***
Total pot $1.95 | Rake $0 
Seat 1: tw0315 folded before Flop (didn't bet)
Seat 2: Effort92 collected ($1.95)
Seat 4: matiko09 folded before Flop (didn't bet)
Seat 5: vlad11122007 folded before Flop (didn't bet)
Seat 6: TonnaMunz (button) folded before Flop (didn't bet)
Seat 7: 2lefthand75 (small blind) folded before Flop
Seat 8: Apparat888 (big blind) folded before Flop





PokerStars Hand #148610192868:  Hold'em No Limit ($0.25/$0.50 USD) - 2016/02/11 13:46:55 CET [2016/02/11 7:46:55 ET]
Table 'Ambrosia II' 9-max Seat #4 is the button
Seat 1: matiko09 ($55.46 in chips) 
Seat 2: JJJ-K9 ($59.46 in chips) 
Seat 3: make6a ($76.01 in chips) 
Seat 4: huudk2016 ($25.03 in chips) 
Seat 5: RICKA16 ($61.42 in chips) 
Seat 6: xxxibgdrgn ($54.50 in chips) 
Seat 8: Dantist1122 ($50 in chips) 
Seat 9: arctur17 ($55.37 in chips) 
RICKA16: posts small blind $0.25
xxxibgdrgn: posts big blind $0.50
*** HOLE CARDS ***
Dealt to matiko09 [Kh 6h]
Dantist1122: folds 
arctur17: raises $0.50 to $1
matiko09: folds 
JJJ-K9: folds 
make6a: folds 
huudk2016: folds 
RICKA16: folds 
xxxibgdrgn: folds 
Uncalled bet ($0.50) returned to arctur17
arctur17 collected $1.25 from pot
arctur17: doesn't show hand 
*** SUMMARY ***
Total pot $1.25 | Rake $0 
Seat 1: matiko09 folded before Flop (didn't bet)
Seat 2: JJJ-K9 folded before Flop (didn't bet)
Seat 3: make6a folded before Flop (didn't bet)
Seat 4: huudk2016 (button) folded before Flop (didn't bet)
Seat 5: RICKA16 (small blind) folded before Flop
Seat 6: xxxibgdrgn (big blind) folded before Flop
Seat 8: Dantist1122 folded before Flop (didn't bet)
Seat 9: arctur17 collected ($1.25)





PokerStars Hand #148610196962:  Hold'em No Limit (€0.25/€0.50 EUR) - 2016/02/11 13:47:01 CET [2016/02/11 7:47:01 ET]
Table 'Otero II' 9-max Seat #5 is the button
Seat 1: Effort92 (€50 in chips) 
Seat 2: knauf1991 (€19.16 in chips) 
Seat 3: Szevasztopol (€58.48 in chips) 
Seat 4: kram0909 (€28.36 in chips) 
Seat 5: vlad11122007 (€49.75 in chips) 
Seat 6: TonnaMunz (€50 in chips) 
Seat 7: CvMCvMCvM (€61.10 in chips) 
Seat 8: matiko09 (€70.25 in chips) 
Seat 9: Apparat888 (€26.63 in chips) 
TonnaMunz: posts small blind €0.25
CvMCvMCvM: posts big blind €0.50
*** HOLE CARDS ***
Dealt to matiko09 [3c Kd]
matiko09: folds 
Apparat888: folds 
Effort92: folds 
knauf1991: calls €0.50
Szevasztopol: folds 
kram0909: calls €0.50
vlad11122007: folds 
TonnaMunz: raises €2 to €2.50
CvMCvMCvM: folds 
knauf1991: calls €2
kram0909: folds 
*** FLOP *** [2h As 9s]
TonnaMunz: bets €2.75
knauf1991: folds 
Uncalled bet (€2.75) returned to TonnaMunz
TonnaMunz collected €5.73 from pot
TonnaMunz: doesn't show hand 
*** SUMMARY ***
Total pot €6 | Rake €0.27 
Board [2h As 9s]
Seat 1: Effort92 folded before Flop (didn't bet)
Seat 2: knauf1991 folded on the Flop
Seat 3: Szevasztopol folded before Flop (didn't bet)
Seat 4: kram0909 folded before Flop
Seat 5: vlad11122007 (button) folded before Flop (didn't bet)
Seat 6: TonnaMunz (small blind) collected (€5.73)
Seat 7: CvMCvMCvM (big blind) folded before Flop
Seat 8: matiko09 folded before Flop (didn't bet)
Seat 9: Apparat888 folded before Flop (didn't bet)





PokerStars Hand #148610199650:  Hold'em No Limit ($0.50/$1.00 USD) - 2016/02/11 13:47:06 CET [2016/02/11 7:47:06 ET]
Table 'Gianfar' 9-max Seat #1 is the button
Seat 1: Vikulja1993 ($102.30 in chips) 
Seat 3: AlKatrone ($172.29 in chips) 
Seat 4: matiko09 ($127.48 in chips) 
Seat 5: hammerwife ($195.99 in chips) 
Seat 6: Sweden_Pound ($100 in chips) 
Seat 7: Rikti ($37.22 in chips) 
Seat 8: Zeeshka ($112.38 in chips) 
Seat 9: oscarleon ($143.12 in chips) 
AlKatrone: posts small blind $0.50
matiko09: posts big blind $1
*** HOLE CARDS ***
Dealt to matiko09 [Tc Qh]
hammerwife: folds 
Sweden_Pound: raises $2 to $3
Rikti: folds 
Zeeshka: folds 
oscarleon: folds 
Vikulja1993: folds 
AlKatrone: folds 
matiko09: folds 
Uncalled bet ($2) returned to Sweden_Pound
Sweden_Pound collected $2.50 from pot
Sweden_Pound: doesn't show hand 
*** SUMMARY ***
Total pot $2.50 | Rake $0 
Seat 1: Vikulja1993 (button) folded before Flop (didn't bet)
Seat 3: AlKatrone (small blind) folded before Flop
Seat 4: matiko09 (big blind) folded before Flop
Seat 5: hammerwife folded before Flop (didn't bet)
Seat 6: Sweden_Pound collected ($2.50)
Seat 7: Rikti folded before Flop (didn't bet)
Seat 8: Zeeshka folded before Flop (didn't bet)
Seat 9: oscarleon folded before Flop (didn't bet)





PokerStars Hand #148610207178:  Hold'em No Limit ($0.25/$0.50 USD) - 2016/02/11 13:47:18 CET [2016/02/11 7:47:18 ET]
Table 'Sylvania II' 9-max Seat #7 is the button
Seat 1: tw0315 ($201.59 in chips) 
Seat 2: Effort92 ($90.75 in chips) 
Seat 4: matiko09 ($124.80 in chips) 
Seat 5: vlad11122007 ($55.91 in chips) 
Seat 6: TonnaMunz ($127.46 in chips) 
Seat 7: 2lefthand75 ($47.78 in chips) 
Seat 8: Apparat888 ($49.83 in chips) 
Seat 9: CvMCvMCvM ($50 in chips) 
Apparat888: posts small blind $0.25
CvMCvMCvM: posts big blind $0.50
tw0315: posts the ante $0.10
Effort92: posts the ante $0.10
matiko09: posts the ante $0.10
vlad11122007: posts the ante $0.10
TonnaMunz: posts the ante $0.10
2lefthand75: posts the ante $0.10
Apparat888: posts the ante $0.10
CvMCvMCvM: posts the ante $0.10
*** HOLE CARDS ***
Dealt to matiko09 [Kd 2d]
tw0315: calls $0.50
Effort92: raises $2 to $2.50
matiko09: folds 
vlad11122007: folds 
TonnaMunz: folds 
2lefthand75: folds 
Apparat888: folds 
CvMCvMCvM: folds 
tw0315: folds 
Uncalled bet ($2) returned to Effort92
Effort92 collected $2.55 from pot
Effort92: doesn't show hand 
*** SUMMARY ***
Total pot $2.55 | Rake $0 
Seat 1: tw0315 folded before Flop
Seat 2: Effort92 collected ($2.55)
Seat 4: matiko09 folded before Flop (didn't bet)
Seat 5: vlad11122007 folded before Flop (didn't bet)
Seat 6: TonnaMunz folded before Flop (didn't bet)
Seat 7: 2lefthand75 (button) folded before Flop (didn't bet)
Seat 8: Apparat888 (small blind) folded before Flop
Seat 9: CvMCvMCvM (big blind) folded before Flop





PokerStars Hand #148610212705:  Hold'em No Limit ($0.50/$1.00 USD) - 2016/02/11 13:47:27 CET [2016/02/11 7:47:27 ET]
Table 'Stephano V' 9-max Seat #9 is the button
Seat 1: hammerwife ($112.25 in chips) 
Seat 2: matiko09 ($145.88 in chips) 
Seat 3: DUkalisUA ($103.90 in chips) 
Seat 4: Zeeshka ($139.75 in chips) 
Seat 5: n2call ($245.10 in chips) 
Seat 6: Sweden_Pound ($100 in chips) 
Seat 7: Effort92 ($100 in chips) 
Seat 8: oscarleon ($232.63 in chips) 
Seat 9: gabi_igna ($100 in chips) 
hammerwife: posts small blind $0.50
matiko09: posts big blind $1
*** HOLE CARDS ***
Dealt to matiko09 [Jd 9h]
DUkalisUA: folds 
Zeeshka: folds 
n2call: folds 
Sweden_Pound: folds 
Effort92: raises $2 to $3
oscarleon: folds 
gabi_igna: folds 
oscarleon leaves the table
hammerwife: folds 
matiko09: folds 
Uncalled bet ($2) returned to Effort92
Effort92 collected $2.50 from pot
Effort92: doesn't show hand 
*** SUMMARY ***
Total pot $2.50 | Rake $0 
Seat 1: hammerwife (small blind) folded before Flop
Seat 2: matiko09 (big blind) folded before Flop
Seat 3: DUkalisUA folded before Flop (didn't bet)
Seat 4: Zeeshka folded before Flop (didn't bet)
Seat 5: n2call folded before Flop (didn't bet)
Seat 6: Sweden_Pound folded before Flop (didn't bet)
Seat 7: Effort92 collected ($2.50)
Seat 8: oscarleon folded before Flop (didn't bet)
Seat 9: gabi_igna (button) folded before Flop (didn't bet)





PokerStars Hand #148610213223:  Hold'em No Limit ($0.25/$0.50 USD) - 2016/02/11 13:47:28 CET [2016/02/11 7:47:28 ET]
Table 'Ambrosia II' 9-max Seat #5 is the button
Seat 1: matiko09 ($55.46 in chips) 
Seat 2: JJJ-K9 ($59.46 in chips) 
Seat 3: make6a ($76.01 in chips) 
Seat 4: huudk2016 ($25.03 in chips) 
Seat 5: RICKA16 ($61.17 in chips) 
Seat 6: xxxibgdrgn ($54 in chips) 
Seat 8: Dantist1122 ($50 in chips) 
Seat 9: arctur17 ($56.12 in chips) 
xxxibgdrgn: posts small blind $0.25
Dantist1122: posts big blind $0.50
*** HOLE CARDS ***
Dealt to matiko09 [8s Qh]
arctur17: folds 
matiko09: folds 
JJJ-K9: folds 
make6a: folds 
huudk2016: calls $0.50
RICKA16: folds 
xxxibgdrgn: folds 
Dantist1122: raises $1.50 to $2
huudk2016: calls $1.50
*** FLOP *** [5c 9s Ah]
Dantist1122: bets $3.13
huudk2016: folds 
Uncalled bet ($3.13) returned to Dantist1122
Dantist1122 collected $4.06 from pot
Dantist1122: doesn't show hand 
*** SUMMARY ***
Total pot $4.25 | Rake $0.19 
Board [5c 9s Ah]
Seat 1: matiko09 folded before Flop (didn't bet)
Seat 2: JJJ-K9 folded before Flop (didn't bet)
Seat 3: make6a folded before Flop (didn't bet)
Seat 4: huudk2016 folded on the Flop
Seat 5: RICKA16 (button) folded before Flop (didn't bet)
Seat 6: xxxibgdrgn (small blind) folded before Flop
Seat 8: Dantist1122 (big blind) collected ($4.06)
Seat 9: arctur17 folded before Flop (didn't bet)





PokerStars Hand #148610218278:  Hold'em No Limit ($0.50/$1.00 USD) - 2016/02/11 13:47:36 CET [2016/02/11 7:47:36 ET]
Table 'Kleopatra II' 9-max Seat #2 is the button
Seat 1: DUkalisUA ($151.42 in chips) 
Seat 2: azvazdam ($34.08 in chips) 
Seat 3: matiko09 ($103.94 in chips) 
Seat 4: TimStone ($123.63 in chips) 
Seat 5: Sweden_Pound ($116.39 in chips) 
Seat 6: hammerwife ($169.25 in chips) 
Seat 7: Zeeshka ($204.42 in chips) 
Seat 9: vrnMike ($111.43 in chips) 
matiko09: posts small blind $0.50
TimStone: posts big blind $1
*** HOLE CARDS ***
Dealt to matiko09 [3h Kh]
Sweden_Pound: folds 
hammerwife: folds 
Zeeshka: folds 
vrnMike: folds 
DUkalisUA: folds 
azvazdam: folds 
matiko09: raises $1.50 to $2.50
TimStone: folds 
Uncalled bet ($1.50) returned to matiko09
matiko09 collected $2 from pot
matiko09: doesn't show hand 
*** SUMMARY ***
Total pot $2 | Rake $0 
Seat 1: DUkalisUA folded before Flop (didn't bet)
Seat 2: azvazdam (button) folded before Flop (didn't bet)
Seat 3: matiko09 (small blind) collected ($2)
Seat 4: TimStone (big blind) folded before Flop
Seat 5: Sweden_Pound folded before Flop (didn't bet)
Seat 6: hammerwife folded before Flop (didn't bet)
Seat 7: Zeeshka folded before Flop (didn't bet)
Seat 9: vrnMike folded before Flop (didn't bet)





PokerStars Hand #148610218908:  Hold'em No Limit ($0.50/$1.00 USD) - 2016/02/11 13:47:37 CET [2016/02/11 7:47:37 ET]
Table 'Marion' 9-max Seat #3 is the button
Seat 1: aseban11 ($101.50 in chips) 
Seat 2: GusenokRUS ($129.15 in chips) 
Seat 3: TimStone ($100 in chips) 
Seat 4: matiko09 ($100 in chips) 
Seat 5: Rikti ($60.25 in chips) 
Seat 6: 19SERGE74 ($94.54 in chips) 
Seat 8: Sweden_Pound ($101.50 in chips) 
Seat 9: Zeeshka ($100 in chips) 
matiko09: posts small blind $0.50
Rikti: posts big blind $1
*** HOLE CARDS ***
Dealt to matiko09 [Th Qd]
19SERGE74: calls $1
Sweden_Pound: folds 
Zeeshka: folds 
aseban11: folds 
GusenokRUS: calls $1
TimStone: raises $5 to $6
matiko09: folds 
Rikti: folds 
19SERGE74: folds 
GusenokRUS: folds 
Uncalled bet ($5) returned to TimStone
TimStone collected $4.50 from pot
TimStone: doesn't show hand 
*** SUMMARY ***
Total pot $4.50 | Rake $0 
Seat 1: aseban11 folded before Flop (didn't bet)
Seat 2: GusenokRUS folded before Flop
Seat 3: TimStone (button) collected ($4.50)
Seat 4: matiko09 (small blind) folded before Flop
Seat 5: Rikti (big blind) folded before Flop
Seat 6: 19SERGE74 folded before Flop
Seat 8: Sweden_Pound folded before Flop (didn't bet)
Seat 9: Zeeshka folded before Flop (didn't bet)





PokerStars Hand #148610221540:  Hold'em No Limit ($0.25/$0.50 USD) - 2016/02/11 13:47:41 CET [2016/02/11 7:47:41 ET]
Table 'Stereoskopia' 9-max Seat #5 is the button
Seat 1: FoRvvArD_go ($50 in chips) 
Seat 2: Dantist1122 ($52.25 in chips) 
Seat 3: fandorin2005 ($50 in chips) 
Seat 4: Anikin44 ($49.96 in chips) 
Seat 5: afrodit71 ($47.23 in chips) 
Seat 6: matiko09 ($50.15 in chips) 
Seat 7: Serhent ($68.32 in chips) 
Seat 9: nastynate075 ($16.35 in chips) 
matiko09: posts small blind $0.25
Serhent: posts big blind $0.50
WDW3: sits out 
*** HOLE CARDS ***
Dealt to matiko09 [3c Kc]
nastynate075: folds 
FoRvvArD_go: folds 
Dantist1122: folds 
fandorin2005: folds 
Anikin44: folds 
afrodit71: calls $0.50
matiko09: calls $0.25
Serhent: checks 
*** FLOP *** [3d Qs 6d]
matiko09: checks 
Serhent: checks 
afrodit71: checks 
*** TURN *** [3d Qs 6d] [Jc]
matiko09: checks 
Serhent: checks 
afrodit71: checks 
*** RIVER *** [3d Qs 6d Jc] [8d]
matiko09: checks 
Serhent: checks 
afrodit71: bets $0.50
matiko09: folds 
Serhent: folds 
Uncalled bet ($0.50) returned to afrodit71
afrodit71 collected $1.43 from pot
afrodit71: doesn't show hand 
*** SUMMARY ***
Total pot $1.50 | Rake $0.07 
Board [3d Qs 6d Jc 8d]
Seat 1: FoRvvArD_go folded before Flop (didn't bet)
Seat 2: Dantist1122 folded before Flop (didn't bet)
Seat 3: fandorin2005 folded before Flop (didn't bet)
Seat 4: Anikin44 folded before Flop (didn't bet)
Seat 5: afrodit71 (button) collected ($1.43)
Seat 6: matiko09 (small blind) folded on the River
Seat 7: Serhent (big blind) folded on the River
Seat 9: nastynate075 folded before Flop (didn't bet)





PokerStars Hand #148610223535:  Hold'em No Limit (€0.25/€0.50 EUR) - 2016/02/11 13:47:45 CET [2016/02/11 7:47:45 ET]
Table 'Otero II' 9-max Seat #6 is the button
Seat 1: Effort92 (€50 in chips) 
Seat 2: knauf1991 (€16.66 in chips) 
Seat 3: Szevasztopol (€58.48 in chips) 
Seat 4: kram0909 (€27.86 in chips) 
Seat 5: vlad11122007 (€49.75 in chips) 
Seat 6: TonnaMunz (€53.23 in chips) 
Seat 7: CvMCvMCvM (€60.60 in chips) 
Seat 8: matiko09 (€70.25 in chips) 
Seat 9: Apparat888 (€26.63 in chips) 
CvMCvMCvM: posts small blind €0.25
matiko09: posts big blind €0.50
*** HOLE CARDS ***
Dealt to matiko09 [Ad 9c]
Apparat888: folds 
Effort92: raises €1 to €1.50
knauf1991: calls €1.50
Szevasztopol: folds 
kram0909: folds 
vlad11122007: folds 
TonnaMunz: folds 
CvMCvMCvM: folds 
matiko09: folds 
*** FLOP *** [4c 8c 2h]
Effort92: bets €2.68
knauf1991: folds 
Uncalled bet (€2.68) returned to Effort92
Effort92 collected €3.58 from pot
Effort92: doesn't show hand 
*** SUMMARY ***
Total pot €3.75 | Rake €0.17 
Board [4c 8c 2h]
Seat 1: Effort92 collected (€3.58)
Seat 2: knauf1991 folded on the Flop
Seat 3: Szevasztopol folded before Flop (didn't bet)
Seat 4: kram0909 folded before Flop (didn't bet)
Seat 5: vlad11122007 folded before Flop (didn't bet)
Seat 6: TonnaMunz (button) folded before Flop (didn't bet)
Seat 7: CvMCvMCvM (small blind) folded before Flop
Seat 8: matiko09 (big blind) folded before Flop
Seat 9: Apparat888 folded before Flop (didn't bet)





PokerStars Hand #148610224946:  Hold'em No Limit ($0.50/$1.00 USD) - 2016/02/11 13:47:47 CET [2016/02/11 7:47:47 ET]
Table 'Tama' 9-max Seat #6 is the button
Seat 1: aseban11 ($112.81 in chips) 
Seat 2: matiko09 ($100 in chips) 
Seat 3: gabi_igna ($102.73 in chips) 
Seat 4: Cogss ($138.20 in chips) 
Seat 5: Zeeshka ($100 in chips) 
Seat 6: vicdroopy ($100 in chips) 
Seat 7: GrishaPE ($47.96 in chips) 
Seat 8: er13to ($100 in chips) 
Seat 9: Edvendor ($146.16 in chips) 
GrishaPE: posts small blind $0.50
er13to: posts big blind $1
*** HOLE CARDS ***
Dealt to matiko09 [Ks 4c]
Edvendor: calls $1
aseban11: folds 
matiko09: folds 
gabi_igna: folds 
Cogss: folds 
Zeeshka: folds 
vicdroopy: raises $3 to $4
GrishaPE: folds 
er13to: folds 
Edvendor: calls $3
*** FLOP *** [7d 9s 4s]
Edvendor: checks 
vicdroopy: checks 
*** TURN *** [7d 9s 4s] [2h]
Edvendor: bets $4.53
vicdroopy: calls $4.53
*** RIVER *** [7d 9s 4s 2h] [5s]
Edvendor: bets $13
vicdroopy: calls $13
*** SHOW DOWN ***
Edvendor: shows [2s 2d] (three of a kind, Deuces)
vicdroopy: shows [5c 5d] (three of a kind, Fives)
vicdroopy collected $42.55 from pot
*** SUMMARY ***
Total pot $44.56 | Rake $2.01 
Board [7d 9s 4s 2h 5s]
Seat 1: aseban11 folded before Flop (didn't bet)
Seat 2: matiko09 folded before Flop (didn't bet)
Seat 3: gabi_igna folded before Flop (didn't bet)
Seat 4: Cogss folded before Flop (didn't bet)
Seat 5: Zeeshka folded before Flop (didn't bet)
Seat 6: vicdroopy (button) showed [5c 5d] and won ($42.55) with three of a kind, Fives
Seat 7: GrishaPE (small blind) folded before Flop
Seat 8: er13to (big blind) folded before Flop
Seat 9: Edvendor showed [2s 2d] and lost with three of a kind, Deuces





PokerStars Hand #148610237050:  Hold'em No Limit ($0.50/$1.00 USD) - 2016/02/11 13:48:06 CET [2016/02/11 7:48:06 ET]
Table 'Marion' 9-max Seat #4 is the button
Seat 1: aseban11 ($101.50 in chips) 
Seat 2: GusenokRUS ($128.15 in chips) 
Seat 3: TimStone ($103.50 in chips) 
Seat 4: matiko09 ($100 in chips) 
Seat 5: Rikti ($59.25 in chips) 
Seat 6: 19SERGE74 ($93.54 in chips) 
Seat 8: Sweden_Pound ($101.50 in chips) 
Seat 9: Zeeshka ($100 in chips) 
Rikti: posts small blind $0.50
19SERGE74: posts big blind $1
*** HOLE CARDS ***
Dealt to matiko09 [8s Ad]
oscarleon leaves the table
Sweden_Pound: folds 
Zeeshka: folds 
aseban11: folds 
GusenokRUS: folds 
TimStone: folds 
gabi_igna joins the table at seat #7 
matiko09: raises $1.27 to $2.27
Rikti: folds 
19SERGE74: folds 
Uncalled bet ($1.27) returned to matiko09
matiko09 collected $2.50 from pot
matiko09: doesn't show hand 
*** SUMMARY ***
Total pot $2.50 | Rake $0 
Seat 1: aseban11 folded before Flop (didn't bet)
Seat 2: GusenokRUS folded before Flop (didn't bet)
Seat 3: TimStone folded before Flop (didn't bet)
Seat 4: matiko09 (button) collected ($2.50)
Seat 5: Rikti (small blind) folded before Flop
Seat 6: 19SERGE74 (big blind) folded before Flop
Seat 8: Sweden_Pound folded before Flop (didn't bet)
Seat 9: Zeeshka folded before Flop (didn't bet)





PokerStars Hand #148610238152:  Hold'em No Limit ($0.25/$0.50 USD) - 2016/02/11 13:48:08 CET [2016/02/11 7:48:08 ET]
Table 'Sylvania II' 9-max Seat #8 is the button
Seat 1: tw0315 ($200.99 in chips) 
Seat 2: Effort92 ($92.70 in chips) 
Seat 4: matiko09 ($124.70 in chips) 
Seat 5: vlad11122007 ($55.81 in chips) 
Seat 6: TonnaMunz ($127.36 in chips) 
Seat 7: 2lefthand75 ($47.68 in chips) 
Seat 8: Apparat888 ($49.48 in chips) 
Seat 9: CvMCvMCvM ($50 in chips) 
CvMCvMCvM: posts small blind $0.25
tw0315: posts big blind $0.50
tw0315: posts the ante $0.10
Effort92: posts the ante $0.10
matiko09: posts the ante $0.10
vlad11122007: posts the ante $0.10
TonnaMunz: posts the ante $0.10
2lefthand75: posts the ante $0.10
Apparat888: posts the ante $0.10
CvMCvMCvM: posts the ante $0.10
*** HOLE CARDS ***
Dealt to matiko09 [Qd 4h]
Effort92: folds 
matiko09: folds 
vlad11122007: folds 
TonnaMunz: folds 
2lefthand75: folds 
Apparat888: folds 
CvMCvMCvM: folds 
Uncalled bet ($0.25) returned to tw0315
tw0315 collected $1.30 from pot
*** SUMMARY ***
Total pot $1.30 | Rake $0 
Seat 1: tw0315 (big blind) collected ($1.30)
Seat 2: Effort92 folded before Flop (didn't bet)
Seat 4: matiko09 folded before Flop (didn't bet)
Seat 5: vlad11122007 folded before Flop (didn't bet)
Seat 6: TonnaMunz folded before Flop (didn't bet)
Seat 7: 2lefthand75 folded before Flop (didn't bet)
Seat 8: Apparat888 (button) folded before Flop (didn't bet)
Seat 9: CvMCvMCvM (small blind) folded before Flop





PokerStars Hand #148610237957:  Hold'em No Limit ($0.50/$1.00 USD) - 2016/02/11 13:48:08 CET [2016/02/11 7:48:08 ET]
Table 'Gianfar' 9-max Seat #3 is the button
Seat 1: Vikulja1993 ($102.30 in chips) 
Seat 3: AlKatrone ($171.79 in chips) 
Seat 4: matiko09 ($126.48 in chips) 
Seat 5: hammerwife ($195.99 in chips) 
Seat 6: Sweden_Pound ($101.50 in chips) 
Seat 7: Rikti ($37.22 in chips) 
Seat 8: Zeeshka ($112.38 in chips) 
matiko09: posts small blind $0.50
hammerwife: posts big blind $1
*** HOLE CARDS ***
Dealt to matiko09 [5c 4d]
oscarleon leaves the table
vrnMike joins the table at seat #9 
vrnMike leaves the table
Sweden_Pound: folds 
Sweden_Pound leaves the table
Rikti: folds 
gabi_igna joins the table at seat #6 
Zeeshka: folds 
Vikulja1993: folds 
AlKatrone: folds 
matiko09: folds 
Uncalled bet ($0.50) returned to hammerwife
hammerwife collected $1 from pot
hammerwife: doesn't show hand 
*** SUMMARY ***
Total pot $1 | Rake $0 
Seat 1: Vikulja1993 folded before Flop (didn't bet)
Seat 3: AlKatrone (button) folded before Flop (didn't bet)
Seat 4: matiko09 (small blind) folded before Flop
Seat 5: hammerwife (big blind) collected ($1)
Seat 6: Sweden_Pound folded before Flop (didn't bet)
Seat 7: Rikti folded before Flop (didn't bet)
Seat 8: Zeeshka folded before Flop (didn't bet)





PokerStars Hand #148610238419:  Hold'em No Limit ($0.50/$1.00 USD) - 2016/02/11 13:48:09 CET [2016/02/11 7:48:09 ET]
Table 'Kleopatra II' 9-max Seat #3 is the button
Seat 1: DUkalisUA ($151.42 in chips) 
Seat 2: azvazdam ($34.08 in chips) 
Seat 3: matiko09 ($104.94 in chips) 
Seat 4: TimStone ($122.63 in chips) 
Seat 5: Sweden_Pound ($116.39 in chips) 
Seat 6: hammerwife ($169.25 in chips) 
Seat 7: Zeeshka ($204.42 in chips) 
Seat 9: vrnMike ($111.43 in chips) 
TimStone: posts small blind $0.50
Sweden_Pound: posts big blind $1
*** HOLE CARDS ***
Dealt to matiko09 [3c Qh]
oscarleon leaves the table
hurtNCYDE joins the table at seat #8 
hurtNCYDE leaves the table
gabi_igna joins the table at seat #8 
hammerwife: folds 
Zeeshka: folds 
vrnMike: folds 
DUkalisUA: raises $2 to $3
azvazdam: folds 
matiko09: folds 
TimStone: folds 
Sweden_Pound: folds 
Uncalled bet ($2) returned to DUkalisUA
DUkalisUA collected $2.50 from pot
DUkalisUA: doesn't show hand 
*** SUMMARY ***
Total pot $2.50 | Rake $0 
Seat 1: DUkalisUA collected ($2.50)
Seat 2: azvazdam folded before Flop (didn't bet)
Seat 3: matiko09 (button) folded before Flop (didn't bet)
Seat 4: TimStone (small blind) folded before Flop
Seat 5: Sweden_Pound (big blind) folded before Flop
Seat 6: hammerwife folded before Flop (didn't bet)
Seat 7: Zeeshka folded before Flop (didn't bet)
Seat 9: vrnMike folded before Flop (didn't bet)





PokerStars Hand #148610245236:  Hold'em No Limit (€0.25/€0.50 EUR) - 2016/02/11 13:48:20 CET [2016/02/11 7:48:20 ET]
Table 'Otero II' 9-max Seat #7 is the button
Seat 1: Effort92 (€52.08 in chips) 
Seat 2: knauf1991 (€15.16 in chips) 
Seat 3: Szevasztopol (€58.48 in chips) 
Seat 4: kram0909 (€27.86 in chips) 
Seat 5: vlad11122007 (€49.75 in chips) 
Seat 6: TonnaMunz (€53.23 in chips) 
Seat 7: CvMCvMCvM (€60.35 in chips) 
Seat 8: matiko09 (€69.75 in chips) 
Seat 9: Apparat888 (€26.63 in chips) 
matiko09: posts small blind €0.25
Apparat888: posts big blind €0.50
*** HOLE CARDS ***
Dealt to matiko09 [9d 7d]
Effort92: folds 
knauf1991: raises €1.50 to €2
Szevasztopol: folds 
kram0909: folds 
vlad11122007: folds 
TonnaMunz: folds 
CvMCvMCvM: folds 
matiko09: folds 
Apparat888: folds 
Uncalled bet (€1.50) returned to knauf1991
knauf1991 collected €1.25 from pot
knauf1991: doesn't show hand 
*** SUMMARY ***
Total pot €1.25 | Rake €0 
Seat 1: Effort92 folded before Flop (didn't bet)
Seat 2: knauf1991 collected (€1.25)
Seat 3: Szevasztopol folded before Flop (didn't bet)
Seat 4: kram0909 folded before Flop (didn't bet)
Seat 5: vlad11122007 folded before Flop (didn't bet)
Seat 6: TonnaMunz folded before Flop (didn't bet)
Seat 7: CvMCvMCvM (button) folded before Flop (didn't bet)
Seat 8: matiko09 (small blind) folded before Flop
Seat 9: Apparat888 (big blind) folded before Flop





PokerStars Hand #148610251464:  Hold'em No Limit ($0.50/$1.00 USD) - 2016/02/11 13:48:30 CET [2016/02/11 7:48:30 ET]
Table 'Marion' 9-max Seat #5 is the button
Seat 1: aseban11 ($101.50 in chips) 
Seat 2: GusenokRUS ($128.15 in chips) 
Seat 3: TimStone ($103.50 in chips) 
Seat 4: matiko09 ($101.50 in chips) 
Seat 5: Rikti ($58.75 in chips) 
Seat 6: 19SERGE74 ($92.54 in chips) 
Seat 7: gabi_igna ($100 in chips) 
Seat 8: Sweden_Pound ($101.50 in chips) 
Seat 9: Zeeshka ($100 in chips) 
19SERGE74: posts small blind $0.50
gabi_igna: posts big blind $1
*** HOLE CARDS ***
Dealt to matiko09 [3s 7c]
Sweden_Pound: folds 
Zeeshka: folds 
aseban11: folds 
GusenokRUS: folds 
TimStone: folds 
matiko09: folds 
Rikti: folds 
19SERGE74: calls $0.50
gabi_igna: raises $2 to $3
19SERGE74: calls $2
*** FLOP *** [Kh 5c Jc]
19SERGE74: checks 
gabi_igna: bets $3
19SERGE74: calls $3
*** TURN *** [Kh 5c Jc] [7s]
19SERGE74: checks 
gabi_igna: bets $7
19SERGE74: calls $7
*** RIVER *** [Kh 5c Jc 7s] [Jd]
19SERGE74: checks 
gabi_igna: checks 
*** SHOW DOWN ***
19SERGE74: shows [Kc 3d] (two pair, Kings and Jacks)
gabi_igna: mucks hand 
19SERGE74 collected $24.83 from pot
*** SUMMARY ***
Total pot $26 | Rake $1.17 
Board [Kh 5c Jc 7s Jd]
Seat 1: aseban11 folded before Flop (didn't bet)
Seat 2: GusenokRUS folded before Flop (didn't bet)
Seat 3: TimStone folded before Flop (didn't bet)
Seat 4: matiko09 folded before Flop (didn't bet)
Seat 5: Rikti (button) folded before Flop (didn't bet)
Seat 6: 19SERGE74 (small blind) showed [Kc 3d] and won ($24.83) with two pair, Kings and Jacks
Seat 7: gabi_igna (big blind) mucked [8c Qc]
Seat 8: Sweden_Pound folded before Flop (didn't bet)
Seat 9: Zeeshka folded before Flop (didn't bet)





PokerStars Hand #148610253048:  Hold'em No Limit ($0.50/$1.00 USD) - 2016/02/11 13:48:33 CET [2016/02/11 7:48:33 ET]
Table 'Stephano V' 9-max Seat #1 is the button
Seat 1: hammerwife ($111.75 in chips) 
Seat 2: matiko09 ($144.88 in chips) 
Seat 4: Zeeshka ($139.75 in chips) 
Seat 5: n2call ($245.10 in chips) 
Seat 6: Sweden_Pound ($100 in chips) 
Seat 7: Effort92 ($101.50 in chips) 
Seat 9: gabi_igna ($100 in chips) 
matiko09: posts small blind $0.50
DUkalisUA: is sitting out 
DUkalisUA leaves the table
Zeeshka: posts big blind $1
*** HOLE CARDS ***
Dealt to matiko09 [5s 5d]
er13to joins the table at seat #8 
n2call: folds 
Sweden_Pound: folds 
Effort92: folds 
gabi_igna: folds 
hammerwife: folds 
matiko09: raises $1.50 to $2.50
Zeeshka: calls $1.50
*** FLOP *** [9d Ks 7s]
matiko09: checks 
Zeeshka: checks 
*** TURN *** [9d Ks 7s] [2s]
matiko09: checks 
Zeeshka: bets $3.20
matiko09: folds 
Uncalled bet ($3.20) returned to Zeeshka
Zeeshka collected $4.78 from pot
Zeeshka: doesn't show hand 
*** SUMMARY ***
Total pot $5 | Rake $0.22 
Board [9d Ks 7s 2s]
Seat 1: hammerwife (button) folded before Flop (didn't bet)
Seat 2: matiko09 (small blind) folded on the Turn
Seat 4: Zeeshka (big blind) collected ($4.78)
Seat 5: n2call folded before Flop (didn't bet)
Seat 6: Sweden_Pound folded before Flop (didn't bet)
Seat 7: Effort92 folded before Flop (didn't bet)
Seat 9: gabi_igna folded before Flop (didn't bet)





PokerStars Hand #148610258490:  Hold'em No Limit ($0.25/$0.50 USD) - 2016/02/11 13:48:41 CET [2016/02/11 7:48:41 ET]
Table 'Sylvania II' 9-max Seat #9 is the button
Seat 1: tw0315 ($201.94 in chips) 
Seat 2: Effort92 ($92.60 in chips) 
Seat 4: matiko09 ($124.60 in chips) 
Seat 5: vlad11122007 ($55.71 in chips) 
Seat 6: TonnaMunz ($127.26 in chips) 
Seat 7: 2lefthand75 ($47.58 in chips) 
Seat 8: Apparat888 ($49.38 in chips) 
Seat 9: CvMCvMCvM ($50 in chips) 
tw0315: posts small blind $0.25
Effort92: posts big blind $0.50
tw0315: posts the ante $0.10
Effort92: posts the ante $0.10
matiko09: posts the ante $0.10
vlad11122007: posts the ante $0.10
TonnaMunz: posts the ante $0.10
2lefthand75: posts the ante $0.10
Apparat888: posts the ante $0.10
CvMCvMCvM: posts the ante $0.10
*** HOLE CARDS ***
Dealt to matiko09 [8s 3d]
matiko09: folds 
vlad11122007: folds 
TonnaMunz: folds 
2lefthand75: folds 
Apparat888: folds 
CvMCvMCvM: raises $0.88 to $1.38
tw0315: folds 
Effort92: calls $0.88
*** FLOP *** [5d 5s Ac]
Effort92: checks 
CvMCvMCvM: bets $2.18
Effort92: calls $2.18
*** TURN *** [5d 5s Ac] [2d]
Effort92: checks 
CvMCvMCvM: bets $9.50
Effort92: calls $9.50
*** RIVER *** [5d 5s Ac 2d] [6c]
Effort92: checks 
CvMCvMCvM: bets $36.84 and is all-in
Effort92: folds 
Uncalled bet ($36.84) returned to CvMCvMCvM
CvMCvMCvM collected $25.95 from pot
CvMCvMCvM: doesn't show hand 
*** SUMMARY ***
Total pot $27.17 | Rake $1.22 
Board [5d 5s Ac 2d 6c]
Seat 1: tw0315 (small blind) folded before Flop
Seat 2: Effort92 (big blind) folded on the River
Seat 4: matiko09 folded before Flop (didn't bet)
Seat 5: vlad11122007 folded before Flop (didn't bet)
Seat 6: TonnaMunz folded before Flop (didn't bet)
Seat 7: 2lefthand75 folded before Flop (didn't bet)
Seat 8: Apparat888 folded before Flop (didn't bet)
Seat 9: CvMCvMCvM (button) collected ($25.95)





PokerStars Hand #148610260328:  Hold'em No Limit ($0.25/$0.50 USD) - 2016/02/11 13:48:44 CET [2016/02/11 7:48:44 ET]
Table 'Stereoskopia' 9-max Seat #6 is the button
Seat 1: FoRvvArD_go ($50 in chips) 
Seat 2: Dantist1122 ($52.25 in chips) 
Seat 3: fandorin2005 ($50 in chips) 
Seat 4: Anikin44 ($49.96 in chips) 
Seat 5: afrodit71 ($48.16 in chips) 
Seat 6: matiko09 ($50 in chips) 
Seat 7: Serhent ($67.82 in chips) 
Seat 8: WDW3 ($50 in chips) 
Seat 9: nastynate075 ($16.35 in chips) 
Serhent: posts small blind $0.25
WDW3: posts big blind $0.50
*** HOLE CARDS ***
Dealt to matiko09 [9h 3d]
nastynate075: folds 
FoRvvArD_go: folds 
Dantist1122: folds 
fandorin2005: folds 
Anikin44: raises $0.75 to $1.25
afrodit71: folds 
matiko09: folds 
Serhent: folds 
WDW3: calls $0.75
*** FLOP *** [6h Ks Ac]
WDW3: checks 
Anikin44: checks 
*** TURN *** [6h Ks Ac] [2c]
WDW3: bets $2
Anikin44: calls $2
*** RIVER *** [6h Ks Ac 2c] [6c]
WDW3: bets $5
Anikin44: raises $5 to $10
WDW3 said, "lol 22"
WDW3: folds 
Uncalled bet ($5) returned to Anikin44
Anikin44 collected $16 from pot
Anikin44: doesn't show hand 
*** SUMMARY ***
Total pot $16.75 | Rake $0.75 
Board [6h Ks Ac 2c 6c]
Seat 1: FoRvvArD_go folded before Flop (didn't bet)
Seat 2: Dantist1122 folded before Flop (didn't bet)
Seat 3: fandorin2005 folded before Flop (didn't bet)
Seat 4: Anikin44 collected ($16)
Seat 5: afrodit71 folded before Flop (didn't bet)
Seat 6: matiko09 (button) folded before Flop (didn't bet)
Seat 7: Serhent (small blind) folded before Flop
Seat 8: WDW3 (big blind) folded on the River
Seat 9: nastynate075 folded before Flop (didn't bet)





PokerStars Hand #148610261521:  Hold'em No Limit ($0.25/$0.50 USD) - 2016/02/11 13:48:46 CET [2016/02/11 7:48:46 ET]
Table 'Ambrosia II' 9-max Seat #6 is the button
Seat 1: matiko09 ($55.46 in chips) 
Seat 2: JJJ-K9 ($59.46 in chips) 
Seat 3: make6a ($76.01 in chips) 
Seat 4: huudk2016 ($23.03 in chips) 
Seat 5: RICKA16 ($61.17 in chips) 
Seat 6: xxxibgdrgn ($53.75 in chips) 
Seat 8: Dantist1122 ($52.06 in chips) 
Seat 9: arctur17 ($56.12 in chips) 
Dantist1122: posts small blind $0.25
arctur17: posts big blind $0.50
*** HOLE CARDS ***
Dealt to matiko09 [2s 7d]
matiko09: folds 
JJJ-K9: raises $1 to $1.50
make6a: folds 
huudk2016: folds 
RICKA16: folds 
xxxibgdrgn: folds 
Dantist1122: folds 
arctur17: calls $1
*** FLOP *** [Qs 8d 4h]
arctur17: checks 
JJJ-K9: bets $2.06
arctur17: folds 
Uncalled bet ($2.06) returned to JJJ-K9
JJJ-K9 collected $3.10 from pot
JJJ-K9: doesn't show hand 
*** SUMMARY ***
Total pot $3.25 | Rake $0.15 
Board [Qs 8d 4h]
Seat 1: matiko09 folded before Flop (didn't bet)
Seat 2: JJJ-K9 collected ($3.10)
Seat 3: make6a folded before Flop (didn't bet)
Seat 4: huudk2016 folded before Flop (didn't bet)
Seat 5: RICKA16 folded before Flop (didn't bet)
Seat 6: xxxibgdrgn (button) folded before Flop (didn't bet)
Seat 8: Dantist1122 (small blind) folded before Flop
Seat 9: arctur17 (big blind) folded on the Flop





PokerStars Hand #148610262405:  Hold'em No Limit ($0.50/$1.00 USD) - 2016/02/11 13:48:48 CET [2016/02/11 7:48:48 ET]
Table 'Kleopatra II' 9-max Seat #4 is the button
Seat 1: DUkalisUA ($152.92 in chips) 
Seat 2: azvazdam ($34.08 in chips) 
Seat 3: matiko09 ($104.94 in chips) 
Seat 4: TimStone ($122.13 in chips) 
Seat 5: Sweden_Pound ($115.39 in chips) 
Seat 6: hammerwife ($169.25 in chips) 
Seat 7: Zeeshka ($204.42 in chips) 
Seat 9: vrnMike ($111.43 in chips) 
Sweden_Pound: posts small blind $0.50
hammerwife: posts big blind $1
gabi_igna: sits out 
*** HOLE CARDS ***
Dealt to matiko09 [7c 7s]
Zeeshka: raises $2 to $3
vrnMike: folds 
DUkalisUA: folds 
azvazdam: folds 
matiko09: calls $3
TimStone: folds 
Sweden_Pound: folds 
hammerwife: folds 
*** FLOP *** [4s Qc Ts]
Zeeshka: checks 
matiko09: checks 
*** TURN *** [4s Qc Ts] [3d]
Zeeshka: bets $4.79
matiko09: folds 
Uncalled bet ($4.79) returned to Zeeshka
Zeeshka collected $7.16 from pot
Zeeshka: doesn't show hand 
*** SUMMARY ***
Total pot $7.50 | Rake $0.34 
Board [4s Qc Ts 3d]
Seat 1: DUkalisUA folded before Flop (didn't bet)
Seat 2: azvazdam folded before Flop (didn't bet)
Seat 3: matiko09 folded on the Turn
Seat 4: TimStone (button) folded before Flop (didn't bet)
Seat 5: Sweden_Pound (small blind) folded before Flop
Seat 6: hammerwife (big blind) folded before Flop
Seat 7: Zeeshka collected ($7.16)
Seat 9: vrnMike folded before Flop (didn't bet)





PokerStars Hand #148610263187:  Hold'em No Limit ($0.50/$1.00 USD) - 2016/02/11 13:48:49 CET [2016/02/11 7:48:49 ET]
Table 'Gianfar' 9-max Seat #4 is the button
Seat 1: Vikulja1993 ($102.30 in chips) 
Seat 3: AlKatrone ($171.79 in chips) 
Seat 4: matiko09 ($125.98 in chips) 
Seat 5: hammerwife ($196.49 in chips) 
Seat 6: gabi_igna ($100 in chips) 
Seat 7: Rikti ($37.22 in chips) 
Seat 8: Zeeshka ($112.38 in chips) 
hammerwife: posts small blind $0.50
gabi_igna: posts big blind $1
*** HOLE CARDS ***
Dealt to matiko09 [7h Ah]
Rikti: folds 
Zeeshka: folds 
Vikulja1993: folds 
AlKatrone: raises $1.50 to $2.50
matiko09: folds 
hammerwife: folds 
gabi_igna: calls $1.50
*** FLOP *** [8d 6c 7c]
gabi_igna: checks 
AlKatrone: bets $4.67
er13to joins the table at seat #9 
Vikulja1993 is disconnected 
er13to leaves the table
hurtNCYDE joins the table at seat #9 
hurtNCYDE leaves the table
gabi_igna: folds 
Uncalled bet ($4.67) returned to AlKatrone
AlKatrone collected $5.25 from pot
AlKatrone: doesn't show hand 
*** SUMMARY ***
Total pot $5.50 | Rake $0.25 
Board [8d 6c 7c]
Seat 1: Vikulja1993 folded before Flop (didn't bet)
Seat 3: AlKatrone collected ($5.25)
Seat 4: matiko09 (button) folded before Flop (didn't bet)
Seat 5: hammerwife (small blind) folded before Flop
Seat 6: gabi_igna (big blind) folded on the Flop
Seat 7: Rikti folded before Flop (didn't bet)
Seat 8: Zeeshka folded before Flop (didn't bet)





PokerStars Hand #148610265481:  Hold'em No Limit (€0.25/€0.50 EUR) - 2016/02/11 13:48:53 CET [2016/02/11 7:48:53 ET]
Table 'Otero II' 9-max Seat #8 is the button
Seat 1: Effort92 (€52.08 in chips) 
Seat 2: knauf1991 (€15.91 in chips) 
Seat 3: Szevasztopol (€58.48 in chips) 
Seat 4: kram0909 (€27.86 in chips) 
Seat 5: vlad11122007 (€49.75 in chips) 
Seat 6: TonnaMunz (€53.23 in chips) 
Seat 7: CvMCvMCvM (€60.35 in chips) 
Seat 8: matiko09 (€69.50 in chips) 
Seat 9: Apparat888 (€26.13 in chips) 
Apparat888: posts small blind €0.25
Effort92: posts big blind €0.50
*** HOLE CARDS ***
Dealt to matiko09 [8h 6c]
knauf1991: calls €0.50
Szevasztopol: folds 
kram0909: folds 
vlad11122007: folds 
TonnaMunz: folds 
CvMCvMCvM: folds 
matiko09: folds 
Apparat888: folds 
Effort92: raises €1 to €1.50
knauf1991: calls €1
*** FLOP *** [6s 3s 3h]
Effort92: checks 
knauf1991: checks 
*** TURN *** [6s 3s 3h] [Ac]
Effort92: bets €1.70
knauf1991: raises €1.70 to €3.40
Effort92: folds 
Uncalled bet (€1.70) returned to knauf1991
knauf1991 collected €6.35 from pot
knauf1991: doesn't show hand 
*** SUMMARY ***
Total pot €6.65 | Rake €0.30 
Board [6s 3s 3h Ac]
Seat 1: Effort92 (big blind) folded on the Turn
Seat 2: knauf1991 collected (€6.35)
Seat 3: Szevasztopol folded before Flop (didn't bet)
Seat 4: kram0909 folded before Flop (didn't bet)
Seat 5: vlad11122007 folded before Flop (didn't bet)
Seat 6: TonnaMunz folded before Flop (didn't bet)
Seat 7: CvMCvMCvM folded before Flop (didn't bet)
Seat 8: matiko09 (button) folded before Flop (didn't bet)
Seat 9: Apparat888 (small blind) folded before Flop





PokerStars Hand #148610266403:  Hold'em No Limit ($0.50/$1.00 USD) - 2016/02/11 13:48:54 CET [2016/02/11 7:48:54 ET]
Table 'Tama' 9-max Seat #7 is the button
Seat 1: aseban11 ($112.81 in chips) 
Seat 2: matiko09 ($100 in chips) 
Seat 3: gabi_igna ($102.73 in chips) 
Seat 4: Cogss ($138.20 in chips) 
Seat 5: Zeeshka ($100 in chips) 
Seat 6: vicdroopy ($121.02 in chips) 
Seat 7: GrishaPE ($47.46 in chips) 
Seat 8: er13to ($100 in chips) 
Seat 9: Edvendor ($124.63 in chips) 
er13to: posts small blind $0.50
Edvendor: posts big blind $1
*** HOLE CARDS ***
Dealt to matiko09 [4d 5d]
aseban11: folds 
matiko09: folds 
gabi_igna: raises $2 to $3
Cogss: calls $3
Zeeshka: folds 
vicdroopy: raises $12 to $15
GrishaPE: folds 
er13to: folds 
Edvendor: calls $14
gabi_igna: calls $12
Cogss: calls $12
*** FLOP *** [8c 5h As]
Edvendor: bets $57.78
gabi_igna: folds 
Cogss: folds 
vicdroopy: folds 
Uncalled bet ($57.78) returned to Edvendor
Edvendor collected $57.78 from pot
Edvendor: doesn't show hand 
*** SUMMARY ***
Total pot $60.50 | Rake $2.72 
Board [8c 5h As]
Seat 1: aseban11 folded before Flop (didn't bet)
Seat 2: matiko09 folded before Flop (didn't bet)
Seat 3: gabi_igna folded on the Flop
Seat 4: Cogss folded on the Flop
Seat 5: Zeeshka folded before Flop (didn't bet)
Seat 6: vicdroopy folded on the Flop
Seat 7: GrishaPE (button) folded before Flop (didn't bet)
Seat 8: er13to (small blind) folded before Flop
Seat 9: Edvendor (big blind) collected ($57.78)





PokerStars Hand #148610295838:  Hold'em No Limit ($0.25/$0.50 USD) - 2016/02/11 13:49:42 CET [2016/02/11 7:49:42 ET]
Table 'Ambrosia II' 9-max Seat #8 is the button
Seat 1: matiko09 ($55.46 in chips) 
Seat 2: JJJ-K9 ($61.06 in chips) 
Seat 3: make6a ($76.01 in chips) 
Seat 4: huudk2016 ($23.03 in chips) 
Seat 5: RICKA16 ($61.17 in chips) 
Seat 6: xxxibgdrgn ($53.75 in chips) 
Seat 8: Dantist1122 ($51.81 in chips) 
Seat 9: arctur17 ($54.62 in chips) 
arctur17: posts small blind $0.25
matiko09: posts big blind $0.50
*** HOLE CARDS ***
Dealt to matiko09 [Jc 8c]
JJJ-K9: folds 
make6a: folds 
huudk2016: folds 
RICKA16: folds 
xxxibgdrgn: raises $0.75 to $1.25
Dantist1122: folds 
arctur17: folds 
matiko09: folds 
Uncalled bet ($0.75) returned to xxxibgdrgn
xxxibgdrgn collected $1.25 from pot
xxxibgdrgn: doesn't show hand 
*** SUMMARY ***
Total pot $1.25 | Rake $0 
Seat 1: matiko09 (big blind) folded before Flop
Seat 2: JJJ-K9 folded before Flop (didn't bet)
Seat 3: make6a folded before Flop (didn't bet)
Seat 4: huudk2016 folded before Flop (didn't bet)
Seat 5: RICKA16 folded before Flop (didn't bet)
Seat 6: xxxibgdrgn collected ($1.25)
Seat 8: Dantist1122 (button) folded before Flop (didn't bet)
Seat 9: arctur17 (small blind) folded before Flop





PokerStars Hand #148610299063:  Hold'em No Limit (€0.25/€0.50 EUR) - 2016/02/11 13:49:47 CET [2016/02/11 7:49:47 ET]
Table 'Otero II' 9-max Seat #9 is the button
Seat 1: Effort92 (€50 in chips) 
Seat 2: knauf1991 (€19.06 in chips) 
Seat 3: Szevasztopol (€58.48 in chips) 
Seat 4: kram0909 (€27.86 in chips) 
Seat 5: vlad11122007 (€49.75 in chips) 
Seat 6: TonnaMunz (€53.23 in chips) 
Seat 7: CvMCvMCvM (€60.35 in chips) 
Seat 8: matiko09 (€69.50 in chips) 
Seat 9: Apparat888 (€25.88 in chips) 
Effort92: posts small blind €0.25
knauf1991: posts big blind €0.50
*** HOLE CARDS ***
Dealt to matiko09 [3d 4d]
Szevasztopol: folds 
kram0909: folds 
vlad11122007: folds 
TonnaMunz: folds 
CvMCvMCvM: folds 
matiko09: folds 
Apparat888: raises €1 to €1.50
Effort92: raises €3 to €4.50
knauf1991: folds 
Apparat888: folds 
Uncalled bet (€3) returned to Effort92
Effort92 collected €3.50 from pot
Effort92: doesn't show hand 
*** SUMMARY ***
Total pot €3.50 | Rake €0 
Seat 1: Effort92 (small blind) collected (€3.50)
Seat 2: knauf1991 (big blind) folded before Flop
Seat 3: Szevasztopol folded before Flop (didn't bet)
Seat 4: kram0909 folded before Flop (didn't bet)
Seat 5: vlad11122007 folded before Flop (didn't bet)
Seat 6: TonnaMunz folded before Flop (didn't bet)
Seat 7: CvMCvMCvM folded before Flop (didn't bet)
Seat 8: matiko09 folded before Flop (didn't bet)
Seat 9: Apparat888 (button) folded before Flop





PokerStars Hand #148610299796:  Hold'em No Limit ($0.50/$1.00 USD) - 2016/02/11 13:49:48 CET [2016/02/11 7:49:48 ET]
Table 'Marion' 9-max Seat #6 is the button
Seat 1: aseban11 ($101.50 in chips) 
Seat 2: GusenokRUS ($128.15 in chips) 
Seat 3: TimStone ($103.50 in chips) 
Seat 4: matiko09 ($101.50 in chips) 
Seat 5: Rikti ($58.75 in chips) 
Seat 6: 19SERGE74 ($104.37 in chips) 
Seat 7: gabi_igna ($100 in chips) 
Seat 8: Sweden_Pound ($101.50 in chips) 
Seat 9: Zeeshka ($100 in chips) 
gabi_igna: posts small blind $0.50
Sweden_Pound: posts big blind $1
*** HOLE CARDS ***
Dealt to matiko09 [7d Ah]
Zeeshka: folds 
aseban11 has timed out
aseban11: folds 
GusenokRUS: folds 
TimStone: folds 
matiko09: folds 
Rikti: folds 
19SERGE74: raises $2 to $3
aseban11 leaves the table
gabi_igna: folds 
Sweden_Pound: folds 
Uncalled bet ($2) returned to 19SERGE74
19SERGE74 collected $2.50 from pot
19SERGE74: doesn't show hand 
*** SUMMARY ***
Total pot $2.50 | Rake $0 
Seat 1: aseban11 folded before Flop (didn't bet)
Seat 2: GusenokRUS folded before Flop (didn't bet)
Seat 3: TimStone folded before Flop (didn't bet)
Seat 4: matiko09 folded before Flop (didn't bet)
Seat 5: Rikti folded before Flop (didn't bet)
Seat 6: 19SERGE74 (button) collected ($2.50)
Seat 7: gabi_igna (small blind) folded before Flop
Seat 8: Sweden_Pound (big blind) folded before Flop
Seat 9: Zeeshka folded before Flop (didn't bet)





PokerStars Hand #148610304773:  Hold'em No Limit ($0.50/$1.00 USD) - 2016/02/11 13:49:56 CET [2016/02/11 7:49:56 ET]
Table 'Anneliese III' 9-max Seat #6 is the button
Seat 1: Matilde81 ($103.80 in chips) 
Seat 2: Igor DoUrden ($100.91 in chips) 
Seat 3: Zeeshka ($100 in chips) 
Seat 4: Avtovo ($100 in chips) 
Seat 5: omorfadramou ($103.23 in chips) 
Seat 6: 1GreasyWop ($78.50 in chips) 
Seat 7: aseban11 ($100.50 in chips) 
Seat 9: matiko09 ($100 in chips) 
aseban11: posts small blind $0.50
matiko09: posts big blind $1
*** HOLE CARDS ***
Dealt to matiko09 [3h 9c]
Matilde81: folds 
Igor DoUrden: folds 
Zeeshka: folds 
Avtovo: folds 
omorfadramou: folds 
er13to leaves the table
1GreasyWop: folds 
aseban11: folds 
Uncalled bet ($0.50) returned to matiko09
matiko09 collected $1 from pot
matiko09: doesn't show hand 
*** SUMMARY ***
Total pot $1 | Rake $0 
Seat 1: Matilde81 folded before Flop (didn't bet)
Seat 2: Igor DoUrden folded before Flop (didn't bet)
Seat 3: Zeeshka folded before Flop (didn't bet)
Seat 4: Avtovo folded before Flop (didn't bet)
Seat 5: omorfadramou folded before Flop (didn't bet)
Seat 6: 1GreasyWop (button) folded before Flop (didn't bet)
Seat 7: aseban11 (small blind) folded before Flop
Seat 9: matiko09 (big blind) collected ($1)





PokerStars Hand #148610305184:  Hold'em No Limit ($0.50/$1.00 USD) - 2016/02/11 13:49:57 CET [2016/02/11 7:49:57 ET]
Table 'Kleopatra II' 9-max Seat #5 is the button
Seat 1: DUkalisUA ($152.92 in chips) 
Seat 2: azvazdam ($34.08 in chips) 
Seat 3: matiko09 ($101.94 in chips) 
Seat 4: TimStone ($122.13 in chips) 
Seat 5: Sweden_Pound ($114.89 in chips) 
Seat 6: hammerwife ($168.25 in chips) 
Seat 7: Zeeshka ($208.58 in chips) 
Seat 9: vrnMike ($111.43 in chips) 
hammerwife: posts small blind $0.50
Zeeshka: posts big blind $1
gabi_igna: sits out 
*** HOLE CARDS ***
Dealt to matiko09 [Tc 5c]
vrnMike: raises $2 to $3
DUkalisUA: folds 
azvazdam: folds 
matiko09: folds 
TimStone: folds 
Sweden_Pound: folds 
hammerwife: folds 
Zeeshka: calls $2
*** FLOP *** [Kc 7h 2d]
Zeeshka: checks 
vrnMike: bets $3.50
Zeeshka: folds 
Uncalled bet ($3.50) returned to vrnMike
vrnMike collected $6.21 from pot
*** SUMMARY ***
Total pot $6.50 | Rake $0.29 
Board [Kc 7h 2d]
Seat 1: DUkalisUA folded before Flop (didn't bet)
Seat 2: azvazdam folded before Flop (didn't bet)
Seat 3: matiko09 folded before Flop (didn't bet)
Seat 4: TimStone folded before Flop (didn't bet)
Seat 5: Sweden_Pound (button) folded before Flop (didn't bet)
Seat 6: hammerwife (small blind) folded before Flop
Seat 7: Zeeshka (big blind) folded on the Flop
Seat 9: vrnMike collected ($6.21)





PokerStars Hand #148610307535:  Hold'em No Limit ($0.50/$1.00 USD) - 2016/02/11 13:50:01 CET [2016/02/11 7:50:01 ET]
Table 'Stephano V' 9-max Seat #2 is the button
Seat 1: hammerwife ($111.75 in chips) 
Seat 2: matiko09 ($142.38 in chips) 
Seat 4: Zeeshka ($142.03 in chips) 
Seat 5: n2call ($245.10 in chips) 
Seat 6: Sweden_Pound ($100 in chips) 
Seat 7: Effort92 ($101.50 in chips) 
Seat 9: gabi_igna ($100 in chips) 
Zeeshka: posts small blind $0.50
n2call: posts big blind $1
er13to: sits out 
*** HOLE CARDS ***
Dealt to matiko09 [Kc 6c]
Sweden_Pound: folds 
Effort92: folds 
AlKatrone joins the table at seat #3 
AlKatrone leaves the table
gabi_igna: folds 
hammerwife: raises $1.50 to $2.50
vicdroopy joins the table at seat #3 
vicdroopy leaves the table
hurtNCYDE joins the table at seat #3 
hurtNCYDE leaves the table
matiko09: folds 
Zeeshka: raises $6.50 to $9
n2call: folds 
hammerwife: folds 
Uncalled bet ($6.50) returned to Zeeshka
Zeeshka collected $6 from pot
Zeeshka: doesn't show hand 
*** SUMMARY ***
Total pot $6 | Rake $0 
Seat 1: hammerwife folded before Flop
Seat 2: matiko09 (button) folded before Flop (didn't bet)
Seat 4: Zeeshka (small blind) collected ($6)
Seat 5: n2call (big blind) folded before Flop
Seat 6: Sweden_Pound folded before Flop (didn't bet)
Seat 7: Effort92 folded before Flop (didn't bet)
Seat 9: gabi_igna folded before Flop (didn't bet)





PokerStars Hand #148610316441:  Hold'em No Limit ($0.50/$1.00 USD) - 2016/02/11 13:50:15 CET [2016/02/11 7:50:15 ET]
Table 'Gianfar' 9-max Seat #5 is the button
Seat 1: Vikulja1993 ($102.30 in chips) 
Seat 3: AlKatrone ($174.54 in chips) 
Seat 4: matiko09 ($125.98 in chips) 
Seat 5: hammerwife ($195.99 in chips) 
Seat 6: gabi_igna ($100 in chips) 
Seat 7: Rikti ($37.22 in chips) 
Seat 8: Zeeshka ($112.38 in chips) 
gabi_igna: posts small blind $0.50
Rikti: posts big blind $1
*** HOLE CARDS ***
Dealt to matiko09 [Td Tc]
Zeeshka: raises $2 to $3
Vikulja1993: folds 
AlKatrone: folds 
vicdroopy joins the table at seat #9 
matiko09: calls $3
hammerwife: folds 
gabi_igna: folds 
Rikti: folds 
*** FLOP *** [Ac 2s Jd]
Zeeshka: checks 
matiko09: checks 
*** TURN *** [Ac 2s Jd] [Jh]
Zeeshka: checks 
matiko09: checks 
*** RIVER *** [Ac 2s Jd Jh] [9s]
Zeeshka: checks 
matiko09: checks 
*** SHOW DOWN ***
Zeeshka: shows [Ah Qs] (two pair, Aces and Jacks)
matiko09: mucks hand 
Zeeshka collected $7.16 from pot
*** SUMMARY ***
Total pot $7.50 | Rake $0.34 
Board [Ac 2s Jd Jh 9s]
Seat 1: Vikulja1993 folded before Flop (didn't bet)
Seat 3: AlKatrone folded before Flop (didn't bet)
Seat 4: matiko09 mucked [Td Tc]
Seat 5: hammerwife (button) folded before Flop (didn't bet)
Seat 6: gabi_igna (small blind) folded before Flop
Seat 7: Rikti (big blind) folded before Flop
Seat 8: Zeeshka showed [Ah Qs] and won ($7.16) with two pair, Aces and Jacks





PokerStars Hand #148610322196:  Hold'em No Limit ($0.50/$1.00 USD) - 2016/02/11 13:50:25 CET [2016/02/11 7:50:25 ET]
Table 'Anneliese III' 9-max Seat #7 is the button
Seat 1: Matilde81 ($103.80 in chips) 
Seat 2: Igor DoUrden ($100.91 in chips) 
Seat 3: Zeeshka ($100 in chips) 
Seat 4: Avtovo ($100 in chips) 
Seat 5: omorfadramou ($103.23 in chips) 
Seat 6: 1GreasyWop ($78.50 in chips) 
Seat 7: aseban11 ($100 in chips) 
Seat 9: matiko09 ($100.50 in chips) 
matiko09: posts small blind $0.50
Matilde81: posts big blind $1
*** HOLE CARDS ***
Dealt to matiko09 [5h Jh]
Igor DoUrden: folds 
Zeeshka: folds 
Avtovo: folds 
hurtNCYDE joins the table at seat #8 
omorfadramou: folds 
1GreasyWop: folds 
aseban11: folds 
hurtNCYDE leaves the table
matiko09: raises $2 to $3
Matilde81: folds 
Uncalled bet ($2) returned to matiko09
matiko09 collected $2 from pot
matiko09: doesn't show hand 
*** SUMMARY ***
Total pot $2 | Rake $0 
Seat 1: Matilde81 (big blind) folded before Flop
Seat 2: Igor DoUrden folded before Flop (didn't bet)
Seat 3: Zeeshka folded before Flop (didn't bet)
Seat 4: Avtovo folded before Flop (didn't bet)
Seat 5: omorfadramou folded before Flop (didn't bet)
Seat 6: 1GreasyWop folded before Flop (didn't bet)
Seat 7: aseban11 (button) folded before Flop (didn't bet)
Seat 9: matiko09 (small blind) collected ($2)





PokerStars Hand #148610323249:  Hold'em No Limit (€0.25/€0.50 EUR) - 2016/02/11 13:50:27 CET [2016/02/11 7:50:27 ET]
Table 'Otero II' 9-max Seat #1 is the button
Seat 1: Effort92 (€52 in chips) 
Seat 2: knauf1991 (€18.56 in chips) 
Seat 3: Szevasztopol (€58.48 in chips) 
Seat 4: kram0909 (€27.86 in chips) 
Seat 5: vlad11122007 (€49.75 in chips) 
Seat 6: TonnaMunz (€53.23 in chips) 
Seat 7: CvMCvMCvM (€60.35 in chips) 
Seat 8: matiko09 (€69.50 in chips) 
Seat 9: Apparat888 (€24.38 in chips) 
knauf1991: posts small blind €0.25
Szevasztopol: posts big blind €0.50
*** HOLE CARDS ***
Dealt to matiko09 [7s Ts]
kram0909: folds 
vlad11122007: folds 
TonnaMunz: folds 
CvMCvMCvM: folds 
matiko09: folds 
Apparat888: folds 
Effort92: raises €0.50 to €1
knauf1991: folds 
Szevasztopol: folds 
Uncalled bet (€0.50) returned to Effort92
Effort92 collected €1.25 from pot
Effort92: doesn't show hand 
*** SUMMARY ***
Total pot €1.25 | Rake €0 
Seat 1: Effort92 (button) collected (€1.25)
Seat 2: knauf1991 (small blind) folded before Flop
Seat 3: Szevasztopol (big blind) folded before Flop
Seat 4: kram0909 folded before Flop (didn't bet)
Seat 5: vlad11122007 folded before Flop (didn't bet)
Seat 6: TonnaMunz folded before Flop (didn't bet)
Seat 7: CvMCvMCvM folded before Flop (didn't bet)
Seat 8: matiko09 folded before Flop (didn't bet)
Seat 9: Apparat888 folded before Flop (didn't bet)





PokerStars Hand #148610323848:  Hold'em No Limit ($0.25/$0.50 USD) - 2016/02/11 13:50:28 CET [2016/02/11 7:50:28 ET]
Table 'Ambrosia II' 9-max Seat #9 is the button
Seat 1: matiko09 ($54.96 in chips) 
Seat 2: JJJ-K9 ($61.06 in chips) 
Seat 3: make6a ($76.01 in chips) 
Seat 4: huudk2016 ($23.03 in chips) 
Seat 5: RICKA16 ($61.17 in chips) 
Seat 6: xxxibgdrgn ($54.50 in chips) 
Seat 8: Dantist1122 ($51.81 in chips) 
Seat 9: arctur17 ($54.37 in chips) 
matiko09: posts small blind $0.25
JJJ-K9: posts big blind $0.50
*** HOLE CARDS ***
Dealt to matiko09 [Th Qc]
make6a: folds 
huudk2016: folds 
RICKA16: folds 
xxxibgdrgn: folds 
Dantist1122: raises $0.85 to $1.35
arctur17: folds 
matiko09: folds 
JJJ-K9: folds 
Uncalled bet ($0.85) returned to Dantist1122
Dantist1122 collected $1.25 from pot
Dantist1122: doesn't show hand 
*** SUMMARY ***
Total pot $1.25 | Rake $0 
Seat 1: matiko09 (small blind) folded before Flop
Seat 2: JJJ-K9 (big blind) folded before Flop
Seat 3: make6a folded before Flop (didn't bet)
Seat 4: huudk2016 folded before Flop (didn't bet)
Seat 5: RICKA16 folded before Flop (didn't bet)
Seat 6: xxxibgdrgn folded before Flop (didn't bet)
Seat 8: Dantist1122 collected ($1.25)
Seat 9: arctur17 (button) folded before Flop (didn't bet)





PokerStars Hand #148610328129:  Hold'em No Limit ($0.25/$0.50 USD) - 2016/02/11 13:50:35 CET [2016/02/11 7:50:35 ET]
Table 'Stereoskopia' 9-max Seat #7 is the button
Seat 1: FoRvvArD_go ($50 in chips) 
Seat 2: Dantist1122 ($52.25 in chips) 
Seat 3: fandorin2005 ($50 in chips) 
Seat 4: Anikin44 ($57.71 in chips) 
Seat 5: afrodit71 ($48.16 in chips) 
Seat 6: matiko09 ($50 in chips) 
Seat 7: Serhent ($67.57 in chips) 
Seat 8: WDW3 ($50 in chips) 
Seat 9: nastynate075 ($16.35 in chips) 
WDW3: posts small blind $0.25
nastynate075: posts big blind $0.50
*** HOLE CARDS ***
Dealt to matiko09 [Qh 2c]
FoRvvArD_go: folds 
Dantist1122: folds 
fandorin2005: folds 
Anikin44: raises $0.50 to $1
afrodit71: folds 
matiko09: folds 
Serhent: folds 
WDW3: folds 
nastynate075: folds 
Uncalled bet ($0.50) returned to Anikin44
Anikin44 collected $1.25 from pot
Anikin44: doesn't show hand 
*** SUMMARY ***
Total pot $1.25 | Rake $0 
Seat 1: FoRvvArD_go folded before Flop (didn't bet)
Seat 2: Dantist1122 folded before Flop (didn't bet)
Seat 3: fandorin2005 folded before Flop (didn't bet)
Seat 4: Anikin44 collected ($1.25)
Seat 5: afrodit71 folded before Flop (didn't bet)
Seat 6: matiko09 folded before Flop (didn't bet)
Seat 7: Serhent (button) folded before Flop (didn't bet)
Seat 8: WDW3 (small blind) folded before Flop
Seat 9: nastynate075 (big blind) folded before Flop





PokerStars Hand #148610338433:  Hold'em No Limit ($0.50/$1.00 USD) - 2016/02/11 13:50:51 CET [2016/02/11 7:50:51 ET]
Table 'Marion' 9-max Seat #7 is the button
Seat 2: GusenokRUS ($128.15 in chips) 
Seat 3: TimStone ($103.50 in chips) 
Seat 4: matiko09 ($101.50 in chips) 
Seat 5: Rikti ($58.75 in chips) 
Seat 6: 19SERGE74 ($105.87 in chips) 
Seat 7: gabi_igna ($100 in chips) 
Seat 8: Sweden_Pound ($100.50 in chips) 
Seat 9: Zeeshka ($100 in chips) 
Sweden_Pound: posts small blind $0.50
Zeeshka: posts big blind $1
*** HOLE CARDS ***
Dealt to matiko09 [3h Ad]
GusenokRUS: folds 
TimStone: folds 
matiko09: folds 
Rikti: folds 
19SERGE74: raises $1 to $2
gabi_igna: folds 
Vikulja1993 joins the table at seat #1 
Sweden_Pound: folds 
Vikulja1993 leaves the table
er13to joins the table at seat #1 
Zeeshka: folds 
Uncalled bet ($1) returned to 19SERGE74
19SERGE74 collected $2.50 from pot
19SERGE74: doesn't show hand 
*** SUMMARY ***
Total pot $2.50 | Rake $0 
Seat 2: GusenokRUS folded before Flop (didn't bet)
Seat 3: TimStone folded before Flop (didn't bet)
Seat 4: matiko09 folded before Flop (didn't bet)
Seat 5: Rikti folded before Flop (didn't bet)
Seat 6: 19SERGE74 collected ($2.50)
Seat 7: gabi_igna (button) folded before Flop (didn't bet)
Seat 8: Sweden_Pound (small blind) folded before Flop
Seat 9: Zeeshka (big blind) folded before Flop





PokerStars Hand #148610338730:  Hold'em No Limit ($0.25/$0.50 USD) - 2016/02/11 13:50:52 CET [2016/02/11 7:50:52 ET]
Table 'Ambrosia II' 9-max Seat #1 is the button
Seat 1: matiko09 ($54.71 in chips) 
Seat 2: JJJ-K9 ($60.56 in chips) 
Seat 3: make6a ($76.01 in chips) 
Seat 4: huudk2016 ($23.03 in chips) 
Seat 5: RICKA16 ($61.17 in chips) 
Seat 6: xxxibgdrgn ($54.50 in chips) 
Seat 8: Dantist1122 ($52.56 in chips) 
Seat 9: arctur17 ($54.37 in chips) 
JJJ-K9: posts small blind $0.25
make6a: posts big blind $0.50
*** HOLE CARDS ***
Dealt to matiko09 [Jc 3h]
huudk2016: raises $1 to $1.50
RICKA16: folds 
xxxibgdrgn: folds 
Dantist1122: folds 
arctur17: folds 
matiko09: folds 
JJJ-K9: folds 
make6a: folds 
Uncalled bet ($1) returned to huudk2016
huudk2016 collected $1.25 from pot
huudk2016: doesn't show hand 
*** SUMMARY ***
Total pot $1.25 | Rake $0 
Seat 1: matiko09 (button) folded before Flop (didn't bet)
Seat 2: JJJ-K9 (small blind) folded before Flop
Seat 3: make6a (big blind) folded before Flop
Seat 4: huudk2016 collected ($1.25)
Seat 5: RICKA16 folded before Flop (didn't bet)
Seat 6: xxxibgdrgn folded before Flop (didn't bet)
Seat 8: Dantist1122 folded before Flop (didn't bet)
Seat 9: arctur17 folded before Flop (didn't bet)





PokerStars Hand #148610339222:  Hold'em No Limit (€0.25/€0.50 EUR) - 2016/02/11 13:50:53 CET [2016/02/11 7:50:53 ET]
Table 'Otero II' 9-max Seat #2 is the button
Seat 1: Effort92 (€52.75 in chips) 
Seat 2: knauf1991 (€18.31 in chips) 
Seat 3: Szevasztopol (€57.98 in chips) 
Seat 4: kram0909 (€27.86 in chips) 
Seat 5: vlad11122007 (€49.75 in chips) 
Seat 6: TonnaMunz (€53.23 in chips) 
Seat 7: CvMCvMCvM (€60.35 in chips) 
Seat 8: matiko09 (€69.50 in chips) 
Seat 9: Apparat888 (€24.38 in chips) 
Szevasztopol: posts small blind €0.25
kram0909: posts big blind €0.50
*** HOLE CARDS ***
Dealt to matiko09 [5c 2c]
vlad11122007: folds 
TonnaMunz: folds 
CvMCvMCvM: folds 
matiko09: folds 
Apparat888: raises €1 to €1.50
Effort92: folds 
knauf1991: folds 
Szevasztopol: folds 
kram0909: calls €1
*** FLOP *** [7c 2h 7s]
kram0909: bets €1
Apparat888: calls €1
*** TURN *** [7c 2h 7s] [4c]
kram0909: checks 
Apparat888: checks 
*** RIVER *** [7c 2h 7s 4c] [7d]
kram0909: bets €2
Apparat888: calls €2
*** SHOW DOWN ***
kram0909: shows [6d 8d] (three of a kind, Sevens)
Apparat888: shows [Qs Ah] (three of a kind, Sevens - Ace kicker)
Apparat888 collected €8.83 from pot
*** SUMMARY ***
Total pot €9.25 | Rake €0.42 
Board [7c 2h 7s 4c 7d]
Seat 1: Effort92 folded before Flop (didn't bet)
Seat 2: knauf1991 (button) folded before Flop (didn't bet)
Seat 3: Szevasztopol (small blind) folded before Flop
Seat 4: kram0909 (big blind) showed [6d 8d] and lost with three of a kind, Sevens
Seat 5: vlad11122007 folded before Flop (didn't bet)
Seat 6: TonnaMunz folded before Flop (didn't bet)
Seat 7: CvMCvMCvM folded before Flop (didn't bet)
Seat 8: matiko09 folded before Flop (didn't bet)
Seat 9: Apparat888 showed [Qs Ah] and won (€8.83) with three of a kind, Sevens





PokerStars Hand #148610342279:  Hold'em No Limit ($0.50/$1.00 USD) - 2016/02/11 13:50:58 CET [2016/02/11 7:50:58 ET]
Table 'Kleopatra II' 9-max Seat #6 is the button
Seat 1: DUkalisUA ($152.92 in chips) 
Seat 2: azvazdam ($34.08 in chips) 
Seat 3: matiko09 ($101.94 in chips) 
Seat 4: TimStone ($122.13 in chips) 
Seat 5: Sweden_Pound ($114.89 in chips) 
Seat 6: hammerwife ($167.75 in chips) 
Seat 7: Zeeshka ($205.58 in chips) 
Seat 8: gabi_igna ($100 in chips) 
Seat 9: vrnMike ($114.64 in chips) 
Zeeshka: posts small blind $0.50
gabi_igna: posts big blind $1
*** HOLE CARDS ***
Dealt to matiko09 [2s Ts]
vrnMike: folds 
DUkalisUA: folds 
azvazdam: folds 
matiko09: folds 
TimStone: folds 
Sweden_Pound: raises $1.50 to $2.50
hammerwife: raises $4.50 to $7
Zeeshka: folds 
gabi_igna: folds 
Sweden_Pound: calls $4.50
*** FLOP *** [Kd 3h Ad]
Sweden_Pound: checks 
hammerwife: bets $8
Sweden_Pound: folds 
Uncalled bet ($8) returned to hammerwife
hammerwife collected $14.80 from pot
hammerwife: doesn't show hand 
*** SUMMARY ***
Total pot $15.50 | Rake $0.70 
Board [Kd 3h Ad]
Seat 1: DUkalisUA folded before Flop (didn't bet)
Seat 2: azvazdam folded before Flop (didn't bet)
Seat 3: matiko09 folded before Flop (didn't bet)
Seat 4: TimStone folded before Flop (didn't bet)
Seat 5: Sweden_Pound folded on the Flop
Seat 6: hammerwife (button) collected ($14.80)
Seat 7: Zeeshka (small blind) folded before Flop
Seat 8: gabi_igna (big blind) folded before Flop
Seat 9: vrnMike folded before Flop (didn't bet)





PokerStars Hand #148610353336:  Hold'em No Limit ($0.50/$1.00 USD) - 2016/02/11 13:51:16 CET [2016/02/11 7:51:16 ET]
Table 'Tama' 9-max Seat #8 is the button
Seat 2: matiko09 ($100 in chips) 
Seat 3: gabi_igna ($100 in chips) 
Seat 4: Cogss ($123.20 in chips) 
Seat 5: Zeeshka ($100 in chips) 
Seat 6: vicdroopy ($106.02 in chips) 
Seat 7: GrishaPE ($47.46 in chips) 
Seat 8: er13to ($100 in chips) 
Seat 9: Edvendor ($167.41 in chips) 
Edvendor: posts small blind $0.50
aseban11: is sitting out 
matiko09: posts big blind $1
*** HOLE CARDS ***
Dealt to matiko09 [Jh 3h]
aseban11 leaves the table
hurtNCYDE joins the table at seat #1 
gabi_igna: folds 
Cogss: folds 
Zeeshka: folds 
hurtNCYDE leaves the table
vicdroopy: raises $1 to $2
GrishaPE: folds 
er13to: folds 
hammerwife joins the table at seat #1 
Edvendor: folds 
matiko09: folds 
Uncalled bet ($1) returned to vicdroopy
vicdroopy collected $2.50 from pot
vicdroopy: doesn't show hand 
*** SUMMARY ***
Total pot $2.50 | Rake $0 
Seat 2: matiko09 (big blind) folded before Flop
Seat 3: gabi_igna folded before Flop (didn't bet)
Seat 4: Cogss folded before Flop (didn't bet)
Seat 5: Zeeshka folded before Flop (didn't bet)
Seat 6: vicdroopy collected ($2.50)
Seat 7: GrishaPE folded before Flop (didn't bet)
Seat 8: er13to (button) folded before Flop (didn't bet)
Seat 9: Edvendor (small blind) folded before Flop





PokerStars Hand #148610354373:  Hold'em No Limit ($0.25/$0.50 USD) - 2016/02/11 13:51:17 CET [2016/02/11 7:51:17 ET]
Table 'Ambrosia II' 9-max Seat #2 is the button
Seat 1: matiko09 ($54.71 in chips) 
Seat 2: JJJ-K9 ($60.31 in chips) 
Seat 3: make6a ($75.51 in chips) 
Seat 4: huudk2016 ($23.78 in chips) 
Seat 5: RICKA16 ($61.17 in chips) 
Seat 6: xxxibgdrgn ($54.50 in chips) 
Seat 8: Dantist1122 ($52.56 in chips) 
Seat 9: arctur17 ($54.37 in chips) 
make6a: posts small blind $0.25
huudk2016: posts big blind $0.50
*** HOLE CARDS ***
Dealt to matiko09 [Ah 7h]
RICKA16: raises $1 to $1.50
xxxibgdrgn: folds 
Dantist1122: folds 
arctur17: calls $1.50
matiko09: folds 
JJJ-K9: folds 
make6a: folds 
huudk2016: folds 
*** FLOP *** [Qh Kd 7s]
RICKA16: bets $2
arctur17: calls $2
*** TURN *** [Qh Kd 7s] [9c]
RICKA16: checks 
arctur17: bets $4
RICKA16: folds 
Uncalled bet ($4) returned to arctur17
arctur17 collected $7.40 from pot
arctur17: doesn't show hand 
*** SUMMARY ***
Total pot $7.75 | Rake $0.35 
Board [Qh Kd 7s 9c]
Seat 1: matiko09 folded before Flop (didn't bet)
Seat 2: JJJ-K9 (button) folded before Flop (didn't bet)
Seat 3: make6a (small blind) folded before Flop
Seat 4: huudk2016 (big blind) folded before Flop
Seat 5: RICKA16 folded on the Turn
Seat 6: xxxibgdrgn folded before Flop (didn't bet)
Seat 8: Dantist1122 folded before Flop (didn't bet)
Seat 9: arctur17 collected ($7.40)





PokerStars Hand #148610354625:  Hold'em No Limit ($0.25/$0.50 USD) - 2016/02/11 13:51:18 CET [2016/02/11 7:51:18 ET]
Table 'Stereoskopia' 9-max Seat #8 is the button
Seat 1: FoRvvArD_go ($50 in chips) 
Seat 2: Dantist1122 ($52.25 in chips) 
Seat 3: fandorin2005 ($50 in chips) 
Seat 4: Anikin44 ($58.46 in chips) 
Seat 6: matiko09 ($50 in chips) 
Seat 7: Serhent ($67.57 in chips) 
Seat 8: WDW3 ($50 in chips) 
Seat 9: nastynate075 ($15.85 in chips) 
nastynate075: posts small blind $0.25
FoRvvArD_go: posts big blind $0.50
*** HOLE CARDS ***
Dealt to matiko09 [7s As]
Dantist1122: folds 
fandorin2005: raises $0.75 to $1.25
Anikin44: folds 
matiko09: folds 
Serhent: folds 
WDW3: calls $1.25
nastynate075: calls $1
FoRvvArD_go: folds 
*** FLOP *** [3c 9d 8s]
nastynate075: checks 
fandorin2005: checks 
WDW3: bets $3
nastynate075: calls $3
fandorin2005: folds 
*** TURN *** [3c 9d 8s] [Kh]
nastynate075: checks 
WDW3: checks 
*** RIVER *** [3c 9d 8s Kh] [5c]
nastynate075: checks 
WDW3: checks 
*** SHOW DOWN ***
nastynate075: shows [7c 7h] (a pair of Sevens)
WDW3: mucks hand 
nastynate075 collected $9.79 from pot
*** SUMMARY ***
Total pot $10.25 | Rake $0.46 
Board [3c 9d 8s Kh 5c]
Seat 1: FoRvvArD_go (big blind) folded before Flop
Seat 2: Dantist1122 folded before Flop (didn't bet)
Seat 3: fandorin2005 folded on the Flop
Seat 4: Anikin44 folded before Flop (didn't bet)
Seat 6: matiko09 folded before Flop (didn't bet)
Seat 7: Serhent folded before Flop (didn't bet)
Seat 8: WDW3 (button) mucked [6h 4h]
Seat 9: nastynate075 (small blind) showed [7c 7h] and won ($9.79) with a pair of Sevens





PokerStars Hand #148610355774:  Hold'em No Limit ($0.25/$0.50 USD) - 2016/02/11 13:51:19 CET [2016/02/11 7:51:19 ET]
Table 'Sylvania II' 9-max Seat #1 is the button
Seat 1: tw0315 ($201.59 in chips) 
Seat 2: Effort92 ($79.44 in chips) 
Seat 4: matiko09 ($124.50 in chips) 
Seat 5: vlad11122007 ($55.61 in chips) 
Seat 6: TonnaMunz ($127.16 in chips) 
Seat 7: 2lefthand75 ($47.48 in chips) 
Seat 8: Apparat888 ($49.28 in chips) 
Seat 9: CvMCvMCvM ($62.79 in chips) 
Effort92: posts small blind $0.25
matiko09: posts big blind $0.50
tw0315: posts the ante $0.10
Effort92: posts the ante $0.10
matiko09: posts the ante $0.10
vlad11122007: posts the ante $0.10
TonnaMunz: posts the ante $0.10
2lefthand75: posts the ante $0.10
Apparat888: posts the ante $0.10
CvMCvMCvM: posts the ante $0.10
*** HOLE CARDS ***
Dealt to matiko09 [Jh Td]
vlad11122007: folds 
TonnaMunz: folds 
2lefthand75: folds 
Apparat888: folds 
CvMCvMCvM: folds 
tw0315: calls $0.50
Effort92: calls $0.25
matiko09: raises $2.50 to $3
tw0315: calls $2.50
Effort92: folds 
*** FLOP *** [6h 9h 2h]
matiko09: checks 
tw0315: checks 
*** TURN *** [6h 9h 2h] [5h]
matiko09: checks 
tw0315: checks 
*** RIVER *** [6h 9h 2h 5h] [8s]
matiko09: bets $4.53
tw0315: folds 
Uncalled bet ($4.53) returned to matiko09
matiko09 collected $6.97 from pot
matiko09: doesn't show hand 
*** SUMMARY ***
Total pot $7.30 | Rake $0.33 
Board [6h 9h 2h 5h 8s]
Seat 1: tw0315 (button) folded on the River
Seat 2: Effort92 (small blind) folded before Flop
Seat 4: matiko09 (big blind) collected ($6.97)
Seat 5: vlad11122007 folded before Flop (didn't bet)
Seat 6: TonnaMunz folded before Flop (didn't bet)
Seat 7: 2lefthand75 folded before Flop (didn't bet)
Seat 8: Apparat888 folded before Flop (didn't bet)
Seat 9: CvMCvMCvM folded before Flop (didn't bet)





PokerStars Hand #148610357827:  Hold'em No Limit ($0.50/$1.00 USD) - 2016/02/11 13:51:23 CET [2016/02/11 7:51:23 ET]
Table 'Stephano V' 9-max Seat #4 is the button
Seat 1: hammerwife ($109.25 in chips) 
Seat 2: matiko09 ($142.38 in chips) 
Seat 4: Zeeshka ($145.53 in chips) 
Seat 5: n2call ($244.10 in chips) 
Seat 6: Sweden_Pound ($100 in chips) 
Seat 7: Effort92 ($101.50 in chips) 
Seat 9: gabi_igna ($100 in chips) 
n2call: posts small blind $0.50
Sweden_Pound: posts big blind $1
er13to: sits out 
*** HOLE CARDS ***
Dealt to matiko09 [Ad 6h]
Effort92: raises $2 to $3
Avtovo joins the table at seat #3 
Avtovo leaves the table
gabi_igna: calls $3
hammerwife: folds 
matiko09: folds 
Zeeshka: folds 
n2call: folds 
Sweden_Pound: folds 
*** FLOP *** [9c 6d 3h]
Effort92: checks 
gabi_igna: checks 
*** TURN *** [9c 6d 3h] [Jh]
Effort92: checks 
gabi_igna: bets $4
Effort92: calls $4
*** RIVER *** [9c 6d 3h Jh] [Ah]
Effort92: checks 
gabi_igna: checks 
*** SHOW DOWN ***
Effort92: shows [Ac Js] (two pair, Aces and Jacks)
gabi_igna: mucks hand 
Effort92 collected $14.80 from pot
*** SUMMARY ***
Total pot $15.50 | Rake $0.70 
Board [9c 6d 3h Jh Ah]
Seat 1: hammerwife folded before Flop (didn't bet)
Seat 2: matiko09 folded before Flop (didn't bet)
Seat 4: Zeeshka (button) folded before Flop (didn't bet)
Seat 5: n2call (small blind) folded before Flop
Seat 6: Sweden_Pound (big blind) folded before Flop
Seat 7: Effort92 showed [Ac Js] and won ($14.80) with two pair, Aces and Jacks
Seat 9: gabi_igna mucked [5d 5s]





PokerStars Hand #148610361770:  Hold'em No Limit ($0.50/$1.00 USD) - 2016/02/11 13:51:29 CET [2016/02/11 7:51:29 ET]
Table 'Gianfar' 9-max Seat #6 is the button
Seat 1: Vikulja1993 ($102.30 in chips) 
Seat 3: AlKatrone ($174.54 in chips) 
Seat 4: matiko09 ($122.98 in chips) 
Seat 5: hammerwife ($195.99 in chips) 
Seat 6: gabi_igna ($100 in chips) 
Seat 7: Rikti ($36.22 in chips) 
Seat 8: Zeeshka ($116.54 in chips) 
Rikti: posts small blind $0.50
Zeeshka: posts big blind $1
vicdroopy: sits out 
*** HOLE CARDS ***
Dealt to matiko09 [2d Qh]
Vikulja1993: folds 
AlKatrone: folds 
matiko09: folds 
hammerwife: raises $1.50 to $2.50
gabi_igna: folds 
Rikti: folds 
Zeeshka: calls $1.50
*** FLOP *** [4c 3s 9s]
Zeeshka: checks 
hammerwife: checks 
*** TURN *** [4c 3s 9s] [3c]
Zeeshka: bets $3
hammerwife: calls $3
*** RIVER *** [4c 3s 9s 3c] [7d]
Zeeshka: bets $6.03
hammerwife: folds 
Uncalled bet ($6.03) returned to Zeeshka
Zeeshka collected $10.98 from pot
*** SUMMARY ***
Total pot $11.50 | Rake $0.52 
Board [4c 3s 9s 3c 7d]
Seat 1: Vikulja1993 folded before Flop (didn't bet)
Seat 3: AlKatrone folded before Flop (didn't bet)
Seat 4: matiko09 folded before Flop (didn't bet)
Seat 5: hammerwife folded on the River
Seat 6: gabi_igna (button) folded before Flop (didn't bet)
Seat 7: Rikti (small blind) folded before Flop
Seat 8: Zeeshka (big blind) collected ($10.98)





PokerStars Hand #148610366584:  Hold'em No Limit ($0.50/$1.00 USD) - 2016/02/11 13:51:37 CET [2016/02/11 7:51:37 ET]
Table 'Tama' 9-max Seat #9 is the button
Seat 2: matiko09 ($100 in chips) 
Seat 3: gabi_igna ($100 in chips) 
Seat 4: Cogss ($123.20 in chips) 
Seat 5: Zeeshka ($100 in chips) 
Seat 6: vicdroopy ($107.52 in chips) 
Seat 7: GrishaPE ($47.46 in chips) 
Seat 8: er13to ($100 in chips) 
Seat 9: Edvendor ($166.91 in chips) 
matiko09: posts small blind $0.50
gabi_igna: posts big blind $1
*** HOLE CARDS ***
Dealt to matiko09 [4d 8c]
hammerwife leaves the table
Cogss: calls $1
Zeeshka: folds 
vicdroopy: folds 
b_____a__242 joins the table at seat #1 
GrishaPE: folds 
er13to: folds 
Edvendor: folds 
matiko09: folds 
gabi_igna: raises $4 to $5
Cogss: calls $4
*** FLOP *** [4h 4s Qh]
gabi_igna: bets $5
Cogss: calls $5
*** TURN *** [4h 4s Qh] [Kc]
gabi_igna: bets $12
Cogss: raises $12 to $24
gabi_igna: calls $12
*** RIVER *** [4h 4s Qh Kc] [Qc]
gabi_igna: checks 
Cogss: checks 
*** SHOW DOWN ***
gabi_igna: shows [Ks Ac] (two pair, Kings and Queens)
Cogss: mucks hand 
gabi_igna collected $65.70 from pot
*** SUMMARY ***
Total pot $68.50 | Rake $2.80 
Board [4h 4s Qh Kc Qc]
Seat 2: matiko09 (small blind) folded before Flop
Seat 3: gabi_igna (big blind) showed [Ks Ac] and won ($65.70) with two pair, Kings and Queens
Seat 4: Cogss mucked [Jd Kh]
Seat 5: Zeeshka folded before Flop (didn't bet)
Seat 6: vicdroopy folded before Flop (didn't bet)
Seat 7: GrishaPE folded before Flop (didn't bet)
Seat 8: er13to folded before Flop (didn't bet)
Seat 9: Edvendor (button) folded before Flop (didn't bet)





PokerStars Hand #148610370570:  Hold'em No Limit ($0.50/$1.00 USD) - 2016/02/11 13:51:43 CET [2016/02/11 7:51:43 ET]
Table 'Anneliese III' 9-max Seat #9 is the button
Seat 1: Matilde81 ($102.80 in chips) 
Seat 2: Igor DoUrden ($100.91 in chips) 
Seat 3: Zeeshka ($100 in chips) 
Seat 4: Avtovo ($100 in chips) 
Seat 5: omorfadramou ($103.23 in chips) 
Seat 6: 1GreasyWop ($78.50 in chips) 
Seat 7: aseban11 ($100 in chips) 
Seat 9: matiko09 ($101.50 in chips) 
Matilde81: posts small blind $0.50
Igor DoUrden: posts big blind $1
*** HOLE CARDS ***
Dealt to matiko09 [6d 4s]
Zeeshka: folds 
Avtovo: raises $1.50 to $2.50
AlKatrone joins the table at seat #8 
omorfadramou: folds 
1GreasyWop: folds 
aseban11: folds 
matiko09: folds 
Matilde81: calls $2
Igor DoUrden: folds 
*** FLOP *** [Ad 5h 3h]
Matilde81: checks 
Avtovo: bets $3.50
Matilde81: folds 
Uncalled bet ($3.50) returned to Avtovo
Avtovo collected $5.73 from pot
Avtovo: doesn't show hand 
*** SUMMARY ***
Total pot $6 | Rake $0.27 
Board [Ad 5h 3h]
Seat 1: Matilde81 (small blind) folded on the Flop
Seat 2: Igor DoUrden (big blind) folded before Flop
Seat 3: Zeeshka folded before Flop (didn't bet)
Seat 4: Avtovo collected ($5.73)
Seat 5: omorfadramou folded before Flop (didn't bet)
Seat 6: 1GreasyWop folded before Flop (didn't bet)
Seat 7: aseban11 folded before Flop (didn't bet)
Seat 9: matiko09 (button) folded before Flop (didn't bet)





PokerStars Hand #148610372338:  Hold'em No Limit ($0.50/$1.00 USD) - 2016/02/11 13:51:46 CET [2016/02/11 7:51:46 ET]
Table 'Marion' 9-max Seat #8 is the button
Seat 1: er13to ($109.23 in chips) 
Seat 2: GusenokRUS ($128.15 in chips) 
Seat 3: TimStone ($103.50 in chips) 
Seat 4: matiko09 ($101.50 in chips) 
Seat 5: Rikti ($58.75 in chips) 
Seat 6: 19SERGE74 ($107.37 in chips) 
Seat 7: gabi_igna ($100 in chips) 
Seat 8: Sweden_Pound ($100 in chips) 
Seat 9: Zeeshka ($100 in chips) 
Zeeshka: posts small blind $0.50
er13to: posts big blind $1
*** HOLE CARDS ***
Dealt to matiko09 [6h 4s]
GusenokRUS: folds 
TimStone: folds 
matiko09: folds 
Rikti: folds 
19SERGE74: calls $1
gabi_igna: raises $3 to $4
Sweden_Pound: folds 
Zeeshka: raises $9 to $13
er13to: folds 
19SERGE74: folds 
gabi_igna: folds 
Uncalled bet ($9) returned to Zeeshka
Zeeshka collected $10 from pot
Zeeshka: doesn't show hand 
*** SUMMARY ***
Total pot $10 | Rake $0 
Seat 1: er13to (big blind) folded before Flop
Seat 2: GusenokRUS folded before Flop (didn't bet)
Seat 3: TimStone folded before Flop (didn't bet)
Seat 4: matiko09 folded before Flop (didn't bet)
Seat 5: Rikti folded before Flop (didn't bet)
Seat 6: 19SERGE74 folded before Flop
Seat 7: gabi_igna folded before Flop
Seat 8: Sweden_Pound (button) folded before Flop (didn't bet)
Seat 9: Zeeshka (small blind) collected ($10)





PokerStars Hand #148610381080:  Hold'em No Limit ($0.50/$1.00 USD) - 2016/02/11 13:52:00 CET [2016/02/11 7:52:00 ET]
Table 'Kleopatra II' 9-max Seat #7 is the button
Seat 1: DUkalisUA ($152.92 in chips) 
Seat 2: azvazdam ($34.08 in chips) 
Seat 3: matiko09 ($101.94 in chips) 
Seat 4: TimStone ($122.13 in chips) 
Seat 5: Sweden_Pound ($107.89 in chips) 
Seat 6: hammerwife ($175.55 in chips) 
Seat 7: Zeeshka ($205.08 in chips) 
Seat 8: gabi_igna ($100 in chips) 
Seat 9: vrnMike ($114.64 in chips) 
gabi_igna: posts small blind $0.50
vrnMike: posts big blind $1
*** HOLE CARDS ***
Dealt to matiko09 [3s Ad]
DUkalisUA: folds 
azvazdam: folds 
matiko09: folds 
TimStone: folds 
Sweden_Pound: raises $2 to $3
hammerwife: folds 
DUkalisUA leaves the table
aseban11 joins the table at seat #1 
aseban11 leaves the table
Zeeshka: folds 
gabi_igna: folds 
vrnMike: folds 
Uncalled bet ($2) returned to Sweden_Pound
Sweden_Pound collected $2.50 from pot
Sweden_Pound: doesn't show hand 
*** SUMMARY ***
Total pot $2.50 | Rake $0 
Seat 1: DUkalisUA folded before Flop (didn't bet)
Seat 2: azvazdam folded before Flop (didn't bet)
Seat 3: matiko09 folded before Flop (didn't bet)
Seat 4: TimStone folded before Flop (didn't bet)
Seat 5: Sweden_Pound collected ($2.50)
Seat 6: hammerwife folded before Flop (didn't bet)
Seat 7: Zeeshka (button) folded before Flop (didn't bet)
Seat 8: gabi_igna (small blind) folded before Flop
Seat 9: vrnMike (big blind) folded before Flop





PokerStars Hand #148610381961:  Hold'em No Limit (€0.25/€0.50 EUR) - 2016/02/11 13:52:02 CET [2016/02/11 7:52:02 ET]
Table 'Otero II' 9-max Seat #3 is the button
Seat 1: Effort92 (€52.75 in chips) 
Seat 2: knauf1991 (€18.31 in chips) 
Seat 3: Szevasztopol (€57.73 in chips) 
Seat 4: kram0909 (€23.36 in chips) 
Seat 5: vlad11122007 (€49.75 in chips) 
Seat 6: TonnaMunz (€53.23 in chips) 
Seat 7: CvMCvMCvM (€60.35 in chips) 
Seat 8: matiko09 (€69.50 in chips) 
Seat 9: Apparat888 (€28.71 in chips) 
kram0909: posts small blind €0.25
vlad11122007: posts big blind €0.50
*** HOLE CARDS ***
Dealt to matiko09 [8c Ac]
TonnaMunz: folds 
CvMCvMCvM: folds 
matiko09: folds 
Apparat888: folds 
Effort92: folds 
knauf1991: calls €0.50
Szevasztopol: folds 
kram0909: calls €0.25
vlad11122007: checks 
*** FLOP *** [6d 6s 9h]
kram0909: checks 
vlad11122007: checks 
knauf1991: checks 
*** TURN *** [6d 6s 9h] [Kh]
kram0909: bets €0.50
vlad11122007: calls €0.50
knauf1991: folds 
*** RIVER *** [6d 6s 9h Kh] [9d]
kram0909: bets €0.50
vlad11122007: calls €0.50
*** SHOW DOWN ***
kram0909: shows [2s Kd] (two pair, Kings and Nines)
vlad11122007: shows [5h Kc] (two pair, Kings and Nines)
kram0909 collected €1.67 from pot
vlad11122007 collected €1.67 from pot
*** SUMMARY ***
Total pot €3.50 | Rake €0.16 
Board [6d 6s 9h Kh 9d]
Seat 1: Effort92 folded before Flop (didn't bet)
Seat 2: knauf1991 folded on the Turn
Seat 3: Szevasztopol (button) folded before Flop (didn't bet)
Seat 4: kram0909 (small blind) showed [2s Kd] and won (€1.67) with two pair, Kings and Nines
Seat 5: vlad11122007 (big blind) showed [5h Kc] and won (€1.67) with two pair, Kings and Nines
Seat 6: TonnaMunz folded before Flop (didn't bet)
Seat 7: CvMCvMCvM folded before Flop (didn't bet)
Seat 8: matiko09 folded before Flop (didn't bet)
Seat 9: Apparat888 folded before Flop (didn't bet)





PokerStars Hand #148610393767:  Hold'em No Limit ($0.25/$0.50 USD) - 2016/02/11 13:52:21 CET [2016/02/11 7:52:21 ET]
Table 'Stereoskopia' 9-max Seat #9 is the button
Seat 1: FoRvvArD_go ($50 in chips) 
Seat 2: Dantist1122 ($52.25 in chips) 
Seat 3: fandorin2005 ($50 in chips) 
Seat 4: Anikin44 ($58.46 in chips) 
Seat 6: matiko09 ($50 in chips) 
Seat 7: Serhent ($67.57 in chips) 
Seat 8: WDW3 ($50 in chips) 
Seat 9: nastynate075 ($21.39 in chips) 
FoRvvArD_go: posts small blind $0.25
Dantist1122: posts big blind $0.50
*** HOLE CARDS ***
Dealt to matiko09 [Ac Kh]
fandorin2005: raises $0.75 to $1.25
Anikin44: folds 
matiko09: calls $1.25
Serhent: folds 
WDW3: folds 
nastynate075: folds 
FoRvvArD_go: folds 
Dantist1122: folds 
*** FLOP *** [Jc 9c 2s]
fandorin2005: bets $2
matiko09: calls $2
*** TURN *** [Jc 9c 2s] [4d]
fandorin2005: checks 
matiko09: checks 
*** RIVER *** [Jc 9c 2s 4d] [9d]
fandorin2005: checks 
matiko09: checks 
*** SHOW DOWN ***
fandorin2005: shows [7c 7s] (two pair, Nines and Sevens)
matiko09: mucks hand 
fandorin2005 collected $6.92 from pot
*** SUMMARY ***
Total pot $7.25 | Rake $0.33 
Board [Jc 9c 2s 4d 9d]
Seat 1: FoRvvArD_go (small blind) folded before Flop
Seat 2: Dantist1122 (big blind) folded before Flop
Seat 3: fandorin2005 showed [7c 7s] and won ($6.92) with two pair, Nines and Sevens
Seat 4: Anikin44 folded before Flop (didn't bet)
Seat 6: matiko09 mucked [Ac Kh]
Seat 7: Serhent folded before Flop (didn't bet)
Seat 8: WDW3 folded before Flop (didn't bet)
Seat 9: nastynate075 (button) folded before Flop (didn't bet)





PokerStars Hand #148610394716:  Hold'em No Limit ($0.25/$0.50 USD) - 2016/02/11 13:52:23 CET [2016/02/11 7:52:23 ET]
Table 'Ambrosia II' 9-max Seat #3 is the button
Seat 1: matiko09 ($54.71 in chips) 
Seat 2: JJJ-K9 ($60.31 in chips) 
Seat 3: make6a ($75.26 in chips) 
Seat 4: huudk2016 ($23.28 in chips) 
Seat 5: RICKA16 ($57.67 in chips) 
Seat 6: xxxibgdrgn ($54.50 in chips) 
Seat 8: Dantist1122 ($52.56 in chips) 
Seat 9: arctur17 ($58.27 in chips) 
huudk2016: posts small blind $0.25
RICKA16: posts big blind $0.50
*** HOLE CARDS ***
Dealt to matiko09 [Ad Jc]
xxxibgdrgn: folds 
Dantist1122: raises $1 to $1.50
arctur17: calls $1.50
matiko09: raises $4 to $5.50
JJJ-K9: folds 
make6a: folds 
huudk2016: folds 
RICKA16: folds 
Dantist1122: folds 
arctur17: folds 
Uncalled bet ($4) returned to matiko09
matiko09 collected $5.25 from pot
matiko09: doesn't show hand 
*** SUMMARY ***
Total pot $5.25 | Rake $0 
Seat 1: matiko09 collected ($5.25)
Seat 2: JJJ-K9 folded before Flop (didn't bet)
Seat 3: make6a (button) folded before Flop (didn't bet)
Seat 4: huudk2016 (small blind) folded before Flop
Seat 5: RICKA16 (big blind) folded before Flop
Seat 6: xxxibgdrgn folded before Flop (didn't bet)
Seat 8: Dantist1122 folded before Flop
Seat 9: arctur17 folded before Flop





PokerStars Hand #148610399689:  Hold'em No Limit ($0.50/$1.00 USD) - 2016/02/11 13:52:31 CET [2016/02/11 7:52:31 ET]
Table 'Tama' 9-max Seat #2 is the button
Seat 2: matiko09 ($100 in chips) 
Seat 3: gabi_igna ($131.70 in chips) 
Seat 4: Cogss ($89.20 in chips) 
Seat 5: Zeeshka ($100 in chips) 
Seat 6: vicdroopy ($107.52 in chips) 
Seat 7: GrishaPE ($47.46 in chips) 
Seat 8: er13to ($100 in chips) 
Seat 9: Edvendor ($166.91 in chips) 
gabi_igna: posts small blind $0.50
Cogss: posts big blind $1
b_____a__242: sits out 
*** HOLE CARDS ***
Dealt to matiko09 [2c 8s]
Zeeshka: folds 
vicdroopy: folds 
GrishaPE: calls $1
er13to: folds 
Edvendor: calls $1
matiko09: folds 
gabi_igna: calls $0.50
Cogss: checks 
*** FLOP *** [7c 4d Kd]
gabi_igna: checks 
Cogss: checks 
GrishaPE: checks 
Edvendor: bets $3
gabi_igna: folds 
Cogss: folds 
GrishaPE: folds 
Uncalled bet ($3) returned to Edvendor
Edvendor collected $3.82 from pot
Edvendor: doesn't show hand 
*** SUMMARY ***
Total pot $4 | Rake $0.18 
Board [7c 4d Kd]
Seat 2: matiko09 (button) folded before Flop (didn't bet)
Seat 3: gabi_igna (small blind) folded on the Flop
Seat 4: Cogss (big blind) folded on the Flop
Seat 5: Zeeshka folded before Flop (didn't bet)
Seat 6: vicdroopy folded before Flop (didn't bet)
Seat 7: GrishaPE folded on the Flop
Seat 8: er13to folded before Flop (didn't bet)
Seat 9: Edvendor collected ($3.82)





PokerStars Hand #148610402712:  Hold'em No Limit ($0.50/$1.00 USD) - 2016/02/11 13:52:35 CET [2016/02/11 7:52:35 ET]
Table 'Marion' 9-max Seat #9 is the button
Seat 1: er13to ($108.23 in chips) 
Seat 2: GusenokRUS ($128.15 in chips) 
Seat 3: TimStone ($103.50 in chips) 
Seat 4: matiko09 ($101.50 in chips) 
Seat 5: Rikti ($58.75 in chips) 
Seat 6: 19SERGE74 ($106.37 in chips) 
Seat 7: gabi_igna ($100 in chips) 
Seat 8: Sweden_Pound ($100 in chips) 
Seat 9: Zeeshka ($106 in chips) 
er13to: posts small blind $0.50
GusenokRUS: posts big blind $1
*** HOLE CARDS ***
Dealt to matiko09 [8d Jd]
TimStone: folds 
matiko09: folds 
Rikti: folds 
19SERGE74: raises $2 to $3
gabi_igna: folds 
Sweden_Pound: folds 
Zeeshka: folds 
er13to: folds 
GusenokRUS: calls $2
*** FLOP *** [6d Qc 4d]
GusenokRUS: checks 
19SERGE74: bets $3.10
GusenokRUS: calls $3.10
*** TURN *** [6d Qc 4d] [9h]
GusenokRUS: checks 
19SERGE74: checks 
*** RIVER *** [6d Qc 4d 9h] [9d]
GusenokRUS: bets $19
19SERGE74: folds 
Uncalled bet ($19) returned to GusenokRUS
GusenokRUS collected $12.13 from pot
GusenokRUS: doesn't show hand 
*** SUMMARY ***
Total pot $12.70 | Rake $0.57 
Board [6d Qc 4d 9h 9d]
Seat 1: er13to (small blind) folded before Flop
Seat 2: GusenokRUS (big blind) collected ($12.13)
Seat 3: TimStone folded before Flop (didn't bet)
Seat 4: matiko09 folded before Flop (didn't bet)
Seat 5: Rikti folded before Flop (didn't bet)
Seat 6: 19SERGE74 folded on the River
Seat 7: gabi_igna folded before Flop (didn't bet)
Seat 8: Sweden_Pound folded before Flop (didn't bet)
Seat 9: Zeeshka (button) folded before Flop (didn't bet)





PokerStars Hand #148610406084:  Hold'em No Limit ($0.50/$1.00 USD) - 2016/02/11 13:52:41 CET [2016/02/11 7:52:41 ET]
Table 'Gianfar' 9-max Seat #7 is the button
Seat 1: Vikulja1993 ($102.30 in chips) 
Seat 3: AlKatrone ($174.54 in chips) 
Seat 4: matiko09 ($122.98 in chips) 
Seat 5: hammerwife ($190.49 in chips) 
Seat 6: gabi_igna ($100 in chips) 
Seat 7: Rikti ($35.72 in chips) 
Seat 8: Zeeshka ($122.02 in chips) 
Seat 9: vicdroopy ($100 in chips) 
Zeeshka: posts small blind $0.50
vicdroopy: posts big blind $1
*** HOLE CARDS ***
Dealt to matiko09 [2c Kd]
Vikulja1993: folds 
AlKatrone: raises $2 to $3
matiko09: folds 
hammerwife: folds 
gabi_igna: folds 
Rikti: folds 
Zeeshka: folds 
vicdroopy: folds 
Uncalled bet ($2) returned to AlKatrone
AlKatrone collected $2.50 from pot
AlKatrone: doesn't show hand 
*** SUMMARY ***
Total pot $2.50 | Rake $0 
Seat 1: Vikulja1993 folded before Flop (didn't bet)
Seat 3: AlKatrone collected ($2.50)
Seat 4: matiko09 folded before Flop (didn't bet)
Seat 5: hammerwife folded before Flop (didn't bet)
Seat 6: gabi_igna folded before Flop (didn't bet)
Seat 7: Rikti (button) folded before Flop (didn't bet)
Seat 8: Zeeshka (small blind) folded before Flop
Seat 9: vicdroopy (big blind) folded before Flop





PokerStars Hand #148610407039:  Hold'em No Limit ($0.25/$0.50 USD) - 2016/02/11 13:52:42 CET [2016/02/11 7:52:42 ET]
Table 'Sylvania II' 9-max Seat #2 is the button
Seat 1: tw0315 ($198.49 in chips) 
Seat 2: Effort92 ($78.84 in chips) 
Seat 4: matiko09 ($128.37 in chips) 
Seat 5: vlad11122007 ($55.51 in chips) 
Seat 6: TonnaMunz ($127.06 in chips) 
Seat 7: 2lefthand75 ($47.38 in chips) 
Seat 8: Apparat888 ($49.18 in chips) 
Seat 9: CvMCvMCvM ($62.69 in chips) 
ruyingren will be allowed to play after the button
matiko09: posts small blind $0.25
vlad11122007: posts big blind $0.50
tw0315: posts the ante $0.10
Effort92: posts the ante $0.10
matiko09: posts the ante $0.10
vlad11122007: posts the ante $0.10
TonnaMunz: posts the ante $0.10
2lefthand75: posts the ante $0.10
Apparat888: posts the ante $0.10
CvMCvMCvM: posts the ante $0.10
*** HOLE CARDS ***
Dealt to matiko09 [8s 6s]
ruyingren is disconnected 
TonnaMunz: folds 
2lefthand75: calls $0.50
Apparat888: folds 
CvMCvMCvM: folds 
tw0315: calls $0.50
Effort92: calls $0.50
matiko09: calls $0.25
vlad11122007: checks 
*** FLOP *** [4d 7h Ad]
matiko09: checks 
vlad11122007: checks 
2lefthand75: checks 
tw0315: checks 
Effort92: bets $2
matiko09: folds 
vlad11122007: folds 
2lefthand75: calls $2
tw0315: calls $2
*** TURN *** [4d 7h Ad] [Qc]
2lefthand75: checks 
tw0315: checks 
Effort92: bets $6
2lefthand75: folds 
tw0315: folds 
Uncalled bet ($6) returned to Effort92
Effort92 collected $8.88 from pot
Effort92: doesn't show hand 
*** SUMMARY ***
Total pot $9.30 | Rake $0.42 
Board [4d 7h Ad Qc]
Seat 1: tw0315 folded on the Turn
Seat 2: Effort92 (button) collected ($8.88)
Seat 4: matiko09 (small blind) folded on the Flop
Seat 5: vlad11122007 (big blind) folded on the Flop
Seat 6: TonnaMunz folded before Flop (didn't bet)
Seat 7: 2lefthand75 folded on the Turn
Seat 8: Apparat888 folded before Flop (didn't bet)
Seat 9: CvMCvMCvM folded before Flop (didn't bet)





PokerStars Hand #148610407885:  Hold'em No Limit ($0.50/$1.00 USD) - 2016/02/11 13:52:44 CET [2016/02/11 7:52:44 ET]
Table 'Kleopatra II' 9-max Seat #8 is the button
Seat 2: azvazdam ($34.08 in chips) 
Seat 3: matiko09 ($101.94 in chips) 
Seat 4: TimStone ($122.13 in chips) 
Seat 5: Sweden_Pound ($109.39 in chips) 
Seat 6: hammerwife ($175.55 in chips) 
Seat 7: Zeeshka ($205.08 in chips) 
Seat 8: gabi_igna ($100 in chips) 
Seat 9: vrnMike ($113.64 in chips) 
vrnMike: posts small blind $0.50
azvazdam: posts big blind $1
*** HOLE CARDS ***
Dealt to matiko09 [Kc 4h]
matiko09: folds 
TimStone: folds 
Vikulja1993 joins the table at seat #1 
Sweden_Pound: folds 
hammerwife: raises $1.50 to $2.50
Zeeshka: folds 
gabi_igna: calls $2.50
vrnMike: folds 
azvazdam: calls $1.50
*** FLOP *** [4d Ks 3h]
azvazdam: checks 
hammerwife: checks 
gabi_igna: bets $3
azvazdam: folds 
hammerwife: folds 
Uncalled bet ($3) returned to gabi_igna
gabi_igna collected $7.64 from pot
gabi_igna: doesn't show hand 
*** SUMMARY ***
Total pot $8 | Rake $0.36 
Board [4d Ks 3h]
Seat 2: azvazdam (big blind) folded on the Flop
Seat 3: matiko09 folded before Flop (didn't bet)
Seat 4: TimStone folded before Flop (didn't bet)
Seat 5: Sweden_Pound folded before Flop (didn't bet)
Seat 6: hammerwife folded on the Flop
Seat 7: Zeeshka folded before Flop (didn't bet)
Seat 8: gabi_igna (button) collected ($7.64)
Seat 9: vrnMike (small blind) folded before Flop





PokerStars Hand #148610408718:  Hold'em No Limit ($0.50/$1.00 USD) - 2016/02/11 13:52:45 CET [2016/02/11 7:52:45 ET]
Table 'Anneliese III' 9-max Seat #1 is the button
Seat 1: Matilde81 ($100.30 in chips) 
Seat 2: Igor DoUrden ($100 in chips) 
Seat 3: Zeeshka ($100 in chips) 
Seat 4: Avtovo ($103.23 in chips) 
Seat 5: omorfadramou ($103.23 in chips) 
Seat 6: 1GreasyWop ($78.50 in chips) 
Seat 7: aseban11 ($100 in chips) 
Seat 9: matiko09 ($101.50 in chips) 
Igor DoUrden: posts small blind $0.50
Zeeshka: posts big blind $1
AlKatrone: sits out 
*** HOLE CARDS ***
Dealt to matiko09 [Kd 2h]
Avtovo: folds 
omorfadramou: folds 
1GreasyWop: folds 
aseban11: folds 
matiko09: folds 
Matilde81: folds 
Igor DoUrden: raises $1.50 to $2.50
Zeeshka: folds 
Uncalled bet ($1.50) returned to Igor DoUrden
Igor DoUrden collected $2 from pot
Igor DoUrden: doesn't show hand 
*** SUMMARY ***
Total pot $2 | Rake $0 
Seat 1: Matilde81 (button) folded before Flop (didn't bet)
Seat 2: Igor DoUrden (small blind) collected ($2)
Seat 3: Zeeshka (big blind) folded before Flop
Seat 4: Avtovo folded before Flop (didn't bet)
Seat 5: omorfadramou folded before Flop (didn't bet)
Seat 6: 1GreasyWop folded before Flop (didn't bet)
Seat 7: aseban11 folded before Flop (didn't bet)
Seat 9: matiko09 folded before Flop (didn't bet)





PokerStars Hand #148610411401:  Hold'em No Limit ($0.50/$1.00 USD) - 2016/02/11 13:52:50 CET [2016/02/11 7:52:50 ET]
Table 'Stephano V' 9-max Seat #5 is the button
Seat 1: hammerwife ($109.25 in chips) 
Seat 2: matiko09 ($142.38 in chips) 
Seat 4: Zeeshka ($145.53 in chips) 
Seat 5: n2call ($243.60 in chips) 
Seat 6: Sweden_Pound ($100 in chips) 
Seat 7: Effort92 ($109.30 in chips) 
Seat 9: gabi_igna ($100 in chips) 
Sweden_Pound: posts small blind $0.50
Effort92: posts big blind $1
er13to: sits out 
*** HOLE CARDS ***
Dealt to matiko09 [Ts 7s]
gabi_igna: folds 
hammerwife: folds 
matiko09: folds 
Zeeshka: folds 
n2call: raises $2 to $3
Sweden_Pound: folds 
Effort92: folds 
Uncalled bet ($2) returned to n2call
n2call collected $2.50 from pot
n2call: doesn't show hand 
*** SUMMARY ***
Total pot $2.50 | Rake $0 
Seat 1: hammerwife folded before Flop (didn't bet)
Seat 2: matiko09 folded before Flop (didn't bet)
Seat 4: Zeeshka folded before Flop (didn't bet)
Seat 5: n2call (button) collected ($2.50)
Seat 6: Sweden_Pound (small blind) folded before Flop
Seat 7: Effort92 (big blind) folded before Flop
Seat 9: gabi_igna folded before Flop (didn't bet)





PokerStars Hand #148610420687:  Hold'em No Limit ($0.50/$1.00 USD) - 2016/02/11 13:53:05 CET [2016/02/11 7:53:05 ET]
Table 'Anneliese III' 9-max Seat #2 is the button
Seat 1: Matilde81 ($100.30 in chips) 
Seat 2: Igor DoUrden ($101 in chips) 
Seat 3: Zeeshka ($100 in chips) 
Seat 4: Avtovo ($103.23 in chips) 
Seat 5: omorfadramou ($103.23 in chips) 
Seat 6: 1GreasyWop ($78.50 in chips) 
Seat 7: aseban11 ($100 in chips) 
Seat 9: matiko09 ($101.50 in chips) 
Zeeshka: posts small blind $0.50
Avtovo: posts big blind $1
AlKatrone: sits out 
*** HOLE CARDS ***
Dealt to matiko09 [5c Jd]
omorfadramou: folds 
1GreasyWop: folds 
aseban11: folds 
matiko09: folds 
Matilde81: folds 
Igor DoUrden: raises $1.05 to $2.05
Zeeshka: calls $1.55
Avtovo: folds 
*** FLOP *** [4s 8c Ad]
Zeeshka: checks 
Igor DoUrden: checks 
*** TURN *** [4s 8c Ad] [4c]
Zeeshka: checks 
Igor DoUrden: checks 
*** RIVER *** [4s 8c Ad 4c] [Qd]
Zeeshka: bets $2.67
Igor DoUrden: folds 
Uncalled bet ($2.67) returned to Zeeshka
Zeeshka collected $4.87 from pot
Zeeshka: doesn't show hand 
*** SUMMARY ***
Total pot $5.10 | Rake $0.23 
Board [4s 8c Ad 4c Qd]
Seat 1: Matilde81 folded before Flop (didn't bet)
Seat 2: Igor DoUrden (button) folded on the River
Seat 3: Zeeshka (small blind) collected ($4.87)
Seat 4: Avtovo (big blind) folded before Flop
Seat 5: omorfadramou folded before Flop (didn't bet)
Seat 6: 1GreasyWop folded before Flop (didn't bet)
Seat 7: aseban11 folded before Flop (didn't bet)
Seat 9: matiko09 folded before Flop (didn't bet)





PokerStars Hand #148610420716:  Hold'em No Limit ($0.25/$0.50 USD) - 2016/02/11 13:53:05 CET [2016/02/11 7:53:05 ET]
Table 'Ambrosia II' 9-max Seat #4 is the button
Seat 1: matiko09 ($58.46 in chips) 
Seat 2: JJJ-K9 ($60.31 in chips) 
Seat 3: make6a ($75.26 in chips) 
Seat 4: huudk2016 ($23.03 in chips) 
Seat 5: RICKA16 ($57.17 in chips) 
Seat 6: xxxibgdrgn ($54.50 in chips) 
Seat 8: Dantist1122 ($51.06 in chips) 
Seat 9: arctur17 ($56.77 in chips) 
RICKA16: posts small blind $0.25
xxxibgdrgn: posts big blind $0.50
*** HOLE CARDS ***
Dealt to matiko09 [Ad 8c]
Dantist1122: folds 
arctur17: folds 
matiko09: folds 
JJJ-K9: folds 
make6a: folds 
huudk2016: calls $0.50
RICKA16: folds 
xxxibgdrgn: raises $1.50 to $2
huudk2016: calls $1.50
*** FLOP *** [3c 4h Qc]
xxxibgdrgn: bets $2
huudk2016: folds 
Uncalled bet ($2) returned to xxxibgdrgn
xxxibgdrgn collected $4.06 from pot
xxxibgdrgn: doesn't show hand 
*** SUMMARY ***
Total pot $4.25 | Rake $0.19 
Board [3c 4h Qc]
Seat 1: matiko09 folded before Flop (didn't bet)
Seat 2: JJJ-K9 folded before Flop (didn't bet)
Seat 3: make6a folded before Flop (didn't bet)
Seat 4: huudk2016 (button) folded on the Flop
Seat 5: RICKA16 (small blind) folded before Flop
Seat 6: xxxibgdrgn (big blind) collected ($4.06)
Seat 8: Dantist1122 folded before Flop (didn't bet)
Seat 9: arctur17 folded before Flop (didn't bet)





PokerStars Hand #148610428605:  Hold'em No Limit (€0.25/€0.50 EUR) - 2016/02/11 13:53:17 CET [2016/02/11 7:53:17 ET]
Table 'Otero II' 9-max Seat #4 is the button
Seat 1: Effort92 (€52.75 in chips) 
Seat 2: knauf1991 (€17.81 in chips) 
Seat 3: Szevasztopol (€57.73 in chips) 
Seat 4: kram0909 (€23.53 in chips) 
Seat 5: vlad11122007 (€49.92 in chips) 
Seat 6: TonnaMunz (€53.23 in chips) 
Seat 7: CvMCvMCvM (€60.35 in chips) 
Seat 8: matiko09 (€69.50 in chips) 
Seat 9: Apparat888 (€28.71 in chips) 
vlad11122007: posts small blind €0.25
TonnaMunz: posts big blind €0.50
*** HOLE CARDS ***
Dealt to matiko09 [Kd 5s]
CvMCvMCvM: folds 
matiko09: folds 
Apparat888: folds 
Effort92: raises €1 to €1.50
knauf1991: folds 
Szevasztopol: folds 
kram0909: folds 
vlad11122007: folds 
TonnaMunz: folds 
Uncalled bet (€1) returned to Effort92
Effort92 collected €1.25 from pot
Effort92: doesn't show hand 
*** SUMMARY ***
Total pot €1.25 | Rake €0 
Seat 1: Effort92 collected (€1.25)
Seat 2: knauf1991 folded before Flop (didn't bet)
Seat 3: Szevasztopol folded before Flop (didn't bet)
Seat 4: kram0909 (button) folded before Flop (didn't bet)
Seat 5: vlad11122007 (small blind) folded before Flop
Seat 6: TonnaMunz (big blind) folded before Flop
Seat 7: CvMCvMCvM folded before Flop (didn't bet)
Seat 8: matiko09 folded before Flop (didn't bet)
Seat 9: Apparat888 folded before Flop (didn't bet)





PokerStars Hand #148610431454:  Hold'em No Limit ($0.25/$0.50 USD) - 2016/02/11 13:53:22 CET [2016/02/11 7:53:22 ET]
Table 'Stereoskopia' 9-max Seat #1 is the button
Seat 1: FoRvvArD_go ($50 in chips) 
Seat 2: Dantist1122 ($51.75 in chips) 
Seat 3: fandorin2005 ($53.67 in chips) 
Seat 4: Anikin44 ($58.46 in chips) 
Seat 6: matiko09 ($50 in chips) 
Seat 7: Serhent ($67.57 in chips) 
Seat 8: WDW3 ($50 in chips) 
Seat 9: nastynate075 ($21.39 in chips) 
Dantist1122: posts small blind $0.25
fandorin2005: posts big blind $0.50
*** HOLE CARDS ***
Dealt to matiko09 [Jh 2d]
Anikin44: raises $0.75 to $1.25
matiko09: folds 
Serhent: folds 
WDW3: folds 
nastynate075: folds 
FoRvvArD_go: folds 
Dantist1122: folds 
fandorin2005: folds 
Uncalled bet ($0.75) returned to Anikin44
Anikin44 collected $1.25 from pot
Anikin44: doesn't show hand 
*** SUMMARY ***
Total pot $1.25 | Rake $0 
Seat 1: FoRvvArD_go (button) folded before Flop (didn't bet)
Seat 2: Dantist1122 (small blind) folded before Flop
Seat 3: fandorin2005 (big blind) folded before Flop
Seat 4: Anikin44 collected ($1.25)
Seat 6: matiko09 folded before Flop (didn't bet)
Seat 7: Serhent folded before Flop (didn't bet)
Seat 8: WDW3 folded before Flop (didn't bet)
Seat 9: nastynate075 folded before Flop (didn't bet)





PokerStars Hand #148610432792:  Hold'em No Limit ($0.50/$1.00 USD) - 2016/02/11 13:53:24 CET [2016/02/11 7:53:24 ET]
Table 'Gianfar' 9-max Seat #8 is the button
Seat 1: Vikulja1993 ($102.30 in chips) 
Seat 3: AlKatrone ($176.04 in chips) 
Seat 4: matiko09 ($122.98 in chips) 
Seat 5: hammerwife ($190.49 in chips) 
Seat 6: gabi_igna ($100 in chips) 
Seat 7: Rikti ($35.72 in chips) 
Seat 8: Zeeshka ($121.52 in chips) 
Seat 9: vicdroopy ($100 in chips) 
vicdroopy: posts small blind $0.50
Vikulja1993: posts big blind $1
*** HOLE CARDS ***
Dealt to matiko09 [7s 4d]
AlKatrone: folds 
matiko09: folds 
hammerwife: folds 
gabi_igna: folds 
Rikti: raises $1 to $2
Zeeshka: folds 
vicdroopy: folds 
Vikulja1993: calls $1
*** FLOP *** [3s Qc 2c]
Vikulja1993: checks 
Rikti: bets $3
Vikulja1993: calls $3
*** TURN *** [3s Qc 2c] [Qs]
Vikulja1993: checks 
Rikti: checks 
*** RIVER *** [3s Qc 2c Qs] [Jd]
Vikulja1993: checks 
Rikti: bets $7.50
Vikulja1993: folds 
Uncalled bet ($7.50) returned to Rikti
Rikti collected $10.03 from pot
Rikti: doesn't show hand 
*** SUMMARY ***
Total pot $10.50 | Rake $0.47 
Board [3s Qc 2c Qs Jd]
Seat 1: Vikulja1993 (big blind) folded on the River
Seat 3: AlKatrone folded before Flop (didn't bet)
Seat 4: matiko09 folded before Flop (didn't bet)
Seat 5: hammerwife folded before Flop (didn't bet)
Seat 6: gabi_igna folded before Flop (didn't bet)
Seat 7: Rikti collected ($10.03)
Seat 8: Zeeshka (button) folded before Flop (didn't bet)
Seat 9: vicdroopy (small blind) folded before Flop





PokerStars Hand #148610434734:  Hold'em No Limit ($0.50/$1.00 USD) - 2016/02/11 13:53:27 CET [2016/02/11 7:53:27 ET]
Table 'Stephano V' 9-max Seat #6 is the button
Seat 1: hammerwife ($109.25 in chips) 
Seat 2: matiko09 ($142.38 in chips) 
Seat 4: Zeeshka ($145.53 in chips) 
Seat 5: n2call ($245.10 in chips) 
Seat 6: Sweden_Pound ($100 in chips) 
Seat 7: Effort92 ($108.30 in chips) 
Seat 8: er13to ($100 in chips) 
Seat 9: gabi_igna ($100 in chips) 
Effort92: posts small blind $0.50
er13to: posts big blind $1
*** HOLE CARDS ***
Dealt to matiko09 [Th 9h]
AlKatrone joins the table at seat #3 
AlKatrone leaves the table
Avtovo joins the table at seat #3 
Avtovo leaves the table
Vikulja1993 joins the table at seat #3 
gabi_igna: raises $2 to $3
hammerwife: folds 
Vikulja1993 leaves the table
hurtNCYDE joins the table at seat #3 
hurtNCYDE leaves the table
matiko09: folds 
omorfadramou joins the table at seat #3 
omorfadramou leaves the table
Zeeshka: calls $3
n2call: folds 
Sweden_Pound: folds 
Effort92: folds 
er13to: folds 
*** FLOP *** [3s 9s 7d]
gabi_igna: bets $4
Zeeshka: folds 
Uncalled bet ($4) returned to gabi_igna
gabi_igna collected $7.16 from pot
gabi_igna: doesn't show hand 
*** SUMMARY ***
Total pot $7.50 | Rake $0.34 
Board [3s 9s 7d]
Seat 1: hammerwife folded before Flop (didn't bet)
Seat 2: matiko09 folded before Flop (didn't bet)
Seat 4: Zeeshka folded on the Flop
Seat 5: n2call folded before Flop (didn't bet)
Seat 6: Sweden_Pound (button) folded before Flop (didn't bet)
Seat 7: Effort92 (small blind) folded before Flop
Seat 8: er13to (big blind) folded before Flop
Seat 9: gabi_igna collected ($7.16)





