PokerStars Hand #154362511580:  Hold'em No Limit ($0.50/$1.00 USD) - 2016/06/06 12:18:39 CET [2016/06/06 6:18:39 ET]
Table 'Safara' 9-max Seat #8 is the button
Seat 1: oscarleon ($227.49 in chips) 
Seat 3: Filojoes ($109.42 in chips) 
Seat 4: mattyt212 ($202.58 in chips) 
Seat 5: Dantist1122 ($100 in chips) 
Seat 6: matiko09 ($100 in chips) 
Seat 7: rusher_NiNja ($128.62 in chips) 
Seat 8: Priidix ($100 in chips) 
Seat 9: Mr.Grigoriy ($103.68 in chips) 
Mr.Grigoriy: posts small blind $0.50
oscarleon: posts big blind $1
Szevasztopol: sits out 
*** HOLE CARDS ***
Dealt to matiko09 [3s Kd]
Filojoes: folds 
mattyt212: folds 
Dantist1122: folds 
matiko09: folds 
rusher_NiNja: folds 
Priidix: raises $1.24 to $2.24
Mr.Grigoriy: folds 
oscarleon: folds 
Uncalled bet ($1.24) returned to Priidix
Priidix collected $2.50 from pot
Priidix: doesn't show hand 
*** SUMMARY ***
Total pot $2.50 | Rake $0 
Seat 1: oscarleon (big blind) folded before Flop
Seat 3: Filojoes folded before Flop (didn't bet)
Seat 4: mattyt212 folded before Flop (didn't bet)
Seat 5: Dantist1122 folded before Flop (didn't bet)
Seat 6: matiko09 folded before Flop (didn't bet)
Seat 7: rusher_NiNja folded before Flop (didn't bet)
Seat 8: Priidix (button) collected ($2.50)
Seat 9: Mr.Grigoriy (small blind) folded before Flop





PokerStars Hand #154362511954:  Hold'em No Limit ($0.50/$1.00 USD) - 2016/06/06 12:18:40 CET [2016/06/06 6:18:40 ET]
Table 'Wezen II' 9-max Seat #6 is the button
Seat 1: matiko09 ($165.47 in chips) 
Seat 2: Mr.Grigoriy ($103.18 in chips) 
Seat 3: oscarleon ($100 in chips) 
Seat 5: rusher_NiNja ($102.72 in chips) 
Seat 6: Szevasztopol ($100 in chips) 
Seat 7: KDJAll3 ($133.02 in chips) 
Seat 8: mavin80 ($146.36 in chips) 
Seat 9: Filojoes ($100 in chips) 
KDJAll3: posts small blind $0.50
mavin80: posts big blind $1
maxxmeister: sits out 
*** HOLE CARDS ***
Dealt to matiko09 [Qh 2s]
Filojoes: folds 
matiko09: folds 
Mr.Grigoriy: folds 
oscarleon: raises $2 to $3
rusher_NiNja: folds 
Szevasztopol: folds 
KDJAll3: folds 
mavin80: calls $2
*** FLOP *** [6d 5c 3d]
mavin80: checks 
oscarleon: bets $4
mavin80: calls $4
*** TURN *** [6d 5c 3d] [Ah]
mavin80: checks 
oscarleon: bets $10
mavin80: calls $10
*** RIVER *** [6d 5c 3d Ah] [3s]
mavin80: bets $18
oscarleon: folds 
Uncalled bet ($18) returned to mavin80
mavin80 collected $32.78 from pot
mavin80: doesn't show hand 
*** SUMMARY ***
Total pot $34.50 | Rake $1.72 
Board [6d 5c 3d Ah 3s]
Seat 1: matiko09 folded before Flop (didn't bet)
Seat 2: Mr.Grigoriy folded before Flop (didn't bet)
Seat 3: oscarleon folded on the River
Seat 5: rusher_NiNja folded before Flop (didn't bet)
Seat 6: Szevasztopol (button) folded before Flop (didn't bet)
Seat 7: KDJAll3 (small blind) folded before Flop
Seat 8: mavin80 (big blind) collected ($32.78)
Seat 9: Filojoes folded before Flop (didn't bet)





PokerStars Hand #154362518002:  Hold'em Pot Limit ($0.50/$1.00 USD) - 2016/06/06 12:18:55 CET [2016/06/06 6:18:55 ET]
Table 'Khama' 9-max Seat #5 is the button
Seat 5: markocvijan ($57.30 in chips) 
Seat 6: matiko09 ($100 in chips) 
Seat 7: Filojoes ($100 in chips) 
matiko09: posts small blind $0.50
Filojoes: posts big blind $1
ozone2003: sits out 
*** HOLE CARDS ***
Dealt to matiko09 [9s Tc]
markocvijan: folds 
matiko09: folds 
Uncalled bet ($0.50) returned to Filojoes
Filojoes collected $1 from pot
Filojoes: doesn't show hand 
markocvijan leaves the table
*** SUMMARY ***
Total pot $1 | Rake $0 
Seat 5: markocvijan (button) folded before Flop (didn't bet)
Seat 6: matiko09 (small blind) folded before Flop
Seat 7: Filojoes (big blind) collected ($1)





PokerStars Hand #154362518637:  Hold'em No Limit ($0.50/$1.00 USD) - 2016/06/06 12:18:57 CET [2016/06/06 6:18:57 ET]
Table 'Safara' 9-max Seat #9 is the button
Seat 1: oscarleon ($226.49 in chips) 
Seat 2: Szevasztopol ($100 in chips) 
Seat 3: Filojoes ($109.42 in chips) 
Seat 4: mattyt212 ($202.58 in chips) 
Seat 5: Dantist1122 ($100 in chips) 
Seat 6: matiko09 ($100 in chips) 
Seat 7: rusher_NiNja ($128.62 in chips) 
Seat 8: Priidix ($101.50 in chips) 
Seat 9: Mr.Grigoriy ($103.18 in chips) 
oscarleon: posts small blind $0.50
Szevasztopol: posts big blind $1
*** HOLE CARDS ***
Dealt to matiko09 [7h Ac]
Filojoes: folds 
mattyt212: folds 
Dantist1122: folds 
matiko09: folds 
rusher_NiNja: folds 
Priidix: folds 
Mr.Grigoriy: raises $1 to $2
oscarleon: raises $8 to $10
Szevasztopol: folds 
Mr.Grigoriy: calls $8
*** FLOP *** [8s 3d Kh]
oscarleon: bets $14
Mr.Grigoriy: folds 
Uncalled bet ($14) returned to oscarleon
oscarleon collected $19.95 from pot
oscarleon: doesn't show hand 
*** SUMMARY ***
Total pot $21 | Rake $1.05 
Board [8s 3d Kh]
Seat 1: oscarleon (small blind) collected ($19.95)
Seat 2: Szevasztopol (big blind) folded before Flop
Seat 3: Filojoes folded before Flop (didn't bet)
Seat 4: mattyt212 folded before Flop (didn't bet)
Seat 5: Dantist1122 folded before Flop (didn't bet)
Seat 6: matiko09 folded before Flop (didn't bet)
Seat 7: rusher_NiNja folded before Flop (didn't bet)
Seat 8: Priidix folded before Flop (didn't bet)
Seat 9: Mr.Grigoriy (button) folded on the Flop





PokerStars Hand #154362520680:  Hold'em Pot Limit ($0.50/$1.00 USD) - 2016/06/06 12:19:03 CET [2016/06/06 6:19:03 ET]
Table 'Khama' 9-max Seat #6 is the button
Seat 6: matiko09 ($100 in chips) 
Seat 7: Filojoes ($100.50 in chips) 
Seat 8: ozone2003 ($100 in chips) 
Filojoes: posts small blind $0.50
ozone2003: posts big blind $1
*** HOLE CARDS ***
Dealt to matiko09 [8d 8h]
matiko09: raises $1.27 to $2.27
Filojoes: raises $5.54 to $7.81
ozone2003: folds 
matiko09: calls $5.54
*** FLOP *** [4c 4d Jd]
Filojoes: bets $9
matiko09: calls $9
*** TURN *** [4c 4d Jd] [6h]
Filojoes: bets $21
matiko09: calls $21
*** RIVER *** [4c 4d Jd 6h] [5c]
Filojoes: checks 
coinflip_si leaves the table
matiko09: checks 
*** SHOW DOWN ***
Filojoes: shows [Qc As] (a pair of Fours)
matiko09: shows [8d 8h] (two pair, Eights and Fours)
matiko09 collected $75.62 from pot
*** SUMMARY ***
Total pot $76.62 | Rake $1 
Board [4c 4d Jd 6h 5c]
Seat 6: matiko09 (button) showed [8d 8h] and won ($75.62) with two pair, Eights and Fours
Seat 7: Filojoes (small blind) showed [Qc As] and lost with a pair of Fours
Seat 8: ozone2003 (big blind) folded before Flop





PokerStars Hand #154362523796:  Hold'em No Limit ($0.50/$1.00 USD) - 2016/06/06 12:19:11 CET [2016/06/06 6:19:11 ET]
Table 'Heze' 9-max Seat #2 is the button
Seat 1: matiko09 ($198 in chips) 
Seat 2: oscarleon ($260.81 in chips) 
Seat 3: maxxmeister ($100 in chips) 
Seat 4: xxxZeka ($100 in chips) 
Seat 5: Filojoes ($107.72 in chips) 
Seat 6: Dantist1122 ($109.28 in chips) 
Seat 8: AlSmithy88 ($56.55 in chips) 
Seat 9: Mr.Grigoriy ($125.24 in chips) 
maxxmeister: posts small blind $0.50
xxxZeka: posts big blind $1
Priidix: sits out 
*** HOLE CARDS ***
Dealt to matiko09 [As 3s]
Filojoes: folds 
Dantist1122: folds 
AlSmithy88: folds 
Mr.Grigoriy: raises $2 to $3
matiko09: folds 
oscarleon: folds 
maxxmeister: folds 
xxxZeka: folds 
Uncalled bet ($2) returned to Mr.Grigoriy
Mr.Grigoriy collected $2.50 from pot
Mr.Grigoriy: doesn't show hand 
*** SUMMARY ***
Total pot $2.50 | Rake $0 
Seat 1: matiko09 folded before Flop (didn't bet)
Seat 2: oscarleon (button) folded before Flop (didn't bet)
Seat 3: maxxmeister (small blind) folded before Flop
Seat 4: xxxZeka (big blind) folded before Flop
Seat 5: Filojoes folded before Flop (didn't bet)
Seat 6: Dantist1122 folded before Flop (didn't bet)
Seat 8: AlSmithy88 folded before Flop (didn't bet)
Seat 9: Mr.Grigoriy collected ($2.50)





PokerStars Hand #154362529160:  Hold'em No Limit ($0.50/$1.00 USD) - 2016/06/06 12:19:24 CET [2016/06/06 6:19:24 ET]
Table 'Irmgard II' 9-max Seat #7 is the button
Seat 1: matiko09 ($197.50 in chips) 
Seat 2: hammerwife ($117.43 in chips) 
Seat 3: xxxZeka ($101.40 in chips) 
Seat 4: oscarleon ($173.51 in chips) 
Seat 5: Dantist1122 ($104.50 in chips) 
Seat 6: maxxmeister ($185 in chips) 
Seat 7: ghostriderxu ($11.41 in chips) 
Seat 8: Szevasztopol ($100 in chips) 
Seat 9: Filojoes ($138.22 in chips) 
Szevasztopol: posts small blind $0.50
Filojoes: posts big blind $1
*** HOLE CARDS ***
Dealt to matiko09 [Th 6s]
matiko09: folds 
hammerwife: folds 
xxxZeka: raises $2 to $3
oscarleon: folds 
Dantist1122: folds 
maxxmeister: folds 
ghostriderxu: folds 
Szevasztopol: folds 
Filojoes: folds 
Uncalled bet ($2) returned to xxxZeka
xxxZeka collected $2.50 from pot
*** SUMMARY ***
Total pot $2.50 | Rake $0 
Seat 1: matiko09 folded before Flop (didn't bet)
Seat 2: hammerwife folded before Flop (didn't bet)
Seat 3: xxxZeka collected ($2.50)
Seat 4: oscarleon folded before Flop (didn't bet)
Seat 5: Dantist1122 folded before Flop (didn't bet)
Seat 6: maxxmeister folded before Flop (didn't bet)
Seat 7: ghostriderxu (button) folded before Flop (didn't bet)
Seat 8: Szevasztopol (small blind) folded before Flop
Seat 9: Filojoes (big blind) folded before Flop





PokerStars Hand #154362530798:  Hold'em No Limit ($0.50/$1.00 USD) - 2016/06/06 12:19:29 CET [2016/06/06 6:19:29 ET]
Table 'Gajdariya' 9-max Seat #9 is the button
Seat 1: matiko09 ($102 in chips) 
Seat 2: xxxZeka ($128.22 in chips) 
Seat 3: oscarleon ($100 in chips) 
Seat 6: mono123viva ($75.58 in chips) 
Seat 7: Wombatkilla ($114.18 in chips) 
Seat 9: rusher_NiNja ($136.42 in chips) 
matiko09: posts small blind $0.50
xxxZeka: posts big blind $1
Szevasztopol: sits out 
147734319: sits out 
mono123viva: posts big blind $1
ardo888: sits out 
*** HOLE CARDS ***
Dealt to matiko09 [Jd Kc]
oscarleon: folds 
mono123viva: checks 
Wombatkilla: folds 
rusher_NiNja: raises $2 to $3
matiko09: folds 
xxxZeka: calls $2
mono123viva: calls $2
*** FLOP *** [3h 5d 2s]
xxxZeka: bets $6.76
mono123viva: folds 
rusher_NiNja: folds 
Uncalled bet ($6.76) returned to xxxZeka
xxxZeka collected $9.02 from pot
*** SUMMARY ***
Total pot $9.50 | Rake $0.48 
Board [3h 5d 2s]
Seat 1: matiko09 (small blind) folded before Flop
Seat 2: xxxZeka (big blind) collected ($9.02)
Seat 3: oscarleon folded before Flop (didn't bet)
Seat 6: mono123viva folded on the Flop
Seat 7: Wombatkilla folded before Flop (didn't bet)
Seat 9: rusher_NiNja (button) folded on the Flop





PokerStars Hand #154362532410:  Hold'em No Limit ($0.50/$1.00 USD) - 2016/06/06 12:19:33 CET [2016/06/06 6:19:33 ET]
Table 'Williams' 9-max Seat #4 is the button
Seat 1: matiko09 ($195.79 in chips) 
Seat 4: Filojoes ($125.42 in chips) 
Seat 5: ardo888 ($100 in chips) 
Seat 6: Priidix ($100 in chips) 
Seat 7: kevinho109 ($97 in chips) 
Seat 8: oscarleon ($104 in chips) 
Seat 9: kind ten ($27.26 in chips) 
ardo888: posts small blind $0.50
Priidix: posts big blind $1
PacPacBum: sits out 
granbunny: sits out 
*** HOLE CARDS ***
Dealt to matiko09 [2d 3h]
kevinho109: folds 
oscarleon: folds 
kind ten: raises $2 to $3
matiko09: folds 
Filojoes: folds 
ardo888: folds 
Priidix: folds 
Uncalled bet ($2) returned to kind ten
kind ten collected $2.50 from pot
kind ten: doesn't show hand 
*** SUMMARY ***
Total pot $2.50 | Rake $0 
Seat 1: matiko09 folded before Flop (didn't bet)
Seat 4: Filojoes (button) folded before Flop (didn't bet)
Seat 5: ardo888 (small blind) folded before Flop
Seat 6: Priidix (big blind) folded before Flop
Seat 7: kevinho109 folded before Flop (didn't bet)
Seat 8: oscarleon folded before Flop (didn't bet)
Seat 9: kind ten collected ($2.50)





PokerStars Hand #154362539010:  Hold'em No Limit ($0.50/$1.00 USD) - 2016/06/06 12:19:50 CET [2016/06/06 6:19:50 ET]
Table 'Wezen II' 9-max Seat #7 is the button
Seat 1: matiko09 ($165.47 in chips) 
Seat 2: Mr.Grigoriy ($103.18 in chips) 
Seat 3: oscarleon ($100 in chips) 
Seat 5: rusher_NiNja ($102.72 in chips) 
Seat 6: Szevasztopol ($100 in chips) 
Seat 7: KDJAll3 ($132.52 in chips) 
Seat 8: mavin80 ($162.14 in chips) 
Seat 9: Filojoes ($100 in chips) 
mavin80: posts small blind $0.50
Filojoes: posts big blind $1
maxxmeister: sits out 
*** HOLE CARDS ***
Dealt to matiko09 [Ks 8c]
matiko09: folds 
Mr.Grigoriy: folds 
oscarleon: folds 
rusher_NiNja: folds 
Szevasztopol: folds 
KDJAll3 has timed out
KDJAll3: folds 
mavin80: raises $1.50 to $2.50
Filojoes: calls $1.50
*** FLOP *** [4h 6c 5c]
mavin80: checks 
Filojoes: bets $2.60
mavin80: folds 
Uncalled bet ($2.60) returned to Filojoes
Filojoes collected $4.75 from pot
Filojoes: doesn't show hand 
*** SUMMARY ***
Total pot $5 | Rake $0.25 
Board [4h 6c 5c]
Seat 1: matiko09 folded before Flop (didn't bet)
Seat 2: Mr.Grigoriy folded before Flop (didn't bet)
Seat 3: oscarleon folded before Flop (didn't bet)
Seat 5: rusher_NiNja folded before Flop (didn't bet)
Seat 6: Szevasztopol folded before Flop (didn't bet)
Seat 7: KDJAll3 (button) folded before Flop (didn't bet)
Seat 8: mavin80 (small blind) folded on the Flop
Seat 9: Filojoes (big blind) collected ($4.75)





PokerStars Hand #154362541006:  Hold'em No Limit ($0.50/$1.00 USD) - 2016/06/06 12:19:55 CET [2016/06/06 6:19:55 ET]
Table 'Heze' 9-max Seat #3 is the button
Seat 1: matiko09 ($198 in chips) 
Seat 2: oscarleon ($260.81 in chips) 
Seat 3: maxxmeister ($100 in chips) 
Seat 4: xxxZeka ($100 in chips) 
Seat 5: Filojoes ($107.72 in chips) 
Seat 6: Dantist1122 ($109.28 in chips) 
Seat 8: AlSmithy88 ($56.55 in chips) 
Seat 9: Mr.Grigoriy ($126.74 in chips) 
xxxZeka: posts small blind $0.50
Filojoes: posts big blind $1
Priidix: sits out 
*** HOLE CARDS ***
Dealt to matiko09 [4s 5s]
Dantist1122: folds 
AlSmithy88: calls $1
Dantist1122 leaves the table
Mr.Grigoriy: folds 
matiko09: folds 
oscarleon: folds 
maxxmeister: folds 
xxxZeka: folds 
Filojoes: checks 
*** FLOP *** [9c Jh Qc]
Filojoes: bets $1.43
ozone2003 joins the table at seat #6 
AlSmithy88: calls $1.43
*** TURN *** [9c Jh Qc] [4d]
Filojoes: bets $3.05
AlSmithy88: calls $3.05
*** RIVER *** [9c Jh Qc 4d] [8c]
Filojoes: checks 
AlSmithy88: bets $5
Filojoes: folds 
Uncalled bet ($5) returned to AlSmithy88
AlSmithy88 collected $10.89 from pot
AlSmithy88: doesn't show hand 
*** SUMMARY ***
Total pot $11.46 | Rake $0.57 
Board [9c Jh Qc 4d 8c]
Seat 1: matiko09 folded before Flop (didn't bet)
Seat 2: oscarleon folded before Flop (didn't bet)
Seat 3: maxxmeister (button) folded before Flop (didn't bet)
Seat 4: xxxZeka (small blind) folded before Flop
Seat 5: Filojoes (big blind) folded on the River
Seat 6: Dantist1122 folded before Flop (didn't bet)
Seat 8: AlSmithy88 collected ($10.89)
Seat 9: Mr.Grigoriy folded before Flop (didn't bet)





PokerStars Hand #154362542472:  Hold'em Pot Limit ($0.50/$1.00 USD) - 2016/06/06 12:19:59 CET [2016/06/06 6:19:59 ET]
Table 'Khama' 9-max Seat #7 is the button
Seat 6: matiko09 ($137.81 in chips) 
Seat 7: Filojoes ($100 in chips) 
Seat 8: ozone2003 ($100 in chips) 
ozone2003: posts small blind $0.50
matiko09: posts big blind $1
*** HOLE CARDS ***
Dealt to matiko09 [Jh Kd]
Filojoes: folds 
Filojoes leaves the table
ozone2003: folds 
Uncalled bet ($0.50) returned to matiko09
matiko09 collected $1 from pot
matiko09: doesn't show hand 
*** SUMMARY ***
Total pot $1 | Rake $0 
Seat 6: matiko09 (big blind) collected ($1)
Seat 7: Filojoes (button) folded before Flop (didn't bet)
Seat 8: ozone2003 (small blind) folded before Flop





PokerStars Hand #154362543222:  Hold'em No Limit ($0.50/$1.00 USD) - 2016/06/06 12:20:01 CET [2016/06/06 6:20:01 ET]
Table 'Williams' 9-max Seat #5 is the button
Seat 1: matiko09 ($195.79 in chips) 
Seat 4: Filojoes ($125.42 in chips) 
Seat 5: ardo888 ($100 in chips) 
Seat 6: Priidix ($100 in chips) 
Seat 7: kevinho109 ($97 in chips) 
Seat 8: oscarleon ($104 in chips) 
Seat 9: kind ten ($28.76 in chips) 
Priidix: posts small blind $0.50
kevinho109: posts big blind $1
PacPacBum: sits out 
granbunny: sits out 
*** HOLE CARDS ***
Dealt to matiko09 [Tc Qs]
oscarleon: folds 
kind ten: folds 
matiko09: folds 
Filojoes: folds 
ardo888: raises $1.50 to $2.50
Priidix: folds 
kevinho109: folds 
Uncalled bet ($1.50) returned to ardo888
ardo888 collected $2.50 from pot
ardo888: doesn't show hand 
*** SUMMARY ***
Total pot $2.50 | Rake $0 
Seat 1: matiko09 folded before Flop (didn't bet)
Seat 4: Filojoes folded before Flop (didn't bet)
Seat 5: ardo888 (button) collected ($2.50)
Seat 6: Priidix (small blind) folded before Flop
Seat 7: kevinho109 (big blind) folded before Flop
Seat 8: oscarleon folded before Flop (didn't bet)
Seat 9: kind ten folded before Flop (didn't bet)





PokerStars Hand #154362547313:  Hold'em No Limit ($0.50/$1.00 USD) - 2016/06/06 12:20:11 CET [2016/06/06 6:20:11 ET]
Table 'Irmgard II' 9-max Seat #8 is the button
Seat 1: matiko09 ($197.50 in chips) 
Seat 2: hammerwife ($117.43 in chips) 
Seat 3: xxxZeka ($102.90 in chips) 
Seat 4: oscarleon ($173.51 in chips) 
Seat 5: Dantist1122 ($104.50 in chips) 
Seat 6: maxxmeister ($185 in chips) 
Seat 7: ghostriderxu ($11.41 in chips) 
Seat 8: Szevasztopol ($100 in chips) 
Seat 9: Filojoes ($137.22 in chips) 
Filojoes: posts small blind $0.50
matiko09: posts big blind $1
*** HOLE CARDS ***
Dealt to matiko09 [5c Td]
hammerwife: folds 
xxxZeka: folds 
oscarleon: raises $2 to $3
Dantist1122: folds 
maxxmeister: folds 
ghostriderxu: folds 
Szevasztopol: folds 
Filojoes: folds 
matiko09: folds 
Uncalled bet ($2) returned to oscarleon
oscarleon collected $2.50 from pot
oscarleon: doesn't show hand 
*** SUMMARY ***
Total pot $2.50 | Rake $0 
Seat 1: matiko09 (big blind) folded before Flop
Seat 2: hammerwife folded before Flop (didn't bet)
Seat 3: xxxZeka folded before Flop (didn't bet)
Seat 4: oscarleon collected ($2.50)
Seat 5: Dantist1122 folded before Flop (didn't bet)
Seat 6: maxxmeister folded before Flop (didn't bet)
Seat 7: ghostriderxu folded before Flop (didn't bet)
Seat 8: Szevasztopol (button) folded before Flop (didn't bet)
Seat 9: Filojoes (small blind) folded before Flop





PokerStars Hand #154362547835:  Hold'em No Limit ($0.50/$1.00 USD) - 2016/06/06 12:20:12 CET [2016/06/06 6:20:12 ET]
Table 'Gajdariya' 9-max Seat #1 is the button
Seat 1: matiko09 ($101.50 in chips) 
Seat 2: xxxZeka ($134.24 in chips) 
Seat 3: oscarleon ($100 in chips) 
Seat 6: mono123viva ($72.58 in chips) 
Seat 7: Wombatkilla ($114.18 in chips) 
Seat 9: rusher_NiNja ($133.42 in chips) 
xxxZeka: posts small blind $0.50
oscarleon: posts big blind $1
Szevasztopol: sits out 
147734319: sits out 
ardo888: sits out 
*** HOLE CARDS ***
Dealt to matiko09 [Tc 4c]
mono123viva: folds 
Wombatkilla: raises $2 to $3
rusher_NiNja: raises $5.50 to $8.50
matiko09: folds 
xxxZeka: folds 
oscarleon: folds 
Wombatkilla: calls $5.50
*** FLOP *** [6d 7d 3d]
Wombatkilla: checks 
rusher_NiNja: bets $9.50
Wombatkilla: folds 
Uncalled bet ($9.50) returned to rusher_NiNja
rusher_NiNja collected $17.58 from pot
rusher_NiNja: doesn't show hand 
*** SUMMARY ***
Total pot $18.50 | Rake $0.92 
Board [6d 7d 3d]
Seat 1: matiko09 (button) folded before Flop (didn't bet)
Seat 2: xxxZeka (small blind) folded before Flop
Seat 3: oscarleon (big blind) folded before Flop
Seat 6: mono123viva folded before Flop (didn't bet)
Seat 7: Wombatkilla folded on the Flop
Seat 9: rusher_NiNja collected ($17.58)





PokerStars Hand #154362551784:  Hold'em No Limit ($0.50/$1.00 USD) - 2016/06/06 12:20:23 CET [2016/06/06 6:20:23 ET]
Table 'Williams' 9-max Seat #6 is the button
Seat 1: matiko09 ($195.79 in chips) 
Seat 4: Filojoes ($125.42 in chips) 
Seat 5: ardo888 ($101.50 in chips) 
Seat 6: Priidix ($100 in chips) 
Seat 7: kevinho109 ($96 in chips) 
Seat 8: oscarleon ($104 in chips) 
Seat 9: kind ten ($28.76 in chips) 
kevinho109: posts small blind $0.50
oscarleon: posts big blind $1
PacPacBum: sits out 
granbunny: sits out 
*** HOLE CARDS ***
Dealt to matiko09 [6c 3h]
kind ten: folds 
matiko09: folds 
Filojoes: folds 
ardo888: folds 
Priidix: raises $1.24 to $2.24
kevinho109: folds 
oscarleon: raises $6.76 to $9
Priidix: folds 
Uncalled bet ($6.76) returned to oscarleon
oscarleon collected $4.98 from pot
oscarleon: doesn't show hand 
*** SUMMARY ***
Total pot $4.98 | Rake $0 
Seat 1: matiko09 folded before Flop (didn't bet)
Seat 4: Filojoes folded before Flop (didn't bet)
Seat 5: ardo888 folded before Flop (didn't bet)
Seat 6: Priidix (button) folded before Flop
Seat 7: kevinho109 (small blind) folded before Flop
Seat 8: oscarleon (big blind) collected ($4.98)
Seat 9: kind ten folded before Flop (didn't bet)





PokerStars Hand #154362555447:  Hold'em No Limit ($0.50/$1.00 USD) - 2016/06/06 12:20:32 CET [2016/06/06 6:20:32 ET]
Table 'Safara' 9-max Seat #1 is the button
Seat 1: oscarleon ($236.44 in chips) 
Seat 2: Szevasztopol ($100 in chips) 
Seat 4: mattyt212 ($202.58 in chips) 
Seat 5: Dantist1122 ($100 in chips) 
Seat 6: matiko09 ($100 in chips) 
Seat 7: rusher_NiNja ($128.62 in chips) 
Seat 8: Priidix ($101.50 in chips) 
Seat 9: Mr.Grigoriy ($100 in chips) 
Szevasztopol: posts small blind $0.50
Filojoes: is sitting out 
Filojoes leaves the table
mattyt212: posts big blind $1
*** HOLE CARDS ***
Dealt to matiko09 [Ah 2d]
Dantist1122: folds 
matiko09: folds 
ozone2003 joins the table at seat #3 
rusher_NiNja: folds 
Priidix: folds 
Mr.Grigoriy: raises $1.50 to $2.50
oscarleon: folds 
Szevasztopol: folds 
mattyt212: calls $1.50
*** FLOP *** [As Kd Qd]
mattyt212: checks 
Mr.Grigoriy: checks 
*** TURN *** [As Kd Qd] [9h]
mattyt212: bets $5.22
Mr.Grigoriy: folds 
Uncalled bet ($5.22) returned to mattyt212
mattyt212 collected $5.22 from pot
mattyt212: doesn't show hand 
*** SUMMARY ***
Total pot $5.50 | Rake $0.28 
Board [As Kd Qd 9h]
Seat 1: oscarleon (button) folded before Flop (didn't bet)
Seat 2: Szevasztopol (small blind) folded before Flop
Seat 4: mattyt212 (big blind) collected ($5.22)
Seat 5: Dantist1122 folded before Flop (didn't bet)
Seat 6: matiko09 folded before Flop (didn't bet)
Seat 7: rusher_NiNja folded before Flop (didn't bet)
Seat 8: Priidix folded before Flop (didn't bet)
Seat 9: Mr.Grigoriy folded on the Turn





PokerStars Hand #154362560374:  Hold'em No Limit ($0.50/$1.00 USD) - 2016/06/06 12:20:45 CET [2016/06/06 6:20:45 ET]
Table 'Irmgard II' 9-max Seat #9 is the button
Seat 1: matiko09 ($196.50 in chips) 
Seat 2: hammerwife ($117.43 in chips) 
Seat 3: xxxZeka ($102.90 in chips) 
Seat 4: oscarleon ($175.01 in chips) 
Seat 5: Dantist1122 ($104.50 in chips) 
Seat 6: maxxmeister ($185 in chips) 
Seat 7: ghostriderxu ($11.41 in chips) 
Seat 8: Szevasztopol ($100 in chips) 
Seat 9: Filojoes ($136.72 in chips) 
matiko09: posts small blind $0.50
hammerwife: posts big blind $1
*** HOLE CARDS ***
Dealt to matiko09 [7s Ac]
xxxZeka: folds 
oscarleon: folds 
Dantist1122: folds 
maxxmeister: folds 
ghostriderxu: folds 
Szevasztopol: folds 
Filojoes: raises $1 to $2
matiko09: folds 
hammerwife: folds 
Uncalled bet ($1) returned to Filojoes
Filojoes collected $2.50 from pot
Filojoes: doesn't show hand 
*** SUMMARY ***
Total pot $2.50 | Rake $0 
Seat 1: matiko09 (small blind) folded before Flop
Seat 2: hammerwife (big blind) folded before Flop
Seat 3: xxxZeka folded before Flop (didn't bet)
Seat 4: oscarleon folded before Flop (didn't bet)
Seat 5: Dantist1122 folded before Flop (didn't bet)
Seat 6: maxxmeister folded before Flop (didn't bet)
Seat 7: ghostriderxu folded before Flop (didn't bet)
Seat 8: Szevasztopol folded before Flop (didn't bet)
Seat 9: Filojoes (button) collected ($2.50)





PokerStars Hand #154362562028:  Hold'em No Limit ($0.50/$1.00 USD) - 2016/06/06 12:20:49 CET [2016/06/06 6:20:49 ET]
Table 'Williams' 9-max Seat #7 is the button
Seat 1: matiko09 ($195.79 in chips) 
Seat 4: Filojoes ($125.42 in chips) 
Seat 5: ardo888 ($101.50 in chips) 
Seat 6: Priidix ($100 in chips) 
Seat 7: kevinho109 ($95.50 in chips) 
Seat 8: oscarleon ($106.74 in chips) 
Seat 9: kind ten ($28.76 in chips) 
oscarleon: posts small blind $0.50
kind ten: posts big blind $1
PacPacBum: sits out 
granbunny: sits out 
*** HOLE CARDS ***
Dealt to matiko09 [8c 7d]
matiko09: folds 
Filojoes: folds 
ardo888: folds 
Priidix: raises $1.44 to $2.44
kevinho109: calls $2.44
oscarleon: folds 
kind ten: calls $1.44
*** FLOP *** [Jd 7s Tc]
kind ten: checks 
Priidix: bets $5.50
kevinho109: calls $5.50
kind ten: folds 
*** TURN *** [Jd 7s Tc] [Qs]
Priidix: bets $15
kevinho109: calls $15
*** RIVER *** [Jd 7s Tc Qs] [5s]
Priidix: bets $25
kevinho109: folds 
Uncalled bet ($25) returned to Priidix
Priidix collected $46.38 from pot
Priidix: doesn't show hand 
*** SUMMARY ***
Total pot $48.82 | Rake $2.44 
Board [Jd 7s Tc Qs 5s]
Seat 1: matiko09 folded before Flop (didn't bet)
Seat 4: Filojoes folded before Flop (didn't bet)
Seat 5: ardo888 folded before Flop (didn't bet)
Seat 6: Priidix collected ($46.38)
Seat 7: kevinho109 (button) folded on the River
Seat 8: oscarleon (small blind) folded before Flop
Seat 9: kind ten (big blind) folded on the Flop





PokerStars Hand #154362562068:  Hold'em No Limit ($0.50/$1.00 USD) - 2016/06/06 12:20:49 CET [2016/06/06 6:20:49 ET]
Table 'Gajdariya' 9-max Seat #2 is the button
Seat 1: matiko09 ($101.50 in chips) 
Seat 2: xxxZeka ($133.74 in chips) 
Seat 3: oscarleon ($100 in chips) 
Seat 4: Szevasztopol ($110.77 in chips) 
Seat 6: mono123viva ($72.58 in chips) 
Seat 7: Wombatkilla ($105.68 in chips) 
Seat 9: rusher_NiNja ($142.50 in chips) 
oscarleon: posts small blind $0.50
Szevasztopol: posts big blind $1
147734319: sits out 
ardo888: sits out 
*** HOLE CARDS ***
Dealt to matiko09 [Jc 7s]
mono123viva: folds 
Wombatkilla: folds 
rusher_NiNja: folds 
matiko09: folds 
xxxZeka: raises $1.50 to $2.50
oscarleon: folds 
Szevasztopol: raises $5.50 to $8
xxxZeka: folds 
Uncalled bet ($5.50) returned to Szevasztopol
Szevasztopol collected $5.50 from pot
Szevasztopol: doesn't show hand 
*** SUMMARY ***
Total pot $5.50 | Rake $0 
Seat 1: matiko09 folded before Flop (didn't bet)
Seat 2: xxxZeka (button) folded before Flop
Seat 3: oscarleon (small blind) folded before Flop
Seat 4: Szevasztopol (big blind) collected ($5.50)
Seat 6: mono123viva folded before Flop (didn't bet)
Seat 7: Wombatkilla folded before Flop (didn't bet)
Seat 9: rusher_NiNja folded before Flop (didn't bet)





PokerStars Hand #154362564145:  Hold'em No Limit ($0.50/$1.00 USD) - 2016/06/06 12:20:54 CET [2016/06/06 6:20:54 ET]
Table 'Wezen II' 9-max Seat #8 is the button
Seat 1: matiko09 ($165.47 in chips) 
Seat 2: Mr.Grigoriy ($103.18 in chips) 
Seat 3: oscarleon ($100 in chips) 
Seat 5: rusher_NiNja ($102.72 in chips) 
Seat 6: Szevasztopol ($100 in chips) 
Seat 7: KDJAll3 ($132.52 in chips) 
Seat 8: mavin80 ($159.64 in chips) 
Seat 9: Filojoes ($102.25 in chips) 
Filojoes: posts small blind $0.50
matiko09: posts big blind $1
maxxmeister: sits out 
*** HOLE CARDS ***
Dealt to matiko09 [Ts 3h]
Mr.Grigoriy: folds 
oscarleon: folds 
rusher_NiNja: folds 
Szevasztopol: folds 
KDJAll3: raises $1 to $2
mavin80: calls $2
Filojoes: calls $1.50
matiko09: folds 
*** FLOP *** [7c Qs Ah]
Filojoes: checks 
KDJAll3: bets $1
mavin80: calls $1
Filojoes: folds 
*** TURN *** [7c Qs Ah] [5c]
KDJAll3: checks 
mavin80: bets $3
KDJAll3: folds 
Uncalled bet ($3) returned to mavin80
mavin80 collected $8.55 from pot
mavin80: doesn't show hand 
*** SUMMARY ***
Total pot $9 | Rake $0.45 
Board [7c Qs Ah 5c]
Seat 1: matiko09 (big blind) folded before Flop
Seat 2: Mr.Grigoriy folded before Flop (didn't bet)
Seat 3: oscarleon folded before Flop (didn't bet)
Seat 5: rusher_NiNja folded before Flop (didn't bet)
Seat 6: Szevasztopol folded before Flop (didn't bet)
Seat 7: KDJAll3 folded on the Turn
Seat 8: mavin80 (button) collected ($8.55)
Seat 9: Filojoes (small blind) folded on the Flop





PokerStars Hand #154362565017:  Hold'em No Limit ($0.50/$1.00 USD) - 2016/06/06 12:20:57 CET [2016/06/06 6:20:57 ET]
Table 'Yarilo' 9-max Seat #5 is the button
Seat 1: xxxZeka ($100 in chips) 
Seat 2: thecurv ($108.32 in chips) 
Seat 3: matiko09 ($112.42 in chips) 
Seat 4: riggedsh** ($120.92 in chips) 
Seat 5: Szevasztopol ($100 in chips) 
Seat 6: maxxmeister ($100 in chips) 
Seat 7: KEBIN1974 ($101.50 in chips) 
Seat 8: Mr.Grigoriy ($155.17 in chips) 
Seat 9: Filojoes ($102.48 in chips) 
maxxmeister: posts small blind $0.50
KEBIN1974: posts big blind $1
*** HOLE CARDS ***
Dealt to matiko09 [8s Ad]
Mr.Grigoriy: folds 
Filojoes: folds 
xxxZeka: folds 
thecurv: folds 
matiko09: folds 
riggedsh**: folds 
Szevasztopol: raises $1 to $2
maxxmeister: folds 
KEBIN1974: raises $3 to $5
Szevasztopol: calls $3
*** FLOP *** [Jd 2s Js]
KEBIN1974: checks 
Szevasztopol: bets $3.89
KEBIN1974: raises $10.30 to $14.19
Szevasztopol: calls $10.30
*** TURN *** [Jd 2s Js] [6h]
KEBIN1974: bets $20
Szevasztopol: calls $20
*** RIVER *** [Jd 2s Js 6h] [9c]
KEBIN1974: checks 
Szevasztopol: bets $60.81 and is all-in
KEBIN1974: folds 
Uncalled bet ($60.81) returned to Szevasztopol
Szevasztopol collected $76.38 from pot
Szevasztopol: doesn't show hand 
*** SUMMARY ***
Total pot $78.88 | Rake $2.50 
Board [Jd 2s Js 6h 9c]
Seat 1: xxxZeka folded before Flop (didn't bet)
Seat 2: thecurv folded before Flop (didn't bet)
Seat 3: matiko09 folded before Flop (didn't bet)
Seat 4: riggedsh** folded before Flop (didn't bet)
Seat 5: Szevasztopol (button) collected ($76.38)
Seat 6: maxxmeister (small blind) folded before Flop
Seat 7: KEBIN1974 (big blind) folded on the River
Seat 8: Mr.Grigoriy folded before Flop (didn't bet)
Seat 9: Filojoes folded before Flop (didn't bet)





PokerStars Hand #154362573065:  Hold'em No Limit ($0.50/$1.00 USD) - 2016/06/06 12:21:18 CET [2016/06/06 6:21:18 ET]
Table 'Heze' 9-max Seat #4 is the button
Seat 1: matiko09 ($198 in chips) 
Seat 2: oscarleon ($260.81 in chips) 
Seat 3: maxxmeister ($100 in chips) 
Seat 4: xxxZeka ($100 in chips) 
Seat 5: Filojoes ($102.24 in chips) 
Seat 6: ozone2003 ($100 in chips) 
Seat 8: AlSmithy88 ($61.96 in chips) 
Seat 9: Mr.Grigoriy ($126.74 in chips) 
Filojoes: posts small blind $0.50
ozone2003: posts big blind $1
Priidix: sits out 
*** HOLE CARDS ***
Dealt to matiko09 [8s Jc]
AlSmithy88: folds 
Mr.Grigoriy: folds 
matiko09: folds 
oscarleon: folds 
maxxmeister: folds 
xxxZeka: folds 
Filojoes: folds 
Uncalled bet ($0.50) returned to ozone2003
ozone2003 collected $1 from pot
ozone2003: doesn't show hand 
*** SUMMARY ***
Total pot $1 | Rake $0 
Seat 1: matiko09 folded before Flop (didn't bet)
Seat 2: oscarleon folded before Flop (didn't bet)
Seat 3: maxxmeister folded before Flop (didn't bet)
Seat 4: xxxZeka (button) folded before Flop (didn't bet)
Seat 5: Filojoes (small blind) folded before Flop
Seat 6: ozone2003 (big blind) collected ($1)
Seat 8: AlSmithy88 folded before Flop (didn't bet)
Seat 9: Mr.Grigoriy folded before Flop (didn't bet)





PokerStars Hand #154362576739:  Hold'em No Limit ($0.50/$1.00 USD) - 2016/06/06 12:21:27 CET [2016/06/06 6:21:27 ET]
Table 'Safara' 9-max Seat #2 is the button
Seat 1: oscarleon ($236.44 in chips) 
Seat 2: Szevasztopol ($100 in chips) 
Seat 4: mattyt212 ($205.30 in chips) 
Seat 5: Dantist1122 ($100 in chips) 
Seat 6: matiko09 ($100 in chips) 
Seat 7: rusher_NiNja ($128.62 in chips) 
Seat 8: Priidix ($101.50 in chips) 
Seat 9: Mr.Grigoriy ($100 in chips) 
ozone2003 will be allowed to play after the button
mattyt212: posts small blind $0.50
Dantist1122: posts big blind $1
*** HOLE CARDS ***
Dealt to matiko09 [3d 6d]
matiko09: folds 
rusher_NiNja: raises $1.50 to $2.50
Priidix: folds 
Mr.Grigoriy: folds 
oscarleon: folds 
Szevasztopol: folds 
mattyt212: folds 
Dantist1122: calls $1.50
*** FLOP *** [3c Jc 7h]
Dantist1122: checks 
rusher_NiNja: bets $3
Dantist1122: folds 
Uncalled bet ($3) returned to rusher_NiNja
rusher_NiNja collected $5.22 from pot
rusher_NiNja: doesn't show hand 
*** SUMMARY ***
Total pot $5.50 | Rake $0.28 
Board [3c Jc 7h]
Seat 1: oscarleon folded before Flop (didn't bet)
Seat 2: Szevasztopol (button) folded before Flop (didn't bet)
Seat 4: mattyt212 (small blind) folded before Flop
Seat 5: Dantist1122 (big blind) folded on the Flop
Seat 6: matiko09 folded before Flop (didn't bet)
Seat 7: rusher_NiNja collected ($5.22)
Seat 8: Priidix folded before Flop (didn't bet)
Seat 9: Mr.Grigoriy folded before Flop (didn't bet)





PokerStars Hand #154362578734:  Hold'em No Limit ($0.50/$1.00 USD) - 2016/06/06 12:21:32 CET [2016/06/06 6:21:32 ET]
Table 'Heze' 9-max Seat #5 is the button
Seat 1: matiko09 ($198 in chips) 
Seat 2: oscarleon ($260.81 in chips) 
Seat 3: maxxmeister ($100 in chips) 
Seat 4: xxxZeka ($100 in chips) 
Seat 5: Filojoes ($101.74 in chips) 
Seat 6: ozone2003 ($100.50 in chips) 
Seat 7: Priidix ($100 in chips) 
Seat 8: AlSmithy88 ($61.96 in chips) 
Seat 9: Mr.Grigoriy ($126.74 in chips) 
ozone2003: posts small blind $0.50
Priidix: posts big blind $1
*** HOLE CARDS ***
Dealt to matiko09 [5s 3h]
AlSmithy88: folds 
Mr.Grigoriy: folds 
matiko09: folds 
oscarleon: folds 
maxxmeister: raises $2.50 to $3.50
xxxZeka: folds 
Filojoes: folds 
ozone2003: folds 
Priidix: folds 
Uncalled bet ($2.50) returned to maxxmeister
maxxmeister collected $2.50 from pot
maxxmeister: doesn't show hand 
*** SUMMARY ***
Total pot $2.50 | Rake $0 
Seat 1: matiko09 folded before Flop (didn't bet)
Seat 2: oscarleon folded before Flop (didn't bet)
Seat 3: maxxmeister collected ($2.50)
Seat 4: xxxZeka folded before Flop (didn't bet)
Seat 5: Filojoes (button) folded before Flop (didn't bet)
Seat 6: ozone2003 (small blind) folded before Flop
Seat 7: Priidix (big blind) folded before Flop
Seat 8: AlSmithy88 folded before Flop (didn't bet)
Seat 9: Mr.Grigoriy folded before Flop (didn't bet)





PokerStars Hand #154362579948:  Hold'em No Limit ($0.50/$1.00 USD) - 2016/06/06 12:21:35 CET [2016/06/06 6:21:35 ET]
Table 'Irmgard II' 9-max Seat #1 is the button
Seat 1: matiko09 ($196 in chips) 
Seat 2: hammerwife ($116.43 in chips) 
Seat 3: xxxZeka ($102.90 in chips) 
Seat 4: oscarleon ($175.01 in chips) 
Seat 5: Dantist1122 ($104.50 in chips) 
Seat 6: maxxmeister ($185 in chips) 
Seat 7: ghostriderxu ($11.41 in chips) 
Seat 8: Szevasztopol ($100 in chips) 
Seat 9: Filojoes ($138.22 in chips) 
hammerwife: posts small blind $0.50
xxxZeka: posts big blind $1
*** HOLE CARDS ***
Dealt to matiko09 [8d 4h]
oscarleon: folds 
Dantist1122: raises $2 to $3
maxxmeister: folds 
ghostriderxu: raises $8.41 to $11.41 and is all-in
Szevasztopol: folds 
Filojoes: folds 
matiko09: folds 
hammerwife: folds 
xxxZeka: raises $9.59 to $21
Dantist1122: folds 
Uncalled bet ($9.59) returned to xxxZeka
*** FLOP *** [5h 2h 7s]
*** TURN *** [5h 2h 7s] [Kd]
*** RIVER *** [5h 2h 7s Kd] [8c]
*** SHOW DOWN ***
xxxZeka: shows [Qc Jc] (high card King)
ghostriderxu: shows [Jd Jh] (a pair of Jacks)
ghostriderxu collected $25 from pot
*** SUMMARY ***
Total pot $26.32 | Rake $1.32 
Board [5h 2h 7s Kd 8c]
Seat 1: matiko09 (button) folded before Flop (didn't bet)
Seat 2: hammerwife (small blind) folded before Flop
Seat 3: xxxZeka (big blind) showed [Qc Jc] and lost with high card King
Seat 4: oscarleon folded before Flop (didn't bet)
Seat 5: Dantist1122 folded before Flop
Seat 6: maxxmeister folded before Flop (didn't bet)
Seat 7: ghostriderxu showed [Jd Jh] and won ($25) with a pair of Jacks
Seat 8: Szevasztopol folded before Flop (didn't bet)
Seat 9: Filojoes folded before Flop (didn't bet)





PokerStars Hand #154362580907:  Hold'em No Limit (€0.50/€1.00 EUR) - 2016/06/06 12:21:38 CET [2016/06/06 6:21:38 ET]
Table 'Gase' 6-max Seat #2 is the button
Seat 1: jomapel (€100 in chips) 
Seat 2: AngulenUK (€101.50 in chips) 
Seat 3: fun duncan (€107.81 in chips) 
Seat 4: matiko09 (€100 in chips) 
Seat 5: thecurv (€116.67 in chips) 
Seat 6: AlexPles (€101.50 in chips) 
fun duncan: posts small blind €0.50
matiko09: posts big blind €1
*** HOLE CARDS ***
Dealt to matiko09 [8d 7c]
thecurv: folds 
AlexPles: folds 
jomapel: folds 
AngulenUK: folds 
fun duncan: calls €0.50
matiko09: checks 
*** FLOP *** [3c 4d 7d]
fun duncan: checks 
matiko09: bets €1.24
fun duncan: folds 
Uncalled bet (€1.24) returned to matiko09
matiko09 collected €1.90 from pot
matiko09: doesn't show hand 
*** SUMMARY ***
Total pot €2 | Rake €0.10 
Board [3c 4d 7d]
Seat 1: jomapel folded before Flop (didn't bet)
Seat 2: AngulenUK (button) folded before Flop (didn't bet)
Seat 3: fun duncan (small blind) folded on the Flop
Seat 4: matiko09 (big blind) collected (€1.90)
Seat 5: thecurv folded before Flop (didn't bet)
Seat 6: AlexPles folded before Flop (didn't bet)





PokerStars Hand #154362581631:  Hold'em No Limit ($0.50/$1.00 USD) - 2016/06/06 12:21:40 CET [2016/06/06 6:21:40 ET]
Table 'Wezen II' 9-max Seat #9 is the button
Seat 1: matiko09 ($164.47 in chips) 
Seat 2: Mr.Grigoriy ($103.18 in chips) 
Seat 3: oscarleon ($100 in chips) 
Seat 5: rusher_NiNja ($102.72 in chips) 
Seat 6: Szevasztopol ($100 in chips) 
Seat 7: KDJAll3 ($129.52 in chips) 
Seat 8: mavin80 ($165.19 in chips) 
Seat 9: Filojoes ($100.25 in chips) 
matiko09: posts small blind $0.50
Mr.Grigoriy: posts big blind $1
maxxmeister: sits out 
*** HOLE CARDS ***
Dealt to matiko09 [Td 6c]
oscarleon: folds 
rusher_NiNja: raises $1.50 to $2.50
Szevasztopol: folds 
KDJAll3: folds 
mavin80: folds 
Filojoes: folds 
matiko09: folds 
Mr.Grigoriy: folds 
Uncalled bet ($1.50) returned to rusher_NiNja
rusher_NiNja collected $2.50 from pot
rusher_NiNja: doesn't show hand 
*** SUMMARY ***
Total pot $2.50 | Rake $0 
Seat 1: matiko09 (small blind) folded before Flop
Seat 2: Mr.Grigoriy (big blind) folded before Flop
Seat 3: oscarleon folded before Flop (didn't bet)
Seat 5: rusher_NiNja collected ($2.50)
Seat 6: Szevasztopol folded before Flop (didn't bet)
Seat 7: KDJAll3 folded before Flop (didn't bet)
Seat 8: mavin80 folded before Flop (didn't bet)
Seat 9: Filojoes (button) folded before Flop (didn't bet)





PokerStars Hand #154362583232:  Hold'em No Limit ($0.50/$1.00 USD) - 2016/06/06 12:21:44 CET [2016/06/06 6:21:44 ET]
Table 'Gajdariya' 9-max Seat #3 is the button
Seat 1: matiko09 ($101.50 in chips) 
Seat 2: xxxZeka ($131.24 in chips) 
Seat 3: oscarleon ($100 in chips) 
Seat 4: Szevasztopol ($113.77 in chips) 
Seat 5: 147734319 ($100 in chips) 
Seat 6: mono123viva ($72.58 in chips) 
Seat 7: Wombatkilla ($105.68 in chips) 
Seat 9: rusher_NiNja ($142.50 in chips) 
Szevasztopol: posts small blind $0.50
147734319: posts big blind $1
ardo888: sits out 
*** HOLE CARDS ***
Dealt to matiko09 [2c Qs]
mono123viva: folds 
Wombatkilla: raises $2 to $3
rusher_NiNja: folds 
matiko09: folds 
xxxZeka: folds 
oscarleon: folds 
Szevasztopol: folds 
147734319: folds 
Uncalled bet ($2) returned to Wombatkilla
Wombatkilla collected $2.50 from pot
*** SUMMARY ***
Total pot $2.50 | Rake $0 
Seat 1: matiko09 folded before Flop (didn't bet)
Seat 2: xxxZeka folded before Flop (didn't bet)
Seat 3: oscarleon (button) folded before Flop (didn't bet)
Seat 4: Szevasztopol (small blind) folded before Flop
Seat 5: 147734319 (big blind) folded before Flop
Seat 6: mono123viva folded before Flop (didn't bet)
Seat 7: Wombatkilla collected ($2.50)
Seat 9: rusher_NiNja folded before Flop (didn't bet)





PokerStars Hand #154362592157:  Hold'em No Limit ($0.50/$1.00 USD) - 2016/06/06 12:22:07 CET [2016/06/06 6:22:07 ET]
Table 'Williams' 9-max Seat #8 is the button
Seat 1: matiko09 ($195.79 in chips) 
Seat 4: Filojoes ($125.42 in chips) 
Seat 5: ardo888 ($101.50 in chips) 
Seat 6: Priidix ($123.44 in chips) 
Seat 7: kevinho109 ($72.56 in chips) 
Seat 8: oscarleon ($106.24 in chips) 
Seat 9: kind ten ($26.32 in chips) 
kind ten: posts small blind $0.50
matiko09: posts big blind $1
PacPacBum: sits out 
granbunny: sits out 
*** HOLE CARDS ***
Dealt to matiko09 [4d Ac]
Filojoes: raises $2 to $3
ardo888: folds 
Priidix: folds 
kevinho109: folds 
oscarleon: calls $3
kind ten: folds 
matiko09: folds 
*** FLOP *** [5s 3d Ad]
Filojoes: checks 
oscarleon: bets $5
Filojoes: folds 
Uncalled bet ($5) returned to oscarleon
oscarleon collected $7.12 from pot
oscarleon: doesn't show hand 
*** SUMMARY ***
Total pot $7.50 | Rake $0.38 
Board [5s 3d Ad]
Seat 1: matiko09 (big blind) folded before Flop
Seat 4: Filojoes folded on the Flop
Seat 5: ardo888 folded before Flop (didn't bet)
Seat 6: Priidix folded before Flop (didn't bet)
Seat 7: kevinho109 folded before Flop (didn't bet)
Seat 8: oscarleon (button) collected ($7.12)
Seat 9: kind ten (small blind) folded before Flop





PokerStars Hand #154362592892:  Hold'em No Limit ($0.50/$1.00 USD) - 2016/06/06 12:22:08 CET [2016/06/06 6:22:08 ET]
Table 'Wezen II' 9-max Seat #1 is the button
Seat 1: matiko09 ($163.97 in chips) 
Seat 2: Mr.Grigoriy ($102.18 in chips) 
Seat 3: oscarleon ($100 in chips) 
Seat 5: rusher_NiNja ($104.22 in chips) 
Seat 6: Szevasztopol ($100 in chips) 
Seat 7: KDJAll3 ($129.52 in chips) 
Seat 8: mavin80 ($165.19 in chips) 
Seat 9: Filojoes ($100.25 in chips) 
Mr.Grigoriy: posts small blind $0.50
oscarleon: posts big blind $1
maxxmeister: sits out 
*** HOLE CARDS ***
Dealt to matiko09 [9d Ts]
rusher_NiNja: folds 
Szevasztopol: folds 
KDJAll3: folds 
mavin80: raises $1.50 to $2.50
Filojoes: calls $2.50
matiko09: folds 
Mr.Grigoriy: raises $7.50 to $10
oscarleon: folds 
mavin80: folds 
Filojoes: folds 
Uncalled bet ($7.50) returned to Mr.Grigoriy
Mr.Grigoriy collected $8.50 from pot
Mr.Grigoriy: doesn't show hand 
*** SUMMARY ***
Total pot $8.50 | Rake $0 
Seat 1: matiko09 (button) folded before Flop (didn't bet)
Seat 2: Mr.Grigoriy (small blind) collected ($8.50)
Seat 3: oscarleon (big blind) folded before Flop
Seat 5: rusher_NiNja folded before Flop (didn't bet)
Seat 6: Szevasztopol folded before Flop (didn't bet)
Seat 7: KDJAll3 folded before Flop (didn't bet)
Seat 8: mavin80 folded before Flop
Seat 9: Filojoes folded before Flop





PokerStars Hand #154362592968:  Hold'em No Limit (€0.50/€1.00 EUR) - 2016/06/06 12:22:09 CET [2016/06/06 6:22:09 ET]
Table 'Gase' 6-max Seat #3 is the button
Seat 1: jomapel (€100 in chips) 
Seat 2: AngulenUK (€101.50 in chips) 
Seat 3: fun duncan (€106.81 in chips) 
Seat 4: matiko09 (€100.90 in chips) 
Seat 5: thecurv (€116.67 in chips) 
Seat 6: AlexPles (€101.50 in chips) 
matiko09: posts small blind €0.50
thecurv: posts big blind €1
*** HOLE CARDS ***
Dealt to matiko09 [4c Ah]
AlexPles: raises €2 to €3
jomapel: folds 
AngulenUK: folds 
fun duncan: folds 
matiko09: folds 
thecurv: folds 
Uncalled bet (€2) returned to AlexPles
AlexPles collected €2.50 from pot
AlexPles: doesn't show hand 
*** SUMMARY ***
Total pot €2.50 | Rake €0 
Seat 1: jomapel folded before Flop (didn't bet)
Seat 2: AngulenUK folded before Flop (didn't bet)
Seat 3: fun duncan (button) folded before Flop (didn't bet)
Seat 4: matiko09 (small blind) folded before Flop
Seat 5: thecurv (big blind) folded before Flop
Seat 6: AlexPles collected (€2.50)





PokerStars Hand #154362594098:  Hold'em No Limit ($0.50/$1.00 USD) - 2016/06/06 12:22:12 CET [2016/06/06 6:22:12 ET]
Table 'Gajdariya' 9-max Seat #4 is the button
Seat 1: matiko09 ($101.50 in chips) 
Seat 2: xxxZeka ($131.24 in chips) 
Seat 3: oscarleon ($100 in chips) 
Seat 4: Szevasztopol ($113.27 in chips) 
Seat 5: 147734319 ($99 in chips) 
Seat 6: mono123viva ($72.58 in chips) 
Seat 7: Wombatkilla ($107.18 in chips) 
Seat 9: rusher_NiNja ($142.50 in chips) 
147734319: posts small blind $0.50
mono123viva: posts big blind $1
ardo888: sits out 
*** HOLE CARDS ***
Dealt to matiko09 [Jd 4d]
Wombatkilla: folds 
rusher_NiNja: folds 
matiko09: folds 
xxxZeka: folds 
oscarleon: folds 
Szevasztopol: folds 
147734319: raises $1 to $2
mono123viva: calls $1
*** FLOP *** [9d Qh 4s]
147734319: bets $1.90
mono123viva: calls $1.90
*** TURN *** [9d Qh 4s] [8d]
147734319: checks 
mono123viva: bets $4
147734319: calls $4
*** RIVER *** [9d Qh 4s 8d] [Ac]
147734319: checks 
mono123viva: bets $6
147734319: calls $6
*** SHOW DOWN ***
mono123viva: shows [3d 5d] (high card Ace)
147734319: shows [6c Qc] (a pair of Queens)
147734319 collected $26.41 from pot
*** SUMMARY ***
Total pot $27.80 | Rake $1.39 
Board [9d Qh 4s 8d Ac]
Seat 1: matiko09 folded before Flop (didn't bet)
Seat 2: xxxZeka folded before Flop (didn't bet)
Seat 3: oscarleon folded before Flop (didn't bet)
Seat 4: Szevasztopol (button) folded before Flop (didn't bet)
Seat 5: 147734319 (small blind) showed [6c Qc] and won ($26.41) with a pair of Queens
Seat 6: mono123viva (big blind) showed [3d 5d] and lost with high card Ace
Seat 7: Wombatkilla folded before Flop (didn't bet)
Seat 9: rusher_NiNja folded before Flop (didn't bet)





PokerStars Hand #154362595814:  Hold'em No Limit ($0.50/$1.00 USD) - 2016/06/06 12:22:16 CET [2016/06/06 6:22:16 ET]
Table 'Heze' 9-max Seat #6 is the button
Seat 1: matiko09 ($198 in chips) 
Seat 2: oscarleon ($260.81 in chips) 
Seat 3: maxxmeister ($101.50 in chips) 
Seat 4: xxxZeka ($100 in chips) 
Seat 5: Filojoes ($101.74 in chips) 
Seat 6: ozone2003 ($100 in chips) 
Seat 7: Priidix ($100 in chips) 
Seat 8: AlSmithy88 ($61.96 in chips) 
Seat 9: Mr.Grigoriy ($126.74 in chips) 
Priidix: posts small blind $0.50
AlSmithy88: posts big blind $1
*** HOLE CARDS ***
Dealt to matiko09 [8h 4s]
Mr.Grigoriy: raises $2 to $3
matiko09: folds 
oscarleon: folds 
maxxmeister: folds 
xxxZeka: folds 
Filojoes: folds 
ozone2003: folds 
Priidix: folds 
AlSmithy88: folds 
Uncalled bet ($2) returned to Mr.Grigoriy
Mr.Grigoriy collected $2.50 from pot
Mr.Grigoriy: doesn't show hand 
*** SUMMARY ***
Total pot $2.50 | Rake $0 
Seat 1: matiko09 folded before Flop (didn't bet)
Seat 2: oscarleon folded before Flop (didn't bet)
Seat 3: maxxmeister folded before Flop (didn't bet)
Seat 4: xxxZeka folded before Flop (didn't bet)
Seat 5: Filojoes folded before Flop (didn't bet)
Seat 6: ozone2003 (button) folded before Flop (didn't bet)
Seat 7: Priidix (small blind) folded before Flop
Seat 8: AlSmithy88 (big blind) folded before Flop
Seat 9: Mr.Grigoriy collected ($2.50)





PokerStars Hand #154362597120:  Hold'em No Limit (€0.50/€1.00 EUR) - 2016/06/06 12:22:19 CET [2016/06/06 6:22:19 ET]
Table 'Gase' 6-max Seat #4 is the button
Seat 1: jomapel (€100 in chips) 
Seat 2: AngulenUK (€101.50 in chips) 
Seat 3: fun duncan (€106.81 in chips) 
Seat 4: matiko09 (€100.40 in chips) 
Seat 5: thecurv (€115.67 in chips) 
Seat 6: AlexPles (€103 in chips) 
thecurv: posts small blind €0.50
AlexPles: posts big blind €1
*** HOLE CARDS ***
Dealt to matiko09 [Tc Td]
jomapel: folds 
AngulenUK: folds 
fun duncan: folds 
matiko09: raises €1.27 to €2.27
thecurv: folds 
AlexPles: folds 
Uncalled bet (€1.27) returned to matiko09
matiko09 collected €2.50 from pot
matiko09: doesn't show hand 
*** SUMMARY ***
Total pot €2.50 | Rake €0 
Seat 1: jomapel folded before Flop (didn't bet)
Seat 2: AngulenUK folded before Flop (didn't bet)
Seat 3: fun duncan folded before Flop (didn't bet)
Seat 4: matiko09 (button) collected (€2.50)
Seat 5: thecurv (small blind) folded before Flop
Seat 6: AlexPles (big blind) folded before Flop





PokerStars Hand #154362599442:  Hold'em No Limit ($0.50/$1.00 USD) - 2016/06/06 12:22:25 CET [2016/06/06 6:22:25 ET]
Table 'Safara' 9-max Seat #4 is the button
Seat 1: oscarleon ($236.44 in chips) 
Seat 2: Szevasztopol ($100 in chips) 
Seat 4: mattyt212 ($204.80 in chips) 
Seat 5: Dantist1122 ($100 in chips) 
Seat 6: matiko09 ($100 in chips) 
Seat 7: rusher_NiNja ($131.34 in chips) 
Seat 8: Priidix ($101.50 in chips) 
Seat 9: Mr.Grigoriy ($100 in chips) 
Dantist1122: posts small blind $0.50
matiko09: posts big blind $1
ozone2003: sits out 
*** HOLE CARDS ***
Dealt to matiko09 [5h Qc]
rusher_NiNja: raises $1.50 to $2.50
Priidix: folds 
Mr.Grigoriy: folds 
oscarleon: folds 
Szevasztopol: folds 
mattyt212: folds 
Dantist1122: folds 
matiko09: folds 
Uncalled bet ($1.50) returned to rusher_NiNja
rusher_NiNja collected $2.50 from pot
rusher_NiNja: doesn't show hand 
*** SUMMARY ***
Total pot $2.50 | Rake $0 
Seat 1: oscarleon folded before Flop (didn't bet)
Seat 2: Szevasztopol folded before Flop (didn't bet)
Seat 4: mattyt212 (button) folded before Flop (didn't bet)
Seat 5: Dantist1122 (small blind) folded before Flop
Seat 6: matiko09 (big blind) folded before Flop
Seat 7: rusher_NiNja collected ($2.50)
Seat 8: Priidix folded before Flop (didn't bet)
Seat 9: Mr.Grigoriy folded before Flop (didn't bet)





PokerStars Hand #154362604598:  Hold'em No Limit (€0.50/€1.00 EUR) - 2016/06/06 12:22:39 CET [2016/06/06 6:22:39 ET]
Table 'Gase' 6-max Seat #5 is the button
Seat 1: jomapel (€100 in chips) 
Seat 2: AngulenUK (€101.50 in chips) 
Seat 3: fun duncan (€106.81 in chips) 
Seat 4: matiko09 (€101.90 in chips) 
Seat 5: thecurv (€115.17 in chips) 
Seat 6: AlexPles (€102 in chips) 
AlexPles: posts small blind €0.50
jomapel: posts big blind €1
*** HOLE CARDS ***
Dealt to matiko09 [2c Kc]
AngulenUK: folds 
fun duncan: folds 
matiko09: folds 
thecurv: folds 
AlexPles: folds 
Uncalled bet (€0.50) returned to jomapel
jomapel collected €1 from pot
*** SUMMARY ***
Total pot €1 | Rake €0 
Seat 1: jomapel (big blind) collected (€1)
Seat 2: AngulenUK folded before Flop (didn't bet)
Seat 3: fun duncan folded before Flop (didn't bet)
Seat 4: matiko09 folded before Flop (didn't bet)
Seat 5: thecurv (button) folded before Flop (didn't bet)
Seat 6: AlexPles (small blind) folded before Flop





PokerStars Hand #154362608167:  Hold'em No Limit ($0.50/$1.00 USD) - 2016/06/06 12:22:48 CET [2016/06/06 6:22:48 ET]
Table 'Safara' 9-max Seat #5 is the button
Seat 1: oscarleon ($236.44 in chips) 
Seat 2: Szevasztopol ($100 in chips) 
Seat 4: mattyt212 ($204.80 in chips) 
Seat 5: Dantist1122 ($100 in chips) 
Seat 6: matiko09 ($100 in chips) 
Seat 8: Priidix ($101.50 in chips) 
Seat 9: Mr.Grigoriy ($100 in chips) 
matiko09: posts small blind $0.50
rusher_NiNja: is sitting out 
Priidix: posts big blind $1
ozone2003: sits out 
*** HOLE CARDS ***
Dealt to matiko09 [3d 4c]
rusher_NiNja leaves the table
Mr.Grigoriy: folds 
oscarleon: folds 
Szevasztopol: folds 
PacPacBum joins the table at seat #7 
mattyt212: calls $1
Dantist1122: folds 
matiko09: folds 
Priidix: checks 
*** FLOP *** [6d Jh 5s]
Priidix: checks 
mattyt212: checks 
*** TURN *** [6d Jh 5s] [8c]
Priidix: bets $1.50
mattyt212: raises $1.50 to $3
Priidix: folds 
Uncalled bet ($1.50) returned to mattyt212
mattyt212 collected $5.22 from pot
mattyt212: doesn't show hand 
*** SUMMARY ***
Total pot $5.50 | Rake $0.28 
Board [6d Jh 5s 8c]
Seat 1: oscarleon folded before Flop (didn't bet)
Seat 2: Szevasztopol folded before Flop (didn't bet)
Seat 4: mattyt212 collected ($5.22)
Seat 5: Dantist1122 (button) folded before Flop (didn't bet)
Seat 6: matiko09 (small blind) folded before Flop
Seat 8: Priidix (big blind) folded on the Turn
Seat 9: Mr.Grigoriy folded before Flop (didn't bet)





PokerStars Hand #154362608975:  Hold'em No Limit ($0.50/$1.00 USD) - 2016/06/06 12:22:50 CET [2016/06/06 6:22:50 ET]
Table 'Heze' 9-max Seat #7 is the button
Seat 1: matiko09 ($198 in chips) 
Seat 2: oscarleon ($260.81 in chips) 
Seat 3: maxxmeister ($101.50 in chips) 
Seat 4: xxxZeka ($100 in chips) 
Seat 5: Filojoes ($101.74 in chips) 
Seat 6: ozone2003 ($100 in chips) 
Seat 7: Priidix ($100 in chips) 
Seat 8: AlSmithy88 ($60.96 in chips) 
Seat 9: Mr.Grigoriy ($128.24 in chips) 
AlSmithy88: posts small blind $0.50
Mr.Grigoriy: posts big blind $1
*** HOLE CARDS ***
Dealt to matiko09 [Ad Jh]
matiko09: folds 
oscarleon: folds 
maxxmeister: folds 
xxxZeka: folds 
Filojoes: folds 
ozone2003: raises $1.50 to $2.50
Priidix: folds 
AlSmithy88: folds 
Mr.Grigoriy: folds 
Uncalled bet ($1.50) returned to ozone2003
ozone2003 collected $2.50 from pot
ozone2003: doesn't show hand 
*** SUMMARY ***
Total pot $2.50 | Rake $0 
Seat 1: matiko09 folded before Flop (didn't bet)
Seat 2: oscarleon folded before Flop (didn't bet)
Seat 3: maxxmeister folded before Flop (didn't bet)
Seat 4: xxxZeka folded before Flop (didn't bet)
Seat 5: Filojoes folded before Flop (didn't bet)
Seat 6: ozone2003 collected ($2.50)
Seat 7: Priidix (button) folded before Flop (didn't bet)
Seat 8: AlSmithy88 (small blind) folded before Flop
Seat 9: Mr.Grigoriy (big blind) folded before Flop





PokerStars Hand #154362609241:  Hold'em No Limit ($0.50/$1.00 USD) - 2016/06/06 12:22:51 CET [2016/06/06 6:22:51 ET]
Table 'Irmgard II' 9-max Seat #2 is the button
Seat 1: matiko09 ($196 in chips) 
Seat 2: hammerwife ($115.93 in chips) 
Seat 3: xxxZeka ($100 in chips) 
Seat 4: oscarleon ($175.01 in chips) 
Seat 5: Dantist1122 ($101.50 in chips) 
Seat 6: maxxmeister ($185 in chips) 
Seat 7: ghostriderxu ($25 in chips) 
Seat 8: Szevasztopol ($100 in chips) 
Seat 9: Filojoes ($138.22 in chips) 
xxxZeka: posts small blind $0.50
oscarleon: posts big blind $1
*** HOLE CARDS ***
Dealt to matiko09 [Kh Kc]
Dantist1122: folds 
maxxmeister: raises $2.50 to $3.50
ghostriderxu: folds 
Szevasztopol: folds 
Filojoes: folds 
matiko09: raises $7.50 to $11
hammerwife: folds 
xxxZeka: folds 
oscarleon: folds 
maxxmeister: raises $16.50 to $27.50
matiko09: calls $16.50
*** FLOP *** [8c Td 3c]
maxxmeister: bets $22
matiko09: calls $22
*** TURN *** [8c Td 3c] [7h]
maxxmeister: bets $44
matiko09: folds 
Uncalled bet ($44) returned to maxxmeister
maxxmeister collected $98 from pot
maxxmeister: doesn't show hand 
*** SUMMARY ***
Total pot $100.50 | Rake $2.50 
Board [8c Td 3c 7h]
Seat 1: matiko09 folded on the Turn
Seat 2: hammerwife (button) folded before Flop (didn't bet)
Seat 3: xxxZeka (small blind) folded before Flop
Seat 4: oscarleon (big blind) folded before Flop
Seat 5: Dantist1122 folded before Flop (didn't bet)
Seat 6: maxxmeister collected ($98)
Seat 7: ghostriderxu folded before Flop (didn't bet)
Seat 8: Szevasztopol folded before Flop (didn't bet)
Seat 9: Filojoes folded before Flop (didn't bet)





PokerStars Hand #154362610579:  Hold'em No Limit ($0.50/$1.00 USD) - 2016/06/06 12:22:54 CET [2016/06/06 6:22:54 ET]
Table 'Williams' 9-max Seat #9 is the button
Seat 1: matiko09 ($194.79 in chips) 
Seat 2: PacPacBum ($100 in chips) 
Seat 4: Filojoes ($122.42 in chips) 
Seat 5: ardo888 ($101.50 in chips) 
Seat 6: Priidix ($123.44 in chips) 
Seat 7: kevinho109 ($72.56 in chips) 
Seat 8: oscarleon ($110.36 in chips) 
Seat 9: kind ten ($25.82 in chips) 
matiko09: posts small blind $0.50
PacPacBum: posts big blind $1
granbunny: sits out 
*** HOLE CARDS ***
Dealt to matiko09 [3s Ts]
Filojoes: folds 
ardo888: folds 
Priidix: folds 
kevinho109: folds 
oscarleon: raises $2 to $3
kind ten: folds 
matiko09: folds 
PacPacBum: folds 
Uncalled bet ($2) returned to oscarleon
oscarleon collected $2.50 from pot
oscarleon: doesn't show hand 
*** SUMMARY ***
Total pot $2.50 | Rake $0 
Seat 1: matiko09 (small blind) folded before Flop
Seat 2: PacPacBum (big blind) folded before Flop
Seat 4: Filojoes folded before Flop (didn't bet)
Seat 5: ardo888 folded before Flop (didn't bet)
Seat 6: Priidix folded before Flop (didn't bet)
Seat 7: kevinho109 folded before Flop (didn't bet)
Seat 8: oscarleon collected ($2.50)
Seat 9: kind ten (button) folded before Flop (didn't bet)





PokerStars Hand #154362613062:  Hold'em No Limit (€0.50/€1.00 EUR) - 2016/06/06 12:23:01 CET [2016/06/06 6:23:01 ET]
Table 'Gase' 6-max Seat #6 is the button
Seat 1: jomapel (€100.50 in chips) 
Seat 2: AngulenUK (€101.50 in chips) 
Seat 3: fun duncan (€106.81 in chips) 
Seat 4: matiko09 (€101.90 in chips) 
Seat 5: thecurv (€115.17 in chips) 
Seat 6: AlexPles (€101.50 in chips) 
jomapel: posts small blind €0.50
AngulenUK: posts big blind €1
*** HOLE CARDS ***
Dealt to matiko09 [2d Js]
fun duncan: folds 
matiko09: folds 
fun duncan leaves the table
thecurv: folds 
AlexPles: folds 
jomapel: folds 
Uncalled bet (€0.50) returned to AngulenUK
AngulenUK collected €1 from pot
AngulenUK: doesn't show hand 
*** SUMMARY ***
Total pot €1 | Rake €0 
Seat 1: jomapel (small blind) folded before Flop
Seat 2: AngulenUK (big blind) collected (€1)
Seat 3: fun duncan folded before Flop (didn't bet)
Seat 4: matiko09 folded before Flop (didn't bet)
Seat 5: thecurv folded before Flop (didn't bet)
Seat 6: AlexPles (button) folded before Flop (didn't bet)





PokerStars Hand #154362616271:  Hold'em No Limit ($0.50/$1.00 USD) - 2016/06/06 12:23:09 CET [2016/06/06 6:23:09 ET]
Table 'Wezen II' 9-max Seat #2 is the button
Seat 1: matiko09 ($163.97 in chips) 
Seat 2: Mr.Grigoriy ($108.18 in chips) 
Seat 3: oscarleon ($100 in chips) 
Seat 4: maxxmeister ($100 in chips) 
Seat 5: rusher_NiNja ($104.22 in chips) 
Seat 6: Szevasztopol ($100 in chips) 
Seat 7: KDJAll3 ($129.52 in chips) 
Seat 8: mavin80 ($162.69 in chips) 
Seat 9: Filojoes ($100 in chips) 
oscarleon: posts small blind $0.50
maxxmeister: posts big blind $1
*** HOLE CARDS ***
Dealt to matiko09 [9d Ad]
rusher_NiNja: folds 
Szevasztopol: folds 
KDJAll3: folds 
mavin80: raises $1.50 to $2.50
Filojoes: calls $2.50
matiko09 has timed out
matiko09: folds 
Mr.Grigoriy: folds 
oscarleon: folds 
maxxmeister: folds 
*** FLOP *** [3h Qd Qs]
mavin80: checks 
Filojoes: bets $3.71
mavin80: calls $3.71
*** TURN *** [3h Qd Qs] [7h]
mavin80: checks 
Filojoes: bets $9
mavin80: folds 
Uncalled bet ($9) returned to Filojoes
Filojoes collected $13.22 from pot
Filojoes: doesn't show hand 
*** SUMMARY ***
Total pot $13.92 | Rake $0.70 
Board [3h Qd Qs 7h]
Seat 1: matiko09 folded before Flop (didn't bet)
Seat 2: Mr.Grigoriy (button) folded before Flop (didn't bet)
Seat 3: oscarleon (small blind) folded before Flop
Seat 4: maxxmeister (big blind) folded before Flop
Seat 5: rusher_NiNja folded before Flop (didn't bet)
Seat 6: Szevasztopol folded before Flop (didn't bet)
Seat 7: KDJAll3 folded before Flop (didn't bet)
Seat 8: mavin80 folded on the Turn
Seat 9: Filojoes collected ($13.22)





PokerStars Hand #154362619112:  Hold'em No Limit ($0.50/$1.00 USD) - 2016/06/06 12:23:16 CET [2016/06/06 6:23:16 ET]
Table 'Gajdariya' 9-max Seat #5 is the button
Seat 1: matiko09 ($101.50 in chips) 
Seat 2: xxxZeka ($131.24 in chips) 
Seat 3: oscarleon ($100 in chips) 
Seat 4: Szevasztopol ($113.27 in chips) 
Seat 5: 147734319 ($111.51 in chips) 
Seat 6: mono123viva ($58.68 in chips) 
Seat 7: Wombatkilla ($107.18 in chips) 
Seat 9: rusher_NiNja ($142.50 in chips) 
mono123viva: posts small blind $0.50
Wombatkilla: posts big blind $1
ardo888: sits out 
*** HOLE CARDS ***
Dealt to matiko09 [6h Jc]
rusher_NiNja: folds 
matiko09: folds 
xxxZeka: raises $2 to $3
oscarleon: folds 
Szevasztopol: folds 
147734319: folds 
mono123viva: calls $2.50
Wombatkilla: calls $2
*** FLOP *** [Jh 7d 3s]
mono123viva: checks 
Wombatkilla: checks 
xxxZeka: checks 
*** TURN *** [Jh 7d 3s] [4c]
mono123viva: bets $4
Wombatkilla: calls $4
xxxZeka: folds 
*** RIVER *** [Jh 7d 3s 4c] [7h]
mono123viva: bets $9
Wombatkilla: calls $9
*** SHOW DOWN ***
mono123viva: shows [4s 4h] (a full house, Fours full of Sevens)
Wombatkilla: mucks hand 
mono123viva collected $33.25 from pot
*** SUMMARY ***
Total pot $35 | Rake $1.75 
Board [Jh 7d 3s 4c 7h]
Seat 1: matiko09 folded before Flop (didn't bet)
Seat 2: xxxZeka folded on the Turn
Seat 3: oscarleon folded before Flop (didn't bet)
Seat 4: Szevasztopol folded before Flop (didn't bet)
Seat 5: 147734319 (button) folded before Flop (didn't bet)
Seat 6: mono123viva (small blind) showed [4s 4h] and won ($33.25) with a full house, Fours full of Sevens
Seat 7: Wombatkilla (big blind) mucked [Jd Qs]
Seat 9: rusher_NiNja folded before Flop (didn't bet)





PokerStars Hand #154362620022:  Hold'em No Limit ($0.50/$1.00 USD) - 2016/06/06 12:23:18 CET [2016/06/06 6:23:18 ET]
Table 'Heze' 9-max Seat #8 is the button
Seat 1: matiko09 ($198 in chips) 
Seat 2: oscarleon ($260.81 in chips) 
Seat 3: maxxmeister ($101.50 in chips) 
Seat 4: xxxZeka ($100 in chips) 
Seat 5: Filojoes ($101.74 in chips) 
Seat 6: ozone2003 ($101.50 in chips) 
Seat 7: Priidix ($100 in chips) 
Seat 8: AlSmithy88 ($60.46 in chips) 
Seat 9: Mr.Grigoriy ($127.24 in chips) 
Mr.Grigoriy: posts small blind $0.50
matiko09: posts big blind $1
*** HOLE CARDS ***
Dealt to matiko09 [8s 9c]
oscarleon: folds 
maxxmeister: folds 
xxxZeka: folds 
Filojoes: folds 
ozone2003: folds 
Priidix: folds 
AlSmithy88: folds 
Mr.Grigoriy: folds 
Uncalled bet ($0.50) returned to matiko09
matiko09 collected $1 from pot
matiko09: doesn't show hand 
*** SUMMARY ***
Total pot $1 | Rake $0 
Seat 1: matiko09 (big blind) collected ($1)
Seat 2: oscarleon folded before Flop (didn't bet)
Seat 3: maxxmeister folded before Flop (didn't bet)
Seat 4: xxxZeka folded before Flop (didn't bet)
Seat 5: Filojoes folded before Flop (didn't bet)
Seat 6: ozone2003 folded before Flop (didn't bet)
Seat 7: Priidix folded before Flop (didn't bet)
Seat 8: AlSmithy88 (button) folded before Flop (didn't bet)
Seat 9: Mr.Grigoriy (small blind) folded before Flop





PokerStars Hand #154362621873:  Hold'em No Limit ($0.50/$1.00 USD) - 2016/06/06 12:23:23 CET [2016/06/06 6:23:23 ET]
Table 'Williams' 9-max Seat #1 is the button
Seat 1: matiko09 ($194.29 in chips) 
Seat 2: PacPacBum ($100 in chips) 
Seat 3: granbunny ($69.58 in chips) 
Seat 4: Filojoes ($122.42 in chips) 
Seat 5: ardo888 ($101.50 in chips) 
Seat 6: Priidix ($123.44 in chips) 
Seat 7: kevinho109 ($72.56 in chips) 
Seat 8: oscarleon ($111.86 in chips) 
Seat 9: kind ten ($25.82 in chips) 
PacPacBum: posts small blind $0.50
granbunny: posts big blind $1
*** HOLE CARDS ***
Dealt to matiko09 [3h 6s]
Filojoes: folds 
ardo888: folds 
Priidix: folds 
kevinho109: folds 
oscarleon: folds 
kind ten: folds 
matiko09: folds 
PacPacBum: raises $1.04 to $2.04
granbunny: calls $1.04
*** FLOP *** [Ad Ac 7h]
PacPacBum: bets $2.09
granbunny: calls $2.09
*** TURN *** [Ad Ac 7h] [Qs]
PacPacBum: checks 
granbunny: checks 
*** RIVER *** [Ad Ac 7h Qs] [3c]
PacPacBum: bets $4.23
granbunny: calls $4.23
*** SHOW DOWN ***
PacPacBum: shows [7d Qd] (two pair, Aces and Queens)
granbunny: shows [9d Ah] (three of a kind, Aces)
granbunny collected $15.88 from pot
*** SUMMARY ***
Total pot $16.72 | Rake $0.84 
Board [Ad Ac 7h Qs 3c]
Seat 1: matiko09 (button) folded before Flop (didn't bet)
Seat 2: PacPacBum (small blind) showed [7d Qd] and lost with two pair, Aces and Queens
Seat 3: granbunny (big blind) showed [9d Ah] and won ($15.88) with three of a kind, Aces
Seat 4: Filojoes folded before Flop (didn't bet)
Seat 5: ardo888 folded before Flop (didn't bet)
Seat 6: Priidix folded before Flop (didn't bet)
Seat 7: kevinho109 folded before Flop (didn't bet)
Seat 8: oscarleon folded before Flop (didn't bet)
Seat 9: kind ten folded before Flop (didn't bet)





PokerStars Hand #154362628848:  Hold'em No Limit (€0.50/€1.00 EUR) - 2016/06/06 12:23:41 CET [2016/06/06 6:23:41 ET]
Table 'Gase' 6-max Seat #1 is the button
Seat 1: jomapel (€100 in chips) 
Seat 2: AngulenUK (€102 in chips) 
Seat 4: matiko09 (€101.90 in chips) 
Seat 5: thecurv (€115.17 in chips) 
Seat 6: AlexPles (€101.50 in chips) 
AngulenUK: posts small blind €0.50
matiko09: posts big blind €1
*** HOLE CARDS ***
Dealt to matiko09 [Qs Qd]
thecurv: folds 
AlexPles: raises €2 to €3
jomapel: folds 
AngulenUK: folds 
matiko09: raises €7 to €10
AlexPles: calls €7
*** FLOP *** [Ts 8s Jd]
matiko09: checks 
AlexPles: bets €12.86
matiko09: calls €12.86
*** TURN *** [Ts 8s Jd] [6c]
matiko09: checks 
AlexPles: bets €29.31
matiko09: calls €29.31
*** RIVER *** [Ts 8s Jd 6c] [8c]
matiko09: checks 
AlexPles: checks 
*** SHOW DOWN ***
matiko09: shows [Qs Qd] (two pair, Queens and Eights)
AlexPles: mucks hand 
matiko09 collected €102.59 from pot
*** SUMMARY ***
Total pot €104.84 | Rake €2.25 
Board [Ts 8s Jd 6c 8c]
Seat 1: jomapel (button) folded before Flop (didn't bet)
Seat 2: AngulenUK (small blind) folded before Flop
Seat 4: matiko09 (big blind) showed [Qs Qd] and won (€102.59) with two pair, Queens and Eights
Seat 5: thecurv folded before Flop (didn't bet)
Seat 6: AlexPles mucked [Qh Ac]





PokerStars Hand #154362630356:  Hold'em No Limit ($0.50/$1.00 USD) - 2016/06/06 12:23:45 CET [2016/06/06 6:23:45 ET]
Table 'Heze' 9-max Seat #9 is the button
Seat 1: matiko09 ($198.50 in chips) 
Seat 2: oscarleon ($260.81 in chips) 
Seat 3: maxxmeister ($101.50 in chips) 
Seat 4: xxxZeka ($100 in chips) 
Seat 5: Filojoes ($101.74 in chips) 
Seat 6: ozone2003 ($101.50 in chips) 
Seat 7: Priidix ($100 in chips) 
Seat 8: AlSmithy88 ($60.46 in chips) 
Seat 9: Mr.Grigoriy ($126.74 in chips) 
matiko09: posts small blind $0.50
oscarleon: posts big blind $1
*** HOLE CARDS ***
Dealt to matiko09 [7h 3h]
maxxmeister: folds 
xxxZeka: folds 
Filojoes: folds 
ozone2003: folds 
Priidix: folds 
AlSmithy88: calls $1
Mr.Grigoriy: raises $3 to $4
matiko09: folds 
oscarleon: folds 
AlSmithy88: calls $3
*** FLOP *** [6c As 3c]
AlSmithy88: checks 
Mr.Grigoriy: bets $6.04
AlSmithy88: folds 
Uncalled bet ($6.04) returned to Mr.Grigoriy
Mr.Grigoriy collected $9.02 from pot
Mr.Grigoriy: doesn't show hand 
*** SUMMARY ***
Total pot $9.50 | Rake $0.48 
Board [6c As 3c]
Seat 1: matiko09 (small blind) folded before Flop
Seat 2: oscarleon (big blind) folded before Flop
Seat 3: maxxmeister folded before Flop (didn't bet)
Seat 4: xxxZeka folded before Flop (didn't bet)
Seat 5: Filojoes folded before Flop (didn't bet)
Seat 6: ozone2003 folded before Flop (didn't bet)
Seat 7: Priidix folded before Flop (didn't bet)
Seat 8: AlSmithy88 folded on the Flop
Seat 9: Mr.Grigoriy (button) collected ($9.02)





PokerStars Hand #154362636016:  Hold'em No Limit ($0.50/$1.00 USD) - 2016/06/06 12:24:00 CET [2016/06/06 6:24:00 ET]
Table 'Safara' 9-max Seat #6 is the button
Seat 1: oscarleon ($236.44 in chips) 
Seat 2: Szevasztopol ($100 in chips) 
Seat 4: mattyt212 ($207.52 in chips) 
Seat 5: Dantist1122 ($100 in chips) 
Seat 6: matiko09 ($100 in chips) 
Seat 8: Priidix ($100 in chips) 
Seat 9: Mr.Grigoriy ($100 in chips) 
PacPacBum will be allowed to play after the button
Priidix: posts small blind $0.50
Mr.Grigoriy: posts big blind $1
ozone2003: sits out 
*** HOLE CARDS ***
Dealt to matiko09 [4s 9d]
oscarleon: folds 
Szevasztopol: folds 
mattyt212: folds 
Dantist1122: folds 
matiko09: folds 
Priidix: folds 
Uncalled bet ($0.50) returned to Mr.Grigoriy
Mr.Grigoriy collected $1 from pot
Mr.Grigoriy: doesn't show hand 
*** SUMMARY ***
Total pot $1 | Rake $0 
Seat 1: oscarleon folded before Flop (didn't bet)
Seat 2: Szevasztopol folded before Flop (didn't bet)
Seat 4: mattyt212 folded before Flop (didn't bet)
Seat 5: Dantist1122 folded before Flop (didn't bet)
Seat 6: matiko09 (button) folded before Flop (didn't bet)
Seat 8: Priidix (small blind) folded before Flop
Seat 9: Mr.Grigoriy (big blind) collected ($1)





PokerStars Hand #154362642437:  Hold'em No Limit ($0.50/$1.00 USD) - 2016/06/06 12:24:16 CET [2016/06/06 6:24:16 ET]
Table 'Yarilo' 9-max Seat #6 is the button
Seat 1: xxxZeka ($100 in chips) 
Seat 2: thecurv ($108.32 in chips) 
Seat 3: matiko09 ($112.42 in chips) 
Seat 4: riggedsh** ($120.92 in chips) 
Seat 5: Szevasztopol ($137.19 in chips) 
Seat 6: maxxmeister ($100 in chips) 
Seat 7: KEBIN1974 ($100 in chips) 
Seat 8: Mr.Grigoriy ($155.17 in chips) 
Seat 9: Filojoes ($102.48 in chips) 
KEBIN1974: posts small blind $0.50
Mr.Grigoriy: posts big blind $1
*** HOLE CARDS ***
Dealt to matiko09 [2s 2c]
Filojoes: folds 
xxxZeka: folds 
thecurv: calls $1
matiko09: folds 
riggedsh**: raises $2.50 to $3.50
Szevasztopol: folds 
maxxmeister: folds 
KEBIN1974: folds 
Mr.Grigoriy: folds 
thecurv: calls $2.50
*** FLOP *** [4d Ac Ad]
thecurv: checks 
riggedsh**: bets $4.04
thecurv: calls $4.04
*** TURN *** [4d Ac Ad] [8h]
thecurv: checks 
riggedsh**: checks 
*** RIVER *** [4d Ac Ad 8h] [6s]
thecurv: bets $12.50
riggedsh**: folds 
Uncalled bet ($12.50) returned to thecurv
thecurv collected $15.75 from pot
thecurv: doesn't show hand 
*** SUMMARY ***
Total pot $16.58 | Rake $0.83 
Board [4d Ac Ad 8h 6s]
Seat 1: xxxZeka folded before Flop (didn't bet)
Seat 2: thecurv collected ($15.75)
Seat 3: matiko09 folded before Flop (didn't bet)
Seat 4: riggedsh** folded on the River
Seat 5: Szevasztopol folded before Flop (didn't bet)
Seat 6: maxxmeister (button) folded before Flop (didn't bet)
Seat 7: KEBIN1974 (small blind) folded before Flop
Seat 8: Mr.Grigoriy (big blind) folded before Flop
Seat 9: Filojoes folded before Flop (didn't bet)





PokerStars Hand #154362642993:  Hold'em No Limit ($0.50/$1.00 USD) - 2016/06/06 12:24:18 CET [2016/06/06 6:24:18 ET]
Table 'Williams' 9-max Seat #2 is the button
Seat 1: matiko09 ($194.29 in chips) 
Seat 2: PacPacBum ($100 in chips) 
Seat 3: granbunny ($77.10 in chips) 
Seat 4: Filojoes ($122.42 in chips) 
Seat 5: ardo888 ($101.50 in chips) 
Seat 6: Priidix ($123.44 in chips) 
Seat 7: kevinho109 ($72.56 in chips) 
Seat 8: oscarleon ($111.86 in chips) 
Seat 9: kind ten ($25.82 in chips) 
granbunny: posts small blind $0.50
Filojoes: posts big blind $1
*** HOLE CARDS ***
Dealt to matiko09 [9h 4h]
ardo888: raises $2 to $3
Priidix: folds 
kevinho109: folds 
oscarleon: folds 
kind ten: folds 
matiko09: folds 
PacPacBum: folds 
granbunny: folds 
Filojoes: folds 
Uncalled bet ($2) returned to ardo888
ardo888 collected $2.50 from pot
ardo888: doesn't show hand 
*** SUMMARY ***
Total pot $2.50 | Rake $0 
Seat 1: matiko09 folded before Flop (didn't bet)
Seat 2: PacPacBum (button) folded before Flop (didn't bet)
Seat 3: granbunny (small blind) folded before Flop
Seat 4: Filojoes (big blind) folded before Flop
Seat 5: ardo888 collected ($2.50)
Seat 6: Priidix folded before Flop (didn't bet)
Seat 7: kevinho109 folded before Flop (didn't bet)
Seat 8: oscarleon folded before Flop (didn't bet)
Seat 9: kind ten folded before Flop (didn't bet)





PokerStars Hand #154362644296:  Hold'em No Limit ($0.50/$1.00 USD) - 2016/06/06 12:24:21 CET [2016/06/06 6:24:21 ET]
Table 'Irmgard II' 9-max Seat #3 is the button
Seat 1: matiko09 ($146.50 in chips) 
Seat 2: hammerwife ($115.93 in chips) 
Seat 3: xxxZeka ($100 in chips) 
Seat 4: oscarleon ($174.01 in chips) 
Seat 5: Dantist1122 ($101.50 in chips) 
Seat 6: maxxmeister ($233.50 in chips) 
Seat 7: ghostriderxu ($25 in chips) 
Seat 8: Szevasztopol ($100 in chips) 
Seat 9: Filojoes ($138.22 in chips) 
oscarleon: posts small blind $0.50
Dantist1122: posts big blind $1
*** HOLE CARDS ***
Dealt to matiko09 [Ks Ad]
maxxmeister: folds 
ghostriderxu: folds 
Szevasztopol: folds 
Filojoes: folds 
matiko09: raises $2 to $3
hammerwife: folds 
xxxZeka: folds 
oscarleon: folds 
Dantist1122: folds 
Uncalled bet ($2) returned to matiko09
matiko09 collected $2.50 from pot
matiko09: doesn't show hand 
*** SUMMARY ***
Total pot $2.50 | Rake $0 
Seat 1: matiko09 collected ($2.50)
Seat 2: hammerwife folded before Flop (didn't bet)
Seat 3: xxxZeka (button) folded before Flop (didn't bet)
Seat 4: oscarleon (small blind) folded before Flop
Seat 5: Dantist1122 (big blind) folded before Flop
Seat 6: maxxmeister folded before Flop (didn't bet)
Seat 7: ghostriderxu folded before Flop (didn't bet)
Seat 8: Szevasztopol folded before Flop (didn't bet)
Seat 9: Filojoes folded before Flop (didn't bet)





PokerStars Hand #154362647052:  Hold'em No Limit (€0.50/€1.00 EUR) - 2016/06/06 12:24:28 CET [2016/06/06 6:24:28 ET]
Table 'Gase' 6-max Seat #2 is the button
Seat 1: jomapel (€100 in chips) 
Seat 2: AngulenUK (€101.50 in chips) 
Seat 4: matiko09 (€152.32 in chips) 
matiko09: posts small blind €0.50
thecurv: is sitting out 
thecurv leaves the table
AlexPles: is sitting out 
jomapel: posts big blind €1
*** HOLE CARDS ***
Dealt to matiko09 [7h 9d]
AlexPles leaves the table
AngulenUK: folds 
matiko09: folds 
Uncalled bet (€0.50) returned to jomapel
jomapel collected €1 from pot
*** SUMMARY ***
Total pot €1 | Rake €0 
Seat 1: jomapel (big blind) collected (€1)
Seat 2: AngulenUK (button) folded before Flop (didn't bet)
Seat 4: matiko09 (small blind) folded before Flop





PokerStars Hand #154362649939:  Hold'em No Limit ($0.50/$1.00 USD) - 2016/06/06 12:24:35 CET [2016/06/06 6:24:35 ET]
Table 'Gajdariya' 9-max Seat #6 is the button
Seat 1: matiko09 ($101.50 in chips) 
Seat 2: xxxZeka ($128.24 in chips) 
Seat 3: oscarleon ($100 in chips) 
Seat 4: Szevasztopol ($113.27 in chips) 
Seat 5: 147734319 ($111.51 in chips) 
Seat 6: mono123viva ($75.93 in chips) 
Seat 7: Wombatkilla ($91.18 in chips) 
Seat 8: ardo888 ($100 in chips) 
Seat 9: rusher_NiNja ($142.50 in chips) 
Wombatkilla: posts small blind $0.50
ardo888: posts big blind $1
*** HOLE CARDS ***
Dealt to matiko09 [Kh 4c]
rusher_NiNja: folds 
matiko09: folds 
xxxZeka: folds 
oscarleon: folds 
Szevasztopol: folds 
147734319: folds 
mono123viva: raises $2 to $3
Wombatkilla: folds 
ardo888: raises $7 to $10
mono123viva: calls $7
*** FLOP *** [5s Ad 6c]
ardo888: bets $7.12
mono123viva: calls $7.12
*** TURN *** [5s Ad 6c] [7s]
ardo888: bets $21.45
mono123viva: calls $21.45
*** RIVER *** [5s Ad 6c 7s] [8d]
ardo888: bets $57.10
mono123viva: calls $37.36 and is all-in
Uncalled bet ($19.74) returned to ardo888
*** SHOW DOWN ***
ardo888: shows [Ks Ah] (a pair of Aces)
mono123viva: shows [9d Kd] (a straight, Five to Nine)
mono123viva collected $149.86 from pot
*** SUMMARY ***
Total pot $152.36 | Rake $2.50 
Board [5s Ad 6c 7s 8d]
Seat 1: matiko09 folded before Flop (didn't bet)
Seat 2: xxxZeka folded before Flop (didn't bet)
Seat 3: oscarleon folded before Flop (didn't bet)
Seat 4: Szevasztopol folded before Flop (didn't bet)
Seat 5: 147734319 folded before Flop (didn't bet)
Seat 6: mono123viva (button) showed [9d Kd] and won ($149.86) with a straight, Five to Nine
Seat 7: Wombatkilla (small blind) folded before Flop
Seat 8: ardo888 (big blind) showed [Ks Ah] and lost with a pair of Aces
Seat 9: rusher_NiNja folded before Flop (didn't bet)





PokerStars Hand #154362651024:  Hold'em No Limit ($0.50/$1.00 USD) - 2016/06/06 12:24:38 CET [2016/06/06 6:24:38 ET]
Table 'Safara' 9-max Seat #8 is the button
Seat 1: oscarleon ($236.44 in chips) 
Seat 2: Szevasztopol ($100 in chips) 
Seat 4: mattyt212 ($207.52 in chips) 
Seat 5: Dantist1122 ($100 in chips) 
Seat 6: matiko09 ($100 in chips) 
Seat 8: Priidix ($100 in chips) 
Seat 9: Mr.Grigoriy ($100.50 in chips) 
Mr.Grigoriy: posts small blind $0.50
oscarleon: posts big blind $1
ozone2003: sits out 
PacPacBum: sits out 
*** HOLE CARDS ***
Dealt to matiko09 [9h 3s]
Szevasztopol: folds 
mattyt212: calls $1
Dantist1122: folds 
matiko09: folds 
Priidix: folds 
Mr.Grigoriy: calls $0.50
oscarleon: checks 
*** FLOP *** [8c 2d 5s]
Mr.Grigoriy: checks 
oscarleon: checks 
mattyt212: checks 
*** TURN *** [8c 2d 5s] [7h]
Mr.Grigoriy: bets $2.02
oscarleon: folds 
mattyt212: calls $2.02
*** RIVER *** [8c 2d 5s 7h] [Jc]
Mr.Grigoriy: bets $4.75
mattyt212: folds 
Uncalled bet ($4.75) returned to Mr.Grigoriy
Mr.Grigoriy collected $6.69 from pot
Mr.Grigoriy: doesn't show hand 
*** SUMMARY ***
Total pot $7.04 | Rake $0.35 
Board [8c 2d 5s 7h Jc]
Seat 1: oscarleon (big blind) folded on the Turn
Seat 2: Szevasztopol folded before Flop (didn't bet)
Seat 4: mattyt212 folded on the River
Seat 5: Dantist1122 folded before Flop (didn't bet)
Seat 6: matiko09 folded before Flop (didn't bet)
Seat 8: Priidix (button) folded before Flop (didn't bet)
Seat 9: Mr.Grigoriy (small blind) collected ($6.69)





PokerStars Hand #154362653728:  Hold'em No Limit ($0.50/$1.00 USD) - 2016/06/06 12:24:45 CET [2016/06/06 6:24:45 ET]
Table 'Heze' 9-max Seat #1 is the button
Seat 1: matiko09 ($198 in chips) 
Seat 2: oscarleon ($259.81 in chips) 
Seat 3: maxxmeister ($101.50 in chips) 
Seat 4: xxxZeka ($100 in chips) 
Seat 5: Filojoes ($101.74 in chips) 
Seat 6: ozone2003 ($101.50 in chips) 
Seat 7: Priidix ($100 in chips) 
Seat 8: AlSmithy88 ($56.46 in chips) 
Seat 9: Mr.Grigoriy ($131.76 in chips) 
oscarleon: posts small blind $0.50
maxxmeister: posts big blind $1
*** HOLE CARDS ***
Dealt to matiko09 [3s Ks]
xxxZeka: folds 
Filojoes: folds 
ozone2003: folds 
Priidix: folds 
AlSmithy88: calls $1
Mr.Grigoriy: calls $1
matiko09: calls $1
oscarleon: folds 
maxxmeister: checks 
*** FLOP *** [6c Kc 9s]
maxxmeister: checks 
AlSmithy88: checks 
Mr.Grigoriy: checks 
matiko09: bets $2.78
maxxmeister: calls $2.78
AlSmithy88: calls $2.78
Mr.Grigoriy: folds 
*** TURN *** [6c Kc 9s] [Kd]
maxxmeister: checks 
AlSmithy88: checks 
matiko09: bets $6.34
maxxmeister: calls $6.34
AlSmithy88: calls $6.34
*** RIVER *** [6c Kc 9s Kd] [Qd]
maxxmeister: checks 
AlSmithy88: checks 
matiko09: checks 
*** SHOW DOWN ***
maxxmeister: shows [9h 2c] (two pair, Kings and Nines)
AlSmithy88: mucks hand 
matiko09: shows [3s Ks] (three of a kind, Kings)
matiko09 collected $30.27 from pot
*** SUMMARY ***
Total pot $31.86 | Rake $1.59 
Board [6c Kc 9s Kd Qd]
Seat 1: matiko09 (button) showed [3s Ks] and won ($30.27) with three of a kind, Kings
Seat 2: oscarleon (small blind) folded before Flop
Seat 3: maxxmeister (big blind) showed [9h 2c] and lost with two pair, Kings and Nines
Seat 4: xxxZeka folded before Flop (didn't bet)
Seat 5: Filojoes folded before Flop (didn't bet)
Seat 6: ozone2003 folded before Flop (didn't bet)
Seat 7: Priidix folded before Flop (didn't bet)
Seat 8: AlSmithy88 mucked [8c 7c]
Seat 9: Mr.Grigoriy folded on the Flop





PokerStars Hand #154362657859:  Hold'em No Limit ($0.50/$1.00 USD) - 2016/06/06 12:24:56 CET [2016/06/06 6:24:56 ET]
Table 'Irmgard II' 9-max Seat #4 is the button
Seat 1: matiko09 ($148 in chips) 
Seat 2: hammerwife ($115.93 in chips) 
Seat 3: xxxZeka ($100 in chips) 
Seat 4: oscarleon ($173.51 in chips) 
Seat 5: Dantist1122 ($100.50 in chips) 
Seat 6: maxxmeister ($233.50 in chips) 
Seat 7: ghostriderxu ($25 in chips) 
Seat 8: Szevasztopol ($100 in chips) 
Seat 9: Filojoes ($138.22 in chips) 
Dantist1122: posts small blind $0.50
maxxmeister: posts big blind $1
*** HOLE CARDS ***
Dealt to matiko09 [6s 4d]
ghostriderxu: folds 
Szevasztopol: folds 
Filojoes: folds 
matiko09: folds 
hammerwife: folds 
xxxZeka: folds 
oscarleon: raises $2 to $3
Dantist1122: folds 
maxxmeister: folds 
Uncalled bet ($2) returned to oscarleon
oscarleon collected $2.50 from pot
oscarleon: doesn't show hand 
*** SUMMARY ***
Total pot $2.50 | Rake $0 
Seat 1: matiko09 folded before Flop (didn't bet)
Seat 2: hammerwife folded before Flop (didn't bet)
Seat 3: xxxZeka folded before Flop (didn't bet)
Seat 4: oscarleon (button) collected ($2.50)
Seat 5: Dantist1122 (small blind) folded before Flop
Seat 6: maxxmeister (big blind) folded before Flop
Seat 7: ghostriderxu folded before Flop (didn't bet)
Seat 8: Szevasztopol folded before Flop (didn't bet)
Seat 9: Filojoes folded before Flop (didn't bet)





PokerStars Hand #154362665154:  Hold'em No Limit ($0.50/$1.00 USD) - 2016/06/06 12:25:14 CET [2016/06/06 6:25:14 ET]
Table 'Williams' 9-max Seat #3 is the button
Seat 1: matiko09 ($194.29 in chips) 
Seat 2: PacPacBum ($100 in chips) 
Seat 3: granbunny ($76.60 in chips) 
Seat 4: Filojoes ($121.42 in chips) 
Seat 5: ardo888 ($103 in chips) 
Seat 6: Priidix ($123.44 in chips) 
Seat 7: kevinho109 ($72.56 in chips) 
Seat 8: oscarleon ($111.86 in chips) 
Seat 9: kind ten ($25.82 in chips) 
Filojoes: posts small blind $0.50
ardo888: posts big blind $1
*** HOLE CARDS ***
Dealt to matiko09 [7d Qc]
Priidix: folds 
kevinho109: folds 
oscarleon: folds 
kind ten: folds 
matiko09: folds 
PacPacBum: folds 
granbunny: raises $1 to $2
Filojoes: calls $1.50
ardo888: raises $6 to $8
granbunny: calls $6
Filojoes: calls $6
*** FLOP *** [Ah 8d 6d]
Filojoes: checks 
ardo888: checks 
granbunny: bets $8
Filojoes: folds 
ardo888: calls $8
*** TURN *** [Ah 8d 6d] [Ac]
ardo888: checks 
granbunny: checks 
*** RIVER *** [Ah 8d 6d Ac] [5s]
ardo888: checks 
granbunny: checks 
*** SHOW DOWN ***
ardo888: shows [Ts As] (three of a kind, Aces)
granbunny: mucks hand 
ardo888 collected $38 from pot
*** SUMMARY ***
Total pot $40 | Rake $2 
Board [Ah 8d 6d Ac 5s]
Seat 1: matiko09 folded before Flop (didn't bet)
Seat 2: PacPacBum folded before Flop (didn't bet)
Seat 3: granbunny (button) mucked [Jh Qh]
Seat 4: Filojoes (small blind) folded on the Flop
Seat 5: ardo888 (big blind) showed [Ts As] and won ($38) with three of a kind, Aces
Seat 6: Priidix folded before Flop (didn't bet)
Seat 7: kevinho109 folded before Flop (didn't bet)
Seat 8: oscarleon folded before Flop (didn't bet)
Seat 9: kind ten folded before Flop (didn't bet)





PokerStars Hand #154362665469:  Hold'em No Limit ($0.50/$1.00 USD) - 2016/06/06 12:25:15 CET [2016/06/06 6:25:15 ET]
Table 'Wezen II' 9-max Seat #3 is the button
Seat 1: matiko09 ($163.97 in chips) 
Seat 2: Mr.Grigoriy ($108.18 in chips) 
Seat 3: oscarleon ($100 in chips) 
Seat 4: maxxmeister ($100 in chips) 
Seat 6: Szevasztopol ($100 in chips) 
Seat 7: KDJAll3 ($129.52 in chips) 
Seat 8: mavin80 ($156.48 in chips) 
Seat 9: Filojoes ($107.01 in chips) 
maxxmeister: posts small blind $0.50
rusher_NiNja: is sitting out 
Szevasztopol: posts big blind $1
*** HOLE CARDS ***
Dealt to matiko09 [9h 2c]
rusher_NiNja leaves the table
nombraalne1 joins the table at seat #5 
KDJAll3: folds 
mavin80: folds 
Filojoes: folds 
nombraalne1 leaves the table
matiko09: folds 
Mr.Grigoriy: folds 
oscarleon: raises $2 to $3
maxxmeister: folds 
xxxZeka joins the table at seat #5 
xxxZeka leaves the table
Szevasztopol: calls $2
*** FLOP *** [Kh Qd Td]
Szevasztopol: checks 
oscarleon: bets $4
stds st joins the table at seat #5 
Szevasztopol: folds 
Uncalled bet ($4) returned to oscarleon
oscarleon collected $6.18 from pot
oscarleon: doesn't show hand 
*** SUMMARY ***
Total pot $6.50 | Rake $0.32 
Board [Kh Qd Td]
Seat 1: matiko09 folded before Flop (didn't bet)
Seat 2: Mr.Grigoriy folded before Flop (didn't bet)
Seat 3: oscarleon (button) collected ($6.18)
Seat 4: maxxmeister (small blind) folded before Flop
Seat 6: Szevasztopol (big blind) folded on the Flop
Seat 7: KDJAll3 folded before Flop (didn't bet)
Seat 8: mavin80 folded before Flop (didn't bet)
Seat 9: Filojoes folded before Flop (didn't bet)





PokerStars Hand #154362671080:  Hold'em No Limit ($0.50/$1.00 USD) - 2016/06/06 12:25:30 CET [2016/06/06 6:25:30 ET]
Table 'Irmgard II' 9-max Seat #5 is the button
Seat 1: matiko09 ($148 in chips) 
Seat 2: hammerwife ($115.93 in chips) 
Seat 3: xxxZeka ($100 in chips) 
Seat 4: oscarleon ($175.01 in chips) 
Seat 5: Dantist1122 ($100 in chips) 
Seat 6: maxxmeister ($232.50 in chips) 
Seat 7: ghostriderxu ($25 in chips) 
Seat 8: Szevasztopol ($100 in chips) 
Seat 9: Filojoes ($138.22 in chips) 
maxxmeister: posts small blind $0.50
ghostriderxu: posts big blind $1
*** HOLE CARDS ***
Dealt to matiko09 [5h Kh]
Szevasztopol: folds 
Filojoes: folds 
matiko09: folds 
hammerwife: folds 
xxxZeka: folds 
oscarleon: raises $2 to $3
Dantist1122: folds 
maxxmeister: calls $2.50
ghostriderxu: folds 
*** FLOP *** [8h 3s 9s]
maxxmeister: checks 
oscarleon: bets $5
maxxmeister: calls $5
*** TURN *** [8h 3s 9s] [Ts]
maxxmeister: checks 
oscarleon: checks 
*** RIVER *** [8h 3s 9s Ts] [8c]
maxxmeister: bets $13
oscarleon: folds 
Uncalled bet ($13) returned to maxxmeister
maxxmeister collected $16.15 from pot
maxxmeister: doesn't show hand 
*** SUMMARY ***
Total pot $17 | Rake $0.85 
Board [8h 3s 9s Ts 8c]
Seat 1: matiko09 folded before Flop (didn't bet)
Seat 2: hammerwife folded before Flop (didn't bet)
Seat 3: xxxZeka folded before Flop (didn't bet)
Seat 4: oscarleon folded on the River
Seat 5: Dantist1122 (button) folded before Flop (didn't bet)
Seat 6: maxxmeister (small blind) collected ($16.15)
Seat 7: ghostriderxu (big blind) folded before Flop
Seat 8: Szevasztopol folded before Flop (didn't bet)
Seat 9: Filojoes folded before Flop (didn't bet)





PokerStars Hand #154362684894:  Hold'em No Limit ($0.50/$1.00 USD) - 2016/06/06 12:26:05 CET [2016/06/06 6:26:05 ET]
Table 'Yarilo' 9-max Seat #7 is the button
Seat 1: xxxZeka ($100 in chips) 
Seat 2: thecurv ($116.53 in chips) 
Seat 3: matiko09 ($112.42 in chips) 
Seat 4: riggedsh** ($113.38 in chips) 
Seat 5: Szevasztopol ($137.19 in chips) 
Seat 6: maxxmeister ($100 in chips) 
Seat 7: KEBIN1974 ($100 in chips) 
Seat 8: Mr.Grigoriy ($154.17 in chips) 
Seat 9: Filojoes ($102.48 in chips) 
Mr.Grigoriy: posts small blind $0.50
Filojoes: posts big blind $1
*** HOLE CARDS ***
Dealt to matiko09 [Ts 4s]
xxxZeka: folds 
thecurv: folds 
matiko09: folds 
riggedsh**: folds 
Szevasztopol: folds 
maxxmeister: raises $2 to $3
KEBIN1974: folds 
Mr.Grigoriy: folds 
Filojoes: raises $6.50 to $9.50
maxxmeister: folds 
Uncalled bet ($6.50) returned to Filojoes
Filojoes collected $6.50 from pot
Filojoes: doesn't show hand 
*** SUMMARY ***
Total pot $6.50 | Rake $0 
Seat 1: xxxZeka folded before Flop (didn't bet)
Seat 2: thecurv folded before Flop (didn't bet)
Seat 3: matiko09 folded before Flop (didn't bet)
Seat 4: riggedsh** folded before Flop (didn't bet)
Seat 5: Szevasztopol folded before Flop (didn't bet)
Seat 6: maxxmeister folded before Flop
Seat 7: KEBIN1974 (button) folded before Flop (didn't bet)
Seat 8: Mr.Grigoriy (small blind) folded before Flop
Seat 9: Filojoes (big blind) collected ($6.50)





PokerStars Hand #154362687419:  Hold'em No Limit ($0.50/$1.00 USD) - 2016/06/06 12:26:11 CET [2016/06/06 6:26:11 ET]
Table 'Safara' 9-max Seat #9 is the button
Seat 1: oscarleon ($235.44 in chips) 
Seat 2: Szevasztopol ($100 in chips) 
Seat 4: mattyt212 ($204.50 in chips) 
Seat 5: Dantist1122 ($100 in chips) 
Seat 6: matiko09 ($100 in chips) 
Seat 8: Priidix ($100 in chips) 
Seat 9: Mr.Grigoriy ($104.17 in chips) 
oscarleon: posts small blind $0.50
Szevasztopol: posts big blind $1
ozone2003: sits out 
PacPacBum: sits out 
*** HOLE CARDS ***
Dealt to matiko09 [3c 7d]
mattyt212: folds 
Dantist1122: folds 
matiko09: folds 
Priidix: raises $1.44 to $2.44
Mr.Grigoriy: folds 
oscarleon: folds 
Szevasztopol: folds 
Uncalled bet ($1.44) returned to Priidix
Priidix collected $2.50 from pot
Priidix: doesn't show hand 
*** SUMMARY ***
Total pot $2.50 | Rake $0 
Seat 1: oscarleon (small blind) folded before Flop
Seat 2: Szevasztopol (big blind) folded before Flop
Seat 4: mattyt212 folded before Flop (didn't bet)
Seat 5: Dantist1122 folded before Flop (didn't bet)
Seat 6: matiko09 folded before Flop (didn't bet)
Seat 8: Priidix collected ($2.50)
Seat 9: Mr.Grigoriy (button) folded before Flop (didn't bet)





PokerStars Hand #154362689319:  Hold'em No Limit ($0.50/$1.00 USD) - 2016/06/06 12:26:16 CET [2016/06/06 6:26:16 ET]
Table 'Gajdariya' 9-max Seat #7 is the button
Seat 1: matiko09 ($101.50 in chips) 
Seat 2: xxxZeka ($128.24 in chips) 
Seat 3: oscarleon ($100 in chips) 
Seat 4: Szevasztopol ($113.27 in chips) 
Seat 5: 147734319 ($111.51 in chips) 
Seat 6: mono123viva ($149.86 in chips) 
Seat 7: Wombatkilla ($90.68 in chips) 
Seat 8: ardo888 ($100 in chips) 
ardo888: posts small blind $0.50
rusher_NiNja: is sitting out 
matiko09: posts big blind $1
*** HOLE CARDS ***
Dealt to matiko09 [Th Qc]
rusher_NiNja leaves the table
Mr.Grigoriy joins the table at seat #9 
xxxZeka: folds 
oscarleon: folds 
Szevasztopol: raises $1.14 to $2.14
147734319: folds 
mono123viva: folds 
Wombatkilla: raises $4.86 to $7
ardo888: folds 
matiko09: folds 
Szevasztopol: folds 
Uncalled bet ($4.86) returned to Wombatkilla
Wombatkilla collected $5.78 from pot
*** SUMMARY ***
Total pot $5.78 | Rake $0 
Seat 1: matiko09 (big blind) folded before Flop
Seat 2: xxxZeka folded before Flop (didn't bet)
Seat 3: oscarleon folded before Flop (didn't bet)
Seat 4: Szevasztopol folded before Flop
Seat 5: 147734319 folded before Flop (didn't bet)
Seat 6: mono123viva folded before Flop (didn't bet)
Seat 7: Wombatkilla (button) collected ($5.78)
Seat 8: ardo888 (small blind) folded before Flop





PokerStars Hand #154362690165:  Hold'em No Limit ($0.50/$1.00 USD) - 2016/06/06 12:26:18 CET [2016/06/06 6:26:18 ET]
Table 'Heze' 9-max Seat #2 is the button
Seat 1: matiko09 ($218.15 in chips) 
Seat 2: oscarleon ($259.31 in chips) 
Seat 3: maxxmeister ($100 in chips) 
Seat 4: xxxZeka ($100 in chips) 
Seat 5: Filojoes ($101.74 in chips) 
Seat 6: ozone2003 ($101.50 in chips) 
Seat 7: Priidix ($100 in chips) 
Seat 8: AlSmithy88 ($46.34 in chips) 
Seat 9: Mr.Grigoriy ($130.76 in chips) 
maxxmeister: posts small blind $0.50
xxxZeka: posts big blind $1
*** HOLE CARDS ***
Dealt to matiko09 [Ac 8d]
Filojoes: folds 
ozone2003: folds 
Priidix: folds 
AlSmithy88: calls $1
Mr.Grigoriy: folds 
matiko09: raises $2 to $3
oscarleon: folds 
maxxmeister: raises $9 to $12
xxxZeka: folds 
AlSmithy88: folds 
matiko09: folds 
Uncalled bet ($9) returned to maxxmeister
maxxmeister collected $8 from pot
maxxmeister: doesn't show hand 
*** SUMMARY ***
Total pot $8 | Rake $0 
Seat 1: matiko09 folded before Flop
Seat 2: oscarleon (button) folded before Flop (didn't bet)
Seat 3: maxxmeister (small blind) collected ($8)
Seat 4: xxxZeka (big blind) folded before Flop
Seat 5: Filojoes folded before Flop (didn't bet)
Seat 6: ozone2003 folded before Flop (didn't bet)
Seat 7: Priidix folded before Flop (didn't bet)
Seat 8: AlSmithy88 folded before Flop
Seat 9: Mr.Grigoriy folded before Flop (didn't bet)





PokerStars Hand #154362690592:  Hold'em No Limit ($0.50/$1.00 USD) - 2016/06/06 12:26:19 CET [2016/06/06 6:26:19 ET]
Table 'Wezen II' 9-max Seat #4 is the button
Seat 1: matiko09 ($163.97 in chips) 
Seat 2: Mr.Grigoriy ($108.18 in chips) 
Seat 3: oscarleon ($103.18 in chips) 
Seat 4: maxxmeister ($100 in chips) 
Seat 6: Szevasztopol ($100 in chips) 
Seat 7: KDJAll3 ($129.52 in chips) 
Seat 8: mavin80 ($156.48 in chips) 
Seat 9: Filojoes ($107.01 in chips) 
stds st will be allowed to play after the button
Szevasztopol: posts small blind $0.50
KDJAll3: posts big blind $1
*** HOLE CARDS ***
Dealt to matiko09 [8c 9s]
mavin80: folds 
Filojoes: folds 
matiko09: folds 
Mr.Grigoriy: folds 
oscarleon: folds 
maxxmeister: raises $2 to $3
Szevasztopol: folds 
KDJAll3: raises $5 to $8
maxxmeister: raises $11 to $19
KDJAll3: calls $11
*** FLOP *** [9h Qh 4d]
KDJAll3: checks 
maxxmeister: checks 
*** TURN *** [9h Qh 4d] [Jc]
KDJAll3: bets $10
maxxmeister: calls $10
*** RIVER *** [9h Qh 4d Jc] [Th]
KDJAll3: bets $18
maxxmeister: raises $53 to $71 and is all-in
KDJAll3: folds 
Uncalled bet ($53) returned to maxxmeister
maxxmeister collected $92 from pot
maxxmeister: doesn't show hand 
*** SUMMARY ***
Total pot $94.50 | Rake $2.50 
Board [9h Qh 4d Jc Th]
Seat 1: matiko09 folded before Flop (didn't bet)
Seat 2: Mr.Grigoriy folded before Flop (didn't bet)
Seat 3: oscarleon folded before Flop (didn't bet)
Seat 4: maxxmeister (button) collected ($92)
Seat 6: Szevasztopol (small blind) folded before Flop
Seat 7: KDJAll3 (big blind) folded on the River
Seat 8: mavin80 folded before Flop (didn't bet)
Seat 9: Filojoes folded before Flop (didn't bet)





PokerStars Hand #154362693382:  Hold'em No Limit ($0.50/$1.00 USD) - 2016/06/06 12:26:26 CET [2016/06/06 6:26:26 ET]
Table 'Williams' 9-max Seat #4 is the button
Seat 1: matiko09 ($194.29 in chips) 
Seat 2: PacPacBum ($100 in chips) 
Seat 3: granbunny ($60.60 in chips) 
Seat 4: Filojoes ($113.42 in chips) 
Seat 5: ardo888 ($125 in chips) 
Seat 6: Priidix ($123.44 in chips) 
Seat 7: kevinho109 ($72.56 in chips) 
Seat 8: oscarleon ($111.86 in chips) 
Seat 9: kind ten ($25.82 in chips) 
ardo888: posts small blind $0.50
Priidix: posts big blind $1
*** HOLE CARDS ***
Dealt to matiko09 [Kc 5h]
kevinho109: folds 
oscarleon: folds 
kind ten: raises $2 to $3
matiko09: folds 
PacPacBum: folds 
granbunny: calls $3
Filojoes: folds 
ardo888: folds 
Priidix: folds 
*** FLOP *** [6s 5d Td]
kind ten: bets $4
granbunny: folds 
Uncalled bet ($4) returned to kind ten
kind ten collected $7.12 from pot
kind ten: doesn't show hand 
*** SUMMARY ***
Total pot $7.50 | Rake $0.38 
Board [6s 5d Td]
Seat 1: matiko09 folded before Flop (didn't bet)
Seat 2: PacPacBum folded before Flop (didn't bet)
Seat 3: granbunny folded on the Flop
Seat 4: Filojoes (button) folded before Flop (didn't bet)
Seat 5: ardo888 (small blind) folded before Flop
Seat 6: Priidix (big blind) folded before Flop
Seat 7: kevinho109 folded before Flop (didn't bet)
Seat 8: oscarleon folded before Flop (didn't bet)
Seat 9: kind ten collected ($7.12)





PokerStars Hand #154362704071:  Hold'em No Limit ($0.50/$1.00 USD) - 2016/06/06 12:26:53 CET [2016/06/06 6:26:53 ET]
Table 'Gajdariya' 9-max Seat #8 is the button
Seat 1: matiko09 ($100.50 in chips) 
Seat 2: xxxZeka ($128.24 in chips) 
Seat 3: oscarleon ($100 in chips) 
Seat 4: Szevasztopol ($111.13 in chips) 
Seat 5: 147734319 ($111.51 in chips) 
Seat 6: mono123viva ($149.86 in chips) 
Seat 7: Wombatkilla ($94.32 in chips) 
Seat 8: ardo888 ($100 in chips) 
Mr.Grigoriy will be allowed to play after the button
matiko09: posts small blind $0.50
xxxZeka: posts big blind $1
*** HOLE CARDS ***
Dealt to matiko09 [Jc 3h]
oscarleon: folds 
Szevasztopol: folds 
147734319: folds 
mono123viva: raises $2 to $3
Wombatkilla: folds 
ardo888: folds 
matiko09: folds 
xxxZeka: folds 
Uncalled bet ($2) returned to mono123viva
mono123viva collected $2.50 from pot
*** SUMMARY ***
Total pot $2.50 | Rake $0 
Seat 1: matiko09 (small blind) folded before Flop
Seat 2: xxxZeka (big blind) folded before Flop
Seat 3: oscarleon folded before Flop (didn't bet)
Seat 4: Szevasztopol folded before Flop (didn't bet)
Seat 5: 147734319 folded before Flop (didn't bet)
Seat 6: mono123viva collected ($2.50)
Seat 7: Wombatkilla folded before Flop (didn't bet)
Seat 8: ardo888 (button) folded before Flop (didn't bet)





PokerStars Hand #154362705917:  Hold'em No Limit ($0.50/$1.00 USD) - 2016/06/06 12:26:58 CET [2016/06/06 6:26:58 ET]
Table 'Safara' 9-max Seat #1 is the button
Seat 1: oscarleon ($234.94 in chips) 
Seat 2: Szevasztopol ($100 in chips) 
Seat 3: ozone2003 ($100 in chips) 
Seat 4: mattyt212 ($204.50 in chips) 
Seat 5: Dantist1122 ($100 in chips) 
Seat 6: matiko09 ($100 in chips) 
Seat 8: Priidix ($101.50 in chips) 
Seat 9: Mr.Grigoriy ($104.17 in chips) 
Szevasztopol: posts small blind $0.50
ozone2003: posts big blind $1
PacPacBum: sits out 
*** HOLE CARDS ***
Dealt to matiko09 [8c 8h]
mattyt212: folds 
Dantist1122: folds 
matiko09: raises $2 to $3
Priidix: folds 
Mr.Grigoriy: folds 
oscarleon: folds 
Szevasztopol: folds 
ozone2003: raises $6 to $9
matiko09: folds 
Uncalled bet ($6) returned to ozone2003
ozone2003 collected $6.50 from pot
ozone2003: doesn't show hand 
*** SUMMARY ***
Total pot $6.50 | Rake $0 
Seat 1: oscarleon (button) folded before Flop (didn't bet)
Seat 2: Szevasztopol (small blind) folded before Flop
Seat 3: ozone2003 (big blind) collected ($6.50)
Seat 4: mattyt212 folded before Flop (didn't bet)
Seat 5: Dantist1122 folded before Flop (didn't bet)
Seat 6: matiko09 folded before Flop
Seat 8: Priidix folded before Flop (didn't bet)
Seat 9: Mr.Grigoriy folded before Flop (didn't bet)





PokerStars Hand #154362707961:  Hold'em No Limit ($0.50/$1.00 USD) - 2016/06/06 12:27:03 CET [2016/06/06 6:27:03 ET]
Table 'Williams' 9-max Seat #5 is the button
Seat 1: matiko09 ($194.29 in chips) 
Seat 2: PacPacBum ($100 in chips) 
Seat 3: granbunny ($57.60 in chips) 
Seat 4: Filojoes ($113.42 in chips) 
Seat 5: ardo888 ($124.50 in chips) 
Seat 6: Priidix ($122.44 in chips) 
Seat 7: kevinho109 ($72.56 in chips) 
Seat 8: oscarleon ($111.86 in chips) 
Seat 9: kind ten ($29.94 in chips) 
Priidix: posts small blind $0.50
kevinho109: posts big blind $1
*** HOLE CARDS ***
Dealt to matiko09 [8s 6c]
oscarleon: folds 
kind ten: folds 
matiko09: folds 
PacPacBum: folds 
granbunny: folds 
Filojoes: folds 
ardo888: raises $1.50 to $2.50
Priidix: folds 
kevinho109: folds 
Uncalled bet ($1.50) returned to ardo888
ardo888 collected $2.50 from pot
ardo888: doesn't show hand 
*** SUMMARY ***
Total pot $2.50 | Rake $0 
Seat 1: matiko09 folded before Flop (didn't bet)
Seat 2: PacPacBum folded before Flop (didn't bet)
Seat 3: granbunny folded before Flop (didn't bet)
Seat 4: Filojoes folded before Flop (didn't bet)
Seat 5: ardo888 (button) collected ($2.50)
Seat 6: Priidix (small blind) folded before Flop
Seat 7: kevinho109 (big blind) folded before Flop
Seat 8: oscarleon folded before Flop (didn't bet)
Seat 9: kind ten folded before Flop (didn't bet)





PokerStars Hand #154362708138:  Hold'em No Limit ($0.50/$1.00 USD) - 2016/06/06 12:27:04 CET [2016/06/06 6:27:04 ET]
Table 'Irmgard II' 9-max Seat #6 is the button
Seat 1: matiko09 ($148 in chips) 
Seat 2: hammerwife ($115.93 in chips) 
Seat 3: xxxZeka ($100 in chips) 
Seat 4: oscarleon ($167.01 in chips) 
Seat 5: Dantist1122 ($100 in chips) 
Seat 6: maxxmeister ($240.65 in chips) 
Seat 7: ghostriderxu ($24 in chips) 
Seat 8: Szevasztopol ($100 in chips) 
Seat 9: Filojoes ($138.22 in chips) 
ghostriderxu: posts small blind $0.50
Szevasztopol: posts big blind $1
*** HOLE CARDS ***
Dealt to matiko09 [Ah 4d]
Filojoes: folds 
matiko09: folds 
hammerwife: folds 
xxxZeka: folds 
oscarleon: folds 
Dantist1122: folds 
maxxmeister: calls $1
ghostriderxu: raises $3 to $4
Szevasztopol: folds 
maxxmeister: calls $3
*** FLOP *** [Ts 2s 6c]
ghostriderxu: bets $20 and is all-in
maxxmeister: calls $20
*** TURN *** [Ts 2s 6c] [2d]
*** RIVER *** [Ts 2s 6c 2d] [3c]
*** SHOW DOWN ***
ghostriderxu: shows [Qd As] (a pair of Deuces)
maxxmeister: shows [6s 4s] (two pair, Sixes and Deuces)
maxxmeister collected $46.55 from pot
*** SUMMARY ***
Total pot $49 | Rake $2.45 
Board [Ts 2s 6c 2d 3c]
Seat 1: matiko09 folded before Flop (didn't bet)
Seat 2: hammerwife folded before Flop (didn't bet)
Seat 3: xxxZeka folded before Flop (didn't bet)
Seat 4: oscarleon folded before Flop (didn't bet)
Seat 5: Dantist1122 folded before Flop (didn't bet)
Seat 6: maxxmeister (button) showed [6s 4s] and won ($46.55) with two pair, Sixes and Deuces
Seat 7: ghostriderxu (small blind) showed [Qd As] and lost with a pair of Deuces
Seat 8: Szevasztopol (big blind) folded before Flop
Seat 9: Filojoes folded before Flop (didn't bet)





PokerStars Hand #154362708783:  Hold'em No Limit ($0.50/$1.00 USD) - 2016/06/06 12:27:05 CET [2016/06/06 6:27:05 ET]
Table 'Yarilo' 9-max Seat #8 is the button
Seat 1: xxxZeka ($100 in chips) 
Seat 2: thecurv ($116.53 in chips) 
Seat 3: matiko09 ($112.42 in chips) 
Seat 4: riggedsh** ($113.38 in chips) 
Seat 5: Szevasztopol ($137.19 in chips) 
Seat 6: maxxmeister ($100 in chips) 
Seat 7: KEBIN1974 ($100 in chips) 
Seat 8: Mr.Grigoriy ($153.67 in chips) 
Seat 9: Filojoes ($105.98 in chips) 
Filojoes: posts small blind $0.50
xxxZeka: posts big blind $1
*** HOLE CARDS ***
Dealt to matiko09 [2h Ad]
thecurv: raises $1 to $2
matiko09: folds 
riggedsh**: folds 
Szevasztopol: folds 
maxxmeister: calls $2
KEBIN1974: folds 
Mr.Grigoriy: folds 
Filojoes: folds 
xxxZeka: folds 
*** FLOP *** [6c Qs 7c]
thecurv: bets $3
maxxmeister: calls $3
*** TURN *** [6c Qs 7c] [Qc]
thecurv: bets $7.50
maxxmeister: folds 
Uncalled bet ($7.50) returned to thecurv
thecurv collected $10.92 from pot
thecurv: doesn't show hand 
*** SUMMARY ***
Total pot $11.50 | Rake $0.58 
Board [6c Qs 7c Qc]
Seat 1: xxxZeka (big blind) folded before Flop
Seat 2: thecurv collected ($10.92)
Seat 3: matiko09 folded before Flop (didn't bet)
Seat 4: riggedsh** folded before Flop (didn't bet)
Seat 5: Szevasztopol folded before Flop (didn't bet)
Seat 6: maxxmeister folded on the Turn
Seat 7: KEBIN1974 folded before Flop (didn't bet)
Seat 8: Mr.Grigoriy (button) folded before Flop (didn't bet)
Seat 9: Filojoes (small blind) folded before Flop





PokerStars Hand #154362713174:  Hold'em No Limit ($0.50/$1.00 USD) - 2016/06/06 12:27:16 CET [2016/06/06 6:27:16 ET]
Table 'Gajdariya' 9-max Seat #1 is the button
Seat 1: matiko09 ($100 in chips) 
Seat 2: xxxZeka ($127.24 in chips) 
Seat 3: oscarleon ($100 in chips) 
Seat 4: Szevasztopol ($111.13 in chips) 
Seat 5: 147734319 ($111.51 in chips) 
Seat 6: mono123viva ($151.36 in chips) 
Seat 7: Wombatkilla ($94.32 in chips) 
Seat 8: ardo888 ($100 in chips) 
xxxZeka: posts small blind $0.50
oscarleon: posts big blind $1
Mr.Grigoriy: sits out 
*** HOLE CARDS ***
Dealt to matiko09 [6s 2s]
Szevasztopol: folds 
147734319: folds 
mono123viva: folds 
Wombatkilla: folds 
ardo888: raises $1.50 to $2.50
matiko09: folds 
xxxZeka: folds 
oscarleon: folds 
Uncalled bet ($1.50) returned to ardo888
ardo888 collected $2.50 from pot
ardo888: doesn't show hand 
*** SUMMARY ***
Total pot $2.50 | Rake $0 
Seat 1: matiko09 (button) folded before Flop (didn't bet)
Seat 2: xxxZeka (small blind) folded before Flop
Seat 3: oscarleon (big blind) folded before Flop
Seat 4: Szevasztopol folded before Flop (didn't bet)
Seat 5: 147734319 folded before Flop (didn't bet)
Seat 6: mono123viva folded before Flop (didn't bet)
Seat 7: Wombatkilla folded before Flop (didn't bet)
Seat 8: ardo888 collected ($2.50)





PokerStars Hand #154362717603:  Hold'em No Limit ($0.50/$1.00 USD) - 2016/06/06 12:27:28 CET [2016/06/06 6:27:28 ET]
Table 'Williams' 9-max Seat #6 is the button
Seat 1: matiko09 ($194.29 in chips) 
Seat 2: PacPacBum ($100 in chips) 
Seat 3: granbunny ($57.60 in chips) 
Seat 4: Filojoes ($113.42 in chips) 
Seat 5: ardo888 ($126 in chips) 
Seat 6: Priidix ($121.94 in chips) 
Seat 7: kevinho109 ($71.56 in chips) 
Seat 8: oscarleon ($111.86 in chips) 
Seat 9: kind ten ($29.94 in chips) 
kevinho109: posts small blind $0.50
oscarleon: posts big blind $1
*** HOLE CARDS ***
Dealt to matiko09 [5c Js]
kind ten: folds 
matiko09: folds 
PacPacBum: raises $2 to $3
granbunny: calls $3
Filojoes: raises $10 to $13
ardo888: folds 
Priidix: folds 
kevinho109: folds 
oscarleon: folds 
PacPacBum: folds 
granbunny: folds 
Uncalled bet ($10) returned to Filojoes
Filojoes collected $10.50 from pot
Filojoes: doesn't show hand 
*** SUMMARY ***
Total pot $10.50 | Rake $0 
Seat 1: matiko09 folded before Flop (didn't bet)
Seat 2: PacPacBum folded before Flop
Seat 3: granbunny folded before Flop
Seat 4: Filojoes collected ($10.50)
Seat 5: ardo888 folded before Flop (didn't bet)
Seat 6: Priidix (button) folded before Flop (didn't bet)
Seat 7: kevinho109 (small blind) folded before Flop
Seat 8: oscarleon (big blind) folded before Flop
Seat 9: kind ten folded before Flop (didn't bet)





PokerStars Hand #154362717931:  Hold'em No Limit ($0.50/$1.00 USD) - 2016/06/06 12:27:29 CET [2016/06/06 6:27:29 ET]
Table 'Heze' 9-max Seat #3 is the button
Seat 1: matiko09 ($215.15 in chips) 
Seat 2: oscarleon ($259.31 in chips) 
Seat 3: maxxmeister ($105 in chips) 
Seat 4: xxxZeka ($100 in chips) 
Seat 5: Filojoes ($101.74 in chips) 
Seat 6: ozone2003 ($101.50 in chips) 
Seat 7: Priidix ($100 in chips) 
Seat 8: AlSmithy88 ($45.34 in chips) 
Seat 9: Mr.Grigoriy ($130.76 in chips) 
xxxZeka: posts small blind $0.50
Filojoes: posts big blind $1
*** HOLE CARDS ***
Dealt to matiko09 [4c Td]
ozone2003: folds 
Priidix: raises $2 to $3
AlSmithy88: folds 
Mr.Grigoriy: folds 
matiko09: folds 
oscarleon: folds 
maxxmeister: folds 
xxxZeka: folds 
Filojoes: folds 
Uncalled bet ($2) returned to Priidix
Priidix collected $2.50 from pot
Priidix: doesn't show hand 
*** SUMMARY ***
Total pot $2.50 | Rake $0 
Seat 1: matiko09 folded before Flop (didn't bet)
Seat 2: oscarleon folded before Flop (didn't bet)
Seat 3: maxxmeister (button) folded before Flop (didn't bet)
Seat 4: xxxZeka (small blind) folded before Flop
Seat 5: Filojoes (big blind) folded before Flop
Seat 6: ozone2003 folded before Flop (didn't bet)
Seat 7: Priidix collected ($2.50)
Seat 8: AlSmithy88 folded before Flop (didn't bet)
Seat 9: Mr.Grigoriy folded before Flop (didn't bet)





PokerStars Hand #154362722907:  Hold'em No Limit ($0.50/$1.00 USD) - 2016/06/06 12:27:41 CET [2016/06/06 6:27:41 ET]
Table 'Safara' 9-max Seat #2 is the button
Seat 1: oscarleon ($234.94 in chips) 
Seat 2: Szevasztopol ($100 in chips) 
Seat 3: ozone2003 ($103.50 in chips) 
Seat 4: mattyt212 ($204.50 in chips) 
Seat 5: Dantist1122 ($100 in chips) 
Seat 6: matiko09 ($100 in chips) 
Seat 8: Priidix ($101.50 in chips) 
Seat 9: Mr.Grigoriy ($104.17 in chips) 
ozone2003: posts small blind $0.50
mattyt212: posts big blind $1
PacPacBum: sits out 
*** HOLE CARDS ***
Dealt to matiko09 [Ts Jh]
Dantist1122: folds 
matiko09: folds 
Priidix: folds 
Mr.Grigoriy: raises $2 to $3
oscarleon: folds 
Szevasztopol: folds 
ozone2003: folds 
mattyt212: folds 
Uncalled bet ($2) returned to Mr.Grigoriy
Mr.Grigoriy collected $2.50 from pot
Mr.Grigoriy: doesn't show hand 
*** SUMMARY ***
Total pot $2.50 | Rake $0 
Seat 1: oscarleon folded before Flop (didn't bet)
Seat 2: Szevasztopol (button) folded before Flop (didn't bet)
Seat 3: ozone2003 (small blind) folded before Flop
Seat 4: mattyt212 (big blind) folded before Flop
Seat 5: Dantist1122 folded before Flop (didn't bet)
Seat 6: matiko09 folded before Flop (didn't bet)
Seat 8: Priidix folded before Flop (didn't bet)
Seat 9: Mr.Grigoriy collected ($2.50)





PokerStars Hand #154362724128:  Hold'em No Limit ($0.50/$1.00 USD) - 2016/06/06 12:27:44 CET [2016/06/06 6:27:44 ET]
Table 'Gajdariya' 9-max Seat #2 is the button
Seat 1: matiko09 ($100 in chips) 
Seat 2: xxxZeka ($126.74 in chips) 
Seat 3: oscarleon ($100 in chips) 
Seat 4: Szevasztopol ($111.13 in chips) 
Seat 5: 147734319 ($111.51 in chips) 
Seat 6: mono123viva ($151.36 in chips) 
Seat 7: Wombatkilla ($94.32 in chips) 
Seat 8: ardo888 ($101.50 in chips) 
oscarleon: posts small blind $0.50
Szevasztopol: posts big blind $1
Mr.Grigoriy: sits out 
*** HOLE CARDS ***
Dealt to matiko09 [5s 6h]
147734319: folds 
mono123viva: folds 
Wombatkilla: folds 
ardo888: folds 
matiko09: folds 
xxxZeka: folds 
oscarleon: raises $2 to $3
Szevasztopol: folds 
Uncalled bet ($2) returned to oscarleon
oscarleon collected $2 from pot
oscarleon: doesn't show hand 
*** SUMMARY ***
Total pot $2 | Rake $0 
Seat 1: matiko09 folded before Flop (didn't bet)
Seat 2: xxxZeka (button) folded before Flop (didn't bet)
Seat 3: oscarleon (small blind) collected ($2)
Seat 4: Szevasztopol (big blind) folded before Flop
Seat 5: 147734319 folded before Flop (didn't bet)
Seat 6: mono123viva folded before Flop (didn't bet)
Seat 7: Wombatkilla folded before Flop (didn't bet)
Seat 8: ardo888 folded before Flop (didn't bet)





PokerStars Hand #154362728453:  Hold'em No Limit ($0.50/$1.00 USD) - 2016/06/06 12:27:55 CET [2016/06/06 6:27:55 ET]
Table 'Heze' 9-max Seat #4 is the button
Seat 1: matiko09 ($215.15 in chips) 
Seat 2: oscarleon ($259.31 in chips) 
Seat 3: maxxmeister ($105 in chips) 
Seat 4: xxxZeka ($100 in chips) 
Seat 5: Filojoes ($100.74 in chips) 
Seat 6: ozone2003 ($101.50 in chips) 
Seat 7: Priidix ($101.50 in chips) 
Seat 8: AlSmithy88 ($45.34 in chips) 
Seat 9: Mr.Grigoriy ($130.76 in chips) 
Filojoes: posts small blind $0.50
ozone2003: posts big blind $1
*** HOLE CARDS ***
Dealt to matiko09 [6s Js]
Priidix: folds 
AlSmithy88: folds 
Mr.Grigoriy: raises $2 to $3
matiko09: folds 
oscarleon: folds 
maxxmeister: folds 
xxxZeka: folds 
Filojoes: folds 
ozone2003: folds 
Uncalled bet ($2) returned to Mr.Grigoriy
Mr.Grigoriy collected $2.50 from pot
Mr.Grigoriy: doesn't show hand 
*** SUMMARY ***
Total pot $2.50 | Rake $0 
Seat 1: matiko09 folded before Flop (didn't bet)
Seat 2: oscarleon folded before Flop (didn't bet)
Seat 3: maxxmeister folded before Flop (didn't bet)
Seat 4: xxxZeka (button) folded before Flop (didn't bet)
Seat 5: Filojoes (small blind) folded before Flop
Seat 6: ozone2003 (big blind) folded before Flop
Seat 7: Priidix folded before Flop (didn't bet)
Seat 8: AlSmithy88 folded before Flop (didn't bet)
Seat 9: Mr.Grigoriy collected ($2.50)





PokerStars Hand #154362730128:  Hold'em No Limit ($0.50/$1.00 USD) - 2016/06/06 12:27:59 CET [2016/06/06 6:27:59 ET]
Table 'Chaldaea II' 9-max Seat #7 is the button
Seat 2: maxxmeister ($172.07 in chips) 
Seat 3: ardo888 ($100 in chips) 
Seat 4: ozone2003 ($107.08 in chips) 
Seat 5: MiiiTCHy__ ($63.38 in chips) 
Seat 6: PacPacBum ($100 in chips) 
Seat 7: riggedsh** ($158.88 in chips) 
Seat 8: o.miro ($100 in chips) 
Seat 9: matiko09 ($100 in chips) 
o.miro: posts small blind $0.50
matiko09: posts big blind $1
xxxZeka: sits out 
*** HOLE CARDS ***
Dealt to matiko09 [5h 2c]
maxxmeister: folds 
ardo888: folds 
ozone2003: folds 
MiiiTCHy__: folds 
PacPacBum: folds 
riggedsh**: folds 
o.miro: folds 
Uncalled bet ($0.50) returned to matiko09
matiko09 collected $1 from pot
matiko09: doesn't show hand 
*** SUMMARY ***
Total pot $1 | Rake $0 
Seat 2: maxxmeister folded before Flop (didn't bet)
Seat 3: ardo888 folded before Flop (didn't bet)
Seat 4: ozone2003 folded before Flop (didn't bet)
Seat 5: MiiiTCHy__ folded before Flop (didn't bet)
Seat 6: PacPacBum folded before Flop (didn't bet)
Seat 7: riggedsh** (button) folded before Flop (didn't bet)
Seat 8: o.miro (small blind) folded before Flop
Seat 9: matiko09 (big blind) collected ($1)





PokerStars Hand #154362734708:  Hold'em No Limit ($0.50/$1.00 USD) - 2016/06/06 12:28:11 CET [2016/06/06 6:28:11 ET]
Table 'Gajdariya' 9-max Seat #3 is the button
Seat 1: matiko09 ($100 in chips) 
Seat 3: oscarleon ($101 in chips) 
Seat 4: Szevasztopol ($110.13 in chips) 
Seat 5: 147734319 ($111.51 in chips) 
Seat 6: mono123viva ($151.36 in chips) 
Seat 7: Wombatkilla ($94.32 in chips) 
Seat 8: ardo888 ($101.50 in chips) 
Szevasztopol: posts small blind $0.50
147734319: posts big blind $1
Mr.Grigoriy: sits out 
*** HOLE CARDS ***
Dealt to matiko09 [4c 4s]
mono123viva: folds 
Wombatkilla: folds 
ardo888: folds 
matiko09: raises $2 to $3
oscarleon: raises $6 to $9
Szevasztopol: folds 
147734319: folds 
matiko09: folds 
Uncalled bet ($6) returned to oscarleon
oscarleon collected $7.50 from pot
oscarleon: doesn't show hand 
*** SUMMARY ***
Total pot $7.50 | Rake $0 
Seat 1: matiko09 folded before Flop
Seat 3: oscarleon (button) collected ($7.50)
Seat 4: Szevasztopol (small blind) folded before Flop
Seat 5: 147734319 (big blind) folded before Flop
Seat 6: mono123viva folded before Flop (didn't bet)
Seat 7: Wombatkilla folded before Flop (didn't bet)
Seat 8: ardo888 folded before Flop (didn't bet)





PokerStars Hand #154362736342:  Hold'em No Limit ($0.50/$1.00 USD) - 2016/06/06 12:28:15 CET [2016/06/06 6:28:15 ET]
Table 'Safara' 9-max Seat #3 is the button
Seat 1: oscarleon ($234.94 in chips) 
Seat 2: Szevasztopol ($100 in chips) 
Seat 3: ozone2003 ($103 in chips) 
Seat 4: mattyt212 ($203.50 in chips) 
Seat 5: Dantist1122 ($100 in chips) 
Seat 6: matiko09 ($100 in chips) 
Seat 8: Priidix ($101.50 in chips) 
Seat 9: Mr.Grigoriy ($105.67 in chips) 
mattyt212: posts small blind $0.50
Dantist1122: posts big blind $1
PacPacBum: sits out 
*** HOLE CARDS ***
Dealt to matiko09 [Ks As]
matiko09: raises $2 to $3
Priidix: folds 
Mr.Grigoriy: folds 
oscarleon: raises $7 to $10
Szevasztopol: folds 
ozone2003: folds 
mattyt212: folds 
Dantist1122: folds 
matiko09: calls $7
*** FLOP *** [Ts 9c 6c]
matiko09: checks 
oscarleon: bets $15
matiko09: calls $15
*** TURN *** [Ts 9c 6c] [5d]
matiko09: checks 
oscarleon: checks 
*** RIVER *** [Ts 9c 6c 5d] [2s]
matiko09: checks 
oscarleon: checks 
*** SHOW DOWN ***
matiko09: shows [Ks As] (high card Ace)
oscarleon: shows [Ac Kc] (high card Ace)
matiko09 collected $24.50 from pot
oscarleon collected $24.50 from pot
*** SUMMARY ***
Total pot $51.50 | Rake $2.50 
Board [Ts 9c 6c 5d 2s]
Seat 1: oscarleon showed [Ac Kc] and won ($24.50) with high card Ace
Seat 2: Szevasztopol folded before Flop (didn't bet)
Seat 3: ozone2003 (button) folded before Flop (didn't bet)
Seat 4: mattyt212 (small blind) folded before Flop
Seat 5: Dantist1122 (big blind) folded before Flop
Seat 6: matiko09 showed [Ks As] and won ($24.50) with high card Ace
Seat 8: Priidix folded before Flop (didn't bet)
Seat 9: Mr.Grigoriy folded before Flop (didn't bet)





PokerStars Hand #154362736935:  Hold'em No Limit ($0.50/$1.00 USD) - 2016/06/06 12:28:16 CET [2016/06/06 6:28:16 ET]
Table 'Irmgard II' 9-max Seat #8 is the button
Seat 1: matiko09 ($148 in chips) 
Seat 2: hammerwife ($115.93 in chips) 
Seat 4: oscarleon ($167.01 in chips) 
Seat 5: Dantist1122 ($100 in chips) 
Seat 6: maxxmeister ($263.20 in chips) 
Seat 8: Szevasztopol ($100 in chips) 
Seat 9: Filojoes ($138.22 in chips) 
Filojoes: posts small blind $0.50
matiko09: posts big blind $1
*** HOLE CARDS ***
Dealt to matiko09 [5d Qs]
hammerwife: folds 
oscarleon: folds 
Dantist1122: folds 
maxxmeister: folds 
Szevasztopol: folds 
ghostriderxu leaves the table
Filojoes: folds 
Uncalled bet ($0.50) returned to matiko09
matiko09 collected $1 from pot
matiko09: doesn't show hand 
*** SUMMARY ***
Total pot $1 | Rake $0 
Seat 1: matiko09 (big blind) collected ($1)
Seat 2: hammerwife folded before Flop (didn't bet)
Seat 4: oscarleon folded before Flop (didn't bet)
Seat 5: Dantist1122 folded before Flop (didn't bet)
Seat 6: maxxmeister folded before Flop (didn't bet)
Seat 8: Szevasztopol (button) folded before Flop (didn't bet)
Seat 9: Filojoes (small blind) folded before Flop





PokerStars Hand #154362737112:  Hold'em No Limit ($0.50/$1.00 USD) - 2016/06/06 12:28:17 CET [2016/06/06 6:28:17 ET]
Table 'Williams' 9-max Seat #7 is the button
Seat 1: matiko09 ($194.29 in chips) 
Seat 2: PacPacBum ($100 in chips) 
Seat 3: granbunny ($54.60 in chips) 
Seat 4: Filojoes ($120.92 in chips) 
Seat 5: ardo888 ($126 in chips) 
Seat 6: Priidix ($121.94 in chips) 
Seat 7: kevinho109 ($71.06 in chips) 
Seat 8: oscarleon ($110.86 in chips) 
Seat 9: kind ten ($29.94 in chips) 
oscarleon: posts small blind $0.50
kind ten: posts big blind $1
*** HOLE CARDS ***
Dealt to matiko09 [Kd Tc]
matiko09: folds 
PacPacBum: raises $2 to $3
granbunny: folds 
Filojoes: folds 
ardo888: folds 
Priidix: folds 
kevinho109: folds 
oscarleon: folds 
kind ten: calls $2
*** FLOP *** [Qh 2s 3h]
kind ten: checks 
PacPacBum: bets $2.16
kind ten: calls $2.16
*** TURN *** [Qh 2s 3h] [Qs]
kind ten: checks 
PacPacBum: bets $5.55
kind ten: raises $19.23 to $24.78 and is all-in
PacPacBum: folds 
Uncalled bet ($19.23) returned to kind ten
kind ten collected $20.82 from pot
kind ten: doesn't show hand 
*** SUMMARY ***
Total pot $21.92 | Rake $1.10 
Board [Qh 2s 3h Qs]
Seat 1: matiko09 folded before Flop (didn't bet)
Seat 2: PacPacBum folded on the Turn
Seat 3: granbunny folded before Flop (didn't bet)
Seat 4: Filojoes folded before Flop (didn't bet)
Seat 5: ardo888 folded before Flop (didn't bet)
Seat 6: Priidix folded before Flop (didn't bet)
Seat 7: kevinho109 (button) folded before Flop (didn't bet)
Seat 8: oscarleon (small blind) folded before Flop
Seat 9: kind ten (big blind) collected ($20.82)





PokerStars Hand #154362742155:  Hold'em No Limit ($0.50/$1.00 USD) - 2016/06/06 12:28:29 CET [2016/06/06 6:28:29 ET]
Table 'Wezen II' 9-max Seat #6 is the button
Seat 1: matiko09 ($163.97 in chips) 
Seat 2: Mr.Grigoriy ($108.18 in chips) 
Seat 3: oscarleon ($103.18 in chips) 
Seat 4: maxxmeister ($145 in chips) 
Seat 6: Szevasztopol ($100 in chips) 
Seat 7: KDJAll3 ($82.52 in chips) 
Seat 8: mavin80 ($156.48 in chips) 
Seat 9: Filojoes ($107.01 in chips) 
KDJAll3: posts small blind $0.50
mavin80: posts big blind $1
stds st: sits out 
*** HOLE CARDS ***
Dealt to matiko09 [Ts 5c]
Filojoes: folds 
matiko09: folds 
Mr.Grigoriy: folds 
oscarleon: folds 
maxxmeister: raises $2 to $3
Szevasztopol: raises $7.50 to $10.50
KDJAll3: folds 
mavin80: folds 
maxxmeister: folds 
Uncalled bet ($7.50) returned to Szevasztopol
Szevasztopol collected $7.50 from pot
Szevasztopol: doesn't show hand 
*** SUMMARY ***
Total pot $7.50 | Rake $0 
Seat 1: matiko09 folded before Flop (didn't bet)
Seat 2: Mr.Grigoriy folded before Flop (didn't bet)
Seat 3: oscarleon folded before Flop (didn't bet)
Seat 4: maxxmeister folded before Flop
Seat 6: Szevasztopol (button) collected ($7.50)
Seat 7: KDJAll3 (small blind) folded before Flop
Seat 8: mavin80 (big blind) folded before Flop
Seat 9: Filojoes folded before Flop (didn't bet)





PokerStars Hand #154362742961:  Hold'em No Limit ($0.50/$1.00 USD) - 2016/06/06 12:28:32 CET [2016/06/06 6:28:32 ET]
Table 'Chaldaea II' 9-max Seat #8 is the button
Seat 3: ardo888 ($100 in chips) 
Seat 4: ozone2003 ($107.08 in chips) 
Seat 5: MiiiTCHy__ ($63.38 in chips) 
Seat 6: PacPacBum ($100 in chips) 
Seat 7: riggedsh** ($158.88 in chips) 
Seat 8: o.miro ($100 in chips) 
Seat 9: matiko09 ($100.50 in chips) 
matiko09: posts small blind $0.50
maxxmeister: is sitting out 
ardo888: posts big blind $1
*** HOLE CARDS ***
Dealt to matiko09 [8s 5c]
ozone2003: folds 
MiiiTCHy__: folds 
PacPacBum: folds 
riggedsh**: raises $1.50 to $2.50
o.miro: folds 
matiko09: folds 
ardo888: raises $7 to $9.50
riggedsh**: calls $7
*** FLOP *** [9d 4d 3s]
maxxmeister leaves the table
ardo888: bets $9.63
riggedsh**: folds 
Uncalled bet ($9.63) returned to ardo888
ardo888 collected $18.52 from pot
ardo888: doesn't show hand 
*** SUMMARY ***
Total pot $19.50 | Rake $0.98 
Board [9d 4d 3s]
Seat 3: ardo888 (big blind) collected ($18.52)
Seat 4: ozone2003 folded before Flop (didn't bet)
Seat 5: MiiiTCHy__ folded before Flop (didn't bet)
Seat 6: PacPacBum folded before Flop (didn't bet)
Seat 7: riggedsh** folded on the Flop
Seat 8: o.miro (button) folded before Flop (didn't bet)
Seat 9: matiko09 (small blind) folded before Flop





PokerStars Hand #154362746541:  Hold'em No Limit ($0.50/$1.00 USD) - 2016/06/06 12:28:41 CET [2016/06/06 6:28:41 ET]
Table 'Irmgard II' 9-max Seat #9 is the button
Seat 1: matiko09 ($148.50 in chips) 
Seat 2: hammerwife ($115.93 in chips) 
Seat 3: xxxZeka ($100 in chips) 
Seat 4: oscarleon ($167.01 in chips) 
Seat 5: Dantist1122 ($100 in chips) 
Seat 6: maxxmeister ($263.20 in chips) 
Seat 8: Szevasztopol ($100 in chips) 
Seat 9: Filojoes ($137.72 in chips) 
matiko09: posts small blind $0.50
hammerwife: posts big blind $1
*** HOLE CARDS ***
Dealt to matiko09 [2c 5d]
xxxZeka: folds 
oscarleon: folds 
Dantist1122: folds 
maxxmeister: folds 
Szevasztopol: folds 
Filojoes: folds 
matiko09: folds 
Uncalled bet ($0.50) returned to hammerwife
hammerwife collected $1 from pot
hammerwife: doesn't show hand 
*** SUMMARY ***
Total pot $1 | Rake $0 
Seat 1: matiko09 (small blind) folded before Flop
Seat 2: hammerwife (big blind) collected ($1)
Seat 3: xxxZeka folded before Flop (didn't bet)
Seat 4: oscarleon folded before Flop (didn't bet)
Seat 5: Dantist1122 folded before Flop (didn't bet)
Seat 6: maxxmeister folded before Flop (didn't bet)
Seat 8: Szevasztopol folded before Flop (didn't bet)
Seat 9: Filojoes (button) folded before Flop (didn't bet)





PokerStars Hand #154362748092:  Hold'em No Limit ($0.50/$1.00 USD) - 2016/06/06 12:28:44 CET [2016/06/06 6:28:44 ET]
Table 'Gajdariya' 9-max Seat #4 is the button
Seat 1: matiko09 ($100 in chips) 
Seat 3: oscarleon ($105.50 in chips) 
Seat 4: Szevasztopol ($109.63 in chips) 
Seat 5: 147734319 ($110.51 in chips) 
Seat 6: mono123viva ($151.36 in chips) 
Seat 7: Wombatkilla ($94.32 in chips) 
Seat 8: ardo888 ($101.50 in chips) 
147734319: posts small blind $0.50
mono123viva: posts big blind $1
Mr.Grigoriy: sits out 
*** HOLE CARDS ***
Dealt to matiko09 [8s 9s]
Wombatkilla: folds 
ardo888: folds 
matiko09: raises $2 to $3
oscarleon: folds 
Szevasztopol: calls $3
147734319: folds 
mono123viva: calls $2
*** FLOP *** [Td 8c 5d]
mono123viva: checks 
matiko09: bets $5.45
Szevasztopol: folds 
mono123viva: calls $5.45
*** TURN *** [Td 8c 5d] [Ts]
mono123viva: checks 
matiko09: checks 
*** RIVER *** [Td 8c 5d Ts] [5s]
mono123viva: bets $7
matiko09: calls $7
*** SHOW DOWN ***
mono123viva: shows [Kd 6d] (two pair, Tens and Fives)
matiko09: shows [8s 9s] (two pair, Tens and Eights)
matiko09 collected $32.68 from pot
*** SUMMARY ***
Total pot $34.40 | Rake $1.72 
Board [Td 8c 5d Ts 5s]
Seat 1: matiko09 showed [8s 9s] and won ($32.68) with two pair, Tens and Eights
Seat 3: oscarleon folded before Flop (didn't bet)
Seat 4: Szevasztopol (button) folded on the Flop
Seat 5: 147734319 (small blind) folded before Flop
Seat 6: mono123viva (big blind) showed [Kd 6d] and lost with two pair, Tens and Fives
Seat 7: Wombatkilla folded before Flop (didn't bet)
Seat 8: ardo888 folded before Flop (didn't bet)





PokerStars Hand #154362749143:  Hold'em No Limit ($0.50/$1.00 USD) - 2016/06/06 12:28:47 CET [2016/06/06 6:28:47 ET]
Table 'Heze' 9-max Seat #5 is the button
Seat 1: matiko09 ($215.15 in chips) 
Seat 2: oscarleon ($259.31 in chips) 
Seat 3: maxxmeister ($105 in chips) 
Seat 4: xxxZeka ($100 in chips) 
Seat 5: Filojoes ($100.24 in chips) 
Seat 6: ozone2003 ($100.50 in chips) 
Seat 7: Priidix ($101.50 in chips) 
Seat 8: AlSmithy88 ($45.34 in chips) 
Seat 9: Mr.Grigoriy ($132.26 in chips) 
ozone2003: posts small blind $0.50
Priidix: posts big blind $1
*** HOLE CARDS ***
Dealt to matiko09 [8c 6h]
AlSmithy88: folds 
Mr.Grigoriy: raises $2 to $3
matiko09: folds 
oscarleon: folds 
maxxmeister: calls $3
xxxZeka: folds 
AlSmithy88 is disconnected 
Filojoes: folds 
ozone2003: folds 
Priidix: folds 
*** FLOP *** [7c 2s Td]
Mr.Grigoriy: bets $5.06
maxxmeister: calls $5.06
*** TURN *** [7c 2s Td] [Jd]
Mr.Grigoriy: checks 
maxxmeister: bets $12
Mr.Grigoriy: folds 
Uncalled bet ($12) returned to maxxmeister
maxxmeister collected $16.74 from pot
maxxmeister: doesn't show hand 
*** SUMMARY ***
Total pot $17.62 | Rake $0.88 
Board [7c 2s Td Jd]
Seat 1: matiko09 folded before Flop (didn't bet)
Seat 2: oscarleon folded before Flop (didn't bet)
Seat 3: maxxmeister collected ($16.74)
Seat 4: xxxZeka folded before Flop (didn't bet)
Seat 5: Filojoes (button) folded before Flop (didn't bet)
Seat 6: ozone2003 (small blind) folded before Flop
Seat 7: Priidix (big blind) folded before Flop
Seat 8: AlSmithy88 folded before Flop (didn't bet)
Seat 9: Mr.Grigoriy folded on the Turn





PokerStars Hand #154362751606:  Hold'em No Limit ($0.50/$1.00 USD) - 2016/06/06 12:28:53 CET [2016/06/06 6:28:53 ET]
Table 'Yarilo' 9-max Seat #9 is the button
Seat 1: xxxZeka ($100 in chips) 
Seat 3: matiko09 ($112.42 in chips) 
Seat 4: riggedsh** ($113.38 in chips) 
Seat 5: Szevasztopol ($137.19 in chips) 
Seat 6: maxxmeister ($100 in chips) 
Seat 7: KEBIN1974 ($100 in chips) 
Seat 8: Mr.Grigoriy ($153.67 in chips) 
Seat 9: Filojoes ($105.48 in chips) 
xxxZeka: posts small blind $0.50
thecurv: is sitting out 
matiko09: posts big blind $1
*** HOLE CARDS ***
Dealt to matiko09 [Ts Qc]
thecurv leaves the table
riggedsh**: folds 
nombraalne1 joins the table at seat #2 
Szevasztopol: folds 
maxxmeister: folds 
KEBIN1974: folds 
Mr.Grigoriy: folds 
Filojoes: raises $1 to $2
xxxZeka: folds 
matiko09: calls $1
*** FLOP *** [9c Ad 2s]
matiko09: checks 
Filojoes: bets $2.57
matiko09: folds 
Uncalled bet ($2.57) returned to Filojoes
Filojoes collected $4.28 from pot
Filojoes: doesn't show hand 
*** SUMMARY ***
Total pot $4.50 | Rake $0.22 
Board [9c Ad 2s]
Seat 1: xxxZeka (small blind) folded before Flop
Seat 3: matiko09 (big blind) folded on the Flop
Seat 4: riggedsh** folded before Flop (didn't bet)
Seat 5: Szevasztopol folded before Flop (didn't bet)
Seat 6: maxxmeister folded before Flop (didn't bet)
Seat 7: KEBIN1974 folded before Flop (didn't bet)
Seat 8: Mr.Grigoriy folded before Flop (didn't bet)
Seat 9: Filojoes (button) collected ($4.28)





PokerStars Hand #154362760595:  Hold'em No Limit ($0.50/$1.00 USD) - 2016/06/06 12:29:16 CET [2016/06/06 6:29:16 ET]
Table 'Irmgard II' 9-max Seat #1 is the button
Seat 1: matiko09 ($148 in chips) 
Seat 2: hammerwife ($116.43 in chips) 
Seat 4: oscarleon ($167.01 in chips) 
Seat 5: Dantist1122 ($100 in chips) 
Seat 6: maxxmeister ($263.20 in chips) 
Seat 8: Szevasztopol ($100 in chips) 
Seat 9: Filojoes ($137.72 in chips) 
hammerwife: posts small blind $0.50
xxxZeka: is sitting out 
oscarleon: posts big blind $1
*** HOLE CARDS ***
Dealt to matiko09 [7h 5c]
Dantist1122: folds 
Dantist1122 leaves the table
Mr.Grigoriy joins the table at seat #5 
maxxmeister: folds 
Szevasztopol: folds 
Filojoes: raises $1.50 to $2.50
matiko09: folds 
Mr.Grigoriy leaves the table
hammerwife: folds 
oscarleon: folds 
Uncalled bet ($1.50) returned to Filojoes
Filojoes collected $2.50 from pot
Filojoes: doesn't show hand 
*** SUMMARY ***
Total pot $2.50 | Rake $0 
Seat 1: matiko09 (button) folded before Flop (didn't bet)
Seat 2: hammerwife (small blind) folded before Flop
Seat 4: oscarleon (big blind) folded before Flop
Seat 5: Dantist1122 folded before Flop (didn't bet)
Seat 6: maxxmeister folded before Flop (didn't bet)
Seat 8: Szevasztopol folded before Flop (didn't bet)
Seat 9: Filojoes collected ($2.50)





PokerStars Hand #154362763939:  Hold'em No Limit ($0.50/$1.00 USD) - 2016/06/06 12:29:25 CET [2016/06/06 6:29:25 ET]
Table 'Williams' 9-max Seat #8 is the button
Seat 1: matiko09 ($194.29 in chips) 
Seat 2: PacPacBum ($100 in chips) 
Seat 3: granbunny ($54.60 in chips) 
Seat 4: Filojoes ($120.92 in chips) 
Seat 5: ardo888 ($126 in chips) 
Seat 6: Priidix ($121.94 in chips) 
Seat 7: kevinho109 ($71.06 in chips) 
Seat 8: oscarleon ($110.36 in chips) 
Seat 9: kind ten ($40.05 in chips) 
kind ten: posts small blind $0.50
matiko09: posts big blind $1
*** HOLE CARDS ***
Dealt to matiko09 [7h 5d]
PacPacBum: folds 
granbunny: folds 
Filojoes: folds 
ardo888: folds 
Priidix: folds 
kevinho109: folds 
oscarleon: raises $2 to $3
kind ten: folds 
matiko09: folds 
Uncalled bet ($2) returned to oscarleon
oscarleon collected $2.50 from pot
oscarleon: doesn't show hand 
*** SUMMARY ***
Total pot $2.50 | Rake $0 
Seat 1: matiko09 (big blind) folded before Flop
Seat 2: PacPacBum folded before Flop (didn't bet)
Seat 3: granbunny folded before Flop (didn't bet)
Seat 4: Filojoes folded before Flop (didn't bet)
Seat 5: ardo888 folded before Flop (didn't bet)
Seat 6: Priidix folded before Flop (didn't bet)
Seat 7: kevinho109 folded before Flop (didn't bet)
Seat 8: oscarleon (button) collected ($2.50)
Seat 9: kind ten (small blind) folded before Flop





PokerStars Hand #154362769090:  Hold'em No Limit ($0.50/$1.00 USD) - 2016/06/06 12:29:38 CET [2016/06/06 6:29:38 ET]
Table 'Wezen II' 9-max Seat #7 is the button
Seat 1: matiko09 ($163.97 in chips) 
Seat 2: Mr.Grigoriy ($108.18 in chips) 
Seat 3: oscarleon ($103.18 in chips) 
Seat 4: maxxmeister ($142 in chips) 
Seat 6: Szevasztopol ($104.50 in chips) 
Seat 7: KDJAll3 ($82.02 in chips) 
Seat 8: mavin80 ($155.48 in chips) 
Seat 9: Filojoes ($107.01 in chips) 
mavin80: posts small blind $0.50
Filojoes: posts big blind $1
stds st: sits out 
*** HOLE CARDS ***
Dealt to matiko09 [7d 5s]
matiko09: folds 
Mr.Grigoriy: folds 
oscarleon: folds 
maxxmeister: raises $2 to $3
Szevasztopol: folds 
KDJAll3: folds 
mavin80: raises $6.50 to $9.50
Filojoes: folds 
maxxmeister: folds 
Uncalled bet ($6.50) returned to mavin80
mavin80 collected $7 from pot
mavin80: doesn't show hand 
*** SUMMARY ***
Total pot $7 | Rake $0 
Seat 1: matiko09 folded before Flop (didn't bet)
Seat 2: Mr.Grigoriy folded before Flop (didn't bet)
Seat 3: oscarleon folded before Flop (didn't bet)
Seat 4: maxxmeister folded before Flop
Seat 6: Szevasztopol folded before Flop (didn't bet)
Seat 7: KDJAll3 (button) folded before Flop (didn't bet)
Seat 8: mavin80 (small blind) collected ($7)
Seat 9: Filojoes (big blind) folded before Flop





PokerStars Hand #154362769753:  Hold'em No Limit ($0.50/$1.00 USD) - 2016/06/06 12:29:39 CET [2016/06/06 6:29:39 ET]
Table 'Safara' 9-max Seat #4 is the button
Seat 1: oscarleon ($234.44 in chips) 
Seat 2: Szevasztopol ($100 in chips) 
Seat 3: ozone2003 ($103 in chips) 
Seat 4: mattyt212 ($203 in chips) 
Seat 5: Dantist1122 ($100 in chips) 
Seat 6: matiko09 ($100 in chips) 
Seat 8: Priidix ($101.50 in chips) 
Seat 9: Mr.Grigoriy ($105.67 in chips) 
Dantist1122: posts small blind $0.50
matiko09: posts big blind $1
PacPacBum: sits out 
*** HOLE CARDS ***
Dealt to matiko09 [Ah 6h]
Priidix: folds 
Mr.Grigoriy: folds 
oscarleon: folds 
Szevasztopol: folds 
ozone2003: folds 
mattyt212: folds 
Dantist1122: raises $2 to $3
matiko09: calls $2
*** FLOP *** [5d Ts 7d]
Dantist1122: checks 
matiko09: checks 
*** TURN *** [5d Ts 7d] [8h]
Dantist1122: bets $3.70
matiko09: calls $3.70
*** RIVER *** [5d Ts 7d 8h] [Ks]
Dantist1122: bets $8.27
matiko09: folds 
Uncalled bet ($8.27) returned to Dantist1122
Dantist1122 collected $12.73 from pot
Dantist1122: doesn't show hand 
*** SUMMARY ***
Total pot $13.40 | Rake $0.67 
Board [5d Ts 7d 8h Ks]
Seat 1: oscarleon folded before Flop (didn't bet)
Seat 2: Szevasztopol folded before Flop (didn't bet)
Seat 3: ozone2003 folded before Flop (didn't bet)
Seat 4: mattyt212 (button) folded before Flop (didn't bet)
Seat 5: Dantist1122 (small blind) collected ($12.73)
Seat 6: matiko09 (big blind) folded on the River
Seat 8: Priidix folded before Flop (didn't bet)
Seat 9: Mr.Grigoriy folded before Flop (didn't bet)





PokerStars Hand #154362770794:  Hold'em No Limit ($0.50/$1.00 USD) - 2016/06/06 12:29:42 CET [2016/06/06 6:29:42 ET]
Table 'Yarilo' 9-max Seat #3 is the button
Seat 3: matiko09 ($110.42 in chips) 
Seat 4: riggedsh** ($113.38 in chips) 
Seat 5: Szevasztopol ($137.19 in chips) 
Seat 6: maxxmeister ($100 in chips) 
Seat 7: KEBIN1974 ($100 in chips) 
Seat 8: Mr.Grigoriy ($153.67 in chips) 
Seat 9: Filojoes ($107.76 in chips) 
riggedsh**: posts small blind $0.50
Szevasztopol: posts big blind $1
nombraalne1: sits out 
*** HOLE CARDS ***
Dealt to matiko09 [8h 2d]
maxxmeister: folds 
KEBIN1974: raises $1.50 to $2.50
Mr.Grigoriy: raises $5 to $7.50
Filojoes: folds 
matiko09: folds 
riggedsh**: folds 
Szevasztopol: folds 
KEBIN1974: calls $5
*** FLOP *** [Ah 8d Jh]
KEBIN1974: bets $9.09
Mr.Grigoriy: calls $9.09
*** TURN *** [Ah 8d Jh] [7s]
KEBIN1974: checks 
Mr.Grigoriy: bets $23.39
KEBIN1974: folds 
Uncalled bet ($23.39) returned to Mr.Grigoriy
Mr.Grigoriy collected $32.95 from pot
Mr.Grigoriy: doesn't show hand 
*** SUMMARY ***
Total pot $34.68 | Rake $1.73 
Board [Ah 8d Jh 7s]
Seat 3: matiko09 (button) folded before Flop (didn't bet)
Seat 4: riggedsh** (small blind) folded before Flop
Seat 5: Szevasztopol (big blind) folded before Flop
Seat 6: maxxmeister folded before Flop (didn't bet)
Seat 7: KEBIN1974 folded on the Turn
Seat 8: Mr.Grigoriy collected ($32.95)
Seat 9: Filojoes folded before Flop (didn't bet)





PokerStars Hand #154362771947:  Hold'em No Limit ($0.50/$1.00 USD) - 2016/06/06 12:29:45 CET [2016/06/06 6:29:45 ET]
Table 'Irmgard II' 9-max Seat #2 is the button
Seat 1: matiko09 ($148 in chips) 
Seat 2: hammerwife ($115.93 in chips) 
Seat 4: oscarleon ($166.01 in chips) 
Seat 6: maxxmeister ($263.20 in chips) 
Seat 8: Szevasztopol ($100 in chips) 
Seat 9: Filojoes ($139.22 in chips) 
oscarleon: posts small blind $0.50
maxxmeister: posts big blind $1
*** HOLE CARDS ***
Dealt to matiko09 [7c Js]
Szevasztopol: folds 
Filojoes: folds 
matiko09: folds 
hammerwife: raises $1.01 to $2.01
oscarleon: raises $6.99 to $9
maxxmeister: folds 
hammerwife: calls $6.99
*** FLOP *** [2d Kh 5d]
oscarleon: bets $13
hammerwife: calls $13
*** TURN *** [2d Kh 5d] [Ad]
32rrew joins the table at seat #7 
oscarleon: checks 
hammerwife: bets $21.50
oscarleon: calls $21.50
*** RIVER *** [2d Kh 5d Ad] [Qs]
oscarleon: checks 
hammerwife: checks 
*** SHOW DOWN ***
oscarleon: shows [Jc Ac] (a pair of Aces)
hammerwife: shows [Jh Ah] (a pair of Aces)
xxxZeka leaves the table
oscarleon collected $42.75 from pot
hammerwife collected $42.75 from pot
*** SUMMARY ***
Total pot $88 | Rake $2.50 
Board [2d Kh 5d Ad Qs]
Seat 1: matiko09 folded before Flop (didn't bet)
Seat 2: hammerwife (button) showed [Jh Ah] and won ($42.75) with a pair of Aces
Seat 4: oscarleon (small blind) showed [Jc Ac] and won ($42.75) with a pair of Aces
Seat 6: maxxmeister (big blind) folded before Flop
Seat 8: Szevasztopol folded before Flop (didn't bet)
Seat 9: Filojoes folded before Flop (didn't bet)





PokerStars Hand #154362773605:  Hold'em No Limit ($0.50/$1.00 USD) - 2016/06/06 12:29:49 CET [2016/06/06 6:29:49 ET]
Table 'Chaldaea II' 9-max Seat #9 is the button
Seat 3: ardo888 ($109.02 in chips) 
Seat 4: ozone2003 ($107.08 in chips) 
Seat 5: MiiiTCHy__ ($63.38 in chips) 
Seat 6: PacPacBum ($100 in chips) 
Seat 7: riggedsh** ($149.38 in chips) 
Seat 8: o.miro ($100 in chips) 
Seat 9: matiko09 ($100 in chips) 
ardo888: posts small blind $0.50
ozone2003: posts big blind $1
*** HOLE CARDS ***
Dealt to matiko09 [6d Ah]
MiiiTCHy__: folds 
PacPacBum: folds 
riggedsh**: folds 
o.miro: folds 
matiko09: folds 
ardo888: calls $0.50
ozone2003: checks 
*** FLOP *** [4h Td Kd]
ardo888: bets $1
ozone2003: raises $4.03 to $5.03
ardo888: calls $4.03
*** TURN *** [4h Td Kd] [5s]
ardo888: checks 
masaytoo joins the table at seat #2 
ozone2003: bets $10.22
ardo888: calls $10.22
*** RIVER *** [4h Td Kd 5s] [Js]
ardo888: checks 
ozone2003: bets $9.45
ardo888: folds 
Uncalled bet ($9.45) returned to ozone2003
ozone2003 collected $30.88 from pot
ozone2003: doesn't show hand 
*** SUMMARY ***
Total pot $32.50 | Rake $1.62 
Board [4h Td Kd 5s Js]
Seat 3: ardo888 (small blind) folded on the River
Seat 4: ozone2003 (big blind) collected ($30.88)
Seat 5: MiiiTCHy__ folded before Flop (didn't bet)
Seat 6: PacPacBum folded before Flop (didn't bet)
Seat 7: riggedsh** folded before Flop (didn't bet)
Seat 8: o.miro folded before Flop (didn't bet)
Seat 9: matiko09 (button) folded before Flop (didn't bet)





PokerStars Hand #154362775359:  Hold'em No Limit ($0.50/$1.00 USD) - 2016/06/06 12:29:53 CET [2016/06/06 6:29:53 ET]
Table 'Williams' 9-max Seat #9 is the button
Seat 1: matiko09 ($193.29 in chips) 
Seat 2: PacPacBum ($100 in chips) 
Seat 3: granbunny ($54.60 in chips) 
Seat 4: Filojoes ($120.92 in chips) 
Seat 5: ardo888 ($126 in chips) 
Seat 6: Priidix ($121.94 in chips) 
Seat 7: kevinho109 ($71.06 in chips) 
Seat 8: oscarleon ($111.86 in chips) 
Seat 9: kind ten ($39.55 in chips) 
matiko09: posts small blind $0.50
PacPacBum: posts big blind $1
*** HOLE CARDS ***
Dealt to matiko09 [Jd 2h]
granbunny: folds 
Filojoes: folds 
ardo888: folds 
Priidix: folds 
kevinho109: folds 
oscarleon: raises $2 to $3
kind ten: folds 
matiko09: folds 
PacPacBum: raises $6 to $9
oscarleon: folds 
Uncalled bet ($6) returned to PacPacBum
PacPacBum collected $6.50 from pot
PacPacBum: doesn't show hand 
*** SUMMARY ***
Total pot $6.50 | Rake $0 
Seat 1: matiko09 (small blind) folded before Flop
Seat 2: PacPacBum (big blind) collected ($6.50)
Seat 3: granbunny folded before Flop (didn't bet)
Seat 4: Filojoes folded before Flop (didn't bet)
Seat 5: ardo888 folded before Flop (didn't bet)
Seat 6: Priidix folded before Flop (didn't bet)
Seat 7: kevinho109 folded before Flop (didn't bet)
Seat 8: oscarleon folded before Flop
Seat 9: kind ten (button) folded before Flop (didn't bet)





PokerStars Hand #154362787099:  Hold'em No Limit ($0.50/$1.00 USD) - 2016/06/06 12:30:23 CET [2016/06/06 6:30:23 ET]
Table 'Heze' 9-max Seat #6 is the button
Seat 1: matiko09 ($215.15 in chips) 
Seat 2: oscarleon ($259.31 in chips) 
Seat 3: maxxmeister ($113.68 in chips) 
Seat 5: Filojoes ($100.24 in chips) 
Seat 6: ozone2003 ($100 in chips) 
Seat 7: Priidix ($100.50 in chips) 
Seat 8: AlSmithy88 ($45.34 in chips) 
Seat 9: Mr.Grigoriy ($124.20 in chips) 
Priidix: posts small blind $0.50
AlSmithy88: posts big blind $1
*** HOLE CARDS ***
Dealt to matiko09 [3s 7d]
Mr.Grigoriy: folds 
matiko09: folds 
oscarleon: raises $2 to $3
maxxmeister: calls $3
Filojoes: folds 
ozone2003: folds 
Priidix: folds 
AlSmithy88: folds 
*** FLOP *** [Kd 7h Tc]
oscarleon: bets $5
maxxmeister: calls $5
*** TURN *** [Kd 7h Tc] [6d]
oscarleon: checks 
maxxmeister: bets $8
oscarleon: calls $8
*** RIVER *** [Kd 7h Tc 6d] [7c]
oscarleon: checks 
maxxmeister: checks 
*** SHOW DOWN ***
oscarleon: shows [8s 8h] (two pair, Eights and Sevens)
maxxmeister: shows [Jd Jh] (two pair, Jacks and Sevens)
maxxmeister collected $31.82 from pot
*** SUMMARY ***
Total pot $33.50 | Rake $1.68 
Board [Kd 7h Tc 6d 7c]
Seat 1: matiko09 folded before Flop (didn't bet)
Seat 2: oscarleon showed [8s 8h] and lost with two pair, Eights and Sevens
Seat 3: maxxmeister showed [Jd Jh] and won ($31.82) with two pair, Jacks and Sevens
Seat 5: Filojoes folded before Flop (didn't bet)
Seat 6: ozone2003 (button) folded before Flop (didn't bet)
Seat 7: Priidix (small blind) folded before Flop
Seat 8: AlSmithy88 (big blind) folded before Flop
Seat 9: Mr.Grigoriy folded before Flop (didn't bet)





PokerStars Hand #154362787677:  Hold'em No Limit ($0.50/$1.00 USD) - 2016/06/06 12:30:24 CET [2016/06/06 6:30:24 ET]
Table 'Gajdariya' 9-max Seat #5 is the button
Seat 1: matiko09 ($117.23 in chips) 
Seat 3: oscarleon ($105.50 in chips) 
Seat 4: Szevasztopol ($106.63 in chips) 
Seat 5: 147734319 ($110.01 in chips) 
Seat 6: mono123viva ($135.91 in chips) 
Seat 7: Wombatkilla ($94.32 in chips) 
Seat 8: ardo888 ($101.50 in chips) 
mono123viva: posts small blind $0.50
Wombatkilla: posts big blind $1
Mr.Grigoriy: sits out 
*** HOLE CARDS ***
Dealt to matiko09 [4c Td]
ardo888: folds 
matiko09: folds 
oscarleon: folds 
Szevasztopol: raises $1.04 to $2.04
147734319: folds 
mono123viva: folds 
Wombatkilla: folds 
Uncalled bet ($1.04) returned to Szevasztopol
Szevasztopol collected $2.50 from pot
Szevasztopol: doesn't show hand 
*** SUMMARY ***
Total pot $2.50 | Rake $0 
Seat 1: matiko09 folded before Flop (didn't bet)
Seat 3: oscarleon folded before Flop (didn't bet)
Seat 4: Szevasztopol collected ($2.50)
Seat 5: 147734319 (button) folded before Flop (didn't bet)
Seat 6: mono123viva (small blind) folded before Flop
Seat 7: Wombatkilla (big blind) folded before Flop
Seat 8: ardo888 folded before Flop (didn't bet)





PokerStars Hand #154362787983:  Hold'em No Limit ($0.50/$1.00 USD) - 2016/06/06 12:30:25 CET [2016/06/06 6:30:25 ET]
Table 'Wezen II' 9-max Seat #8 is the button
Seat 1: matiko09 ($163.97 in chips) 
Seat 2: Mr.Grigoriy ($108.18 in chips) 
Seat 3: oscarleon ($103.18 in chips) 
Seat 4: maxxmeister ($139 in chips) 
Seat 6: Szevasztopol ($104.50 in chips) 
Seat 7: KDJAll3 ($82.02 in chips) 
Seat 8: mavin80 ($159.48 in chips) 
Seat 9: Filojoes ($106.01 in chips) 
Filojoes: posts small blind $0.50
matiko09: posts big blind $1
stds st: sits out 
*** HOLE CARDS ***
Dealt to matiko09 [8s Th]
Mr.Grigoriy: folds 
oscarleon: folds 
maxxmeister: folds 
Szevasztopol: raises $1.14 to $2.14
KDJAll3: calls $2.14
mavin80: folds 
Filojoes: folds 
matiko09: folds 
*** FLOP *** [2d Qd 5d]
Szevasztopol: checks 
KDJAll3: bets $3
Szevasztopol: folds 
Uncalled bet ($3) returned to KDJAll3
KDJAll3 collected $5.49 from pot
KDJAll3: doesn't show hand 
*** SUMMARY ***
Total pot $5.78 | Rake $0.29 
Board [2d Qd 5d]
Seat 1: matiko09 (big blind) folded before Flop
Seat 2: Mr.Grigoriy folded before Flop (didn't bet)
Seat 3: oscarleon folded before Flop (didn't bet)
Seat 4: maxxmeister folded before Flop (didn't bet)
Seat 6: Szevasztopol folded on the Flop
Seat 7: KDJAll3 collected ($5.49)
Seat 8: mavin80 (button) folded before Flop (didn't bet)
Seat 9: Filojoes (small blind) folded before Flop





PokerStars Hand #154362788044:  Hold'em No Limit ($0.50/$1.00 USD) - 2016/06/06 12:30:25 CET [2016/06/06 6:30:25 ET]
Table 'Williams' 9-max Seat #1 is the button
Seat 1: matiko09 ($192.79 in chips) 
Seat 2: PacPacBum ($103.50 in chips) 
Seat 3: granbunny ($54.60 in chips) 
Seat 4: Filojoes ($120.92 in chips) 
Seat 5: ardo888 ($126 in chips) 
Seat 6: Priidix ($121.94 in chips) 
Seat 7: kevinho109 ($71.06 in chips) 
Seat 8: oscarleon ($108.86 in chips) 
Seat 9: kind ten ($39.55 in chips) 
PacPacBum: posts small blind $0.50
granbunny: posts big blind $1
*** HOLE CARDS ***
Dealt to matiko09 [4s Th]
Filojoes: folds 
ardo888: folds 
Priidix: folds 
kevinho109: folds 
oscarleon: folds 
kind ten: folds 
matiko09: folds 
PacPacBum: folds 
Uncalled bet ($0.50) returned to granbunny
granbunny collected $1 from pot
granbunny: doesn't show hand 
*** SUMMARY ***
Total pot $1 | Rake $0 
Seat 1: matiko09 (button) folded before Flop (didn't bet)
Seat 2: PacPacBum (small blind) folded before Flop
Seat 3: granbunny (big blind) collected ($1)
Seat 4: Filojoes folded before Flop (didn't bet)
Seat 5: ardo888 folded before Flop (didn't bet)
Seat 6: Priidix folded before Flop (didn't bet)
Seat 7: kevinho109 folded before Flop (didn't bet)
Seat 8: oscarleon folded before Flop (didn't bet)
Seat 9: kind ten folded before Flop (didn't bet)





PokerStars Hand #154362798940:  Hold'em No Limit ($0.50/$1.00 USD) - 2016/06/06 12:30:53 CET [2016/06/06 6:30:53 ET]
Table 'Gajdariya' 9-max Seat #6 is the button
Seat 1: matiko09 ($117.23 in chips) 
Seat 3: oscarleon ($105.50 in chips) 
Seat 4: Szevasztopol ($108.13 in chips) 
Seat 5: 147734319 ($110.01 in chips) 
Seat 6: mono123viva ($135.41 in chips) 
Seat 7: Wombatkilla ($93.32 in chips) 
Seat 8: ardo888 ($101.50 in chips) 
Wombatkilla: posts small blind $0.50
ardo888: posts big blind $1
Mr.Grigoriy: sits out 
*** HOLE CARDS ***
Dealt to matiko09 [Jc Jh]
matiko09: raises $2 to $3
oscarleon: folds 
Szevasztopol: folds 
147734319: folds 
mono123viva has timed out
mono123viva: folds 
Wombatkilla: folds 
ardo888: folds 
Uncalled bet ($2) returned to matiko09
matiko09 collected $2.50 from pot
matiko09: doesn't show hand 
*** SUMMARY ***
Total pot $2.50 | Rake $0 
Seat 1: matiko09 collected ($2.50)
Seat 3: oscarleon folded before Flop (didn't bet)
Seat 4: Szevasztopol folded before Flop (didn't bet)
Seat 5: 147734319 folded before Flop (didn't bet)
Seat 6: mono123viva (button) folded before Flop (didn't bet)
Seat 7: Wombatkilla (small blind) folded before Flop
Seat 8: ardo888 (big blind) folded before Flop





PokerStars Hand #154362798935:  Hold'em No Limit ($0.50/$1.00 USD) - 2016/06/06 12:30:53 CET [2016/06/06 6:30:53 ET]
Table 'Williams' 9-max Seat #2 is the button
Seat 1: matiko09 ($192.79 in chips) 
Seat 2: PacPacBum ($103 in chips) 
Seat 3: granbunny ($55.10 in chips) 
Seat 4: Filojoes ($120.92 in chips) 
Seat 5: ardo888 ($126 in chips) 
Seat 6: Priidix ($121.94 in chips) 
Seat 7: kevinho109 ($71.06 in chips) 
Seat 8: oscarleon ($108.86 in chips) 
Seat 9: kind ten ($39.55 in chips) 
granbunny: posts small blind $0.50
Filojoes: posts big blind $1
*** HOLE CARDS ***
Dealt to matiko09 [5d 8c]
ardo888: folds 
Priidix: raises $2 to $3
kevinho109: folds 
oscarleon: folds 
kind ten: folds 
matiko09: folds 
PacPacBum: folds 
granbunny: folds 
Filojoes: folds 
Uncalled bet ($2) returned to Priidix
Priidix collected $2.50 from pot
Priidix: doesn't show hand 
*** SUMMARY ***
Total pot $2.50 | Rake $0 
Seat 1: matiko09 folded before Flop (didn't bet)
Seat 2: PacPacBum (button) folded before Flop (didn't bet)
Seat 3: granbunny (small blind) folded before Flop
Seat 4: Filojoes (big blind) folded before Flop
Seat 5: ardo888 folded before Flop (didn't bet)
Seat 6: Priidix collected ($2.50)
Seat 7: kevinho109 folded before Flop (didn't bet)
Seat 8: oscarleon folded before Flop (didn't bet)
Seat 9: kind ten folded before Flop (didn't bet)





PokerStars Hand #154362803651:  Hold'em No Limit ($0.50/$1.00 USD) - 2016/06/06 12:31:04 CET [2016/06/06 6:31:04 ET]
Table 'Safara' 9-max Seat #5 is the button
Seat 1: oscarleon ($234.44 in chips) 
Seat 2: Szevasztopol ($100 in chips) 
Seat 3: ozone2003 ($103 in chips) 
Seat 4: mattyt212 ($203 in chips) 
Seat 5: Dantist1122 ($106.03 in chips) 
Seat 6: matiko09 ($100 in chips) 
Seat 7: PacPacBum ($100 in chips) 
Seat 8: Priidix ($101.50 in chips) 
Seat 9: Mr.Grigoriy ($105.67 in chips) 
matiko09: posts small blind $0.50
PacPacBum: posts big blind $1
*** HOLE CARDS ***
Dealt to matiko09 [Kd Ah]
Priidix: folds 
Mr.Grigoriy: folds 
oscarleon: folds 
Szevasztopol: raises $1.14 to $2.14
ozone2003: folds 
mattyt212: folds 
Dantist1122: folds 
matiko09: calls $1.64
PacPacBum: folds 
*** FLOP *** [Ks 9h Kh]
matiko09: checks 
Szevasztopol: checks 
*** TURN *** [Ks 9h Kh] [4s]
matiko09: bets $3.26
Szevasztopol: folds 
Uncalled bet ($3.26) returned to matiko09
matiko09 collected $5.02 from pot
matiko09: doesn't show hand 
*** SUMMARY ***
Total pot $5.28 | Rake $0.26 
Board [Ks 9h Kh 4s]
Seat 1: oscarleon folded before Flop (didn't bet)
Seat 2: Szevasztopol folded on the Turn
Seat 3: ozone2003 folded before Flop (didn't bet)
Seat 4: mattyt212 folded before Flop (didn't bet)
Seat 5: Dantist1122 (button) folded before Flop (didn't bet)
Seat 6: matiko09 (small blind) collected ($5.02)
Seat 7: PacPacBum (big blind) folded before Flop
Seat 8: Priidix folded before Flop (didn't bet)
Seat 9: Mr.Grigoriy folded before Flop (didn't bet)





PokerStars Hand #154362804000:  Hold'em No Limit ($0.50/$1.00 USD) - 2016/06/06 12:31:05 CET [2016/06/06 6:31:05 ET]
Table 'Irmgard II' 9-max Seat #4 is the button
Seat 1: matiko09 ($148 in chips) 
Seat 2: hammerwife ($115.18 in chips) 
Seat 4: oscarleon ($165.26 in chips) 
Seat 6: maxxmeister ($262.20 in chips) 
Seat 7: 32rrew ($100 in chips) 
Seat 8: Szevasztopol ($100 in chips) 
Seat 9: Filojoes ($139.22 in chips) 
maxxmeister: posts small blind $0.50
32rrew: posts big blind $1
*** HOLE CARDS ***
Dealt to matiko09 [Qd Jc]
Szevasztopol: folds 
Filojoes: folds 
matiko09: folds 
hammerwife: folds 
oscarleon: raises $2 to $3
maxxmeister: folds 
32rrew: calls $2
*** FLOP *** [8c 9h Td]
32rrew: checks 
oscarleon: checks 
*** TURN *** [8c 9h Td] [Ad]
32rrew: checks 
oscarleon: checks 
*** RIVER *** [8c 9h Td Ad] [3d]
stds st joins the table at seat #3 
32rrew: bets $4.11
oscarleon: folds 
Uncalled bet ($4.11) returned to 32rrew
32rrew collected $6.18 from pot
32rrew: doesn't show hand 
*** SUMMARY ***
Total pot $6.50 | Rake $0.32 
Board [8c 9h Td Ad 3d]
Seat 1: matiko09 folded before Flop (didn't bet)
Seat 2: hammerwife folded before Flop (didn't bet)
Seat 4: oscarleon (button) folded on the River
Seat 6: maxxmeister (small blind) folded before Flop
Seat 7: 32rrew (big blind) collected ($6.18)
Seat 8: Szevasztopol folded before Flop (didn't bet)
Seat 9: Filojoes folded before Flop (didn't bet)





PokerStars Hand #154362809947:  Hold'em No Limit ($0.50/$1.00 USD) - 2016/06/06 12:31:20 CET [2016/06/06 6:31:20 ET]
Table 'Williams' 9-max Seat #3 is the button
Seat 1: matiko09 ($192.79 in chips) 
Seat 2: PacPacBum ($103 in chips) 
Seat 3: granbunny ($54.60 in chips) 
Seat 4: Filojoes ($119.92 in chips) 
Seat 5: ardo888 ($126 in chips) 
Seat 6: Priidix ($123.44 in chips) 
Seat 7: kevinho109 ($71.06 in chips) 
Seat 8: oscarleon ($108.86 in chips) 
Seat 9: kind ten ($39.55 in chips) 
Filojoes: posts small blind $0.50
ardo888: posts big blind $1
*** HOLE CARDS ***
Dealt to matiko09 [3c Qd]
Priidix: raises $2 to $3
kevinho109: folds 
oscarleon: folds 
kind ten: folds 
matiko09: folds 
PacPacBum: folds 
granbunny: folds 
Filojoes: folds 
ardo888: folds 
Uncalled bet ($2) returned to Priidix
Priidix collected $2.50 from pot
Priidix: doesn't show hand 
*** SUMMARY ***
Total pot $2.50 | Rake $0 
Seat 1: matiko09 folded before Flop (didn't bet)
Seat 2: PacPacBum folded before Flop (didn't bet)
Seat 3: granbunny (button) folded before Flop (didn't bet)
Seat 4: Filojoes (small blind) folded before Flop
Seat 5: ardo888 (big blind) folded before Flop
Seat 6: Priidix collected ($2.50)
Seat 7: kevinho109 folded before Flop (didn't bet)
Seat 8: oscarleon folded before Flop (didn't bet)
Seat 9: kind ten folded before Flop (didn't bet)





PokerStars Hand #154362816295:  Hold'em No Limit ($0.50/$1.00 USD) - 2016/06/06 12:31:36 CET [2016/06/06 6:31:36 ET]
Table 'Gajdariya' 9-max Seat #7 is the button
Seat 1: matiko09 ($118.73 in chips) 
Seat 2: xxxZeka ($126.74 in chips) 
Seat 3: oscarleon ($105.50 in chips) 
Seat 4: Szevasztopol ($108.13 in chips) 
Seat 5: 147734319 ($110.01 in chips) 
Seat 6: mono123viva ($135.41 in chips) 
Seat 7: Wombatkilla ($92.82 in chips) 
Seat 8: ardo888 ($100.50 in chips) 
Seat 9: Mr.Grigoriy ($104.56 in chips) 
ardo888: posts small blind $0.50
Mr.Grigoriy: posts big blind $1
*** HOLE CARDS ***
Dealt to matiko09 [Th 5h]
matiko09: folds 
xxxZeka: raises $2 to $3
oscarleon: folds 
Szevasztopol: folds 
147734319: folds 
mono123viva: folds 
Wombatkilla: folds 
ardo888: folds 
Mr.Grigoriy: folds 
Uncalled bet ($2) returned to xxxZeka
xxxZeka collected $2.50 from pot
*** SUMMARY ***
Total pot $2.50 | Rake $0 
Seat 1: matiko09 folded before Flop (didn't bet)
Seat 2: xxxZeka collected ($2.50)
Seat 3: oscarleon folded before Flop (didn't bet)
Seat 4: Szevasztopol folded before Flop (didn't bet)
Seat 5: 147734319 folded before Flop (didn't bet)
Seat 6: mono123viva folded before Flop (didn't bet)
Seat 7: Wombatkilla (button) folded before Flop (didn't bet)
Seat 8: ardo888 (small blind) folded before Flop
Seat 9: Mr.Grigoriy (big blind) folded before Flop





PokerStars Hand #154362819426:  Hold'em No Limit ($0.50/$1.00 USD) - 2016/06/06 12:31:44 CET [2016/06/06 6:31:44 ET]
Table 'Chaldaea II' 9-max Seat #3 is the button
Seat 3: ardo888 ($100 in chips) 
Seat 4: ozone2003 ($121.71 in chips) 
Seat 5: MiiiTCHy__ ($63.38 in chips) 
Seat 6: PacPacBum ($100 in chips) 
Seat 7: riggedsh** ($149.38 in chips) 
Seat 8: o.miro ($100 in chips) 
Seat 9: matiko09 ($100 in chips) 
ozone2003: posts small blind $0.50
MiiiTCHy__: posts big blind $1
xxxZeka: sits out 
masaytoo: sits out 
*** HOLE CARDS ***
Dealt to matiko09 [5c 3d]
PacPacBum: folds 
riggedsh**: raises $2 to $3
o.miro: folds 
matiko09: folds 
ardo888: folds 
ozone2003: folds 
MiiiTCHy__: folds 
Uncalled bet ($2) returned to riggedsh**
riggedsh** collected $2.50 from pot
riggedsh**: doesn't show hand 
*** SUMMARY ***
Total pot $2.50 | Rake $0 
Seat 3: ardo888 (button) folded before Flop (didn't bet)
Seat 4: ozone2003 (small blind) folded before Flop
Seat 5: MiiiTCHy__ (big blind) folded before Flop
Seat 6: PacPacBum folded before Flop (didn't bet)
Seat 7: riggedsh** collected ($2.50)
Seat 8: o.miro folded before Flop (didn't bet)
Seat 9: matiko09 folded before Flop (didn't bet)





PokerStars Hand #154362820273:  Hold'em No Limit ($0.50/$1.00 USD) - 2016/06/06 12:31:46 CET [2016/06/06 6:31:46 ET]
Table 'Yarilo' 9-max Seat #4 is the button
Seat 1: xxxZeka ($100 in chips) 
Seat 3: matiko09 ($110.42 in chips) 
Seat 4: riggedsh** ($112.88 in chips) 
Seat 5: Szevasztopol ($136.19 in chips) 
Seat 6: maxxmeister ($100 in chips) 
Seat 7: KEBIN1974 ($100 in chips) 
Seat 8: Mr.Grigoriy ($170.03 in chips) 
Seat 9: Filojoes ($107.76 in chips) 
Szevasztopol: posts small blind $0.50
maxxmeister: posts big blind $1
nombraalne1: sits out 
*** HOLE CARDS ***
Dealt to matiko09 [Qs 3h]
KEBIN1974: folds 
Mr.Grigoriy: folds 
Filojoes: folds 
xxxZeka: raises $2 to $3
matiko09: folds 
riggedsh**: folds 
Szevasztopol: folds 
maxxmeister: folds 
Uncalled bet ($2) returned to xxxZeka
xxxZeka collected $2.50 from pot
*** SUMMARY ***
Total pot $2.50 | Rake $0 
Seat 1: xxxZeka collected ($2.50)
Seat 3: matiko09 folded before Flop (didn't bet)
Seat 4: riggedsh** (button) folded before Flop (didn't bet)
Seat 5: Szevasztopol (small blind) folded before Flop
Seat 6: maxxmeister (big blind) folded before Flop
Seat 7: KEBIN1974 folded before Flop (didn't bet)
Seat 8: Mr.Grigoriy folded before Flop (didn't bet)
Seat 9: Filojoes folded before Flop (didn't bet)





PokerStars Hand #154362820412:  Hold'em No Limit ($0.50/$1.00 USD) - 2016/06/06 12:31:47 CET [2016/06/06 6:31:47 ET]
Table 'Heze' 9-max Seat #7 is the button
Seat 1: matiko09 ($215.15 in chips) 
Seat 2: oscarleon ($243.31 in chips) 
Seat 3: maxxmeister ($129.50 in chips) 
Seat 4: xxxZeka ($100 in chips) 
Seat 5: Filojoes ($100.24 in chips) 
Seat 6: ozone2003 ($100 in chips) 
Seat 7: Priidix ($100 in chips) 
Seat 8: AlSmithy88 ($44.34 in chips) 
Seat 9: Mr.Grigoriy ($124.20 in chips) 
AlSmithy88: posts small blind $0.50
Mr.Grigoriy: posts big blind $1
*** HOLE CARDS ***
Dealt to matiko09 [5h 2c]
matiko09: folds 
oscarleon: folds 
maxxmeister: raises $2.50 to $3.50
xxxZeka: folds 
Filojoes: folds 
ozone2003: calls $3.50
Priidix: folds 
AlSmithy88 is disconnected 
AlSmithy88 is connected 
AlSmithy88: folds 
Mr.Grigoriy: folds 
*** FLOP *** [5d 5c 3s]
maxxmeister: bets $4.99
ozone2003: calls $4.99
*** TURN *** [5d 5c 3s] [7d]
maxxmeister: checks 
ozone2003: bets $11.06
maxxmeister: folds 
Uncalled bet ($11.06) returned to ozone2003
AlSmithy88 is disconnected 
ozone2003 collected $17.56 from pot
ozone2003: doesn't show hand 
*** SUMMARY ***
Total pot $18.48 | Rake $0.92 
Board [5d 5c 3s 7d]
Seat 1: matiko09 folded before Flop (didn't bet)
Seat 2: oscarleon folded before Flop (didn't bet)
Seat 3: maxxmeister folded on the Turn
Seat 4: xxxZeka folded before Flop (didn't bet)
Seat 5: Filojoes folded before Flop (didn't bet)
Seat 6: ozone2003 collected ($17.56)
Seat 7: Priidix (button) folded before Flop (didn't bet)
Seat 8: AlSmithy88 (small blind) folded before Flop
Seat 9: Mr.Grigoriy (big blind) folded before Flop





PokerStars Hand #154362820634:  Hold'em No Limit ($0.50/$1.00 USD) - 2016/06/06 12:31:47 CET [2016/06/06 6:31:47 ET]
Table 'Smither' 9-max Seat #7 is the button
Seat 1: PacPacBum ($100.50 in chips) 
Seat 2: matiko09 ($100 in chips) 
Seat 4: maxxmeister ($213.16 in chips) 
Seat 6: riggedsh** ($108.78 in chips) 
Seat 7: 007Bond001 ($63.50 in chips) 
PacPacBum: posts small blind $0.50
matiko09: posts big blind $1
xxxZeka: sits out 
*** HOLE CARDS ***
Dealt to matiko09 [9s 5s]
nombraalne1 leaves the table
Szevasztopol joins the table at seat #5 
maxxmeister: folds 
riggedsh**: raises $1.50 to $2.50
007Bond001: folds 
PacPacBum: folds 
matiko09: folds 
Uncalled bet ($1.50) returned to riggedsh**
riggedsh** collected $2.50 from pot
riggedsh**: doesn't show hand 
*** SUMMARY ***
Total pot $2.50 | Rake $0 
Seat 1: PacPacBum (small blind) folded before Flop
Seat 2: matiko09 (big blind) folded before Flop
Seat 4: maxxmeister folded before Flop (didn't bet)
Seat 6: riggedsh** collected ($2.50)
Seat 7: 007Bond001 (button) folded before Flop (didn't bet)





PokerStars Hand #154362822849:  Hold'em No Limit ($0.50/$1.00 USD) - 2016/06/06 12:31:53 CET [2016/06/06 6:31:53 ET]
Table 'Wezen II' 9-max Seat #9 is the button
Seat 1: matiko09 ($162.97 in chips) 
Seat 2: Mr.Grigoriy ($108.18 in chips) 
Seat 3: oscarleon ($103.18 in chips) 
Seat 4: maxxmeister ($139 in chips) 
Seat 6: Szevasztopol ($102.36 in chips) 
Seat 7: KDJAll3 ($85.37 in chips) 
Seat 8: mavin80 ($159.48 in chips) 
Seat 9: Filojoes ($105.51 in chips) 
matiko09: posts small blind $0.50
Mr.Grigoriy: posts big blind $1
stds st: sits out 
*** HOLE CARDS ***
Dealt to matiko09 [4c 2c]
oscarleon: folds 
maxxmeister: folds 
Szevasztopol: folds 
KDJAll3: folds 
mavin80: folds 
Filojoes: raises $1 to $2
matiko09: folds 
Mr.Grigoriy: folds 
Uncalled bet ($1) returned to Filojoes
Filojoes collected $2.50 from pot
Filojoes: doesn't show hand 
*** SUMMARY ***
Total pot $2.50 | Rake $0 
Seat 1: matiko09 (small blind) folded before Flop
Seat 2: Mr.Grigoriy (big blind) folded before Flop
Seat 3: oscarleon folded before Flop (didn't bet)
Seat 4: maxxmeister folded before Flop (didn't bet)
Seat 6: Szevasztopol folded before Flop (didn't bet)
Seat 7: KDJAll3 folded before Flop (didn't bet)
Seat 8: mavin80 folded before Flop (didn't bet)
Seat 9: Filojoes (button) collected ($2.50)





PokerStars Hand #154362827419:  Hold'em No Limit ($0.50/$1.00 USD) - 2016/06/06 12:32:04 CET [2016/06/06 6:32:04 ET]
Table 'Williams' 9-max Seat #4 is the button
Seat 1: matiko09 ($192.79 in chips) 
Seat 2: PacPacBum ($103 in chips) 
Seat 3: granbunny ($54.60 in chips) 
Seat 4: Filojoes ($119.42 in chips) 
Seat 5: ardo888 ($125 in chips) 
Seat 6: Priidix ($124.94 in chips) 
Seat 7: kevinho109 ($71.06 in chips) 
Seat 8: oscarleon ($108.86 in chips) 
Seat 9: kind ten ($39.55 in chips) 
ardo888: posts small blind $0.50
Priidix: posts big blind $1
*** HOLE CARDS ***
Dealt to matiko09 [2h 4c]
kevinho109: folds 
oscarleon: folds 
kind ten: folds 
matiko09: folds 
PacPacBum: raises $1.04 to $2.04
granbunny: folds 
Filojoes: folds 
ardo888: folds 
Priidix: folds 
Uncalled bet ($1.04) returned to PacPacBum
PacPacBum collected $2.50 from pot
PacPacBum: doesn't show hand 
*** SUMMARY ***
Total pot $2.50 | Rake $0 
Seat 1: matiko09 folded before Flop (didn't bet)
Seat 2: PacPacBum collected ($2.50)
Seat 3: granbunny folded before Flop (didn't bet)
Seat 4: Filojoes (button) folded before Flop (didn't bet)
Seat 5: ardo888 (small blind) folded before Flop
Seat 6: Priidix (big blind) folded before Flop
Seat 7: kevinho109 folded before Flop (didn't bet)
Seat 8: oscarleon folded before Flop (didn't bet)
Seat 9: kind ten folded before Flop (didn't bet)





PokerStars Hand #154362827408:  Hold'em No Limit ($0.50/$1.00 USD) - 2016/06/06 12:32:04 CET [2016/06/06 6:32:04 ET]
Table 'Gajdariya' 9-max Seat #8 is the button
Seat 1: matiko09 ($118.73 in chips) 
Seat 2: xxxZeka ($128.24 in chips) 
Seat 3: oscarleon ($105.50 in chips) 
Seat 4: Szevasztopol ($108.13 in chips) 
Seat 5: 147734319 ($110.01 in chips) 
Seat 6: mono123viva ($135.41 in chips) 
Seat 7: Wombatkilla ($92.82 in chips) 
Seat 8: ardo888 ($100 in chips) 
Seat 9: Mr.Grigoriy ($103.56 in chips) 
Mr.Grigoriy: posts small blind $0.50
matiko09: posts big blind $1
*** HOLE CARDS ***
Dealt to matiko09 [3h 6c]
xxxZeka: folds 
oscarleon: folds 
Szevasztopol: folds 
147734319: folds 
mono123viva: folds 
Wombatkilla: raises $2 to $3
ardo888: folds 
Mr.Grigoriy: folds 
matiko09: folds 
Uncalled bet ($2) returned to Wombatkilla
Wombatkilla collected $2.50 from pot
*** SUMMARY ***
Total pot $2.50 | Rake $0 
Seat 1: matiko09 (big blind) folded before Flop
Seat 2: xxxZeka folded before Flop (didn't bet)
Seat 3: oscarleon folded before Flop (didn't bet)
Seat 4: Szevasztopol folded before Flop (didn't bet)
Seat 5: 147734319 folded before Flop (didn't bet)
Seat 6: mono123viva folded before Flop (didn't bet)
Seat 7: Wombatkilla collected ($2.50)
Seat 8: ardo888 (button) folded before Flop (didn't bet)
Seat 9: Mr.Grigoriy (small blind) folded before Flop





PokerStars Hand #154362828479:  Hold'em No Limit ($0.50/$1.00 USD) - 2016/06/06 12:32:07 CET [2016/06/06 6:32:07 ET]
Table 'Smither' 9-max Seat #1 is the button
Seat 1: PacPacBum ($100 in chips) 
Seat 2: matiko09 ($100 in chips) 
Seat 3: xxxZeka ($100 in chips) 
Seat 4: maxxmeister ($213.16 in chips) 
Seat 6: riggedsh** ($110.28 in chips) 
Seat 7: 007Bond001 ($63.50 in chips) 
matiko09: posts small blind $0.50
xxxZeka: posts big blind $1
Szevasztopol: sits out 
*** HOLE CARDS ***
Dealt to matiko09 [Jc 8d]
maxxmeister: folds 
riggedsh**: folds 
007Bond001: folds 
PacPacBum: raises $1.04 to $2.04
matiko09: folds 
xxxZeka: folds 
Uncalled bet ($1.04) returned to PacPacBum
PacPacBum collected $2.50 from pot
PacPacBum: doesn't show hand 
*** SUMMARY ***
Total pot $2.50 | Rake $0 
Seat 1: PacPacBum (button) collected ($2.50)
Seat 2: matiko09 (small blind) folded before Flop
Seat 3: xxxZeka (big blind) folded before Flop
Seat 4: maxxmeister folded before Flop (didn't bet)
Seat 6: riggedsh** folded before Flop (didn't bet)
Seat 7: 007Bond001 folded before Flop (didn't bet)





PokerStars Hand #154362830096:  Hold'em No Limit ($0.50/$1.00 USD) - 2016/06/06 12:32:11 CET [2016/06/06 6:32:11 ET]
Table 'Wezen II' 9-max Seat #1 is the button
Seat 1: matiko09 ($162.47 in chips) 
Seat 2: Mr.Grigoriy ($107.18 in chips) 
Seat 3: oscarleon ($103.18 in chips) 
Seat 4: maxxmeister ($139 in chips) 
Seat 6: Szevasztopol ($102.36 in chips) 
Seat 7: KDJAll3 ($85.37 in chips) 
Seat 8: mavin80 ($159.48 in chips) 
Seat 9: Filojoes ($107.01 in chips) 
Mr.Grigoriy: posts small blind $0.50
oscarleon: posts big blind $1
stds st: sits out 
*** HOLE CARDS ***
Dealt to matiko09 [Td Kh]
maxxmeister: folds 
maxxmeister leaves the table
Szevasztopol: folds 
KDJAll3: folds 
mavin80: raises $1.50 to $2.50
xxxibgdrgn joins the table at seat #4 
Filojoes: folds 
matiko09: folds 
Mr.Grigoriy: folds 
oscarleon: calls $1.50
*** FLOP *** [8c 7c Jd]
oscarleon: checks 
mavin80: bets $2
oscarleon: folds 
Uncalled bet ($2) returned to mavin80
mavin80 collected $5.22 from pot
mavin80: doesn't show hand 
*** SUMMARY ***
Total pot $5.50 | Rake $0.28 
Board [8c 7c Jd]
Seat 1: matiko09 (button) folded before Flop (didn't bet)
Seat 2: Mr.Grigoriy (small blind) folded before Flop
Seat 3: oscarleon (big blind) folded on the Flop
Seat 4: maxxmeister folded before Flop (didn't bet)
Seat 6: Szevasztopol folded before Flop (didn't bet)
Seat 7: KDJAll3 folded before Flop (didn't bet)
Seat 8: mavin80 collected ($5.22)
Seat 9: Filojoes folded before Flop (didn't bet)





PokerStars Hand #154362830238:  Hold'em No Limit ($0.50/$1.00 USD) - 2016/06/06 12:32:12 CET [2016/06/06 6:32:12 ET]
Table 'Chaldaea II' 9-max Seat #4 is the button
Seat 3: ardo888 ($100 in chips) 
Seat 4: ozone2003 ($121.21 in chips) 
Seat 5: MiiiTCHy__ ($62.38 in chips) 
Seat 6: PacPacBum ($100 in chips) 
Seat 7: riggedsh** ($150.88 in chips) 
Seat 8: o.miro ($100 in chips) 
Seat 9: matiko09 ($100 in chips) 
MiiiTCHy__: posts small blind $0.50
PacPacBum: posts big blind $1
xxxZeka: sits out 
masaytoo: sits out 
*** HOLE CARDS ***
Dealt to matiko09 [5c 6s]
riggedsh**: folds 
o.miro: folds 
matiko09: folds 
ardo888: raises $1.50 to $2.50
ozone2003: calls $2.50
MiiiTCHy__: calls $2
PacPacBum: folds 
*** FLOP *** [8d 3c Kd]
MiiiTCHy__: checks 
ardo888: checks 
ozone2003: checks 
*** TURN *** [8d 3c Kd] [Kh]
MiiiTCHy__: checks 
ardo888: bets $5.50
ozone2003: folds 
MiiiTCHy__: folds 
Uncalled bet ($5.50) returned to ardo888
ardo888 collected $8.08 from pot
ardo888: doesn't show hand 
*** SUMMARY ***
Total pot $8.50 | Rake $0.42 
Board [8d 3c Kd Kh]
Seat 3: ardo888 collected ($8.08)
Seat 4: ozone2003 (button) folded on the Turn
Seat 5: MiiiTCHy__ (small blind) folded on the Turn
Seat 6: PacPacBum (big blind) folded before Flop
Seat 7: riggedsh** folded before Flop (didn't bet)
Seat 8: o.miro folded before Flop (didn't bet)
Seat 9: matiko09 folded before Flop (didn't bet)





PokerStars Hand #154362834069:  Hold'em No Limit ($0.50/$1.00 USD) - 2016/06/06 12:32:21 CET [2016/06/06 6:32:21 ET]
Table 'Yarilo' 9-max Seat #5 is the button
Seat 1: xxxZeka ($101.50 in chips) 
Seat 3: matiko09 ($110.42 in chips) 
Seat 4: riggedsh** ($112.88 in chips) 
Seat 5: Szevasztopol ($135.69 in chips) 
Seat 6: maxxmeister ($100 in chips) 
Seat 7: KEBIN1974 ($100 in chips) 
Seat 8: Mr.Grigoriy ($170.03 in chips) 
Seat 9: Filojoes ($107.76 in chips) 
maxxmeister: posts small blind $0.50
KEBIN1974: posts big blind $1
nombraalne1: sits out 
*** HOLE CARDS ***
Dealt to matiko09 [4c Ts]
Mr.Grigoriy: folds 
Filojoes: raises $2 to $3
xxxZeka: folds 
matiko09: folds 
riggedsh**: folds 
Szevasztopol: folds 
maxxmeister: folds 
KEBIN1974: calls $2
*** FLOP *** [2c 6s Ah]
KEBIN1974: checks 
Filojoes: checks 
*** TURN *** [2c 6s Ah] [Ad]
KEBIN1974: bets $2.10
Filojoes: calls $2.10
*** RIVER *** [2c 6s Ah Ad] [9d]
KEBIN1974: checks 
Filojoes: bets $6.10
KEBIN1974: folds 
Uncalled bet ($6.10) returned to Filojoes
Filojoes collected $10.16 from pot
Filojoes: doesn't show hand 
*** SUMMARY ***
Total pot $10.70 | Rake $0.54 
Board [2c 6s Ah Ad 9d]
Seat 1: xxxZeka folded before Flop (didn't bet)
Seat 3: matiko09 folded before Flop (didn't bet)
Seat 4: riggedsh** folded before Flop (didn't bet)
Seat 5: Szevasztopol (button) folded before Flop (didn't bet)
Seat 6: maxxmeister (small blind) folded before Flop
Seat 7: KEBIN1974 (big blind) folded on the River
Seat 8: Mr.Grigoriy folded before Flop (didn't bet)
Seat 9: Filojoes collected ($10.16)





PokerStars Hand #154362835492:  Hold'em No Limit ($0.50/$1.00 USD) - 2016/06/06 12:32:25 CET [2016/06/06 6:32:25 ET]
Table 'Williams' 9-max Seat #5 is the button
Seat 1: matiko09 ($192.79 in chips) 
Seat 2: PacPacBum ($104.50 in chips) 
Seat 3: granbunny ($54.60 in chips) 
Seat 4: Filojoes ($119.42 in chips) 
Seat 5: ardo888 ($124.50 in chips) 
Seat 6: Priidix ($123.94 in chips) 
Seat 7: kevinho109 ($71.06 in chips) 
Seat 8: oscarleon ($108.86 in chips) 
Seat 9: kind ten ($39.55 in chips) 
Priidix: posts small blind $0.50
kevinho109: posts big blind $1
*** HOLE CARDS ***
Dealt to matiko09 [6d 4d]
oscarleon: folds 
kind ten: folds 
matiko09: folds 
PacPacBum: folds 
granbunny: folds 
Filojoes: raises $1.50 to $2.50
ardo888: folds 
Priidix: folds 
kevinho109: calls $1.50
*** FLOP *** [Td Kh 3d]
kevinho109: checks 
Filojoes: bets $3.13
kevinho109: calls $3.13
*** TURN *** [Td Kh 3d] [2d]
kevinho109: checks 
Filojoes: bets $6.70
kevinho109: calls $6.70
*** RIVER *** [Td Kh 3d 2d] [9h]
kevinho109: checks 
Filojoes: checks 
*** SHOW DOWN ***
kevinho109: shows [Qs Ad] (high card Ace)
Filojoes: shows [Ks 3s] (two pair, Kings and Threes)
Filojoes collected $23.90 from pot
*** SUMMARY ***
Total pot $25.16 | Rake $1.26 
Board [Td Kh 3d 2d 9h]
Seat 1: matiko09 folded before Flop (didn't bet)
Seat 2: PacPacBum folded before Flop (didn't bet)
Seat 3: granbunny folded before Flop (didn't bet)
Seat 4: Filojoes showed [Ks 3s] and won ($23.90) with two pair, Kings and Threes
Seat 5: ardo888 (button) folded before Flop (didn't bet)
Seat 6: Priidix (small blind) folded before Flop
Seat 7: kevinho109 (big blind) showed [Qs Ad] and lost with high card Ace
Seat 8: oscarleon folded before Flop (didn't bet)
Seat 9: kind ten folded before Flop (didn't bet)





PokerStars Hand #154362835935:  Hold'em No Limit ($0.50/$1.00 USD) - 2016/06/06 12:32:26 CET [2016/06/06 6:32:26 ET]
Table 'Smither' 9-max Seat #2 is the button
Seat 1: PacPacBum ($101.50 in chips) 
Seat 2: matiko09 ($100 in chips) 
Seat 3: xxxZeka ($100 in chips) 
Seat 4: maxxmeister ($213.16 in chips) 
Seat 6: riggedsh** ($110.28 in chips) 
Seat 7: 007Bond001 ($63.50 in chips) 
xxxZeka: posts small blind $0.50
maxxmeister: posts big blind $1
Szevasztopol: sits out 
*** HOLE CARDS ***
Dealt to matiko09 [2c Ts]
riggedsh**: folds 
007Bond001: folds 
PacPacBum: folds 
matiko09: folds 
xxxZeka: folds 
Uncalled bet ($0.50) returned to maxxmeister
maxxmeister collected $1 from pot
maxxmeister: doesn't show hand 
*** SUMMARY ***
Total pot $1 | Rake $0 
Seat 1: PacPacBum folded before Flop (didn't bet)
Seat 2: matiko09 (button) folded before Flop (didn't bet)
Seat 3: xxxZeka (small blind) folded before Flop
Seat 4: maxxmeister (big blind) collected ($1)
Seat 6: riggedsh** folded before Flop (didn't bet)
Seat 7: 007Bond001 folded before Flop (didn't bet)





PokerStars Hand #154362835850:  Hold'em No Limit ($0.50/$1.00 USD) - 2016/06/06 12:32:26 CET [2016/06/06 6:32:26 ET]
Table 'Irmgard II' 9-max Seat #6 is the button
Seat 1: matiko09 ($148 in chips) 
Seat 2: hammerwife ($115.18 in chips) 
Seat 4: oscarleon ($162.26 in chips) 
Seat 6: maxxmeister ($261.70 in chips) 
Seat 7: 32rrew ($103.18 in chips) 
Seat 8: Szevasztopol ($100 in chips) 
Seat 9: Filojoes ($139.22 in chips) 
32rrew: posts small blind $0.50
Szevasztopol: posts big blind $1
stds st: sits out 
*** HOLE CARDS ***
Dealt to matiko09 [7h Js]
Filojoes: folds 
Filojoes leaves the table
matiko09: folds 
hammerwife: folds 
oscarleon: raises $2 to $3
maxxmeister: raises $12 to $15
32rrew: folds 
Szevasztopol: folds 
oscarleon: folds 
Uncalled bet ($12) returned to maxxmeister
maxxmeister collected $7.50 from pot
maxxmeister: doesn't show hand 
*** SUMMARY ***
Total pot $7.50 | Rake $0 
Seat 1: matiko09 folded before Flop (didn't bet)
Seat 2: hammerwife folded before Flop (didn't bet)
Seat 4: oscarleon folded before Flop
Seat 6: maxxmeister (button) collected ($7.50)
Seat 7: 32rrew (small blind) folded before Flop
Seat 8: Szevasztopol (big blind) folded before Flop
Seat 9: Filojoes folded before Flop (didn't bet)





PokerStars Hand #154362841989:  Hold'em No Limit ($0.50/$1.00 USD) - 2016/06/06 12:32:41 CET [2016/06/06 6:32:41 ET]
Table 'Safara' 9-max Seat #6 is the button
Seat 1: oscarleon ($234.44 in chips) 
Seat 2: Szevasztopol ($100 in chips) 
Seat 3: ozone2003 ($103 in chips) 
Seat 4: mattyt212 ($203 in chips) 
Seat 5: Dantist1122 ($106.03 in chips) 
Seat 6: matiko09 ($102.88 in chips) 
Seat 7: PacPacBum ($100 in chips) 
Seat 8: Priidix ($101.50 in chips) 
Seat 9: Mr.Grigoriy ($105.67 in chips) 
PacPacBum: posts small blind $0.50
Priidix: posts big blind $1
*** HOLE CARDS ***
Dealt to matiko09 [4s 7d]
Mr.Grigoriy: folds 
oscarleon: folds 
Szevasztopol: folds 
ozone2003: folds 
mattyt212: folds 
Dantist1122: raises $1.70 to $2.70
matiko09: folds 
PacPacBum: folds 
Priidix: folds 
Uncalled bet ($1.70) returned to Dantist1122
Dantist1122 collected $2.50 from pot
Dantist1122: doesn't show hand 
*** SUMMARY ***
Total pot $2.50 | Rake $0 
Seat 1: oscarleon folded before Flop (didn't bet)
Seat 2: Szevasztopol folded before Flop (didn't bet)
Seat 3: ozone2003 folded before Flop (didn't bet)
Seat 4: mattyt212 folded before Flop (didn't bet)
Seat 5: Dantist1122 collected ($2.50)
Seat 6: matiko09 (button) folded before Flop (didn't bet)
Seat 7: PacPacBum (small blind) folded before Flop
Seat 8: Priidix (big blind) folded before Flop
Seat 9: Mr.Grigoriy folded before Flop (didn't bet)





PokerStars Hand #154362846369:  Hold'em No Limit ($0.50/$1.00 USD) - 2016/06/06 12:32:53 CET [2016/06/06 6:32:53 ET]
Table 'Smither' 9-max Seat #3 is the button
Seat 1: PacPacBum ($101.50 in chips) 
Seat 2: matiko09 ($100 in chips) 
Seat 3: xxxZeka ($100 in chips) 
Seat 4: maxxmeister ($213.66 in chips) 
Seat 5: Szevasztopol ($100 in chips) 
Seat 6: riggedsh** ($110.28 in chips) 
Seat 7: 007Bond001 ($63.50 in chips) 
maxxmeister: posts small blind $0.50
Szevasztopol: posts big blind $1
*** HOLE CARDS ***
Dealt to matiko09 [6d Ah]
riggedsh**: folds 
007Bond001: folds 
PacPacBum: raises $1.04 to $2.04
matiko09: folds 
xxxZeka: folds 
maxxmeister: folds 
Szevasztopol: folds 
Uncalled bet ($1.04) returned to PacPacBum
PacPacBum collected $2.50 from pot
PacPacBum: doesn't show hand 
*** SUMMARY ***
Total pot $2.50 | Rake $0 
Seat 1: PacPacBum collected ($2.50)
Seat 2: matiko09 folded before Flop (didn't bet)
Seat 3: xxxZeka (button) folded before Flop (didn't bet)
Seat 4: maxxmeister (small blind) folded before Flop
Seat 5: Szevasztopol (big blind) folded before Flop
Seat 6: riggedsh** folded before Flop (didn't bet)
Seat 7: 007Bond001 folded before Flop (didn't bet)





PokerStars Hand #154362847538:  Hold'em No Limit ($0.50/$1.00 USD) - 2016/06/06 12:32:56 CET [2016/06/06 6:32:56 ET]
Table 'Gajdariya' 9-max Seat #9 is the button
Seat 1: matiko09 ($117.73 in chips) 
Seat 2: xxxZeka ($128.24 in chips) 
Seat 3: oscarleon ($105.50 in chips) 
Seat 4: Szevasztopol ($108.13 in chips) 
Seat 5: 147734319 ($110.01 in chips) 
Seat 6: mono123viva ($135.41 in chips) 
Seat 7: Wombatkilla ($94.32 in chips) 
Seat 8: ardo888 ($100 in chips) 
Seat 9: Mr.Grigoriy ($103.06 in chips) 
matiko09: posts small blind $0.50
xxxZeka: posts big blind $1
*** HOLE CARDS ***
Dealt to matiko09 [2d Tc]
oscarleon: folds 
Szevasztopol: folds 
147734319: folds 
mono123viva: raises $2 to $3
Wombatkilla: folds 
ardo888: folds 
Mr.Grigoriy: folds 
matiko09: folds 
xxxZeka: folds 
Uncalled bet ($2) returned to mono123viva
mono123viva collected $2.50 from pot
*** SUMMARY ***
Total pot $2.50 | Rake $0 
Seat 1: matiko09 (small blind) folded before Flop
Seat 2: xxxZeka (big blind) folded before Flop
Seat 3: oscarleon folded before Flop (didn't bet)
Seat 4: Szevasztopol folded before Flop (didn't bet)
Seat 5: 147734319 folded before Flop (didn't bet)
Seat 6: mono123viva collected ($2.50)
Seat 7: Wombatkilla folded before Flop (didn't bet)
Seat 8: ardo888 folded before Flop (didn't bet)
Seat 9: Mr.Grigoriy (button) folded before Flop (didn't bet)





PokerStars Hand #154362848159:  Hold'em No Limit ($0.50/$1.00 USD) - 2016/06/06 12:32:57 CET [2016/06/06 6:32:57 ET]
Table 'Wezen II' 9-max Seat #2 is the button
Seat 1: matiko09 ($162.47 in chips) 
Seat 2: Mr.Grigoriy ($106.68 in chips) 
Seat 3: oscarleon ($100.68 in chips) 
Seat 4: xxxibgdrgn ($100 in chips) 
Seat 6: Szevasztopol ($102.36 in chips) 
Seat 7: KDJAll3 ($85.37 in chips) 
Seat 8: mavin80 ($162.20 in chips) 
Seat 9: Filojoes ($107.01 in chips) 
oscarleon: posts small blind $0.50
xxxibgdrgn: posts big blind $1
stds st: sits out 
*** HOLE CARDS ***
Dealt to matiko09 [9d Jc]
Szevasztopol: folds 
KDJAll3: folds 
mavin80: folds 
Filojoes: folds 
matiko09: folds 
Mr.Grigoriy: raises $1 to $2
oscarleon: folds 
xxxibgdrgn: folds 
Uncalled bet ($1) returned to Mr.Grigoriy
Mr.Grigoriy collected $2.50 from pot
Mr.Grigoriy: doesn't show hand 
*** SUMMARY ***
Total pot $2.50 | Rake $0 
Seat 1: matiko09 folded before Flop (didn't bet)
Seat 2: Mr.Grigoriy (button) collected ($2.50)
Seat 3: oscarleon (small blind) folded before Flop
Seat 4: xxxibgdrgn (big blind) folded before Flop
Seat 6: Szevasztopol folded before Flop (didn't bet)
Seat 7: KDJAll3 folded before Flop (didn't bet)
Seat 8: mavin80 folded before Flop (didn't bet)
Seat 9: Filojoes folded before Flop (didn't bet)





PokerStars Hand #154362850082:  Hold'em No Limit ($0.50/$1.00 USD) - 2016/06/06 12:33:02 CET [2016/06/06 6:33:02 ET]
Table 'Irmgard II' 9-max Seat #7 is the button
Seat 1: matiko09 ($148 in chips) 
Seat 2: hammerwife ($115.18 in chips) 
Seat 4: oscarleon ($159.26 in chips) 
Seat 6: maxxmeister ($266.20 in chips) 
Seat 7: 32rrew ($102.68 in chips) 
Seat 8: Szevasztopol ($100 in chips) 
Szevasztopol: posts small blind $0.50
matiko09: posts big blind $1
stds st: sits out 
*** HOLE CARDS ***
Dealt to matiko09 [2c 9h]
hammerwife: raises $1.50 to $2.50
oscarleon: folds 
maxxmeister: folds 
32rrew: folds 
Szevasztopol: folds 
matiko09: folds 
Uncalled bet ($1.50) returned to hammerwife
hammerwife collected $2.50 from pot
hammerwife: doesn't show hand 
*** SUMMARY ***
Total pot $2.50 | Rake $0 
Seat 1: matiko09 (big blind) folded before Flop
Seat 2: hammerwife collected ($2.50)
Seat 4: oscarleon folded before Flop (didn't bet)
Seat 6: maxxmeister folded before Flop (didn't bet)
Seat 7: 32rrew (button) folded before Flop (didn't bet)
Seat 8: Szevasztopol (small blind) folded before Flop





PokerStars Hand #154362853466:  Hold'em No Limit ($0.50/$1.00 USD) - 2016/06/06 12:33:10 CET [2016/06/06 6:33:10 ET]
Table 'Safara' 9-max Seat #7 is the button
Seat 1: oscarleon ($234.44 in chips) 
Seat 2: Szevasztopol ($100 in chips) 
Seat 3: ozone2003 ($103 in chips) 
Seat 4: mattyt212 ($203 in chips) 
Seat 5: Dantist1122 ($107.53 in chips) 
Seat 6: matiko09 ($102.88 in chips) 
Seat 7: PacPacBum ($100 in chips) 
Seat 8: Priidix ($100.50 in chips) 
Seat 9: Mr.Grigoriy ($105.67 in chips) 
Priidix: posts small blind $0.50
Mr.Grigoriy: posts big blind $1
*** HOLE CARDS ***
Dealt to matiko09 [Kc Ks]
oscarleon: folds 
Szevasztopol: folds 
ozone2003: folds 
mattyt212: folds 
Dantist1122: folds 
matiko09: raises $1.50 to $2.50
PacPacBum: folds 
Priidix: folds 
Mr.Grigoriy: calls $1.50
*** FLOP *** [8c 3c 4s]
Mr.Grigoriy: checks 
matiko09: bets $3.39
Mr.Grigoriy: folds 
Uncalled bet ($3.39) returned to matiko09
matiko09 collected $5.22 from pot
matiko09: doesn't show hand 
*** SUMMARY ***
Total pot $5.50 | Rake $0.28 
Board [8c 3c 4s]
Seat 1: oscarleon folded before Flop (didn't bet)
Seat 2: Szevasztopol folded before Flop (didn't bet)
Seat 3: ozone2003 folded before Flop (didn't bet)
Seat 4: mattyt212 folded before Flop (didn't bet)
Seat 5: Dantist1122 folded before Flop (didn't bet)
Seat 6: matiko09 collected ($5.22)
Seat 7: PacPacBum (button) folded before Flop (didn't bet)
Seat 8: Priidix (small blind) folded before Flop
Seat 9: Mr.Grigoriy (big blind) folded on the Flop





PokerStars Hand #154362858257:  Hold'em No Limit ($0.50/$1.00 USD) - 2016/06/06 12:33:23 CET [2016/06/06 6:33:23 ET]
Table 'Wezen II' 9-max Seat #3 is the button
Seat 1: matiko09 ($162.47 in chips) 
Seat 2: Mr.Grigoriy ($108.18 in chips) 
Seat 3: oscarleon ($100.18 in chips) 
Seat 4: xxxibgdrgn ($100 in chips) 
Seat 5: stds st ($40 in chips) 
Seat 6: Szevasztopol ($102.36 in chips) 
Seat 7: KDJAll3 ($85.37 in chips) 
Seat 8: mavin80 ($162.20 in chips) 
Seat 9: Filojoes ($107.01 in chips) 
xxxibgdrgn: posts small blind $0.50
stds st: posts big blind $1
*** HOLE CARDS ***
Dealt to matiko09 [9s Kc]
Szevasztopol: raises $1.24 to $2.24
KDJAll3: calls $2.24
mavin80: folds 
Filojoes: folds 
matiko09: folds 
Mr.Grigoriy: folds 
oscarleon: folds 
xxxibgdrgn: folds 
stds st: folds 
*** FLOP *** [4h 7c 9h]
Szevasztopol: checks 
KDJAll3: bets $2
Szevasztopol: folds 
Uncalled bet ($2) returned to KDJAll3
KDJAll3 collected $5.68 from pot
KDJAll3: doesn't show hand 
*** SUMMARY ***
Total pot $5.98 | Rake $0.30 
Board [4h 7c 9h]
Seat 1: matiko09 folded before Flop (didn't bet)
Seat 2: Mr.Grigoriy folded before Flop (didn't bet)
Seat 3: oscarleon (button) folded before Flop (didn't bet)
Seat 4: xxxibgdrgn (small blind) folded before Flop
Seat 5: stds st (big blind) folded before Flop
Seat 6: Szevasztopol folded on the Flop
Seat 7: KDJAll3 collected ($5.68)
Seat 8: mavin80 folded before Flop (didn't bet)
Seat 9: Filojoes folded before Flop (didn't bet)





PokerStars Hand #154362860015:  Hold'em No Limit ($0.50/$1.00 USD) - 2016/06/06 12:33:27 CET [2016/06/06 6:33:27 ET]
Table 'Heze' 9-max Seat #8 is the button
Seat 1: matiko09 ($215.15 in chips) 
Seat 2: oscarleon ($243.31 in chips) 
Seat 3: maxxmeister ($121.01 in chips) 
Seat 4: xxxZeka ($100 in chips) 
Seat 5: Filojoes ($100.24 in chips) 
Seat 6: ozone2003 ($109.07 in chips) 
Seat 7: Priidix ($100 in chips) 
Seat 8: AlSmithy88 ($43.84 in chips) 
Seat 9: Mr.Grigoriy ($123.20 in chips) 
Mr.Grigoriy: posts small blind $0.50
matiko09: posts big blind $1
*** HOLE CARDS ***
Dealt to matiko09 [Ad 5d]
oscarleon: folds 
maxxmeister: folds 
xxxZeka: raises $2 to $3
Filojoes: folds 
ozone2003: folds 
Priidix: folds 
AlSmithy88: folds 
Mr.Grigoriy: folds 
matiko09: folds 
Uncalled bet ($2) returned to xxxZeka
xxxZeka collected $2.50 from pot
*** SUMMARY ***
Total pot $2.50 | Rake $0 
Seat 1: matiko09 (big blind) folded before Flop
Seat 2: oscarleon folded before Flop (didn't bet)
Seat 3: maxxmeister folded before Flop (didn't bet)
Seat 4: xxxZeka collected ($2.50)
Seat 5: Filojoes folded before Flop (didn't bet)
Seat 6: ozone2003 folded before Flop (didn't bet)
Seat 7: Priidix folded before Flop (didn't bet)
Seat 8: AlSmithy88 (button) folded before Flop (didn't bet)
Seat 9: Mr.Grigoriy (small blind) folded before Flop





PokerStars Hand #154362860362:  Hold'em No Limit ($0.50/$1.00 USD) - 2016/06/06 12:33:28 CET [2016/06/06 6:33:28 ET]
Table 'Gajdariya' 9-max Seat #1 is the button
Seat 1: matiko09 ($117.23 in chips) 
Seat 2: xxxZeka ($127.24 in chips) 
Seat 3: oscarleon ($105.50 in chips) 
Seat 4: Szevasztopol ($108.13 in chips) 
Seat 5: 147734319 ($110.01 in chips) 
Seat 6: mono123viva ($136.91 in chips) 
Seat 7: Wombatkilla ($94.32 in chips) 
Seat 8: ardo888 ($100 in chips) 
Seat 9: Mr.Grigoriy ($103.06 in chips) 
xxxZeka: posts small blind $0.50
oscarleon: posts big blind $1
*** HOLE CARDS ***
Dealt to matiko09 [Td 8c]
Szevasztopol: folds 
147734319: folds 
mono123viva: folds 
Wombatkilla: raises $2 to $3
ardo888: folds 
Mr.Grigoriy: folds 
matiko09: folds 
xxxZeka: folds 
oscarleon: folds 
Uncalled bet ($2) returned to Wombatkilla
Wombatkilla collected $2.50 from pot
*** SUMMARY ***
Total pot $2.50 | Rake $0 
Seat 1: matiko09 (button) folded before Flop (didn't bet)
Seat 2: xxxZeka (small blind) folded before Flop
Seat 3: oscarleon (big blind) folded before Flop
Seat 4: Szevasztopol folded before Flop (didn't bet)
Seat 5: 147734319 folded before Flop (didn't bet)
Seat 6: mono123viva folded before Flop (didn't bet)
Seat 7: Wombatkilla collected ($2.50)
Seat 8: ardo888 folded before Flop (didn't bet)
Seat 9: Mr.Grigoriy folded before Flop (didn't bet)





PokerStars Hand #154362860709:  Hold'em No Limit ($0.50/$1.00 USD) - 2016/06/06 12:33:29 CET [2016/06/06 6:33:29 ET]
Table 'Chaldaea II' 9-max Seat #5 is the button
Seat 3: ardo888 ($105.58 in chips) 
Seat 4: ozone2003 ($118.71 in chips) 
Seat 5: MiiiTCHy__ ($59.88 in chips) 
Seat 6: PacPacBum ($100 in chips) 
Seat 7: riggedsh** ($150.88 in chips) 
Seat 8: o.miro ($100 in chips) 
Seat 9: matiko09 ($100 in chips) 
PacPacBum: posts small blind $0.50
riggedsh**: posts big blind $1
xxxZeka: sits out 
masaytoo: sits out 
*** HOLE CARDS ***
Dealt to matiko09 [9h Js]
o.miro: folds 
matiko09: folds 
ardo888: folds 
ozone2003: raises $1.50 to $2.50
MiiiTCHy__: folds 
PacPacBum: folds 
riggedsh**: folds 
Uncalled bet ($1.50) returned to ozone2003
ozone2003 collected $2.50 from pot
ozone2003: doesn't show hand 
*** SUMMARY ***
Total pot $2.50 | Rake $0 
Seat 3: ardo888 folded before Flop (didn't bet)
Seat 4: ozone2003 collected ($2.50)
Seat 5: MiiiTCHy__ (button) folded before Flop (didn't bet)
Seat 6: PacPacBum (small blind) folded before Flop
Seat 7: riggedsh** (big blind) folded before Flop
Seat 8: o.miro folded before Flop (didn't bet)
Seat 9: matiko09 folded before Flop (didn't bet)





PokerStars Hand #154362862313:  Hold'em No Limit ($0.50/$1.00 USD) - 2016/06/06 12:33:33 CET [2016/06/06 6:33:33 ET]
Table 'Williams' 9-max Seat #6 is the button
Seat 1: matiko09 ($192.79 in chips) 
Seat 2: PacPacBum ($104.50 in chips) 
Seat 3: granbunny ($54.60 in chips) 
Seat 4: Filojoes ($130.99 in chips) 
Seat 5: ardo888 ($124.50 in chips) 
Seat 6: Priidix ($123.44 in chips) 
Seat 7: kevinho109 ($58.73 in chips) 
Seat 8: oscarleon ($108.86 in chips) 
Seat 9: kind ten ($39.55 in chips) 
kevinho109: posts small blind $0.50
oscarleon: posts big blind $1
*** HOLE CARDS ***
Dealt to matiko09 [7h Ad]
kind ten: folds 
matiko09: folds 
PacPacBum: folds 
granbunny: raises $1 to $2
Filojoes: folds 
ardo888: folds 
Priidix: folds 
kevinho109: folds 
oscarleon: folds 
Uncalled bet ($1) returned to granbunny
granbunny collected $2.50 from pot
granbunny: doesn't show hand 
*** SUMMARY ***
Total pot $2.50 | Rake $0 
Seat 1: matiko09 folded before Flop (didn't bet)
Seat 2: PacPacBum folded before Flop (didn't bet)
Seat 3: granbunny collected ($2.50)
Seat 4: Filojoes folded before Flop (didn't bet)
Seat 5: ardo888 folded before Flop (didn't bet)
Seat 6: Priidix (button) folded before Flop (didn't bet)
Seat 7: kevinho109 (small blind) folded before Flop
Seat 8: oscarleon (big blind) folded before Flop
Seat 9: kind ten folded before Flop (didn't bet)





PokerStars Hand #154362863109:  Hold'em No Limit ($0.50/$1.00 USD) - 2016/06/06 12:33:35 CET [2016/06/06 6:33:35 ET]
Table 'Smither' 9-max Seat #4 is the button
Seat 1: PacPacBum ($103 in chips) 
Seat 2: matiko09 ($100 in chips) 
Seat 3: xxxZeka ($100 in chips) 
Seat 4: maxxmeister ($213.16 in chips) 
Seat 5: Szevasztopol ($100 in chips) 
Seat 6: riggedsh** ($110.28 in chips) 
Seat 7: 007Bond001 ($63.50 in chips) 
Szevasztopol: posts small blind $0.50
riggedsh**: posts big blind $1
*** HOLE CARDS ***
Dealt to matiko09 [Ks 3h]
007Bond001: calls $1
PacPacBum: folds 
matiko09: folds 
xxxZeka: raises $3.50 to $4.50
maxxmeister: folds 
Szevasztopol: folds 
riggedsh**: folds 
007Bond001: calls $3.50
*** FLOP *** [6d Qc 7d]
007Bond001: checks 
xxxZeka: bets $7.48
007Bond001: calls $7.48
*** TURN *** [6d Qc 7d] [2d]
007Bond001: checks 
xxxZeka: checks 
*** RIVER *** [6d Qc 7d 2d] [Kd]
007Bond001: bets $5
xxxZeka: calls $5
*** SHOW DOWN ***
007Bond001: shows [7s 9s] (a pair of Sevens)
xxxZeka: shows [As Ac] (a pair of Aces)
xxxZeka collected $33.69 from pot
*** SUMMARY ***
Total pot $35.46 | Rake $1.77 
Board [6d Qc 7d 2d Kd]
Seat 1: PacPacBum folded before Flop (didn't bet)
Seat 2: matiko09 folded before Flop (didn't bet)
Seat 3: xxxZeka showed [As Ac] and won ($33.69) with a pair of Aces
Seat 4: maxxmeister (button) folded before Flop (didn't bet)
Seat 5: Szevasztopol (small blind) folded before Flop
Seat 6: riggedsh** (big blind) folded before Flop
Seat 7: 007Bond001 showed [7s 9s] and lost with a pair of Sevens





PokerStars Hand #154362866004:  Hold'em No Limit ($0.50/$1.00 USD) - 2016/06/06 12:33:42 CET [2016/06/06 6:33:42 ET]
Table 'Irmgard II' 9-max Seat #8 is the button
Seat 1: matiko09 ($147 in chips) 
Seat 2: hammerwife ($116.68 in chips) 
Seat 4: oscarleon ($159.26 in chips) 
Seat 6: maxxmeister ($266.20 in chips) 
Seat 7: 32rrew ($102.68 in chips) 
Seat 8: Szevasztopol ($100 in chips) 
matiko09: posts small blind $0.50
hammerwife: posts big blind $1
stds st: sits out 
*** HOLE CARDS ***
Dealt to matiko09 [8c Ks]
oscarleon: folds 
maxxmeister: folds 
32rrew: folds 
Szevasztopol: raises $1 to $2
matiko09: folds 
hammerwife: raises $6.50 to $8.50
Szevasztopol: calls $6.50
*** FLOP *** [2d 8h 8d]
hammerwife: bets $8.31
DONFILIPPO1 joins the table at seat #9 
Szevasztopol: folds 
Uncalled bet ($8.31) returned to hammerwife
hammerwife collected $16.62 from pot
hammerwife: doesn't show hand 
*** SUMMARY ***
Total pot $17.50 | Rake $0.88 
Board [2d 8h 8d]
Seat 1: matiko09 (small blind) folded before Flop
Seat 2: hammerwife (big blind) collected ($16.62)
Seat 4: oscarleon folded before Flop (didn't bet)
Seat 6: maxxmeister folded before Flop (didn't bet)
Seat 7: 32rrew folded before Flop (didn't bet)
Seat 8: Szevasztopol (button) folded on the Flop





PokerStars Hand #154362867890:  Hold'em No Limit ($0.50/$1.00 USD) - 2016/06/06 12:33:47 CET [2016/06/06 6:33:47 ET]
Table 'Yarilo' 9-max Seat #6 is the button
Seat 1: xxxZeka ($101.50 in chips) 
Seat 3: matiko09 ($110.42 in chips) 
Seat 4: riggedsh** ($112.88 in chips) 
Seat 5: Szevasztopol ($135.69 in chips) 
Seat 6: maxxmeister ($100 in chips) 
Seat 7: KEBIN1974 ($100 in chips) 
Seat 8: Mr.Grigoriy ($170.03 in chips) 
Seat 9: Filojoes ($112.82 in chips) 
KEBIN1974: posts small blind $0.50
Mr.Grigoriy: posts big blind $1
nombraalne1: sits out 
*** HOLE CARDS ***
Dealt to matiko09 [8s 4d]
Filojoes: folds 
xxxZeka: folds 
matiko09: folds 
riggedsh**: folds 
Szevasztopol: folds 
maxxmeister: raises $2 to $3
KEBIN1974: raises $7 to $10
Mr.Grigoriy: folds 
maxxmeister: raises $11 to $21
KEBIN1974: folds 
Uncalled bet ($11) returned to maxxmeister
maxxmeister collected $21 from pot
maxxmeister: doesn't show hand 
*** SUMMARY ***
Total pot $21 | Rake $0 
Seat 1: xxxZeka folded before Flop (didn't bet)
Seat 3: matiko09 folded before Flop (didn't bet)
Seat 4: riggedsh** folded before Flop (didn't bet)
Seat 5: Szevasztopol folded before Flop (didn't bet)
Seat 6: maxxmeister (button) collected ($21)
Seat 7: KEBIN1974 (small blind) folded before Flop
Seat 8: Mr.Grigoriy (big blind) folded before Flop
Seat 9: Filojoes folded before Flop (didn't bet)





PokerStars Hand #154362869095:  Hold'em No Limit ($0.50/$1.00 USD) - 2016/06/06 12:33:50 CET [2016/06/06 6:33:50 ET]
Table 'Chaldaea II' 9-max Seat #6 is the button
Seat 3: ardo888 ($105.58 in chips) 
Seat 4: ozone2003 ($120.21 in chips) 
Seat 5: MiiiTCHy__ ($59.88 in chips) 
Seat 6: PacPacBum ($100 in chips) 
Seat 7: riggedsh** ($149.88 in chips) 
Seat 8: o.miro ($100 in chips) 
Seat 9: matiko09 ($100 in chips) 
riggedsh**: posts small blind $0.50
o.miro: posts big blind $1
xxxZeka: sits out 
masaytoo: sits out 
*** HOLE CARDS ***
Dealt to matiko09 [Qc Ts]
matiko09: folds 
ardo888: folds 
ozone2003: folds 
MiiiTCHy__: folds 
PacPacBum: raises $2 to $3
riggedsh**: folds 
o.miro: calls $2
*** FLOP *** [6h 2h 9h]
o.miro: checks 
PacPacBum: bets $2.16
o.miro: calls $2.16
*** TURN *** [6h 2h 9h] [5d]
o.miro: checks 
PacPacBum: checks 
*** RIVER *** [6h 2h 9h 5d] [6c]
o.miro: checks 
PacPacBum: bets $7.09
o.miro: calls $7.09
*** SHOW DOWN ***
PacPacBum: shows [5s 4s] (two pair, Sixes and Fives)
o.miro: shows [Jd 9d] (two pair, Nines and Sixes)
o.miro collected $23.75 from pot
*** SUMMARY ***
Total pot $25 | Rake $1.25 
Board [6h 2h 9h 5d 6c]
Seat 3: ardo888 folded before Flop (didn't bet)
Seat 4: ozone2003 folded before Flop (didn't bet)
Seat 5: MiiiTCHy__ folded before Flop (didn't bet)
Seat 6: PacPacBum (button) showed [5s 4s] and lost with two pair, Sixes and Fives
Seat 7: riggedsh** (small blind) folded before Flop
Seat 8: o.miro (big blind) showed [Jd 9d] and won ($23.75) with two pair, Nines and Sixes
Seat 9: matiko09 folded before Flop (didn't bet)





PokerStars Hand #154362869457:  Hold'em No Limit ($0.50/$1.00 USD) - 2016/06/06 12:33:51 CET [2016/06/06 6:33:51 ET]
Table 'Gajdariya' 9-max Seat #2 is the button
Seat 1: matiko09 ($117.23 in chips) 
Seat 2: xxxZeka ($126.74 in chips) 
Seat 3: oscarleon ($104.50 in chips) 
Seat 4: Szevasztopol ($108.13 in chips) 
Seat 5: 147734319 ($110.01 in chips) 
Seat 6: mono123viva ($136.91 in chips) 
Seat 7: Wombatkilla ($95.82 in chips) 
Seat 8: ardo888 ($100 in chips) 
Seat 9: Mr.Grigoriy ($103.06 in chips) 
oscarleon: posts small blind $0.50
Szevasztopol: posts big blind $1
*** HOLE CARDS ***
Dealt to matiko09 [3c 9c]
147734319: raises $2 to $3
mono123viva: folds 
Wombatkilla: folds 
ardo888: folds 
Mr.Grigoriy: folds 
matiko09: folds 
xxxZeka: folds 
oscarleon: raises $6 to $9
Szevasztopol: folds 
147734319: calls $6
*** FLOP *** [7c Jc 5c]
oscarleon: bets $13
147734319: folds 
Uncalled bet ($13) returned to oscarleon
oscarleon collected $18.05 from pot
oscarleon: doesn't show hand 
*** SUMMARY ***
Total pot $19 | Rake $0.95 
Board [7c Jc 5c]
Seat 1: matiko09 folded before Flop (didn't bet)
Seat 2: xxxZeka (button) folded before Flop (didn't bet)
Seat 3: oscarleon (small blind) collected ($18.05)
Seat 4: Szevasztopol (big blind) folded before Flop
Seat 5: 147734319 folded on the Flop
Seat 6: mono123viva folded before Flop (didn't bet)
Seat 7: Wombatkilla folded before Flop (didn't bet)
Seat 8: ardo888 folded before Flop (didn't bet)
Seat 9: Mr.Grigoriy folded before Flop (didn't bet)





PokerStars Hand #154362872733:  Hold'em No Limit ($0.50/$1.00 USD) - 2016/06/06 12:34:00 CET [2016/06/06 6:34:00 ET]
Table 'Heze' 9-max Seat #9 is the button
Seat 1: matiko09 ($214.15 in chips) 
Seat 2: oscarleon ($243.31 in chips) 
Seat 3: maxxmeister ($121.01 in chips) 
Seat 4: xxxZeka ($101.50 in chips) 
Seat 5: Filojoes ($100.24 in chips) 
Seat 6: ozone2003 ($109.07 in chips) 
Seat 7: Priidix ($100 in chips) 
Seat 8: AlSmithy88 ($43.84 in chips) 
Seat 9: Mr.Grigoriy ($122.70 in chips) 
matiko09: posts small blind $0.50
oscarleon: posts big blind $1
*** HOLE CARDS ***
Dealt to matiko09 [Ah Ac]
maxxmeister: folds 
xxxZeka: folds 
Filojoes: folds 
ozone2003: raises $2 to $3
Priidix: folds 
AlSmithy88: folds 
Mr.Grigoriy: folds 
matiko09: raises $7 to $10
oscarleon: folds 
ozone2003: folds 
Uncalled bet ($7) returned to matiko09
matiko09 collected $7 from pot
matiko09: doesn't show hand 
*** SUMMARY ***
Total pot $7 | Rake $0 
Seat 1: matiko09 (small blind) collected ($7)
Seat 2: oscarleon (big blind) folded before Flop
Seat 3: maxxmeister folded before Flop (didn't bet)
Seat 4: xxxZeka folded before Flop (didn't bet)
Seat 5: Filojoes folded before Flop (didn't bet)
Seat 6: ozone2003 folded before Flop
Seat 7: Priidix folded before Flop (didn't bet)
Seat 8: AlSmithy88 folded before Flop (didn't bet)
Seat 9: Mr.Grigoriy (button) folded before Flop (didn't bet)





PokerStars Hand #154362873961:  Hold'em Pot Limit ($0.50/$1.00 USD) - 2016/06/06 12:34:03 CET [2016/06/06 6:34:03 ET]
Table 'Abnoba' 9-max Seat #4 is the button
Seat 3: vanilica ($112 in chips) 
Seat 4: ozone2003 ($100 in chips) 
Seat 5: bojankalas ($28 in chips) 
Seat 7: matiko09 ($100 in chips) 
bojankalas: posts small blind $0.50
matiko09: posts big blind $1
nombraalne1: sits out 
*** HOLE CARDS ***
Dealt to matiko09 [4h 9s]
vanilica: folds 
ozone2003: raises $1.20 to $2.20
bojankalas: folds 
matiko09: folds 
Uncalled bet ($1.20) returned to ozone2003
bojankalas leaves the table
ozone2003 collected $2.50 from pot
ozone2003: doesn't show hand 
*** SUMMARY ***
Total pot $2.50 | Rake $0 
Seat 3: vanilica folded before Flop (didn't bet)
Seat 4: ozone2003 (button) collected ($2.50)
Seat 5: bojankalas (small blind) folded before Flop
Seat 7: matiko09 (big blind) folded before Flop





PokerStars Hand #154362877374:  Hold'em No Limit ($0.50/$1.00 USD) - 2016/06/06 12:34:11 CET [2016/06/06 6:34:11 ET]
Table 'Williams' 9-max Seat #7 is the button
Seat 1: matiko09 ($192.79 in chips) 
Seat 2: PacPacBum ($104.50 in chips) 
Seat 3: granbunny ($56.10 in chips) 
Seat 4: Filojoes ($130.99 in chips) 
Seat 5: ardo888 ($124.50 in chips) 
Seat 6: Priidix ($123.44 in chips) 
Seat 7: kevinho109 ($58.23 in chips) 
Seat 8: oscarleon ($107.86 in chips) 
Seat 9: kind ten ($39.55 in chips) 
oscarleon: posts small blind $0.50
kind ten: posts big blind $1
*** HOLE CARDS ***
Dealt to matiko09 [Kd 8s]
matiko09: folds 
PacPacBum: raises $2 to $3
granbunny: folds 
Filojoes: folds 
ardo888: folds 
Priidix: folds 
kevinho109: folds 
oscarleon: folds 
kind ten: folds 
Uncalled bet ($2) returned to PacPacBum
PacPacBum collected $2.50 from pot
PacPacBum: doesn't show hand 
*** SUMMARY ***
Total pot $2.50 | Rake $0 
Seat 1: matiko09 folded before Flop (didn't bet)
Seat 2: PacPacBum collected ($2.50)
Seat 3: granbunny folded before Flop (didn't bet)
Seat 4: Filojoes folded before Flop (didn't bet)
Seat 5: ardo888 folded before Flop (didn't bet)
Seat 6: Priidix folded before Flop (didn't bet)
Seat 7: kevinho109 (button) folded before Flop (didn't bet)
Seat 8: oscarleon (small blind) folded before Flop
Seat 9: kind ten (big blind) folded before Flop





PokerStars Hand #154362879808:  Hold'em Pot Limit ($0.50/$1.00 USD) - 2016/06/06 12:34:18 CET [2016/06/06 6:34:18 ET]
Table 'Abnoba' 9-max Seat #7 is the button
Seat 3: vanilica ($112 in chips) 
Seat 4: ozone2003 ($101.50 in chips) 
Seat 7: matiko09 ($100 in chips) 
nombraalne1 will be allowed to play after the button
vanilica: posts small blind $0.50
ozone2003: posts big blind $1
*** HOLE CARDS ***
Dealt to matiko09 [7h 3h]
matiko09: folds 
vanilica: raises $2 to $3
ozone2003: folds 
Uncalled bet ($2) returned to vanilica
vanilica collected $2 from pot
vanilica: doesn't show hand 
*** SUMMARY ***
Total pot $2 | Rake $0 
Seat 3: vanilica (small blind) collected ($2)
Seat 4: ozone2003 (big blind) folded before Flop
Seat 7: matiko09 (button) folded before Flop (didn't bet)





PokerStars Hand #154362879923:  Hold'em No Limit ($0.50/$1.00 USD) - 2016/06/06 12:34:18 CET [2016/06/06 6:34:18 ET]
Table 'Wezen II' 9-max Seat #4 is the button
Seat 1: matiko09 ($162.47 in chips) 
Seat 2: Mr.Grigoriy ($108.18 in chips) 
Seat 3: oscarleon ($100.18 in chips) 
Seat 4: xxxibgdrgn ($100 in chips) 
Seat 5: stds st ($39 in chips) 
Seat 7: KDJAll3 ($88.81 in chips) 
Seat 8: mavin80 ($162.20 in chips) 
Seat 9: Filojoes ($107.01 in chips) 
stds st: posts small blind $0.50
Szevasztopol: is sitting out 
KDJAll3: posts big blind $1
*** HOLE CARDS ***
Dealt to matiko09 [As 9h]
mavin80: raises $1 to $2
Filojoes: folds 
matiko09: folds 
Mr.Grigoriy: folds 
oscarleon: folds 
xxxibgdrgn: folds 
stds st: folds 
KDJAll3: folds 
Uncalled bet ($1) returned to mavin80
mavin80 collected $2.50 from pot
mavin80: doesn't show hand 
*** SUMMARY ***
Total pot $2.50 | Rake $0 
Seat 1: matiko09 folded before Flop (didn't bet)
Seat 2: Mr.Grigoriy folded before Flop (didn't bet)
Seat 3: oscarleon folded before Flop (didn't bet)
Seat 4: xxxibgdrgn (button) folded before Flop (didn't bet)
Seat 5: stds st (small blind) folded before Flop
Seat 7: KDJAll3 (big blind) folded before Flop
Seat 8: mavin80 collected ($2.50)
Seat 9: Filojoes folded before Flop (didn't bet)





PokerStars Hand #154362886319:  Hold'em Pot Limit ($0.50/$1.00 USD) - 2016/06/06 12:34:34 CET [2016/06/06 6:34:34 ET]
Table 'Abnoba' 9-max Seat #3 is the button
Seat 3: vanilica ($113 in chips) 
Seat 4: ozone2003 ($100.50 in chips) 
Seat 7: matiko09 ($100 in chips) 
ozone2003: posts small blind $0.50
matiko09: posts big blind $1
nombraalne1: sits out 
*** HOLE CARDS ***
Dealt to matiko09 [Th Ks]
vanilica: folds 
ozone2003: folds 
Uncalled bet ($0.50) returned to matiko09
matiko09 collected $1 from pot
matiko09: doesn't show hand 
*** SUMMARY ***
Total pot $1 | Rake $0 
Seat 3: vanilica (button) folded before Flop (didn't bet)
Seat 4: ozone2003 (small blind) folded before Flop
Seat 7: matiko09 (big blind) collected ($1)





PokerStars Hand #154362886935:  Hold'em No Limit ($0.50/$1.00 USD) - 2016/06/06 12:34:36 CET [2016/06/06 6:34:36 ET]
Table 'Williams' 9-max Seat #8 is the button
Seat 1: matiko09 ($192.79 in chips) 
Seat 2: PacPacBum ($106 in chips) 
Seat 3: granbunny ($56.10 in chips) 
Seat 4: Filojoes ($130.99 in chips) 
Seat 5: ardo888 ($124.50 in chips) 
Seat 6: Priidix ($123.44 in chips) 
Seat 7: kevinho109 ($58.23 in chips) 
Seat 8: oscarleon ($107.36 in chips) 
Seat 9: kind ten ($38.55 in chips) 
kind ten: posts small blind $0.50
matiko09: posts big blind $1
*** HOLE CARDS ***
Dealt to matiko09 [3h 9h]
PacPacBum: folds 
granbunny: raises $1 to $2
Filojoes: folds 
ardo888: calls $2
Priidix: folds 
kevinho109: folds 
oscarleon: folds 
kind ten: folds 
matiko09: folds 
*** FLOP *** [Jd 9d 4c]
granbunny: checks 
ardo888: checks 
*** TURN *** [Jd 9d 4c] [8s]
granbunny: checks 
ardo888: bets $3.39
granbunny: folds 
Uncalled bet ($3.39) returned to ardo888
ardo888 collected $5.22 from pot
ardo888: doesn't show hand 
*** SUMMARY ***
Total pot $5.50 | Rake $0.28 
Board [Jd 9d 4c 8s]
Seat 1: matiko09 (big blind) folded before Flop
Seat 2: PacPacBum folded before Flop (didn't bet)
Seat 3: granbunny folded on the Turn
Seat 4: Filojoes folded before Flop (didn't bet)
Seat 5: ardo888 collected ($5.22)
Seat 6: Priidix folded before Flop (didn't bet)
Seat 7: kevinho109 folded before Flop (didn't bet)
Seat 8: oscarleon (button) folded before Flop (didn't bet)
Seat 9: kind ten (small blind) folded before Flop





PokerStars Hand #154362888252:  Hold'em No Limit ($0.50/$1.00 USD) - 2016/06/06 12:34:39 CET [2016/06/06 6:34:39 ET]
Table 'Safara' 9-max Seat #8 is the button
Seat 1: oscarleon ($234.44 in chips) 
Seat 2: Szevasztopol ($100 in chips) 
Seat 3: ozone2003 ($103 in chips) 
Seat 4: mattyt212 ($203 in chips) 
Seat 5: Dantist1122 ($107.53 in chips) 
Seat 6: matiko09 ($105.60 in chips) 
Seat 7: PacPacBum ($100 in chips) 
Seat 8: Priidix ($100 in chips) 
Seat 9: Mr.Grigoriy ($103.17 in chips) 
Mr.Grigoriy: posts small blind $0.50
oscarleon: posts big blind $1
*** HOLE CARDS ***
Dealt to matiko09 [7s 3s]
Szevasztopol: folds 
ozone2003: folds 
mattyt212: folds 
Dantist1122: folds 
matiko09: folds 
PacPacBum: folds 
Priidix: raises $1.24 to $2.24
Mr.Grigoriy: folds 
oscarleon: folds 
Uncalled bet ($1.24) returned to Priidix
Priidix collected $2.50 from pot
Priidix: doesn't show hand 
*** SUMMARY ***
Total pot $2.50 | Rake $0 
Seat 1: oscarleon (big blind) folded before Flop
Seat 2: Szevasztopol folded before Flop (didn't bet)
Seat 3: ozone2003 folded before Flop (didn't bet)
Seat 4: mattyt212 folded before Flop (didn't bet)
Seat 5: Dantist1122 folded before Flop (didn't bet)
Seat 6: matiko09 folded before Flop (didn't bet)
Seat 7: PacPacBum folded before Flop (didn't bet)
Seat 8: Priidix (button) collected ($2.50)
Seat 9: Mr.Grigoriy (small blind) folded before Flop





PokerStars Hand #154362888450:  Hold'em No Limit ($0.50/$1.00 USD) - 2016/06/06 12:34:40 CET [2016/06/06 6:34:40 ET]
Table 'Yarilo' 9-max Seat #7 is the button
Seat 1: xxxZeka ($101.50 in chips) 
Seat 3: matiko09 ($110.42 in chips) 
Seat 4: riggedsh** ($112.88 in chips) 
Seat 5: Szevasztopol ($135.69 in chips) 
Seat 6: maxxmeister ($111 in chips) 
Seat 7: KEBIN1974 ($100 in chips) 
Seat 8: Mr.Grigoriy ($169.03 in chips) 
Mr.Grigoriy: posts small blind $0.50
Filojoes: is sitting out 
xxxZeka: posts big blind $1
Filojoes leaves the table
nombraalne1: sits out 
*** HOLE CARDS ***
Dealt to matiko09 [2d Ad]
o.miro joins the table at seat #9 
matiko09: folds 
riggedsh**: folds 
Szevasztopol: folds 
maxxmeister: folds 
KEBIN1974: raises $1.50 to $2.50
Mr.Grigoriy: folds 
xxxZeka: folds 
Uncalled bet ($1.50) returned to KEBIN1974
KEBIN1974 collected $2.50 from pot
KEBIN1974: doesn't show hand 
*** SUMMARY ***
Total pot $2.50 | Rake $0 
Seat 1: xxxZeka (big blind) folded before Flop
Seat 3: matiko09 folded before Flop (didn't bet)
Seat 4: riggedsh** folded before Flop (didn't bet)
Seat 5: Szevasztopol folded before Flop (didn't bet)
Seat 6: maxxmeister folded before Flop (didn't bet)
Seat 7: KEBIN1974 (button) collected ($2.50)
Seat 8: Mr.Grigoriy (small blind) folded before Flop





PokerStars Hand #154362889637:  Hold'em No Limit ($0.50/$1.00 USD) - 2016/06/06 12:34:43 CET [2016/06/06 6:34:43 ET]
Table 'Gajdariya' 9-max Seat #3 is the button
Seat 1: matiko09 ($117.23 in chips) 
Seat 2: xxxZeka ($126.74 in chips) 
Seat 3: oscarleon ($113.55 in chips) 
Seat 4: Szevasztopol ($107.13 in chips) 
Seat 5: 147734319 ($101.01 in chips) 
Seat 6: mono123viva ($136.91 in chips) 
Seat 7: Wombatkilla ($95.82 in chips) 
Seat 8: ardo888 ($100 in chips) 
Seat 9: Mr.Grigoriy ($103.06 in chips) 
Szevasztopol: posts small blind $0.50
147734319: posts big blind $1
*** HOLE CARDS ***
Dealt to matiko09 [Ac 8d]
mono123viva: folds 
Wombatkilla: folds 
ardo888: folds 
Mr.Grigoriy: raises $2 to $3
matiko09: folds 
xxxZeka: folds 
oscarleon: folds 
Szevasztopol: folds 
147734319: folds 
Uncalled bet ($2) returned to Mr.Grigoriy
Mr.Grigoriy collected $2.50 from pot
Mr.Grigoriy: doesn't show hand 
*** SUMMARY ***
Total pot $2.50 | Rake $0 
Seat 1: matiko09 folded before Flop (didn't bet)
Seat 2: xxxZeka folded before Flop (didn't bet)
Seat 3: oscarleon (button) folded before Flop (didn't bet)
Seat 4: Szevasztopol (small blind) folded before Flop
Seat 5: 147734319 (big blind) folded before Flop
Seat 6: mono123viva folded before Flop (didn't bet)
Seat 7: Wombatkilla folded before Flop (didn't bet)
Seat 8: ardo888 folded before Flop (didn't bet)
Seat 9: Mr.Grigoriy collected ($2.50)





PokerStars Hand #154362889574:  Hold'em Pot Limit ($0.50/$1.00 USD) - 2016/06/06 12:34:43 CET [2016/06/06 6:34:43 ET]
Table 'Abnoba' 9-max Seat #4 is the button
Seat 3: vanilica ($113 in chips) 
Seat 4: ozone2003 ($100 in chips) 
Seat 7: matiko09 ($100.50 in chips) 
Seat 8: nombraalne1 ($100 in chips) 
matiko09: posts small blind $0.50
nombraalne1: posts big blind $1
*** HOLE CARDS ***
Dealt to matiko09 [Jd 4d]
vanilica: folds 
vanilica leaves the table
ozone2003: folds 
matiko09: raises $2 to $3
nombraalne1: calls $2
*** FLOP *** [5h 5c 4c]
matiko09: bets $2.96
nombraalne1: folds 
Uncalled bet ($2.96) returned to matiko09
matiko09 collected $5.70 from pot
matiko09: doesn't show hand 
*** SUMMARY ***
Total pot $6 | Rake $0.30 
Board [5h 5c 4c]
Seat 3: vanilica folded before Flop (didn't bet)
Seat 4: ozone2003 (button) folded before Flop (didn't bet)
Seat 7: matiko09 (small blind) collected ($5.70)
Seat 8: nombraalne1 (big blind) folded on the Flop





PokerStars Hand #154362895977:  Hold'em No Limit ($0.50/$1.00 USD) - 2016/06/06 12:34:59 CET [2016/06/06 6:34:59 ET]
Table 'Wezen II' 9-max Seat #5 is the button
Seat 1: matiko09 ($162.47 in chips) 
Seat 2: Mr.Grigoriy ($108.18 in chips) 
Seat 3: oscarleon ($100.18 in chips) 
Seat 4: xxxibgdrgn ($100 in chips) 
Seat 5: stds st ($38.50 in chips) 
Seat 7: KDJAll3 ($87.81 in chips) 
Seat 8: mavin80 ($163.70 in chips) 
Seat 9: Filojoes ($107.01 in chips) 
KDJAll3: posts small blind $0.50
mavin80: posts big blind $1
*** HOLE CARDS ***
Dealt to matiko09 [8c 4s]
Szevasztopol leaves the table
Filojoes: folds 
matiko09: folds 
masaytoo joins the table at seat #6 
Mr.Grigoriy: folds 
oscarleon: folds 
xxxibgdrgn: folds 
stds st: folds 
KDJAll3: folds 
Uncalled bet ($0.50) returned to mavin80
mavin80 collected $1 from pot
mavin80: doesn't show hand 
*** SUMMARY ***
Total pot $1 | Rake $0 
Seat 1: matiko09 folded before Flop (didn't bet)
Seat 2: Mr.Grigoriy folded before Flop (didn't bet)
Seat 3: oscarleon folded before Flop (didn't bet)
Seat 4: xxxibgdrgn folded before Flop (didn't bet)
Seat 5: stds st (button) folded before Flop (didn't bet)
Seat 7: KDJAll3 (small blind) folded before Flop
Seat 8: mavin80 (big blind) collected ($1)
Seat 9: Filojoes folded before Flop (didn't bet)





PokerStars Hand #154362897414:  Hold'em No Limit ($0.50/$1.00 USD) - 2016/06/06 12:35:02 CET [2016/06/06 6:35:02 ET]
Table 'Heze' 9-max Seat #1 is the button
Seat 1: matiko09 ($218.15 in chips) 
Seat 2: oscarleon ($242.31 in chips) 
Seat 3: maxxmeister ($121.01 in chips) 
Seat 4: xxxZeka ($101.50 in chips) 
Seat 5: Filojoes ($100.24 in chips) 
Seat 6: ozone2003 ($106.07 in chips) 
Seat 7: Priidix ($100 in chips) 
Seat 8: AlSmithy88 ($43.84 in chips) 
Seat 9: Mr.Grigoriy ($122.70 in chips) 
oscarleon: posts small blind $0.50
maxxmeister: posts big blind $1
*** HOLE CARDS ***
Dealt to matiko09 [Kc 7d]
xxxZeka: folds 
Filojoes: folds 
ozone2003: folds 
Priidix: folds 
AlSmithy88: folds 
Mr.Grigoriy: raises $1.50 to $2.50
matiko09: folds 
oscarleon: folds 
maxxmeister: folds 
Uncalled bet ($1.50) returned to Mr.Grigoriy
Mr.Grigoriy collected $2.50 from pot
Mr.Grigoriy: doesn't show hand 
*** SUMMARY ***
Total pot $2.50 | Rake $0 
Seat 1: matiko09 (button) folded before Flop (didn't bet)
Seat 2: oscarleon (small blind) folded before Flop
Seat 3: maxxmeister (big blind) folded before Flop
Seat 4: xxxZeka folded before Flop (didn't bet)
Seat 5: Filojoes folded before Flop (didn't bet)
Seat 6: ozone2003 folded before Flop (didn't bet)
Seat 7: Priidix folded before Flop (didn't bet)
Seat 8: AlSmithy88 folded before Flop (didn't bet)
Seat 9: Mr.Grigoriy collected ($2.50)





PokerStars Hand #154362897492:  Hold'em No Limit ($0.50/$1.00 USD) - 2016/06/06 12:35:02 CET [2016/06/06 6:35:02 ET]
Table 'Yarilo' 9-max Seat #8 is the button
Seat 1: xxxZeka ($100.50 in chips) 
Seat 2: nombraalne1 ($100 in chips) 
Seat 3: matiko09 ($110.42 in chips) 
Seat 4: riggedsh** ($112.88 in chips) 
Seat 5: Szevasztopol ($135.69 in chips) 
Seat 6: maxxmeister ($111 in chips) 
Seat 7: KEBIN1974 ($101.50 in chips) 
Seat 8: Mr.Grigoriy ($168.53 in chips) 
o.miro will be allowed to play after the button
xxxZeka: posts small blind $0.50
nombraalne1: posts big blind $1
*** HOLE CARDS ***
Dealt to matiko09 [2d 4h]
matiko09: folds 
riggedsh**: folds 
Szevasztopol: folds 
maxxmeister: folds 
KEBIN1974: folds 
Mr.Grigoriy: folds 
xxxZeka: raises $1.50 to $2.50
nombraalne1: raises $6.50 to $9
xxxZeka: folds 
Uncalled bet ($6.50) returned to nombraalne1
nombraalne1 collected $5 from pot
nombraalne1: doesn't show hand 
*** SUMMARY ***
Total pot $5 | Rake $0 
Seat 1: xxxZeka (small blind) folded before Flop
Seat 2: nombraalne1 (big blind) collected ($5)
Seat 3: matiko09 folded before Flop (didn't bet)
Seat 4: riggedsh** folded before Flop (didn't bet)
Seat 5: Szevasztopol folded before Flop (didn't bet)
Seat 6: maxxmeister folded before Flop (didn't bet)
Seat 7: KEBIN1974 folded before Flop (didn't bet)
Seat 8: Mr.Grigoriy (button) folded before Flop (didn't bet)





PokerStars Hand #154362897995:  Hold'em No Limit ($0.50/$1.00 USD) - 2016/06/06 12:35:04 CET [2016/06/06 6:35:04 ET]
Table 'Smither' 9-max Seat #5 is the button
Seat 1: PacPacBum ($103 in chips) 
Seat 2: matiko09 ($100 in chips) 
Seat 3: xxxZeka ($116.71 in chips) 
Seat 4: maxxmeister ($213.16 in chips) 
Seat 5: Szevasztopol ($100 in chips) 
Seat 6: riggedsh** ($109.28 in chips) 
Seat 7: 007Bond001 ($46.52 in chips) 
Seat 8: 74 ROADIE ($99 in chips) 
riggedsh**: posts small blind $0.50
007Bond001: posts big blind $1
74 ROADIE: posts small & big blinds $1.50
hammerwife: sits out 
*** HOLE CARDS ***
Dealt to matiko09 [5c Jh]
74 ROADIE: checks 
PacPacBum: raises $4 to $5
matiko09: folds 
xxxZeka: folds 
maxxmeister: folds 
Szevasztopol: folds 
riggedsh**: folds 
007Bond001: calls $4
74 ROADIE: folds 
*** FLOP *** [Qs Qc 9h]
007Bond001: checks 
PacPacBum: bets $3.99
007Bond001: folds 
Uncalled bet ($3.99) returned to PacPacBum
PacPacBum collected $11.40 from pot
PacPacBum: doesn't show hand 
*** SUMMARY ***
Total pot $12 | Rake $0.60 
Board [Qs Qc 9h]
Seat 1: PacPacBum collected ($11.40)
Seat 2: matiko09 folded before Flop (didn't bet)
Seat 3: xxxZeka folded before Flop (didn't bet)
Seat 4: maxxmeister folded before Flop (didn't bet)
Seat 5: Szevasztopol (button) folded before Flop (didn't bet)
Seat 6: riggedsh** (small blind) folded before Flop
Seat 7: 007Bond001 (big blind) folded on the Flop
Seat 8: 74 ROADIE folded before Flop





PokerStars Hand #154362904747:  Hold'em No Limit ($0.50/$1.00 USD) - 2016/06/06 12:35:21 CET [2016/06/06 6:35:21 ET]
Table 'Williams' 9-max Seat #9 is the button
Seat 1: matiko09 ($191.79 in chips) 
Seat 2: PacPacBum ($106 in chips) 
Seat 3: granbunny ($54.10 in chips) 
Seat 4: Filojoes ($130.99 in chips) 
Seat 5: ardo888 ($127.72 in chips) 
Seat 6: Priidix ($123.44 in chips) 
Seat 7: kevinho109 ($58.23 in chips) 
Seat 8: oscarleon ($107.36 in chips) 
Seat 9: kind ten ($38.05 in chips) 
matiko09: posts small blind $0.50
PacPacBum: posts big blind $1
*** HOLE CARDS ***
Dealt to matiko09 [6s 8c]
granbunny: folds 
Filojoes: folds 
ardo888: folds 
Priidix: folds 
kevinho109: folds 
oscarleon: raises $2 to $3
kind ten: folds 
matiko09: folds 
PacPacBum: folds 
Uncalled bet ($2) returned to oscarleon
oscarleon collected $2.50 from pot
oscarleon: doesn't show hand 
*** SUMMARY ***
Total pot $2.50 | Rake $0 
Seat 1: matiko09 (small blind) folded before Flop
Seat 2: PacPacBum (big blind) folded before Flop
Seat 3: granbunny folded before Flop (didn't bet)
Seat 4: Filojoes folded before Flop (didn't bet)
Seat 5: ardo888 folded before Flop (didn't bet)
Seat 6: Priidix folded before Flop (didn't bet)
Seat 7: kevinho109 folded before Flop (didn't bet)
Seat 8: oscarleon collected ($2.50)
Seat 9: kind ten (button) folded before Flop (didn't bet)





PokerStars Hand #154362904613:  Hold'em No Limit ($0.50/$1.00 USD) - 2016/06/06 12:35:21 CET [2016/06/06 6:35:21 ET]
Table 'Safara' 9-max Seat #9 is the button
Seat 1: oscarleon ($233.44 in chips) 
Seat 2: Szevasztopol ($100 in chips) 
Seat 3: ozone2003 ($103 in chips) 
Seat 4: mattyt212 ($203 in chips) 
Seat 5: Dantist1122 ($107.53 in chips) 
Seat 6: matiko09 ($105.60 in chips) 
Seat 7: PacPacBum ($100 in chips) 
Seat 8: Priidix ($101.50 in chips) 
Seat 9: Mr.Grigoriy ($102.67 in chips) 
oscarleon: posts small blind $0.50
Szevasztopol: posts big blind $1
*** HOLE CARDS ***
Dealt to matiko09 [Ad 6d]
ozone2003: folds 
mattyt212: calls $1
Dantist1122: folds 
matiko09: folds 
PacPacBum: folds 
Priidix: raises $3 to $4
Mr.Grigoriy: folds 
oscarleon: folds 
Szevasztopol: folds 
mattyt212: calls $3
*** FLOP *** [Ah 3c 6h]
mattyt212: checks 
Priidix: bets $5
mattyt212: folds 
Uncalled bet ($5) returned to Priidix
Priidix collected $9.02 from pot
Priidix: doesn't show hand 
*** SUMMARY ***
Total pot $9.50 | Rake $0.48 
Board [Ah 3c 6h]
Seat 1: oscarleon (small blind) folded before Flop
Seat 2: Szevasztopol (big blind) folded before Flop
Seat 3: ozone2003 folded before Flop (didn't bet)
Seat 4: mattyt212 folded on the Flop
Seat 5: Dantist1122 folded before Flop (didn't bet)
Seat 6: matiko09 folded before Flop (didn't bet)
Seat 7: PacPacBum folded before Flop (didn't bet)
Seat 8: Priidix collected ($9.02)
Seat 9: Mr.Grigoriy (button) folded before Flop (didn't bet)





PokerStars Hand #154362905510:  Hold'em No Limit ($0.50/$1.00 USD) - 2016/06/06 12:35:23 CET [2016/06/06 6:35:23 ET]
Table 'Gajdariya' 9-max Seat #4 is the button
Seat 1: matiko09 ($117.23 in chips) 
Seat 2: xxxZeka ($126.74 in chips) 
Seat 3: oscarleon ($113.55 in chips) 
Seat 4: Szevasztopol ($106.63 in chips) 
Seat 5: 147734319 ($100.01 in chips) 
Seat 6: mono123viva ($136.91 in chips) 
Seat 7: Wombatkilla ($95.82 in chips) 
Seat 8: ardo888 ($100 in chips) 
Seat 9: Mr.Grigoriy ($104.56 in chips) 
147734319: posts small blind $0.50
mono123viva: posts big blind $1
*** HOLE CARDS ***
Dealt to matiko09 [Ks Qh]
Wombatkilla: folds 
ardo888: raises $2 to $3
Mr.Grigoriy: folds 
matiko09: folds 
xxxZeka: folds 
oscarleon: folds 
Szevasztopol: folds 
147734319: folds 
mono123viva: folds 
Uncalled bet ($2) returned to ardo888
ardo888 collected $2.50 from pot
ardo888: doesn't show hand 
*** SUMMARY ***
Total pot $2.50 | Rake $0 
Seat 1: matiko09 folded before Flop (didn't bet)
Seat 2: xxxZeka folded before Flop (didn't bet)
Seat 3: oscarleon folded before Flop (didn't bet)
Seat 4: Szevasztopol (button) folded before Flop (didn't bet)
Seat 5: 147734319 (small blind) folded before Flop
Seat 6: mono123viva (big blind) folded before Flop
Seat 7: Wombatkilla folded before Flop (didn't bet)
Seat 8: ardo888 collected ($2.50)
Seat 9: Mr.Grigoriy folded before Flop (didn't bet)





PokerStars Hand #154362906494:  Hold'em No Limit ($0.50/$1.00 USD) - 2016/06/06 12:35:26 CET [2016/06/06 6:35:26 ET]
Table 'Chaldaea II' 9-max Seat #7 is the button
Seat 3: ardo888 ($105.58 in chips) 
Seat 4: ozone2003 ($120.21 in chips) 
Seat 5: MiiiTCHy__ ($59.88 in chips) 
Seat 6: PacPacBum ($100 in chips) 
Seat 7: riggedsh** ($149.38 in chips) 
Seat 8: o.miro ($111.50 in chips) 
Seat 9: matiko09 ($100 in chips) 
o.miro: posts small blind $0.50
matiko09: posts big blind $1
xxxZeka: sits out 
masaytoo: sits out 
*** HOLE CARDS ***
Dealt to matiko09 [5h Js]
ardo888: folds 
ozone2003: folds 
MiiiTCHy__: raises $1.50 to $2.50
PacPacBum: folds 
riggedsh**: folds 
o.miro: folds 
matiko09: folds 
Uncalled bet ($1.50) returned to MiiiTCHy__
MiiiTCHy__ collected $2.50 from pot
*** SUMMARY ***
Total pot $2.50 | Rake $0 
Seat 3: ardo888 folded before Flop (didn't bet)
Seat 4: ozone2003 folded before Flop (didn't bet)
Seat 5: MiiiTCHy__ collected ($2.50)
Seat 6: PacPacBum folded before Flop (didn't bet)
Seat 7: riggedsh** (button) folded before Flop (didn't bet)
Seat 8: o.miro (small blind) folded before Flop
Seat 9: matiko09 (big blind) folded before Flop





PokerStars Hand #154362909255:  Hold'em No Limit ($0.50/$1.00 USD) - 2016/06/06 12:35:32 CET [2016/06/06 6:35:32 ET]
Table 'Wezen II' 9-max Seat #7 is the button
Seat 1: matiko09 ($162.47 in chips) 
Seat 2: Mr.Grigoriy ($108.18 in chips) 
Seat 3: oscarleon ($100.18 in chips) 
Seat 4: xxxibgdrgn ($100 in chips) 
Seat 5: stds st ($38.50 in chips) 
Seat 7: KDJAll3 ($87.31 in chips) 
Seat 8: mavin80 ($164.20 in chips) 
mavin80: posts small blind $0.50
Filojoes: is sitting out 
Filojoes leaves the table
matiko09: posts big blind $1
masaytoo: sits out 
*** HOLE CARDS ***
Dealt to matiko09 [3c 6c]
Mr.Grigoriy: folds 
oscarleon: folds 
xxxibgdrgn: folds 
PacPacBum joins the table at seat #9 
stds st: raises $1.50 to $2.50
KDJAll3: folds 
mavin80: calls $2
matiko09: folds 
*** FLOP *** [Qc Jh 2c]
mavin80: checks 
stds st: checks 
*** TURN *** [Qc Jh 2c] [2d]
mavin80: checks 
stds st: checks 
*** RIVER *** [Qc Jh 2c 2d] [Ts]
mavin80: checks 
stds st: bets $4.10
mavin80: folds 
Uncalled bet ($4.10) returned to stds st
stds st collected $5.70 from pot
stds st: doesn't show hand 
*** SUMMARY ***
Total pot $6 | Rake $0.30 
Board [Qc Jh 2c 2d Ts]
Seat 1: matiko09 (big blind) folded before Flop
Seat 2: Mr.Grigoriy folded before Flop (didn't bet)
Seat 3: oscarleon folded before Flop (didn't bet)
Seat 4: xxxibgdrgn folded before Flop (didn't bet)
Seat 5: stds st collected ($5.70)
Seat 7: KDJAll3 (button) folded before Flop (didn't bet)
Seat 8: mavin80 (small blind) folded on the River





PokerStars Hand #154362910736:  Hold'em No Limit ($0.50/$1.00 USD) - 2016/06/06 12:35:36 CET [2016/06/06 6:35:36 ET]
Table 'Heze' 9-max Seat #2 is the button
Seat 1: matiko09 ($218.15 in chips) 
Seat 2: oscarleon ($241.81 in chips) 
Seat 3: maxxmeister ($120.01 in chips) 
Seat 4: xxxZeka ($101.50 in chips) 
Seat 5: Filojoes ($100.24 in chips) 
Seat 6: ozone2003 ($106.07 in chips) 
Seat 7: Priidix ($100 in chips) 
Seat 8: AlSmithy88 ($43.84 in chips) 
Seat 9: Mr.Grigoriy ($124.20 in chips) 
maxxmeister: posts small blind $0.50
xxxZeka: posts big blind $1
*** HOLE CARDS ***
Dealt to matiko09 [3h Ts]
Filojoes: folds 
Filojoes leaves the table
ozone2003: folds 
Priidix: folds 
AlSmithy88: folds 
Mr.Grigoriy: raises $2 to $3
matiko09: folds 
oscarleon: folds 
maxxmeister: folds 
xxxZeka: folds 
Uncalled bet ($2) returned to Mr.Grigoriy
Mr.Grigoriy collected $2.50 from pot
Mr.Grigoriy: doesn't show hand 
*** SUMMARY ***
Total pot $2.50 | Rake $0 
Seat 1: matiko09 folded before Flop (didn't bet)
Seat 2: oscarleon (button) folded before Flop (didn't bet)
Seat 3: maxxmeister (small blind) folded before Flop
Seat 4: xxxZeka (big blind) folded before Flop
Seat 5: Filojoes folded before Flop (didn't bet)
Seat 6: ozone2003 folded before Flop (didn't bet)
Seat 7: Priidix folded before Flop (didn't bet)
Seat 8: AlSmithy88 folded before Flop (didn't bet)
Seat 9: Mr.Grigoriy collected ($2.50)





PokerStars Hand #154362911196:  Hold'em No Limit ($0.50/$1.00 USD) - 2016/06/06 12:35:37 CET [2016/06/06 6:35:37 ET]
Table 'Smither' 9-max Seat #6 is the button
Seat 1: PacPacBum ($109.40 in chips) 
Seat 2: matiko09 ($100 in chips) 
Seat 3: xxxZeka ($116.71 in chips) 
Seat 4: maxxmeister ($213.16 in chips) 
Seat 5: Szevasztopol ($100 in chips) 
Seat 6: riggedsh** ($108.78 in chips) 
Seat 7: 007Bond001 ($41.52 in chips) 
Seat 8: 74 ROADIE ($97.50 in chips) 
007Bond001: posts small blind $0.50
74 ROADIE: posts big blind $1
hammerwife: sits out 
*** HOLE CARDS ***
Dealt to matiko09 [8h 8d]
PacPacBum: folds 
matiko09: raises $2 to $3
xxxZeka: folds 
maxxmeister: folds 
Szevasztopol: folds 
riggedsh**: folds 
007Bond001: calls $2.50
74 ROADIE: folds 
*** FLOP *** [Ac Tc 5s]
007Bond001: checks 
matiko09: checks 
*** TURN *** [Ac Tc 5s] [Ad]
007Bond001: checks 
matiko09: bets $3
007Bond001: calls $3
*** RIVER *** [Ac Tc 5s Ad] [4s]
007Bond001: checks 
matiko09: checks 
*** SHOW DOWN ***
007Bond001: shows [Qd Jd] (a pair of Aces)
matiko09: shows [8h 8d] (two pair, Aces and Eights)
matiko09 collected $12.35 from pot
*** SUMMARY ***
Total pot $13 | Rake $0.65 
Board [Ac Tc 5s Ad 4s]
Seat 1: PacPacBum folded before Flop (didn't bet)
Seat 2: matiko09 showed [8h 8d] and won ($12.35) with two pair, Aces and Eights
Seat 3: xxxZeka folded before Flop (didn't bet)
Seat 4: maxxmeister folded before Flop (didn't bet)
Seat 5: Szevasztopol folded before Flop (didn't bet)
Seat 6: riggedsh** (button) folded before Flop (didn't bet)
Seat 7: 007Bond001 (small blind) showed [Qd Jd] and lost with a pair of Aces
Seat 8: 74 ROADIE (big blind) folded before Flop





PokerStars Hand #154362912493:  Hold'em No Limit ($0.50/$1.00 USD) - 2016/06/06 12:35:41 CET [2016/06/06 6:35:41 ET]
Table 'Yarilo' 9-max Seat #1 is the button
Seat 1: xxxZeka ($100 in chips) 
Seat 2: nombraalne1 ($102.50 in chips) 
Seat 3: matiko09 ($110.42 in chips) 
Seat 4: riggedsh** ($112.88 in chips) 
Seat 5: Szevasztopol ($135.69 in chips) 
Seat 6: maxxmeister ($111 in chips) 
Seat 7: KEBIN1974 ($101.50 in chips) 
Seat 8: Mr.Grigoriy ($168.53 in chips) 
nombraalne1: posts small blind $0.50
matiko09: posts big blind $1
o.miro: sits out 
*** HOLE CARDS ***
Dealt to matiko09 [2d 5d]
riggedsh**: folds 
Szevasztopol: folds 
maxxmeister: folds 
KEBIN1974: raises $1.50 to $2.50
Mr.Grigoriy: raises $5 to $7.50
xxxZeka: folds 
nombraalne1: folds 
matiko09: folds 
KEBIN1974: folds 
Uncalled bet ($5) returned to Mr.Grigoriy
Mr.Grigoriy collected $6.50 from pot
Mr.Grigoriy: doesn't show hand 
*** SUMMARY ***
Total pot $6.50 | Rake $0 
Seat 1: xxxZeka (button) folded before Flop (didn't bet)
Seat 2: nombraalne1 (small blind) folded before Flop
Seat 3: matiko09 (big blind) folded before Flop
Seat 4: riggedsh** folded before Flop (didn't bet)
Seat 5: Szevasztopol folded before Flop (didn't bet)
Seat 6: maxxmeister folded before Flop (didn't bet)
Seat 7: KEBIN1974 folded before Flop
Seat 8: Mr.Grigoriy collected ($6.50)





PokerStars Hand #154362912820:  Hold'em No Limit ($0.50/$1.00 USD) - 2016/06/06 12:35:42 CET [2016/06/06 6:35:42 ET]
Table 'Williams' 9-max Seat #1 is the button
Seat 1: matiko09 ($191.29 in chips) 
Seat 2: PacPacBum ($105 in chips) 
Seat 3: granbunny ($54.10 in chips) 
Seat 4: Filojoes ($130.99 in chips) 
Seat 5: ardo888 ($127.72 in chips) 
Seat 6: Priidix ($123.44 in chips) 
Seat 7: kevinho109 ($58.23 in chips) 
Seat 8: oscarleon ($108.86 in chips) 
Seat 9: kind ten ($38.05 in chips) 
PacPacBum: posts small blind $0.50
granbunny: posts big blind $1
*** HOLE CARDS ***
Dealt to matiko09 [2h Ac]
Filojoes: folds 
Filojoes leaves the table
ardo888: folds 
Mr.Grigoriy joins the table at seat #4 
Priidix: folds 
kevinho109: raises $2 to $3
oscarleon: folds 
kind ten: folds 
matiko09: folds 
PacPacBum: folds 
granbunny: folds 
Uncalled bet ($2) returned to kevinho109
kevinho109 collected $2.50 from pot
*** SUMMARY ***
Total pot $2.50 | Rake $0 
Seat 1: matiko09 (button) folded before Flop (didn't bet)
Seat 2: PacPacBum (small blind) folded before Flop
Seat 3: granbunny (big blind) folded before Flop
Seat 4: Filojoes folded before Flop (didn't bet)
Seat 5: ardo888 folded before Flop (didn't bet)
Seat 6: Priidix folded before Flop (didn't bet)
Seat 7: kevinho109 collected ($2.50)
Seat 8: oscarleon folded before Flop (didn't bet)
Seat 9: kind ten folded before Flop (didn't bet)





PokerStars Hand #154362913474:  Hold'em No Limit ($0.50/$1.00 USD) - 2016/06/06 12:35:43 CET [2016/06/06 6:35:43 ET]
Table 'Irmgard II' 9-max Seat #1 is the button
Seat 1: matiko09 ($146.50 in chips) 
Seat 2: hammerwife ($124.80 in chips) 
Seat 3: stds st ($40 in chips) 
Seat 4: oscarleon ($159.26 in chips) 
Seat 6: maxxmeister ($266.20 in chips) 
Seat 7: 32rrew ($102.68 in chips) 
Seat 8: Szevasztopol ($100 in chips) 
Seat 9: DONFILIPPO1 ($50.01 in chips) 
hammerwife: posts small blind $0.50
stds st: posts big blind $1
DONFILIPPO1: posts big blind $1
*** HOLE CARDS ***
Dealt to matiko09 [Ts 7c]
oscarleon: folds 
maxxmeister: folds 
Mr.Grigoriy joins the table at seat #5 
32rrew: folds 
Szevasztopol: folds 
DONFILIPPO1: checks 
matiko09: folds 
hammerwife: folds 
stds st: checks 
*** FLOP *** [Ad 8d 8s]
stds st: checks 
DONFILIPPO1: bets $2
stds st: calls $2
*** TURN *** [Ad 8d 8s] [3c]
stds st: checks 
DONFILIPPO1: bets $2
stds st: calls $2
*** RIVER *** [Ad 8d 8s 3c] [6d]
stds st: checks 
DONFILIPPO1: checks 
*** SHOW DOWN ***
stds st: shows [Ac 2s] (two pair, Aces and Eights)
DONFILIPPO1: mucks hand 
stds st collected $9.98 from pot
*** SUMMARY ***
Total pot $10.50 | Rake $0.52 
Board [Ad 8d 8s 3c 6d]
Seat 1: matiko09 (button) folded before Flop (didn't bet)
Seat 2: hammerwife (small blind) folded before Flop
Seat 3: stds st (big blind) showed [Ac 2s] and won ($9.98) with two pair, Aces and Eights
Seat 4: oscarleon folded before Flop (didn't bet)
Seat 6: maxxmeister folded before Flop (didn't bet)
Seat 7: 32rrew folded before Flop (didn't bet)
Seat 8: Szevasztopol folded before Flop (didn't bet)
Seat 9: DONFILIPPO1 mucked [Qh 3s]





PokerStars Hand #154362920744:  Hold'em No Limit ($0.50/$1.00 USD) - 2016/06/06 12:36:02 CET [2016/06/06 6:36:02 ET]
Table 'Gajdariya' 9-max Seat #5 is the button
Seat 1: matiko09 ($117.23 in chips) 
Seat 2: xxxZeka ($126.74 in chips) 
Seat 3: oscarleon ($113.55 in chips) 
Seat 4: Szevasztopol ($106.63 in chips) 
Seat 5: 147734319 ($99.51 in chips) 
Seat 6: mono123viva ($135.91 in chips) 
Seat 7: Wombatkilla ($95.82 in chips) 
Seat 8: ardo888 ($101.50 in chips) 
Seat 9: Mr.Grigoriy ($104.56 in chips) 
mono123viva: posts small blind $0.50
Wombatkilla: posts big blind $1
*** HOLE CARDS ***
Dealt to matiko09 [4s 3h]
ardo888: folds 
Mr.Grigoriy: folds 
matiko09: folds 
xxxZeka: folds 
oscarleon: folds 
Szevasztopol: folds 
147734319: folds 
mono123viva: raises $2 to $3
Wombatkilla: calls $2
*** FLOP *** [5h 9d 2d]
mono123viva: bets $4
Wombatkilla: calls $4
*** TURN *** [5h 9d 2d] [7s]
mono123viva: checks 
Wombatkilla: checks 
*** RIVER *** [5h 9d 2d 7s] [Jh]
mono123viva: bets $6
Wombatkilla: raises $11 to $17
mono123viva: calls $11
*** SHOW DOWN ***
Wombatkilla: shows [7d 9h] (two pair, Nines and Sevens)
mono123viva: mucks hand 
Wombatkilla collected $45.60 from pot
*** SUMMARY ***
Total pot $48 | Rake $2.40 
Board [5h 9d 2d 7s Jh]
Seat 1: matiko09 folded before Flop (didn't bet)
Seat 2: xxxZeka folded before Flop (didn't bet)
Seat 3: oscarleon folded before Flop (didn't bet)
Seat 4: Szevasztopol folded before Flop (didn't bet)
Seat 5: 147734319 (button) folded before Flop (didn't bet)
Seat 6: mono123viva (small blind) mucked [Kh Jc]
Seat 7: Wombatkilla (big blind) showed [7d 9h] and won ($45.60) with two pair, Nines and Sevens
Seat 8: ardo888 folded before Flop (didn't bet)
Seat 9: Mr.Grigoriy folded before Flop (didn't bet)





PokerStars Hand #154362922735:  Hold'em No Limit ($0.50/$1.00 USD) - 2016/06/06 12:36:07 CET [2016/06/06 6:36:07 ET]
Table 'Chaldaea II' 9-max Seat #8 is the button
Seat 1: xxxZeka ($100 in chips) 
Seat 3: ardo888 ($105.58 in chips) 
Seat 4: ozone2003 ($120.21 in chips) 
Seat 5: MiiiTCHy__ ($61.38 in chips) 
Seat 6: PacPacBum ($100 in chips) 
Seat 7: riggedsh** ($149.38 in chips) 
Seat 8: o.miro ($111 in chips) 
Seat 9: matiko09 ($100 in chips) 
matiko09: posts small blind $0.50
xxxZeka: posts big blind $1
masaytoo: sits out 
*** HOLE CARDS ***
Dealt to matiko09 [Qd Ah]
ardo888: folds 
ozone2003: folds 
MiiiTCHy__: folds 
PacPacBum: raises $1.50 to $2.50
riggedsh**: calls $2.50
o.miro: folds 
matiko09: raises $9 to $11.50
xxxZeka: folds 
PacPacBum: folds 
riggedsh**: folds 
Uncalled bet ($9) returned to matiko09
matiko09 collected $8.50 from pot
matiko09: doesn't show hand 
*** SUMMARY ***
Total pot $8.50 | Rake $0 
Seat 1: xxxZeka (big blind) folded before Flop
Seat 3: ardo888 folded before Flop (didn't bet)
Seat 4: ozone2003 folded before Flop (didn't bet)
Seat 5: MiiiTCHy__ folded before Flop (didn't bet)
Seat 6: PacPacBum folded before Flop
Seat 7: riggedsh** folded before Flop
Seat 8: o.miro (button) folded before Flop (didn't bet)
Seat 9: matiko09 (small blind) collected ($8.50)





PokerStars Hand #154362923268:  Hold'em No Limit ($0.50/$1.00 USD) - 2016/06/06 12:36:08 CET [2016/06/06 6:36:08 ET]
Table 'Williams' 9-max Seat #2 is the button
Seat 1: matiko09 ($191.29 in chips) 
Seat 2: PacPacBum ($104.50 in chips) 
Seat 3: granbunny ($53.10 in chips) 
Seat 4: Mr.Grigoriy ($100 in chips) 
Seat 5: ardo888 ($127.72 in chips) 
Seat 6: Priidix ($123.44 in chips) 
Seat 7: kevinho109 ($59.73 in chips) 
Seat 8: oscarleon ($108.86 in chips) 
Seat 9: kind ten ($38.05 in chips) 
granbunny: posts small blind $0.50
Mr.Grigoriy: posts big blind $1
*** HOLE CARDS ***
Dealt to matiko09 [5s Kd]
ardo888: folds 
Priidix: folds 
kevinho109: folds 
oscarleon: folds 
ardo888 leaves the table
kind ten: folds 
matiko09: folds 
PacPacBum: folds 
granbunny: folds 
Uncalled bet ($0.50) returned to Mr.Grigoriy
Mr.Grigoriy collected $1 from pot
Mr.Grigoriy: doesn't show hand 
*** SUMMARY ***
Total pot $1 | Rake $0 
Seat 1: matiko09 folded before Flop (didn't bet)
Seat 2: PacPacBum (button) folded before Flop (didn't bet)
Seat 3: granbunny (small blind) folded before Flop
Seat 4: Mr.Grigoriy (big blind) collected ($1)
Seat 5: ardo888 folded before Flop (didn't bet)
Seat 6: Priidix folded before Flop (didn't bet)
Seat 7: kevinho109 folded before Flop (didn't bet)
Seat 8: oscarleon folded before Flop (didn't bet)
Seat 9: kind ten folded before Flop (didn't bet)





PokerStars Hand #154362925704:  Hold'em No Limit ($0.50/$1.00 USD) - 2016/06/06 12:36:14 CET [2016/06/06 6:36:14 ET]
Table 'Heze' 9-max Seat #3 is the button
Seat 1: matiko09 ($218.15 in chips) 
Seat 2: oscarleon ($241.81 in chips) 
Seat 3: maxxmeister ($119.51 in chips) 
Seat 4: xxxZeka ($100.50 in chips) 
Seat 6: ozone2003 ($106.07 in chips) 
Seat 7: Priidix ($100 in chips) 
Seat 8: AlSmithy88 ($43.84 in chips) 
Seat 9: Mr.Grigoriy ($125.70 in chips) 
xxxZeka: posts small blind $0.50
ozone2003: posts big blind $1
*** HOLE CARDS ***
Dealt to matiko09 [7s 4s]
Priidix: folds 
AlSmithy88: calls $1
Mr.Grigoriy: folds 
matiko09: folds 
oscarleon: folds 
maxxmeister: raises $4 to $5
xxxZeka: folds 
ozone2003: raises $8 to $13
AlSmithy88: folds 
maxxmeister: folds 
Uncalled bet ($8) returned to ozone2003
ozone2003 collected $11.50 from pot
ozone2003: doesn't show hand 
*** SUMMARY ***
Total pot $11.50 | Rake $0 
Seat 1: matiko09 folded before Flop (didn't bet)
Seat 2: oscarleon folded before Flop (didn't bet)
Seat 3: maxxmeister (button) folded before Flop
Seat 4: xxxZeka (small blind) folded before Flop
Seat 6: ozone2003 (big blind) collected ($11.50)
Seat 7: Priidix folded before Flop (didn't bet)
Seat 8: AlSmithy88 folded before Flop
Seat 9: Mr.Grigoriy folded before Flop (didn't bet)





PokerStars Hand #154362928810:  Hold'em No Limit ($0.50/$1.00 USD) - 2016/06/06 12:36:22 CET [2016/06/06 6:36:22 ET]
Table 'Yarilo' 9-max Seat #2 is the button
Seat 1: xxxZeka ($100 in chips) 
Seat 2: nombraalne1 ($102 in chips) 
Seat 3: matiko09 ($109.42 in chips) 
Seat 5: Szevasztopol ($135.69 in chips) 
Seat 6: maxxmeister ($111 in chips) 
Seat 7: KEBIN1974 ($100 in chips) 
Seat 8: Mr.Grigoriy ($172.53 in chips) 
matiko09: posts small blind $0.50
riggedsh**: is sitting out 
Szevasztopol: posts big blind $1
o.miro: sits out 
*** HOLE CARDS ***
Dealt to matiko09 [Jh 2s]
maxxmeister: folds 
KEBIN1974: raises $1.50 to $2.50
Mr.Grigoriy: folds 
xxxZeka: folds 
nombraalne1: folds 
matiko09: folds 
Szevasztopol: calls $1.50
*** FLOP *** [Th Ks Qs]
Szevasztopol: checks 
KEBIN1974: checks 
*** TURN *** [Th Ks Qs] [Jc]
Szevasztopol: checks 
KEBIN1974: bets $4.01
Szevasztopol: calls $4.01
*** RIVER *** [Th Ks Qs Jc] [7d]
Szevasztopol: checks 
KEBIN1974: bets $18
Szevasztopol: calls $18
*** SHOW DOWN ***
KEBIN1974: shows [4d Ac] (a straight, Ten to Ace)
Szevasztopol: shows [As 7s] (a straight, Ten to Ace)
Szevasztopol collected $23.52 from pot
KEBIN1974 collected $23.52 from pot
*** SUMMARY ***
Total pot $49.52 | Rake $2.48 
Board [Th Ks Qs Jc 7d]
Seat 1: xxxZeka folded before Flop (didn't bet)
Seat 2: nombraalne1 (button) folded before Flop (didn't bet)
Seat 3: matiko09 (small blind) folded before Flop
Seat 5: Szevasztopol (big blind) showed [As 7s] and won ($23.52) with a straight, Ten to Ace
Seat 6: maxxmeister folded before Flop (didn't bet)
Seat 7: KEBIN1974 showed [4d Ac] and won ($23.52) with a straight, Ten to Ace
Seat 8: Mr.Grigoriy folded before Flop (didn't bet)





PokerStars Hand #154362930096:  Hold'em No Limit ($0.50/$1.00 USD) - 2016/06/06 12:36:25 CET [2016/06/06 6:36:25 ET]
Table 'Williams' 9-max Seat #3 is the button
Seat 1: matiko09 ($191.29 in chips) 
Seat 2: PacPacBum ($104.50 in chips) 
Seat 3: granbunny ($52.60 in chips) 
Seat 4: Mr.Grigoriy ($100.50 in chips) 
Seat 7: kevinho109 ($59.73 in chips) 
Seat 8: oscarleon ($108.86 in chips) 
Seat 9: kind ten ($38.05 in chips) 
Mr.Grigoriy: posts small blind $0.50
Priidix: is sitting out 
kevinho109: posts big blind $1
*** HOLE CARDS ***
Dealt to matiko09 [Qd 2s]
oscarleon: raises $2 to $3
kind ten: folds 
matiko09: folds 
PacPacBum: folds 
granbunny: folds 
Mr.Grigoriy: folds 
kevinho109: folds 
Uncalled bet ($2) returned to oscarleon
oscarleon collected $2.50 from pot
oscarleon: doesn't show hand 
*** SUMMARY ***
Total pot $2.50 | Rake $0 
Seat 1: matiko09 folded before Flop (didn't bet)
Seat 2: PacPacBum folded before Flop (didn't bet)
Seat 3: granbunny (button) folded before Flop (didn't bet)
Seat 4: Mr.Grigoriy (small blind) folded before Flop
Seat 7: kevinho109 (big blind) folded before Flop
Seat 8: oscarleon collected ($2.50)
Seat 9: kind ten folded before Flop (didn't bet)





PokerStars Hand #154362930974:  Hold'em No Limit ($0.50/$1.00 USD) - 2016/06/06 12:36:27 CET [2016/06/06 6:36:27 ET]
Table 'Smither' 9-max Seat #7 is the button
Seat 1: PacPacBum ($109.40 in chips) 
Seat 2: matiko09 ($106.35 in chips) 
Seat 3: xxxZeka ($116.71 in chips) 
Seat 4: maxxmeister ($213.16 in chips) 
Seat 5: Szevasztopol ($100 in chips) 
Seat 6: riggedsh** ($108.78 in chips) 
Seat 7: 007Bond001 ($35.52 in chips) 
Seat 8: 74 ROADIE ($96.50 in chips) 
Seat 9: hammerwife ($199.69 in chips) 
74 ROADIE: posts small blind $0.50
hammerwife: posts big blind $1
*** HOLE CARDS ***
Dealt to matiko09 [4h Ts]
PacPacBum: folds 
matiko09: folds 
xxxZeka: raises $2 to $3
maxxmeister: folds 
Szevasztopol: folds 
riggedsh** has timed out
riggedsh**: folds 
007Bond001: calls $3
74 ROADIE: folds 
hammerwife: folds 
*** FLOP *** [7c 7d Qc]
xxxZeka: bets $3.56
007Bond001: folds 
Uncalled bet ($3.56) returned to xxxZeka
xxxZeka collected $7.12 from pot
*** SUMMARY ***
Total pot $7.50 | Rake $0.38 
Board [7c 7d Qc]
Seat 1: PacPacBum folded before Flop (didn't bet)
Seat 2: matiko09 folded before Flop (didn't bet)
Seat 3: xxxZeka collected ($7.12)
Seat 4: maxxmeister folded before Flop (didn't bet)
Seat 5: Szevasztopol folded before Flop (didn't bet)
Seat 6: riggedsh** folded before Flop (didn't bet)
Seat 7: 007Bond001 (button) folded on the Flop
Seat 8: 74 ROADIE (small blind) folded before Flop
Seat 9: hammerwife (big blind) folded before Flop





PokerStars Hand #154362933389:  Hold'em No Limit ($0.50/$1.00 USD) - 2016/06/06 12:36:33 CET [2016/06/06 6:36:33 ET]
Table 'Safara' 9-max Seat #1 is the button
Seat 1: oscarleon ($232.94 in chips) 
Seat 2: Szevasztopol ($100 in chips) 
Seat 3: ozone2003 ($103 in chips) 
Seat 4: mattyt212 ($199 in chips) 
Seat 5: Dantist1122 ($107.53 in chips) 
Seat 6: matiko09 ($105.60 in chips) 
Seat 7: PacPacBum ($100 in chips) 
Seat 8: Priidix ($106.52 in chips) 
Seat 9: Mr.Grigoriy ($102.67 in chips) 
Szevasztopol: posts small blind $0.50
ozone2003: posts big blind $1
*** HOLE CARDS ***
Dealt to matiko09 [7h 7s]
mattyt212: calls $1
Dantist1122: raises $4 to $5
matiko09: calls $5
PacPacBum: folds 
Priidix: folds 
Mr.Grigoriy: folds 
oscarleon: folds 
Szevasztopol: folds 
ozone2003: calls $4
mattyt212: calls $4
*** FLOP *** [Qh 9h 6s]
ozone2003: checks 
mattyt212: checks 
Dantist1122: checks 
matiko09: checks 
*** TURN *** [Qh 9h 6s] [4d]
ozone2003: checks 
mattyt212: checks 
Dantist1122: checks 
matiko09: checks 
*** RIVER *** [Qh 9h 6s 4d] [7c]
ozone2003: checks 
mattyt212: checks 
Dantist1122: checks 
matiko09: bets $10.12
ozone2003: folds 
mattyt212: folds 
Dantist1122: folds 
Uncalled bet ($10.12) returned to matiko09
matiko09 collected $19.48 from pot
matiko09: doesn't show hand 
*** SUMMARY ***
Total pot $20.50 | Rake $1.02 
Board [Qh 9h 6s 4d 7c]
Seat 1: oscarleon (button) folded before Flop (didn't bet)
Seat 2: Szevasztopol (small blind) folded before Flop
Seat 3: ozone2003 (big blind) folded on the River
Seat 4: mattyt212 folded on the River
Seat 5: Dantist1122 folded on the River
Seat 6: matiko09 collected ($19.48)
Seat 7: PacPacBum folded before Flop (didn't bet)
Seat 8: Priidix folded before Flop (didn't bet)
Seat 9: Mr.Grigoriy folded before Flop (didn't bet)





PokerStars Hand #154362939441:  Hold'em No Limit ($0.50/$1.00 USD) - 2016/06/06 12:36:49 CET [2016/06/06 6:36:49 ET]
Table 'Heze' 9-max Seat #4 is the button
Seat 1: matiko09 ($218.15 in chips) 
Seat 2: oscarleon ($241.81 in chips) 
Seat 3: maxxmeister ($114.51 in chips) 
Seat 4: xxxZeka ($100 in chips) 
Seat 6: ozone2003 ($112.57 in chips) 
Seat 8: AlSmithy88 ($42.84 in chips) 
Seat 9: Mr.Grigoriy ($125.70 in chips) 
ozone2003: posts small blind $0.50
Priidix: is sitting out 
AlSmithy88: posts big blind $1
*** HOLE CARDS ***
Dealt to matiko09 [6c 9h]
Mr.Grigoriy: folds 
matiko09: folds 
oscarleon: folds 
maxxmeister: folds 
xxxZeka: raises $1.50 to $2.50
ozone2003: folds 
AlSmithy88: calls $1.50
*** FLOP *** [3h Kc 9s]
AlSmithy88: checks 
xxxZeka: checks 
*** TURN *** [3h Kc 9s] [2c]
stds st joins the table at seat #5 
AlSmithy88: checks 
xxxZeka: checks 
*** RIVER *** [3h Kc 9s 2c] [4h]
AlSmithy88: bets $5
xxxZeka: calls $5
*** SHOW DOWN ***
AlSmithy88: shows [2h 2s] (three of a kind, Deuces)
xxxZeka: mucks hand 
AlSmithy88 collected $14.72 from pot
*** SUMMARY ***
Total pot $15.50 | Rake $0.78 
Board [3h Kc 9s 2c 4h]
Seat 1: matiko09 folded before Flop (didn't bet)
Seat 2: oscarleon folded before Flop (didn't bet)
Seat 3: maxxmeister folded before Flop (didn't bet)
Seat 4: xxxZeka (button) mucked [Th 9d]
Seat 6: ozone2003 (small blind) folded before Flop
Seat 8: AlSmithy88 (big blind) showed [2h 2s] and won ($14.72) with three of a kind, Deuces
Seat 9: Mr.Grigoriy folded before Flop (didn't bet)





PokerStars Hand #154362941014:  Hold'em No Limit ($0.50/$1.00 USD) - 2016/06/06 12:36:53 CET [2016/06/06 6:36:53 ET]
Table 'Williams' 9-max Seat #4 is the button
Seat 1: matiko09 ($191.29 in chips) 
Seat 2: PacPacBum ($104.50 in chips) 
Seat 3: granbunny ($52.60 in chips) 
Seat 4: Mr.Grigoriy ($100 in chips) 
Seat 7: kevinho109 ($58.73 in chips) 
Seat 8: oscarleon ($110.36 in chips) 
Seat 9: kind ten ($38.05 in chips) 
kevinho109: posts small blind $0.50
oscarleon: posts big blind $1
*** HOLE CARDS ***
Dealt to matiko09 [7s Qc]
kind ten: folds 
matiko09: folds 
PacPacBum: folds 
granbunny: raises $2 to $3
xxxibgdrgn joins the table at seat #5 
Mr.Grigoriy: folds 
kevinho109: calls $2.50
oscarleon: folds 
*** FLOP *** [Ks 3s 4d]
kevinho109: checks 
granbunny: checks 
*** TURN *** [Ks 3s 4d] [Kc]
kevinho109: checks 
granbunny: checks 
*** RIVER *** [Ks 3s 4d Kc] [Qs]
kevinho109: bets $3
granbunny: calls $3
*** SHOW DOWN ***
kevinho109: shows [Qd Ad] (two pair, Kings and Queens)
granbunny: mucks hand 
kevinho109 collected $12.35 from pot
*** SUMMARY ***
Total pot $13 | Rake $0.65 
Board [Ks 3s 4d Kc Qs]
Seat 1: matiko09 folded before Flop (didn't bet)
Seat 2: PacPacBum folded before Flop (didn't bet)
Seat 3: granbunny mucked [Th Ts]
Seat 4: Mr.Grigoriy (button) folded before Flop (didn't bet)
Seat 7: kevinho109 (small blind) showed [Qd Ad] and won ($12.35) with two pair, Kings and Queens
Seat 8: oscarleon (big blind) folded before Flop
Seat 9: kind ten folded before Flop (didn't bet)





PokerStars Hand #154362941396:  Hold'em No Limit ($0.50/$1.00 USD) - 2016/06/06 12:36:54 CET [2016/06/06 6:36:54 ET]
Table 'Irmgard II' 9-max Seat #2 is the button
Seat 1: matiko09 ($146.50 in chips) 
Seat 2: hammerwife ($124.30 in chips) 
Seat 3: stds st ($44.98 in chips) 
Seat 4: oscarleon ($159.26 in chips) 
Seat 6: maxxmeister ($266.20 in chips) 
Seat 7: 32rrew ($102.68 in chips) 
Seat 8: Szevasztopol ($100 in chips) 
Seat 9: DONFILIPPO1 ($45.01 in chips) 
stds st: posts small blind $0.50
oscarleon: posts big blind $1
Mr.Grigoriy: sits out 
*** HOLE CARDS ***
Dealt to matiko09 [4h 7h]
maxxmeister: folds 
32rrew: folds 
Szevasztopol: folds 
DONFILIPPO1: calls $1
matiko09: folds 
hammerwife: raises $3 to $4
stds st: folds 
oscarleon: folds 
DONFILIPPO1: calls $3
*** FLOP *** [9c 3s 7s]
DONFILIPPO1: checks 
hammerwife: bets $5
DONFILIPPO1: calls $5
*** TURN *** [9c 3s 7s] [Ah]
DONFILIPPO1: checks 
hammerwife: checks 
*** RIVER *** [9c 3s 7s Ah] [8c]
DONFILIPPO1: checks 
hammerwife: bets $13
DONFILIPPO1: folds 
Uncalled bet ($13) returned to hammerwife
hammerwife collected $18.52 from pot
hammerwife: doesn't show hand 
*** SUMMARY ***
Total pot $19.50 | Rake $0.98 
Board [9c 3s 7s Ah 8c]
Seat 1: matiko09 folded before Flop (didn't bet)
Seat 2: hammerwife (button) collected ($18.52)
Seat 3: stds st (small blind) folded before Flop
Seat 4: oscarleon (big blind) folded before Flop
Seat 6: maxxmeister folded before Flop (didn't bet)
Seat 7: 32rrew folded before Flop (didn't bet)
Seat 8: Szevasztopol folded before Flop (didn't bet)
Seat 9: DONFILIPPO1 folded on the River





PokerStars Hand #154362942611:  Hold'em No Limit ($0.50/$1.00 USD) - 2016/06/06 12:36:57 CET [2016/06/06 6:36:57 ET]
Table 'Chaldaea II' 9-max Seat #9 is the button
Seat 1: xxxZeka ($100 in chips) 
Seat 2: masaytoo ($100 in chips) 
Seat 3: ardo888 ($105.58 in chips) 
Seat 4: ozone2003 ($120.21 in chips) 
Seat 5: MiiiTCHy__ ($61.38 in chips) 
Seat 6: PacPacBum ($100 in chips) 
Seat 7: riggedsh** ($146.88 in chips) 
Seat 8: o.miro ($111 in chips) 
Seat 9: matiko09 ($106 in chips) 
xxxZeka: posts small blind $0.50
masaytoo: posts big blind $1
*** HOLE CARDS ***
Dealt to matiko09 [9s Th]
ardo888: folds 
ozone2003: folds 
MiiiTCHy__: calls $1
PacPacBum: folds 
riggedsh**: calls $1
o.miro: folds 
matiko09: folds 
xxxZeka: raises $4 to $5
masaytoo: folds 
MiiiTCHy__: calls $4
riggedsh**: calls $4
*** FLOP *** [4s 5s 4c]
xxxZeka: bets $10.13
MiiiTCHy__: folds 
riggedsh**: folds 
Uncalled bet ($10.13) returned to xxxZeka
xxxZeka collected $15.20 from pot
*** SUMMARY ***
Total pot $16 | Rake $0.80 
Board [4s 5s 4c]
Seat 1: xxxZeka (small blind) collected ($15.20)
Seat 2: masaytoo (big blind) folded before Flop
Seat 3: ardo888 folded before Flop (didn't bet)
Seat 4: ozone2003 folded before Flop (didn't bet)
Seat 5: MiiiTCHy__ folded on the Flop
Seat 6: PacPacBum folded before Flop (didn't bet)
Seat 7: riggedsh** folded on the Flop
Seat 8: o.miro folded before Flop (didn't bet)
Seat 9: matiko09 (button) folded before Flop (didn't bet)





PokerStars Hand #154362949960:  Hold'em No Limit ($0.50/$1.00 USD) - 2016/06/06 12:37:15 CET [2016/06/06 6:37:15 ET]
Table 'Gajdariya' 9-max Seat #6 is the button
Seat 1: matiko09 ($117.23 in chips) 
Seat 2: xxxZeka ($126.74 in chips) 
Seat 3: oscarleon ($113.55 in chips) 
Seat 4: Szevasztopol ($106.63 in chips) 
Seat 5: 147734319 ($99.51 in chips) 
Seat 6: mono123viva ($111.91 in chips) 
Seat 7: Wombatkilla ($117.42 in chips) 
Seat 8: ardo888 ($101.50 in chips) 
Seat 9: Mr.Grigoriy ($104.56 in chips) 
Wombatkilla: posts small blind $0.50
ardo888: posts big blind $1
*** HOLE CARDS ***
Dealt to matiko09 [4c Qd]
Mr.Grigoriy: folds 
matiko09: folds 
xxxZeka: folds 
oscarleon: folds 
Szevasztopol: folds 
147734319: folds 
mono123viva: raises $2 to $3
Wombatkilla: raises $6 to $9
ardo888: folds 
mono123viva: calls $6
*** FLOP *** [Tc 9s 8h]
Wombatkilla: bets $9
mono123viva: calls $9
*** TURN *** [Tc 9s 8h] [9d]
Wombatkilla: checks 
mono123viva: checks 
*** RIVER *** [Tc 9s 8h 9d] [7h]
Wombatkilla: checks 
mono123viva: checks 
*** SHOW DOWN ***
Wombatkilla: shows [Kh Ad] (a pair of Nines)
mono123viva: shows [Th Qs] (two pair, Tens and Nines)
mono123viva collected $35.15 from pot
*** SUMMARY ***
Total pot $37 | Rake $1.85 
Board [Tc 9s 8h 9d 7h]
Seat 1: matiko09 folded before Flop (didn't bet)
Seat 2: xxxZeka folded before Flop (didn't bet)
Seat 3: oscarleon folded before Flop (didn't bet)
Seat 4: Szevasztopol folded before Flop (didn't bet)
Seat 5: 147734319 folded before Flop (didn't bet)
Seat 6: mono123viva (button) showed [Th Qs] and won ($35.15) with two pair, Tens and Nines
Seat 7: Wombatkilla (small blind) showed [Kh Ad] and lost with a pair of Nines
Seat 8: ardo888 (big blind) folded before Flop
Seat 9: Mr.Grigoriy folded before Flop (didn't bet)





PokerStars Hand #154362955216:  Hold'em No Limit ($0.50/$1.00 USD) - 2016/06/06 12:37:28 CET [2016/06/06 6:37:28 ET]
Table 'Smither' 9-max Seat #8 is the button
Seat 1: PacPacBum ($109.40 in chips) 
Seat 2: matiko09 ($106.35 in chips) 
Seat 3: xxxZeka ($120.83 in chips) 
Seat 4: maxxmeister ($213.16 in chips) 
Seat 5: Szevasztopol ($100 in chips) 
Seat 7: 007Bond001 ($32.52 in chips) 
Seat 8: 74 ROADIE ($96 in chips) 
Seat 9: hammerwife ($198.69 in chips) 
hammerwife: posts small blind $0.50
PacPacBum: posts big blind $1
*** HOLE CARDS ***
Dealt to matiko09 [Qh 5h]
matiko09: folds 
xxxZeka: folds 
maxxmeister: folds 
Szevasztopol: folds 
007Bond001: folds 
007Bond001 leaves the table
74 ROADIE: raises $2 to $3
hammerwife: folds 
PacPacBum: folds 
Uncalled bet ($2) returned to 74 ROADIE
74 ROADIE collected $2.50 from pot
Mr.Grigoriy joins the table at seat #7 
*** SUMMARY ***
Total pot $2.50 | Rake $0 
Seat 1: PacPacBum (big blind) folded before Flop
Seat 2: matiko09 folded before Flop (didn't bet)
Seat 3: xxxZeka folded before Flop (didn't bet)
Seat 4: maxxmeister folded before Flop (didn't bet)
Seat 5: Szevasztopol folded before Flop (didn't bet)
Seat 7: 007Bond001 folded before Flop (didn't bet)
Seat 8: 74 ROADIE (button) collected ($2.50)
Seat 9: hammerwife (small blind) folded before Flop





PokerStars Hand #154362957801:  Hold'em No Limit ($0.50/$1.00 USD) - 2016/06/06 12:37:34 CET [2016/06/06 6:37:34 ET]
Table 'Wezen II' 9-max Seat #8 is the button
Seat 1: matiko09 ($161.47 in chips) 
Seat 2: Mr.Grigoriy ($108.18 in chips) 
Seat 3: oscarleon ($100.18 in chips) 
Seat 4: xxxibgdrgn ($100 in chips) 
Seat 5: stds st ($41.70 in chips) 
Seat 7: KDJAll3 ($87.31 in chips) 
Seat 8: mavin80 ($161.70 in chips) 
PacPacBum will be allowed to play after the button
matiko09: posts small blind $0.50
Mr.Grigoriy: posts big blind $1
masaytoo: sits out 
*** HOLE CARDS ***
Dealt to matiko09 [Ks 8d]
oscarleon: folds 
xxxibgdrgn: folds 
stds st: folds 
KDJAll3: folds 
mavin80: folds 
matiko09: raises $2 to $3
Mr.Grigoriy: folds 
Uncalled bet ($2) returned to matiko09
matiko09 collected $2 from pot
matiko09: doesn't show hand 
*** SUMMARY ***
Total pot $2 | Rake $0 
Seat 1: matiko09 (small blind) collected ($2)
Seat 2: Mr.Grigoriy (big blind) folded before Flop
Seat 3: oscarleon folded before Flop (didn't bet)
Seat 4: xxxibgdrgn folded before Flop (didn't bet)
Seat 5: stds st folded before Flop (didn't bet)
Seat 7: KDJAll3 folded before Flop (didn't bet)
Seat 8: mavin80 (button) folded before Flop (didn't bet)





PokerStars Hand #154362958401:  Hold'em No Limit ($0.50/$1.00 USD) - 2016/06/06 12:37:36 CET [2016/06/06 6:37:36 ET]
Table 'Heze' 9-max Seat #6 is the button
Seat 1: matiko09 ($218.15 in chips) 
Seat 2: oscarleon ($241.81 in chips) 
Seat 3: maxxmeister ($114.51 in chips) 
Seat 4: xxxZeka ($100 in chips) 
Seat 6: ozone2003 ($112.07 in chips) 
Seat 8: AlSmithy88 ($50.06 in chips) 
Seat 9: Mr.Grigoriy ($125.70 in chips) 
AlSmithy88: posts small blind $0.50
Mr.Grigoriy: posts big blind $1
stds st: sits out 
*** HOLE CARDS ***
Dealt to matiko09 [3d 7d]
matiko09: folds 
oscarleon: folds 
maxxmeister: folds 
xxxZeka: raises $2 to $3
ozone2003: folds 
AlSmithy88: folds 
Mr.Grigoriy: folds 
Uncalled bet ($2) returned to xxxZeka
xxxZeka collected $2.50 from pot
*** SUMMARY ***
Total pot $2.50 | Rake $0 
Seat 1: matiko09 folded before Flop (didn't bet)
Seat 2: oscarleon folded before Flop (didn't bet)
Seat 3: maxxmeister folded before Flop (didn't bet)
Seat 4: xxxZeka collected ($2.50)
Seat 6: ozone2003 (button) folded before Flop (didn't bet)
Seat 8: AlSmithy88 (small blind) folded before Flop
Seat 9: Mr.Grigoriy (big blind) folded before Flop





PokerStars Hand #154362962996:  Hold'em No Limit ($0.50/$1.00 USD) - 2016/06/06 12:37:47 CET [2016/06/06 6:37:47 ET]
Table 'Smither' 9-max Seat #9 is the button
Seat 1: PacPacBum ($108.40 in chips) 
Seat 2: matiko09 ($106.35 in chips) 
Seat 3: xxxZeka ($120.83 in chips) 
Seat 4: maxxmeister ($213.16 in chips) 
Seat 5: Szevasztopol ($100 in chips) 
Seat 6: riggedsh** ($108.78 in chips) 
Seat 8: 74 ROADIE ($97.50 in chips) 
Seat 9: hammerwife ($198.19 in chips) 
PacPacBum: posts small blind $0.50
matiko09: posts big blind $1
Mr.Grigoriy: sits out 
*** HOLE CARDS ***
Dealt to matiko09 [Qc 8h]
xxxZeka: folds 
maxxmeister: folds 
Szevasztopol: folds 
riggedsh**: folds 
74 ROADIE: folds 
hammerwife: raises $1.01 to $2.01
PacPacBum: folds 
matiko09: calls $1.01
*** FLOP *** [5h 3h 4d]
matiko09: checks 
hammerwife: bets $1.71
matiko09: folds 
Uncalled bet ($1.71) returned to hammerwife
hammerwife collected $4.29 from pot
hammerwife: doesn't show hand 
*** SUMMARY ***
Total pot $4.52 | Rake $0.23 
Board [5h 3h 4d]
Seat 1: PacPacBum (small blind) folded before Flop
Seat 2: matiko09 (big blind) folded on the Flop
Seat 3: xxxZeka folded before Flop (didn't bet)
Seat 4: maxxmeister folded before Flop (didn't bet)
Seat 5: Szevasztopol folded before Flop (didn't bet)
Seat 6: riggedsh** folded before Flop (didn't bet)
Seat 8: 74 ROADIE folded before Flop (didn't bet)
Seat 9: hammerwife (button) collected ($4.29)





PokerStars Hand #154362966183:  Hold'em No Limit ($0.50/$1.00 USD) - 2016/06/06 12:37:55 CET [2016/06/06 6:37:55 ET]
Table 'Williams' 9-max Seat #7 is the button
Seat 1: matiko09 ($191.29 in chips) 
Seat 2: PacPacBum ($104.50 in chips) 
Seat 3: granbunny ($46.60 in chips) 
Seat 4: Mr.Grigoriy ($100 in chips) 
Seat 7: kevinho109 ($65.08 in chips) 
Seat 8: oscarleon ($109.36 in chips) 
Seat 9: kind ten ($38.05 in chips) 
oscarleon: posts small blind $0.50
kind ten: posts big blind $1
xxxibgdrgn: sits out 
*** HOLE CARDS ***
Dealt to matiko09 [4s Ts]
matiko09: folds 
PacPacBum: folds 
granbunny: raises $2 to $3
Mr.Grigoriy: raises $5 to $8
kevinho109: folds 
oscarleon: folds 
kind ten: folds 
granbunny: calls $5
*** FLOP *** [3d 9s 2c]
granbunny: checks 
Mr.Grigoriy: bets $8.97
granbunny: raises $29.63 to $38.60 and is all-in
Mr.Grigoriy: folds 
Uncalled bet ($29.63) returned to granbunny
granbunny collected $33.67 from pot
granbunny: doesn't show hand 
*** SUMMARY ***
Total pot $35.44 | Rake $1.77 
Board [3d 9s 2c]
Seat 1: matiko09 folded before Flop (didn't bet)
Seat 2: PacPacBum folded before Flop (didn't bet)
Seat 3: granbunny collected ($33.67)
Seat 4: Mr.Grigoriy folded on the Flop
Seat 7: kevinho109 (button) folded before Flop (didn't bet)
Seat 8: oscarleon (small blind) folded before Flop
Seat 9: kind ten (big blind) folded before Flop





PokerStars Hand #154362972913:  Hold'em No Limit ($0.50/$1.00 USD) - 2016/06/06 12:38:12 CET [2016/06/06 6:38:12 ET]
Table 'Heze' 9-max Seat #8 is the button
Seat 1: matiko09 ($218.15 in chips) 
Seat 2: oscarleon ($241.81 in chips) 
Seat 3: maxxmeister ($114.51 in chips) 
Seat 4: xxxZeka ($101.50 in chips) 
Seat 6: ozone2003 ($112.07 in chips) 
Seat 8: AlSmithy88 ($49.56 in chips) 
Seat 9: Mr.Grigoriy ($124.70 in chips) 
Mr.Grigoriy: posts small blind $0.50
matiko09: posts big blind $1
stds st: sits out 
*** HOLE CARDS ***
Dealt to matiko09 [5h Ts]
oscarleon: folds 
maxxmeister: folds 
xxxZeka: folds 
ozone2003: folds 
AlSmithy88: folds 
Mr.Grigoriy: folds 
Uncalled bet ($0.50) returned to matiko09
matiko09 collected $1 from pot
matiko09: doesn't show hand 
*** SUMMARY ***
Total pot $1 | Rake $0 
Seat 1: matiko09 (big blind) collected ($1)
Seat 2: oscarleon folded before Flop (didn't bet)
Seat 3: maxxmeister folded before Flop (didn't bet)
Seat 4: xxxZeka folded before Flop (didn't bet)
Seat 6: ozone2003 folded before Flop (didn't bet)
Seat 8: AlSmithy88 (button) folded before Flop (didn't bet)
Seat 9: Mr.Grigoriy (small blind) folded before Flop





PokerStars Hand #154362972978:  Hold'em No Limit ($0.50/$1.00 USD) - 2016/06/06 12:38:13 CET [2016/06/06 6:38:13 ET]
Table 'Wezen II' 9-max Seat #1 is the button
Seat 1: matiko09 ($162.47 in chips) 
Seat 2: Mr.Grigoriy ($107.18 in chips) 
Seat 3: oscarleon ($100.18 in chips) 
Seat 4: xxxibgdrgn ($100 in chips) 
Seat 5: stds st ($41.70 in chips) 
Seat 7: KDJAll3 ($87.31 in chips) 
Seat 8: mavin80 ($161.70 in chips) 
Mr.Grigoriy: posts small blind $0.50
oscarleon: posts big blind $1
masaytoo: sits out 
PacPacBum: sits out 
*** HOLE CARDS ***
Dealt to matiko09 [3h 4h]
xxxibgdrgn: folds 
stds st: raises $1.50 to $2.50
KDJAll3: calls $2.50
mavin80: calls $2.50
matiko09: folds 
Mr.Grigoriy: folds 
oscarleon: folds 
*** FLOP *** [Jh 8c 3d]
stds st: checks 
KDJAll3: bets $3
mavin80: folds 
stds st: calls $3
*** TURN *** [Jh 8c 3d] [Qc]
stds st: checks 
KDJAll3: bets $6
stds st: folds 
Uncalled bet ($6) returned to KDJAll3
KDJAll3 collected $14.25 from pot
KDJAll3: doesn't show hand 
*** SUMMARY ***
Total pot $15 | Rake $0.75 
Board [Jh 8c 3d Qc]
Seat 1: matiko09 (button) folded before Flop (didn't bet)
Seat 2: Mr.Grigoriy (small blind) folded before Flop
Seat 3: oscarleon (big blind) folded before Flop
Seat 4: xxxibgdrgn folded before Flop (didn't bet)
Seat 5: stds st folded on the Turn
Seat 7: KDJAll3 collected ($14.25)
Seat 8: mavin80 folded on the Flop





PokerStars Hand #154362975989:  Hold'em No Limit ($0.50/$1.00 USD) - 2016/06/06 12:38:20 CET [2016/06/06 6:38:20 ET]
Table 'Irmgard II' 9-max Seat #3 is the button
Seat 1: matiko09 ($146.50 in chips) 
Seat 2: hammerwife ($133.82 in chips) 
Seat 3: stds st ($44.48 in chips) 
Seat 4: oscarleon ($158.26 in chips) 
Seat 5: Mr.Grigoriy ($146.26 in chips) 
Seat 6: maxxmeister ($266.20 in chips) 
Seat 7: 32rrew ($102.68 in chips) 
Seat 8: Szevasztopol ($100 in chips) 
Seat 9: DONFILIPPO1 ($36.01 in chips) 
oscarleon: posts small blind $0.50
Mr.Grigoriy: posts big blind $1
*** HOLE CARDS ***
Dealt to matiko09 [Qh 4d]
maxxmeister: folds 
32rrew: folds 
Szevasztopol: folds 
DONFILIPPO1: folds 
matiko09: folds 
hammerwife: raises $1.50 to $2.50
stds st: folds 
oscarleon: folds 
Mr.Grigoriy: folds 
Uncalled bet ($1.50) returned to hammerwife
hammerwife collected $2.50 from pot
hammerwife: doesn't show hand 
*** SUMMARY ***
Total pot $2.50 | Rake $0 
Seat 1: matiko09 folded before Flop (didn't bet)
Seat 2: hammerwife collected ($2.50)
Seat 3: stds st (button) folded before Flop (didn't bet)
Seat 4: oscarleon (small blind) folded before Flop
Seat 5: Mr.Grigoriy (big blind) folded before Flop
Seat 6: maxxmeister folded before Flop (didn't bet)
Seat 7: 32rrew folded before Flop (didn't bet)
Seat 8: Szevasztopol folded before Flop (didn't bet)
Seat 9: DONFILIPPO1 folded before Flop (didn't bet)





PokerStars Hand #154362976286:  Hold'em No Limit ($0.50/$1.00 USD) - 2016/06/06 12:38:21 CET [2016/06/06 6:38:21 ET]
Table 'Gajdariya' 9-max Seat #7 is the button
Seat 1: matiko09 ($117.23 in chips) 
Seat 2: xxxZeka ($126.74 in chips) 
Seat 3: oscarleon ($113.55 in chips) 
Seat 4: Szevasztopol ($106.63 in chips) 
Seat 5: 147734319 ($99.51 in chips) 
Seat 6: mono123viva ($129.06 in chips) 
Seat 7: Wombatkilla ($99.42 in chips) 
Seat 8: ardo888 ($100.50 in chips) 
Seat 9: Mr.Grigoriy ($104.56 in chips) 
ardo888: posts small blind $0.50
Mr.Grigoriy: posts big blind $1
*** HOLE CARDS ***
Dealt to matiko09 [8d 9h]
matiko09: folds 
xxxZeka: folds 
oscarleon: folds 
Szevasztopol: folds 
147734319: folds 
mono123viva: raises $2 to $3
Wombatkilla: folds 
ardo888: raises $7 to $10
Mr.Grigoriy: raises $10 to $20
mono123viva: calls $17
ardo888: calls $10
*** FLOP *** [4c 2c 8c]
ardo888: checks 
Mr.Grigoriy: checks 
mono123viva: checks 
*** TURN *** [4c 2c 8c] [5c]
ardo888: checks 
Mr.Grigoriy: checks 
mono123viva: bets $25
ardo888: folds 
Mr.Grigoriy: folds 
Uncalled bet ($25) returned to mono123viva
mono123viva collected $57.50 from pot
*** SUMMARY ***
Total pot $60 | Rake $2.50 
Board [4c 2c 8c 5c]
Seat 1: matiko09 folded before Flop (didn't bet)
Seat 2: xxxZeka folded before Flop (didn't bet)
Seat 3: oscarleon folded before Flop (didn't bet)
Seat 4: Szevasztopol folded before Flop (didn't bet)
Seat 5: 147734319 folded before Flop (didn't bet)
Seat 6: mono123viva collected ($57.50)
Seat 7: Wombatkilla (button) folded before Flop (didn't bet)
Seat 8: ardo888 (small blind) folded on the Turn
Seat 9: Mr.Grigoriy (big blind) folded on the Turn





PokerStars Hand #154362976878:  Hold'em No Limit ($0.50/$1.00 USD) - 2016/06/06 12:38:22 CET [2016/06/06 6:38:22 ET]
Table 'Yarilo' 9-max Seat #3 is the button
Seat 1: xxxZeka ($100 in chips) 
Seat 2: nombraalne1 ($102 in chips) 
Seat 3: matiko09 ($108.92 in chips) 
Seat 5: Szevasztopol ($134.70 in chips) 
Seat 7: KEBIN1974 ($100 in chips) 
Seat 8: Mr.Grigoriy ($172.53 in chips) 
Szevasztopol: posts small blind $0.50
maxxmeister: is sitting out 
KEBIN1974: posts big blind $1
o.miro: sits out 
*** HOLE CARDS ***
Dealt to matiko09 [Kh Qd]
Mr.Grigoriy: folds 
xxxZeka: folds 
nombraalne1: folds 
maxxmeister leaves the table
matiko09: raises $1.27 to $2.27
ozone2003 joins the table at seat #6 
Szevasztopol: folds 
KEBIN1974: raises $1.73 to $4
matiko09: calls $1.73
*** FLOP *** [8c 3h Qc]
KEBIN1974: bets $4.68
matiko09: calls $4.68
*** TURN *** [8c 3h Qc] [6h]
KEBIN1974: bets $9.84
matiko09: calls $9.84
*** RIVER *** [8c 3h Qc 6h] [7h]
KEBIN1974: bets $12.12
matiko09: calls $12.12
*** SHOW DOWN ***
KEBIN1974: shows [9s 8h] (a pair of Eights)
matiko09: shows [Kh Qd] (a pair of Queens)
matiko09 collected $59.28 from pot
*** SUMMARY ***
Total pot $61.78 | Rake $2.50 
Board [8c 3h Qc 6h 7h]
Seat 1: xxxZeka folded before Flop (didn't bet)
Seat 2: nombraalne1 folded before Flop (didn't bet)
Seat 3: matiko09 (button) showed [Kh Qd] and won ($59.28) with a pair of Queens
Seat 5: Szevasztopol (small blind) folded before Flop
Seat 7: KEBIN1974 (big blind) showed [9s 8h] and lost with a pair of Eights
Seat 8: Mr.Grigoriy folded before Flop (didn't bet)





PokerStars Hand #154362977015:  Hold'em No Limit ($0.50/$1.00 USD) - 2016/06/06 12:38:23 CET [2016/06/06 6:38:23 ET]
Table 'Sheliak' 9-max Seat #9 is the button
Seat 1: 32rrew ($100 in chips) 
Seat 2: masaytoo ($100 in chips) 
Seat 3: oscarleon ($100 in chips) 
Seat 4: Priidix ($100 in chips) 
Seat 5: vanilica ($100 in chips) 
Seat 6: matiko09 ($100 in chips) 
Seat 7: stds st ($40 in chips) 
Seat 8: djammusic ($40 in chips) 
Seat 9: nombraalne1 ($100 in chips) 
32rrew: posts small blind $0.50
masaytoo: posts big blind $1
*** HOLE CARDS ***
Dealt to matiko09 [3c 9d]
oscarleon: folds 
Priidix: folds 
Priidix leaves the table
vanilica: folds 
hurtNCYDE joins the table at seat #4 
hurtNCYDE leaves the table
matiko09: folds 
stds st: folds 
djammusic: folds 
nombraalne1: folds 
32rrew: raises $2 to $3
masaytoo: folds 
Uncalled bet ($2) returned to 32rrew
32rrew collected $2 from pot
32rrew: doesn't show hand 
*** SUMMARY ***
Total pot $2 | Rake $0 
Seat 1: 32rrew (small blind) collected ($2)
Seat 2: masaytoo (big blind) folded before Flop
Seat 3: oscarleon folded before Flop (didn't bet)
Seat 4: Priidix folded before Flop (didn't bet)
Seat 5: vanilica folded before Flop (didn't bet)
Seat 6: matiko09 folded before Flop (didn't bet)
Seat 7: stds st folded before Flop (didn't bet)
Seat 8: djammusic folded before Flop (didn't bet)
Seat 9: nombraalne1 (button) folded before Flop (didn't bet)





PokerStars Hand #154362978158:  Hold'em No Limit ($0.50/$1.00 USD) - 2016/06/06 12:38:25 CET [2016/06/06 6:38:25 ET]
Table 'Chaldaea II' 9-max Seat #1 is the button
Seat 1: xxxZeka ($110.20 in chips) 
Seat 2: masaytoo ($99 in chips) 
Seat 3: ardo888 ($105.58 in chips) 
Seat 4: ozone2003 ($120.21 in chips) 
Seat 5: MiiiTCHy__ ($56.38 in chips) 
Seat 6: PacPacBum ($100 in chips) 
Seat 7: riggedsh** ($141.88 in chips) 
Seat 8: o.miro ($111 in chips) 
Seat 9: matiko09 ($106 in chips) 
masaytoo: posts small blind $0.50
ardo888: posts big blind $1
*** HOLE CARDS ***
Dealt to matiko09 [7d 6h]
ozone2003: folds 
MiiiTCHy__: folds 
PacPacBum: folds 
riggedsh**: folds 
o.miro: folds 
matiko09: folds 
xxxZeka: folds 
masaytoo: raises $2 to $3
ardo888: calls $2
*** FLOP *** [Qc Ts Jc]
masaytoo: checks 
ardo888: bets $3.70
masaytoo: calls $3.70
*** TURN *** [Qc Ts Jc] [6s]
masaytoo: checks 
ardo888: bets $9.67
masaytoo: folds 
Uncalled bet ($9.67) returned to ardo888
ardo888 collected $12.73 from pot
ardo888: doesn't show hand 
*** SUMMARY ***
Total pot $13.40 | Rake $0.67 
Board [Qc Ts Jc 6s]
Seat 1: xxxZeka (button) folded before Flop (didn't bet)
Seat 2: masaytoo (small blind) folded on the Turn
Seat 3: ardo888 (big blind) collected ($12.73)
Seat 4: ozone2003 folded before Flop (didn't bet)
Seat 5: MiiiTCHy__ folded before Flop (didn't bet)
Seat 6: PacPacBum folded before Flop (didn't bet)
Seat 7: riggedsh** folded before Flop (didn't bet)
Seat 8: o.miro folded before Flop (didn't bet)
Seat 9: matiko09 folded before Flop (didn't bet)





PokerStars Hand #154362984727:  Hold'em No Limit ($0.50/$1.00 USD) - 2016/06/06 12:38:42 CET [2016/06/06 6:38:42 ET]
Table 'Heze' 9-max Seat #9 is the button
Seat 1: matiko09 ($218.65 in chips) 
Seat 2: oscarleon ($241.81 in chips) 
Seat 3: maxxmeister ($114.51 in chips) 
Seat 4: xxxZeka ($101.50 in chips) 
Seat 6: ozone2003 ($112.07 in chips) 
Seat 8: AlSmithy88 ($49.56 in chips) 
Seat 9: Mr.Grigoriy ($124.20 in chips) 
matiko09: posts small blind $0.50
oscarleon: posts big blind $1
stds st: sits out 
*** HOLE CARDS ***
Dealt to matiko09 [6d 2h]
maxxmeister: folds 
maxxmeister leaves the table
xxxZeka: folds 
ozone2003: folds 
AlSmithy88: folds 
Mr.Grigoriy: folds 
matiko09: folds 
Uncalled bet ($0.50) returned to oscarleon
oscarleon collected $1 from pot
oscarleon: doesn't show hand 
xxxibgdrgn joins the table at seat #3 
*** SUMMARY ***
Total pot $1 | Rake $0 
Seat 1: matiko09 (small blind) folded before Flop
Seat 2: oscarleon (big blind) collected ($1)
Seat 3: maxxmeister folded before Flop (didn't bet)
Seat 4: xxxZeka folded before Flop (didn't bet)
Seat 6: ozone2003 folded before Flop (didn't bet)
Seat 8: AlSmithy88 folded before Flop (didn't bet)
Seat 9: Mr.Grigoriy (button) folded before Flop (didn't bet)





PokerStars Hand #154362986139:  Hold'em No Limit ($0.50/$1.00 USD) - 2016/06/06 12:38:45 CET [2016/06/06 6:38:45 ET]
Table 'Smither' 9-max Seat #1 is the button
Seat 1: PacPacBum ($107.90 in chips) 
Seat 2: matiko09 ($104.34 in chips) 
Seat 3: xxxZeka ($120.83 in chips) 
Seat 4: maxxmeister ($213.16 in chips) 
Seat 5: Szevasztopol ($100 in chips) 
Seat 6: riggedsh** ($108.78 in chips) 
Seat 8: 74 ROADIE ($97.50 in chips) 
Seat 9: hammerwife ($200.47 in chips) 
matiko09: posts small blind $0.50
xxxZeka: posts big blind $1
*** HOLE CARDS ***
Dealt to matiko09 [3h Td]
maxxmeister: folds 
Szevasztopol: folds 
riggedsh**: folds 
74 ROADIE: folds 
hammerwife: folds 
PacPacBum: raises $1.50 to $2.50
matiko09: folds 
xxxZeka: folds 
Uncalled bet ($1.50) returned to PacPacBum
PacPacBum collected $2.50 from pot
PacPacBum: doesn't show hand 
*** SUMMARY ***
Total pot $2.50 | Rake $0 
Seat 1: PacPacBum (button) collected ($2.50)
Seat 2: matiko09 (small blind) folded before Flop
Seat 3: xxxZeka (big blind) folded before Flop
Seat 4: maxxmeister folded before Flop (didn't bet)
Seat 5: Szevasztopol folded before Flop (didn't bet)
Seat 6: riggedsh** folded before Flop (didn't bet)
Seat 8: 74 ROADIE folded before Flop (didn't bet)
Seat 9: hammerwife folded before Flop (didn't bet)





PokerStars Hand #154362986412:  Hold'em No Limit ($0.50/$1.00 USD) - 2016/06/06 12:38:46 CET [2016/06/06 6:38:46 ET]
Table 'Safara' 9-max Seat #2 is the button
Seat 1: oscarleon ($232.94 in chips) 
Seat 2: Szevasztopol ($100 in chips) 
Seat 3: ozone2003 ($100 in chips) 
Seat 5: Dantist1122 ($102.53 in chips) 
Seat 6: matiko09 ($120.08 in chips) 
Seat 7: PacPacBum ($100 in chips) 
Seat 8: Priidix ($106.52 in chips) 
Seat 9: Mr.Grigoriy ($102.67 in chips) 
ozone2003: posts small blind $0.50
mattyt212: is sitting out 
Dantist1122: posts big blind $1
*** HOLE CARDS ***
Dealt to matiko09 [8d Tc]
matiko09: folds 
mattyt212 leaves the table
PacPacBum: folds 
Priidix: folds 
Mr.Grigoriy: folds 
oscarleon: raises $2 to $3
Szevasztopol: folds 
ozone2003: folds 
Priidix leaves the table
Dantist1122: folds 
Uncalled bet ($2) returned to oscarleon
oscarleon collected $2.50 from pot
oscarleon: doesn't show hand 
*** SUMMARY ***
Total pot $2.50 | Rake $0 
Seat 1: oscarleon collected ($2.50)
Seat 2: Szevasztopol (button) folded before Flop (didn't bet)
Seat 3: ozone2003 (small blind) folded before Flop
Seat 5: Dantist1122 (big blind) folded before Flop
Seat 6: matiko09 folded before Flop (didn't bet)
Seat 7: PacPacBum folded before Flop (didn't bet)
Seat 8: Priidix folded before Flop (didn't bet)
Seat 9: Mr.Grigoriy folded before Flop (didn't bet)





PokerStars Hand #154362995802:  Hold'em No Limit ($0.50/$1.00 USD) - 2016/06/06 12:39:10 CET [2016/06/06 6:39:10 ET]
Table 'Smither' 9-max Seat #2 is the button
Seat 1: PacPacBum ($109.40 in chips) 
Seat 2: matiko09 ($103.84 in chips) 
Seat 3: xxxZeka ($119.83 in chips) 
Seat 4: maxxmeister ($213.16 in chips) 
Seat 5: Szevasztopol ($100 in chips) 
Seat 6: riggedsh** ($108.78 in chips) 
Seat 8: 74 ROADIE ($97.50 in chips) 
Seat 9: hammerwife ($200.47 in chips) 
xxxZeka: posts small blind $0.50
maxxmeister: posts big blind $1
*** HOLE CARDS ***
Dealt to matiko09 [6h As]
Szevasztopol: raises $1.24 to $2.24
riggedsh**: folds 
74 ROADIE: folds 
hammerwife: folds 
PacPacBum: folds 
matiko09: folds 
xxxZeka: folds 
maxxmeister: folds 
Uncalled bet ($1.24) returned to Szevasztopol
Szevasztopol collected $2.50 from pot
Szevasztopol: doesn't show hand 
*** SUMMARY ***
Total pot $2.50 | Rake $0 
Seat 1: PacPacBum folded before Flop (didn't bet)
Seat 2: matiko09 (button) folded before Flop (didn't bet)
Seat 3: xxxZeka (small blind) folded before Flop
Seat 4: maxxmeister (big blind) folded before Flop
Seat 5: Szevasztopol collected ($2.50)
Seat 6: riggedsh** folded before Flop (didn't bet)
Seat 8: 74 ROADIE folded before Flop (didn't bet)
Seat 9: hammerwife folded before Flop (didn't bet)





PokerStars Hand #154362997347:  Hold'em No Limit ($0.50/$1.00 USD) - 2016/06/06 12:39:14 CET [2016/06/06 6:39:14 ET]
Table 'Heze' 9-max Seat #1 is the button
Seat 1: matiko09 ($218.15 in chips) 
Seat 2: oscarleon ($242.31 in chips) 
Seat 3: xxxibgdrgn ($100 in chips) 
Seat 4: xxxZeka ($101.50 in chips) 
Seat 6: ozone2003 ($112.07 in chips) 
Seat 8: AlSmithy88 ($49.56 in chips) 
Seat 9: Mr.Grigoriy ($124.20 in chips) 
oscarleon: posts small blind $0.50
xxxibgdrgn: posts big blind $1
stds st: sits out 
*** HOLE CARDS ***
Dealt to matiko09 [8s Ac]
xxxZeka: folds 
ozone2003: folds 
AlSmithy88: folds 
Mr.Grigoriy: raises $1.50 to $2.50
matiko09: folds 
Priidix leaves the table
oscarleon: folds 
xxxibgdrgn: folds 
Uncalled bet ($1.50) returned to Mr.Grigoriy
Mr.Grigoriy collected $2.50 from pot
Mr.Grigoriy: doesn't show hand 
*** SUMMARY ***
Total pot $2.50 | Rake $0 
Seat 1: matiko09 (button) folded before Flop (didn't bet)
Seat 2: oscarleon (small blind) folded before Flop
Seat 3: xxxibgdrgn (big blind) folded before Flop
Seat 4: xxxZeka folded before Flop (didn't bet)
Seat 6: ozone2003 folded before Flop (didn't bet)
Seat 8: AlSmithy88 folded before Flop (didn't bet)
Seat 9: Mr.Grigoriy collected ($2.50)





PokerStars Hand #154362998196:  Hold'em No Limit ($0.50/$1.00 USD) - 2016/06/06 12:39:16 CET [2016/06/06 6:39:16 ET]
Table 'Williams' 9-max Seat #8 is the button
Seat 1: matiko09 ($191.29 in chips) 
Seat 2: PacPacBum ($104.50 in chips) 
Seat 3: granbunny ($63.30 in chips) 
Seat 4: Mr.Grigoriy ($100 in chips) 
Seat 7: kevinho109 ($65.08 in chips) 
Seat 8: oscarleon ($108.86 in chips) 
Seat 9: kind ten ($37.05 in chips) 
kind ten: posts small blind $0.50
matiko09: posts big blind $1
xxxibgdrgn: sits out 
*** HOLE CARDS ***
Dealt to matiko09 [Ad 2s]
PacPacBum: folds 
granbunny: folds 
Mr.Grigoriy: raises $2 to $3
kevinho109: folds 
oscarleon: folds 
kind ten: folds 
matiko09: folds 
Uncalled bet ($2) returned to Mr.Grigoriy
Priidix leaves the table
Mr.Grigoriy collected $2.50 from pot
Mr.Grigoriy: doesn't show hand 
*** SUMMARY ***
Total pot $2.50 | Rake $0 
Seat 1: matiko09 (big blind) folded before Flop
Seat 2: PacPacBum folded before Flop (didn't bet)
Seat 3: granbunny folded before Flop (didn't bet)
Seat 4: Mr.Grigoriy collected ($2.50)
Seat 7: kevinho109 folded before Flop (didn't bet)
Seat 8: oscarleon (button) folded before Flop (didn't bet)
Seat 9: kind ten (small blind) folded before Flop





PokerStars Hand #154362998447:  Hold'em No Limit ($0.50/$1.00 USD) - 2016/06/06 12:39:17 CET [2016/06/06 6:39:17 ET]
Table 'Irmgard II' 9-max Seat #4 is the button
Seat 1: matiko09 ($146.50 in chips) 
Seat 2: hammerwife ($135.32 in chips) 
Seat 3: stds st ($44.48 in chips) 
Seat 4: oscarleon ($157.76 in chips) 
Seat 5: Mr.Grigoriy ($145.26 in chips) 
Seat 7: 32rrew ($102.68 in chips) 
Seat 8: Szevasztopol ($100 in chips) 
Seat 9: DONFILIPPO1 ($36.01 in chips) 
Mr.Grigoriy: posts small blind $0.50
maxxmeister: is sitting out 
32rrew: posts big blind $1
*** HOLE CARDS ***
Dealt to matiko09 [3c 9s]
Szevasztopol: raises $1.24 to $2.24
DONFILIPPO1: folds 
matiko09: folds 
maxxmeister leaves the table
hammerwife: raises $5.76 to $8
stds st: folds 
oscarleon: folds 
Mr.Grigoriy: folds 
DancerNN1 joins the table at seat #6 
32rrew: folds 
Szevasztopol: raises $14 to $22
hammerwife: folds 
Uncalled bet ($14) returned to Szevasztopol
Szevasztopol collected $17.50 from pot
Szevasztopol: doesn't show hand 
*** SUMMARY ***
Total pot $17.50 | Rake $0 
Seat 1: matiko09 folded before Flop (didn't bet)
Seat 2: hammerwife folded before Flop
Seat 3: stds st folded before Flop (didn't bet)
Seat 4: oscarleon (button) folded before Flop (didn't bet)
Seat 5: Mr.Grigoriy (small blind) folded before Flop
Seat 7: 32rrew (big blind) folded before Flop
Seat 8: Szevasztopol collected ($17.50)
Seat 9: DONFILIPPO1 folded before Flop (didn't bet)





PokerStars Hand #154363005449:  Hold'em No Limit ($0.50/$1.00 USD) - 2016/06/06 12:39:34 CET [2016/06/06 6:39:34 ET]
Table 'Yarilo' 9-max Seat #5 is the button
Seat 1: xxxZeka ($100 in chips) 
Seat 2: nombraalne1 ($102 in chips) 
Seat 3: matiko09 ($137.56 in chips) 
Seat 5: Szevasztopol ($134.20 in chips) 
Seat 7: KEBIN1974 ($100 in chips) 
Seat 8: Mr.Grigoriy ($172.53 in chips) 
ozone2003 will be allowed to play after the button
KEBIN1974: posts small blind $0.50
Mr.Grigoriy: posts big blind $1
o.miro: sits out 
*** HOLE CARDS ***
Dealt to matiko09 [Jh Kd]
xxxZeka: folds 
nombraalne1: folds 
matiko09: raises $1.50 to $2.50
Szevasztopol: folds 
KEBIN1974: raises $6.50 to $9
Mr.Grigoriy: folds 
matiko09: folds 
Uncalled bet ($6.50) returned to KEBIN1974
KEBIN1974 collected $6 from pot
KEBIN1974: doesn't show hand 
*** SUMMARY ***
Total pot $6 | Rake $0 
Seat 1: xxxZeka folded before Flop (didn't bet)
Seat 2: nombraalne1 folded before Flop (didn't bet)
Seat 3: matiko09 folded before Flop
Seat 5: Szevasztopol (button) folded before Flop (didn't bet)
Seat 7: KEBIN1974 (small blind) collected ($6)
Seat 8: Mr.Grigoriy (big blind) folded before Flop





PokerStars Hand #154363007141:  Hold'em No Limit ($0.50/$1.00 USD) - 2016/06/06 12:39:38 CET [2016/06/06 6:39:38 ET]
Table 'Chaldaea II' 9-max Seat #2 is the button
Seat 1: xxxZeka ($110.20 in chips) 
Seat 2: masaytoo ($92.30 in chips) 
Seat 3: ardo888 ($111.61 in chips) 
Seat 4: ozone2003 ($120.21 in chips) 
Seat 5: MiiiTCHy__ ($56.38 in chips) 
Seat 6: PacPacBum ($100 in chips) 
Seat 7: riggedsh** ($141.88 in chips) 
Seat 8: o.miro ($111 in chips) 
Seat 9: matiko09 ($106 in chips) 
ardo888: posts small blind $0.50
ozone2003: posts big blind $1
*** HOLE CARDS ***
Dealt to matiko09 [Qh 4h]
MiiiTCHy__: raises $1.50 to $2.50
PacPacBum: folds 
riggedsh**: folds 
o.miro: folds 
matiko09: folds 
xxxZeka: folds 
masaytoo: calls $2.50
ardo888: folds 
ozone2003: folds 
*** FLOP *** [5d Ac Tc]
MiiiTCHy__: checks 
masaytoo: bets $3.09
MiiiTCHy__: calls $3.09
*** TURN *** [5d Ac Tc] [7h]
MiiiTCHy__: checks 
masaytoo: checks 
*** RIVER *** [5d Ac Tc 7h] [4s]
MiiiTCHy__: checks 
masaytoo: checks 
*** SHOW DOWN ***
MiiiTCHy__: shows [Qd Js] (high card Ace)
masaytoo: shows [2c 2s] (a pair of Deuces)
masaytoo collected $12.05 from pot
*** SUMMARY ***
Total pot $12.68 | Rake $0.63 
Board [5d Ac Tc 7h 4s]
Seat 1: xxxZeka folded before Flop (didn't bet)
Seat 2: masaytoo (button) showed [2c 2s] and won ($12.05) with a pair of Deuces
Seat 3: ardo888 (small blind) folded before Flop
Seat 4: ozone2003 (big blind) folded before Flop
Seat 5: MiiiTCHy__ showed [Qd Js] and lost with high card Ace
Seat 6: PacPacBum folded before Flop (didn't bet)
Seat 7: riggedsh** folded before Flop (didn't bet)
Seat 8: o.miro folded before Flop (didn't bet)
Seat 9: matiko09 folded before Flop (didn't bet)





PokerStars Hand #154363007057:  Hold'em No Limit ($0.50/$1.00 USD) - 2016/06/06 12:39:38 CET [2016/06/06 6:39:38 ET]
Table 'Smither' 9-max Seat #3 is the button
Seat 1: PacPacBum ($109.40 in chips) 
Seat 2: matiko09 ($103.84 in chips) 
Seat 3: xxxZeka ($119.33 in chips) 
Seat 4: maxxmeister ($212.16 in chips) 
Seat 5: Szevasztopol ($101.50 in chips) 
Seat 6: riggedsh** ($108.78 in chips) 
Seat 8: 74 ROADIE ($97.50 in chips) 
Seat 9: hammerwife ($200.47 in chips) 
maxxmeister: posts small blind $0.50
Szevasztopol: posts big blind $1
*** HOLE CARDS ***
Dealt to matiko09 [7c 2s]
riggedsh**: folds 
74 ROADIE: folds 
hammerwife: raises $1.50 to $2.50
PacPacBum: folds 
matiko09: folds 
xxxZeka: folds 
maxxmeister: folds 
Szevasztopol: folds 
Uncalled bet ($1.50) returned to hammerwife
hammerwife collected $2.50 from pot
hammerwife: doesn't show hand 
*** SUMMARY ***
Total pot $2.50 | Rake $0 
Seat 1: PacPacBum folded before Flop (didn't bet)
Seat 2: matiko09 folded before Flop (didn't bet)
Seat 3: xxxZeka (button) folded before Flop (didn't bet)
Seat 4: maxxmeister (small blind) folded before Flop
Seat 5: Szevasztopol (big blind) folded before Flop
Seat 6: riggedsh** folded before Flop (didn't bet)
Seat 8: 74 ROADIE folded before Flop (didn't bet)
Seat 9: hammerwife collected ($2.50)





PokerStars Hand #154363008808:  Hold'em No Limit ($0.50/$1.00 USD) - 2016/06/06 12:39:42 CET [2016/06/06 6:39:42 ET]
Table 'Williams' 9-max Seat #9 is the button
Seat 1: matiko09 ($190.29 in chips) 
Seat 2: PacPacBum ($104.50 in chips) 
Seat 3: granbunny ($63.30 in chips) 
Seat 4: Mr.Grigoriy ($101.50 in chips) 
Seat 7: kevinho109 ($65.08 in chips) 
Seat 8: oscarleon ($108.86 in chips) 
Seat 9: kind ten ($36.55 in chips) 
matiko09: posts small blind $0.50
PacPacBum: posts big blind $1
xxxibgdrgn: sits out 
*** HOLE CARDS ***
Dealt to matiko09 [9h 5s]
xxxZeka joins the table at seat #6 
granbunny: folds 
Mr.Grigoriy: folds 
kevinho109: folds 
oscarleon: folds 
kind ten: folds 
matiko09: folds 
Uncalled bet ($0.50) returned to PacPacBum
PacPacBum collected $1 from pot
PacPacBum: doesn't show hand 
*** SUMMARY ***
Total pot $1 | Rake $0 
Seat 1: matiko09 (small blind) folded before Flop
Seat 2: PacPacBum (big blind) collected ($1)
Seat 3: granbunny folded before Flop (didn't bet)
Seat 4: Mr.Grigoriy folded before Flop (didn't bet)
Seat 7: kevinho109 folded before Flop (didn't bet)
Seat 8: oscarleon folded before Flop (didn't bet)
Seat 9: kind ten (button) folded before Flop (didn't bet)





PokerStars Hand #154363009755:  Hold'em No Limit ($0.50/$1.00 USD) - 2016/06/06 12:39:44 CET [2016/06/06 6:39:44 ET]
Table 'Heze' 9-max Seat #2 is the button
Seat 1: matiko09 ($218.15 in chips) 
Seat 2: oscarleon ($241.81 in chips) 
Seat 3: xxxibgdrgn ($100 in chips) 
Seat 4: xxxZeka ($101.50 in chips) 
Seat 6: ozone2003 ($112.07 in chips) 
Seat 8: AlSmithy88 ($49.56 in chips) 
Seat 9: Mr.Grigoriy ($125.70 in chips) 
xxxibgdrgn: posts small blind $0.50
xxxZeka: posts big blind $1
stds st: sits out 
*** HOLE CARDS ***
Dealt to matiko09 [8h 5d]
ozone2003: raises $2 to $3
AlSmithy88: folds 
Mr.Grigoriy: folds 
matiko09: folds 
oscarleon: folds 
xxxibgdrgn: folds 
xxxZeka: folds 
Uncalled bet ($2) returned to ozone2003
ozone2003 collected $2.50 from pot
ozone2003: doesn't show hand 
*** SUMMARY ***
Total pot $2.50 | Rake $0 
Seat 1: matiko09 folded before Flop (didn't bet)
Seat 2: oscarleon (button) folded before Flop (didn't bet)
Seat 3: xxxibgdrgn (small blind) folded before Flop
Seat 4: xxxZeka (big blind) folded before Flop
Seat 6: ozone2003 collected ($2.50)
Seat 8: AlSmithy88 folded before Flop (didn't bet)
Seat 9: Mr.Grigoriy folded before Flop (didn't bet)





PokerStars Hand #154363009836:  Hold'em No Limit ($0.50/$1.00 USD) - 2016/06/06 12:39:45 CET [2016/06/06 6:39:45 ET]
Table 'Safara' 9-max Seat #3 is the button
Seat 1: oscarleon ($234.44 in chips) 
Seat 2: Szevasztopol ($100 in chips) 
Seat 3: ozone2003 ($100 in chips) 
Seat 5: Dantist1122 ($101.53 in chips) 
Seat 6: matiko09 ($120.08 in chips) 
Seat 7: PacPacBum ($100 in chips) 
Seat 9: Mr.Grigoriy ($102.67 in chips) 
Dantist1122: posts small blind $0.50
matiko09: posts big blind $1
*** HOLE CARDS ***
Dealt to matiko09 [5d Ah]
PacPacBum: folds 
Mr.Grigoriy: folds 
oscarleon: folds 
Szevasztopol: raises $1.04 to $2.04
ozone2003: folds 
xxxZeka joins the table at seat #8 
Dantist1122: folds 
xxxZeka leaves the table
32rrew joins the table at seat #8 
matiko09: folds 
Uncalled bet ($1.04) returned to Szevasztopol
Szevasztopol collected $2.50 from pot
Szevasztopol: doesn't show hand 
*** SUMMARY ***
Total pot $2.50 | Rake $0 
Seat 1: oscarleon folded before Flop (didn't bet)
Seat 2: Szevasztopol collected ($2.50)
Seat 3: ozone2003 (button) folded before Flop (didn't bet)
Seat 5: Dantist1122 (small blind) folded before Flop
Seat 6: matiko09 (big blind) folded before Flop
Seat 7: PacPacBum folded before Flop (didn't bet)
Seat 9: Mr.Grigoriy folded before Flop (didn't bet)





PokerStars Hand #154363012525:  Hold'em No Limit ($0.50/$1.00 USD) - 2016/06/06 12:39:51 CET [2016/06/06 6:39:51 ET]
Table 'Wezen II' 9-max Seat #2 is the button
Seat 1: matiko09 ($162.47 in chips) 
Seat 2: Mr.Grigoriy ($106.68 in chips) 
Seat 3: oscarleon ($100 in chips) 
Seat 4: xxxibgdrgn ($100 in chips) 
Seat 5: stds st ($36.20 in chips) 
Seat 7: KDJAll3 ($96.06 in chips) 
Seat 8: mavin80 ($159.20 in chips) 
oscarleon: posts small blind $0.50
xxxibgdrgn: posts big blind $1
masaytoo: sits out 
PacPacBum: sits out 
*** HOLE CARDS ***
Dealt to matiko09 [Qs 4h]
stds st: folds 
KDJAll3: raises $1 to $2
mavin80: calls $2
matiko09: folds 
Mr.Grigoriy: folds 
oscarleon: folds 
xxxibgdrgn: folds 
*** FLOP *** [Ac 6h Jc]
KDJAll3: bets $1
mavin80: calls $1
*** TURN *** [Ac 6h Jc] [Ad]
KDJAll3: bets $3
mavin80: calls $3
*** RIVER *** [Ac 6h Jc Ad] [7c]
KDJAll3: bets $4
mavin80: raises $4 to $8
KDJAll3: calls $4
*** SHOW DOWN ***
mavin80: shows [Jh As] (a full house, Aces full of Jacks)
KDJAll3: mucks hand 
mavin80 collected $28.02 from pot
*** SUMMARY ***
Total pot $29.50 | Rake $1.48 
Board [Ac 6h Jc Ad 7c]
Seat 1: matiko09 folded before Flop (didn't bet)
Seat 2: Mr.Grigoriy (button) folded before Flop (didn't bet)
Seat 3: oscarleon (small blind) folded before Flop
Seat 4: xxxibgdrgn (big blind) folded before Flop
Seat 5: stds st folded before Flop (didn't bet)
Seat 7: KDJAll3 mucked [Kc Jd]
Seat 8: mavin80 showed [Jh As] and won ($28.02) with a full house, Aces full of Jacks





PokerStars Hand #154363013328:  Hold'em No Limit ($0.50/$1.00 USD) - 2016/06/06 12:39:53 CET [2016/06/06 6:39:53 ET]
Table 'Williams' 9-max Seat #1 is the button
Seat 1: matiko09 ($189.79 in chips) 
Seat 2: PacPacBum ($105 in chips) 
Seat 3: granbunny ($63.30 in chips) 
Seat 4: Mr.Grigoriy ($101.50 in chips) 
Seat 7: kevinho109 ($65.08 in chips) 
Seat 8: oscarleon ($108.86 in chips) 
Seat 9: kind ten ($36.55 in chips) 
PacPacBum: posts small blind $0.50
granbunny: posts big blind $1
xxxibgdrgn: sits out 
xxxZeka: sits out 
*** HOLE CARDS ***
Dealt to matiko09 [Ah 8c]
Mr.Grigoriy: raises $2 to $3
kevinho109: folds 
oscarleon: folds 
kind ten: folds 
matiko09: folds 
PacPacBum: calls $2.50
granbunny: folds 
*** FLOP *** [Qc 3s 8s]
PacPacBum: checks 
Mr.Grigoriy: bets $4.72
PacPacBum: calls $4.72
*** TURN *** [Qc 3s 8s] [8d]
PacPacBum: checks 
Mr.Grigoriy: checks 
*** RIVER *** [Qc 3s 8s 8d] [8h]
PacPacBum: bets $10.77
Mr.Grigoriy: folds 
Uncalled bet ($10.77) returned to PacPacBum
PacPacBum collected $15.62 from pot
PacPacBum: doesn't show hand 
*** SUMMARY ***
Total pot $16.44 | Rake $0.82 
Board [Qc 3s 8s 8d 8h]
Seat 1: matiko09 (button) folded before Flop (didn't bet)
Seat 2: PacPacBum (small blind) collected ($15.62)
Seat 3: granbunny (big blind) folded before Flop
Seat 4: Mr.Grigoriy folded on the River
Seat 7: kevinho109 folded before Flop (didn't bet)
Seat 8: oscarleon folded before Flop (didn't bet)
Seat 9: kind ten folded before Flop (didn't bet)





PokerStars Hand #154363016052:  Hold'em No Limit ($0.50/$1.00 USD) - 2016/06/06 12:40:00 CET [2016/06/06 6:40:00 ET]
Table 'Sheliak' 9-max Seat #1 is the button
Seat 1: 32rrew ($101 in chips) 
Seat 2: masaytoo ($99 in chips) 
Seat 3: oscarleon ($100 in chips) 
Seat 5: vanilica ($100 in chips) 
Seat 6: matiko09 ($100 in chips) 
Seat 7: stds st ($40 in chips) 
Seat 8: djammusic ($40 in chips) 
Seat 9: nombraalne1 ($100 in chips) 
masaytoo: posts small blind $0.50
oscarleon: posts big blind $1
*** HOLE CARDS ***
Dealt to matiko09 [4d 6h]
vanilica: folds 
matiko09: folds 
stds st: folds 
djammusic: folds 
nombraalne1: raises $1 to $2
32rrew: folds 
masaytoo: folds 
oscarleon: calls $1
*** FLOP *** [9d 3c Qd]
oscarleon: checks 
Soundust_007 joins the table at seat #4 
nombraalne1: checks 
*** TURN *** [9d 3c Qd] [Qs]
oscarleon: checks 
nombraalne1: checks 
*** RIVER *** [9d 3c Qd Qs] [4s]
oscarleon: checks 
nombraalne1: checks 
*** SHOW DOWN ***
oscarleon: shows [6c 7h] (a pair of Queens)
nombraalne1: shows [Kc As] (a pair of Queens - Ace kicker)
nombraalne1 collected $4.28 from pot
*** SUMMARY ***
Total pot $4.50 | Rake $0.22 
Board [9d 3c Qd Qs 4s]
Seat 1: 32rrew (button) folded before Flop (didn't bet)
Seat 2: masaytoo (small blind) folded before Flop
Seat 3: oscarleon (big blind) showed [6c 7h] and lost with a pair of Queens
Seat 5: vanilica folded before Flop (didn't bet)
Seat 6: matiko09 folded before Flop (didn't bet)
Seat 7: stds st folded before Flop (didn't bet)
Seat 8: djammusic folded before Flop (didn't bet)
Seat 9: nombraalne1 showed [Kc As] and won ($4.28) with a pair of Queens





PokerStars Hand #154363020058:  Hold'em No Limit ($0.50/$1.00 USD) - 2016/06/06 12:40:10 CET [2016/06/06 6:40:10 ET]
Table 'Heze' 9-max Seat #3 is the button
Seat 1: matiko09 ($218.15 in chips) 
Seat 2: oscarleon ($241.81 in chips) 
Seat 3: xxxibgdrgn ($100 in chips) 
Seat 4: xxxZeka ($100.50 in chips) 
Seat 5: stds st ($40 in chips) 
Seat 6: ozone2003 ($113.57 in chips) 
Seat 8: AlSmithy88 ($49.56 in chips) 
Seat 9: Mr.Grigoriy ($125.70 in chips) 
xxxZeka: posts small blind $0.50
stds st: posts big blind $1
*** HOLE CARDS ***
Dealt to matiko09 [5s 3s]
32rrew joins the table at seat #7 
ozone2003: folds 
AlSmithy88: folds 
Mr.Grigoriy: folds 
matiko09: folds 
oscarleon: folds 
xxxibgdrgn: folds 
xxxZeka: folds 
Uncalled bet ($0.50) returned to stds st
stds st collected $1 from pot
stds st: doesn't show hand 
*** SUMMARY ***
Total pot $1 | Rake $0 
Seat 1: matiko09 folded before Flop (didn't bet)
Seat 2: oscarleon folded before Flop (didn't bet)
Seat 3: xxxibgdrgn (button) folded before Flop (didn't bet)
Seat 4: xxxZeka (small blind) folded before Flop
Seat 5: stds st (big blind) collected ($1)
Seat 6: ozone2003 folded before Flop (didn't bet)
Seat 8: AlSmithy88 folded before Flop (didn't bet)
Seat 9: Mr.Grigoriy folded before Flop (didn't bet)





PokerStars Hand #154363020487:  Hold'em No Limit ($0.50/$1.00 USD) - 2016/06/06 12:40:11 CET [2016/06/06 6:40:11 ET]
Table 'Yarilo' 9-max Seat #7 is the button
Seat 1: xxxZeka ($100 in chips) 
Seat 2: nombraalne1 ($102 in chips) 
Seat 3: matiko09 ($135.06 in chips) 
Seat 5: Szevasztopol ($134.20 in chips) 
Seat 7: KEBIN1974 ($103.50 in chips) 
Seat 8: Mr.Grigoriy ($171.53 in chips) 
Seat 9: o.miro ($100 in chips) 
Mr.Grigoriy: posts small blind $0.50
o.miro: posts big blind $1
ozone2003: sits out 
*** HOLE CARDS ***
Dealt to matiko09 [4d Kd]
xxxZeka: folds 
nombraalne1: folds 
matiko09: folds 
Szevasztopol: raises $1.04 to $2.04
KEBIN1974: folds 
Mr.Grigoriy: folds 
o.miro: calls $1.04
*** FLOP *** [8s 2c 8h]
o.miro: checks 
riggedsh** leaves the table
Szevasztopol: bets $2.87
o.miro: folds 
Uncalled bet ($2.87) returned to Szevasztopol
Szevasztopol collected $4.35 from pot
Szevasztopol: doesn't show hand 
*** SUMMARY ***
Total pot $4.58 | Rake $0.23 
Board [8s 2c 8h]
Seat 1: xxxZeka folded before Flop (didn't bet)
Seat 2: nombraalne1 folded before Flop (didn't bet)
Seat 3: matiko09 folded before Flop (didn't bet)
Seat 5: Szevasztopol collected ($4.35)
Seat 7: KEBIN1974 (button) folded before Flop (didn't bet)
Seat 8: Mr.Grigoriy (small blind) folded before Flop
Seat 9: o.miro (big blind) folded on the Flop





PokerStars Hand #154363021329:  Hold'em No Limit ($0.50/$1.00 USD) - 2016/06/06 12:40:13 CET [2016/06/06 6:40:13 ET]
Table 'Safara' 9-max Seat #5 is the button
Seat 1: oscarleon ($234.44 in chips) 
Seat 2: Szevasztopol ($101.50 in chips) 
Seat 3: ozone2003 ($100 in chips) 
Seat 5: Dantist1122 ($101.03 in chips) 
Seat 6: matiko09 ($119.08 in chips) 
Seat 7: PacPacBum ($100 in chips) 
Seat 9: Mr.Grigoriy ($102.67 in chips) 
matiko09: posts small blind $0.50
PacPacBum: posts big blind $1
32rrew: sits out 
*** HOLE CARDS ***
Dealt to matiko09 [Qc As]
Mr.Grigoriy: folds 
oscarleon: folds 
Szevasztopol: folds 
ozone2003: folds 
Dantist1122: folds 
matiko09: raises $2 to $3
hurtNCYDE joins the table at seat #4 
hurtNCYDE leaves the table
PacPacBum: calls $2
*** FLOP *** [2s 4s 7h]
matiko09: checks 
PacPacBum: checks 
*** TURN *** [2s 4s 7h] [3c]
matiko09: checks 
PacPacBum: checks 
*** RIVER *** [2s 4s 7h 3c] [Jh]
matiko09: checks 
PacPacBum: checks 
*** SHOW DOWN ***
matiko09: shows [Qc As] (high card Ace)
PacPacBum: mucks hand 
matiko09 collected $5.70 from pot
*** SUMMARY ***
Total pot $6 | Rake $0.30 
Board [2s 4s 7h 3c Jh]
Seat 1: oscarleon folded before Flop (didn't bet)
Seat 2: Szevasztopol folded before Flop (didn't bet)
Seat 3: ozone2003 folded before Flop (didn't bet)
Seat 5: Dantist1122 (button) folded before Flop (didn't bet)
Seat 6: matiko09 (small blind) showed [Qc As] and won ($5.70) with high card Ace
Seat 7: PacPacBum (big blind) mucked [Tc 8c]
Seat 9: Mr.Grigoriy folded before Flop (didn't bet)





PokerStars Hand #154363022760:  Hold'em No Limit ($0.50/$1.00 USD) - 2016/06/06 12:40:16 CET [2016/06/06 6:40:16 ET]
Table 'Titius' 9-max Seat #9 is the button
Seat 1: xxxZeka ($100 in chips) 
Seat 2: matiko09 ($100 in chips) 
Seat 5: riggedsh** ($199 in chips) 
Seat 6: oscarleon ($105.50 in chips) 
Seat 7: ardo888 ($100 in chips) 
Seat 8: DB3333 ($48.50 in chips) 
Seat 9: PacPacBum ($102.50 in chips) 
xxxZeka: posts small blind $0.50
matiko09: posts big blind $1
vanilica: sits out 
ozone2003: sits out 
*** HOLE CARDS ***
Dealt to matiko09 [2d 8h]
riggedsh**: folds 
oscarleon: folds 
ardo888: folds 
DB3333: folds 
PacPacBum: raises $1.04 to $2.04
xxxZeka: folds 
matiko09: folds 
Uncalled bet ($1.04) returned to PacPacBum
PacPacBum collected $2.50 from pot
PacPacBum: doesn't show hand 
*** SUMMARY ***
Total pot $2.50 | Rake $0 
Seat 1: xxxZeka (small blind) folded before Flop
Seat 2: matiko09 (big blind) folded before Flop
Seat 5: riggedsh** folded before Flop (didn't bet)
Seat 6: oscarleon folded before Flop (didn't bet)
Seat 7: ardo888 folded before Flop (didn't bet)
Seat 8: DB3333 folded before Flop (didn't bet)
Seat 9: PacPacBum (button) collected ($2.50)





PokerStars Hand #154363026994:  Hold'em No Limit ($0.50/$1.00 USD) - 2016/06/06 12:40:27 CET [2016/06/06 6:40:27 ET]
Table 'Smither' 9-max Seat #4 is the button
Seat 1: PacPacBum ($109.40 in chips) 
Seat 2: matiko09 ($103.84 in chips) 
Seat 3: xxxZeka ($119.33 in chips) 
Seat 4: maxxmeister ($211.66 in chips) 
Seat 5: Szevasztopol ($100.50 in chips) 
Seat 6: riggedsh** ($108.78 in chips) 
Seat 8: 74 ROADIE ($97.50 in chips) 
Seat 9: hammerwife ($201.97 in chips) 
Szevasztopol: posts small blind $0.50
riggedsh**: posts big blind $1
*** HOLE CARDS ***
Dealt to matiko09 [8c Qh]
74 ROADIE: raises $2 to $3
hammerwife: folds 
PacPacBum: folds 
matiko09: folds 
xxxZeka: raises $5 to $8
maxxmeister: folds 
Szevasztopol: folds 
riggedsh**: folds 
74 ROADIE: calls $5
*** FLOP *** [9c 5c Js]
74 ROADIE: checks 
xxxZeka: bets $10
74 ROADIE: folds 
Uncalled bet ($10) returned to xxxZeka
xxxZeka collected $16.62 from pot
*** SUMMARY ***
Total pot $17.50 | Rake $0.88 
Board [9c 5c Js]
Seat 1: PacPacBum folded before Flop (didn't bet)
Seat 2: matiko09 folded before Flop (didn't bet)
Seat 3: xxxZeka collected ($16.62)
Seat 4: maxxmeister (button) folded before Flop (didn't bet)
Seat 5: Szevasztopol (small blind) folded before Flop
Seat 6: riggedsh** (big blind) folded before Flop
Seat 8: 74 ROADIE folded on the Flop
Seat 9: hammerwife folded before Flop (didn't bet)





PokerStars Hand #154363031710:  Hold'em No Limit ($0.50/$1.00 USD) - 2016/06/06 12:40:38 CET [2016/06/06 6:40:38 ET]
Table 'Irmgard II' 9-max Seat #5 is the button
Seat 1: matiko09 ($146.50 in chips) 
Seat 2: hammerwife ($127.32 in chips) 
Seat 3: stds st ($44.48 in chips) 
Seat 4: oscarleon ($157.76 in chips) 
Seat 5: Mr.Grigoriy ($144.76 in chips) 
Seat 7: 32rrew ($101.68 in chips) 
Seat 9: DONFILIPPO1 ($36.01 in chips) 
DancerNN1 will be allowed to play after the button
32rrew: posts small blind $0.50
Szevasztopol: is sitting out 
DONFILIPPO1: posts big blind $1
*** HOLE CARDS ***
Dealt to matiko09 [3d Ac]
matiko09: folds 
hammerwife: folds 
stds st: folds 
oscarleon: folds 
Mr.Grigoriy: folds 
32rrew: folds 
Uncalled bet ($0.50) returned to DONFILIPPO1
DONFILIPPO1 collected $1 from pot
DONFILIPPO1: doesn't show hand 
*** SUMMARY ***
Total pot $1 | Rake $0 
Seat 1: matiko09 folded before Flop (didn't bet)
Seat 2: hammerwife folded before Flop (didn't bet)
Seat 3: stds st folded before Flop (didn't bet)
Seat 4: oscarleon folded before Flop (didn't bet)
Seat 5: Mr.Grigoriy (button) folded before Flop (didn't bet)
Seat 7: 32rrew (small blind) folded before Flop
Seat 9: DONFILIPPO1 (big blind) collected ($1)





PokerStars Hand #154363031792:  Hold'em No Limit ($0.50/$1.00 USD) - 2016/06/06 12:40:39 CET [2016/06/06 6:40:39 ET]
Table 'Gajdariya' 9-max Seat #8 is the button
Seat 1: matiko09 ($117.23 in chips) 
Seat 2: xxxZeka ($126.74 in chips) 
Seat 3: oscarleon ($113.55 in chips) 
Seat 4: Szevasztopol ($106.63 in chips) 
Seat 5: 147734319 ($99.51 in chips) 
Seat 6: mono123viva ($166.56 in chips) 
Seat 7: Wombatkilla ($99.42 in chips) 
Seat 8: ardo888 ($100 in chips) 
Seat 9: Mr.Grigoriy ($100 in chips) 
Mr.Grigoriy: posts small blind $0.50
matiko09: posts big blind $1
*** HOLE CARDS ***
Dealt to matiko09 [9s Qc]
xxxZeka: folds 
oscarleon: folds 
Szevasztopol: folds 
147734319: folds 
mono123viva: folds 
Wombatkilla: folds 
ardo888: folds 
Mr.Grigoriy: raises $1.50 to $2.50
matiko09: calls $1.50
*** FLOP *** [As 4c 5h]
Mr.Grigoriy: checks 
matiko09: checks 
*** TURN *** [As 4c 5h] [8s]
Mr.Grigoriy: bets $3.37
matiko09: folds 
Uncalled bet ($3.37) returned to Mr.Grigoriy
Mr.Grigoriy collected $4.75 from pot
Mr.Grigoriy: doesn't show hand 
*** SUMMARY ***
Total pot $5 | Rake $0.25 
Board [As 4c 5h 8s]
Seat 1: matiko09 (big blind) folded on the Turn
Seat 2: xxxZeka folded before Flop (didn't bet)
Seat 3: oscarleon folded before Flop (didn't bet)
Seat 4: Szevasztopol folded before Flop (didn't bet)
Seat 5: 147734319 folded before Flop (didn't bet)
Seat 6: mono123viva folded before Flop (didn't bet)
Seat 7: Wombatkilla folded before Flop (didn't bet)
Seat 8: ardo888 (button) folded before Flop (didn't bet)
Seat 9: Mr.Grigoriy (small blind) collected ($4.75)





PokerStars Hand #154363033261:  Hold'em No Limit ($0.50/$1.00 USD) - 2016/06/06 12:40:42 CET [2016/06/06 6:40:42 ET]
Table 'Sheliak' 9-max Seat #2 is the button
Seat 1: 32rrew ($101 in chips) 
Seat 2: masaytoo ($98.50 in chips) 
Seat 3: oscarleon ($100 in chips) 
Seat 4: Soundust_007 ($40 in chips) 
Seat 5: vanilica ($100 in chips) 
Seat 6: matiko09 ($100 in chips) 
Seat 7: stds st ($40 in chips) 
Seat 8: djammusic ($40 in chips) 
Seat 9: nombraalne1 ($102.28 in chips) 
oscarleon: posts small blind $0.50
Soundust_007: posts big blind $1
*** HOLE CARDS ***
Dealt to matiko09 [Js 6h]
vanilica: raises $1.85 to $2.85
matiko09: folds 
stds st: folds 
djammusic: folds 
nombraalne1: folds 
32rrew: folds 
masaytoo: folds 
oscarleon: folds 
Soundust_007: raises $37.15 to $40 and is all-in
vanilica: calls $37.15
*** FLOP *** [Qc 9s Kd]
*** TURN *** [Qc 9s Kd] [4h]
*** RIVER *** [Qc 9s Kd 4h] [2s]
*** SHOW DOWN ***
Soundust_007: shows [2c 2d] (three of a kind, Deuces)
vanilica: shows [As Ac] (a pair of Aces)
Soundust_007 collected $78 from pot
*** SUMMARY ***
Total pot $80.50 | Rake $2.50 
Board [Qc 9s Kd 4h 2s]
Seat 1: 32rrew folded before Flop (didn't bet)
Seat 2: masaytoo (button) folded before Flop (didn't bet)
Seat 3: oscarleon (small blind) folded before Flop
Seat 4: Soundust_007 (big blind) showed [2c 2d] and won ($78) with three of a kind, Deuces
Seat 5: vanilica showed [As Ac] and lost with a pair of Aces
Seat 6: matiko09 folded before Flop (didn't bet)
Seat 7: stds st folded before Flop (didn't bet)
Seat 8: djammusic folded before Flop (didn't bet)
Seat 9: nombraalne1 folded before Flop (didn't bet)





PokerStars Hand #154363034761:  Hold'em No Limit ($0.50/$1.00 USD) - 2016/06/06 12:40:46 CET [2016/06/06 6:40:46 ET]
Table 'Titius' 9-max Seat #1 is the button
Seat 1: xxxZeka ($100 in chips) 
Seat 2: matiko09 ($100 in chips) 
Seat 3: vanilica ($100 in chips) 
Seat 5: riggedsh** ($199 in chips) 
Seat 6: oscarleon ($105.50 in chips) 
Seat 7: ardo888 ($100 in chips) 
Seat 8: DB3333 ($48.50 in chips) 
Seat 9: PacPacBum ($104 in chips) 
matiko09: posts small blind $0.50
vanilica: posts big blind $1
ozone2003: sits out 
*** HOLE CARDS ***
Dealt to matiko09 [3s Ts]
riggedsh**: folds 
oscarleon: folds 
ardo888: folds 
DB3333: folds 
PacPacBum: raises $1.04 to $2.04
xxxZeka: folds 
matiko09: folds 
vanilica: folds 
Uncalled bet ($1.04) returned to PacPacBum
PacPacBum collected $2.50 from pot
PacPacBum: doesn't show hand 
*** SUMMARY ***
Total pot $2.50 | Rake $0 
Seat 1: xxxZeka (button) folded before Flop (didn't bet)
Seat 2: matiko09 (small blind) folded before Flop
Seat 3: vanilica (big blind) folded before Flop
Seat 5: riggedsh** folded before Flop (didn't bet)
Seat 6: oscarleon folded before Flop (didn't bet)
Seat 7: ardo888 folded before Flop (didn't bet)
Seat 8: DB3333 folded before Flop (didn't bet)
Seat 9: PacPacBum collected ($2.50)





PokerStars Hand #154363036972:  Hold'em No Limit ($0.50/$1.00 USD) - 2016/06/06 12:40:51 CET [2016/06/06 6:40:51 ET]
Table 'Chaldaea II' 9-max Seat #3 is the button
Seat 1: xxxZeka ($110.20 in chips) 
Seat 2: masaytoo ($98.76 in chips) 
Seat 3: ardo888 ($111.11 in chips) 
Seat 4: ozone2003 ($119.21 in chips) 
Seat 5: MiiiTCHy__ ($50.79 in chips) 
Seat 6: PacPacBum ($100 in chips) 
Seat 7: riggedsh** ($141.88 in chips) 
Seat 8: o.miro ($111 in chips) 
Seat 9: matiko09 ($106 in chips) 
ozone2003: posts small blind $0.50
MiiiTCHy__: posts big blind $1
*** HOLE CARDS ***
Dealt to matiko09 [Th 9d]
PacPacBum: folds 
riggedsh**: folds 
o.miro: folds 
matiko09: folds 
xxxZeka: raises $2 to $3
masaytoo: folds 
ardo888: folds 
ozone2003: folds 
MiiiTCHy__: calls $2
*** FLOP *** [9s 2c 3s]
MiiiTCHy__: checks 
xxxZeka: bets $4.11
MiiiTCHy__: calls $4.11
*** TURN *** [9s 2c 3s] [7h]
MiiiTCHy__: checks 
xxxZeka: checks 
*** RIVER *** [9s 2c 3s 7h] [Ad]
MiiiTCHy__: bets $10.06
xxxZeka: folds 
Uncalled bet ($10.06) returned to MiiiTCHy__
MiiiTCHy__ collected $13.98 from pot
*** SUMMARY ***
Total pot $14.72 | Rake $0.74 
Board [9s 2c 3s 7h Ad]
Seat 1: xxxZeka folded on the River
Seat 2: masaytoo folded before Flop (didn't bet)
Seat 3: ardo888 (button) folded before Flop (didn't bet)
Seat 4: ozone2003 (small blind) folded before Flop
Seat 5: MiiiTCHy__ (big blind) collected ($13.98)
Seat 6: PacPacBum folded before Flop (didn't bet)
Seat 7: riggedsh** folded before Flop (didn't bet)
Seat 8: o.miro folded before Flop (didn't bet)
Seat 9: matiko09 folded before Flop (didn't bet)





PokerStars Hand #154363037027:  Hold'em No Limit ($0.50/$1.00 USD) - 2016/06/06 12:40:52 CET [2016/06/06 6:40:52 ET]
Table 'Heze' 9-max Seat #4 is the button
Seat 1: matiko09 ($218.15 in chips) 
Seat 2: oscarleon ($241.81 in chips) 
Seat 3: xxxibgdrgn ($100 in chips) 
Seat 4: xxxZeka ($100 in chips) 
Seat 5: stds st ($40.50 in chips) 
Seat 6: ozone2003 ($113.57 in chips) 
Seat 8: AlSmithy88 ($49.56 in chips) 
Seat 9: Mr.Grigoriy ($125.70 in chips) 
stds st: posts small blind $0.50
ozone2003: posts big blind $1
32rrew: sits out 
*** HOLE CARDS ***
Dealt to matiko09 [3h 9s]
AlSmithy88: folds 
Mr.Grigoriy: folds 
matiko09: folds 
oscarleon: folds 
xxxibgdrgn: folds 
xxxZeka: raises $1.50 to $2.50
stds st: folds 
ozone2003: calls $1.50
*** FLOP *** [4s Qd Tc]
ozone2003: checks 
xxxZeka: checks 
*** TURN *** [4s Qd Tc] [2h]
ozone2003: checks 
xxxZeka: checks 
*** RIVER *** [4s Qd Tc 2h] [3s]
ozone2003: checks 
xxxZeka: checks 
*** SHOW DOWN ***
ozone2003: shows [Ad 3d] (a pair of Threes)
xxxZeka: mucks hand 
ozone2003 collected $5.22 from pot
*** SUMMARY ***
Total pot $5.50 | Rake $0.28 
Board [4s Qd Tc 2h 3s]
Seat 1: matiko09 folded before Flop (didn't bet)
Seat 2: oscarleon folded before Flop (didn't bet)
Seat 3: xxxibgdrgn folded before Flop (didn't bet)
Seat 4: xxxZeka (button) mucked [Ac 2s]
Seat 5: stds st (small blind) folded before Flop
Seat 6: ozone2003 (big blind) showed [Ad 3d] and won ($5.22) with a pair of Threes
Seat 8: AlSmithy88 folded before Flop (didn't bet)
Seat 9: Mr.Grigoriy folded before Flop (didn't bet)





PokerStars Hand #154363039332:  Hold'em No Limit (€0.50/€1.00 EUR) - 2016/06/06 12:40:57 CET [2016/06/06 6:40:57 ET]
Table 'Lesath' 9-max Seat #2 is the button
Seat 1: o.miro (€101.94 in chips) 
Seat 2: thecurv (€123.42 in chips) 
Seat 4: hammerwife (€119.98 in chips) 
Seat 5: matiko09 (€100 in chips) 
Seat 6: Szevasztopol (€100.74 in chips) 
Seat 7: Mr.Grigoriy (€100 in chips) 
Seat 8: maxxmeister (€154.72 in chips) 
Seat 9: 72nloses (€103.02 in chips) 
ozone2003 will be allowed to play after the button
hammerwife: posts small blind €0.50
matiko09: posts big blind €1
*** HOLE CARDS ***
Dealt to matiko09 [6h Qh]
Szevasztopol: folds 
Mr.Grigoriy: folds 
maxxmeister: folds 
72nloses: folds 
o.miro: folds 
thecurv: raises €1 to €2
hammerwife: folds 
matiko09: calls €1
*** FLOP *** [Jc 6c 7d]
matiko09: checks 
thecurv: bets €3
matiko09: folds 
Uncalled bet (€3) returned to thecurv
thecurv collected €4.28 from pot
thecurv: doesn't show hand 
*** SUMMARY ***
Total pot €4.50 | Rake €0.22 
Board [Jc 6c 7d]
Seat 1: o.miro folded before Flop (didn't bet)
Seat 2: thecurv (button) collected (€4.28)
Seat 4: hammerwife (small blind) folded before Flop
Seat 5: matiko09 (big blind) folded on the Flop
Seat 6: Szevasztopol folded before Flop (didn't bet)
Seat 7: Mr.Grigoriy folded before Flop (didn't bet)
Seat 8: maxxmeister folded before Flop (didn't bet)
Seat 9: 72nloses folded before Flop (didn't bet)





PokerStars Hand #154363048444:  Hold'em No Limit ($0.50/$1.00 USD) - 2016/06/06 12:41:20 CET [2016/06/06 6:41:20 ET]
Table 'Irmgard II' 9-max Seat #7 is the button
Seat 1: matiko09 ($146.50 in chips) 
Seat 2: hammerwife ($127.32 in chips) 
Seat 3: stds st ($44.48 in chips) 
Seat 4: oscarleon ($157.76 in chips) 
Seat 5: Mr.Grigoriy ($144.76 in chips) 
Seat 6: DancerNN1 ($100 in chips) 
Seat 7: 32rrew ($101.18 in chips) 
Seat 9: DONFILIPPO1 ($36.51 in chips) 
Szevasztopol will be allowed to play after the button
DONFILIPPO1: posts small blind $0.50
matiko09: posts big blind $1
DancerNN1: posts big blind $1
*** HOLE CARDS ***
Dealt to matiko09 [2d 5d]
hammerwife: raises $2.50 to $3.50
stds st: folds 
oscarleon: folds 
Mr.Grigoriy: folds 
DancerNN1: folds 
32rrew: folds 
DONFILIPPO1: folds 
matiko09: folds 
Uncalled bet ($2.50) returned to hammerwife
hammerwife collected $3.50 from pot
hammerwife: doesn't show hand 
*** SUMMARY ***
Total pot $3.50 | Rake $0 
Seat 1: matiko09 (big blind) folded before Flop
Seat 2: hammerwife collected ($3.50)
Seat 3: stds st folded before Flop (didn't bet)
Seat 4: oscarleon folded before Flop (didn't bet)
Seat 5: Mr.Grigoriy folded before Flop (didn't bet)
Seat 6: DancerNN1 folded before Flop
Seat 7: 32rrew (button) folded before Flop (didn't bet)
Seat 9: DONFILIPPO1 (small blind) folded before Flop





PokerStars Hand #154363050373:  Hold'em No Limit ($0.50/$1.00 USD) - 2016/06/06 12:41:25 CET [2016/06/06 6:41:25 ET]
Table 'Smither' 9-max Seat #5 is the button
Seat 1: PacPacBum ($109.40 in chips) 
Seat 2: matiko09 ($103.84 in chips) 
Seat 3: xxxZeka ($127.95 in chips) 
Seat 4: maxxmeister ($211.66 in chips) 
Seat 5: Szevasztopol ($100 in chips) 
Seat 6: riggedsh** ($107.78 in chips) 
Seat 8: 74 ROADIE ($89.50 in chips) 
Seat 9: hammerwife ($201.97 in chips) 
riggedsh**: posts small blind $0.50
74 ROADIE: posts big blind $1
*** HOLE CARDS ***
Dealt to matiko09 [6h 9d]
hammerwife: folds 
PacPacBum: folds 
matiko09: folds 
xxxZeka: folds 
maxxmeister: folds 
Mr.Grigoriy leaves the table
Szevasztopol: raises $1 to $2
riggedsh**: folds 
74 ROADIE: calls $1
*** FLOP *** [3s Ad Ac]
74 ROADIE: checks 
Szevasztopol: bets $1.45
74 ROADIE: folds 
Uncalled bet ($1.45) returned to Szevasztopol
Szevasztopol collected $4.28 from pot
Szevasztopol: doesn't show hand 
*** SUMMARY ***
Total pot $4.50 | Rake $0.22 
Board [3s Ad Ac]
Seat 1: PacPacBum folded before Flop (didn't bet)
Seat 2: matiko09 folded before Flop (didn't bet)
Seat 3: xxxZeka folded before Flop (didn't bet)
Seat 4: maxxmeister folded before Flop (didn't bet)
Seat 5: Szevasztopol (button) collected ($4.28)
Seat 6: riggedsh** (small blind) folded before Flop
Seat 8: 74 ROADIE (big blind) folded on the Flop
Seat 9: hammerwife folded before Flop (didn't bet)





PokerStars Hand #154363051193:  Hold'em No Limit ($0.50/$1.00 USD) - 2016/06/06 12:41:27 CET [2016/06/06 6:41:27 ET]
Table 'Titius' 9-max Seat #2 is the button
Seat 1: xxxZeka ($100 in chips) 
Seat 2: matiko09 ($100 in chips) 
Seat 3: vanilica ($100 in chips) 
Seat 4: ozone2003 ($100 in chips) 
Seat 5: riggedsh** ($199 in chips) 
Seat 6: oscarleon ($105.50 in chips) 
Seat 7: ardo888 ($100 in chips) 
Seat 8: DB3333 ($48.50 in chips) 
Seat 9: PacPacBum ($105.50 in chips) 
vanilica: posts small blind $0.50
ozone2003: posts big blind $1
*** HOLE CARDS ***
Dealt to matiko09 [6s 4c]
riggedsh**: folds 
oscarleon: folds 
ardo888: folds 
DB3333: calls $1
PacPacBum: raises $3 to $4
xxxZeka: folds 
matiko09: folds 
vanilica: folds 
ozone2003: folds 
DB3333: calls $3
*** FLOP *** [9s 6h Ad]
DB3333: checks 
PacPacBum: bets $3.15
DB3333: calls $3.15
*** TURN *** [9s 6h Ad] [3d]
DB3333: checks 
PacPacBum: checks 
*** RIVER *** [9s 6h Ad 3d] [Kd]
DB3333: bets $7
PacPacBum: calls $7
*** SHOW DOWN ***
DB3333: shows [Ah 8s] (a pair of Aces)
PacPacBum: mucks hand 
DB3333 collected $28.31 from pot
*** SUMMARY ***
Total pot $29.80 | Rake $1.49 
Board [9s 6h Ad 3d Kd]
Seat 1: xxxZeka folded before Flop (didn't bet)
Seat 2: matiko09 (button) folded before Flop (didn't bet)
Seat 3: vanilica (small blind) folded before Flop
Seat 4: ozone2003 (big blind) folded before Flop
Seat 5: riggedsh** folded before Flop (didn't bet)
Seat 6: oscarleon folded before Flop (didn't bet)
Seat 7: ardo888 folded before Flop (didn't bet)
Seat 8: DB3333 showed [Ah 8s] and won ($28.31) with a pair of Aces
Seat 9: PacPacBum mucked [Qc Kh]





PokerStars Hand #154363051392:  Hold'em No Limit ($0.50/$1.00 USD) - 2016/06/06 12:41:27 CET [2016/06/06 6:41:27 ET]
Table 'Williams' 9-max Seat #2 is the button
Seat 1: matiko09 ($189.79 in chips) 
Seat 2: PacPacBum ($112.90 in chips) 
Seat 3: granbunny ($62.30 in chips) 
Seat 4: Mr.Grigoriy ($100 in chips) 
Seat 7: kevinho109 ($65.08 in chips) 
Seat 8: oscarleon ($108.86 in chips) 
Seat 9: kind ten ($36.55 in chips) 
granbunny: posts small blind $0.50
Mr.Grigoriy: posts big blind $1
xxxibgdrgn: sits out 
xxxZeka: sits out 
*** HOLE CARDS ***
Dealt to matiko09 [Kc Ah]
kevinho109: folds 
oscarleon: folds 
kind ten: folds 
matiko09: raises $2 to $3
PacPacBum: folds 
granbunny: folds 
Mr.Grigoriy: folds 
Uncalled bet ($2) returned to matiko09
matiko09 collected $2.50 from pot
matiko09: doesn't show hand 
*** SUMMARY ***
Total pot $2.50 | Rake $0 
Seat 1: matiko09 collected ($2.50)
Seat 2: PacPacBum (button) folded before Flop (didn't bet)
Seat 3: granbunny (small blind) folded before Flop
Seat 4: Mr.Grigoriy (big blind) folded before Flop
Seat 7: kevinho109 folded before Flop (didn't bet)
Seat 8: oscarleon folded before Flop (didn't bet)
Seat 9: kind ten folded before Flop (didn't bet)





PokerStars Hand #154363052906:  Hold'em No Limit ($0.50/$1.00 USD) - 2016/06/06 12:41:31 CET [2016/06/06 6:41:31 ET]
Table 'Safara' 9-max Seat #6 is the button
Seat 1: oscarleon ($234.44 in chips) 
Seat 2: Szevasztopol ($101.50 in chips) 
Seat 3: ozone2003 ($100 in chips) 
Seat 5: Dantist1122 ($101.03 in chips) 
Seat 6: matiko09 ($121.78 in chips) 
Seat 7: PacPacBum ($100 in chips) 
Seat 8: 32rrew ($100 in chips) 
Seat 9: Mr.Grigoriy ($102.67 in chips) 
PacPacBum: posts small blind $0.50
32rrew: posts big blind $1
*** HOLE CARDS ***
Dealt to matiko09 [9h Tc]
Mr.Grigoriy: folds 
oscarleon: folds 
Szevasztopol: folds 
ozone2003: folds 
Dantist1122: folds 
matiko09: raises $1.27 to $2.27
PacPacBum: calls $1.77
32rrew: calls $1.27
*** FLOP *** [2h 8d Jc]
PacPacBum: checks 
32rrew: bets $4.31
matiko09: raises $8.69 to $13
PacPacBum: folds 
32rrew: folds 
Uncalled bet ($8.69) returned to matiko09
matiko09 collected $14.66 from pot
matiko09: doesn't show hand 
*** SUMMARY ***
Total pot $15.43 | Rake $0.77 
Board [2h 8d Jc]
Seat 1: oscarleon folded before Flop (didn't bet)
Seat 2: Szevasztopol folded before Flop (didn't bet)
Seat 3: ozone2003 folded before Flop (didn't bet)
Seat 5: Dantist1122 folded before Flop (didn't bet)
Seat 6: matiko09 (button) collected ($14.66)
Seat 7: PacPacBum (small blind) folded on the Flop
Seat 8: 32rrew (big blind) folded on the Flop
Seat 9: Mr.Grigoriy folded before Flop (didn't bet)





PokerStars Hand #154363053137:  Hold'em No Limit ($0.50/$1.00 USD) - 2016/06/06 12:41:32 CET [2016/06/06 6:41:32 ET]
Table 'Yarilo' 9-max Seat #8 is the button
Seat 1: xxxZeka ($100 in chips) 
Seat 2: nombraalne1 ($102 in chips) 
Seat 3: matiko09 ($135.06 in chips) 
Seat 5: Szevasztopol ($136.51 in chips) 
Seat 7: KEBIN1974 ($103.50 in chips) 
Seat 8: Mr.Grigoriy ($171.03 in chips) 
Seat 9: o.miro ($100 in chips) 
o.miro: posts small blind $0.50
xxxZeka: posts big blind $1
ozone2003: sits out 
*** HOLE CARDS ***
Dealt to matiko09 [9s 9h]
nombraalne1: folds 
matiko09: raises $2 to $3
Szevasztopol: folds 
KEBIN1974: folds 
Mr.Grigoriy: folds 
o.miro: folds 
xxxZeka: folds 
Uncalled bet ($2) returned to matiko09
matiko09 collected $2.50 from pot
matiko09: doesn't show hand 
stds st joins the table at seat #4 
*** SUMMARY ***
Total pot $2.50 | Rake $0 
Seat 1: xxxZeka (big blind) folded before Flop
Seat 2: nombraalne1 folded before Flop (didn't bet)
Seat 3: matiko09 collected ($2.50)
Seat 5: Szevasztopol folded before Flop (didn't bet)
Seat 7: KEBIN1974 folded before Flop (didn't bet)
Seat 8: Mr.Grigoriy (button) folded before Flop (didn't bet)
Seat 9: o.miro (small blind) folded before Flop





PokerStars Hand #154363054267:  Hold'em No Limit ($0.50/$1.00 USD) - 2016/06/06 12:41:34 CET [2016/06/06 6:41:34 ET]
Table 'Sheliak' 9-max Seat #3 is the button
Seat 1: 32rrew ($101 in chips) 
Seat 2: masaytoo ($98.50 in chips) 
Seat 3: oscarleon ($100 in chips) 
Seat 4: Soundust_007 ($78 in chips) 
Seat 5: vanilica ($100 in chips) 
Seat 6: matiko09 ($100 in chips) 
Seat 7: stds st ($40 in chips) 
Seat 8: djammusic ($40 in chips) 
Seat 9: nombraalne1 ($102.28 in chips) 
Soundust_007: posts small blind $0.50
vanilica: posts big blind $1
*** HOLE CARDS ***
Dealt to matiko09 [Kd Js]
matiko09: folds 
stds st: raises $1.50 to $2.50
djammusic: folds 
nombraalne1: folds 
32rrew: folds 
masaytoo: calls $2.50
oscarleon: folds 
Soundust_007: calls $2
vanilica: calls $1.50
*** FLOP *** [Jc 2d Qs]
Soundust_007: checks 
vanilica: checks 
stds st: checks 
masaytoo: checks 
*** TURN *** [Jc 2d Qs] [7h]
Soundust_007: checks 
vanilica: checks 
stds st: checks 
masaytoo: checks 
*** RIVER *** [Jc 2d Qs 7h] [2c]
Soundust_007: checks 
vanilica: checks 
stds st: checks 
masaytoo: checks 
*** SHOW DOWN ***
Soundust_007: shows [7s Ts] (two pair, Sevens and Deuces)
vanilica: shows [9d 9s] (two pair, Nines and Deuces)
stds st: mucks hand 
masaytoo: mucks hand 
vanilica collected $9.50 from pot
*** SUMMARY ***
Total pot $10 | Rake $0.50 
Board [Jc 2d Qs 7h 2c]
Seat 1: 32rrew folded before Flop (didn't bet)
Seat 2: masaytoo mucked [8d 8s]
Seat 3: oscarleon (button) folded before Flop (didn't bet)
Seat 4: Soundust_007 (small blind) showed [7s Ts] and lost with two pair, Sevens and Deuces
Seat 5: vanilica (big blind) showed [9d 9s] and won ($9.50) with two pair, Nines and Deuces
Seat 6: matiko09 folded before Flop (didn't bet)
Seat 7: stds st mucked [Ah 3h]
Seat 8: djammusic folded before Flop (didn't bet)
Seat 9: nombraalne1 folded before Flop (didn't bet)





PokerStars Hand #154363055845:  Hold'em No Limit ($0.50/$1.00 USD) - 2016/06/06 12:41:38 CET [2016/06/06 6:41:38 ET]
Table 'Gajdariya' 9-max Seat #9 is the button
Seat 1: matiko09 ($114.73 in chips) 
Seat 2: xxxZeka ($126.74 in chips) 
Seat 3: oscarleon ($113.55 in chips) 
Seat 4: Szevasztopol ($106.63 in chips) 
Seat 5: 147734319 ($99.51 in chips) 
Seat 6: mono123viva ($166.56 in chips) 
Seat 7: Wombatkilla ($99.42 in chips) 
Seat 8: ardo888 ($100 in chips) 
Seat 9: Mr.Grigoriy ($102.25 in chips) 
matiko09: posts small blind $0.50
xxxZeka: posts big blind $1
*** HOLE CARDS ***
Dealt to matiko09 [As 8s]
oscarleon: folds 
Szevasztopol: folds 
147734319: folds 
mono123viva: folds 
Wombatkilla: raises $2 to $3
ardo888: folds 
Mr.Grigoriy: folds 
matiko09: folds 
xxxZeka: folds 
Uncalled bet ($2) returned to Wombatkilla
Wombatkilla collected $2.50 from pot
*** SUMMARY ***
Total pot $2.50 | Rake $0 
Seat 1: matiko09 (small blind) folded before Flop
Seat 2: xxxZeka (big blind) folded before Flop
Seat 3: oscarleon folded before Flop (didn't bet)
Seat 4: Szevasztopol folded before Flop (didn't bet)
Seat 5: 147734319 folded before Flop (didn't bet)
Seat 6: mono123viva folded before Flop (didn't bet)
Seat 7: Wombatkilla collected ($2.50)
Seat 8: ardo888 folded before Flop (didn't bet)
Seat 9: Mr.Grigoriy (button) folded before Flop (didn't bet)





PokerStars Hand #154363056218:  Hold'em No Limit ($0.50/$1.00 USD) - 2016/06/06 12:41:39 CET [2016/06/06 6:41:39 ET]
Table 'Wezen II' 9-max Seat #3 is the button
Seat 1: matiko09 ($162.47 in chips) 
Seat 2: Mr.Grigoriy ($106.68 in chips) 
Seat 3: oscarleon ($100 in chips) 
Seat 4: xxxibgdrgn ($100 in chips) 
Seat 5: stds st ($36.20 in chips) 
Seat 7: KDJAll3 ($82.06 in chips) 
Seat 8: mavin80 ($173.22 in chips) 
xxxibgdrgn: posts small blind $0.50
stds st: posts big blind $1
masaytoo: sits out 
PacPacBum: sits out 
*** HOLE CARDS ***
Dealt to matiko09 [8s 4h]
KDJAll3: folds 
mavin80: folds 
matiko09: folds 
Mr.Grigoriy: folds 
oscarleon: folds 
xxxibgdrgn: raises $2 to $3
stds st: calls $2
*** FLOP *** [9d 2c 4c]
xxxibgdrgn: bets $4
stds st: calls $4
*** TURN *** [9d 2c 4c] [Kd]
xxxibgdrgn: bets $9
stds st: raises $20.20 to $29.20 and is all-in
xxxibgdrgn: folds 
Uncalled bet ($20.20) returned to stds st
stds st collected $30.40 from pot
stds st: doesn't show hand 
*** SUMMARY ***
Total pot $32 | Rake $1.60 
Board [9d 2c 4c Kd]
Seat 1: matiko09 folded before Flop (didn't bet)
Seat 2: Mr.Grigoriy folded before Flop (didn't bet)
Seat 3: oscarleon (button) folded before Flop (didn't bet)
Seat 4: xxxibgdrgn (small blind) folded on the Turn
Seat 5: stds st (big blind) collected ($30.40)
Seat 7: KDJAll3 folded before Flop (didn't bet)
Seat 8: mavin80 folded before Flop (didn't bet)





PokerStars Hand #154363059559:  Hold'em No Limit ($0.50/$1.00 USD) - 2016/06/06 12:41:47 CET [2016/06/06 6:41:47 ET]
Table 'Williams' 9-max Seat #3 is the button
Seat 1: matiko09 ($191.29 in chips) 
Seat 2: PacPacBum ($112.90 in chips) 
Seat 3: granbunny ($61.80 in chips) 
Seat 4: Mr.Grigoriy ($100 in chips) 
Seat 5: xxxibgdrgn ($100 in chips) 
Seat 7: kevinho109 ($65.08 in chips) 
Seat 8: oscarleon ($108.86 in chips) 
Seat 9: kind ten ($36.55 in chips) 
Mr.Grigoriy: posts small blind $0.50
xxxibgdrgn: posts big blind $1
xxxZeka: sits out 
*** HOLE CARDS ***
Dealt to matiko09 [Td Th]
kevinho109: raises $2 to $3
oscarleon: folds 
kind ten: raises $6 to $9
matiko09: folds 
PacPacBum: folds 
granbunny: folds 
Mr.Grigoriy: folds 
xxxibgdrgn: folds 
kevinho109: calls $6
*** FLOP *** [Kc Kd 2d]
kevinho109: checks 
kind ten: bets $9
kevinho109: folds 
Uncalled bet ($9) returned to kind ten
kind ten collected $18.52 from pot
kind ten: doesn't show hand 
*** SUMMARY ***
Total pot $19.50 | Rake $0.98 
Board [Kc Kd 2d]
Seat 1: matiko09 folded before Flop (didn't bet)
Seat 2: PacPacBum folded before Flop (didn't bet)
Seat 3: granbunny (button) folded before Flop (didn't bet)
Seat 4: Mr.Grigoriy (small blind) folded before Flop
Seat 5: xxxibgdrgn (big blind) folded before Flop
Seat 7: kevinho109 folded on the Flop
Seat 8: oscarleon folded before Flop (didn't bet)
Seat 9: kind ten collected ($18.52)





PokerStars Hand #154363061921:  Hold'em No Limit ($0.50/$1.00 USD) - 2016/06/06 12:41:53 CET [2016/06/06 6:41:53 ET]
Table 'Irmgard II' 9-max Seat #9 is the button
Seat 1: matiko09 ($145.50 in chips) 
Seat 2: hammerwife ($129.82 in chips) 
Seat 3: stds st ($44.48 in chips) 
Seat 4: oscarleon ($157.76 in chips) 
Seat 5: Mr.Grigoriy ($144.76 in chips) 
Seat 6: DancerNN1 ($100 in chips) 
Seat 7: 32rrew ($101.18 in chips) 
Seat 9: DONFILIPPO1 ($36.01 in chips) 
matiko09: posts small blind $0.50
hammerwife: posts big blind $1
Szevasztopol: sits out 
*** HOLE CARDS ***
Dealt to matiko09 [3s Tc]
stds st: folds 
oscarleon: raises $2 to $3
Mr.Grigoriy: folds 
DancerNN1: folds 
32rrew: calls $3
DONFILIPPO1: calls $3
matiko09: folds 
hammerwife: folds 
*** FLOP *** [9h Qd 6s]
oscarleon: bets $7
32rrew: calls $7
DONFILIPPO1: raises $10 to $17
oscarleon: folds 
32rrew: raises $27 to $44
DONFILIPPO1: calls $16.01 and is all-in
Uncalled bet ($10.99) returned to 32rrew
*** TURN *** [9h Qd 6s] [Td]
*** RIVER *** [9h Qd 6s Td] [Th]
*** SHOW DOWN ***
32rrew: shows [Ac Qs] (two pair, Queens and Tens)
DONFILIPPO1: mucks hand 
32rrew collected $81.02 from pot
*** SUMMARY ***
Total pot $83.52 | Rake $2.50 
Board [9h Qd 6s Td Th]
Seat 1: matiko09 (small blind) folded before Flop
Seat 2: hammerwife (big blind) folded before Flop
Seat 3: stds st folded before Flop (didn't bet)
Seat 4: oscarleon folded on the Flop
Seat 5: Mr.Grigoriy folded before Flop (didn't bet)
Seat 6: DancerNN1 folded before Flop (didn't bet)
Seat 7: 32rrew showed [Ac Qs] and won ($81.02) with two pair, Queens and Tens
Seat 9: DONFILIPPO1 (button) mucked [Qh Jh]





PokerStars Hand #154363062378:  Hold'em No Limit ($0.50/$1.00 USD) - 2016/06/06 12:41:54 CET [2016/06/06 6:41:54 ET]
Table 'Yarilo' 9-max Seat #9 is the button
Seat 1: xxxZeka ($100 in chips) 
Seat 2: nombraalne1 ($102 in chips) 
Seat 3: matiko09 ($136.56 in chips) 
Seat 5: Szevasztopol ($136.51 in chips) 
Seat 7: KEBIN1974 ($103.50 in chips) 
Seat 8: Mr.Grigoriy ($171.03 in chips) 
Seat 9: o.miro ($100 in chips) 
xxxZeka: posts small blind $0.50
nombraalne1: posts big blind $1
stds st: sits out 
ozone2003: sits out 
*** HOLE CARDS ***
Dealt to matiko09 [3c 2d]
matiko09: folds 
Szevasztopol: raises $1.14 to $2.14
KEBIN1974: folds 
Mr.Grigoriy: folds 
o.miro: calls $2.14
xxxZeka: folds 
nombraalne1: folds 
*** FLOP *** [2s 2h 9c]
Szevasztopol: bets $3.62
o.miro: folds 
Uncalled bet ($3.62) returned to Szevasztopol
Szevasztopol collected $5.49 from pot
Szevasztopol: doesn't show hand 
*** SUMMARY ***
Total pot $5.78 | Rake $0.29 
Board [2s 2h 9c]
Seat 1: xxxZeka (small blind) folded before Flop
Seat 2: nombraalne1 (big blind) folded before Flop
Seat 3: matiko09 folded before Flop (didn't bet)
Seat 5: Szevasztopol collected ($5.49)
Seat 7: KEBIN1974 folded before Flop (didn't bet)
Seat 8: Mr.Grigoriy folded before Flop (didn't bet)
Seat 9: o.miro (button) folded on the Flop





PokerStars Hand #154363065603:  Hold'em No Limit ($0.50/$1.00 USD) - 2016/06/06 12:42:02 CET [2016/06/06 6:42:02 ET]
Table 'Chaldaea II' 9-max Seat #4 is the button
Seat 1: xxxZeka ($103.09 in chips) 
Seat 2: masaytoo ($98.76 in chips) 
Seat 3: ardo888 ($111.11 in chips) 
Seat 4: ozone2003 ($118.71 in chips) 
Seat 5: MiiiTCHy__ ($57.66 in chips) 
Seat 6: PacPacBum ($100 in chips) 
Seat 7: riggedsh** ($141.88 in chips) 
Seat 8: o.miro ($111 in chips) 
Seat 9: matiko09 ($106 in chips) 
MiiiTCHy__: posts small blind $0.50
PacPacBum: posts big blind $1
*** HOLE CARDS ***
Dealt to matiko09 [2d 2h]
riggedsh**: folds 
o.miro: folds 
matiko09: raises $2 to $3
xxxZeka: calls $3
masaytoo: folds 
ardo888: folds 
ozone2003: folds 
MiiiTCHy__: folds 
PacPacBum: folds 
*** FLOP *** [Kc Ts 7h]
matiko09: checks 
xxxZeka: checks 
*** TURN *** [Kc Ts 7h] [3s]
matiko09: checks 
xxxZeka: bets $4.74
matiko09: folds 
Uncalled bet ($4.74) returned to xxxZeka
xxxZeka collected $7.12 from pot
*** SUMMARY ***
Total pot $7.50 | Rake $0.38 
Board [Kc Ts 7h 3s]
Seat 1: xxxZeka collected ($7.12)
Seat 2: masaytoo folded before Flop (didn't bet)
Seat 3: ardo888 folded before Flop (didn't bet)
Seat 4: ozone2003 (button) folded before Flop (didn't bet)
Seat 5: MiiiTCHy__ (small blind) folded before Flop
Seat 6: PacPacBum (big blind) folded before Flop
Seat 7: riggedsh** folded before Flop (didn't bet)
Seat 8: o.miro folded before Flop (didn't bet)
Seat 9: matiko09 folded on the Turn





PokerStars Hand #154363069851:  Hold'em No Limit ($0.50/$1.00 USD) - 2016/06/06 12:42:13 CET [2016/06/06 6:42:13 ET]
Table 'Gajdariya' 9-max Seat #1 is the button
Seat 1: matiko09 ($114.23 in chips) 
Seat 2: xxxZeka ($125.74 in chips) 
Seat 3: oscarleon ($113.55 in chips) 
Seat 4: Szevasztopol ($106.63 in chips) 
Seat 5: 147734319 ($99.51 in chips) 
Seat 6: mono123viva ($166.56 in chips) 
Seat 7: Wombatkilla ($100.92 in chips) 
Seat 8: ardo888 ($100 in chips) 
Seat 9: Mr.Grigoriy ($102.25 in chips) 
xxxZeka: posts small blind $0.50
oscarleon: posts big blind $1
*** HOLE CARDS ***
Dealt to matiko09 [8d 9s]
Szevasztopol: folds 
147734319: folds 
mono123viva: folds 
Wombatkilla: raises $2 to $3
ardo888: folds 
Mr.Grigoriy: folds 
matiko09: folds 
xxxZeka: folds 
oscarleon: folds 
Uncalled bet ($2) returned to Wombatkilla
Wombatkilla collected $2.50 from pot
*** SUMMARY ***
Total pot $2.50 | Rake $0 
Seat 1: matiko09 (button) folded before Flop (didn't bet)
Seat 2: xxxZeka (small blind) folded before Flop
Seat 3: oscarleon (big blind) folded before Flop
Seat 4: Szevasztopol folded before Flop (didn't bet)
Seat 5: 147734319 folded before Flop (didn't bet)
Seat 6: mono123viva folded before Flop (didn't bet)
Seat 7: Wombatkilla collected ($2.50)
Seat 8: ardo888 folded before Flop (didn't bet)
Seat 9: Mr.Grigoriy folded before Flop (didn't bet)





PokerStars Hand #154363070417:  Hold'em No Limit (€0.50/€1.00 EUR) - 2016/06/06 12:42:14 CET [2016/06/06 6:42:14 ET]
Table 'Lesath' 9-max Seat #4 is the button
Seat 1: o.miro (€101.94 in chips) 
Seat 2: thecurv (€125.70 in chips) 
Seat 4: hammerwife (€119.48 in chips) 
Seat 5: matiko09 (€100 in chips) 
Seat 6: Szevasztopol (€100.74 in chips) 
Seat 7: Mr.Grigoriy (€100 in chips) 
Seat 8: maxxmeister (€154.72 in chips) 
Seat 9: 72nloses (€103.02 in chips) 
matiko09: posts small blind €0.50
Szevasztopol: posts big blind €1
ozone2003: sits out 
*** HOLE CARDS ***
Dealt to matiko09 [Td Kh]
Mr.Grigoriy: folds 
maxxmeister: folds 
72nloses: folds 
o.miro: folds 
thecurv: folds 
hammerwife: raises €1.01 to €2.01
matiko09: folds 
Szevasztopol: calls €1.01
*** FLOP *** [4c 6c 3h]
Szevasztopol: checks 
hammerwife: bets €2.14
Szevasztopol: folds 
Uncalled bet (€2.14) returned to hammerwife
hammerwife collected €4.29 from pot
hammerwife: doesn't show hand 
*** SUMMARY ***
Total pot €4.52 | Rake €0.23 
Board [4c 6c 3h]
Seat 1: o.miro folded before Flop (didn't bet)
Seat 2: thecurv folded before Flop (didn't bet)
Seat 4: hammerwife (button) collected (€4.29)
Seat 5: matiko09 (small blind) folded before Flop
Seat 6: Szevasztopol (big blind) folded on the Flop
Seat 7: Mr.Grigoriy folded before Flop (didn't bet)
Seat 8: maxxmeister folded before Flop (didn't bet)
Seat 9: 72nloses folded before Flop (didn't bet)





PokerStars Hand #154363073621:  Hold'em No Limit ($0.50/$1.00 USD) - 2016/06/06 12:42:22 CET [2016/06/06 6:42:22 ET]
Table 'Smither' 9-max Seat #6 is the button
Seat 1: PacPacBum ($109.40 in chips) 
Seat 2: matiko09 ($103.84 in chips) 
Seat 3: xxxZeka ($127.95 in chips) 
Seat 4: maxxmeister ($211.66 in chips) 
Seat 5: Szevasztopol ($102.28 in chips) 
Seat 6: riggedsh** ($107.28 in chips) 
Seat 8: 74 ROADIE ($87.50 in chips) 
Seat 9: hammerwife ($201.97 in chips) 
74 ROADIE: posts small blind $0.50
hammerwife: posts big blind $1
*** HOLE CARDS ***
Dealt to matiko09 [9s 4c]
PacPacBum: folds 
matiko09: folds 
xxxZeka: raises $2 to $3
maxxmeister: folds 
Szevasztopol: folds 
riggedsh**: folds 
74 ROADIE: folds 
hammerwife: folds 
Uncalled bet ($2) returned to xxxZeka
xxxZeka collected $2.50 from pot
*** SUMMARY ***
Total pot $2.50 | Rake $0 
Seat 1: PacPacBum folded before Flop (didn't bet)
Seat 2: matiko09 folded before Flop (didn't bet)
Seat 3: xxxZeka collected ($2.50)
Seat 4: maxxmeister folded before Flop (didn't bet)
Seat 5: Szevasztopol folded before Flop (didn't bet)
Seat 6: riggedsh** (button) folded before Flop (didn't bet)
Seat 8: 74 ROADIE (small blind) folded before Flop
Seat 9: hammerwife (big blind) folded before Flop





PokerStars Hand #154363078669:  Hold'em No Limit ($0.50/$1.00 USD) - 2016/06/06 12:42:35 CET [2016/06/06 6:42:35 ET]
Table 'Titius' 9-max Seat #3 is the button
Seat 1: xxxZeka ($100 in chips) 
Seat 2: matiko09 ($100 in chips) 
Seat 3: vanilica ($100 in chips) 
Seat 4: ozone2003 ($100 in chips) 
Seat 5: riggedsh** ($199 in chips) 
Seat 6: oscarleon ($105.50 in chips) 
Seat 7: ardo888 ($100 in chips) 
Seat 8: DB3333 ($62.66 in chips) 
Seat 9: PacPacBum ($100 in chips) 
ozone2003: posts small blind $0.50
riggedsh**: posts big blind $1
*** HOLE CARDS ***
Dealt to matiko09 [8d Qc]
oscarleon: folds 
ardo888: folds 
DB3333: calls $1
PacPacBum: folds 
xxxZeka: raises $3.50 to $4.50
matiko09: folds 
vanilica: folds 
ozone2003: folds 
riggedsh**: folds 
DB3333: calls $3.50
*** FLOP *** [5s 2c Ad]
DB3333: bets $5
xxxZeka: raises $9.99 to $14.99
DB3333: folds 
Uncalled bet ($9.99) returned to xxxZeka
xxxZeka collected $19.48 from pot
*** SUMMARY ***
Total pot $20.50 | Rake $1.02 
Board [5s 2c Ad]
Seat 1: xxxZeka collected ($19.48)
Seat 2: matiko09 folded before Flop (didn't bet)
Seat 3: vanilica (button) folded before Flop (didn't bet)
Seat 4: ozone2003 (small blind) folded before Flop
Seat 5: riggedsh** (big blind) folded before Flop
Seat 6: oscarleon folded before Flop (didn't bet)
Seat 7: ardo888 folded before Flop (didn't bet)
Seat 8: DB3333 folded on the Flop
Seat 9: PacPacBum folded before Flop (didn't bet)





PokerStars Hand #154363080693:  Hold'em No Limit ($0.50/$1.00 USD) - 2016/06/06 12:42:40 CET [2016/06/06 6:42:40 ET]
Table 'Williams' 9-max Seat #4 is the button
Seat 1: matiko09 ($191.29 in chips) 
Seat 2: PacPacBum ($112.90 in chips) 
Seat 3: granbunny ($61.80 in chips) 
Seat 4: Mr.Grigoriy ($100 in chips) 
Seat 5: xxxibgdrgn ($100 in chips) 
Seat 6: xxxZeka ($100 in chips) 
Seat 7: kevinho109 ($56.08 in chips) 
Seat 8: oscarleon ($108.86 in chips) 
Seat 9: kind ten ($46.07 in chips) 
xxxibgdrgn: posts small blind $0.50
xxxZeka: posts big blind $1
*** HOLE CARDS ***
Dealt to matiko09 [Th 2d]
kevinho109: folds 
oscarleon: folds 
kind ten: folds 
matiko09: folds 
PacPacBum: folds 
granbunny: folds 
Mr.Grigoriy: folds 
xxxibgdrgn: raises $2 to $3
xxxZeka: folds 
Uncalled bet ($2) returned to xxxibgdrgn
xxxibgdrgn collected $2 from pot
xxxibgdrgn: doesn't show hand 
*** SUMMARY ***
Total pot $2 | Rake $0 
Seat 1: matiko09 folded before Flop (didn't bet)
Seat 2: PacPacBum folded before Flop (didn't bet)
Seat 3: granbunny folded before Flop (didn't bet)
Seat 4: Mr.Grigoriy (button) folded before Flop (didn't bet)
Seat 5: xxxibgdrgn (small blind) collected ($2)
Seat 6: xxxZeka (big blind) folded before Flop
Seat 7: kevinho109 folded before Flop (didn't bet)
Seat 8: oscarleon folded before Flop (didn't bet)
Seat 9: kind ten folded before Flop (didn't bet)





PokerStars Hand #154363081994:  Hold'em No Limit ($0.50/$1.00 USD) - 2016/06/06 12:42:43 CET [2016/06/06 6:42:43 ET]
Table 'Smither' 9-max Seat #8 is the button
Seat 1: PacPacBum ($109.40 in chips) 
Seat 2: matiko09 ($103.84 in chips) 
Seat 3: xxxZeka ($129.45 in chips) 
Seat 4: maxxmeister ($211.66 in chips) 
Seat 5: Szevasztopol ($102.28 in chips) 
Seat 6: riggedsh** ($107.28 in chips) 
Seat 8: 74 ROADIE ($87 in chips) 
Seat 9: hammerwife ($200.97 in chips) 
hammerwife: posts small blind $0.50
PacPacBum: posts big blind $1
*** HOLE CARDS ***
Dealt to matiko09 [2d 7d]
matiko09: folds 
xxxZeka: raises $2 to $3
maxxmeister: calls $3
Szevasztopol: folds 
riggedsh**: folds 
74 ROADIE: folds 
hammerwife: folds 
PacPacBum: folds 
*** FLOP *** [Th 9d Kd]
vanilica joins the table at seat #7 
xxxZeka: checks 
maxxmeister: checks 
*** TURN *** [Th 9d Kd] [9h]
xxxZeka: bets $4.74
maxxmeister: folds 
Uncalled bet ($4.74) returned to xxxZeka
xxxZeka collected $7.12 from pot
*** SUMMARY ***
Total pot $7.50 | Rake $0.38 
Board [Th 9d Kd 9h]
Seat 1: PacPacBum (big blind) folded before Flop
Seat 2: matiko09 folded before Flop (didn't bet)
Seat 3: xxxZeka collected ($7.12)
Seat 4: maxxmeister folded on the Turn
Seat 5: Szevasztopol folded before Flop (didn't bet)
Seat 6: riggedsh** folded before Flop (didn't bet)
Seat 8: 74 ROADIE (button) folded before Flop (didn't bet)
Seat 9: hammerwife (small blind) folded before Flop





PokerStars Hand #154363086850:  Hold'em No Limit ($0.50/$1.00 USD) - 2016/06/06 12:42:55 CET [2016/06/06 6:42:55 ET]
Table 'Wezen II' 9-max Seat #4 is the button
Seat 1: matiko09 ($162.47 in chips) 
Seat 2: Mr.Grigoriy ($106.68 in chips) 
Seat 3: oscarleon ($100 in chips) 
Seat 4: xxxibgdrgn ($100 in chips) 
Seat 5: stds st ($50.60 in chips) 
Seat 6: masaytoo ($100 in chips) 
Seat 7: KDJAll3 ($82.06 in chips) 
Seat 8: mavin80 ($173.22 in chips) 
stds st: posts small blind $0.50
masaytoo: posts big blind $1
PacPacBum: sits out 
*** HOLE CARDS ***
Dealt to matiko09 [9c Ad]
KDJAll3: folds 
mavin80: folds 
matiko09: folds 
Mr.Grigoriy: folds 
oscarleon: raises $2 to $3
xxxibgdrgn: folds 
stds st: folds 
masaytoo: folds 
Uncalled bet ($2) returned to oscarleon
oscarleon collected $2.50 from pot
oscarleon: doesn't show hand 
*** SUMMARY ***
Total pot $2.50 | Rake $0 
Seat 1: matiko09 folded before Flop (didn't bet)
Seat 2: Mr.Grigoriy folded before Flop (didn't bet)
Seat 3: oscarleon collected ($2.50)
Seat 4: xxxibgdrgn (button) folded before Flop (didn't bet)
Seat 5: stds st (small blind) folded before Flop
Seat 6: masaytoo (big blind) folded before Flop
Seat 7: KDJAll3 folded before Flop (didn't bet)
Seat 8: mavin80 folded before Flop (didn't bet)





PokerStars Hand #154363087017:  Hold'em No Limit ($0.50/$1.00 USD) - 2016/06/06 12:42:56 CET [2016/06/06 6:42:56 ET]
Table 'Yarilo' 9-max Seat #1 is the button
Seat 1: xxxZeka ($100 in chips) 
Seat 2: nombraalne1 ($101 in chips) 
Seat 3: matiko09 ($136.56 in chips) 
Seat 5: Szevasztopol ($139.86 in chips) 
Seat 7: KEBIN1974 ($103.50 in chips) 
Seat 8: Mr.Grigoriy ($171.03 in chips) 
Seat 9: o.miro ($100 in chips) 
nombraalne1: posts small blind $0.50
matiko09: posts big blind $1
stds st: sits out 
ozone2003: sits out 
*** HOLE CARDS ***
Dealt to matiko09 [6s 8d]
Szevasztopol: folds 
KEBIN1974: folds 
Mr.Grigoriy: folds 
o.miro: folds 
xxxZeka: folds 
nombraalne1: raises $1 to $2
matiko09: raises $6 to $8
nombraalne1: calls $6
*** FLOP *** [Ks 8c 4h]
nombraalne1: checks 
matiko09: bets $4.71
nombraalne1: calls $4.71
*** TURN *** [Ks 8c 4h] [Qs]
nombraalne1: checks 
matiko09: checks 
*** RIVER *** [Ks 8c 4h Qs] [Ad]
nombraalne1: checks 
matiko09: checks 
*** SHOW DOWN ***
nombraalne1: shows [9h Kh] (a pair of Kings)
matiko09: mucks hand 
nombraalne1 collected $24.15 from pot
*** SUMMARY ***
Total pot $25.42 | Rake $1.27 
Board [Ks 8c 4h Qs Ad]
Seat 1: xxxZeka (button) folded before Flop (didn't bet)
Seat 2: nombraalne1 (small blind) showed [9h Kh] and won ($24.15) with a pair of Kings
Seat 3: matiko09 (big blind) mucked [6s 8d]
Seat 5: Szevasztopol folded before Flop (didn't bet)
Seat 7: KEBIN1974 folded before Flop (didn't bet)
Seat 8: Mr.Grigoriy folded before Flop (didn't bet)
Seat 9: o.miro folded before Flop (didn't bet)





PokerStars Hand #154363088250:  Hold'em No Limit ($0.50/$1.00 USD) - 2016/06/06 12:42:59 CET [2016/06/06 6:42:59 ET]
Table 'Safara' 9-max Seat #7 is the button
Seat 1: oscarleon ($234.44 in chips) 
Seat 2: Szevasztopol ($101.50 in chips) 
Seat 3: ozone2003 ($100 in chips) 
Seat 5: Dantist1122 ($101.03 in chips) 
Seat 6: matiko09 ($129.86 in chips) 
Seat 7: PacPacBum ($100 in chips) 
Seat 8: 32rrew ($100 in chips) 
Seat 9: Mr.Grigoriy ($102.67 in chips) 
32rrew: posts small blind $0.50
Mr.Grigoriy: posts big blind $1
*** HOLE CARDS ***
Dealt to matiko09 [4h Kd]
oscarleon: raises $2 to $3
Szevasztopol: folds 
ozone2003: folds 
Dantist1122: folds 
matiko09: folds 
PacPacBum: folds 
32rrew: folds 
Mr.Grigoriy: folds 
Uncalled bet ($2) returned to oscarleon
oscarleon collected $2.50 from pot
oscarleon: doesn't show hand 
*** SUMMARY ***
Total pot $2.50 | Rake $0 
Seat 1: oscarleon collected ($2.50)
Seat 2: Szevasztopol folded before Flop (didn't bet)
Seat 3: ozone2003 folded before Flop (didn't bet)
Seat 5: Dantist1122 folded before Flop (didn't bet)
Seat 6: matiko09 folded before Flop (didn't bet)
Seat 7: PacPacBum (button) folded before Flop (didn't bet)
Seat 8: 32rrew (small blind) folded before Flop
Seat 9: Mr.Grigoriy (big blind) folded before Flop





PokerStars Hand #154363088790:  Hold'em No Limit ($0.50/$1.00 USD) - 2016/06/06 12:43:00 CET [2016/06/06 6:43:00 ET]
Table 'Sheliak' 9-max Seat #4 is the button
Seat 1: 32rrew ($101 in chips) 
Seat 2: masaytoo ($96 in chips) 
Seat 3: oscarleon ($100 in chips) 
Seat 4: Soundust_007 ($75.50 in chips) 
Seat 5: vanilica ($107 in chips) 
Seat 6: matiko09 ($100 in chips) 
Seat 7: stds st ($37.50 in chips) 
Seat 8: djammusic ($40 in chips) 
Seat 9: nombraalne1 ($102.28 in chips) 
vanilica: posts small blind $0.50
matiko09: posts big blind $1
*** HOLE CARDS ***
Dealt to matiko09 [6s 4h]
stds st: folds 
djammusic: folds 
nombraalne1: folds 
32rrew: folds 
masaytoo: folds 
oscarleon: folds 
Soundust_007: folds 
vanilica: raises $2 to $3
matiko09: folds 
Uncalled bet ($2) returned to vanilica
vanilica collected $2 from pot
vanilica: doesn't show hand 
*** SUMMARY ***
Total pot $2 | Rake $0 
Seat 1: 32rrew folded before Flop (didn't bet)
Seat 2: masaytoo folded before Flop (didn't bet)
Seat 3: oscarleon folded before Flop (didn't bet)
Seat 4: Soundust_007 (button) folded before Flop (didn't bet)
Seat 5: vanilica (small blind) collected ($2)
Seat 6: matiko09 (big blind) folded before Flop
Seat 7: stds st folded before Flop (didn't bet)
Seat 8: djammusic folded before Flop (didn't bet)
Seat 9: nombraalne1 folded before Flop (didn't bet)





PokerStars Hand #154363088787:  Hold'em No Limit ($0.50/$1.00 USD) - 2016/06/06 12:43:00 CET [2016/06/06 6:43:00 ET]
Table 'Heze' 9-max Seat #5 is the button
Seat 1: matiko09 ($218.15 in chips) 
Seat 2: oscarleon ($241.81 in chips) 
Seat 3: xxxibgdrgn ($100 in chips) 
Seat 4: xxxZeka ($100 in chips) 
Seat 5: stds st ($40 in chips) 
Seat 6: ozone2003 ($116.29 in chips) 
Seat 7: 32rrew ($100 in chips) 
Seat 8: AlSmithy88 ($49.56 in chips) 
Seat 9: Mr.Grigoriy ($125.70 in chips) 
ozone2003: posts small blind $0.50
32rrew: posts big blind $1
*** HOLE CARDS ***
Dealt to matiko09 [5c Ad]
AlSmithy88: calls $1
Mr.Grigoriy: calls $1
matiko09: folds 
oscarleon: folds 
xxxibgdrgn: folds 
xxxZeka: raises $4 to $5
stds st: folds 
ozone2003: folds 
32rrew: folds 
AlSmithy88: calls $4
Mr.Grigoriy: calls $4
*** FLOP *** [Kc Js 6s]
AlSmithy88: checks 
Mr.Grigoriy: checks 
xxxZeka: bets $11
AlSmithy88: folds 
Mr.Grigoriy: folds 
Uncalled bet ($11) returned to xxxZeka
xxxZeka collected $15.68 from pot
*** SUMMARY ***
Total pot $16.50 | Rake $0.82 
Board [Kc Js 6s]
Seat 1: matiko09 folded before Flop (didn't bet)
Seat 2: oscarleon folded before Flop (didn't bet)
Seat 3: xxxibgdrgn folded before Flop (didn't bet)
Seat 4: xxxZeka collected ($15.68)
Seat 5: stds st (button) folded before Flop (didn't bet)
Seat 6: ozone2003 (small blind) folded before Flop
Seat 7: 32rrew (big blind) folded before Flop
Seat 8: AlSmithy88 folded on the Flop
Seat 9: Mr.Grigoriy folded on the Flop





PokerStars Hand #154363089752:  Hold'em No Limit ($0.50/$1.00 USD) - 2016/06/06 12:43:02 CET [2016/06/06 6:43:02 ET]
Table 'Irmgard II' 9-max Seat #1 is the button
Seat 1: matiko09 ($145 in chips) 
Seat 2: hammerwife ($128.82 in chips) 
Seat 3: stds st ($44.48 in chips) 
Seat 4: oscarleon ($147.76 in chips) 
Seat 5: Mr.Grigoriy ($144.76 in chips) 
Seat 6: DancerNN1 ($100 in chips) 
Seat 7: 32rrew ($146.19 in chips) 
hammerwife: posts small blind $0.50
stds st: posts big blind $1
Szevasztopol: sits out 
*** HOLE CARDS ***
Dealt to matiko09 [As Ts]
DONFILIPPO1 leaves the table
oscarleon: folds 
Mr.Grigoriy: folds 
DancerNN1: folds 
PacPacBum joins the table at seat #9 
32rrew has timed out
32rrew: folds 
matiko09: raises $1.27 to $2.27
hammerwife: raises $5.73 to $8
stds st: folds 
matiko09: calls $5.73
*** FLOP *** [6s 9d 4c]
hammerwife: bets $6
matiko09: calls $6
*** TURN *** [6s 9d 4c] [8d]
hammerwife: checks 
matiko09: checks 
*** RIVER *** [6s 9d 4c 8d] [5h]
hammerwife: checks 
matiko09: checks 
*** SHOW DOWN ***
hammerwife: shows [Qc Kd] (high card King)
matiko09: shows [As Ts] (high card Ace)
matiko09 collected $27.55 from pot
*** SUMMARY ***
Total pot $29 | Rake $1.45 
Board [6s 9d 4c 8d 5h]
Seat 1: matiko09 (button) showed [As Ts] and won ($27.55) with high card Ace
Seat 2: hammerwife (small blind) showed [Qc Kd] and lost with high card King
Seat 3: stds st (big blind) folded before Flop
Seat 4: oscarleon folded before Flop (didn't bet)
Seat 5: Mr.Grigoriy folded before Flop (didn't bet)
Seat 6: DancerNN1 folded before Flop (didn't bet)
Seat 7: 32rrew folded before Flop (didn't bet)





PokerStars Hand #154363090736:  Hold'em No Limit ($0.50/$1.00 USD) - 2016/06/06 12:43:05 CET [2016/06/06 6:43:05 ET]
Table 'Gajdariya' 9-max Seat #2 is the button
Seat 1: matiko09 ($114.23 in chips) 
Seat 2: xxxZeka ($125.24 in chips) 
Seat 3: oscarleon ($112.55 in chips) 
Seat 4: Szevasztopol ($106.63 in chips) 
Seat 5: 147734319 ($99.51 in chips) 
Seat 6: mono123viva ($166.56 in chips) 
Seat 7: Wombatkilla ($102.42 in chips) 
Seat 8: ardo888 ($100 in chips) 
Seat 9: Mr.Grigoriy ($102.25 in chips) 
oscarleon: posts small blind $0.50
Szevasztopol: posts big blind $1
*** HOLE CARDS ***
Dealt to matiko09 [2s 3h]
147734319: raises $1.50 to $2.50
mono123viva: folds 
Wombatkilla: folds 
ardo888: folds 
Mr.Grigoriy: folds 
matiko09: folds 
xxxZeka: raises $5.50 to $8
oscarleon: folds 
Szevasztopol: folds 
147734319: calls $5.50
*** FLOP *** [Ks 2c 4h]
147734319: checks 
xxxZeka: bets $10
147734319: calls $10
*** TURN *** [Ks 2c 4h] [6s]
147734319: checks 
xxxZeka: bets $23
147734319: calls $23
*** RIVER *** [Ks 2c 4h 6s] [Kh]
147734319: checks 
xxxZeka: checks 
*** SHOW DOWN ***
147734319: shows [5s 5d] (two pair, Kings and Fives)
xxxZeka: shows [As Ac] (two pair, Aces and Kings)
xxxZeka collected $81 from pot
*** SUMMARY ***
Total pot $83.50 | Rake $2.50 
Board [Ks 2c 4h 6s Kh]
Seat 1: matiko09 folded before Flop (didn't bet)
Seat 2: xxxZeka (button) showed [As Ac] and won ($81) with two pair, Aces and Kings
Seat 3: oscarleon (small blind) folded before Flop
Seat 4: Szevasztopol (big blind) folded before Flop
Seat 5: 147734319 showed [5s 5d] and lost with two pair, Kings and Fives
Seat 6: mono123viva folded before Flop (didn't bet)
Seat 7: Wombatkilla folded before Flop (didn't bet)
Seat 8: ardo888 folded before Flop (didn't bet)
Seat 9: Mr.Grigoriy folded before Flop (didn't bet)





PokerStars Hand #154363092535:  Hold'em No Limit ($0.50/$1.00 USD) - 2016/06/06 12:43:09 CET [2016/06/06 6:43:09 ET]
Table 'Chaldaea II' 9-max Seat #5 is the button
Seat 1: xxxZeka ($107.21 in chips) 
Seat 2: masaytoo ($98.76 in chips) 
Seat 3: ardo888 ($111.11 in chips) 
Seat 4: ozone2003 ($118.71 in chips) 
Seat 5: MiiiTCHy__ ($57.16 in chips) 
Seat 6: PacPacBum ($100 in chips) 
Seat 7: riggedsh** ($141.88 in chips) 
Seat 8: o.miro ($111 in chips) 
Seat 9: matiko09 ($103 in chips) 
PacPacBum: posts small blind $0.50
riggedsh**: posts big blind $1
*** HOLE CARDS ***
Dealt to matiko09 [Kh 8s]
o.miro: folds 
matiko09: folds 
xxxZeka: folds 
masaytoo: folds 
ardo888: folds 
ozone2003: folds 
MiiiTCHy__: folds 
PacPacBum: raises $1.04 to $2.04
riggedsh**: raises $6.46 to $8.50
PacPacBum: folds 
Uncalled bet ($6.46) returned to riggedsh**
riggedsh** collected $4.08 from pot
riggedsh**: doesn't show hand 
*** SUMMARY ***
Total pot $4.08 | Rake $0 
Seat 1: xxxZeka folded before Flop (didn't bet)
Seat 2: masaytoo folded before Flop (didn't bet)
Seat 3: ardo888 folded before Flop (didn't bet)
Seat 4: ozone2003 folded before Flop (didn't bet)
Seat 5: MiiiTCHy__ (button) folded before Flop (didn't bet)
Seat 6: PacPacBum (small blind) folded before Flop
Seat 7: riggedsh** (big blind) collected ($4.08)
Seat 8: o.miro folded before Flop (didn't bet)
Seat 9: matiko09 folded before Flop (didn't bet)





PokerStars Hand #154363094033:  Hold'em No Limit ($0.50/$1.00 USD) - 2016/06/06 12:43:13 CET [2016/06/06 6:43:13 ET]
Table 'Williams' 9-max Seat #5 is the button
Seat 1: matiko09 ($191.29 in chips) 
Seat 2: PacPacBum ($112.90 in chips) 
Seat 3: granbunny ($61.80 in chips) 
Seat 4: Mr.Grigoriy ($100 in chips) 
Seat 5: xxxibgdrgn ($101 in chips) 
Seat 6: xxxZeka ($100 in chips) 
Seat 7: kevinho109 ($56.08 in chips) 
Seat 8: oscarleon ($108.86 in chips) 
Seat 9: kind ten ($46.07 in chips) 
xxxZeka: posts small blind $0.50
kevinho109: posts big blind $1
*** HOLE CARDS ***
Dealt to matiko09 [Qs 4s]
oscarleon: folds 
kind ten: folds 
matiko09: folds 
PacPacBum: raises $2 to $3
granbunny: folds 
Mr.Grigoriy: folds 
xxxibgdrgn: folds 
xxxZeka: folds 
kevinho109: folds 
Uncalled bet ($2) returned to PacPacBum
PacPacBum collected $2.50 from pot
PacPacBum: doesn't show hand 
*** SUMMARY ***
Total pot $2.50 | Rake $0 
Seat 1: matiko09 folded before Flop (didn't bet)
Seat 2: PacPacBum collected ($2.50)
Seat 3: granbunny folded before Flop (didn't bet)
Seat 4: Mr.Grigoriy folded before Flop (didn't bet)
Seat 5: xxxibgdrgn (button) folded before Flop (didn't bet)
Seat 6: xxxZeka (small blind) folded before Flop
Seat 7: kevinho109 (big blind) folded before Flop
Seat 8: oscarleon folded before Flop (didn't bet)
Seat 9: kind ten folded before Flop (didn't bet)





PokerStars Hand #154363096125:  Hold'em No Limit (€0.50/€1.00 EUR) - 2016/06/06 12:43:19 CET [2016/06/06 6:43:19 ET]
Table 'Lesath' 9-max Seat #5 is the button
Seat 1: o.miro (€101.94 in chips) 
Seat 2: thecurv (€125.70 in chips) 
Seat 4: hammerwife (€121.76 in chips) 
Seat 5: matiko09 (€100 in chips) 
Seat 6: Szevasztopol (€100 in chips) 
Seat 7: Mr.Grigoriy (€100 in chips) 
Seat 8: maxxmeister (€154.72 in chips) 
Seat 9: 72nloses (€103.02 in chips) 
Szevasztopol: posts small blind €0.50
Mr.Grigoriy: posts big blind €1
ozone2003: sits out 
*** HOLE CARDS ***
Dealt to matiko09 [5c 5d]
maxxmeister: folds 
72nloses: folds 
o.miro: folds 
thecurv: raises €1 to €2
hammerwife: folds 
matiko09: calls €2
Szevasztopol: folds 
Mr.Grigoriy: folds 
*** FLOP *** [Ts Kc Ah]
thecurv: checks 
matiko09: checks 
*** TURN *** [Ts Kc Ah] [3d]
thecurv: bets €3.50
matiko09: folds 
Uncalled bet (€3.50) returned to thecurv
thecurv collected €5.22 from pot
thecurv: doesn't show hand 
*** SUMMARY ***
Total pot €5.50 | Rake €0.28 
Board [Ts Kc Ah 3d]
Seat 1: o.miro folded before Flop (didn't bet)
Seat 2: thecurv collected (€5.22)
Seat 4: hammerwife folded before Flop (didn't bet)
Seat 5: matiko09 (button) folded on the Turn
Seat 6: Szevasztopol (small blind) folded before Flop
Seat 7: Mr.Grigoriy (big blind) folded before Flop
Seat 8: maxxmeister folded before Flop (didn't bet)
Seat 9: 72nloses folded before Flop (didn't bet)





PokerStars Hand #154363098052:  Hold'em No Limit ($0.50/$1.00 USD) - 2016/06/06 12:43:23 CET [2016/06/06 6:43:23 ET]
Table 'Sheliak' 9-max Seat #5 is the button
Seat 1: 32rrew ($101 in chips) 
Seat 2: masaytoo ($96 in chips) 
Seat 3: oscarleon ($100 in chips) 
Seat 4: Soundust_007 ($75.50 in chips) 
Seat 5: vanilica ($108 in chips) 
Seat 6: matiko09 ($100 in chips) 
Seat 7: stds st ($37.50 in chips) 
Seat 8: djammusic ($40 in chips) 
Seat 9: nombraalne1 ($102.28 in chips) 
matiko09: posts small blind $0.50
stds st: posts big blind $1
*** HOLE CARDS ***
Dealt to matiko09 [4c Kc]
djammusic: folds 
nombraalne1: folds 
32rrew: folds 
masaytoo: folds 
oscarleon: folds 
Soundust_007: folds 
vanilica: raises $1.50 to $2.50
matiko09: folds 
stds st: folds 
Uncalled bet ($1.50) returned to vanilica
vanilica collected $2.50 from pot
vanilica: doesn't show hand 
*** SUMMARY ***
Total pot $2.50 | Rake $0 
Seat 1: 32rrew folded before Flop (didn't bet)
Seat 2: masaytoo folded before Flop (didn't bet)
Seat 3: oscarleon folded before Flop (didn't bet)
Seat 4: Soundust_007 folded before Flop (didn't bet)
Seat 5: vanilica (button) collected ($2.50)
Seat 6: matiko09 (small blind) folded before Flop
Seat 7: stds st (big blind) folded before Flop
Seat 8: djammusic folded before Flop (didn't bet)
Seat 9: nombraalne1 folded before Flop (didn't bet)





PokerStars Hand #154363100041:  Hold'em No Limit ($0.50/$1.00 USD) - 2016/06/06 12:43:28 CET [2016/06/06 6:43:28 ET]
Table 'Titius' 9-max Seat #4 is the button
Seat 1: xxxZeka ($109.98 in chips) 
Seat 2: matiko09 ($100 in chips) 
Seat 3: vanilica ($100 in chips) 
Seat 4: ozone2003 ($100 in chips) 
Seat 5: riggedsh** ($198 in chips) 
Seat 6: oscarleon ($105.50 in chips) 
Seat 7: ardo888 ($100 in chips) 
Seat 8: DB3333 ($53.16 in chips) 
Seat 9: PacPacBum ($100 in chips) 
riggedsh**: posts small blind $0.50
oscarleon: posts big blind $1
*** HOLE CARDS ***
Dealt to matiko09 [Qd 9h]
ardo888: folds 
DB3333: folds 
PacPacBum: folds 
xxxZeka: folds 
matiko09: folds 
vanilica: folds 
ozone2003: raises $1.20 to $2.20
riggedsh**: folds 
oscarleon: folds 
Uncalled bet ($1.20) returned to ozone2003
ozone2003 collected $2.50 from pot
ozone2003: doesn't show hand 
*** SUMMARY ***
Total pot $2.50 | Rake $0 
Seat 1: xxxZeka folded before Flop (didn't bet)
Seat 2: matiko09 folded before Flop (didn't bet)
Seat 3: vanilica folded before Flop (didn't bet)
Seat 4: ozone2003 (button) collected ($2.50)
Seat 5: riggedsh** (small blind) folded before Flop
Seat 6: oscarleon (big blind) folded before Flop
Seat 7: ardo888 folded before Flop (didn't bet)
Seat 8: DB3333 folded before Flop (didn't bet)
Seat 9: PacPacBum folded before Flop (didn't bet)





PokerStars Hand #154363101201:  Hold'em No Limit ($0.50/$1.00 USD) - 2016/06/06 12:43:31 CET [2016/06/06 6:43:31 ET]
Table 'Wezen II' 9-max Seat #5 is the button
Seat 1: matiko09 ($162.47 in chips) 
Seat 2: Mr.Grigoriy ($106.68 in chips) 
Seat 3: oscarleon ($101.50 in chips) 
Seat 4: xxxibgdrgn ($100 in chips) 
Seat 5: stds st ($50.10 in chips) 
Seat 6: masaytoo ($99 in chips) 
Seat 7: KDJAll3 ($82.06 in chips) 
Seat 8: mavin80 ($173.22 in chips) 
masaytoo: posts small blind $0.50
KDJAll3: posts big blind $1
PacPacBum: sits out 
*** HOLE CARDS ***
Dealt to matiko09 [3d Qc]
mavin80: raises $1 to $2
matiko09: folds 
Mr.Grigoriy: folds 
oscarleon: folds 
xxxibgdrgn: folds 
stds st: calls $2
masaytoo: folds 
KDJAll3: calls $1
*** FLOP *** [Jd 5d Tc]
KDJAll3: checks 
mavin80: checks 
stds st: checks 
*** TURN *** [Jd 5d Tc] [4h]
KDJAll3: checks 
mavin80: bets $2
stds st: folds 
KDJAll3: calls $2
*** RIVER *** [Jd 5d Tc 4h] [4c]
KDJAll3: checks 
mavin80: bets $5
KDJAll3: folds 
Uncalled bet ($5) returned to mavin80
mavin80 collected $9.98 from pot
mavin80: doesn't show hand 
*** SUMMARY ***
Total pot $10.50 | Rake $0.52 
Board [Jd 5d Tc 4h 4c]
Seat 1: matiko09 folded before Flop (didn't bet)
Seat 2: Mr.Grigoriy folded before Flop (didn't bet)
Seat 3: oscarleon folded before Flop (didn't bet)
Seat 4: xxxibgdrgn folded before Flop (didn't bet)
Seat 5: stds st (button) folded on the Turn
Seat 6: masaytoo (small blind) folded before Flop
Seat 7: KDJAll3 (big blind) folded on the River
Seat 8: mavin80 collected ($9.98)





PokerStars Hand #154363101460:  Hold'em No Limit ($0.50/$1.00 USD) - 2016/06/06 12:43:32 CET [2016/06/06 6:43:32 ET]
Table 'Smither' 9-max Seat #9 is the button
Seat 1: PacPacBum ($108.40 in chips) 
Seat 2: matiko09 ($103.84 in chips) 
Seat 3: xxxZeka ($133.57 in chips) 
Seat 4: maxxmeister ($208.66 in chips) 
Seat 5: Szevasztopol ($102.28 in chips) 
Seat 6: riggedsh** ($107.28 in chips) 
Seat 8: 74 ROADIE ($87 in chips) 
Seat 9: hammerwife ($200.47 in chips) 
PacPacBum: posts small blind $0.50
matiko09: posts big blind $1
vanilica: sits out 
*** HOLE CARDS ***
Dealt to matiko09 [4c 5s]
xxxZeka: folds 
maxxmeister: folds 
Szevasztopol: folds 
riggedsh**: folds 
74 ROADIE: raises $2 to $3
hammerwife: folds 
PacPacBum: folds 
matiko09: folds 
Uncalled bet ($2) returned to 74 ROADIE
74 ROADIE collected $2.50 from pot
*** SUMMARY ***
Total pot $2.50 | Rake $0 
Seat 1: PacPacBum (small blind) folded before Flop
Seat 2: matiko09 (big blind) folded before Flop
Seat 3: xxxZeka folded before Flop (didn't bet)
Seat 4: maxxmeister folded before Flop (didn't bet)
Seat 5: Szevasztopol folded before Flop (didn't bet)
Seat 6: riggedsh** folded before Flop (didn't bet)
Seat 8: 74 ROADIE collected ($2.50)
Seat 9: hammerwife (button) folded before Flop (didn't bet)





PokerStars Hand #154363105851:  Hold'em No Limit ($0.50/$1.00 USD) - 2016/06/06 12:43:43 CET [2016/06/06 6:43:43 ET]
Table 'Safara' 9-max Seat #8 is the button
Seat 1: oscarleon ($235.94 in chips) 
Seat 2: Szevasztopol ($101.50 in chips) 
Seat 3: ozone2003 ($100 in chips) 
Seat 5: Dantist1122 ($101.03 in chips) 
Seat 6: matiko09 ($129.86 in chips) 
Seat 7: PacPacBum ($100 in chips) 
Seat 8: 32rrew ($100 in chips) 
Seat 9: Mr.Grigoriy ($101.67 in chips) 
Mr.Grigoriy: posts small blind $0.50
oscarleon: posts big blind $1
*** HOLE CARDS ***
Dealt to matiko09 [Td 4s]
Szevasztopol: folds 
ozone2003: folds 
Dantist1122: folds 
matiko09: folds 
PacPacBum: raises $2 to $3
32rrew: calls $3
Mr.Grigoriy: folds 
oscarleon: folds 
*** FLOP *** [4h 6d Qh]
PacPacBum: checks 
ratzo64 joins the table at seat #4 
32rrew: bets $4.74
PacPacBum: calls $4.74
*** TURN *** [4h 6d Qh] [Js]
PacPacBum: checks 
32rrew: bets $10.75
PacPacBum: raises $20.32 to $31.07
32rrew: folds 
Uncalled bet ($20.32) returned to PacPacBum
PacPacBum collected $36.56 from pot
PacPacBum: doesn't show hand 
*** SUMMARY ***
Total pot $38.48 | Rake $1.92 
Board [4h 6d Qh Js]
Seat 1: oscarleon (big blind) folded before Flop
Seat 2: Szevasztopol folded before Flop (didn't bet)
Seat 3: ozone2003 folded before Flop (didn't bet)
Seat 5: Dantist1122 folded before Flop (didn't bet)
Seat 6: matiko09 folded before Flop (didn't bet)
Seat 7: PacPacBum collected ($36.56)
Seat 8: 32rrew (button) folded on the Turn
Seat 9: Mr.Grigoriy (small blind) folded before Flop





PokerStars Hand #154363106855:  Hold'em No Limit ($0.50/$1.00 USD) - 2016/06/06 12:43:45 CET [2016/06/06 6:43:45 ET]
Table 'Williams' 9-max Seat #6 is the button
Seat 1: matiko09 ($191.29 in chips) 
Seat 2: PacPacBum ($114.40 in chips) 
Seat 3: granbunny ($61.80 in chips) 
Seat 4: Mr.Grigoriy ($100 in chips) 
Seat 5: xxxibgdrgn ($101 in chips) 
Seat 6: xxxZeka ($100 in chips) 
Seat 7: kevinho109 ($55.08 in chips) 
Seat 8: oscarleon ($108.86 in chips) 
Seat 9: kind ten ($46.07 in chips) 
kevinho109: posts small blind $0.50
oscarleon: posts big blind $1
*** HOLE CARDS ***
Dealt to matiko09 [6c 6h]
kind ten: folds 
matiko09: raises $2 to $3
PacPacBum: folds 
granbunny: folds 
Mr.Grigoriy: folds 
xxxibgdrgn: calls $3
xxxZeka: folds 
kevinho109: calls $2.50
oscarleon: folds 
*** FLOP *** [Ks 8d 9c]
kevinho109: checks 
matiko09: checks 
xxxibgdrgn: checks 
*** TURN *** [Ks 8d 9c] [3d]
kevinho109: bets $3
matiko09: folds 
xxxibgdrgn: raises $7 to $10
kevinho109: calls $7
*** RIVER *** [Ks 8d 9c 3d] [8c]
kevinho109: checks 
xxxibgdrgn: bets $27
kevinho109: folds 
Uncalled bet ($27) returned to xxxibgdrgn
xxxibgdrgn collected $28.50 from pot
xxxibgdrgn: doesn't show hand 
*** SUMMARY ***
Total pot $30 | Rake $1.50 
Board [Ks 8d 9c 3d 8c]
Seat 1: matiko09 folded on the Turn
Seat 2: PacPacBum folded before Flop (didn't bet)
Seat 3: granbunny folded before Flop (didn't bet)
Seat 4: Mr.Grigoriy folded before Flop (didn't bet)
Seat 5: xxxibgdrgn collected ($28.50)
Seat 6: xxxZeka (button) folded before Flop (didn't bet)
Seat 7: kevinho109 (small blind) folded on the River
Seat 8: oscarleon (big blind) folded before Flop
Seat 9: kind ten folded before Flop (didn't bet)





PokerStars Hand #154363107359:  Hold'em No Limit ($0.50/$1.00 USD) - 2016/06/06 12:43:47 CET [2016/06/06 6:43:47 ET]
Table 'Chaldaea II' 9-max Seat #6 is the button
Seat 1: xxxZeka ($107.21 in chips) 
Seat 2: masaytoo ($98.76 in chips) 
Seat 3: ardo888 ($111.11 in chips) 
Seat 4: ozone2003 ($118.71 in chips) 
Seat 5: MiiiTCHy__ ($57.16 in chips) 
Seat 6: PacPacBum ($100 in chips) 
Seat 7: riggedsh** ($143.92 in chips) 
Seat 8: o.miro ($111 in chips) 
Seat 9: matiko09 ($103 in chips) 
riggedsh**: posts small blind $0.50
o.miro: posts big blind $1
*** HOLE CARDS ***
Dealt to matiko09 [4h Th]
matiko09: folds 
xxxZeka: folds 
masaytoo: folds 
ardo888: folds 
ozone2003: raises $2 to $3
MiiiTCHy__: folds 
PacPacBum: folds 
riggedsh**: folds 
o.miro: folds 
Uncalled bet ($2) returned to ozone2003
ozone2003 collected $2.50 from pot
ozone2003: doesn't show hand 
*** SUMMARY ***
Total pot $2.50 | Rake $0 
Seat 1: xxxZeka folded before Flop (didn't bet)
Seat 2: masaytoo folded before Flop (didn't bet)
Seat 3: ardo888 folded before Flop (didn't bet)
Seat 4: ozone2003 collected ($2.50)
Seat 5: MiiiTCHy__ folded before Flop (didn't bet)
Seat 6: PacPacBum (button) folded before Flop (didn't bet)
Seat 7: riggedsh** (small blind) folded before Flop
Seat 8: o.miro (big blind) folded before Flop
Seat 9: matiko09 folded before Flop (didn't bet)





PokerStars Hand #154363113409:  Hold'em No Limit ($0.50/$1.00 USD) - 2016/06/06 12:44:02 CET [2016/06/06 6:44:02 ET]
Table 'Titius' 9-max Seat #5 is the button
Seat 1: xxxZeka ($109.98 in chips) 
Seat 2: matiko09 ($100 in chips) 
Seat 3: vanilica ($100 in chips) 
Seat 4: ozone2003 ($101.50 in chips) 
Seat 5: riggedsh** ($197.50 in chips) 
Seat 6: oscarleon ($104.50 in chips) 
Seat 7: ardo888 ($100 in chips) 
Seat 8: DB3333 ($53.16 in chips) 
Seat 9: PacPacBum ($100 in chips) 
oscarleon: posts small blind $0.50
ardo888: posts big blind $1
*** HOLE CARDS ***
Dealt to matiko09 [5s 7h]
DB3333: folds 
PacPacBum: raises $1.04 to $2.04
xxxZeka: folds 
matiko09: folds 
vanilica: calls $2.04
ozone2003: folds 
riggedsh**: folds 
oscarleon: folds 
ardo888: folds 
*** FLOP *** [5h 4s 8d]
PacPacBum: checks 
vanilica: bets $3.18
PacPacBum: folds 
Uncalled bet ($3.18) returned to vanilica
vanilica collected $5.30 from pot
vanilica: doesn't show hand 
*** SUMMARY ***
Total pot $5.58 | Rake $0.28 
Board [5h 4s 8d]
Seat 1: xxxZeka folded before Flop (didn't bet)
Seat 2: matiko09 folded before Flop (didn't bet)
Seat 3: vanilica collected ($5.30)
Seat 4: ozone2003 folded before Flop (didn't bet)
Seat 5: riggedsh** (button) folded before Flop (didn't bet)
Seat 6: oscarleon (small blind) folded before Flop
Seat 7: ardo888 (big blind) folded before Flop
Seat 8: DB3333 folded before Flop (didn't bet)
Seat 9: PacPacBum folded on the Flop





PokerStars Hand #154363117507:  Hold'em No Limit ($0.50/$1.00 USD) - 2016/06/06 12:44:12 CET [2016/06/06 6:44:12 ET]
Table 'Sheliak' 9-max Seat #6 is the button
Seat 1: 32rrew ($101 in chips) 
Seat 2: masaytoo ($96 in chips) 
Seat 3: oscarleon ($100 in chips) 
Seat 4: Soundust_007 ($75.50 in chips) 
Seat 5: vanilica ($109.50 in chips) 
Seat 6: matiko09 ($100 in chips) 
Seat 7: stds st ($36.50 in chips) 
stds st: posts small blind $0.50
djammusic: is sitting out 
nombraalne1: is sitting out 
32rrew: posts big blind $1
*** HOLE CARDS ***
Dealt to matiko09 [8s 4s]
masaytoo: folds 
oscarleon: folds 
Soundust_007: folds 
vanilica: folds 
matiko09: folds 
djammusic leaves the table
stds st: raises $1.02 to $2.02
32rrew: folds 
Uncalled bet ($1.02) returned to stds st
stds st collected $2 from pot
stds st: doesn't show hand 
*** SUMMARY ***
Total pot $2 | Rake $0 
Seat 1: 32rrew (big blind) folded before Flop
Seat 2: masaytoo folded before Flop (didn't bet)
Seat 3: oscarleon folded before Flop (didn't bet)
Seat 4: Soundust_007 folded before Flop (didn't bet)
Seat 5: vanilica folded before Flop (didn't bet)
Seat 6: matiko09 (button) folded before Flop (didn't bet)
Seat 7: stds st (small blind) collected ($2)





PokerStars Hand #154363119064:  Hold'em No Limit ($0.50/$1.00 USD) - 2016/06/06 12:44:16 CET [2016/06/06 6:44:16 ET]
Table 'Smither' 9-max Seat #1 is the button
Seat 1: PacPacBum ($107.90 in chips) 
Seat 2: matiko09 ($102.84 in chips) 
Seat 3: xxxZeka ($133.57 in chips) 
Seat 4: maxxmeister ($208.66 in chips) 
Seat 5: Szevasztopol ($102.28 in chips) 
Seat 6: riggedsh** ($107.28 in chips) 
Seat 8: 74 ROADIE ($88.50 in chips) 
Seat 9: hammerwife ($200.47 in chips) 
matiko09: posts small blind $0.50
xxxZeka: posts big blind $1
vanilica: sits out 
*** HOLE CARDS ***
Dealt to matiko09 [Th 8h]
maxxmeister: folds 
Szevasztopol: folds 
riggedsh**: folds 
74 ROADIE: folds 
hammerwife: raises $1.50 to $2.50
PacPacBum: raises $5.50 to $8
matiko09: folds 
xxxZeka: folds 
hammerwife: calls $5.50
*** FLOP *** [Ts Qd 9d]
hammerwife: checks 
PacPacBum: bets $5.81
hammerwife: calls $5.81
*** TURN *** [Ts Qd 9d] [Js]
hammerwife: checks 
PacPacBum: bets $14.93
hammerwife: calls $14.93
*** RIVER *** [Ts Qd 9d Js] [5h]
hammerwife: checks 
PacPacBum: bets $56.48
hammerwife: calls $56.48
*** SHOW DOWN ***
PacPacBum: shows [As Ks] (a straight, Ten to Ace)
hammerwife: mucks hand 
PacPacBum collected $169.44 from pot
*** SUMMARY ***
Total pot $171.94 | Rake $2.50 
Board [Ts Qd 9d Js 5h]
Seat 1: PacPacBum (button) showed [As Ks] and won ($169.44) with a straight, Ten to Ace
Seat 2: matiko09 (small blind) folded before Flop
Seat 3: xxxZeka (big blind) folded before Flop
Seat 4: maxxmeister folded before Flop (didn't bet)
Seat 5: Szevasztopol folded before Flop (didn't bet)
Seat 6: riggedsh** folded before Flop (didn't bet)
Seat 8: 74 ROADIE folded before Flop (didn't bet)
Seat 9: hammerwife mucked [Kd Td]





PokerStars Hand #154363120980:  Hold'em No Limit ($0.50/$1.00 USD) - 2016/06/06 12:44:21 CET [2016/06/06 6:44:21 ET]
Table 'Chaldaea II' 9-max Seat #7 is the button
Seat 1: xxxZeka ($107.21 in chips) 
Seat 2: masaytoo ($98.76 in chips) 
Seat 3: ardo888 ($111.11 in chips) 
Seat 4: ozone2003 ($120.21 in chips) 
Seat 5: MiiiTCHy__ ($57.16 in chips) 
Seat 6: PacPacBum ($100 in chips) 
Seat 7: riggedsh** ($143.42 in chips) 
Seat 8: o.miro ($110 in chips) 
Seat 9: matiko09 ($103 in chips) 
o.miro: posts small blind $0.50
matiko09: posts big blind $1
*** HOLE CARDS ***
Dealt to matiko09 [5s Jc]
xxxZeka: folds 
masaytoo: folds 
ardo888: folds 
ozone2003: folds 
MiiiTCHy__: raises $1.50 to $2.50
PacPacBum: folds 
riggedsh**: raises $5.50 to $8
o.miro: folds 
matiko09: folds 
MiiiTCHy__: raises $10 to $18
riggedsh**: raises $125.42 to $143.42 and is all-in
MiiiTCHy__: calls $39.16 and is all-in
Uncalled bet ($86.26) returned to riggedsh**
*** FLOP *** [Qc Td Ts]
*** TURN *** [Qc Td Ts] [9d]
*** RIVER *** [Qc Td Ts 9d] [6s]
*** SHOW DOWN ***
MiiiTCHy__: shows [Qd Ac] (two pair, Queens and Tens)
riggedsh**: shows [Kc Ks] (two pair, Kings and Tens)
riggedsh** collected $113.32 from pot
*** SUMMARY ***
Total pot $115.82 | Rake $2.50 
Board [Qc Td Ts 9d 6s]
Seat 1: xxxZeka folded before Flop (didn't bet)
Seat 2: masaytoo folded before Flop (didn't bet)
Seat 3: ardo888 folded before Flop (didn't bet)
Seat 4: ozone2003 folded before Flop (didn't bet)
Seat 5: MiiiTCHy__ showed [Qd Ac] and lost with two pair, Queens and Tens
Seat 6: PacPacBum folded before Flop (didn't bet)
Seat 7: riggedsh** (button) showed [Kc Ks] and won ($113.32) with two pair, Kings and Tens
Seat 8: o.miro (small blind) folded before Flop
Seat 9: matiko09 (big blind) folded before Flop





PokerStars Hand #154363126345:  Hold'em No Limit (€0.50/€1.00 EUR) - 2016/06/06 12:44:34 CET [2016/06/06 6:44:34 ET]
Table 'Lesath' 9-max Seat #6 is the button
Seat 1: o.miro (€101.94 in chips) 
Seat 2: thecurv (€128.92 in chips) 
Seat 4: hammerwife (€121.76 in chips) 
Seat 5: matiko09 (€100 in chips) 
Seat 6: Szevasztopol (€100 in chips) 
Seat 7: Mr.Grigoriy (€100 in chips) 
Seat 8: maxxmeister (€154.72 in chips) 
Seat 9: 72nloses (€103.02 in chips) 
Mr.Grigoriy: posts small blind €0.50
maxxmeister: posts big blind €1
ozone2003: sits out 
*** HOLE CARDS ***
Dealt to matiko09 [Qd Js]
72nloses: folds 
o.miro: folds 
thecurv: folds 
hammerwife: folds 
matiko09: raises €1.50 to €2.50
Szevasztopol: folds 
Mr.Grigoriy: folds 
maxxmeister: folds 
Uncalled bet (€1.50) returned to matiko09
matiko09 collected €2.50 from pot
matiko09: doesn't show hand 
*** SUMMARY ***
Total pot €2.50 | Rake €0 
Seat 1: o.miro folded before Flop (didn't bet)
Seat 2: thecurv folded before Flop (didn't bet)
Seat 4: hammerwife folded before Flop (didn't bet)
Seat 5: matiko09 collected (€2.50)
Seat 6: Szevasztopol (button) folded before Flop (didn't bet)
Seat 7: Mr.Grigoriy (small blind) folded before Flop
Seat 8: maxxmeister (big blind) folded before Flop
Seat 9: 72nloses folded before Flop (didn't bet)





PokerStars Hand #154363127656:  Hold'em No Limit ($0.50/$1.00 USD) - 2016/06/06 12:44:37 CET [2016/06/06 6:44:37 ET]
Table 'Gajdariya' 9-max Seat #3 is the button
Seat 1: matiko09 ($114.23 in chips) 
Seat 2: xxxZeka ($165.24 in chips) 
Seat 3: oscarleon ($112.05 in chips) 
Seat 4: Szevasztopol ($105.63 in chips) 
Seat 5: 147734319 ($58.51 in chips) 
Seat 6: mono123viva ($166.56 in chips) 
Seat 7: Wombatkilla ($102.42 in chips) 
Seat 8: ardo888 ($100 in chips) 
Seat 9: Mr.Grigoriy ($102.25 in chips) 
Szevasztopol: posts small blind $0.50
147734319: posts big blind $1
*** HOLE CARDS ***
Dealt to matiko09 [Qc 5c]
mono123viva: folds 
Wombatkilla: folds 
ardo888: folds 
Mr.Grigoriy: folds 
matiko09: folds 
xxxZeka: folds 
oscarleon: raises $2 to $3
Szevasztopol: folds 
147734319: folds 
Uncalled bet ($2) returned to oscarleon
oscarleon collected $2.50 from pot
oscarleon: doesn't show hand 
*** SUMMARY ***
Total pot $2.50 | Rake $0 
Seat 1: matiko09 folded before Flop (didn't bet)
Seat 2: xxxZeka folded before Flop (didn't bet)
Seat 3: oscarleon (button) collected ($2.50)
Seat 4: Szevasztopol (small blind) folded before Flop
Seat 5: 147734319 (big blind) folded before Flop
Seat 6: mono123viva folded before Flop (didn't bet)
Seat 7: Wombatkilla folded before Flop (didn't bet)
Seat 8: ardo888 folded before Flop (didn't bet)
Seat 9: Mr.Grigoriy folded before Flop (didn't bet)





PokerStars Hand #154363130315:  Hold'em No Limit ($0.50/$1.00 USD) - 2016/06/06 12:44:44 CET [2016/06/06 6:44:44 ET]
Table 'Yarilo' 9-max Seat #2 is the button
Seat 1: xxxZeka ($100 in chips) 
Seat 2: nombraalne1 ($112.44 in chips) 
Seat 3: matiko09 ($123.85 in chips) 
Seat 4: stds st ($40 in chips) 
Seat 5: Szevasztopol ($139.86 in chips) 
Seat 7: KEBIN1974 ($103.50 in chips) 
Seat 8: Mr.Grigoriy ($171.03 in chips) 
Seat 9: o.miro ($100 in chips) 
matiko09: posts small blind $0.50
stds st: posts big blind $1
ozone2003: sits out 
*** HOLE CARDS ***
Dealt to matiko09 [7s 5d]
Szevasztopol: folds 
KEBIN1974: raises $1.50 to $2.50
Mr.Grigoriy: folds 
o.miro: folds 
xxxZeka: folds 
nombraalne1: folds 
matiko09: folds 
stds st: calls $1.50
*** FLOP *** [3h 8s Jc]
stds st: bets $3.13
KEBIN1974: calls $3.13
*** TURN *** [3h 8s Jc] [As]
stds st: bets $7.50
KEBIN1974: calls $7.50
*** RIVER *** [3h 8s Jc As] [4s]
stds st: checks 
KEBIN1974: checks 
*** SHOW DOWN ***
stds st: shows [Kc Tc] (high card Ace)
KEBIN1974: shows [6h 8h] (a pair of Eights)
KEBIN1974 collected $25.42 from pot
*** SUMMARY ***
Total pot $26.76 | Rake $1.34 
Board [3h 8s Jc As 4s]
Seat 1: xxxZeka folded before Flop (didn't bet)
Seat 2: nombraalne1 (button) folded before Flop (didn't bet)
Seat 3: matiko09 (small blind) folded before Flop
Seat 4: stds st (big blind) showed [Kc Tc] and lost with high card Ace
Seat 5: Szevasztopol folded before Flop (didn't bet)
Seat 7: KEBIN1974 showed [6h 8h] and won ($25.42) with a pair of Eights
Seat 8: Mr.Grigoriy folded before Flop (didn't bet)
Seat 9: o.miro folded before Flop (didn't bet)





PokerStars Hand #154363130938:  Hold'em No Limit ($0.50/$1.00 USD) - 2016/06/06 12:44:45 CET [2016/06/06 6:44:45 ET]
Table 'Sheliak' 9-max Seat #7 is the button
Seat 1: 32rrew ($100 in chips) 
Seat 2: masaytoo ($96 in chips) 
Seat 3: oscarleon ($100 in chips) 
Seat 4: Soundust_007 ($75.50 in chips) 
Seat 5: vanilica ($109.50 in chips) 
Seat 6: matiko09 ($100 in chips) 
Seat 7: stds st ($37.50 in chips) 
32rrew: posts small blind $0.50
masaytoo: posts big blind $1
*** HOLE CARDS ***
Dealt to matiko09 [9d Ts]
hurtNCYDE joins the table at seat #8 
oscarleon: raises $2 to $3
Soundust_007: folds 
vanilica: folds 
matiko09: folds 
nombraalne1 leaves the table
Szevasztopol joins the table at seat #9 
stds st: raises $4.50 to $7.50
32rrew: folds 
masaytoo: folds 
oscarleon: raises $92.50 to $100 and is all-in
stds st: folds 
Uncalled bet ($92.50) returned to oscarleon
oscarleon collected $16.50 from pot
oscarleon: doesn't show hand 
*** SUMMARY ***
Total pot $16.50 | Rake $0 
Seat 1: 32rrew (small blind) folded before Flop
Seat 2: masaytoo (big blind) folded before Flop
Seat 3: oscarleon collected ($16.50)
Seat 4: Soundust_007 folded before Flop (didn't bet)
Seat 5: vanilica folded before Flop (didn't bet)
Seat 6: matiko09 folded before Flop (didn't bet)
Seat 7: stds st (button) folded before Flop





PokerStars Hand #154363131934:  Hold'em No Limit ($0.50/$1.00 USD) - 2016/06/06 12:44:48 CET [2016/06/06 6:44:48 ET]
Table 'Titius' 9-max Seat #6 is the button
Seat 1: xxxZeka ($109.98 in chips) 
Seat 2: matiko09 ($100 in chips) 
Seat 3: vanilica ($103.26 in chips) 
Seat 4: ozone2003 ($101.50 in chips) 
Seat 5: riggedsh** ($197.50 in chips) 
Seat 6: oscarleon ($104 in chips) 
Seat 7: ardo888 ($100 in chips) 
Seat 8: DB3333 ($53.16 in chips) 
Seat 9: PacPacBum ($100 in chips) 
ardo888: posts small blind $0.50
DB3333: posts big blind $1
*** HOLE CARDS ***
Dealt to matiko09 [Js 3c]
PacPacBum: folds 
xxxZeka: folds 
matiko09: folds 
vanilica: folds 
ozone2003: raises $2 to $3
riggedsh**: calls $3
oscarleon: folds 
ardo888: calls $2.50
DB3333: folds 
*** FLOP *** [7s 2s Th]
ardo888: checks 
ozone2003: checks 
riggedsh**: bets $6.36
ardo888: folds 
ozone2003: folds 
Uncalled bet ($6.36) returned to riggedsh**
riggedsh** collected $9.50 from pot
riggedsh**: doesn't show hand 
*** SUMMARY ***
Total pot $10 | Rake $0.50 
Board [7s 2s Th]
Seat 1: xxxZeka folded before Flop (didn't bet)
Seat 2: matiko09 folded before Flop (didn't bet)
Seat 3: vanilica folded before Flop (didn't bet)
Seat 4: ozone2003 folded on the Flop
Seat 5: riggedsh** collected ($9.50)
Seat 6: oscarleon (button) folded before Flop (didn't bet)
Seat 7: ardo888 (small blind) folded on the Flop
Seat 8: DB3333 (big blind) folded before Flop
Seat 9: PacPacBum folded before Flop (didn't bet)





PokerStars Hand #154363134809:  Hold'em No Limit ($0.50/$1.00 USD) - 2016/06/06 12:44:55 CET [2016/06/06 6:44:55 ET]
Table 'Heze' 9-max Seat #6 is the button
Seat 1: matiko09 ($218.15 in chips) 
Seat 2: oscarleon ($241.81 in chips) 
Seat 3: xxxibgdrgn ($100 in chips) 
Seat 4: xxxZeka ($110.68 in chips) 
Seat 5: stds st ($40 in chips) 
Seat 6: ozone2003 ($115.79 in chips) 
Seat 7: 32rrew ($100 in chips) 
Seat 8: AlSmithy88 ($44.56 in chips) 
Seat 9: Mr.Grigoriy ($120.70 in chips) 
32rrew: posts small blind $0.50
AlSmithy88: posts big blind $1
*** HOLE CARDS ***
Dealt to matiko09 [7s 4s]
Mr.Grigoriy: folds 
matiko09: folds 
oscarleon: folds 
xxxibgdrgn: folds 
xxxZeka: folds 
stds st: folds 
ozone2003: folds 
32rrew: raises $2 to $3
AlSmithy88: calls $2
*** FLOP *** [2d Kh 8d]
32rrew: bets $3.79
AlSmithy88: calls $3.79
*** TURN *** [2d Kh 8d] [5d]
32rrew: bets $8.59
AlSmithy88: calls $8.59
*** RIVER *** [2d Kh 8d 5d] [8c]
32rrew: bets $29.22
AlSmithy88: calls $29.18 and is all-in
Uncalled bet ($0.04) returned to 32rrew
*** SHOW DOWN ***
32rrew: shows [6d 7d] (a flush, Eight high)
AlSmithy88: mucks hand 
32rrew collected $86.62 from pot
*** SUMMARY ***
Total pot $89.12 | Rake $2.50 
Board [2d Kh 8d 5d 8c]
Seat 1: matiko09 folded before Flop (didn't bet)
Seat 2: oscarleon folded before Flop (didn't bet)
Seat 3: xxxibgdrgn folded before Flop (didn't bet)
Seat 4: xxxZeka folded before Flop (didn't bet)
Seat 5: stds st folded before Flop (didn't bet)
Seat 6: ozone2003 (button) folded before Flop (didn't bet)
Seat 7: 32rrew (small blind) showed [6d 7d] and won ($86.62) with a flush, Eight high
Seat 8: AlSmithy88 (big blind) mucked [Ks 9h]
Seat 9: Mr.Grigoriy folded before Flop (didn't bet)





PokerStars Hand #154363138392:  Hold'em No Limit ($0.50/$1.00 USD) - 2016/06/06 12:45:04 CET [2016/06/06 6:45:04 ET]
Table 'Wezen II' 9-max Seat #6 is the button
Seat 1: matiko09 ($162.47 in chips) 
Seat 2: Mr.Grigoriy ($106.68 in chips) 
Seat 3: oscarleon ($101.50 in chips) 
Seat 4: xxxibgdrgn ($100 in chips) 
Seat 5: stds st ($48.10 in chips) 
Seat 6: masaytoo ($98.50 in chips) 
Seat 7: KDJAll3 ($78.06 in chips) 
Seat 8: mavin80 ($179.20 in chips) 
KDJAll3: posts small blind $0.50
mavin80: posts big blind $1
PacPacBum: sits out 
*** HOLE CARDS ***
Dealt to matiko09 [6h 2c]
matiko09: folds 
Mr.Grigoriy: raises $2 to $3
oscarleon: calls $3
xxxibgdrgn: folds 
stds st: folds 
masaytoo: folds 
KDJAll3: folds 
mavin80: folds 
*** FLOP *** [Kc 8d Qs]
Mr.Grigoriy: bets $5.06
oscarleon: folds 
Uncalled bet ($5.06) returned to Mr.Grigoriy
Mr.Grigoriy collected $7.12 from pot
Mr.Grigoriy: doesn't show hand 
*** SUMMARY ***
Total pot $7.50 | Rake $0.38 
Board [Kc 8d Qs]
Seat 1: matiko09 folded before Flop (didn't bet)
Seat 2: Mr.Grigoriy collected ($7.12)
Seat 3: oscarleon folded on the Flop
Seat 4: xxxibgdrgn folded before Flop (didn't bet)
Seat 5: stds st folded before Flop (didn't bet)
Seat 6: masaytoo (button) folded before Flop (didn't bet)
Seat 7: KDJAll3 (small blind) folded before Flop
Seat 8: mavin80 (big blind) folded before Flop





PokerStars Hand #154363139668:  Hold'em No Limit ($0.50/$1.00 USD) - 2016/06/06 12:45:07 CET [2016/06/06 6:45:07 ET]
Table 'Gajdariya' 9-max Seat #4 is the button
Seat 1: matiko09 ($114.23 in chips) 
Seat 2: xxxZeka ($165.24 in chips) 
Seat 3: oscarleon ($113.55 in chips) 
Seat 4: Szevasztopol ($105.13 in chips) 
Seat 5: 147734319 ($57.51 in chips) 
Seat 6: mono123viva ($166.56 in chips) 
Seat 7: Wombatkilla ($102.42 in chips) 
Seat 8: ardo888 ($100 in chips) 
Seat 9: Mr.Grigoriy ($102.25 in chips) 
147734319: posts small blind $0.50
mono123viva: posts big blind $1
*** HOLE CARDS ***
Dealt to matiko09 [Ah 3d]
Wombatkilla: folds 
ardo888: folds 
Mr.Grigoriy: raises $2 to $3
matiko09: folds 
xxxZeka: folds 
oscarleon: folds 
Szevasztopol: folds 
147734319: folds 
mono123viva: folds 
Uncalled bet ($2) returned to Mr.Grigoriy
Mr.Grigoriy collected $2.50 from pot
Mr.Grigoriy: doesn't show hand 
*** SUMMARY ***
Total pot $2.50 | Rake $0 
Seat 1: matiko09 folded before Flop (didn't bet)
Seat 2: xxxZeka folded before Flop (didn't bet)
Seat 3: oscarleon folded before Flop (didn't bet)
Seat 4: Szevasztopol (button) folded before Flop (didn't bet)
Seat 5: 147734319 (small blind) folded before Flop
Seat 6: mono123viva (big blind) folded before Flop
Seat 7: Wombatkilla folded before Flop (didn't bet)
Seat 8: ardo888 folded before Flop (didn't bet)
Seat 9: Mr.Grigoriy collected ($2.50)





PokerStars Hand #154363140571:  Hold'em No Limit ($0.50/$1.00 USD) - 2016/06/06 12:45:09 CET [2016/06/06 6:45:09 ET]
Table 'Williams' 9-max Seat #7 is the button
Seat 1: matiko09 ($188.29 in chips) 
Seat 2: PacPacBum ($114.40 in chips) 
Seat 3: granbunny ($61.80 in chips) 
Seat 4: Mr.Grigoriy ($100 in chips) 
Seat 5: xxxibgdrgn ($116.50 in chips) 
Seat 6: xxxZeka ($100 in chips) 
Seat 7: kevinho109 ($42.08 in chips) 
Seat 8: oscarleon ($107.86 in chips) 
Seat 9: kind ten ($46.07 in chips) 
oscarleon: posts small blind $0.50
kind ten: posts big blind $1
*** HOLE CARDS ***
Dealt to matiko09 [Qs 8c]
matiko09: folds 
PacPacBum: folds 
granbunny: folds 
Mr.Grigoriy: folds 
xxxibgdrgn: folds 
xxxZeka: folds 
kevinho109: folds 
oscarleon: folds 
Uncalled bet ($0.50) returned to kind ten
kind ten collected $1 from pot
kind ten: doesn't show hand 
*** SUMMARY ***
Total pot $1 | Rake $0 
Seat 1: matiko09 folded before Flop (didn't bet)
Seat 2: PacPacBum folded before Flop (didn't bet)
Seat 3: granbunny folded before Flop (didn't bet)
Seat 4: Mr.Grigoriy folded before Flop (didn't bet)
Seat 5: xxxibgdrgn folded before Flop (didn't bet)
Seat 6: xxxZeka folded before Flop (didn't bet)
Seat 7: kevinho109 (button) folded before Flop (didn't bet)
Seat 8: oscarleon (small blind) folded before Flop
Seat 9: kind ten (big blind) collected ($1)





PokerStars Hand #154363146379:  Hold'em No Limit (€0.50/€1.00 EUR) - 2016/06/06 12:45:24 CET [2016/06/06 6:45:24 ET]
Table 'Lesath' 9-max Seat #7 is the button
Seat 1: o.miro (€101.94 in chips) 
Seat 2: thecurv (€128.92 in chips) 
Seat 4: hammerwife (€121.76 in chips) 
Seat 5: matiko09 (€101.50 in chips) 
Seat 6: Szevasztopol (€100 in chips) 
Seat 7: Mr.Grigoriy (€100 in chips) 
Seat 8: maxxmeister (€153.72 in chips) 
Seat 9: 72nloses (€103.02 in chips) 
maxxmeister: posts small blind €0.50
72nloses: posts big blind €1
ozone2003: sits out 
*** HOLE CARDS ***
Dealt to matiko09 [Ad 5c]
o.miro: folds 
thecurv: calls €1
hammerwife: folds 
matiko09: folds 
Szevasztopol: folds 
Mr.Grigoriy: folds 
maxxmeister: folds 
72nloses: checks 
*** FLOP *** [Qs 7s 4s]
72nloses: checks 
thecurv: bets €2
72nloses: calls €2
*** TURN *** [Qs 7s 4s] [Tc]
72nloses: checks 
thecurv: bets €4.50
72nloses: calls €4.50
*** RIVER *** [Qs 7s 4s Tc] [7d]
72nloses: checks 
thecurv: checks 
*** SHOW DOWN ***
72nloses: shows [Ah Ts] (two pair, Tens and Sevens)
thecurv: mucks hand 
72nloses collected €14.72 from pot
*** SUMMARY ***
Total pot €15.50 | Rake €0.78 
Board [Qs 7s 4s Tc 7d]
Seat 1: o.miro folded before Flop (didn't bet)
Seat 2: thecurv mucked [Jh Ac]
Seat 4: hammerwife folded before Flop (didn't bet)
Seat 5: matiko09 folded before Flop (didn't bet)
Seat 6: Szevasztopol folded before Flop (didn't bet)
Seat 7: Mr.Grigoriy (button) folded before Flop (didn't bet)
Seat 8: maxxmeister (small blind) folded before Flop
Seat 9: 72nloses (big blind) showed [Ah Ts] and won (€14.72) with two pair, Tens and Sevens





PokerStars Hand #154363147155:  Hold'em No Limit ($0.50/$1.00 USD) - 2016/06/06 12:45:26 CET [2016/06/06 6:45:26 ET]
Table 'Chaldaea II' 9-max Seat #8 is the button
Seat 1: xxxZeka ($107.21 in chips) 
Seat 2: masaytoo ($98.76 in chips) 
Seat 3: ardo888 ($111.11 in chips) 
Seat 4: ozone2003 ($120.21 in chips) 
Seat 6: PacPacBum ($100 in chips) 
Seat 7: riggedsh** ($199.58 in chips) 
Seat 8: o.miro ($109.50 in chips) 
Seat 9: matiko09 ($102 in chips) 
matiko09: posts small blind $0.50
xxxZeka: posts big blind $1
*** HOLE CARDS ***
Dealt to matiko09 [9s 2h]
masaytoo: folds 
ardo888: folds 
MiiiTCHy__ leaves the table
ozone2003: folds 
PacPacBum: folds 
riggedsh**: folds 
o.miro: raises $1.50 to $2.50
matiko09: folds 
xxxZeka: raises $6.50 to $9
o.miro: folds 
Uncalled bet ($6.50) returned to xxxZeka
xxxZeka collected $5.50 from pot
*** SUMMARY ***
Total pot $5.50 | Rake $0 
Seat 1: xxxZeka (big blind) collected ($5.50)
Seat 2: masaytoo folded before Flop (didn't bet)
Seat 3: ardo888 folded before Flop (didn't bet)
Seat 4: ozone2003 folded before Flop (didn't bet)
Seat 6: PacPacBum folded before Flop (didn't bet)
Seat 7: riggedsh** folded before Flop (didn't bet)
Seat 8: o.miro (button) folded before Flop
Seat 9: matiko09 (small blind) folded before Flop





PokerStars Hand #154363147779:  Hold'em No Limit ($0.50/$1.00 USD) - 2016/06/06 12:45:27 CET [2016/06/06 6:45:27 ET]
Table 'Irmgard II' 9-max Seat #2 is the button
Seat 1: matiko09 ($158.55 in chips) 
Seat 2: hammerwife ($114.82 in chips) 
Seat 3: stds st ($43.48 in chips) 
Seat 4: oscarleon ($147.76 in chips) 
Seat 5: Mr.Grigoriy ($144.76 in chips) 
Seat 6: DancerNN1 ($100 in chips) 
Seat 7: 32rrew ($146.19 in chips) 
stds st: posts small blind $0.50
oscarleon: posts big blind $1
Szevasztopol: sits out 
PacPacBum: sits out 
*** HOLE CARDS ***
Dealt to matiko09 [5s 5c]
Mr.Grigoriy: folds 
DancerNN1: folds 
32rrew: raises $2 to $3
matiko09: calls $3
hammerwife: folds 
stds st: folds 
oscarleon: folds 
*** FLOP *** [2c 6d 9h]
32rrew: bets $4.74
matiko09: calls $4.74
*** TURN *** [2c 6d 9h] [Ks]
32rrew: bets $10.75
matiko09: folds 
Uncalled bet ($10.75) returned to 32rrew
32rrew collected $16.13 from pot
32rrew: doesn't show hand 
*** SUMMARY ***
Total pot $16.98 | Rake $0.85 
Board [2c 6d 9h Ks]
Seat 1: matiko09 folded on the Turn
Seat 2: hammerwife (button) folded before Flop (didn't bet)
Seat 3: stds st (small blind) folded before Flop
Seat 4: oscarleon (big blind) folded before Flop
Seat 5: Mr.Grigoriy folded before Flop (didn't bet)
Seat 6: DancerNN1 folded before Flop (didn't bet)
Seat 7: 32rrew collected ($16.13)





PokerStars Hand #154363148057:  Hold'em No Limit ($0.50/$1.00 USD) - 2016/06/06 12:45:28 CET [2016/06/06 6:45:28 ET]
Table 'Williams' 9-max Seat #8 is the button
Seat 1: matiko09 ($188.29 in chips) 
Seat 2: PacPacBum ($114.40 in chips) 
Seat 3: granbunny ($61.80 in chips) 
Seat 4: Mr.Grigoriy ($100 in chips) 
Seat 5: xxxibgdrgn ($116.50 in chips) 
Seat 6: xxxZeka ($100 in chips) 
Seat 7: kevinho109 ($42.08 in chips) 
Seat 8: oscarleon ($107.36 in chips) 
Seat 9: kind ten ($46.57 in chips) 
kind ten: posts small blind $0.50
matiko09: posts big blind $1
*** HOLE CARDS ***
Dealt to matiko09 [Th 4s]
PacPacBum: folds 
granbunny: folds 
Mr.Grigoriy: folds 
xxxibgdrgn: raises $2 to $3
xxxZeka: folds 
kevinho109: folds 
oscarleon: folds 
kind ten: folds 
matiko09: folds 
Uncalled bet ($2) returned to xxxibgdrgn
xxxibgdrgn collected $2.50 from pot
xxxibgdrgn: doesn't show hand 
*** SUMMARY ***
Total pot $2.50 | Rake $0 
Seat 1: matiko09 (big blind) folded before Flop
Seat 2: PacPacBum folded before Flop (didn't bet)
Seat 3: granbunny folded before Flop (didn't bet)
Seat 4: Mr.Grigoriy folded before Flop (didn't bet)
Seat 5: xxxibgdrgn collected ($2.50)
Seat 6: xxxZeka folded before Flop (didn't bet)
Seat 7: kevinho109 folded before Flop (didn't bet)
Seat 8: oscarleon (button) folded before Flop (didn't bet)
Seat 9: kind ten (small blind) folded before Flop





PokerStars Hand #154363155218:  Hold'em No Limit ($0.50/$1.00 USD) - 2016/06/06 12:45:46 CET [2016/06/06 6:45:46 ET]
Table 'Wezen II' 9-max Seat #7 is the button
Seat 1: matiko09 ($162.47 in chips) 
Seat 2: Mr.Grigoriy ($110.80 in chips) 
Seat 3: oscarleon ($100 in chips) 
Seat 4: xxxibgdrgn ($100 in chips) 
Seat 5: stds st ($48.10 in chips) 
Seat 6: masaytoo ($98.50 in chips) 
Seat 7: KDJAll3 ($77.56 in chips) 
Seat 8: mavin80 ($178.20 in chips) 
Seat 9: PacPacBum ($100 in chips) 
mavin80: posts small blind $0.50
PacPacBum: posts big blind $1
*** HOLE CARDS ***
Dealt to matiko09 [4h 2h]
matiko09: folds 
Mr.Grigoriy: folds 
oscarleon: folds 
xxxibgdrgn: raises $2 to $3
stds st: folds 
masaytoo: folds 
KDJAll3: folds 
mavin80: calls $2.50
PacPacBum: folds 
*** FLOP *** [4c Jc 7d]
mavin80: checks 
xxxibgdrgn: checks 
*** TURN *** [4c Jc 7d] [9s]
mavin80: bets $2
xxxibgdrgn: folds 
Uncalled bet ($2) returned to mavin80
mavin80 collected $6.65 from pot
mavin80: doesn't show hand 
*** SUMMARY ***
Total pot $7 | Rake $0.35 
Board [4c Jc 7d 9s]
Seat 1: matiko09 folded before Flop (didn't bet)
Seat 2: Mr.Grigoriy folded before Flop (didn't bet)
Seat 3: oscarleon folded before Flop (didn't bet)
Seat 4: xxxibgdrgn folded on the Turn
Seat 5: stds st folded before Flop (didn't bet)
Seat 6: masaytoo folded before Flop (didn't bet)
Seat 7: KDJAll3 (button) folded before Flop (didn't bet)
Seat 8: mavin80 (small blind) collected ($6.65)
Seat 9: PacPacBum (big blind) folded before Flop





PokerStars Hand #154363156928:  Hold'em No Limit ($0.50/$1.00 USD) - 2016/06/06 12:45:50 CET [2016/06/06 6:45:50 ET]
Table 'Titius' 9-max Seat #7 is the button
Seat 1: xxxZeka ($109.98 in chips) 
Seat 2: matiko09 ($100 in chips) 
Seat 3: vanilica ($103.26 in chips) 
Seat 4: ozone2003 ($100 in chips) 
Seat 5: riggedsh** ($204 in chips) 
Seat 6: oscarleon ($104 in chips) 
Seat 7: ardo888 ($100 in chips) 
Seat 8: DB3333 ($52.16 in chips) 
Seat 9: PacPacBum ($100 in chips) 
DB3333: posts small blind $0.50
PacPacBum: posts big blind $1
*** HOLE CARDS ***
Dealt to matiko09 [Ah Kc]
xxxZeka: folds 
matiko09: raises $2 to $3
vanilica: folds 
ozone2003: raises $6 to $9
riggedsh**: folds 
oscarleon: folds 
ardo888: folds 
DB3333: folds 
PacPacBum: folds 
matiko09: calls $6
*** FLOP *** [4d 2h 7s]
matiko09: checks 
ozone2003: bets $9.26
matiko09: folds 
Uncalled bet ($9.26) returned to ozone2003
ozone2003 collected $18.52 from pot
ozone2003: doesn't show hand 
*** SUMMARY ***
Total pot $19.50 | Rake $0.98 
Board [4d 2h 7s]
Seat 1: xxxZeka folded before Flop (didn't bet)
Seat 2: matiko09 folded on the Flop
Seat 3: vanilica folded before Flop (didn't bet)
Seat 4: ozone2003 collected ($18.52)
Seat 5: riggedsh** folded before Flop (didn't bet)
Seat 6: oscarleon folded before Flop (didn't bet)
Seat 7: ardo888 (button) folded before Flop (didn't bet)
Seat 8: DB3333 (small blind) folded before Flop
Seat 9: PacPacBum (big blind) folded before Flop





PokerStars Hand #154363156893:  Hold'em No Limit ($0.50/$1.00 USD) - 2016/06/06 12:45:50 CET [2016/06/06 6:45:50 ET]
Table 'Gajdariya' 9-max Seat #5 is the button
Seat 1: matiko09 ($114.23 in chips) 
Seat 2: xxxZeka ($165.24 in chips) 
Seat 3: oscarleon ($113.55 in chips) 
Seat 4: Szevasztopol ($105.13 in chips) 
Seat 5: 147734319 ($57.01 in chips) 
Seat 6: mono123viva ($165.56 in chips) 
Seat 7: Wombatkilla ($102.42 in chips) 
Seat 8: ardo888 ($100 in chips) 
Seat 9: Mr.Grigoriy ($103.75 in chips) 
mono123viva: posts small blind $0.50
Wombatkilla: posts big blind $1
*** HOLE CARDS ***
Dealt to matiko09 [2c Kc]
ardo888: folds 
Mr.Grigoriy: raises $2 to $3
matiko09: folds 
xxxZeka: folds 
oscarleon: folds 
Szevasztopol: folds 
147734319: raises $5 to $8
mono123viva: calls $7.50
Wombatkilla: calls $7
Mr.Grigoriy: calls $5
*** FLOP *** [7s Ad Qc]
mono123viva: checks 
Wombatkilla: checks 
Mr.Grigoriy: checks 
147734319: checks 
*** TURN *** [7s Ad Qc] [6s]
mono123viva: bets $8
Wombatkilla: calls $8
Mr.Grigoriy: raises $28 to $36
147734319: folds 
mono123viva: folds 
Wombatkilla: folds 
Uncalled bet ($28) returned to Mr.Grigoriy
Mr.Grigoriy collected $53.50 from pot
Mr.Grigoriy: doesn't show hand 
*** SUMMARY ***
Total pot $56 | Rake $2.50 
Board [7s Ad Qc 6s]
Seat 1: matiko09 folded before Flop (didn't bet)
Seat 2: xxxZeka folded before Flop (didn't bet)
Seat 3: oscarleon folded before Flop (didn't bet)
Seat 4: Szevasztopol folded before Flop (didn't bet)
Seat 5: 147734319 (button) folded on the Turn
Seat 6: mono123viva (small blind) folded on the Turn
Seat 7: Wombatkilla (big blind) folded on the Turn
Seat 8: ardo888 folded before Flop (didn't bet)
Seat 9: Mr.Grigoriy collected ($53.50)





PokerStars Hand #154363159284:  Hold'em No Limit ($0.50/$1.00 USD) - 2016/06/06 12:45:56 CET [2016/06/06 6:45:56 ET]
Table 'Sheliak' 9-max Seat #1 is the button
Seat 1: 32rrew ($100 in chips) 
Seat 2: masaytoo ($95 in chips) 
Seat 3: oscarleon ($109 in chips) 
Seat 4: Soundust_007 ($75.50 in chips) 
Seat 5: vanilica ($109.50 in chips) 
Seat 6: matiko09 ($100 in chips) 
Seat 7: stds st ($30 in chips) 
masaytoo: posts small blind $0.50
oscarleon: posts big blind $1
hurtNCYDE: sits out 
Szevasztopol: sits out 
*** HOLE CARDS ***
Dealt to matiko09 [9h 4s]
Soundust_007: folds 
vanilica: raises $1.50 to $2.50
matiko09: folds 
stds st: folds 
32rrew: calls $2.50
Soundust_007 leaves the table
masaytoo: folds 
oscarleon: folds 
*** FLOP *** [Jh Ks Qh]
hurtNCYDE leaves the table
vanilica: checks 
iRLM joins the table at seat #4 
32rrew: bets $4.11
ozone2003 joins the table at seat #8 
vanilica: folds 
Uncalled bet ($4.11) returned to 32rrew
32rrew collected $6.18 from pot
32rrew: doesn't show hand 
*** SUMMARY ***
Total pot $6.50 | Rake $0.32 
Board [Jh Ks Qh]
Seat 1: 32rrew (button) collected ($6.18)
Seat 2: masaytoo (small blind) folded before Flop
Seat 3: oscarleon (big blind) folded before Flop
Seat 4: Soundust_007 folded before Flop (didn't bet)
Seat 5: vanilica folded on the Flop
Seat 6: matiko09 folded before Flop (didn't bet)
Seat 7: stds st folded before Flop (didn't bet)





PokerStars Hand #154363161142:  Hold'em No Limit ($0.50/$1.00 USD) - 2016/06/06 12:46:00 CET [2016/06/06 6:46:00 ET]
Table 'Chaldaea II' 9-max Seat #9 is the button
Seat 1: xxxZeka ($110.21 in chips) 
Seat 2: masaytoo ($98.76 in chips) 
Seat 3: ardo888 ($111.11 in chips) 
Seat 4: ozone2003 ($120.21 in chips) 
Seat 6: PacPacBum ($100 in chips) 
Seat 7: riggedsh** ($199.58 in chips) 
Seat 8: o.miro ($107 in chips) 
Seat 9: matiko09 ($101.50 in chips) 
xxxZeka: posts small blind $0.50
masaytoo: posts big blind $1
*** HOLE CARDS ***
Dealt to matiko09 [Td 8h]
ardo888: folds 
ozone2003: folds 
PacPacBum: folds 
riggedsh**: folds 
o.miro: folds 
matiko09: raises $1.27 to $2.27
xxxZeka: folds 
masaytoo: calls $1.27
*** FLOP *** [9c 7d 5s]
Dantist1122 joins the table at seat #5 
masaytoo: checks 
matiko09: bets $3.11
masaytoo: folds 
Uncalled bet ($3.11) returned to matiko09
matiko09 collected $4.79 from pot
matiko09: doesn't show hand 
*** SUMMARY ***
Total pot $5.04 | Rake $0.25 
Board [9c 7d 5s]
Seat 1: xxxZeka (small blind) folded before Flop
Seat 2: masaytoo (big blind) folded on the Flop
Seat 3: ardo888 folded before Flop (didn't bet)
Seat 4: ozone2003 folded before Flop (didn't bet)
Seat 6: PacPacBum folded before Flop (didn't bet)
Seat 7: riggedsh** folded before Flop (didn't bet)
Seat 8: o.miro folded before Flop (didn't bet)
Seat 9: matiko09 (button) collected ($4.79)





PokerStars Hand #154363162516:  Hold'em No Limit ($0.50/$1.00 USD) - 2016/06/06 12:46:04 CET [2016/06/06 6:46:04 ET]
Table 'Safara' 9-max Seat #9 is the button
Seat 1: oscarleon ($234.94 in chips) 
Seat 4: ratzo64 ($100 in chips) 
Seat 5: Dantist1122 ($101.03 in chips) 
Seat 6: matiko09 ($129.86 in chips) 
Seat 7: PacPacBum ($118.07 in chips) 
Seat 8: 32rrew ($100 in chips) 
Seat 9: Mr.Grigoriy ($101.17 in chips) 
oscarleon: posts small blind $0.50
Szevasztopol: is sitting out 
ozone2003: is sitting out 
ratzo64: posts big blind $1
*** HOLE CARDS ***
Dealt to matiko09 [Th Ah]
ozone2003 leaves the table
hurtNCYDE joins the table at seat #3 
Dantist1122: folds 
hurtNCYDE leaves the table
Dantist1122 leaves the table
matiko09: raises $2 to $3
PacPacBum: folds 
32rrew: folds 
Mr.Grigoriy: folds 
oscarleon: folds 
ratzo64: folds 
Uncalled bet ($2) returned to matiko09
matiko09 collected $2.50 from pot
matiko09: doesn't show hand 
*** SUMMARY ***
Total pot $2.50 | Rake $0 
Seat 1: oscarleon (small blind) folded before Flop
Seat 4: ratzo64 (big blind) folded before Flop
Seat 5: Dantist1122 folded before Flop (didn't bet)
Seat 6: matiko09 collected ($2.50)
Seat 7: PacPacBum folded before Flop (didn't bet)
Seat 8: 32rrew folded before Flop (didn't bet)
Seat 9: Mr.Grigoriy (button) folded before Flop (didn't bet)





PokerStars Hand #154363163834:  Hold'em No Limit ($0.50/$1.00 USD) - 2016/06/06 12:46:07 CET [2016/06/06 6:46:07 ET]
Table 'Williams' 9-max Seat #9 is the button
Seat 1: matiko09 ($187.29 in chips) 
Seat 2: PacPacBum ($114.40 in chips) 
Seat 3: granbunny ($61.80 in chips) 
Seat 4: Mr.Grigoriy ($100 in chips) 
Seat 5: xxxibgdrgn ($118 in chips) 
Seat 6: xxxZeka ($100 in chips) 
Seat 7: kevinho109 ($42.08 in chips) 
Seat 8: oscarleon ($107.36 in chips) 
Seat 9: kind ten ($46.07 in chips) 
matiko09: posts small blind $0.50
PacPacBum: posts big blind $1
*** HOLE CARDS ***
Dealt to matiko09 [Qd Js]
granbunny: folds 
Mr.Grigoriy: folds 
xxxibgdrgn: folds 
xxxZeka: folds 
kevinho109: folds 
oscarleon: folds 
kind ten: folds 
matiko09: raises $2 to $3
PacPacBum: folds 
Uncalled bet ($2) returned to matiko09
matiko09 collected $2 from pot
matiko09: doesn't show hand 
*** SUMMARY ***
Total pot $2 | Rake $0 
Seat 1: matiko09 (small blind) collected ($2)
Seat 2: PacPacBum (big blind) folded before Flop
Seat 3: granbunny folded before Flop (didn't bet)
Seat 4: Mr.Grigoriy folded before Flop (didn't bet)
Seat 5: xxxibgdrgn folded before Flop (didn't bet)
Seat 6: xxxZeka folded before Flop (didn't bet)
Seat 7: kevinho109 folded before Flop (didn't bet)
Seat 8: oscarleon folded before Flop (didn't bet)
Seat 9: kind ten (button) folded before Flop (didn't bet)





PokerStars Hand #154363170729:  Hold'em No Limit ($0.50/$1.00 USD) - 2016/06/06 12:46:24 CET [2016/06/06 6:46:24 ET]
Table 'Titius' 9-max Seat #8 is the button
Seat 1: xxxZeka ($109.98 in chips) 
Seat 2: matiko09 ($100 in chips) 
Seat 3: vanilica ($103.26 in chips) 
Seat 4: ozone2003 ($109.52 in chips) 
Seat 5: riggedsh** ($204 in chips) 
Seat 6: oscarleon ($104 in chips) 
Seat 7: ardo888 ($100 in chips) 
Seat 8: DB3333 ($51.66 in chips) 
Seat 9: PacPacBum ($100 in chips) 
PacPacBum: posts small blind $0.50
xxxZeka: posts big blind $1
*** HOLE CARDS ***
Dealt to matiko09 [3s Th]
matiko09: folds 
vanilica: folds 
ozone2003: folds 
riggedsh**: folds 
oscarleon: folds 
ardo888: folds 
DB3333: raises $1 to $2
PacPacBum: folds 
xxxZeka: folds 
Uncalled bet ($1) returned to DB3333
DB3333 collected $2.50 from pot
DB3333: doesn't show hand 
*** SUMMARY ***
Total pot $2.50 | Rake $0 
Seat 1: xxxZeka (big blind) folded before Flop
Seat 2: matiko09 folded before Flop (didn't bet)
Seat 3: vanilica folded before Flop (didn't bet)
Seat 4: ozone2003 folded before Flop (didn't bet)
Seat 5: riggedsh** folded before Flop (didn't bet)
Seat 6: oscarleon folded before Flop (didn't bet)
Seat 7: ardo888 folded before Flop (didn't bet)
Seat 8: DB3333 (button) collected ($2.50)
Seat 9: PacPacBum (small blind) folded before Flop





PokerStars Hand #154363171846:  Hold'em No Limit ($0.50/$1.00 USD) - 2016/06/06 12:46:27 CET [2016/06/06 6:46:27 ET]
Table 'Williams' 9-max Seat #1 is the button
Seat 1: matiko09 ($188.29 in chips) 
Seat 2: PacPacBum ($113.40 in chips) 
Seat 3: granbunny ($61.80 in chips) 
Seat 4: Mr.Grigoriy ($100 in chips) 
Seat 5: xxxibgdrgn ($118 in chips) 
Seat 6: xxxZeka ($100 in chips) 
Seat 7: kevinho109 ($42.08 in chips) 
Seat 8: oscarleon ($107.36 in chips) 
Seat 9: kind ten ($46.07 in chips) 
PacPacBum: posts small blind $0.50
granbunny: posts big blind $1
*** HOLE CARDS ***
Dealt to matiko09 [3s Ac]
Mr.Grigoriy: folds 
xxxibgdrgn: folds 
xxxZeka: folds 
kevinho109: raises $2 to $3
oscarleon: folds 
kind ten: folds 
matiko09: folds 
PacPacBum: folds 
granbunny: raises $5 to $8
kevinho109: calls $5
*** FLOP *** [9s 2h 2s]
granbunny: bets $53.80 and is all-in
kevinho109: folds 
Uncalled bet ($53.80) returned to granbunny
granbunny collected $15.68 from pot
granbunny: doesn't show hand 
*** SUMMARY ***
Total pot $16.50 | Rake $0.82 
Board [9s 2h 2s]
Seat 1: matiko09 (button) folded before Flop (didn't bet)
Seat 2: PacPacBum (small blind) folded before Flop
Seat 3: granbunny (big blind) collected ($15.68)
Seat 4: Mr.Grigoriy folded before Flop (didn't bet)
Seat 5: xxxibgdrgn folded before Flop (didn't bet)
Seat 6: xxxZeka folded before Flop (didn't bet)
Seat 7: kevinho109 folded on the Flop
Seat 8: oscarleon folded before Flop (didn't bet)
Seat 9: kind ten folded before Flop (didn't bet)





PokerStars Hand #154363172886:  Hold'em No Limit ($0.50/$1.00 USD) - 2016/06/06 12:46:29 CET [2016/06/06 6:46:29 ET]
Table 'Wezen II' 9-max Seat #8 is the button
Seat 1: matiko09 ($162.47 in chips) 
Seat 2: Mr.Grigoriy ($110.80 in chips) 
Seat 3: oscarleon ($100 in chips) 
Seat 4: xxxibgdrgn ($100 in chips) 
Seat 5: stds st ($48.10 in chips) 
Seat 6: masaytoo ($98.50 in chips) 
Seat 7: KDJAll3 ($77.56 in chips) 
Seat 8: mavin80 ($181.85 in chips) 
Seat 9: PacPacBum ($100 in chips) 
PacPacBum: posts small blind $0.50
matiko09: posts big blind $1
*** HOLE CARDS ***
Dealt to matiko09 [Jd 4c]
Mr.Grigoriy: folds 
oscarleon: folds 
xxxibgdrgn: folds 
stds st: folds 
masaytoo: folds 
KDJAll3: raises $1 to $2
mavin80: folds 
PacPacBum: folds 
matiko09: folds 
Uncalled bet ($1) returned to KDJAll3
KDJAll3 collected $2.50 from pot
KDJAll3: doesn't show hand 
*** SUMMARY ***
Total pot $2.50 | Rake $0 
Seat 1: matiko09 (big blind) folded before Flop
Seat 2: Mr.Grigoriy folded before Flop (didn't bet)
Seat 3: oscarleon folded before Flop (didn't bet)
Seat 4: xxxibgdrgn folded before Flop (didn't bet)
Seat 5: stds st folded before Flop (didn't bet)
Seat 6: masaytoo folded before Flop (didn't bet)
Seat 7: KDJAll3 collected ($2.50)
Seat 8: mavin80 (button) folded before Flop (didn't bet)
Seat 9: PacPacBum (small blind) folded before Flop





PokerStars Hand #154363172980:  Hold'em No Limit ($0.50/$1.00 USD) - 2016/06/06 12:46:29 CET [2016/06/06 6:46:29 ET]
Table 'Heze' 9-max Seat #7 is the button
Seat 1: matiko09 ($218.15 in chips) 
Seat 2: oscarleon ($241.81 in chips) 
Seat 3: xxxibgdrgn ($100 in chips) 
Seat 4: xxxZeka ($110.68 in chips) 
Seat 5: stds st ($40 in chips) 
Seat 6: ozone2003 ($115.79 in chips) 
Seat 7: 32rrew ($142.06 in chips) 
Seat 9: Mr.Grigoriy ($120.70 in chips) 
Mr.Grigoriy: posts small blind $0.50
matiko09: posts big blind $1
*** HOLE CARDS ***
Dealt to matiko09 [Jh 5s]
oscarleon: folds 
xxxibgdrgn: folds 
AlSmithy88 leaves the table
xxxZeka: folds 
stds st: folds 
PacPacBum joins the table at seat #8 
ozone2003: folds 
32rrew: folds 
Mr.Grigoriy: folds 
Uncalled bet ($0.50) returned to matiko09
matiko09 collected $1 from pot
matiko09: doesn't show hand 
*** SUMMARY ***
Total pot $1 | Rake $0 
Seat 1: matiko09 (big blind) collected ($1)
Seat 2: oscarleon folded before Flop (didn't bet)
Seat 3: xxxibgdrgn folded before Flop (didn't bet)
Seat 4: xxxZeka folded before Flop (didn't bet)
Seat 5: stds st folded before Flop (didn't bet)
Seat 6: ozone2003 folded before Flop (didn't bet)
Seat 7: 32rrew (button) folded before Flop (didn't bet)
Seat 9: Mr.Grigoriy (small blind) folded before Flop





PokerStars Hand #154363173754:  Hold'em No Limit ($0.50/$1.00 USD) - 2016/06/06 12:46:31 CET [2016/06/06 6:46:31 ET]
Table 'Irmgard II' 9-max Seat #3 is the button
Seat 1: matiko09 ($150.81 in chips) 
Seat 2: hammerwife ($114.82 in chips) 
Seat 3: stds st ($42.98 in chips) 
Seat 4: oscarleon ($146.76 in chips) 
Seat 5: Mr.Grigoriy ($144.76 in chips) 
Seat 6: DancerNN1 ($100 in chips) 
Seat 7: 32rrew ($154.58 in chips) 
oscarleon: posts small blind $0.50
Mr.Grigoriy: posts big blind $1
Szevasztopol: sits out 
PacPacBum: sits out 
*** HOLE CARDS ***
Dealt to matiko09 [Qd Kc]
DancerNN1: folds 
DancerNN1 leaves the table
32rrew: raises $2 to $3
matiko09: folds 
hammerwife: folds 
stds st: folds 
xxxZeka joins the table at seat #6 
oscarleon: folds 
xxxZeka leaves the table
Mr.Grigoriy: folds 
Uncalled bet ($2) returned to 32rrew
32rrew collected $2.50 from pot
32rrew: doesn't show hand 
*** SUMMARY ***
Total pot $2.50 | Rake $0 
Seat 1: matiko09 folded before Flop (didn't bet)
Seat 2: hammerwife folded before Flop (didn't bet)
Seat 3: stds st (button) folded before Flop (didn't bet)
Seat 4: oscarleon (small blind) folded before Flop
Seat 5: Mr.Grigoriy (big blind) folded before Flop
Seat 6: DancerNN1 folded before Flop (didn't bet)
Seat 7: 32rrew collected ($2.50)





PokerStars Hand #154363175490:  Hold'em No Limit ($0.50/$1.00 USD) - 2016/06/06 12:46:35 CET [2016/06/06 6:46:35 ET]
Table 'Chaldaea II' 9-max Seat #1 is the button
Seat 1: xxxZeka ($109.71 in chips) 
Seat 2: masaytoo ($96.49 in chips) 
Seat 5: Dantist1122 ($100 in chips) 
Seat 6: PacPacBum ($100 in chips) 
Seat 7: riggedsh** ($199.58 in chips) 
Seat 8: o.miro ($107 in chips) 
Seat 9: matiko09 ($104.02 in chips) 
masaytoo: posts small blind $0.50
ardo888: is sitting out 
ozone2003: is sitting out 
Dantist1122: posts big blind $1
*** HOLE CARDS ***
Dealt to matiko09 [Ts 8c]
PacPacBum: folds 
riggedsh**: folds 
o.miro: folds 
matiko09: folds 
xxxZeka: folds 
ozone2003 leaves the table
masaytoo: folds 
Uncalled bet ($0.50) returned to Dantist1122
Dantist1122 collected $1 from pot
Dantist1122: doesn't show hand 
*** SUMMARY ***
Total pot $1 | Rake $0 
Seat 1: xxxZeka (button) folded before Flop (didn't bet)
Seat 2: masaytoo (small blind) folded before Flop
Seat 5: Dantist1122 (big blind) collected ($1)
Seat 6: PacPacBum folded before Flop (didn't bet)
Seat 7: riggedsh** folded before Flop (didn't bet)
Seat 8: o.miro folded before Flop (didn't bet)
Seat 9: matiko09 folded before Flop (didn't bet)





PokerStars Hand #154363175629:  Hold'em No Limit ($0.50/$1.00 USD) - 2016/06/06 12:46:36 CET [2016/06/06 6:46:36 ET]
Table 'Safara' 9-max Seat #1 is the button
Seat 1: oscarleon ($234.44 in chips) 
Seat 4: ratzo64 ($99 in chips) 
Seat 6: matiko09 ($131.36 in chips) 
Seat 7: PacPacBum ($118.07 in chips) 
Seat 8: 32rrew ($100 in chips) 
Seat 9: Mr.Grigoriy ($101.17 in chips) 
ratzo64: posts small blind $0.50
matiko09: posts big blind $1
*** HOLE CARDS ***
Dealt to matiko09 [Jc 9d]
PacPacBum: folds 
32rrew: folds 
Mukhin1 joins the table at seat #5 
Mr.Grigoriy: raises $1.50 to $2.50
oscarleon: raises $6 to $8.50
ratzo64: folds 
matiko09: folds 
Mr.Grigoriy: folds 
Uncalled bet ($6) returned to oscarleon
oscarleon collected $6.50 from pot
oscarleon: doesn't show hand 
*** SUMMARY ***
Total pot $6.50 | Rake $0 
Seat 1: oscarleon (button) collected ($6.50)
Seat 4: ratzo64 (small blind) folded before Flop
Seat 6: matiko09 (big blind) folded before Flop
Seat 7: PacPacBum folded before Flop (didn't bet)
Seat 8: 32rrew folded before Flop (didn't bet)
Seat 9: Mr.Grigoriy folded before Flop





PokerStars Hand #154363176856:  Hold'em No Limit (€0.50/€1.00 EUR) - 2016/06/06 12:46:39 CET [2016/06/06 6:46:39 ET]
Table 'Lesath' 9-max Seat #8 is the button
Seat 1: o.miro (€101.94 in chips) 
Seat 2: thecurv (€121.42 in chips) 
Seat 4: hammerwife (€121.76 in chips) 
Seat 5: matiko09 (€101.50 in chips) 
Seat 6: Szevasztopol (€100 in chips) 
Seat 7: Mr.Grigoriy (€100 in chips) 
Seat 8: maxxmeister (€153.22 in chips) 
Seat 9: 72nloses (€110.24 in chips) 
72nloses: posts small blind €0.50
o.miro: posts big blind €1
ozone2003: sits out 
*** HOLE CARDS ***
Dealt to matiko09 [3s Ac]
thecurv: folds 
hammerwife: folds 
matiko09: folds 
Szevasztopol: folds 
Mr.Grigoriy: folds 
maxxmeister: folds 
72nloses: raises €1 to €2
o.miro: calls €1
*** FLOP *** [Js 9c Td]
72nloses: checks 
o.miro: bets €2
72nloses: calls €2
*** TURN *** [Js 9c Td] [4h]
72nloses: checks 
o.miro: checks 
*** RIVER *** [Js 9c Td 4h] [6h]
72nloses: bets €7.60
o.miro: folds 
Uncalled bet (€7.60) returned to 72nloses
72nloses collected €7.60 from pot
*** SUMMARY ***
Total pot €8 | Rake €0.40 
Board [Js 9c Td 4h 6h]
Seat 1: o.miro (big blind) folded on the River
Seat 2: thecurv folded before Flop (didn't bet)
Seat 4: hammerwife folded before Flop (didn't bet)
Seat 5: matiko09 folded before Flop (didn't bet)
Seat 6: Szevasztopol folded before Flop (didn't bet)
Seat 7: Mr.Grigoriy folded before Flop (didn't bet)
Seat 8: maxxmeister (button) folded before Flop (didn't bet)
Seat 9: 72nloses (small blind) collected (€7.60)





PokerStars Hand #154363177943:  Hold'em No Limit ($0.50/$1.00 USD) - 2016/06/06 12:46:42 CET [2016/06/06 6:46:42 ET]
Table 'Sheliak' 9-max Seat #2 is the button
Seat 1: 32rrew ($103.68 in chips) 
Seat 2: masaytoo ($94.50 in chips) 
Seat 3: oscarleon ($108 in chips) 
Seat 4: iRLM ($52.88 in chips) 
Seat 5: vanilica ($107 in chips) 
Seat 6: matiko09 ($100 in chips) 
Seat 7: stds st ($30 in chips) 
oscarleon: posts small blind $0.50
iRLM: posts big blind $1
ozone2003: sits out 
Szevasztopol: sits out 
*** HOLE CARDS ***
Dealt to matiko09 [4d Ac]
vanilica: folds 
matiko09: folds 
stds st: folds 
32rrew: folds 
masaytoo: folds 
oscarleon: folds 
Uncalled bet ($0.50) returned to iRLM
iRLM collected $1 from pot
iRLM: doesn't show hand 
*** SUMMARY ***
Total pot $1 | Rake $0 
Seat 1: 32rrew folded before Flop (didn't bet)
Seat 2: masaytoo (button) folded before Flop (didn't bet)
Seat 3: oscarleon (small blind) folded before Flop
Seat 4: iRLM (big blind) collected ($1)
Seat 5: vanilica folded before Flop (didn't bet)
Seat 6: matiko09 folded before Flop (didn't bet)
Seat 7: stds st folded before Flop (didn't bet)





PokerStars Hand #154363180174:  Hold'em No Limit ($0.50/$1.00 USD) - 2016/06/06 12:46:47 CET [2016/06/06 6:46:47 ET]
Table 'Yarilo' 9-max Seat #3 is the button
Seat 1: xxxZeka ($100 in chips) 
Seat 2: nombraalne1 ($112.44 in chips) 
Seat 3: matiko09 ($123.35 in chips) 
Seat 4: stds st ($26.87 in chips) 
Seat 6: ozone2003 ($100 in chips) 
Seat 7: KEBIN1974 ($115.79 in chips) 
Seat 8: Mr.Grigoriy ($171.03 in chips) 
Seat 9: o.miro ($100 in chips) 
stds st: posts small blind $0.50
Szevasztopol: is sitting out 
ozone2003: posts big blind $1
*** HOLE CARDS ***
Dealt to matiko09 [Jh Kd]
KEBIN1974: folds 
Mr.Grigoriy: folds 
o.miro: folds 
xxxZeka: folds 
nombraalne1: raises $1 to $2
matiko09: raises $6 to $8
stds st: folds 
ozone2003: folds 
nombraalne1: raises $17 to $25
matiko09: folds 
Uncalled bet ($17) returned to nombraalne1
nombraalne1 collected $17.50 from pot
nombraalne1: doesn't show hand 
*** SUMMARY ***
Total pot $17.50 | Rake $0 
Seat 1: xxxZeka folded before Flop (didn't bet)
Seat 2: nombraalne1 collected ($17.50)
Seat 3: matiko09 (button) folded before Flop
Seat 4: stds st (small blind) folded before Flop
Seat 6: ozone2003 (big blind) folded before Flop
Seat 7: KEBIN1974 folded before Flop (didn't bet)
Seat 8: Mr.Grigoriy folded before Flop (didn't bet)
Seat 9: o.miro folded before Flop (didn't bet)





PokerStars Hand #154363180993:  Hold'em No Limit ($0.50/$1.00 USD) - 2016/06/06 12:46:49 CET [2016/06/06 6:46:49 ET]
Table 'Titius' 9-max Seat #9 is the button
Seat 1: xxxZeka ($108.98 in chips) 
Seat 2: matiko09 ($100 in chips) 
Seat 3: vanilica ($103.26 in chips) 
Seat 4: ozone2003 ($109.52 in chips) 
Seat 5: riggedsh** ($204 in chips) 
Seat 6: oscarleon ($104 in chips) 
Seat 7: ardo888 ($100 in chips) 
Seat 8: DB3333 ($53.16 in chips) 
Seat 9: PacPacBum ($100 in chips) 
xxxZeka: posts small blind $0.50
matiko09: posts big blind $1
*** HOLE CARDS ***
Dealt to matiko09 [3h 9h]
vanilica: folds 
ozone2003: folds 
riggedsh**: folds 
oscarleon: folds 
ardo888: folds 
DB3333: raises $1 to $2
PacPacBum: calls $2
xxxZeka: folds 
matiko09: folds 
*** FLOP *** [6s Kd 5c]
DB3333: bets $2
PacPacBum: calls $2
*** TURN *** [6s Kd 5c] [Ts]
DB3333: bets $5
PacPacBum: raises $13.12 to $18.12
DB3333: calls $13.12
*** RIVER *** [6s Kd 5c Ts] [Th]
DB3333: bets $22
PacPacBum: raises $22 to $44
DB3333: calls $9.04 and is all-in
Uncalled bet ($12.96) returned to PacPacBum
*** SHOW DOWN ***
PacPacBum: shows [5d 5h] (a full house, Fives full of Tens)
DB3333: mucks hand 
PacPacBum collected $105.32 from pot
*** SUMMARY ***
Total pot $107.82 | Rake $2.50 
Board [6s Kd 5c Ts Th]
Seat 1: xxxZeka (small blind) folded before Flop
Seat 2: matiko09 (big blind) folded before Flop
Seat 3: vanilica folded before Flop (didn't bet)
Seat 4: ozone2003 folded before Flop (didn't bet)
Seat 5: riggedsh** folded before Flop (didn't bet)
Seat 6: oscarleon folded before Flop (didn't bet)
Seat 7: ardo888 folded before Flop (didn't bet)
Seat 8: DB3333 mucked [Ah Jc]
Seat 9: PacPacBum (button) showed [5d 5h] and won ($105.32) with a full house, Fives full of Tens





PokerStars Hand #154363181448:  Hold'em No Limit ($0.50/$1.00 USD) - 2016/06/06 12:46:50 CET [2016/06/06 6:46:50 ET]
Table 'Irmgard II' 9-max Seat #4 is the button
Seat 1: matiko09 ($150.81 in chips) 
Seat 2: hammerwife ($114.82 in chips) 
Seat 3: stds st ($42.98 in chips) 
Seat 4: oscarleon ($146.26 in chips) 
Seat 5: Mr.Grigoriy ($143.76 in chips) 
Seat 7: 32rrew ($156.08 in chips) 
Mr.Grigoriy: posts small blind $0.50
32rrew: posts big blind $1
Szevasztopol: sits out 
PacPacBum: sits out 
*** HOLE CARDS ***
Dealt to matiko09 [Td Ac]
matiko09: folds 
hammerwife: folds 
stds st: folds 
oscarleon: raises $2 to $3
hurtNCYDE joins the table at seat #6 
hurtNCYDE leaves the table
Mr.Grigoriy: raises $8 to $11
Mashulia7777 joins the table at seat #6 
32rrew: folds 
oscarleon: folds 
Uncalled bet ($8) returned to Mr.Grigoriy
Mr.Grigoriy collected $7 from pot
Mr.Grigoriy: doesn't show hand 
*** SUMMARY ***
Total pot $7 | Rake $0 
Seat 1: matiko09 folded before Flop (didn't bet)
Seat 2: hammerwife folded before Flop (didn't bet)
Seat 3: stds st folded before Flop (didn't bet)
Seat 4: oscarleon (button) folded before Flop
Seat 5: Mr.Grigoriy (small blind) collected ($7)
Seat 7: 32rrew (big blind) folded before Flop





PokerStars Hand #154363183124:  Hold'em No Limit ($0.50/$1.00 USD) - 2016/06/06 12:46:55 CET [2016/06/06 6:46:55 ET]
Table 'Heze' 9-max Seat #9 is the button
Seat 1: matiko09 ($218.65 in chips) 
Seat 2: oscarleon ($241.81 in chips) 
Seat 3: xxxibgdrgn ($100 in chips) 
Seat 4: xxxZeka ($110.68 in chips) 
Seat 5: stds st ($40 in chips) 
Seat 6: ozone2003 ($115.79 in chips) 
Seat 7: 32rrew ($142.06 in chips) 
Seat 9: Mr.Grigoriy ($120.20 in chips) 
matiko09: posts small blind $0.50
oscarleon: posts big blind $1
PacPacBum: sits out 
*** HOLE CARDS ***
Dealt to matiko09 [Kd 6d]
xxxibgdrgn: folds 
xxxZeka: folds 
xxxibgdrgn leaves the table
stds st: folds 
hurtNCYDE joins the table at seat #3 
hurtNCYDE leaves the table
ozone2003: raises $2 to $3
32rrew: folds 
Mr.Grigoriy: folds 
matiko09: folds 
oscarleon: raises $6 to $9
ozone2003: raises $12 to $21
oscarleon: folds 
Uncalled bet ($12) returned to ozone2003
ozone2003 collected $18.50 from pot
ozone2003: doesn't show hand 
*** SUMMARY ***
Total pot $18.50 | Rake $0 
Seat 1: matiko09 (small blind) folded before Flop
Seat 2: oscarleon (big blind) folded before Flop
Seat 3: xxxibgdrgn folded before Flop (didn't bet)
Seat 4: xxxZeka folded before Flop (didn't bet)
Seat 5: stds st folded before Flop (didn't bet)
Seat 6: ozone2003 collected ($18.50)
Seat 7: 32rrew folded before Flop (didn't bet)
Seat 9: Mr.Grigoriy (button) folded before Flop (didn't bet)





PokerStars Hand #154363183505:  Hold'em No Limit ($0.50/$1.00 USD) - 2016/06/06 12:46:55 CET [2016/06/06 6:46:55 ET]
Table 'Wezen II' 9-max Seat #9 is the button
Seat 1: matiko09 ($161.47 in chips) 
Seat 2: Mr.Grigoriy ($110.80 in chips) 
Seat 3: oscarleon ($100 in chips) 
Seat 4: xxxibgdrgn ($100 in chips) 
Seat 5: stds st ($48.10 in chips) 
Seat 6: masaytoo ($98.50 in chips) 
Seat 7: KDJAll3 ($79.06 in chips) 
Seat 8: mavin80 ($181.85 in chips) 
Seat 9: PacPacBum ($100 in chips) 
matiko09: posts small blind $0.50
Mr.Grigoriy: posts big blind $1
*** HOLE CARDS ***
Dealt to matiko09 [Jh Qd]
oscarleon: folds 
xxxibgdrgn: folds 
stds st: folds 
masaytoo: folds 
KDJAll3: folds 
mavin80: folds 
PacPacBum: folds 
matiko09: raises $2 to $3
Mr.Grigoriy: calls $2
*** FLOP *** [7h Ah 2s]
matiko09: checks 
Mr.Grigoriy: checks 
*** TURN *** [7h Ah 2s] [Js]
matiko09: checks 
Mr.Grigoriy: bets $3.81
matiko09: calls $3.81
*** RIVER *** [7h Ah 2s Js] [3h]
matiko09: checks 
Mr.Grigoriy: checks 
*** SHOW DOWN ***
matiko09: shows [Jh Qd] (a pair of Jacks)
Mr.Grigoriy: mucks hand 
matiko09 collected $12.94 from pot
*** SUMMARY ***
Total pot $13.62 | Rake $0.68 
Board [7h Ah 2s Js 3h]
Seat 1: matiko09 (small blind) showed [Jh Qd] and won ($12.94) with a pair of Jacks
Seat 2: Mr.Grigoriy (big blind) mucked [Jd 9d]
Seat 3: oscarleon folded before Flop (didn't bet)
Seat 4: xxxibgdrgn folded before Flop (didn't bet)
Seat 5: stds st folded before Flop (didn't bet)
Seat 6: masaytoo folded before Flop (didn't bet)
Seat 7: KDJAll3 folded before Flop (didn't bet)
Seat 8: mavin80 folded before Flop (didn't bet)
Seat 9: PacPacBum (button) folded before Flop (didn't bet)





PokerStars Hand #154363183593:  Hold'em No Limit ($0.50/$1.00 USD) - 2016/06/06 12:46:56 CET [2016/06/06 6:46:56 ET]
Table 'Chaldaea II' 9-max Seat #2 is the button
Seat 1: xxxZeka ($109.71 in chips) 
Seat 2: masaytoo ($95.99 in chips) 
Seat 5: Dantist1122 ($100.50 in chips) 
Seat 6: PacPacBum ($100 in chips) 
Seat 7: riggedsh** ($199.58 in chips) 
Seat 8: o.miro ($107 in chips) 
Seat 9: matiko09 ($104.02 in chips) 
Dantist1122: posts small blind $0.50
PacPacBum: posts big blind $1
*** HOLE CARDS ***
Dealt to matiko09 [8h Qs]
riggedsh**: folds 
o.miro: folds 
mooose100 joins the table at seat #4 
matiko09: folds 
xxxZeka: raises $2 to $3
masaytoo: folds 
Dantist1122: folds 
PacPacBum: folds 
Uncalled bet ($2) returned to xxxZeka
xxxZeka collected $2.50 from pot
*** SUMMARY ***
Total pot $2.50 | Rake $0 
Seat 1: xxxZeka collected ($2.50)
Seat 2: masaytoo (button) folded before Flop (didn't bet)
Seat 5: Dantist1122 (small blind) folded before Flop
Seat 6: PacPacBum (big blind) folded before Flop
Seat 7: riggedsh** folded before Flop (didn't bet)
Seat 8: o.miro folded before Flop (didn't bet)
Seat 9: matiko09 folded before Flop (didn't bet)





PokerStars Hand #154363184401:  Hold'em No Limit ($0.50/$1.00 USD) - 2016/06/06 12:46:58 CET [2016/06/06 6:46:58 ET]
Table 'Smither' 9-max Seat #2 is the button
Seat 1: PacPacBum ($192.12 in chips) 
Seat 2: matiko09 ($102.34 in chips) 
Seat 3: xxxZeka ($132.57 in chips) 
Seat 4: maxxmeister ($208.66 in chips) 
Seat 5: Szevasztopol ($102.28 in chips) 
Seat 6: riggedsh** ($107.28 in chips) 
Seat 8: 74 ROADIE ($88.50 in chips) 
Seat 9: hammerwife ($115.25 in chips) 
xxxZeka: posts small blind $0.50
maxxmeister: posts big blind $1
vanilica: sits out 
*** HOLE CARDS ***
Dealt to matiko09 [Kc Jh]
Szevasztopol: folds 
riggedsh**: folds 
74 ROADIE: folds 
hammerwife: folds 
PacPacBum: folds 
matiko09: raises $1.27 to $2.27
xxxZeka: folds 
maxxmeister: folds 
Uncalled bet ($1.27) returned to matiko09
matiko09 collected $2.50 from pot
matiko09: doesn't show hand 
*** SUMMARY ***
Total pot $2.50 | Rake $0 
Seat 1: PacPacBum folded before Flop (didn't bet)
Seat 2: matiko09 (button) collected ($2.50)
Seat 3: xxxZeka (small blind) folded before Flop
Seat 4: maxxmeister (big blind) folded before Flop
Seat 5: Szevasztopol folded before Flop (didn't bet)
Seat 6: riggedsh** folded before Flop (didn't bet)
Seat 8: 74 ROADIE folded before Flop (didn't bet)
Seat 9: hammerwife folded before Flop (didn't bet)





PokerStars Hand #154363189783:  Hold'em No Limit ($0.50/$1.00 USD) - 2016/06/06 12:47:11 CET [2016/06/06 6:47:11 ET]
Table 'Williams' 9-max Seat #2 is the button
Seat 1: matiko09 ($188.29 in chips) 
Seat 2: PacPacBum ($112.90 in chips) 
Seat 3: granbunny ($69.48 in chips) 
Seat 4: Mr.Grigoriy ($100 in chips) 
Seat 5: xxxibgdrgn ($118 in chips) 
Seat 6: xxxZeka ($100 in chips) 
Seat 7: kevinho109 ($34.08 in chips) 
Seat 8: oscarleon ($107.36 in chips) 
Seat 9: kind ten ($46.07 in chips) 
granbunny: posts small blind $0.50
Mr.Grigoriy: posts big blind $1
*** HOLE CARDS ***
Dealt to matiko09 [9c Qc]
xxxibgdrgn: folds 
xxxZeka: folds 
kevinho109: folds 
oscarleon: folds 
kind ten: folds 
matiko09: raises $1.50 to $2.50
PacPacBum: folds 
granbunny: folds 
Mr.Grigoriy: calls $1.50
*** FLOP *** [9s Ts 9h]
Mr.Grigoriy: checks 
matiko09: bets $3.39
Mr.Grigoriy: folds 
Uncalled bet ($3.39) returned to matiko09
matiko09 collected $5.22 from pot
matiko09: doesn't show hand 
*** SUMMARY ***
Total pot $5.50 | Rake $0.28 
Board [9s Ts 9h]
Seat 1: matiko09 collected ($5.22)
Seat 2: PacPacBum (button) folded before Flop (didn't bet)
Seat 3: granbunny (small blind) folded before Flop
Seat 4: Mr.Grigoriy (big blind) folded on the Flop
Seat 5: xxxibgdrgn folded before Flop (didn't bet)
Seat 6: xxxZeka folded before Flop (didn't bet)
Seat 7: kevinho109 folded before Flop (didn't bet)
Seat 8: oscarleon folded before Flop (didn't bet)
Seat 9: kind ten folded before Flop (didn't bet)





PokerStars Hand #154363190115:  Hold'em No Limit ($0.50/$1.00 USD) - 2016/06/06 12:47:12 CET [2016/06/06 6:47:12 ET]
Table 'Sheliak' 9-max Seat #3 is the button
Seat 1: 32rrew ($103.68 in chips) 
Seat 2: masaytoo ($94.50 in chips) 
Seat 3: oscarleon ($107.50 in chips) 
Seat 4: iRLM ($53.38 in chips) 
Seat 6: matiko09 ($100 in chips) 
Seat 7: stds st ($30 in chips) 
iRLM: posts small blind $0.50
vanilica: is sitting out 
vanilica leaves the table
matiko09: posts big blind $1
ozone2003: sits out 
Szevasztopol: sits out 
*** HOLE CARDS ***
Dealt to matiko09 [2c Qh]
hammerwife joins the table at seat #5 
stds st: folds 
32rrew: folds 
masaytoo: raises $2 to $3
oscarleon: folds 
iRLM: folds 
matiko09: folds 
Uncalled bet ($2) returned to masaytoo
masaytoo collected $2.50 from pot
masaytoo: doesn't show hand 
*** SUMMARY ***
Total pot $2.50 | Rake $0 
Seat 1: 32rrew folded before Flop (didn't bet)
Seat 2: masaytoo collected ($2.50)
Seat 3: oscarleon (button) folded before Flop (didn't bet)
Seat 4: iRLM (small blind) folded before Flop
Seat 6: matiko09 (big blind) folded before Flop
Seat 7: stds st folded before Flop (didn't bet)





PokerStars Hand #154363194596:  Hold'em No Limit ($0.50/$1.00 USD) - 2016/06/06 12:47:23 CET [2016/06/06 6:47:23 ET]
Table 'Smither' 9-max Seat #3 is the button
Seat 1: PacPacBum ($192.12 in chips) 
Seat 2: matiko09 ($103.84 in chips) 
Seat 3: xxxZeka ($132.07 in chips) 
Seat 4: maxxmeister ($207.66 in chips) 
Seat 5: Szevasztopol ($102.28 in chips) 
Seat 6: riggedsh** ($107.28 in chips) 
Seat 8: 74 ROADIE ($88.50 in chips) 
Seat 9: hammerwife ($115.25 in chips) 
maxxmeister: posts small blind $0.50
Szevasztopol: posts big blind $1
vanilica: sits out 
*** HOLE CARDS ***
Dealt to matiko09 [6d 8h]
riggedsh**: folds 
74 ROADIE: calls $1
hammerwife: raises $4 to $5
PacPacBum: folds 
matiko09: folds 
xxxZeka: folds 
maxxmeister: folds 
Szevasztopol: folds 
74 ROADIE: calls $4
*** FLOP *** [3s 9h Th]
74 ROADIE: bets $8
hammerwife: calls $8
*** TURN *** [3s 9h Th] [8c]
74 ROADIE: bets $15
hammerwife: raises $87.25 to $102.25 and is all-in
74 ROADIE: folds 
Uncalled bet ($87.25) returned to hammerwife
hammerwife collected $55 from pot
hammerwife: doesn't show hand 
*** SUMMARY ***
Total pot $57.50 | Rake $2.50 
Board [3s 9h Th 8c]
Seat 1: PacPacBum folded before Flop (didn't bet)
Seat 2: matiko09 folded before Flop (didn't bet)
Seat 3: xxxZeka (button) folded before Flop (didn't bet)
Seat 4: maxxmeister (small blind) folded before Flop
Seat 5: Szevasztopol (big blind) folded before Flop
Seat 6: riggedsh** folded before Flop (didn't bet)
Seat 8: 74 ROADIE folded on the Turn
Seat 9: hammerwife collected ($55)





PokerStars Hand #154363194413:  Hold'em No Limit ($0.50/$1.00 USD) - 2016/06/06 12:47:23 CET [2016/06/06 6:47:23 ET]
Table 'Chaldaea II' 9-max Seat #5 is the button
Seat 1: xxxZeka ($111.21 in chips) 
Seat 2: masaytoo ($95.99 in chips) 
Seat 5: Dantist1122 ($100 in chips) 
Seat 6: PacPacBum ($100 in chips) 
Seat 9: matiko09 ($104.02 in chips) 
PacPacBum: posts small blind $0.50
riggedsh**: is sitting out 
o.miro: is sitting out 
matiko09: posts big blind $1
mooose100: sits out 
*** HOLE CARDS ***
Dealt to matiko09 [Th Ah]
xxxZeka: folds 
masaytoo: folds 
Dantist1122: raises $1.05 to $2.05
o.miro leaves the table
PacPacBum: folds 
32rrew joins the table at seat #8 
matiko09: calls $1.05
*** FLOP *** [8c 3s Kh]
matiko09: checks 
Dantist1122: checks 
*** TURN *** [8c 3s Kh] [6h]
matiko09: checks 
Dantist1122: checks 
*** RIVER *** [8c 3s Kh 6h] [As]
matiko09: checks 
Dantist1122: bets $2.84
matiko09: calls $2.84
*** SHOW DOWN ***
Dantist1122: shows [Jh Ac] (a pair of Aces)
matiko09: mucks hand 
Dantist1122 collected $9.77 from pot
*** SUMMARY ***
Total pot $10.28 | Rake $0.51 
Board [8c 3s Kh 6h As]
Seat 1: xxxZeka folded before Flop (didn't bet)
Seat 2: masaytoo folded before Flop (didn't bet)
Seat 5: Dantist1122 (button) showed [Jh Ac] and won ($9.77) with a pair of Aces
Seat 6: PacPacBum (small blind) folded before Flop
Seat 9: matiko09 (big blind) mucked [Th Ah]





PokerStars Hand #154363200883:  Hold'em No Limit ($0.50/$1.00 USD) - 2016/06/06 12:47:39 CET [2016/06/06 6:47:39 ET]
Table 'Irmgard II' 9-max Seat #5 is the button
Seat 1: matiko09 ($150.81 in chips) 
Seat 2: hammerwife ($114.82 in chips) 
Seat 3: stds st ($42.98 in chips) 
Seat 4: oscarleon ($143.26 in chips) 
Seat 5: Mr.Grigoriy ($147.76 in chips) 
Seat 7: 32rrew ($155.08 in chips) 
Seat 8: Szevasztopol ($109.50 in chips) 
Mashulia7777 will be allowed to play after the button
32rrew: posts small blind $0.50
Szevasztopol: posts big blind $1
PacPacBum: sits out 
*** HOLE CARDS ***
Dealt to matiko09 [7c 7d]
matiko09: raises $2 to $3
hammerwife: folds 
stds st: folds 
oscarleon: folds 
Mr.Grigoriy: folds 
32rrew: folds 
Szevasztopol: folds 
Uncalled bet ($2) returned to matiko09
matiko09 collected $2.50 from pot
matiko09: doesn't show hand 
*** SUMMARY ***
Total pot $2.50 | Rake $0 
Seat 1: matiko09 collected ($2.50)
Seat 2: hammerwife folded before Flop (didn't bet)
Seat 3: stds st folded before Flop (didn't bet)
Seat 4: oscarleon folded before Flop (didn't bet)
Seat 5: Mr.Grigoriy (button) folded before Flop (didn't bet)
Seat 7: 32rrew (small blind) folded before Flop
Seat 8: Szevasztopol (big blind) folded before Flop





PokerStars Hand #154363201352:  Hold'em No Limit ($0.50/$1.00 USD) - 2016/06/06 12:47:40 CET [2016/06/06 6:47:40 ET]
Table 'Gajdariya' 9-max Seat #6 is the button
Seat 1: matiko09 ($114.23 in chips) 
Seat 2: xxxZeka ($165.24 in chips) 
Seat 3: oscarleon ($113.55 in chips) 
Seat 4: Szevasztopol ($105.13 in chips) 
Seat 5: 147734319 ($49.01 in chips) 
Seat 6: mono123viva ($149.56 in chips) 
Seat 7: Wombatkilla ($86.42 in chips) 
Seat 8: ardo888 ($100 in chips) 
Seat 9: Mr.Grigoriy ($141.25 in chips) 
Wombatkilla: posts small blind $0.50
ardo888: posts big blind $1
*** HOLE CARDS ***
Dealt to matiko09 [7h 3d]
Mr.Grigoriy: folds 
matiko09: folds 
xxxZeka: folds 
oscarleon: folds 
Szevasztopol: folds 
147734319: raises $2 to $3
mono123viva: calls $3
Wombatkilla: raises $6 to $9
ardo888: folds 
147734319: calls $6
mono123viva: calls $6
*** FLOP *** [8h Qh 5h]
Wombatkilla: checks 
147734319: checks 
mono123viva: checks 
*** TURN *** [8h Qh 5h] [6h]
Wombatkilla: checks 
147734319: checks 
mono123viva: checks 
*** RIVER *** [8h Qh 5h 6h] [8s]
Wombatkilla: bets $10
147734319: folds 
mono123viva: calls $10
*** SHOW DOWN ***
Wombatkilla: shows [Jh Js] (a flush, Queen high)
mono123viva: mucks hand 
Wombatkilla collected $45.60 from pot
*** SUMMARY ***
Total pot $48 | Rake $2.40 
Board [8h Qh 5h 6h 8s]
Seat 1: matiko09 folded before Flop (didn't bet)
Seat 2: xxxZeka folded before Flop (didn't bet)
Seat 3: oscarleon folded before Flop (didn't bet)
Seat 4: Szevasztopol folded before Flop (didn't bet)
Seat 5: 147734319 folded on the River
Seat 6: mono123viva (button) mucked [Ts Tc]
Seat 7: Wombatkilla (small blind) showed [Jh Js] and won ($45.60) with a flush, Queen high
Seat 8: ardo888 (big blind) folded before Flop
Seat 9: Mr.Grigoriy folded before Flop (didn't bet)





PokerStars Hand #154363201645:  Hold'em No Limit ($0.50/$1.00 USD) - 2016/06/06 12:47:41 CET [2016/06/06 6:47:41 ET]
Table 'Yarilo' 9-max Seat #4 is the button
Seat 1: xxxZeka ($100 in chips) 
Seat 2: nombraalne1 ($121.94 in chips) 
Seat 3: matiko09 ($115.35 in chips) 
Seat 4: stds st ($26.37 in chips) 
Seat 6: ozone2003 ($100 in chips) 
Seat 7: KEBIN1974 ($115.79 in chips) 
Seat 8: Mr.Grigoriy ($171.03 in chips) 
Seat 9: o.miro ($100 in chips) 
ozone2003: posts small blind $0.50
KEBIN1974: posts big blind $1
*** HOLE CARDS ***
Dealt to matiko09 [Ks Kc]
Mr.Grigoriy: folds 
o.miro: folds 
xxxZeka: folds 
nombraalne1: folds 
matiko09: raises $1.50 to $2.50
stds st: folds 
ozone2003: folds 
KEBIN1974: calls $1.50
*** FLOP *** [5d 5s 3c]
KEBIN1974: checks 
matiko09: checks 
*** TURN *** [5d 5s 3c] [Js]
KEBIN1974: checks 
matiko09: bets $3.39
KEBIN1974: raises $3.39 to $6.78
matiko09: calls $3.39
*** RIVER *** [5d 5s 3c Js] [7h]
KEBIN1974: checks 
matiko09: bets $11.77
KEBIN1974: raises $14.16 to $25.93
matiko09: calls $14.16
*** SHOW DOWN ***
KEBIN1974: shows [5h Jd] (a full house, Fives full of Jacks)
matiko09: mucks hand 
KEBIN1974 collected $68.42 from pot
*** SUMMARY ***
Total pot $70.92 | Rake $2.50 
Board [5d 5s 3c Js 7h]
Seat 1: xxxZeka folded before Flop (didn't bet)
Seat 2: nombraalne1 folded before Flop (didn't bet)
Seat 3: matiko09 mucked [Ks Kc]
Seat 4: stds st (button) folded before Flop (didn't bet)
Seat 6: ozone2003 (small blind) folded before Flop
Seat 7: KEBIN1974 (big blind) showed [5h Jd] and won ($68.42) with a full house, Fives full of Jacks
Seat 8: Mr.Grigoriy folded before Flop (didn't bet)
Seat 9: o.miro folded before Flop (didn't bet)





PokerStars Hand #154363202292:  Hold'em No Limit ($0.50/$1.00 USD) - 2016/06/06 12:47:42 CET [2016/06/06 6:47:42 ET]
Table 'Safara' 9-max Seat #4 is the button
Seat 1: oscarleon ($238.44 in chips) 
Seat 4: ratzo64 ($98.50 in chips) 
Seat 6: matiko09 ($130.36 in chips) 
Seat 7: PacPacBum ($118.07 in chips) 
Seat 8: 32rrew ($100 in chips) 
Seat 9: Mr.Grigoriy ($100 in chips) 
Mukhin1 will be allowed to play after the button
matiko09: posts small blind $0.50
PacPacBum: posts big blind $1
*** HOLE CARDS ***
Dealt to matiko09 [4d 3c]
32rrew: folds 
Mr.Grigoriy: folds 
oscarleon: folds 
Melvisfan joins the table at seat #3 
ratzo64: folds 
matiko09: folds 
Uncalled bet ($0.50) returned to PacPacBum
PacPacBum collected $1 from pot
PacPacBum: doesn't show hand 
*** SUMMARY ***
Total pot $1 | Rake $0 
Seat 1: oscarleon folded before Flop (didn't bet)
Seat 4: ratzo64 (button) folded before Flop (didn't bet)
Seat 6: matiko09 (small blind) folded before Flop
Seat 7: PacPacBum (big blind) collected ($1)
Seat 8: 32rrew folded before Flop (didn't bet)
Seat 9: Mr.Grigoriy folded before Flop (didn't bet)





PokerStars Hand #154363205427:  Hold'em No Limit ($0.50/$1.00 USD) - 2016/06/06 12:47:50 CET [2016/06/06 6:47:50 ET]
Table 'Sheliak' 9-max Seat #4 is the button
Seat 1: 32rrew ($103.68 in chips) 
Seat 2: masaytoo ($96 in chips) 
Seat 3: oscarleon ($107.50 in chips) 
Seat 4: iRLM ($52.88 in chips) 
Seat 6: matiko09 ($100 in chips) 
Seat 7: stds st ($30 in chips) 
hammerwife will be allowed to play after the button
matiko09: posts small blind $0.50
stds st: posts big blind $1
ozone2003: sits out 
Szevasztopol: sits out 
*** HOLE CARDS ***
Dealt to matiko09 [4s 7s]
32rrew: folds 
masaytoo: folds 
oscarleon: folds 
iRLM: calls $1
matiko09: folds 
stds st: checks 
*** FLOP *** [2s Js Ah]
stds st: checks 
iRLM: checks 
*** TURN *** [2s Js Ah] [Qs]
stds st: checks 
iRLM: bets $1
stds st: calls $1
*** RIVER *** [2s Js Ah Qs] [7h]
stds st: checks 
iRLM: bets $4.28
stds st: calls $4.28
*** SHOW DOWN ***
iRLM: shows [Ad 2h] (two pair, Aces and Deuces)
stds st: shows [Ac 7d] (two pair, Aces and Sevens)
stds st collected $12.41 from pot
*** SUMMARY ***
Total pot $13.06 | Rake $0.65 
Board [2s Js Ah Qs 7h]
Seat 1: 32rrew folded before Flop (didn't bet)
Seat 2: masaytoo folded before Flop (didn't bet)
Seat 3: oscarleon folded before Flop (didn't bet)
Seat 4: iRLM (button) showed [Ad 2h] and lost with two pair, Aces and Deuces
Seat 6: matiko09 (small blind) folded before Flop
Seat 7: stds st (big blind) showed [Ac 7d] and won ($12.41) with two pair, Aces and Sevens





PokerStars Hand #154363206204:  Hold'em No Limit ($0.50/$1.00 USD) - 2016/06/06 12:47:52 CET [2016/06/06 6:47:52 ET]
Table 'Heze' 9-max Seat #1 is the button
Seat 1: matiko09 ($218.15 in chips) 
Seat 2: oscarleon ($232.81 in chips) 
Seat 5: stds st ($40 in chips) 
Seat 6: ozone2003 ($125.29 in chips) 
Seat 7: 32rrew ($142.06 in chips) 
Seat 9: Mr.Grigoriy ($120.20 in chips) 
oscarleon: posts small blind $0.50
xxxZeka: is sitting out 
stds st: posts big blind $1
PacPacBum: sits out 
*** HOLE CARDS ***
Dealt to matiko09 [3c 4d]
ozone2003: folds 
ozone2003 leaves the table
32rrew: folds 
Mr.Grigoriy: folds 
matiko09: folds 
oscarleon: folds 
Uncalled bet ($0.50) returned to stds st
stds st collected $1 from pot
stds st: doesn't show hand 
*** SUMMARY ***
Total pot $1 | Rake $0 
Seat 1: matiko09 (button) folded before Flop (didn't bet)
Seat 2: oscarleon (small blind) folded before Flop
Seat 5: stds st (big blind) collected ($1)
Seat 6: ozone2003 folded before Flop (didn't bet)
Seat 7: 32rrew folded before Flop (didn't bet)
Seat 9: Mr.Grigoriy folded before Flop (didn't bet)





PokerStars Hand #154363214121:  Hold'em No Limit ($0.50/$1.00 USD) - 2016/06/06 12:48:11 CET [2016/06/06 6:48:11 ET]
Table 'Heze' 9-max Seat #2 is the button
Seat 1: matiko09 ($218.15 in chips) 
Seat 2: oscarleon ($232.31 in chips) 
Seat 5: stds st ($40.50 in chips) 
Seat 7: 32rrew ($142.06 in chips) 
Seat 9: Mr.Grigoriy ($120.20 in chips) 
stds st: posts small blind $0.50
32rrew: posts big blind $1
PacPacBum: sits out 
*** HOLE CARDS ***
Dealt to matiko09 [8h 3s]
Mr.Grigoriy: folds 
matiko09: folds 
yfcq36 joins the table at seat #6 
oscarleon: raises $2 to $3
stds st: folds 
32rrew: calls $2
*** FLOP *** [Ks 7s 3c]
32rrew: checks 
oscarleon: bets $5
32rrew: folds 
Uncalled bet ($5) returned to oscarleon
oscarleon collected $6.18 from pot
oscarleon: doesn't show hand 
*** SUMMARY ***
Total pot $6.50 | Rake $0.32 
Board [Ks 7s 3c]
Seat 1: matiko09 folded before Flop (didn't bet)
Seat 2: oscarleon (button) collected ($6.18)
Seat 5: stds st (small blind) folded before Flop
Seat 7: 32rrew (big blind) folded on the Flop
Seat 9: Mr.Grigoriy folded before Flop (didn't bet)





PokerStars Hand #154363214310:  Hold'em No Limit (€0.50/€1.00 EUR) - 2016/06/06 12:48:12 CET [2016/06/06 6:48:12 ET]
Table 'Lesath' 9-max Seat #9 is the button
Seat 1: o.miro (€100 in chips) 
Seat 2: thecurv (€121.42 in chips) 
Seat 4: hammerwife (€121.76 in chips) 
Seat 5: matiko09 (€101.50 in chips) 
Seat 6: Szevasztopol (€100 in chips) 
Seat 7: Mr.Grigoriy (€100 in chips) 
Seat 8: maxxmeister (€153.22 in chips) 
Seat 9: 72nloses (€113.84 in chips) 
o.miro: posts small blind €0.50
thecurv: posts big blind €1
ozone2003: sits out 
*** HOLE CARDS ***
Dealt to matiko09 [8s Ad]
hammerwife: folds 
matiko09: folds 
Szevasztopol: folds 
Mr.Grigoriy: raises €2 to €3
maxxmeister: calls €3
72nloses: folds 
o.miro: folds 
thecurv: folds 
*** FLOP *** [9d 5h 9c]
Mr.Grigoriy: checks 
maxxmeister: bets €3
Mr.Grigoriy: calls €3
*** TURN *** [9d 5h 9c] [7c]
Mr.Grigoriy: checks 
maxxmeister: checks 
*** RIVER *** [9d 5h 9c 7c] [Kc]
Mr.Grigoriy: checks 
maxxmeister: checks 
*** SHOW DOWN ***
Mr.Grigoriy: shows [Kd Ah] (two pair, Kings and Nines)
maxxmeister: mucks hand 
Mr.Grigoriy collected €12.82 from pot
*** SUMMARY ***
Total pot €13.50 | Rake €0.68 
Board [9d 5h 9c 7c Kc]
Seat 1: o.miro (small blind) folded before Flop
Seat 2: thecurv (big blind) folded before Flop
Seat 4: hammerwife folded before Flop (didn't bet)
Seat 5: matiko09 folded before Flop (didn't bet)
Seat 6: Szevasztopol folded before Flop (didn't bet)
Seat 7: Mr.Grigoriy showed [Kd Ah] and won (€12.82) with two pair, Kings and Nines
Seat 8: maxxmeister mucked [3h 3c]
Seat 9: 72nloses (button) folded before Flop (didn't bet)





PokerStars Hand #154363220112:  Hold'em No Limit ($0.50/$1.00 USD) - 2016/06/06 12:48:17 CET [2016/06/06 6:48:17 ET]
Table 'Williams' 9-max Seat #3 is the button
Seat 1: matiko09 ($191.01 in chips) 
Seat 2: PacPacBum ($112.90 in chips) 
Seat 3: granbunny ($68.98 in chips) 
Seat 4: Mr.Grigoriy ($100 in chips) 
Seat 5: xxxibgdrgn ($118 in chips) 
Seat 6: xxxZeka ($100 in chips) 
Seat 7: kevinho109 ($34.08 in chips) 
Seat 8: oscarleon ($107.36 in chips) 
Seat 9: kind ten ($46.07 in chips) 
Mr.Grigoriy: posts small blind $0.50
xxxibgdrgn: posts big blind $1
*** HOLE CARDS ***
Dealt to matiko09 [3c 2h]
xxxZeka: folds 
kevinho109: folds 
oscarleon: folds 
kind ten: folds 
matiko09: folds 
PacPacBum: folds 
granbunny: raises $2 to $3
Mr.Grigoriy: raises $7 to $10
xxxibgdrgn: folds 
granbunny: folds 
Uncalled bet ($7) returned to Mr.Grigoriy
Mr.Grigoriy collected $7 from pot
Mr.Grigoriy: doesn't show hand 
*** SUMMARY ***
Total pot $7 | Rake $0 
Seat 1: matiko09 folded before Flop (didn't bet)
Seat 2: PacPacBum folded before Flop (didn't bet)
Seat 3: granbunny (button) folded before Flop
Seat 4: Mr.Grigoriy (small blind) collected ($7)
Seat 5: xxxibgdrgn (big blind) folded before Flop
Seat 6: xxxZeka folded before Flop (didn't bet)
Seat 7: kevinho109 folded before Flop (didn't bet)
Seat 8: oscarleon folded before Flop (didn't bet)
Seat 9: kind ten folded before Flop (didn't bet)





PokerStars Hand #154363221141:  Hold'em No Limit ($0.50/$1.00 USD) - 2016/06/06 12:48:19 CET [2016/06/06 6:48:19 ET]
Table 'Safara' 9-max Seat #6 is the button
Seat 1: oscarleon ($238.44 in chips) 
Seat 4: ratzo64 ($98.50 in chips) 
Seat 6: matiko09 ($129.86 in chips) 
Seat 7: PacPacBum ($118.57 in chips) 
Seat 8: 32rrew ($100 in chips) 
Seat 9: Mr.Grigoriy ($100 in chips) 
PacPacBum: posts small blind $0.50
32rrew: posts big blind $1
Melvisfan: sits out 
Mukhin1: sits out 
*** HOLE CARDS ***
Dealt to matiko09 [6h 8s]
Mr.Grigoriy: raises $2 to $3
oscarleon: folds 
ratzo64: raises $7.50 to $10.50
matiko09: folds 
PacPacBum: folds 
32rrew: folds 
Mr.Grigoriy: raises $12.50 to $23
ratzo64: calls $12.50
*** FLOP *** [Th 8h 8d]
Mr.Grigoriy: checks 
ratzo64: checks 
*** TURN *** [Th 8h 8d] [6c]
Mr.Grigoriy: checks 
ratzo64: checks 
*** RIVER *** [Th 8h 8d 6c] [5d]
Mr.Grigoriy: checks 
ratzo64: checks 
*** SHOW DOWN ***
Mr.Grigoriy: shows [As Qc] (a pair of Eights)
ratzo64: shows [Qd Ad] (a pair of Eights)
Mr.Grigoriy collected $22.56 from pot
ratzo64 collected $22.56 from pot
*** SUMMARY ***
Total pot $47.50 | Rake $2.38 
Board [Th 8h 8d 6c 5d]
Seat 1: oscarleon folded before Flop (didn't bet)
Seat 4: ratzo64 showed [Qd Ad] and won ($22.56) with a pair of Eights
Seat 6: matiko09 (button) folded before Flop (didn't bet)
Seat 7: PacPacBum (small blind) folded before Flop
Seat 8: 32rrew (big blind) folded before Flop
Seat 9: Mr.Grigoriy showed [As Qc] and won ($22.56) with a pair of Eights





PokerStars Hand #154363223273:  Hold'em No Limit ($0.50/$1.00 USD) - 2016/06/06 12:48:25 CET [2016/06/06 6:48:25 ET]
Table 'Irmgard II' 9-max Seat #7 is the button
Seat 1: matiko09 ($152.31 in chips) 
Seat 2: hammerwife ($114.82 in chips) 
Seat 3: stds st ($42.98 in chips) 
Seat 4: oscarleon ($143.26 in chips) 
Seat 5: Mr.Grigoriy ($147.76 in chips) 
Seat 7: 32rrew ($154.58 in chips) 
Seat 8: Szevasztopol ($108.50 in chips) 
Seat 9: PacPacBum ($100 in chips) 
Szevasztopol: posts small blind $0.50
PacPacBum: posts big blind $1
Mashulia7777: sits out 
*** HOLE CARDS ***
Dealt to matiko09 [4h 8d]
matiko09: folds 
hammerwife: raises $2 to $3
stds st: folds 
oscarleon: folds 
Mr.Grigoriy: folds 
32rrew: folds 
Szevasztopol: folds 
PacPacBum: folds 
Uncalled bet ($2) returned to hammerwife
hammerwife collected $2.50 from pot
hammerwife: doesn't show hand 
*** SUMMARY ***
Total pot $2.50 | Rake $0 
Seat 1: matiko09 folded before Flop (didn't bet)
Seat 2: hammerwife collected ($2.50)
Seat 3: stds st folded before Flop (didn't bet)
Seat 4: oscarleon folded before Flop (didn't bet)
Seat 5: Mr.Grigoriy folded before Flop (didn't bet)
Seat 7: 32rrew (button) folded before Flop (didn't bet)
Seat 8: Szevasztopol (small blind) folded before Flop
Seat 9: PacPacBum (big blind) folded before Flop





PokerStars Hand #154363225332:  Hold'em No Limit ($0.50/$1.00 USD) - 2016/06/06 12:48:30 CET [2016/06/06 6:48:30 ET]
Table 'Wezen II' 9-max Seat #1 is the button
Seat 1: matiko09 ($167.60 in chips) 
Seat 2: Mr.Grigoriy ($103.99 in chips) 
Seat 3: oscarleon ($100 in chips) 
Seat 4: xxxibgdrgn ($100 in chips) 
Seat 5: stds st ($48.10 in chips) 
Seat 6: masaytoo ($98.50 in chips) 
Seat 7: KDJAll3 ($79.06 in chips) 
Seat 8: mavin80 ($181.85 in chips) 
Seat 9: PacPacBum ($100 in chips) 
Mr.Grigoriy: posts small blind $0.50
oscarleon: posts big blind $1
*** HOLE CARDS ***
Dealt to matiko09 [Ah 6d]
xxxibgdrgn: folds 
stds st: raises $1.50 to $2.50
masaytoo: folds 
KDJAll3: folds 
mavin80: folds 
PacPacBum: folds 
matiko09: folds 
Mr.Grigoriy: raises $5 to $7.50
oscarleon: folds 
stds st: raises $5 to $12.50
Mr.Grigoriy: calls $5
*** FLOP *** [Ts Jh 4c]
Mr.Grigoriy: checks 
stds st: bets $8.50
Mr.Grigoriy: calls $8.50
*** TURN *** [Ts Jh 4c] [As]
Mr.Grigoriy: checks 
stds st: checks 
*** RIVER *** [Ts Jh 4c As] [8s]
Mr.Grigoriy: checks 
stds st: checks 
*** SHOW DOWN ***
Mr.Grigoriy: shows [Ac Qh] (a pair of Aces)
stds st: mucks hand 
Mr.Grigoriy collected $40.85 from pot
*** SUMMARY ***
Total pot $43 | Rake $2.15 
Board [Ts Jh 4c As 8s]
Seat 1: matiko09 (button) folded before Flop (didn't bet)
Seat 2: Mr.Grigoriy (small blind) showed [Ac Qh] and won ($40.85) with a pair of Aces
Seat 3: oscarleon (big blind) folded before Flop
Seat 4: xxxibgdrgn folded before Flop (didn't bet)
Seat 5: stds st mucked [Ks Kd]
Seat 6: masaytoo folded before Flop (didn't bet)
Seat 7: KDJAll3 folded before Flop (didn't bet)
Seat 8: mavin80 folded before Flop (didn't bet)
Seat 9: PacPacBum folded before Flop (didn't bet)





PokerStars Hand #154363228228:  Hold'em No Limit ($0.50/$1.00 USD) - 2016/06/06 12:48:37 CET [2016/06/06 6:48:37 ET]
Table 'Titius' 9-max Seat #1 is the button
Seat 1: xxxZeka ($108.48 in chips) 
Seat 2: matiko09 ($100 in chips) 
Seat 3: vanilica ($103.26 in chips) 
Seat 4: ozone2003 ($109.52 in chips) 
Seat 5: riggedsh** ($204 in chips) 
Seat 6: oscarleon ($104 in chips) 
Seat 7: ardo888 ($100 in chips) 
Seat 9: PacPacBum ($152.16 in chips) 
matiko09: posts small blind $0.50
vanilica: posts big blind $1
*** HOLE CARDS ***
Dealt to matiko09 [Qs Ks]
ozone2003: folds 
riggedsh**: folds 
oscarleon: folds 
ardo888: folds 
PacPacBum: folds 
DB3333 leaves the table
hurtNCYDE joins the table at seat #8 
hurtNCYDE leaves the table
xxxZeka: folds 
Dantist1122 joins the table at seat #8 
matiko09: raises $2 to $3
vanilica: folds 
Uncalled bet ($2) returned to matiko09
matiko09 collected $2 from pot
matiko09: doesn't show hand 
*** SUMMARY ***
Total pot $2 | Rake $0 
Seat 1: xxxZeka (button) folded before Flop (didn't bet)
Seat 2: matiko09 (small blind) collected ($2)
Seat 3: vanilica (big blind) folded before Flop
Seat 4: ozone2003 folded before Flop (didn't bet)
Seat 5: riggedsh** folded before Flop (didn't bet)
Seat 6: oscarleon folded before Flop (didn't bet)
Seat 7: ardo888 folded before Flop (didn't bet)
Seat 9: PacPacBum folded before Flop (didn't bet)





PokerStars Hand #154363232014:  Hold'em No Limit ($0.50/$1.00 USD) - 2016/06/06 12:48:46 CET [2016/06/06 6:48:46 ET]
Table 'Chaldaea II' 9-max Seat #6 is the button
Seat 2: masaytoo ($95.99 in chips) 
Seat 4: mooose100 ($80 in chips) 
Seat 5: Dantist1122 ($104.88 in chips) 
Seat 6: PacPacBum ($100 in chips) 
Seat 9: matiko09 ($100 in chips) 
32rrew will be allowed to play after the button
matiko09: posts small blind $0.50
xxxZeka: is sitting out 
masaytoo: posts big blind $1
ardo888: sits out 
mooose100: posts big blind $1
*** HOLE CARDS ***
Dealt to matiko09 [7h 2d]
mooose100: checks 
xxxZeka leaves the table
Dantist1122: raises $4 to $5
Szevasztopol joins the table at seat #1 
PacPacBum: folds 
matiko09: folds 
masaytoo: folds 
mooose100: folds 
Uncalled bet ($4) returned to Dantist1122
Dantist1122 collected $3.50 from pot
Dantist1122: doesn't show hand 
*** SUMMARY ***
Total pot $3.50 | Rake $0 
Seat 2: masaytoo (big blind) folded before Flop
Seat 4: mooose100 folded before Flop
Seat 5: Dantist1122 collected ($3.50)
Seat 6: PacPacBum (button) folded before Flop (didn't bet)
Seat 9: matiko09 (small blind) folded before Flop





PokerStars Hand #154363233572:  Hold'em No Limit ($0.50/$1.00 USD) - 2016/06/06 12:48:50 CET [2016/06/06 6:48:50 ET]
Table 'Heze' 9-max Seat #5 is the button
Seat 1: matiko09 ($218.15 in chips) 
Seat 2: oscarleon ($235.49 in chips) 
Seat 5: stds st ($40 in chips) 
Seat 7: 32rrew ($139.06 in chips) 
Seat 8: PacPacBum ($100 in chips) 
Seat 9: Mr.Grigoriy ($120.20 in chips) 
yfcq36 will be allowed to play after the button
32rrew: posts small blind $0.50
PacPacBum: posts big blind $1
*** HOLE CARDS ***
Dealt to matiko09 [Ah Qs]
ozone2003 joins the table at seat #3 
Mr.Grigoriy: raises $2 to $3
matiko09: calls $3
oscarleon: folds 
stds st: folds 
32rrew: folds 
xxxZeka leaves the table
hurtNCYDE joins the table at seat #4 
PacPacBum: folds 
*** FLOP *** [5s 9d Kd]
hurtNCYDE leaves the table
Mr.Grigoriy: bets $5.06
matiko09: folds 
Uncalled bet ($5.06) returned to Mr.Grigoriy
Mr.Grigoriy collected $7.12 from pot
Mr.Grigoriy: doesn't show hand 
*** SUMMARY ***
Total pot $7.50 | Rake $0.38 
Board [5s 9d Kd]
Seat 1: matiko09 folded on the Flop
Seat 2: oscarleon folded before Flop (didn't bet)
Seat 5: stds st (button) folded before Flop (didn't bet)
Seat 7: 32rrew (small blind) folded before Flop
Seat 8: PacPacBum (big blind) folded before Flop
Seat 9: Mr.Grigoriy collected ($7.12)





PokerStars Hand #154363237577:  Hold'em No Limit ($0.50/$1.00 USD) - 2016/06/06 12:49:00 CET [2016/06/06 6:49:00 ET]
Table 'Smither' 9-max Seat #4 is the button
Seat 1: PacPacBum ($192.12 in chips) 
Seat 2: matiko09 ($103.84 in chips) 
Seat 3: xxxZeka ($132.07 in chips) 
Seat 4: maxxmeister ($207.16 in chips) 
Seat 5: Szevasztopol ($101.28 in chips) 
Seat 6: riggedsh** ($107.28 in chips) 
Seat 8: 74 ROADIE ($60.50 in chips) 
Seat 9: hammerwife ($142.25 in chips) 
Szevasztopol: posts small blind $0.50
riggedsh**: posts big blind $1
vanilica: sits out 
*** HOLE CARDS ***
Dealt to matiko09 [7s Td]
74 ROADIE: folds 
hammerwife: raises $2 to $3
PacPacBum: folds 
matiko09: folds 
xxxZeka: folds 
maxxmeister: folds 
Szevasztopol: folds 
riggedsh**: folds 
Uncalled bet ($2) returned to hammerwife
hammerwife collected $2.50 from pot
hammerwife: doesn't show hand 
*** SUMMARY ***
Total pot $2.50 | Rake $0 
Seat 1: PacPacBum folded before Flop (didn't bet)
Seat 2: matiko09 folded before Flop (didn't bet)
Seat 3: xxxZeka folded before Flop (didn't bet)
Seat 4: maxxmeister (button) folded before Flop (didn't bet)
Seat 5: Szevasztopol (small blind) folded before Flop
Seat 6: riggedsh** (big blind) folded before Flop
Seat 8: 74 ROADIE folded before Flop (didn't bet)
Seat 9: hammerwife collected ($2.50)





PokerStars Hand #154363239450:  Hold'em No Limit ($0.50/$1.00 USD) - 2016/06/06 12:49:04 CET [2016/06/06 6:49:04 ET]
Table 'Sheliak' 9-max Seat #6 is the button
Seat 1: 32rrew ($103.68 in chips) 
Seat 2: masaytoo ($96 in chips) 
Seat 3: oscarleon ($107.50 in chips) 
Seat 4: iRLM ($46.60 in chips) 
Seat 5: hammerwife ($100 in chips) 
Seat 6: matiko09 ($100 in chips) 
Seat 7: stds st ($36.13 in chips) 
Seat 8: ozone2003 ($100 in chips) 
stds st: posts small blind $0.50
ozone2003: posts big blind $1
Szevasztopol: sits out 
hammerwife: posts big blind $1
*** HOLE CARDS ***
Dealt to matiko09 [7h Jh]
32rrew: folds 
masaytoo: folds 
oscarleon: folds 
iRLM: calls $1
hammerwife: raises $4 to $5
matiko09: folds 
stds st: folds 
ozone2003: folds 
iRLM: folds 
Uncalled bet ($4) returned to hammerwife
hammerwife collected $3.50 from pot
hammerwife: doesn't show hand 
*** SUMMARY ***
Total pot $3.50 | Rake $0 
Seat 1: 32rrew folded before Flop (didn't bet)
Seat 2: masaytoo folded before Flop (didn't bet)
Seat 3: oscarleon folded before Flop (didn't bet)
Seat 4: iRLM folded before Flop
Seat 5: hammerwife collected ($3.50)
Seat 6: matiko09 (button) folded before Flop (didn't bet)
Seat 7: stds st (small blind) folded before Flop
Seat 8: ozone2003 (big blind) folded before Flop





PokerStars Hand #154363240144:  Hold'em No Limit ($0.50/$1.00 USD) - 2016/06/06 12:49:06 CET [2016/06/06 6:49:06 ET]
Table 'Titius' 9-max Seat #2 is the button
Seat 1: xxxZeka ($108.48 in chips) 
Seat 2: matiko09 ($101 in chips) 
Seat 3: vanilica ($102.26 in chips) 
Seat 4: ozone2003 ($109.52 in chips) 
Seat 5: riggedsh** ($204 in chips) 
Seat 6: oscarleon ($104 in chips) 
Seat 7: ardo888 ($100 in chips) 
Seat 9: PacPacBum ($152.16 in chips) 
vanilica: posts small blind $0.50
ozone2003: posts big blind $1
Dantist1122: sits out 
*** HOLE CARDS ***
Dealt to matiko09 [7c 3h]
riggedsh**: folds 
oscarleon: folds 
ardo888: folds 
PacPacBum: folds 
xxxZeka: folds 
matiko09: folds 
vanilica: raises $2 to $3
ozone2003: folds 
Uncalled bet ($2) returned to vanilica
vanilica collected $2 from pot
vanilica: doesn't show hand 
*** SUMMARY ***
Total pot $2 | Rake $0 
Seat 1: xxxZeka folded before Flop (didn't bet)
Seat 2: matiko09 (button) folded before Flop (didn't bet)
Seat 3: vanilica (small blind) collected ($2)
Seat 4: ozone2003 (big blind) folded before Flop
Seat 5: riggedsh** folded before Flop (didn't bet)
Seat 6: oscarleon folded before Flop (didn't bet)
Seat 7: ardo888 folded before Flop (didn't bet)
Seat 9: PacPacBum folded before Flop (didn't bet)





PokerStars Hand #154363246439:  Hold'em No Limit ($0.50/$1.00 USD) - 2016/06/06 12:49:21 CET [2016/06/06 6:49:21 ET]
Table 'Gajdariya' 9-max Seat #7 is the button
Seat 1: matiko09 ($114.23 in chips) 
Seat 2: xxxZeka ($165.24 in chips) 
Seat 3: oscarleon ($113.55 in chips) 
Seat 4: Szevasztopol ($105.13 in chips) 
Seat 5: 147734319 ($40.01 in chips) 
Seat 6: mono123viva ($130.56 in chips) 
Seat 7: Wombatkilla ($113.02 in chips) 
Seat 8: ardo888 ($100 in chips) 
Seat 9: Mr.Grigoriy ($141.25 in chips) 
ardo888: posts small blind $0.50
Mr.Grigoriy: posts big blind $1
*** HOLE CARDS ***
Dealt to matiko09 [Jd 3d]
matiko09: folds 
xxxZeka: folds 
oscarleon: folds 
Szevasztopol: folds 
147734319: raises $2 to $3
mono123viva: folds 
Wombatkilla: calls $3
ardo888: folds 
Mr.Grigoriy: folds 
*** FLOP *** [As Kd 6d]
147734319: bets $4
Wombatkilla: folds 
Uncalled bet ($4) returned to 147734319
147734319 collected $7.12 from pot
147734319: doesn't show hand 
*** SUMMARY ***
Total pot $7.50 | Rake $0.38 
Board [As Kd 6d]
Seat 1: matiko09 folded before Flop (didn't bet)
Seat 2: xxxZeka folded before Flop (didn't bet)
Seat 3: oscarleon folded before Flop (didn't bet)
Seat 4: Szevasztopol folded before Flop (didn't bet)
Seat 5: 147734319 collected ($7.12)
Seat 6: mono123viva folded before Flop (didn't bet)
Seat 7: Wombatkilla (button) folded on the Flop
Seat 8: ardo888 (small blind) folded before Flop
Seat 9: Mr.Grigoriy (big blind) folded before Flop





PokerStars Hand #154363247652:  Hold'em No Limit ($0.50/$1.00 USD) - 2016/06/06 12:49:24 CET [2016/06/06 6:49:24 ET]
Table 'Chaldaea II' 9-max Seat #9 is the button
Seat 2: masaytoo ($94.99 in chips) 
Seat 3: ardo888 ($111.11 in chips) 
Seat 4: mooose100 ($79 in chips) 
Seat 5: Dantist1122 ($107.38 in chips) 
Seat 6: PacPacBum ($100 in chips) 
Seat 9: matiko09 ($100 in chips) 
Szevasztopol will be allowed to play after the button
masaytoo: posts small blind $0.50
ardo888: posts big blind $1
32rrew: sits out 
*** HOLE CARDS ***
Dealt to matiko09 [Kc 6c]
mooose100 has timed out
mooose100: folds 
Dantist1122: folds 
PacPacBum: folds 
matiko09: raises $1.27 to $2.27
masaytoo: folds 
ardo888: folds 
Uncalled bet ($1.27) returned to matiko09
matiko09 collected $2.50 from pot
matiko09: doesn't show hand 
*** SUMMARY ***
Total pot $2.50 | Rake $0 
Seat 2: masaytoo (small blind) folded before Flop
Seat 3: ardo888 (big blind) folded before Flop
Seat 4: mooose100 folded before Flop (didn't bet)
Seat 5: Dantist1122 folded before Flop (didn't bet)
Seat 6: PacPacBum folded before Flop (didn't bet)
Seat 9: matiko09 (button) collected ($2.50)





PokerStars Hand #154363250046:  Hold'em No Limit ($0.50/$1.00 USD) - 2016/06/06 12:49:30 CET [2016/06/06 6:49:30 ET]
Table 'Heze' 9-max Seat #7 is the button
Seat 1: matiko09 ($215.15 in chips) 
Seat 2: oscarleon ($235.49 in chips) 
Seat 5: stds st ($40 in chips) 
Seat 7: 32rrew ($138.56 in chips) 
Seat 8: PacPacBum ($100 in chips) 
Seat 9: Mr.Grigoriy ($124.32 in chips) 
PacPacBum: posts small blind $0.50
Mr.Grigoriy: posts big blind $1
ozone2003: sits out 
yfcq36: sits out 
*** HOLE CARDS ***
Dealt to matiko09 [6h 3s]
matiko09: folds 
oscarleon: folds 
stds st: folds 
32rrew: folds 
ardo888 joins the table at seat #4 
PacPacBum: raises $1.04 to $2.04
Mr.Grigoriy: calls $1.04
*** FLOP *** [Jh 4c Jc]
PacPacBum: checks 
Mr.Grigoriy: checks 
*** TURN *** [Jh 4c Jc] [5c]
PacPacBum: checks 
Mr.Grigoriy: checks 
*** RIVER *** [Jh 4c Jc 5c] [Qh]
PacPacBum: checks 
Mr.Grigoriy: bets $2.75
PacPacBum: folds 
Uncalled bet ($2.75) returned to Mr.Grigoriy
Mr.Grigoriy collected $3.88 from pot
Mr.Grigoriy: doesn't show hand 
*** SUMMARY ***
Total pot $4.08 | Rake $0.20 
Board [Jh 4c Jc 5c Qh]
Seat 1: matiko09 folded before Flop (didn't bet)
Seat 2: oscarleon folded before Flop (didn't bet)
Seat 5: stds st folded before Flop (didn't bet)
Seat 7: 32rrew (button) folded before Flop (didn't bet)
Seat 8: PacPacBum (small blind) folded on the River
Seat 9: Mr.Grigoriy (big blind) collected ($3.88)





PokerStars Hand #154363252115:  Hold'em No Limit ($0.50/$1.00 USD) - 2016/06/06 12:49:35 CET [2016/06/06 6:49:35 ET]
Table 'Sheliak' 9-max Seat #7 is the button
Seat 1: 32rrew ($103.68 in chips) 
Seat 2: masaytoo ($96 in chips) 
Seat 3: oscarleon ($107.50 in chips) 
Seat 4: iRLM ($45.60 in chips) 
Seat 5: hammerwife ($102.50 in chips) 
Seat 6: matiko09 ($100 in chips) 
Seat 7: stds st ($35.63 in chips) 
Seat 8: ozone2003 ($100 in chips) 
Seat 9: Szevasztopol ($100 in chips) 
ozone2003: posts small blind $0.50
Szevasztopol: posts big blind $1
*** HOLE CARDS ***
Dealt to matiko09 [6h 2s]
32rrew: folds 
masaytoo: raises $2 to $3
oscarleon: folds 
iRLM: folds 
hammerwife: folds 
matiko09: folds 
stds st: folds 
ozone2003: folds 
Szevasztopol: folds 
Uncalled bet ($2) returned to masaytoo
masaytoo collected $2.50 from pot
masaytoo: doesn't show hand 
*** SUMMARY ***
Total pot $2.50 | Rake $0 
Seat 1: 32rrew folded before Flop (didn't bet)
Seat 2: masaytoo collected ($2.50)
Seat 3: oscarleon folded before Flop (didn't bet)
Seat 4: iRLM folded before Flop (didn't bet)
Seat 5: hammerwife folded before Flop (didn't bet)
Seat 6: matiko09 folded before Flop (didn't bet)
Seat 7: stds st (button) folded before Flop (didn't bet)
Seat 8: ozone2003 (small blind) folded before Flop
Seat 9: Szevasztopol (big blind) folded before Flop





PokerStars Hand #154363252997:  Hold'em No Limit ($0.50/$1.00 USD) - 2016/06/06 12:49:37 CET [2016/06/06 6:49:37 ET]
Table 'Titius' 9-max Seat #3 is the button
Seat 1: xxxZeka ($108.48 in chips) 
Seat 2: matiko09 ($101 in chips) 
Seat 3: vanilica ($103.26 in chips) 
Seat 4: ozone2003 ($108.52 in chips) 
Seat 5: riggedsh** ($204 in chips) 
Seat 6: oscarleon ($104 in chips) 
Seat 7: ardo888 ($100 in chips) 
Seat 9: PacPacBum ($152.16 in chips) 
ozone2003: posts small blind $0.50
riggedsh**: posts big blind $1
Dantist1122: sits out 
*** HOLE CARDS ***
Dealt to matiko09 [3s Ts]
oscarleon: folds 
ardo888: folds 
PacPacBum: folds 
xxxZeka: folds 
matiko09: folds 
vanilica: folds 
ozone2003: folds 
Uncalled bet ($0.50) returned to riggedsh**
riggedsh** collected $1 from pot
riggedsh**: doesn't show hand 
*** SUMMARY ***
Total pot $1 | Rake $0 
Seat 1: xxxZeka folded before Flop (didn't bet)
Seat 2: matiko09 folded before Flop (didn't bet)
Seat 3: vanilica (button) folded before Flop (didn't bet)
Seat 4: ozone2003 (small blind) folded before Flop
Seat 5: riggedsh** (big blind) collected ($1)
Seat 6: oscarleon folded before Flop (didn't bet)
Seat 7: ardo888 folded before Flop (didn't bet)
Seat 9: PacPacBum folded before Flop (didn't bet)





PokerStars Hand #154363252698:  Hold'em No Limit ($0.50/$1.00 USD) - 2016/06/06 12:49:37 CET [2016/06/06 6:49:37 ET]
Table 'Williams' 9-max Seat #4 is the button
Seat 1: matiko09 ($191.01 in chips) 
Seat 2: PacPacBum ($112.90 in chips) 
Seat 3: granbunny ($65.98 in chips) 
Seat 4: Mr.Grigoriy ($104 in chips) 
Seat 5: xxxibgdrgn ($117 in chips) 
Seat 6: xxxZeka ($100 in chips) 
Seat 7: kevinho109 ($34.08 in chips) 
Seat 8: oscarleon ($107.36 in chips) 
Seat 9: kind ten ($46.07 in chips) 
xxxibgdrgn: posts small blind $0.50
xxxZeka: posts big blind $1
*** HOLE CARDS ***
Dealt to matiko09 [6s 2c]
kevinho109: folds 
oscarleon: folds 
kind ten: folds 
matiko09: folds 
PacPacBum: folds 
granbunny: folds 
Mr.Grigoriy: folds 
xxxibgdrgn: raises $2 to $3
xxxZeka: calls $2
*** FLOP *** [Kd Js Jh]
xxxibgdrgn: bets $4
xxxZeka: calls $4
*** TURN *** [Kd Js Jh] [5c]
xxxibgdrgn: checks 
xxxZeka: checks 
*** RIVER *** [Kd Js Jh 5c] [Kh]
xxxibgdrgn: checks 
xxxZeka: bets $7
xxxibgdrgn: folds 
Uncalled bet ($7) returned to xxxZeka
xxxZeka collected $13.30 from pot
*** SUMMARY ***
Total pot $14 | Rake $0.70 
Board [Kd Js Jh 5c Kh]
Seat 1: matiko09 folded before Flop (didn't bet)
Seat 2: PacPacBum folded before Flop (didn't bet)
Seat 3: granbunny folded before Flop (didn't bet)
Seat 4: Mr.Grigoriy (button) folded before Flop (didn't bet)
Seat 5: xxxibgdrgn (small blind) folded on the River
Seat 6: xxxZeka (big blind) collected ($13.30)
Seat 7: kevinho109 folded before Flop (didn't bet)
Seat 8: oscarleon folded before Flop (didn't bet)
Seat 9: kind ten folded before Flop (didn't bet)





PokerStars Hand #154363253785:  Hold'em No Limit ($0.50/$1.00 USD) - 2016/06/06 12:49:39 CET [2016/06/06 6:49:39 ET]
Table 'Yarilo' 9-max Seat #6 is the button
Seat 1: xxxZeka ($100 in chips) 
Seat 2: nombraalne1 ($121.94 in chips) 
Seat 3: matiko09 ($100 in chips) 
Seat 4: stds st ($26.37 in chips) 
Seat 6: ozone2003 ($100 in chips) 
Seat 7: KEBIN1974 ($149 in chips) 
Seat 8: Mr.Grigoriy ($171.03 in chips) 
Seat 9: o.miro ($100 in chips) 
KEBIN1974: posts small blind $0.50
Mr.Grigoriy: posts big blind $1
*** HOLE CARDS ***
Dealt to matiko09 [5c 7c]
o.miro: folds 
xxxZeka: raises $2 to $3
nombraalne1: folds 
matiko09: folds 
stds st: folds 
ozone2003: calls $3
KEBIN1974: calls $2.50
Mr.Grigoriy: calls $2
*** FLOP *** [5h 6h 3h]
KEBIN1974: checks 
Mr.Grigoriy: checks 
xxxZeka: bets $7.59
ozone2003: folds 
KEBIN1974: folds 
Mr.Grigoriy: folds 
Uncalled bet ($7.59) returned to xxxZeka
xxxZeka collected $11.40 from pot
*** SUMMARY ***
Total pot $12 | Rake $0.60 
Board [5h 6h 3h]
Seat 1: xxxZeka collected ($11.40)
Seat 2: nombraalne1 folded before Flop (didn't bet)
Seat 3: matiko09 folded before Flop (didn't bet)
Seat 4: stds st folded before Flop (didn't bet)
Seat 6: ozone2003 (button) folded on the Flop
Seat 7: KEBIN1974 (small blind) folded on the Flop
Seat 8: Mr.Grigoriy (big blind) folded on the Flop
Seat 9: o.miro folded before Flop (didn't bet)





PokerStars Hand #154363259226:  Hold'em No Limit ($0.50/$1.00 USD) - 2016/06/06 12:49:52 CET [2016/06/06 6:49:52 ET]
Table 'Titius' 9-max Seat #4 is the button
Seat 1: xxxZeka ($108.48 in chips) 
Seat 2: matiko09 ($101 in chips) 
Seat 3: vanilica ($103.26 in chips) 
Seat 4: ozone2003 ($108.02 in chips) 
Seat 5: riggedsh** ($204.50 in chips) 
Seat 6: oscarleon ($104 in chips) 
Seat 7: ardo888 ($100 in chips) 
Seat 9: PacPacBum ($152.16 in chips) 
riggedsh**: posts small blind $0.50
oscarleon: posts big blind $1
Dantist1122: sits out 
*** HOLE CARDS ***
Dealt to matiko09 [5d 4c]
ardo888: folds 
ardo888 leaves the table
PacPacBum: raises $1.04 to $2.04
xxxZeka: folds 
matiko09: folds 
vanilica: folds 
ozone2003: folds 
riggedsh**: folds 
oscarleon: folds 
Uncalled bet ($1.04) returned to PacPacBum
PacPacBum collected $2.50 from pot
PacPacBum: doesn't show hand 
*** SUMMARY ***
Total pot $2.50 | Rake $0 
Seat 1: xxxZeka folded before Flop (didn't bet)
Seat 2: matiko09 folded before Flop (didn't bet)
Seat 3: vanilica folded before Flop (didn't bet)
Seat 4: ozone2003 (button) folded before Flop (didn't bet)
Seat 5: riggedsh** (small blind) folded before Flop
Seat 6: oscarleon (big blind) folded before Flop
Seat 7: ardo888 folded before Flop (didn't bet)
Seat 9: PacPacBum collected ($2.50)





PokerStars Hand #154363259981:  Hold'em No Limit ($0.50/$1.00 USD) - 2016/06/06 12:49:54 CET [2016/06/06 6:49:54 ET]
Table 'Smither' 9-max Seat #5 is the button
Seat 1: PacPacBum ($192.12 in chips) 
Seat 2: matiko09 ($103.84 in chips) 
Seat 3: xxxZeka ($132.07 in chips) 
Seat 4: maxxmeister ($207.16 in chips) 
Seat 5: Szevasztopol ($100.78 in chips) 
Seat 6: riggedsh** ($106.28 in chips) 
Seat 7: vanilica ($100 in chips) 
Seat 8: 74 ROADIE ($60.50 in chips) 
Seat 9: hammerwife ($143.75 in chips) 
riggedsh**: posts small blind $0.50
vanilica: posts big blind $1
*** HOLE CARDS ***
Dealt to matiko09 [2h Ah]
74 ROADIE: folds 
hammerwife: folds 
PacPacBum: folds 
matiko09: folds 
xxxZeka: folds 
maxxmeister: folds 
Szevasztopol: folds 
riggedsh**: folds 
Uncalled bet ($0.50) returned to vanilica
vanilica collected $1 from pot
vanilica: doesn't show hand 
*** SUMMARY ***
Total pot $1 | Rake $0 
Seat 1: PacPacBum folded before Flop (didn't bet)
Seat 2: matiko09 folded before Flop (didn't bet)
Seat 3: xxxZeka folded before Flop (didn't bet)
Seat 4: maxxmeister folded before Flop (didn't bet)
Seat 5: Szevasztopol (button) folded before Flop (didn't bet)
Seat 6: riggedsh** (small blind) folded before Flop
Seat 7: vanilica (big blind) collected ($1)
Seat 8: 74 ROADIE folded before Flop (didn't bet)
Seat 9: hammerwife folded before Flop (didn't bet)





PokerStars Hand #154363261985:  Hold'em No Limit ($0.50/$1.00 USD) - 2016/06/06 12:49:59 CET [2016/06/06 6:49:59 ET]
Table 'Chaldaea II' 9-max Seat #2 is the button
Seat 2: masaytoo ($94.49 in chips) 
Seat 3: ardo888 ($110.11 in chips) 
Seat 6: PacPacBum ($100 in chips) 
Seat 9: matiko09 ($101.50 in chips) 
ardo888: posts small blind $0.50
Dantist1122: is sitting out 
Dantist1122 leaves the table
PacPacBum: posts big blind $1
riggedsh**: sits out 
32rrew: sits out 
Szevasztopol: sits out 
*** HOLE CARDS ***
Dealt to matiko09 [6s Qc]
matiko09: folds 
masaytoo: raises $2 to $3
ardo888: folds 
PacPacBum: folds 
Uncalled bet ($2) returned to masaytoo
masaytoo collected $2.50 from pot
masaytoo: doesn't show hand 
*** SUMMARY ***
Total pot $2.50 | Rake $0 
Seat 2: masaytoo (button) collected ($2.50)
Seat 3: ardo888 (small blind) folded before Flop
Seat 6: PacPacBum (big blind) folded before Flop
Seat 9: matiko09 folded before Flop (didn't bet)





PokerStars Hand #154363262113:  Hold'em No Limit ($0.50/$1.00 USD) - 2016/06/06 12:50:00 CET [2016/06/06 6:50:00 ET]
Table 'Sheliak' 9-max Seat #8 is the button
Seat 1: 32rrew ($103.68 in chips) 
Seat 2: masaytoo ($97.50 in chips) 
Seat 3: oscarleon ($107.50 in chips) 
Seat 4: iRLM ($45.60 in chips) 
Seat 5: hammerwife ($102.50 in chips) 
Seat 6: matiko09 ($100 in chips) 
Seat 7: stds st ($35.63 in chips) 
Seat 8: ozone2003 ($100 in chips) 
Seat 9: Szevasztopol ($100 in chips) 
Szevasztopol: posts small blind $0.50
32rrew: posts big blind $1
*** HOLE CARDS ***
Dealt to matiko09 [Th Js]
masaytoo: folds 
oscarleon: folds 
iRLM: calls $1
hammerwife: folds 
matiko09: folds 
stds st: folds 
ozone2003: folds 
Szevasztopol: calls $0.50
32rrew: checks 
*** FLOP *** [Ks 2s Qc]
Szevasztopol: checks 
32rrew: checks 
iRLM: checks 
*** TURN *** [Ks 2s Qc] [Ah]
Szevasztopol: checks 
32rrew: bets $2
iRLM: calls $2
Szevasztopol: calls $2
*** RIVER *** [Ks 2s Qc Ah] [9c]
Szevasztopol: checks 
32rrew: checks 
iRLM: bets $8
Szevasztopol: folds 
32rrew: calls $8
*** SHOW DOWN ***
iRLM: shows [Qs Kh] (two pair, Kings and Queens)
32rrew: mucks hand 
iRLM collected $23.75 from pot
*** SUMMARY ***
Total pot $25 | Rake $1.25 
Board [Ks 2s Qc Ah 9c]
Seat 1: 32rrew (big blind) mucked [Ac 8h]
Seat 2: masaytoo folded before Flop (didn't bet)
Seat 3: oscarleon folded before Flop (didn't bet)
Seat 4: iRLM showed [Qs Kh] and won ($23.75) with two pair, Kings and Queens
Seat 5: hammerwife folded before Flop (didn't bet)
Seat 6: matiko09 folded before Flop (didn't bet)
Seat 7: stds st folded before Flop (didn't bet)
Seat 8: ozone2003 (button) folded before Flop (didn't bet)
Seat 9: Szevasztopol (small blind) folded on the River





PokerStars Hand #154363262862:  Hold'em No Limit (€0.50/€1.00 EUR) - 2016/06/06 12:50:01 CET [2016/06/06 6:50:01 ET]
Table 'Lesath' 9-max Seat #1 is the button
Seat 1: o.miro (€100 in chips) 
Seat 2: thecurv (€120.42 in chips) 
Seat 3: ozone2003 (€100 in chips) 
Seat 4: hammerwife (€121.76 in chips) 
Seat 5: matiko09 (€101.50 in chips) 
Seat 6: Szevasztopol (€100 in chips) 
Seat 7: Mr.Grigoriy (€106.82 in chips) 
Seat 8: maxxmeister (€147.22 in chips) 
Seat 9: 72nloses (€113.84 in chips) 
thecurv: posts small blind €0.50
ozone2003: posts big blind €1
*** HOLE CARDS ***
Dealt to matiko09 [5d Kc]
hammerwife: folds 
matiko09: folds 
Szevasztopol: folds 
Mr.Grigoriy: folds 
maxxmeister: folds 
72nloses: raises €2.50 to €3.50
o.miro: folds 
thecurv: calls €3
ozone2003: raises €14.90 to €18.40
72nloses: calls €14.90
thecurv: raises €102.02 to €120.42 and is all-in
ozone2003: calls €81.60 and is all-in
72nloses: folds 
Uncalled bet (€20.42) returned to thecurv
*** FLOP *** [Th 2h 6s]
*** TURN *** [Th 2h 6s] [2s]
*** RIVER *** [Th 2h 6s 2s] [Ad]
*** SHOW DOWN ***
thecurv: shows [Qh Qc] (two pair, Queens and Deuces)
ozone2003: shows [As Kd] (two pair, Aces and Deuces)
ozone2003 collected €216.15 from pot
*** SUMMARY ***
Total pot €218.40 | Rake €2.25 
Board [Th 2h 6s 2s Ad]
Seat 1: o.miro (button) folded before Flop (didn't bet)
Seat 2: thecurv (small blind) showed [Qh Qc] and lost with two pair, Queens and Deuces
Seat 3: ozone2003 (big blind) showed [As Kd] and won (€216.15) with two pair, Aces and Deuces
Seat 4: hammerwife folded before Flop (didn't bet)
Seat 5: matiko09 folded before Flop (didn't bet)
Seat 6: Szevasztopol folded before Flop (didn't bet)
Seat 7: Mr.Grigoriy folded before Flop (didn't bet)
Seat 8: maxxmeister folded before Flop (didn't bet)
Seat 9: 72nloses folded before Flop





PokerStars Hand #154363269689:  Hold'em No Limit ($0.50/$1.00 USD) - 2016/06/06 12:50:18 CET [2016/06/06 6:50:18 ET]
Table 'Gajdariya' 9-max Seat #8 is the button
Seat 1: matiko09 ($114.23 in chips) 
Seat 2: xxxZeka ($165.24 in chips) 
Seat 3: oscarleon ($113.55 in chips) 
Seat 4: Szevasztopol ($105.13 in chips) 
Seat 5: 147734319 ($44.13 in chips) 
Seat 6: mono123viva ($130.56 in chips) 
Seat 7: Wombatkilla ($110.02 in chips) 
Seat 8: ardo888 ($100 in chips) 
Seat 9: Mr.Grigoriy ($140.25 in chips) 
Mr.Grigoriy: posts small blind $0.50
matiko09: posts big blind $1
*** HOLE CARDS ***
Dealt to matiko09 [Jh Qh]
xxxZeka: folds 
oscarleon: folds 
Szevasztopol: raises $1.14 to $2.14
147734319: folds 
mono123viva: calls $2.14
Wombatkilla: raises $5.86 to $8
ardo888: folds 
Mr.Grigoriy: folds 
matiko09: folds 
Szevasztopol: raises $14 to $22
mono123viva: folds 
Wombatkilla: calls $14
*** FLOP *** [3s Kd 9s]
Szevasztopol: bets $22.63
Wombatkilla: calls $22.63
*** TURN *** [3s Kd 9s] [6c]
Szevasztopol: bets $60.50 and is all-in
Wombatkilla: folds 
Uncalled bet ($60.50) returned to Szevasztopol
Szevasztopol collected $90.40 from pot
Szevasztopol: doesn't show hand 
*** SUMMARY ***
Total pot $92.90 | Rake $2.50 
Board [3s Kd 9s 6c]
Seat 1: matiko09 (big blind) folded before Flop
Seat 2: xxxZeka folded before Flop (didn't bet)
Seat 3: oscarleon folded before Flop (didn't bet)
Seat 4: Szevasztopol collected ($90.40)
Seat 5: 147734319 folded before Flop (didn't bet)
Seat 6: mono123viva folded before Flop
Seat 7: Wombatkilla folded on the Turn
Seat 8: ardo888 (button) folded before Flop (didn't bet)
Seat 9: Mr.Grigoriy (small blind) folded before Flop





PokerStars Hand #154363271431:  Hold'em No Limit ($0.50/$1.00 USD) - 2016/06/06 12:50:23 CET [2016/06/06 6:50:23 ET]
Table 'Chaldaea II' 9-max Seat #3 is the button
Seat 2: masaytoo ($95.99 in chips) 
Seat 3: ardo888 ($109.61 in chips) 
Seat 6: PacPacBum ($100 in chips) 
Seat 8: 32rrew ($100 in chips) 
Seat 9: matiko09 ($101.50 in chips) 
PacPacBum: posts small blind $0.50
32rrew: posts big blind $1
Szevasztopol: sits out 
*** HOLE CARDS ***
Dealt to matiko09 [9h 6h]
matiko09: folds 
masaytoo: folds 
ardo888: raises $1.50 to $2.50
PacPacBum: raises $5.50 to $8
32rrew: folds 
stds st joins the table at seat #5 
ardo888: folds 
Uncalled bet ($5.50) returned to PacPacBum
PacPacBum collected $6 from pot
PacPacBum: doesn't show hand 
*** SUMMARY ***
Total pot $6 | Rake $0 
Seat 2: masaytoo folded before Flop (didn't bet)
Seat 3: ardo888 (button) folded before Flop
Seat 6: PacPacBum (small blind) collected ($6)
Seat 8: 32rrew (big blind) folded before Flop
Seat 9: matiko09 folded before Flop (didn't bet)





PokerStars Hand #154363271947:  Hold'em No Limit ($0.50/$1.00 USD) - 2016/06/06 12:50:24 CET [2016/06/06 6:50:24 ET]
Table 'Titius' 9-max Seat #5 is the button
Seat 1: xxxZeka ($108.48 in chips) 
Seat 2: matiko09 ($101 in chips) 
Seat 3: vanilica ($103.26 in chips) 
Seat 4: ozone2003 ($108.02 in chips) 
Seat 5: riggedsh** ($204 in chips) 
Seat 6: oscarleon ($103 in chips) 
Seat 8: Dantist1122 ($100 in chips) 
Seat 9: PacPacBum ($153.66 in chips) 
oscarleon: posts small blind $0.50
Dantist1122: posts big blind $1
*** HOLE CARDS ***
Dealt to matiko09 [5c 6h]
PacPacBum: raises $1.04 to $2.04
xxxZeka: folds 
matiko09: folds 
vanilica: folds 
ozone2003: calls $2.04
riggedsh**: folds 
oscarleon: folds 
Dantist1122: folds 
*** FLOP *** [Ac Ah 6c]
PacPacBum: checks 
ozone2003: bets $3.44
PacPacBum: calls $3.44
*** TURN *** [Ac Ah 6c] [Qh]
PacPacBum: checks 
ozone2003: bets $8.46
PacPacBum: raises $15.53 to $23.99
ozone2003: folds 
Uncalled bet ($15.53) returned to PacPacBum
PacPacBum collected $27.91 from pot
PacPacBum: doesn't show hand 
*** SUMMARY ***
Total pot $29.38 | Rake $1.47 
Board [Ac Ah 6c Qh]
Seat 1: xxxZeka folded before Flop (didn't bet)
Seat 2: matiko09 folded before Flop (didn't bet)
Seat 3: vanilica folded before Flop (didn't bet)
Seat 4: ozone2003 folded on the Turn
Seat 5: riggedsh** (button) folded before Flop (didn't bet)
Seat 6: oscarleon (small blind) folded before Flop
Seat 8: Dantist1122 (big blind) folded before Flop
Seat 9: PacPacBum collected ($27.91)





PokerStars Hand #154363275747:  Hold'em No Limit ($0.50/$1.00 USD) - 2016/06/06 12:50:33 CET [2016/06/06 6:50:33 ET]
Table 'Smither' 9-max Seat #6 is the button
Seat 1: PacPacBum ($192.12 in chips) 
Seat 2: matiko09 ($103.84 in chips) 
Seat 3: xxxZeka ($132.07 in chips) 
Seat 4: maxxmeister ($207.16 in chips) 
Seat 5: Szevasztopol ($100.78 in chips) 
Seat 6: riggedsh** ($105.78 in chips) 
Seat 7: vanilica ($100.50 in chips) 
Seat 8: 74 ROADIE ($60.50 in chips) 
Seat 9: hammerwife ($143.75 in chips) 
vanilica: posts small blind $0.50
74 ROADIE: posts big blind $1
*** HOLE CARDS ***
Dealt to matiko09 [Th 8d]
hammerwife: folds 
PacPacBum: folds 
matiko09: folds 
xxxZeka: folds 
maxxmeister: folds 
Szevasztopol: folds 
riggedsh**: raises $1.50 to $2.50
vanilica: folds 
74 ROADIE: calls $1.50
*** FLOP *** [6d 3s 4d]
74 ROADIE: checks 
riggedsh**: bets $1
74 ROADIE: folds 
Uncalled bet ($1) returned to riggedsh**
riggedsh** collected $5.22 from pot
riggedsh**: doesn't show hand 
*** SUMMARY ***
Total pot $5.50 | Rake $0.28 
Board [6d 3s 4d]
Seat 1: PacPacBum folded before Flop (didn't bet)
Seat 2: matiko09 folded before Flop (didn't bet)
Seat 3: xxxZeka folded before Flop (didn't bet)
Seat 4: maxxmeister folded before Flop (didn't bet)
Seat 5: Szevasztopol folded before Flop (didn't bet)
Seat 6: riggedsh** (button) collected ($5.22)
Seat 7: vanilica (small blind) folded before Flop
Seat 8: 74 ROADIE (big blind) folded on the Flop
Seat 9: hammerwife folded before Flop (didn't bet)





PokerStars Hand #154363279683:  Hold'em No Limit ($0.50/$1.00 USD) - 2016/06/06 12:50:43 CET [2016/06/06 6:50:43 ET]
Table 'Safara' 9-max Seat #7 is the button
Seat 1: oscarleon ($238.44 in chips) 
Seat 3: Melvisfan ($100 in chips) 
Seat 4: ratzo64 ($98.06 in chips) 
Seat 6: matiko09 ($129.86 in chips) 
Seat 7: PacPacBum ($118.07 in chips) 
Seat 8: 32rrew ($100 in chips) 
Seat 9: Mr.Grigoriy ($100 in chips) 
32rrew: posts small blind $0.50
Mr.Grigoriy: posts big blind $1
Melvisfan: posts big blind $1
Mukhin1: sits out 
*** HOLE CARDS ***
Dealt to matiko09 [2h 8c]
oscarleon: raises $3.50 to $4.50
Melvisfan: folds 
ratzo64: folds 
matiko09: folds 
PacPacBum: folds 
32rrew: folds 
Mr.Grigoriy: folds 
Uncalled bet ($3.50) returned to oscarleon
oscarleon collected $3.50 from pot
oscarleon: doesn't show hand 
*** SUMMARY ***
Total pot $3.50 | Rake $0 
Seat 1: oscarleon collected ($3.50)
Seat 3: Melvisfan folded before Flop
Seat 4: ratzo64 folded before Flop (didn't bet)
Seat 6: matiko09 folded before Flop (didn't bet)
Seat 7: PacPacBum (button) folded before Flop (didn't bet)
Seat 8: 32rrew (small blind) folded before Flop
Seat 9: Mr.Grigoriy (big blind) folded before Flop





PokerStars Hand #154363281210:  Hold'em No Limit ($0.50/$1.00 USD) - 2016/06/06 12:50:46 CET [2016/06/06 6:50:46 ET]
Table 'Williams' 9-max Seat #5 is the button
Seat 1: matiko09 ($191.01 in chips) 
Seat 2: PacPacBum ($112.90 in chips) 
Seat 3: granbunny ($65.98 in chips) 
Seat 4: Mr.Grigoriy ($104 in chips) 
Seat 5: xxxibgdrgn ($110 in chips) 
Seat 6: xxxZeka ($106.30 in chips) 
Seat 7: kevinho109 ($34.08 in chips) 
Seat 8: oscarleon ($107.36 in chips) 
Seat 9: kind ten ($46.07 in chips) 
xxxZeka: posts small blind $0.50
kevinho109: posts big blind $1
*** HOLE CARDS ***
Dealt to matiko09 [4s Kd]
oscarleon: folds 
kind ten: folds 
matiko09: folds 
PacPacBum: folds 
granbunny: folds 
Mr.Grigoriy: folds 
xxxibgdrgn: raises $1.50 to $2.50
xxxZeka: raises $6.50 to $9
kevinho109: folds 
xxxibgdrgn: raises $10 to $19
xxxZeka: calls $10
*** FLOP *** [5c Jc 9d]
xxxZeka: checks 
xxxibgdrgn: checks 
*** TURN *** [5c Jc 9d] [Td]
xxxZeka: bets $17
xxxibgdrgn: folds 
Uncalled bet ($17) returned to xxxZeka
xxxZeka collected $37.05 from pot
*** SUMMARY ***
Total pot $39 | Rake $1.95 
Board [5c Jc 9d Td]
Seat 1: matiko09 folded before Flop (didn't bet)
Seat 2: PacPacBum folded before Flop (didn't bet)
Seat 3: granbunny folded before Flop (didn't bet)
Seat 4: Mr.Grigoriy folded before Flop (didn't bet)
Seat 5: xxxibgdrgn (button) folded on the Turn
Seat 6: xxxZeka (small blind) collected ($37.05)
Seat 7: kevinho109 (big blind) folded before Flop
Seat 8: oscarleon folded before Flop (didn't bet)
Seat 9: kind ten folded before Flop (didn't bet)





PokerStars Hand #154363283902:  Hold'em No Limit ($0.50/$1.00 USD) - 2016/06/06 12:50:53 CET [2016/06/06 6:50:53 ET]
Table 'Heze' 9-max Seat #8 is the button
Seat 1: matiko09 ($215.15 in chips) 
Seat 2: oscarleon ($235.49 in chips) 
Seat 5: stds st ($40 in chips) 
Seat 7: 32rrew ($138.56 in chips) 
Seat 8: PacPacBum ($100 in chips) 
Seat 9: Mr.Grigoriy ($126.16 in chips) 
Mr.Grigoriy: posts small blind $0.50
matiko09: posts big blind $1
ozone2003: sits out 
ardo888: sits out 
yfcq36: sits out 
*** HOLE CARDS ***
Dealt to matiko09 [6s 2d]
oscarleon: folds 
stds st: folds 
32rrew: folds 
PacPacBum: folds 
Mr.Grigoriy: raises $1 to $2
matiko09: folds 
Uncalled bet ($1) returned to Mr.Grigoriy
Mr.Grigoriy collected $2 from pot
Mr.Grigoriy: doesn't show hand 
*** SUMMARY ***
Total pot $2 | Rake $0 
Seat 1: matiko09 (big blind) folded before Flop
Seat 2: oscarleon folded before Flop (didn't bet)
Seat 5: stds st folded before Flop (didn't bet)
Seat 7: 32rrew folded before Flop (didn't bet)
Seat 8: PacPacBum (button) folded before Flop (didn't bet)
Seat 9: Mr.Grigoriy (small blind) collected ($2)





PokerStars Hand #154363284341:  Hold'em No Limit ($0.50/$1.00 USD) - 2016/06/06 12:50:54 CET [2016/06/06 6:50:54 ET]
Table 'Chaldaea II' 9-max Seat #6 is the button
Seat 2: masaytoo ($95.99 in chips) 
Seat 3: ardo888 ($107.11 in chips) 
Seat 4: mooose100 ($79 in chips) 
Seat 6: PacPacBum ($103.50 in chips) 
Seat 8: 32rrew ($100 in chips) 
Seat 9: matiko09 ($101.50 in chips) 
32rrew: posts small blind $0.50
matiko09: posts big blind $1
Szevasztopol: sits out 
mooose100: posts small & big blinds $1.50
stds st: sits out 
*** HOLE CARDS ***
Dealt to matiko09 [Jd Ah]
masaytoo: folds 
ardo888: folds 
mooose100: checks 
PacPacBum: folds 
32rrew: folds 
matiko09: raises $3.50 to $4.50
mooose100: folds 
Uncalled bet ($3.50) returned to matiko09
matiko09 collected $3 from pot
matiko09: doesn't show hand 
*** SUMMARY ***
Total pot $3 | Rake $0 
Seat 2: masaytoo folded before Flop (didn't bet)
Seat 3: ardo888 folded before Flop (didn't bet)
Seat 4: mooose100 folded before Flop
Seat 6: PacPacBum (button) folded before Flop (didn't bet)
Seat 8: 32rrew (small blind) folded before Flop
Seat 9: matiko09 (big blind) collected ($3)





PokerStars Hand #154363285103:  Hold'em No Limit ($0.50/$1.00 USD) - 2016/06/06 12:50:56 CET [2016/06/06 6:50:56 ET]
Table 'Yarilo' 9-max Seat #7 is the button
Seat 1: xxxZeka ($108.40 in chips) 
Seat 2: nombraalne1 ($121.94 in chips) 
Seat 3: matiko09 ($100 in chips) 
Seat 4: stds st ($26.37 in chips) 
Seat 6: ozone2003 ($100 in chips) 
Seat 7: KEBIN1974 ($146 in chips) 
Seat 8: Mr.Grigoriy ($168.03 in chips) 
Seat 9: o.miro ($100 in chips) 
Mr.Grigoriy: posts small blind $0.50
o.miro: posts big blind $1
*** HOLE CARDS ***
Dealt to matiko09 [Qh 8h]
xxxZeka: folds 
nombraalne1: raises $1.50 to $2.50
matiko09: folds 
stds st: folds 
ozone2003: folds 
KEBIN1974 has timed out
KEBIN1974: folds 
Mr.Grigoriy: folds 
o.miro: folds 
Uncalled bet ($1.50) returned to nombraalne1
nombraalne1 collected $2.50 from pot
nombraalne1: doesn't show hand 
*** SUMMARY ***
Total pot $2.50 | Rake $0 
Seat 1: xxxZeka folded before Flop (didn't bet)
Seat 2: nombraalne1 collected ($2.50)
Seat 3: matiko09 folded before Flop (didn't bet)
Seat 4: stds st folded before Flop (didn't bet)
Seat 6: ozone2003 folded before Flop (didn't bet)
Seat 7: KEBIN1974 (button) folded before Flop (didn't bet)
Seat 8: Mr.Grigoriy (small blind) folded before Flop
Seat 9: o.miro (big blind) folded before Flop





PokerStars Hand #154363292389:  Hold'em No Limit ($0.50/$1.00 USD) - 2016/06/06 12:51:14 CET [2016/06/06 6:51:14 ET]
Table 'Smither' 9-max Seat #7 is the button
Seat 1: PacPacBum ($192.12 in chips) 
Seat 2: matiko09 ($103.84 in chips) 
Seat 3: xxxZeka ($132.07 in chips) 
Seat 4: maxxmeister ($207.16 in chips) 
Seat 5: Szevasztopol ($100.78 in chips) 
Seat 6: riggedsh** ($108.50 in chips) 
Seat 7: vanilica ($100 in chips) 
Seat 8: 74 ROADIE ($58 in chips) 
Seat 9: hammerwife ($143.75 in chips) 
74 ROADIE: posts small blind $0.50
hammerwife: posts big blind $1
*** HOLE CARDS ***
Dealt to matiko09 [Jc 2h]
PacPacBum: folds 
matiko09: folds 
xxxZeka: folds 
maxxmeister: folds 
Szevasztopol: raises $1.14 to $2.14
riggedsh**: calls $2.14
vanilica: calls $2.14
74 ROADIE: raises $11.14 to $13.28
hammerwife: folds 
Szevasztopol: folds 
riggedsh**: folds 
vanilica: folds 
Uncalled bet ($11.14) returned to 74 ROADIE
74 ROADIE collected $9.56 from pot
*** SUMMARY ***
Total pot $9.56 | Rake $0 
Seat 1: PacPacBum folded before Flop (didn't bet)
Seat 2: matiko09 folded before Flop (didn't bet)
Seat 3: xxxZeka folded before Flop (didn't bet)
Seat 4: maxxmeister folded before Flop (didn't bet)
Seat 5: Szevasztopol folded before Flop
Seat 6: riggedsh** folded before Flop
Seat 7: vanilica (button) folded before Flop
Seat 8: 74 ROADIE (small blind) collected ($9.56)
Seat 9: hammerwife (big blind) folded before Flop





PokerStars Hand #154363298593:  Hold'em No Limit ($0.50/$1.00 USD) - 2016/06/06 12:51:28 CET [2016/06/06 6:51:28 ET]
Table 'Chaldaea II' 9-max Seat #8 is the button
Seat 1: Szevasztopol ($100 in chips) 
Seat 2: masaytoo ($95.99 in chips) 
Seat 3: ardo888 ($107.11 in chips) 
Seat 4: mooose100 ($77.50 in chips) 
Seat 6: PacPacBum ($103.50 in chips) 
Seat 8: 32rrew ($100 in chips) 
Seat 9: matiko09 ($103.50 in chips) 
matiko09: posts small blind $0.50
Szevasztopol: posts big blind $1
stds st: sits out 
riggedsh**: sits out 
*** HOLE CARDS ***
Dealt to matiko09 [Js 2c]
masaytoo: folds 
ardo888: folds 
mooose100: folds 
PacPacBum: folds 
32rrew: raises $1.50 to $2.50
matiko09: folds 
Szevasztopol: calls $1.50
*** FLOP *** [6d 4h 4c]
Szevasztopol: bets $3.45
32rrew: folds 
Uncalled bet ($3.45) returned to Szevasztopol
Szevasztopol collected $5.22 from pot
Szevasztopol: doesn't show hand 
*** SUMMARY ***
Total pot $5.50 | Rake $0.28 
Board [6d 4h 4c]
Seat 1: Szevasztopol (big blind) collected ($5.22)
Seat 2: masaytoo folded before Flop (didn't bet)
Seat 3: ardo888 folded before Flop (didn't bet)
Seat 4: mooose100 folded before Flop (didn't bet)
Seat 6: PacPacBum folded before Flop (didn't bet)
Seat 8: 32rrew (button) folded on the Flop
Seat 9: matiko09 (small blind) folded before Flop





PokerStars Hand #154363299782:  Hold'em No Limit ($0.50/$1.00 USD) - 2016/06/06 12:51:31 CET [2016/06/06 6:51:31 ET]
Table 'Safara' 9-max Seat #8 is the button
Seat 1: oscarleon ($240.94 in chips) 
Seat 3: Melvisfan ($99 in chips) 
Seat 4: ratzo64 ($98.06 in chips) 
Seat 6: matiko09 ($129.86 in chips) 
Seat 7: PacPacBum ($118.07 in chips) 
Seat 8: 32rrew ($100 in chips) 
Seat 9: Mr.Grigoriy ($100 in chips) 
Mr.Grigoriy: posts small blind $0.50
oscarleon: posts big blind $1
Mukhin1: sits out 
*** HOLE CARDS ***
Dealt to matiko09 [Ad 7c]
Melvisfan: calls $1
ratzo64: folds 
matiko09: folds 
PacPacBum: folds 
32rrew: folds 
Mr.Grigoriy: folds 
oscarleon: raises $2.50 to $3.50
Melvisfan: calls $2.50
*** FLOP *** [5h 4c Qh]
oscarleon: bets $5
Melvisfan: folds 
Uncalled bet ($5) returned to oscarleon
oscarleon collected $7.12 from pot
oscarleon: doesn't show hand 
*** SUMMARY ***
Total pot $7.50 | Rake $0.38 
Board [5h 4c Qh]
Seat 1: oscarleon (big blind) collected ($7.12)
Seat 3: Melvisfan folded on the Flop
Seat 4: ratzo64 folded before Flop (didn't bet)
Seat 6: matiko09 folded before Flop (didn't bet)
Seat 7: PacPacBum folded before Flop (didn't bet)
Seat 8: 32rrew (button) folded before Flop (didn't bet)
Seat 9: Mr.Grigoriy (small blind) folded before Flop





PokerStars Hand #154363301170:  Hold'em No Limit ($0.50/$1.00 USD) - 2016/06/06 12:51:35 CET [2016/06/06 6:51:35 ET]
Table 'Heze' 9-max Seat #9 is the button
Seat 1: matiko09 ($214.15 in chips) 
Seat 2: oscarleon ($235.49 in chips) 
Seat 5: stds st ($40 in chips) 
Seat 7: 32rrew ($138.56 in chips) 
Seat 8: PacPacBum ($100 in chips) 
Seat 9: Mr.Grigoriy ($127.16 in chips) 
matiko09: posts small blind $0.50
oscarleon: posts big blind $1
ozone2003: sits out 
ardo888: sits out 
yfcq36: sits out 
*** HOLE CARDS ***
Dealt to matiko09 [Qd Td]
stds st: folds 
32rrew: raises $2 to $3
PacPacBum: folds 
Mr.Grigoriy: folds 
matiko09: folds 
oscarleon: calls $2
*** FLOP *** [6h 4d 6d]
oscarleon: checks 
32rrew: bets $4.11
oscarleon: calls $4.11
*** TURN *** [6h 4d 6d] [7h]
oscarleon: checks 
32rrew: bets $11.18
oscarleon: calls $11.18
*** RIVER *** [6h 4d 6d 7h] [Qs]
oscarleon: checks 
32rrew: bets $26
oscarleon: calls $26
*** SHOW DOWN ***
32rrew: shows [6s As] (three of a kind, Sixes)
oscarleon: mucks hand 
32rrew collected $86.58 from pot
*** SUMMARY ***
Total pot $89.08 | Rake $2.50 
Board [6h 4d 6d 7h Qs]
Seat 1: matiko09 (small blind) folded before Flop
Seat 2: oscarleon (big blind) mucked [5c 5h]
Seat 5: stds st folded before Flop (didn't bet)
Seat 7: 32rrew showed [6s As] and won ($86.58) with three of a kind, Sixes
Seat 8: PacPacBum folded before Flop (didn't bet)
Seat 9: Mr.Grigoriy (button) folded before Flop (didn't bet)





PokerStars Hand #154363305345:  Hold'em No Limit ($0.50/$1.00 USD) - 2016/06/06 12:51:45 CET [2016/06/06 6:51:45 ET]
Table 'Yarilo' 9-max Seat #8 is the button
Seat 1: xxxZeka ($108.40 in chips) 
Seat 2: nombraalne1 ($123.44 in chips) 
Seat 3: matiko09 ($100 in chips) 
Seat 4: stds st ($26.37 in chips) 
Seat 6: ozone2003 ($100 in chips) 
Seat 8: Mr.Grigoriy ($167.53 in chips) 
Seat 9: o.miro ($100 in chips) 
o.miro: posts small blind $0.50
xxxZeka: posts big blind $1
*** HOLE CARDS ***
Dealt to matiko09 [9s Qc]
nombraalne1: folds 
matiko09: folds 
stds st: folds 
ozone2003: folds 
Mr.Grigoriy: folds 
o.miro: raises $2 to $3
xxxZeka: raises $5 to $8
o.miro: raises $14 to $22
xxxZeka: folds 
Uncalled bet ($14) returned to o.miro
o.miro collected $16 from pot
o.miro: doesn't show hand 
*** SUMMARY ***
Total pot $16 | Rake $0 
Seat 1: xxxZeka (big blind) folded before Flop
Seat 2: nombraalne1 folded before Flop (didn't bet)
Seat 3: matiko09 folded before Flop (didn't bet)
Seat 4: stds st folded before Flop (didn't bet)
Seat 6: ozone2003 folded before Flop (didn't bet)
Seat 8: Mr.Grigoriy (button) folded before Flop (didn't bet)
Seat 9: o.miro (small blind) collected ($16)





PokerStars Hand #154363306851:  Hold'em No Limit ($0.50/$1.00 USD) - 2016/06/06 12:51:49 CET [2016/06/06 6:51:49 ET]
Table 'Titius' 9-max Seat #6 is the button
Seat 2: matiko09 ($101 in chips) 
Seat 3: vanilica ($103.26 in chips) 
Seat 4: ozone2003 ($100 in chips) 
Seat 5: riggedsh** ($204 in chips) 
Seat 6: oscarleon ($102.50 in chips) 
Seat 8: Dantist1122 ($100 in chips) 
Dantist1122: posts small blind $0.50
PacPacBum: is sitting out 
xxxZeka: is sitting out 
matiko09: posts big blind $1
*** HOLE CARDS ***
Dealt to matiko09 [Ks 6c]
vanilica: raises $1.85 to $2.85
PacPacBum leaves the table
ozone2003: folds 
hurtNCYDE joins the table at seat #7 
riggedsh**: folds 
oscarleon: folds 
hurtNCYDE leaves the table
Dantist1122: folds 
matiko09: folds 
Uncalled bet ($1.85) returned to vanilica
vanilica collected $2.50 from pot
vanilica: doesn't show hand 
*** SUMMARY ***
Total pot $2.50 | Rake $0 
Seat 2: matiko09 (big blind) folded before Flop
Seat 3: vanilica collected ($2.50)
Seat 4: ozone2003 folded before Flop (didn't bet)
Seat 5: riggedsh** folded before Flop (didn't bet)
Seat 6: oscarleon (button) folded before Flop (didn't bet)
Seat 8: Dantist1122 (small blind) folded before Flop





PokerStars Hand #154363309115:  Hold'em No Limit ($0.50/$1.00 USD) - 2016/06/06 12:51:54 CET [2016/06/06 6:51:54 ET]
Table 'Wezen II' 9-max Seat #2 is the button
Seat 1: matiko09 ($167.60 in chips) 
Seat 2: Mr.Grigoriy ($123.84 in chips) 
Seat 3: oscarleon ($100 in chips) 
Seat 4: xxxibgdrgn ($100 in chips) 
Seat 5: stds st ($27.10 in chips) 
Seat 6: masaytoo ($98.50 in chips) 
Seat 7: KDJAll3 ($79.06 in chips) 
Seat 8: mavin80 ($181.85 in chips) 
Seat 9: PacPacBum ($100 in chips) 
oscarleon: posts small blind $0.50
xxxibgdrgn: posts big blind $1
*** HOLE CARDS ***
Dealt to matiko09 [3h Ad]
stds st: raises $1.50 to $2.50
masaytoo: folds 
KDJAll3: folds 
mavin80: folds 
PacPacBum: folds 
matiko09: folds 
Mr.Grigoriy: folds 
oscarleon: folds 
xxxibgdrgn: folds 
Uncalled bet ($1.50) returned to stds st
stds st collected $2.50 from pot
stds st: doesn't show hand 
*** SUMMARY ***
Total pot $2.50 | Rake $0 
Seat 1: matiko09 folded before Flop (didn't bet)
Seat 2: Mr.Grigoriy (button) folded before Flop (didn't bet)
Seat 3: oscarleon (small blind) folded before Flop
Seat 4: xxxibgdrgn (big blind) folded before Flop
Seat 5: stds st collected ($2.50)
Seat 6: masaytoo folded before Flop (didn't bet)
Seat 7: KDJAll3 folded before Flop (didn't bet)
Seat 8: mavin80 folded before Flop (didn't bet)
Seat 9: PacPacBum folded before Flop (didn't bet)





PokerStars Hand #154363313627:  Hold'em No Limit ($0.50/$1.00 USD) - 2016/06/06 12:52:05 CET [2016/06/06 6:52:05 ET]
Table 'Titius' 9-max Seat #8 is the button
Seat 2: matiko09 ($100 in chips) 
Seat 5: riggedsh** ($204 in chips) 
Seat 6: oscarleon ($102.50 in chips) 
Seat 8: Dantist1122 ($100 in chips) 
matiko09: posts small blind $0.50
vanilica: is sitting out 
vanilica leaves the table
ozone2003: is sitting out 
riggedsh**: posts big blind $1
*** HOLE CARDS ***
Dealt to matiko09 [Jd Kd]
oscarleon: folds 
ozone2003 leaves the table
Dantist1122: raises $1.05 to $2.05
matiko09: raises $6.95 to $9
riggedsh**: folds 
Dantist1122: raises $13 to $22
matiko09: calls $13
*** FLOP *** [7c Ad Qd]
matiko09: checks 
Dantist1122: bets $15
matiko09: calls $15
*** TURN *** [7c Ad Qd] [2s]
matiko09: checks 
Dantist1122: bets $25
matiko09: calls $25
*** RIVER *** [7c Ad Qd 2s] [9s]
matiko09: checks 
Dantist1122: bets $38 and is all-in
matiko09: folds 
Uncalled bet ($38) returned to Dantist1122
Dantist1122 collected $124 from pot
Dantist1122: doesn't show hand 
*** SUMMARY ***
Total pot $125 | Rake $1 
Board [7c Ad Qd 2s 9s]
Seat 2: matiko09 (small blind) folded on the River
Seat 5: riggedsh** (big blind) folded before Flop
Seat 6: oscarleon folded before Flop (didn't bet)
Seat 8: Dantist1122 (button) collected ($124)





PokerStars Hand #154363319349:  Hold'em No Limit (€0.50/€1.00 EUR) - 2016/06/06 12:52:19 CET [2016/06/06 6:52:19 ET]
Table 'Kythera' 9-max Seat #4 is the button
Seat 1: aquarua7 (€106.17 in chips) 
Seat 3: matiko09 (€100 in chips) 
Seat 4: PacPacBum (€100 in chips) 
aquarua7: posts small blind €0.50
matiko09: posts big blind €1
*** HOLE CARDS ***
Dealt to matiko09 [Jh 9d]
PacPacBum: raises €1.04 to €2.04
maxxmeister leaves the table
aquarua7: folds 
matiko09: calls €1.04
*** FLOP *** [2c 4s 9s]
matiko09: checks 
vanilica joins the table at seat #2 
PacPacBum: bets €1.52
matiko09: calls €1.52
*** TURN *** [2c 4s 9s] [6s]
matiko09: checks 
PacPacBum: checks 
*** RIVER *** [2c 4s 9s 6s] [2s]
matiko09: checks 
PacPacBum: checks 
*** SHOW DOWN ***
matiko09: shows [Jh 9d] (two pair, Nines and Deuces)
PacPacBum: mucks hand 
matiko09 collected €7.24 from pot
*** SUMMARY ***
Total pot €7.62 | Rake €0.38 
Board [2c 4s 9s 6s 2s]
Seat 1: aquarua7 (small blind) folded before Flop
Seat 3: matiko09 (big blind) showed [Jh 9d] and won (€7.24) with two pair, Nines and Deuces
Seat 4: PacPacBum (button) mucked [3h 3c]





PokerStars Hand #154363321160:  Hold'em No Limit ($0.50/$1.00 USD) - 2016/06/06 12:52:23 CET [2016/06/06 6:52:23 ET]
Table 'Gajdariya' 9-max Seat #9 is the button
Seat 1: matiko09 ($113.23 in chips) 
Seat 2: xxxZeka ($165.24 in chips) 
Seat 3: oscarleon ($113.55 in chips) 
Seat 4: Szevasztopol ($150.90 in chips) 
Seat 5: 147734319 ($44.13 in chips) 
Seat 6: mono123viva ($128.42 in chips) 
Seat 7: Wombatkilla ($65.39 in chips) 
Seat 8: ardo888 ($100 in chips) 
Seat 9: Mr.Grigoriy ($139.75 in chips) 
matiko09: posts small blind $0.50
xxxZeka: posts big blind $1
*** HOLE CARDS ***
Dealt to matiko09 [4d Ts]
oscarleon: folds 
Szevasztopol: folds 
147734319: folds 
mono123viva: raises $2 to $3
Wombatkilla: folds 
ardo888: raises $7 to $10
Mr.Grigoriy: folds 
matiko09: folds 
xxxZeka: folds 
mono123viva: calls $7
*** FLOP *** [Jh As 8c]
mono123viva: checks 
ardo888: bets $10.61
mono123viva: calls $10.61
*** TURN *** [Jh As 8c] [9s]
mono123viva: checks 
ardo888: checks 
*** RIVER *** [Jh As 8c 9s] [Qh]
mono123viva: checks 
ardo888: bets $16.10
mono123viva: calls $16.10
*** SHOW DOWN ***
ardo888: shows [Qd Ac] (two pair, Aces and Queens)
mono123viva: mucks hand 
ardo888 collected $72.42 from pot
*** SUMMARY ***
Total pot $74.92 | Rake $2.50 
Board [Jh As 8c 9s Qh]
Seat 1: matiko09 (small blind) folded before Flop
Seat 2: xxxZeka (big blind) folded before Flop
Seat 3: oscarleon folded before Flop (didn't bet)
Seat 4: Szevasztopol folded before Flop (didn't bet)
Seat 5: 147734319 folded before Flop (didn't bet)
Seat 6: mono123viva mucked [7c Qc]
Seat 7: Wombatkilla folded before Flop (didn't bet)
Seat 8: ardo888 showed [Qd Ac] and won ($72.42) with two pair, Aces and Queens
Seat 9: Mr.Grigoriy (button) folded before Flop (didn't bet)





PokerStars Hand #154363321638:  Hold'em No Limit ($0.50/$1.00 USD) - 2016/06/06 12:52:25 CET [2016/06/06 6:52:25 ET]
Table 'Smither' 9-max Seat #8 is the button
Seat 1: PacPacBum ($192.12 in chips) 
Seat 2: matiko09 ($103.84 in chips) 
Seat 3: xxxZeka ($132.07 in chips) 
Seat 4: maxxmeister ($207.16 in chips) 
Seat 5: Szevasztopol ($100 in chips) 
Seat 6: riggedsh** ($106.36 in chips) 
Seat 7: vanilica ($100 in chips) 
Seat 8: 74 ROADIE ($65.42 in chips) 
Seat 9: hammerwife ($142.75 in chips) 
hammerwife: posts small blind $0.50
PacPacBum: posts big blind $1
*** HOLE CARDS ***
Dealt to matiko09 [Qs 2c]
matiko09: folds 
xxxZeka: folds 
maxxmeister: folds 
Szevasztopol: folds 
riggedsh**: raises $2 to $3
vanilica: folds 
74 ROADIE: calls $3
hammerwife: folds 
PacPacBum: calls $2
*** FLOP *** [Qh 7d 8s]
PacPacBum: checks 
riggedsh**: checks 
74 ROADIE: checks 
*** TURN *** [Qh 7d 8s] [2d]
PacPacBum: checks 
riggedsh**: bets $6.04
74 ROADIE: calls $6.04
PacPacBum: folds 
*** RIVER *** [Qh 7d 8s 2d] [5d]
riggedsh**: bets $12.50
74 ROADIE: folds 
Uncalled bet ($12.50) returned to riggedsh**
riggedsh** collected $20.50 from pot
riggedsh**: doesn't show hand 
*** SUMMARY ***
Total pot $21.58 | Rake $1.08 
Board [Qh 7d 8s 2d 5d]
Seat 1: PacPacBum (big blind) folded on the Turn
Seat 2: matiko09 folded before Flop (didn't bet)
Seat 3: xxxZeka folded before Flop (didn't bet)
Seat 4: maxxmeister folded before Flop (didn't bet)
Seat 5: Szevasztopol folded before Flop (didn't bet)
Seat 6: riggedsh** collected ($20.50)
Seat 7: vanilica folded before Flop (didn't bet)
Seat 8: 74 ROADIE (button) folded on the River
Seat 9: hammerwife (small blind) folded before Flop





PokerStars Hand #154363324878:  Hold'em No Limit ($0.50/$1.00 USD) - 2016/06/06 12:52:32 CET [2016/06/06 6:52:32 ET]
Table 'Wezen II' 9-max Seat #3 is the button
Seat 1: matiko09 ($167.60 in chips) 
Seat 2: Mr.Grigoriy ($123.84 in chips) 
Seat 3: oscarleon ($100 in chips) 
Seat 4: xxxibgdrgn ($100 in chips) 
Seat 5: stds st ($28.60 in chips) 
Seat 6: masaytoo ($98.50 in chips) 
Seat 7: KDJAll3 ($79.06 in chips) 
Seat 8: mavin80 ($181.85 in chips) 
Seat 9: PacPacBum ($100 in chips) 
xxxibgdrgn: posts small blind $0.50
stds st: posts big blind $1
*** HOLE CARDS ***
Dealt to matiko09 [3c 8h]
masaytoo: folds 
KDJAll3: folds 
mavin80: folds 
PacPacBum: folds 
matiko09: folds 
Mr.Grigoriy: folds 
oscarleon: folds 
xxxibgdrgn: raises $2 to $3
stds st: folds 
Uncalled bet ($2) returned to xxxibgdrgn
xxxibgdrgn collected $2 from pot
xxxibgdrgn: doesn't show hand 
*** SUMMARY ***
Total pot $2 | Rake $0 
Seat 1: matiko09 folded before Flop (didn't bet)
Seat 2: Mr.Grigoriy folded before Flop (didn't bet)
Seat 3: oscarleon (button) folded before Flop (didn't bet)
Seat 4: xxxibgdrgn (small blind) collected ($2)
Seat 5: stds st (big blind) folded before Flop
Seat 6: masaytoo folded before Flop (didn't bet)
Seat 7: KDJAll3 folded before Flop (didn't bet)
Seat 8: mavin80 folded before Flop (didn't bet)
Seat 9: PacPacBum folded before Flop (didn't bet)





PokerStars Hand #154363325666:  Hold'em No Limit (€0.50/€1.00 EUR) - 2016/06/06 12:52:34 CET [2016/06/06 6:52:34 ET]
Table 'Lesath' 9-max Seat #2 is the button
Seat 1: o.miro (€100 in chips) 
Seat 2: thecurv (€100 in chips) 
Seat 3: ozone2003 (€216.15 in chips) 
Seat 4: hammerwife (€121.76 in chips) 
Seat 5: matiko09 (€101.50 in chips) 
Seat 6: Szevasztopol (€100 in chips) 
Seat 7: Mr.Grigoriy (€106.82 in chips) 
Seat 8: maxxmeister (€147.22 in chips) 
Seat 9: 72nloses (€95.44 in chips) 
ozone2003: posts small blind €0.50
hammerwife: posts big blind €1
*** HOLE CARDS ***
Dealt to matiko09 [3d Jh]
matiko09: folds 
Szevasztopol: folds 
Mr.Grigoriy: folds 
maxxmeister: folds 
72nloses: folds 
o.miro: folds 
thecurv: raises €1 to €2
ozone2003: raises €6 to €8
hammerwife: folds 
thecurv: folds 
Uncalled bet (€6) returned to ozone2003
ozone2003 collected €5 from pot
ozone2003: doesn't show hand 
*** SUMMARY ***
Total pot €5 | Rake €0 
Seat 1: o.miro folded before Flop (didn't bet)
Seat 2: thecurv (button) folded before Flop
Seat 3: ozone2003 (small blind) collected (€5)
Seat 4: hammerwife (big blind) folded before Flop
Seat 5: matiko09 folded before Flop (didn't bet)
Seat 6: Szevasztopol folded before Flop (didn't bet)
Seat 7: Mr.Grigoriy folded before Flop (didn't bet)
Seat 8: maxxmeister folded before Flop (didn't bet)
Seat 9: 72nloses folded before Flop (didn't bet)





PokerStars Hand #154363326792:  Hold'em No Limit ($0.50/$1.00 USD) - 2016/06/06 12:52:37 CET [2016/06/06 6:52:37 ET]
Table 'Safara' 9-max Seat #9 is the button
Seat 1: oscarleon ($244.56 in chips) 
Seat 3: Melvisfan ($95.50 in chips) 
Seat 4: ratzo64 ($98.06 in chips) 
Seat 6: matiko09 ($129.86 in chips) 
Seat 7: PacPacBum ($118.07 in chips) 
Seat 8: 32rrew ($100 in chips) 
Seat 9: Mr.Grigoriy ($100 in chips) 
oscarleon: posts small blind $0.50
Melvisfan: posts big blind $1
Mukhin1: sits out 
*** HOLE CARDS ***
Dealt to matiko09 [4d Tc]
ratzo64: raises $2 to $3
matiko09: folds 
PacPacBum: folds 
32rrew: raises $6 to $9
Mr.Grigoriy: folds 
oscarleon: folds 
Melvisfan: folds 
ratzo64: raises $19.50 to $28.50
32rrew: folds 
Uncalled bet ($19.50) returned to ratzo64
ratzo64 collected $19.50 from pot
ratzo64: doesn't show hand 
*** SUMMARY ***
Total pot $19.50 | Rake $0 
Seat 1: oscarleon (small blind) folded before Flop
Seat 3: Melvisfan (big blind) folded before Flop
Seat 4: ratzo64 collected ($19.50)
Seat 6: matiko09 folded before Flop (didn't bet)
Seat 7: PacPacBum folded before Flop (didn't bet)
Seat 8: 32rrew folded before Flop
Seat 9: Mr.Grigoriy (button) folded before Flop (didn't bet)





PokerStars Hand #154363329322:  Hold'em No Limit ($0.50/$1.00 USD) - 2016/06/06 12:52:43 CET [2016/06/06 6:52:43 ET]
Table 'Williams' 9-max Seat #6 is the button
Seat 1: matiko09 ($191.01 in chips) 
Seat 2: PacPacBum ($112.90 in chips) 
Seat 3: granbunny ($65.98 in chips) 
Seat 4: Mr.Grigoriy ($104 in chips) 
Seat 5: xxxibgdrgn ($100 in chips) 
Seat 6: xxxZeka ($124.35 in chips) 
Seat 7: kevinho109 ($33.08 in chips) 
Seat 8: oscarleon ($107.36 in chips) 
Seat 9: kind ten ($46.07 in chips) 
kevinho109: posts small blind $0.50
oscarleon: posts big blind $1
*** HOLE CARDS ***
Dealt to matiko09 [2c 4h]
kind ten: folds 
matiko09: folds 
PacPacBum: folds 
kind ten leaves the table
granbunny: folds 
Mr.Grigoriy: folds 
xxxibgdrgn: folds 
xxxZeka: raises $1.50 to $2.50
kevinho109: calls $2
oscarleon: folds 
*** FLOP *** [2d Qd 3h]
kevinho109: checks 
xxxZeka: bets $3.79
kevinho109: folds 
Uncalled bet ($3.79) returned to xxxZeka
xxxZeka collected $5.70 from pot
*** SUMMARY ***
Total pot $6 | Rake $0.30 
Board [2d Qd 3h]
Seat 1: matiko09 folded before Flop (didn't bet)
Seat 2: PacPacBum folded before Flop (didn't bet)
Seat 3: granbunny folded before Flop (didn't bet)
Seat 4: Mr.Grigoriy folded before Flop (didn't bet)
Seat 5: xxxibgdrgn folded before Flop (didn't bet)
Seat 6: xxxZeka (button) collected ($5.70)
Seat 7: kevinho109 (small blind) folded on the Flop
Seat 8: oscarleon (big blind) folded before Flop
Seat 9: kind ten folded before Flop (didn't bet)





PokerStars Hand #154363331693:  Hold'em No Limit ($0.50/$1.00 USD) - 2016/06/06 12:52:49 CET [2016/06/06 6:52:49 ET]
Table 'Chaldaea II' 9-max Seat #9 is the button
Seat 1: Szevasztopol ($102.72 in chips) 
Seat 2: masaytoo ($95.99 in chips) 
Seat 3: ardo888 ($107.11 in chips) 
Seat 4: mooose100 ($77.50 in chips) 
Seat 6: PacPacBum ($103.50 in chips) 
Seat 8: 32rrew ($100 in chips) 
Seat 9: matiko09 ($103 in chips) 
Szevasztopol: posts small blind $0.50
masaytoo: posts big blind $1
stds st: sits out 
riggedsh**: sits out 
*** HOLE CARDS ***
Dealt to matiko09 [6h 3d]
ardo888: folds 
mooose100: folds 
PacPacBum: folds 
32rrew: folds 
matiko09: folds 
Szevasztopol: folds 
Uncalled bet ($0.50) returned to masaytoo
masaytoo collected $1 from pot
masaytoo: doesn't show hand 
*** SUMMARY ***
Total pot $1 | Rake $0 
Seat 1: Szevasztopol (small blind) folded before Flop
Seat 2: masaytoo (big blind) collected ($1)
Seat 3: ardo888 folded before Flop (didn't bet)
Seat 4: mooose100 folded before Flop (didn't bet)
Seat 6: PacPacBum folded before Flop (didn't bet)
Seat 8: 32rrew folded before Flop (didn't bet)
Seat 9: matiko09 (button) folded before Flop (didn't bet)





PokerStars Hand #154363333462:  Hold'em No Limit ($0.50/$1.00 USD) - 2016/06/06 12:52:54 CET [2016/06/06 6:52:54 ET]
Table 'Sheliak' 9-max Seat #9 is the button
Seat 1: 32rrew ($100 in chips) 
Seat 2: masaytoo ($97.50 in chips) 
Seat 3: oscarleon ($107.50 in chips) 
Seat 4: iRLM ($58.35 in chips) 
Seat 5: hammerwife ($102.50 in chips) 
Seat 6: matiko09 ($100 in chips) 
Seat 7: stds st ($35.63 in chips) 
Seat 8: ozone2003 ($100 in chips) 
Seat 9: Szevasztopol ($100 in chips) 
32rrew: posts small blind $0.50
masaytoo: posts big blind $1
*** HOLE CARDS ***
Dealt to matiko09 [8h Th]
oscarleon: folds 
iRLM: calls $1
hammerwife: raises $3.50 to $4.50
matiko09: folds 
stds st: folds 
ozone2003: folds 
Szevasztopol: folds 
32rrew: folds 
masaytoo: folds 
iRLM: folds 
Uncalled bet ($3.50) returned to hammerwife
hammerwife collected $3.50 from pot
hammerwife: doesn't show hand 
*** SUMMARY ***
Total pot $3.50 | Rake $0 
Seat 1: 32rrew (small blind) folded before Flop
Seat 2: masaytoo (big blind) folded before Flop
Seat 3: oscarleon folded before Flop (didn't bet)
Seat 4: iRLM folded before Flop
Seat 5: hammerwife collected ($3.50)
Seat 6: matiko09 folded before Flop (didn't bet)
Seat 7: stds st folded before Flop (didn't bet)
Seat 8: ozone2003 folded before Flop (didn't bet)
Seat 9: Szevasztopol (button) folded before Flop (didn't bet)





PokerStars Hand #154363334618:  Hold'em No Limit ($0.50/$1.00 USD) - 2016/06/06 12:52:56 CET [2016/06/06 6:52:56 ET]
Table 'Yarilo' 9-max Seat #9 is the button
Seat 1: xxxZeka ($100.40 in chips) 
Seat 2: nombraalne1 ($123.44 in chips) 
Seat 3: matiko09 ($100 in chips) 
Seat 4: stds st ($26.37 in chips) 
Seat 6: ozone2003 ($100 in chips) 
Seat 7: KEBIN1974 ($146 in chips) 
Seat 8: Mr.Grigoriy ($167.53 in chips) 
Seat 9: o.miro ($108 in chips) 
xxxZeka: posts small blind $0.50
nombraalne1: posts big blind $1
*** HOLE CARDS ***
Dealt to matiko09 [5s Kc]
matiko09: folds 
stds st: folds 
ozone2003: folds 
KEBIN1974: raises $1.50 to $2.50
Mr.Grigoriy: folds 
o.miro: calls $2.50
xxxZeka: calls $2
nombraalne1: folds 
*** FLOP *** [2d 2c 8s]
xxxZeka: checks 
KEBIN1974: bets $4.68
o.miro: folds 
xxxZeka: calls $4.68
*** TURN *** [2d 2c 8s] [6s]
xxxZeka: checks 
KEBIN1974: checks 
*** RIVER *** [2d 2c 8s 6s] [Qh]
xxxZeka: checks 
KEBIN1974: checks 
*** SHOW DOWN ***
xxxZeka: shows [7h 7c] (two pair, Sevens and Deuces)
KEBIN1974: shows [8d 6h] (two pair, Eights and Sixes)
KEBIN1974 collected $16.97 from pot
*** SUMMARY ***
Total pot $17.86 | Rake $0.89 
Board [2d 2c 8s 6s Qh]
Seat 1: xxxZeka (small blind) showed [7h 7c] and lost with two pair, Sevens and Deuces
Seat 2: nombraalne1 (big blind) folded before Flop
Seat 3: matiko09 folded before Flop (didn't bet)
Seat 4: stds st folded before Flop (didn't bet)
Seat 6: ozone2003 folded before Flop (didn't bet)
Seat 7: KEBIN1974 showed [8d 6h] and won ($16.97) with two pair, Eights and Sixes
Seat 8: Mr.Grigoriy folded before Flop (didn't bet)
Seat 9: o.miro (button) folded on the Flop





PokerStars Hand #154363337873:  Hold'em No Limit (€0.50/€1.00 EUR) - 2016/06/06 12:53:04 CET [2016/06/06 6:53:04 ET]
Table 'Kythera' 9-max Seat #1 is the button
Seat 1: aquarua7 (€105.67 in chips) 
Seat 3: matiko09 (€103.68 in chips) 
Seat 4: PacPacBum (€100 in chips) 
vanilica will be allowed to play after the button
matiko09: posts small blind €0.50
PacPacBum: posts big blind €1
*** HOLE CARDS ***
Dealt to matiko09 [Tc 9h]
aquarua7: raises €1.50 to €2.50
matiko09: folds 
PacPacBum: folds 
Uncalled bet (€1.50) returned to aquarua7
aquarua7 collected €2.50 from pot
aquarua7: doesn't show hand 
*** SUMMARY ***
Total pot €2.50 | Rake €0 
Seat 1: aquarua7 (button) collected (€2.50)
Seat 3: matiko09 (small blind) folded before Flop
Seat 4: PacPacBum (big blind) folded before Flop





PokerStars Hand #154363338155:  Hold'em No Limit ($0.50/$1.00 USD) - 2016/06/06 12:53:05 CET [2016/06/06 6:53:05 ET]
Table 'Wezen II' 9-max Seat #4 is the button
Seat 1: matiko09 ($167.60 in chips) 
Seat 2: Mr.Grigoriy ($123.84 in chips) 
Seat 3: oscarleon ($100 in chips) 
Seat 4: xxxibgdrgn ($101 in chips) 
Seat 5: stds st ($27.60 in chips) 
Seat 6: masaytoo ($98.50 in chips) 
Seat 7: KDJAll3 ($79.06 in chips) 
Seat 8: mavin80 ($181.85 in chips) 
Seat 9: PacPacBum ($100 in chips) 
stds st: posts small blind $0.50
masaytoo: posts big blind $1
*** HOLE CARDS ***
Dealt to matiko09 [Kd 4d]
KDJAll3 has timed out
KDJAll3: folds 
mavin80: folds 
PacPacBum: raises $1.04 to $2.04
matiko09: folds 
Mr.Grigoriy: raises $4.46 to $6.50
oscarleon: folds 
xxxibgdrgn: folds 
stds st: folds 
masaytoo: folds 
PacPacBum: folds 
Uncalled bet ($4.46) returned to Mr.Grigoriy
Mr.Grigoriy collected $5.58 from pot
Mr.Grigoriy: doesn't show hand 
*** SUMMARY ***
Total pot $5.58 | Rake $0 
Seat 1: matiko09 folded before Flop (didn't bet)
Seat 2: Mr.Grigoriy collected ($5.58)
Seat 3: oscarleon folded before Flop (didn't bet)
Seat 4: xxxibgdrgn (button) folded before Flop (didn't bet)
Seat 5: stds st (small blind) folded before Flop
Seat 6: masaytoo (big blind) folded before Flop
Seat 7: KDJAll3 folded before Flop (didn't bet)
Seat 8: mavin80 folded before Flop (didn't bet)
Seat 9: PacPacBum folded before Flop





PokerStars Hand #154363340929:  Hold'em No Limit (€0.50/€1.00 EUR) - 2016/06/06 12:53:12 CET [2016/06/06 6:53:12 ET]
Table 'Lesath' 9-max Seat #3 is the button
Seat 1: o.miro (€100 in chips) 
Seat 2: thecurv (€100 in chips) 
Seat 3: ozone2003 (€219.15 in chips) 
Seat 4: hammerwife (€120.76 in chips) 
Seat 5: matiko09 (€101.50 in chips) 
Seat 6: Szevasztopol (€100 in chips) 
Seat 7: Mr.Grigoriy (€106.82 in chips) 
Seat 8: maxxmeister (€147.22 in chips) 
Seat 9: 72nloses (€95.44 in chips) 
hammerwife: posts small blind €0.50
matiko09: posts big blind €1
*** HOLE CARDS ***
Dealt to matiko09 [8s As]
Szevasztopol: folds 
Mr.Grigoriy: folds 
maxxmeister: folds 
72nloses: raises €2.50 to €3.50
o.miro: folds 
thecurv: folds 
ozone2003: folds 
hammerwife: folds 
matiko09: folds 
Uncalled bet (€2.50) returned to 72nloses
72nloses collected €2.50 from pot
*** SUMMARY ***
Total pot €2.50 | Rake €0 
Seat 1: o.miro folded before Flop (didn't bet)
Seat 2: thecurv folded before Flop (didn't bet)
Seat 3: ozone2003 (button) folded before Flop (didn't bet)
Seat 4: hammerwife (small blind) folded before Flop
Seat 5: matiko09 (big blind) folded before Flop
Seat 6: Szevasztopol folded before Flop (didn't bet)
Seat 7: Mr.Grigoriy folded before Flop (didn't bet)
Seat 8: maxxmeister folded before Flop (didn't bet)
Seat 9: 72nloses collected (€2.50)





PokerStars Hand #154363343030:  Hold'em No Limit ($0.50/$1.00 USD) - 2016/06/06 12:53:17 CET [2016/06/06 6:53:17 ET]
Table 'Heze' 9-max Seat #1 is the button
Seat 1: matiko09 ($213.65 in chips) 
Seat 2: oscarleon ($191.20 in chips) 
Seat 3: ozone2003 ($125.29 in chips) 
Seat 5: stds st ($40 in chips) 
Seat 7: 32rrew ($180.85 in chips) 
Seat 8: PacPacBum ($100 in chips) 
Seat 9: Mr.Grigoriy ($127.16 in chips) 
oscarleon: posts small blind $0.50
ozone2003: posts big blind $1
ardo888: sits out 
yfcq36: sits out 
*** HOLE CARDS ***
Dealt to matiko09 [As Tc]
stds st: folds 
32rrew: folds 
PacPacBum: folds 
Mr.Grigoriy: folds 
matiko09: raises $1.27 to $2.27
oscarleon: folds 
ozone2003: folds 
Uncalled bet ($1.27) returned to matiko09
matiko09 collected $2.50 from pot
matiko09: doesn't show hand 
*** SUMMARY ***
Total pot $2.50 | Rake $0 
Seat 1: matiko09 (button) collected ($2.50)
Seat 2: oscarleon (small blind) folded before Flop
Seat 3: ozone2003 (big blind) folded before Flop
Seat 5: stds st folded before Flop (didn't bet)
Seat 7: 32rrew folded before Flop (didn't bet)
Seat 8: PacPacBum folded before Flop (didn't bet)
Seat 9: Mr.Grigoriy folded before Flop (didn't bet)





PokerStars Hand #154363343885:  Hold'em No Limit (€0.50/€1.00 EUR) - 2016/06/06 12:53:19 CET [2016/06/06 6:53:19 ET]
Table 'Kythera' 9-max Seat #3 is the button
Seat 1: aquarua7 (€107.17 in chips) 
Seat 3: matiko09 (€103.18 in chips) 
Seat 4: PacPacBum (€100 in chips) 
PacPacBum: posts small blind €0.50
aquarua7: posts big blind €1
vanilica: sits out 
*** HOLE CARDS ***
Dealt to matiko09 [Kd 5c]
matiko09: folds 
PacPacBum: folds 
Uncalled bet (€0.50) returned to aquarua7
aquarua7 collected €1 from pot
aquarua7: doesn't show hand 
*** SUMMARY ***
Total pot €1 | Rake €0 
Seat 1: aquarua7 (big blind) collected (€1)
Seat 3: matiko09 (button) folded before Flop (didn't bet)
Seat 4: PacPacBum (small blind) folded before Flop





PokerStars Hand #154363346370:  Hold'em No Limit ($0.50/$1.00 USD) - 2016/06/06 12:53:25 CET [2016/06/06 6:53:25 ET]
Table 'Sheliak' 9-max Seat #1 is the button
Seat 1: 32rrew ($100 in chips) 
Seat 2: masaytoo ($96.50 in chips) 
Seat 3: oscarleon ($107.50 in chips) 
Seat 4: iRLM ($57.35 in chips) 
Seat 5: hammerwife ($105 in chips) 
Seat 6: matiko09 ($100 in chips) 
Seat 7: stds st ($35.63 in chips) 
Seat 8: ozone2003 ($100 in chips) 
Seat 9: Szevasztopol ($100 in chips) 
masaytoo: posts small blind $0.50
oscarleon: posts big blind $1
*** HOLE CARDS ***
Dealt to matiko09 [Js Jh]
iRLM: folds 
hammerwife: folds 
matiko09: raises $2 to $3
stds st: raises $4.50 to $7.50
ozone2003: folds 
Szevasztopol: folds 
32rrew: folds 
masaytoo: folds 
oscarleon: raises $12.50 to $20
matiko09: folds 
stds st: folds 
Uncalled bet ($12.50) returned to oscarleon
oscarleon collected $18.50 from pot
oscarleon: doesn't show hand 
*** SUMMARY ***
Total pot $18.50 | Rake $0 
Seat 1: 32rrew (button) folded before Flop (didn't bet)
Seat 2: masaytoo (small blind) folded before Flop
Seat 3: oscarleon (big blind) collected ($18.50)
Seat 4: iRLM folded before Flop (didn't bet)
Seat 5: hammerwife folded before Flop (didn't bet)
Seat 6: matiko09 folded before Flop
Seat 7: stds st folded before Flop
Seat 8: ozone2003 folded before Flop (didn't bet)
Seat 9: Szevasztopol folded before Flop (didn't bet)





PokerStars Hand #154363347064:  Hold'em No Limit (€0.50/€1.00 EUR) - 2016/06/06 12:53:27 CET [2016/06/06 6:53:27 ET]
Table 'Kythera' 9-max Seat #4 is the button
Seat 1: aquarua7 (€107.67 in chips) 
Seat 2: vanilica (€100 in chips) 
Seat 3: matiko09 (€103.18 in chips) 
Seat 4: PacPacBum (€100 in chips) 
aquarua7: posts small blind €0.50
vanilica: posts big blind €1
*** HOLE CARDS ***
Dealt to matiko09 [3h 2c]
matiko09: folds 
PacPacBum: folds 
aquarua7: calls €0.50
vanilica: checks 
*** FLOP *** [Ah Jh 9h]
aquarua7: bets €1
vanilica: folds 
Uncalled bet (€1) returned to aquarua7
Dickyxxx joins the table at seat #5 
aquarua7 collected €1.90 from pot
aquarua7: doesn't show hand 
*** SUMMARY ***
Total pot €2 | Rake €0.10 
Board [Ah Jh 9h]
Seat 1: aquarua7 (small blind) collected (€1.90)
Seat 2: vanilica (big blind) folded on the Flop
Seat 3: matiko09 folded before Flop (didn't bet)
Seat 4: PacPacBum (button) folded before Flop (didn't bet)





PokerStars Hand #154363348331:  Hold'em No Limit ($0.50/$1.00 USD) - 2016/06/06 12:53:30 CET [2016/06/06 6:53:30 ET]
Table 'Williams' 9-max Seat #7 is the button
Seat 1: matiko09 ($191.01 in chips) 
Seat 2: PacPacBum ($112.90 in chips) 
Seat 3: granbunny ($65.98 in chips) 
Seat 4: Mr.Grigoriy ($104 in chips) 
Seat 5: xxxibgdrgn ($100 in chips) 
Seat 6: xxxZeka ($127.55 in chips) 
Seat 7: kevinho109 ($30.58 in chips) 
Seat 8: oscarleon ($106.36 in chips) 
oscarleon: posts small blind $0.50
matiko09: posts big blind $1
*** HOLE CARDS ***
Dealt to matiko09 [5c 9h]
hurtNCYDE joins the table at seat #9 
PacPacBum: folds 
granbunny: folds 
hurtNCYDE leaves the table
Mr.Grigoriy: folds 
xxxibgdrgn: folds 
xxxZeka: folds 
kevinho109: folds 
oscarleon: raises $2 to $3
matiko09: folds 
Uncalled bet ($2) returned to oscarleon
stds st joins the table at seat #9 
oscarleon collected $2 from pot
oscarleon: doesn't show hand 
*** SUMMARY ***
Total pot $2 | Rake $0 
Seat 1: matiko09 (big blind) folded before Flop
Seat 2: PacPacBum folded before Flop (didn't bet)
Seat 3: granbunny folded before Flop (didn't bet)
Seat 4: Mr.Grigoriy folded before Flop (didn't bet)
Seat 5: xxxibgdrgn folded before Flop (didn't bet)
Seat 6: xxxZeka folded before Flop (didn't bet)
Seat 7: kevinho109 (button) folded before Flop (didn't bet)
Seat 8: oscarleon (small blind) collected ($2)





PokerStars Hand #154363349850:  Hold'em No Limit ($0.50/$1.00 USD) - 2016/06/06 12:53:33 CET [2016/06/06 6:53:33 ET]
Table 'Chaldaea II' 9-max Seat #1 is the button
Seat 1: Szevasztopol ($102.22 in chips) 
Seat 2: masaytoo ($96.49 in chips) 
Seat 3: ardo888 ($107.11 in chips) 
Seat 4: mooose100 ($100 in chips) 
Seat 6: PacPacBum ($103.50 in chips) 
Seat 8: 32rrew ($100 in chips) 
Seat 9: matiko09 ($103 in chips) 
masaytoo: posts small blind $0.50
ardo888: posts big blind $1
stds st: sits out 
riggedsh**: sits out 
*** HOLE CARDS ***
Dealt to matiko09 [3s 2s]
mooose100: folds 
PacPacBum: folds 
32rrew: folds 
matiko09: folds 
Szevasztopol: folds 
masaytoo: folds 
Uncalled bet ($0.50) returned to ardo888
ardo888 collected $1 from pot
ardo888: doesn't show hand 
*** SUMMARY ***
Total pot $1 | Rake $0 
Seat 1: Szevasztopol (button) folded before Flop (didn't bet)
Seat 2: masaytoo (small blind) folded before Flop
Seat 3: ardo888 (big blind) collected ($1)
Seat 4: mooose100 folded before Flop (didn't bet)
Seat 6: PacPacBum folded before Flop (didn't bet)
Seat 8: 32rrew folded before Flop (didn't bet)
Seat 9: matiko09 folded before Flop (didn't bet)





PokerStars Hand #154363350214:  Hold'em No Limit ($0.50/$1.00 USD) - 2016/06/06 12:53:34 CET [2016/06/06 6:53:34 ET]
Table 'Gajdariya' 9-max Seat #1 is the button
Seat 1: matiko09 ($112.73 in chips) 
Seat 2: xxxZeka ($164.24 in chips) 
Seat 3: oscarleon ($113.55 in chips) 
Seat 4: Szevasztopol ($150.90 in chips) 
Seat 5: 147734319 ($44.13 in chips) 
Seat 6: mono123viva ($91.71 in chips) 
Seat 7: Wombatkilla ($65.39 in chips) 
Seat 8: ardo888 ($135.71 in chips) 
Seat 9: Mr.Grigoriy ($139.75 in chips) 
xxxZeka: posts small blind $0.50
oscarleon: posts big blind $1
*** HOLE CARDS ***
Dealt to matiko09 [2c Js]
Szevasztopol: folds 
147734319: raises $2 to $3
mono123viva: calls $3
Wombatkilla: folds 
ardo888: calls $3
Mr.Grigoriy: folds 
matiko09: folds 
xxxZeka: folds 
oscarleon: folds 
*** FLOP *** [Ks 4c 9s]
147734319: checks 
mono123viva: checks 
ardo888: bets $6.48
147734319: folds 
mono123viva: calls $6.48
*** TURN *** [Ks 4c 9s] [6h]
mono123viva: checks 
ardo888: checks 
*** RIVER *** [Ks 4c 9s 6h] [Jc]
mono123viva: checks 
ardo888: bets $5.50
mono123viva: calls $5.50
*** SHOW DOWN ***
ardo888: shows [Jd Td] (a pair of Jacks)
mono123viva: mucks hand 
ardo888 collected $32.74 from pot
*** SUMMARY ***
Total pot $34.46 | Rake $1.72 
Board [Ks 4c 9s 6h Jc]
Seat 1: matiko09 (button) folded before Flop (didn't bet)
Seat 2: xxxZeka (small blind) folded before Flop
Seat 3: oscarleon (big blind) folded before Flop
Seat 4: Szevasztopol folded before Flop (didn't bet)
Seat 5: 147734319 folded on the Flop
Seat 6: mono123viva mucked [7s 7h]
Seat 7: Wombatkilla folded before Flop (didn't bet)
Seat 8: ardo888 showed [Jd Td] and won ($32.74) with a pair of Jacks
Seat 9: Mr.Grigoriy folded before Flop (didn't bet)





PokerStars Hand #154363351675:  Hold'em No Limit ($0.50/$1.00 USD) - 2016/06/06 12:53:38 CET [2016/06/06 6:53:38 ET]
Table 'Heze' 9-max Seat #2 is the button
Seat 1: matiko09 ($215.15 in chips) 
Seat 2: oscarleon ($190.70 in chips) 
Seat 3: ozone2003 ($124.29 in chips) 
Seat 4: ardo888 ($100 in chips) 
Seat 5: stds st ($40 in chips) 
Seat 7: 32rrew ($180.85 in chips) 
Seat 8: PacPacBum ($100 in chips) 
Seat 9: Mr.Grigoriy ($127.16 in chips) 
ozone2003: posts small blind $0.50
ardo888: posts big blind $1
yfcq36: sits out 
*** HOLE CARDS ***
Dealt to matiko09 [5d Qc]
stds st: folds 
32rrew: folds 
PacPacBum: folds 
Mr.Grigoriy: folds 
matiko09: folds 
oscarleon: folds 
ozone2003: folds 
Uncalled bet ($0.50) returned to ardo888
ardo888 collected $1 from pot
ardo888: doesn't show hand 
*** SUMMARY ***
Total pot $1 | Rake $0 
Seat 1: matiko09 folded before Flop (didn't bet)
Seat 2: oscarleon (button) folded before Flop (didn't bet)
Seat 3: ozone2003 (small blind) folded before Flop
Seat 4: ardo888 (big blind) collected ($1)
Seat 5: stds st folded before Flop (didn't bet)
Seat 7: 32rrew folded before Flop (didn't bet)
Seat 8: PacPacBum folded before Flop (didn't bet)
Seat 9: Mr.Grigoriy folded before Flop (didn't bet)





PokerStars Hand #154363356241:  Hold'em No Limit ($0.50/$1.00 USD) - 2016/06/06 12:53:49 CET [2016/06/06 6:53:49 ET]
Table 'Smither' 9-max Seat #9 is the button
Seat 1: PacPacBum ($189.12 in chips) 
Seat 2: matiko09 ($103.84 in chips) 
Seat 3: xxxZeka ($132.07 in chips) 
Seat 4: maxxmeister ($207.16 in chips) 
Seat 5: Szevasztopol ($100 in chips) 
Seat 6: riggedsh** ($117.82 in chips) 
Seat 7: vanilica ($100 in chips) 
Seat 8: 74 ROADIE ($56.38 in chips) 
Seat 9: hammerwife ($142.25 in chips) 
PacPacBum: posts small blind $0.50
matiko09: posts big blind $1
*** HOLE CARDS ***
Dealt to matiko09 [5s 8c]
xxxZeka: folds 
maxxmeister: raises $2.50 to $3.50
Szevasztopol: folds 
riggedsh**: folds 
vanilica: folds 
74 ROADIE: calls $3.50
hammerwife: folds 
PacPacBum: folds 
matiko09: folds 
*** FLOP *** [5h Ks 7d]
maxxmeister: bets $8
74 ROADIE: folds 
Uncalled bet ($8) returned to maxxmeister
maxxmeister collected $8.08 from pot
maxxmeister: doesn't show hand 
*** SUMMARY ***
Total pot $8.50 | Rake $0.42 
Board [5h Ks 7d]
Seat 1: PacPacBum (small blind) folded before Flop
Seat 2: matiko09 (big blind) folded before Flop
Seat 3: xxxZeka folded before Flop (didn't bet)
Seat 4: maxxmeister collected ($8.08)
Seat 5: Szevasztopol folded before Flop (didn't bet)
Seat 6: riggedsh** folded before Flop (didn't bet)
Seat 7: vanilica folded before Flop (didn't bet)
Seat 8: 74 ROADIE folded on the Flop
Seat 9: hammerwife (button) folded before Flop (didn't bet)





PokerStars Hand #154363357202:  Hold'em No Limit (€0.50/€1.00 EUR) - 2016/06/06 12:53:51 CET [2016/06/06 6:53:51 ET]
Table 'Kythera' 9-max Seat #1 is the button
Seat 1: aquarua7 (€108.57 in chips) 
Seat 2: vanilica (€100 in chips) 
Seat 3: matiko09 (€103.18 in chips) 
Seat 4: PacPacBum (€100 in chips) 
vanilica: posts small blind €0.50
matiko09: posts big blind €1
Dickyxxx: sits out 
*** HOLE CARDS ***
Dealt to matiko09 [4s Ad]
PacPacBum: folds 
aquarua7: folds 
vanilica: raises €2 to €3
matiko09: calls €2
*** FLOP *** [Jc 8h 9s]
vanilica: checks 
ozone2003 joins the table at seat #6 
matiko09: checks 
*** TURN *** [Jc 8h 9s] [5s]
vanilica: checks 
matiko09: checks 
*** RIVER *** [Jc 8h 9s 5s] [As]
vanilica: checks 
matiko09: checks 
*** SHOW DOWN ***
vanilica: shows [6c 6h] (a pair of Sixes)
matiko09: shows [4s Ad] (a pair of Aces)
matiko09 collected €5.70 from pot
*** SUMMARY ***
Total pot €6 | Rake €0.30 
Board [Jc 8h 9s 5s As]
Seat 1: aquarua7 (button) folded before Flop (didn't bet)
Seat 2: vanilica (small blind) showed [6c 6h] and lost with a pair of Sixes
Seat 3: matiko09 (big blind) showed [4s Ad] and won (€5.70) with a pair of Aces
Seat 4: PacPacBum folded before Flop (didn't bet)





PokerStars Hand #154363357434:  Hold'em No Limit (€0.50/€1.00 EUR) - 2016/06/06 12:53:52 CET [2016/06/06 6:53:52 ET]
Table 'Lesath' 9-max Seat #4 is the button
Seat 1: o.miro (€100 in chips) 
Seat 2: thecurv (€100 in chips) 
Seat 3: ozone2003 (€219.15 in chips) 
Seat 4: hammerwife (€120.26 in chips) 
Seat 5: matiko09 (€100.50 in chips) 
Seat 6: Szevasztopol (€100 in chips) 
Seat 7: Mr.Grigoriy (€106.82 in chips) 
Seat 8: maxxmeister (€147.22 in chips) 
Seat 9: 72nloses (€96.94 in chips) 
matiko09: posts small blind €0.50
Szevasztopol: posts big blind €1
*** HOLE CARDS ***
Dealt to matiko09 [3d 6s]
Mr.Grigoriy: folds 
maxxmeister: folds 
72nloses: folds 
o.miro: folds 
thecurv: folds 
ozone2003: folds 
hammerwife: raises €1.01 to €2.01
matiko09: folds 
Szevasztopol: folds 
Uncalled bet (€1.01) returned to hammerwife
hammerwife collected €2.50 from pot
hammerwife: doesn't show hand 
*** SUMMARY ***
Total pot €2.50 | Rake €0 
Seat 1: o.miro folded before Flop (didn't bet)
Seat 2: thecurv folded before Flop (didn't bet)
Seat 3: ozone2003 folded before Flop (didn't bet)
Seat 4: hammerwife (button) collected (€2.50)
Seat 5: matiko09 (small blind) folded before Flop
Seat 6: Szevasztopol (big blind) folded before Flop
Seat 7: Mr.Grigoriy folded before Flop (didn't bet)
Seat 8: maxxmeister folded before Flop (didn't bet)
Seat 9: 72nloses folded before Flop (didn't bet)





PokerStars Hand #154363358177:  Hold'em No Limit ($0.50/$1.00 USD) - 2016/06/06 12:53:53 CET [2016/06/06 6:53:53 ET]
Table 'Williams' 9-max Seat #8 is the button
Seat 1: matiko09 ($190.01 in chips) 
Seat 2: PacPacBum ($112.90 in chips) 
Seat 3: granbunny ($65.98 in chips) 
Seat 4: Mr.Grigoriy ($104 in chips) 
Seat 5: xxxibgdrgn ($100 in chips) 
Seat 6: xxxZeka ($127.55 in chips) 
Seat 7: kevinho109 ($30.58 in chips) 
Seat 8: oscarleon ($107.36 in chips) 
stds st will be allowed to play after the button
matiko09: posts small blind $0.50
PacPacBum: posts big blind $1
*** HOLE CARDS ***
Dealt to matiko09 [Jh 4h]
granbunny: folds 
Mr.Grigoriy: folds 
xxxibgdrgn: folds 
xxxZeka: folds 
kevinho109: folds 
oscarleon: raises $2 to $3
matiko09: folds 
PacPacBum: raises $6 to $9
oscarleon: raises $15 to $24
PacPacBum: folds 
Uncalled bet ($15) returned to oscarleon
oscarleon collected $18.50 from pot
oscarleon: doesn't show hand 
*** SUMMARY ***
Total pot $18.50 | Rake $0 
Seat 1: matiko09 (small blind) folded before Flop
Seat 2: PacPacBum (big blind) folded before Flop
Seat 3: granbunny folded before Flop (didn't bet)
Seat 4: Mr.Grigoriy folded before Flop (didn't bet)
Seat 5: xxxibgdrgn folded before Flop (didn't bet)
Seat 6: xxxZeka folded before Flop (didn't bet)
Seat 7: kevinho109 folded before Flop (didn't bet)
Seat 8: oscarleon (button) collected ($18.50)





PokerStars Hand #154363361369:  Hold'em No Limit ($0.50/$1.00 USD) - 2016/06/06 12:54:01 CET [2016/06/06 6:54:01 ET]
Table 'Chaldaea II' 9-max Seat #2 is the button
Seat 1: Szevasztopol ($102.22 in chips) 
Seat 2: masaytoo ($95.99 in chips) 
Seat 3: ardo888 ($107.61 in chips) 
Seat 4: mooose100 ($100 in chips) 
Seat 6: PacPacBum ($103.50 in chips) 
Seat 8: 32rrew ($100 in chips) 
Seat 9: matiko09 ($103 in chips) 
ardo888: posts small blind $0.50
mooose100: posts big blind $1
stds st: sits out 
riggedsh**: sits out 
*** HOLE CARDS ***
Dealt to matiko09 [2s 6s]
PacPacBum: folds 
32rrew: folds 
matiko09: folds 
Szevasztopol: folds 
masaytoo: folds 
ardo888: folds 
Uncalled bet ($0.50) returned to mooose100
mooose100 collected $1 from pot
mooose100: doesn't show hand 
*** SUMMARY ***
Total pot $1 | Rake $0 
Seat 1: Szevasztopol folded before Flop (didn't bet)
Seat 2: masaytoo (button) folded before Flop (didn't bet)
Seat 3: ardo888 (small blind) folded before Flop
Seat 4: mooose100 (big blind) collected ($1)
Seat 6: PacPacBum folded before Flop (didn't bet)
Seat 8: 32rrew folded before Flop (didn't bet)
Seat 9: matiko09 folded before Flop (didn't bet)





PokerStars Hand #154363362464:  Hold'em No Limit ($0.50/$1.00 USD) - 2016/06/06 12:54:04 CET [2016/06/06 6:54:04 ET]
Table 'Safara' 9-max Seat #1 is the button
Seat 1: oscarleon ($244.06 in chips) 
Seat 3: Melvisfan ($94.50 in chips) 
Seat 4: ratzo64 ($108.56 in chips) 
Seat 6: matiko09 ($129.86 in chips) 
Seat 7: PacPacBum ($118.07 in chips) 
Seat 8: 32rrew ($100 in chips) 
Seat 9: Mr.Grigoriy ($100 in chips) 
Melvisfan: posts small blind $0.50
ratzo64: posts big blind $1
Mukhin1: sits out 
*** HOLE CARDS ***
Dealt to matiko09 [Kd 7h]
matiko09: folds 
PacPacBum: folds 
32rrew: folds 
Mr.Grigoriy: raises $1.50 to $2.50
oscarleon: folds 
Melvisfan: calls $2
ratzo64: folds 
*** FLOP *** [Ts Jc Jh]
Melvisfan: bets $2
Mr.Grigoriy: calls $2
*** TURN *** [Ts Jc Jh] [6d]
Melvisfan: bets $4
ratzo64 leaves the table
Mr.Grigoriy: calls $4
*** RIVER *** [Ts Jc Jh 6d] [8s]
Melvisfan: bets $6
o.miro joins the table at seat #4 
Mr.Grigoriy: raises $18 to $24
Melvisfan: folds 
Uncalled bet ($18) returned to Mr.Grigoriy
Mr.Grigoriy collected $28.50 from pot
Mr.Grigoriy: doesn't show hand 
*** SUMMARY ***
Total pot $30 | Rake $1.50 
Board [Ts Jc Jh 6d 8s]
Seat 1: oscarleon (button) folded before Flop (didn't bet)
Seat 3: Melvisfan (small blind) folded on the River
Seat 4: ratzo64 (big blind) folded before Flop
Seat 6: matiko09 folded before Flop (didn't bet)
Seat 7: PacPacBum folded before Flop (didn't bet)
Seat 8: 32rrew folded before Flop (didn't bet)
Seat 9: Mr.Grigoriy collected ($28.50)





PokerStars Hand #154363364395:  Hold'em No Limit ($0.50/$1.00 USD) - 2016/06/06 12:54:09 CET [2016/06/06 6:54:09 ET]
Table 'Wezen II' 9-max Seat #5 is the button
Seat 1: matiko09 ($167.60 in chips) 
Seat 2: Mr.Grigoriy ($127.38 in chips) 
Seat 3: oscarleon ($100 in chips) 
Seat 4: xxxibgdrgn ($101 in chips) 
Seat 5: stds st ($27.10 in chips) 
Seat 6: masaytoo ($97.50 in chips) 
Seat 8: mavin80 ($181.85 in chips) 
Seat 9: PacPacBum ($100 in chips) 
masaytoo: posts small blind $0.50
mavin80: posts big blind $1
*** HOLE CARDS ***
Dealt to matiko09 [Qc Js]
PacPacBum: folds 
matiko09: folds 
Mr.Grigoriy: folds 
oscarleon: folds 
xxxibgdrgn: folds 
stds st: folds 
masaytoo: folds 
Uncalled bet ($0.50) returned to mavin80
mavin80 collected $1 from pot
mavin80: doesn't show hand 
*** SUMMARY ***
Total pot $1 | Rake $0 
Seat 1: matiko09 folded before Flop (didn't bet)
Seat 2: Mr.Grigoriy folded before Flop (didn't bet)
Seat 3: oscarleon folded before Flop (didn't bet)
Seat 4: xxxibgdrgn folded before Flop (didn't bet)
Seat 5: stds st (button) folded before Flop (didn't bet)
Seat 6: masaytoo (small blind) folded before Flop
Seat 8: mavin80 (big blind) collected ($1)
Seat 9: PacPacBum folded before Flop (didn't bet)





PokerStars Hand #154363366897:  Hold'em No Limit (€0.50/€1.00 EUR) - 2016/06/06 12:54:15 CET [2016/06/06 6:54:15 ET]
Table 'Lesath' 9-max Seat #5 is the button
Seat 1: o.miro (€100 in chips) 
Seat 2: thecurv (€100 in chips) 
Seat 3: ozone2003 (€219.15 in chips) 
Seat 4: hammerwife (€121.76 in chips) 
Seat 5: matiko09 (€100 in chips) 
Seat 6: Szevasztopol (€100 in chips) 
Seat 7: Mr.Grigoriy (€106.82 in chips) 
Seat 8: maxxmeister (€147.22 in chips) 
Seat 9: 72nloses (€96.94 in chips) 
Szevasztopol: posts small blind €0.50
Mr.Grigoriy: posts big blind €1
*** HOLE CARDS ***
Dealt to matiko09 [7c 5h]
maxxmeister: raises €2.50 to €3.50
72nloses: folds 
o.miro: folds 
thecurv: calls €3.50
ozone2003: folds 
hammerwife: raises €10.50 to €14
matiko09: folds 
Szevasztopol: folds 
Mr.Grigoriy: folds 
maxxmeister: folds 
thecurv: folds 
Uncalled bet (€10.50) returned to hammerwife
hammerwife collected €12 from pot
hammerwife: doesn't show hand 
*** SUMMARY ***
Total pot €12 | Rake €0 
Seat 1: o.miro folded before Flop (didn't bet)
Seat 2: thecurv folded before Flop
Seat 3: ozone2003 folded before Flop (didn't bet)
Seat 4: hammerwife collected (€12)
Seat 5: matiko09 (button) folded before Flop (didn't bet)
Seat 6: Szevasztopol (small blind) folded before Flop
Seat 7: Mr.Grigoriy (big blind) folded before Flop
Seat 8: maxxmeister folded before Flop
Seat 9: 72nloses folded before Flop (didn't bet)





PokerStars Hand #154363368517:  Hold'em No Limit ($0.50/$1.00 USD) - 2016/06/06 12:54:18 CET [2016/06/06 6:54:18 ET]
Table 'Yarilo' 9-max Seat #1 is the button
Seat 1: xxxZeka ($100 in chips) 
Seat 2: nombraalne1 ($122.44 in chips) 
Seat 3: matiko09 ($100 in chips) 
Seat 4: stds st ($26.37 in chips) 
Seat 6: ozone2003 ($100 in chips) 
Seat 7: KEBIN1974 ($155.79 in chips) 
Seat 8: Mr.Grigoriy ($167.53 in chips) 
Seat 9: o.miro ($105.50 in chips) 
nombraalne1: posts small blind $0.50
matiko09: posts big blind $1
*** HOLE CARDS ***
Dealt to matiko09 [As Js]
stds st: folds 
ozone2003: folds 
KEBIN1974: folds 
Mr.Grigoriy: folds 
o.miro: folds 
xxxZeka: folds 
nombraalne1: folds 
Uncalled bet ($0.50) returned to matiko09
matiko09 collected $1 from pot
matiko09: doesn't show hand 
*** SUMMARY ***
Total pot $1 | Rake $0 
Seat 1: xxxZeka (button) folded before Flop (didn't bet)
Seat 2: nombraalne1 (small blind) folded before Flop
Seat 3: matiko09 (big blind) collected ($1)
Seat 4: stds st folded before Flop (didn't bet)
Seat 6: ozone2003 folded before Flop (didn't bet)
Seat 7: KEBIN1974 folded before Flop (didn't bet)
Seat 8: Mr.Grigoriy folded before Flop (didn't bet)
Seat 9: o.miro folded before Flop (didn't bet)





PokerStars Hand #154363372106:  Hold'em No Limit ($0.50/$1.00 USD) - 2016/06/06 12:54:27 CET [2016/06/06 6:54:27 ET]
Table 'Heze' 9-max Seat #3 is the button
Seat 1: matiko09 ($215.15 in chips) 
Seat 2: oscarleon ($190.70 in chips) 
Seat 3: ozone2003 ($123.79 in chips) 
Seat 4: ardo888 ($100.50 in chips) 
Seat 5: stds st ($40 in chips) 
Seat 7: 32rrew ($180.85 in chips) 
Seat 8: PacPacBum ($100 in chips) 
Seat 9: Mr.Grigoriy ($127.16 in chips) 
ardo888: posts small blind $0.50
stds st: posts big blind $1
yfcq36: sits out 
*** HOLE CARDS ***
Dealt to matiko09 [3d 3h]
32rrew: folds 
PacPacBum: folds 
Mr.Grigoriy: folds 
matiko09: raises $2 to $3
oscarleon: raises $6 to $9
ozone2003: folds 
ardo888: folds 
stds st: folds 
matiko09: folds 
Uncalled bet ($6) returned to oscarleon
oscarleon collected $7.50 from pot
oscarleon: doesn't show hand 
*** SUMMARY ***
Total pot $7.50 | Rake $0 
Seat 1: matiko09 folded before Flop
Seat 2: oscarleon collected ($7.50)
Seat 3: ozone2003 (button) folded before Flop (didn't bet)
Seat 4: ardo888 (small blind) folded before Flop
Seat 5: stds st (big blind) folded before Flop
Seat 7: 32rrew folded before Flop (didn't bet)
Seat 8: PacPacBum folded before Flop (didn't bet)
Seat 9: Mr.Grigoriy folded before Flop (didn't bet)





PokerStars Hand #154363373015:  Hold'em No Limit ($0.50/$1.00 USD) - 2016/06/06 12:54:29 CET [2016/06/06 6:54:29 ET]
Table 'Sheliak' 9-max Seat #2 is the button
Seat 1: 32rrew ($100 in chips) 
Seat 2: masaytoo ($96 in chips) 
Seat 3: oscarleon ($118.50 in chips) 
Seat 4: iRLM ($57.35 in chips) 
Seat 5: hammerwife ($105 in chips) 
Seat 6: matiko09 ($100 in chips) 
Seat 7: stds st ($28.13 in chips) 
Seat 8: ozone2003 ($100 in chips) 
Seat 9: Szevasztopol ($100 in chips) 
oscarleon: posts small blind $0.50
iRLM: posts big blind $1
*** HOLE CARDS ***
Dealt to matiko09 [2c Ac]
hammerwife: folds 
matiko09: folds 
stds st: folds 
ozone2003: folds 
Szevasztopol: raises $1.14 to $2.14
32rrew: calls $2.14
masaytoo: folds 
oscarleon: folds 
iRLM: calls $1.14
*** FLOP *** [6c 8d Js]
iRLM: bets $3.28
Szevasztopol: folds 
32rrew: folds 
Uncalled bet ($3.28) returned to iRLM
iRLM collected $6.57 from pot
iRLM: doesn't show hand 
*** SUMMARY ***
Total pot $6.92 | Rake $0.35 
Board [6c 8d Js]
Seat 1: 32rrew folded on the Flop
Seat 2: masaytoo (button) folded before Flop (didn't bet)
Seat 3: oscarleon (small blind) folded before Flop
Seat 4: iRLM (big blind) collected ($6.57)
Seat 5: hammerwife folded before Flop (didn't bet)
Seat 6: matiko09 folded before Flop (didn't bet)
Seat 7: stds st folded before Flop (didn't bet)
Seat 8: ozone2003 folded before Flop (didn't bet)
Seat 9: Szevasztopol folded on the Flop





PokerStars Hand #154363373592:  Hold'em No Limit ($0.50/$1.00 USD) - 2016/06/06 12:54:31 CET [2016/06/06 6:54:31 ET]
Table 'Chaldaea II' 9-max Seat #3 is the button
Seat 1: Szevasztopol ($102.22 in chips) 
Seat 2: masaytoo ($95.99 in chips) 
Seat 3: ardo888 ($107.11 in chips) 
Seat 4: mooose100 ($100.50 in chips) 
Seat 5: stds st ($40 in chips) 
Seat 6: PacPacBum ($103.50 in chips) 
Seat 8: 32rrew ($100 in chips) 
Seat 9: matiko09 ($103 in chips) 
mooose100: posts small blind $0.50
stds st: posts big blind $1
riggedsh**: sits out 
*** HOLE CARDS ***
Dealt to matiko09 [Jd 9c]
PacPacBum: folds 
32rrew: folds 
matiko09: folds 
Szevasztopol: folds 
masaytoo: folds 
ardo888: folds 
mooose100: folds 
Uncalled bet ($0.50) returned to stds st
stds st collected $1 from pot
stds st: doesn't show hand 
*** SUMMARY ***
Total pot $1 | Rake $0 
Seat 1: Szevasztopol folded before Flop (didn't bet)
Seat 2: masaytoo folded before Flop (didn't bet)
Seat 3: ardo888 (button) folded before Flop (didn't bet)
Seat 4: mooose100 (small blind) folded before Flop
Seat 5: stds st (big blind) collected ($1)
Seat 6: PacPacBum folded before Flop (didn't bet)
Seat 8: 32rrew folded before Flop (didn't bet)
Seat 9: matiko09 folded before Flop (didn't bet)





PokerStars Hand #154363374391:  Hold'em No Limit ($0.50/$1.00 USD) - 2016/06/06 12:54:33 CET [2016/06/06 6:54:33 ET]
Table 'Wezen II' 9-max Seat #6 is the button
Seat 1: matiko09 ($167.60 in chips) 
Seat 2: Mr.Grigoriy ($127.38 in chips) 
Seat 3: oscarleon ($100 in chips) 
Seat 4: xxxibgdrgn ($101 in chips) 
Seat 5: stds st ($27.10 in chips) 
Seat 6: masaytoo ($97 in chips) 
Seat 8: mavin80 ($182.35 in chips) 
Seat 9: PacPacBum ($100 in chips) 
mavin80: posts small blind $0.50
PacPacBum: posts big blind $1
*** HOLE CARDS ***
Dealt to matiko09 [As Jh]
matiko09: folds 
Mr.Grigoriy: folds 
oscarleon: folds 
xxxibgdrgn: raises $2 to $3
stds st: folds 
masaytoo: folds 
mavin80: folds 
PacPacBum: folds 
Uncalled bet ($2) returned to xxxibgdrgn
xxxibgdrgn collected $2.50 from pot
xxxibgdrgn: doesn't show hand 
*** SUMMARY ***
Total pot $2.50 | Rake $0 
Seat 1: matiko09 folded before Flop (didn't bet)
Seat 2: Mr.Grigoriy folded before Flop (didn't bet)
Seat 3: oscarleon folded before Flop (didn't bet)
Seat 4: xxxibgdrgn collected ($2.50)
Seat 5: stds st folded before Flop (didn't bet)
Seat 6: masaytoo (button) folded before Flop (didn't bet)
Seat 8: mavin80 (small blind) folded before Flop
Seat 9: PacPacBum (big blind) folded before Flop





PokerStars Hand #154363376804:  Hold'em No Limit (€0.50/€1.00 EUR) - 2016/06/06 12:54:38 CET [2016/06/06 6:54:38 ET]
Table 'Kythera' 9-max Seat #2 is the button
Seat 1: aquarua7 (€108.57 in chips) 
Seat 2: vanilica (€100 in chips) 
Seat 3: matiko09 (€105.88 in chips) 
Seat 4: PacPacBum (€100 in chips) 
matiko09: posts small blind €0.50
PacPacBum: posts big blind €1
Dickyxxx: sits out 
ozone2003: sits out 
*** HOLE CARDS ***
Dealt to matiko09 [2h 9d]
aquarua7: folds 
vanilica: folds 
matiko09: folds 
Uncalled bet (€0.50) returned to PacPacBum
PacPacBum collected €1 from pot
PacPacBum: doesn't show hand 
*** SUMMARY ***
Total pot €1 | Rake €0 
Seat 1: aquarua7 folded before Flop (didn't bet)
Seat 2: vanilica (button) folded before Flop (didn't bet)
Seat 3: matiko09 (small blind) folded before Flop
Seat 4: PacPacBum (big blind) collected (€1)





PokerStars Hand #154363379598:  Hold'em No Limit ($0.50/$1.00 USD) - 2016/06/06 12:54:45 CET [2016/06/06 6:54:45 ET]
Table 'Williams' 9-max Seat #1 is the button
Seat 1: matiko09 ($189.51 in chips) 
Seat 2: PacPacBum ($103.90 in chips) 
Seat 3: granbunny ($65.98 in chips) 
Seat 4: Mr.Grigoriy ($104 in chips) 
Seat 5: xxxibgdrgn ($100 in chips) 
Seat 6: xxxZeka ($127.55 in chips) 
Seat 7: kevinho109 ($30.58 in chips) 
Seat 8: oscarleon ($116.86 in chips) 
PacPacBum: posts small blind $0.50
granbunny: posts big blind $1
stds st: sits out 
*** HOLE CARDS ***
Dealt to matiko09 [As 3c]
Mr.Grigoriy: folds 
xxxibgdrgn: raises $2 to $3
xxxZeka: folds 
kevinho109: folds 
oscarleon: folds 
matiko09: folds 
PacPacBum: folds 
granbunny: calls $2
*** FLOP *** [Tc 5s 5h]
granbunny: checks 
xxxibgdrgn: bets $4
granbunny: raises $7 to $11
xxxibgdrgn: folds 
Uncalled bet ($7) returned to granbunny
granbunny collected $13.78 from pot
granbunny: doesn't show hand 
*** SUMMARY ***
Total pot $14.50 | Rake $0.72 
Board [Tc 5s 5h]
Seat 1: matiko09 (button) folded before Flop (didn't bet)
Seat 2: PacPacBum (small blind) folded before Flop
Seat 3: granbunny (big blind) collected ($13.78)
Seat 4: Mr.Grigoriy folded before Flop (didn't bet)
Seat 5: xxxibgdrgn folded on the Flop
Seat 6: xxxZeka folded before Flop (didn't bet)
Seat 7: kevinho109 folded before Flop (didn't bet)
Seat 8: oscarleon folded before Flop (didn't bet)





PokerStars Hand #154363381681:  Hold'em No Limit ($0.50/$1.00 USD) - 2016/06/06 12:54:50 CET [2016/06/06 6:54:50 ET]
Table 'Titius' 9-max Seat #2 is the button
Seat 2: matiko09 ($100 in chips) 
Seat 5: riggedsh** ($203 in chips) 
Seat 6: oscarleon ($102.50 in chips) 
Seat 8: Dantist1122 ($162 in chips) 
riggedsh**: posts small blind $0.50
oscarleon: posts big blind $1
*** HOLE CARDS ***
Dealt to matiko09 [6s Jh]
Dantist1122: folds 
matiko09: folds 
riggedsh**: raises $2 to $3
oscarleon: folds 
Uncalled bet ($2) returned to riggedsh**
riggedsh** collected $2 from pot
riggedsh**: doesn't show hand 
*** SUMMARY ***
Total pot $2 | Rake $0 
Seat 2: matiko09 (button) folded before Flop (didn't bet)
Seat 5: riggedsh** (small blind) collected ($2)
Seat 6: oscarleon (big blind) folded before Flop
Seat 8: Dantist1122 folded before Flop (didn't bet)





PokerStars Hand #154363382167:  Hold'em No Limit (€0.50/€1.00 EUR) - 2016/06/06 12:54:51 CET [2016/06/06 6:54:51 ET]
Table 'Kythera' 9-max Seat #3 is the button
Seat 1: aquarua7 (€108.57 in chips) 
Seat 2: vanilica (€100 in chips) 
Seat 3: matiko09 (€105.38 in chips) 
Seat 4: PacPacBum (€100.50 in chips) 
Seat 5: Dickyxxx (€100 in chips) 
PacPacBum: posts small blind €0.50
Dickyxxx: posts big blind €1
ozone2003: sits out 
*** HOLE CARDS ***
Dealt to matiko09 [7c 5h]
aquarua7: raises €1.50 to €2.50
vanilica: folds 
matiko09: folds 
PacPacBum: folds 
Dickyxxx: folds 
Uncalled bet (€1.50) returned to aquarua7
aquarua7 collected €2.50 from pot
aquarua7: doesn't show hand 
*** SUMMARY ***
Total pot €2.50 | Rake €0 
Seat 1: aquarua7 collected (€2.50)
Seat 2: vanilica folded before Flop (didn't bet)
Seat 3: matiko09 (button) folded before Flop (didn't bet)
Seat 4: PacPacBum (small blind) folded before Flop
Seat 5: Dickyxxx (big blind) folded before Flop





PokerStars Hand #154363385806:  Hold'em No Limit ($0.50/$1.00 USD) - 2016/06/06 12:55:00 CET [2016/06/06 6:55:00 ET]
Table 'Smither' 9-max Seat #1 is the button
Seat 1: PacPacBum ($188.62 in chips) 
Seat 2: matiko09 ($102.84 in chips) 
Seat 3: xxxZeka ($132.07 in chips) 
Seat 4: maxxmeister ($211.74 in chips) 
Seat 5: Szevasztopol ($100 in chips) 
Seat 6: riggedsh** ($117.82 in chips) 
Seat 7: vanilica ($100 in chips) 
Seat 8: 74 ROADIE ($52.88 in chips) 
Seat 9: hammerwife ($142.25 in chips) 
matiko09: posts small blind $0.50
xxxZeka: posts big blind $1
*** HOLE CARDS ***
Dealt to matiko09 [Qh Js]
maxxmeister: folds 
Szevasztopol: raises $1.24 to $2.24
riggedsh**: folds 
vanilica: folds 
74 ROADIE: folds 
hammerwife: folds 
PacPacBum: folds 
matiko09: folds 
xxxZeka: folds 
Uncalled bet ($1.24) returned to Szevasztopol
Szevasztopol collected $2.50 from pot
Szevasztopol: doesn't show hand 
*** SUMMARY ***
Total pot $2.50 | Rake $0 
Seat 1: PacPacBum (button) folded before Flop (didn't bet)
Seat 2: matiko09 (small blind) folded before Flop
Seat 3: xxxZeka (big blind) folded before Flop
Seat 4: maxxmeister folded before Flop (didn't bet)
Seat 5: Szevasztopol collected ($2.50)
Seat 6: riggedsh** folded before Flop (didn't bet)
Seat 7: vanilica folded before Flop (didn't bet)
Seat 8: 74 ROADIE folded before Flop (didn't bet)
Seat 9: hammerwife folded before Flop (didn't bet)





PokerStars Hand #154363386460:  Hold'em No Limit ($0.50/$1.00 USD) - 2016/06/06 12:55:02 CET [2016/06/06 6:55:02 ET]
Table 'Wezen II' 9-max Seat #9 is the button
Seat 1: matiko09 ($167.60 in chips) 
Seat 2: Mr.Grigoriy ($127.38 in chips) 
Seat 3: oscarleon ($100 in chips) 
Seat 4: xxxibgdrgn ($102.50 in chips) 
Seat 5: stds st ($27.10 in chips) 
Seat 6: masaytoo ($97 in chips) 
Seat 9: PacPacBum ($100 in chips) 
matiko09: posts small blind $0.50
Mr.Grigoriy: posts big blind $1
*** HOLE CARDS ***
Dealt to matiko09 [Ac Ah]
oscarleon: folds 
xxxibgdrgn has timed out
xxxibgdrgn: folds 
stds st: folds 
masaytoo: folds 
PacPacBum: folds 
matiko09: raises $2 to $3
Mr.Grigoriy: raises $6 to $9
matiko09: raises $11 to $20
Mr.Grigoriy: folds 
Uncalled bet ($11) returned to matiko09
matiko09 collected $18 from pot
matiko09: doesn't show hand 
*** SUMMARY ***
Total pot $18 | Rake $0 
Seat 1: matiko09 (small blind) collected ($18)
Seat 2: Mr.Grigoriy (big blind) folded before Flop
Seat 3: oscarleon folded before Flop (didn't bet)
Seat 4: xxxibgdrgn folded before Flop (didn't bet)
Seat 5: stds st folded before Flop (didn't bet)
Seat 6: masaytoo folded before Flop (didn't bet)
Seat 9: PacPacBum (button) folded before Flop (didn't bet)





PokerStars Hand #154363386897:  Hold'em No Limit ($0.50/$1.00 USD) - 2016/06/06 12:55:03 CET [2016/06/06 6:55:03 ET]
Table 'Yarilo' 9-max Seat #2 is the button
Seat 1: xxxZeka ($100 in chips) 
Seat 2: nombraalne1 ($121.94 in chips) 
Seat 3: matiko09 ($100.50 in chips) 
Seat 4: stds st ($26.37 in chips) 
Seat 6: ozone2003 ($100 in chips) 
Seat 7: KEBIN1974 ($155.79 in chips) 
Seat 8: Mr.Grigoriy ($167.53 in chips) 
Seat 9: o.miro ($105.50 in chips) 
matiko09: posts small blind $0.50
stds st: posts big blind $1
*** HOLE CARDS ***
Dealt to matiko09 [7s Qc]
ozone2003: folds 
KEBIN1974: raises $1.50 to $2.50
Mr.Grigoriy: calls $2.50
o.miro: folds 
xxxZeka: folds 
nombraalne1: folds 
matiko09: folds 
stds st: folds 
*** FLOP *** [9c Th 6s]
KEBIN1974: checks 
Mr.Grigoriy: bets $4.38
KEBIN1974: calls $4.38
*** TURN *** [9c Th 6s] [4d]
KEBIN1974: bets $8.41
Mr.Grigoriy: raises $18.59 to $27
KEBIN1974: calls $18.59
*** RIVER *** [9c Th 6s 4d] [Jd]
KEBIN1974: checks 
Mr.Grigoriy: bets $52.07
KEBIN1974: folds 
Uncalled bet ($52.07) returned to Mr.Grigoriy
Mr.Grigoriy collected $66.76 from pot
Mr.Grigoriy: doesn't show hand 
*** SUMMARY ***
Total pot $69.26 | Rake $2.50 
Board [9c Th 6s 4d Jd]
Seat 1: xxxZeka folded before Flop (didn't bet)
Seat 2: nombraalne1 (button) folded before Flop (didn't bet)
Seat 3: matiko09 (small blind) folded before Flop
Seat 4: stds st (big blind) folded before Flop
Seat 6: ozone2003 folded before Flop (didn't bet)
Seat 7: KEBIN1974 folded on the River
Seat 8: Mr.Grigoriy collected ($66.76)
Seat 9: o.miro folded before Flop (didn't bet)





PokerStars Hand #154363387036:  Hold'em No Limit ($0.50/$1.00 USD) - 2016/06/06 12:55:03 CET [2016/06/06 6:55:03 ET]
Table 'Heze' 9-max Seat #4 is the button
Seat 1: matiko09 ($212.15 in chips) 
Seat 2: oscarleon ($195.20 in chips) 
Seat 3: ozone2003 ($123.79 in chips) 
Seat 4: ardo888 ($100 in chips) 
Seat 5: stds st ($39 in chips) 
Seat 6: yfcq36 ($100 in chips) 
Seat 7: 32rrew ($180.85 in chips) 
Seat 8: PacPacBum ($100 in chips) 
Seat 9: Mr.Grigoriy ($127.16 in chips) 
stds st: posts small blind $0.50
yfcq36: posts big blind $1
*** HOLE CARDS ***
Dealt to matiko09 [Jh 3h]
32rrew: folds 
PacPacBum: folds 
Mr.Grigoriy: raises $2 to $3
matiko09: folds 
oscarleon: folds 
ozone2003: folds 
ardo888: folds 
stds st: folds 
yfcq36: folds 
Uncalled bet ($2) returned to Mr.Grigoriy
Mr.Grigoriy collected $2.50 from pot
Mr.Grigoriy: doesn't show hand 
*** SUMMARY ***
Total pot $2.50 | Rake $0 
Seat 1: matiko09 folded before Flop (didn't bet)
Seat 2: oscarleon folded before Flop (didn't bet)
Seat 3: ozone2003 folded before Flop (didn't bet)
Seat 4: ardo888 (button) folded before Flop (didn't bet)
Seat 5: stds st (small blind) folded before Flop
Seat 6: yfcq36 (big blind) folded before Flop
Seat 7: 32rrew folded before Flop (didn't bet)
Seat 8: PacPacBum folded before Flop (didn't bet)
Seat 9: Mr.Grigoriy collected ($2.50)





PokerStars Hand #154363387391:  Hold'em No Limit ($0.50/$1.00 USD) - 2016/06/06 12:55:04 CET [2016/06/06 6:55:04 ET]
Table 'Chaldaea II' 9-max Seat #4 is the button
Seat 1: Szevasztopol ($102.22 in chips) 
Seat 2: masaytoo ($95.99 in chips) 
Seat 3: ardo888 ($107.11 in chips) 
Seat 4: mooose100 ($100 in chips) 
Seat 5: stds st ($40.50 in chips) 
Seat 6: PacPacBum ($103.50 in chips) 
Seat 8: 32rrew ($100 in chips) 
Seat 9: matiko09 ($103 in chips) 
stds st: posts small blind $0.50
PacPacBum: posts big blind $1
riggedsh**: sits out 
*** HOLE CARDS ***
Dealt to matiko09 [2d Jd]
32rrew: folds 
matiko09: folds 
Szevasztopol: folds 
masaytoo: folds 
ardo888: raises $1.50 to $2.50
mooose100: folds 
stds st: folds 
PacPacBum: folds 
Uncalled bet ($1.50) returned to ardo888
ardo888 collected $2.50 from pot
ardo888: doesn't show hand 
*** SUMMARY ***
Total pot $2.50 | Rake $0 
Seat 1: Szevasztopol folded before Flop (didn't bet)
Seat 2: masaytoo folded before Flop (didn't bet)
Seat 3: ardo888 collected ($2.50)
Seat 4: mooose100 (button) folded before Flop (didn't bet)
Seat 5: stds st (small blind) folded before Flop
Seat 6: PacPacBum (big blind) folded before Flop
Seat 8: 32rrew folded before Flop (didn't bet)
Seat 9: matiko09 folded before Flop (didn't bet)





PokerStars Hand #154363388320:  Hold'em No Limit ($0.50/$1.00 USD) - 2016/06/06 12:55:07 CET [2016/06/06 6:55:07 ET]
Table 'Gajdariya' 9-max Seat #2 is the button
Seat 1: matiko09 ($112.73 in chips) 
Seat 2: xxxZeka ($163.74 in chips) 
Seat 3: oscarleon ($112.55 in chips) 
Seat 4: Szevasztopol ($150.90 in chips) 
Seat 5: 147734319 ($41.13 in chips) 
Seat 6: mono123viva ($76.73 in chips) 
Seat 7: Wombatkilla ($65.39 in chips) 
Seat 8: ardo888 ($153.47 in chips) 
Seat 9: Mr.Grigoriy ($139.75 in chips) 
oscarleon: posts small blind $0.50
Szevasztopol: posts big blind $1
*** HOLE CARDS ***
Dealt to matiko09 [8c 2d]
147734319: folds 
mono123viva: folds 
Wombatkilla: folds 
ardo888: folds 
Mr.Grigoriy: folds 
matiko09: folds 
xxxZeka: raises $1.50 to $2.50
oscarleon: folds 
Szevasztopol: calls $1.50
*** FLOP *** [Js 2c Qd]
Szevasztopol: checks 
xxxZeka: checks 
*** TURN *** [Js 2c Qd] [9s]
Szevasztopol: checks 
xxxZeka: checks 
*** RIVER *** [Js 2c Qd 9s] [Ks]
Szevasztopol: checks 
xxxZeka: checks 
*** SHOW DOWN ***
Szevasztopol: shows [7d Ac] (high card Ace)
xxxZeka: shows [7h 9d] (a pair of Nines)
xxxZeka collected $5.22 from pot
*** SUMMARY ***
Total pot $5.50 | Rake $0.28 
Board [Js 2c Qd 9s Ks]
Seat 1: matiko09 folded before Flop (didn't bet)
Seat 2: xxxZeka (button) showed [7h 9d] and won ($5.22) with a pair of Nines
Seat 3: oscarleon (small blind) folded before Flop
Seat 4: Szevasztopol (big blind) showed [7d Ac] and lost with high card Ace
Seat 5: 147734319 folded before Flop (didn't bet)
Seat 6: mono123viva folded before Flop (didn't bet)
Seat 7: Wombatkilla folded before Flop (didn't bet)
Seat 8: ardo888 folded before Flop (didn't bet)
Seat 9: Mr.Grigoriy folded before Flop (didn't bet)





PokerStars Hand #154363388854:  Hold'em No Limit (€0.50/€1.00 EUR) - 2016/06/06 12:55:08 CET [2016/06/06 6:55:08 ET]
Table 'Kythera' 9-max Seat #4 is the button
Seat 1: aquarua7 (€110.07 in chips) 
Seat 2: vanilica (€100 in chips) 
Seat 3: matiko09 (€105.38 in chips) 
Seat 4: PacPacBum (€100 in chips) 
Seat 5: Dickyxxx (€100 in chips) 
Seat 6: ozone2003 (€100 in chips) 
Dickyxxx: posts small blind €0.50
ozone2003: posts big blind €1
*** HOLE CARDS ***
Dealt to matiko09 [Ac 5s]
aquarua7: folds 
vanilica: folds 
matiko09: folds 
PacPacBum: raises €1.50 to €2.50
Dickyxxx: folds 
ozone2003: calls €1.50
*** FLOP *** [Jd 9h Ah]
ozone2003: checks 
PacPacBum: bets €1.82
ozone2003: calls €1.82
*** TURN *** [Jd 9h Ah] [4s]
ozone2003: checks 
PacPacBum: checks 
*** RIVER *** [Jd 9h Ah 4s] [5d]
ozone2003: checks 
PacPacBum: checks 
*** SHOW DOWN ***
ozone2003: shows [Jc Qc] (a pair of Jacks)
PacPacBum: shows [Kd Js] (a pair of Jacks - Ace+King kicker)
PacPacBum collected €8.68 from pot
*** SUMMARY ***
Total pot €9.14 | Rake €0.46 
Board [Jd 9h Ah 4s 5d]
Seat 1: aquarua7 folded before Flop (didn't bet)
Seat 2: vanilica folded before Flop (didn't bet)
Seat 3: matiko09 folded before Flop (didn't bet)
Seat 4: PacPacBum (button) showed [Kd Js] and won (€8.68) with a pair of Jacks
Seat 5: Dickyxxx (small blind) folded before Flop
Seat 6: ozone2003 (big blind) showed [Jc Qc] and lost with a pair of Jacks





PokerStars Hand #154363395904:  Hold'em No Limit (€0.50/€1.00 EUR) - 2016/06/06 12:55:28 CET [2016/06/06 6:55:28 ET]
Table 'Lesath' 9-max Seat #6 is the button
Seat 1: o.miro (€100 in chips) 
Seat 2: thecurv (€100 in chips) 
Seat 3: ozone2003 (€219.15 in chips) 
Seat 4: hammerwife (€130.26 in chips) 
Seat 5: matiko09 (€100 in chips) 
Seat 6: Szevasztopol (€100 in chips) 
Seat 7: Mr.Grigoriy (€105.82 in chips) 
Seat 9: 72nloses (€96.94 in chips) 
Mr.Grigoriy: posts small blind €0.50
72nloses: posts big blind €1
*** HOLE CARDS ***
Dealt to matiko09 [7c Qs]
o.miro: raises €2 to €3
thecurv: folds 
ozone2003: folds 
hammerwife: folds 
matiko09: folds 
Szevasztopol: raises €7.50 to €10.50
Mr.Grigoriy: folds 
72nloses: folds 
o.miro: folds 
Uncalled bet (€7.50) returned to Szevasztopol
Szevasztopol collected €7.50 from pot
Szevasztopol: doesn't show hand 
*** SUMMARY ***
Total pot €7.50 | Rake €0 
Seat 1: o.miro folded before Flop
Seat 2: thecurv folded before Flop (didn't bet)
Seat 3: ozone2003 folded before Flop (didn't bet)
Seat 4: hammerwife folded before Flop (didn't bet)
Seat 5: matiko09 folded before Flop (didn't bet)
Seat 6: Szevasztopol (button) collected (€7.50)
Seat 7: Mr.Grigoriy (small blind) folded before Flop
Seat 9: 72nloses (big blind) folded before Flop





PokerStars Hand #154363397243:  Hold'em No Limit ($0.50/$1.00 USD) - 2016/06/06 12:55:31 CET [2016/06/06 6:55:31 ET]
Table 'Chaldaea II' 9-max Seat #5 is the button
Seat 1: Szevasztopol ($102.22 in chips) 
Seat 2: masaytoo ($95.99 in chips) 
Seat 3: ardo888 ($108.61 in chips) 
Seat 4: mooose100 ($100 in chips) 
Seat 5: stds st ($40 in chips) 
Seat 6: PacPacBum ($102.50 in chips) 
Seat 7: riggedsh** ($199.58 in chips) 
Seat 8: 32rrew ($100 in chips) 
Seat 9: matiko09 ($103 in chips) 
PacPacBum: posts small blind $0.50
riggedsh**: posts big blind $1
*** HOLE CARDS ***
Dealt to matiko09 [3c 5s]
32rrew: raises $2 to $3
matiko09: folds 
Szevasztopol: folds 
masaytoo: folds 
ardo888: folds 
mooose100: folds 
stds st: folds 
PacPacBum: folds 
riggedsh**: folds 
Uncalled bet ($2) returned to 32rrew
32rrew collected $2.50 from pot
32rrew: doesn't show hand 
*** SUMMARY ***
Total pot $2.50 | Rake $0 
Seat 1: Szevasztopol folded before Flop (didn't bet)
Seat 2: masaytoo folded before Flop (didn't bet)
Seat 3: ardo888 folded before Flop (didn't bet)
Seat 4: mooose100 folded before Flop (didn't bet)
Seat 5: stds st (button) folded before Flop (didn't bet)
Seat 6: PacPacBum (small blind) folded before Flop
Seat 7: riggedsh** (big blind) folded before Flop
Seat 8: 32rrew collected ($2.50)
Seat 9: matiko09 folded before Flop (didn't bet)





PokerStars Hand #154363398599:  Hold'em No Limit ($0.50/$1.00 USD) - 2016/06/06 12:55:35 CET [2016/06/06 6:55:35 ET]
Table 'Smither' 9-max Seat #2 is the button
Seat 1: PacPacBum ($188.62 in chips) 
Seat 2: matiko09 ($102.34 in chips) 
Seat 3: xxxZeka ($131.07 in chips) 
Seat 5: Szevasztopol ($101.50 in chips) 
Seat 6: riggedsh** ($117.82 in chips) 
Seat 7: vanilica ($100 in chips) 
Seat 8: 74 ROADIE ($52.88 in chips) 
Seat 9: hammerwife ($142.25 in chips) 
xxxZeka: posts small blind $0.50
Szevasztopol: posts big blind $1
*** HOLE CARDS ***
Dealt to matiko09 [8d 3h]
riggedsh**: folds 
vanilica: folds 
74 ROADIE: folds 
hammerwife: folds 
PacPacBum: folds 
matiko09: folds 
xxxZeka: folds 
Uncalled bet ($0.50) returned to Szevasztopol
Szevasztopol collected $1 from pot
Szevasztopol: doesn't show hand 
*** SUMMARY ***
Total pot $1 | Rake $0 
Seat 1: PacPacBum folded before Flop (didn't bet)
Seat 2: matiko09 (button) folded before Flop (didn't bet)
Seat 3: xxxZeka (small blind) folded before Flop
Seat 5: Szevasztopol (big blind) collected ($1)
Seat 6: riggedsh** folded before Flop (didn't bet)
Seat 7: vanilica folded before Flop (didn't bet)
Seat 8: 74 ROADIE folded before Flop (didn't bet)
Seat 9: hammerwife folded before Flop (didn't bet)





PokerStars Hand #154363399253:  Hold'em No Limit ($0.50/$1.00 USD) - 2016/06/06 12:55:37 CET [2016/06/06 6:55:37 ET]
Table 'Heze' 9-max Seat #5 is the button
Seat 1: matiko09 ($212.15 in chips) 
Seat 2: oscarleon ($195.20 in chips) 
Seat 3: ozone2003 ($123.79 in chips) 
Seat 4: ardo888 ($100 in chips) 
Seat 5: stds st ($38.50 in chips) 
Seat 6: yfcq36 ($100 in chips) 
Seat 7: 32rrew ($180.85 in chips) 
Seat 8: PacPacBum ($100 in chips) 
Seat 9: Mr.Grigoriy ($128.66 in chips) 
yfcq36: posts small blind $0.50
32rrew: posts big blind $1
*** HOLE CARDS ***
Dealt to matiko09 [7h Ks]
PacPacBum: folds 
Mr.Grigoriy: folds 
matiko09: folds 
oscarleon: folds 
ozone2003: folds 
ardo888: folds 
stds st: folds 
yfcq36: folds 
Uncalled bet ($0.50) returned to 32rrew
32rrew collected $1 from pot
32rrew: doesn't show hand 
*** SUMMARY ***
Total pot $1 | Rake $0 
Seat 1: matiko09 folded before Flop (didn't bet)
Seat 2: oscarleon folded before Flop (didn't bet)
Seat 3: ozone2003 folded before Flop (didn't bet)
Seat 4: ardo888 folded before Flop (didn't bet)
Seat 5: stds st (button) folded before Flop (didn't bet)
Seat 6: yfcq36 (small blind) folded before Flop
Seat 7: 32rrew (big blind) collected ($1)
Seat 8: PacPacBum folded before Flop (didn't bet)
Seat 9: Mr.Grigoriy folded before Flop (didn't bet)





PokerStars Hand #154363404649:  Hold'em No Limit ($0.50/$1.00 USD) - 2016/06/06 12:55:51 CET [2016/06/06 6:55:51 ET]
Table 'Smither' 9-max Seat #3 is the button
Seat 1: PacPacBum ($188.62 in chips) 
Seat 2: matiko09 ($102.34 in chips) 
Seat 3: xxxZeka ($130.57 in chips) 
Seat 5: Szevasztopol ($102 in chips) 
Seat 7: vanilica ($100 in chips) 
Seat 8: 74 ROADIE ($52.88 in chips) 
Seat 9: hammerwife ($142.25 in chips) 
Szevasztopol: posts small blind $0.50
riggedsh**: is sitting out 
vanilica: posts big blind $1
*** HOLE CARDS ***
Dealt to matiko09 [2s 9d]
74 ROADIE: folds 
hammerwife: folds 
riggedsh** leaves the table
PacPacBum: raises $1.04 to $2.04
matiko09: folds 
xxxZeka: folds 
Szevasztopol: folds 
vanilica: folds 
Uncalled bet ($1.04) returned to PacPacBum
PacPacBum collected $2.50 from pot
PacPacBum: doesn't show hand 
*** SUMMARY ***
Total pot $2.50 | Rake $0 
Seat 1: PacPacBum collected ($2.50)
Seat 2: matiko09 folded before Flop (didn't bet)
Seat 3: xxxZeka (button) folded before Flop (didn't bet)
Seat 5: Szevasztopol (small blind) folded before Flop
Seat 7: vanilica (big blind) folded before Flop
Seat 8: 74 ROADIE folded before Flop (didn't bet)
Seat 9: hammerwife folded before Flop (didn't bet)





PokerStars Hand #154363406133:  Hold'em No Limit ($0.50/$1.00 USD) - 2016/06/06 12:55:55 CET [2016/06/06 6:55:55 ET]
Table 'Chaldaea II' 9-max Seat #6 is the button
Seat 1: Szevasztopol ($102.22 in chips) 
Seat 2: masaytoo ($95.99 in chips) 
Seat 3: ardo888 ($108.61 in chips) 
Seat 4: mooose100 ($100 in chips) 
Seat 5: stds st ($40 in chips) 
Seat 6: PacPacBum ($102 in chips) 
Seat 7: riggedsh** ($198.58 in chips) 
Seat 8: 32rrew ($101.50 in chips) 
Seat 9: matiko09 ($103 in chips) 
riggedsh**: posts small blind $0.50
32rrew: posts big blind $1
*** HOLE CARDS ***
Dealt to matiko09 [Kh Tc]
matiko09: folds 
Szevasztopol: folds 
masaytoo: folds 
ardo888: folds 
mooose100 has timed out
mooose100: folds 
stds st: raises $1.50 to $2.50
PacPacBum: folds 
riggedsh**: raises $5.50 to $8
32rrew: folds 
stds st: folds 
Uncalled bet ($5.50) returned to riggedsh**
riggedsh** collected $6 from pot
riggedsh**: doesn't show hand 
*** SUMMARY ***
Total pot $6 | Rake $0 
Seat 1: Szevasztopol folded before Flop (didn't bet)
Seat 2: masaytoo folded before Flop (didn't bet)
Seat 3: ardo888 folded before Flop (didn't bet)
Seat 4: mooose100 folded before Flop (didn't bet)
Seat 5: stds st folded before Flop
Seat 6: PacPacBum (button) folded before Flop (didn't bet)
Seat 7: riggedsh** (small blind) collected ($6)
Seat 8: 32rrew (big blind) folded before Flop
Seat 9: matiko09 folded before Flop (didn't bet)





PokerStars Hand #154363406465:  Hold'em No Limit ($0.50/$1.00 USD) - 2016/06/06 12:55:56 CET [2016/06/06 6:55:56 ET]
Table 'Sheliak' 9-max Seat #3 is the button
Seat 1: 32rrew ($100 in chips) 
Seat 2: masaytoo ($96 in chips) 
Seat 3: oscarleon ($118 in chips) 
Seat 4: iRLM ($61.78 in chips) 
Seat 5: hammerwife ($105 in chips) 
Seat 6: matiko09 ($100 in chips) 
Seat 7: stds st ($28.13 in chips) 
Seat 8: ozone2003 ($100 in chips) 
Seat 9: Szevasztopol ($100 in chips) 
iRLM: posts small blind $0.50
hammerwife: posts big blind $1
*** HOLE CARDS ***
Dealt to matiko09 [5s 4d]
matiko09: folds 
stds st: folds 
ozone2003: folds 
Szevasztopol: folds 
32rrew: folds 
masaytoo: folds 
oscarleon: folds 
iRLM: calls $0.50
hammerwife: checks 
*** FLOP *** [5h Kh Qd]
iRLM: checks 
hammerwife: checks 
*** TURN *** [5h Kh Qd] [2h]
iRLM: checks 
hammerwife: bets $1.50
iRLM: calls $1.50
*** RIVER *** [5h Kh Qd 2h] [3s]
iRLM: bets $4.75
hammerwife: calls $4.75
*** SHOW DOWN ***
iRLM: shows [Qh 6h] (a flush, King high)
hammerwife: mucks hand 
iRLM collected $13.78 from pot
*** SUMMARY ***
Total pot $14.50 | Rake $0.72 
Board [5h Kh Qd 2h 3s]
Seat 1: 32rrew folded before Flop (didn't bet)
Seat 2: masaytoo folded before Flop (didn't bet)
Seat 3: oscarleon (button) folded before Flop (didn't bet)
Seat 4: iRLM (small blind) showed [Qh 6h] and won ($13.78) with a flush, King high
Seat 5: hammerwife (big blind) mucked [Qc 7d]
Seat 6: matiko09 folded before Flop (didn't bet)
Seat 7: stds st folded before Flop (didn't bet)
Seat 8: ozone2003 folded before Flop (didn't bet)
Seat 9: Szevasztopol folded before Flop (didn't bet)





PokerStars Hand #154363407905:  Hold'em No Limit ($0.50/$1.00 USD) - 2016/06/06 12:56:00 CET [2016/06/06 6:56:00 ET]
Table 'Williams' 9-max Seat #2 is the button
Seat 1: matiko09 ($189.51 in chips) 
Seat 2: PacPacBum ($103.40 in chips) 
Seat 3: granbunny ($72.76 in chips) 
Seat 4: Mr.Grigoriy ($104 in chips) 
Seat 5: xxxibgdrgn ($100 in chips) 
Seat 6: xxxZeka ($127.55 in chips) 
Seat 7: kevinho109 ($30.58 in chips) 
Seat 8: oscarleon ($116.86 in chips) 
granbunny: posts small blind $0.50
Mr.Grigoriy: posts big blind $1
stds st: sits out 
*** HOLE CARDS ***
Dealt to matiko09 [Kc 9d]
xxxibgdrgn: folds 
xxxZeka: raises $2 to $3
kevinho109: folds 
oscarleon: folds 
matiko09: folds 
PacPacBum: folds 
granbunny: folds 
Mr.Grigoriy: folds 
Uncalled bet ($2) returned to xxxZeka
xxxZeka collected $2.50 from pot
*** SUMMARY ***
Total pot $2.50 | Rake $0 
Seat 1: matiko09 folded before Flop (didn't bet)
Seat 2: PacPacBum (button) folded before Flop (didn't bet)
Seat 3: granbunny (small blind) folded before Flop
Seat 4: Mr.Grigoriy (big blind) folded before Flop
Seat 5: xxxibgdrgn folded before Flop (didn't bet)
Seat 6: xxxZeka collected ($2.50)
Seat 7: kevinho109 folded before Flop (didn't bet)
Seat 8: oscarleon folded before Flop (didn't bet)





PokerStars Hand #154363410569:  Hold'em No Limit ($0.50/$1.00 USD) - 2016/06/06 12:56:07 CET [2016/06/06 6:56:07 ET]
Table 'Heze' 9-max Seat #6 is the button
Seat 1: matiko09 ($212.15 in chips) 
Seat 2: oscarleon ($195.20 in chips) 
Seat 3: ozone2003 ($123.79 in chips) 
Seat 4: ardo888 ($100 in chips) 
Seat 5: stds st ($38.50 in chips) 
Seat 6: yfcq36 ($100 in chips) 
Seat 7: 32rrew ($181.35 in chips) 
Seat 8: PacPacBum ($100 in chips) 
Seat 9: Mr.Grigoriy ($128.66 in chips) 
32rrew: posts small blind $0.50
PacPacBum: posts big blind $1
*** HOLE CARDS ***
Dealt to matiko09 [6d 9d]
Mr.Grigoriy: folds 
matiko09: folds 
oscarleon: folds 
ozone2003: folds 
ardo888: folds 
stds st: folds 
yfcq36: folds 
32rrew: raises $2 to $3
PacPacBum: raises $6 to $9
32rrew: raises $14 to $23
PacPacBum: calls $14
*** FLOP *** [3h 8s Th]
32rrew: checks 
PacPacBum: bets $15.29
32rrew: folds 
Uncalled bet ($15.29) returned to PacPacBum
PacPacBum collected $43.70 from pot
PacPacBum: doesn't show hand 
*** SUMMARY ***
Total pot $46 | Rake $2.30 
Board [3h 8s Th]
Seat 1: matiko09 folded before Flop (didn't bet)
Seat 2: oscarleon folded before Flop (didn't bet)
Seat 3: ozone2003 folded before Flop (didn't bet)
Seat 4: ardo888 folded before Flop (didn't bet)
Seat 5: stds st folded before Flop (didn't bet)
Seat 6: yfcq36 (button) folded before Flop (didn't bet)
Seat 7: 32rrew (small blind) folded on the Flop
Seat 8: PacPacBum (big blind) collected ($43.70)
Seat 9: Mr.Grigoriy folded before Flop (didn't bet)





PokerStars Hand #154363411615:  Hold'em No Limit (€0.50/€1.00 EUR) - 2016/06/06 12:56:10 CET [2016/06/06 6:56:10 ET]
Table 'Kythera' 9-max Seat #5 is the button
Seat 1: aquarua7 (€110.07 in chips) 
Seat 2: vanilica (€100 in chips) 
Seat 3: matiko09 (€105.38 in chips) 
Seat 4: PacPacBum (€104.36 in chips) 
Seat 5: Dickyxxx (€100 in chips) 
Seat 6: ozone2003 (€100 in chips) 
ozone2003: posts small blind €0.50
aquarua7: posts big blind €1
*** HOLE CARDS ***
Dealt to matiko09 [Qh As]
vanilica: folds 
matiko09: raises €2 to €3
PacPacBum: raises €6 to €9
Dickyxxx: folds 
ozone2003: folds 
aquarua7: folds 
matiko09: calls €6
*** FLOP *** [Ac 9h Jh]
matiko09: checks 
PacPacBum: bets €6.48
matiko09: calls €6.48
*** TURN *** [Ac 9h Jh] [3d]
matiko09: checks 
PacPacBum: checks 
*** RIVER *** [Ac 9h Jh 3d] [Ks]
matiko09: bets €12
PacPacBum: folds 
Uncalled bet (€12) returned to matiko09
matiko09 collected €30.84 from pot
matiko09: doesn't show hand 
*** SUMMARY ***
Total pot €32.46 | Rake €1.62 
Board [Ac 9h Jh 3d Ks]
Seat 1: aquarua7 (big blind) folded before Flop
Seat 2: vanilica folded before Flop (didn't bet)
Seat 3: matiko09 collected (€30.84)
Seat 4: PacPacBum folded on the River
Seat 5: Dickyxxx (button) folded before Flop (didn't bet)
Seat 6: ozone2003 (small blind) folded before Flop





PokerStars Hand #154363411902:  Hold'em No Limit ($0.50/$1.00 USD) - 2016/06/06 12:56:11 CET [2016/06/06 6:56:11 ET]
Table 'Smither' 9-max Seat #5 is the button
Seat 1: PacPacBum ($190.12 in chips) 
Seat 2: matiko09 ($102.34 in chips) 
Seat 3: xxxZeka ($130.57 in chips) 
Seat 5: Szevasztopol ($101.50 in chips) 
Seat 7: vanilica ($100 in chips) 
Seat 8: 74 ROADIE ($52.88 in chips) 
Seat 9: hammerwife ($142.25 in chips) 
vanilica: posts small blind $0.50
74 ROADIE: posts big blind $1
*** HOLE CARDS ***
Dealt to matiko09 [Ks 3c]
hammerwife: folds 
mooose100 joins the table at seat #6 
PacPacBum: folds 
matiko09: folds 
xxxZeka: folds 
Szevasztopol: folds 
vanilica: raises $2 to $3
74 ROADIE: calls $2
*** FLOP *** [7d Jh Qd]
vanilica: checks 
74 ROADIE: checks 
*** TURN *** [7d Jh Qd] [6h]
vanilica: checks 
74 ROADIE: bets $4
vanilica: calls $4
*** RIVER *** [7d Jh Qd 6h] [Ts]
vanilica: checks 
74 ROADIE: checks 
*** SHOW DOWN ***
vanilica: shows [9s 9h] (a pair of Nines)
74 ROADIE: shows [Th 8h] (a pair of Tens)
74 ROADIE collected $13.30 from pot
*** SUMMARY ***
Total pot $14 | Rake $0.70 
Board [7d Jh Qd 6h Ts]
Seat 1: PacPacBum folded before Flop (didn't bet)
Seat 2: matiko09 folded before Flop (didn't bet)
Seat 3: xxxZeka folded before Flop (didn't bet)
Seat 5: Szevasztopol (button) folded before Flop (didn't bet)
Seat 7: vanilica (small blind) showed [9s 9h] and lost with a pair of Nines
Seat 8: 74 ROADIE (big blind) showed [Th 8h] and won ($13.30) with a pair of Tens
Seat 9: hammerwife folded before Flop (didn't bet)





PokerStars Hand #154363415005:  Hold'em No Limit ($0.50/$1.00 USD) - 2016/06/06 12:56:19 CET [2016/06/06 6:56:19 ET]
Table 'Gajdariya' 9-max Seat #3 is the button
Seat 1: matiko09 ($112.73 in chips) 
Seat 2: xxxZeka ($166.46 in chips) 
Seat 3: oscarleon ($112.05 in chips) 
Seat 4: Szevasztopol ($148.40 in chips) 
Seat 5: 147734319 ($41.13 in chips) 
Seat 6: mono123viva ($76.73 in chips) 
Seat 7: Wombatkilla ($65.39 in chips) 
Seat 8: ardo888 ($153.47 in chips) 
Seat 9: Mr.Grigoriy ($139.75 in chips) 
Szevasztopol: posts small blind $0.50
147734319: posts big blind $1
*** HOLE CARDS ***
Dealt to matiko09 [7d 4c]
mono123viva: folds 
Wombatkilla: raises $2 to $3
ardo888: folds 
Mr.Grigoriy: folds 
matiko09: folds 
xxxZeka: folds 
oscarleon: folds 
Szevasztopol: folds 
147734319: folds 
Uncalled bet ($2) returned to Wombatkilla
Wombatkilla collected $2.50 from pot
*** SUMMARY ***
Total pot $2.50 | Rake $0 
Seat 1: matiko09 folded before Flop (didn't bet)
Seat 2: xxxZeka folded before Flop (didn't bet)
Seat 3: oscarleon (button) folded before Flop (didn't bet)
Seat 4: Szevasztopol (small blind) folded before Flop
Seat 5: 147734319 (big blind) folded before Flop
Seat 6: mono123viva folded before Flop (didn't bet)
Seat 7: Wombatkilla collected ($2.50)
Seat 8: ardo888 folded before Flop (didn't bet)
Seat 9: Mr.Grigoriy folded before Flop (didn't bet)





PokerStars Hand #154363416575:  Hold'em No Limit (€0.50/€1.00 EUR) - 2016/06/06 12:56:24 CET [2016/06/06 6:56:24 ET]
Table 'Lesath' 9-max Seat #7 is the button
Seat 1: o.miro (€100 in chips) 
Seat 2: thecurv (€100 in chips) 
Seat 3: ozone2003 (€219.15 in chips) 
Seat 4: hammerwife (€130.26 in chips) 
Seat 5: matiko09 (€100 in chips) 
Seat 6: Szevasztopol (€104.50 in chips) 
Seat 7: Mr.Grigoriy (€105.32 in chips) 
Seat 9: 72nloses (€95.94 in chips) 
72nloses: posts small blind €0.50
o.miro: posts big blind €1
*** HOLE CARDS ***
Dealt to matiko09 [Jc 8c]
thecurv: folds 
ozone2003: folds 
hammerwife: folds 
matiko09: folds 
Szevasztopol: folds 
Mr.Grigoriy: folds 
72nloses: folds 
Uncalled bet (€0.50) returned to o.miro
o.miro collected €1 from pot
o.miro: doesn't show hand 
*** SUMMARY ***
Total pot €1 | Rake €0 
Seat 1: o.miro (big blind) collected (€1)
Seat 2: thecurv folded before Flop (didn't bet)
Seat 3: ozone2003 folded before Flop (didn't bet)
Seat 4: hammerwife folded before Flop (didn't bet)
Seat 5: matiko09 folded before Flop (didn't bet)
Seat 6: Szevasztopol folded before Flop (didn't bet)
Seat 7: Mr.Grigoriy (button) folded before Flop (didn't bet)
Seat 9: 72nloses (small blind) folded before Flop





PokerStars Hand #154363417331:  Hold'em No Limit ($0.50/$1.00 USD) - 2016/06/06 12:56:26 CET [2016/06/06 6:56:26 ET]
Table 'Safara' 9-max Seat #3 is the button
Seat 1: oscarleon ($244.06 in chips) 
Seat 3: Melvisfan ($80 in chips) 
Seat 6: matiko09 ($129.86 in chips) 
Seat 7: PacPacBum ($118.07 in chips) 
Seat 8: 32rrew ($100 in chips) 
Seat 9: Mr.Grigoriy ($114 in chips) 
o.miro will be allowed to play after the button
Mukhin1 will be allowed to play after the button
matiko09: posts small blind $0.50
PacPacBum: posts big blind $1
*** HOLE CARDS ***
Dealt to matiko09 [6c Ac]
32rrew: folds 
Mr.Grigoriy: raises $2 to $3
oscarleon: folds 
Melvisfan: folds 
matiko09: folds 
PacPacBum: folds 
Uncalled bet ($2) returned to Mr.Grigoriy
Mr.Grigoriy collected $2.50 from pot
Mr.Grigoriy: doesn't show hand 
*** SUMMARY ***
Total pot $2.50 | Rake $0 
Seat 1: oscarleon folded before Flop (didn't bet)
Seat 3: Melvisfan (button) folded before Flop (didn't bet)
Seat 6: matiko09 (small blind) folded before Flop
Seat 7: PacPacBum (big blind) folded before Flop
Seat 8: 32rrew folded before Flop (didn't bet)
Seat 9: Mr.Grigoriy collected ($2.50)





PokerStars Hand #154363419424:  Hold'em No Limit ($0.50/$1.00 USD) - 2016/06/06 12:56:31 CET [2016/06/06 6:56:31 ET]
Table 'Williams' 9-max Seat #3 is the button
Seat 1: matiko09 ($189.51 in chips) 
Seat 2: PacPacBum ($103.40 in chips) 
Seat 3: granbunny ($72.26 in chips) 
Seat 4: Mr.Grigoriy ($103 in chips) 
Seat 5: xxxibgdrgn ($100 in chips) 
Seat 6: xxxZeka ($129.05 in chips) 
Seat 7: kevinho109 ($30.58 in chips) 
Seat 8: oscarleon ($116.86 in chips) 
Mr.Grigoriy: posts small blind $0.50
xxxibgdrgn: posts big blind $1
stds st: sits out 
*** HOLE CARDS ***
Dealt to matiko09 [Ac Kc]
xxxZeka: raises $2 to $3
kevinho109: folds 
oscarleon: folds 
matiko09: calls $3
PacPacBum: folds 
granbunny: folds 
Mr.Grigoriy: folds 
xxxibgdrgn: folds 
*** FLOP *** [Qh 2h 8s]
xxxZeka: bets $4.74
matiko09: folds 
Uncalled bet ($4.74) returned to xxxZeka
xxxZeka collected $7.12 from pot
*** SUMMARY ***
Total pot $7.50 | Rake $0.38 
Board [Qh 2h 8s]
Seat 1: matiko09 folded on the Flop
Seat 2: PacPacBum folded before Flop (didn't bet)
Seat 3: granbunny (button) folded before Flop (didn't bet)
Seat 4: Mr.Grigoriy (small blind) folded before Flop
Seat 5: xxxibgdrgn (big blind) folded before Flop
Seat 6: xxxZeka collected ($7.12)
Seat 7: kevinho109 folded before Flop (didn't bet)
Seat 8: oscarleon folded before Flop (didn't bet)





PokerStars Hand #154363421520:  Hold'em No Limit ($0.50/$1.00 USD) - 2016/06/06 12:56:37 CET [2016/06/06 6:56:37 ET]
Table 'Wezen II' 9-max Seat #1 is the button
Seat 1: matiko09 ($176.60 in chips) 
Seat 2: Mr.Grigoriy ($118.38 in chips) 
Seat 3: oscarleon ($100 in chips) 
Seat 4: xxxibgdrgn ($102.50 in chips) 
Seat 5: stds st ($27.10 in chips) 
Seat 6: masaytoo ($97 in chips) 
Seat 8: mavin80 ($181.85 in chips) 
Seat 9: PacPacBum ($100 in chips) 
Mr.Grigoriy: posts small blind $0.50
oscarleon: posts big blind $1
*** HOLE CARDS ***
Dealt to matiko09 [8h Ts]
xxxibgdrgn: folds 
stds st: folds 
masaytoo: folds 
mavin80: folds 
PacPacBum: folds 
matiko09: folds 
Mr.Grigoriy: raises $1.50 to $2.50
oscarleon: folds 
Uncalled bet ($1.50) returned to Mr.Grigoriy
Mr.Grigoriy collected $2 from pot
Mr.Grigoriy: doesn't show hand 
*** SUMMARY ***
Total pot $2 | Rake $0 
Seat 1: matiko09 (button) folded before Flop (didn't bet)
Seat 2: Mr.Grigoriy (small blind) collected ($2)
Seat 3: oscarleon (big blind) folded before Flop
Seat 4: xxxibgdrgn folded before Flop (didn't bet)
Seat 5: stds st folded before Flop (didn't bet)
Seat 6: masaytoo folded before Flop (didn't bet)
Seat 8: mavin80 folded before Flop (didn't bet)
Seat 9: PacPacBum folded before Flop (didn't bet)





PokerStars Hand #154363426379:  Hold'em No Limit (€0.50/€1.00 EUR) - 2016/06/06 12:56:50 CET [2016/06/06 6:56:50 ET]
Table 'Lesath' 9-max Seat #9 is the button
Seat 1: o.miro (€100.50 in chips) 
Seat 2: thecurv (€100 in chips) 
Seat 3: ozone2003 (€219.15 in chips) 
Seat 4: hammerwife (€130.26 in chips) 
Seat 5: matiko09 (€100 in chips) 
Seat 6: Szevasztopol (€104.50 in chips) 
Seat 7: Mr.Grigoriy (€105.32 in chips) 
Seat 9: 72nloses (€95.44 in chips) 
o.miro: posts small blind €0.50
thecurv: posts big blind €1
*** HOLE CARDS ***
Dealt to matiko09 [Tc Jh]
ozone2003: folds 
hammerwife: raises €2 to €3
matiko09: folds 
Szevasztopol: folds 
Mr.Grigoriy: folds 
72nloses: folds 
o.miro: folds 
thecurv: folds 
Uncalled bet (€2) returned to hammerwife
hammerwife collected €2.50 from pot
hammerwife: doesn't show hand 
*** SUMMARY ***
Total pot €2.50 | Rake €0 
Seat 1: o.miro (small blind) folded before Flop
Seat 2: thecurv (big blind) folded before Flop
Seat 3: ozone2003 folded before Flop (didn't bet)
Seat 4: hammerwife collected (€2.50)
Seat 5: matiko09 folded before Flop (didn't bet)
Seat 6: Szevasztopol folded before Flop (didn't bet)
Seat 7: Mr.Grigoriy folded before Flop (didn't bet)
Seat 9: 72nloses (button) folded before Flop (didn't bet)





PokerStars Hand #154363426477:  Hold'em No Limit ($0.50/$1.00 USD) - 2016/06/06 12:56:50 CET [2016/06/06 6:56:50 ET]
Table 'Safara' 9-max Seat #6 is the button
Seat 1: oscarleon ($244.06 in chips) 
Seat 3: Melvisfan ($80 in chips) 
Seat 6: matiko09 ($129.36 in chips) 
Seat 7: PacPacBum ($117.07 in chips) 
Seat 8: 32rrew ($100 in chips) 
Seat 9: Mr.Grigoriy ($115.50 in chips) 
PacPacBum: posts small blind $0.50
32rrew: posts big blind $1
o.miro: sits out 
Mukhin1: sits out 
*** HOLE CARDS ***
Dealt to matiko09 [Ks 3s]
Mr.Grigoriy: folds 
oscarleon: folds 
Melvisfan: folds 
matiko09: raises $1.27 to $2.27
PacPacBum: folds 
32rrew: folds 
Uncalled bet ($1.27) returned to matiko09
matiko09 collected $2.50 from pot
matiko09: doesn't show hand 
*** SUMMARY ***
Total pot $2.50 | Rake $0 
Seat 1: oscarleon folded before Flop (didn't bet)
Seat 3: Melvisfan folded before Flop (didn't bet)
Seat 6: matiko09 (button) collected ($2.50)
Seat 7: PacPacBum (small blind) folded before Flop
Seat 8: 32rrew (big blind) folded before Flop
Seat 9: Mr.Grigoriy folded before Flop (didn't bet)





PokerStars Hand #154363429855:  Hold'em No Limit ($0.50/$1.00 USD) - 2016/06/06 12:56:59 CET [2016/06/06 6:56:59 ET]
Table 'Gajdariya' 9-max Seat #4 is the button
Seat 1: matiko09 ($112.73 in chips) 
Seat 2: xxxZeka ($166.46 in chips) 
Seat 3: oscarleon ($112.05 in chips) 
Seat 4: Szevasztopol ($147.90 in chips) 
Seat 5: 147734319 ($40.13 in chips) 
Seat 6: mono123viva ($76.73 in chips) 
Seat 7: Wombatkilla ($66.89 in chips) 
Seat 8: ardo888 ($153.47 in chips) 
Seat 9: Mr.Grigoriy ($139.75 in chips) 
147734319: posts small blind $0.50
mono123viva: posts big blind $1
*** HOLE CARDS ***
Dealt to matiko09 [5c Ad]
Wombatkilla: folds 
ardo888: folds 
Mr.Grigoriy: folds 
matiko09: folds 
xxxZeka: folds 
oscarleon: folds 
Szevasztopol: folds 
147734319: raises $1.50 to $2.50
mono123viva: calls $1.50
*** FLOP *** [Qs 4d 8d]
147734319: bets $4.75
mono123viva: folds 
Uncalled bet ($4.75) returned to 147734319
147734319 collected $4.75 from pot
147734319: doesn't show hand 
*** SUMMARY ***
Total pot $5 | Rake $0.25 
Board [Qs 4d 8d]
Seat 1: matiko09 folded before Flop (didn't bet)
Seat 2: xxxZeka folded before Flop (didn't bet)
Seat 3: oscarleon folded before Flop (didn't bet)
Seat 4: Szevasztopol (button) folded before Flop (didn't bet)
Seat 5: 147734319 (small blind) collected ($4.75)
Seat 6: mono123viva (big blind) folded on the Flop
Seat 7: Wombatkilla folded before Flop (didn't bet)
Seat 8: ardo888 folded before Flop (didn't bet)
Seat 9: Mr.Grigoriy folded before Flop (didn't bet)





PokerStars Hand #154363433076:  Hold'em No Limit (€0.50/€1.00 EUR) - 2016/06/06 12:57:08 CET [2016/06/06 6:57:08 ET]
Table 'Lesath' 9-max Seat #1 is the button
Seat 1: o.miro (€100 in chips) 
Seat 2: thecurv (€100 in chips) 
Seat 3: ozone2003 (€219.15 in chips) 
Seat 4: hammerwife (€131.76 in chips) 
Seat 5: matiko09 (€100 in chips) 
Seat 6: Szevasztopol (€104.50 in chips) 
Seat 7: Mr.Grigoriy (€105.32 in chips) 
Seat 9: 72nloses (€95.44 in chips) 
thecurv: posts small blind €0.50
ozone2003: posts big blind €1
*** HOLE CARDS ***
Dealt to matiko09 [7h 7d]
hammerwife: folds 
matiko09: raises €2 to €3
Szevasztopol: folds 
Mr.Grigoriy: folds 
72nloses: folds 
o.miro: folds 
thecurv: folds 
ozone2003: folds 
Uncalled bet (€2) returned to matiko09
matiko09 collected €2.50 from pot
matiko09: doesn't show hand 
*** SUMMARY ***
Total pot €2.50 | Rake €0 
Seat 1: o.miro (button) folded before Flop (didn't bet)
Seat 2: thecurv (small blind) folded before Flop
Seat 3: ozone2003 (big blind) folded before Flop
Seat 4: hammerwife folded before Flop (didn't bet)
Seat 5: matiko09 collected (€2.50)
Seat 6: Szevasztopol folded before Flop (didn't bet)
Seat 7: Mr.Grigoriy folded before Flop (didn't bet)
Seat 9: 72nloses folded before Flop (didn't bet)





PokerStars Hand #154363435448:  Hold'em No Limit ($0.50/$1.00 USD) - 2016/06/06 12:57:14 CET [2016/06/06 6:57:14 ET]
Table 'Safara' 9-max Seat #7 is the button
Seat 1: oscarleon ($244.06 in chips) 
Seat 3: Melvisfan ($80 in chips) 
Seat 6: matiko09 ($130.86 in chips) 
Seat 7: PacPacBum ($116.57 in chips) 
Seat 8: 32rrew ($100 in chips) 
Seat 9: Mr.Grigoriy ($115.50 in chips) 
32rrew: posts small blind $0.50
Mr.Grigoriy: posts big blind $1
o.miro: sits out 
Mukhin1: sits out 
*** HOLE CARDS ***
Dealt to matiko09 [9c 2s]
oscarleon: folds 
Melvisfan: calls $1
matiko09: folds 
PacPacBum: raises $4 to $5
32rrew: folds 
Mr.Grigoriy: folds 
Melvisfan: folds 
Uncalled bet ($4) returned to PacPacBum
PacPacBum collected $3.50 from pot
PacPacBum: doesn't show hand 
*** SUMMARY ***
Total pot $3.50 | Rake $0 
Seat 1: oscarleon folded before Flop (didn't bet)
Seat 3: Melvisfan folded before Flop
Seat 6: matiko09 folded before Flop (didn't bet)
Seat 7: PacPacBum (button) collected ($3.50)
Seat 8: 32rrew (small blind) folded before Flop
Seat 9: Mr.Grigoriy (big blind) folded before Flop





PokerStars Hand #154363435787:  Hold'em No Limit ($0.50/$1.00 USD) - 2016/06/06 12:57:15 CET [2016/06/06 6:57:15 ET]
Table 'Wezen II' 9-max Seat #2 is the button
Seat 1: matiko09 ($176.60 in chips) 
Seat 2: Mr.Grigoriy ($119.38 in chips) 
Seat 3: oscarleon ($100 in chips) 
Seat 4: xxxibgdrgn ($102.50 in chips) 
Seat 5: stds st ($27.10 in chips) 
Seat 6: masaytoo ($97 in chips) 
Seat 8: mavin80 ($181.85 in chips) 
Seat 9: PacPacBum ($100 in chips) 
oscarleon: posts small blind $0.50
xxxibgdrgn: posts big blind $1
*** HOLE CARDS ***
Dealt to matiko09 [9s Jd]
stds st: folds 
masaytoo: raises $2 to $3
mavin80: calls $3
PacPacBum: folds 
matiko09: folds 
Mr.Grigoriy: folds 
oscarleon: folds 
xxxibgdrgn: folds 
*** FLOP *** [Tc Td Js]
masaytoo: bets $3.60
mavin80: folds 
Uncalled bet ($3.60) returned to masaytoo
masaytoo collected $7.12 from pot
masaytoo: doesn't show hand 
*** SUMMARY ***
Total pot $7.50 | Rake $0.38 
Board [Tc Td Js]
Seat 1: matiko09 folded before Flop (didn't bet)
Seat 2: Mr.Grigoriy (button) folded before Flop (didn't bet)
Seat 3: oscarleon (small blind) folded before Flop
Seat 4: xxxibgdrgn (big blind) folded before Flop
Seat 5: stds st folded before Flop (didn't bet)
Seat 6: masaytoo collected ($7.12)
Seat 8: mavin80 folded on the Flop
Seat 9: PacPacBum folded before Flop (didn't bet)





PokerStars Hand #154363437913:  Hold'em No Limit ($0.50/$1.00 USD) - 2016/06/06 12:57:21 CET [2016/06/06 6:57:21 ET]
Table 'Chaldaea II' 9-max Seat #7 is the button
Seat 1: Szevasztopol ($102.22 in chips) 
Seat 2: masaytoo ($95.99 in chips) 
Seat 3: ardo888 ($108.61 in chips) 
Seat 4: mooose100 ($100 in chips) 
Seat 5: stds st ($37.50 in chips) 
Seat 6: PacPacBum ($102 in chips) 
Seat 7: riggedsh** ($202.08 in chips) 
Seat 8: 32rrew ($100.50 in chips) 
Seat 9: matiko09 ($103 in chips) 
32rrew: posts small blind $0.50
matiko09: posts big blind $1
*** HOLE CARDS ***
Dealt to matiko09 [5c Ks]
Szevasztopol: folds 
masaytoo: folds 
ardo888: raises $2 to $3
mooose100: folds 
stds st: folds 
PacPacBum: folds 
riggedsh**: folds 
32rrew: folds 
matiko09: folds 
Uncalled bet ($2) returned to ardo888
ardo888 collected $2.50 from pot
ardo888: doesn't show hand 
*** SUMMARY ***
Total pot $2.50 | Rake $0 
Seat 1: Szevasztopol folded before Flop (didn't bet)
Seat 2: masaytoo folded before Flop (didn't bet)
Seat 3: ardo888 collected ($2.50)
Seat 4: mooose100 folded before Flop (didn't bet)
Seat 5: stds st folded before Flop (didn't bet)
Seat 6: PacPacBum folded before Flop (didn't bet)
Seat 7: riggedsh** (button) folded before Flop (didn't bet)
Seat 8: 32rrew (small blind) folded before Flop
Seat 9: matiko09 (big blind) folded before Flop





PokerStars Hand #154363437949:  Hold'em No Limit ($0.50/$1.00 USD) - 2016/06/06 12:57:21 CET [2016/06/06 6:57:21 ET]
Table 'Smither' 9-max Seat #7 is the button
Seat 1: PacPacBum ($190.12 in chips) 
Seat 2: matiko09 ($102.34 in chips) 
Seat 3: xxxZeka ($130.57 in chips) 
Seat 5: Szevasztopol ($101.50 in chips) 
Seat 7: vanilica ($100 in chips) 
Seat 8: 74 ROADIE ($59.18 in chips) 
Seat 9: hammerwife ($142.25 in chips) 
74 ROADIE: posts small blind $0.50
hammerwife: posts big blind $1
mooose100: sits out 
*** HOLE CARDS ***
Dealt to matiko09 [Ah Ac]
PacPacBum: folds 
matiko09: raises $2 to $3
xxxZeka: folds 
Szevasztopol: folds 
vanilica: folds 
74 ROADIE: folds 
hammerwife: folds 
Uncalled bet ($2) returned to matiko09
matiko09 collected $2.50 from pot
matiko09: doesn't show hand 
*** SUMMARY ***
Total pot $2.50 | Rake $0 
Seat 1: PacPacBum folded before Flop (didn't bet)
Seat 2: matiko09 collected ($2.50)
Seat 3: xxxZeka folded before Flop (didn't bet)
Seat 5: Szevasztopol folded before Flop (didn't bet)
Seat 7: vanilica (button) folded before Flop (didn't bet)
Seat 8: 74 ROADIE (small blind) folded before Flop
Seat 9: hammerwife (big blind) folded before Flop





PokerStars Hand #154363439675:  Hold'em No Limit ($0.50/$1.00 USD) - 2016/06/06 12:57:25 CET [2016/06/06 6:57:25 ET]
Table 'Williams' 9-max Seat #4 is the button
Seat 1: matiko09 ($186.51 in chips) 
Seat 2: PacPacBum ($103.40 in chips) 
Seat 3: granbunny ($72.26 in chips) 
Seat 4: Mr.Grigoriy ($102.50 in chips) 
Seat 5: xxxibgdrgn ($100 in chips) 
Seat 6: xxxZeka ($133.17 in chips) 
Seat 7: kevinho109 ($30.58 in chips) 
Seat 8: oscarleon ($116.86 in chips) 
xxxibgdrgn: posts small blind $0.50
xxxZeka: posts big blind $1
stds st: sits out 
*** HOLE CARDS ***
Dealt to matiko09 [Th 4c]
kevinho109: folds 
oscarleon: folds 
matiko09: folds 
PacPacBum: folds 
granbunny: raises $1 to $2
Mr.Grigoriy: folds 
xxxibgdrgn: folds 
xxxZeka: calls $1
*** FLOP *** [Qh 8s 8c]
xxxZeka: checks 
granbunny: bets $4
xxxZeka: folds 
Uncalled bet ($4) returned to granbunny
granbunny collected $4.28 from pot
granbunny: doesn't show hand 
*** SUMMARY ***
Total pot $4.50 | Rake $0.22 
Board [Qh 8s 8c]
Seat 1: matiko09 folded before Flop (didn't bet)
Seat 2: PacPacBum folded before Flop (didn't bet)
Seat 3: granbunny collected ($4.28)
Seat 4: Mr.Grigoriy (button) folded before Flop (didn't bet)
Seat 5: xxxibgdrgn (small blind) folded before Flop
Seat 6: xxxZeka (big blind) folded on the Flop
Seat 7: kevinho109 folded before Flop (didn't bet)
Seat 8: oscarleon folded before Flop (didn't bet)





PokerStars Hand #154363441406:  Hold'em No Limit ($0.50/$1.00 USD) - 2016/06/06 12:57:30 CET [2016/06/06 6:57:30 ET]
Table 'Gajdariya' 9-max Seat #5 is the button
Seat 1: matiko09 ($112.73 in chips) 
Seat 2: xxxZeka ($166.46 in chips) 
Seat 3: oscarleon ($112.05 in chips) 
Seat 4: Szevasztopol ($147.90 in chips) 
Seat 5: 147734319 ($42.38 in chips) 
Seat 6: mono123viva ($74.23 in chips) 
Seat 7: Wombatkilla ($66.89 in chips) 
Seat 8: ardo888 ($153.47 in chips) 
Seat 9: Mr.Grigoriy ($139.75 in chips) 
mono123viva: posts small blind $0.50
Wombatkilla: posts big blind $1
*** HOLE CARDS ***
Dealt to matiko09 [9d Td]
ardo888: folds 
Mr.Grigoriy: folds 
matiko09: raises $2 to $3
xxxZeka: folds 
oscarleon: folds 
Szevasztopol: folds 
147734319: calls $3
mono123viva: folds 
Wombatkilla: folds 
*** FLOP *** [8h Qh 7h]
matiko09: checks 
147734319: checks 
*** TURN *** [8h Qh 7h] [Ks]
matiko09: bets $4
147734319: folds 
Uncalled bet ($4) returned to matiko09
matiko09 collected $7.12 from pot
matiko09: doesn't show hand 
*** SUMMARY ***
Total pot $7.50 | Rake $0.38 
Board [8h Qh 7h Ks]
Seat 1: matiko09 collected ($7.12)
Seat 2: xxxZeka folded before Flop (didn't bet)
Seat 3: oscarleon folded before Flop (didn't bet)
Seat 4: Szevasztopol folded before Flop (didn't bet)
Seat 5: 147734319 (button) folded on the Turn
Seat 6: mono123viva (small blind) folded before Flop
Seat 7: Wombatkilla (big blind) folded before Flop
Seat 8: ardo888 folded before Flop (didn't bet)
Seat 9: Mr.Grigoriy folded before Flop (didn't bet)





PokerStars Hand #154363446221:  Hold'em No Limit (€0.50/€1.00 EUR) - 2016/06/06 12:57:43 CET [2016/06/06 6:57:43 ET]
Table 'Kythera' 9-max Seat #6 is the button
Seat 1: aquarua7 (€109.07 in chips) 
Seat 2: vanilica (€100 in chips) 
Seat 3: matiko09 (€120.74 in chips) 
Seat 4: PacPacBum (€100 in chips) 
Seat 5: Dickyxxx (€100 in chips) 
Seat 6: ozone2003 (€100 in chips) 
aquarua7: posts small blind €0.50
vanilica: posts big blind €1
*** HOLE CARDS ***
Dealt to matiko09 [9d 7h]
matiko09: folds 
PacPacBum: folds 
Dickyxxx: folds 
ozone2003: raises €1.20 to €2.20
aquarua7: folds 
vanilica: folds 
Uncalled bet (€1.20) returned to ozone2003
ozone2003 collected €2.50 from pot
ozone2003: doesn't show hand 
*** SUMMARY ***
Total pot €2.50 | Rake €0 
Seat 1: aquarua7 (small blind) folded before Flop
Seat 2: vanilica (big blind) folded before Flop
Seat 3: matiko09 folded before Flop (didn't bet)
Seat 4: PacPacBum folded before Flop (didn't bet)
Seat 5: Dickyxxx folded before Flop (didn't bet)
Seat 6: ozone2003 (button) collected (€2.50)





PokerStars Hand #154363448010:  Hold'em No Limit ($0.50/$1.00 USD) - 2016/06/06 12:57:47 CET [2016/06/06 6:57:47 ET]
Table 'Safara' 9-max Seat #8 is the button
Seat 1: oscarleon ($244.06 in chips) 
Seat 3: Melvisfan ($79 in chips) 
Seat 6: matiko09 ($130.86 in chips) 
Seat 7: PacPacBum ($119.07 in chips) 
Seat 8: 32rrew ($100 in chips) 
Seat 9: Mr.Grigoriy ($114.50 in chips) 
Mr.Grigoriy: posts small blind $0.50
oscarleon: posts big blind $1
o.miro: sits out 
Mukhin1: sits out 
*** HOLE CARDS ***
Dealt to matiko09 [8d 8s]
Melvisfan: calls $1
matiko09: raises $3 to $4
PacPacBum: folds 
32rrew: folds 
Mr.Grigoriy: folds 
oscarleon: folds 
Melvisfan: calls $3
*** FLOP *** [Ad Kd 2c]
Melvisfan: bets $1
matiko09: calls $1
*** TURN *** [Ad Kd 2c] [9s]
Melvisfan: bets $1
matiko09: calls $1
*** RIVER *** [Ad Kd 2c 9s] [8h]
Melvisfan: bets $1
matiko09: raises $9.63 to $10.63
Melvisfan: folds 
Uncalled bet ($9.63) returned to matiko09
matiko09 collected $14.72 from pot
matiko09: doesn't show hand 
*** SUMMARY ***
Total pot $15.50 | Rake $0.78 
Board [Ad Kd 2c 9s 8h]
Seat 1: oscarleon (big blind) folded before Flop
Seat 3: Melvisfan folded on the River
Seat 6: matiko09 collected ($14.72)
Seat 7: PacPacBum folded before Flop (didn't bet)
Seat 8: 32rrew (button) folded before Flop (didn't bet)
Seat 9: Mr.Grigoriy (small blind) folded before Flop





PokerStars Hand #154363448951:  Hold'em No Limit ($0.50/$1.00 USD) - 2016/06/06 12:57:50 CET [2016/06/06 6:57:50 ET]
Table 'Chaldaea II' 9-max Seat #8 is the button
Seat 1: Szevasztopol ($102.22 in chips) 
Seat 2: masaytoo ($95.99 in chips) 
Seat 3: ardo888 ($110.11 in chips) 
Seat 4: mooose100 ($100 in chips) 
Seat 5: stds st ($37.50 in chips) 
Seat 6: PacPacBum ($102 in chips) 
Seat 7: riggedsh** ($202.08 in chips) 
Seat 8: 32rrew ($100 in chips) 
Seat 9: matiko09 ($102 in chips) 
matiko09: posts small blind $0.50
Szevasztopol: posts big blind $1
*** HOLE CARDS ***
Dealt to matiko09 [8h 6c]
masaytoo: folds 
ardo888: folds 
mooose100: folds 
stds st: folds 
PacPacBum: folds 
riggedsh**: folds 
32rrew: folds 
matiko09: folds 
Uncalled bet ($0.50) returned to Szevasztopol
Szevasztopol collected $1 from pot
Szevasztopol: doesn't show hand 
*** SUMMARY ***
Total pot $1 | Rake $0 
Seat 1: Szevasztopol (big blind) collected ($1)
Seat 2: masaytoo folded before Flop (didn't bet)
Seat 3: ardo888 folded before Flop (didn't bet)
Seat 4: mooose100 folded before Flop (didn't bet)
Seat 5: stds st folded before Flop (didn't bet)
Seat 6: PacPacBum folded before Flop (didn't bet)
Seat 7: riggedsh** folded before Flop (didn't bet)
Seat 8: 32rrew (button) folded before Flop (didn't bet)
Seat 9: matiko09 (small blind) folded before Flop





PokerStars Hand #154363450832:  Hold'em No Limit ($0.50/$1.00 USD) - 2016/06/06 12:57:55 CET [2016/06/06 6:57:55 ET]
Table 'Sheliak' 9-max Seat #4 is the button
Seat 1: 32rrew ($100 in chips) 
Seat 2: masaytoo ($96 in chips) 
Seat 3: oscarleon ($118 in chips) 
Seat 4: iRLM ($68.31 in chips) 
Seat 5: hammerwife ($100 in chips) 
Seat 6: matiko09 ($100 in chips) 
Seat 7: stds st ($28.13 in chips) 
Seat 8: ozone2003 ($100 in chips) 
Seat 9: Szevasztopol ($100 in chips) 
hammerwife: posts small blind $0.50
matiko09: posts big blind $1
*** HOLE CARDS ***
Dealt to matiko09 [7d 7c]
stds st: folds 
ozone2003: folds 
Szevasztopol: folds 
32rrew: folds 
masaytoo: raises $2 to $3
oscarleon: folds 
iRLM: folds 
hammerwife: folds 
matiko09: calls $2
*** FLOP *** [Qs Qh 5d]
matiko09: checks 
masaytoo: bets $3.30
matiko09: calls $3.30
*** TURN *** [Qs Qh 5d] [Jd]
matiko09: checks 
masaytoo: checks 
*** RIVER *** [Qs Qh 5d Jd] [Kd]
matiko09: checks 
masaytoo: checks 
*** SHOW DOWN ***
matiko09: shows [7d 7c] (two pair, Queens and Sevens)
masaytoo: shows [Ac Td] (a straight, Ten to Ace)
masaytoo collected $12.44 from pot
*** SUMMARY ***
Total pot $13.10 | Rake $0.66 
Board [Qs Qh 5d Jd Kd]
Seat 1: 32rrew folded before Flop (didn't bet)
Seat 2: masaytoo showed [Ac Td] and won ($12.44) with a straight, Ten to Ace
Seat 3: oscarleon folded before Flop (didn't bet)
Seat 4: iRLM (button) folded before Flop (didn't bet)
Seat 5: hammerwife (small blind) folded before Flop
Seat 6: matiko09 (big blind) showed [7d 7c] and lost with two pair, Queens and Sevens
Seat 7: stds st folded before Flop (didn't bet)
Seat 8: ozone2003 folded before Flop (didn't bet)
Seat 9: Szevasztopol folded before Flop (didn't bet)





PokerStars Hand #154363451089:  Hold'em No Limit (€0.50/€1.00 EUR) - 2016/06/06 12:57:56 CET [2016/06/06 6:57:56 ET]
Table 'Lesath' 9-max Seat #2 is the button
Seat 1: o.miro (€100 in chips) 
Seat 2: thecurv (€100 in chips) 
Seat 3: ozone2003 (€218.15 in chips) 
Seat 4: hammerwife (€131.76 in chips) 
Seat 5: matiko09 (€101.50 in chips) 
Seat 6: Szevasztopol (€104.50 in chips) 
Seat 7: Mr.Grigoriy (€105.32 in chips) 
Seat 9: 72nloses (€95.44 in chips) 
ozone2003: posts small blind €0.50
hammerwife: posts big blind €1
*** HOLE CARDS ***
Dealt to matiko09 [Js 9d]
matiko09: folds 
Szevasztopol: folds 
Mr.Grigoriy: raises €2 to €3
72nloses: folds 
o.miro: folds 
thecurv: folds 
ozone2003: folds 
hammerwife: folds 
Uncalled bet (€2) returned to Mr.Grigoriy
Mr.Grigoriy collected €2.50 from pot
Mr.Grigoriy: doesn't show hand 
*** SUMMARY ***
Total pot €2.50 | Rake €0 
Seat 1: o.miro folded before Flop (didn't bet)
Seat 2: thecurv (button) folded before Flop (didn't bet)
Seat 3: ozone2003 (small blind) folded before Flop
Seat 4: hammerwife (big blind) folded before Flop
Seat 5: matiko09 folded before Flop (didn't bet)
Seat 6: Szevasztopol folded before Flop (didn't bet)
Seat 7: Mr.Grigoriy collected (€2.50)
Seat 9: 72nloses folded before Flop (didn't bet)





PokerStars Hand #154363451864:  Hold'em No Limit ($0.50/$1.00 USD) - 2016/06/06 12:57:58 CET [2016/06/06 6:57:58 ET]
Table 'Smither' 9-max Seat #8 is the button
Seat 1: PacPacBum ($190.12 in chips) 
Seat 2: matiko09 ($103.84 in chips) 
Seat 3: xxxZeka ($130.57 in chips) 
Seat 5: Szevasztopol ($101.50 in chips) 
Seat 7: vanilica ($100 in chips) 
Seat 8: 74 ROADIE ($58.68 in chips) 
Seat 9: hammerwife ($141.25 in chips) 
hammerwife: posts small blind $0.50
PacPacBum: posts big blind $1
mooose100: sits out 
*** HOLE CARDS ***
Dealt to matiko09 [Jd 3d]
matiko09: folds 
xxxZeka: folds 
Szevasztopol: folds 
vanilica: folds 
74 ROADIE: folds 
hammerwife: folds 
Uncalled bet ($0.50) returned to PacPacBum
PacPacBum collected $1 from pot
PacPacBum: doesn't show hand 
*** SUMMARY ***
Total pot $1 | Rake $0 
Seat 1: PacPacBum (big blind) collected ($1)
Seat 2: matiko09 folded before Flop (didn't bet)
Seat 3: xxxZeka folded before Flop (didn't bet)
Seat 5: Szevasztopol folded before Flop (didn't bet)
Seat 7: vanilica folded before Flop (didn't bet)
Seat 8: 74 ROADIE (button) folded before Flop (didn't bet)
Seat 9: hammerwife (small blind) folded before Flop





PokerStars Hand #154363453723:  Hold'em No Limit ($0.50/$1.00 USD) - 2016/06/06 12:58:03 CET [2016/06/06 6:58:03 ET]
Table 'Williams' 9-max Seat #5 is the button
Seat 1: matiko09 ($186.51 in chips) 
Seat 2: PacPacBum ($103.40 in chips) 
Seat 3: granbunny ($74.54 in chips) 
Seat 4: Mr.Grigoriy ($102.50 in chips) 
Seat 5: xxxibgdrgn ($100 in chips) 
Seat 6: xxxZeka ($131.17 in chips) 
Seat 7: kevinho109 ($30.58 in chips) 
Seat 8: oscarleon ($116.86 in chips) 
xxxZeka: posts small blind $0.50
kevinho109: posts big blind $1
stds st: sits out 
*** HOLE CARDS ***
Dealt to matiko09 [Jc 9h]
oscarleon: folds 
matiko09: folds 
PacPacBum: folds 
granbunny: folds 
Mr.Grigoriy: folds 
xxxibgdrgn: raises $1.50 to $2.50
xxxZeka: folds 
kevinho109: folds 
Uncalled bet ($1.50) returned to xxxibgdrgn
xxxibgdrgn collected $2.50 from pot
xxxibgdrgn: doesn't show hand 
*** SUMMARY ***
Total pot $2.50 | Rake $0 
Seat 1: matiko09 folded before Flop (didn't bet)
Seat 2: PacPacBum folded before Flop (didn't bet)
Seat 3: granbunny folded before Flop (didn't bet)
Seat 4: Mr.Grigoriy folded before Flop (didn't bet)
Seat 5: xxxibgdrgn (button) collected ($2.50)
Seat 6: xxxZeka (small blind) folded before Flop
Seat 7: kevinho109 (big blind) folded before Flop
Seat 8: oscarleon folded before Flop (didn't bet)





PokerStars Hand #154363454759:  Hold'em No Limit (€0.50/€1.00 EUR) - 2016/06/06 12:58:05 CET [2016/06/06 6:58:05 ET]
Table 'Kythera' 9-max Seat #1 is the button
Seat 1: aquarua7 (€108.57 in chips) 
Seat 2: vanilica (€100 in chips) 
Seat 3: matiko09 (€120.74 in chips) 
Seat 4: PacPacBum (€100 in chips) 
Seat 5: Dickyxxx (€100 in chips) 
Seat 6: ozone2003 (€101.50 in chips) 
vanilica: posts small blind €0.50
matiko09: posts big blind €1
*** HOLE CARDS ***
Dealt to matiko09 [4c 2d]
PacPacBum: folds 
Dickyxxx: raises €2 to €3
ozone2003: folds 
aquarua7: folds 
vanilica: folds 
matiko09: folds 
Uncalled bet (€2) returned to Dickyxxx
Dickyxxx collected €2.50 from pot
Dickyxxx: doesn't show hand 
*** SUMMARY ***
Total pot €2.50 | Rake €0 
Seat 1: aquarua7 (button) folded before Flop (didn't bet)
Seat 2: vanilica (small blind) folded before Flop
Seat 3: matiko09 (big blind) folded before Flop
Seat 4: PacPacBum folded before Flop (didn't bet)
Seat 5: Dickyxxx collected (€2.50)
Seat 6: ozone2003 folded before Flop (didn't bet)





PokerStars Hand #154363456961:  Hold'em No Limit ($0.50/$1.00 USD) - 2016/06/06 12:58:11 CET [2016/06/06 6:58:11 ET]
Table 'Smither' 9-max Seat #9 is the button
Seat 1: PacPacBum ($190.62 in chips) 
Seat 2: matiko09 ($103.84 in chips) 
Seat 3: xxxZeka ($130.57 in chips) 
Seat 5: Szevasztopol ($101.50 in chips) 
Seat 7: vanilica ($100 in chips) 
Seat 8: 74 ROADIE ($58.68 in chips) 
Seat 9: hammerwife ($140.75 in chips) 
PacPacBum: posts small blind $0.50
matiko09: posts big blind $1
mooose100: sits out 
*** HOLE CARDS ***
Dealt to matiko09 [5h Ts]
xxxZeka: folds 
Szevasztopol: folds 
vanilica: folds 
74 ROADIE has timed out
74 ROADIE: folds 
hammerwife: folds 
PacPacBum: folds 
Uncalled bet ($0.50) returned to matiko09
matiko09 collected $1 from pot
matiko09: doesn't show hand 
*** SUMMARY ***
Total pot $1 | Rake $0 
Seat 1: PacPacBum (small blind) folded before Flop
Seat 2: matiko09 (big blind) collected ($1)
Seat 3: xxxZeka folded before Flop (didn't bet)
Seat 5: Szevasztopol folded before Flop (didn't bet)
Seat 7: vanilica folded before Flop (didn't bet)
Seat 8: 74 ROADIE folded before Flop (didn't bet)
Seat 9: hammerwife (button) folded before Flop (didn't bet)





PokerStars Hand #154363457082:  Hold'em No Limit ($0.50/$1.00 USD) - 2016/06/06 12:58:11 CET [2016/06/06 6:58:11 ET]
Table 'Chaldaea II' 9-max Seat #9 is the button
Seat 1: Szevasztopol ($102.72 in chips) 
Seat 2: masaytoo ($95.99 in chips) 
Seat 3: ardo888 ($110.11 in chips) 
Seat 4: mooose100 ($100 in chips) 
Seat 5: stds st ($37.50 in chips) 
Seat 6: PacPacBum ($102 in chips) 
Seat 7: riggedsh** ($202.08 in chips) 
Seat 8: 32rrew ($100 in chips) 
Seat 9: matiko09 ($101.50 in chips) 
Szevasztopol: posts small blind $0.50
masaytoo: posts big blind $1
*** HOLE CARDS ***
Dealt to matiko09 [4d 4s]
ardo888: folds 
mooose100: folds 
stds st: raises $1.50 to $2.50
PacPacBum: folds 
riggedsh**: folds 
32rrew: folds 
matiko09: folds 
Szevasztopol: folds 
masaytoo: folds 
Uncalled bet ($1.50) returned to stds st
stds st collected $2.50 from pot
stds st: doesn't show hand 
*** SUMMARY ***
Total pot $2.50 | Rake $0 
Seat 1: Szevasztopol (small blind) folded before Flop
Seat 2: masaytoo (big blind) folded before Flop
Seat 3: ardo888 folded before Flop (didn't bet)
Seat 4: mooose100 folded before Flop (didn't bet)
Seat 5: stds st collected ($2.50)
Seat 6: PacPacBum folded before Flop (didn't bet)
Seat 7: riggedsh** folded before Flop (didn't bet)
Seat 8: 32rrew folded before Flop (didn't bet)
Seat 9: matiko09 (button) folded before Flop (didn't bet)





PokerStars Hand #154363457347:  Hold'em No Limit ($0.50/$1.00 USD) - 2016/06/06 12:58:12 CET [2016/06/06 6:58:12 ET]
Table 'Yarilo' 9-max Seat #3 is the button
Seat 1: xxxZeka ($100 in chips) 
Seat 2: nombraalne1 ($121.94 in chips) 
Seat 3: matiko09 ($100 in chips) 
Seat 4: stds st ($25.37 in chips) 
Seat 6: ozone2003 ($100 in chips) 
Seat 7: KEBIN1974 ($121.91 in chips) 
Seat 8: Mr.Grigoriy ($200.41 in chips) 
Seat 9: o.miro ($105.50 in chips) 
stds st: posts small blind $0.50
ozone2003: posts big blind $1
*** HOLE CARDS ***
Dealt to matiko09 [Js 5d]
KEBIN1974: folds 
Mr.Grigoriy: folds 
o.miro: folds 
xxxZeka: folds 
KEBIN1974 leaves the table
nombraalne1: folds 
matiko09: folds 
stds st: folds 
Uncalled bet ($0.50) returned to ozone2003
ozone2003 collected $1 from pot
ozone2003: doesn't show hand 
*** SUMMARY ***
Total pot $1 | Rake $0 
Seat 1: xxxZeka folded before Flop (didn't bet)
Seat 2: nombraalne1 folded before Flop (didn't bet)
Seat 3: matiko09 (button) folded before Flop (didn't bet)
Seat 4: stds st (small blind) folded before Flop
Seat 6: ozone2003 (big blind) collected ($1)
Seat 7: KEBIN1974 folded before Flop (didn't bet)
Seat 8: Mr.Grigoriy folded before Flop (didn't bet)
Seat 9: o.miro folded before Flop (didn't bet)





PokerStars Hand #154363458153:  Hold'em No Limit ($0.50/$1.00 USD) - 2016/06/06 12:58:14 CET [2016/06/06 6:58:14 ET]
Table 'Wezen II' 9-max Seat #3 is the button
Seat 1: matiko09 ($176.60 in chips) 
Seat 2: Mr.Grigoriy ($119.38 in chips) 
Seat 3: oscarleon ($100 in chips) 
Seat 4: xxxibgdrgn ($101.50 in chips) 
Seat 5: stds st ($27.10 in chips) 
Seat 6: masaytoo ($101.12 in chips) 
Seat 8: mavin80 ($178.85 in chips) 
Seat 9: PacPacBum ($100 in chips) 
xxxibgdrgn: posts small blind $0.50
stds st: posts big blind $1
*** HOLE CARDS ***
Dealt to matiko09 [4s 6d]
masaytoo: folds 
mavin80: raises $1 to $2
PacPacBum: folds 
matiko09: folds 
Mr.Grigoriy: folds 
oscarleon: folds 
xxxibgdrgn: folds 
stds st: folds 
Uncalled bet ($1) returned to mavin80
mavin80 collected $2.50 from pot
mavin80: doesn't show hand 
*** SUMMARY ***
Total pot $2.50 | Rake $0 
Seat 1: matiko09 folded before Flop (didn't bet)
Seat 2: Mr.Grigoriy folded before Flop (didn't bet)
Seat 3: oscarleon (button) folded before Flop (didn't bet)
Seat 4: xxxibgdrgn (small blind) folded before Flop
Seat 5: stds st (big blind) folded before Flop
Seat 6: masaytoo folded before Flop (didn't bet)
Seat 8: mavin80 collected ($2.50)
Seat 9: PacPacBum folded before Flop (didn't bet)





PokerStars Hand #154363458518:  Hold'em No Limit ($0.50/$1.00 USD) - 2016/06/06 12:58:15 CET [2016/06/06 6:58:15 ET]
Table 'Heze' 9-max Seat #7 is the button
Seat 1: matiko09 ($212.15 in chips) 
Seat 2: oscarleon ($195.20 in chips) 
Seat 3: ozone2003 ($123.79 in chips) 
Seat 4: ardo888 ($100 in chips) 
Seat 5: stds st ($38.50 in chips) 
Seat 6: yfcq36 ($100 in chips) 
Seat 7: 32rrew ($158.35 in chips) 
Seat 8: PacPacBum ($120.70 in chips) 
Seat 9: Mr.Grigoriy ($128.66 in chips) 
PacPacBum: posts small blind $0.50
Mr.Grigoriy: posts big blind $1
*** HOLE CARDS ***
Dealt to matiko09 [Qh Jh]
matiko09: raises $2 to $3
oscarleon: folds 
ozone2003: folds 
ardo888: folds 
stds st: folds 
yfcq36: raises $5 to $8
32rrew: folds 
PacPacBum: folds 
Mr.Grigoriy: folds 
matiko09: calls $5
*** FLOP *** [7h 2c 9h]
matiko09: checks 
yfcq36: bets $12
matiko09: calls $12
*** TURN *** [7h 2c 9h] [4d]
matiko09: checks 
yfcq36: bets $22
matiko09: calls $22
*** RIVER *** [7h 2c 9h 4d] [3c]
matiko09: checks 
yfcq36: bets $58 and is all-in
matiko09: folds 
Uncalled bet ($58) returned to yfcq36
yfcq36 collected $83 from pot
yfcq36: doesn't show hand 
*** SUMMARY ***
Total pot $85.50 | Rake $2.50 
Board [7h 2c 9h 4d 3c]
Seat 1: matiko09 folded on the River
Seat 2: oscarleon folded before Flop (didn't bet)
Seat 3: ozone2003 folded before Flop (didn't bet)
Seat 4: ardo888 folded before Flop (didn't bet)
Seat 5: stds st folded before Flop (didn't bet)
Seat 6: yfcq36 collected ($83)
Seat 7: 32rrew (button) folded before Flop (didn't bet)
Seat 8: PacPacBum (small blind) folded before Flop
Seat 9: Mr.Grigoriy (big blind) folded before Flop





PokerStars Hand #154363459607:  Hold'em No Limit (€0.50/€1.00 EUR) - 2016/06/06 12:58:18 CET [2016/06/06 6:58:18 ET]
Table 'Lesath' 9-max Seat #3 is the button
Seat 1: o.miro (€100 in chips) 
Seat 2: thecurv (€100 in chips) 
Seat 3: ozone2003 (€217.65 in chips) 
Seat 4: hammerwife (€130.76 in chips) 
Seat 5: matiko09 (€101.50 in chips) 
Seat 6: Szevasztopol (€104.50 in chips) 
Seat 7: Mr.Grigoriy (€106.82 in chips) 
Seat 9: 72nloses (€95.44 in chips) 
hammerwife: posts small blind €0.50
matiko09: posts big blind €1
*** HOLE CARDS ***
Dealt to matiko09 [4c 6d]
Szevasztopol: folds 
Mr.Grigoriy: folds 
72nloses: calls €1
o.miro: folds 
thecurv: folds 
ozone2003: folds 
hammerwife: calls €0.50
matiko09: checks 
*** FLOP *** [Kh 9s As]
hammerwife: checks 
matiko09: checks 
72nloses: checks 
*** TURN *** [Kh 9s As] [5c]
hammerwife: checks 
matiko09: checks 
72nloses: checks 
*** RIVER *** [Kh 9s As 5c] [9h]
hammerwife: checks 
matiko09: checks 
72nloses: checks 
*** SHOW DOWN ***
hammerwife: shows [3h 3s] (two pair, Nines and Threes)
matiko09: mucks hand 
72nloses: mucks hand 
hammerwife collected €2.85 from pot
*** SUMMARY ***
Total pot €3 | Rake €0.15 
Board [Kh 9s As 5c 9h]
Seat 1: o.miro folded before Flop (didn't bet)
Seat 2: thecurv folded before Flop (didn't bet)
Seat 3: ozone2003 (button) folded before Flop (didn't bet)
Seat 4: hammerwife (small blind) showed [3h 3s] and won (€2.85) with two pair, Nines and Threes
Seat 5: matiko09 (big blind) mucked [4c 6d]
Seat 6: Szevasztopol folded before Flop (didn't bet)
Seat 7: Mr.Grigoriy folded before Flop (didn't bet)
Seat 9: 72nloses mucked [Jc 6c]





PokerStars Hand #154363461272:  Hold'em No Limit (€0.50/€1.00 EUR) - 2016/06/06 12:58:22 CET [2016/06/06 6:58:22 ET]
Table 'Kythera' 9-max Seat #2 is the button
Seat 1: aquarua7 (€108.57 in chips) 
Seat 2: vanilica (€100 in chips) 
Seat 3: matiko09 (€119.74 in chips) 
Seat 4: PacPacBum (€100 in chips) 
Seat 5: Dickyxxx (€101.50 in chips) 
Seat 6: ozone2003 (€101.50 in chips) 
matiko09: posts small blind €0.50
PacPacBum: posts big blind €1
*** HOLE CARDS ***
Dealt to matiko09 [8c 4c]
Dickyxxx: folds 
ozone2003: folds 
aquarua7: folds 
vanilica: folds 
matiko09: raises €2 to €3
PacPacBum: folds 
Uncalled bet (€2) returned to matiko09
matiko09 collected €2 from pot
matiko09: doesn't show hand 
*** SUMMARY ***
Total pot €2 | Rake €0 
Seat 1: aquarua7 folded before Flop (didn't bet)
Seat 2: vanilica (button) folded before Flop (didn't bet)
Seat 3: matiko09 (small blind) collected (€2)
Seat 4: PacPacBum (big blind) folded before Flop
Seat 5: Dickyxxx folded before Flop (didn't bet)
Seat 6: ozone2003 folded before Flop (didn't bet)





PokerStars Hand #154363463031:  Hold'em No Limit ($0.50/$1.00 USD) - 2016/06/06 12:58:27 CET [2016/06/06 6:58:27 ET]
Table 'Williams' 9-max Seat #6 is the button
Seat 1: matiko09 ($186.51 in chips) 
Seat 2: PacPacBum ($103.40 in chips) 
Seat 3: granbunny ($74.54 in chips) 
Seat 4: Mr.Grigoriy ($102.50 in chips) 
Seat 5: xxxibgdrgn ($101.50 in chips) 
Seat 6: xxxZeka ($130.67 in chips) 
Seat 7: kevinho109 ($29.58 in chips) 
Seat 8: oscarleon ($116.86 in chips) 
kevinho109: posts small blind $0.50
oscarleon: posts big blind $1
stds st: sits out 
*** HOLE CARDS ***
Dealt to matiko09 [As 2s]
matiko09: folds 
PacPacBum: folds 
granbunny: folds 
Mr.Grigoriy: folds 
xxxibgdrgn: raises $1.50 to $2.50
xxxZeka: folds 
kevinho109: folds 
oscarleon: calls $1.50
*** FLOP *** [Td 9c Jd]
oscarleon: checks 
xxxibgdrgn: checks 
*** TURN *** [Td 9c Jd] [8c]
oscarleon: checks 
xxxibgdrgn: checks 
*** RIVER *** [Td 9c Jd 8c] [Ks]
oscarleon: checks 
xxxibgdrgn: checks 
*** SHOW DOWN ***
oscarleon: shows [3h 4h] (high card King)
xxxibgdrgn: shows [9s Ts] (two pair, Tens and Nines)
xxxibgdrgn collected $5.22 from pot
*** SUMMARY ***
Total pot $5.50 | Rake $0.28 
Board [Td 9c Jd 8c Ks]
Seat 1: matiko09 folded before Flop (didn't bet)
Seat 2: PacPacBum folded before Flop (didn't bet)
Seat 3: granbunny folded before Flop (didn't bet)
Seat 4: Mr.Grigoriy folded before Flop (didn't bet)
Seat 5: xxxibgdrgn showed [9s Ts] and won ($5.22) with two pair, Tens and Nines
Seat 6: xxxZeka (button) folded before Flop (didn't bet)
Seat 7: kevinho109 (small blind) folded before Flop
Seat 8: oscarleon (big blind) showed [3h 4h] and lost with high card King





PokerStars Hand #154363463562:  Hold'em No Limit ($0.50/$1.00 USD) - 2016/06/06 12:58:29 CET [2016/06/06 6:58:29 ET]
Table 'Gajdariya' 9-max Seat #6 is the button
Seat 1: matiko09 ($116.85 in chips) 
Seat 2: xxxZeka ($166.46 in chips) 
Seat 3: oscarleon ($112.05 in chips) 
Seat 4: Szevasztopol ($147.90 in chips) 
Seat 5: 147734319 ($39.38 in chips) 
Seat 6: mono123viva ($73.73 in chips) 
Seat 7: Wombatkilla ($65.89 in chips) 
Seat 8: ardo888 ($153.47 in chips) 
Seat 9: Mr.Grigoriy ($139.75 in chips) 
Wombatkilla: posts small blind $0.50
ardo888: posts big blind $1
*** HOLE CARDS ***
Dealt to matiko09 [Qc Jc]
Mr.Grigoriy: folds 
matiko09: raises $2 to $3
xxxZeka: folds 
oscarleon: folds 
Szevasztopol: folds 
147734319: folds 
mono123viva: calls $3
Wombatkilla: folds 
ardo888: folds 
*** FLOP *** [Ah Td As]
matiko09: bets $4
mono123viva: calls $4
*** TURN *** [Ah Td As] [Ks]
matiko09: checks 
mono123viva: bets $6
matiko09: raises $8 to $14
mono123viva: calls $8
*** RIVER *** [Ah Td As Ks] [2s]
matiko09: bets $21.48
mono123viva: folds 
Uncalled bet ($21.48) returned to matiko09
matiko09 collected $41.32 from pot
matiko09: doesn't show hand 
*** SUMMARY ***
Total pot $43.50 | Rake $2.18 
Board [Ah Td As Ks 2s]
Seat 1: matiko09 collected ($41.32)
Seat 2: xxxZeka folded before Flop (didn't bet)
Seat 3: oscarleon folded before Flop (didn't bet)
Seat 4: Szevasztopol folded before Flop (didn't bet)
Seat 5: 147734319 folded before Flop (didn't bet)
Seat 6: mono123viva (button) folded on the River
Seat 7: Wombatkilla (small blind) folded before Flop
Seat 8: ardo888 (big blind) folded before Flop
Seat 9: Mr.Grigoriy folded before Flop (didn't bet)





PokerStars Hand #154363468728:  Hold'em No Limit ($0.50/$1.00 USD) - 2016/06/06 12:58:43 CET [2016/06/06 6:58:43 ET]
Table 'Wezen II' 9-max Seat #4 is the button
Seat 1: matiko09 ($176.60 in chips) 
Seat 2: Mr.Grigoriy ($119.38 in chips) 
Seat 3: oscarleon ($100 in chips) 
Seat 4: xxxibgdrgn ($101 in chips) 
Seat 5: stds st ($26.10 in chips) 
Seat 6: masaytoo ($101.12 in chips) 
Seat 8: mavin80 ($180.35 in chips) 
Seat 9: PacPacBum ($100 in chips) 
stds st: posts small blind $0.50
masaytoo: posts big blind $1
KDJAll3: sits out 
*** HOLE CARDS ***
Dealt to matiko09 [Qd 2s]
mavin80 has timed out
mavin80: folds 
PacPacBum: folds 
mavin80 leaves the table
matiko09: folds 
o.miro joins the table at seat #8 
Mr.Grigoriy: raises $2 to $3
oscarleon: folds 
xxxibgdrgn: folds 
stds st: raises $23.10 to $26.10 and is all-in
masaytoo: folds 
Mr.Grigoriy: calls $23.10
*** FIRST FLOP *** [Ks Th 4s]
*** FIRST TURN *** [Ks Th 4s] [3d]
*** FIRST RIVER *** [Ks Th 4s 3d] [5s]
*** SECOND FLOP *** [6h Qh Ts]
*** SECOND TURN *** [6h Qh Ts] [2d]
*** SECOND RIVER *** [6h Qh Ts 2d] [4d]
*** FIRST SHOW DOWN ***
stds st: shows [Ad Kc] (a pair of Kings)
Mr.Grigoriy: shows [Kd Ac] (a pair of Kings)
stds st collected $12.68 from pot
Mr.Grigoriy collected $12.67 from pot
*** SECOND SHOW DOWN ***
stds st: shows [Ad Kc] (high card Ace)
Mr.Grigoriy: shows [Kd Ac] (high card Ace)
stds st collected $12.68 from pot
Mr.Grigoriy collected $12.67 from pot
*** SUMMARY ***
Total pot $53.20 | Rake $2.50 
Hand was run twice
FIRST Board [Ks Th 4s 3d 5s]
SECOND Board [6h Qh Ts 2d 4d]
Seat 1: matiko09 folded before Flop (didn't bet)
Seat 2: Mr.Grigoriy showed [Kd Ac] and won ($12.67) with a pair of Kings, and won ($12.67) with high card Ace
Seat 3: oscarleon folded before Flop (didn't bet)
Seat 4: xxxibgdrgn (button) folded before Flop (didn't bet)
Seat 5: stds st (small blind) showed [Ad Kc] and won ($12.68) with a pair of Kings, and won ($12.68) with high card Ace
Seat 6: masaytoo (big blind) folded before Flop
Seat 8: mavin80 folded before Flop (didn't bet)
Seat 9: PacPacBum folded before Flop (didn't bet)





PokerStars Hand #154363469110:  Hold'em No Limit (€0.50/€1.00 EUR) - 2016/06/06 12:58:44 CET [2016/06/06 6:58:44 ET]
Table 'Kythera' 9-max Seat #3 is the button
Seat 1: aquarua7 (€108.57 in chips) 
Seat 2: vanilica (€100 in chips) 
Seat 3: matiko09 (€120.74 in chips) 
Seat 4: PacPacBum (€100 in chips) 
Seat 5: Dickyxxx (€101.50 in chips) 
Seat 6: ozone2003 (€101.50 in chips) 
PacPacBum: posts small blind €0.50
Dickyxxx: posts big blind €1
*** HOLE CARDS ***
Dealt to matiko09 [Kc 5h]
ozone2003: raises €2 to €3
aquarua7: raises €7.50 to €10.50
vanilica: folds 
matiko09: folds 
PacPacBum: folds 
Dickyxxx: folds 
ozone2003: calls €7.50
*** FLOP *** [3d 6c As]
ozone2003: checks 
aquarua7: bets €14.25
ozone2003: folds 
Uncalled bet (€14.25) returned to aquarua7
aquarua7 collected €21.38 from pot
aquarua7: doesn't show hand 
*** SUMMARY ***
Total pot €22.50 | Rake €1.12 
Board [3d 6c As]
Seat 1: aquarua7 collected (€21.38)
Seat 2: vanilica folded before Flop (didn't bet)
Seat 3: matiko09 (button) folded before Flop (didn't bet)
Seat 4: PacPacBum (small blind) folded before Flop
Seat 5: Dickyxxx (big blind) folded before Flop
Seat 6: ozone2003 folded on the Flop





PokerStars Hand #154363469484:  Hold'em No Limit ($0.50/$1.00 USD) - 2016/06/06 12:58:45 CET [2016/06/06 6:58:45 ET]
Table 'Smither' 9-max Seat #1 is the button
Seat 1: PacPacBum ($190.12 in chips) 
Seat 2: matiko09 ($104.34 in chips) 
Seat 3: xxxZeka ($130.57 in chips) 
Seat 5: Szevasztopol ($101.50 in chips) 
Seat 7: vanilica ($100 in chips) 
Seat 8: 74 ROADIE ($58.68 in chips) 
Seat 9: hammerwife ($140.75 in chips) 
matiko09: posts small blind $0.50
xxxZeka: posts big blind $1
mooose100: sits out 
*** HOLE CARDS ***
Dealt to matiko09 [Ad 7s]
Szevasztopol: folds 
vanilica: folds 
74 ROADIE: folds 
hammerwife: folds 
PacPacBum: raises $1.50 to $2.50
matiko09: folds 
xxxZeka: folds 
Uncalled bet ($1.50) returned to PacPacBum
PacPacBum collected $2.50 from pot
PacPacBum: doesn't show hand 
*** SUMMARY ***
Total pot $2.50 | Rake $0 
Seat 1: PacPacBum (button) collected ($2.50)
Seat 2: matiko09 (small blind) folded before Flop
Seat 3: xxxZeka (big blind) folded before Flop
Seat 5: Szevasztopol folded before Flop (didn't bet)
Seat 7: vanilica folded before Flop (didn't bet)
Seat 8: 74 ROADIE folded before Flop (didn't bet)
Seat 9: hammerwife folded before Flop (didn't bet)





PokerStars Hand #154363472497:  Hold'em No Limit ($0.50/$1.00 USD) - 2016/06/06 12:58:53 CET [2016/06/06 6:58:53 ET]
Table 'Safara' 9-max Seat #9 is the button
Seat 1: oscarleon ($243.06 in chips) 
Seat 3: Melvisfan ($72 in chips) 
Seat 6: matiko09 ($138.58 in chips) 
Seat 7: PacPacBum ($119.07 in chips) 
Seat 8: 32rrew ($100 in chips) 
Seat 9: Mr.Grigoriy ($114 in chips) 
oscarleon: posts small blind $0.50
Melvisfan: posts big blind $1
o.miro: sits out 
Mukhin1: sits out 
*** HOLE CARDS ***
Dealt to matiko09 [Kh 6s]
matiko09: folds 
PacPacBum: folds 
32rrew: folds 
Mr.Grigoriy: folds 
oscarleon: raises $2 to $3
Melvisfan: calls $2
*** FLOP *** [3d 5h Jd]
oscarleon: bets $4
Melvisfan: calls $4
*** TURN *** [3d 5h Jd] [2h]
oscarleon: bets $10
Melvisfan: calls $10
*** RIVER *** [3d 5h Jd 2h] [Kd]
oscarleon: bets $23
Melvisfan: folds 
Uncalled bet ($23) returned to oscarleon
oscarleon collected $32.30 from pot
oscarleon: doesn't show hand 
*** SUMMARY ***
Total pot $34 | Rake $1.70 
Board [3d 5h Jd 2h Kd]
Seat 1: oscarleon (small blind) collected ($32.30)
Seat 3: Melvisfan (big blind) folded on the River
Seat 6: matiko09 folded before Flop (didn't bet)
Seat 7: PacPacBum folded before Flop (didn't bet)
Seat 8: 32rrew folded before Flop (didn't bet)
Seat 9: Mr.Grigoriy (button) folded before Flop (didn't bet)





PokerStars Hand #154363473720:  Hold'em No Limit ($0.50/$1.00 USD) - 2016/06/06 12:58:56 CET [2016/06/06 6:58:56 ET]
Table 'Chaldaea II' 9-max Seat #1 is the button
Seat 1: Szevasztopol ($102.22 in chips) 
Seat 2: masaytoo ($94.99 in chips) 
Seat 3: ardo888 ($110.11 in chips) 
Seat 4: mooose100 ($100 in chips) 
Seat 5: stds st ($39 in chips) 
Seat 6: PacPacBum ($102 in chips) 
Seat 7: riggedsh** ($202.08 in chips) 
Seat 8: 32rrew ($100 in chips) 
Seat 9: matiko09 ($101.50 in chips) 
masaytoo: posts small blind $0.50
ardo888: posts big blind $1
*** HOLE CARDS ***
Dealt to matiko09 [2d 7s]
mooose100: calls $1
stds st: folds 
PacPacBum: folds 
riggedsh**: folds 
32rrew: folds 
matiko09: folds 
Szevasztopol: folds 
masaytoo: folds 
ardo888: checks 
*** FLOP *** [Jc 9c 9h]
ardo888: checks 
mooose100: checks 
*** TURN *** [Jc 9c 9h] [6h]
ardo888: bets $1.80
mooose100: folds 
Uncalled bet ($1.80) returned to ardo888
ardo888 collected $2.38 from pot
ardo888: doesn't show hand 
*** SUMMARY ***
Total pot $2.50 | Rake $0.12 
Board [Jc 9c 9h 6h]
Seat 1: Szevasztopol (button) folded before Flop (didn't bet)
Seat 2: masaytoo (small blind) folded before Flop
Seat 3: ardo888 (big blind) collected ($2.38)
Seat 4: mooose100 folded on the Turn
Seat 5: stds st folded before Flop (didn't bet)
Seat 6: PacPacBum folded before Flop (didn't bet)
Seat 7: riggedsh** folded before Flop (didn't bet)
Seat 8: 32rrew folded before Flop (didn't bet)
Seat 9: matiko09 folded before Flop (didn't bet)





PokerStars Hand #154363473967:  Hold'em No Limit ($0.50/$1.00 USD) - 2016/06/06 12:58:57 CET [2016/06/06 6:58:57 ET]
Table 'Yarilo' 9-max Seat #4 is the button
Seat 1: xxxZeka ($100 in chips) 
Seat 2: nombraalne1 ($121.94 in chips) 
Seat 3: matiko09 ($100 in chips) 
Seat 4: stds st ($40 in chips) 
Seat 6: ozone2003 ($100.50 in chips) 
Seat 9: o.miro ($105.50 in chips) 
ozone2003: posts small blind $0.50
Mr.Grigoriy: is sitting out 
o.miro: posts big blind $1
*** HOLE CARDS ***
Dealt to matiko09 [2s Qs]
xxxZeka: folds 
Mr.Grigoriy leaves the table
hurtNCYDE joins the table at seat #7 
hurtNCYDE leaves the table
vanilica joins the table at seat #7 
nombraalne1: raises $1.50 to $2.50
vanilica leaves the table
matiko09: folds 
Dickyxxx joins the table at seat #7 
stds st: folds 
ozone2003: folds 
o.miro: folds 
Uncalled bet ($1.50) returned to nombraalne1
nombraalne1 collected $2.50 from pot
nombraalne1: doesn't show hand 
*** SUMMARY ***
Total pot $2.50 | Rake $0 
Seat 1: xxxZeka folded before Flop (didn't bet)
Seat 2: nombraalne1 collected ($2.50)
Seat 3: matiko09 folded before Flop (didn't bet)
Seat 4: stds st (button) folded before Flop (didn't bet)
Seat 6: ozone2003 (small blind) folded before Flop
Seat 9: o.miro (big blind) folded before Flop





PokerStars Hand #154363477860:  Hold'em No Limit ($0.50/$1.00 USD) - 2016/06/06 12:59:07 CET [2016/06/06 6:59:07 ET]
Table 'Williams' 9-max Seat #7 is the button
Seat 1: matiko09 ($186.51 in chips) 
Seat 2: PacPacBum ($103.40 in chips) 
Seat 3: granbunny ($74.54 in chips) 
Seat 4: Mr.Grigoriy ($102.50 in chips) 
Seat 5: xxxibgdrgn ($104.22 in chips) 
Seat 6: xxxZeka ($130.67 in chips) 
Seat 7: kevinho109 ($29.08 in chips) 
Seat 8: oscarleon ($114.36 in chips) 
Seat 9: stds st ($40 in chips) 
oscarleon: posts small blind $0.50
stds st: posts big blind $1
*** HOLE CARDS ***
Dealt to matiko09 [Ks 9c]
matiko09: folds 
PacPacBum: folds 
granbunny: raises $1 to $2
Mr.Grigoriy: folds 
xxxibgdrgn: folds 
xxxZeka: raises $5.50 to $7.50
kevinho109: folds 
oscarleon: folds 
stds st: folds 
granbunny: folds 
Uncalled bet ($5.50) returned to xxxZeka
xxxZeka collected $5.50 from pot
*** SUMMARY ***
Total pot $5.50 | Rake $0 
Seat 1: matiko09 folded before Flop (didn't bet)
Seat 2: PacPacBum folded before Flop (didn't bet)
Seat 3: granbunny folded before Flop
Seat 4: Mr.Grigoriy folded before Flop (didn't bet)
Seat 5: xxxibgdrgn folded before Flop (didn't bet)
Seat 6: xxxZeka collected ($5.50)
Seat 7: kevinho109 (button) folded before Flop (didn't bet)
Seat 8: oscarleon (small blind) folded before Flop
Seat 9: stds st (big blind) folded before Flop





PokerStars Hand #154363478280:  Hold'em No Limit ($0.50/$1.00 USD) - 2016/06/06 12:59:09 CET [2016/06/06 6:59:09 ET]
Table 'Smither' 9-max Seat #2 is the button
Seat 1: PacPacBum ($191.62 in chips) 
Seat 2: matiko09 ($103.84 in chips) 
Seat 3: xxxZeka ($129.57 in chips) 
Seat 5: Szevasztopol ($101.50 in chips) 
Seat 7: vanilica ($100 in chips) 
Seat 8: 74 ROADIE ($58.68 in chips) 
Seat 9: hammerwife ($140.75 in chips) 
xxxZeka: posts small blind $0.50
Szevasztopol: posts big blind $1
mooose100: sits out 
*** HOLE CARDS ***
Dealt to matiko09 [7h 9s]
vanilica: folds 
74 ROADIE: raises $2 to $3
hammerwife: folds 
PacPacBum: raises $6 to $9
matiko09: folds 
xxxZeka: folds 
Szevasztopol: folds 
74 ROADIE: calls $6
*** FLOP *** [Kd Th 5s]
74 ROADIE: checks 
PacPacBum: bets $6.48
74 ROADIE: raises $43.20 to $49.68 and is all-in
PacPacBum: folds 
Uncalled bet ($43.20) returned to 74 ROADIE
74 ROADIE collected $30.84 from pot
*** SUMMARY ***
Total pot $32.46 | Rake $1.62 
Board [Kd Th 5s]
Seat 1: PacPacBum folded on the Flop
Seat 2: matiko09 (button) folded before Flop (didn't bet)
Seat 3: xxxZeka (small blind) folded before Flop
Seat 5: Szevasztopol (big blind) folded before Flop
Seat 7: vanilica folded before Flop (didn't bet)
Seat 8: 74 ROADIE collected ($30.84)
Seat 9: hammerwife folded before Flop (didn't bet)





PokerStars Hand #154363484082:  Hold'em No Limit (€0.50/€1.00 EUR) - 2016/06/06 12:59:24 CET [2016/06/06 6:59:24 ET]
Table 'Kythera' 9-max Seat #4 is the button
Seat 1: aquarua7 (€119.45 in chips) 
Seat 2: vanilica (€100 in chips) 
Seat 3: matiko09 (€120.74 in chips) 
Seat 4: PacPacBum (€100 in chips) 
Seat 5: Dickyxxx (€100.50 in chips) 
Seat 6: ozone2003 (€100 in chips) 
Dickyxxx: posts small blind €0.50
ozone2003: posts big blind €1
*** HOLE CARDS ***
Dealt to matiko09 [Qd As]
aquarua7: folds 
vanilica: folds 
matiko09 has timed out
matiko09: folds 
PacPacBum: folds 
Dickyxxx: folds 
Uncalled bet (€0.50) returned to ozone2003
ozone2003 collected €1 from pot
ozone2003: doesn't show hand 
*** SUMMARY ***
Total pot €1 | Rake €0 
Seat 1: aquarua7 folded before Flop (didn't bet)
Seat 2: vanilica folded before Flop (didn't bet)
Seat 3: matiko09 folded before Flop (didn't bet)
Seat 4: PacPacBum (button) folded before Flop (didn't bet)
Seat 5: Dickyxxx (small blind) folded before Flop
Seat 6: ozone2003 (big blind) collected (€1)





PokerStars Hand #154363485922:  Hold'em No Limit ($0.50/$1.00 USD) - 2016/06/06 12:59:29 CET [2016/06/06 6:59:29 ET]
Table 'Yarilo' 9-max Seat #6 is the button
Seat 3: matiko09 ($100 in chips) 
Seat 4: stds st ($40 in chips) 
Seat 6: ozone2003 ($100 in chips) 
Seat 9: o.miro ($104.50 in chips) 
Dickyxxx will be allowed to play after the button
o.miro: posts small blind $0.50
xxxZeka: is sitting out 
nombraalne1: is sitting out 
matiko09: posts big blind $1
*** HOLE CARDS ***
Dealt to matiko09 [9d 7s]
stds st: folds 
nombraalne1 leaves the table
hurtNCYDE joins the table at seat #2 
hurtNCYDE leaves the table
ozone2003: folds 
o.miro: folds 
Uncalled bet ($0.50) returned to matiko09
matiko09 collected $1 from pot
matiko09: doesn't show hand 
*** SUMMARY ***
Total pot $1 | Rake $0 
Seat 3: matiko09 (big blind) collected ($1)
Seat 4: stds st folded before Flop (didn't bet)
Seat 6: ozone2003 (button) folded before Flop (didn't bet)
Seat 9: o.miro (small blind) folded before Flop





PokerStars Hand #154363490738:  Hold'em No Limit ($0.50/$1.00 USD) - 2016/06/06 12:59:42 CET [2016/06/06 6:59:42 ET]
Table 'Yarilo' 9-max Seat #9 is the button
Seat 3: matiko09 ($100.50 in chips) 
Seat 4: stds st ($40 in chips) 
Seat 6: ozone2003 ($100 in chips) 
Seat 9: o.miro ($104 in chips) 
matiko09: posts small blind $0.50
stds st: posts big blind $1
Dickyxxx: sits out 
*** HOLE CARDS ***
Dealt to matiko09 [5h Ts]
ozone2003: folds 
o.miro: raises $1.50 to $2.50
matiko09: folds 
stds st: folds 
Uncalled bet ($1.50) returned to o.miro
o.miro collected $2.50 from pot
o.miro: doesn't show hand 
*** SUMMARY ***
Total pot $2.50 | Rake $0 
Seat 3: matiko09 (small blind) folded before Flop
Seat 4: stds st (big blind) folded before Flop
Seat 6: ozone2003 folded before Flop (didn't bet)
Seat 9: o.miro (button) collected ($2.50)





PokerStars Hand #154363491198:  Hold'em No Limit ($0.50/$1.00 USD) - 2016/06/06 12:59:43 CET [2016/06/06 6:59:43 ET]
Table 'Sheliak' 9-max Seat #5 is the button
Seat 1: 32rrew ($100 in chips) 
Seat 2: masaytoo ($102.14 in chips) 
Seat 3: oscarleon ($118 in chips) 
Seat 4: iRLM ($68.31 in chips) 
Seat 5: hammerwife ($100 in chips) 
Seat 6: matiko09 ($100 in chips) 
Seat 7: stds st ($28.13 in chips) 
Seat 8: ozone2003 ($100 in chips) 
Seat 9: Szevasztopol ($100 in chips) 
matiko09: posts small blind $0.50
stds st: posts big blind $1
*** HOLE CARDS ***
Dealt to matiko09 [3h 8d]
ozone2003: folds 
Szevasztopol: raises $1.24 to $2.24
32rrew: folds 
masaytoo: folds 
oscarleon: folds 
iRLM: folds 
hammerwife: folds 
matiko09: folds 
stds st: folds 
Uncalled bet ($1.24) returned to Szevasztopol
Szevasztopol collected $2.50 from pot
Szevasztopol: doesn't show hand 
*** SUMMARY ***
Total pot $2.50 | Rake $0 
Seat 1: 32rrew folded before Flop (didn't bet)
Seat 2: masaytoo folded before Flop (didn't bet)
Seat 3: oscarleon folded before Flop (didn't bet)
Seat 4: iRLM folded before Flop (didn't bet)
Seat 5: hammerwife (button) folded before Flop (didn't bet)
Seat 6: matiko09 (small blind) folded before Flop
Seat 7: stds st (big blind) folded before Flop
Seat 8: ozone2003 folded before Flop (didn't bet)
Seat 9: Szevasztopol collected ($2.50)





PokerStars Hand #154363492473:  Hold'em No Limit ($0.50/$1.00 USD) - 2016/06/06 12:59:47 CET [2016/06/06 6:59:47 ET]
Table 'Wezen II' 9-max Seat #5 is the button
Seat 1: matiko09 ($176.60 in chips) 
Seat 2: Mr.Grigoriy ($118.62 in chips) 
Seat 3: oscarleon ($100 in chips) 
Seat 4: xxxibgdrgn ($101 in chips) 
Seat 5: stds st ($25.36 in chips) 
Seat 6: masaytoo ($100.12 in chips) 
Seat 7: KDJAll3 ($79.06 in chips) 
Seat 9: PacPacBum ($100 in chips) 
masaytoo: posts small blind $0.50
KDJAll3: posts big blind $1
o.miro: sits out 
*** HOLE CARDS ***
Dealt to matiko09 [2d 3h]
PacPacBum: folds 
matiko09: folds 
Mr.Grigoriy: folds 
oscarleon: folds 
xxxibgdrgn: folds 
stds st: raises $1.02 to $2.02
masaytoo: folds 
KDJAll3: folds 
Uncalled bet ($1.02) returned to stds st
stds st collected $2.50 from pot
stds st: doesn't show hand 
*** SUMMARY ***
Total pot $2.50 | Rake $0 
Seat 1: matiko09 folded before Flop (didn't bet)
Seat 2: Mr.Grigoriy folded before Flop (didn't bet)
Seat 3: oscarleon folded before Flop (didn't bet)
Seat 4: xxxibgdrgn folded before Flop (didn't bet)
Seat 5: stds st (button) collected ($2.50)
Seat 6: masaytoo (small blind) folded before Flop
Seat 7: KDJAll3 (big blind) folded before Flop
Seat 9: PacPacBum folded before Flop (didn't bet)





PokerStars Hand #154363492896:  Hold'em No Limit (€0.50/€1.00 EUR) - 2016/06/06 12:59:48 CET [2016/06/06 6:59:48 ET]
Table 'Lesath' 9-max Seat #4 is the button
Seat 1: o.miro (€100 in chips) 
Seat 2: thecurv (€100 in chips) 
Seat 3: ozone2003 (€217.65 in chips) 
Seat 4: hammerwife (€132.61 in chips) 
Seat 5: matiko09 (€100.50 in chips) 
Seat 6: Szevasztopol (€104.50 in chips) 
Seat 7: Mr.Grigoriy (€106.82 in chips) 
Seat 9: 72nloses (€94.44 in chips) 
matiko09: posts small blind €0.50
Szevasztopol: posts big blind €1
*** HOLE CARDS ***
Dealt to matiko09 [9c 8h]
Mr.Grigoriy: folds 
72nloses: folds 
o.miro: folds 
thecurv: folds 
ozone2003: folds 
hammerwife: raises €1.01 to €2.01
matiko09: folds 
Szevasztopol: folds 
Uncalled bet (€1.01) returned to hammerwife
hammerwife collected €2.50 from pot
hammerwife: doesn't show hand 
*** SUMMARY ***
Total pot €2.50 | Rake €0 
Seat 1: o.miro folded before Flop (didn't bet)
Seat 2: thecurv folded before Flop (didn't bet)
Seat 3: ozone2003 folded before Flop (didn't bet)
Seat 4: hammerwife (button) collected (€2.50)
Seat 5: matiko09 (small blind) folded before Flop
Seat 6: Szevasztopol (big blind) folded before Flop
Seat 7: Mr.Grigoriy folded before Flop (didn't bet)
Seat 9: 72nloses folded before Flop (didn't bet)





PokerStars Hand #154363493327:  Hold'em No Limit ($0.50/$1.00 USD) - 2016/06/06 12:59:49 CET [2016/06/06 6:59:49 ET]
Table 'Williams' 9-max Seat #8 is the button
Seat 1: matiko09 ($186.51 in chips) 
Seat 2: PacPacBum ($103.40 in chips) 
Seat 3: granbunny ($72.54 in chips) 
Seat 4: Mr.Grigoriy ($102.50 in chips) 
Seat 5: xxxibgdrgn ($104.22 in chips) 
Seat 6: xxxZeka ($134.17 in chips) 
Seat 7: kevinho109 ($29.08 in chips) 
Seat 8: oscarleon ($113.86 in chips) 
Seat 9: stds st ($39 in chips) 
stds st: posts small blind $0.50
matiko09: posts big blind $1
*** HOLE CARDS ***
Dealt to matiko09 [8c Qd]
PacPacBum: raises $1.50 to $2.50
granbunny: calls $2.50
Mr.Grigoriy: folds 
xxxibgdrgn: folds 
xxxZeka: folds 
kevinho109: folds 
oscarleon: folds 
stds st: folds 
matiko09: folds 
*** FLOP *** [Tc 5h As]
PacPacBum: bets $3.33
granbunny: folds 
Uncalled bet ($3.33) returned to PacPacBum
PacPacBum collected $6.18 from pot
PacPacBum: doesn't show hand 
*** SUMMARY ***
Total pot $6.50 | Rake $0.32 
Board [Tc 5h As]
Seat 1: matiko09 (big blind) folded before Flop
Seat 2: PacPacBum collected ($6.18)
Seat 3: granbunny folded on the Flop
Seat 4: Mr.Grigoriy folded before Flop (didn't bet)
Seat 5: xxxibgdrgn folded before Flop (didn't bet)
Seat 6: xxxZeka folded before Flop (didn't bet)
Seat 7: kevinho109 folded before Flop (didn't bet)
Seat 8: oscarleon (button) folded before Flop (didn't bet)
Seat 9: stds st (small blind) folded before Flop





PokerStars Hand #154363496402:  Hold'em No Limit ($0.50/$1.00 USD) - 2016/06/06 12:59:57 CET [2016/06/06 6:59:57 ET]
Table 'Safara' 9-max Seat #1 is the button
Seat 1: oscarleon ($258.36 in chips) 
Seat 3: Melvisfan ($55 in chips) 
Seat 4: o.miro ($100 in chips) 
Seat 6: matiko09 ($138.58 in chips) 
Seat 7: PacPacBum ($119.07 in chips) 
Seat 8: 32rrew ($100 in chips) 
Seat 9: Mr.Grigoriy ($114 in chips) 
Melvisfan: posts small blind $0.50
o.miro: posts big blind $1
Mukhin1: sits out 
*** HOLE CARDS ***
Dealt to matiko09 [Th As]
matiko09: folds 
PacPacBum: raises $1.04 to $2.04
32rrew: folds 
Mr.Grigoriy: folds 
oscarleon: folds 
Melvisfan: folds 
o.miro: folds 
Uncalled bet ($1.04) returned to PacPacBum
Melvisfan leaves the table
PacPacBum collected $2.50 from pot
PacPacBum: doesn't show hand 
*** SUMMARY ***
Total pot $2.50 | Rake $0 
Seat 1: oscarleon (button) folded before Flop (didn't bet)
Seat 3: Melvisfan (small blind) folded before Flop
Seat 4: o.miro (big blind) folded before Flop
Seat 6: matiko09 folded before Flop (didn't bet)
Seat 7: PacPacBum collected ($2.50)
Seat 8: 32rrew folded before Flop (didn't bet)
Seat 9: Mr.Grigoriy folded before Flop (didn't bet)





PokerStars Hand #154363496217:  Hold'em No Limit ($0.50/$1.00 USD) - 2016/06/06 12:59:57 CET [2016/06/06 6:59:57 ET]
Table 'Chaldaea II' 9-max Seat #2 is the button
Seat 1: Szevasztopol ($102.22 in chips) 
Seat 2: masaytoo ($94.49 in chips) 
Seat 3: ardo888 ($111.49 in chips) 
Seat 4: mooose100 ($99 in chips) 
Seat 5: stds st ($39 in chips) 
Seat 6: PacPacBum ($102 in chips) 
Seat 7: riggedsh** ($202.08 in chips) 
Seat 8: 32rrew ($100 in chips) 
Seat 9: matiko09 ($101.50 in chips) 
ardo888: posts small blind $0.50
mooose100: posts big blind $1
*** HOLE CARDS ***
Dealt to matiko09 [4h Js]
stds st: raises $1.50 to $2.50
PacPacBum: folds 
riggedsh**: folds 
32rrew: folds 
matiko09: folds 
Szevasztopol: folds 
masaytoo: folds 
ardo888: folds 
mooose100: folds 
Uncalled bet ($1.50) returned to stds st
stds st collected $2.50 from pot
stds st: doesn't show hand 
*** SUMMARY ***
Total pot $2.50 | Rake $0 
Seat 1: Szevasztopol folded before Flop (didn't bet)
Seat 2: masaytoo (button) folded before Flop (didn't bet)
Seat 3: ardo888 (small blind) folded before Flop
Seat 4: mooose100 (big blind) folded before Flop
Seat 5: stds st collected ($2.50)
Seat 6: PacPacBum folded before Flop (didn't bet)
Seat 7: riggedsh** folded before Flop (didn't bet)
Seat 8: 32rrew folded before Flop (didn't bet)
Seat 9: matiko09 folded before Flop (didn't bet)





PokerStars Hand #154363496487:  Hold'em No Limit ($0.50/$1.00 USD) - 2016/06/06 12:59:58 CET [2016/06/06 6:59:58 ET]
Table 'Gajdariya' 9-max Seat #7 is the button
Seat 1: matiko09 ($137.17 in chips) 
Seat 2: xxxZeka ($166.46 in chips) 
Seat 3: oscarleon ($112.05 in chips) 
Seat 4: Szevasztopol ($147.90 in chips) 
Seat 5: 147734319 ($39.38 in chips) 
Seat 6: mono123viva ($52.73 in chips) 
Seat 7: Wombatkilla ($65.39 in chips) 
Seat 8: ardo888 ($152.47 in chips) 
Seat 9: Mr.Grigoriy ($139.75 in chips) 
ardo888: posts small blind $0.50
Mr.Grigoriy: posts big blind $1
*** HOLE CARDS ***
Dealt to matiko09 [4h 4s]
matiko09: folds 
xxxZeka: folds 
oscarleon: folds 
Szevasztopol: folds 
147734319: folds 
mono123viva: folds 
Wombatkilla: folds 
ardo888: folds 
Uncalled bet ($0.50) returned to Mr.Grigoriy
mono123viva leaves the table
Mr.Grigoriy collected $1 from pot
Mr.Grigoriy: doesn't show hand 
*** SUMMARY ***
Total pot $1 | Rake $0 
Seat 1: matiko09 folded before Flop (didn't bet)
Seat 2: xxxZeka folded before Flop (didn't bet)
Seat 3: oscarleon folded before Flop (didn't bet)
Seat 4: Szevasztopol folded before Flop (didn't bet)
Seat 5: 147734319 folded before Flop (didn't bet)
Seat 6: mono123viva folded before Flop (didn't bet)
Seat 7: Wombatkilla (button) folded before Flop (didn't bet)
Seat 8: ardo888 (small blind) folded before Flop
Seat 9: Mr.Grigoriy (big blind) collected ($1)





PokerStars Hand #154363498253:  Hold'em No Limit ($0.50/$1.00 USD) - 2016/06/06 13:00:02 CET [2016/06/06 7:00:02 ET]
Table 'Yarilo' 9-max Seat #3 is the button
Seat 3: matiko09 ($100 in chips) 
Seat 4: stds st ($39 in chips) 
Seat 7: Dickyxxx ($100 in chips) 
Seat 9: o.miro ($105.50 in chips) 
stds st: posts small blind $0.50
ozone2003: is sitting out 
Dickyxxx: posts big blind $1
*** HOLE CARDS ***
Dealt to matiko09 [Ts Kd]
o.miro: folds 
ozone2003 leaves the table
matiko09: raises $1.27 to $2.27
stds st: raises $4.03 to $6.30
Dickyxxx: folds 
matiko09: folds 
Uncalled bet ($4.03) returned to stds st
stds st collected $5.54 from pot
stds st: doesn't show hand 
*** SUMMARY ***
Total pot $5.54 | Rake $0 
Seat 3: matiko09 (button) folded before Flop
Seat 4: stds st (small blind) collected ($5.54)
Seat 7: Dickyxxx (big blind) folded before Flop
Seat 9: o.miro folded before Flop (didn't bet)





PokerStars Hand #154363498386:  Hold'em No Limit ($0.50/$1.00 USD) - 2016/06/06 13:00:03 CET [2016/06/06 7:00:03 ET]
Table 'Smither' 9-max Seat #3 is the button
Seat 1: PacPacBum ($176.14 in chips) 
Seat 2: matiko09 ($103.84 in chips) 
Seat 3: xxxZeka ($129.07 in chips) 
Seat 5: Szevasztopol ($100.50 in chips) 
Seat 6: mooose100 ($80 in chips) 
Seat 7: vanilica ($100 in chips) 
Seat 8: 74 ROADIE ($74.04 in chips) 
Seat 9: hammerwife ($140.75 in chips) 
Szevasztopol: posts small blind $0.50
mooose100: posts big blind $1
*** HOLE CARDS ***
Dealt to matiko09 [3h 6s]
vanilica: folds 
74 ROADIE: raises $3 to $4
hammerwife: folds 
PacPacBum: folds 
matiko09: folds 
xxxZeka: folds 
Szevasztopol: folds 
mooose100: folds 
Uncalled bet ($3) returned to 74 ROADIE
74 ROADIE collected $2.50 from pot
*** SUMMARY ***
Total pot $2.50 | Rake $0 
Seat 1: PacPacBum folded before Flop (didn't bet)
Seat 2: matiko09 folded before Flop (didn't bet)
Seat 3: xxxZeka (button) folded before Flop (didn't bet)
Seat 5: Szevasztopol (small blind) folded before Flop
Seat 6: mooose100 (big blind) folded before Flop
Seat 7: vanilica folded before Flop (didn't bet)
Seat 8: 74 ROADIE collected ($2.50)
Seat 9: hammerwife folded before Flop (didn't bet)





PokerStars Hand #154363500896:  Hold'em No Limit (€0.50/€1.00 EUR) - 2016/06/06 13:00:09 CET [2016/06/06 7:00:09 ET]
Table 'Lesath' 9-max Seat #5 is the button
Seat 1: o.miro (€100 in chips) 
Seat 2: thecurv (€100 in chips) 
Seat 3: ozone2003 (€217.65 in chips) 
Seat 4: hammerwife (€134.11 in chips) 
Seat 5: matiko09 (€100 in chips) 
Seat 6: Szevasztopol (€103.50 in chips) 
Seat 7: Mr.Grigoriy (€106.82 in chips) 
Seat 9: 72nloses (€94.44 in chips) 
Szevasztopol: posts small blind €0.50
Mr.Grigoriy: posts big blind €1
*** HOLE CARDS ***
Dealt to matiko09 [2s Kc]
72nloses: raises €2 to €3
o.miro: folds 
thecurv: folds 
ozone2003: folds 
hammerwife: calls €3
matiko09: folds 
Szevasztopol: folds 
Mr.Grigoriy: folds 
*** FLOP *** [4d 6c Jc]
72nloses: bets €7.12
hammerwife: folds 
Uncalled bet (€7.12) returned to 72nloses
72nloses collected €7.12 from pot
*** SUMMARY ***
Total pot €7.50 | Rake €0.38 
Board [4d 6c Jc]
Seat 1: o.miro folded before Flop (didn't bet)
Seat 2: thecurv folded before Flop (didn't bet)
Seat 3: ozone2003 folded before Flop (didn't bet)
Seat 4: hammerwife folded on the Flop
Seat 5: matiko09 (button) folded before Flop (didn't bet)
Seat 6: Szevasztopol (small blind) folded before Flop
Seat 7: Mr.Grigoriy (big blind) folded before Flop
Seat 9: 72nloses collected (€7.12)





PokerStars Hand #154363503041:  Hold'em No Limit ($0.50/$1.00 USD) - 2016/06/06 13:00:15 CET [2016/06/06 7:00:15 ET]
Table 'Gajdariya' 9-max Seat #8 is the button
Seat 1: matiko09 ($137.17 in chips) 
Seat 2: xxxZeka ($166.46 in chips) 
Seat 3: oscarleon ($112.05 in chips) 
Seat 4: Szevasztopol ($147.90 in chips) 
Seat 5: 147734319 ($39.38 in chips) 
Seat 7: Wombatkilla ($65.39 in chips) 
Seat 8: ardo888 ($151.97 in chips) 
Seat 9: Mr.Grigoriy ($140.25 in chips) 
Mr.Grigoriy: posts small blind $0.50
matiko09: posts big blind $1
*** HOLE CARDS ***
Dealt to matiko09 [7h Kc]
o.miro joins the table at seat #6 
xxxZeka: folds 
oscarleon: folds 
Szevasztopol: folds 
147734319: raises $2 to $3
Wombatkilla: calls $3
ardo888: folds 
o.miro leaves the table
Dantist1122 joins the table at seat #6 
Mr.Grigoriy: raises $8 to $11
matiko09: folds 
147734319: raises $28.38 to $39.38 and is all-in
Wombatkilla: folds 
Mr.Grigoriy: calls $28.38
*** FLOP *** [4s 2d 8h]
*** TURN *** [4s 2d 8h] [8c]
*** RIVER *** [4s 2d 8h 8c] [Js]
*** SHOW DOWN ***
Mr.Grigoriy: shows [Qc Qs] (two pair, Queens and Eights)
147734319: mucks hand 
Mr.Grigoriy collected $80.26 from pot
*** SUMMARY ***
Total pot $82.76 | Rake $2.50 
Board [4s 2d 8h 8c Js]
Seat 1: matiko09 (big blind) folded before Flop
Seat 2: xxxZeka folded before Flop (didn't bet)
Seat 3: oscarleon folded before Flop (didn't bet)
Seat 4: Szevasztopol folded before Flop (didn't bet)
Seat 5: 147734319 mucked [Tc Ts]
Seat 7: Wombatkilla folded before Flop
Seat 8: ardo888 (button) folded before Flop (didn't bet)
Seat 9: Mr.Grigoriy (small blind) showed [Qc Qs] and won ($80.26) with two pair, Queens and Eights





PokerStars Hand #154363504408:  Hold'em No Limit ($0.50/$1.00 USD) - 2016/06/06 13:00:18 CET [2016/06/06 7:00:18 ET]
Table 'Wezen II' 9-max Seat #6 is the button
Seat 1: matiko09 ($176.60 in chips) 
Seat 2: Mr.Grigoriy ($118.62 in chips) 
Seat 3: oscarleon ($100 in chips) 
Seat 4: xxxibgdrgn ($101 in chips) 
Seat 5: stds st ($26.86 in chips) 
Seat 6: masaytoo ($99.62 in chips) 
Seat 7: KDJAll3 ($78.06 in chips) 
Seat 8: o.miro ($100 in chips) 
Seat 9: PacPacBum ($100 in chips) 
KDJAll3: posts small blind $0.50
o.miro: posts big blind $1
*** HOLE CARDS ***
Dealt to matiko09 [5h 2s]
PacPacBum: folds 
matiko09: folds 
Mr.Grigoriy: folds 
oscarleon: folds 
xxxibgdrgn: folds 
stds st: raises $1.02 to $2.02
masaytoo: folds 
KDJAll3: folds 
masaytoo leaves the table
xxxZeka joins the table at seat #6 
xxxZeka leaves the table
vanilica joins the table at seat #6 
o.miro: calls $1.02
*** FLOP *** [7h 9c 5s]
o.miro: checks 
stds st: bets $2.37
o.miro: folds 
Uncalled bet ($2.37) returned to stds st
stds st collected $4.31 from pot
stds st: doesn't show hand 
*** SUMMARY ***
Total pot $4.54 | Rake $0.23 
Board [7h 9c 5s]
Seat 1: matiko09 folded before Flop (didn't bet)
Seat 2: Mr.Grigoriy folded before Flop (didn't bet)
Seat 3: oscarleon folded before Flop (didn't bet)
Seat 4: xxxibgdrgn folded before Flop (didn't bet)
Seat 5: stds st collected ($4.31)
Seat 6: masaytoo (button) folded before Flop (didn't bet)
Seat 7: KDJAll3 (small blind) folded before Flop
Seat 8: o.miro (big blind) folded on the Flop
Seat 9: PacPacBum folded before Flop (didn't bet)





PokerStars Hand #154363509605:  Hold'em No Limit ($0.50/$1.00 USD) - 2016/06/06 13:00:32 CET [2016/06/06 7:00:32 ET]
Table 'Heze' 9-max Seat #8 is the button
Seat 1: matiko09 ($170.15 in chips) 
Seat 2: oscarleon ($195.20 in chips) 
Seat 3: ozone2003 ($123.79 in chips) 
Seat 4: ardo888 ($100 in chips) 
Seat 5: stds st ($38.50 in chips) 
Seat 6: yfcq36 ($141 in chips) 
Seat 7: 32rrew ($158.35 in chips) 
Seat 8: PacPacBum ($120.20 in chips) 
Seat 9: Mr.Grigoriy ($127.66 in chips) 
Mr.Grigoriy: posts small blind $0.50
matiko09: posts big blind $1
*** HOLE CARDS ***
Dealt to matiko09 [8s As]
oscarleon: folds 
ozone2003: folds 
ardo888: folds 
stds st: folds 
yfcq36: folds 
32rrew: folds 
PacPacBum: folds 
Mr.Grigoriy: raises $1.50 to $2.50
matiko09: calls $1.50
*** FLOP *** [Kd Qh Qs]
Mr.Grigoriy: bets $2.56
matiko09: calls $2.56
*** TURN *** [Kd Qh Qs] [3h]
Mr.Grigoriy: bets $6.43
matiko09: folds 
Uncalled bet ($6.43) returned to Mr.Grigoriy
Mr.Grigoriy collected $9.61 from pot
Mr.Grigoriy: doesn't show hand 
*** SUMMARY ***
Total pot $10.12 | Rake $0.51 
Board [Kd Qh Qs 3h]
Seat 1: matiko09 (big blind) folded on the Turn
Seat 2: oscarleon folded before Flop (didn't bet)
Seat 3: ozone2003 folded before Flop (didn't bet)
Seat 4: ardo888 folded before Flop (didn't bet)
Seat 5: stds st folded before Flop (didn't bet)
Seat 6: yfcq36 folded before Flop (didn't bet)
Seat 7: 32rrew folded before Flop (didn't bet)
Seat 8: PacPacBum (button) folded before Flop (didn't bet)
Seat 9: Mr.Grigoriy (small blind) collected ($9.61)





PokerStars Hand #154363509495:  Hold'em No Limit ($0.50/$1.00 USD) - 2016/06/06 13:00:32 CET [2016/06/06 7:00:32 ET]
Table 'Chaldaea II' 9-max Seat #3 is the button
Seat 1: Szevasztopol ($102.22 in chips) 
Seat 2: masaytoo ($94.49 in chips) 
Seat 3: ardo888 ($110.99 in chips) 
Seat 4: mooose100 ($98 in chips) 
Seat 5: stds st ($40.50 in chips) 
Seat 6: PacPacBum ($102 in chips) 
Seat 7: riggedsh** ($202.08 in chips) 
Seat 8: 32rrew ($100 in chips) 
Seat 9: matiko09 ($101.50 in chips) 
mooose100: posts small blind $0.50
stds st: posts big blind $1
*** HOLE CARDS ***
Dealt to matiko09 [Kc Jc]
PacPacBum: folds 
riggedsh**: raises $2 to $3
32rrew: folds 
matiko09: calls $3
Szevasztopol: folds 
masaytoo: calls $3
ardo888: folds 
mooose100: calls $2.50
stds st: calls $2
*** FLOP *** [3s 2d 5h]
mooose100: checks 
stds st: checks 
riggedsh**: checks 
matiko09: checks 
masaytoo: checks 
*** TURN *** [3s 2d 5h] [6d]
mooose100: bets $7.12
stds st: calls $7.12
riggedsh**: calls $7.12
matiko09: folds 
masaytoo: folds 
*** RIVER *** [3s 2d 5h 6d] [Ts]
masaytoo leaves the table
hurtNCYDE joins the table at seat #2 
hurtNCYDE leaves the table
Mr.Grigoriy joins the table at seat #2 
mooose100: bets $34.54
stds st: folds 
riggedsh**: folds 
Uncalled bet ($34.54) returned to mooose100
mooose100 collected $34.54 from pot
mooose100: doesn't show hand 
*** SUMMARY ***
Total pot $36.36 | Rake $1.82 
Board [3s 2d 5h 6d Ts]
Seat 1: Szevasztopol folded before Flop (didn't bet)
Seat 2: masaytoo folded on the Turn
Seat 3: ardo888 (button) folded before Flop (didn't bet)
Seat 4: mooose100 (small blind) collected ($34.54)
Seat 5: stds st (big blind) folded on the River
Seat 6: PacPacBum folded before Flop (didn't bet)
Seat 7: riggedsh** folded on the River
Seat 8: 32rrew folded before Flop (didn't bet)
Seat 9: matiko09 folded on the Turn





PokerStars Hand #154363511823:  Hold'em No Limit (€0.50/€1.00 EUR) - 2016/06/06 13:00:38 CET [2016/06/06 7:00:38 ET]
Table 'Kythera' 9-max Seat #5 is the button
Seat 1: aquarua7 (€119.45 in chips) 
Seat 2: vanilica (€100 in chips) 
Seat 3: matiko09 (€120.74 in chips) 
Seat 4: PacPacBum (€100 in chips) 
Seat 5: Dickyxxx (€100 in chips) 
Seat 6: ozone2003 (€100.50 in chips) 
ozone2003: posts small blind €0.50
aquarua7: posts big blind €1
*** HOLE CARDS ***
Dealt to matiko09 [4d 8c]
vanilica: folds 
matiko09: folds 
PacPacBum: raises €2 to €3
Dickyxxx: folds 
ozone2003: folds 
aquarua7: folds 
Uncalled bet (€2) returned to PacPacBum
PacPacBum collected €2.50 from pot
PacPacBum: doesn't show hand 
*** SUMMARY ***
Total pot €2.50 | Rake €0 
Seat 1: aquarua7 (big blind) folded before Flop
Seat 2: vanilica folded before Flop (didn't bet)
Seat 3: matiko09 folded before Flop (didn't bet)
Seat 4: PacPacBum collected (€2.50)
Seat 5: Dickyxxx (button) folded before Flop (didn't bet)
Seat 6: ozone2003 (small blind) folded before Flop





PokerStars Hand #154363512055:  Hold'em No Limit ($0.50/$1.00 USD) - 2016/06/06 13:00:39 CET [2016/06/06 7:00:39 ET]
Table 'Williams' 9-max Seat #9 is the button
Seat 1: matiko09 ($185.51 in chips) 
Seat 2: PacPacBum ($107.08 in chips) 
Seat 3: granbunny ($70.04 in chips) 
Seat 4: Mr.Grigoriy ($102.50 in chips) 
Seat 5: xxxibgdrgn ($104.22 in chips) 
Seat 6: xxxZeka ($134.17 in chips) 
Seat 7: kevinho109 ($29.08 in chips) 
Seat 8: oscarleon ($113.86 in chips) 
Seat 9: stds st ($38.50 in chips) 
matiko09: posts small blind $0.50
PacPacBum: posts big blind $1
*** HOLE CARDS ***
Dealt to matiko09 [Qs Kh]
granbunny: folds 
Mr.Grigoriy: folds 
xxxibgdrgn: folds 
xxxZeka: folds 
kevinho109: folds 
oscarleon: folds 
stds st: folds 
matiko09: raises $2 to $3
PacPacBum: raises $5 to $8
matiko09: calls $5
*** FLOP *** [Ts 4c 6c]
matiko09: checks 
PacPacBum: checks 
*** TURN *** [Ts 4c 6c] [Ah]
matiko09: checks 
PacPacBum: bets $8.20
matiko09: folds 
Uncalled bet ($8.20) returned to PacPacBum
PacPacBum collected $15.20 from pot
PacPacBum: doesn't show hand 
*** SUMMARY ***
Total pot $16 | Rake $0.80 
Board [Ts 4c 6c Ah]
Seat 1: matiko09 (small blind) folded on the Turn
Seat 2: PacPacBum (big blind) collected ($15.20)
Seat 3: granbunny folded before Flop (didn't bet)
Seat 4: Mr.Grigoriy folded before Flop (didn't bet)
Seat 5: xxxibgdrgn folded before Flop (didn't bet)
Seat 6: xxxZeka folded before Flop (didn't bet)
Seat 7: kevinho109 folded before Flop (didn't bet)
Seat 8: oscarleon folded before Flop (didn't bet)
Seat 9: stds st (button) folded before Flop (didn't bet)





PokerStars Hand #154363512630:  Hold'em No Limit ($0.50/$1.00 USD) - 2016/06/06 13:00:40 CET [2016/06/06 7:00:40 ET]
Table 'Sheliak' 9-max Seat #6 is the button
Seat 1: 32rrew ($100 in chips) 
Seat 2: masaytoo ($102.14 in chips) 
Seat 3: oscarleon ($118 in chips) 
Seat 4: iRLM ($68.31 in chips) 
Seat 5: hammerwife ($100 in chips) 
Seat 6: matiko09 ($100 in chips) 
Seat 7: stds st ($27.13 in chips) 
Seat 8: ozone2003 ($100 in chips) 
Seat 9: Szevasztopol ($101.50 in chips) 
stds st: posts small blind $0.50
ozone2003: posts big blind $1
*** HOLE CARDS ***
Dealt to matiko09 [Td 9s]
Szevasztopol: folds 
32rrew: folds 
masaytoo: raises $2 to $3
oscarleon: folds 
iRLM: calls $3
hammerwife: folds 
matiko09: folds 
stds st: folds 
ozone2003: calls $2
*** FLOP *** [8h Kd Qs]
ozone2003: checks 
masaytoo: checks 
iRLM: bets $1
ozone2003: calls $1
masaytoo: calls $1
*** TURN *** [8h Kd Qs] [9d]
ozone2003: checks 
masaytoo: checks 
iRLM: bets $1
ozone2003: calls $1
masaytoo: calls $1
*** RIVER *** [8h Kd Qs 9d] [Kc]
ozone2003: checks 
masaytoo: checks 
iRLM: bets $3
ozone2003: folds 
masaytoo: folds 
Uncalled bet ($3) returned to iRLM
iRLM collected $14.72 from pot
iRLM: doesn't show hand 
*** SUMMARY ***
Total pot $15.50 | Rake $0.78 
Board [8h Kd Qs 9d Kc]
Seat 1: 32rrew folded before Flop (didn't bet)
Seat 2: masaytoo folded on the River
Seat 3: oscarleon folded before Flop (didn't bet)
Seat 4: iRLM collected ($14.72)
Seat 5: hammerwife folded before Flop (didn't bet)
Seat 6: matiko09 (button) folded before Flop (didn't bet)
Seat 7: stds st (small blind) folded before Flop
Seat 8: ozone2003 (big blind) folded on the River
Seat 9: Szevasztopol folded before Flop (didn't bet)





PokerStars Hand #154363513188:  Hold'em No Limit ($0.50/$1.00 USD) - 2016/06/06 13:00:41 CET [2016/06/06 7:00:41 ET]
Table 'Smither' 9-max Seat #5 is the button
Seat 1: PacPacBum ($176.14 in chips) 
Seat 2: matiko09 ($103.84 in chips) 
Seat 3: xxxZeka ($129.07 in chips) 
Seat 5: Szevasztopol ($100 in chips) 
Seat 6: mooose100 ($79 in chips) 
Seat 7: vanilica ($100 in chips) 
Seat 8: 74 ROADIE ($75.54 in chips) 
Seat 9: hammerwife ($140.75 in chips) 
mooose100: posts small blind $0.50
vanilica: posts big blind $1
*** HOLE CARDS ***
Dealt to matiko09 [5s Qh]
74 ROADIE: calls $1
hammerwife: raises $3.50 to $4.50
PacPacBum: folds 
matiko09: folds 
xxxZeka: folds 
Szevasztopol: calls $4.50
mooose100: folds 
vanilica: folds 
74 ROADIE: calls $3.50
*** FLOP *** [Js 9c 6s]
74 ROADIE: checks 
hammerwife: bets $7.50
Szevasztopol: calls $7.50
74 ROADIE: calls $7.50
*** TURN *** [Js 9c 6s] [4h]
74 ROADIE: checks 
hammerwife: checks 
Szevasztopol: bets $23.51
74 ROADIE: folds 
hammerwife: folds 
Uncalled bet ($23.51) returned to Szevasztopol
Szevasztopol collected $35.62 from pot
Szevasztopol: doesn't show hand 
*** SUMMARY ***
Total pot $37.50 | Rake $1.88 
Board [Js 9c 6s 4h]
Seat 1: PacPacBum folded before Flop (didn't bet)
Seat 2: matiko09 folded before Flop (didn't bet)
Seat 3: xxxZeka folded before Flop (didn't bet)
Seat 5: Szevasztopol (button) collected ($35.62)
Seat 6: mooose100 (small blind) folded before Flop
Seat 7: vanilica (big blind) folded before Flop
Seat 8: 74 ROADIE folded on the Turn
Seat 9: hammerwife folded on the Turn





PokerStars Hand #154363519481:  Hold'em No Limit (€0.50/€1.00 EUR) - 2016/06/06 13:00:57 CET [2016/06/06 7:00:57 ET]
Table 'Lesath' 9-max Seat #6 is the button
Seat 1: o.miro (€100 in chips) 
Seat 2: thecurv (€100 in chips) 
Seat 3: ozone2003 (€217.65 in chips) 
Seat 4: hammerwife (€131.11 in chips) 
Seat 5: matiko09 (€100 in chips) 
Seat 6: Szevasztopol (€103 in chips) 
Seat 7: Mr.Grigoriy (€105.82 in chips) 
Seat 9: 72nloses (€98.56 in chips) 
Mr.Grigoriy: posts small blind €0.50
72nloses: posts big blind €1
*** HOLE CARDS ***
Dealt to matiko09 [5d 2h]
o.miro: folds 
thecurv: folds 
ozone2003: folds 
hammerwife: folds 
matiko09: folds 
Szevasztopol: raises €1 to €2
Mr.Grigoriy: folds 
72nloses: calls €1
*** FLOP *** [6h Kc Kh]
72nloses: checks 
Szevasztopol: bets €2.82
72nloses: folds 
Uncalled bet (€2.82) returned to Szevasztopol
Szevasztopol collected €4.28 from pot
Szevasztopol: doesn't show hand 
*** SUMMARY ***
Total pot €4.50 | Rake €0.22 
Board [6h Kc Kh]
Seat 1: o.miro folded before Flop (didn't bet)
Seat 2: thecurv folded before Flop (didn't bet)
Seat 3: ozone2003 folded before Flop (didn't bet)
Seat 4: hammerwife folded before Flop (didn't bet)
Seat 5: matiko09 folded before Flop (didn't bet)
Seat 6: Szevasztopol (button) collected (€4.28)
Seat 7: Mr.Grigoriy (small blind) folded before Flop
Seat 9: 72nloses (big blind) folded on the Flop





PokerStars Hand #154363522507:  Hold'em No Limit (€0.50/€1.00 EUR) - 2016/06/06 13:01:05 CET [2016/06/06 7:01:05 ET]
Table 'Kythera' 9-max Seat #6 is the button
Seat 1: aquarua7 (€118.45 in chips) 
Seat 2: vanilica (€100 in chips) 
Seat 3: matiko09 (€120.74 in chips) 
Seat 4: PacPacBum (€101.50 in chips) 
Seat 5: Dickyxxx (€100 in chips) 
Seat 6: ozone2003 (€100 in chips) 
aquarua7: posts small blind €0.50
vanilica: posts big blind €1
*** HOLE CARDS ***
Dealt to matiko09 [6c 9s]
matiko09: folds 
PacPacBum: folds 
Dickyxxx: raises €2 to €3
ozone2003: folds 
aquarua7: calls €2.50
vanilica: folds 
*** FLOP *** [Ad 5s Jc]
aquarua7: checks 
Dickyxxx: bets €4.25
aquarua7: calls €4.25
*** TURN *** [Ad 5s Jc] [4s]
aquarua7: checks 
Dickyxxx: checks 
*** RIVER *** [Ad 5s Jc 4s] [Kh]
aquarua7: checks 
Dickyxxx: checks 
*** SHOW DOWN ***
aquarua7: shows [Th Ah] (a pair of Aces)
Dickyxxx: mucks hand 
aquarua7 collected €14.72 from pot
*** SUMMARY ***
Total pot €15.50 | Rake €0.78 
Board [Ad 5s Jc 4s Kh]
Seat 1: aquarua7 (small blind) showed [Th Ah] and won (€14.72) with a pair of Aces
Seat 2: vanilica (big blind) folded before Flop
Seat 3: matiko09 folded before Flop (didn't bet)
Seat 4: PacPacBum folded before Flop (didn't bet)
Seat 5: Dickyxxx mucked [5h 6h]
Seat 6: ozone2003 (button) folded before Flop (didn't bet)





PokerStars Hand #154363522892:  Hold'em No Limit ($0.50/$1.00 USD) - 2016/06/06 13:01:06 CET [2016/06/06 7:01:06 ET]
Table 'Safara' 9-max Seat #4 is the button
Seat 1: oscarleon ($258.36 in chips) 
Seat 4: o.miro ($100 in chips) 
Seat 6: matiko09 ($138.58 in chips) 
Seat 7: PacPacBum ($120.57 in chips) 
Seat 8: 32rrew ($100 in chips) 
Seat 9: Mr.Grigoriy ($114 in chips) 
Mukhin1 will be allowed to play after the button
matiko09: posts small blind $0.50
PacPacBum: posts big blind $1
*** HOLE CARDS ***
Dealt to matiko09 [Kc Ad]
ozone2003 joins the table at seat #3 
ozone2003 leaves the table
Dantist1122 joins the table at seat #3 
32rrew: folds 
Mr.Grigoriy: folds 
oscarleon: folds 
o.miro: raises $1.50 to $2.50
matiko09: calls $2
PacPacBum: folds 
*** FLOP *** [5s 5h Th]
matiko09: checks 
o.miro: checks 
*** TURN *** [5s 5h Th] [Kh]
matiko09: bets $4
o.miro: folds 
Uncalled bet ($4) returned to matiko09
matiko09 collected $5.70 from pot
matiko09: doesn't show hand 
*** SUMMARY ***
Total pot $6 | Rake $0.30 
Board [5s 5h Th Kh]
Seat 1: oscarleon folded before Flop (didn't bet)
Seat 4: o.miro (button) folded on the Turn
Seat 6: matiko09 (small blind) collected ($5.70)
Seat 7: PacPacBum (big blind) folded before Flop
Seat 8: 32rrew folded before Flop (didn't bet)
Seat 9: Mr.Grigoriy folded before Flop (didn't bet)





PokerStars Hand #154363534918:  Hold'em No Limit ($0.50/$1.00 USD) - 2016/06/06 13:01:35 CET [2016/06/06 7:01:35 ET]
Table 'Gajdariya' 9-max Seat #9 is the button
Seat 1: matiko09 ($136.17 in chips) 
Seat 2: xxxZeka ($166.46 in chips) 
Seat 3: oscarleon ($112.05 in chips) 
Seat 4: Szevasztopol ($147.90 in chips) 
Seat 7: Wombatkilla ($62.39 in chips) 
Seat 8: ardo888 ($151.97 in chips) 
Seat 9: Mr.Grigoriy ($181.13 in chips) 
matiko09: posts small blind $0.50
xxxZeka: posts big blind $1
*** HOLE CARDS ***
Dealt to matiko09 [Ks 8c]
oscarleon: folds 
Szevasztopol: raises $1.14 to $2.14
Wombatkilla: folds 
ardo888: folds 
147734319 leaves the table
Mr.Grigoriy: folds 
stds st joins the table at seat #5 
matiko09: folds 
xxxZeka: folds 
Uncalled bet ($1.14) returned to Szevasztopol
Szevasztopol collected $2.50 from pot
Szevasztopol: doesn't show hand 
*** SUMMARY ***
Total pot $2.50 | Rake $0 
Seat 1: matiko09 (small blind) folded before Flop
Seat 2: xxxZeka (big blind) folded before Flop
Seat 3: oscarleon folded before Flop (didn't bet)
Seat 4: Szevasztopol collected ($2.50)
Seat 7: Wombatkilla folded before Flop (didn't bet)
Seat 8: ardo888 folded before Flop (didn't bet)
Seat 9: Mr.Grigoriy (button) folded before Flop (didn't bet)





PokerStars Hand #154363535957:  Hold'em No Limit ($0.50/$1.00 USD) - 2016/06/06 13:01:38 CET [2016/06/06 7:01:38 ET]
Table 'Wezen II' 9-max Seat #7 is the button
Seat 1: matiko09 ($176.60 in chips) 
Seat 2: Mr.Grigoriy ($118.62 in chips) 
Seat 3: oscarleon ($100 in chips) 
Seat 4: xxxibgdrgn ($101 in chips) 
Seat 5: stds st ($29.15 in chips) 
Seat 7: KDJAll3 ($77.56 in chips) 
Seat 8: o.miro ($100 in chips) 
Seat 9: PacPacBum ($100 in chips) 
o.miro: posts small blind $0.50
PacPacBum: posts big blind $1
vanilica: sits out 
*** HOLE CARDS ***
Dealt to matiko09 [7d 8s]
matiko09: folds 
Mr.Grigoriy: folds 
oscarleon: folds 
xxxibgdrgn: folds 
stds st: folds 
KDJAll3: folds 
o.miro: raises $2 to $3
PacPacBum: folds 
Uncalled bet ($2) returned to o.miro
o.miro collected $2 from pot
o.miro: doesn't show hand 
*** SUMMARY ***
Total pot $2 | Rake $0 
Seat 1: matiko09 folded before Flop (didn't bet)
Seat 2: Mr.Grigoriy folded before Flop (didn't bet)
Seat 3: oscarleon folded before Flop (didn't bet)
Seat 4: xxxibgdrgn folded before Flop (didn't bet)
Seat 5: stds st folded before Flop (didn't bet)
Seat 7: KDJAll3 (button) folded before Flop (didn't bet)
Seat 8: o.miro (small blind) collected ($2)
Seat 9: PacPacBum (big blind) folded before Flop





PokerStars Hand #154363538214:  Hold'em No Limit (€0.50/€1.00 EUR) - 2016/06/06 13:01:44 CET [2016/06/06 7:01:44 ET]
Table 'Kythera' 9-max Seat #1 is the button
Seat 1: aquarua7 (€125.92 in chips) 
Seat 2: vanilica (€100 in chips) 
Seat 3: matiko09 (€120.74 in chips) 
Seat 4: PacPacBum (€101.50 in chips) 
Seat 5: Dickyxxx (€100 in chips) 
Seat 6: ozone2003 (€100 in chips) 
vanilica: posts small blind €0.50
matiko09: posts big blind €1
*** HOLE CARDS ***
Dealt to matiko09 [Td 6h]
PacPacBum: folds 
Dickyxxx: folds 
ozone2003: folds 
aquarua7: folds 
vanilica: folds 
Uncalled bet (€0.50) returned to matiko09
matiko09 collected €1 from pot
matiko09: doesn't show hand 
*** SUMMARY ***
Total pot €1 | Rake €0 
Seat 1: aquarua7 (button) folded before Flop (didn't bet)
Seat 2: vanilica (small blind) folded before Flop
Seat 3: matiko09 (big blind) collected (€1)
Seat 4: PacPacBum folded before Flop (didn't bet)
Seat 5: Dickyxxx folded before Flop (didn't bet)
Seat 6: ozone2003 folded before Flop (didn't bet)





PokerStars Hand #154363539004:  Hold'em No Limit ($0.50/$1.00 USD) - 2016/06/06 13:01:46 CET [2016/06/06 7:01:46 ET]
Table 'Williams' 9-max Seat #1 is the button
Seat 1: matiko09 ($177.51 in chips) 
Seat 2: PacPacBum ($114.28 in chips) 
Seat 3: granbunny ($70.04 in chips) 
Seat 4: Mr.Grigoriy ($102.50 in chips) 
Seat 5: xxxibgdrgn ($104.22 in chips) 
Seat 6: xxxZeka ($134.17 in chips) 
Seat 7: kevinho109 ($29.08 in chips) 
Seat 8: oscarleon ($113.86 in chips) 
Seat 9: stds st ($38.50 in chips) 
PacPacBum: posts small blind $0.50
granbunny: posts big blind $1
*** HOLE CARDS ***
Dealt to matiko09 [Th 4s]
Mr.Grigoriy: folds 
xxxibgdrgn: raises $2 to $3
xxxZeka: folds 
kevinho109: folds 
oscarleon: folds 
stds st: folds 
matiko09: folds 
PacPacBum: folds 
granbunny: folds 
Uncalled bet ($2) returned to xxxibgdrgn
xxxibgdrgn collected $2.50 from pot
xxxibgdrgn: doesn't show hand 
*** SUMMARY ***
Total pot $2.50 | Rake $0 
Seat 1: matiko09 (button) folded before Flop (didn't bet)
Seat 2: PacPacBum (small blind) folded before Flop
Seat 3: granbunny (big blind) folded before Flop
Seat 4: Mr.Grigoriy folded before Flop (didn't bet)
Seat 5: xxxibgdrgn collected ($2.50)
Seat 6: xxxZeka folded before Flop (didn't bet)
Seat 7: kevinho109 folded before Flop (didn't bet)
Seat 8: oscarleon folded before Flop (didn't bet)
Seat 9: stds st folded before Flop (didn't bet)





PokerStars Hand #154363541989:  Hold'em No Limit ($0.50/$1.00 USD) - 2016/06/06 13:01:53 CET [2016/06/06 7:01:53 ET]
Table 'Heze' 9-max Seat #9 is the button
Seat 1: matiko09 ($165.09 in chips) 
Seat 2: oscarleon ($195.20 in chips) 
Seat 3: ozone2003 ($123.79 in chips) 
Seat 4: ardo888 ($100 in chips) 
Seat 5: stds st ($38.50 in chips) 
Seat 6: yfcq36 ($141 in chips) 
Seat 7: 32rrew ($158.35 in chips) 
Seat 8: PacPacBum ($120.20 in chips) 
Seat 9: Mr.Grigoriy ($132.21 in chips) 
matiko09: posts small blind $0.50
oscarleon: posts big blind $1
*** HOLE CARDS ***
Dealt to matiko09 [Td 7h]
ozone2003: folds 
ardo888: folds 
stds st: raises $1.50 to $2.50
yfcq36: folds 
32rrew: raises $5.50 to $8
PacPacBum: folds 
Mr.Grigoriy: folds 
matiko09: folds 
oscarleon: folds 
stds st: folds 
Uncalled bet ($5.50) returned to 32rrew
32rrew collected $6.50 from pot
32rrew: doesn't show hand 
*** SUMMARY ***
Total pot $6.50 | Rake $0 
Seat 1: matiko09 (small blind) folded before Flop
Seat 2: oscarleon (big blind) folded before Flop
Seat 3: ozone2003 folded before Flop (didn't bet)
Seat 4: ardo888 folded before Flop (didn't bet)
Seat 5: stds st folded before Flop
Seat 6: yfcq36 folded before Flop (didn't bet)
Seat 7: 32rrew collected ($6.50)
Seat 8: PacPacBum folded before Flop (didn't bet)
Seat 9: Mr.Grigoriy (button) folded before Flop (didn't bet)





PokerStars Hand #154363543478:  Hold'em No Limit (€0.50/€1.00 EUR) - 2016/06/06 13:01:57 CET [2016/06/06 7:01:57 ET]
Table 'Kythera' 9-max Seat #2 is the button
Seat 2: vanilica (€100 in chips) 
Seat 3: matiko09 (€121.24 in chips) 
Seat 4: PacPacBum (€101.50 in chips) 
Seat 5: Dickyxxx (€100 in chips) 
Seat 6: ozone2003 (€100 in chips) 
matiko09: posts small blind €0.50
PacPacBum: posts big blind €1
*** HOLE CARDS ***
Dealt to matiko09 [2h 3h]
Dickyxxx: folds 
aquarua7 leaves the table
ozone2003: folds 
vanilica: raises €1.50 to €2.50
matiko09: folds 
PacPacBum: folds 
Uncalled bet (€1.50) returned to vanilica
vanilica collected €2.50 from pot
vanilica: doesn't show hand 
*** SUMMARY ***
Total pot €2.50 | Rake €0 
Seat 2: vanilica (button) collected (€2.50)
Seat 3: matiko09 (small blind) folded before Flop
Seat 4: PacPacBum (big blind) folded before Flop
Seat 5: Dickyxxx folded before Flop (didn't bet)
Seat 6: ozone2003 folded before Flop (didn't bet)





PokerStars Hand #154363543860:  Hold'em No Limit (€0.50/€1.00 EUR) - 2016/06/06 13:01:58 CET [2016/06/06 7:01:58 ET]
Table 'Lesath' 9-max Seat #7 is the button
Seat 1: o.miro (€100 in chips) 
Seat 2: thecurv (€100 in chips) 
Seat 3: ozone2003 (€217.65 in chips) 
Seat 4: hammerwife (€131.11 in chips) 
Seat 5: matiko09 (€100 in chips) 
Seat 6: Szevasztopol (€105.28 in chips) 
Seat 7: Mr.Grigoriy (€105.32 in chips) 
Seat 9: 72nloses (€96.56 in chips) 
72nloses: posts small blind €0.50
o.miro: posts big blind €1
*** HOLE CARDS ***
Dealt to matiko09 [2d Ah]
thecurv: folds 
ozone2003: folds 
hammerwife: folds 
matiko09: folds 
Szevasztopol: folds 
Mr.Grigoriy: raises €2 to €3
72nloses: folds 
o.miro: folds 
Uncalled bet (€2) returned to Mr.Grigoriy
Mr.Grigoriy collected €2.50 from pot
Mr.Grigoriy: doesn't show hand 
*** SUMMARY ***
Total pot €2.50 | Rake €0 
Seat 1: o.miro (big blind) folded before Flop
Seat 2: thecurv folded before Flop (didn't bet)
Seat 3: ozone2003 folded before Flop (didn't bet)
Seat 4: hammerwife folded before Flop (didn't bet)
Seat 5: matiko09 folded before Flop (didn't bet)
Seat 6: Szevasztopol folded before Flop (didn't bet)
Seat 7: Mr.Grigoriy (button) collected (€2.50)
Seat 9: 72nloses (small blind) folded before Flop





PokerStars Hand #154363544591:  Hold'em No Limit ($0.50/$1.00 USD) - 2016/06/06 13:02:00 CET [2016/06/06 7:02:00 ET]
Table 'Safara' 9-max Seat #6 is the button
Seat 1: oscarleon ($258.36 in chips) 
Seat 4: o.miro ($100 in chips) 
Seat 6: matiko09 ($141.78 in chips) 
Seat 7: PacPacBum ($119.57 in chips) 
Seat 8: 32rrew ($100 in chips) 
Seat 9: Mr.Grigoriy ($114 in chips) 
PacPacBum: posts small blind $0.50
32rrew: posts big blind $1
Mukhin1: sits out 
*** HOLE CARDS ***
Dealt to matiko09 [As 8c]
Mr.Grigoriy: folds 
oscarleon: folds 
o.miro: folds 
matiko09: raises $1.27 to $2.27
PacPacBum: folds 
32rrew: folds 
Uncalled bet ($1.27) returned to matiko09
matiko09 collected $2.50 from pot
matiko09: doesn't show hand 
*** SUMMARY ***
Total pot $2.50 | Rake $0 
Seat 1: oscarleon folded before Flop (didn't bet)
Seat 4: o.miro folded before Flop (didn't bet)
Seat 6: matiko09 (button) collected ($2.50)
Seat 7: PacPacBum (small blind) folded before Flop
Seat 8: 32rrew (big blind) folded before Flop
Seat 9: Mr.Grigoriy folded before Flop (didn't bet)





PokerStars Hand #154363549555:  Hold'em No Limit ($0.50/$1.00 USD) - 2016/06/06 13:02:11 CET [2016/06/06 7:02:11 ET]
Table 'Gajdariya' 9-max Seat #1 is the button
Seat 1: matiko09 ($135.67 in chips) 
Seat 2: xxxZeka ($165.46 in chips) 
Seat 3: oscarleon ($112.05 in chips) 
Seat 4: Szevasztopol ($149.40 in chips) 
Seat 7: Wombatkilla ($62.39 in chips) 
Seat 8: ardo888 ($151.97 in chips) 
Seat 9: Mr.Grigoriy ($181.13 in chips) 
xxxZeka: posts small blind $0.50
oscarleon: posts big blind $1
stds st: sits out 
*** HOLE CARDS ***
Dealt to matiko09 [4c 8d]
Szevasztopol: folds 
Wombatkilla: folds 
ardo888: folds 
Mr.Grigoriy: folds 
matiko09: folds 
xxxZeka: raises $1.50 to $2.50
oscarleon: calls $1.50
*** FLOP *** [Kc 9h Ac]
xxxZeka: checks 
oscarleon: checks 
*** TURN *** [Kc 9h Ac] [Qh]
xxxZeka: checks 
oscarleon: bets $3
xxxZeka: calls $3
*** RIVER *** [Kc 9h Ac Qh] [2h]
xxxZeka: checks 
oscarleon: checks 
*** SHOW DOWN ***
xxxZeka: shows [4d Ah] (a pair of Aces)
oscarleon: mucks hand 
xxxZeka collected $10.45 from pot
*** SUMMARY ***
Total pot $11 | Rake $0.55 
Board [Kc 9h Ac Qh 2h]
Seat 1: matiko09 (button) folded before Flop (didn't bet)
Seat 2: xxxZeka (small blind) showed [4d Ah] and won ($10.45) with a pair of Aces
Seat 3: oscarleon (big blind) mucked [Kd Js]
Seat 4: Szevasztopol folded before Flop (didn't bet)
Seat 7: Wombatkilla folded before Flop (didn't bet)
Seat 8: ardo888 folded before Flop (didn't bet)
Seat 9: Mr.Grigoriy folded before Flop (didn't bet)





PokerStars Hand #154363549485:  Hold'em No Limit ($0.50/$1.00 USD) - 2016/06/06 13:02:11 CET [2016/06/06 7:02:11 ET]
Table 'Williams' 9-max Seat #2 is the button
Seat 1: matiko09 ($177.51 in chips) 
Seat 2: PacPacBum ($113.78 in chips) 
Seat 3: granbunny ($69.04 in chips) 
Seat 4: Mr.Grigoriy ($102.50 in chips) 
Seat 5: xxxibgdrgn ($105.72 in chips) 
Seat 6: xxxZeka ($134.17 in chips) 
Seat 7: kevinho109 ($29.08 in chips) 
Seat 8: oscarleon ($113.86 in chips) 
Seat 9: stds st ($38.50 in chips) 
granbunny: posts small blind $0.50
Mr.Grigoriy: posts big blind $1
*** HOLE CARDS ***
Dealt to matiko09 [5d Kc]
xxxibgdrgn: folds 
xxxZeka: raises $2 to $3
kevinho109: folds 
oscarleon: raises $7 to $10
stds st: folds 
matiko09: folds 
PacPacBum: folds 
granbunny: folds 
Mr.Grigoriy: folds 
xxxZeka: folds 
Uncalled bet ($7) returned to oscarleon
oscarleon collected $7.50 from pot
oscarleon: doesn't show hand 
*** SUMMARY ***
Total pot $7.50 | Rake $0 
Seat 1: matiko09 folded before Flop (didn't bet)
Seat 2: PacPacBum (button) folded before Flop (didn't bet)
Seat 3: granbunny (small blind) folded before Flop
Seat 4: Mr.Grigoriy (big blind) folded before Flop
Seat 5: xxxibgdrgn folded before Flop (didn't bet)
Seat 6: xxxZeka folded before Flop
Seat 7: kevinho109 folded before Flop (didn't bet)
Seat 8: oscarleon collected ($7.50)
Seat 9: stds st folded before Flop (didn't bet)





PokerStars Hand #154363550577:  Hold'em No Limit ($0.50/$1.00 USD) - 2016/06/06 13:02:14 CET [2016/06/06 7:02:14 ET]
Table 'Wezen II' 9-max Seat #8 is the button
Seat 1: matiko09 ($176.60 in chips) 
Seat 2: Mr.Grigoriy ($118.62 in chips) 
Seat 3: oscarleon ($100 in chips) 
Seat 4: xxxibgdrgn ($101 in chips) 
Seat 5: stds st ($29.15 in chips) 
Seat 7: KDJAll3 ($77.56 in chips) 
Seat 8: o.miro ($101 in chips) 
Seat 9: PacPacBum ($100 in chips) 
PacPacBum: posts small blind $0.50
matiko09: posts big blind $1
vanilica: sits out 
*** HOLE CARDS ***
Dealt to matiko09 [7c 6c]
Mr.Grigoriy: folds 
oscarleon: folds 
xxxibgdrgn: folds 
stds st: folds 
KDJAll3 has timed out
KDJAll3: folds 
o.miro: raises $1.50 to $2.50
PacPacBum: folds 
matiko09: calls $1.50
*** FLOP *** [Jc 8s 8h]
matiko09: checks 
o.miro: checks 
*** TURN *** [Jc 8s 8h] [Ts]
matiko09: bets $3.39
o.miro: folds 
Uncalled bet ($3.39) returned to matiko09
matiko09 collected $5.22 from pot
matiko09: doesn't show hand 
*** SUMMARY ***
Total pot $5.50 | Rake $0.28 
Board [Jc 8s 8h Ts]
Seat 1: matiko09 (big blind) collected ($5.22)
Seat 2: Mr.Grigoriy folded before Flop (didn't bet)
Seat 3: oscarleon folded before Flop (didn't bet)
Seat 4: xxxibgdrgn folded before Flop (didn't bet)
Seat 5: stds st folded before Flop (didn't bet)
Seat 7: KDJAll3 folded before Flop (didn't bet)
Seat 8: o.miro (button) folded on the Turn
Seat 9: PacPacBum (small blind) folded before Flop





PokerStars Hand #154363554379:  Hold'em No Limit ($0.50/$1.00 USD) - 2016/06/06 13:02:23 CET [2016/06/06 7:02:23 ET]
Table 'Safara' 9-max Seat #7 is the button
Seat 1: oscarleon ($258.36 in chips) 
Seat 4: o.miro ($100 in chips) 
Seat 6: matiko09 ($143.28 in chips) 
Seat 7: PacPacBum ($119.07 in chips) 
Seat 8: 32rrew ($100 in chips) 
Seat 9: Mr.Grigoriy ($114 in chips) 
32rrew: posts small blind $0.50
Mr.Grigoriy: posts big blind $1
Mukhin1: sits out 
*** HOLE CARDS ***
Dealt to matiko09 [5c 8d]
oscarleon: folds 
o.miro: folds 
matiko09: folds 
PacPacBum: folds 
32rrew: folds 
Uncalled bet ($0.50) returned to Mr.Grigoriy
Mr.Grigoriy collected $1 from pot
Mr.Grigoriy: doesn't show hand 
*** SUMMARY ***
Total pot $1 | Rake $0 
Seat 1: oscarleon folded before Flop (didn't bet)
Seat 4: o.miro folded before Flop (didn't bet)
Seat 6: matiko09 folded before Flop (didn't bet)
Seat 7: PacPacBum (button) folded before Flop (didn't bet)
Seat 8: 32rrew (small blind) folded before Flop
Seat 9: Mr.Grigoriy (big blind) collected ($1)





PokerStars Hand #154363556320:  Hold'em No Limit ($0.50/$1.00 USD) - 2016/06/06 13:02:28 CET [2016/06/06 7:02:28 ET]
Table 'Smither' 9-max Seat #6 is the button
Seat 1: PacPacBum ($176.14 in chips) 
Seat 2: matiko09 ($103.84 in chips) 
Seat 3: xxxZeka ($129.07 in chips) 
Seat 5: Szevasztopol ($123.62 in chips) 
Seat 6: mooose100 ($78.50 in chips) 
Seat 7: vanilica ($100 in chips) 
Seat 8: 74 ROADIE ($63.54 in chips) 
Seat 9: hammerwife ($128.75 in chips) 
vanilica: posts small blind $0.50
74 ROADIE: posts big blind $1
*** HOLE CARDS ***
Dealt to matiko09 [As Jc]
hammerwife: folds 
PacPacBum: raises $1.04 to $2.04
matiko09: raises $5.96 to $8
xxxZeka: folds 
Szevasztopol: folds 
mooose100: folds 
vanilica: folds 
74 ROADIE: calls $7
PacPacBum: folds 
*** FLOP *** [4h 7d 3s]
74 ROADIE: bets $11
matiko09: folds 
Uncalled bet ($11) returned to 74 ROADIE
74 ROADIE collected $17.61 from pot
*** SUMMARY ***
Total pot $18.54 | Rake $0.93 
Board [4h 7d 3s]
Seat 1: PacPacBum folded before Flop
Seat 2: matiko09 folded on the Flop
Seat 3: xxxZeka folded before Flop (didn't bet)
Seat 5: Szevasztopol folded before Flop (didn't bet)
Seat 6: mooose100 (button) folded before Flop (didn't bet)
Seat 7: vanilica (small blind) folded before Flop
Seat 8: 74 ROADIE (big blind) collected ($17.61)
Seat 9: hammerwife folded before Flop (didn't bet)





PokerStars Hand #154363560405:  Hold'em No Limit (€0.50/€1.00 EUR) - 2016/06/06 13:02:38 CET [2016/06/06 7:02:38 ET]
Table 'Kythera' 9-max Seat #3 is the button
Seat 2: vanilica (€101.50 in chips) 
Seat 3: matiko09 (€120.74 in chips) 
Seat 4: PacPacBum (€100.50 in chips) 
Seat 5: Dickyxxx (€100 in chips) 
Seat 6: ozone2003 (€100 in chips) 
PacPacBum: posts small blind €0.50
Dickyxxx: posts big blind €1
*** HOLE CARDS ***
Dealt to matiko09 [Qh 6d]
ozone2003: folds 
vanilica: folds 
ozone2003 leaves the table
matiko09: folds 
PacPacBum: folds 
Uncalled bet (€0.50) returned to Dickyxxx
Dickyxxx collected €1 from pot
Dickyxxx: doesn't show hand 
*** SUMMARY ***
Total pot €1 | Rake €0 
Seat 2: vanilica folded before Flop (didn't bet)
Seat 3: matiko09 (button) folded before Flop (didn't bet)
Seat 4: PacPacBum (small blind) folded before Flop
Seat 5: Dickyxxx (big blind) collected (€1)
Seat 6: ozone2003 folded before Flop (didn't bet)





PokerStars Hand #154363562370:  Hold'em No Limit ($0.50/$1.00 USD) - 2016/06/06 13:02:42 CET [2016/06/06 7:02:42 ET]
Table 'Heze' 9-max Seat #1 is the button
Seat 1: matiko09 ($164.59 in chips) 
Seat 2: oscarleon ($194.20 in chips) 
Seat 3: ozone2003 ($123.79 in chips) 
Seat 4: ardo888 ($100 in chips) 
Seat 5: stds st ($36 in chips) 
Seat 6: yfcq36 ($141 in chips) 
Seat 7: 32rrew ($162.35 in chips) 
Seat 8: PacPacBum ($120.20 in chips) 
Seat 9: Mr.Grigoriy ($132.21 in chips) 
oscarleon: posts small blind $0.50
ozone2003: posts big blind $1
*** HOLE CARDS ***
Dealt to matiko09 [Qc Ts]
ardo888: folds 
stds st: folds 
yfcq36: folds 
32rrew: folds 
PacPacBum: folds 
Mr.Grigoriy: raises $1.50 to $2.50
matiko09: folds 
oscarleon: folds 
ozone2003: folds 
Uncalled bet ($1.50) returned to Mr.Grigoriy
Mr.Grigoriy collected $2.50 from pot
Mr.Grigoriy: doesn't show hand 
*** SUMMARY ***
Total pot $2.50 | Rake $0 
Seat 1: matiko09 (button) folded before Flop (didn't bet)
Seat 2: oscarleon (small blind) folded before Flop
Seat 3: ozone2003 (big blind) folded before Flop
Seat 4: ardo888 folded before Flop (didn't bet)
Seat 5: stds st folded before Flop (didn't bet)
Seat 6: yfcq36 folded before Flop (didn't bet)
Seat 7: 32rrew folded before Flop (didn't bet)
Seat 8: PacPacBum folded before Flop (didn't bet)
Seat 9: Mr.Grigoriy collected ($2.50)





PokerStars Hand #154363564321:  Hold'em No Limit ($0.50/$1.00 USD) - 2016/06/06 13:02:47 CET [2016/06/06 7:02:47 ET]
Table 'Sheliak' 9-max Seat #7 is the button
Seat 1: 32rrew ($100 in chips) 
Seat 3: oscarleon ($118 in chips) 
Seat 4: iRLM ($78.03 in chips) 
Seat 5: hammerwife ($100 in chips) 
Seat 6: matiko09 ($100 in chips) 
Seat 7: stds st ($26.63 in chips) 
Seat 8: ozone2003 ($100 in chips) 
Seat 9: Szevasztopol ($101.50 in chips) 
ozone2003: posts small blind $0.50
Szevasztopol: posts big blind $1
*** HOLE CARDS ***
Dealt to matiko09 [7d Ad]
masaytoo leaves the table
hurtNCYDE joins the table at seat #2 
hurtNCYDE leaves the table
32rrew: folds 
oscarleon: folds 
iRLM has timed out
iRLM: folds 
hammerwife: folds 
DancerNN1 joins the table at seat #2 
matiko09: raises $1.50 to $2.50
stds st: raises $3.50 to $6
ozone2003: folds 
Szevasztopol: folds 
matiko09: folds 
Uncalled bet ($3.50) returned to stds st
stds st collected $6.50 from pot
stds st: doesn't show hand 
*** SUMMARY ***
Total pot $6.50 | Rake $0 
Seat 1: 32rrew folded before Flop (didn't bet)
Seat 3: oscarleon folded before Flop (didn't bet)
Seat 4: iRLM folded before Flop (didn't bet)
Seat 5: hammerwife folded before Flop (didn't bet)
Seat 6: matiko09 folded before Flop
Seat 7: stds st (button) collected ($6.50)
Seat 8: ozone2003 (small blind) folded before Flop
Seat 9: Szevasztopol (big blind) folded before Flop





PokerStars Hand #154363564312:  Hold'em No Limit ($0.50/$1.00 USD) - 2016/06/06 13:02:47 CET [2016/06/06 7:02:47 ET]
Table 'Williams' 9-max Seat #3 is the button
Seat 1: matiko09 ($177.51 in chips) 
Seat 2: PacPacBum ($113.78 in chips) 
Seat 3: granbunny ($68.54 in chips) 
Seat 4: Mr.Grigoriy ($101.50 in chips) 
Seat 5: xxxibgdrgn ($105.72 in chips) 
Seat 6: xxxZeka ($131.17 in chips) 
Seat 7: kevinho109 ($29.08 in chips) 
Seat 8: oscarleon ($118.36 in chips) 
Seat 9: stds st ($38.50 in chips) 
Mr.Grigoriy: posts small blind $0.50
xxxibgdrgn: posts big blind $1
*** HOLE CARDS ***
Dealt to matiko09 [4h Ac]
xxxZeka: folds 
kevinho109: folds 
oscarleon: folds 
stds st: folds 
matiko09: folds 
PacPacBum: raises $1.50 to $2.50
granbunny: folds 
Mr.Grigoriy: folds 
xxxibgdrgn: calls $1.50
*** FLOP *** [5h 5d Kh]
xxxibgdrgn: checks 
PacPacBum: checks 
*** TURN *** [5h 5d Kh] [8c]
xxxibgdrgn: checks 
PacPacBum: checks 
*** RIVER *** [5h 5d Kh 8c] [5c]
xxxibgdrgn: checks 
PacPacBum: checks 
*** SHOW DOWN ***
xxxibgdrgn: shows [Jd Qh] (three of a kind, Fives)
PacPacBum: shows [Ad Jh] (three of a kind, Fives - Ace kicker)
PacPacBum collected $5.22 from pot
*** SUMMARY ***
Total pot $5.50 | Rake $0.28 
Board [5h 5d Kh 8c 5c]
Seat 1: matiko09 folded before Flop (didn't bet)
Seat 2: PacPacBum showed [Ad Jh] and won ($5.22) with three of a kind, Fives
Seat 3: granbunny (button) folded before Flop (didn't bet)
Seat 4: Mr.Grigoriy (small blind) folded before Flop
Seat 5: xxxibgdrgn (big blind) showed [Jd Qh] and lost with three of a kind, Fives
Seat 6: xxxZeka folded before Flop (didn't bet)
Seat 7: kevinho109 folded before Flop (didn't bet)
Seat 8: oscarleon folded before Flop (didn't bet)
Seat 9: stds st folded before Flop (didn't bet)





PokerStars Hand #154363565923:  Hold'em No Limit (€0.50/€1.00 EUR) - 2016/06/06 13:02:51 CET [2016/06/06 7:02:51 ET]
Table 'Lesath' 9-max Seat #9 is the button
Seat 1: o.miro (€100 in chips) 
Seat 2: thecurv (€100 in chips) 
Seat 3: ozone2003 (€217.65 in chips) 
Seat 4: hammerwife (€131.11 in chips) 
Seat 5: matiko09 (€100 in chips) 
Seat 6: Szevasztopol (€105.28 in chips) 
Seat 7: Mr.Grigoriy (€106.82 in chips) 
Seat 9: 72nloses (€96.06 in chips) 
o.miro: posts small blind €0.50
thecurv: posts big blind €1
*** HOLE CARDS ***
Dealt to matiko09 [4c 8s]
ozone2003: folds 
hammerwife: folds 
matiko09: folds 
Szevasztopol: folds 
Mr.Grigoriy: folds 
72nloses: calls €1
o.miro: calls €0.50
thecurv: checks 
*** FLOP *** [3c 8h 2c]
o.miro: checks 
thecurv: bets €2.13
72nloses: folds 
o.miro: folds 
Uncalled bet (€2.13) returned to thecurv
thecurv collected €2.85 from pot
thecurv: doesn't show hand 
*** SUMMARY ***
Total pot €3 | Rake €0.15 
Board [3c 8h 2c]
Seat 1: o.miro (small blind) folded on the Flop
Seat 2: thecurv (big blind) collected (€2.85)
Seat 3: ozone2003 folded before Flop (didn't bet)
Seat 4: hammerwife folded before Flop (didn't bet)
Seat 5: matiko09 folded before Flop (didn't bet)
Seat 6: Szevasztopol folded before Flop (didn't bet)
Seat 7: Mr.Grigoriy folded before Flop (didn't bet)
Seat 9: 72nloses (button) folded on the Flop





PokerStars Hand #154363566456:  Hold'em No Limit ($0.50/$1.00 USD) - 2016/06/06 13:02:52 CET [2016/06/06 7:02:52 ET]
Table 'Safara' 9-max Seat #8 is the button
Seat 1: oscarleon ($258.36 in chips) 
Seat 4: o.miro ($100 in chips) 
Seat 6: matiko09 ($143.28 in chips) 
Seat 7: PacPacBum ($119.07 in chips) 
Seat 8: 32rrew ($100 in chips) 
Seat 9: Mr.Grigoriy ($114.50 in chips) 
Mr.Grigoriy: posts small blind $0.50
oscarleon: posts big blind $1
Mukhin1: sits out 
*** HOLE CARDS ***
Dealt to matiko09 [As 6s]
o.miro: folds 
matiko09: folds 
PacPacBum: raises $1.04 to $2.04
32rrew: calls $2.04
Mr.Grigoriy: calls $1.54
oscarleon: folds 
*** FLOP *** [Jh 4c 9d]
Mr.Grigoriy: checks 
PacPacBum: checks 
32rrew: bets $4.50
Mr.Grigoriy: folds 
PacPacBum: folds 
Uncalled bet ($4.50) returned to 32rrew
32rrew collected $6.76 from pot
32rrew: doesn't show hand 
*** SUMMARY ***
Total pot $7.12 | Rake $0.36 
Board [Jh 4c 9d]
Seat 1: oscarleon (big blind) folded before Flop
Seat 4: o.miro folded before Flop (didn't bet)
Seat 6: matiko09 folded before Flop (didn't bet)
Seat 7: PacPacBum folded on the Flop
Seat 8: 32rrew (button) collected ($6.76)
Seat 9: Mr.Grigoriy (small blind) folded on the Flop





PokerStars Hand #154363571294:  Hold'em No Limit ($0.50/$1.00 USD) - 2016/06/06 13:03:04 CET [2016/06/06 7:03:04 ET]
Table 'Gajdariya' 9-max Seat #2 is the button
Seat 1: matiko09 ($135.67 in chips) 
Seat 2: xxxZeka ($170.41 in chips) 
Seat 3: oscarleon ($106.55 in chips) 
Seat 4: Szevasztopol ($149.40 in chips) 
Seat 7: Wombatkilla ($62.39 in chips) 
Seat 8: ardo888 ($151.97 in chips) 
Seat 9: Mr.Grigoriy ($181.13 in chips) 
oscarleon: posts small blind $0.50
Szevasztopol: posts big blind $1
stds st: sits out 
*** HOLE CARDS ***
Dealt to matiko09 [4c 2s]
Wombatkilla: folds 
ardo888: folds 
Mr.Grigoriy: folds 
matiko09: folds 
xxxZeka: folds 
oscarleon: raises $2 to $3
Szevasztopol: calls $2
*** FLOP *** [6h 3c 8d]
oscarleon: bets $4
Szevasztopol: calls $4
*** TURN *** [6h 3c 8d] [9c]
oscarleon: bets $9
Szevasztopol: calls $9
*** RIVER *** [6h 3c 8d 9c] [6c]
oscarleon: checks 
Szevasztopol: checks 
*** SHOW DOWN ***
oscarleon: shows [3d 9d] (two pair, Nines and Sixes)
Szevasztopol: mucks hand 
oscarleon collected $30.40 from pot
*** SUMMARY ***
Total pot $32 | Rake $1.60 
Board [6h 3c 8d 9c 6c]
Seat 1: matiko09 folded before Flop (didn't bet)
Seat 2: xxxZeka (button) folded before Flop (didn't bet)
Seat 3: oscarleon (small blind) showed [3d 9d] and won ($30.40) with two pair, Nines and Sixes
Seat 4: Szevasztopol (big blind) mucked [Jc 8s]
Seat 7: Wombatkilla folded before Flop (didn't bet)
Seat 8: ardo888 folded before Flop (didn't bet)
Seat 9: Mr.Grigoriy folded before Flop (didn't bet)





PokerStars Hand #154363575948:  Hold'em No Limit ($0.50/$1.00 USD) - 2016/06/06 13:03:15 CET [2016/06/06 7:03:15 ET]
Table 'Chaldaea II' 9-max Seat #4 is the button
Seat 1: Szevasztopol ($102.22 in chips) 
Seat 3: ardo888 ($110.99 in chips) 
Seat 4: mooose100 ($122.42 in chips) 
Seat 5: stds st ($30.38 in chips) 
Seat 6: PacPacBum ($102 in chips) 
Seat 7: riggedsh** ($191.96 in chips) 
Seat 8: 32rrew ($100 in chips) 
Seat 9: matiko09 ($100 in chips) 
stds st: posts small blind $0.50
PacPacBum: posts big blind $1
Mr.Grigoriy: sits out 
*** HOLE CARDS ***
Dealt to matiko09 [8d 2d]
riggedsh**: folds 
32rrew: folds 
matiko09: folds 
Szevasztopol: raises $1.14 to $2.14
ardo888: folds 
mooose100: calls $2.14
stds st: folds 
PacPacBum: folds 
*** FLOP *** [5d 9s Ts]
Szevasztopol: checks 
mooose100: checks 
*** TURN *** [5d 9s Ts] [7s]
Szevasztopol: checks 
mooose100: bets $5.49
Szevasztopol: folds 
Uncalled bet ($5.49) returned to mooose100
mooose100 collected $5.49 from pot
mooose100: doesn't show hand 
*** SUMMARY ***
Total pot $5.78 | Rake $0.29 
Board [5d 9s Ts 7s]
Seat 1: Szevasztopol folded on the Turn
Seat 3: ardo888 folded before Flop (didn't bet)
Seat 4: mooose100 (button) collected ($5.49)
Seat 5: stds st (small blind) folded before Flop
Seat 6: PacPacBum (big blind) folded before Flop
Seat 7: riggedsh** folded before Flop (didn't bet)
Seat 8: 32rrew folded before Flop (didn't bet)
Seat 9: matiko09 folded before Flop (didn't bet)





PokerStars Hand #154363576505:  Hold'em No Limit ($0.50/$1.00 USD) - 2016/06/06 13:03:17 CET [2016/06/06 7:03:17 ET]
Table 'Heze' 9-max Seat #2 is the button
Seat 1: matiko09 ($164.59 in chips) 
Seat 2: oscarleon ($193.70 in chips) 
Seat 3: ozone2003 ($122.79 in chips) 
Seat 4: ardo888 ($100 in chips) 
Seat 5: stds st ($36 in chips) 
Seat 6: yfcq36 ($141 in chips) 
Seat 7: 32rrew ($162.35 in chips) 
Seat 8: PacPacBum ($120.20 in chips) 
Seat 9: Mr.Grigoriy ($133.71 in chips) 
ozone2003: posts small blind $0.50
ardo888: posts big blind $1
*** HOLE CARDS ***
Dealt to matiko09 [8d 9s]
stds st: folds 
yfcq36: folds 
32rrew: raises $2 to $3
PacPacBum: folds 
Mr.Grigoriy: folds 
matiko09: folds 
oscarleon: calls $3
ozone2003: folds 
ardo888: folds 
*** FLOP *** [Qs 6d Kd]
32rrew: checks 
oscarleon: bets $5
32rrew: calls $5
*** TURN *** [Qs 6d Kd] [7d]
32rrew: checks 
oscarleon: checks 
*** RIVER *** [Qs 6d Kd 7d] [2s]
32rrew: checks 
oscarleon: checks 
*** SHOW DOWN ***
32rrew: shows [Jc Jh] (a pair of Jacks)
oscarleon: mucks hand 
32rrew collected $16.62 from pot
*** SUMMARY ***
Total pot $17.50 | Rake $0.88 
Board [Qs 6d Kd 7d 2s]
Seat 1: matiko09 folded before Flop (didn't bet)
Seat 2: oscarleon (button) mucked [Js Ts]
Seat 3: ozone2003 (small blind) folded before Flop
Seat 4: ardo888 (big blind) folded before Flop
Seat 5: stds st folded before Flop (didn't bet)
Seat 6: yfcq36 folded before Flop (didn't bet)
Seat 7: 32rrew showed [Jc Jh] and won ($16.62) with a pair of Jacks
Seat 8: PacPacBum folded before Flop (didn't bet)
Seat 9: Mr.Grigoriy folded before Flop (didn't bet)





PokerStars Hand #154363578995:  Hold'em No Limit ($0.50/$1.00 USD) - 2016/06/06 13:03:23 CET [2016/06/06 7:03:23 ET]
Table 'Smither' 9-max Seat #7 is the button
Seat 1: PacPacBum ($174.10 in chips) 
Seat 2: matiko09 ($100 in chips) 
Seat 3: xxxZeka ($129.07 in chips) 
Seat 5: Szevasztopol ($123.62 in chips) 
Seat 6: mooose100 ($78.50 in chips) 
Seat 7: vanilica ($100 in chips) 
Seat 8: 74 ROADIE ($73.15 in chips) 
Seat 9: hammerwife ($128.75 in chips) 
74 ROADIE: posts small blind $0.50
hammerwife: posts big blind $1
*** HOLE CARDS ***
Dealt to matiko09 [Jh Th]
PacPacBum: folds 
matiko09: raises $2 to $3
xxxZeka: folds 
Szevasztopol: folds 
mooose100: folds 
vanilica: calls $3
74 ROADIE: calls $2.50
hammerwife: folds 
*** FLOP *** [8d 2c Qh]
74 ROADIE: checks 
matiko09: bets $6.18
vanilica: folds 
74 ROADIE: calls $6.18
*** TURN *** [8d 2c Qh] [3d]
74 ROADIE: checks 
matiko09: checks 
*** RIVER *** [8d 2c Qh 3d] [Kc]
74 ROADIE: checks 
matiko09: checks 
*** SHOW DOWN ***
74 ROADIE: shows [Qc Td] (a pair of Queens)
matiko09: mucks hand 
74 ROADIE collected $21.24 from pot
*** SUMMARY ***
Total pot $22.36 | Rake $1.12 
Board [8d 2c Qh 3d Kc]
Seat 1: PacPacBum folded before Flop (didn't bet)
Seat 2: matiko09 mucked [Jh Th]
Seat 3: xxxZeka folded before Flop (didn't bet)
Seat 5: Szevasztopol folded before Flop (didn't bet)
Seat 6: mooose100 folded before Flop (didn't bet)
Seat 7: vanilica (button) folded on the Flop
Seat 8: 74 ROADIE (small blind) showed [Qc Td] and won ($21.24) with a pair of Queens
Seat 9: hammerwife (big blind) folded before Flop





PokerStars Hand #154363581809:  Hold'em No Limit ($0.50/$1.00 USD) - 2016/06/06 13:03:29 CET [2016/06/06 7:03:29 ET]
Table 'Wezen II' 9-max Seat #9 is the button
Seat 1: matiko09 ($179.32 in chips) 
Seat 2: Mr.Grigoriy ($118.62 in chips) 
Seat 3: oscarleon ($100 in chips) 
Seat 4: xxxibgdrgn ($101 in chips) 
Seat 5: stds st ($29.15 in chips) 
Seat 8: o.miro ($100 in chips) 
Seat 9: PacPacBum ($100 in chips) 
matiko09: posts small blind $0.50
Mr.Grigoriy: posts big blind $1
vanilica: sits out 
*** HOLE CARDS ***
Dealt to matiko09 [6c 7s]
oscarleon: folds 
xxxibgdrgn: folds 
stds st: raises $1.50 to $2.50
o.miro: folds 
PacPacBum: folds 
matiko09: folds 
Mr.Grigoriy: folds 
Uncalled bet ($1.50) returned to stds st
stds st collected $2.50 from pot
stds st: doesn't show hand 
*** SUMMARY ***
Total pot $2.50 | Rake $0 
Seat 1: matiko09 (small blind) folded before Flop
Seat 2: Mr.Grigoriy (big blind) folded before Flop
Seat 3: oscarleon folded before Flop (didn't bet)
Seat 4: xxxibgdrgn folded before Flop (didn't bet)
Seat 5: stds st collected ($2.50)
Seat 8: o.miro folded before Flop (didn't bet)
Seat 9: PacPacBum (button) folded before Flop (didn't bet)





PokerStars Hand #154363584180:  Hold'em No Limit (€0.50/€1.00 EUR) - 2016/06/06 13:03:35 CET [2016/06/06 7:03:35 ET]
Table 'Lesath' 9-max Seat #1 is the button
Seat 1: o.miro (€100 in chips) 
Seat 2: thecurv (€101.85 in chips) 
Seat 3: ozone2003 (€217.65 in chips) 
Seat 4: hammerwife (€131.11 in chips) 
Seat 5: matiko09 (€100 in chips) 
Seat 6: Szevasztopol (€105.28 in chips) 
Seat 7: Mr.Grigoriy (€106.82 in chips) 
Seat 9: 72nloses (€95.06 in chips) 
thecurv: posts small blind €0.50
ozone2003: posts big blind €1
*** HOLE CARDS ***
Dealt to matiko09 [2s 3h]
hammerwife: folds 
matiko09: folds 
Szevasztopol: folds 
Mr.Grigoriy: folds 
72nloses: folds 
o.miro: raises €1.20 to €2.20
thecurv: folds 
ozone2003: calls €1.20
*** FLOP *** [3c 7c Kc]
ozone2003: checks 
o.miro: bets €1.58
ozone2003: folds 
Uncalled bet (€1.58) returned to o.miro
o.miro collected €4.66 from pot
o.miro: doesn't show hand 
*** SUMMARY ***
Total pot €4.90 | Rake €0.24 
Board [3c 7c Kc]
Seat 1: o.miro (button) collected (€4.66)
Seat 2: thecurv (small blind) folded before Flop
Seat 3: ozone2003 (big blind) folded on the Flop
Seat 4: hammerwife folded before Flop (didn't bet)
Seat 5: matiko09 folded before Flop (didn't bet)
Seat 6: Szevasztopol folded before Flop (didn't bet)
Seat 7: Mr.Grigoriy folded before Flop (didn't bet)
Seat 9: 72nloses folded before Flop (didn't bet)





PokerStars Hand #154363586064:  Hold'em No Limit ($0.50/$1.00 USD) - 2016/06/06 13:03:39 CET [2016/06/06 7:03:39 ET]
Table 'Sheliak' 9-max Seat #8 is the button
Seat 1: 32rrew ($100 in chips) 
Seat 3: oscarleon ($118 in chips) 
Seat 5: hammerwife ($100 in chips) 
Seat 6: matiko09 ($100 in chips) 
Seat 7: stds st ($30.63 in chips) 
Seat 8: ozone2003 ($100 in chips) 
Seat 9: Szevasztopol ($100.50 in chips) 
Szevasztopol: posts small blind $0.50
32rrew: posts big blind $1
DancerNN1: sits out 
*** HOLE CARDS ***
Dealt to matiko09 [4s Kd]
oscarleon: folds 
hammerwife: folds 
matiko09: folds 
stds st: raises $1.50 to $2.50
ozone2003: folds 
Szevasztopol: folds 
32rrew: calls $1.50
*** FLOP *** [Js Kh Ts]
32rrew: checks 
stds st: bets $3.50
32rrew: folds 
Uncalled bet ($3.50) returned to stds st
stds st collected $5.22 from pot
stds st: doesn't show hand 
*** SUMMARY ***
Total pot $5.50 | Rake $0.28 
Board [Js Kh Ts]
Seat 1: 32rrew (big blind) folded on the Flop
Seat 3: oscarleon folded before Flop (didn't bet)
Seat 5: hammerwife folded before Flop (didn't bet)
Seat 6: matiko09 folded before Flop (didn't bet)
Seat 7: stds st collected ($5.22)
Seat 8: ozone2003 (button) folded before Flop (didn't bet)
Seat 9: Szevasztopol (small blind) folded before Flop





PokerStars Hand #154363595595:  Hold'em No Limit ($0.50/$1.00 USD) - 2016/06/06 13:04:02 CET [2016/06/06 7:04:02 ET]
Table 'Gajdariya' 9-max Seat #3 is the button
Seat 1: matiko09 ($135.67 in chips) 
Seat 2: xxxZeka ($170.41 in chips) 
Seat 3: oscarleon ($120.95 in chips) 
Seat 4: Szevasztopol ($133.40 in chips) 
Seat 5: stds st ($40 in chips) 
Seat 7: Wombatkilla ($62.39 in chips) 
Seat 8: ardo888 ($151.97 in chips) 
Seat 9: Mr.Grigoriy ($181.13 in chips) 
Szevasztopol: posts small blind $0.50
stds st: posts big blind $1
Dantist1122: sits out 
*** HOLE CARDS ***
Dealt to matiko09 [As 4h]
Wombatkilla: folds 
ardo888: folds 
Mr.Grigoriy: folds 
matiko09: folds 
xxxZeka: folds 
oscarleon: folds 
Szevasztopol: folds 
Uncalled bet ($0.50) returned to stds st
stds st collected $1 from pot
stds st: doesn't show hand 
*** SUMMARY ***
Total pot $1 | Rake $0 
Seat 1: matiko09 folded before Flop (didn't bet)
Seat 2: xxxZeka folded before Flop (didn't bet)
Seat 3: oscarleon (button) folded before Flop (didn't bet)
Seat 4: Szevasztopol (small blind) folded before Flop
Seat 5: stds st (big blind) collected ($1)
Seat 7: Wombatkilla folded before Flop (didn't bet)
Seat 8: ardo888 folded before Flop (didn't bet)
Seat 9: Mr.Grigoriy folded before Flop (didn't bet)





PokerStars Hand #154363596914:  Hold'em No Limit ($0.50/$1.00 USD) - 2016/06/06 13:04:05 CET [2016/06/06 7:04:05 ET]
Table 'Williams' 9-max Seat #4 is the button
Seat 1: matiko09 ($177.51 in chips) 
Seat 2: PacPacBum ($116.50 in chips) 
Seat 3: granbunny ($68.54 in chips) 
Seat 4: Mr.Grigoriy ($101 in chips) 
Seat 5: xxxibgdrgn ($103.22 in chips) 
Seat 6: xxxZeka ($131.17 in chips) 
Seat 7: kevinho109 ($29.08 in chips) 
Seat 8: oscarleon ($118.36 in chips) 
Seat 9: stds st ($38.50 in chips) 
xxxibgdrgn: posts small blind $0.50
xxxZeka: posts big blind $1
*** HOLE CARDS ***
Dealt to matiko09 [Qd 3h]
kevinho109: folds 
oscarleon: folds 
stds st: folds 
matiko09: folds 
PacPacBum: folds 
granbunny: folds 
Mr.Grigoriy: raises $1 to $2
xxxibgdrgn: folds 
xxxZeka: folds 
Uncalled bet ($1) returned to Mr.Grigoriy
Mr.Grigoriy collected $2.50 from pot
Mr.Grigoriy: doesn't show hand 
*** SUMMARY ***
Total pot $2.50 | Rake $0 
Seat 1: matiko09 folded before Flop (didn't bet)
Seat 2: PacPacBum folded before Flop (didn't bet)
Seat 3: granbunny folded before Flop (didn't bet)
Seat 4: Mr.Grigoriy (button) collected ($2.50)
Seat 5: xxxibgdrgn (small blind) folded before Flop
Seat 6: xxxZeka (big blind) folded before Flop
Seat 7: kevinho109 folded before Flop (didn't bet)
Seat 8: oscarleon folded before Flop (didn't bet)
Seat 9: stds st folded before Flop (didn't bet)





PokerStars Hand #154363597379:  Hold'em No Limit ($0.50/$1.00 USD) - 2016/06/06 13:04:06 CET [2016/06/06 7:04:06 ET]
Table 'Wezen II' 9-max Seat #1 is the button
Seat 1: matiko09 ($178.82 in chips) 
Seat 2: Mr.Grigoriy ($117.62 in chips) 
Seat 3: oscarleon ($100 in chips) 
Seat 4: xxxibgdrgn ($101 in chips) 
Seat 5: stds st ($30.65 in chips) 
Seat 7: KDJAll3 ($77.56 in chips) 
Seat 8: o.miro ($100 in chips) 
Seat 9: PacPacBum ($100 in chips) 
Mr.Grigoriy: posts small blind $0.50
oscarleon: posts big blind $1
vanilica: sits out 
*** HOLE CARDS ***
Dealt to matiko09 [9s Qd]
xxxibgdrgn: folds 
stds st: folds 
KDJAll3: folds 
o.miro: raises $1.50 to $2.50
PacPacBum: raises $5.50 to $8
matiko09: folds 
Mr.Grigoriy: folds 
oscarleon: folds 
o.miro: folds 
Uncalled bet ($5.50) returned to PacPacBum
PacPacBum collected $6.50 from pot
PacPacBum: doesn't show hand 
*** SUMMARY ***
Total pot $6.50 | Rake $0 
Seat 1: matiko09 (button) folded before Flop (didn't bet)
Seat 2: Mr.Grigoriy (small blind) folded before Flop
Seat 3: oscarleon (big blind) folded before Flop
Seat 4: xxxibgdrgn folded before Flop (didn't bet)
Seat 5: stds st folded before Flop (didn't bet)
Seat 7: KDJAll3 folded before Flop (didn't bet)
Seat 8: o.miro folded before Flop
Seat 9: PacPacBum collected ($6.50)





PokerStars Hand #154363597959:  Hold'em No Limit ($0.50/$1.00 USD) - 2016/06/06 13:04:08 CET [2016/06/06 7:04:08 ET]
Table 'Safara' 9-max Seat #9 is the button
Seat 1: oscarleon ($257.36 in chips) 
Seat 3: Dantist1122 ($101.03 in chips) 
Seat 4: o.miro ($100 in chips) 
Seat 6: matiko09 ($143.28 in chips) 
Seat 7: PacPacBum ($117.03 in chips) 
Seat 8: 32rrew ($104.72 in chips) 
Seat 9: Mr.Grigoriy ($112.46 in chips) 
oscarleon: posts small blind $0.50
Dantist1122: posts big blind $1
Mukhin1: sits out 
*** HOLE CARDS ***
Dealt to matiko09 [3d Ks]
o.miro: raises $2 to $3
matiko09: folds 
PacPacBum: raises $6 to $9
32rrew: folds 
Mr.Grigoriy: folds 
oscarleon: folds 
Dantist1122: folds 
o.miro: folds 
Uncalled bet ($6) returned to PacPacBum
PacPacBum collected $7.50 from pot
PacPacBum: doesn't show hand 
*** SUMMARY ***
Total pot $7.50 | Rake $0 
Seat 1: oscarleon (small blind) folded before Flop
Seat 3: Dantist1122 (big blind) folded before Flop
Seat 4: o.miro folded before Flop
Seat 6: matiko09 folded before Flop (didn't bet)
Seat 7: PacPacBum collected ($7.50)
Seat 8: 32rrew folded before Flop (didn't bet)
Seat 9: Mr.Grigoriy (button) folded before Flop (didn't bet)





PokerStars Hand #154363600996:  Hold'em No Limit ($0.50/$1.00 USD) - 2016/06/06 13:04:15 CET [2016/06/06 7:04:15 ET]
Table 'Smither' 9-max Seat #8 is the button
Seat 1: PacPacBum ($174.10 in chips) 
Seat 2: matiko09 ($100 in chips) 
Seat 3: xxxZeka ($129.07 in chips) 
Seat 5: Szevasztopol ($123.62 in chips) 
Seat 6: mooose100 ($78.50 in chips) 
Seat 7: vanilica ($100 in chips) 
Seat 8: 74 ROADIE ($85.21 in chips) 
Seat 9: hammerwife ($127.75 in chips) 
hammerwife: posts small blind $0.50
PacPacBum: posts big blind $1
*** HOLE CARDS ***
Dealt to matiko09 [Jh 3h]
matiko09: folds 
xxxZeka: folds 
Szevasztopol: folds 
74 ROADIE is disconnected 
mooose100: calls $1
vanilica: folds 
74 ROADIE has timed out while disconnected
74 ROADIE: folds 
hammerwife: folds 
PacPacBum: checks 
*** FLOP *** [6s 3d 8h]
PacPacBum: checks 
mooose100: bets $2.38
PacPacBum: folds 
Uncalled bet ($2.38) returned to mooose100
mooose100 collected $2.38 from pot
mooose100: doesn't show hand 
*** SUMMARY ***
Total pot $2.50 | Rake $0.12 
Board [6s 3d 8h]
Seat 1: PacPacBum (big blind) folded on the Flop
Seat 2: matiko09 folded before Flop (didn't bet)
Seat 3: xxxZeka folded before Flop (didn't bet)
Seat 5: Szevasztopol folded before Flop (didn't bet)
Seat 6: mooose100 collected ($2.38)
Seat 7: vanilica folded before Flop (didn't bet)
Seat 8: 74 ROADIE (button) folded before Flop (didn't bet)
Seat 9: hammerwife (small blind) folded before Flop





PokerStars Hand #154363605217:  Hold'em No Limit (€0.50/€1.00 EUR) - 2016/06/06 13:04:25 CET [2016/06/06 7:04:25 ET]
Table 'Lesath' 9-max Seat #2 is the button
Seat 1: o.miro (€102.46 in chips) 
Seat 2: thecurv (€101.35 in chips) 
Seat 3: ozone2003 (€215.45 in chips) 
Seat 4: hammerwife (€131.11 in chips) 
Seat 5: matiko09 (€100 in chips) 
Seat 6: Szevasztopol (€105.28 in chips) 
Seat 7: Mr.Grigoriy (€106.82 in chips) 
Seat 9: 72nloses (€95.06 in chips) 
ozone2003: posts small blind €0.50
hammerwife: posts big blind €1
*** HOLE CARDS ***
Dealt to matiko09 [2s 7h]
matiko09: folds 
Szevasztopol: folds 
Mr.Grigoriy: folds 
72nloses: raises €2.50 to €3.50
o.miro: folds 
thecurv: folds 
ozone2003: folds 
hammerwife: calls €2.50
*** FLOP *** [Qc 4d 3s]
hammerwife: checks 
72nloses: bets €8
hammerwife: folds 
Uncalled bet (€8) returned to 72nloses
72nloses collected €7.12 from pot
*** SUMMARY ***
Total pot €7.50 | Rake €0.38 
Board [Qc 4d 3s]
Seat 1: o.miro folded before Flop (didn't bet)
Seat 2: thecurv (button) folded before Flop (didn't bet)
Seat 3: ozone2003 (small blind) folded before Flop
Seat 4: hammerwife (big blind) folded on the Flop
Seat 5: matiko09 folded before Flop (didn't bet)
Seat 6: Szevasztopol folded before Flop (didn't bet)
Seat 7: Mr.Grigoriy folded before Flop (didn't bet)
Seat 9: 72nloses collected (€7.12)





PokerStars Hand #154363605293:  Hold'em No Limit ($0.50/$1.00 USD) - 2016/06/06 13:04:26 CET [2016/06/06 7:04:26 ET]
Table 'Sheliak' 9-max Seat #9 is the button
Seat 1: 32rrew ($100 in chips) 
Seat 2: DancerNN1 ($100 in chips) 
Seat 3: oscarleon ($118 in chips) 
Seat 5: hammerwife ($100 in chips) 
Seat 6: matiko09 ($100 in chips) 
Seat 7: stds st ($33.35 in chips) 
Seat 8: ozone2003 ($100 in chips) 
Seat 9: Szevasztopol ($100 in chips) 
32rrew: posts small blind $0.50
DancerNN1: posts big blind $1
*** HOLE CARDS ***
Dealt to matiko09 [8s 5c]
oscarleon: folds 
hammerwife: folds 
matiko09: folds 
stds st: raises $1.50 to $2.50
ozone2003: folds 
Szevasztopol: folds 
32rrew: folds 
DancerNN1: folds 
Uncalled bet ($1.50) returned to stds st
stds st collected $2.50 from pot
stds st: doesn't show hand 
*** SUMMARY ***
Total pot $2.50 | Rake $0 
Seat 1: 32rrew (small blind) folded before Flop
Seat 2: DancerNN1 (big blind) folded before Flop
Seat 3: oscarleon folded before Flop (didn't bet)
Seat 5: hammerwife folded before Flop (didn't bet)
Seat 6: matiko09 folded before Flop (didn't bet)
Seat 7: stds st collected ($2.50)
Seat 8: ozone2003 folded before Flop (didn't bet)
Seat 9: Szevasztopol (button) folded before Flop (didn't bet)





PokerStars Hand #154363607235:  Hold'em No Limit ($0.50/$1.00 USD) - 2016/06/06 13:04:30 CET [2016/06/06 7:04:30 ET]
Table 'Williams' 9-max Seat #5 is the button
Seat 1: matiko09 ($177.51 in chips) 
Seat 2: PacPacBum ($116.50 in chips) 
Seat 3: granbunny ($68.54 in chips) 
Seat 4: Mr.Grigoriy ($102.50 in chips) 
Seat 5: xxxibgdrgn ($102.72 in chips) 
Seat 6: xxxZeka ($130.17 in chips) 
Seat 7: kevinho109 ($29.08 in chips) 
Seat 8: oscarleon ($118.36 in chips) 
Seat 9: stds st ($38.50 in chips) 
xxxZeka: posts small blind $0.50
kevinho109: posts big blind $1
*** HOLE CARDS ***
Dealt to matiko09 [4d 5s]
oscarleon: folds 
stds st: folds 
matiko09: folds 
PacPacBum: folds 
granbunny: raises $2 to $3
Mr.Grigoriy: folds 
xxxibgdrgn: calls $3
xxxZeka: folds 
kevinho109: calls $2
*** FLOP *** [6h 9s Ts]
kevinho109: checks 
granbunny: checks 
xxxibgdrgn: checks 
*** TURN *** [6h 9s Ts] [Th]
kevinho109: checks 
granbunny: checks 
xxxibgdrgn: checks 
*** RIVER *** [6h 9s Ts Th] [9h]
kevinho109: checks 
granbunny: checks 
xxxibgdrgn: checks 
*** SHOW DOWN ***
kevinho109: shows [Jh As] (two pair, Tens and Nines)
granbunny: shows [Ah 3s] (two pair, Tens and Nines)
xxxibgdrgn: mucks hand 
kevinho109 collected $4.51 from pot
granbunny collected $4.51 from pot
*** SUMMARY ***
Total pot $9.50 | Rake $0.48 
Board [6h 9s Ts Th 9h]
Seat 1: matiko09 folded before Flop (didn't bet)
Seat 2: PacPacBum folded before Flop (didn't bet)
Seat 3: granbunny showed [Ah 3s] and won ($4.51) with two pair, Tens and Nines
Seat 4: Mr.Grigoriy folded before Flop (didn't bet)
Seat 5: xxxibgdrgn (button) mucked [Jc Kd]
Seat 6: xxxZeka (small blind) folded before Flop
Seat 7: kevinho109 (big blind) showed [Jh As] and won ($4.51) with two pair, Tens and Nines
Seat 8: oscarleon folded before Flop (didn't bet)
Seat 9: stds st folded before Flop (didn't bet)





PokerStars Hand #154363607815:  Hold'em No Limit ($0.50/$1.00 USD) - 2016/06/06 13:04:31 CET [2016/06/06 7:04:31 ET]
Table 'Safara' 9-max Seat #1 is the button
Seat 1: oscarleon ($256.86 in chips) 
Seat 3: Dantist1122 ($100.03 in chips) 
Seat 4: o.miro ($100 in chips) 
Seat 6: matiko09 ($143.28 in chips) 
Seat 7: PacPacBum ($121.53 in chips) 
Seat 8: 32rrew ($104.72 in chips) 
Seat 9: Mr.Grigoriy ($112.46 in chips) 
Dantist1122: posts small blind $0.50
o.miro: posts big blind $1
Mukhin1: sits out 
*** HOLE CARDS ***
Dealt to matiko09 [Jc 8d]
matiko09: folds 
PacPacBum: folds 
32rrew: folds 
Mr.Grigoriy: folds 
oscarleon: folds 
Dantist1122: folds 
Uncalled bet ($0.50) returned to o.miro
o.miro collected $1 from pot
o.miro: doesn't show hand 
*** SUMMARY ***
Total pot $1 | Rake $0 
Seat 1: oscarleon (button) folded before Flop (didn't bet)
Seat 3: Dantist1122 (small blind) folded before Flop
Seat 4: o.miro (big blind) collected ($1)
Seat 6: matiko09 folded before Flop (didn't bet)
Seat 7: PacPacBum folded before Flop (didn't bet)
Seat 8: 32rrew folded before Flop (didn't bet)
Seat 9: Mr.Grigoriy folded before Flop (didn't bet)





PokerStars Hand #154363613467:  Hold'em No Limit ($0.50/$1.00 USD) - 2016/06/06 13:04:45 CET [2016/06/06 7:04:45 ET]
Table 'Gajdariya' 9-max Seat #4 is the button
Seat 1: matiko09 ($135.67 in chips) 
Seat 2: xxxZeka ($170.41 in chips) 
Seat 3: oscarleon ($120.95 in chips) 
Seat 4: Szevasztopol ($132.90 in chips) 
Seat 5: stds st ($40.50 in chips) 
Seat 6: Dantist1122 ($100 in chips) 
Seat 7: Wombatkilla ($62.39 in chips) 
Seat 8: ardo888 ($151.97 in chips) 
Seat 9: Mr.Grigoriy ($181.13 in chips) 
stds st: posts small blind $0.50
Dantist1122: posts big blind $1
*** HOLE CARDS ***
Dealt to matiko09 [Ad Ks]
Wombatkilla: folds 
ardo888: folds 
Mr.Grigoriy: folds 
matiko09: raises $2 to $3
xxxZeka: folds 
oscarleon: folds 
Szevasztopol: folds 
stds st: folds 
Dantist1122: folds 
Uncalled bet ($2) returned to matiko09
matiko09 collected $2.50 from pot
matiko09: doesn't show hand 
*** SUMMARY ***
Total pot $2.50 | Rake $0 
Seat 1: matiko09 collected ($2.50)
Seat 2: xxxZeka folded before Flop (didn't bet)
Seat 3: oscarleon folded before Flop (didn't bet)
Seat 4: Szevasztopol (button) folded before Flop (didn't bet)
Seat 5: stds st (small blind) folded before Flop
Seat 6: Dantist1122 (big blind) folded before Flop
Seat 7: Wombatkilla folded before Flop (didn't bet)
Seat 8: ardo888 folded before Flop (didn't bet)
Seat 9: Mr.Grigoriy folded before Flop (didn't bet)





PokerStars Hand #154363615052:  Hold'em No Limit ($0.50/$1.00 USD) - 2016/06/06 13:04:49 CET [2016/06/06 7:04:49 ET]
Table 'Chaldaea II' 9-max Seat #5 is the button
Seat 1: Szevasztopol ($100.08 in chips) 
Seat 3: ardo888 ($110.99 in chips) 
Seat 4: mooose100 ($125.77 in chips) 
Seat 5: stds st ($29.88 in chips) 
Seat 6: PacPacBum ($101 in chips) 
Seat 8: 32rrew ($100 in chips) 
Seat 9: matiko09 ($100 in chips) 
PacPacBum: posts small blind $0.50
riggedsh**: is sitting out 
32rrew: posts big blind $1
Mr.Grigoriy: sits out 
*** HOLE CARDS ***
Dealt to matiko09 [Jd 5h]
riggedsh** leaves the table
matiko09: folds 
xxxibgdrgn joins the table at seat #7 
Szevasztopol: raises $1.14 to $2.14
ardo888: calls $2.14
mooose100: calls $2.14
stds st: calls $2.14
PacPacBum: folds 
32rrew: calls $1.14
*** FLOP *** [Js 9h 6h]
32rrew: checks 
Szevasztopol: bets $7.02
ardo888: folds 
mooose100: folds 
stds st: folds 
32rrew: folds 
Uncalled bet ($7.02) returned to Szevasztopol
Szevasztopol collected $10.64 from pot
Szevasztopol: doesn't show hand 
*** SUMMARY ***
Total pot $11.20 | Rake $0.56 
Board [Js 9h 6h]
Seat 1: Szevasztopol collected ($10.64)
Seat 3: ardo888 folded on the Flop
Seat 4: mooose100 folded on the Flop
Seat 5: stds st (button) folded on the Flop
Seat 6: PacPacBum (small blind) folded before Flop
Seat 8: 32rrew (big blind) folded on the Flop
Seat 9: matiko09 folded before Flop (didn't bet)





PokerStars Hand #154363616307:  Hold'em No Limit ($0.50/$1.00 USD) - 2016/06/06 13:04:52 CET [2016/06/06 7:04:52 ET]
Table 'Sheliak' 9-max Seat #1 is the button
Seat 1: 32rrew ($100 in chips) 
Seat 2: DancerNN1 ($100 in chips) 
Seat 3: oscarleon ($118 in chips) 
Seat 5: hammerwife ($100 in chips) 
Seat 6: matiko09 ($100 in chips) 
Seat 7: stds st ($34.85 in chips) 
Seat 8: ozone2003 ($100 in chips) 
Seat 9: Szevasztopol ($100 in chips) 
DancerNN1: posts small blind $0.50
oscarleon: posts big blind $1
*** HOLE CARDS ***
Dealt to matiko09 [7d Ts]
hammerwife: raises $2 to $3
matiko09: folds 
stds st: folds 
ozone2003: folds 
Szevasztopol: folds 
32rrew: folds 
DancerNN1: folds 
oscarleon: folds 
Uncalled bet ($2) returned to hammerwife
hammerwife collected $2.50 from pot
hammerwife: doesn't show hand 
*** SUMMARY ***
Total pot $2.50 | Rake $0 
Seat 1: 32rrew (button) folded before Flop (didn't bet)
Seat 2: DancerNN1 (small blind) folded before Flop
Seat 3: oscarleon (big blind) folded before Flop
Seat 5: hammerwife collected ($2.50)
Seat 6: matiko09 folded before Flop (didn't bet)
Seat 7: stds st folded before Flop (didn't bet)
Seat 8: ozone2003 folded before Flop (didn't bet)
Seat 9: Szevasztopol folded before Flop (didn't bet)





PokerStars Hand #154363618686:  Hold'em No Limit ($0.50/$1.00 USD) - 2016/06/06 13:04:57 CET [2016/06/06 7:04:57 ET]
Table 'Heze' 9-max Seat #3 is the button
Seat 1: matiko09 ($164.59 in chips) 
Seat 2: oscarleon ($185.70 in chips) 
Seat 3: ozone2003 ($122.29 in chips) 
Seat 4: ardo888 ($100 in chips) 
Seat 5: stds st ($36 in chips) 
Seat 6: yfcq36 ($141 in chips) 
Seat 7: 32rrew ($170.97 in chips) 
Seat 8: PacPacBum ($120.20 in chips) 
Seat 9: Mr.Grigoriy ($133.71 in chips) 
ardo888: posts small blind $0.50
stds st: posts big blind $1
*** HOLE CARDS ***
Dealt to matiko09 [Kh Tc]
yfcq36: folds 
32rrew: folds 
PacPacBum: folds 
Mr.Grigoriy: folds 
matiko09: folds 
oscarleon: raises $2 to $3
ozone2003: folds 
ardo888: folds 
stds st: folds 
Uncalled bet ($2) returned to oscarleon
oscarleon collected $2.50 from pot
oscarleon: doesn't show hand 
*** SUMMARY ***
Total pot $2.50 | Rake $0 
Seat 1: matiko09 folded before Flop (didn't bet)
Seat 2: oscarleon collected ($2.50)
Seat 3: ozone2003 (button) folded before Flop (didn't bet)
Seat 4: ardo888 (small blind) folded before Flop
Seat 5: stds st (big blind) folded before Flop
Seat 6: yfcq36 folded before Flop (didn't bet)
Seat 7: 32rrew folded before Flop (didn't bet)
Seat 8: PacPacBum folded before Flop (didn't bet)
Seat 9: Mr.Grigoriy folded before Flop (didn't bet)





PokerStars Hand #154363619039:  Hold'em No Limit ($0.50/$1.00 USD) - 2016/06/06 13:04:58 CET [2016/06/06 7:04:58 ET]
Table 'Wezen II' 9-max Seat #2 is the button
Seat 1: matiko09 ($178.82 in chips) 
Seat 2: Mr.Grigoriy ($117.12 in chips) 
Seat 3: oscarleon ($100 in chips) 
Seat 4: xxxibgdrgn ($101 in chips) 
Seat 5: stds st ($30.65 in chips) 
Seat 7: KDJAll3 ($77.56 in chips) 
Seat 8: o.miro ($100 in chips) 
Seat 9: PacPacBum ($104 in chips) 
oscarleon: posts small blind $0.50
xxxibgdrgn: posts big blind $1
vanilica: sits out 
*** HOLE CARDS ***
Dealt to matiko09 [Tc Qs]
stds st: folds 
KDJAll3: folds 
o.miro: folds 
PacPacBum: folds 
matiko09: raises $1.50 to $2.50
Mr.Grigoriy: folds 
oscarleon: folds 
xxxibgdrgn: folds 
Uncalled bet ($1.50) returned to matiko09
matiko09 collected $2.50 from pot
matiko09: doesn't show hand 
*** SUMMARY ***
Total pot $2.50 | Rake $0 
Seat 1: matiko09 collected ($2.50)
Seat 2: Mr.Grigoriy (button) folded before Flop (didn't bet)
Seat 3: oscarleon (small blind) folded before Flop
Seat 4: xxxibgdrgn (big blind) folded before Flop
Seat 5: stds st folded before Flop (didn't bet)
Seat 7: KDJAll3 folded before Flop (didn't bet)
Seat 8: o.miro folded before Flop (didn't bet)
Seat 9: PacPacBum folded before Flop (didn't bet)





PokerStars Hand #154363625317:  Hold'em No Limit ($0.50/$1.00 USD) - 2016/06/06 13:05:13 CET [2016/06/06 7:05:13 ET]
Table 'Sheliak' 9-max Seat #2 is the button
Seat 1: 32rrew ($100 in chips) 
Seat 2: DancerNN1 ($100 in chips) 
Seat 3: oscarleon ($117 in chips) 
Seat 5: hammerwife ($101.50 in chips) 
Seat 6: matiko09 ($100 in chips) 
Seat 7: stds st ($34.85 in chips) 
Seat 8: ozone2003 ($100 in chips) 
Seat 9: Szevasztopol ($100 in chips) 
oscarleon: posts small blind $0.50
hammerwife: posts big blind $1
*** HOLE CARDS ***
Dealt to matiko09 [Kd Qs]
matiko09: folds 
stds st: folds 
ozone2003: folds 
Szevasztopol: raises $1.14 to $2.14
32rrew: folds 
DancerNN1: folds 
oscarleon: folds 
hammerwife: folds 
Uncalled bet ($1.14) returned to Szevasztopol
Szevasztopol collected $2.50 from pot
Szevasztopol: doesn't show hand 
*** SUMMARY ***
Total pot $2.50 | Rake $0 
Seat 1: 32rrew folded before Flop (didn't bet)
Seat 2: DancerNN1 (button) folded before Flop (didn't bet)
Seat 3: oscarleon (small blind) folded before Flop
Seat 5: hammerwife (big blind) folded before Flop
Seat 6: matiko09 folded before Flop (didn't bet)
Seat 7: stds st folded before Flop (didn't bet)
Seat 8: ozone2003 folded before Flop (didn't bet)
Seat 9: Szevasztopol collected ($2.50)





PokerStars Hand #154363626745:  Hold'em No Limit ($0.50/$1.00 USD) - 2016/06/06 13:05:16 CET [2016/06/06 7:05:16 ET]
Table 'Smither' 9-max Seat #9 is the button
Seat 1: PacPacBum ($173.10 in chips) 
Seat 2: matiko09 ($100 in chips) 
Seat 3: xxxZeka ($129.07 in chips) 
Seat 5: Szevasztopol ($123.62 in chips) 
Seat 6: mooose100 ($79.88 in chips) 
Seat 7: vanilica ($100 in chips) 
Seat 9: hammerwife ($127.25 in chips) 
PacPacBum: posts small blind $0.50
matiko09: posts big blind $1
*** HOLE CARDS ***
Dealt to matiko09 [3d 6h]
xxxZeka: folds 
Szevasztopol: folds 
mooose100: calls $1
vanilica: folds 
hammerwife: folds 
PacPacBum: folds 
matiko09: checks 
*** FLOP *** [Qc Ts Jc]
matiko09: checks 
mooose100: bets $1.19
matiko09: folds 
Uncalled bet ($1.19) returned to mooose100
mooose100 collected $2.38 from pot
mooose100: doesn't show hand 
*** SUMMARY ***
Total pot $2.50 | Rake $0.12 
Board [Qc Ts Jc]
Seat 1: PacPacBum (small blind) folded before Flop
Seat 2: matiko09 (big blind) folded on the Flop
Seat 3: xxxZeka folded before Flop (didn't bet)
Seat 5: Szevasztopol folded before Flop (didn't bet)
Seat 6: mooose100 collected ($2.38)
Seat 7: vanilica folded before Flop (didn't bet)
Seat 9: hammerwife (button) folded before Flop (didn't bet)





PokerStars Hand #154363630428:  Hold'em No Limit (€0.50/€1.00 EUR) - 2016/06/06 13:05:25 CET [2016/06/06 7:05:25 ET]
Table 'Lesath' 9-max Seat #3 is the button
Seat 1: o.miro (€102.46 in chips) 
Seat 2: thecurv (€101.35 in chips) 
Seat 3: ozone2003 (€214.95 in chips) 
Seat 4: hammerwife (€127.61 in chips) 
Seat 5: matiko09 (€100 in chips) 
Seat 6: Szevasztopol (€105.28 in chips) 
Seat 7: Mr.Grigoriy (€106.82 in chips) 
Seat 9: 72nloses (€98.68 in chips) 
hammerwife: posts small blind €0.50
matiko09: posts big blind €1
*** HOLE CARDS ***
Dealt to matiko09 [5d Kc]
Szevasztopol: folds 
Mr.Grigoriy: folds 
72nloses: folds 
o.miro: folds 
thecurv: folds 
ozone2003: folds 
hammerwife: folds 
Uncalled bet (€0.50) returned to matiko09
matiko09 collected €1 from pot
matiko09: doesn't show hand 
*** SUMMARY ***
Total pot €1 | Rake €0 
Seat 1: o.miro folded before Flop (didn't bet)
Seat 2: thecurv folded before Flop (didn't bet)
Seat 3: ozone2003 (button) folded before Flop (didn't bet)
Seat 4: hammerwife (small blind) folded before Flop
Seat 5: matiko09 (big blind) collected (€1)
Seat 6: Szevasztopol folded before Flop (didn't bet)
Seat 7: Mr.Grigoriy folded before Flop (didn't bet)
Seat 9: 72nloses folded before Flop (didn't bet)





PokerStars Hand #154363632740:  Hold'em No Limit ($0.50/$1.00 USD) - 2016/06/06 13:05:30 CET [2016/06/06 7:05:30 ET]
Table 'Heze' 9-max Seat #4 is the button
Seat 1: matiko09 ($164.59 in chips) 
Seat 2: oscarleon ($187.20 in chips) 
Seat 3: ozone2003 ($122.29 in chips) 
Seat 4: ardo888 ($100 in chips) 
Seat 5: stds st ($35 in chips) 
Seat 6: yfcq36 ($141 in chips) 
Seat 7: 32rrew ($170.97 in chips) 
Seat 8: PacPacBum ($120.20 in chips) 
Seat 9: Mr.Grigoriy ($133.71 in chips) 
stds st: posts small blind $0.50
yfcq36: posts big blind $1
*** HOLE CARDS ***
Dealt to matiko09 [Ts Td]
32rrew: folds 
PacPacBum: folds 
Mr.Grigoriy: folds 
matiko09: raises $2 to $3
oscarleon: folds 
ozone2003: folds 
ardo888: folds 
stds st: folds 
yfcq36: calls $2
*** FLOP *** [8c 5h 5s]
yfcq36: bets $3.09
oscarleon leaves the table
hurtNCYDE joins the table at seat #2 
hurtNCYDE leaves the table
matiko09: calls $3.09
*** TURN *** [8c 5h 5s] [Ah]
yfcq36: checks 
matiko09: bets $6
yfcq36: folds 
Uncalled bet ($6) returned to matiko09
matiko09 collected $12.05 from pot
matiko09: doesn't show hand 
*** SUMMARY ***
Total pot $12.68 | Rake $0.63 
Board [8c 5h 5s Ah]
Seat 1: matiko09 collected ($12.05)
Seat 2: oscarleon folded before Flop (didn't bet)
Seat 3: ozone2003 folded before Flop (didn't bet)
Seat 4: ardo888 (button) folded before Flop (didn't bet)
Seat 5: stds st (small blind) folded before Flop
Seat 6: yfcq36 (big blind) folded on the Turn
Seat 7: 32rrew folded before Flop (didn't bet)
Seat 8: PacPacBum folded before Flop (didn't bet)
Seat 9: Mr.Grigoriy folded before Flop (didn't bet)





PokerStars Hand #154363633317:  Hold'em No Limit ($0.50/$1.00 USD) - 2016/06/06 13:05:32 CET [2016/06/06 7:05:32 ET]
Table 'Gajdariya' 9-max Seat #5 is the button
Seat 1: matiko09 ($137.17 in chips) 
Seat 2: xxxZeka ($170.41 in chips) 
Seat 4: Szevasztopol ($132.90 in chips) 
Seat 5: stds st ($40 in chips) 
Seat 6: Dantist1122 ($100 in chips) 
Seat 7: Wombatkilla ($62.39 in chips) 
Seat 8: ardo888 ($151.97 in chips) 
Seat 9: Mr.Grigoriy ($181.13 in chips) 
Dantist1122: posts small blind $0.50
Wombatkilla: posts big blind $1
*** HOLE CARDS ***
Dealt to matiko09 [Ks Ac]
ardo888: folds 
Mr.Grigoriy: folds 
matiko09: raises $2 to $3
xxxZeka: folds 
Szevasztopol: folds 
stds st: folds 
Dantist1122: folds 
Wombatkilla: folds 
Uncalled bet ($2) returned to matiko09
matiko09 collected $2.50 from pot
matiko09: doesn't show hand 
*** SUMMARY ***
Total pot $2.50 | Rake $0 
Seat 1: matiko09 collected ($2.50)
Seat 2: xxxZeka folded before Flop (didn't bet)
Seat 4: Szevasztopol folded before Flop (didn't bet)
Seat 5: stds st (button) folded before Flop (didn't bet)
Seat 6: Dantist1122 (small blind) folded before Flop
Seat 7: Wombatkilla (big blind) folded before Flop
Seat 8: ardo888 folded before Flop (didn't bet)
Seat 9: Mr.Grigoriy folded before Flop (didn't bet)





PokerStars Hand #154363634534:  Hold'em No Limit ($0.50/$1.00 USD) - 2016/06/06 13:05:35 CET [2016/06/06 7:05:35 ET]
Table 'Williams' 9-max Seat #6 is the button
Seat 1: matiko09 ($177.51 in chips) 
Seat 2: PacPacBum ($116.50 in chips) 
Seat 3: granbunny ($70.05 in chips) 
Seat 4: Mr.Grigoriy ($102.50 in chips) 
Seat 5: xxxibgdrgn ($100 in chips) 
Seat 6: xxxZeka ($129.67 in chips) 
Seat 7: kevinho109 ($30.59 in chips) 
Seat 9: stds st ($38.50 in chips) 
kevinho109: posts small blind $0.50
stds st: posts big blind $1
*** HOLE CARDS ***
Dealt to matiko09 [6s 5s]
matiko09: folds 
PacPacBum: folds 
granbunny: folds 
Mr.Grigoriy: folds 
xxxibgdrgn: folds 
xxxZeka: raises $1.50 to $2.50
kevinho109: folds 
stds st: folds 
Uncalled bet ($1.50) returned to xxxZeka
xxxZeka collected $2.50 from pot
*** SUMMARY ***
Total pot $2.50 | Rake $0 
Seat 1: matiko09 folded before Flop (didn't bet)
Seat 2: PacPacBum folded before Flop (didn't bet)
Seat 3: granbunny folded before Flop (didn't bet)
Seat 4: Mr.Grigoriy folded before Flop (didn't bet)
Seat 5: xxxibgdrgn folded before Flop (didn't bet)
Seat 6: xxxZeka (button) collected ($2.50)
Seat 7: kevinho109 (small blind) folded before Flop
Seat 9: stds st (big blind) folded before Flop





PokerStars Hand #154363634608:  Hold'em No Limit ($0.50/$1.00 USD) - 2016/06/06 13:05:35 CET [2016/06/06 7:05:35 ET]
Table 'Wezen II' 9-max Seat #4 is the button
Seat 1: matiko09 ($180.32 in chips) 
Seat 2: Mr.Grigoriy ($117.12 in chips) 
Seat 4: xxxibgdrgn ($100 in chips) 
Seat 5: stds st ($30.65 in chips) 
Seat 6: vanilica ($100 in chips) 
Seat 7: KDJAll3 ($77.56 in chips) 
Seat 8: o.miro ($100 in chips) 
Seat 9: PacPacBum ($104 in chips) 
stds st: posts small blind $0.50
vanilica: posts big blind $1
*** HOLE CARDS ***
Dealt to matiko09 [6s 7h]
KDJAll3: raises $1 to $2
o.miro: folds 
PacPacBum: folds 
matiko09: folds 
Mr.Grigoriy: folds 
xxxibgdrgn: folds 
stds st: folds 
vanilica: folds 
Uncalled bet ($1) returned to KDJAll3
KDJAll3 collected $2.50 from pot
KDJAll3: doesn't show hand 
*** SUMMARY ***
Total pot $2.50 | Rake $0 
Seat 1: matiko09 folded before Flop (didn't bet)
Seat 2: Mr.Grigoriy folded before Flop (didn't bet)
Seat 4: xxxibgdrgn (button) folded before Flop (didn't bet)
Seat 5: stds st (small blind) folded before Flop
Seat 6: vanilica (big blind) folded before Flop
Seat 7: KDJAll3 collected ($2.50)
Seat 8: o.miro folded before Flop (didn't bet)
Seat 9: PacPacBum folded before Flop (didn't bet)





PokerStars Hand #154363641787:  Hold'em No Limit (€0.50/€1.00 EUR) - 2016/06/06 13:05:52 CET [2016/06/06 7:05:52 ET]
Table 'Lesath' 9-max Seat #4 is the button
Seat 1: o.miro (€102.46 in chips) 
Seat 2: thecurv (€101.35 in chips) 
Seat 3: ozone2003 (€214.95 in chips) 
Seat 4: hammerwife (€127.11 in chips) 
Seat 5: matiko09 (€100.50 in chips) 
Seat 6: Szevasztopol (€105.28 in chips) 
Seat 7: Mr.Grigoriy (€106.82 in chips) 
Seat 9: 72nloses (€98.68 in chips) 
matiko09: posts small blind €0.50
Szevasztopol: posts big blind €1
*** HOLE CARDS ***
Dealt to matiko09 [5s 6s]
Mr.Grigoriy: folds 
72nloses: raises €2.50 to €3.50
o.miro: folds 
thecurv: folds 
ozone2003: folds 
hammerwife: folds 
matiko09: folds 
Szevasztopol: calls €2.50
*** FLOP *** [Jh 4s 3h]
Szevasztopol: checks 
72nloses: bets €9
Szevasztopol: calls €9
*** TURN *** [Jh 4s 3h] [8s]
Szevasztopol: checks 
72nloses: bets €30
Szevasztopol: calls €30
*** RIVER *** [Jh 4s 3h 8s] [8c]
Szevasztopol: checks 
72nloses: checks 
*** SHOW DOWN ***
Szevasztopol: shows [Jd Ac] (two pair, Jacks and Eights)
72nloses: mucks hand 
Szevasztopol collected €83.25 from pot
*** SUMMARY ***
Total pot €85.50 | Rake €2.25 
Board [Jh 4s 3h 8s 8c]
Seat 1: o.miro folded before Flop (didn't bet)
Seat 2: thecurv folded before Flop (didn't bet)
Seat 3: ozone2003 folded before Flop (didn't bet)
Seat 4: hammerwife (button) folded before Flop (didn't bet)
Seat 5: matiko09 (small blind) folded before Flop
Seat 6: Szevasztopol (big blind) showed [Jd Ac] and won (€83.25) with two pair, Jacks and Eights
Seat 7: Mr.Grigoriy folded before Flop (didn't bet)
Seat 9: 72nloses mucked [9s 9c]





PokerStars Hand #154363642091:  Hold'em No Limit ($0.50/$1.00 USD) - 2016/06/06 13:05:53 CET [2016/06/06 7:05:53 ET]
Table 'Sheliak' 9-max Seat #5 is the button
Seat 1: 32rrew ($100 in chips) 
Seat 2: DancerNN1 ($100 in chips) 
Seat 5: hammerwife ($100.50 in chips) 
Seat 6: matiko09 ($100 in chips) 
Seat 7: stds st ($34.85 in chips) 
Seat 8: ozone2003 ($100 in chips) 
Seat 9: Szevasztopol ($101.50 in chips) 
matiko09: posts small blind $0.50
stds st: posts big blind $1
*** HOLE CARDS ***
Dealt to matiko09 [9c 8h]
ozone2003: folds 
Szevasztopol: folds 
32rrew: raises $2 to $3
oscarleon leaves the table
DancerNN1: folds 
hammerwife: folds 
matiko09: folds 
stds st: folds 
Uncalled bet ($2) returned to 32rrew
32rrew collected $2.50 from pot
32rrew: doesn't show hand 
*** SUMMARY ***
Total pot $2.50 | Rake $0 
Seat 1: 32rrew collected ($2.50)
Seat 2: DancerNN1 folded before Flop (didn't bet)
Seat 5: hammerwife (button) folded before Flop (didn't bet)
Seat 6: matiko09 (small blind) folded before Flop
Seat 7: stds st (big blind) folded before Flop
Seat 8: ozone2003 folded before Flop (didn't bet)
Seat 9: Szevasztopol folded before Flop (didn't bet)





PokerStars Hand #154363643435:  Hold'em No Limit ($0.50/$1.00 USD) - 2016/06/06 13:05:56 CET [2016/06/06 7:05:56 ET]
Table 'Gajdariya' 9-max Seat #6 is the button
Seat 1: matiko09 ($138.67 in chips) 
Seat 2: xxxZeka ($170.41 in chips) 
Seat 4: Szevasztopol ($132.90 in chips) 
Seat 5: stds st ($40 in chips) 
Seat 6: Dantist1122 ($100 in chips) 
Seat 7: Wombatkilla ($61.39 in chips) 
Seat 8: ardo888 ($151.97 in chips) 
Seat 9: Mr.Grigoriy ($181.13 in chips) 
Wombatkilla: posts small blind $0.50
ardo888: posts big blind $1
*** HOLE CARDS ***
Dealt to matiko09 [5h 3c]
Mr.Grigoriy: raises $2 to $3
matiko09: folds 
oscarleon leaves the table
xxxZeka: folds 
Szevasztopol: folds 
stds st: folds 
Dantist1122: folds 
Wombatkilla: folds 
ardo888: folds 
Uncalled bet ($2) returned to Mr.Grigoriy
Mr.Grigoriy collected $2.50 from pot
Mr.Grigoriy: doesn't show hand 
*** SUMMARY ***
Total pot $2.50 | Rake $0 
Seat 1: matiko09 folded before Flop (didn't bet)
Seat 2: xxxZeka folded before Flop (didn't bet)
Seat 4: Szevasztopol folded before Flop (didn't bet)
Seat 5: stds st folded before Flop (didn't bet)
Seat 6: Dantist1122 (button) folded before Flop (didn't bet)
Seat 7: Wombatkilla (small blind) folded before Flop
Seat 8: ardo888 (big blind) folded before Flop
Seat 9: Mr.Grigoriy collected ($2.50)





PokerStars Hand #154363644054:  Hold'em No Limit ($0.50/$1.00 USD) - 2016/06/06 13:05:57 CET [2016/06/06 7:05:57 ET]
Table 'Williams' 9-max Seat #7 is the button
Seat 1: matiko09 ($177.51 in chips) 
Seat 2: PacPacBum ($116.50 in chips) 
Seat 3: granbunny ($70.05 in chips) 
Seat 4: Mr.Grigoriy ($102.50 in chips) 
Seat 5: xxxibgdrgn ($100 in chips) 
Seat 6: xxxZeka ($131.17 in chips) 
Seat 7: kevinho109 ($30.09 in chips) 
Seat 9: stds st ($37.50 in chips) 
stds st: posts small blind $0.50
matiko09: posts big blind $1
*** HOLE CARDS ***
Dealt to matiko09 [3h 8c]
PacPacBum: folds 
granbunny: folds 
Mr.Grigoriy: folds 
oscarleon leaves the table
xxxibgdrgn: folds 
xxxZeka: raises $2 to $3
kevinho109: folds 
o.miro joins the table at seat #8 
stds st: folds 
matiko09: folds 
Uncalled bet ($2) returned to xxxZeka
xxxZeka collected $2.50 from pot
*** SUMMARY ***
Total pot $2.50 | Rake $0 
Seat 1: matiko09 (big blind) folded before Flop
Seat 2: PacPacBum folded before Flop (didn't bet)
Seat 3: granbunny folded before Flop (didn't bet)
Seat 4: Mr.Grigoriy folded before Flop (didn't bet)
Seat 5: xxxibgdrgn folded before Flop (didn't bet)
Seat 6: xxxZeka collected ($2.50)
Seat 7: kevinho109 (button) folded before Flop (didn't bet)
Seat 9: stds st (small blind) folded before Flop





PokerStars Hand #154363645141:  Hold'em No Limit ($0.50/$1.00 USD) - 2016/06/06 13:06:00 CET [2016/06/06 7:06:00 ET]
Table 'Smither' 9-max Seat #1 is the button
Seat 1: PacPacBum ($172.60 in chips) 
Seat 2: matiko09 ($100 in chips) 
Seat 3: xxxZeka ($129.07 in chips) 
Seat 5: Szevasztopol ($123.62 in chips) 
Seat 6: mooose100 ($81.26 in chips) 
Seat 7: vanilica ($100 in chips) 
Seat 9: hammerwife ($127.25 in chips) 
matiko09: posts small blind $0.50
xxxZeka: posts big blind $1
*** HOLE CARDS ***
Dealt to matiko09 [5d 2h]
Szevasztopol: folds 
mooose100: folds 
vanilica: folds 
hammerwife: folds 
PacPacBum: folds 
matiko09: folds 
Uncalled bet ($0.50) returned to xxxZeka
xxxZeka collected $1 from pot
*** SUMMARY ***
Total pot $1 | Rake $0 
Seat 1: PacPacBum (button) folded before Flop (didn't bet)
Seat 2: matiko09 (small blind) folded before Flop
Seat 3: xxxZeka (big blind) collected ($1)
Seat 5: Szevasztopol folded before Flop (didn't bet)
Seat 6: mooose100 folded before Flop (didn't bet)
Seat 7: vanilica folded before Flop (didn't bet)
Seat 9: hammerwife folded before Flop (didn't bet)





PokerStars Hand #154363647333:  Hold'em No Limit ($0.50/$1.00 USD) - 2016/06/06 13:06:05 CET [2016/06/06 7:06:05 ET]
Table 'Wezen II' 9-max Seat #5 is the button
Seat 1: matiko09 ($180.32 in chips) 
Seat 2: Mr.Grigoriy ($117.12 in chips) 
Seat 4: xxxibgdrgn ($100 in chips) 
Seat 5: stds st ($30.15 in chips) 
Seat 6: vanilica ($100 in chips) 
Seat 7: KDJAll3 ($79.06 in chips) 
Seat 8: o.miro ($100 in chips) 
Seat 9: PacPacBum ($104 in chips) 
vanilica: posts small blind $0.50
KDJAll3: posts big blind $1
*** HOLE CARDS ***
Dealt to matiko09 [Ks 4c]
oscarleon leaves the table
hurtNCYDE joins the table at seat #3 
o.miro: folds 
hurtNCYDE leaves the table
Dickyxxx joins the table at seat #3 
PacPacBum: folds 
matiko09: folds 
Mr.Grigoriy: folds 
xxxibgdrgn: folds 
stds st: raises $1.02 to $2.02
vanilica: folds 
KDJAll3: folds 
Uncalled bet ($1.02) returned to stds st
stds st collected $2.50 from pot
stds st: doesn't show hand 
*** SUMMARY ***
Total pot $2.50 | Rake $0 
Seat 1: matiko09 folded before Flop (didn't bet)
Seat 2: Mr.Grigoriy folded before Flop (didn't bet)
Seat 4: xxxibgdrgn folded before Flop (didn't bet)
Seat 5: stds st (button) collected ($2.50)
Seat 6: vanilica (small blind) folded before Flop
Seat 7: KDJAll3 (big blind) folded before Flop
Seat 8: o.miro folded before Flop (didn't bet)
Seat 9: PacPacBum folded before Flop (didn't bet)





PokerStars Hand #154363652759:  Hold'em No Limit ($0.50/$1.00 USD) - 2016/06/06 13:06:18 CET [2016/06/06 7:06:18 ET]
Table 'Williams' 9-max Seat #9 is the button
Seat 1: matiko09 ($176.51 in chips) 
Seat 2: PacPacBum ($116.50 in chips) 
Seat 3: granbunny ($70.05 in chips) 
Seat 4: Mr.Grigoriy ($102.50 in chips) 
Seat 5: xxxibgdrgn ($100 in chips) 
Seat 6: xxxZeka ($132.67 in chips) 
Seat 7: kevinho109 ($30.09 in chips) 
Seat 9: stds st ($37 in chips) 
matiko09: posts small blind $0.50
PacPacBum: posts big blind $1
o.miro: sits out 
*** HOLE CARDS ***
Dealt to matiko09 [Qd Js]
granbunny: raises $1 to $2
Mr.Grigoriy: calls $2
xxxibgdrgn: folds 
xxxZeka: raises $8 to $10
kevinho109: folds 
o.miro leaves the table
Dickyxxx joins the table at seat #8 
stds st: folds 
matiko09: folds 
PacPacBum: folds 
granbunny: folds 
Mr.Grigoriy: folds 
Uncalled bet ($8) returned to xxxZeka
xxxZeka collected $7.50 from pot
*** SUMMARY ***
Total pot $7.50 | Rake $0 
Seat 1: matiko09 (small blind) folded before Flop
Seat 2: PacPacBum (big blind) folded before Flop
Seat 3: granbunny folded before Flop
Seat 4: Mr.Grigoriy folded before Flop
Seat 5: xxxibgdrgn folded before Flop (didn't bet)
Seat 6: xxxZeka collected ($7.50)
Seat 7: kevinho109 folded before Flop (didn't bet)
Seat 9: stds st (button) folded before Flop (didn't bet)





PokerStars Hand #154363653460:  Hold'em No Limit ($0.50/$1.00 USD) - 2016/06/06 13:06:20 CET [2016/06/06 7:06:20 ET]
Table 'Gajdariya' 9-max Seat #7 is the button
Seat 1: matiko09 ($138.67 in chips) 
Seat 2: xxxZeka ($170.41 in chips) 
Seat 4: Szevasztopol ($132.90 in chips) 
Seat 5: stds st ($40 in chips) 
Seat 6: Dantist1122 ($100 in chips) 
Seat 7: Wombatkilla ($60.89 in chips) 
Seat 8: ardo888 ($150.97 in chips) 
ardo888: posts small blind $0.50
Mr.Grigoriy: is sitting out 
matiko09: posts big blind $1
*** HOLE CARDS ***
Dealt to matiko09 [Tc Kc]
xxxZeka: folds 
Szevasztopol: folds 
stds st: raises $1.50 to $2.50
Mr.Grigoriy leaves the table
Dantist1122: raises $5.50 to $8
Wombatkilla: folds 
ardo888: folds 
matiko09: folds 
stds st: folds 
Uncalled bet ($5.50) returned to Dantist1122
Dantist1122 collected $6.50 from pot
Dantist1122: doesn't show hand 
*** SUMMARY ***
Total pot $6.50 | Rake $0 
Seat 1: matiko09 (big blind) folded before Flop
Seat 2: xxxZeka folded before Flop (didn't bet)
Seat 4: Szevasztopol folded before Flop (didn't bet)
Seat 5: stds st folded before Flop
Seat 6: Dantist1122 collected ($6.50)
Seat 7: Wombatkilla (button) folded before Flop (didn't bet)
Seat 8: ardo888 (small blind) folded before Flop





PokerStars Hand #154363653412:  Hold'em No Limit ($0.50/$1.00 USD) - 2016/06/06 13:06:20 CET [2016/06/06 7:06:20 ET]
Table 'Lucidor II' 9-max Seat #2 is the button
Seat 2: Mobile92 ($40 in chips) 
Seat 4: matiko09 ($100 in chips) 
Seat 5: hammerwife ($100 in chips) 
Seat 6: R1aki ($100 in chips) 
Seat 7: PacPacBum ($100 in chips) 
matiko09: posts small blind $0.50
hammerwife: posts big blind $1
*** HOLE CARDS ***
Dealt to matiko09 [9c 7d]
R1aki: raises $1.50 to $2.50
PacPacBum: folds 
ardo888 joins the table at seat #8 
PacPacBum leaves the table
Mobile92: folds 
matiko09: folds 
hammerwife: folds 
Uncalled bet ($1.50) returned to R1aki
R1aki collected $2.50 from pot
R1aki: doesn't show hand 
*** SUMMARY ***
Total pot $2.50 | Rake $0 
Seat 2: Mobile92 (button) folded before Flop (didn't bet)
Seat 4: matiko09 (small blind) folded before Flop
Seat 5: hammerwife (big blind) folded before Flop
Seat 6: R1aki collected ($2.50)
Seat 7: PacPacBum folded before Flop (didn't bet)





PokerStars Hand #154363658715:  Hold'em No Limit ($0.50/$1.00 USD) - 2016/06/06 13:06:32 CET [2016/06/06 7:06:32 ET]
Table 'Lucidor II' 9-max Seat #4 is the button
Seat 2: Mobile92 ($40 in chips) 
Seat 4: matiko09 ($100 in chips) 
Seat 5: hammerwife ($100 in chips) 
Seat 6: R1aki ($101.50 in chips) 
hammerwife: posts small blind $0.50
R1aki: posts big blind $1
ardo888: sits out 
*** HOLE CARDS ***
Dealt to matiko09 [Ad Js]
vanilica joins the table at seat #7 
Mobile92: raises $2.50 to $3.50
o.miro joins the table at seat #3 
matiko09: calls $3.50
ozone2003 joins the table at seat #9 
xxxZeka leaves the table
hammerwife: calls $3
hurtNCYDE joins the table at seat #1 
hurtNCYDE leaves the table
R1aki: folds 
*** FLOP *** [As 3c 4h]
Eskimo Fox joins the table at seat #1 
hammerwife: checks 
Mobile92: checks 
matiko09: checks 
*** TURN *** [As 3c 4h] [3d]
hammerwife: checks 
Mobile92: bets $10.92
matiko09: calls $10.92
hammerwife: folds 
*** RIVER *** [As 3c 4h 3d] [Qh]
Mobile92: bets $25.58 and is all-in
matiko09: calls $25.58
*** SHOW DOWN ***
Mobile92: shows [Ks 2d] (a pair of Threes)
matiko09: shows [Ad Js] (two pair, Aces and Threes)
matiko09 collected $83.50 from pot
*** SUMMARY ***
Total pot $84.50 | Rake $1 
Board [As 3c 4h 3d Qh]
Seat 2: Mobile92 showed [Ks 2d] and lost with a pair of Threes
Seat 4: matiko09 (button) showed [Ad Js] and won ($83.50) with two pair, Aces and Threes
Seat 5: hammerwife (small blind) folded on the Turn
Seat 6: R1aki (big blind) folded before Flop





PokerStars Hand #154363658840:  Hold'em No Limit ($0.50/$1.00 USD) - 2016/06/06 13:06:33 CET [2016/06/06 7:06:33 ET]
Table 'Heze' 9-max Seat #5 is the button
Seat 1: matiko09 ($170.55 in chips) 
Seat 3: ozone2003 ($122.29 in chips) 
Seat 4: ardo888 ($100 in chips) 
Seat 5: stds st ($34.50 in chips) 
Seat 6: yfcq36 ($134.91 in chips) 
Seat 7: 32rrew ($170.97 in chips) 
Seat 8: PacPacBum ($120.20 in chips) 
Seat 9: Mr.Grigoriy ($133.71 in chips) 
yfcq36: posts small blind $0.50
32rrew: posts big blind $1
*** HOLE CARDS ***
Dealt to matiko09 [Jc Qc]
PacPacBum: folds 
Mr.Grigoriy: folds 
matiko09: raises $2 to $3
xxxibgdrgn joins the table at seat #2 
ozone2003: calls $3
ardo888: folds 
stds st: folds 
yfcq36: folds 
32rrew: folds 
*** FLOP *** [Qs Kh Qh]
matiko09: checks 
ozone2003: checks 
*** TURN *** [Qs Kh Qh] [8h]
matiko09: bets $4.63
ozone2003: folds 
Uncalled bet ($4.63) returned to matiko09
matiko09 collected $7.12 from pot
matiko09: doesn't show hand 
*** SUMMARY ***
Total pot $7.50 | Rake $0.38 
Board [Qs Kh Qh 8h]
Seat 1: matiko09 collected ($7.12)
Seat 3: ozone2003 folded on the Turn
Seat 4: ardo888 folded before Flop (didn't bet)
Seat 5: stds st (button) folded before Flop (didn't bet)
Seat 6: yfcq36 (small blind) folded before Flop
Seat 7: 32rrew (big blind) folded before Flop
Seat 8: PacPacBum folded before Flop (didn't bet)
Seat 9: Mr.Grigoriy folded before Flop (didn't bet)





PokerStars Hand #154363659333:  Hold'em No Limit ($0.50/$1.00 USD) - 2016/06/06 13:06:34 CET [2016/06/06 7:06:34 ET]
Table 'Sheliak' 9-max Seat #6 is the button
Seat 1: 32rrew ($101.50 in chips) 
Seat 2: DancerNN1 ($100 in chips) 
Seat 5: hammerwife ($100.50 in chips) 
Seat 6: matiko09 ($100 in chips) 
Seat 7: stds st ($33.85 in chips) 
Seat 8: ozone2003 ($100 in chips) 
Seat 9: Szevasztopol ($101.50 in chips) 
stds st: posts small blind $0.50
ozone2003: posts big blind $1
iRLM: sits out 
*** HOLE CARDS ***
Dealt to matiko09 [8d 8s]
Szevasztopol: raises $1.14 to $2.14
32rrew: folds 
DancerNN1: folds 
hammerwife: folds 
matiko09: calls $2.14
stds st: folds 
ozone2003: folds 
*** FLOP *** [6h Qh Ah]
Szevasztopol: checks 
matiko09: checks 
*** TURN *** [6h Qh Ah] [Kh]
Szevasztopol: checks 
matiko09: checks 
*** RIVER *** [6h Qh Ah Kh] [2d]
Szevasztopol: bets $3.62
matiko09: folds 
Uncalled bet ($3.62) returned to Szevasztopol
Szevasztopol collected $5.49 from pot
Szevasztopol: doesn't show hand 
*** SUMMARY ***
Total pot $5.78 | Rake $0.29 
Board [6h Qh Ah Kh 2d]
Seat 1: 32rrew folded before Flop (didn't bet)
Seat 2: DancerNN1 folded before Flop (didn't bet)
Seat 5: hammerwife folded before Flop (didn't bet)
Seat 6: matiko09 (button) folded on the River
Seat 7: stds st (small blind) folded before Flop
Seat 8: ozone2003 (big blind) folded before Flop
Seat 9: Szevasztopol collected ($5.49)





PokerStars Hand #154363664664:  Hold'em No Limit ($0.50/$1.00 USD) - 2016/06/06 13:06:46 CET [2016/06/06 7:06:46 ET]
Table 'Smither' 9-max Seat #2 is the button
Seat 1: PacPacBum ($172.60 in chips) 
Seat 2: matiko09 ($100 in chips) 
Seat 3: xxxZeka ($129.57 in chips) 
Seat 5: Szevasztopol ($123.62 in chips) 
Seat 6: mooose100 ($81.26 in chips) 
Seat 7: vanilica ($100 in chips) 
Seat 9: hammerwife ($127.25 in chips) 
xxxZeka: posts small blind $0.50
Szevasztopol: posts big blind $1
*** HOLE CARDS ***
Dealt to matiko09 [3d Ah]
mooose100: folds 
vanilica: raises $1.85 to $2.85
hammerwife: folds 
PacPacBum: folds 
matiko09: folds 
xxxZeka: folds 
Szevasztopol: folds 
Uncalled bet ($1.85) returned to vanilica
vanilica collected $2.50 from pot
vanilica: doesn't show hand 
*** SUMMARY ***
Total pot $2.50 | Rake $0 
Seat 1: PacPacBum folded before Flop (didn't bet)
Seat 2: matiko09 (button) folded before Flop (didn't bet)
Seat 3: xxxZeka (small blind) folded before Flop
Seat 5: Szevasztopol (big blind) folded before Flop
Seat 6: mooose100 folded before Flop (didn't bet)
Seat 7: vanilica collected ($2.50)
Seat 9: hammerwife folded before Flop (didn't bet)





PokerStars Hand #154363666630:  Hold'em No Limit ($0.50/$1.00 USD) - 2016/06/06 13:06:51 CET [2016/06/06 7:06:51 ET]
Table 'Williams' 9-max Seat #1 is the button
Seat 1: matiko09 ($176.01 in chips) 
Seat 2: PacPacBum ($115.50 in chips) 
Seat 3: granbunny ($68.05 in chips) 
Seat 4: Mr.Grigoriy ($100.50 in chips) 
Seat 5: xxxibgdrgn ($100 in chips) 
Seat 6: xxxZeka ($138.17 in chips) 
Seat 7: kevinho109 ($30.09 in chips) 
Seat 9: stds st ($37 in chips) 
PacPacBum: posts small blind $0.50
granbunny: posts big blind $1
Dickyxxx: sits out 
*** HOLE CARDS ***
Dealt to matiko09 [Ts 6h]
Mr.Grigoriy: folds 
xxxibgdrgn: folds 
xxxZeka: folds 
kevinho109: folds 
stds st: folds 
matiko09: folds 
PacPacBum: folds 
Uncalled bet ($0.50) returned to granbunny
granbunny collected $1 from pot
granbunny: doesn't show hand 
*** SUMMARY ***
Total pot $1 | Rake $0 
Seat 1: matiko09 (button) folded before Flop (didn't bet)
Seat 2: PacPacBum (small blind) folded before Flop
Seat 3: granbunny (big blind) collected ($1)
Seat 4: Mr.Grigoriy folded before Flop (didn't bet)
Seat 5: xxxibgdrgn folded before Flop (didn't bet)
Seat 6: xxxZeka folded before Flop (didn't bet)
Seat 7: kevinho109 folded before Flop (didn't bet)
Seat 9: stds st folded before Flop (didn't bet)





PokerStars Hand #154363667003:  Hold'em No Limit ($0.50/$1.00 USD) - 2016/06/06 13:06:52 CET [2016/06/06 7:06:52 ET]
Table 'Wezen II' 9-max Seat #6 is the button
Seat 1: matiko09 ($180.32 in chips) 
Seat 2: Mr.Grigoriy ($117.12 in chips) 
Seat 4: xxxibgdrgn ($100 in chips) 
Seat 5: stds st ($31.65 in chips) 
Seat 6: vanilica ($100 in chips) 
Seat 7: KDJAll3 ($78.06 in chips) 
Seat 8: o.miro ($100 in chips) 
Seat 9: PacPacBum ($104 in chips) 
KDJAll3: posts small blind $0.50
o.miro: posts big blind $1
Dickyxxx: sits out 
*** HOLE CARDS ***
Dealt to matiko09 [9d 2d]
PacPacBum: folds 
matiko09: folds 
Mr.Grigoriy: folds 
xxxibgdrgn: folds 
stds st: folds 
vanilica: folds 
KDJAll3: calls $0.50
o.miro: checks 
*** FLOP *** [7h 5s Jd]
KDJAll3: bets $1
o.miro: folds 
Uncalled bet ($1) returned to KDJAll3
KDJAll3 collected $1.90 from pot
KDJAll3: doesn't show hand 
*** SUMMARY ***
Total pot $2 | Rake $0.10 
Board [7h 5s Jd]
Seat 1: matiko09 folded before Flop (didn't bet)
Seat 2: Mr.Grigoriy folded before Flop (didn't bet)
Seat 4: xxxibgdrgn folded before Flop (didn't bet)
Seat 5: stds st folded before Flop (didn't bet)
Seat 6: vanilica (button) folded before Flop (didn't bet)
Seat 7: KDJAll3 (small blind) collected ($1.90)
Seat 8: o.miro (big blind) folded on the Flop
Seat 9: PacPacBum folded before Flop (didn't bet)





PokerStars Hand #154363667896:  Hold'em No Limit ($0.50/$1.00 USD) - 2016/06/06 13:06:54 CET [2016/06/06 7:06:54 ET]
Table 'Chaldaea II' 9-max Seat #6 is the button
Seat 1: Szevasztopol ($108.58 in chips) 
Seat 3: ardo888 ($108.85 in chips) 
Seat 4: mooose100 ($123.63 in chips) 
Seat 5: stds st ($27.74 in chips) 
Seat 6: PacPacBum ($100.50 in chips) 
Seat 8: 32rrew ($100 in chips) 
Seat 9: matiko09 ($100 in chips) 
xxxibgdrgn will be allowed to play after the button
32rrew: posts small blind $0.50
matiko09: posts big blind $1
Mr.Grigoriy: sits out 
*** HOLE CARDS ***
Dealt to matiko09 [4s 8d]
Szevasztopol: folds 
ardo888: folds 
mooose100: folds 
stds st: folds 
PacPacBum: folds 
32rrew: folds 
Uncalled bet ($0.50) returned to matiko09
matiko09 collected $1 from pot
matiko09: doesn't show hand 
*** SUMMARY ***
Total pot $1 | Rake $0 
Seat 1: Szevasztopol folded before Flop (didn't bet)
Seat 3: ardo888 folded before Flop (didn't bet)
Seat 4: mooose100 folded before Flop (didn't bet)
Seat 5: stds st folded before Flop (didn't bet)
Seat 6: PacPacBum (button) folded before Flop (didn't bet)
Seat 8: 32rrew (small blind) folded before Flop
Seat 9: matiko09 (big blind) collected ($1)





PokerStars Hand #154363670862:  Hold'em No Limit ($0.50/$1.00 USD) - 2016/06/06 13:07:01 CET [2016/06/06 7:07:01 ET]
Table 'Gajdariya' 9-max Seat #8 is the button
Seat 1: matiko09 ($137.67 in chips) 
Seat 2: xxxZeka ($170.41 in chips) 
Seat 4: Szevasztopol ($132.90 in chips) 
Seat 5: stds st ($37.50 in chips) 
Seat 6: Dantist1122 ($104 in chips) 
Seat 7: Wombatkilla ($60.89 in chips) 
Seat 8: ardo888 ($150.47 in chips) 
matiko09: posts small blind $0.50
xxxZeka: posts big blind $1
*** HOLE CARDS ***
Dealt to matiko09 [Qs 8h]
Szevasztopol: folds 
stds st: folds 
PacPacBum joins the table at seat #9 
Dantist1122: folds 
Wombatkilla: folds 
ardo888: raises $1.50 to $2.50
matiko09: folds 
xxxZeka: folds 
Uncalled bet ($1.50) returned to ardo888
ardo888 collected $2.50 from pot
ardo888: doesn't show hand 
*** SUMMARY ***
Total pot $2.50 | Rake $0 
Seat 1: matiko09 (small blind) folded before Flop
Seat 2: xxxZeka (big blind) folded before Flop
Seat 4: Szevasztopol folded before Flop (didn't bet)
Seat 5: stds st folded before Flop (didn't bet)
Seat 6: Dantist1122 folded before Flop (didn't bet)
Seat 7: Wombatkilla folded before Flop (didn't bet)
Seat 8: ardo888 (button) collected ($2.50)





PokerStars Hand #154363673867:  Hold'em No Limit ($0.50/$1.00 USD) - 2016/06/06 13:07:08 CET [2016/06/06 7:07:08 ET]
Table 'Smither' 9-max Seat #3 is the button
Seat 1: PacPacBum ($172.60 in chips) 
Seat 2: matiko09 ($100 in chips) 
Seat 3: xxxZeka ($129.07 in chips) 
Seat 5: Szevasztopol ($122.62 in chips) 
Seat 6: mooose100 ($81.26 in chips) 
Seat 7: vanilica ($101.50 in chips) 
Seat 9: hammerwife ($127.25 in chips) 
Szevasztopol: posts small blind $0.50
mooose100: posts big blind $1
*** HOLE CARDS ***
Dealt to matiko09 [As 3h]
vanilica: raises $1.85 to $2.85
hammerwife: folds 
PacPacBum: folds 
matiko09: folds 
xxxZeka: folds 
Szevasztopol: folds 
mooose100: calls $1.85
*** FLOP *** [5s Jh 7d]
mooose100: checks 
vanilica: checks 
*** TURN *** [5s Jh 7d] [Js]
mooose100: bets $2.94
vanilica: calls $2.94
*** RIVER *** [5s Jh 7d Js] [9s]
mooose100: checks 
vanilica: bets $8.61
mooose100: folds 
Uncalled bet ($8.61) returned to vanilica
vanilica collected $11.48 from pot
vanilica: doesn't show hand 
*** SUMMARY ***
Total pot $12.08 | Rake $0.60 
Board [5s Jh 7d Js 9s]
Seat 1: PacPacBum folded before Flop (didn't bet)
Seat 2: matiko09 folded before Flop (didn't bet)
Seat 3: xxxZeka (button) folded before Flop (didn't bet)
Seat 5: Szevasztopol (small blind) folded before Flop
Seat 6: mooose100 (big blind) folded on the River
Seat 7: vanilica collected ($11.48)
Seat 9: hammerwife folded before Flop (didn't bet)





PokerStars Hand #154363676762:  Hold'em No Limit ($0.50/$1.00 USD) - 2016/06/06 13:07:15 CET [2016/06/06 7:07:15 ET]
Table 'Heze' 9-max Seat #6 is the button
Seat 1: matiko09 ($174.67 in chips) 
Seat 3: ozone2003 ($119.29 in chips) 
Seat 4: ardo888 ($100 in chips) 
Seat 5: stds st ($34.50 in chips) 
Seat 6: yfcq36 ($134.41 in chips) 
Seat 7: 32rrew ($169.97 in chips) 
Seat 8: PacPacBum ($120.20 in chips) 
Seat 9: Mr.Grigoriy ($133.71 in chips) 
32rrew: posts small blind $0.50
PacPacBum: posts big blind $1
xxxibgdrgn: sits out 
*** HOLE CARDS ***
Dealt to matiko09 [Qd Ts]
Mr.Grigoriy: folds 
matiko09: folds 
ozone2003: raises $2 to $3
ardo888: folds 
stds st: folds 
yfcq36: raises $3 to $6
32rrew: folds 
PacPacBum: folds 
ozone2003: raises $15 to $21
yfcq36: folds 
Uncalled bet ($15) returned to ozone2003
ozone2003 collected $13.50 from pot
ozone2003: doesn't show hand 
*** SUMMARY ***
Total pot $13.50 | Rake $0 
Seat 1: matiko09 folded before Flop (didn't bet)
Seat 3: ozone2003 collected ($13.50)
Seat 4: ardo888 folded before Flop (didn't bet)
Seat 5: stds st folded before Flop (didn't bet)
Seat 6: yfcq36 (button) folded before Flop
Seat 7: 32rrew (small blind) folded before Flop
Seat 8: PacPacBum (big blind) folded before Flop
Seat 9: Mr.Grigoriy folded before Flop (didn't bet)





PokerStars Hand #154363678062:  Hold'em No Limit ($0.50/$1.00 USD) - 2016/06/06 13:07:18 CET [2016/06/06 7:07:18 ET]
Table 'Williams' 9-max Seat #2 is the button
Seat 1: matiko09 ($176.01 in chips) 
Seat 2: PacPacBum ($115 in chips) 
Seat 3: granbunny ($68.55 in chips) 
Seat 4: Mr.Grigoriy ($100.50 in chips) 
Seat 5: xxxibgdrgn ($100 in chips) 
Seat 6: xxxZeka ($138.17 in chips) 
Seat 7: kevinho109 ($30.09 in chips) 
Seat 9: stds st ($37 in chips) 
granbunny: posts small blind $0.50
Mr.Grigoriy: posts big blind $1
Dickyxxx: sits out 
*** HOLE CARDS ***
Dealt to matiko09 [Td 7d]
xxxibgdrgn: folds 
xxxZeka: folds 
kevinho109: folds 
stds st: raises $1.50 to $2.50
matiko09: folds 
PacPacBum: folds 
granbunny: folds 
Mr.Grigoriy: folds 
Uncalled bet ($1.50) returned to stds st
stds st collected $2.50 from pot
stds st: doesn't show hand 
*** SUMMARY ***
Total pot $2.50 | Rake $0 
Seat 1: matiko09 folded before Flop (didn't bet)
Seat 2: PacPacBum (button) folded before Flop (didn't bet)
Seat 3: granbunny (small blind) folded before Flop
Seat 4: Mr.Grigoriy (big blind) folded before Flop
Seat 5: xxxibgdrgn folded before Flop (didn't bet)
Seat 6: xxxZeka folded before Flop (didn't bet)
Seat 7: kevinho109 folded before Flop (didn't bet)
Seat 9: stds st collected ($2.50)





PokerStars Hand #154363678805:  Hold'em No Limit ($0.50/$1.00 USD) - 2016/06/06 13:07:20 CET [2016/06/06 7:07:20 ET]
Table 'Chaldaea II' 9-max Seat #8 is the button
Seat 1: Szevasztopol ($108.58 in chips) 
Seat 3: ardo888 ($108.85 in chips) 
Seat 4: mooose100 ($123.63 in chips) 
Seat 5: stds st ($27.74 in chips) 
Seat 6: PacPacBum ($100.50 in chips) 
Seat 8: 32rrew ($100 in chips) 
Seat 9: matiko09 ($100.50 in chips) 
matiko09: posts small blind $0.50
Szevasztopol: posts big blind $1
Mr.Grigoriy: sits out 
xxxibgdrgn: sits out 
*** HOLE CARDS ***
Dealt to matiko09 [Td Ah]
ardo888: raises $2 to $3
mooose100: folds 
stds st: folds 
PacPacBum: folds 
32rrew: folds 
matiko09: folds 
Szevasztopol: folds 
Uncalled bet ($2) returned to ardo888
ardo888 collected $2.50 from pot
ardo888: doesn't show hand 
*** SUMMARY ***
Total pot $2.50 | Rake $0 
Seat 1: Szevasztopol (big blind) folded before Flop
Seat 3: ardo888 collected ($2.50)
Seat 4: mooose100 folded before Flop (didn't bet)
Seat 5: stds st folded before Flop (didn't bet)
Seat 6: PacPacBum folded before Flop (didn't bet)
Seat 8: 32rrew (button) folded before Flop (didn't bet)
Seat 9: matiko09 (small blind) folded before Flop





PokerStars Hand #154363683650:  Hold'em No Limit ($0.50/$1.00 USD) - 2016/06/06 13:07:32 CET [2016/06/06 7:07:32 ET]
Table 'Gajdariya' 9-max Seat #1 is the button
Seat 1: matiko09 ($137.17 in chips) 
Seat 2: xxxZeka ($169.41 in chips) 
Seat 4: Szevasztopol ($132.90 in chips) 
Seat 5: stds st ($37.50 in chips) 
Seat 6: Dantist1122 ($104 in chips) 
Seat 7: Wombatkilla ($60.89 in chips) 
Seat 8: ardo888 ($151.97 in chips) 
xxxZeka: posts small blind $0.50
Szevasztopol: posts big blind $1
PacPacBum: sits out 
*** HOLE CARDS ***
Dealt to matiko09 [Ts 9s]
stds st: raises $1.50 to $2.50
Dantist1122: folds 
Wombatkilla: calls $2.50
ardo888: folds 
matiko09: calls $2.50
mooose100 joins the table at seat #3 
xxxZeka: folds 
Szevasztopol: folds 
*** FLOP *** [7s Jh 2d]
stds st: bets $5.13
Wombatkilla: calls $5.13
matiko09: calls $5.13
*** TURN *** [7s Jh 2d] [7c]
stds st: checks 
Wombatkilla: bets $11
matiko09: folds 
stds st: raises $18.87 to $29.87 and is all-in
Wombatkilla: calls $18.87
*** RIVER *** [7s Jh 2d 7c] [3s]
*** SHOW DOWN ***
stds st: shows [As Jc] (two pair, Jacks and Sevens)
Wombatkilla: shows [Js Qd] (two pair, Jacks and Sevens - lower kicker)
stds st collected $81.63 from pot
*** SUMMARY ***
Total pot $84.13 | Rake $2.50 
Board [7s Jh 2d 7c 3s]
Seat 1: matiko09 (button) folded on the Turn
Seat 2: xxxZeka (small blind) folded before Flop
Seat 4: Szevasztopol (big blind) folded before Flop
Seat 5: stds st showed [As Jc] and won ($81.63) with two pair, Jacks and Sevens
Seat 6: Dantist1122 folded before Flop (didn't bet)
Seat 7: Wombatkilla showed [Js Qd] and lost with two pair, Jacks and Sevens
Seat 8: ardo888 folded before Flop (didn't bet)





PokerStars Hand #154363685107:  Hold'em No Limit ($0.50/$1.00 USD) - 2016/06/06 13:07:35 CET [2016/06/06 7:07:35 ET]
Table 'Wezen II' 9-max Seat #7 is the button
Seat 1: matiko09 ($180.32 in chips) 
Seat 2: Mr.Grigoriy ($117.12 in chips) 
Seat 4: xxxibgdrgn ($100 in chips) 
Seat 5: stds st ($31.65 in chips) 
Seat 6: vanilica ($100 in chips) 
Seat 7: KDJAll3 ($78.96 in chips) 
Seat 8: o.miro ($100 in chips) 
Seat 9: PacPacBum ($104 in chips) 
o.miro: posts small blind $0.50
PacPacBum: posts big blind $1
Dickyxxx: sits out 
*** HOLE CARDS ***
Dealt to matiko09 [Ah 4h]
matiko09: folds 
Mr.Grigoriy: folds 
xxxibgdrgn: folds 
stds st: folds 
vanilica: folds 
KDJAll3: raises $1 to $2
o.miro: folds 
PacPacBum: folds 
Uncalled bet ($1) returned to KDJAll3
KDJAll3 collected $2.50 from pot
KDJAll3: doesn't show hand 
*** SUMMARY ***
Total pot $2.50 | Rake $0 
Seat 1: matiko09 folded before Flop (didn't bet)
Seat 2: Mr.Grigoriy folded before Flop (didn't bet)
Seat 4: xxxibgdrgn folded before Flop (didn't bet)
Seat 5: stds st folded before Flop (didn't bet)
Seat 6: vanilica folded before Flop (didn't bet)
Seat 7: KDJAll3 (button) collected ($2.50)
Seat 8: o.miro (small blind) folded before Flop
Seat 9: PacPacBum (big blind) folded before Flop





PokerStars Hand #154363691817:  Hold'em No Limit ($0.50/$1.00 USD) - 2016/06/06 13:07:51 CET [2016/06/06 7:07:51 ET]
Table 'Sheliak' 9-max Seat #7 is the button
Seat 1: 32rrew ($101.50 in chips) 
Seat 2: DancerNN1 ($100 in chips) 
Seat 5: hammerwife ($100.50 in chips) 
Seat 6: matiko09 ($100 in chips) 
Seat 7: stds st ($33.35 in chips) 
Seat 8: ozone2003 ($100 in chips) 
Seat 9: Szevasztopol ($104.85 in chips) 
ozone2003: posts small blind $0.50
Szevasztopol: posts big blind $1
iRLM: sits out 
*** HOLE CARDS ***
Dealt to matiko09 [Ah Kc]
32rrew: raises $2 to $3
DancerNN1: folds 
hammerwife: folds 
matiko09: calls $3
stds st: folds 
ozone2003: folds 
Szevasztopol: folds 
*** FLOP *** [5d 5s Th]
32rrew: bets $4.74
xxxZeka joins the table at seat #3 
matiko09: calls $4.74
*** TURN *** [5d 5s Th] [9c]
32rrew: checks 
matiko09: checks 
*** RIVER *** [5d 5s Th 9c] [4s]
32rrew: checks 
matiko09: checks 
*** SHOW DOWN ***
32rrew: shows [As Kd] (a pair of Fives)
matiko09: shows [Ah Kc] (a pair of Fives)
32rrew collected $8.07 from pot
matiko09 collected $8.06 from pot
*** SUMMARY ***
Total pot $16.98 | Rake $0.85 
Board [5d 5s Th 9c 4s]
Seat 1: 32rrew showed [As Kd] and won ($8.07) with a pair of Fives
Seat 2: DancerNN1 folded before Flop (didn't bet)
Seat 5: hammerwife folded before Flop (didn't bet)
Seat 6: matiko09 showed [Ah Kc] and won ($8.06) with a pair of Fives
Seat 7: stds st (button) folded before Flop (didn't bet)
Seat 8: ozone2003 (small blind) folded before Flop
Seat 9: Szevasztopol (big blind) folded before Flop





PokerStars Hand #154363695188:  Hold'em No Limit ($0.50/$1.00 USD) - 2016/06/06 13:07:59 CET [2016/06/06 7:07:59 ET]
Table 'Williams' 9-max Seat #3 is the button
Seat 1: matiko09 ($176.01 in chips) 
Seat 2: PacPacBum ($115 in chips) 
Seat 3: granbunny ($68.05 in chips) 
Seat 4: Mr.Grigoriy ($100 in chips) 
Seat 5: xxxibgdrgn ($100 in chips) 
Seat 6: xxxZeka ($138.17 in chips) 
Seat 7: kevinho109 ($30.09 in chips) 
Seat 9: stds st ($38.50 in chips) 
Mr.Grigoriy: posts small blind $0.50
xxxibgdrgn: posts big blind $1
Dickyxxx: sits out 
*** HOLE CARDS ***
Dealt to matiko09 [Qd 6c]
xxxZeka: folds 
kevinho109: folds 
stds st: folds 
matiko09: folds 
PacPacBum: raises $1.04 to $2.04
granbunny: calls $2.04
Mr.Grigoriy: folds 
xxxibgdrgn: folds 
*** FLOP *** [7d Tc 2c]
PacPacBum: checks 
granbunny: checks 
*** TURN *** [7d Tc 2c] [Kh]
PacPacBum: checks 
granbunny: checks 
*** RIVER *** [7d Tc 2c Kh] [7h]
PacPacBum: checks 
granbunny: bets $7
PacPacBum: folds 
Uncalled bet ($7) returned to granbunny
granbunny collected $5.30 from pot
granbunny: doesn't show hand 
*** SUMMARY ***
Total pot $5.58 | Rake $0.28 
Board [7d Tc 2c Kh 7h]
Seat 1: matiko09 folded before Flop (didn't bet)
Seat 2: PacPacBum folded on the River
Seat 3: granbunny (button) collected ($5.30)
Seat 4: Mr.Grigoriy (small blind) folded before Flop
Seat 5: xxxibgdrgn (big blind) folded before Flop
Seat 6: xxxZeka folded before Flop (didn't bet)
Seat 7: kevinho109 folded before Flop (didn't bet)
Seat 9: stds st folded before Flop (didn't bet)





PokerStars Hand #154363695514:  Hold'em No Limit ($0.50/$1.00 USD) - 2016/06/06 13:08:00 CET [2016/06/06 7:08:00 ET]
Table 'Chaldaea II' 9-max Seat #9 is the button
Seat 1: Szevasztopol ($107.58 in chips) 
Seat 2: Mr.Grigoriy ($100 in chips) 
Seat 3: ardo888 ($110.35 in chips) 
Seat 4: mooose100 ($123.63 in chips) 
Seat 5: stds st ($27.74 in chips) 
Seat 6: PacPacBum ($100.50 in chips) 
Seat 8: 32rrew ($100 in chips) 
Seat 9: matiko09 ($100 in chips) 
Szevasztopol: posts small blind $0.50
Mr.Grigoriy: posts big blind $1
xxxibgdrgn: sits out 
*** HOLE CARDS ***
Dealt to matiko09 [4h Qs]
ardo888: folds 
mooose100: folds 
stds st: folds 
PacPacBum: folds 
32rrew: raises $2 to $3
matiko09: folds 
Szevasztopol: folds 
Mr.Grigoriy: folds 
Uncalled bet ($2) returned to 32rrew
32rrew collected $2.50 from pot
32rrew: doesn't show hand 
*** SUMMARY ***
Total pot $2.50 | Rake $0 
Seat 1: Szevasztopol (small blind) folded before Flop
Seat 2: Mr.Grigoriy (big blind) folded before Flop
Seat 3: ardo888 folded before Flop (didn't bet)
Seat 4: mooose100 folded before Flop (didn't bet)
Seat 5: stds st folded before Flop (didn't bet)
Seat 6: PacPacBum folded before Flop (didn't bet)
Seat 8: 32rrew collected ($2.50)
Seat 9: matiko09 (button) folded before Flop (didn't bet)





PokerStars Hand #154363702079:  Hold'em No Limit ($0.50/$1.00 USD) - 2016/06/06 13:08:15 CET [2016/06/06 7:08:15 ET]
Table 'Wezen II' 9-max Seat #8 is the button
Seat 1: matiko09 ($180.32 in chips) 
Seat 2: Mr.Grigoriy ($117.12 in chips) 
Seat 4: xxxibgdrgn ($100 in chips) 
Seat 5: stds st ($31.65 in chips) 
Seat 6: vanilica ($100 in chips) 
Seat 7: KDJAll3 ($80.46 in chips) 
Seat 8: o.miro ($100 in chips) 
Seat 9: PacPacBum ($103 in chips) 
PacPacBum: posts small blind $0.50
matiko09: posts big blind $1
Dickyxxx: sits out 
*** HOLE CARDS ***
Dealt to matiko09 [6h Kd]
Mr.Grigoriy: folds 
xxxibgdrgn: folds 
stds st: folds 
vanilica: folds 
KDJAll3: folds 
o.miro: raises $1.50 to $2.50
PacPacBum: folds 
matiko09: folds 
Uncalled bet ($1.50) returned to o.miro
o.miro collected $2.50 from pot
o.miro: doesn't show hand 
*** SUMMARY ***
Total pot $2.50 | Rake $0 
Seat 1: matiko09 (big blind) folded before Flop
Seat 2: Mr.Grigoriy folded before Flop (didn't bet)
Seat 4: xxxibgdrgn folded before Flop (didn't bet)
Seat 5: stds st folded before Flop (didn't bet)
Seat 6: vanilica folded before Flop (didn't bet)
Seat 7: KDJAll3 folded before Flop (didn't bet)
Seat 8: o.miro (button) collected ($2.50)
Seat 9: PacPacBum (small blind) folded before Flop





PokerStars Hand #154363702199:  Hold'em No Limit (€0.50/€1.00 EUR) - 2016/06/06 13:08:16 CET [2016/06/06 7:08:16 ET]
Table 'Lesath' 9-max Seat #5 is the button
Seat 1: o.miro (€102.46 in chips) 
Seat 2: thecurv (€101.35 in chips) 
Seat 3: ozone2003 (€214.95 in chips) 
Seat 4: hammerwife (€127.11 in chips) 
Seat 5: matiko09 (€100 in chips) 
Seat 6: Szevasztopol (€146.03 in chips) 
Seat 7: Mr.Grigoriy (€106.82 in chips) 
Seat 9: 72nloses (€56.18 in chips) 
Szevasztopol: posts small blind €0.50
Mr.Grigoriy: posts big blind €1
*** HOLE CARDS ***
Dealt to matiko09 [Qc Qh]
72nloses has timed out
72nloses: folds 
o.miro: folds 
thecurv: folds 
ozone2003: folds 
hammerwife: folds 
matiko09: raises €1.27 to €2.27
Szevasztopol: folds 
Mr.Grigoriy: calls €1.27
*** FLOP *** [Qd 3s 9c]
Mr.Grigoriy: checks 
matiko09: checks 
*** TURN *** [Qd 3s 9c] [9s]
Mr.Grigoriy: bets €3.40
matiko09: calls €3.40
*** RIVER *** [Qd 3s 9c 9s] [Ks]
Mr.Grigoriy: bets €8.77
matiko09: raises €17.23 to €26
Mr.Grigoriy: folds 
Uncalled bet (€17.23) returned to matiko09
matiko09 collected €27.91 from pot
matiko09: doesn't show hand 
*** SUMMARY ***
Total pot €29.38 | Rake €1.47 
Board [Qd 3s 9c 9s Ks]
Seat 1: o.miro folded before Flop (didn't bet)
Seat 2: thecurv folded before Flop (didn't bet)
Seat 3: ozone2003 folded before Flop (didn't bet)
Seat 4: hammerwife folded before Flop (didn't bet)
Seat 5: matiko09 (button) collected (€27.91)
Seat 6: Szevasztopol (small blind) folded before Flop
Seat 7: Mr.Grigoriy (big blind) folded on the River
Seat 9: 72nloses folded before Flop (didn't bet)





PokerStars Hand #154363702934:  Hold'em No Limit ($0.50/$1.00 USD) - 2016/06/06 13:08:17 CET [2016/06/06 7:08:17 ET]
Table 'Heze' 9-max Seat #7 is the button
Seat 1: matiko09 ($174.67 in chips) 
Seat 3: ozone2003 ($126.79 in chips) 
Seat 4: ardo888 ($100 in chips) 
Seat 5: stds st ($34.50 in chips) 
Seat 6: yfcq36 ($128.41 in chips) 
Seat 7: 32rrew ($169.47 in chips) 
Seat 8: PacPacBum ($119.20 in chips) 
Seat 9: Mr.Grigoriy ($133.71 in chips) 
PacPacBum: posts small blind $0.50
Mr.Grigoriy: posts big blind $1
xxxibgdrgn: sits out 
*** HOLE CARDS ***
Dealt to matiko09 [7d 3h]
matiko09: folds 
ozone2003: folds 
ardo888: folds 
stds st: folds 
yfcq36: raises $2 to $3
32rrew: calls $3
PacPacBum: folds 
Mr.Grigoriy: folds 
*** FLOP *** [9h 8h 9s]
yfcq36: bets $4
32rrew: calls $4
*** TURN *** [9h 8h 9s] [2d]
yfcq36: bets $12
32rrew: folds 
Uncalled bet ($12) returned to yfcq36
yfcq36 collected $14.72 from pot
yfcq36: doesn't show hand 
*** SUMMARY ***
Total pot $15.50 | Rake $0.78 
Board [9h 8h 9s 2d]
Seat 1: matiko09 folded before Flop (didn't bet)
Seat 3: ozone2003 folded before Flop (didn't bet)
Seat 4: ardo888 folded before Flop (didn't bet)
Seat 5: stds st folded before Flop (didn't bet)
Seat 6: yfcq36 collected ($14.72)
Seat 7: 32rrew (button) folded on the Turn
Seat 8: PacPacBum (small blind) folded before Flop
Seat 9: Mr.Grigoriy (big blind) folded before Flop





PokerStars Hand #154363707232:  Hold'em No Limit ($0.50/$1.00 USD) - 2016/06/06 13:08:28 CET [2016/06/06 7:08:28 ET]
Table 'Lucidor II' 9-max Seat #5 is the button
Seat 4: matiko09 ($143.50 in chips) 
Seat 5: hammerwife ($100 in chips) 
Seat 6: R1aki ($100.50 in chips) 
Seat 7: vanilica ($100 in chips) 
R1aki: posts small blind $0.50
vanilica: posts big blind $1
ardo888: sits out 
ozone2003: sits out 
Eskimo Fox: sits out 
o.miro: sits out 
*** HOLE CARDS ***
Dealt to matiko09 [Th 8c]
Mobile92 leaves the table
xxxZeka joins the table at seat #2 
xxxZeka leaves the table
hurtNCYDE joins the table at seat #2 
hurtNCYDE leaves the table
matiko09: folds 
ozone2003 leaves the table
hammerwife: raises $1.01 to $2.01
o.miro leaves the table
R1aki: folds 
xhinostrabli joins the table at seat #3 
vanilica: folds 
Uncalled bet ($1.01) returned to hammerwife
hammerwife collected $2.50 from pot
hammerwife: doesn't show hand 
*** SUMMARY ***
Total pot $2.50 | Rake $0 
Seat 4: matiko09 folded before Flop (didn't bet)
Seat 5: hammerwife (button) collected ($2.50)
Seat 6: R1aki (small blind) folded before Flop
Seat 7: vanilica (big blind) folded before Flop





PokerStars Hand #154363709671:  Hold'em No Limit ($0.50/$1.00 USD) - 2016/06/06 13:08:34 CET [2016/06/06 7:08:34 ET]
Table 'Smither' 9-max Seat #5 is the button
Seat 1: PacPacBum ($172.60 in chips) 
Seat 2: matiko09 ($100 in chips) 
Seat 3: xxxZeka ($129.07 in chips) 
Seat 5: Szevasztopol ($122.12 in chips) 
Seat 6: mooose100 ($75.47 in chips) 
Seat 7: vanilica ($107.19 in chips) 
Seat 8: 74 ROADIE ($85.21 in chips) 
Seat 9: hammerwife ($127.25 in chips) 
mooose100: posts small blind $0.50
vanilica: posts big blind $1
*** HOLE CARDS ***
Dealt to matiko09 [2s 9s]
74 ROADIE: folds 
hammerwife: folds 
PacPacBum: folds 
matiko09: folds 
xxxZeka: folds 
Szevasztopol: folds 
mooose100: folds 
Uncalled bet ($0.50) returned to vanilica
vanilica collected $1 from pot
vanilica: doesn't show hand 
*** SUMMARY ***
Total pot $1 | Rake $0 
Seat 1: PacPacBum folded before Flop (didn't bet)
Seat 2: matiko09 folded before Flop (didn't bet)
Seat 3: xxxZeka folded before Flop (didn't bet)
Seat 5: Szevasztopol (button) folded before Flop (didn't bet)
Seat 6: mooose100 (small blind) folded before Flop
Seat 7: vanilica (big blind) collected ($1)
Seat 8: 74 ROADIE folded before Flop (didn't bet)
Seat 9: hammerwife folded before Flop (didn't bet)





PokerStars Hand #154363713366:  Hold'em No Limit ($0.50/$1.00 USD) - 2016/06/06 13:08:42 CET [2016/06/06 7:08:42 ET]
Table 'Chaldaea II' 9-max Seat #1 is the button
Seat 1: Szevasztopol ($107.08 in chips) 
Seat 2: Mr.Grigoriy ($100 in chips) 
Seat 3: ardo888 ($110.35 in chips) 
Seat 4: mooose100 ($123.63 in chips) 
Seat 5: stds st ($27.74 in chips) 
Seat 6: PacPacBum ($100.50 in chips) 
Seat 8: 32rrew ($101.50 in chips) 
Seat 9: matiko09 ($100 in chips) 
Mr.Grigoriy: posts small blind $0.50
ardo888: posts big blind $1
xxxibgdrgn: sits out 
*** HOLE CARDS ***
Dealt to matiko09 [Ts 9s]
mooose100: calls $1
stds st: folds 
PacPacBum: folds 
32rrew: folds 
matiko09: raises $3 to $4
Szevasztopol: folds 
Mr.Grigoriy: folds 
ardo888: folds 
mooose100: calls $3
*** FLOP *** [2h Jh Jc]
mooose100: checks 
matiko09: checks 
*** TURN *** [2h Jh Jc] [Jd]
mooose100: bets $4.51
matiko09: folds 
Uncalled bet ($4.51) returned to mooose100
mooose100 collected $9.02 from pot
mooose100: doesn't show hand 
*** SUMMARY ***
Total pot $9.50 | Rake $0.48 
Board [2h Jh Jc Jd]
Seat 1: Szevasztopol (button) folded before Flop (didn't bet)
Seat 2: Mr.Grigoriy (small blind) folded before Flop
Seat 3: ardo888 (big blind) folded before Flop
Seat 4: mooose100 collected ($9.02)
Seat 5: stds st folded before Flop (didn't bet)
Seat 6: PacPacBum folded before Flop (didn't bet)
Seat 8: 32rrew folded before Flop (didn't bet)
Seat 9: matiko09 folded on the Turn





PokerStars Hand #154363718618:  Hold'em No Limit ($0.50/$1.00 USD) - 2016/06/06 13:08:55 CET [2016/06/06 7:08:55 ET]
Table 'Wezen II' 9-max Seat #9 is the button
Seat 1: matiko09 ($179.32 in chips) 
Seat 2: Mr.Grigoriy ($117.12 in chips) 
Seat 4: xxxibgdrgn ($100 in chips) 
Seat 5: stds st ($31.65 in chips) 
Seat 6: vanilica ($100 in chips) 
Seat 7: KDJAll3 ($80.46 in chips) 
Seat 8: o.miro ($101.50 in chips) 
Seat 9: PacPacBum ($102.50 in chips) 
matiko09: posts small blind $0.50
Mr.Grigoriy: posts big blind $1
Dickyxxx: sits out 
*** HOLE CARDS ***
Dealt to matiko09 [Th 3h]
xxxibgdrgn: folds 
stds st: folds 
vanilica: folds 
KDJAll3: folds 
o.miro: raises $1.50 to $2.50
PacPacBum: folds 
matiko09: folds 
Mr.Grigoriy: folds 
Uncalled bet ($1.50) returned to o.miro
o.miro collected $2.50 from pot
o.miro: doesn't show hand 
*** SUMMARY ***
Total pot $2.50 | Rake $0 
Seat 1: matiko09 (small blind) folded before Flop
Seat 2: Mr.Grigoriy (big blind) folded before Flop
Seat 4: xxxibgdrgn folded before Flop (didn't bet)
Seat 5: stds st folded before Flop (didn't bet)
Seat 6: vanilica folded before Flop (didn't bet)
Seat 7: KDJAll3 folded before Flop (didn't bet)
Seat 8: o.miro collected ($2.50)
Seat 9: PacPacBum (button) folded before Flop (didn't bet)





PokerStars Hand #154363719956:  Hold'em No Limit ($0.50/$1.00 USD) - 2016/06/06 13:08:58 CET [2016/06/06 7:08:58 ET]
Table 'Lucidor II' 9-max Seat #6 is the button
Seat 4: matiko09 ($143.50 in chips) 
Seat 5: hammerwife ($101.50 in chips) 
Seat 6: R1aki ($100 in chips) 
Seat 7: vanilica ($100 in chips) 
Seat 8: ardo888 ($100 in chips) 
vanilica: posts small blind $0.50
ardo888: posts big blind $1
Eskimo Fox: sits out 
xhinostrabli: sits out 
*** HOLE CARDS ***
Dealt to matiko09 [Kc 5d]
matiko09: folds 
hammerwife: raises $1.50 to $2.50
R1aki: folds 
vanilica: folds 
ardo888: folds 
Uncalled bet ($1.50) returned to hammerwife
hammerwife collected $2.50 from pot
hammerwife: doesn't show hand 
*** SUMMARY ***
Total pot $2.50 | Rake $0 
Seat 4: matiko09 folded before Flop (didn't bet)
Seat 5: hammerwife collected ($2.50)
Seat 6: R1aki (button) folded before Flop (didn't bet)
Seat 7: vanilica (small blind) folded before Flop
Seat 8: ardo888 (big blind) folded before Flop





PokerStars Hand #154363720592:  Hold'em No Limit ($0.50/$1.00 USD) - 2016/06/06 13:08:59 CET [2016/06/06 7:08:59 ET]
Table 'Williams' 9-max Seat #4 is the button
Seat 1: matiko09 ($176.01 in chips) 
Seat 2: PacPacBum ($112.96 in chips) 
Seat 3: granbunny ($71.31 in chips) 
Seat 4: Mr.Grigoriy ($100 in chips) 
Seat 5: xxxibgdrgn ($100 in chips) 
Seat 6: xxxZeka ($138.17 in chips) 
Seat 7: kevinho109 ($30.09 in chips) 
Seat 9: stds st ($38.50 in chips) 
xxxibgdrgn: posts small blind $0.50
xxxZeka: posts big blind $1
Dickyxxx: sits out 
*** HOLE CARDS ***
Dealt to matiko09 [2h 8c]
kevinho109: folds 
stds st: folds 
kevinho109 leaves the table
hurtNCYDE joins the table at seat #7 
hurtNCYDE leaves the table
matiko09: folds 
PacPacBum: folds 
granbunny: folds 
Mr.Grigoriy: raises $1 to $2
xxxibgdrgn: folds 
Eskimo Fox joins the table at seat #7 
xxxZeka: folds 
Uncalled bet ($1) returned to Mr.Grigoriy
Mr.Grigoriy collected $2.50 from pot
Mr.Grigoriy: doesn't show hand 
*** SUMMARY ***
Total pot $2.50 | Rake $0 
Seat 1: matiko09 folded before Flop (didn't bet)
Seat 2: PacPacBum folded before Flop (didn't bet)
Seat 3: granbunny folded before Flop (didn't bet)
Seat 4: Mr.Grigoriy (button) collected ($2.50)
Seat 5: xxxibgdrgn (small blind) folded before Flop
Seat 6: xxxZeka (big blind) folded before Flop
Seat 7: kevinho109 folded before Flop (didn't bet)
Seat 9: stds st folded before Flop (didn't bet)





PokerStars Hand #154363720647:  Hold'em No Limit ($0.50/$1.00 USD) - 2016/06/06 13:08:59 CET [2016/06/06 7:08:59 ET]
Table 'Smither' 9-max Seat #6 is the button
Seat 1: PacPacBum ($172.60 in chips) 
Seat 2: matiko09 ($100 in chips) 
Seat 3: xxxZeka ($129.07 in chips) 
Seat 5: Szevasztopol ($122.12 in chips) 
Seat 6: mooose100 ($74.97 in chips) 
Seat 7: vanilica ($107.69 in chips) 
Seat 8: 74 ROADIE ($85.21 in chips) 
Seat 9: hammerwife ($127.25 in chips) 
vanilica: posts small blind $0.50
74 ROADIE: posts big blind $1
*** HOLE CARDS ***
Dealt to matiko09 [6c 8s]
hammerwife: folds 
PacPacBum: folds 
matiko09: folds 
xxxZeka: folds 
Szevasztopol: folds 
mooose100: folds 
vanilica: folds 
Uncalled bet ($0.50) returned to 74 ROADIE
74 ROADIE collected $1 from pot
*** SUMMARY ***
Total pot $1 | Rake $0 
Seat 1: PacPacBum folded before Flop (didn't bet)
Seat 2: matiko09 folded before Flop (didn't bet)
Seat 3: xxxZeka folded before Flop (didn't bet)
Seat 5: Szevasztopol folded before Flop (didn't bet)
Seat 6: mooose100 (button) folded before Flop (didn't bet)
Seat 7: vanilica (small blind) folded before Flop
Seat 8: 74 ROADIE (big blind) collected ($1)
Seat 9: hammerwife folded before Flop (didn't bet)





PokerStars Hand #154363723207:  Hold'em No Limit ($0.50/$1.00 USD) - 2016/06/06 13:09:05 CET [2016/06/06 7:09:05 ET]
Table 'Sheliak' 9-max Seat #8 is the button
Seat 1: 32rrew ($101.83 in chips) 
Seat 2: DancerNN1 ($100 in chips) 
Seat 5: hammerwife ($100.50 in chips) 
Seat 6: matiko09 ($100.32 in chips) 
Seat 7: stds st ($33.35 in chips) 
Seat 8: ozone2003 ($100 in chips) 
Seat 9: Szevasztopol ($103.85 in chips) 
Szevasztopol: posts small blind $0.50
32rrew: posts big blind $1
xxxZeka: sits out 
iRLM: sits out 
*** HOLE CARDS ***
Dealt to matiko09 [Kh 8h]
DancerNN1: folds 
hammerwife: raises $1.50 to $2.50
matiko09: folds 
stds st: folds 
ozone2003: folds 
Szevasztopol: folds 
32rrew: folds 
Uncalled bet ($1.50) returned to hammerwife
hammerwife collected $2.50 from pot
hammerwife: doesn't show hand 
*** SUMMARY ***
Total pot $2.50 | Rake $0 
Seat 1: 32rrew (big blind) folded before Flop
Seat 2: DancerNN1 folded before Flop (didn't bet)
Seat 5: hammerwife collected ($2.50)
Seat 6: matiko09 folded before Flop (didn't bet)
Seat 7: stds st folded before Flop (didn't bet)
Seat 8: ozone2003 (button) folded before Flop (didn't bet)
Seat 9: Szevasztopol (small blind) folded before Flop





PokerStars Hand #154363727244:  Hold'em No Limit ($0.50/$1.00 USD) - 2016/06/06 13:09:15 CET [2016/06/06 7:09:15 ET]
Table 'Lucidor II' 9-max Seat #7 is the button
Seat 1: Eskimo Fox ($100 in chips) 
Seat 4: matiko09 ($143.50 in chips) 
Seat 5: hammerwife ($103 in chips) 
Seat 6: R1aki ($100 in chips) 
Seat 7: vanilica ($100 in chips) 
Seat 8: ardo888 ($100 in chips) 
ardo888: posts small blind $0.50
Eskimo Fox: posts big blind $1
xhinostrabli: sits out 
*** HOLE CARDS ***
Dealt to matiko09 [5s 8h]
matiko09: folds 
hammerwife: folds 
R1aki: folds 
vanilica: folds 
ardo888: folds 
Uncalled bet ($0.50) returned to Eskimo Fox
Eskimo Fox collected $1 from pot
Eskimo Fox: doesn't show hand 
*** SUMMARY ***
Total pot $1 | Rake $0 
Seat 1: Eskimo Fox (big blind) collected ($1)
Seat 4: matiko09 folded before Flop (didn't bet)
Seat 5: hammerwife folded before Flop (didn't bet)
Seat 6: R1aki folded before Flop (didn't bet)
Seat 7: vanilica (button) folded before Flop (didn't bet)
Seat 8: ardo888 (small blind) folded before Flop





PokerStars Hand #154363727466:  Hold'em No Limit ($0.50/$1.00 USD) - 2016/06/06 13:09:15 CET [2016/06/06 7:09:15 ET]
Table 'Smither' 9-max Seat #7 is the button
Seat 1: PacPacBum ($172.60 in chips) 
Seat 2: matiko09 ($100 in chips) 
Seat 3: xxxZeka ($129.07 in chips) 
Seat 5: Szevasztopol ($122.12 in chips) 
Seat 6: mooose100 ($74.97 in chips) 
Seat 7: vanilica ($107.19 in chips) 
Seat 8: 74 ROADIE ($85.71 in chips) 
Seat 9: hammerwife ($127.25 in chips) 
74 ROADIE: posts small blind $0.50
hammerwife: posts big blind $1
*** HOLE CARDS ***
Dealt to matiko09 [Js Kh]
PacPacBum: folds 
matiko09: raises $2 to $3
xxxZeka: folds 
Szevasztopol: folds 
mooose100: folds 
vanilica: folds 
74 ROADIE: calls $2.50
hammerwife: raises $10 to $13
matiko09: folds 
74 ROADIE: folds 
Uncalled bet ($10) returned to hammerwife
hammerwife collected $9 from pot
hammerwife: doesn't show hand 
*** SUMMARY ***
Total pot $9 | Rake $0 
Seat 1: PacPacBum folded before Flop (didn't bet)
Seat 2: matiko09 folded before Flop
Seat 3: xxxZeka folded before Flop (didn't bet)
Seat 5: Szevasztopol folded before Flop (didn't bet)
Seat 6: mooose100 folded before Flop (didn't bet)
Seat 7: vanilica (button) folded before Flop (didn't bet)
Seat 8: 74 ROADIE (small blind) folded before Flop
Seat 9: hammerwife (big blind) collected ($9)





PokerStars Hand #154363729454:  Hold'em No Limit ($0.50/$1.00 USD) - 2016/06/06 13:09:20 CET [2016/06/06 7:09:20 ET]
Table 'Gajdariya' 9-max Seat #2 is the button
Seat 1: matiko09 ($129.54 in chips) 
Seat 2: xxxZeka ($168.91 in chips) 
Seat 4: Szevasztopol ($131.90 in chips) 
Seat 5: stds st ($81.63 in chips) 
Seat 6: Dantist1122 ($104 in chips) 
Seat 7: Wombatkilla ($23.39 in chips) 
Seat 8: ardo888 ($151.97 in chips) 
mooose100 will be allowed to play after the button
Szevasztopol: posts small blind $0.50
stds st: posts big blind $1
PacPacBum: sits out 
*** HOLE CARDS ***
Dealt to matiko09 [8h 4s]
Dantist1122: raises $2 to $3
Wombatkilla: folds 
Wombatkilla leaves the table
ardo888: folds 
hurtNCYDE joins the table at seat #7 
matiko09: folds 
xxxZeka: folds 
Szevasztopol: folds 
stds st: folds 
Uncalled bet ($2) returned to Dantist1122
Dantist1122 collected $2.50 from pot
Dantist1122: doesn't show hand 
*** SUMMARY ***
Total pot $2.50 | Rake $0 
Seat 1: matiko09 folded before Flop (didn't bet)
Seat 2: xxxZeka (button) folded before Flop (didn't bet)
Seat 4: Szevasztopol (small blind) folded before Flop
Seat 5: stds st (big blind) folded before Flop
Seat 6: Dantist1122 collected ($2.50)
Seat 7: Wombatkilla folded before Flop (didn't bet)
Seat 8: ardo888 folded before Flop (didn't bet)





PokerStars Hand #154363731148:  Hold'em No Limit ($0.50/$1.00 USD) - 2016/06/06 13:09:24 CET [2016/06/06 7:09:24 ET]
Table 'Williams' 9-max Seat #5 is the button
Seat 1: matiko09 ($176.01 in chips) 
Seat 2: PacPacBum ($112.96 in chips) 
Seat 3: granbunny ($71.31 in chips) 
Seat 4: Mr.Grigoriy ($101.50 in chips) 
Seat 5: xxxibgdrgn ($100 in chips) 
Seat 6: xxxZeka ($137.17 in chips) 
Seat 7: Eskimo Fox ($100 in chips) 
Seat 9: stds st ($38.50 in chips) 
xxxZeka: posts small blind $0.50
Eskimo Fox: posts big blind $1
Dickyxxx: sits out 
*** HOLE CARDS ***
Dealt to matiko09 [4d 3d]
stds st: folds 
matiko09: folds 
PacPacBum: raises $2 to $3
granbunny: folds 
Mr.Grigoriy: folds 
xxxibgdrgn: folds 
xxxZeka: calls $2.50
Eskimo Fox: calls $2
*** FLOP *** [4c 5h 7d]
xxxZeka: bets $6.41
Eskimo Fox: raises $11.59 to $18
PacPacBum: folds 
xxxZeka: folds 
Uncalled bet ($11.59) returned to Eskimo Fox
Eskimo Fox collected $20.73 from pot
Eskimo Fox: doesn't show hand 
*** SUMMARY ***
Total pot $21.82 | Rake $1.09 
Board [4c 5h 7d]
Seat 1: matiko09 folded before Flop (didn't bet)
Seat 2: PacPacBum folded on the Flop
Seat 3: granbunny folded before Flop (didn't bet)
Seat 4: Mr.Grigoriy folded before Flop (didn't bet)
Seat 5: xxxibgdrgn (button) folded before Flop (didn't bet)
Seat 6: xxxZeka (small blind) folded on the Flop
Seat 7: Eskimo Fox (big blind) collected ($20.73)
Seat 9: stds st folded before Flop (didn't bet)





PokerStars Hand #154363736355:  Hold'em No Limit ($0.50/$1.00 USD) - 2016/06/06 13:09:36 CET [2016/06/06 7:09:36 ET]
Table 'Heze' 9-max Seat #8 is the button
Seat 1: matiko09 ($174.67 in chips) 
Seat 3: ozone2003 ($126.79 in chips) 
Seat 4: ardo888 ($100 in chips) 
Seat 5: stds st ($34.50 in chips) 
Seat 6: yfcq36 ($136.13 in chips) 
Seat 7: 32rrew ($162.47 in chips) 
Seat 8: PacPacBum ($118.70 in chips) 
Seat 9: Mr.Grigoriy ($132.71 in chips) 
Mr.Grigoriy: posts small blind $0.50
matiko09: posts big blind $1
xxxibgdrgn: sits out 
*** HOLE CARDS ***
Dealt to matiko09 [3s Ts]
ozone2003: folds 
ardo888: raises $2 to $3
stds st: raises $4.50 to $7.50
yfcq36: folds 
32rrew: folds 
PacPacBum: folds 
Mr.Grigoriy: folds 
matiko09: folds 
ardo888: folds 
Uncalled bet ($4.50) returned to stds st
stds st collected $7.50 from pot
stds st: doesn't show hand 
*** SUMMARY ***
Total pot $7.50 | Rake $0 
Seat 1: matiko09 (big blind) folded before Flop
Seat 3: ozone2003 folded before Flop (didn't bet)
Seat 4: ardo888 folded before Flop
Seat 5: stds st collected ($7.50)
Seat 6: yfcq36 folded before Flop (didn't bet)
Seat 7: 32rrew folded before Flop (didn't bet)
Seat 8: PacPacBum (button) folded before Flop (didn't bet)
Seat 9: Mr.Grigoriy (small blind) folded before Flop





PokerStars Hand #154363737026:  Hold'em No Limit ($0.50/$1.00 USD) - 2016/06/06 13:09:38 CET [2016/06/06 7:09:38 ET]
Table 'Lucidor II' 9-max Seat #8 is the button
Seat 1: Eskimo Fox ($100.50 in chips) 
Seat 3: xhinostrabli ($80 in chips) 
Seat 4: matiko09 ($143.50 in chips) 
Seat 5: hammerwife ($103 in chips) 
Seat 6: R1aki ($100 in chips) 
Seat 7: vanilica ($100 in chips) 
Seat 8: ardo888 ($100 in chips) 
Eskimo Fox: posts small blind $0.50
xhinostrabli: posts big blind $1
*** HOLE CARDS ***
Dealt to matiko09 [Ts 6h]
matiko09: folds 
hammerwife: folds 
R1aki: folds 
vanilica: folds 
ardo888: raises $1.50 to $2.50
Eskimo Fox: folds 
xhinostrabli: folds 
Uncalled bet ($1.50) returned to ardo888
ardo888 collected $2.50 from pot
ardo888: doesn't show hand 
*** SUMMARY ***
Total pot $2.50 | Rake $0 
Seat 1: Eskimo Fox (small blind) folded before Flop
Seat 3: xhinostrabli (big blind) folded before Flop
Seat 4: matiko09 folded before Flop (didn't bet)
Seat 5: hammerwife folded before Flop (didn't bet)
Seat 6: R1aki folded before Flop (didn't bet)
Seat 7: vanilica folded before Flop (didn't bet)
Seat 8: ardo888 (button) collected ($2.50)





PokerStars Hand #154363737356:  Hold'em No Limit ($0.50/$1.00 USD) - 2016/06/06 13:09:39 CET [2016/06/06 7:09:39 ET]
Table 'Sheliak' 9-max Seat #9 is the button
Seat 1: 32rrew ($100.83 in chips) 
Seat 2: DancerNN1 ($100 in chips) 
Seat 5: hammerwife ($102 in chips) 
Seat 6: matiko09 ($100.32 in chips) 
Seat 7: stds st ($33.35 in chips) 
Seat 8: ozone2003 ($100 in chips) 
Seat 9: Szevasztopol ($103.35 in chips) 
32rrew: posts small blind $0.50
DancerNN1: posts big blind $1
xxxZeka: sits out 
iRLM: sits out 
*** HOLE CARDS ***
Dealt to matiko09 [Ah 2d]
hammerwife: folds 
matiko09: folds 
stds st: folds 
ozone2003: folds 
Szevasztopol: raises $1 to $2
32rrew: folds 
DancerNN1: folds 
Uncalled bet ($1) returned to Szevasztopol
Szevasztopol collected $2.50 from pot
Szevasztopol: doesn't show hand 
*** SUMMARY ***
Total pot $2.50 | Rake $0 
Seat 1: 32rrew (small blind) folded before Flop
Seat 2: DancerNN1 (big blind) folded before Flop
Seat 5: hammerwife folded before Flop (didn't bet)
Seat 6: matiko09 folded before Flop (didn't bet)
Seat 7: stds st folded before Flop (didn't bet)
Seat 8: ozone2003 folded before Flop (didn't bet)
Seat 9: Szevasztopol (button) collected ($2.50)





PokerStars Hand #154363738921:  Hold'em No Limit ($0.50/$1.00 USD) - 2016/06/06 13:09:42 CET [2016/06/06 7:09:42 ET]
Table 'Gajdariya' 9-max Seat #4 is the button
Seat 1: matiko09 ($129.54 in chips) 
Seat 2: xxxZeka ($168.91 in chips) 
Seat 4: Szevasztopol ($131.40 in chips) 
Seat 5: stds st ($80.63 in chips) 
Seat 7: hurtNCYDE ($100 in chips) 
Seat 8: ardo888 ($151.97 in chips) 
stds st: posts small blind $0.50
Dantist1122: is sitting out 
Dantist1122 leaves the table
hurtNCYDE: posts big blind $1
PacPacBum: sits out 
mooose100: sits out 
*** HOLE CARDS ***
Dealt to matiko09 [Qd 3h]
vanilica joins the table at seat #6 
ardo888: folds 
matiko09: folds 
xxxZeka: raises $2 to $3
Szevasztopol: folds 
stds st: folds 
hurtNCYDE: folds 
Uncalled bet ($2) returned to xxxZeka
xxxZeka collected $2.50 from pot
*** SUMMARY ***
Total pot $2.50 | Rake $0 
Seat 1: matiko09 folded before Flop (didn't bet)
Seat 2: xxxZeka collected ($2.50)
Seat 4: Szevasztopol (button) folded before Flop (didn't bet)
Seat 5: stds st (small blind) folded before Flop
Seat 7: hurtNCYDE (big blind) folded before Flop
Seat 8: ardo888 folded before Flop (didn't bet)





PokerStars Hand #154363745300:  Hold'em No Limit ($0.50/$1.00 USD) - 2016/06/06 13:09:58 CET [2016/06/06 7:09:58 ET]
Table 'Gajdariya' 9-max Seat #5 is the button
Seat 1: matiko09 ($129.54 in chips) 
Seat 2: xxxZeka ($170.41 in chips) 
Seat 4: Szevasztopol ($131.40 in chips) 
Seat 5: stds st ($80.13 in chips) 
Seat 7: hurtNCYDE ($100 in chips) 
Seat 8: ardo888 ($151.97 in chips) 
vanilica will be allowed to play after the button
hurtNCYDE: posts small blind $0.50
ardo888: posts big blind $1
PacPacBum: sits out 
mooose100: sits out 
*** HOLE CARDS ***
Dealt to matiko09 [5s 6s]
matiko09: folds 
xxxZeka: folds 
Szevasztopol: raises $1.04 to $2.04
stds st: folds 
hurtNCYDE: raises $6.96 to $9
ardo888: folds 
Szevasztopol: calls $6.96
*** FLOP *** [4c 9c Kh]
hurtNCYDE: bets $6.13
Szevasztopol: calls $6.13
*** TURN *** [4c 9c Kh] [7s]
hurtNCYDE: checks 
Szevasztopol: checks 
*** RIVER *** [4c 9c Kh 7s] [Ah]
hurtNCYDE: bets $20.49
Szevasztopol: folds 
Uncalled bet ($20.49) returned to hurtNCYDE
hurtNCYDE collected $29.70 from pot
hurtNCYDE: doesn't show hand 
*** SUMMARY ***
Total pot $31.26 | Rake $1.56 
Board [4c 9c Kh 7s Ah]
Seat 1: matiko09 folded before Flop (didn't bet)
Seat 2: xxxZeka folded before Flop (didn't bet)
Seat 4: Szevasztopol folded on the River
Seat 5: stds st (button) folded before Flop (didn't bet)
Seat 7: hurtNCYDE (small blind) collected ($29.70)
Seat 8: ardo888 (big blind) folded before Flop





PokerStars Hand #154363747881:  Hold'em No Limit ($0.50/$1.00 USD) - 2016/06/06 13:10:04 CET [2016/06/06 7:10:04 ET]
Table 'Wezen II' 9-max Seat #1 is the button
Seat 1: matiko09 ($178.82 in chips) 
Seat 2: Mr.Grigoriy ($116.12 in chips) 
Seat 3: Dickyxxx ($100 in chips) 
Seat 4: xxxibgdrgn ($100 in chips) 
Seat 5: stds st ($31.65 in chips) 
Seat 6: vanilica ($100 in chips) 
Seat 7: KDJAll3 ($80.46 in chips) 
Seat 8: o.miro ($103 in chips) 
Seat 9: PacPacBum ($102.50 in chips) 
Mr.Grigoriy: posts small blind $0.50
Dickyxxx: posts big blind $1
*** HOLE CARDS ***
Dealt to matiko09 [Kd 7s]
xxxibgdrgn: folds 
stds st: folds 
vanilica: folds 
KDJAll3: raises $1 to $2
o.miro: raises $5.50 to $7.50
PacPacBum: folds 
matiko09: folds 
Mr.Grigoriy: folds 
Dickyxxx: folds 
KDJAll3: folds 
Uncalled bet ($5.50) returned to o.miro
o.miro collected $5.50 from pot
o.miro: doesn't show hand 
*** SUMMARY ***
Total pot $5.50 | Rake $0 
Seat 1: matiko09 (button) folded before Flop (didn't bet)
Seat 2: Mr.Grigoriy (small blind) folded before Flop
Seat 3: Dickyxxx (big blind) folded before Flop
Seat 4: xxxibgdrgn folded before Flop (didn't bet)
Seat 5: stds st folded before Flop (didn't bet)
Seat 6: vanilica folded before Flop (didn't bet)
Seat 7: KDJAll3 folded before Flop
Seat 8: o.miro collected ($5.50)
Seat 9: PacPacBum folded before Flop (didn't bet)





PokerStars Hand #154363749083:  Hold'em No Limit ($0.50/$1.00 USD) - 2016/06/06 13:10:06 CET [2016/06/06 7:10:06 ET]
Table 'Lucidor II' 9-max Seat #1 is the button
Seat 1: Eskimo Fox ($100 in chips) 
Seat 3: xhinostrabli ($79 in chips) 
Seat 4: matiko09 ($143.50 in chips) 
Seat 5: hammerwife ($103 in chips) 
Seat 6: R1aki ($100 in chips) 
Seat 7: vanilica ($100 in chips) 
Seat 8: ardo888 ($101.50 in chips) 
xhinostrabli: posts small blind $0.50
matiko09: posts big blind $1
*** HOLE CARDS ***
Dealt to matiko09 [Qc 8h]
hammerwife: folds 
R1aki: folds 
vanilica: folds 
ardo888: raises $1.50 to $2.50
Eskimo Fox: folds 
xhinostrabli: folds 
matiko09: folds 
Uncalled bet ($1.50) returned to ardo888
ardo888 collected $2.50 from pot
ardo888: doesn't show hand 
*** SUMMARY ***
Total pot $2.50 | Rake $0 
Seat 1: Eskimo Fox (button) folded before Flop (didn't bet)
Seat 3: xhinostrabli (small blind) folded before Flop
Seat 4: matiko09 (big blind) folded before Flop
Seat 5: hammerwife folded before Flop (didn't bet)
Seat 6: R1aki folded before Flop (didn't bet)
Seat 7: vanilica folded before Flop (didn't bet)
Seat 8: ardo888 collected ($2.50)





PokerStars Hand #154363750499:  Hold'em No Limit ($0.50/$1.00 USD) - 2016/06/06 13:10:10 CET [2016/06/06 7:10:10 ET]
Table 'Chaldaea II' 9-max Seat #2 is the button
Seat 1: Szevasztopol ($107.08 in chips) 
Seat 2: Mr.Grigoriy ($100 in chips) 
Seat 3: ardo888 ($109.35 in chips) 
Seat 4: mooose100 ($128.65 in chips) 
Seat 5: stds st ($27.74 in chips) 
Seat 6: PacPacBum ($100.50 in chips) 
Seat 8: 32rrew ($101.50 in chips) 
Seat 9: matiko09 ($100 in chips) 
ardo888: posts small blind $0.50
mooose100: posts big blind $1
xxxibgdrgn: sits out 
*** HOLE CARDS ***
Dealt to matiko09 [Kc Js]
stds st: raises $1.50 to $2.50
PacPacBum: folds 
32rrew: folds 
matiko09: folds 
Szevasztopol: folds 
Mr.Grigoriy: folds 
ardo888: folds 
mooose100: folds 
Uncalled bet ($1.50) returned to stds st
stds st collected $2.50 from pot
stds st: doesn't show hand 
*** SUMMARY ***
Total pot $2.50 | Rake $0 
Seat 1: Szevasztopol folded before Flop (didn't bet)
Seat 2: Mr.Grigoriy (button) folded before Flop (didn't bet)
Seat 3: ardo888 (small blind) folded before Flop
Seat 4: mooose100 (big blind) folded before Flop
Seat 5: stds st collected ($2.50)
Seat 6: PacPacBum folded before Flop (didn't bet)
Seat 8: 32rrew folded before Flop (didn't bet)
Seat 9: matiko09 folded before Flop (didn't bet)





PokerStars Hand #154363750925:  Hold'em No Limit ($0.50/$1.00 USD) - 2016/06/06 13:10:11 CET [2016/06/06 7:10:11 ET]
Table 'Smither' 9-max Seat #8 is the button
Seat 1: PacPacBum ($172.60 in chips) 
Seat 2: matiko09 ($100 in chips) 
Seat 3: xxxZeka ($129.07 in chips) 
Seat 5: Szevasztopol ($122.12 in chips) 
Seat 6: mooose100 ($74.97 in chips) 
Seat 7: vanilica ($107.19 in chips) 
Seat 8: 74 ROADIE ($82.71 in chips) 
Seat 9: hammerwife ($133.25 in chips) 
hammerwife: posts small blind $0.50
PacPacBum: posts big blind $1
*** HOLE CARDS ***
Dealt to matiko09 [Td 4s]
matiko09: folds 
xxxZeka: folds 
Szevasztopol: folds 
mooose100: folds 
vanilica: raises $1.50 to $2.50
74 ROADIE: calls $2.50
hammerwife: calls $2
PacPacBum: folds 
*** FLOP *** [5s Kh 9c]
hammerwife: checks 
vanilica: checks 
74 ROADIE: checks 
*** TURN *** [5s Kh 9c] [7d]
hammerwife: checks 
vanilica: bets $5.97
74 ROADIE: calls $5.97
hammerwife: folds 
*** RIVER *** [5s Kh 9c 7d] [2h]
vanilica: bets $14.37
74 ROADIE: calls $14.37
*** SHOW DOWN ***
vanilica: shows [Kc Kd] (three of a kind, Kings)
74 ROADIE: mucks hand 
vanilica collected $46.72 from pot
*** SUMMARY ***
Total pot $49.18 | Rake $2.46 
Board [5s Kh 9c 7d 2h]
Seat 1: PacPacBum (big blind) folded before Flop
Seat 2: matiko09 folded before Flop (didn't bet)
Seat 3: xxxZeka folded before Flop (didn't bet)
Seat 5: Szevasztopol folded before Flop (didn't bet)
Seat 6: mooose100 folded before Flop (didn't bet)
Seat 7: vanilica showed [Kc Kd] and won ($46.72) with three of a kind, Kings
Seat 8: 74 ROADIE (button) mucked [3c 5c]
Seat 9: hammerwife (small blind) folded on the Turn





PokerStars Hand #154363757862:  Hold'em No Limit ($0.50/$1.00 USD) - 2016/06/06 13:10:27 CET [2016/06/06 7:10:27 ET]
Table 'Heze' 9-max Seat #9 is the button
Seat 1: matiko09 ($173.67 in chips) 
Seat 2: xxxibgdrgn ($100 in chips) 
Seat 3: ozone2003 ($126.79 in chips) 
Seat 4: ardo888 ($100 in chips) 
Seat 5: stds st ($39 in chips) 
Seat 6: yfcq36 ($136.13 in chips) 
Seat 7: 32rrew ($162.47 in chips) 
Seat 8: PacPacBum ($118.70 in chips) 
Seat 9: Mr.Grigoriy ($132.21 in chips) 
matiko09: posts small blind $0.50
xxxibgdrgn: posts big blind $1
*** HOLE CARDS ***
Dealt to matiko09 [6d 2c]
ozone2003: folds 
ardo888: folds 
stds st: folds 
yfcq36: raises $2 to $3
32rrew: folds 
PacPacBum: folds 
Mr.Grigoriy: folds 
matiko09: folds 
xxxibgdrgn: raises $6 to $9
yfcq36: calls $6
*** FLOP *** [Js Jc Kd]
xxxibgdrgn: checks 
yfcq36: checks 
*** TURN *** [Js Jc Kd] [Td]
xxxibgdrgn: checks 
yfcq36: bets $11
xxxibgdrgn: calls $11
*** RIVER *** [Js Jc Kd Td] [7s]
xxxibgdrgn: checks 
yfcq36: checks 
*** SHOW DOWN ***
xxxibgdrgn: shows [Qh Qd] (two pair, Queens and Jacks)
yfcq36: mucks hand 
xxxibgdrgn collected $38.48 from pot
*** SUMMARY ***
Total pot $40.50 | Rake $2.02 
Board [Js Jc Kd Td 7s]
Seat 1: matiko09 (small blind) folded before Flop
Seat 2: xxxibgdrgn (big blind) showed [Qh Qd] and won ($38.48) with two pair, Queens and Jacks
Seat 3: ozone2003 folded before Flop (didn't bet)
Seat 4: ardo888 folded before Flop (didn't bet)
Seat 5: stds st folded before Flop (didn't bet)
Seat 6: yfcq36 mucked [3c Ac]
Seat 7: 32rrew folded before Flop (didn't bet)
Seat 8: PacPacBum folded before Flop (didn't bet)
Seat 9: Mr.Grigoriy (button) folded before Flop (didn't bet)





PokerStars Hand #154363759850:  Hold'em No Limit (€0.50/€1.00 EUR) - 2016/06/06 13:10:32 CET [2016/06/06 7:10:32 ET]
Table 'Lesath' 9-max Seat #6 is the button
Seat 1: o.miro (€102.46 in chips) 
Seat 2: thecurv (€101.35 in chips) 
Seat 3: ozone2003 (€214.95 in chips) 
Seat 4: hammerwife (€127.11 in chips) 
Seat 5: matiko09 (€113.47 in chips) 
Seat 6: Szevasztopol (€145.53 in chips) 
Seat 7: Mr.Grigoriy (€100 in chips) 
Seat 9: 72nloses (€56.18 in chips) 
Mr.Grigoriy: posts small blind €0.50
72nloses: posts big blind €1
*** HOLE CARDS ***
Dealt to matiko09 [7s Ts]
o.miro: folds 
thecurv: folds 
ozone2003: raises €2 to €3
hammerwife: folds 
matiko09: folds 
Szevasztopol: folds 
Mr.Grigoriy: folds 
72nloses: calls €2
*** FLOP *** [9d 4h 5c]
72nloses: checks 
ozone2003: bets €5.02
72nloses: calls €5.02
*** TURN *** [9d 4h 5c] [Jc]
72nloses: checks 
ozone2003: bets €8.01
72nloses: folds 
Uncalled bet (€8.01) returned to ozone2003
ozone2003 collected €15.71 from pot
ozone2003: doesn't show hand 
*** SUMMARY ***
Total pot €16.54 | Rake €0.83 
Board [9d 4h 5c Jc]
Seat 1: o.miro folded before Flop (didn't bet)
Seat 2: thecurv folded before Flop (didn't bet)
Seat 3: ozone2003 collected (€15.71)
Seat 4: hammerwife folded before Flop (didn't bet)
Seat 5: matiko09 folded before Flop (didn't bet)
Seat 6: Szevasztopol (button) folded before Flop (didn't bet)
Seat 7: Mr.Grigoriy (small blind) folded before Flop
Seat 9: 72nloses (big blind) folded on the Turn





PokerStars Hand #154363765103:  Hold'em No Limit ($0.50/$1.00 USD) - 2016/06/06 13:10:44 CET [2016/06/06 7:10:44 ET]
Table 'Chaldaea II' 9-max Seat #3 is the button
Seat 1: Szevasztopol ($107.08 in chips) 
Seat 2: Mr.Grigoriy ($100 in chips) 
Seat 3: ardo888 ($108.85 in chips) 
Seat 4: mooose100 ($127.65 in chips) 
Seat 5: stds st ($29.24 in chips) 
Seat 6: PacPacBum ($100.50 in chips) 
Seat 8: 32rrew ($101.50 in chips) 
Seat 9: matiko09 ($100 in chips) 
mooose100: posts small blind $0.50
stds st: posts big blind $1
xxxibgdrgn: sits out 
*** HOLE CARDS ***
Dealt to matiko09 [2s Td]
PacPacBum: folds 
32rrew: folds 
matiko09: folds 
Szevasztopol: folds 
Mr.Grigoriy: folds 
ardo888: folds 
mooose100: raises $2 to $3
stds st: folds 
Uncalled bet ($2) returned to mooose100
mooose100 collected $2 from pot
mooose100: doesn't show hand 
*** SUMMARY ***
Total pot $2 | Rake $0 
Seat 1: Szevasztopol folded before Flop (didn't bet)
Seat 2: Mr.Grigoriy folded before Flop (didn't bet)
Seat 3: ardo888 (button) folded before Flop (didn't bet)
Seat 4: mooose100 (small blind) collected ($2)
Seat 5: stds st (big blind) folded before Flop
Seat 6: PacPacBum folded before Flop (didn't bet)
Seat 8: 32rrew folded before Flop (didn't bet)
Seat 9: matiko09 folded before Flop (didn't bet)





PokerStars Hand #154363765380:  Hold'em No Limit ($0.50/$1.00 USD) - 2016/06/06 13:10:45 CET [2016/06/06 7:10:45 ET]
Table 'Sheliak' 9-max Seat #1 is the button
Seat 1: 32rrew ($100.33 in chips) 
Seat 2: DancerNN1 ($100 in chips) 
Seat 3: xxxZeka ($100 in chips) 
Seat 5: hammerwife ($102 in chips) 
Seat 6: matiko09 ($100.32 in chips) 
Seat 7: stds st ($33.35 in chips) 
Seat 8: ozone2003 ($100 in chips) 
Seat 9: Szevasztopol ($104.85 in chips) 
DancerNN1: posts small blind $0.50
xxxZeka: posts big blind $1
iRLM: sits out 
*** HOLE CARDS ***
Dealt to matiko09 [5d 9d]
hammerwife: folds 
matiko09: folds 
stds st: folds 
ozone2003: folds 
Szevasztopol: folds 
32rrew: folds 
DancerNN1: raises $1.40 to $2.40
xxxZeka: folds 
Uncalled bet ($1.40) returned to DancerNN1
DancerNN1 collected $2 from pot
DancerNN1: doesn't show hand 
*** SUMMARY ***
Total pot $2 | Rake $0 
Seat 1: 32rrew (button) folded before Flop (didn't bet)
Seat 2: DancerNN1 (small blind) collected ($2)
Seat 3: xxxZeka (big blind) folded before Flop
Seat 5: hammerwife folded before Flop (didn't bet)
Seat 6: matiko09 folded before Flop (didn't bet)
Seat 7: stds st folded before Flop (didn't bet)
Seat 8: ozone2003 folded before Flop (didn't bet)
Seat 9: Szevasztopol folded before Flop (didn't bet)





PokerStars Hand #154363769121:  Hold'em No Limit ($0.50/$1.00 USD) - 2016/06/06 13:10:53 CET [2016/06/06 7:10:53 ET]
Table 'Lucidor II' 9-max Seat #3 is the button
Seat 1: Eskimo Fox ($100 in chips) 
Seat 3: xhinostrabli ($78.50 in chips) 
Seat 4: matiko09 ($142.50 in chips) 
matiko09: posts small blind $0.50
hammerwife: is sitting out 
R1aki: is sitting out 
vanilica: is sitting out 
ardo888: is sitting out 
vanilica leaves the table
Eskimo Fox: posts big blind $1
*** HOLE CARDS ***
Dealt to matiko09 [Qd Jc]
R1aki leaves the table
hammerwife leaves the table
xhinostrabli: folds 
matiko09: raises $1.50 to $2.50
Eskimo Fox: folds 
Uncalled bet ($1.50) returned to matiko09
xhinostrabli leaves the table
matiko09 collected $2 from pot
matiko09: doesn't show hand 
*** SUMMARY ***
Total pot $2 | Rake $0 
Seat 1: Eskimo Fox (big blind) folded before Flop
Seat 3: xhinostrabli (button) folded before Flop (didn't bet)
Seat 4: matiko09 (small blind) collected ($2)





PokerStars Hand #154363770126:  Hold'em No Limit ($0.50/$1.00 USD) - 2016/06/06 13:10:55 CET [2016/06/06 7:10:55 ET]
Table 'Williams' 9-max Seat #6 is the button
Seat 1: matiko09 ($176.01 in chips) 
Seat 2: PacPacBum ($109.96 in chips) 
Seat 3: granbunny ($71.31 in chips) 
Seat 4: Mr.Grigoriy ($101.50 in chips) 
Seat 5: xxxibgdrgn ($100 in chips) 
Seat 6: xxxZeka ($127.76 in chips) 
Seat 7: Eskimo Fox ($111.32 in chips) 
Seat 8: Dickyxxx ($100 in chips) 
Seat 9: stds st ($38.50 in chips) 
Eskimo Fox: posts small blind $0.50
Dickyxxx: posts big blind $1
*** HOLE CARDS ***
Dealt to matiko09 [Ac Th]
stds st: folds 
matiko09: folds 
PacPacBum: folds 
granbunny: folds 
Mr.Grigoriy: folds 
xxxibgdrgn: raises $1.50 to $2.50
xxxZeka: folds 
Eskimo Fox: folds 
Dickyxxx: folds 
Uncalled bet ($1.50) returned to xxxibgdrgn
xxxibgdrgn collected $2.50 from pot
xxxibgdrgn: doesn't show hand 
*** SUMMARY ***
Total pot $2.50 | Rake $0 
Seat 1: matiko09 folded before Flop (didn't bet)
Seat 2: PacPacBum folded before Flop (didn't bet)
Seat 3: granbunny folded before Flop (didn't bet)
Seat 4: Mr.Grigoriy folded before Flop (didn't bet)
Seat 5: xxxibgdrgn collected ($2.50)
Seat 6: xxxZeka (button) folded before Flop (didn't bet)
Seat 7: Eskimo Fox (small blind) folded before Flop
Seat 8: Dickyxxx (big blind) folded before Flop
Seat 9: stds st folded before Flop (didn't bet)





PokerStars Hand #154363776688:  Hold'em No Limit ($0.50/$1.00 USD) - 2016/06/06 13:11:11 CET [2016/06/06 7:11:11 ET]
Table 'Lucidor II' 9-max Seat #1 is the button
Seat 1: Eskimo Fox ($100 in chips) 
Seat 4: matiko09 ($143.50 in chips) 
Eskimo Fox: posts small blind $0.50
matiko09: posts big blind $1
*** HOLE CARDS ***
Dealt to matiko09 [Kc 7d]
Eskimo Fox: raises $1 to $2
matiko09: folds 
Uncalled bet ($1) returned to Eskimo Fox
Eskimo Fox collected $2 from pot
Eskimo Fox: doesn't show hand 
*** SUMMARY ***
Total pot $2 | Rake $0 
Seat 1: Eskimo Fox (button) (small blind) collected ($2)
Seat 4: matiko09 (big blind) folded before Flop





PokerStars Hand #154363778047:  Hold'em No Limit ($0.50/$1.00 USD) - 2016/06/06 13:11:14 CET [2016/06/06 7:11:14 ET]
Table 'Wezen II' 9-max Seat #2 is the button
Seat 1: matiko09 ($178.82 in chips) 
Seat 2: Mr.Grigoriy ($115.62 in chips) 
Seat 3: Dickyxxx ($100 in chips) 
Seat 4: xxxibgdrgn ($100 in chips) 
Seat 5: stds st ($31.65 in chips) 
Seat 6: vanilica ($100 in chips) 
Seat 7: KDJAll3 ($78.46 in chips) 
Seat 8: o.miro ($106.50 in chips) 
Seat 9: PacPacBum ($102.50 in chips) 
Dickyxxx: posts small blind $0.50
xxxibgdrgn: posts big blind $1
*** HOLE CARDS ***
Dealt to matiko09 [2s 7d]
stds st: folds 
vanilica: folds 
KDJAll3: folds 
o.miro: folds 
PacPacBum: folds 
matiko09: folds 
Mr.Grigoriy: raises $1.50 to $2.50
Dickyxxx: folds 
xxxibgdrgn: folds 
Uncalled bet ($1.50) returned to Mr.Grigoriy
Mr.Grigoriy collected $2.50 from pot
Mr.Grigoriy: doesn't show hand 
*** SUMMARY ***
Total pot $2.50 | Rake $0 
Seat 1: matiko09 folded before Flop (didn't bet)
Seat 2: Mr.Grigoriy (button) collected ($2.50)
Seat 3: Dickyxxx (small blind) folded before Flop
Seat 4: xxxibgdrgn (big blind) folded before Flop
Seat 5: stds st folded before Flop (didn't bet)
Seat 6: vanilica folded before Flop (didn't bet)
Seat 7: KDJAll3 folded before Flop (didn't bet)
Seat 8: o.miro folded before Flop (didn't bet)
Seat 9: PacPacBum folded before Flop (didn't bet)





PokerStars Hand #154363782400:  Hold'em No Limit ($0.50/$1.00 USD) - 2016/06/06 13:11:25 CET [2016/06/06 7:11:25 ET]
Table 'Williams' 9-max Seat #7 is the button
Seat 1: matiko09 ($176.01 in chips) 
Seat 2: PacPacBum ($109.96 in chips) 
Seat 3: granbunny ($71.31 in chips) 
Seat 4: Mr.Grigoriy ($101.50 in chips) 
Seat 5: xxxibgdrgn ($101.50 in chips) 
Seat 6: xxxZeka ($127.76 in chips) 
Seat 7: Eskimo Fox ($110.82 in chips) 
Seat 8: Dickyxxx ($100 in chips) 
Seat 9: stds st ($38.50 in chips) 
Dickyxxx: posts small blind $0.50
stds st: posts big blind $1
*** HOLE CARDS ***
Dealt to matiko09 [Jc 9h]
matiko09: folds 
PacPacBum: folds 
granbunny: folds 
Mr.Grigoriy: raises $2 to $3
xxxibgdrgn: folds 
xxxZeka: folds 
Eskimo Fox: calls $3
matiko09 leaves the table
Dickyxxx: folds 
stds st: folds 
*** FLOP *** [Kc 7h 9s]
hurtNCYDE joins the table at seat #1 
hurtNCYDE leaves the table
Mr.Grigoriy: checks 
Eskimo Fox: checks 
*** TURN *** [Kc 7h 9s] [3h]
Mr.Grigoriy: checks 
Eskimo Fox: checks 
*** RIVER *** [Kc 7h 9s 3h] [5h]
xhinostrabli joins the table at seat #1 
Mr.Grigoriy: checks 
Eskimo Fox: bets $5
Mr.Grigoriy: folds 
Uncalled bet ($5) returned to Eskimo Fox
Eskimo Fox collected $7.12 from pot
Eskimo Fox: doesn't show hand 
*** SUMMARY ***
Total pot $7.50 | Rake $0.38 
Board [Kc 7h 9s 3h 5h]
Seat 1: matiko09 folded before Flop (didn't bet)
Seat 2: PacPacBum folded before Flop (didn't bet)
Seat 3: granbunny folded before Flop (didn't bet)
Seat 4: Mr.Grigoriy folded on the River
Seat 5: xxxibgdrgn folded before Flop (didn't bet)
Seat 6: xxxZeka folded before Flop (didn't bet)
Seat 7: Eskimo Fox (button) collected ($7.12)
Seat 8: Dickyxxx (small blind) folded before Flop
Seat 9: stds st (big blind) folded before Flop





PokerStars Hand #154363783354:  Hold'em No Limit ($0.50/$1.00 USD) - 2016/06/06 13:11:27 CET [2016/06/06 7:11:27 ET]
Table 'Smither' 9-max Seat #9 is the button
Seat 1: PacPacBum ($171.60 in chips) 
Seat 2: matiko09 ($100 in chips) 
Seat 3: xxxZeka ($129.07 in chips) 
Seat 5: Szevasztopol ($122.12 in chips) 
Seat 6: mooose100 ($74.97 in chips) 
Seat 7: vanilica ($131.07 in chips) 
Seat 8: 74 ROADIE ($59.87 in chips) 
Seat 9: hammerwife ($130.75 in chips) 
PacPacBum: posts small blind $0.50
matiko09: posts big blind $1
*** HOLE CARDS ***
Dealt to matiko09 [8h 5s]
xxxZeka: folds 
Szevasztopol: folds 
mooose100: folds 
vanilica: raises $1.50 to $2.50
74 ROADIE: calls $2.50
hammerwife: folds 
PacPacBum: folds 
matiko09: folds 
*** FLOP *** [Th 2d As]
vanilica: checks 
74 ROADIE: bets $5
vanilica: calls $5
*** TURN *** [Th 2d As] [5d]
vanilica: checks 
74 ROADIE: checks 
*** RIVER *** [Th 2d As 5d] [Qh]
vanilica: checks 
74 ROADIE: checks 
*** SHOW DOWN ***
vanilica: shows [Ks Td] (a pair of Tens)
74 ROADIE: shows [Ah 9s] (a pair of Aces)
74 ROADIE collected $15.68 from pot
*** SUMMARY ***
Total pot $16.50 | Rake $0.82 
Board [Th 2d As 5d Qh]
Seat 1: PacPacBum (small blind) folded before Flop
Seat 2: matiko09 (big blind) folded before Flop
Seat 3: xxxZeka folded before Flop (didn't bet)
Seat 5: Szevasztopol folded before Flop (didn't bet)
Seat 6: mooose100 folded before Flop (didn't bet)
Seat 7: vanilica showed [Ks Td] and lost with a pair of Tens
Seat 8: 74 ROADIE showed [Ah 9s] and won ($15.68) with a pair of Aces
Seat 9: hammerwife (button) folded before Flop (didn't bet)





PokerStars Hand #154363783814:  Hold'em No Limit ($0.50/$1.00 USD) - 2016/06/06 13:11:28 CET [2016/06/06 7:11:28 ET]
Table 'Chaldaea II' 9-max Seat #4 is the button
Seat 1: Szevasztopol ($107.08 in chips) 
Seat 2: Mr.Grigoriy ($100 in chips) 
Seat 3: ardo888 ($108.85 in chips) 
Seat 4: mooose100 ($128.65 in chips) 
Seat 5: stds st ($28.24 in chips) 
Seat 6: PacPacBum ($100.50 in chips) 
Seat 8: 32rrew ($101.50 in chips) 
Seat 9: matiko09 ($100 in chips) 
stds st: posts small blind $0.50
PacPacBum: posts big blind $1
xxxibgdrgn: sits out 
*** HOLE CARDS ***
Dealt to matiko09 [Tc Jc]
32rrew: folds 
matiko09: raises $2 to $3
Szevasztopol: folds 
Mr.Grigoriy: folds 
ardo888: folds 
mooose100: folds 
stds st: folds 
PacPacBum: folds 
Uncalled bet ($2) returned to matiko09
matiko09 collected $2.50 from pot
matiko09: doesn't show hand 
*** SUMMARY ***
Total pot $2.50 | Rake $0 
Seat 1: Szevasztopol folded before Flop (didn't bet)
Seat 2: Mr.Grigoriy folded before Flop (didn't bet)
Seat 3: ardo888 folded before Flop (didn't bet)
Seat 4: mooose100 (button) folded before Flop (didn't bet)
Seat 5: stds st (small blind) folded before Flop
Seat 6: PacPacBum (big blind) folded before Flop
Seat 8: 32rrew folded before Flop (didn't bet)
Seat 9: matiko09 collected ($2.50)





PokerStars Hand #154363784077:  Hold'em No Limit ($0.50/$1.00 USD) - 2016/06/06 13:11:28 CET [2016/06/06 7:11:28 ET]
Table 'Gajdariya' 9-max Seat #7 is the button
Seat 1: matiko09 ($129.54 in chips) 
Seat 2: xxxZeka ($170.41 in chips) 
Seat 4: Szevasztopol ($116.27 in chips) 
Seat 5: stds st ($80.13 in chips) 
Seat 7: hurtNCYDE ($114.57 in chips) 
Seat 8: ardo888 ($150.97 in chips) 
Seat 9: PacPacBum ($100 in chips) 
ardo888: posts small blind $0.50
PacPacBum: posts big blind $1
mooose100: sits out 
vanilica: sits out 
*** HOLE CARDS ***
Dealt to matiko09 [8h 3h]
matiko09: folds 
xxxZeka: raises $2 to $3
Szevasztopol: folds 
stds st: folds 
hurtNCYDE: calls $3
ardo888: folds 
PacPacBum: folds 
*** FLOP *** [7s Qc Js]
xxxZeka: bets $5
hurtNCYDE: folds 
Uncalled bet ($5) returned to xxxZeka
xxxZeka collected $7.12 from pot
*** SUMMARY ***
Total pot $7.50 | Rake $0.38 
Board [7s Qc Js]
Seat 1: matiko09 folded before Flop (didn't bet)
Seat 2: xxxZeka collected ($7.12)
Seat 4: Szevasztopol folded before Flop (didn't bet)
Seat 5: stds st folded before Flop (didn't bet)
Seat 7: hurtNCYDE (button) folded on the Flop
Seat 8: ardo888 (small blind) folded before Flop
Seat 9: PacPacBum (big blind) folded before Flop





PokerStars Hand #154363785049:  Hold'em No Limit ($0.50/$1.00 USD) - 2016/06/06 13:11:31 CET [2016/06/06 7:11:31 ET]
Table 'Sheliak' 9-max Seat #2 is the button
Seat 1: 32rrew ($100.33 in chips) 
Seat 2: DancerNN1 ($101 in chips) 
Seat 3: xxxZeka ($100 in chips) 
Seat 4: iRLM ($78.03 in chips) 
Seat 5: hammerwife ($102 in chips) 
Seat 6: matiko09 ($100.32 in chips) 
Seat 7: stds st ($33.35 in chips) 
Seat 8: ozone2003 ($100 in chips) 
Seat 9: Szevasztopol ($104.85 in chips) 
xxxZeka: posts small blind $0.50
iRLM: posts big blind $1
*** HOLE CARDS ***
Dealt to matiko09 [Tc 2h]
hammerwife: folds 
matiko09: folds 
stds st: raises $1.50 to $2.50
ozone2003: folds 
Szevasztopol: folds 
32rrew: folds 
DancerNN1: calls $2.50
xxxZeka: raises $8.50 to $11
iRLM: folds 
stds st: calls $8.50
DancerNN1: calls $8.50
*** FLOP *** [8d 2d Jd]
xxxZeka: bets $21
stds st: folds 
DancerNN1: folds 
Uncalled bet ($21) returned to xxxZeka
xxxZeka collected $32.30 from pot
*** SUMMARY ***
Total pot $34 | Rake $1.70 
Board [8d 2d Jd]
Seat 1: 32rrew folded before Flop (didn't bet)
Seat 2: DancerNN1 (button) folded on the Flop
Seat 3: xxxZeka (small blind) collected ($32.30)
Seat 4: iRLM (big blind) folded before Flop
Seat 5: hammerwife folded before Flop (didn't bet)
Seat 6: matiko09 folded before Flop (didn't bet)
Seat 7: stds st folded on the Flop
Seat 8: ozone2003 folded before Flop (didn't bet)
Seat 9: Szevasztopol folded before Flop (didn't bet)





PokerStars Hand #154363787079:  Hold'em No Limit (€0.50/€1.00 EUR) - 2016/06/06 13:11:36 CET [2016/06/06 7:11:36 ET]
Table 'Lesath' 9-max Seat #7 is the button
Seat 1: o.miro (€102.46 in chips) 
Seat 2: thecurv (€101.35 in chips) 
Seat 3: ozone2003 (€222.64 in chips) 
Seat 4: hammerwife (€127.11 in chips) 
Seat 5: matiko09 (€113.47 in chips) 
Seat 6: Szevasztopol (€145.53 in chips) 
Seat 7: Mr.Grigoriy (€100 in chips) 
Seat 9: 72nloses (€48.16 in chips) 
maxxmeister will be allowed to play after the button
72nloses: posts small blind €0.50
o.miro: posts big blind €1
*** HOLE CARDS ***
Dealt to matiko09 [Kd 4d]
thecurv: raises €1 to €2
ozone2003: folds 
hammerwife: folds 
matiko09: folds 
Szevasztopol: folds 
Mr.Grigoriy: folds 
72nloses: calls €1.50
o.miro: folds 
*** FLOP *** [4c Td 3h]
72nloses: checks 
thecurv: bets €3.50
72nloses: folds 
Uncalled bet (€3.50) returned to thecurv
thecurv collected €4.75 from pot
thecurv: doesn't show hand 
*** SUMMARY ***
Total pot €5 | Rake €0.25 
Board [4c Td 3h]
Seat 1: o.miro (big blind) folded before Flop
Seat 2: thecurv collected (€4.75)
Seat 3: ozone2003 folded before Flop (didn't bet)
Seat 4: hammerwife folded before Flop (didn't bet)
Seat 5: matiko09 folded before Flop (didn't bet)
Seat 6: Szevasztopol folded before Flop (didn't bet)
Seat 7: Mr.Grigoriy (button) folded before Flop (didn't bet)
Seat 9: 72nloses (small blind) folded on the Flop





PokerStars Hand #154363797138:  Hold'em No Limit ($0.50/$1.00 USD) - 2016/06/06 13:11:59 CET [2016/06/06 7:11:59 ET]
Table 'Wezen II' 9-max Seat #3 is the button
Seat 1: matiko09 ($178.82 in chips) 
Seat 2: Mr.Grigoriy ($117.12 in chips) 
Seat 3: Dickyxxx ($100 in chips) 
Seat 4: xxxibgdrgn ($100 in chips) 
Seat 5: stds st ($31.65 in chips) 
Seat 6: vanilica ($100 in chips) 
Seat 7: KDJAll3 ($78.46 in chips) 
Seat 8: o.miro ($106.50 in chips) 
Seat 9: PacPacBum ($102.50 in chips) 
xxxibgdrgn: posts small blind $0.50
stds st: posts big blind $1
*** HOLE CARDS ***
Dealt to matiko09 [3h Td]
vanilica: folds 
KDJAll3: folds 
o.miro: folds 
PacPacBum: folds 
matiko09: folds 
Mr.Grigoriy: folds 
Dickyxxx: folds 
xxxibgdrgn: folds 
Uncalled bet ($0.50) returned to stds st
stds st collected $1 from pot
stds st: doesn't show hand 
*** SUMMARY ***
Total pot $1 | Rake $0 
Seat 1: matiko09 folded before Flop (didn't bet)
Seat 2: Mr.Grigoriy folded before Flop (didn't bet)
Seat 3: Dickyxxx (button) folded before Flop (didn't bet)
Seat 4: xxxibgdrgn (small blind) folded before Flop
Seat 5: stds st (big blind) collected ($1)
Seat 6: vanilica folded before Flop (didn't bet)
Seat 7: KDJAll3 folded before Flop (didn't bet)
Seat 8: o.miro folded before Flop (didn't bet)
Seat 9: PacPacBum folded before Flop (didn't bet)





PokerStars Hand #154363799263:  Hold'em No Limit ($0.50/$1.00 USD) - 2016/06/06 13:12:04 CET [2016/06/06 7:12:04 ET]
Table 'Heze' 9-max Seat #1 is the button
Seat 1: matiko09 ($173.17 in chips) 
Seat 2: xxxibgdrgn ($118.48 in chips) 
Seat 5: stds st ($39 in chips) 
Seat 6: yfcq36 ($116.13 in chips) 
Seat 7: 32rrew ($162.47 in chips) 
Seat 8: PacPacBum ($118.70 in chips) 
Seat 9: Mr.Grigoriy ($132.21 in chips) 
xxxibgdrgn: posts small blind $0.50
ozone2003: is sitting out 
ardo888: is sitting out 
stds st: posts big blind $1
*** HOLE CARDS ***
Dealt to matiko09 [Td 3s]
yfcq36: folds 
32rrew: folds 
ozone2003 leaves the table
PacPacBum: folds 
Mr.Grigoriy: folds 
Dickyxxx joins the table at seat #3 
matiko09: folds 
xxxibgdrgn: folds 
Uncalled bet ($0.50) returned to stds st
stds st collected $1 from pot
stds st: doesn't show hand 
*** SUMMARY ***
Total pot $1 | Rake $0 
Seat 1: matiko09 (button) folded before Flop (didn't bet)
Seat 2: xxxibgdrgn (small blind) folded before Flop
Seat 5: stds st (big blind) collected ($1)
Seat 6: yfcq36 folded before Flop (didn't bet)
Seat 7: 32rrew folded before Flop (didn't bet)
Seat 8: PacPacBum folded before Flop (didn't bet)
Seat 9: Mr.Grigoriy folded before Flop (didn't bet)





PokerStars Hand #154363800106:  Hold'em No Limit ($0.50/$1.00 USD) - 2016/06/06 13:12:06 CET [2016/06/06 7:12:06 ET]
Table 'Smither' 9-max Seat #1 is the button
Seat 1: PacPacBum ($171.10 in chips) 
Seat 2: matiko09 ($100 in chips) 
Seat 3: xxxZeka ($129.07 in chips) 
Seat 5: Szevasztopol ($122.12 in chips) 
Seat 6: mooose100 ($74.97 in chips) 
Seat 7: vanilica ($123.57 in chips) 
Seat 8: 74 ROADIE ($68.05 in chips) 
Seat 9: hammerwife ($130.75 in chips) 
matiko09: posts small blind $0.50
xxxZeka: posts big blind $1
maxxmeister: sits out 
*** HOLE CARDS ***
Dealt to matiko09 [4h 5s]
Szevasztopol: folds 
mooose100: folds 
vanilica: folds 
74 ROADIE: folds 
hammerwife: folds 
PacPacBum: folds 
matiko09: folds 
Uncalled bet ($0.50) returned to xxxZeka
xxxZeka collected $1 from pot
*** SUMMARY ***
Total pot $1 | Rake $0 
Seat 1: PacPacBum (button) folded before Flop (didn't bet)
Seat 2: matiko09 (small blind) folded before Flop
Seat 3: xxxZeka (big blind) collected ($1)
Seat 5: Szevasztopol folded before Flop (didn't bet)
Seat 6: mooose100 folded before Flop (didn't bet)
Seat 7: vanilica folded before Flop (didn't bet)
Seat 8: 74 ROADIE folded before Flop (didn't bet)
Seat 9: hammerwife folded before Flop (didn't bet)





PokerStars Hand #154363804387:  Hold'em No Limit ($0.50/$1.00 USD) - 2016/06/06 13:12:16 CET [2016/06/06 7:12:16 ET]
Table 'Chaldaea II' 9-max Seat #5 is the button
Seat 1: Szevasztopol ($107.08 in chips) 
Seat 2: Mr.Grigoriy ($100 in chips) 
Seat 3: ardo888 ($108.85 in chips) 
Seat 4: mooose100 ($128.65 in chips) 
Seat 5: stds st ($27.74 in chips) 
Seat 6: PacPacBum ($100 in chips) 
Seat 7: xxxibgdrgn ($100 in chips) 
Seat 8: 32rrew ($101.50 in chips) 
Seat 9: matiko09 ($101.50 in chips) 
PacPacBum: posts small blind $0.50
xxxibgdrgn: posts big blind $1
*** HOLE CARDS ***
Dealt to matiko09 [4c 3c]
32rrew: folds 
matiko09: folds 
Szevasztopol: folds 
Mr.Grigoriy: raises $2 to $3
ardo888: folds 
mooose100: folds 
stds st: folds 
PacPacBum: folds 
xxxibgdrgn: folds 
Uncalled bet ($2) returned to Mr.Grigoriy
Mr.Grigoriy collected $2.50 from pot
Mr.Grigoriy: doesn't show hand 
*** SUMMARY ***
Total pot $2.50 | Rake $0 
Seat 1: Szevasztopol folded before Flop (didn't bet)
Seat 2: Mr.Grigoriy collected ($2.50)
Seat 3: ardo888 folded before Flop (didn't bet)
Seat 4: mooose100 folded before Flop (didn't bet)
Seat 5: stds st (button) folded before Flop (didn't bet)
Seat 6: PacPacBum (small blind) folded before Flop
Seat 7: xxxibgdrgn (big blind) folded before Flop
Seat 8: 32rrew folded before Flop (didn't bet)
Seat 9: matiko09 folded before Flop (didn't bet)





PokerStars Hand #154363805660:  Hold'em No Limit ($0.50/$1.00 USD) - 2016/06/06 13:12:19 CET [2016/06/06 7:12:19 ET]
Table 'Gajdariya' 9-max Seat #8 is the button
Seat 1: matiko09 ($129.54 in chips) 
Seat 2: xxxZeka ($174.53 in chips) 
Seat 4: Szevasztopol ($116.27 in chips) 
Seat 5: stds st ($80.13 in chips) 
Seat 7: hurtNCYDE ($111.57 in chips) 
Seat 8: ardo888 ($150.47 in chips) 
Seat 9: PacPacBum ($100 in chips) 
PacPacBum: posts small blind $0.50
matiko09: posts big blind $1
mooose100: sits out 
vanilica: sits out 
*** HOLE CARDS ***
Dealt to matiko09 [3c 3d]
xxxZeka: folds 
Szevasztopol: folds 
stds st: folds 
hurtNCYDE: folds 
ardo888: raises $1.50 to $2.50
xxxZeka leaves the table
PacPacBum: raises $5.50 to $8
Dickyxxx joins the table at seat #2 
matiko09: folds 
ardo888: calls $5.50
*** FLOP *** [Ks 6h 5s]
PacPacBum: bets $5.65
ardo888: calls $5.65
*** TURN *** [Ks 6h 5s] [Jc]
PacPacBum: bets $18.54
ardo888: folds 
Uncalled bet ($18.54) returned to PacPacBum
PacPacBum collected $26.88 from pot
PacPacBum: doesn't show hand 
*** SUMMARY ***
Total pot $28.30 | Rake $1.42 
Board [Ks 6h 5s Jc]
Seat 1: matiko09 (big blind) folded before Flop
Seat 2: xxxZeka folded before Flop (didn't bet)
Seat 4: Szevasztopol folded before Flop (didn't bet)
Seat 5: stds st folded before Flop (didn't bet)
Seat 7: hurtNCYDE folded before Flop (didn't bet)
Seat 8: ardo888 (button) folded on the Turn
Seat 9: PacPacBum (small blind) collected ($26.88)





PokerStars Hand #154363810570:  Hold'em No Limit (€0.50/€1.00 EUR) - 2016/06/06 13:12:31 CET [2016/06/06 7:12:31 ET]
Table 'Lesath' 9-max Seat #9 is the button
Seat 1: o.miro (€101.46 in chips) 
Seat 2: thecurv (€104.10 in chips) 
Seat 3: ozone2003 (€222.64 in chips) 
Seat 4: hammerwife (€127.11 in chips) 
Seat 5: matiko09 (€113.47 in chips) 
Seat 6: Szevasztopol (€145.53 in chips) 
Seat 7: Mr.Grigoriy (€100 in chips) 
Seat 9: 72nloses (€46.16 in chips) 
o.miro: posts small blind €0.50
thecurv: posts big blind €1
maxxmeister: sits out 
*** HOLE CARDS ***
Dealt to matiko09 [Ad 7c]
ozone2003: folds 
hammerwife: folds 
matiko09: folds 
Szevasztopol: raises €1.14 to €2.14
Mr.Grigoriy: calls €2.14
72nloses: folds 
o.miro: folds 
thecurv: calls €1.14
*** FLOP *** [Ah Qh Ac]
thecurv: checks 
Szevasztopol: checks 
Mr.Grigoriy: checks 
*** TURN *** [Ah Qh Ac] [9d]
thecurv: bets €3.28
Szevasztopol: folds 
Mr.Grigoriy: calls €3.28
*** RIVER *** [Ah Qh Ac 9d] [Qd]
thecurv: checks 
Mr.Grigoriy: checks 
*** SHOW DOWN ***
thecurv: shows [Qs Kd] (a full house, Queens full of Aces)
Mr.Grigoriy: mucks hand 
thecurv collected €12.81 from pot
*** SUMMARY ***
Total pot €13.48 | Rake €0.67 
Board [Ah Qh Ac 9d Qd]
Seat 1: o.miro (small blind) folded before Flop
Seat 2: thecurv (big blind) showed [Qs Kd] and won (€12.81) with a full house, Queens full of Aces
Seat 3: ozone2003 folded before Flop (didn't bet)
Seat 4: hammerwife folded before Flop (didn't bet)
Seat 5: matiko09 folded before Flop (didn't bet)
Seat 6: Szevasztopol folded on the Turn
Seat 7: Mr.Grigoriy mucked [Jh Js]
Seat 9: 72nloses (button) folded before Flop (didn't bet)





PokerStars Hand #154363811550:  Hold'em No Limit ($0.50/$1.00 USD) - 2016/06/06 13:12:33 CET [2016/06/06 7:12:33 ET]
Table 'Heze' 9-max Seat #2 is the button
Seat 1: matiko09 ($173.17 in chips) 
Seat 2: xxxibgdrgn ($117.98 in chips) 
Seat 5: stds st ($39.50 in chips) 
Seat 6: yfcq36 ($116.13 in chips) 
Seat 7: 32rrew ($162.47 in chips) 
Seat 8: PacPacBum ($118.70 in chips) 
Seat 9: Mr.Grigoriy ($132.21 in chips) 
Dickyxxx will be allowed to play after the button
stds st: posts small blind $0.50
yfcq36: posts big blind $1
*** HOLE CARDS ***
Dealt to matiko09 [Td 7s]
32rrew: folds 
PacPacBum: raises $1.50 to $2.50
Mr.Grigoriy: folds 
matiko09: folds 
xxxibgdrgn: folds 
stds st: folds 
yfcq36: calls $1.50
*** FLOP *** [7d 6c Jc]
yfcq36: checks 
PacPacBum: checks 
*** TURN *** [7d 6c Jc] [5s]
yfcq36: bets $3
PacPacBum: calls $3
*** RIVER *** [7d 6c Jc 5s] [Kc]
yfcq36: bets $10.92
PacPacBum: folds 
Uncalled bet ($10.92) returned to yfcq36
yfcq36 collected $10.92 from pot
yfcq36: doesn't show hand 
*** SUMMARY ***
Total pot $11.50 | Rake $0.58 
Board [7d 6c Jc 5s Kc]
Seat 1: matiko09 folded before Flop (didn't bet)
Seat 2: xxxibgdrgn (button) folded before Flop (didn't bet)
Seat 5: stds st (small blind) folded before Flop
Seat 6: yfcq36 (big blind) collected ($10.92)
Seat 7: 32rrew folded before Flop (didn't bet)
Seat 8: PacPacBum folded on the River
Seat 9: Mr.Grigoriy folded before Flop (didn't bet)





PokerStars Hand #154363811791:  Hold'em No Limit ($0.50/$1.00 USD) - 2016/06/06 13:12:34 CET [2016/06/06 7:12:34 ET]
Table 'Smither' 9-max Seat #2 is the button
Seat 1: PacPacBum ($171.10 in chips) 
Seat 2: matiko09 ($100 in chips) 
Seat 3: xxxZeka ($129.57 in chips) 
Seat 4: maxxmeister ($211.74 in chips) 
Seat 5: Szevasztopol ($122.12 in chips) 
Seat 6: mooose100 ($74.97 in chips) 
Seat 7: vanilica ($123.57 in chips) 
Seat 8: 74 ROADIE ($68.05 in chips) 
Seat 9: hammerwife ($130.75 in chips) 
xxxZeka: posts small blind $0.50
maxxmeister: posts big blind $1
*** HOLE CARDS ***
Dealt to matiko09 [3d 7s]
Szevasztopol: folds 
mooose100: folds 
vanilica: folds 
74 ROADIE: raises $2 to $3
hammerwife: folds 
PacPacBum: folds 
matiko09: folds 
xxxZeka: folds 
maxxmeister: folds 
Uncalled bet ($2) returned to 74 ROADIE
74 ROADIE collected $2.50 from pot
*** SUMMARY ***
Total pot $2.50 | Rake $0 
Seat 1: PacPacBum folded before Flop (didn't bet)
Seat 2: matiko09 (button) folded before Flop (didn't bet)
Seat 3: xxxZeka (small blind) folded before Flop
Seat 4: maxxmeister (big blind) folded before Flop
Seat 5: Szevasztopol folded before Flop (didn't bet)
Seat 6: mooose100 folded before Flop (didn't bet)
Seat 7: vanilica folded before Flop (didn't bet)
Seat 8: 74 ROADIE collected ($2.50)
Seat 9: hammerwife folded before Flop (didn't bet)





PokerStars Hand #154363814361:  Hold'em No Limit ($0.50/$1.00 USD) - 2016/06/06 13:12:40 CET [2016/06/06 7:12:40 ET]
Table 'Wezen II' 9-max Seat #4 is the button
Seat 1: matiko09 ($178.82 in chips) 
Seat 2: Mr.Grigoriy ($117.12 in chips) 
Seat 3: Dickyxxx ($100 in chips) 
Seat 4: xxxibgdrgn ($100 in chips) 
Seat 5: stds st ($32.15 in chips) 
Seat 7: KDJAll3 ($78.46 in chips) 
Seat 8: o.miro ($106.50 in chips) 
Seat 9: PacPacBum ($102.50 in chips) 
stds st: posts small blind $0.50
vanilica: is sitting out 
KDJAll3: posts big blind $1
vanilica leaves the table
*** HOLE CARDS ***
Dealt to matiko09 [Qd Qh]
o.miro: folds 
PacPacBum: folds 
matiko09: raises $2 to $3
Mr.Grigoriy: folds 
xxxZeka joins the table at seat #6 
xxxZeka leaves the table
hurtNCYDE joins the table at seat #6 
hurtNCYDE leaves the table
Dickyxxx: calls $3
Eskimo Fox joins the table at seat #6 
xxxibgdrgn: raises $8 to $11
stds st: folds 
KDJAll3: folds 
matiko09: calls $8
Dickyxxx: folds 
*** FLOP *** [Qc Ad Kh]
matiko09: checks 
xxxibgdrgn: bets $14
matiko09: calls $14
*** TURN *** [Qc Ad Kh] [9c]
matiko09: checks 
xxxibgdrgn: bets $28.50
matiko09: raises $125.32 to $153.82 and is all-in
xxxibgdrgn: calls $46.50 and is all-in
Uncalled bet ($78.82) returned to matiko09
*** RIVER *** [Qc Ad Kh 9c] [Kc]
*** SHOW DOWN ***
matiko09: shows [Qd Qh] (a full house, Queens full of Kings)
xxxibgdrgn: shows [Ks As] (a full house, Kings full of Aces)
xxxibgdrgn collected $202 from pot
*** SUMMARY ***
Total pot $204.50 | Rake $2.50 
Board [Qc Ad Kh 9c Kc]
Seat 1: matiko09 showed [Qd Qh] and lost with a full house, Queens full of Kings
Seat 2: Mr.Grigoriy folded before Flop (didn't bet)
Seat 3: Dickyxxx folded before Flop
Seat 4: xxxibgdrgn (button) showed [Ks As] and won ($202) with a full house, Kings full of Aces
Seat 5: stds st (small blind) folded before Flop
Seat 7: KDJAll3 (big blind) folded before Flop
Seat 8: o.miro folded before Flop (didn't bet)
Seat 9: PacPacBum folded before Flop (didn't bet)





PokerStars Hand #154363823169:  Hold'em No Limit ($0.50/$1.00 USD) - 2016/06/06 13:13:00 CET [2016/06/06 7:13:00 ET]
Table 'Chaldaea II' 9-max Seat #6 is the button
Seat 1: Szevasztopol ($107.08 in chips) 
Seat 2: Mr.Grigoriy ($101.50 in chips) 
Seat 3: ardo888 ($108.85 in chips) 
Seat 4: mooose100 ($128.65 in chips) 
Seat 5: stds st ($27.74 in chips) 
Seat 6: PacPacBum ($100 in chips) 
Seat 7: xxxibgdrgn ($100 in chips) 
Seat 8: 32rrew ($101.50 in chips) 
Seat 9: matiko09 ($101.50 in chips) 
xxxibgdrgn: posts small blind $0.50
32rrew: posts big blind $1
*** HOLE CARDS ***
Dealt to matiko09 [3h 8c]
matiko09: folds 
Szevasztopol: folds 
Mr.Grigoriy: folds 
ardo888: folds 
mooose100: folds 
stds st: raises $1.02 to $2.02
PacPacBum: folds 
xxxibgdrgn: folds 
32rrew: calls $1.02
*** FLOP *** [6s 3c Jd]
32rrew: checks 
stds st: bets $2.37
32rrew: folds 
Uncalled bet ($2.37) returned to stds st
stds st collected $4.31 from pot
stds st: doesn't show hand 
*** SUMMARY ***
Total pot $4.54 | Rake $0.23 
Board [6s 3c Jd]
Seat 1: Szevasztopol folded before Flop (didn't bet)
Seat 2: Mr.Grigoriy folded before Flop (didn't bet)
Seat 3: ardo888 folded before Flop (didn't bet)
Seat 4: mooose100 folded before Flop (didn't bet)
Seat 5: stds st collected ($4.31)
Seat 6: PacPacBum (button) folded before Flop (didn't bet)
Seat 7: xxxibgdrgn (small blind) folded before Flop
Seat 8: 32rrew (big blind) folded on the Flop
Seat 9: matiko09 folded before Flop (didn't bet)





PokerStars Hand #154363830884:  Hold'em No Limit ($0.50/$1.00 USD) - 2016/06/06 13:13:18 CET [2016/06/06 7:13:18 ET]
Table 'Smither' 9-max Seat #3 is the button
Seat 1: PacPacBum ($171.10 in chips) 
Seat 2: matiko09 ($100 in chips) 
Seat 3: xxxZeka ($129.07 in chips) 
Seat 4: maxxmeister ($210.74 in chips) 
Seat 5: Szevasztopol ($122.12 in chips) 
Seat 6: mooose100 ($74.97 in chips) 
Seat 7: vanilica ($123.57 in chips) 
Seat 8: 74 ROADIE ($69.55 in chips) 
Seat 9: hammerwife ($130.75 in chips) 
maxxmeister: posts small blind $0.50
Szevasztopol: posts big blind $1
*** HOLE CARDS ***
Dealt to matiko09 [Jc Qd]
mooose100: folds 
vanilica: folds 
74 ROADIE: folds 
hammerwife: folds 
PacPacBum: folds 
74 ROADIE leaves the table
ozone2003 joins the table at seat #8 
matiko09: raises $1.50 to $2.50
xxxZeka: raises $5.50 to $8
maxxmeister: folds 
Szevasztopol: folds 
matiko09: folds 
Uncalled bet ($5.50) returned to xxxZeka
xxxZeka collected $6.50 from pot
*** SUMMARY ***
Total pot $6.50 | Rake $0 
Seat 1: PacPacBum folded before Flop (didn't bet)
Seat 2: matiko09 folded before Flop
Seat 3: xxxZeka (button) collected ($6.50)
Seat 4: maxxmeister (small blind) folded before Flop
Seat 5: Szevasztopol (big blind) folded before Flop
Seat 6: mooose100 folded before Flop (didn't bet)
Seat 7: vanilica folded before Flop (didn't bet)
Seat 8: 74 ROADIE folded before Flop (didn't bet)
Seat 9: hammerwife folded before Flop (didn't bet)





PokerStars Hand #154363832095:  Hold'em No Limit ($0.50/$1.00 USD) - 2016/06/06 13:13:21 CET [2016/06/06 7:13:21 ET]
Table 'Sheliak' 9-max Seat #3 is the button
Seat 1: 32rrew ($100.33 in chips) 
Seat 2: DancerNN1 ($100 in chips) 
Seat 3: xxxZeka ($121.30 in chips) 
Seat 4: iRLM ($77.03 in chips) 
Seat 5: hammerwife ($102 in chips) 
Seat 6: matiko09 ($100.32 in chips) 
Seat 7: stds st ($40 in chips) 
Seat 8: ozone2003 ($100 in chips) 
Seat 9: Szevasztopol ($104.85 in chips) 
iRLM: posts small blind $0.50
hammerwife: posts big blind $1
*** HOLE CARDS ***
Dealt to matiko09 [Jh Qh]
matiko09: raises $2 to $3
stds st: folds 
ozone2003: folds 
Szevasztopol: folds 
32rrew: folds 
DancerNN1: folds 
xxxZeka: folds 
iRLM: calls $2.50
hammerwife: calls $2
*** FLOP *** [Tc 9s Ks]
iRLM: bets $1.78
hammerwife: folds 
matiko09: raises $7.22 to $9
iRLM: folds 
Uncalled bet ($7.22) returned to matiko09
matiko09 collected $11.93 from pot
matiko09: doesn't show hand 
*** SUMMARY ***
Total pot $12.56 | Rake $0.63 
Board [Tc 9s Ks]
Seat 1: 32rrew folded before Flop (didn't bet)
Seat 2: DancerNN1 folded before Flop (didn't bet)
Seat 3: xxxZeka (button) folded before Flop (didn't bet)
Seat 4: iRLM (small blind) folded on the Flop
Seat 5: hammerwife (big blind) folded on the Flop
Seat 6: matiko09 collected ($11.93)
Seat 7: stds st folded before Flop (didn't bet)
Seat 8: ozone2003 folded before Flop (didn't bet)
Seat 9: Szevasztopol folded before Flop (didn't bet)





PokerStars Hand #154363832227:  Hold'em No Limit ($0.50/$1.00 USD) - 2016/06/06 13:13:21 CET [2016/06/06 7:13:21 ET]
Table 'Gajdariya' 9-max Seat #9 is the button
Seat 1: matiko09 ($128.54 in chips) 
Seat 2: Dickyxxx ($100 in chips) 
Seat 4: Szevasztopol ($116.27 in chips) 
Seat 5: stds st ($80.13 in chips) 
Seat 7: hurtNCYDE ($111.57 in chips) 
Seat 8: ardo888 ($136.82 in chips) 
Seat 9: PacPacBum ($113.23 in chips) 
matiko09: posts small blind $0.50
Dickyxxx: posts big blind $1
mooose100: sits out 
vanilica: sits out 
*** HOLE CARDS ***
Dealt to matiko09 [9c 8d]
Szevasztopol: raises $1.14 to $2.14
stds st: folds 
hurtNCYDE: folds 
ardo888: folds 
PacPacBum: folds 
matiko09: folds 
Dickyxxx: folds 
Uncalled bet ($1.14) returned to Szevasztopol
Szevasztopol collected $2.50 from pot
Szevasztopol: doesn't show hand 
*** SUMMARY ***
Total pot $2.50 | Rake $0 
Seat 1: matiko09 (small blind) folded before Flop
Seat 2: Dickyxxx (big blind) folded before Flop
Seat 4: Szevasztopol collected ($2.50)
Seat 5: stds st folded before Flop (didn't bet)
Seat 7: hurtNCYDE folded before Flop (didn't bet)
Seat 8: ardo888 folded before Flop (didn't bet)
Seat 9: PacPacBum (button) folded before Flop (didn't bet)





PokerStars Hand #154363839550:  Hold'em No Limit ($0.50/$1.00 USD) - 2016/06/06 13:13:38 CET [2016/06/06 7:13:38 ET]
Table 'Heze' 9-max Seat #5 is the button
Seat 1: matiko09 ($173.17 in chips) 
Seat 2: xxxibgdrgn ($117.98 in chips) 
Seat 5: stds st ($39 in chips) 
Seat 6: yfcq36 ($121.55 in chips) 
Seat 7: 32rrew ($162.47 in chips) 
Seat 8: PacPacBum ($113.20 in chips) 
Seat 9: Mr.Grigoriy ($132.21 in chips) 
yfcq36: posts small blind $0.50
32rrew: posts big blind $1
Dickyxxx: sits out 
*** HOLE CARDS ***
Dealt to matiko09 [Qs 3h]
PacPacBum: folds 
Mr.Grigoriy: folds 
matiko09: folds 
xxxibgdrgn: raises $1.50 to $2.50
stds st: folds 
yfcq36: folds 
32rrew: folds 
Uncalled bet ($1.50) returned to xxxibgdrgn
xxxibgdrgn collected $2.50 from pot
xxxibgdrgn: doesn't show hand 
*** SUMMARY ***
Total pot $2.50 | Rake $0 
Seat 1: matiko09 folded before Flop (didn't bet)
Seat 2: xxxibgdrgn collected ($2.50)
Seat 5: stds st (button) folded before Flop (didn't bet)
Seat 6: yfcq36 (small blind) folded before Flop
Seat 7: 32rrew (big blind) folded before Flop
Seat 8: PacPacBum folded before Flop (didn't bet)
Seat 9: Mr.Grigoriy folded before Flop (didn't bet)





PokerStars Hand #154363845828:  Hold'em No Limit ($0.50/$1.00 USD) - 2016/06/06 13:13:53 CET [2016/06/06 7:13:53 ET]
Table 'Smither' 9-max Seat #4 is the button
Seat 1: PacPacBum ($171.10 in chips) 
Seat 2: matiko09 ($100 in chips) 
Seat 3: xxxZeka ($133.07 in chips) 
Seat 4: maxxmeister ($210.24 in chips) 
Seat 5: Szevasztopol ($121.12 in chips) 
Seat 6: mooose100 ($74.97 in chips) 
Seat 7: vanilica ($123.57 in chips) 
Seat 9: hammerwife ($130.75 in chips) 
Szevasztopol: posts small blind $0.50
mooose100: posts big blind $1
ozone2003: sits out 
*** HOLE CARDS ***
Dealt to matiko09 [Ks 8c]
vanilica: folds 
hammerwife: folds 
PacPacBum: folds 
matiko09: folds 
xxxZeka: raises $2 to $3
maxxmeister: folds 
Szevasztopol: folds 
mooose100: calls $2
*** FLOP *** [Qd 6h Tc]
mooose100: checks 
xxxZeka: checks 
*** TURN *** [Qd 6h Tc] [Kh]
mooose100: bets $3.09
xxxZeka: folds 
Uncalled bet ($3.09) returned to mooose100
mooose100 collected $6.18 from pot
mooose100: doesn't show hand 
*** SUMMARY ***
Total pot $6.50 | Rake $0.32 
Board [Qd 6h Tc Kh]
Seat 1: PacPacBum folded before Flop (didn't bet)
Seat 2: matiko09 folded before Flop (didn't bet)
Seat 3: xxxZeka folded on the Turn
Seat 4: maxxmeister (button) folded before Flop (didn't bet)
Seat 5: Szevasztopol (small blind) folded before Flop
Seat 6: mooose100 (big blind) collected ($6.18)
Seat 7: vanilica folded before Flop (didn't bet)
Seat 9: hammerwife folded before Flop (didn't bet)





PokerStars Hand #154363846145:  Hold'em No Limit ($0.50/$1.00 USD) - 2016/06/06 13:13:54 CET [2016/06/06 7:13:54 ET]
Table 'Gajdariya' 9-max Seat #1 is the button
Seat 1: matiko09 ($128.04 in chips) 
Seat 2: Dickyxxx ($100 in chips) 
Seat 3: mooose100 ($80 in chips) 
Seat 4: Szevasztopol ($117.77 in chips) 
Seat 5: stds st ($80.13 in chips) 
Seat 7: hurtNCYDE ($111.57 in chips) 
Seat 8: ardo888 ($136.82 in chips) 
Seat 9: PacPacBum ($113.23 in chips) 
Dickyxxx: posts small blind $0.50
mooose100: posts big blind $1
vanilica: sits out 
*** HOLE CARDS ***
Dealt to matiko09 [2h 3d]
Szevasztopol: folds 
stds st: folds 
hurtNCYDE: folds 
ardo888: folds 
PacPacBum: folds 
matiko09: folds 
Dickyxxx: folds 
Uncalled bet ($0.50) returned to mooose100
mooose100 collected $1 from pot
mooose100: doesn't show hand 
*** SUMMARY ***
Total pot $1 | Rake $0 
Seat 1: matiko09 (button) folded before Flop (didn't bet)
Seat 2: Dickyxxx (small blind) folded before Flop
Seat 3: mooose100 (big blind) collected ($1)
Seat 4: Szevasztopol folded before Flop (didn't bet)
Seat 5: stds st folded before Flop (didn't bet)
Seat 7: hurtNCYDE folded before Flop (didn't bet)
Seat 8: ardo888 folded before Flop (didn't bet)
Seat 9: PacPacBum folded before Flop (didn't bet)





PokerStars Hand #154363851884:  Hold'em No Limit ($0.50/$1.00 USD) - 2016/06/06 13:14:07 CET [2016/06/06 7:14:07 ET]
Table 'Chaldaea II' 9-max Seat #7 is the button
Seat 1: Szevasztopol ($107.08 in chips) 
Seat 2: Mr.Grigoriy ($101.50 in chips) 
Seat 3: ardo888 ($108.85 in chips) 
Seat 4: mooose100 ($128.65 in chips) 
Seat 5: stds st ($30.03 in chips) 
Seat 6: PacPacBum ($100 in chips) 
Seat 7: xxxibgdrgn ($100 in chips) 
Seat 8: 32rrew ($100 in chips) 
Seat 9: matiko09 ($101.50 in chips) 
32rrew: posts small blind $0.50
matiko09: posts big blind $1
*** HOLE CARDS ***
Dealt to matiko09 [2h 8h]
Szevasztopol: folds 
Mr.Grigoriy: folds 
ardo888: folds 
mooose100: folds 
stds st: folds 
PacPacBum: folds 
xxxibgdrgn: folds 
32rrew: folds 
Uncalled bet ($0.50) returned to matiko09
matiko09 collected $1 from pot
matiko09: doesn't show hand 
*** SUMMARY ***
Total pot $1 | Rake $0 
Seat 1: Szevasztopol folded before Flop (didn't bet)
Seat 2: Mr.Grigoriy folded before Flop (didn't bet)
Seat 3: ardo888 folded before Flop (didn't bet)
Seat 4: mooose100 folded before Flop (didn't bet)
Seat 5: stds st folded before Flop (didn't bet)
Seat 6: PacPacBum folded before Flop (didn't bet)
Seat 7: xxxibgdrgn (button) folded before Flop (didn't bet)
Seat 8: 32rrew (small blind) folded before Flop
Seat 9: matiko09 (big blind) collected ($1)





PokerStars Hand #154363852375:  Hold'em No Limit ($0.50/$1.00 USD) - 2016/06/06 13:14:08 CET [2016/06/06 7:14:08 ET]
Table 'Heze' 9-max Seat #6 is the button
Seat 1: matiko09 ($173.17 in chips) 
Seat 2: xxxibgdrgn ($119.48 in chips) 
Seat 5: stds st ($39 in chips) 
Seat 6: yfcq36 ($121.05 in chips) 
Seat 7: 32rrew ($161.47 in chips) 
Seat 8: PacPacBum ($113.20 in chips) 
Seat 9: Mr.Grigoriy ($132.21 in chips) 
32rrew: posts small blind $0.50
PacPacBum: posts big blind $1
Dickyxxx: sits out 
*** HOLE CARDS ***
Dealt to matiko09 [Jc 3d]
Mr.Grigoriy: folds 
matiko09: folds 
xxxibgdrgn: folds 
stds st: folds 
yfcq36: raises $2 to $3
32rrew: folds 
PacPacBum: folds 
Uncalled bet ($2) returned to yfcq36
yfcq36 collected $2.50 from pot
yfcq36: doesn't show hand 
*** SUMMARY ***
Total pot $2.50 | Rake $0 
Seat 1: matiko09 folded before Flop (didn't bet)
Seat 2: xxxibgdrgn folded before Flop (didn't bet)
Seat 5: stds st folded before Flop (didn't bet)
Seat 6: yfcq36 (button) collected ($2.50)
Seat 7: 32rrew (small blind) folded before Flop
Seat 8: PacPacBum (big blind) folded before Flop
Seat 9: Mr.Grigoriy folded before Flop (didn't bet)





PokerStars Hand #154363860240:  Hold'em No Limit ($0.50/$1.00 USD) - 2016/06/06 13:14:26 CET [2016/06/06 7:14:26 ET]
Table 'Safara' 9-max Seat #4 is the button
Seat 1: Dickyxxx ($100 in chips) 
Seat 2: ozone2003 ($100.88 in chips) 
Seat 4: xxxibgdrgn ($100.88 in chips) 
Seat 5: perezzi10 ($50 in chips) 
Seat 6: matiko09 ($143.28 in chips) 
Seat 7: PacPacBum ($122.53 in chips) 
Seat 8: 32rrew ($107.27 in chips) 
perezzi10: posts small blind $0.50
matiko09: posts big blind $1
R1aki: sits out 
erd33: sits out 
*** HOLE CARDS ***
Dealt to matiko09 [4d 2c]
PacPacBum: folds 
32rrew: folds 
Dickyxxx: folds 
ozone2003: raises $1.50 to $2.50
xxxibgdrgn: folds 
perezzi10: calls $2
matiko09: folds 
*** FLOP *** [2d Qd 8c]
perezzi10: checks 
ozone2003: bets $3.70
perezzi10: folds 
Uncalled bet ($3.70) returned to ozone2003
ozone2003 collected $5.70 from pot
ozone2003: doesn't show hand 
*** SUMMARY ***
Total pot $6 | Rake $0.30 
Board [2d Qd 8c]
Seat 1: Dickyxxx folded before Flop (didn't bet)
Seat 2: ozone2003 collected ($5.70)
Seat 4: xxxibgdrgn (button) folded before Flop (didn't bet)
Seat 5: perezzi10 (small blind) folded on the Flop
Seat 6: matiko09 (big blind) folded before Flop
Seat 7: PacPacBum folded before Flop (didn't bet)
Seat 8: 32rrew folded before Flop (didn't bet)





PokerStars Hand #154363860358:  Hold'em No Limit ($0.50/$1.00 USD) - 2016/06/06 13:14:27 CET [2016/06/06 7:14:27 ET]
Table 'Wezen II' 9-max Seat #5 is the button
Seat 1: matiko09 ($100 in chips) 
Seat 2: Mr.Grigoriy ($117.12 in chips) 
Seat 3: Dickyxxx ($100 in chips) 
Seat 4: xxxibgdrgn ($202 in chips) 
Seat 5: stds st ($31.65 in chips) 
Seat 7: KDJAll3 ($77.46 in chips) 
Seat 8: o.miro ($106.50 in chips) 
Seat 9: PacPacBum ($102.50 in chips) 
Eskimo Fox will be allowed to play after the button
KDJAll3: posts small blind $0.50
o.miro: posts big blind $1
*** HOLE CARDS ***
Dealt to matiko09 [2d 5c]
PacPacBum: folds 
matiko09: folds 
Mr.Grigoriy: raises $2 to $3
Dickyxxx: folds 
xxxibgdrgn: calls $3
stds st: raises $28.65 to $31.65 and is all-in
KDJAll3: folds 
o.miro: folds 
Mr.Grigoriy: folds 
xxxibgdrgn: folds 
Uncalled bet ($28.65) returned to stds st
stds st collected $10.50 from pot
stds st: doesn't show hand 
*** SUMMARY ***
Total pot $10.50 | Rake $0 
Seat 1: matiko09 folded before Flop (didn't bet)
Seat 2: Mr.Grigoriy folded before Flop
Seat 3: Dickyxxx folded before Flop (didn't bet)
Seat 4: xxxibgdrgn folded before Flop
Seat 5: stds st (button) collected ($10.50)
Seat 7: KDJAll3 (small blind) folded before Flop
Seat 8: o.miro (big blind) folded before Flop
Seat 9: PacPacBum folded before Flop (didn't bet)





PokerStars Hand #154363862269:  Hold'em No Limit (€0.50/€1.00 EUR) - 2016/06/06 13:14:31 CET [2016/06/06 7:14:31 ET]
Table 'Lesath' 9-max Seat #1 is the button
Seat 1: o.miro (€100.96 in chips) 
Seat 2: thecurv (€111.49 in chips) 
Seat 3: ozone2003 (€222.64 in chips) 
Seat 4: hammerwife (€127.11 in chips) 
Seat 5: matiko09 (€113.47 in chips) 
Seat 6: Szevasztopol (€143.39 in chips) 
Seat 7: Mr.Grigoriy (€100 in chips) 
Seat 9: 72nloses (€46.16 in chips) 
thecurv: posts small blind €0.50
ozone2003: posts big blind €1
maxxmeister: sits out 
*** HOLE CARDS ***
Dealt to matiko09 [2d 9c]
hammerwife: folds 
matiko09: folds 
Szevasztopol: folds 
Mr.Grigoriy: folds 
72nloses: folds 
o.miro: folds 
thecurv: folds 
Uncalled bet (€0.50) returned to ozone2003
ozone2003 collected €1 from pot
ozone2003: doesn't show hand 
*** SUMMARY ***
Total pot €1 | Rake €0 
Seat 1: o.miro (button) folded before Flop (didn't bet)
Seat 2: thecurv (small blind) folded before Flop
Seat 3: ozone2003 (big blind) collected (€1)
Seat 4: hammerwife folded before Flop (didn't bet)
Seat 5: matiko09 folded before Flop (didn't bet)
Seat 6: Szevasztopol folded before Flop (didn't bet)
Seat 7: Mr.Grigoriy folded before Flop (didn't bet)
Seat 9: 72nloses folded before Flop (didn't bet)





PokerStars Hand #154363862549:  Hold'em No Limit ($0.50/$1.00 USD) - 2016/06/06 13:14:32 CET [2016/06/06 7:14:32 ET]
Table 'Sheliak' 9-max Seat #4 is the button
Seat 1: 32rrew ($100.33 in chips) 
Seat 2: DancerNN1 ($100 in chips) 
Seat 3: xxxZeka ($121.30 in chips) 
Seat 4: iRLM ($72.25 in chips) 
Seat 5: hammerwife ($100 in chips) 
Seat 6: matiko09 ($107.47 in chips) 
Seat 7: stds st ($40 in chips) 
Seat 8: ozone2003 ($100 in chips) 
Seat 9: Szevasztopol ($104.85 in chips) 
hammerwife: posts small blind $0.50
matiko09: posts big blind $1
*** HOLE CARDS ***
Dealt to matiko09 [Jd Ts]
stds st: folds 
ozone2003: folds 
Szevasztopol: folds 
32rrew: folds 
DancerNN1: folds 
xxxZeka: folds 
iRLM: folds 
hammerwife: folds 
Uncalled bet ($0.50) returned to matiko09
matiko09 collected $1 from pot
matiko09: doesn't show hand 
*** SUMMARY ***
Total pot $1 | Rake $0 
Seat 1: 32rrew folded before Flop (didn't bet)
Seat 2: DancerNN1 folded before Flop (didn't bet)
Seat 3: xxxZeka folded before Flop (didn't bet)
Seat 4: iRLM (button) folded before Flop (didn't bet)
Seat 5: hammerwife (small blind) folded before Flop
Seat 6: matiko09 (big blind) collected ($1)
Seat 7: stds st folded before Flop (didn't bet)
Seat 8: ozone2003 folded before Flop (didn't bet)
Seat 9: Szevasztopol folded before Flop (didn't bet)





PokerStars Hand #154363865930:  Hold'em No Limit ($0.50/$1.00 USD) - 2016/06/06 13:14:40 CET [2016/06/06 7:14:40 ET]
Table 'Gajdariya' 9-max Seat #2 is the button
Seat 1: matiko09 ($128.04 in chips) 
Seat 2: Dickyxxx ($100 in chips) 
Seat 3: mooose100 ($80.50 in chips) 
Seat 4: Szevasztopol ($117.77 in chips) 
Seat 5: stds st ($80.13 in chips) 
Seat 7: hurtNCYDE ($111.57 in chips) 
Seat 8: ardo888 ($136.82 in chips) 
Seat 9: PacPacBum ($113.23 in chips) 
mooose100: posts small blind $0.50
Szevasztopol: posts big blind $1
vanilica: sits out 
*** HOLE CARDS ***
Dealt to matiko09 [6d 4h]
stds st: raises $2 to $3
hurtNCYDE: folds 
ardo888: folds 
PacPacBum: folds 
matiko09: folds 
Dickyxxx: calls $3
mooose100: folds 
Szevasztopol: calls $2
*** FLOP *** [9d Qc Kh]
Szevasztopol: checks 
stds st: checks 
Dickyxxx: checks 
*** TURN *** [9d Qc Kh] [9c]
Szevasztopol: checks 
stds st: checks 
Dickyxxx: checks 
*** RIVER *** [9d Qc Kh 9c] [Qs]
Szevasztopol: checks 
stds st: checks 
Dickyxxx: checks 
*** SHOW DOWN ***
Szevasztopol: shows [6h 6c] (two pair, Queens and Nines)
stds st: shows [7s 7c] (two pair, Queens and Nines)
Dickyxxx: shows [Js Ad] (two pair, Queens and Nines - Ace kicker)
Dickyxxx collected $9.02 from pot
*** SUMMARY ***
Total pot $9.50 | Rake $0.48 
Board [9d Qc Kh 9c Qs]
Seat 1: matiko09 folded before Flop (didn't bet)
Seat 2: Dickyxxx (button) showed [Js Ad] and won ($9.02) with two pair, Queens and Nines
Seat 3: mooose100 (small blind) folded before Flop
Seat 4: Szevasztopol (big blind) showed [6h 6c] and lost with two pair, Queens and Nines
Seat 5: stds st showed [7s 7c] and lost with two pair, Queens and Nines
Seat 7: hurtNCYDE folded before Flop (didn't bet)
Seat 8: ardo888 folded before Flop (didn't bet)
Seat 9: PacPacBum folded before Flop (didn't bet)





PokerStars Hand #154363869998:  Hold'em No Limit ($0.50/$1.00 USD) - 2016/06/06 13:14:49 CET [2016/06/06 7:14:49 ET]
Table 'Heze' 9-max Seat #7 is the button
Seat 1: matiko09 ($173.17 in chips) 
Seat 2: xxxibgdrgn ($119.48 in chips) 
Seat 5: stds st ($39 in chips) 
Seat 6: yfcq36 ($122.55 in chips) 
Seat 7: 32rrew ($160.97 in chips) 
Seat 8: PacPacBum ($112.20 in chips) 
Seat 9: Mr.Grigoriy ($132.21 in chips) 
PacPacBum: posts small blind $0.50
Mr.Grigoriy: posts big blind $1
Dickyxxx: sits out 
*** HOLE CARDS ***
Dealt to matiko09 [Js 7c]
matiko09: folds 
xxxibgdrgn: folds 
stds st: raises $1.50 to $2.50
yfcq36: folds 
32rrew: folds 
PacPacBum: raises $5.50 to $8
Mr.Grigoriy: folds 
stds st: folds 
Uncalled bet ($5.50) returned to PacPacBum
PacPacBum collected $6 from pot
PacPacBum: doesn't show hand 
*** SUMMARY ***
Total pot $6 | Rake $0 
Seat 1: matiko09 folded before Flop (didn't bet)
Seat 2: xxxibgdrgn folded before Flop (didn't bet)
Seat 5: stds st folded before Flop
Seat 6: yfcq36 folded before Flop (didn't bet)
Seat 7: 32rrew (button) folded before Flop (didn't bet)
Seat 8: PacPacBum (small blind) collected ($6)
Seat 9: Mr.Grigoriy (big blind) folded before Flop





PokerStars Hand #154363870184:  Hold'em No Limit (€0.50/€1.00 EUR) - 2016/06/06 13:14:50 CET [2016/06/06 7:14:50 ET]
Table 'Lesath' 9-max Seat #2 is the button
Seat 1: o.miro (€100.96 in chips) 
Seat 2: thecurv (€110.99 in chips) 
Seat 3: ozone2003 (€223.14 in chips) 
Seat 4: hammerwife (€127.11 in chips) 
Seat 5: matiko09 (€113.47 in chips) 
Seat 6: Szevasztopol (€143.39 in chips) 
Seat 7: Mr.Grigoriy (€100 in chips) 
Seat 9: 72nloses (€46.16 in chips) 
ozone2003: posts small blind €0.50
hammerwife: posts big blind €1
maxxmeister: sits out 
*** HOLE CARDS ***
Dealt to matiko09 [6s 4h]
matiko09: folds 
Szevasztopol: folds 
Mr.Grigoriy: folds 
maxxmeister leaves the table
72nloses has timed out
72nloses: folds 
o.miro: raises €1.50 to €2.50
thecurv: folds 
stds st joins the table at seat #8 
ozone2003: raises €6.50 to €9
hammerwife: folds 
o.miro: calls €6.50
*** FLOP *** [7d Ks 5h]
ozone2003: bets €9.50
o.miro: calls €9.50
*** TURN *** [7d Ks 5h] [Js]
ozone2003: checks 
o.miro: bets €23
ozone2003: folds 
Uncalled bet (€23) returned to o.miro
o.miro collected €36.10 from pot
o.miro: doesn't show hand 
*** SUMMARY ***
Total pot €38 | Rake €1.90 
Board [7d Ks 5h Js]
Seat 1: o.miro collected (€36.10)
Seat 2: thecurv (button) folded before Flop (didn't bet)
Seat 3: ozone2003 (small blind) folded on the Turn
Seat 4: hammerwife (big blind) folded before Flop
Seat 5: matiko09 folded before Flop (didn't bet)
Seat 6: Szevasztopol folded before Flop (didn't bet)
Seat 7: Mr.Grigoriy folded before Flop (didn't bet)
Seat 9: 72nloses folded before Flop (didn't bet)





PokerStars Hand #154363873768:  Hold'em No Limit ($0.50/$1.00 USD) - 2016/06/06 13:14:58 CET [2016/06/06 7:14:58 ET]
Table 'Safara' 9-max Seat #5 is the button
Seat 1: Dickyxxx ($100 in chips) 
Seat 2: ozone2003 ($104.08 in chips) 
Seat 4: xxxibgdrgn ($100.88 in chips) 
Seat 5: perezzi10 ($47.50 in chips) 
Seat 6: matiko09 ($142.28 in chips) 
Seat 9: R1aki ($100 in chips) 
matiko09: posts small blind $0.50
PacPacBum: is sitting out 
32rrew: is sitting out 
R1aki: posts big blind $1
32rrew leaves the table
erd33: sits out 
*** HOLE CARDS ***
Dealt to matiko09 [2c 6h]
Dickyxxx: raises $2 to $3
ozone2003: folds 
o.miro joins the table at seat #8 
xxxibgdrgn: folds 
perezzi10: calls $3
matiko09: folds 
R1aki: folds 
*** FLOP *** [8s Qh 5h]
Dickyxxx: bets $4.55
perezzi10: folds 
Uncalled bet ($4.55) returned to Dickyxxx
Dickyxxx collected $7.12 from pot
Dickyxxx: doesn't show hand 
*** SUMMARY ***
Total pot $7.50 | Rake $0.38 
Board [8s Qh 5h]
Seat 1: Dickyxxx collected ($7.12)
Seat 2: ozone2003 folded before Flop (didn't bet)
Seat 4: xxxibgdrgn folded before Flop (didn't bet)
Seat 5: perezzi10 (button) folded on the Flop
Seat 6: matiko09 (small blind) folded before Flop
Seat 9: R1aki (big blind) folded before Flop





PokerStars Hand #154363875830:  Hold'em No Limit ($0.50/$1.00 USD) - 2016/06/06 13:15:03 CET [2016/06/06 7:15:03 ET]
Table 'Chaldaea II' 9-max Seat #8 is the button
Seat 2: Mr.Grigoriy ($101.50 in chips) 
Seat 3: ardo888 ($108.85 in chips) 
Seat 4: mooose100 ($128.65 in chips) 
Seat 5: stds st ($30.03 in chips) 
Seat 6: PacPacBum ($100 in chips) 
Seat 7: xxxibgdrgn ($100 in chips) 
Seat 8: 32rrew ($100 in chips) 
Seat 9: matiko09 ($102 in chips) 
matiko09: posts small blind $0.50
Szevasztopol: is sitting out 
Mr.Grigoriy: posts big blind $1
*** HOLE CARDS ***
Dealt to matiko09 [Qc 5s]
ardo888: raises $2 to $3
mooose100: calls $3
stds st: folds 
PacPacBum: folds 
xxxibgdrgn: raises $8 to $11
32rrew: folds 
matiko09: folds 
Mr.Grigoriy: folds 
ardo888: folds 
mooose100: calls $8
*** FLOP *** [9d Th 5d]
mooose100: bets $12.59
xxxibgdrgn: folds 
Uncalled bet ($12.59) returned to mooose100
mooose100 collected $25.18 from pot
*** SUMMARY ***
Total pot $26.50 | Rake $1.32 
Board [9d Th 5d]
Seat 2: Mr.Grigoriy (big blind) folded before Flop
Seat 3: ardo888 folded before Flop
Seat 4: mooose100 collected ($25.18)
Seat 5: stds st folded before Flop (didn't bet)
Seat 6: PacPacBum folded before Flop (didn't bet)
Seat 7: xxxibgdrgn folded on the Flop
Seat 8: 32rrew (button) folded before Flop (didn't bet)
Seat 9: matiko09 (small blind) folded before Flop





PokerStars Hand #154363881282:  Hold'em No Limit ($0.50/$1.00 USD) - 2016/06/06 13:15:16 CET [2016/06/06 7:15:16 ET]
Table 'Smither' 9-max Seat #5 is the button
Seat 1: PacPacBum ($171.10 in chips) 
Seat 2: matiko09 ($100 in chips) 
Seat 3: xxxZeka ($130.07 in chips) 
Seat 4: maxxmeister ($210.24 in chips) 
Seat 5: Szevasztopol ($120.62 in chips) 
Seat 6: mooose100 ($78.15 in chips) 
Seat 7: vanilica ($123.57 in chips) 
Seat 9: hammerwife ($130.75 in chips) 
mooose100: posts small blind $0.50
vanilica: posts big blind $1
ozone2003: sits out 
*** HOLE CARDS ***
Dealt to matiko09 [9s 4h]
hammerwife: folds 
PacPacBum: folds 
matiko09: folds 
xxxZeka: folds 
maxxmeister: raises $2 to $3
Szevasztopol: folds 
mooose100: folds 
vanilica: folds 
Uncalled bet ($2) returned to maxxmeister
maxxmeister collected $2.50 from pot
maxxmeister: doesn't show hand 
*** SUMMARY ***
Total pot $2.50 | Rake $0 
Seat 1: PacPacBum folded before Flop (didn't bet)
Seat 2: matiko09 folded before Flop (didn't bet)
Seat 3: xxxZeka folded before Flop (didn't bet)
Seat 4: maxxmeister collected ($2.50)
Seat 5: Szevasztopol (button) folded before Flop (didn't bet)
Seat 6: mooose100 (small blind) folded before Flop
Seat 7: vanilica (big blind) folded before Flop
Seat 9: hammerwife folded before Flop (didn't bet)





PokerStars Hand #154363882843:  Hold'em No Limit ($0.50/$1.00 USD) - 2016/06/06 13:15:19 CET [2016/06/06 7:15:19 ET]
Table 'Sheliak' 9-max Seat #5 is the button
Seat 1: 32rrew ($100.33 in chips) 
Seat 2: DancerNN1 ($100 in chips) 
Seat 3: xxxZeka ($121.30 in chips) 
Seat 4: iRLM ($72.25 in chips) 
Seat 5: hammerwife ($100 in chips) 
Seat 6: matiko09 ($107.97 in chips) 
Seat 7: stds st ($40 in chips) 
Seat 8: ozone2003 ($100 in chips) 
Seat 9: Szevasztopol ($104.85 in chips) 
matiko09: posts small blind $0.50
stds st: posts big blind $1
*** HOLE CARDS ***
Dealt to matiko09 [2s Th]
ozone2003: folds 
Szevasztopol: folds 
32rrew: folds 
DancerNN1: raises $2 to $3
xxxZeka: calls $3
iRLM: folds 
hammerwife: folds 
matiko09: folds 
stds st: folds 
*** FLOP *** [Kh 4h 8s]
DancerNN1: bets $5
xxxZeka: folds 
Uncalled bet ($5) returned to DancerNN1
DancerNN1 collected $7.12 from pot
DancerNN1: doesn't show hand 
*** SUMMARY ***
Total pot $7.50 | Rake $0.38 
Board [Kh 4h 8s]
Seat 1: 32rrew folded before Flop (didn't bet)
Seat 2: DancerNN1 collected ($7.12)
Seat 3: xxxZeka folded on the Flop
Seat 4: iRLM folded before Flop (didn't bet)
Seat 5: hammerwife (button) folded before Flop (didn't bet)
Seat 6: matiko09 (small blind) folded before Flop
Seat 7: stds st (big blind) folded before Flop
Seat 8: ozone2003 folded before Flop (didn't bet)
Seat 9: Szevasztopol folded before Flop (didn't bet)





PokerStars Hand #154363883140:  Hold'em No Limit ($0.50/$1.00 USD) - 2016/06/06 13:15:20 CET [2016/06/06 7:15:20 ET]
Table 'Wezen II' 9-max Seat #7 is the button
Seat 1: matiko09 ($100 in chips) 
Seat 2: Mr.Grigoriy ($114.12 in chips) 
Seat 3: Dickyxxx ($100 in chips) 
Seat 4: xxxibgdrgn ($199 in chips) 
Seat 5: stds st ($39.15 in chips) 
Seat 7: KDJAll3 ($76.96 in chips) 
Seat 8: o.miro ($105.50 in chips) 
o.miro: posts small blind $0.50
PacPacBum: is sitting out 
matiko09: posts big blind $1
Eskimo Fox: sits out 
*** HOLE CARDS ***
Dealt to matiko09 [6s 8h]
PacPacBum leaves the table
hurtNCYDE joins the table at seat #9 
hurtNCYDE leaves the table
Mr.Grigoriy: folds 
Cogss joins the table at seat #9 
Dickyxxx: folds 
xxxibgdrgn: folds 
stds st: raises $1.50 to $2.50
KDJAll3: folds 
o.miro: folds 
matiko09: folds 
Uncalled bet ($1.50) returned to stds st
stds st collected $2.50 from pot
stds st: doesn't show hand 
*** SUMMARY ***
Total pot $2.50 | Rake $0 
Seat 1: matiko09 (big blind) folded before Flop
Seat 2: Mr.Grigoriy folded before Flop (didn't bet)
Seat 3: Dickyxxx folded before Flop (didn't bet)
Seat 4: xxxibgdrgn folded before Flop (didn't bet)
Seat 5: stds st collected ($2.50)
Seat 7: KDJAll3 (button) folded before Flop (didn't bet)
Seat 8: o.miro (small blind) folded before Flop





PokerStars Hand #154363885618:  Hold'em No Limit ($0.50/$1.00 USD) - 2016/06/06 13:15:26 CET [2016/06/06 7:15:26 ET]
Table 'Safara' 9-max Seat #6 is the button
Seat 1: Dickyxxx ($104.12 in chips) 
Seat 2: ozone2003 ($104.08 in chips) 
Seat 4: xxxibgdrgn ($100.88 in chips) 
Seat 5: perezzi10 ($44.50 in chips) 
Seat 6: matiko09 ($141.78 in chips) 
Seat 9: R1aki ($100 in chips) 
PacPacBum will be allowed to play after the button
o.miro will be allowed to play after the button
R1aki: posts small blind $0.50
Dickyxxx: posts big blind $1
erd33: sits out 
*** HOLE CARDS ***
Dealt to matiko09 [Kc 8h]
ozone2003: folds 
xxxibgdrgn: raises $2 to $3
perezzi10: folds 
matiko09: folds 
R1aki: folds 
Dickyxxx: folds 
Uncalled bet ($2) returned to xxxibgdrgn
xxxibgdrgn collected $2.50 from pot
xxxibgdrgn: doesn't show hand 
*** SUMMARY ***
Total pot $2.50 | Rake $0 
Seat 1: Dickyxxx (big blind) folded before Flop
Seat 2: ozone2003 folded before Flop (didn't bet)
Seat 4: xxxibgdrgn collected ($2.50)
Seat 5: perezzi10 folded before Flop (didn't bet)
Seat 6: matiko09 (button) folded before Flop (didn't bet)
Seat 9: R1aki (small blind) folded before Flop





PokerStars Hand #154363892474:  Hold'em No Limit ($0.50/$1.00 USD) - 2016/06/06 13:15:42 CET [2016/06/06 7:15:42 ET]
Table 'Smither' 9-max Seat #6 is the button
Seat 1: PacPacBum ($171.10 in chips) 
Seat 2: matiko09 ($100 in chips) 
Seat 3: xxxZeka ($130.07 in chips) 
Seat 4: maxxmeister ($211.74 in chips) 
Seat 5: Szevasztopol ($120.62 in chips) 
Seat 6: mooose100 ($77.65 in chips) 
Seat 7: vanilica ($122.57 in chips) 
Seat 8: ozone2003 ($100 in chips) 
Seat 9: hammerwife ($130.75 in chips) 
vanilica: posts small blind $0.50
ozone2003: posts big blind $1
*** HOLE CARDS ***
Dealt to matiko09 [Ks 7s]
hammerwife: folds 
PacPacBum: folds 
matiko09: folds 
xxxZeka: raises $2 to $3
maxxmeister: folds 
Szevasztopol: folds 
mooose100: folds 
vanilica: folds 
ozone2003: folds 
Uncalled bet ($2) returned to xxxZeka
xxxZeka collected $2.50 from pot
*** SUMMARY ***
Total pot $2.50 | Rake $0 
Seat 1: PacPacBum folded before Flop (didn't bet)
Seat 2: matiko09 folded before Flop (didn't bet)
Seat 3: xxxZeka collected ($2.50)
Seat 4: maxxmeister folded before Flop (didn't bet)
Seat 5: Szevasztopol folded before Flop (didn't bet)
Seat 6: mooose100 (button) folded before Flop (didn't bet)
Seat 7: vanilica (small blind) folded before Flop
Seat 8: ozone2003 (big blind) folded before Flop
Seat 9: hammerwife folded before Flop (didn't bet)





PokerStars Hand #154363892877:  Hold'em No Limit ($0.50/$1.00 USD) - 2016/06/06 13:15:43 CET [2016/06/06 7:15:43 ET]
Table 'Heze' 9-max Seat #8 is the button
Seat 1: matiko09 ($173.17 in chips) 
Seat 2: xxxibgdrgn ($119.48 in chips) 
Seat 5: stds st ($36.50 in chips) 
Seat 6: yfcq36 ($122.55 in chips) 
Seat 7: 32rrew ($160.97 in chips) 
Seat 8: PacPacBum ($115.70 in chips) 
Seat 9: Mr.Grigoriy ($131.21 in chips) 
Mr.Grigoriy: posts small blind $0.50
matiko09: posts big blind $1
Dickyxxx: sits out 
*** HOLE CARDS ***
Dealt to matiko09 [2d 5d]
xxxibgdrgn: folds 
stds st: folds 
yfcq36: folds 
32rrew: raises $2 to $3
PacPacBum: folds 
Mr.Grigoriy: folds 
matiko09: folds 
Uncalled bet ($2) returned to 32rrew
32rrew collected $2.50 from pot
32rrew: doesn't show hand 
*** SUMMARY ***
Total pot $2.50 | Rake $0 
Seat 1: matiko09 (big blind) folded before Flop
Seat 2: xxxibgdrgn folded before Flop (didn't bet)
Seat 5: stds st folded before Flop (didn't bet)
Seat 6: yfcq36 folded before Flop (didn't bet)
Seat 7: 32rrew collected ($2.50)
Seat 8: PacPacBum (button) folded before Flop (didn't bet)
Seat 9: Mr.Grigoriy (small blind) folded before Flop





PokerStars Hand #154363902936:  Hold'em No Limit ($0.50/$1.00 USD) - 2016/06/06 13:16:06 CET [2016/06/06 7:16:06 ET]
Table 'Wezen II' 9-max Seat #8 is the button
Seat 1: matiko09 ($100 in chips) 
Seat 2: Mr.Grigoriy ($114.12 in chips) 
Seat 3: Dickyxxx ($100 in chips) 
Seat 4: xxxibgdrgn ($199 in chips) 
Seat 5: stds st ($40.65 in chips) 
Seat 7: KDJAll3 ($76.96 in chips) 
Seat 8: o.miro ($105 in chips) 
Cogss will be allowed to play after the button
matiko09: posts small blind $0.50
Mr.Grigoriy: posts big blind $1
Eskimo Fox: sits out 
*** HOLE CARDS ***
Dealt to matiko09 [Td 4s]
Dickyxxx: folds 
xxxibgdrgn: folds 
stds st: raises $1.50 to $2.50
KDJAll3 has timed out
KDJAll3: folds 
o.miro: folds 
matiko09: folds 
Mr.Grigoriy: folds 
Uncalled bet ($1.50) returned to stds st
stds st collected $2.50 from pot
stds st: doesn't show hand 
*** SUMMARY ***
Total pot $2.50 | Rake $0 
Seat 1: matiko09 (small blind) folded before Flop
Seat 2: Mr.Grigoriy (big blind) folded before Flop
Seat 3: Dickyxxx folded before Flop (didn't bet)
Seat 4: xxxibgdrgn folded before Flop (didn't bet)
Seat 5: stds st collected ($2.50)
Seat 7: KDJAll3 folded before Flop (didn't bet)
Seat 8: o.miro (button) folded before Flop (didn't bet)





PokerStars Hand #154363903719:  Hold'em No Limit ($0.50/$1.00 USD) - 2016/06/06 13:16:08 CET [2016/06/06 7:16:08 ET]
Table 'Safara' 9-max Seat #9 is the button
Seat 1: Dickyxxx ($103.12 in chips) 
Seat 2: ozone2003 ($104.08 in chips) 
Seat 4: xxxibgdrgn ($102.38 in chips) 
Seat 5: perezzi10 ($44.50 in chips) 
Seat 6: matiko09 ($141.78 in chips) 
Seat 9: R1aki ($100 in chips) 
Dickyxxx: posts small blind $0.50
ozone2003: posts big blind $1
erd33: sits out 
PacPacBum: sits out 
o.miro: sits out 
*** HOLE CARDS ***
Dealt to matiko09 [3h 6h]
xxxibgdrgn: folds 
perezzi10: folds 
matiko09: folds 
R1aki: folds 
Dickyxxx: raises $2 to $3
ozone2003: folds 
Uncalled bet ($2) returned to Dickyxxx
Dickyxxx collected $2 from pot
Dickyxxx: doesn't show hand 
*** SUMMARY ***
Total pot $2 | Rake $0 
Seat 1: Dickyxxx (small blind) collected ($2)
Seat 2: ozone2003 (big blind) folded before Flop
Seat 4: xxxibgdrgn folded before Flop (didn't bet)
Seat 5: perezzi10 folded before Flop (didn't bet)
Seat 6: matiko09 folded before Flop (didn't bet)
Seat 9: R1aki (button) folded before Flop (didn't bet)





PokerStars Hand #154363907709:  Hold'em No Limit ($0.50/$1.00 USD) - 2016/06/06 13:16:17 CET [2016/06/06 7:16:17 ET]
Table 'Sheliak' 9-max Seat #6 is the button
Seat 1: 32rrew ($100.33 in chips) 
Seat 2: DancerNN1 ($104.12 in chips) 
Seat 3: xxxZeka ($118.30 in chips) 
Seat 4: iRLM ($72.25 in chips) 
Seat 5: hammerwife ($100 in chips) 
Seat 6: matiko09 ($107.47 in chips) 
Seat 7: stds st ($39 in chips) 
Seat 8: ozone2003 ($100 in chips) 
Seat 9: Szevasztopol ($104.85 in chips) 
stds st: posts small blind $0.50
ozone2003: posts big blind $1
*** HOLE CARDS ***
Dealt to matiko09 [Qh 6d]
Szevasztopol: folds 
32rrew: folds 
DancerNN1: folds 
xxxZeka: folds 
iRLM: folds 
hammerwife: folds 
matiko09: folds 
stds st: raises $1.02 to $2.02
ozone2003: calls $1.02
*** FLOP *** [3h 8h Kh]
stds st: checks 
ozone2003: checks 
*** TURN *** [3h 8h Kh] [Th]
stds st: checks 
ozone2003: checks 
*** RIVER *** [3h 8h Kh Th] [2c]
stds st: checks 
ozone2003: checks 
*** SHOW DOWN ***
stds st: shows [Ad Jc] (high card Ace)
ozone2003: mucks hand 
stds st collected $3.84 from pot
*** SUMMARY ***
Total pot $4.04 | Rake $0.20 
Board [3h 8h Kh Th 2c]
Seat 1: 32rrew folded before Flop (didn't bet)
Seat 2: DancerNN1 folded before Flop (didn't bet)
Seat 3: xxxZeka folded before Flop (didn't bet)
Seat 4: iRLM folded before Flop (didn't bet)
Seat 5: hammerwife folded before Flop (didn't bet)
Seat 6: matiko09 (button) folded before Flop (didn't bet)
Seat 7: stds st (small blind) showed [Ad Jc] and won ($3.84) with high card Ace
Seat 8: ozone2003 (big blind) mucked [4c 7c]
Seat 9: Szevasztopol folded before Flop (didn't bet)





PokerStars Hand #154363907886:  Hold'em No Limit ($0.50/$1.00 USD) - 2016/06/06 13:16:18 CET [2016/06/06 7:16:18 ET]
Table 'Gajdariya' 9-max Seat #3 is the button
Seat 1: matiko09 ($128.04 in chips) 
Seat 2: Dickyxxx ($106.02 in chips) 
Seat 3: mooose100 ($80 in chips) 
Seat 4: Szevasztopol ($114.77 in chips) 
Seat 5: stds st ($77.13 in chips) 
Seat 7: hurtNCYDE ($111.57 in chips) 
Seat 8: ardo888 ($136.82 in chips) 
Seat 9: PacPacBum ($113.23 in chips) 
Szevasztopol: posts small blind $0.50
stds st: posts big blind $1
vanilica: sits out 
*** HOLE CARDS ***
Dealt to matiko09 [6d 8s]
hurtNCYDE: folds 
ardo888: folds 
PacPacBum: folds 
matiko09: folds 
Dickyxxx: raises $2 to $3
mooose100: folds 
Szevasztopol: folds 
stds st: folds 
Uncalled bet ($2) returned to Dickyxxx
Dickyxxx collected $2.50 from pot
Dickyxxx: doesn't show hand 
*** SUMMARY ***
Total pot $2.50 | Rake $0 
Seat 1: matiko09 folded before Flop (didn't bet)
Seat 2: Dickyxxx collected ($2.50)
Seat 3: mooose100 (button) folded before Flop (didn't bet)
Seat 4: Szevasztopol (small blind) folded before Flop
Seat 5: stds st (big blind) folded before Flop
Seat 7: hurtNCYDE folded before Flop (didn't bet)
Seat 8: ardo888 folded before Flop (didn't bet)
Seat 9: PacPacBum folded before Flop (didn't bet)





PokerStars Hand #154363909857:  Hold'em No Limit ($0.50/$1.00 USD) - 2016/06/06 13:16:22 CET [2016/06/06 7:16:22 ET]
Table 'Smither' 9-max Seat #7 is the button
Seat 1: PacPacBum ($171.10 in chips) 
Seat 2: matiko09 ($100 in chips) 
Seat 3: xxxZeka ($131.57 in chips) 
Seat 4: maxxmeister ($211.74 in chips) 
Seat 5: Szevasztopol ($120.62 in chips) 
Seat 6: mooose100 ($77.65 in chips) 
Seat 7: vanilica ($122.07 in chips) 
Seat 8: ozone2003 ($100 in chips) 
ozone2003: posts small blind $0.50
hammerwife: is sitting out 
PacPacBum: posts big blind $1
*** HOLE CARDS ***
Dealt to matiko09 [Qc Kc]
matiko09: raises $2 to $3
xxxZeka: folds 
maxxmeister: folds 
Szevasztopol: folds 
mooose100: folds 
vanilica: folds 
ozone2003: folds 
PacPacBum: folds 
Uncalled bet ($2) returned to matiko09
matiko09 collected $2.50 from pot
matiko09: doesn't show hand 
*** SUMMARY ***
Total pot $2.50 | Rake $0 
Seat 1: PacPacBum (big blind) folded before Flop
Seat 2: matiko09 collected ($2.50)
Seat 3: xxxZeka folded before Flop (didn't bet)
Seat 4: maxxmeister folded before Flop (didn't bet)
Seat 5: Szevasztopol folded before Flop (didn't bet)
Seat 6: mooose100 folded before Flop (didn't bet)
Seat 7: vanilica (button) folded before Flop (didn't bet)
Seat 8: ozone2003 (small blind) folded before Flop





PokerStars Hand #154363913423:  Hold'em No Limit (€0.50/€1.00 EUR) - 2016/06/06 13:16:31 CET [2016/06/06 7:16:31 ET]
Table 'Lesath' 9-max Seat #3 is the button
Seat 1: o.miro (€118.56 in chips) 
Seat 2: thecurv (€110.99 in chips) 
Seat 3: ozone2003 (€204.64 in chips) 
Seat 4: hammerwife (€126.11 in chips) 
Seat 5: matiko09 (€113.47 in chips) 
Seat 6: Szevasztopol (€143.39 in chips) 
Seat 7: Mr.Grigoriy (€100 in chips) 
Seat 9: 72nloses (€46.16 in chips) 
hammerwife: posts small blind €0.50
matiko09: posts big blind €1
stds st: sits out 
*** HOLE CARDS ***
Dealt to matiko09 [9s Th]
Szevasztopol: folds 
Mr.Grigoriy: folds 
72nloses: folds 
o.miro: folds 
thecurv: folds 
ozone2003: folds 
hammerwife: folds 
Uncalled bet (€0.50) returned to matiko09
matiko09 collected €1 from pot
matiko09: doesn't show hand 
*** SUMMARY ***
Total pot €1 | Rake €0 
Seat 1: o.miro folded before Flop (didn't bet)
Seat 2: thecurv folded before Flop (didn't bet)
Seat 3: ozone2003 (button) folded before Flop (didn't bet)
Seat 4: hammerwife (small blind) folded before Flop
Seat 5: matiko09 (big blind) collected (€1)
Seat 6: Szevasztopol folded before Flop (didn't bet)
Seat 7: Mr.Grigoriy folded before Flop (didn't bet)
Seat 9: 72nloses folded before Flop (didn't bet)





PokerStars Hand #154363913815:  Hold'em No Limit ($0.50/$1.00 USD) - 2016/06/06 13:16:32 CET [2016/06/06 7:16:32 ET]
Table 'Heze' 9-max Seat #9 is the button
Seat 1: matiko09 ($172.17 in chips) 
Seat 2: xxxibgdrgn ($119.48 in chips) 
Seat 5: stds st ($36.50 in chips) 
Seat 6: yfcq36 ($122.55 in chips) 
Seat 7: 32rrew ($162.47 in chips) 
Seat 8: PacPacBum ($115.70 in chips) 
Seat 9: Mr.Grigoriy ($130.71 in chips) 
matiko09: posts small blind $0.50
xxxibgdrgn: posts big blind $1
Dickyxxx: sits out 
*** HOLE CARDS ***
Dealt to matiko09 [7c 5c]
stds st: folds 
yfcq36: folds 
32rrew: folds 
PacPacBum: raises $1.04 to $2.04
Mr.Grigoriy: folds 
matiko09: folds 
xxxibgdrgn: folds 
Uncalled bet ($1.04) returned to PacPacBum
PacPacBum collected $2.50 from pot
PacPacBum: doesn't show hand 
*** SUMMARY ***
Total pot $2.50 | Rake $0 
Seat 1: matiko09 (small blind) folded before Flop
Seat 2: xxxibgdrgn (big blind) folded before Flop
Seat 5: stds st folded before Flop (didn't bet)
Seat 6: yfcq36 folded before Flop (didn't bet)
Seat 7: 32rrew folded before Flop (didn't bet)
Seat 8: PacPacBum collected ($2.50)
Seat 9: Mr.Grigoriy (button) folded before Flop (didn't bet)





PokerStars Hand #154363914865:  Hold'em No Limit ($0.50/$1.00 USD) - 2016/06/06 13:16:34 CET [2016/06/06 7:16:34 ET]
Table 'Chaldaea II' 9-max Seat #9 is the button
Seat 2: Mr.Grigoriy ($100.50 in chips) 
Seat 3: ardo888 ($105.85 in chips) 
Seat 4: mooose100 ($142.83 in chips) 
Seat 5: stds st ($30.03 in chips) 
Seat 6: PacPacBum ($100 in chips) 
Seat 7: xxxibgdrgn ($100 in chips) 
Seat 8: 32rrew ($100 in chips) 
Seat 9: matiko09 ($101.50 in chips) 
Mr.Grigoriy: posts small blind $0.50
ardo888: posts big blind $1
*** HOLE CARDS ***
Dealt to matiko09 [Ad 8d]
mooose100: folds 
stds st: raises $1.50 to $2.50
PacPacBum: folds 
xxxibgdrgn: folds 
32rrew: folds 
matiko09: folds 
Mr.Grigoriy: folds 
ardo888: folds 
Uncalled bet ($1.50) returned to stds st
stds st collected $2.50 from pot
stds st: doesn't show hand 
*** SUMMARY ***
Total pot $2.50 | Rake $0 
Seat 2: Mr.Grigoriy (small blind) folded before Flop
Seat 3: ardo888 (big blind) folded before Flop
Seat 4: mooose100 folded before Flop (didn't bet)
Seat 5: stds st collected ($2.50)
Seat 6: PacPacBum folded before Flop (didn't bet)
Seat 7: xxxibgdrgn folded before Flop (didn't bet)
Seat 8: 32rrew folded before Flop (didn't bet)
Seat 9: matiko09 (button) folded before Flop (didn't bet)





PokerStars Hand #154363916220:  Hold'em No Limit ($0.50/$1.00 USD) - 2016/06/06 13:16:37 CET [2016/06/06 7:16:37 ET]
Table 'Safara' 9-max Seat #1 is the button
Seat 1: Dickyxxx ($104.12 in chips) 
Seat 2: ozone2003 ($103.08 in chips) 
Seat 3: erd33 ($80 in chips) 
Seat 4: xxxibgdrgn ($102.38 in chips) 
Seat 5: perezzi10 ($44.50 in chips) 
Seat 6: matiko09 ($141.78 in chips) 
Seat 9: R1aki ($100 in chips) 
ozone2003: posts small blind $0.50
erd33: posts big blind $1
PacPacBum: sits out 
o.miro: sits out 
*** HOLE CARDS ***
Dealt to matiko09 [Ad 8c]
xxxibgdrgn: folds 
perezzi10: calls $1
matiko09: folds 
R1aki: raises $2.50 to $3.50
Dickyxxx: folds 
ozone2003: folds 
erd33: calls $2.50
perezzi10: calls $2.50
*** FLOP *** [Jd Ts 8h]
erd33: checks 
perezzi10: checks 
R1aki: bets $7.50
erd33: calls $7.50
perezzi10: folds 
*** TURN *** [Jd Ts 8h] [Ac]
erd33: checks 
R1aki: bets $17.50
erd33: raises $27.50 to $45
R1aki: raises $27.50 to $72.50
erd33: calls $24 and is all-in
Uncalled bet ($3.50) returned to R1aki
*** RIVER *** [Jd Ts 8h Ac] [9s]
*** SHOW DOWN ***
erd33: shows [Qd 9d] (a straight, Eight to Queen)
R1aki: shows [9h 7h] (a straight, Seven to Jack)
erd33 collected $161.50 from pot
*** SUMMARY ***
Total pot $164 | Rake $2.50 
Board [Jd Ts 8h Ac 9s]
Seat 1: Dickyxxx (button) folded before Flop (didn't bet)
Seat 2: ozone2003 (small blind) folded before Flop
Seat 3: erd33 (big blind) showed [Qd 9d] and won ($161.50) with a straight, Eight to Queen
Seat 4: xxxibgdrgn folded before Flop (didn't bet)
Seat 5: perezzi10 folded on the Flop
Seat 6: matiko09 folded before Flop (didn't bet)
Seat 9: R1aki showed [9h 7h] and lost with a straight, Seven to Jack





PokerStars Hand #154363918863:  Hold'em No Limit ($0.50/$1.00 USD) - 2016/06/06 13:16:43 CET [2016/06/06 7:16:43 ET]
Table 'Gajdariya' 9-max Seat #4 is the button
Seat 1: matiko09 ($128.04 in chips) 
Seat 2: Dickyxxx ($107.52 in chips) 
Seat 3: mooose100 ($80 in chips) 
Seat 4: Szevasztopol ($114.27 in chips) 
Seat 5: stds st ($76.13 in chips) 
Seat 6: vanilica ($100 in chips) 
Seat 7: hurtNCYDE ($111.57 in chips) 
Seat 8: ardo888 ($136.82 in chips) 
Seat 9: PacPacBum ($113.23 in chips) 
stds st: posts small blind $0.50
vanilica: posts big blind $1
*** HOLE CARDS ***
Dealt to matiko09 [2h 9d]
hurtNCYDE: folds 
ardo888: folds 
PacPacBum: folds 
matiko09: folds 
Dickyxxx: folds 
mooose100: calls $1
Szevasztopol: folds 
stds st: calls $0.50
vanilica: checks 
*** FLOP *** [8c 6c 8s]
stds st: checks 
vanilica: checks 
mooose100: checks 
*** TURN *** [8c 6c 8s] [3c]
stds st: checks 
vanilica: checks 
mooose100: bets $2.85
stds st: folds 
vanilica: folds 
Uncalled bet ($2.85) returned to mooose100
mooose100 collected $2.85 from pot
mooose100: doesn't show hand 
*** SUMMARY ***
Total pot $3 | Rake $0.15 
Board [8c 6c 8s 3c]
Seat 1: matiko09 folded before Flop (didn't bet)
Seat 2: Dickyxxx folded before Flop (didn't bet)
Seat 3: mooose100 collected ($2.85)
Seat 4: Szevasztopol (button) folded before Flop (didn't bet)
Seat 5: stds st (small blind) folded on the Turn
Seat 6: vanilica (big blind) folded on the Turn
Seat 7: hurtNCYDE folded before Flop (didn't bet)
Seat 8: ardo888 folded before Flop (didn't bet)
Seat 9: PacPacBum folded before Flop (didn't bet)





PokerStars Hand #154363920049:  Hold'em No Limit ($0.50/$1.00 USD) - 2016/06/06 13:16:46 CET [2016/06/06 7:16:46 ET]
Table 'Wezen II' 9-max Seat #1 is the button
Seat 1: matiko09 ($100 in chips) 
Seat 2: Mr.Grigoriy ($113.12 in chips) 
Seat 3: Dickyxxx ($100 in chips) 
Seat 4: xxxibgdrgn ($199 in chips) 
Seat 5: stds st ($42.15 in chips) 
Seat 8: o.miro ($105 in chips) 
Seat 9: Cogss ($100 in chips) 
Mr.Grigoriy: posts small blind $0.50
Dickyxxx: posts big blind $1
Eskimo Fox: sits out 
Cogss: posts big blind $1
*** HOLE CARDS ***
Dealt to matiko09 [Ts Jh]
xxxibgdrgn: folds 
stds st: folds 
o.miro: folds 
Cogss: checks 
matiko09: raises $3 to $4
Mr.Grigoriy: folds 
Dickyxxx: folds 
Cogss: raises $4 to $8
matiko09: folds 
Uncalled bet ($4) returned to Cogss
Cogss collected $9.50 from pot
*** SUMMARY ***
Total pot $9.50 | Rake $0 
Seat 1: matiko09 (button) folded before Flop
Seat 2: Mr.Grigoriy (small blind) folded before Flop
Seat 3: Dickyxxx (big blind) folded before Flop
Seat 4: xxxibgdrgn folded before Flop (didn't bet)
Seat 5: stds st folded before Flop (didn't bet)
Seat 8: o.miro folded before Flop (didn't bet)
Seat 9: Cogss collected ($9.50)





PokerStars Hand #154363919766:  Hold'em No Limit (€0.50/€1.00 EUR) - 2016/06/06 13:16:46 CET [2016/06/06 7:16:46 ET]
Table 'Lesath' 9-max Seat #4 is the button
Seat 1: o.miro (€118.56 in chips) 
Seat 2: thecurv (€110.99 in chips) 
Seat 3: ozone2003 (€204.64 in chips) 
Seat 4: hammerwife (€125.61 in chips) 
Seat 5: matiko09 (€113.97 in chips) 
Seat 7: Mr.Grigoriy (€100 in chips) 
Seat 9: 72nloses (€46.16 in chips) 
matiko09: posts small blind €0.50
Szevasztopol: is sitting out 
Mr.Grigoriy: posts big blind €1
stds st: sits out 
*** HOLE CARDS ***
Dealt to matiko09 [Jc 2s]
72nloses: folds 
o.miro: folds 
thecurv: folds 
ozone2003: folds 
hammerwife: raises €1.01 to €2.01
matiko09: folds 
Mr.Grigoriy: folds 
Uncalled bet (€1.01) returned to hammerwife
hammerwife collected €2.50 from pot
hammerwife: doesn't show hand 
*** SUMMARY ***
Total pot €2.50 | Rake €0 
Seat 1: o.miro folded before Flop (didn't bet)
Seat 2: thecurv folded before Flop (didn't bet)
Seat 3: ozone2003 folded before Flop (didn't bet)
Seat 4: hammerwife (button) collected (€2.50)
Seat 5: matiko09 (small blind) folded before Flop
Seat 7: Mr.Grigoriy (big blind) folded before Flop
Seat 9: 72nloses folded before Flop (didn't bet)





PokerStars Hand #154363920234:  Hold'em No Limit ($0.50/$1.00 USD) - 2016/06/06 13:16:47 CET [2016/06/06 7:16:47 ET]
Table 'Smither' 9-max Seat #8 is the button
Seat 1: PacPacBum ($170.10 in chips) 
Seat 2: matiko09 ($101.50 in chips) 
Seat 3: xxxZeka ($131.57 in chips) 
Seat 4: maxxmeister ($211.74 in chips) 
Seat 5: Szevasztopol ($120.62 in chips) 
Seat 6: mooose100 ($77.65 in chips) 
Seat 7: vanilica ($122.07 in chips) 
Seat 8: ozone2003 ($100 in chips) 
hammerwife will be allowed to play after the button
PacPacBum: posts small blind $0.50
matiko09: posts big blind $1
*** HOLE CARDS ***
Dealt to matiko09 [7c 4h]
xxxZeka: folds 
maxxmeister: folds 
xxxZeka leaves the table
stds st joins the table at seat #3 
Szevasztopol: folds 
mooose100: folds 
vanilica: folds 
ozone2003: folds 
PacPacBum: folds 
Uncalled bet ($0.50) returned to matiko09
matiko09 collected $1 from pot
matiko09: doesn't show hand 
*** SUMMARY ***
Total pot $1 | Rake $0 
Seat 1: PacPacBum (small blind) folded before Flop
Seat 2: matiko09 (big blind) collected ($1)
Seat 3: xxxZeka folded before Flop (didn't bet)
Seat 4: maxxmeister folded before Flop (didn't bet)
Seat 5: Szevasztopol folded before Flop (didn't bet)
Seat 6: mooose100 folded before Flop (didn't bet)
Seat 7: vanilica folded before Flop (didn't bet)
Seat 8: ozone2003 (button) folded before Flop (didn't bet)





PokerStars Hand #154363926225:  Hold'em No Limit ($0.50/$1.00 USD) - 2016/06/06 13:17:00 CET [2016/06/06 7:17:00 ET]
Table 'Chaldaea II' 9-max Seat #2 is the button
Seat 2: Mr.Grigoriy ($100 in chips) 
Seat 3: ardo888 ($104.85 in chips) 
Seat 4: mooose100 ($142.83 in chips) 
Seat 5: stds st ($31.53 in chips) 
Seat 6: PacPacBum ($100 in chips) 
Seat 7: xxxibgdrgn ($100 in chips) 
Seat 8: 32rrew ($100 in chips) 
Seat 9: matiko09 ($101.50 in chips) 
ardo888: posts small blind $0.50
mooose100: posts big blind $1
*** HOLE CARDS ***
Dealt to matiko09 [8h 3d]
stds st: folds 
PacPacBum: raises $1.50 to $2.50
xxxibgdrgn: folds 
32rrew: folds 
matiko09: folds 
Mr.Grigoriy: folds 
ardo888: folds 
mooose100: folds 
Uncalled bet ($1.50) returned to PacPacBum
PacPacBum collected $2.50 from pot
PacPacBum: doesn't show hand 
*** SUMMARY ***
Total pot $2.50 | Rake $0 
Seat 2: Mr.Grigoriy (button) folded before Flop (didn't bet)
Seat 3: ardo888 (small blind) folded before Flop
Seat 4: mooose100 (big blind) folded before Flop
Seat 5: stds st folded before Flop (didn't bet)
Seat 6: PacPacBum collected ($2.50)
Seat 7: xxxibgdrgn folded before Flop (didn't bet)
Seat 8: 32rrew folded before Flop (didn't bet)
Seat 9: matiko09 folded before Flop (didn't bet)





PokerStars Hand #154363931388:  Hold'em No Limit ($0.50/$1.00 USD) - 2016/06/06 13:17:12 CET [2016/06/06 7:17:12 ET]
Table 'Heze' 9-max Seat #1 is the button
Seat 1: matiko09 ($171.67 in chips) 
Seat 2: xxxibgdrgn ($118.48 in chips) 
Seat 3: Dickyxxx ($100 in chips) 
Seat 5: stds st ($36.50 in chips) 
Seat 6: yfcq36 ($122.55 in chips) 
Seat 7: 32rrew ($162.47 in chips) 
Seat 8: PacPacBum ($117.20 in chips) 
Seat 9: Mr.Grigoriy ($130.71 in chips) 
xxxibgdrgn: posts small blind $0.50
Dickyxxx: posts big blind $1
*** HOLE CARDS ***
Dealt to matiko09 [Ks Tc]
stds st: raises $1.50 to $2.50
yfcq36: folds 
32rrew: folds 
PacPacBum: folds 
Mr.Grigoriy: folds 
matiko09: folds 
xxxibgdrgn: folds 
Dickyxxx: folds 
Uncalled bet ($1.50) returned to stds st
stds st collected $2.50 from pot
stds st: doesn't show hand 
*** SUMMARY ***
Total pot $2.50 | Rake $0 
Seat 1: matiko09 (button) folded before Flop (didn't bet)
Seat 2: xxxibgdrgn (small blind) folded before Flop
Seat 3: Dickyxxx (big blind) folded before Flop
Seat 5: stds st collected ($2.50)
Seat 6: yfcq36 folded before Flop (didn't bet)
Seat 7: 32rrew folded before Flop (didn't bet)
Seat 8: PacPacBum folded before Flop (didn't bet)
Seat 9: Mr.Grigoriy folded before Flop (didn't bet)





PokerStars Hand #154363935584:  Hold'em No Limit (€0.50/€1.00 EUR) - 2016/06/06 13:17:22 CET [2016/06/06 7:17:22 ET]
Table 'Lesath' 9-max Seat #5 is the button
Seat 1: o.miro (€118.56 in chips) 
Seat 2: thecurv (€110.99 in chips) 
Seat 3: ozone2003 (€204.64 in chips) 
Seat 4: hammerwife (€127.11 in chips) 
Seat 5: matiko09 (€113.47 in chips) 
Seat 7: Mr.Grigoriy (€100 in chips) 
Seat 8: stds st (€40 in chips) 
Seat 9: 72nloses (€46.16 in chips) 
Mr.Grigoriy: posts small blind €0.50
stds st: posts big blind €1
*** HOLE CARDS ***
Dealt to matiko09 [8d Jh]
72nloses: folds 
o.miro: folds 
thecurv: folds 
ozone2003: folds 
hammerwife: folds 
matiko09: folds 
Mr.Grigoriy: folds 
Uncalled bet (€0.50) returned to stds st
stds st collected €1 from pot
stds st: doesn't show hand 
*** SUMMARY ***
Total pot €1 | Rake €0 
Seat 1: o.miro folded before Flop (didn't bet)
Seat 2: thecurv folded before Flop (didn't bet)
Seat 3: ozone2003 folded before Flop (didn't bet)
Seat 4: hammerwife folded before Flop (didn't bet)
Seat 5: matiko09 (button) folded before Flop (didn't bet)
Seat 7: Mr.Grigoriy (small blind) folded before Flop
Seat 8: stds st (big blind) collected (€1)
Seat 9: 72nloses folded before Flop (didn't bet)





PokerStars Hand #154363935570:  Hold'em No Limit ($0.50/$1.00 USD) - 2016/06/06 13:17:22 CET [2016/06/06 7:17:22 ET]
Table 'Smither' 9-max Seat #1 is the button
Seat 1: PacPacBum ($169.60 in chips) 
Seat 2: matiko09 ($102 in chips) 
Seat 3: stds st ($40 in chips) 
Seat 4: maxxmeister ($211.74 in chips) 
Seat 5: Szevasztopol ($120.62 in chips) 
Seat 6: mooose100 ($77.65 in chips) 
Seat 7: vanilica ($122.07 in chips) 
Seat 8: ozone2003 ($100 in chips) 
Seat 9: hammerwife ($130.75 in chips) 
matiko09: posts small blind $0.50
stds st: posts big blind $1
hammerwife: posts small & big blinds $1.50
*** HOLE CARDS ***
Dealt to matiko09 [2d 3h]
maxxmeister: folds 
maxxmeister leaves the table
hurtNCYDE joins the table at seat #4 
hurtNCYDE leaves the table
Szevasztopol: raises $2.14 to $3.14
mooose100: folds 
vanilica: folds 
ozone2003: folds 
hammerwife: folds 
PacPacBum: folds 
matiko09: folds 
stds st: folds 
Uncalled bet ($2.14) returned to Szevasztopol
Szevasztopol collected $4 from pot
Szevasztopol: doesn't show hand 
*** SUMMARY ***
Total pot $4 | Rake $0 
Seat 1: PacPacBum (button) folded before Flop (didn't bet)
Seat 2: matiko09 (small blind) folded before Flop
Seat 3: stds st (big blind) folded before Flop
Seat 4: maxxmeister folded before Flop (didn't bet)
Seat 5: Szevasztopol collected ($4)
Seat 6: mooose100 folded before Flop (didn't bet)
Seat 7: vanilica folded before Flop (didn't bet)
Seat 8: ozone2003 folded before Flop (didn't bet)
Seat 9: hammerwife folded before Flop





PokerStars Hand #154363936320:  Hold'em No Limit ($0.50/$1.00 USD) - 2016/06/06 13:17:24 CET [2016/06/06 7:17:24 ET]
Table 'Chaldaea II' 9-max Seat #3 is the button
Seat 2: Mr.Grigoriy ($100 in chips) 
Seat 3: ardo888 ($104.35 in chips) 
Seat 4: mooose100 ($141.83 in chips) 
Seat 5: stds st ($31.53 in chips) 
Seat 6: PacPacBum ($101.50 in chips) 
Seat 7: xxxibgdrgn ($100 in chips) 
Seat 8: 32rrew ($100 in chips) 
Seat 9: matiko09 ($101.50 in chips) 
mooose100: posts small blind $0.50
stds st: posts big blind $1
*** HOLE CARDS ***
Dealt to matiko09 [7h Th]
PacPacBum: folds 
xxxibgdrgn: folds 
32rrew: folds 
matiko09: folds 
Mr.Grigoriy: folds 
ardo888: raises $1.50 to $2.50
mooose100: calls $2
stds st: folds 
*** FLOP *** [Js As 5h]
mooose100: bets $5.70
ardo888: folds 
Uncalled bet ($5.70) returned to mooose100
mooose100 collected $5.70 from pot
mooose100: doesn't show hand 
*** SUMMARY ***
Total pot $6 | Rake $0.30 
Board [Js As 5h]
Seat 2: Mr.Grigoriy folded before Flop (didn't bet)
Seat 3: ardo888 (button) folded on the Flop
Seat 4: mooose100 (small blind) collected ($5.70)
Seat 5: stds st (big blind) folded before Flop
Seat 6: PacPacBum folded before Flop (didn't bet)
Seat 7: xxxibgdrgn folded before Flop (didn't bet)
Seat 8: 32rrew folded before Flop (didn't bet)
Seat 9: matiko09 folded before Flop (didn't bet)





PokerStars Hand #154363936599:  Hold'em No Limit ($0.50/$1.00 USD) - 2016/06/06 13:17:25 CET [2016/06/06 7:17:25 ET]
Table 'Wezen II' 9-max Seat #2 is the button
Seat 1: matiko09 ($100 in chips) 
Seat 2: Mr.Grigoriy ($112.62 in chips) 
Seat 3: Dickyxxx ($100 in chips) 
Seat 4: xxxibgdrgn ($199 in chips) 
Seat 5: stds st ($42.15 in chips) 
Seat 7: KDJAll3 ($76.96 in chips) 
Seat 8: o.miro ($105 in chips) 
Seat 9: Cogss ($105.50 in chips) 
Dickyxxx: posts small blind $0.50
xxxibgdrgn: posts big blind $1
Eskimo Fox: sits out 
*** HOLE CARDS ***
Dealt to matiko09 [5s Ac]
stds st: folds 
KDJAll3: folds 
o.miro: raises $1.50 to $2.50
Cogss: folds 
matiko09: folds 
Mr.Grigoriy: folds 
Dickyxxx: folds 
xxxibgdrgn: folds 
Uncalled bet ($1.50) returned to o.miro
o.miro collected $2.50 from pot
o.miro: doesn't show hand 
*** SUMMARY ***
Total pot $2.50 | Rake $0 
Seat 1: matiko09 folded before Flop (didn't bet)
Seat 2: Mr.Grigoriy (button) folded before Flop (didn't bet)
Seat 3: Dickyxxx (small blind) folded before Flop
Seat 4: xxxibgdrgn (big blind) folded before Flop
Seat 5: stds st folded before Flop (didn't bet)
Seat 7: KDJAll3 folded before Flop (didn't bet)
Seat 8: o.miro collected ($2.50)
Seat 9: Cogss folded before Flop (didn't bet)





PokerStars Hand #154363939069:  Hold'em No Limit ($0.50/$1.00 USD) - 2016/06/06 13:17:30 CET [2016/06/06 7:17:30 ET]
Table 'Gajdariya' 9-max Seat #5 is the button
Seat 1: matiko09 ($128.04 in chips) 
Seat 2: Dickyxxx ($107.52 in chips) 
Seat 3: mooose100 ($81.85 in chips) 
Seat 4: Szevasztopol ($114.27 in chips) 
Seat 5: stds st ($75.13 in chips) 
Seat 6: vanilica ($100 in chips) 
Seat 7: hurtNCYDE ($111.57 in chips) 
Seat 8: ardo888 ($136.82 in chips) 
Seat 9: PacPacBum ($113.23 in chips) 
vanilica: posts small blind $0.50
hurtNCYDE: posts big blind $1
*** HOLE CARDS ***
Dealt to matiko09 [9h 8c]
ardo888: folds 
PacPacBum: folds 
matiko09: folds 
Dickyxxx: folds 
mooose100: folds 
Szevasztopol: folds 
stds st: folds 
vanilica: folds 
Uncalled bet ($0.50) returned to hurtNCYDE
hurtNCYDE collected $1 from pot
*** SUMMARY ***
Total pot $1 | Rake $0 
Seat 1: matiko09 folded before Flop (didn't bet)
Seat 2: Dickyxxx folded before Flop (didn't bet)
Seat 3: mooose100 folded before Flop (didn't bet)
Seat 4: Szevasztopol folded before Flop (didn't bet)
Seat 5: stds st (button) folded before Flop (didn't bet)
Seat 6: vanilica (small blind) folded before Flop
Seat 7: hurtNCYDE (big blind) collected ($1)
Seat 8: ardo888 folded before Flop (didn't bet)
Seat 9: PacPacBum folded before Flop (didn't bet)





PokerStars Hand #154363947764:  Hold'em No Limit (€0.50/€1.00 EUR) - 2016/06/06 13:17:51 CET [2016/06/06 7:17:51 ET]
Table 'Lesath' 9-max Seat #7 is the button
Seat 1: o.miro (€118.56 in chips) 
Seat 2: thecurv (€110.99 in chips) 
Seat 3: ozone2003 (€204.64 in chips) 
Seat 4: hammerwife (€127.11 in chips) 
Seat 5: matiko09 (€113.47 in chips) 
Seat 7: Mr.Grigoriy (€100 in chips) 
Seat 8: stds st (€40.50 in chips) 
Seat 9: 72nloses (€46.16 in chips) 
stds st: posts small blind €0.50
72nloses: posts big blind €1
*** HOLE CARDS ***
Dealt to matiko09 [9s 3h]
o.miro: folds 
thecurv: folds 
ozone2003: folds 
hammerwife: raises €1.50 to €2.50
matiko09: folds 
Mr.Grigoriy: folds 
stds st: raises €4 to €6.50
72nloses: folds 
hammerwife: folds 
Uncalled bet (€4) returned to stds st
stds st collected €6 from pot
stds st: doesn't show hand 
*** SUMMARY ***
Total pot €6 | Rake €0 
Seat 1: o.miro folded before Flop (didn't bet)
Seat 2: thecurv folded before Flop (didn't bet)
Seat 3: ozone2003 folded before Flop (didn't bet)
Seat 4: hammerwife folded before Flop
Seat 5: matiko09 folded before Flop (didn't bet)
Seat 7: Mr.Grigoriy (button) folded before Flop (didn't bet)
Seat 8: stds st (small blind) collected (€6)
Seat 9: 72nloses (big blind) folded before Flop





PokerStars Hand #154363950924:  Hold'em No Limit ($0.50/$1.00 USD) - 2016/06/06 13:17:58 CET [2016/06/06 7:17:58 ET]
Table 'Sheliak' 9-max Seat #7 is the button
Seat 1: 32rrew ($100.33 in chips) 
Seat 2: DancerNN1 ($104.12 in chips) 
Seat 3: xxxZeka ($118.30 in chips) 
Seat 4: iRLM ($72.25 in chips) 
Seat 5: hammerwife ($100 in chips) 
Seat 6: matiko09 ($107.47 in chips) 
Seat 7: stds st ($40.82 in chips) 
Seat 8: ozone2003 ($100 in chips) 
ozone2003: posts small blind $0.50
Szevasztopol: is sitting out 
32rrew: posts big blind $1
*** HOLE CARDS ***
Dealt to matiko09 [Kd Jc]
DancerNN1: folds 
xxxZeka: folds 
iRLM: folds 
hammerwife: folds 
matiko09: raises $1.50 to $2.50
stds st: folds 
ozone2003: folds 
32rrew: folds 
Uncalled bet ($1.50) returned to matiko09
matiko09 collected $2.50 from pot
matiko09: doesn't show hand 
*** SUMMARY ***
Total pot $2.50 | Rake $0 
Seat 1: 32rrew (big blind) folded before Flop
Seat 2: DancerNN1 folded before Flop (didn't bet)
Seat 3: xxxZeka folded before Flop (didn't bet)
Seat 4: iRLM folded before Flop (didn't bet)
Seat 5: hammerwife folded before Flop (didn't bet)
Seat 6: matiko09 collected ($2.50)
Seat 7: stds st (button) folded before Flop (didn't bet)
Seat 8: ozone2003 (small blind) folded before Flop





PokerStars Hand #154363953358:  Hold'em No Limit ($0.50/$1.00 USD) - 2016/06/06 13:18:04 CET [2016/06/06 7:18:04 ET]
Table 'Smither' 9-max Seat #2 is the button
Seat 1: PacPacBum ($169.60 in chips) 
Seat 2: matiko09 ($101.50 in chips) 
Seat 3: stds st ($39 in chips) 
Seat 6: mooose100 ($77.65 in chips) 
Seat 7: vanilica ($122.07 in chips) 
Seat 8: ozone2003 ($100 in chips) 
Seat 9: hammerwife ($129.25 in chips) 
stds st: posts small blind $0.50
Szevasztopol: is sitting out 
mooose100: posts big blind $1
*** HOLE CARDS ***
Dealt to matiko09 [9h 7c]
vanilica: folds 
ozone2003: folds 
hammerwife: folds 
Dantist1122 joins the table at seat #4 
PacPacBum: folds 
matiko09: folds 
stds st: folds 
Uncalled bet ($0.50) returned to mooose100
mooose100 collected $1 from pot
mooose100: doesn't show hand 
*** SUMMARY ***
Total pot $1 | Rake $0 
Seat 1: PacPacBum folded before Flop (didn't bet)
Seat 2: matiko09 (button) folded before Flop (didn't bet)
Seat 3: stds st (small blind) folded before Flop
Seat 6: mooose100 (big blind) collected ($1)
Seat 7: vanilica folded before Flop (didn't bet)
Seat 8: ozone2003 folded before Flop (didn't bet)
Seat 9: hammerwife folded before Flop (didn't bet)





PokerStars Hand #154363953926:  Hold'em No Limit ($0.50/$1.00 USD) - 2016/06/06 13:18:05 CET [2016/06/06 7:18:05 ET]
Table 'Gajdariya' 9-max Seat #6 is the button
Seat 1: matiko09 ($128.04 in chips) 
Seat 2: Dickyxxx ($107.52 in chips) 
Seat 3: mooose100 ($81.85 in chips) 
Seat 4: Szevasztopol ($114.27 in chips) 
Seat 5: stds st ($75.13 in chips) 
Seat 6: vanilica ($100 in chips) 
Seat 7: hurtNCYDE ($112.07 in chips) 
Seat 8: ardo888 ($136.82 in chips) 
Seat 9: PacPacBum ($113.23 in chips) 
hurtNCYDE: posts small blind $0.50
ardo888: posts big blind $1
*** HOLE CARDS ***
Dealt to matiko09 [4h Qc]
PacPacBum: folds 
matiko09: folds 
Dickyxxx: folds 
mooose100: calls $1
Szevasztopol: folds 
stds st: raises $2.50 to $3.50
vanilica: folds 
hurtNCYDE: folds 
ardo888: folds 
mooose100: calls $2.50
*** FLOP *** [Td 5h Jc]
mooose100: checks 
stds st: bets $4.44
mooose100: folds 
Uncalled bet ($4.44) returned to stds st
stds st collected $8.08 from pot
stds st: doesn't show hand 
*** SUMMARY ***
Total pot $8.50 | Rake $0.42 
Board [Td 5h Jc]
Seat 1: matiko09 folded before Flop (didn't bet)
Seat 2: Dickyxxx folded before Flop (didn't bet)
Seat 3: mooose100 folded on the Flop
Seat 4: Szevasztopol folded before Flop (didn't bet)
Seat 5: stds st collected ($8.08)
Seat 6: vanilica (button) folded before Flop (didn't bet)
Seat 7: hurtNCYDE (small blind) folded before Flop
Seat 8: ardo888 (big blind) folded before Flop
Seat 9: PacPacBum folded before Flop (didn't bet)





PokerStars Hand #154363955278:  Hold'em No Limit ($0.50/$1.00 USD) - 2016/06/06 13:18:08 CET [2016/06/06 7:18:08 ET]
Table 'Wezen II' 9-max Seat #3 is the button
Seat 1: matiko09 ($100 in chips) 
Seat 2: Mr.Grigoriy ($112.62 in chips) 
Seat 3: Dickyxxx ($100 in chips) 
Seat 4: xxxibgdrgn ($198 in chips) 
Seat 5: stds st ($42.15 in chips) 
Seat 7: KDJAll3 ($76.96 in chips) 
Seat 8: o.miro ($106.50 in chips) 
Seat 9: Cogss ($105.50 in chips) 
xxxibgdrgn: posts small blind $0.50
stds st: posts big blind $1
Eskimo Fox: sits out 
*** HOLE CARDS ***
Dealt to matiko09 [4s 6d]
KDJAll3: folds 
o.miro: folds 
Cogss: raises $1 to $2
matiko09: folds 
Mr.Grigoriy: folds 
Dickyxxx: folds 
xxxibgdrgn: calls $1.50
stds st: calls $1
*** FLOP *** [7c Js 7d]
xxxibgdrgn: checks 
stds st: checks 
Cogss: bets $5.70
xxxibgdrgn: folds 
stds st: folds 
Uncalled bet ($5.70) returned to Cogss
Cogss collected $5.70 from pot
*** SUMMARY ***
Total pot $6 | Rake $0.30 
Board [7c Js 7d]
Seat 1: matiko09 folded before Flop (didn't bet)
Seat 2: Mr.Grigoriy folded before Flop (didn't bet)
Seat 3: Dickyxxx (button) folded before Flop (didn't bet)
Seat 4: xxxibgdrgn (small blind) folded on the Flop
Seat 5: stds st (big blind) folded on the Flop
Seat 7: KDJAll3 folded before Flop (didn't bet)
Seat 8: o.miro folded before Flop (didn't bet)
Seat 9: Cogss collected ($5.70)





PokerStars Hand #154363955220:  Hold'em No Limit ($0.50/$1.00 USD) - 2016/06/06 13:18:08 CET [2016/06/06 7:18:08 ET]
Table 'Heze' 9-max Seat #2 is the button
Seat 1: matiko09 ($171.67 in chips) 
Seat 2: xxxibgdrgn ($117.98 in chips) 
Seat 3: Dickyxxx ($100 in chips) 
Seat 5: stds st ($38 in chips) 
Seat 6: yfcq36 ($122.55 in chips) 
Seat 7: 32rrew ($162.47 in chips) 
Seat 8: PacPacBum ($117.20 in chips) 
Seat 9: Mr.Grigoriy ($130.71 in chips) 
Dickyxxx: posts small blind $0.50
stds st: posts big blind $1
*** HOLE CARDS ***
Dealt to matiko09 [Qh 9c]
yfcq36: folds 
32rrew: folds 
PacPacBum: folds 
Mr.Grigoriy: folds 
matiko09: folds 
xxxibgdrgn: folds 
Dickyxxx: folds 
Uncalled bet ($0.50) returned to stds st
stds st collected $1 from pot
stds st: doesn't show hand 
*** SUMMARY ***
Total pot $1 | Rake $0 
Seat 1: matiko09 folded before Flop (didn't bet)
Seat 2: xxxibgdrgn (button) folded before Flop (didn't bet)
Seat 3: Dickyxxx (small blind) folded before Flop
Seat 5: stds st (big blind) collected ($1)
Seat 6: yfcq36 folded before Flop (didn't bet)
Seat 7: 32rrew folded before Flop (didn't bet)
Seat 8: PacPacBum folded before Flop (didn't bet)
Seat 9: Mr.Grigoriy folded before Flop (didn't bet)





PokerStars Hand #154363957795:  Hold'em No Limit ($0.50/$1.00 USD) - 2016/06/06 13:18:14 CET [2016/06/06 7:18:14 ET]
Table 'Safara' 9-max Seat #2 is the button
Seat 1: Dickyxxx ($104.12 in chips) 
Seat 2: ozone2003 ($102.58 in chips) 
Seat 3: erd33 ($161.50 in chips) 
Seat 4: xxxibgdrgn ($102.38 in chips) 
Seat 5: perezzi10 ($41 in chips) 
Seat 6: matiko09 ($141.78 in chips) 
Seat 9: R1aki ($100 in chips) 
erd33: posts small blind $0.50
xxxibgdrgn: posts big blind $1
PacPacBum: sits out 
o.miro: sits out 
*** HOLE CARDS ***
Dealt to matiko09 [5d As]
perezzi10: folds 
matiko09: folds 
R1aki: folds 
Dickyxxx: folds 
ozone2003: raises $1.20 to $2.20
erd33: folds 
xxxibgdrgn: folds 
Uncalled bet ($1.20) returned to ozone2003
ozone2003 collected $2.50 from pot
ozone2003: doesn't show hand 
*** SUMMARY ***
Total pot $2.50 | Rake $0 
Seat 1: Dickyxxx folded before Flop (didn't bet)
Seat 2: ozone2003 (button) collected ($2.50)
Seat 3: erd33 (small blind) folded before Flop
Seat 4: xxxibgdrgn (big blind) folded before Flop
Seat 5: perezzi10 folded before Flop (didn't bet)
Seat 6: matiko09 folded before Flop (didn't bet)
Seat 9: R1aki folded before Flop (didn't bet)





PokerStars Hand #154363965508:  Hold'em No Limit ($0.50/$1.00 USD) - 2016/06/06 13:18:32 CET [2016/06/06 7:18:32 ET]
Table 'Smither' 9-max Seat #3 is the button
Seat 1: PacPacBum ($169.60 in chips) 
Seat 2: matiko09 ($101.50 in chips) 
Seat 3: stds st ($38.50 in chips) 
Seat 6: mooose100 ($78.15 in chips) 
Seat 7: vanilica ($122.07 in chips) 
Seat 8: ozone2003 ($100 in chips) 
Seat 9: hammerwife ($129.25 in chips) 
Dantist1122 will be allowed to play after the button
mooose100: posts small blind $0.50
vanilica: posts big blind $1
*** HOLE CARDS ***
Dealt to matiko09 [3d 4d]
ozone2003: folds 
hammerwife: raises $2 to $3
PacPacBum: folds 
matiko09: folds 
stds st: folds 
mooose100: calls $2.50
vanilica: folds 
*** FLOP *** [5c 9c Qc]
mooose100: checks 
hammerwife: bets $3
mooose100: raises $3 to $6
hammerwife: folds 
Uncalled bet ($3) returned to mooose100
mooose100 collected $12.35 from pot
mooose100: doesn't show hand 
*** SUMMARY ***
Total pot $13 | Rake $0.65 
Board [5c 9c Qc]
Seat 1: PacPacBum folded before Flop (didn't bet)
Seat 2: matiko09 folded before Flop (didn't bet)
Seat 3: stds st (button) folded before Flop (didn't bet)
Seat 6: mooose100 (small blind) collected ($12.35)
Seat 7: vanilica (big blind) folded before Flop
Seat 8: ozone2003 folded before Flop (didn't bet)
Seat 9: hammerwife folded on the Flop





PokerStars Hand #154363966399:  Hold'em No Limit ($0.50/$1.00 USD) - 2016/06/06 13:18:34 CET [2016/06/06 7:18:34 ET]
Table 'Sheliak' 9-max Seat #8 is the button
Seat 1: 32rrew ($100 in chips) 
Seat 2: DancerNN1 ($104.12 in chips) 
Seat 3: xxxZeka ($118.30 in chips) 
Seat 4: iRLM ($72.25 in chips) 
Seat 5: hammerwife ($100 in chips) 
Seat 6: matiko09 ($108.97 in chips) 
Seat 7: stds st ($40.82 in chips) 
Seat 8: ozone2003 ($100 in chips) 
32rrew: posts small blind $0.50
DancerNN1: posts big blind $1
*** HOLE CARDS ***
Dealt to matiko09 [7s 9c]
xxxZeka: folds 
iRLM has timed out
iRLM: folds 
hammerwife: folds 
matiko09: folds 
stds st: folds 
ozone2003: raises $1.20 to $2.20
32rrew: folds 
DancerNN1: folds 
Uncalled bet ($1.20) returned to ozone2003
ozone2003 collected $2.50 from pot
ozone2003: doesn't show hand 
*** SUMMARY ***
Total pot $2.50 | Rake $0 
Seat 1: 32rrew (small blind) folded before Flop
Seat 2: DancerNN1 (big blind) folded before Flop
Seat 3: xxxZeka folded before Flop (didn't bet)
Seat 4: iRLM folded before Flop (didn't bet)
Seat 5: hammerwife folded before Flop (didn't bet)
Seat 6: matiko09 folded before Flop (didn't bet)
Seat 7: stds st folded before Flop (didn't bet)
Seat 8: ozone2003 (button) collected ($2.50)





PokerStars Hand #154363967911:  Hold'em No Limit ($0.50/$1.00 USD) - 2016/06/06 13:18:37 CET [2016/06/06 7:18:37 ET]
Table 'Heze' 9-max Seat #3 is the button
Seat 1: matiko09 ($171.67 in chips) 
Seat 2: xxxibgdrgn ($117.98 in chips) 
Seat 3: Dickyxxx ($100 in chips) 
Seat 5: stds st ($38.50 in chips) 
Seat 6: yfcq36 ($122.55 in chips) 
Seat 7: 32rrew ($162.47 in chips) 
Seat 8: PacPacBum ($117.20 in chips) 
Seat 9: Mr.Grigoriy ($130.71 in chips) 
stds st: posts small blind $0.50
yfcq36: posts big blind $1
*** HOLE CARDS ***
Dealt to matiko09 [8d 7c]
32rrew: folds 
PacPacBum: raises $2 to $3
Mr.Grigoriy: folds 
matiko09: folds 
xxxibgdrgn: folds 
Dickyxxx: folds 
stds st: folds 
yfcq36: folds 
Uncalled bet ($2) returned to PacPacBum
PacPacBum collected $2.50 from pot
PacPacBum: doesn't show hand 
*** SUMMARY ***
Total pot $2.50 | Rake $0 
Seat 1: matiko09 folded before Flop (didn't bet)
Seat 2: xxxibgdrgn folded before Flop (didn't bet)
Seat 3: Dickyxxx (button) folded before Flop (didn't bet)
Seat 5: stds st (small blind) folded before Flop
Seat 6: yfcq36 (big blind) folded before Flop
Seat 7: 32rrew folded before Flop (didn't bet)
Seat 8: PacPacBum collected ($2.50)
Seat 9: Mr.Grigoriy folded before Flop (didn't bet)





PokerStars Hand #154363967800:  Hold'em No Limit ($0.50/$1.00 USD) - 2016/06/06 13:18:37 CET [2016/06/06 7:18:37 ET]
Table 'Chaldaea II' 9-max Seat #4 is the button
Seat 2: Mr.Grigoriy ($100 in chips) 
Seat 3: ardo888 ($101.85 in chips) 
Seat 4: mooose100 ($145.03 in chips) 
Seat 5: stds st ($30.53 in chips) 
Seat 6: PacPacBum ($101.50 in chips) 
Seat 7: xxxibgdrgn ($100 in chips) 
Seat 8: 32rrew ($100 in chips) 
Seat 9: matiko09 ($101.50 in chips) 
stds st: posts small blind $0.50
PacPacBum: posts big blind $1
*** HOLE CARDS ***
Dealt to matiko09 [Js 8c]
xxxibgdrgn: folds 
32rrew: folds 
matiko09: folds 
Mr.Grigoriy: folds 
ardo888: raises $1.50 to $2.50
mooose100: folds 
stds st: folds 
PacPacBum: raises $5.50 to $8
ardo888: folds 
Uncalled bet ($5.50) returned to PacPacBum
PacPacBum collected $5.50 from pot
PacPacBum: doesn't show hand 
*** SUMMARY ***
Total pot $5.50 | Rake $0 
Seat 2: Mr.Grigoriy folded before Flop (didn't bet)
Seat 3: ardo888 folded before Flop
Seat 4: mooose100 (button) folded before Flop (didn't bet)
Seat 5: stds st (small blind) folded before Flop
Seat 6: PacPacBum (big blind) collected ($5.50)
Seat 7: xxxibgdrgn folded before Flop (didn't bet)
Seat 8: 32rrew folded before Flop (didn't bet)
Seat 9: matiko09 folded before Flop (didn't bet)





PokerStars Hand #154363970193:  Hold'em No Limit ($0.50/$1.00 USD) - 2016/06/06 13:18:43 CET [2016/06/06 7:18:43 ET]
Table 'Safara' 9-max Seat #3 is the button
Seat 1: Dickyxxx ($104.12 in chips) 
Seat 2: ozone2003 ($104.08 in chips) 
Seat 3: erd33 ($161 in chips) 
Seat 4: xxxibgdrgn ($101.38 in chips) 
Seat 5: perezzi10 ($41 in chips) 
Seat 6: matiko09 ($141.78 in chips) 
Seat 9: R1aki ($100 in chips) 
xxxibgdrgn: posts small blind $0.50
perezzi10: posts big blind $1
PacPacBum: sits out 
o.miro: sits out 
*** HOLE CARDS ***
Dealt to matiko09 [Ad 3d]
matiko09: folds 
R1aki: folds 
Dickyxxx: folds 
ozone2003: folds 
erd33: raises $2 to $3
xxxibgdrgn: folds 
perezzi10: calls $2
*** FLOP *** [5d Jd 9c]
perezzi10: bets $2
erd33: folds 
Uncalled bet ($2) returned to perezzi10
perezzi10 collected $6.18 from pot
*** SUMMARY ***
Total pot $6.50 | Rake $0.32 
Board [5d Jd 9c]
Seat 1: Dickyxxx folded before Flop (didn't bet)
Seat 2: ozone2003 folded before Flop (didn't bet)
Seat 3: erd33 (button) folded on the Flop
Seat 4: xxxibgdrgn (small blind) folded before Flop
Seat 5: perezzi10 (big blind) collected ($6.18)
Seat 6: matiko09 folded before Flop (didn't bet)
Seat 9: R1aki folded before Flop (didn't bet)





PokerStars Hand #154363976286:  Hold'em No Limit (€0.50/€1.00 EUR) - 2016/06/06 13:18:57 CET [2016/06/06 7:18:57 ET]
Table 'Lesath' 9-max Seat #8 is the button
Seat 1: o.miro (€118.56 in chips) 
Seat 2: thecurv (€110.99 in chips) 
Seat 3: ozone2003 (€204.64 in chips) 
Seat 4: hammerwife (€124.61 in chips) 
Seat 5: matiko09 (€113.47 in chips) 
Seat 7: Mr.Grigoriy (€100 in chips) 
Seat 8: stds st (€44 in chips) 
Seat 9: 72nloses (€45.16 in chips) 
72nloses: posts small blind €0.50
o.miro: posts big blind €1
*** HOLE CARDS ***
Dealt to matiko09 [7h 8c]
thecurv: raises €1 to €2
ozone2003: calls €2
hammerwife: folds 
matiko09: folds 
Mr.Grigoriy: folds 
stds st: raises €5 to €7
72nloses: folds 
o.miro: folds 
thecurv: folds 
ozone2003: folds 
Uncalled bet (€5) returned to stds st
stds st collected €7.50 from pot
stds st: doesn't show hand 
*** SUMMARY ***
Total pot €7.50 | Rake €0 
Seat 1: o.miro (big blind) folded before Flop
Seat 2: thecurv folded before Flop
Seat 3: ozone2003 folded before Flop
Seat 4: hammerwife folded before Flop (didn't bet)
Seat 5: matiko09 folded before Flop (didn't bet)
Seat 7: Mr.Grigoriy folded before Flop (didn't bet)
Seat 8: stds st (button) collected (€7.50)
Seat 9: 72nloses (small blind) folded before Flop





PokerStars Hand #154363978780:  Hold'em No Limit ($0.50/$1.00 USD) - 2016/06/06 13:19:03 CET [2016/06/06 7:19:03 ET]
Table 'Gajdariya' 9-max Seat #7 is the button
Seat 1: matiko09 ($128.04 in chips) 
Seat 2: Dickyxxx ($107.52 in chips) 
Seat 3: mooose100 ($78.35 in chips) 
Seat 4: Szevasztopol ($114.27 in chips) 
Seat 5: stds st ($79.71 in chips) 
Seat 6: vanilica ($100 in chips) 
Seat 7: hurtNCYDE ($111.57 in chips) 
Seat 8: ardo888 ($135.82 in chips) 
Seat 9: PacPacBum ($113.23 in chips) 
ardo888: posts small blind $0.50
PacPacBum: posts big blind $1
*** HOLE CARDS ***
Dealt to matiko09 [Kd 2d]
matiko09: folds 
Dickyxxx: folds 
mooose100: calls $1
Szevasztopol: folds 
stds st: raises $2.50 to $3.50
vanilica: folds 
hurtNCYDE: folds 
ardo888: folds 
PacPacBum: folds 
mooose100: calls $2.50
*** FLOP *** [4c Th 7d]
mooose100: checks 
stds st: bets $4.44
mooose100: raises $4.44 to $8.88
stds st: calls $4.44
*** TURN *** [4c Th 7d] [8s]
mooose100: bets $12.47
stds st: folds 
Uncalled bet ($12.47) returned to mooose100
mooose100 collected $24.95 from pot
mooose100: doesn't show hand 
*** SUMMARY ***
Total pot $26.26 | Rake $1.31 
Board [4c Th 7d 8s]
Seat 1: matiko09 folded before Flop (didn't bet)
Seat 2: Dickyxxx folded before Flop (didn't bet)
Seat 3: mooose100 collected ($24.95)
Seat 4: Szevasztopol folded before Flop (didn't bet)
Seat 5: stds st folded on the Turn
Seat 6: vanilica folded before Flop (didn't bet)
Seat 7: hurtNCYDE (button) folded before Flop (didn't bet)
Seat 8: ardo888 (small blind) folded before Flop
Seat 9: PacPacBum (big blind) folded before Flop





PokerStars Hand #154363982603:  Hold'em No Limit ($0.50/$1.00 USD) - 2016/06/06 13:19:12 CET [2016/06/06 7:19:12 ET]
Table 'Heze' 9-max Seat #5 is the button
Seat 1: matiko09 ($171.67 in chips) 
Seat 2: xxxibgdrgn ($117.98 in chips) 
Seat 3: Dickyxxx ($100 in chips) 
Seat 5: stds st ($38 in chips) 
Seat 6: yfcq36 ($121.55 in chips) 
Seat 7: 32rrew ($162.47 in chips) 
Seat 8: PacPacBum ($118.70 in chips) 
Seat 9: Mr.Grigoriy ($130.71 in chips) 
yfcq36: posts small blind $0.50
32rrew: posts big blind $1
*** HOLE CARDS ***
Dealt to matiko09 [7d 3d]
PacPacBum: folds 
Mr.Grigoriy: folds 
matiko09: folds 
xxxibgdrgn: folds 
Dickyxxx: raises $2 to $3
stds st: folds 
yfcq36: folds 
32rrew: calls $2
*** FLOP *** [Kd Js 8d]
32rrew: checks 
ardo888 leaves the table
Dickyxxx: bets $3.95
xxxZeka joins the table at seat #4 
xxxZeka leaves the table
hurtNCYDE joins the table at seat #4 
hurtNCYDE leaves the table
32rrew: folds 
Uncalled bet ($3.95) returned to Dickyxxx
Dickyxxx collected $6.18 from pot
Dickyxxx: doesn't show hand 
*** SUMMARY ***
Total pot $6.50 | Rake $0.32 
Board [Kd Js 8d]
Seat 1: matiko09 folded before Flop (didn't bet)
Seat 2: xxxibgdrgn folded before Flop (didn't bet)
Seat 3: Dickyxxx collected ($6.18)
Seat 5: stds st (button) folded before Flop (didn't bet)
Seat 6: yfcq36 (small blind) folded before Flop
Seat 7: 32rrew (big blind) folded on the Flop
Seat 8: PacPacBum folded before Flop (didn't bet)
Seat 9: Mr.Grigoriy folded before Flop (didn't bet)





PokerStars Hand #154363983258:  Hold'em No Limit ($0.50/$1.00 USD) - 2016/06/06 13:19:13 CET [2016/06/06 7:19:13 ET]
Table 'Chaldaea II' 9-max Seat #5 is the button
Seat 2: Mr.Grigoriy ($100 in chips) 
Seat 3: ardo888 ($100 in chips) 
Seat 4: mooose100 ($145.03 in chips) 
Seat 5: stds st ($30.03 in chips) 
Seat 6: PacPacBum ($104.50 in chips) 
Seat 7: xxxibgdrgn ($100 in chips) 
Seat 8: 32rrew ($100 in chips) 
Seat 9: matiko09 ($101.50 in chips) 
PacPacBum: posts small blind $0.50
xxxibgdrgn: posts big blind $1
*** HOLE CARDS ***
Dealt to matiko09 [6d Th]
32rrew: folds 
matiko09: folds 
Mr.Grigoriy: folds 
ardo888: folds 
mooose100: folds 
stds st: raises $1.02 to $2.02
PacPacBum: folds 
xxxibgdrgn: raises $5.98 to $8
stds st: folds 
Uncalled bet ($5.98) returned to xxxibgdrgn
xxxibgdrgn collected $4.54 from pot
xxxibgdrgn: doesn't show hand 
*** SUMMARY ***
Total pot $4.54 | Rake $0 
Seat 2: Mr.Grigoriy folded before Flop (didn't bet)
Seat 3: ardo888 folded before Flop (didn't bet)
Seat 4: mooose100 folded before Flop (didn't bet)
Seat 5: stds st (button) folded before Flop
Seat 6: PacPacBum (small blind) folded before Flop
Seat 7: xxxibgdrgn (big blind) collected ($4.54)
Seat 8: 32rrew folded before Flop (didn't bet)
Seat 9: matiko09 folded before Flop (didn't bet)





PokerStars Hand #154363982919:  Hold'em No Limit ($0.50/$1.00 USD) - 2016/06/06 13:19:13 CET [2016/06/06 7:19:13 ET]
Table 'Sheliak' 9-max Seat #1 is the button
Seat 1: 32rrew ($100 in chips) 
Seat 2: DancerNN1 ($103.12 in chips) 
Seat 3: xxxZeka ($118.30 in chips) 
Seat 5: hammerwife ($100 in chips) 
Seat 6: matiko09 ($108.97 in chips) 
Seat 7: stds st ($40.82 in chips) 
Seat 8: ozone2003 ($101.50 in chips) 
DancerNN1: posts small blind $0.50
xxxZeka: posts big blind $1
*** HOLE CARDS ***
Dealt to matiko09 [9d 5h]
hammerwife: folds 
matiko09: folds 
stds st: folds 
ozone2003: folds 
32rrew: raises $1.50 to $2.50
DancerNN1: folds 
xxxZeka: raises $6.50 to $9
32rrew: folds 
Uncalled bet ($6.50) returned to xxxZeka
xxxZeka collected $5.50 from pot
*** SUMMARY ***
Total pot $5.50 | Rake $0 
Seat 1: 32rrew (button) folded before Flop
Seat 2: DancerNN1 (small blind) folded before Flop
Seat 3: xxxZeka (big blind) collected ($5.50)
Seat 5: hammerwife folded before Flop (didn't bet)
Seat 6: matiko09 folded before Flop (didn't bet)
Seat 7: stds st folded before Flop (didn't bet)
Seat 8: ozone2003 folded before Flop (didn't bet)





PokerStars Hand #154363985926:  Hold'em No Limit ($0.50/$1.00 USD) - 2016/06/06 13:19:20 CET [2016/06/06 7:19:20 ET]
Table 'Wezen II' 9-max Seat #4 is the button
Seat 1: matiko09 ($100 in chips) 
Seat 2: Mr.Grigoriy ($112.62 in chips) 
Seat 3: Dickyxxx ($100 in chips) 
Seat 4: xxxibgdrgn ($196 in chips) 
Seat 5: stds st ($40.15 in chips) 
Seat 6: Eskimo Fox ($100 in chips) 
Seat 7: KDJAll3 ($76.96 in chips) 
Seat 8: o.miro ($106.50 in chips) 
Seat 9: Cogss ($109.20 in chips) 
stds st: posts small blind $0.50
Eskimo Fox: posts big blind $1
*** HOLE CARDS ***
Dealt to matiko09 [4s 5c]
KDJAll3: folds 
o.miro: folds 
Cogss: folds 
matiko09: folds 
Mr.Grigoriy: folds 
Dickyxxx: folds 
xxxibgdrgn: folds 
stds st: raises $1.02 to $2.02
Eskimo Fox: raises $2.98 to $5
stds st: folds 
Uncalled bet ($2.98) returned to Eskimo Fox
Eskimo Fox collected $4.04 from pot
Eskimo Fox: doesn't show hand 
*** SUMMARY ***
Total pot $4.04 | Rake $0 
Seat 1: matiko09 folded before Flop (didn't bet)
Seat 2: Mr.Grigoriy folded before Flop (didn't bet)
Seat 3: Dickyxxx folded before Flop (didn't bet)
Seat 4: xxxibgdrgn (button) folded before Flop (didn't bet)
Seat 5: stds st (small blind) folded before Flop
Seat 6: Eskimo Fox (big blind) collected ($4.04)
Seat 7: KDJAll3 folded before Flop (didn't bet)
Seat 8: o.miro folded before Flop (didn't bet)
Seat 9: Cogss folded before Flop (didn't bet)





PokerStars Hand #154363988504:  Hold'em No Limit ($0.50/$1.00 USD) - 2016/06/06 13:19:26 CET [2016/06/06 7:19:26 ET]
Table 'Smither' 9-max Seat #6 is the button
Seat 1: PacPacBum ($169.60 in chips) 
Seat 2: matiko09 ($101.50 in chips) 
Seat 3: stds st ($38.50 in chips) 
Seat 6: mooose100 ($84.50 in chips) 
Seat 7: vanilica ($121.07 in chips) 
Seat 8: ozone2003 ($100 in chips) 
Seat 9: hammerwife ($123.25 in chips) 
vanilica: posts small blind $0.50
ozone2003: posts big blind $1
Dantist1122: sits out 
*** HOLE CARDS ***
Dealt to matiko09 [Ks Qs]
hammerwife: folds 
PacPacBum: folds 
matiko09: raises $2 to $3
stds st: folds 
mooose100: folds 
vanilica: folds 
ozone2003: folds 
Uncalled bet ($2) returned to matiko09
matiko09 collected $2.50 from pot
matiko09: doesn't show hand 
*** SUMMARY ***
Total pot $2.50 | Rake $0 
Seat 1: PacPacBum folded before Flop (didn't bet)
Seat 2: matiko09 collected ($2.50)
Seat 3: stds st folded before Flop (didn't bet)
Seat 6: mooose100 (button) folded before Flop (didn't bet)
Seat 7: vanilica (small blind) folded before Flop
Seat 8: ozone2003 (big blind) folded before Flop
Seat 9: hammerwife folded before Flop (didn't bet)





PokerStars Hand #154363990406:  Hold'em No Limit ($0.50/$1.00 USD) - 2016/06/06 13:19:30 CET [2016/06/06 7:19:30 ET]
Table 'Safara' 9-max Seat #4 is the button
Seat 1: Dickyxxx ($104.12 in chips) 
Seat 2: ozone2003 ($104.08 in chips) 
Seat 3: erd33 ($158 in chips) 
Seat 4: xxxibgdrgn ($100.88 in chips) 
Seat 5: perezzi10 ($44.18 in chips) 
Seat 6: matiko09 ($141.78 in chips) 
Seat 9: R1aki ($100 in chips) 
perezzi10: posts small blind $0.50
matiko09: posts big blind $1
PacPacBum: sits out 
o.miro: sits out 
*** HOLE CARDS ***
Dealt to matiko09 [Kh 3d]
R1aki: folds 
Dickyxxx: folds 
ozone2003: folds 
erd33: raises $2 to $3
xxxibgdrgn: folds 
perezzi10: calls $2.50
matiko09: folds 
*** FLOP *** [Kd 3h Jh]
perezzi10: checks 
erd33: checks 
*** TURN *** [Kd 3h Jh] [2h]
perezzi10: bets $1
erd33: calls $1
*** RIVER *** [Kd 3h Jh 2h] [7c]
perezzi10: checks 
erd33: bets $3
perezzi10: folds 
Uncalled bet ($3) returned to erd33
erd33 collected $8.55 from pot
*** SUMMARY ***
Total pot $9 | Rake $0.45 
Board [Kd 3h Jh 2h 7c]
Seat 1: Dickyxxx folded before Flop (didn't bet)
Seat 2: ozone2003 folded before Flop (didn't bet)
Seat 3: erd33 collected ($8.55)
Seat 4: xxxibgdrgn (button) folded before Flop (didn't bet)
Seat 5: perezzi10 (small blind) folded on the River
Seat 6: matiko09 (big blind) folded before Flop
Seat 9: R1aki folded before Flop (didn't bet)





PokerStars Hand #154363996016:  Hold'em No Limit ($0.50/$1.00 USD) - 2016/06/06 13:19:43 CET [2016/06/06 7:19:43 ET]
Table 'Williams' 9-max Seat #9 is the button
Seat 1: xhinostrabli ($75.50 in chips) 
Seat 2: matiko09 ($176.01 in chips) 
Seat 3: granbunny ($66.81 in chips) 
Seat 4: Mr.Grigoriy ($107.62 in chips) 
Seat 5: xxxibgdrgn ($100 in chips) 
Seat 6: xxxZeka ($130.38 in chips) 
Seat 7: Eskimo Fox ($117.94 in chips) 
Seat 8: Dickyxxx ($101.50 in chips) 
Seat 9: stds st ($41.08 in chips) 
xhinostrabli: posts small blind $0.50
matiko09: posts big blind $1
*** HOLE CARDS ***
Dealt to matiko09 [5d Th]
granbunny: raises $1 to $2
Mr.Grigoriy: folds 
xxxibgdrgn: folds 
xxxZeka: folds 
Eskimo Fox: folds 
Dickyxxx: folds 
stds st: folds 
xhinostrabli: calls $1.50
matiko09: folds 
*** FLOP *** [Ad 7s As]
xhinostrabli: checks 
granbunny: checks 
*** TURN *** [Ad 7s As] [4c]
xhinostrabli: checks 
granbunny: bets $4
xhinostrabli: folds 
Uncalled bet ($4) returned to granbunny
granbunny collected $4.75 from pot
granbunny: doesn't show hand 
*** SUMMARY ***
Total pot $5 | Rake $0.25 
Board [Ad 7s As 4c]
Seat 1: xhinostrabli (small blind) folded on the Turn
Seat 2: matiko09 (big blind) folded before Flop
Seat 3: granbunny collected ($4.75)
Seat 4: Mr.Grigoriy folded before Flop (didn't bet)
Seat 5: xxxibgdrgn folded before Flop (didn't bet)
Seat 6: xxxZeka folded before Flop (didn't bet)
Seat 7: Eskimo Fox folded before Flop (didn't bet)
Seat 8: Dickyxxx folded before Flop (didn't bet)
Seat 9: stds st (button) folded before Flop (didn't bet)





PokerStars Hand #154363998834:  Hold'em No Limit ($0.50/$1.00 USD) - 2016/06/06 13:19:50 CET [2016/06/06 7:19:50 ET]
Table 'Chaldaea II' 9-max Seat #6 is the button
Seat 2: Mr.Grigoriy ($100 in chips) 
Seat 3: ardo888 ($100 in chips) 
Seat 4: mooose100 ($145.03 in chips) 
Seat 5: stds st ($28.01 in chips) 
Seat 6: PacPacBum ($104 in chips) 
Seat 7: xxxibgdrgn ($102.52 in chips) 
Seat 8: 32rrew ($100 in chips) 
Seat 9: matiko09 ($101.50 in chips) 
xxxibgdrgn: posts small blind $0.50
32rrew: posts big blind $1
*** HOLE CARDS ***
Dealt to matiko09 [Qd 8c]
matiko09: folds 
Mr.Grigoriy: folds 
ardo888: folds 
mooose100: folds 
stds st: raises $1.50 to $2.50
PacPacBum: calls $2.50
xxxibgdrgn: folds 
32rrew: calls $1.50
*** FLOP *** [3d 4s 2d]
32rrew: checks 
stds st: bets $4.18
PacPacBum: calls $4.18
32rrew: folds 
*** TURN *** [3d 4s 2d] [4c]
stds st: checks 
PacPacBum: bets $8.39
stds st: folds 
Uncalled bet ($8.39) returned to PacPacBum
PacPacBum collected $15.54 from pot
PacPacBum: doesn't show hand 
*** SUMMARY ***
Total pot $16.36 | Rake $0.82 
Board [3d 4s 2d 4c]
Seat 2: Mr.Grigoriy folded before Flop (didn't bet)
Seat 3: ardo888 folded before Flop (didn't bet)
Seat 4: mooose100 folded before Flop (didn't bet)
Seat 5: stds st folded on the Turn
Seat 6: PacPacBum (button) collected ($15.54)
Seat 7: xxxibgdrgn (small blind) folded before Flop
Seat 8: 32rrew (big blind) folded on the Flop
Seat 9: matiko09 folded before Flop (didn't bet)





PokerStars Hand #154364000054:  Hold'em No Limit (€0.50/€1.00 EUR) - 2016/06/06 13:19:53 CET [2016/06/06 7:19:53 ET]
Table 'Lesath' 9-max Seat #9 is the button
Seat 1: o.miro (€117.56 in chips) 
Seat 2: thecurv (€108.99 in chips) 
Seat 3: ozone2003 (€202.64 in chips) 
Seat 4: hammerwife (€124.61 in chips) 
Seat 5: matiko09 (€113.47 in chips) 
Seat 7: Mr.Grigoriy (€100 in chips) 
Seat 8: stds st (€49.50 in chips) 
Seat 9: 72nloses (€44.66 in chips) 
o.miro: posts small blind €0.50
thecurv: posts big blind €1
*** HOLE CARDS ***
Dealt to matiko09 [7h 9c]
ozone2003: folds 
hammerwife: folds 
matiko09: folds 
Mr.Grigoriy: folds 
stds st: raises €1.02 to €2.02
72nloses: folds 
o.miro: folds 
thecurv: folds 
Uncalled bet (€1.02) returned to stds st
stds st collected €2.50 from pot
stds st: doesn't show hand 
*** SUMMARY ***
Total pot €2.50 | Rake €0 
Seat 1: o.miro (small blind) folded before Flop
Seat 2: thecurv (big blind) folded before Flop
Seat 3: ozone2003 folded before Flop (didn't bet)
Seat 4: hammerwife folded before Flop (didn't bet)
Seat 5: matiko09 folded before Flop (didn't bet)
Seat 7: Mr.Grigoriy folded before Flop (didn't bet)
Seat 8: stds st collected (€2.50)
Seat 9: 72nloses (button) folded before Flop (didn't bet)





PokerStars Hand #154364002689:  Hold'em No Limit ($0.50/$1.00 USD) - 2016/06/06 13:19:59 CET [2016/06/06 7:19:59 ET]
Table 'Wezen II' 9-max Seat #5 is the button
Seat 1: matiko09 ($100 in chips) 
Seat 2: Mr.Grigoriy ($112.62 in chips) 
Seat 3: Dickyxxx ($100 in chips) 
Seat 4: xxxibgdrgn ($196 in chips) 
Seat 5: stds st ($38.13 in chips) 
Seat 6: Eskimo Fox ($102.02 in chips) 
Seat 7: KDJAll3 ($76.96 in chips) 
Seat 8: o.miro ($106.50 in chips) 
Seat 9: Cogss ($109.20 in chips) 
Eskimo Fox: posts small blind $0.50
KDJAll3: posts big blind $1
*** HOLE CARDS ***
Dealt to matiko09 [7h Td]
o.miro: folds 
Cogss: folds 
matiko09: folds 
Mr.Grigoriy: folds 
Dickyxxx: folds 
xxxibgdrgn: folds 
stds st: folds 
Eskimo Fox: folds 
Uncalled bet ($0.50) returned to KDJAll3
KDJAll3 collected $1 from pot
KDJAll3: doesn't show hand 
*** SUMMARY ***
Total pot $1 | Rake $0 
Seat 1: matiko09 folded before Flop (didn't bet)
Seat 2: Mr.Grigoriy folded before Flop (didn't bet)
Seat 3: Dickyxxx folded before Flop (didn't bet)
Seat 4: xxxibgdrgn folded before Flop (didn't bet)
Seat 5: stds st (button) folded before Flop (didn't bet)
Seat 6: Eskimo Fox (small blind) folded before Flop
Seat 7: KDJAll3 (big blind) collected ($1)
Seat 8: o.miro folded before Flop (didn't bet)
Seat 9: Cogss folded before Flop (didn't bet)





PokerStars Hand #154364004986:  Hold'em No Limit ($0.50/$1.00 USD) - 2016/06/06 13:20:04 CET [2016/06/06 7:20:04 ET]
Table 'Smither' 9-max Seat #7 is the button
Seat 1: PacPacBum ($169.60 in chips) 
Seat 2: matiko09 ($103 in chips) 
Seat 3: stds st ($38.50 in chips) 
Seat 6: mooose100 ($84.50 in chips) 
Seat 7: vanilica ($120.57 in chips) 
Seat 8: ozone2003 ($100 in chips) 
ozone2003: posts small blind $0.50
hammerwife: is sitting out 
PacPacBum: posts big blind $1
Dantist1122: sits out 
*** HOLE CARDS ***
Dealt to matiko09 [Qs 2s]
matiko09: folds 
stds st: folds 
mooose100: calls $1
vanilica: raises $3.50 to $4.50
ozone2003: folds 
PacPacBum: folds 
mooose100: calls $3.50
*** FLOP *** [3h Jd Tc]
mooose100: checks 
vanilica: checks 
*** TURN *** [3h Jd Tc] [9c]
mooose100: checks 
vanilica: bets $7.48
mooose100: folds 
Uncalled bet ($7.48) returned to vanilica
vanilica collected $9.98 from pot
vanilica: doesn't show hand 
*** SUMMARY ***
Total pot $10.50 | Rake $0.52 
Board [3h Jd Tc 9c]
Seat 1: PacPacBum (big blind) folded before Flop
Seat 2: matiko09 folded before Flop (didn't bet)
Seat 3: stds st folded before Flop (didn't bet)
Seat 6: mooose100 folded on the Turn
Seat 7: vanilica (button) collected ($9.98)
Seat 8: ozone2003 (small blind) folded before Flop





PokerStars Hand #154364009252:  Hold'em No Limit ($0.50/$1.00 USD) - 2016/06/06 13:20:14 CET [2016/06/06 7:20:14 ET]
Table 'Sheliak' 9-max Seat #2 is the button
Seat 1: 32rrew ($100 in chips) 
Seat 2: DancerNN1 ($102.62 in chips) 
Seat 3: xxxZeka ($121.30 in chips) 
Seat 6: matiko09 ($108.97 in chips) 
Seat 7: stds st ($40.82 in chips) 
Seat 8: ozone2003 ($101.50 in chips) 
xxxZeka: posts small blind $0.50
hammerwife: is sitting out 
matiko09: posts big blind $1
*** HOLE CARDS ***
Dealt to matiko09 [7h 4h]
stds st: raises $1.50 to $2.50
ozone2003: folds 
32rrew: folds 
DancerNN1: folds 
xxxZeka: folds 
matiko09: folds 
Uncalled bet ($1.50) returned to stds st
stds st collected $2.50 from pot
stds st: doesn't show hand 
*** SUMMARY ***
Total pot $2.50 | Rake $0 
Seat 1: 32rrew folded before Flop (didn't bet)
Seat 2: DancerNN1 (button) folded before Flop (didn't bet)
Seat 3: xxxZeka (small blind) folded before Flop
Seat 6: matiko09 (big blind) folded before Flop
Seat 7: stds st collected ($2.50)
Seat 8: ozone2003 folded before Flop (didn't bet)





PokerStars Hand #154364009957:  Hold'em No Limit ($0.50/$1.00 USD) - 2016/06/06 13:20:15 CET [2016/06/06 7:20:15 ET]
Table 'Heze' 9-max Seat #6 is the button
Seat 1: matiko09 ($171.67 in chips) 
Seat 2: xxxibgdrgn ($117.98 in chips) 
Seat 3: Dickyxxx ($103.18 in chips) 
Seat 5: stds st ($38 in chips) 
Seat 6: yfcq36 ($121.05 in chips) 
Seat 7: 32rrew ($159.47 in chips) 
Seat 8: PacPacBum ($118.70 in chips) 
Seat 9: Mr.Grigoriy ($130.71 in chips) 
32rrew: posts small blind $0.50
PacPacBum: posts big blind $1
*** HOLE CARDS ***
Dealt to matiko09 [Jc Td]
Mr.Grigoriy: folds 
matiko09: folds 
xxxibgdrgn: folds 
Dickyxxx: folds 
stds st: folds 
yfcq36: raises $2 to $3
32rrew: folds 
Eskimo Fox joins the table at seat #4 
PacPacBum: calls $2
*** FLOP *** [9d 4d Th]
PacPacBum: checks 
yfcq36: bets $6
PacPacBum: folds 
Uncalled bet ($6) returned to yfcq36
yfcq36 collected $6.18 from pot
yfcq36: doesn't show hand 
*** SUMMARY ***
Total pot $6.50 | Rake $0.32 
Board [9d 4d Th]
Seat 1: matiko09 folded before Flop (didn't bet)
Seat 2: xxxibgdrgn folded before Flop (didn't bet)
Seat 3: Dickyxxx folded before Flop (didn't bet)
Seat 5: stds st folded before Flop (didn't bet)
Seat 6: yfcq36 (button) collected ($6.18)
Seat 7: 32rrew (small blind) folded before Flop
Seat 8: PacPacBum (big blind) folded on the Flop
Seat 9: Mr.Grigoriy folded before Flop (didn't bet)





PokerStars Hand #154364010930:  Hold'em No Limit ($0.50/$1.00 USD) - 2016/06/06 13:20:17 CET [2016/06/06 7:20:17 ET]
Table 'Safara' 9-max Seat #5 is the button
Seat 1: Dickyxxx ($104.12 in chips) 
Seat 2: ozone2003 ($104.08 in chips) 
Seat 3: erd33 ($162.55 in chips) 
Seat 4: xxxibgdrgn ($100.88 in chips) 
Seat 5: perezzi10 ($40.18 in chips) 
Seat 6: matiko09 ($140.78 in chips) 
Seat 7: PacPacBum ($122.53 in chips) 
Seat 9: R1aki ($100 in chips) 
matiko09: posts small blind $0.50
PacPacBum: posts big blind $1
o.miro: sits out 
*** HOLE CARDS ***
Dealt to matiko09 [8s Jh]
R1aki: folds 
Dickyxxx: folds 
ozone2003: folds 
erd33: folds 
xxxibgdrgn: raises $1.50 to $2.50
perezzi10: folds 
matiko09: folds 
PacPacBum: folds 
Uncalled bet ($1.50) returned to xxxibgdrgn
xxxibgdrgn collected $2.50 from pot
xxxibgdrgn: doesn't show hand 
*** SUMMARY ***
Total pot $2.50 | Rake $0 
Seat 1: Dickyxxx folded before Flop (didn't bet)
Seat 2: ozone2003 folded before Flop (didn't bet)
Seat 3: erd33 folded before Flop (didn't bet)
Seat 4: xxxibgdrgn collected ($2.50)
Seat 5: perezzi10 (button) folded before Flop (didn't bet)
Seat 6: matiko09 (small blind) folded before Flop
Seat 7: PacPacBum (big blind) folded before Flop
Seat 9: R1aki folded before Flop (didn't bet)





PokerStars Hand #154364013671:  Hold'em No Limit ($0.50/$1.00 USD) - 2016/06/06 13:20:24 CET [2016/06/06 7:20:24 ET]
Table 'Wezen II' 9-max Seat #6 is the button
Seat 1: matiko09 ($100 in chips) 
Seat 2: Mr.Grigoriy ($112.62 in chips) 
Seat 3: Dickyxxx ($100 in chips) 
Seat 4: xxxibgdrgn ($196 in chips) 
Seat 5: stds st ($38.13 in chips) 
Seat 6: Eskimo Fox ($101.52 in chips) 
Seat 7: KDJAll3 ($77.46 in chips) 
Seat 8: o.miro ($106.50 in chips) 
Seat 9: Cogss ($109.20 in chips) 
KDJAll3: posts small blind $0.50
o.miro: posts big blind $1
*** HOLE CARDS ***
Dealt to matiko09 [Js 4d]
Cogss: folds 
matiko09: folds 
Mr.Grigoriy: folds 
Dickyxxx: folds 
xxxibgdrgn: folds 
stds st: raises $1.50 to $2.50
Eskimo Fox: folds 
KDJAll3: calls $2
o.miro: folds 
*** FLOP *** [Jh 6c 9c]
KDJAll3: checks 
stds st: checks 
*** TURN *** [Jh 6c 9c] [Qd]
KDJAll3: checks 
stds st: checks 
*** RIVER *** [Jh 6c 9c Qd] [3c]
KDJAll3: checks 
stds st: checks 
*** SHOW DOWN ***
KDJAll3: shows [As 4s] (high card Ace)
stds st: shows [7h 7d] (a pair of Sevens)
stds st collected $5.70 from pot
*** SUMMARY ***
Total pot $6 | Rake $0.30 
Board [Jh 6c 9c Qd 3c]
Seat 1: matiko09 folded before Flop (didn't bet)
Seat 2: Mr.Grigoriy folded before Flop (didn't bet)
Seat 3: Dickyxxx folded before Flop (didn't bet)
Seat 4: xxxibgdrgn folded before Flop (didn't bet)
Seat 5: stds st showed [7h 7d] and won ($5.70) with a pair of Sevens
Seat 6: Eskimo Fox (button) folded before Flop (didn't bet)
Seat 7: KDJAll3 (small blind) showed [As 4s] and lost with high card Ace
Seat 8: o.miro (big blind) folded before Flop
Seat 9: Cogss folded before Flop (didn't bet)





PokerStars Hand #154364019995:  Hold'em No Limit ($0.50/$1.00 USD) - 2016/06/06 13:20:39 CET [2016/06/06 7:20:39 ET]
Table 'Sheliak' 9-max Seat #3 is the button
Seat 1: 32rrew ($100 in chips) 
Seat 2: DancerNN1 ($102.62 in chips) 
Seat 3: xxxZeka ($120.80 in chips) 
Seat 6: matiko09 ($107.97 in chips) 
Seat 7: stds st ($42.32 in chips) 
Seat 8: ozone2003 ($101.50 in chips) 
iRLM will be allowed to play after the button
matiko09: posts small blind $0.50
stds st: posts big blind $1
*** HOLE CARDS ***
Dealt to matiko09 [3h 5h]
ozone2003: folds 
32rrew: folds 
DancerNN1: folds 
xxxZeka: folds 
matiko09: folds 
Uncalled bet ($0.50) returned to stds st
stds st collected $1 from pot
stds st: doesn't show hand 
*** SUMMARY ***
Total pot $1 | Rake $0 
Seat 1: 32rrew folded before Flop (didn't bet)
Seat 2: DancerNN1 folded before Flop (didn't bet)
Seat 3: xxxZeka (button) folded before Flop (didn't bet)
Seat 6: matiko09 (small blind) folded before Flop
Seat 7: stds st (big blind) collected ($1)
Seat 8: ozone2003 folded before Flop (didn't bet)





PokerStars Hand #154364020677:  Hold'em No Limit ($0.50/$1.00 USD) - 2016/06/06 13:20:40 CET [2016/06/06 7:20:40 ET]
Table 'Gajdariya' 9-max Seat #8 is the button
Seat 1: matiko09 ($128.04 in chips) 
Seat 2: Dickyxxx ($107.52 in chips) 
Seat 3: mooose100 ($90.92 in chips) 
Seat 4: Szevasztopol ($114.27 in chips) 
Seat 5: stds st ($67.33 in chips) 
Seat 6: vanilica ($100 in chips) 
Seat 7: hurtNCYDE ($111.57 in chips) 
Seat 8: ardo888 ($135.32 in chips) 
Seat 9: PacPacBum ($112.23 in chips) 
PacPacBum: posts small blind $0.50
matiko09: posts big blind $1
*** HOLE CARDS ***
Dealt to matiko09 [3c 4d]
Dickyxxx: folds 
mooose100: calls $1
Szevasztopol: folds 
stds st: folds 
vanilica: folds 
hurtNCYDE: raises $3 to $4
ardo888: folds 
PacPacBum: folds 
matiko09: folds 
mooose100: calls $3
*** FLOP *** [4h Js Qd]
mooose100: checks 
hurtNCYDE: bets $3.06
mooose100: folds 
Uncalled bet ($3.06) returned to hurtNCYDE
hurtNCYDE collected $9.02 from pot
*** SUMMARY ***
Total pot $9.50 | Rake $0.48 
Board [4h Js Qd]
Seat 1: matiko09 (big blind) folded before Flop
Seat 2: Dickyxxx folded before Flop (didn't bet)
Seat 3: mooose100 folded on the Flop
Seat 4: Szevasztopol folded before Flop (didn't bet)
Seat 5: stds st folded before Flop (didn't bet)
Seat 6: vanilica folded before Flop (didn't bet)
Seat 7: hurtNCYDE collected ($9.02)
Seat 8: ardo888 (button) folded before Flop (didn't bet)
Seat 9: PacPacBum (small blind) folded before Flop





PokerStars Hand #154364023765:  Hold'em No Limit (€0.50/€1.00 EUR) - 2016/06/06 13:20:47 CET [2016/06/06 7:20:47 ET]
Table 'Lesath' 9-max Seat #1 is the button
Seat 1: o.miro (€117.06 in chips) 
Seat 2: thecurv (€107.99 in chips) 
Seat 3: ozone2003 (€202.64 in chips) 
Seat 4: hammerwife (€124.61 in chips) 
Seat 5: matiko09 (€113.47 in chips) 
Seat 7: Mr.Grigoriy (€100 in chips) 
Seat 8: stds st (€51 in chips) 
Seat 9: 72nloses (€44.66 in chips) 
thecurv: posts small blind €0.50
ozone2003: posts big blind €1
*** HOLE CARDS ***
Dealt to matiko09 [Ah Jd]
hammerwife: folds 
matiko09: raises €2 to €3
Mr.Grigoriy: folds 
stds st: folds 
72nloses: folds 
o.miro: folds 
thecurv: folds 
ozone2003: folds 
Uncalled bet (€2) returned to matiko09
matiko09 collected €2.50 from pot
matiko09: doesn't show hand 
*** SUMMARY ***
Total pot €2.50 | Rake €0 
Seat 1: o.miro (button) folded before Flop (didn't bet)
Seat 2: thecurv (small blind) folded before Flop
Seat 3: ozone2003 (big blind) folded before Flop
Seat 4: hammerwife folded before Flop (didn't bet)
Seat 5: matiko09 collected (€2.50)
Seat 7: Mr.Grigoriy folded before Flop (didn't bet)
Seat 8: stds st folded before Flop (didn't bet)
Seat 9: 72nloses folded before Flop (didn't bet)





PokerStars Hand #154364024127:  Hold'em No Limit ($0.50/$1.00 USD) - 2016/06/06 13:20:48 CET [2016/06/06 7:20:48 ET]
Table 'Williams' 9-max Seat #1 is the button
Seat 1: xhinostrabli ($73.50 in chips) 
Seat 2: matiko09 ($175.01 in chips) 
Seat 3: granbunny ($69.56 in chips) 
Seat 4: Mr.Grigoriy ($107.62 in chips) 
Seat 5: xxxibgdrgn ($100 in chips) 
Seat 6: xxxZeka ($130.38 in chips) 
Seat 7: Eskimo Fox ($117.94 in chips) 
Seat 8: Dickyxxx ($101.50 in chips) 
Seat 9: stds st ($41.08 in chips) 
matiko09: posts small blind $0.50
granbunny: posts big blind $1
*** HOLE CARDS ***
Dealt to matiko09 [6s Qh]
Mr.Grigoriy: folds 
xxxibgdrgn: folds 
xxxZeka: folds 
Eskimo Fox: folds 
Dickyxxx: folds 
stds st: folds 
xhinostrabli: folds 
matiko09: folds 
Uncalled bet ($0.50) returned to granbunny
granbunny collected $1 from pot
granbunny: doesn't show hand 
*** SUMMARY ***
Total pot $1 | Rake $0 
Seat 1: xhinostrabli (button) folded before Flop (didn't bet)
Seat 2: matiko09 (small blind) folded before Flop
Seat 3: granbunny (big blind) collected ($1)
Seat 4: Mr.Grigoriy folded before Flop (didn't bet)
Seat 5: xxxibgdrgn folded before Flop (didn't bet)
Seat 6: xxxZeka folded before Flop (didn't bet)
Seat 7: Eskimo Fox folded before Flop (didn't bet)
Seat 8: Dickyxxx folded before Flop (didn't bet)
Seat 9: stds st folded before Flop (didn't bet)





PokerStars Hand #154364025961:  Hold'em No Limit ($0.50/$1.00 USD) - 2016/06/06 13:20:52 CET [2016/06/06 7:20:52 ET]
Table 'Safara' 9-max Seat #6 is the button
Seat 1: Dickyxxx ($104.12 in chips) 
Seat 2: ozone2003 ($104.08 in chips) 
Seat 3: erd33 ($162.55 in chips) 
Seat 4: xxxibgdrgn ($102.38 in chips) 
Seat 5: perezzi10 ($40.18 in chips) 
Seat 6: matiko09 ($140.28 in chips) 
Seat 7: PacPacBum ($121.53 in chips) 
Seat 8: o.miro ($110.10 in chips) 
Seat 9: R1aki ($100 in chips) 
PacPacBum: posts small blind $0.50
o.miro: posts big blind $1
*** HOLE CARDS ***
Dealt to matiko09 [Tc Qh]
R1aki: folds 
Dickyxxx: folds 
ozone2003: folds 
erd33: folds 
xxxibgdrgn: raises $2 to $3
perezzi10: folds 
matiko09: folds 
PacPacBum: folds 
o.miro: folds 
Uncalled bet ($2) returned to xxxibgdrgn
xxxibgdrgn collected $2.50 from pot
xxxibgdrgn: doesn't show hand 
*** SUMMARY ***
Total pot $2.50 | Rake $0 
Seat 1: Dickyxxx folded before Flop (didn't bet)
Seat 2: ozone2003 folded before Flop (didn't bet)
Seat 3: erd33 folded before Flop (didn't bet)
Seat 4: xxxibgdrgn collected ($2.50)
Seat 5: perezzi10 folded before Flop (didn't bet)
Seat 6: matiko09 (button) folded before Flop (didn't bet)
Seat 7: PacPacBum (small blind) folded before Flop
Seat 8: o.miro (big blind) folded before Flop
Seat 9: R1aki folded before Flop (didn't bet)





PokerStars Hand #154364028856:  Hold'em No Limit ($0.50/$1.00 USD) - 2016/06/06 13:20:59 CET [2016/06/06 7:20:59 ET]
Table 'Sheliak' 9-max Seat #6 is the button
Seat 1: 32rrew ($100 in chips) 
Seat 2: DancerNN1 ($102.62 in chips) 
Seat 3: xxxZeka ($120.80 in chips) 
Seat 6: matiko09 ($107.47 in chips) 
Seat 7: stds st ($42.82 in chips) 
Seat 8: ozone2003 ($101.50 in chips) 
stds st: posts small blind $0.50
ozone2003: posts big blind $1
iRLM: sits out 
*** HOLE CARDS ***
Dealt to matiko09 [Th 8h]
32rrew: folds 
DancerNN1: folds 
xxxZeka: folds 
matiko09: raises $1.27 to $2.27
stds st: folds 
ozone2003: calls $1.27
*** FLOP *** [7h Ah Qs]
ozone2003: checks 
matiko09: bets $3.11
ozone2003: folds 
Uncalled bet ($3.11) returned to matiko09
matiko09 collected $4.79 from pot
matiko09: doesn't show hand 
*** SUMMARY ***
Total pot $5.04 | Rake $0.25 
Board [7h Ah Qs]
Seat 1: 32rrew folded before Flop (didn't bet)
Seat 2: DancerNN1 folded before Flop (didn't bet)
Seat 3: xxxZeka folded before Flop (didn't bet)
Seat 6: matiko09 (button) collected ($4.79)
Seat 7: stds st (small blind) folded before Flop
Seat 8: ozone2003 (big blind) folded on the Flop





PokerStars Hand #154364040285:  Hold'em No Limit ($0.50/$1.00 USD) - 2016/06/06 13:21:12 CET [2016/06/06 7:21:12 ET]
Table 'Smither' 9-max Seat #8 is the button
Seat 1: PacPacBum ($168.60 in chips) 
Seat 2: matiko09 ($103 in chips) 
Seat 3: stds st ($38.50 in chips) 
Seat 6: mooose100 ($80 in chips) 
Seat 7: vanilica ($126.05 in chips) 
Seat 8: ozone2003 ($100 in chips) 
PacPacBum: posts small blind $0.50
matiko09: posts big blind $1
Dantist1122: sits out 
*** HOLE CARDS ***
Dealt to matiko09 [Ks 8c]
stds st: folds 
mooose100: folds 
vanilica: folds 
ozone2003: raises $1.20 to $2.20
PacPacBum: raises $5.20 to $7.40
matiko09: folds 
ozone2003: folds 
Uncalled bet ($5.20) returned to PacPacBum
PacPacBum collected $5.40 from pot
PacPacBum: doesn't show hand 
*** SUMMARY ***
Total pot $5.40 | Rake $0 
Seat 1: PacPacBum (small blind) collected ($5.40)
Seat 2: matiko09 (big blind) folded before Flop
Seat 3: stds st folded before Flop (didn't bet)
Seat 6: mooose100 folded before Flop (didn't bet)
Seat 7: vanilica folded before Flop (didn't bet)
Seat 8: ozone2003 (button) folded before Flop





PokerStars Hand #154364043422:  Hold'em No Limit (€0.50/€1.00 EUR) - 2016/06/06 13:21:19 CET [2016/06/06 7:21:19 ET]
Table 'Lesath' 9-max Seat #2 is the button
Seat 1: o.miro (€117.06 in chips) 
Seat 2: thecurv (€107.49 in chips) 
Seat 3: ozone2003 (€201.64 in chips) 
Seat 5: matiko09 (€114.97 in chips) 
Seat 7: Mr.Grigoriy (€100 in chips) 
Seat 8: stds st (€51 in chips) 
Seat 9: 72nloses (€44.66 in chips) 
ozone2003: posts small blind €0.50
hammerwife: is sitting out 
matiko09: posts big blind €1
*** HOLE CARDS ***
Dealt to matiko09 [8d 6h]
Mr.Grigoriy: folds 
stds st: folds 
72nloses: folds 
o.miro: raises €1.50 to €2.50
thecurv: calls €2.50
ozone2003: folds 
matiko09: folds 
*** FLOP *** [6s Jd 7s]
o.miro: checks 
thecurv: bets €4.63
o.miro: calls €4.63
*** TURN *** [6s Jd 7s] [8c]
o.miro: checks 
thecurv: bets €10
o.miro: calls €10
*** RIVER *** [6s Jd 7s 8c] [As]
o.miro: checks 
thecurv: checks 
*** SHOW DOWN ***
o.miro: shows [Js Ac] (two pair, Aces and Jacks)
thecurv: shows [Jh Ad] (two pair, Aces and Jacks)
o.miro collected €16.99 from pot
thecurv collected €16.98 from pot
*** SUMMARY ***
Total pot €35.76 | Rake €1.79 
Board [6s Jd 7s 8c As]
Seat 1: o.miro showed [Js Ac] and won (€16.99) with two pair, Aces and Jacks
Seat 2: thecurv (button) showed [Jh Ad] and won (€16.98) with two pair, Aces and Jacks
Seat 3: ozone2003 (small blind) folded before Flop
Seat 5: matiko09 (big blind) folded before Flop
Seat 7: Mr.Grigoriy folded before Flop (didn't bet)
Seat 8: stds st folded before Flop (didn't bet)
Seat 9: 72nloses folded before Flop (didn't bet)





PokerStars Hand #154364043893:  Hold'em No Limit ($0.50/$1.00 USD) - 2016/06/06 13:21:20 CET [2016/06/06 7:21:20 ET]
Table 'Safara' 9-max Seat #7 is the button
Seat 1: Dickyxxx ($104.12 in chips) 
Seat 2: ozone2003 ($104.08 in chips) 
Seat 3: erd33 ($162.55 in chips) 
Seat 4: xxxibgdrgn ($103.88 in chips) 
Seat 5: perezzi10 ($40.18 in chips) 
Seat 6: matiko09 ($140.28 in chips) 
Seat 7: PacPacBum ($121.03 in chips) 
Seat 8: o.miro ($109.10 in chips) 
Seat 9: R1aki ($100 in chips) 
o.miro: posts small blind $0.50
R1aki: posts big blind $1
*** HOLE CARDS ***
Dealt to matiko09 [4s 3h]
Dickyxxx: folds 
ozone2003: folds 
erd33: folds 
xxxibgdrgn: folds 
perezzi10: folds 
matiko09: folds 
PacPacBum: folds 
o.miro: folds 
Uncalled bet ($0.50) returned to R1aki
R1aki collected $1 from pot
R1aki: doesn't show hand 
*** SUMMARY ***
Total pot $1 | Rake $0 
Seat 1: Dickyxxx folded before Flop (didn't bet)
Seat 2: ozone2003 folded before Flop (didn't bet)
Seat 3: erd33 folded before Flop (didn't bet)
Seat 4: xxxibgdrgn folded before Flop (didn't bet)
Seat 5: perezzi10 folded before Flop (didn't bet)
Seat 6: matiko09 folded before Flop (didn't bet)
Seat 7: PacPacBum (button) folded before Flop (didn't bet)
Seat 8: o.miro (small blind) folded before Flop
Seat 9: R1aki (big blind) collected ($1)





PokerStars Hand #154364047542:  Hold'em No Limit ($0.50/$1.00 USD) - 2016/06/06 13:21:28 CET [2016/06/06 7:21:28 ET]
Table 'Gajdariya' 9-max Seat #9 is the button
Seat 1: matiko09 ($127.04 in chips) 
Seat 2: Dickyxxx ($107.52 in chips) 
Seat 3: mooose100 ($86.92 in chips) 
Seat 4: Szevasztopol ($114.27 in chips) 
Seat 5: stds st ($67.33 in chips) 
Seat 6: vanilica ($100 in chips) 
Seat 7: hurtNCYDE ($116.59 in chips) 
Seat 8: ardo888 ($135.32 in chips) 
Seat 9: PacPacBum ($111.73 in chips) 
matiko09: posts small blind $0.50
Dickyxxx: posts big blind $1
*** HOLE CARDS ***
Dealt to matiko09 [Kc 9h]
mooose100: calls $1
Szevasztopol: folds 
stds st: folds 
vanilica: folds 
hurtNCYDE: folds 
ardo888: folds 
PacPacBum: folds 
matiko09: calls $0.50
Dickyxxx: checks 
*** FLOP *** [5d Td 7h]
matiko09: checks 
Dickyxxx: checks 
mooose100: bets $2.85
matiko09: folds 
Dickyxxx: folds 
Uncalled bet ($2.85) returned to mooose100
mooose100 collected $2.85 from pot
mooose100: doesn't show hand 
*** SUMMARY ***
Total pot $3 | Rake $0.15 
Board [5d Td 7h]
Seat 1: matiko09 (small blind) folded on the Flop
Seat 2: Dickyxxx (big blind) folded on the Flop
Seat 3: mooose100 collected ($2.85)
Seat 4: Szevasztopol folded before Flop (didn't bet)
Seat 5: stds st folded before Flop (didn't bet)
Seat 6: vanilica folded before Flop (didn't bet)
Seat 7: hurtNCYDE folded before Flop (didn't bet)
Seat 8: ardo888 folded before Flop (didn't bet)
Seat 9: PacPacBum (button) folded before Flop (didn't bet)





PokerStars Hand #154364051422:  Hold'em No Limit ($0.50/$1.00 USD) - 2016/06/06 13:21:37 CET [2016/06/06 7:21:37 ET]
Table 'Williams' 9-max Seat #2 is the button
Seat 1: xhinostrabli ($73.50 in chips) 
Seat 2: matiko09 ($174.51 in chips) 
Seat 3: granbunny ($70.06 in chips) 
Seat 4: Mr.Grigoriy ($107.62 in chips) 
Seat 5: xxxibgdrgn ($100 in chips) 
Seat 6: xxxZeka ($130.38 in chips) 
Seat 7: Eskimo Fox ($117.94 in chips) 
Seat 8: Dickyxxx ($101.50 in chips) 
Seat 9: stds st ($41.08 in chips) 
granbunny: posts small blind $0.50
Mr.Grigoriy: posts big blind $1
*** HOLE CARDS ***
Dealt to matiko09 [Kd 4c]
xxxibgdrgn: folds 
xxxZeka: folds 
Eskimo Fox: folds 
Dickyxxx: folds 
stds st: raises $1.50 to $2.50
xhinostrabli: calls $2.50
matiko09: folds 
granbunny: folds 
Mr.Grigoriy: folds 
*** FLOP *** [Js 3c 7c]
stds st: bets $3.70
xhinostrabli: calls $3.70
*** TURN *** [Js 3c 7c] [5h]
stds st: checks 
xhinostrabli: bets $6.60
stds st: folds 
Uncalled bet ($6.60) returned to xhinostrabli
xhinostrabli collected $13.20 from pot
*** SUMMARY ***
Total pot $13.90 | Rake $0.70 
Board [Js 3c 7c 5h]
Seat 1: xhinostrabli collected ($13.20)
Seat 2: matiko09 (button) folded before Flop (didn't bet)
Seat 3: granbunny (small blind) folded before Flop
Seat 4: Mr.Grigoriy (big blind) folded before Flop
Seat 5: xxxibgdrgn folded before Flop (didn't bet)
Seat 6: xxxZeka folded before Flop (didn't bet)
Seat 7: Eskimo Fox folded before Flop (didn't bet)
Seat 8: Dickyxxx folded before Flop (didn't bet)
Seat 9: stds st folded on the Turn





PokerStars Hand #154364052192:  Hold'em No Limit ($0.50/$1.00 USD) - 2016/06/06 13:21:39 CET [2016/06/06 7:21:39 ET]
Table 'Heze' 9-max Seat #7 is the button
Seat 1: matiko09 ($171.67 in chips) 
Seat 2: xxxibgdrgn ($117.98 in chips) 
Seat 3: Dickyxxx ($103.18 in chips) 
Seat 5: stds st ($38 in chips) 
Seat 6: yfcq36 ($124.23 in chips) 
Seat 7: 32rrew ($158.97 in chips) 
Seat 8: PacPacBum ($115.70 in chips) 
Seat 9: Mr.Grigoriy ($130.71 in chips) 
PacPacBum: posts small blind $0.50
Mr.Grigoriy: posts big blind $1
Eskimo Fox: sits out 
*** HOLE CARDS ***
Dealt to matiko09 [7c Qd]
matiko09: folds 
xxxibgdrgn: raises $2 to $3
Dickyxxx: folds 
stds st: folds 
yfcq36: raises $4 to $7
32rrew: folds 
PacPacBum: folds 
Mr.Grigoriy: folds 
xxxibgdrgn: calls $4
*** FLOP *** [Jd 9c 9d]
xxxibgdrgn: checks 
yfcq36: checks 
*** TURN *** [Jd 9c 9d] [8s]
xxxibgdrgn: bets $10
yfcq36: calls $10
*** RIVER *** [Jd 9c 9d 8s] [Qs]
xxxibgdrgn: checks 
yfcq36: bets $23
xxxibgdrgn: folds 
Uncalled bet ($23) returned to yfcq36
yfcq36 collected $33.72 from pot
yfcq36: doesn't show hand 
*** SUMMARY ***
Total pot $35.50 | Rake $1.78 
Board [Jd 9c 9d 8s Qs]
Seat 1: matiko09 folded before Flop (didn't bet)
Seat 2: xxxibgdrgn folded on the River
Seat 3: Dickyxxx folded before Flop (didn't bet)
Seat 5: stds st folded before Flop (didn't bet)
Seat 6: yfcq36 collected ($33.72)
Seat 7: 32rrew (button) folded before Flop (didn't bet)
Seat 8: PacPacBum (small blind) folded before Flop
Seat 9: Mr.Grigoriy (big blind) folded before Flop





PokerStars Hand #154364052998:  Hold'em No Limit ($0.50/$1.00 USD) - 2016/06/06 13:21:41 CET [2016/06/06 7:21:41 ET]
Table 'Chaldaea II' 9-max Seat #7 is the button
Seat 2: Mr.Grigoriy ($100 in chips) 
Seat 3: ardo888 ($100 in chips) 
Seat 4: mooose100 ($145.03 in chips) 
Seat 5: stds st ($40 in chips) 
Seat 6: PacPacBum ($112.86 in chips) 
Seat 7: xxxibgdrgn ($102.02 in chips) 
Seat 8: 32rrew ($100 in chips) 
Seat 9: matiko09 ($101.50 in chips) 
32rrew: posts small blind $0.50
matiko09: posts big blind $1
*** HOLE CARDS ***
Dealt to matiko09 [3s 5d]
Mr.Grigoriy: folds 
ardo888: folds 
mooose100: folds 
stds st: folds 
PacPacBum: folds 
xxxibgdrgn: raises $1.50 to $2.50
32rrew: raises $6.50 to $9
matiko09: folds 
xxxibgdrgn: folds 
Uncalled bet ($6.50) returned to 32rrew
32rrew collected $6 from pot
32rrew: doesn't show hand 
*** SUMMARY ***
Total pot $6 | Rake $0 
Seat 2: Mr.Grigoriy folded before Flop (didn't bet)
Seat 3: ardo888 folded before Flop (didn't bet)
Seat 4: mooose100 folded before Flop (didn't bet)
Seat 5: stds st folded before Flop (didn't bet)
Seat 6: PacPacBum folded before Flop (didn't bet)
Seat 7: xxxibgdrgn (button) folded before Flop
Seat 8: 32rrew (small blind) collected ($6)
Seat 9: matiko09 (big blind) folded before Flop





PokerStars Hand #154364054861:  Hold'em No Limit ($0.50/$1.00 USD) - 2016/06/06 13:21:45 CET [2016/06/06 7:21:45 ET]
Table 'Safara' 9-max Seat #8 is the button
Seat 1: Dickyxxx ($104.12 in chips) 
Seat 2: ozone2003 ($104.08 in chips) 
Seat 3: erd33 ($162.55 in chips) 
Seat 4: xxxibgdrgn ($103.88 in chips) 
Seat 5: perezzi10 ($40.18 in chips) 
Seat 6: matiko09 ($140.28 in chips) 
Seat 7: PacPacBum ($121.03 in chips) 
Seat 8: o.miro ($108.60 in chips) 
Seat 9: R1aki ($100.50 in chips) 
R1aki: posts small blind $0.50
Dickyxxx: posts big blind $1
*** HOLE CARDS ***
Dealt to matiko09 [6s 7h]
ozone2003: folds 
erd33: folds 
xxxibgdrgn: folds 
perezzi10: folds 
matiko09: folds 
PacPacBum: raises $1.50 to $2.50
o.miro: folds 
R1aki: folds 
Dickyxxx: folds 
Uncalled bet ($1.50) returned to PacPacBum
PacPacBum collected $2.50 from pot
PacPacBum: doesn't show hand 
*** SUMMARY ***
Total pot $2.50 | Rake $0 
Seat 1: Dickyxxx (big blind) folded before Flop
Seat 2: ozone2003 folded before Flop (didn't bet)
Seat 3: erd33 folded before Flop (didn't bet)
Seat 4: xxxibgdrgn folded before Flop (didn't bet)
Seat 5: perezzi10 folded before Flop (didn't bet)
Seat 6: matiko09 folded before Flop (didn't bet)
Seat 7: PacPacBum collected ($2.50)
Seat 8: o.miro (button) folded before Flop (didn't bet)
Seat 9: R1aki (small blind) folded before Flop





PokerStars Hand #154364055599:  Hold'em No Limit ($0.50/$1.00 USD) - 2016/06/06 13:21:47 CET [2016/06/06 7:21:47 ET]
Table 'Sheliak' 9-max Seat #7 is the button
Seat 1: 32rrew ($100 in chips) 
Seat 2: DancerNN1 ($102.62 in chips) 
Seat 3: xxxZeka ($120.80 in chips) 
Seat 6: matiko09 ($109.99 in chips) 
Seat 7: stds st ($42.32 in chips) 
Seat 8: ozone2003 ($100 in chips) 
ozone2003: posts small blind $0.50
32rrew: posts big blind $1
iRLM: sits out 
*** HOLE CARDS ***
Dealt to matiko09 [5h Ad]
DancerNN1: folds 
xxxZeka: folds 
matiko09: folds 
stds st: raises $1.02 to $2.02
ozone2003: folds 
32rrew: folds 
Uncalled bet ($1.02) returned to stds st
stds st collected $2.50 from pot
stds st: doesn't show hand 
*** SUMMARY ***
Total pot $2.50 | Rake $0 
Seat 1: 32rrew (big blind) folded before Flop
Seat 2: DancerNN1 folded before Flop (didn't bet)
Seat 3: xxxZeka folded before Flop (didn't bet)
Seat 6: matiko09 folded before Flop (didn't bet)
Seat 7: stds st (button) collected ($2.50)
Seat 8: ozone2003 (small blind) folded before Flop





PokerStars Hand #154364056949:  Hold'em No Limit ($0.50/$1.00 USD) - 2016/06/06 13:21:50 CET [2016/06/06 7:21:50 ET]
Table 'Wezen II' 9-max Seat #7 is the button
Seat 1: matiko09 ($100 in chips) 
Seat 2: Mr.Grigoriy ($112.62 in chips) 
Seat 3: Dickyxxx ($100 in chips) 
Seat 4: xxxibgdrgn ($196 in chips) 
Seat 5: stds st ($41.33 in chips) 
Seat 6: Eskimo Fox ($101.52 in chips) 
Seat 7: KDJAll3 ($74.96 in chips) 
Seat 8: o.miro ($105.50 in chips) 
Seat 9: Cogss ($109.20 in chips) 
o.miro: posts small blind $0.50
Cogss: posts big blind $1
*** HOLE CARDS ***
Dealt to matiko09 [2d Kd]
matiko09: folds 
Mr.Grigoriy: folds 
Dickyxxx: raises $2 to $3
xxxibgdrgn: folds 
stds st: folds 
Eskimo Fox: folds 
KDJAll3: folds 
o.miro: folds 
Cogss: folds 
Uncalled bet ($2) returned to Dickyxxx
Dickyxxx collected $2.50 from pot
Dickyxxx: doesn't show hand 
*** SUMMARY ***
Total pot $2.50 | Rake $0 
Seat 1: matiko09 folded before Flop (didn't bet)
Seat 2: Mr.Grigoriy folded before Flop (didn't bet)
Seat 3: Dickyxxx collected ($2.50)
Seat 4: xxxibgdrgn folded before Flop (didn't bet)
Seat 5: stds st folded before Flop (didn't bet)
Seat 6: Eskimo Fox folded before Flop (didn't bet)
Seat 7: KDJAll3 (button) folded before Flop (didn't bet)
Seat 8: o.miro (small blind) folded before Flop
Seat 9: Cogss (big blind) folded before Flop





PokerStars Hand #154364063300:  Hold'em No Limit ($0.50/$1.00 USD) - 2016/06/06 13:22:05 CET [2016/06/06 7:22:05 ET]
Table 'Smither' 9-max Seat #1 is the button
Seat 1: PacPacBum ($171.80 in chips) 
Seat 2: matiko09 ($102 in chips) 
Seat 3: stds st ($38.50 in chips) 
Seat 6: mooose100 ($80 in chips) 
Seat 7: vanilica ($126.05 in chips) 
Seat 8: ozone2003 ($100 in chips) 
matiko09: posts small blind $0.50
stds st: posts big blind $1
Dantist1122: sits out 
*** HOLE CARDS ***
Dealt to matiko09 [6d Jc]
mooose100: folds 
vanilica: folds 
ozone2003: folds 
PacPacBum: raises $1.04 to $2.04
matiko09: folds 
stds st: folds 
Uncalled bet ($1.04) returned to PacPacBum
PacPacBum collected $2.50 from pot
PacPacBum: doesn't show hand 
*** SUMMARY ***
Total pot $2.50 | Rake $0 
Seat 1: PacPacBum (button) collected ($2.50)
Seat 2: matiko09 (small blind) folded before Flop
Seat 3: stds st (big blind) folded before Flop
Seat 6: mooose100 folded before Flop (didn't bet)
Seat 7: vanilica folded before Flop (didn't bet)
Seat 8: ozone2003 folded before Flop (didn't bet)





PokerStars Hand #154364067630:  Hold'em No Limit ($0.50/$1.00 USD) - 2016/06/06 13:22:15 CET [2016/06/06 7:22:15 ET]
Table 'Safara' 9-max Seat #9 is the button
Seat 1: Dickyxxx ($103.12 in chips) 
Seat 2: ozone2003 ($104.08 in chips) 
Seat 3: erd33 ($162.55 in chips) 
Seat 4: xxxibgdrgn ($103.88 in chips) 
Seat 5: perezzi10 ($40.18 in chips) 
Seat 6: matiko09 ($140.28 in chips) 
Seat 7: PacPacBum ($122.53 in chips) 
Seat 8: o.miro ($108.60 in chips) 
Seat 9: R1aki ($100 in chips) 
Dickyxxx: posts small blind $0.50
ozone2003: posts big blind $1
*** HOLE CARDS ***
Dealt to matiko09 [7s Ks]
erd33: folds 
xxxibgdrgn: folds 
perezzi10: folds 
matiko09: folds 
PacPacBum: folds 
o.miro: raises $1.50 to $2.50
R1aki: folds 
Dickyxxx: calls $2
ozone2003: raises $7.50 to $10
o.miro: calls $7.50
Dickyxxx: calls $7.50
*** FLOP *** [Kh Tc Ts]
Dickyxxx: checks 
ozone2003: checks 
o.miro: checks 
*** TURN *** [Kh Tc Ts] [Jc]
Dickyxxx: checks 
ozone2003: bets $14.25
o.miro: calls $14.25
Dickyxxx: folds 
*** RIVER *** [Kh Tc Ts Jc] [Th]
ozone2003: bets $9.88
o.miro: raises $29.62 to $39.50
ozone2003: folds 
Uncalled bet ($29.62) returned to o.miro
o.miro collected $75.76 from pot
o.miro: doesn't show hand 
*** SUMMARY ***
Total pot $78.26 | Rake $2.50 
Board [Kh Tc Ts Jc Th]
Seat 1: Dickyxxx (small blind) folded on the Turn
Seat 2: ozone2003 (big blind) folded on the River
Seat 3: erd33 folded before Flop (didn't bet)
Seat 4: xxxibgdrgn folded before Flop (didn't bet)
Seat 5: perezzi10 folded before Flop (didn't bet)
Seat 6: matiko09 folded before Flop (didn't bet)
Seat 7: PacPacBum folded before Flop (didn't bet)
Seat 8: o.miro collected ($75.76)
Seat 9: R1aki (button) folded before Flop (didn't bet)





PokerStars Hand #154364070072:  Hold'em No Limit ($0.50/$1.00 USD) - 2016/06/06 13:22:21 CET [2016/06/06 7:22:21 ET]
Table 'Gajdariya' 9-max Seat #1 is the button
Seat 1: matiko09 ($126.04 in chips) 
Seat 2: Dickyxxx ($106.52 in chips) 
Seat 3: mooose100 ($88.77 in chips) 
Seat 4: Szevasztopol ($114.27 in chips) 
Seat 5: stds st ($67.33 in chips) 
Seat 6: vanilica ($100 in chips) 
Seat 7: hurtNCYDE ($116.59 in chips) 
Seat 8: ardo888 ($135.32 in chips) 
Seat 9: PacPacBum ($111.73 in chips) 
Dickyxxx: posts small blind $0.50
mooose100: posts big blind $1
*** HOLE CARDS ***
Dealt to matiko09 [7c 4h]
Szevasztopol: folds 
stds st: folds 
vanilica: folds 
hurtNCYDE: folds 
ardo888: folds 
PacPacBum: folds 
matiko09: folds 
Dickyxxx: raises $2 to $3
mooose100: folds 
Uncalled bet ($2) returned to Dickyxxx
Dickyxxx collected $2 from pot
Dickyxxx: doesn't show hand 
*** SUMMARY ***
Total pot $2 | Rake $0 
Seat 1: matiko09 (button) folded before Flop (didn't bet)
Seat 2: Dickyxxx (small blind) collected ($2)
Seat 3: mooose100 (big blind) folded before Flop
Seat 4: Szevasztopol folded before Flop (didn't bet)
Seat 5: stds st folded before Flop (didn't bet)
Seat 6: vanilica folded before Flop (didn't bet)
Seat 7: hurtNCYDE folded before Flop (didn't bet)
Seat 8: ardo888 folded before Flop (didn't bet)
Seat 9: PacPacBum folded before Flop (didn't bet)





PokerStars Hand #154364072389:  Hold'em No Limit ($0.50/$1.00 USD) - 2016/06/06 13:22:26 CET [2016/06/06 7:22:26 ET]
Table 'Sheliak' 9-max Seat #8 is the button
Seat 1: 32rrew ($100 in chips) 
Seat 2: DancerNN1 ($102.62 in chips) 
Seat 3: xxxZeka ($120.80 in chips) 
Seat 6: matiko09 ($109.99 in chips) 
Seat 7: stds st ($43.82 in chips) 
Seat 8: ozone2003 ($100 in chips) 
32rrew: posts small blind $0.50
DancerNN1: posts big blind $1
iRLM: sits out 
*** HOLE CARDS ***
Dealt to matiko09 [5d 7c]
xxxZeka: folds 
matiko09: folds 
stds st: folds 
ozone2003: folds 
32rrew: raises $2 to $3
DancerNN1: folds 
Uncalled bet ($2) returned to 32rrew
32rrew collected $2 from pot
32rrew: doesn't show hand 
*** SUMMARY ***
Total pot $2 | Rake $0 
Seat 1: 32rrew (small blind) collected ($2)
Seat 2: DancerNN1 (big blind) folded before Flop
Seat 3: xxxZeka folded before Flop (didn't bet)
Seat 6: matiko09 folded before Flop (didn't bet)
Seat 7: stds st folded before Flop (didn't bet)
Seat 8: ozone2003 (button) folded before Flop (didn't bet)





PokerStars Hand #154364074243:  Hold'em No Limit ($0.50/$1.00 USD) - 2016/06/06 13:22:30 CET [2016/06/06 7:22:30 ET]
Table 'Chaldaea II' 9-max Seat #8 is the button
Seat 2: Mr.Grigoriy ($100 in chips) 
Seat 3: ardo888 ($100 in chips) 
Seat 4: mooose100 ($145.03 in chips) 
Seat 5: stds st ($40 in chips) 
Seat 6: PacPacBum ($112.86 in chips) 
Seat 7: xxxibgdrgn ($100 in chips) 
Seat 8: 32rrew ($103.50 in chips) 
Seat 9: matiko09 ($100.50 in chips) 
matiko09: posts small blind $0.50
Mr.Grigoriy: posts big blind $1
*** HOLE CARDS ***
Dealt to matiko09 [7d 3c]
ardo888: folds 
mooose100 has timed out
mooose100: folds 
stds st: folds 
PacPacBum: folds 
xxxibgdrgn: folds 
32rrew: raises $1.50 to $2.50
matiko09: folds 
Mr.Grigoriy: raises $6 to $8.50
32rrew: folds 
Uncalled bet ($6) returned to Mr.Grigoriy
Mr.Grigoriy collected $5.50 from pot
Mr.Grigoriy: doesn't show hand 
*** SUMMARY ***
Total pot $5.50 | Rake $0 
Seat 2: Mr.Grigoriy (big blind) collected ($5.50)
Seat 3: ardo888 folded before Flop (didn't bet)
Seat 4: mooose100 folded before Flop (didn't bet)
Seat 5: stds st folded before Flop (didn't bet)
Seat 6: PacPacBum folded before Flop (didn't bet)
Seat 7: xxxibgdrgn folded before Flop (didn't bet)
Seat 8: 32rrew (button) folded before Flop
Seat 9: matiko09 (small blind) folded before Flop





PokerStars Hand #154364079960:  Hold'em No Limit ($0.50/$1.00 USD) - 2016/06/06 13:22:44 CET [2016/06/06 7:22:44 ET]
Table 'Smither' 9-max Seat #2 is the button
Seat 1: PacPacBum ($173.30 in chips) 
Seat 2: matiko09 ($101.50 in chips) 
Seat 3: stds st ($37.50 in chips) 
Seat 4: Dantist1122 ($100 in chips) 
Seat 6: mooose100 ($80 in chips) 
Seat 7: vanilica ($126.05 in chips) 
Seat 8: ozone2003 ($100 in chips) 
stds st: posts small blind $0.50
Dantist1122: posts big blind $1
*** HOLE CARDS ***
Dealt to matiko09 [8h 5h]
mooose100: folds 
vanilica: folds 
ozone2003: folds 
PacPacBum: raises $1.50 to $2.50
matiko09: folds 
stds st: folds 
Dantist1122: folds 
Uncalled bet ($1.50) returned to PacPacBum
PacPacBum collected $2.50 from pot
PacPacBum: doesn't show hand 
*** SUMMARY ***
Total pot $2.50 | Rake $0 
Seat 1: PacPacBum collected ($2.50)
Seat 2: matiko09 (button) folded before Flop (didn't bet)
Seat 3: stds st (small blind) folded before Flop
Seat 4: Dantist1122 (big blind) folded before Flop
Seat 6: mooose100 folded before Flop (didn't bet)
Seat 7: vanilica folded before Flop (didn't bet)
Seat 8: ozone2003 folded before Flop (didn't bet)





PokerStars Hand #154364083951:  Hold'em No Limit ($0.50/$1.00 USD) - 2016/06/06 13:22:53 CET [2016/06/06 7:22:53 ET]
Table 'Wezen II' 9-max Seat #8 is the button
Seat 1: matiko09 ($100 in chips) 
Seat 2: Mr.Grigoriy ($112.62 in chips) 
Seat 3: Dickyxxx ($101.50 in chips) 
Seat 4: xxxibgdrgn ($196 in chips) 
Seat 5: stds st ($41.33 in chips) 
Seat 6: Eskimo Fox ($101.52 in chips) 
Seat 7: KDJAll3 ($74.96 in chips) 
Seat 8: o.miro ($105 in chips) 
Seat 9: Cogss ($108.20 in chips) 
Cogss: posts small blind $0.50
matiko09: posts big blind $1
*** HOLE CARDS ***
Dealt to matiko09 [Ac 7d]
Mr.Grigoriy: folds 
Dickyxxx: folds 
xxxibgdrgn: raises $2 to $3
stds st: folds 
Eskimo Fox: folds 
KDJAll3: folds 
o.miro: folds 
Cogss: folds 
matiko09: folds 
Uncalled bet ($2) returned to xxxibgdrgn
xxxibgdrgn collected $2.50 from pot
xxxibgdrgn: doesn't show hand 
*** SUMMARY ***
Total pot $2.50 | Rake $0 
Seat 1: matiko09 (big blind) folded before Flop
Seat 2: Mr.Grigoriy folded before Flop (didn't bet)
Seat 3: Dickyxxx folded before Flop (didn't bet)
Seat 4: xxxibgdrgn collected ($2.50)
Seat 5: stds st folded before Flop (didn't bet)
Seat 6: Eskimo Fox folded before Flop (didn't bet)
Seat 7: KDJAll3 folded before Flop (didn't bet)
Seat 8: o.miro (button) folded before Flop (didn't bet)
Seat 9: Cogss (small blind) folded before Flop





PokerStars Hand #154364085804:  Hold'em No Limit ($0.50/$1.00 USD) - 2016/06/06 13:22:57 CET [2016/06/06 7:22:57 ET]
Table 'Sheliak' 9-max Seat #1 is the button
Seat 1: 32rrew ($101 in chips) 
Seat 2: DancerNN1 ($101.62 in chips) 
Seat 3: xxxZeka ($120.80 in chips) 
Seat 6: matiko09 ($109.99 in chips) 
Seat 7: stds st ($43.82 in chips) 
Seat 8: ozone2003 ($100 in chips) 
DancerNN1: posts small blind $0.50
xxxZeka: posts big blind $1
iRLM: sits out 
*** HOLE CARDS ***
Dealt to matiko09 [Js Ks]
matiko09: raises $2 to $3
stds st: folds 
ozone2003: folds 
32rrew: folds 
DancerNN1: folds 
xxxZeka: folds 
Uncalled bet ($2) returned to matiko09
matiko09 collected $2.50 from pot
matiko09: doesn't show hand 
*** SUMMARY ***
Total pot $2.50 | Rake $0 
Seat 1: 32rrew (button) folded before Flop (didn't bet)
Seat 2: DancerNN1 (small blind) folded before Flop
Seat 3: xxxZeka (big blind) folded before Flop
Seat 6: matiko09 collected ($2.50)
Seat 7: stds st folded before Flop (didn't bet)
Seat 8: ozone2003 folded before Flop (didn't bet)





PokerStars Hand #154364086016:  Hold'em No Limit ($0.50/$1.00 USD) - 2016/06/06 13:22:57 CET [2016/06/06 7:22:57 ET]
Table 'Williams' 9-max Seat #3 is the button
Seat 1: xhinostrabli ($80.50 in chips) 
Seat 2: matiko09 ($174.51 in chips) 
Seat 3: granbunny ($69.56 in chips) 
Seat 4: Mr.Grigoriy ($106.62 in chips) 
Seat 5: xxxibgdrgn ($100 in chips) 
Seat 6: xxxZeka ($130.38 in chips) 
Seat 7: Eskimo Fox ($117.94 in chips) 
Seat 8: Dickyxxx ($101.50 in chips) 
Seat 9: stds st ($34.88 in chips) 
Mr.Grigoriy: posts small blind $0.50
xxxibgdrgn: posts big blind $1
*** HOLE CARDS ***
Dealt to matiko09 [3d Td]
xxxZeka: folds 
Eskimo Fox: folds 
Dickyxxx: raises $2 to $3
stds st: raises $4.50 to $7.50
xhinostrabli: folds 
matiko09: folds 
granbunny: folds 
Mr.Grigoriy: folds 
xxxibgdrgn: folds 
Dickyxxx: raises $94 to $101.50 and is all-in
stds st: calls $27.38 and is all-in
Uncalled bet ($66.62) returned to Dickyxxx
*** FIRST FLOP *** [8d 5c Qs]
*** FIRST TURN *** [8d 5c Qs] [3h]
*** FIRST RIVER *** [8d 5c Qs 3h] [Tc]
*** SECOND FLOP *** [Jd 2d Js]
*** SECOND TURN *** [Jd 2d Js] [4s]
*** SECOND RIVER *** [Jd 2d Js 4s] [4d]
*** FIRST SHOW DOWN ***
Dickyxxx: shows [6d 6s] (a pair of Sixes)
stds st: shows [Ac Ah] (a pair of Aces)
stds st collected $34.38 from pot
*** SECOND SHOW DOWN ***
Dickyxxx: shows [6d 6s] (two pair, Jacks and Sixes)
stds st: shows [Ac Ah] (two pair, Aces and Jacks)
stds st collected $34.38 from pot
*** SUMMARY ***
Total pot $71.26 | Rake $2.50 
Hand was run twice
FIRST Board [8d 5c Qs 3h Tc]
SECOND Board [Jd 2d Js 4s 4d]
Seat 1: xhinostrabli folded before Flop (didn't bet)
Seat 2: matiko09 folded before Flop (didn't bet)
Seat 3: granbunny (button) folded before Flop (didn't bet)
Seat 4: Mr.Grigoriy (small blind) folded before Flop
Seat 5: xxxibgdrgn (big blind) folded before Flop
Seat 6: xxxZeka folded before Flop (didn't bet)
Seat 7: Eskimo Fox folded before Flop (didn't bet)
Seat 8: Dickyxxx showed [6d 6s] and lost with a pair of Sixes, and lost with two pair, Jacks and Sixes
Seat 9: stds st showed [Ac Ah] and won ($34.38) with a pair of Aces, and won ($34.38) with two pair, Aces and Jacks





PokerStars Hand #154364085848:  Hold'em No Limit (€0.50/€1.00 EUR) - 2016/06/06 13:22:57 CET [2016/06/06 7:22:57 ET]
Table 'Lesath' 9-max Seat #3 is the button
Seat 1: o.miro (€116.92 in chips) 
Seat 2: thecurv (€107.34 in chips) 
Seat 3: ozone2003 (€201.14 in chips) 
Seat 5: matiko09 (€113.97 in chips) 
Seat 7: Mr.Grigoriy (€100 in chips) 
Seat 8: stds st (€51 in chips) 
Seat 9: 72nloses (€44.66 in chips) 
matiko09: posts small blind €0.50
Mr.Grigoriy: posts big blind €1
*** HOLE CARDS ***
Dealt to matiko09 [6d Tc]
stds st: folds 
72nloses: raises €2 to €3
o.miro: folds 
thecurv: folds 
ozone2003: folds 
matiko09: folds 
Mr.Grigoriy: folds 
Uncalled bet (€2) returned to 72nloses
72nloses collected €2.50 from pot
*** SUMMARY ***
Total pot €2.50 | Rake €0 
Seat 1: o.miro folded before Flop (didn't bet)
Seat 2: thecurv folded before Flop (didn't bet)
Seat 3: ozone2003 (button) folded before Flop (didn't bet)
Seat 5: matiko09 (small blind) folded before Flop
Seat 7: Mr.Grigoriy (big blind) folded before Flop
Seat 8: stds st folded before Flop (didn't bet)
Seat 9: 72nloses collected (€2.50)





PokerStars Hand #154364086766:  Hold'em No Limit ($0.50/$1.00 USD) - 2016/06/06 13:22:59 CET [2016/06/06 7:22:59 ET]
Table 'Gajdariya' 9-max Seat #2 is the button
Seat 1: matiko09 ($126.04 in chips) 
Seat 2: Dickyxxx ($107.52 in chips) 
Seat 3: mooose100 ($87.77 in chips) 
Seat 5: stds st ($67.33 in chips) 
Seat 6: vanilica ($100 in chips) 
Seat 7: hurtNCYDE ($116.59 in chips) 
Seat 8: ardo888 ($135.32 in chips) 
Seat 9: PacPacBum ($111.73 in chips) 
mooose100: posts small blind $0.50
stds st: posts big blind $1
*** HOLE CARDS ***
Dealt to matiko09 [8c 6h]
vanilica: folds 
hurtNCYDE: raises $1.50 to $2.50
ardo888: folds 
PacPacBum: folds 
matiko09: folds 
Dickyxxx: folds 
mooose100: folds 
stds st: folds 
Uncalled bet ($1.50) returned to hurtNCYDE
hurtNCYDE collected $2.50 from pot
*** SUMMARY ***
Total pot $2.50 | Rake $0 
Seat 1: matiko09 folded before Flop (didn't bet)
Seat 2: Dickyxxx (button) folded before Flop (didn't bet)
Seat 3: mooose100 (small blind) folded before Flop
Seat 5: stds st (big blind) folded before Flop
Seat 6: vanilica folded before Flop (didn't bet)
Seat 7: hurtNCYDE collected ($2.50)
Seat 8: ardo888 folded before Flop (didn't bet)
Seat 9: PacPacBum folded before Flop (didn't bet)





PokerStars Hand #154364088730:  Hold'em No Limit ($0.50/$1.00 USD) - 2016/06/06 13:23:04 CET [2016/06/06 7:23:04 ET]
Table 'Smither' 9-max Seat #3 is the button
Seat 1: PacPacBum ($174.80 in chips) 
Seat 2: matiko09 ($101.50 in chips) 
Seat 3: stds st ($37 in chips) 
Seat 4: Dantist1122 ($100 in chips) 
Seat 6: mooose100 ($80 in chips) 
Seat 7: vanilica ($126.05 in chips) 
Seat 8: ozone2003 ($100 in chips) 
Dantist1122: posts small blind $0.50
mooose100: posts big blind $1
*** HOLE CARDS ***
Dealt to matiko09 [2h 8s]
vanilica: folds 
ozone2003: folds 
PacPacBum: folds 
matiko09: folds 
stds st: folds 
Dantist1122: raises $2 to $3
mooose100: calls $2
*** FLOP *** [Kd Tc Td]
Dantist1122: bets $3.13
mooose100: calls $3.13
*** TURN *** [Kd Tc Td] [8d]
Dantist1122: checks 
mooose100: bets $5.82
Dantist1122: folds 
Uncalled bet ($5.82) returned to mooose100
mooose100 collected $11.65 from pot
mooose100: doesn't show hand 
*** SUMMARY ***
Total pot $12.26 | Rake $0.61 
Board [Kd Tc Td 8d]
Seat 1: PacPacBum folded before Flop (didn't bet)
Seat 2: matiko09 folded before Flop (didn't bet)
Seat 3: stds st (button) folded before Flop (didn't bet)
Seat 4: Dantist1122 (small blind) folded on the Turn
Seat 6: mooose100 (big blind) collected ($11.65)
Seat 7: vanilica folded before Flop (didn't bet)
Seat 8: ozone2003 folded before Flop (didn't bet)





PokerStars Hand #154364092892:  Hold'em No Limit ($0.50/$1.00 USD) - 2016/06/06 13:23:13 CET [2016/06/06 7:23:13 ET]
Table 'Heze' 9-max Seat #8 is the button
Seat 1: matiko09 ($171.67 in chips) 
Seat 2: xxxibgdrgn ($100.98 in chips) 
Seat 3: Dickyxxx ($103.18 in chips) 
Seat 5: stds st ($38 in chips) 
Seat 6: yfcq36 ($140.95 in chips) 
Seat 7: 32rrew ($158.97 in chips) 
Seat 8: PacPacBum ($115.20 in chips) 
Seat 9: Mr.Grigoriy ($129.71 in chips) 
Mr.Grigoriy: posts small blind $0.50
matiko09: posts big blind $1
Eskimo Fox: sits out 
*** HOLE CARDS ***
Dealt to matiko09 [5s Jh]
xxxibgdrgn: folds 
Dickyxxx: folds 
stds st: folds 
yfcq36: folds 
32rrew has timed out
32rrew: folds 
PacPacBum: folds 
Mr.Grigoriy: raises $1.50 to $2.50
matiko09: folds 
Uncalled bet ($1.50) returned to Mr.Grigoriy
Mr.Grigoriy collected $2 from pot
Mr.Grigoriy: doesn't show hand 
*** SUMMARY ***
Total pot $2 | Rake $0 
Seat 1: matiko09 (big blind) folded before Flop
Seat 2: xxxibgdrgn folded before Flop (didn't bet)
Seat 3: Dickyxxx folded before Flop (didn't bet)
Seat 5: stds st folded before Flop (didn't bet)
Seat 6: yfcq36 folded before Flop (didn't bet)
Seat 7: 32rrew folded before Flop (didn't bet)
Seat 8: PacPacBum (button) folded before Flop (didn't bet)
Seat 9: Mr.Grigoriy (small blind) collected ($2)





PokerStars Hand #154364096605:  Hold'em No Limit ($0.50/$1.00 USD) - 2016/06/06 13:23:22 CET [2016/06/06 7:23:22 ET]
Table 'Wezen II' 9-max Seat #9 is the button
Seat 1: matiko09 ($100 in chips) 
Seat 2: Mr.Grigoriy ($112.62 in chips) 
Seat 3: Dickyxxx ($101.50 in chips) 
Seat 4: xxxibgdrgn ($197.50 in chips) 
Seat 5: stds st ($41.33 in chips) 
Seat 6: Eskimo Fox ($101.52 in chips) 
Seat 7: KDJAll3 ($74.96 in chips) 
Seat 8: o.miro ($105 in chips) 
Seat 9: Cogss ($107.70 in chips) 
matiko09: posts small blind $0.50
Mr.Grigoriy: posts big blind $1
*** HOLE CARDS ***
Dealt to matiko09 [5d Qs]
Dickyxxx: folds 
xxxibgdrgn: folds 
stds st: folds 
Eskimo Fox: raises $2 to $3
KDJAll3: calls $3
o.miro: folds 
Cogss: folds 
matiko09: folds 
Mr.Grigoriy: folds 
*** FLOP *** [Js 7c 2h]
Eskimo Fox: checks 
KDJAll3: checks 
*** TURN *** [Js 7c 2h] [7h]
Eskimo Fox: checks 
KDJAll3: checks 
*** RIVER *** [Js 7c 2h 7h] [Th]
Eskimo Fox: checks 
KDJAll3: bets $5
Eskimo Fox: folds 
Uncalled bet ($5) returned to KDJAll3
KDJAll3 collected $7.12 from pot
KDJAll3: doesn't show hand 
*** SUMMARY ***
Total pot $7.50 | Rake $0.38 
Board [Js 7c 2h 7h Th]
Seat 1: matiko09 (small blind) folded before Flop
Seat 2: Mr.Grigoriy (big blind) folded before Flop
Seat 3: Dickyxxx folded before Flop (didn't bet)
Seat 4: xxxibgdrgn folded before Flop (didn't bet)
Seat 5: stds st folded before Flop (didn't bet)
Seat 6: Eskimo Fox folded on the River
Seat 7: KDJAll3 collected ($7.12)
Seat 8: o.miro folded before Flop (didn't bet)
Seat 9: Cogss (button) folded before Flop (didn't bet)





PokerStars Hand #154364098956:  Hold'em No Limit ($0.50/$1.00 USD) - 2016/06/06 13:23:27 CET [2016/06/06 7:23:27 ET]
Table 'Sheliak' 9-max Seat #2 is the button
Seat 1: 32rrew ($101 in chips) 
Seat 2: DancerNN1 ($101.12 in chips) 
Seat 3: xxxZeka ($119.80 in chips) 
Seat 4: iRLM ($72.25 in chips) 
Seat 6: matiko09 ($111.49 in chips) 
Seat 7: stds st ($43.82 in chips) 
Seat 8: ozone2003 ($100 in chips) 
xxxZeka: posts small blind $0.50
iRLM: posts big blind $1
*** HOLE CARDS ***
Dealt to matiko09 [Jd 4c]
matiko09: folds 
stds st: folds 
ozone2003: folds 
32rrew: raises $2 to $3
DancerNN1: folds 
xxxZeka: folds 
iRLM: folds 
Uncalled bet ($2) returned to 32rrew
32rrew collected $2.50 from pot
32rrew: doesn't show hand 
*** SUMMARY ***
Total pot $2.50 | Rake $0 
Seat 1: 32rrew collected ($2.50)
Seat 2: DancerNN1 (button) folded before Flop (didn't bet)
Seat 3: xxxZeka (small blind) folded before Flop
Seat 4: iRLM (big blind) folded before Flop
Seat 6: matiko09 folded before Flop (didn't bet)
Seat 7: stds st folded before Flop (didn't bet)
Seat 8: ozone2003 folded before Flop (didn't bet)





PokerStars Hand #154364102124:  Hold'em No Limit (€0.50/€1.00 EUR) - 2016/06/06 13:23:34 CET [2016/06/06 7:23:34 ET]
Table 'Lesath' 9-max Seat #5 is the button
Seat 1: o.miro (€116.92 in chips) 
Seat 2: thecurv (€107.34 in chips) 
Seat 3: ozone2003 (€201.14 in chips) 
Seat 5: matiko09 (€113.47 in chips) 
Seat 7: Mr.Grigoriy (€100 in chips) 
Seat 8: stds st (€51 in chips) 
Seat 9: 72nloses (€46.16 in chips) 
Mr.Grigoriy: posts small blind €0.50
stds st: posts big blind €1
*** HOLE CARDS ***
Dealt to matiko09 [Js 2c]
72nloses: folds 
o.miro: folds 
thecurv: raises €1.50 to €2.50
ozone2003: folds 
matiko09: folds 
Mr.Grigoriy: folds 
stds st: folds 
Uncalled bet (€1.50) returned to thecurv
thecurv collected €2.50 from pot
thecurv: doesn't show hand 
*** SUMMARY ***
Total pot €2.50 | Rake €0 
Seat 1: o.miro folded before Flop (didn't bet)
Seat 2: thecurv collected (€2.50)
Seat 3: ozone2003 folded before Flop (didn't bet)
Seat 5: matiko09 (button) folded before Flop (didn't bet)
Seat 7: Mr.Grigoriy (small blind) folded before Flop
Seat 8: stds st (big blind) folded before Flop
Seat 9: 72nloses folded before Flop (didn't bet)





PokerStars Hand #154364107491:  Hold'em No Limit ($0.50/$1.00 USD) - 2016/06/06 13:23:47 CET [2016/06/06 7:23:47 ET]
Table 'Chaldaea II' 9-max Seat #9 is the button
Seat 2: Mr.Grigoriy ($103 in chips) 
Seat 4: mooose100 ($145.03 in chips) 
Seat 5: stds st ($40 in chips) 
Seat 6: PacPacBum ($112.86 in chips) 
Seat 7: xxxibgdrgn ($100 in chips) 
Seat 8: 32rrew ($101 in chips) 
Seat 9: matiko09 ($100 in chips) 
Mr.Grigoriy: posts small blind $0.50
ardo888: is sitting out 
ardo888 leaves the table
mooose100: posts big blind $1
*** HOLE CARDS ***
Dealt to matiko09 [6h 6s]
hammerwife joins the table at seat #3 
stds st: folds 
PacPacBum: folds 
xxxibgdrgn: raises $2 to $3
32rrew: folds 
matiko09: calls $3
Mr.Grigoriy: folds 
mooose100: calls $2
*** FLOP *** [Ah 8c 8s]
mooose100: checks 
Szevasztopol leaves the table
ozone2003 joins the table at seat #1 
xxxibgdrgn: bets $6
matiko09: folds 
mooose100: folds 
Uncalled bet ($6) returned to xxxibgdrgn
xxxibgdrgn collected $9.02 from pot
xxxibgdrgn: doesn't show hand 
*** SUMMARY ***
Total pot $9.50 | Rake $0.48 
Board [Ah 8c 8s]
Seat 2: Mr.Grigoriy (small blind) folded before Flop
Seat 4: mooose100 (big blind) folded on the Flop
Seat 5: stds st folded before Flop (didn't bet)
Seat 6: PacPacBum folded before Flop (didn't bet)
Seat 7: xxxibgdrgn collected ($9.02)
Seat 8: 32rrew folded before Flop (didn't bet)
Seat 9: matiko09 (button) folded on the Flop





PokerStars Hand #154364111010:  Hold'em No Limit ($0.50/$1.00 USD) - 2016/06/06 13:23:55 CET [2016/06/06 7:23:55 ET]
Table 'Gajdariya' 9-max Seat #3 is the button
Seat 1: matiko09 ($126.04 in chips) 
Seat 2: Dickyxxx ($107.52 in chips) 
Seat 3: mooose100 ($87.27 in chips) 
Seat 5: stds st ($66.33 in chips) 
Seat 6: vanilica ($100 in chips) 
Seat 7: hurtNCYDE ($118.09 in chips) 
Seat 8: ardo888 ($135.32 in chips) 
Seat 9: PacPacBum ($111.73 in chips) 
stds st: posts small blind $0.50
vanilica: posts big blind $1
*** HOLE CARDS ***
Dealt to matiko09 [Jd Td]
hurtNCYDE: folds 
ardo888: folds 
PacPacBum: folds 
matiko09: raises $2 to $3
Dickyxxx: folds 
mooose100: folds 
stds st: raises $6 to $9
vanilica: folds 
matiko09: calls $6
*** FLOP *** [Qd 9s 8s]
stds st: checks 
Szevasztopol leaves the table
ozone2003 joins the table at seat #4 
matiko09: bets $9.38
stds st: folds 
Uncalled bet ($9.38) returned to matiko09
matiko09 collected $18.05 from pot
matiko09: doesn't show hand 
*** SUMMARY ***
Total pot $19 | Rake $0.95 
Board [Qd 9s 8s]
Seat 1: matiko09 collected ($18.05)
Seat 2: Dickyxxx folded before Flop (didn't bet)
Seat 3: mooose100 (button) folded before Flop (didn't bet)
Seat 5: stds st (small blind) folded on the Flop
Seat 6: vanilica (big blind) folded before Flop
Seat 7: hurtNCYDE folded before Flop (didn't bet)
Seat 8: ardo888 folded before Flop (didn't bet)
Seat 9: PacPacBum folded before Flop (didn't bet)





PokerStars Hand #154364117189:  Hold'em No Limit ($0.50/$1.00 USD) - 2016/06/06 13:24:09 CET [2016/06/06 7:24:09 ET]
Table 'Williams' 9-max Seat #4 is the button
Seat 1: xhinostrabli ($80.50 in chips) 
Seat 2: matiko09 ($174.51 in chips) 
Seat 3: granbunny ($69.56 in chips) 
Seat 4: Mr.Grigoriy ($106.12 in chips) 
Seat 5: xxxibgdrgn ($100 in chips) 
Seat 6: xxxZeka ($130.38 in chips) 
Seat 7: Eskimo Fox ($117.94 in chips) 
Seat 8: Dickyxxx ($100 in chips) 
Seat 9: stds st ($68.76 in chips) 
xxxibgdrgn: posts small blind $0.50
xxxZeka: posts big blind $1
*** HOLE CARDS ***
Dealt to matiko09 [7c 4c]
Eskimo Fox: folds 
Dickyxxx: raises $2 to $3
stds st: folds 
xhinostrabli: folds 
matiko09: folds 
granbunny: folds 
Mr.Grigoriy: folds 
xxxibgdrgn: folds 
xxxZeka: folds 
Uncalled bet ($2) returned to Dickyxxx
Dickyxxx collected $2.50 from pot
Dickyxxx: doesn't show hand 
*** SUMMARY ***
Total pot $2.50 | Rake $0 
Seat 1: xhinostrabli folded before Flop (didn't bet)
Seat 2: matiko09 folded before Flop (didn't bet)
Seat 3: granbunny folded before Flop (didn't bet)
Seat 4: Mr.Grigoriy (button) folded before Flop (didn't bet)
Seat 5: xxxibgdrgn (small blind) folded before Flop
Seat 6: xxxZeka (big blind) folded before Flop
Seat 7: Eskimo Fox folded before Flop (didn't bet)
Seat 8: Dickyxxx collected ($2.50)
Seat 9: stds st folded before Flop (didn't bet)





PokerStars Hand #154364118934:  Hold'em No Limit ($0.50/$1.00 USD) - 2016/06/06 13:24:13 CET [2016/06/06 7:24:13 ET]
Table 'Heze' 9-max Seat #9 is the button
Seat 1: matiko09 ($170.67 in chips) 
Seat 2: xxxibgdrgn ($100.98 in chips) 
Seat 3: Dickyxxx ($103.18 in chips) 
Seat 5: stds st ($38 in chips) 
Seat 6: yfcq36 ($140.95 in chips) 
Seat 7: 32rrew ($158.97 in chips) 
Seat 8: PacPacBum ($115.20 in chips) 
Seat 9: Mr.Grigoriy ($130.71 in chips) 
matiko09: posts small blind $0.50
xxxibgdrgn: posts big blind $1
Eskimo Fox: sits out 
*** HOLE CARDS ***
Dealt to matiko09 [2c 9d]
Dickyxxx: folds 
stds st: folds 
yfcq36: folds 
32rrew: folds 
PacPacBum: raises $1.04 to $2.04
Mr.Grigoriy: folds 
matiko09: folds 
xxxibgdrgn: folds 
Uncalled bet ($1.04) returned to PacPacBum
PacPacBum collected $2.50 from pot
PacPacBum: doesn't show hand 
*** SUMMARY ***
Total pot $2.50 | Rake $0 
Seat 1: matiko09 (small blind) folded before Flop
Seat 2: xxxibgdrgn (big blind) folded before Flop
Seat 3: Dickyxxx folded before Flop (didn't bet)
Seat 5: stds st folded before Flop (didn't bet)
Seat 6: yfcq36 folded before Flop (didn't bet)
Seat 7: 32rrew folded before Flop (didn't bet)
Seat 8: PacPacBum collected ($2.50)
Seat 9: Mr.Grigoriy (button) folded before Flop (didn't bet)





PokerStars Hand #154364118718:  Hold'em No Limit (€0.50/€1.00 EUR) - 2016/06/06 13:24:13 CET [2016/06/06 7:24:13 ET]
Table 'Lesath' 9-max Seat #7 is the button
Seat 1: o.miro (€116.92 in chips) 
Seat 2: thecurv (€108.84 in chips) 
Seat 3: ozone2003 (€201.14 in chips) 
Seat 5: matiko09 (€113.47 in chips) 
Seat 7: Mr.Grigoriy (€100 in chips) 
Seat 8: stds st (€50 in chips) 
Seat 9: 72nloses (€46.16 in chips) 
stds st: posts small blind €0.50
72nloses: posts big blind €1
*** HOLE CARDS ***
Dealt to matiko09 [6d 9h]
o.miro: folds 
thecurv: folds 
ozone2003: folds 
matiko09: folds 
Mr.Grigoriy: folds 
stds st: folds 
Uncalled bet (€0.50) returned to 72nloses
72nloses collected €1 from pot
*** SUMMARY ***
Total pot €1 | Rake €0 
Seat 1: o.miro folded before Flop (didn't bet)
Seat 2: thecurv folded before Flop (didn't bet)
Seat 3: ozone2003 folded before Flop (didn't bet)
Seat 5: matiko09 folded before Flop (didn't bet)
Seat 7: Mr.Grigoriy (button) folded before Flop (didn't bet)
Seat 8: stds st (small blind) folded before Flop
Seat 9: 72nloses (big blind) collected (€1)





PokerStars Hand #154364119775:  Hold'em No Limit ($0.50/$1.00 USD) - 2016/06/06 13:24:15 CET [2016/06/06 7:24:15 ET]
Table 'Sheliak' 9-max Seat #3 is the button
Seat 1: 32rrew ($102.50 in chips) 
Seat 2: DancerNN1 ($101.12 in chips) 
Seat 3: xxxZeka ($119.30 in chips) 
Seat 4: iRLM ($71.25 in chips) 
Seat 6: matiko09 ($111.49 in chips) 
Seat 7: stds st ($43.82 in chips) 
Seat 8: ozone2003 ($100 in chips) 
iRLM: posts small blind $0.50
matiko09: posts big blind $1
*** HOLE CARDS ***
Dealt to matiko09 [3h 6c]
stds st: folds 
ozone2003: folds 
32rrew: folds 
DancerNN1: folds 
xxxZeka: raises $1.50 to $2.50
iRLM: folds 
matiko09: folds 
Uncalled bet ($1.50) returned to xxxZeka
xxxZeka collected $2.50 from pot
*** SUMMARY ***
Total pot $2.50 | Rake $0 
Seat 1: 32rrew folded before Flop (didn't bet)
Seat 2: DancerNN1 folded before Flop (didn't bet)
Seat 3: xxxZeka (button) collected ($2.50)
Seat 4: iRLM (small blind) folded before Flop
Seat 6: matiko09 (big blind) folded before Flop
Seat 7: stds st folded before Flop (didn't bet)
Seat 8: ozone2003 folded before Flop (didn't bet)





PokerStars Hand #154364126040:  Hold'em No Limit ($0.50/$1.00 USD) - 2016/06/06 13:24:30 CET [2016/06/06 7:24:30 ET]
Table 'Oppavia' 9-max Seat #6 is the button
Seat 1: xxxZeka ($100 in chips) 
Seat 2: o.miro ($101.50 in chips) 
Seat 3: thecurv ($126 in chips) 
Seat 4: vanilica ($101.22 in chips) 
Seat 5: Eskimo Fox ($100 in chips) 
Seat 6: stds st ($44.50 in chips) 
Seat 7: chenlongn ($79 in chips) 
Seat 8: matiko09 ($100 in chips) 
Seat 9: Soundust_007 ($40 in chips) 
chenlongn: posts small blind $0.50
matiko09: posts big blind $1
*** HOLE CARDS ***
Dealt to matiko09 [6s 8c]
Soundust_007: folds 
xxxZeka: raises $2 to $3
o.miro: folds 
thecurv: folds 
vanilica: calls $3
Eskimo Fox: folds 
stds st: folds 
chenlongn: folds 
matiko09: folds 
*** FLOP *** [3s As Ac]
xxxZeka: bets $4.74
vanilica: calls $4.74
*** TURN *** [3s As Ac] [Kh]
xxxZeka: checks 
vanilica: checks 
*** RIVER *** [3s As Ac Kh] [Tc]
xxxZeka: checks 
vanilica: checks 
*** SHOW DOWN ***
xxxZeka: shows [5c 5d] (two pair, Aces and Fives)
vanilica: shows [Jd Jh] (two pair, Aces and Jacks)
vanilica collected $16.13 from pot
*** SUMMARY ***
Total pot $16.98 | Rake $0.85 
Board [3s As Ac Kh Tc]
Seat 1: xxxZeka showed [5c 5d] and lost with two pair, Aces and Fives
Seat 2: o.miro folded before Flop (didn't bet)
Seat 3: thecurv folded before Flop (didn't bet)
Seat 4: vanilica showed [Jd Jh] and won ($16.13) with two pair, Aces and Jacks
Seat 5: Eskimo Fox folded before Flop (didn't bet)
Seat 6: stds st (button) folded before Flop (didn't bet)
Seat 7: chenlongn (small blind) folded before Flop
Seat 8: matiko09 (big blind) folded before Flop
Seat 9: Soundust_007 folded before Flop (didn't bet)





PokerStars Hand #154364127041:  Hold'em No Limit ($0.50/$1.00 USD) - 2016/06/06 13:24:32 CET [2016/06/06 7:24:32 ET]
Table 'Smither' 9-max Seat #4 is the button
Seat 1: PacPacBum ($174.80 in chips) 
Seat 2: matiko09 ($101.50 in chips) 
Seat 3: stds st ($37 in chips) 
Seat 4: Dantist1122 ($100 in chips) 
Seat 6: mooose100 ($85.52 in chips) 
Seat 7: vanilica ($126.05 in chips) 
Seat 8: ozone2003 ($100 in chips) 
mooose100: posts small blind $0.50
vanilica: posts big blind $1
*** HOLE CARDS ***
Dealt to matiko09 [5s 6d]
ozone2003: folds 
PacPacBum: folds 
matiko09: folds 
stds st: folds 
Dantist1122: folds 
Szevasztopol leaves the table
mooose100: folds 
Uncalled bet ($0.50) returned to vanilica
vanilica collected $1 from pot
vanilica: doesn't show hand 
Dickyxxx joins the table at seat #5 
*** SUMMARY ***
Total pot $1 | Rake $0 
Seat 1: PacPacBum folded before Flop (didn't bet)
Seat 2: matiko09 folded before Flop (didn't bet)
Seat 3: stds st folded before Flop (didn't bet)
Seat 4: Dantist1122 (button) folded before Flop (didn't bet)
Seat 6: mooose100 (small blind) folded before Flop
Seat 7: vanilica (big blind) collected ($1)
Seat 8: ozone2003 folded before Flop (didn't bet)





PokerStars Hand #154364128166:  Hold'em No Limit ($0.50/$1.00 USD) - 2016/06/06 13:24:35 CET [2016/06/06 7:24:35 ET]
Table 'Safara' 9-max Seat #1 is the button
Seat 1: Dickyxxx ($100 in chips) 
Seat 2: ozone2003 ($100 in chips) 
Seat 3: erd33 ($162.55 in chips) 
Seat 4: xxxibgdrgn ($103.88 in chips) 
Seat 5: perezzi10 ($40.18 in chips) 
Seat 6: matiko09 ($140.28 in chips) 
Seat 7: PacPacBum ($122.53 in chips) 
Seat 8: o.miro ($150.23 in chips) 
Seat 9: R1aki ($100 in chips) 
ozone2003: posts small blind $0.50
erd33: posts big blind $1
*** HOLE CARDS ***
Dealt to matiko09 [5s Qs]
xxxibgdrgn: folds 
perezzi10: calls $1
matiko09: folds 
PacPacBum: folds 
o.miro: folds 
R1aki: folds 
Dickyxxx: folds 
ozone2003: folds 
erd33: checks 
*** FLOP *** [6c Tc Jh]
erd33: checks 
perezzi10: checks 
*** TURN *** [6c Tc Jh] [Ah]
erd33: checks 
perezzi10: checks 
*** RIVER *** [6c Tc Jh Ah] [3s]
erd33: checks 
perezzi10: checks 
*** SHOW DOWN ***
erd33: shows [2d 6s] (a pair of Sixes)
perezzi10: mucks hand 
erd33 collected $2.38 from pot
*** SUMMARY ***
Total pot $2.50 | Rake $0.12 
Board [6c Tc Jh Ah 3s]
Seat 1: Dickyxxx (button) folded before Flop (didn't bet)
Seat 2: ozone2003 (small blind) folded before Flop
Seat 3: erd33 (big blind) showed [2d 6s] and won ($2.38) with a pair of Sixes
Seat 4: xxxibgdrgn folded before Flop (didn't bet)
Seat 5: perezzi10 mucked [4h Qh]
Seat 6: matiko09 folded before Flop (didn't bet)
Seat 7: PacPacBum folded before Flop (didn't bet)
Seat 8: o.miro folded before Flop (didn't bet)
Seat 9: R1aki folded before Flop (didn't bet)





PokerStars Hand #154364130990:  Hold'em No Limit (€0.50/€1.00 EUR) - 2016/06/06 13:24:41 CET [2016/06/06 7:24:41 ET]
Table 'Lesath' 9-max Seat #8 is the button
Seat 1: o.miro (€116.92 in chips) 
Seat 2: thecurv (€108.84 in chips) 
Seat 3: ozone2003 (€201.14 in chips) 
Seat 5: matiko09 (€113.47 in chips) 
Seat 7: Mr.Grigoriy (€100 in chips) 
Seat 8: stds st (€49.50 in chips) 
Seat 9: 72nloses (€46.66 in chips) 
72nloses: posts small blind €0.50
o.miro: posts big blind €1
*** HOLE CARDS ***
Dealt to matiko09 [7s Jd]
thecurv: folds 
ozone2003: folds 
Szevasztopol leaves the table
matiko09: folds 
hurtNCYDE joins the table at seat #6 
Mr.Grigoriy: folds 
hurtNCYDE leaves the table
stds st: folds 
72nloses: raises €2 to €3
o.miro: calls €2
*** FLOP *** [Qh Ks 2h]
72nloses: bets €5.70
o.miro: folds 
Uncalled bet (€5.70) returned to 72nloses
72nloses collected €5.70 from pot
*** SUMMARY ***
Total pot €6 | Rake €0.30 
Board [Qh Ks 2h]
Seat 1: o.miro (big blind) folded on the Flop
Seat 2: thecurv folded before Flop (didn't bet)
Seat 3: ozone2003 folded before Flop (didn't bet)
Seat 5: matiko09 folded before Flop (didn't bet)
Seat 7: Mr.Grigoriy folded before Flop (didn't bet)
Seat 8: stds st (button) folded before Flop (didn't bet)
Seat 9: 72nloses (small blind) collected (€5.70)





PokerStars Hand #154364132466:  Hold'em No Limit ($0.50/$1.00 USD) - 2016/06/06 13:24:45 CET [2016/06/06 7:24:45 ET]
Table 'Heze' 9-max Seat #1 is the button
Seat 1: matiko09 ($170.17 in chips) 
Seat 2: xxxibgdrgn ($100 in chips) 
Seat 3: Dickyxxx ($103.18 in chips) 
Seat 5: stds st ($38 in chips) 
Seat 6: yfcq36 ($140.95 in chips) 
Seat 7: 32rrew ($158.97 in chips) 
Seat 8: PacPacBum ($116.70 in chips) 
Seat 9: Mr.Grigoriy ($130.71 in chips) 
xxxibgdrgn: posts small blind $0.50
Dickyxxx: posts big blind $1
Eskimo Fox: sits out 
*** HOLE CARDS ***
Dealt to matiko09 [4h 9d]
stds st: folds 
yfcq36: folds 
32rrew: folds 
PacPacBum: folds 
Mr.Grigoriy: folds 
matiko09: folds 
xxxibgdrgn: folds 
Uncalled bet ($0.50) returned to Dickyxxx
Dickyxxx collected $1 from pot
Dickyxxx: doesn't show hand 
*** SUMMARY ***
Total pot $1 | Rake $0 
Seat 1: matiko09 (button) folded before Flop (didn't bet)
Seat 2: xxxibgdrgn (small blind) folded before Flop
Seat 3: Dickyxxx (big blind) collected ($1)
Seat 5: stds st folded before Flop (didn't bet)
Seat 6: yfcq36 folded before Flop (didn't bet)
Seat 7: 32rrew folded before Flop (didn't bet)
Seat 8: PacPacBum folded before Flop (didn't bet)
Seat 9: Mr.Grigoriy folded before Flop (didn't bet)





PokerStars Hand #154364132864:  Hold'em No Limit ($0.50/$1.00 USD) - 2016/06/06 13:24:46 CET [2016/06/06 7:24:46 ET]
Table 'Sheliak' 9-max Seat #4 is the button
Seat 1: 32rrew ($102.50 in chips) 
Seat 2: DancerNN1 ($101.12 in chips) 
Seat 3: xxxZeka ($120.80 in chips) 
Seat 4: iRLM ($70.75 in chips) 
Seat 6: matiko09 ($110.49 in chips) 
Seat 7: stds st ($43.82 in chips) 
Seat 8: ozone2003 ($100 in chips) 
Szevasztopol leaves the table
matiko09: posts small blind $0.50
stds st: posts big blind $1
*** HOLE CARDS ***
Dealt to matiko09 [4h 2s]
ipashutapkom joins the table at seat #9 
ozone2003: folds 
32rrew: folds 
DancerNN1: raises $2 to $3
xxxZeka: folds 
iRLM: calls $3
matiko09: folds 
stds st: folds 
*** FLOP *** [6c Jd Ks]
DancerNN1: bets $2.84
iRLM: folds 
Uncalled bet ($2.84) returned to DancerNN1
DancerNN1 collected $7.12 from pot
DancerNN1: doesn't show hand 
*** SUMMARY ***
Total pot $7.50 | Rake $0.38 
Board [6c Jd Ks]
Seat 1: 32rrew folded before Flop (didn't bet)
Seat 2: DancerNN1 collected ($7.12)
Seat 3: xxxZeka folded before Flop (didn't bet)
Seat 4: iRLM (button) folded on the Flop
Seat 6: matiko09 (small blind) folded before Flop
Seat 7: stds st (big blind) folded before Flop
Seat 8: ozone2003 folded before Flop (didn't bet)





PokerStars Hand #154364134001:  Hold'em No Limit ($0.50/$1.00 USD) - 2016/06/06 13:24:48 CET [2016/06/06 7:24:48 ET]
Table 'Smither' 9-max Seat #6 is the button
Seat 1: PacPacBum ($174.80 in chips) 
Seat 2: matiko09 ($101.50 in chips) 
Seat 3: stds st ($37 in chips) 
Seat 4: Dantist1122 ($100 in chips) 
Seat 6: mooose100 ($85.02 in chips) 
Seat 7: vanilica ($126.55 in chips) 
Seat 8: ozone2003 ($100 in chips) 
vanilica: posts small blind $0.50
ozone2003: posts big blind $1
Dickyxxx: sits out 
*** HOLE CARDS ***
Dealt to matiko09 [Ks 5h]
PacPacBum: folds 
matiko09: folds 
stds st: folds 
Dantist1122: folds 
mooose100: raises $2 to $3
vanilica: folds 
ozone2003: folds 
Uncalled bet ($2) returned to mooose100
mooose100 collected $2.50 from pot
mooose100: doesn't show hand 
*** SUMMARY ***
Total pot $2.50 | Rake $0 
Seat 1: PacPacBum folded before Flop (didn't bet)
Seat 2: matiko09 folded before Flop (didn't bet)
Seat 3: stds st folded before Flop (didn't bet)
Seat 4: Dantist1122 folded before Flop (didn't bet)
Seat 6: mooose100 (button) collected ($2.50)
Seat 7: vanilica (small blind) folded before Flop
Seat 8: ozone2003 (big blind) folded before Flop





PokerStars Hand #154364134418:  Hold'em No Limit ($0.50/$1.00 USD) - 2016/06/06 13:24:49 CET [2016/06/06 7:24:49 ET]
Table 'Williams' 9-max Seat #5 is the button
Seat 1: xhinostrabli ($80.50 in chips) 
Seat 2: matiko09 ($174.51 in chips) 
Seat 3: granbunny ($69.56 in chips) 
Seat 4: Mr.Grigoriy ($106.12 in chips) 
Seat 5: xxxibgdrgn ($100 in chips) 
Seat 6: xxxZeka ($129.38 in chips) 
Seat 7: Eskimo Fox ($117.94 in chips) 
Seat 8: Dickyxxx ($101.50 in chips) 
Seat 9: stds st ($68.76 in chips) 
xxxZeka: posts small blind $0.50
Eskimo Fox: posts big blind $1
*** HOLE CARDS ***
Dealt to matiko09 [3d Ts]
Dickyxxx: folds 
stds st: folds 
xhinostrabli: folds 
matiko09: folds 
granbunny: folds 
Mr.Grigoriy: folds 
xxxibgdrgn: folds 
xxxZeka: folds 
Uncalled bet ($0.50) returned to Eskimo Fox
Eskimo Fox collected $1 from pot
Eskimo Fox: doesn't show hand 
*** SUMMARY ***
Total pot $1 | Rake $0 
Seat 1: xhinostrabli folded before Flop (didn't bet)
Seat 2: matiko09 folded before Flop (didn't bet)
Seat 3: granbunny folded before Flop (didn't bet)
Seat 4: Mr.Grigoriy folded before Flop (didn't bet)
Seat 5: xxxibgdrgn (button) folded before Flop (didn't bet)
Seat 6: xxxZeka (small blind) folded before Flop
Seat 7: Eskimo Fox (big blind) collected ($1)
Seat 8: Dickyxxx folded before Flop (didn't bet)
Seat 9: stds st folded before Flop (didn't bet)





PokerStars Hand #154364138845:  Hold'em No Limit ($0.50/$1.00 USD) - 2016/06/06 13:25:00 CET [2016/06/06 7:25:00 ET]
Table 'Gajdariya' 9-max Seat #5 is the button
Seat 1: matiko09 ($135.09 in chips) 
Seat 2: Dickyxxx ($107.52 in chips) 
Seat 3: mooose100 ($87.27 in chips) 
Seat 5: stds st ($57.33 in chips) 
Seat 6: vanilica ($100 in chips) 
Seat 7: hurtNCYDE ($118.09 in chips) 
Seat 8: ardo888 ($135.32 in chips) 
Seat 9: PacPacBum ($111.73 in chips) 
vanilica: posts small blind $0.50
hurtNCYDE: posts big blind $1
ozone2003: sits out 
*** HOLE CARDS ***
Dealt to matiko09 [Tc 7h]
ardo888: folds 
ardo888 leaves the table
PacPacBum: folds 
matiko09: folds 
Dickyxxx: folds 
Mr.Grigoriy joins the table at seat #8 
mooose100: folds 
stds st: raises $1.02 to $2.02
vanilica: folds 
hurtNCYDE: raises $4.98 to $7
stds st: raises $6 to $13
hurtNCYDE: folds 
Uncalled bet ($6) returned to stds st
stds st collected $14.50 from pot
stds st: doesn't show hand 
*** SUMMARY ***
Total pot $14.50 | Rake $0 
Seat 1: matiko09 folded before Flop (didn't bet)
Seat 2: Dickyxxx folded before Flop (didn't bet)
Seat 3: mooose100 folded before Flop (didn't bet)
Seat 5: stds st (button) collected ($14.50)
Seat 6: vanilica (small blind) folded before Flop
Seat 7: hurtNCYDE (big blind) folded before Flop
Seat 8: ardo888 folded before Flop (didn't bet)
Seat 9: PacPacBum folded before Flop (didn't bet)





PokerStars Hand #154364142546:  Hold'em No Limit ($0.50/$1.00 USD) - 2016/06/06 13:25:08 CET [2016/06/06 7:25:08 ET]
Table 'Chaldaea II' 9-max Seat #2 is the button
Seat 2: Mr.Grigoriy ($102.50 in chips) 
Seat 4: mooose100 ($142.03 in chips) 
Seat 5: stds st ($40 in chips) 
Seat 6: PacPacBum ($112.86 in chips) 
Seat 7: xxxibgdrgn ($106.02 in chips) 
Seat 8: 32rrew ($101 in chips) 
Seat 9: matiko09 ($100 in chips) 
mooose100: posts small blind $0.50
stds st: posts big blind $1
ozone2003: sits out 
*** HOLE CARDS ***
Dealt to matiko09 [As Js]
PacPacBum: folds 
xxxibgdrgn: folds 
32rrew: folds 
matiko09: raises $1.50 to $2.50
Mr.Grigoriy: folds 
mooose100: folds 
stds st: folds 
Uncalled bet ($1.50) returned to matiko09
matiko09 collected $2.50 from pot
matiko09: doesn't show hand 
*** SUMMARY ***
Total pot $2.50 | Rake $0 
Seat 2: Mr.Grigoriy (button) folded before Flop (didn't bet)
Seat 4: mooose100 (small blind) folded before Flop
Seat 5: stds st (big blind) folded before Flop
Seat 6: PacPacBum folded before Flop (didn't bet)
Seat 7: xxxibgdrgn folded before Flop (didn't bet)
Seat 8: 32rrew folded before Flop (didn't bet)
Seat 9: matiko09 collected ($2.50)





PokerStars Hand #154364144109:  Hold'em No Limit ($0.50/$1.00 USD) - 2016/06/06 13:25:12 CET [2016/06/06 7:25:12 ET]
Table 'Heze' 9-max Seat #2 is the button
Seat 1: matiko09 ($170.17 in chips) 
Seat 2: xxxibgdrgn ($100 in chips) 
Seat 3: Dickyxxx ($103.68 in chips) 
Seat 4: Eskimo Fox ($100 in chips) 
Seat 5: stds st ($38 in chips) 
Seat 6: yfcq36 ($140.95 in chips) 
Seat 7: 32rrew ($158.97 in chips) 
Seat 8: PacPacBum ($116.70 in chips) 
Seat 9: Mr.Grigoriy ($130.71 in chips) 
Dickyxxx: posts small blind $0.50
Eskimo Fox: posts big blind $1
*** HOLE CARDS ***
Dealt to matiko09 [3c 3s]
stds st: folds 
yfcq36: folds 
32rrew: folds 
PacPacBum: folds 
Mr.Grigoriy: folds 
matiko09: raises $1.50 to $2.50
xxxibgdrgn: folds 
Dickyxxx: folds 
Eskimo Fox: folds 
Uncalled bet ($1.50) returned to matiko09
matiko09 collected $2.50 from pot
matiko09: doesn't show hand 
*** SUMMARY ***
Total pot $2.50 | Rake $0 
Seat 1: matiko09 collected ($2.50)
Seat 2: xxxibgdrgn (button) folded before Flop (didn't bet)
Seat 3: Dickyxxx (small blind) folded before Flop
Seat 4: Eskimo Fox (big blind) folded before Flop
Seat 5: stds st folded before Flop (didn't bet)
Seat 6: yfcq36 folded before Flop (didn't bet)
Seat 7: 32rrew folded before Flop (didn't bet)
Seat 8: PacPacBum folded before Flop (didn't bet)
Seat 9: Mr.Grigoriy folded before Flop (didn't bet)





PokerStars Hand #154364144861:  Hold'em No Limit (€0.50/€1.00 EUR) - 2016/06/06 13:25:14 CET [2016/06/06 7:25:14 ET]
Table 'Lesath' 9-max Seat #9 is the button
Seat 1: o.miro (€113.92 in chips) 
Seat 2: thecurv (€108.84 in chips) 
Seat 3: ozone2003 (€201.14 in chips) 
Seat 5: matiko09 (€113.47 in chips) 
Seat 7: Mr.Grigoriy (€100 in chips) 
Seat 8: stds st (€49.50 in chips) 
Seat 9: 72nloses (€49.36 in chips) 
o.miro: posts small blind €0.50
thecurv: posts big blind €1
*** HOLE CARDS ***
Dealt to matiko09 [6s Jc]
ozone2003: folds 
Dickyxxx joins the table at seat #6 
matiko09: folds 
Mr.Grigoriy: folds 
stds st: raises €1.02 to €2.02
72nloses: calls €2.02
o.miro: calls €1.52
thecurv: calls €1.02
*** FLOP *** [4d 3s 7s]
o.miro: checks 
thecurv: checks 
stds st: checks 
72nloses: bets €8
o.miro: folds 
thecurv: folds 
stds st: raises €39.48 to €47.48 and is all-in
72nloses: folds 
Uncalled bet (€39.48) returned to stds st
stds st collected €22.88 from pot
stds st: doesn't show hand 
*** SUMMARY ***
Total pot €24.08 | Rake €1.20 
Board [4d 3s 7s]
Seat 1: o.miro (small blind) folded on the Flop
Seat 2: thecurv (big blind) folded on the Flop
Seat 3: ozone2003 folded before Flop (didn't bet)
Seat 5: matiko09 folded before Flop (didn't bet)
Seat 7: Mr.Grigoriy folded before Flop (didn't bet)
Seat 8: stds st collected (€22.88)
Seat 9: 72nloses (button) folded on the Flop





PokerStars Hand #154364145443:  Hold'em No Limit ($0.50/$1.00 USD) - 2016/06/06 13:25:15 CET [2016/06/06 7:25:15 ET]
Table 'Safara' 9-max Seat #2 is the button
Seat 1: Dickyxxx ($100 in chips) 
Seat 2: ozone2003 ($100 in chips) 
Seat 3: erd33 ($163.93 in chips) 
Seat 4: xxxibgdrgn ($103.88 in chips) 
Seat 5: perezzi10 ($39.18 in chips) 
Seat 6: matiko09 ($140.28 in chips) 
Seat 7: PacPacBum ($122.53 in chips) 
Seat 8: o.miro ($150.23 in chips) 
Seat 9: R1aki ($100 in chips) 
erd33: posts small blind $0.50
xxxibgdrgn: posts big blind $1
*** HOLE CARDS ***
Dealt to matiko09 [Td Ts]
perezzi10: calls $1
matiko09: raises $3 to $4
PacPacBum: folds 
o.miro: folds 
R1aki: folds 
Dickyxxx: folds 
ozone2003: folds 
erd33: folds 
xxxibgdrgn: folds 
perezzi10: calls $3
*** FLOP *** [5c 9d Ac]
perezzi10: checks 
matiko09: checks 
*** TURN *** [5c 9d Ac] [Qd]
perezzi10: bets $3
matiko09: calls $3
*** RIVER *** [5c 9d Ac Qd] [Kh]
perezzi10: checks 
matiko09: checks 
*** SHOW DOWN ***
perezzi10: shows [Qh 8d] (a pair of Queens)
matiko09: mucks hand 
perezzi10 collected $14.72 from pot
*** SUMMARY ***
Total pot $15.50 | Rake $0.78 
Board [5c 9d Ac Qd Kh]
Seat 1: Dickyxxx folded before Flop (didn't bet)
Seat 2: ozone2003 (button) folded before Flop (didn't bet)
Seat 3: erd33 (small blind) folded before Flop
Seat 4: xxxibgdrgn (big blind) folded before Flop
Seat 5: perezzi10 showed [Qh 8d] and won ($14.72) with a pair of Queens
Seat 6: matiko09 mucked [Td Ts]
Seat 7: PacPacBum folded before Flop (didn't bet)
Seat 8: o.miro folded before Flop (didn't bet)
Seat 9: R1aki folded before Flop (didn't bet)





PokerStars Hand #154364146164:  Hold'em No Limit ($0.50/$1.00 USD) - 2016/06/06 13:25:17 CET [2016/06/06 7:25:17 ET]
Table 'Williams' 9-max Seat #6 is the button
Seat 1: xhinostrabli ($80.50 in chips) 
Seat 2: matiko09 ($174.51 in chips) 
Seat 3: granbunny ($69.56 in chips) 
Seat 4: Mr.Grigoriy ($106.12 in chips) 
Seat 5: xxxibgdrgn ($100 in chips) 
Seat 6: xxxZeka ($128.88 in chips) 
Seat 7: Eskimo Fox ($118.44 in chips) 
Seat 8: Dickyxxx ($101.50 in chips) 
Seat 9: stds st ($68.76 in chips) 
Eskimo Fox: posts small blind $0.50
Dickyxxx: posts big blind $1
*** HOLE CARDS ***
Dealt to matiko09 [Js Kh]
stds st: folds 
xhinostrabli: folds 
matiko09: folds 
granbunny: folds 
Mr.Grigoriy: folds 
xxxibgdrgn: folds 
xxxZeka: raises $1.50 to $2.50
Eskimo Fox: folds 
Dickyxxx: raises $6.50 to $9
xxxZeka: folds 
Uncalled bet ($6.50) returned to Dickyxxx
Dickyxxx collected $5.50 from pot
Dickyxxx: doesn't show hand 
*** SUMMARY ***
Total pot $5.50 | Rake $0 
Seat 1: xhinostrabli folded before Flop (didn't bet)
Seat 2: matiko09 folded before Flop (didn't bet)
Seat 3: granbunny folded before Flop (didn't bet)
Seat 4: Mr.Grigoriy folded before Flop (didn't bet)
Seat 5: xxxibgdrgn folded before Flop (didn't bet)
Seat 6: xxxZeka (button) folded before Flop
Seat 7: Eskimo Fox (small blind) folded before Flop
Seat 8: Dickyxxx (big blind) collected ($5.50)
Seat 9: stds st folded before Flop (didn't bet)





PokerStars Hand #154364148382:  Hold'em No Limit ($0.50/$1.00 USD) - 2016/06/06 13:25:22 CET [2016/06/06 7:25:22 ET]
Table 'Wezen II' 9-max Seat #1 is the button
Seat 1: matiko09 ($100 in chips) 
Seat 2: Mr.Grigoriy ($111.62 in chips) 
Seat 3: Dickyxxx ($101.50 in chips) 
Seat 4: xxxibgdrgn ($197.50 in chips) 
Seat 5: stds st ($41.33 in chips) 
Seat 6: Eskimo Fox ($100 in chips) 
Seat 7: KDJAll3 ($79.08 in chips) 
Seat 8: o.miro ($105 in chips) 
Seat 9: Cogss ($107.70 in chips) 
Mr.Grigoriy: posts small blind $0.50
Dickyxxx: posts big blind $1
*** HOLE CARDS ***
Dealt to matiko09 [Jd 9c]
xxxibgdrgn: folds 
stds st: folds 
Eskimo Fox: raises $2 to $3
KDJAll3: folds 
o.miro: folds 
Cogss: folds 
matiko09: folds 
Mr.Grigoriy: folds 
Dickyxxx: folds 
Uncalled bet ($2) returned to Eskimo Fox
Eskimo Fox collected $2.50 from pot
*** SUMMARY ***
Total pot $2.50 | Rake $0 
Seat 1: matiko09 (button) folded before Flop (didn't bet)
Seat 2: Mr.Grigoriy (small blind) folded before Flop
Seat 3: Dickyxxx (big blind) folded before Flop
Seat 4: xxxibgdrgn folded before Flop (didn't bet)
Seat 5: stds st folded before Flop (didn't bet)
Seat 6: Eskimo Fox collected ($2.50)
Seat 7: KDJAll3 folded before Flop (didn't bet)
Seat 8: o.miro folded before Flop (didn't bet)
Seat 9: Cogss folded before Flop (didn't bet)





PokerStars Hand #154364151169:  Hold'em No Limit ($0.50/$1.00 USD) - 2016/06/06 13:25:28 CET [2016/06/06 7:25:28 ET]
Table 'Smither' 9-max Seat #7 is the button
Seat 1: PacPacBum ($174.80 in chips) 
Seat 2: matiko09 ($101.50 in chips) 
Seat 3: stds st ($37 in chips) 
Seat 4: Dantist1122 ($100 in chips) 
Seat 6: mooose100 ($86.52 in chips) 
Seat 7: vanilica ($126.05 in chips) 
Seat 8: ozone2003 ($100 in chips) 
ozone2003: posts small blind $0.50
PacPacBum: posts big blind $1
Dickyxxx: sits out 
*** HOLE CARDS ***
Dealt to matiko09 [3s Qs]
matiko09: folds 
stds st: folds 
Dantist1122: folds 
mooose100: calls $1
vanilica: folds 
ozone2003: folds 
PacPacBum: checks 
*** FLOP *** [4d 9s Js]
PacPacBum: checks 
mooose100: bets $1
PacPacBum: calls $1
*** TURN *** [4d 9s Js] [6h]
PacPacBum: checks 
mooose100: bets $1
PacPacBum: calls $1
*** RIVER *** [4d 9s Js 6h] [5s]
PacPacBum: checks 
mooose100: checks 
*** SHOW DOWN ***
PacPacBum: shows [Ks Th] (high card King)
mooose100: shows [2c 4c] (a pair of Fours)
mooose100 collected $6.18 from pot
*** SUMMARY ***
Total pot $6.50 | Rake $0.32 
Board [4d 9s Js 6h 5s]
Seat 1: PacPacBum (big blind) showed [Ks Th] and lost with high card King
Seat 2: matiko09 folded before Flop (didn't bet)
Seat 3: stds st folded before Flop (didn't bet)
Seat 4: Dantist1122 folded before Flop (didn't bet)
Seat 6: mooose100 showed [2c 4c] and won ($6.18) with a pair of Fours
Seat 7: vanilica (button) folded before Flop (didn't bet)
Seat 8: ozone2003 (small blind) folded before Flop





PokerStars Hand #154364153952:  Hold'em No Limit ($0.50/$1.00 USD) - 2016/06/06 13:25:35 CET [2016/06/06 7:25:35 ET]
Table 'Oppavia' 9-max Seat #7 is the button
Seat 1: xxxZeka ($100 in chips) 
Seat 2: o.miro ($101.50 in chips) 
Seat 3: thecurv ($126 in chips) 
Seat 4: vanilica ($109.61 in chips) 
Seat 5: Eskimo Fox ($100 in chips) 
Seat 6: stds st ($44.50 in chips) 
Seat 7: chenlongn ($78.50 in chips) 
Seat 8: matiko09 ($100 in chips) 
Seat 9: Soundust_007 ($40 in chips) 
matiko09: posts small blind $0.50
Soundust_007: posts big blind $1
*** HOLE CARDS ***
Dealt to matiko09 [6d Qh]
xxxZeka: folds 
o.miro: folds 
thecurv: folds 
vanilica: raises $1.50 to $2.50
Eskimo Fox: folds 
stds st: folds 
chenlongn: folds 
matiko09: folds 
Soundust_007: calls $1.50
*** FLOP *** [9h 3h 4h]
Soundust_007: bets $1
vanilica: raises $6 to $7
Soundust_007: folds 
Uncalled bet ($6) returned to vanilica
vanilica collected $7.12 from pot
vanilica: doesn't show hand 
*** SUMMARY ***
Total pot $7.50 | Rake $0.38 
Board [9h 3h 4h]
Seat 1: xxxZeka folded before Flop (didn't bet)
Seat 2: o.miro folded before Flop (didn't bet)
Seat 3: thecurv folded before Flop (didn't bet)
Seat 4: vanilica collected ($7.12)
Seat 5: Eskimo Fox folded before Flop (didn't bet)
Seat 6: stds st folded before Flop (didn't bet)
Seat 7: chenlongn (button) folded before Flop (didn't bet)
Seat 8: matiko09 (small blind) folded before Flop
Seat 9: Soundust_007 (big blind) folded on the Flop





PokerStars Hand #154364155953:  Hold'em No Limit ($0.50/$1.00 USD) - 2016/06/06 13:25:39 CET [2016/06/06 7:25:39 ET]
Table 'Sheliak' 9-max Seat #6 is the button
Seat 1: 32rrew ($102.50 in chips) 
Seat 2: DancerNN1 ($105.24 in chips) 
Seat 3: xxxZeka ($120.80 in chips) 
Seat 4: iRLM ($67.75 in chips) 
Seat 6: matiko09 ($109.99 in chips) 
Seat 7: stds st ($42.82 in chips) 
Seat 8: ozone2003 ($100 in chips) 
stds st: posts small blind $0.50
ozone2003: posts big blind $1
ipashutapkom: sits out 
*** HOLE CARDS ***
Dealt to matiko09 [Ts 2h]
32rrew: folds 
DancerNN1: folds 
xxxZeka: folds 
iRLM: folds 
matiko09: folds 
stds st: raises $1.02 to $2.02
ozone2003: calls $1.02
*** FLOP *** [4s 7d Qh]
stds st: bets $2.11
ozone2003: folds 
Uncalled bet ($2.11) returned to stds st
stds st collected $3.84 from pot
stds st: doesn't show hand 
*** SUMMARY ***
Total pot $4.04 | Rake $0.20 
Board [4s 7d Qh]
Seat 1: 32rrew folded before Flop (didn't bet)
Seat 2: DancerNN1 folded before Flop (didn't bet)
Seat 3: xxxZeka folded before Flop (didn't bet)
Seat 4: iRLM folded before Flop (didn't bet)
Seat 6: matiko09 (button) folded before Flop (didn't bet)
Seat 7: stds st (small blind) collected ($3.84)
Seat 8: ozone2003 (big blind) folded on the Flop





PokerStars Hand #154364162446:  Hold'em No Limit ($0.50/$1.00 USD) - 2016/06/06 13:25:54 CET [2016/06/06 7:25:54 ET]
Table 'Heze' 9-max Seat #3 is the button
Seat 1: matiko09 ($171.67 in chips) 
Seat 2: xxxibgdrgn ($100 in chips) 
Seat 3: Dickyxxx ($103.18 in chips) 
Seat 4: Eskimo Fox ($100 in chips) 
Seat 5: stds st ($38 in chips) 
Seat 6: yfcq36 ($140.95 in chips) 
Seat 7: 32rrew ($158.97 in chips) 
Seat 8: PacPacBum ($116.70 in chips) 
Seat 9: Mr.Grigoriy ($130.71 in chips) 
Eskimo Fox: posts small blind $0.50
stds st: posts big blind $1
*** HOLE CARDS ***
Dealt to matiko09 [9d Jc]
yfcq36: folds 
32rrew: folds 
PacPacBum: raises $1.04 to $2.04
Mr.Grigoriy: folds 
matiko09: folds 
xxxibgdrgn: folds 
Dickyxxx: folds 
Eskimo Fox: folds 
stds st: folds 
Uncalled bet ($1.04) returned to PacPacBum
PacPacBum collected $2.50 from pot
PacPacBum: doesn't show hand 
*** SUMMARY ***
Total pot $2.50 | Rake $0 
Seat 1: matiko09 folded before Flop (didn't bet)
Seat 2: xxxibgdrgn folded before Flop (didn't bet)
Seat 3: Dickyxxx (button) folded before Flop (didn't bet)
Seat 4: Eskimo Fox (small blind) folded before Flop
Seat 5: stds st (big blind) folded before Flop
Seat 6: yfcq36 folded before Flop (didn't bet)
Seat 7: 32rrew folded before Flop (didn't bet)
Seat 8: PacPacBum collected ($2.50)
Seat 9: Mr.Grigoriy folded before Flop (didn't bet)





PokerStars Hand #154364163814:  Hold'em No Limit ($0.50/$1.00 USD) - 2016/06/06 13:25:58 CET [2016/06/06 7:25:58 ET]
Table 'Chaldaea II' 9-max Seat #4 is the button
Seat 2: Mr.Grigoriy ($102.50 in chips) 
Seat 4: mooose100 ($141.53 in chips) 
Seat 5: stds st ($39 in chips) 
Seat 6: PacPacBum ($112.86 in chips) 
Seat 7: xxxibgdrgn ($106.02 in chips) 
Seat 8: 32rrew ($101 in chips) 
Seat 9: matiko09 ($101.50 in chips) 
stds st: posts small blind $0.50
PacPacBum: posts big blind $1
ozone2003: sits out 
*** HOLE CARDS ***
Dealt to matiko09 [5d Tc]
xxxibgdrgn: folds 
32rrew: folds 
matiko09: folds 
Mr.Grigoriy: folds 
mooose100: raises $2 to $3
stds st: folds 
PacPacBum: calls $2
*** FLOP *** [3s Ad 3c]
PacPacBum: checks 
mooose100: bets $3.09
PacPacBum: folds 
Uncalled bet ($3.09) returned to mooose100
mooose100 collected $6.18 from pot
mooose100: doesn't show hand 
*** SUMMARY ***
Total pot $6.50 | Rake $0.32 
Board [3s Ad 3c]
Seat 2: Mr.Grigoriy folded before Flop (didn't bet)
Seat 4: mooose100 (button) collected ($6.18)
Seat 5: stds st (small blind) folded before Flop
Seat 6: PacPacBum (big blind) folded on the Flop
Seat 7: xxxibgdrgn folded before Flop (didn't bet)
Seat 8: 32rrew folded before Flop (didn't bet)
Seat 9: matiko09 folded before Flop (didn't bet)





PokerStars Hand #154364164370:  Hold'em No Limit ($0.50/$1.00 USD) - 2016/06/06 13:25:59 CET [2016/06/06 7:25:59 ET]
Table 'Gajdariya' 9-max Seat #6 is the button
Seat 1: matiko09 ($135.09 in chips) 
Seat 2: Dickyxxx ($107.52 in chips) 
Seat 3: mooose100 ($87.27 in chips) 
Seat 5: stds st ($64.83 in chips) 
Seat 6: vanilica ($100 in chips) 
Seat 7: hurtNCYDE ($111.09 in chips) 
Seat 8: Mr.Grigoriy ($182.63 in chips) 
Seat 9: PacPacBum ($111.73 in chips) 
hurtNCYDE: posts small blind $0.50
Mr.Grigoriy: posts big blind $1
ozone2003: sits out 
*** HOLE CARDS ***
Dealt to matiko09 [Jd 4d]
PacPacBum: folds 
matiko09: folds 
Dickyxxx: folds 
mooose100: calls $1
stds st: folds 
vanilica: raises $2.50 to $3.50
hurtNCYDE: folds 
Mr.Grigoriy: calls $2.50
mooose100: calls $2.50
*** FLOP *** [4c Kh As]
Mr.Grigoriy: checks 
mooose100: bets $5.22
vanilica: folds 
Mr.Grigoriy: calls $5.22
*** TURN *** [4c Kh As] [3c]
Mr.Grigoriy: checks 
mooose100: bets $10.18
Mr.Grigoriy: folds 
Uncalled bet ($10.18) returned to mooose100
mooose100 collected $20.37 from pot
mooose100: doesn't show hand 
*** SUMMARY ***
Total pot $21.44 | Rake $1.07 
Board [4c Kh As 3c]
Seat 1: matiko09 folded before Flop (didn't bet)
Seat 2: Dickyxxx folded before Flop (didn't bet)
Seat 3: mooose100 collected ($20.37)
Seat 5: stds st folded before Flop (didn't bet)
Seat 6: vanilica (button) folded on the Flop
Seat 7: hurtNCYDE (small blind) folded before Flop
Seat 8: Mr.Grigoriy (big blind) folded on the Turn
Seat 9: PacPacBum folded before Flop (didn't bet)





PokerStars Hand #154364166444:  Hold'em No Limit ($0.50/$1.00 USD) - 2016/06/06 13:26:04 CET [2016/06/06 7:26:04 ET]
Table 'Wezen II' 9-max Seat #2 is the button
Seat 1: matiko09 ($100 in chips) 
Seat 2: Mr.Grigoriy ($111.12 in chips) 
Seat 3: Dickyxxx ($100.50 in chips) 
Seat 4: xxxibgdrgn ($197.50 in chips) 
Seat 5: stds st ($41.33 in chips) 
Seat 6: Eskimo Fox ($101.50 in chips) 
Seat 7: KDJAll3 ($79.08 in chips) 
Seat 8: o.miro ($105 in chips) 
Seat 9: Cogss ($107.70 in chips) 
Dickyxxx: posts small blind $0.50
xxxibgdrgn: posts big blind $1
*** HOLE CARDS ***
Dealt to matiko09 [5s Td]
stds st: folds 
Eskimo Fox: raises $2 to $3
KDJAll3: folds 
o.miro: folds 
Cogss: folds 
matiko09: folds 
Mr.Grigoriy: folds 
Dickyxxx: folds 
xxxibgdrgn: folds 
Uncalled bet ($2) returned to Eskimo Fox
Eskimo Fox collected $2.50 from pot
Eskimo Fox: doesn't show hand 
*** SUMMARY ***
Total pot $2.50 | Rake $0 
Seat 1: matiko09 folded before Flop (didn't bet)
Seat 2: Mr.Grigoriy (button) folded before Flop (didn't bet)
Seat 3: Dickyxxx (small blind) folded before Flop
Seat 4: xxxibgdrgn (big blind) folded before Flop
Seat 5: stds st folded before Flop (didn't bet)
Seat 6: Eskimo Fox collected ($2.50)
Seat 7: KDJAll3 folded before Flop (didn't bet)
Seat 8: o.miro folded before Flop (didn't bet)
Seat 9: Cogss folded before Flop (didn't bet)





PokerStars Hand #154364167989:  Hold'em No Limit ($0.50/$1.00 USD) - 2016/06/06 13:26:07 CET [2016/06/06 7:26:07 ET]
Table 'Williams' 9-max Seat #7 is the button
Seat 1: xhinostrabli ($80.50 in chips) 
Seat 2: matiko09 ($174.51 in chips) 
Seat 3: granbunny ($69.56 in chips) 
Seat 4: Mr.Grigoriy ($106.12 in chips) 
Seat 5: xxxibgdrgn ($100 in chips) 
Seat 6: xxxZeka ($126.38 in chips) 
Seat 7: Eskimo Fox ($117.94 in chips) 
Seat 8: Dickyxxx ($104.50 in chips) 
Seat 9: stds st ($68.76 in chips) 
Dickyxxx: posts small blind $0.50
stds st: posts big blind $1
*** HOLE CARDS ***
Dealt to matiko09 [8h 5h]
xhinostrabli: raises $2 to $3
matiko09: folds 
granbunny: folds 
Mr.Grigoriy: folds 
xxxibgdrgn: folds 
xxxZeka: folds 
Eskimo Fox: folds 
Dickyxxx: folds 
stds st: folds 
Uncalled bet ($2) returned to xhinostrabli
xhinostrabli collected $2.50 from pot
*** SUMMARY ***
Total pot $2.50 | Rake $0 
Seat 1: xhinostrabli collected ($2.50)
Seat 2: matiko09 folded before Flop (didn't bet)
Seat 3: granbunny folded before Flop (didn't bet)
Seat 4: Mr.Grigoriy folded before Flop (didn't bet)
Seat 5: xxxibgdrgn folded before Flop (didn't bet)
Seat 6: xxxZeka folded before Flop (didn't bet)
Seat 7: Eskimo Fox (button) folded before Flop (didn't bet)
Seat 8: Dickyxxx (small blind) folded before Flop
Seat 9: stds st (big blind) folded before Flop





PokerStars Hand #154364171089:  Hold'em No Limit ($0.50/$1.00 USD) - 2016/06/06 13:26:14 CET [2016/06/06 7:26:14 ET]
Table 'Safara' 9-max Seat #3 is the button
Seat 1: Dickyxxx ($100 in chips) 
Seat 2: ozone2003 ($100 in chips) 
Seat 3: erd33 ($163.43 in chips) 
Seat 4: xxxibgdrgn ($102.88 in chips) 
Seat 5: perezzi10 ($46.90 in chips) 
Seat 6: matiko09 ($133.28 in chips) 
Seat 7: PacPacBum ($122.53 in chips) 
Seat 8: o.miro ($150.23 in chips) 
Seat 9: R1aki ($100 in chips) 
xxxibgdrgn: posts small blind $0.50
perezzi10: posts big blind $1
*** HOLE CARDS ***
Dealt to matiko09 [7s Td]
matiko09: folds 
PacPacBum: folds 
o.miro: folds 
R1aki: raises $1.50 to $2.50
Dickyxxx: folds 
ozone2003: folds 
erd33: folds 
xxxibgdrgn: folds 
perezzi10: calls $1.50
*** FLOP *** [Th Qd 2s]
perezzi10: checks 
R1aki: checks 
*** TURN *** [Th Qd 2s] [5h]
perezzi10: checks 
R1aki: bets $1.50
perezzi10: folds 
Uncalled bet ($1.50) returned to R1aki
R1aki collected $5.22 from pot
R1aki: doesn't show hand 
*** SUMMARY ***
Total pot $5.50 | Rake $0.28 
Board [Th Qd 2s 5h]
Seat 1: Dickyxxx folded before Flop (didn't bet)
Seat 2: ozone2003 folded before Flop (didn't bet)
Seat 3: erd33 (button) folded before Flop (didn't bet)
Seat 4: xxxibgdrgn (small blind) folded before Flop
Seat 5: perezzi10 (big blind) folded on the Turn
Seat 6: matiko09 folded before Flop (didn't bet)
Seat 7: PacPacBum folded before Flop (didn't bet)
Seat 8: o.miro folded before Flop (didn't bet)
Seat 9: R1aki collected ($5.22)





PokerStars Hand #154364175884:  Hold'em No Limit ($0.50/$1.00 USD) - 2016/06/06 13:26:25 CET [2016/06/06 7:26:25 ET]
Table 'Oppavia' 9-max Seat #8 is the button
Seat 1: xxxZeka ($100 in chips) 
Seat 2: o.miro ($101.50 in chips) 
Seat 3: thecurv ($126 in chips) 
Seat 4: vanilica ($113.23 in chips) 
Seat 5: Eskimo Fox ($100 in chips) 
Seat 6: stds st ($44.50 in chips) 
Seat 7: chenlongn ($78.50 in chips) 
Seat 8: matiko09 ($100 in chips) 
Seat 9: Soundust_007 ($36.50 in chips) 
Soundust_007: posts small blind $0.50
xxxZeka: posts big blind $1
*** HOLE CARDS ***
Dealt to matiko09 [4s 4d]
o.miro: folds 
thecurv: folds 
vanilica: folds 
Eskimo Fox: folds 
stds st: folds 
chenlongn: raises $1 to $2
matiko09: calls $2
Soundust_007: folds 
xxxZeka: calls $1
*** FLOP *** [6d Qc 2s]
xxxZeka: checks 
chenlongn: checks 
matiko09: bets $4.02
xxxZeka: folds 
chenlongn: folds 
Uncalled bet ($4.02) returned to matiko09
matiko09 collected $6.18 from pot
matiko09: doesn't show hand 
*** SUMMARY ***
Total pot $6.50 | Rake $0.32 
Board [6d Qc 2s]
Seat 1: xxxZeka (big blind) folded on the Flop
Seat 2: o.miro folded before Flop (didn't bet)
Seat 3: thecurv folded before Flop (didn't bet)
Seat 4: vanilica folded before Flop (didn't bet)
Seat 5: Eskimo Fox folded before Flop (didn't bet)
Seat 6: stds st folded before Flop (didn't bet)
Seat 7: chenlongn folded on the Flop
Seat 8: matiko09 (button) collected ($6.18)
Seat 9: Soundust_007 (small blind) folded before Flop





PokerStars Hand #154364177871:  Hold'em No Limit ($0.50/$1.00 USD) - 2016/06/06 13:26:30 CET [2016/06/06 7:26:30 ET]
Table 'Sheliak' 9-max Seat #7 is the button
Seat 1: 32rrew ($102.50 in chips) 
Seat 2: DancerNN1 ($105.24 in chips) 
Seat 3: xxxZeka ($120.80 in chips) 
Seat 4: iRLM ($67.75 in chips) 
Seat 6: matiko09 ($109.99 in chips) 
Seat 7: stds st ($44.64 in chips) 
Seat 8: ozone2003 ($100 in chips) 
Seat 9: ipashutapkom ($49 in chips) 
ozone2003: posts small blind $0.50
ipashutapkom: posts big blind $1
*** HOLE CARDS ***
Dealt to matiko09 [6s Qh]
32rrew: folds 
DancerNN1: folds 
xxxZeka: folds 
iRLM: folds 
matiko09: folds 
stds st: raises $1.02 to $2.02
ozone2003: raises $3.98 to $6
ipashutapkom: folds 
iRLM leaves the table
stds st: folds 
Uncalled bet ($3.98) returned to ozone2003
hurtNCYDE joins the table at seat #4 
ozone2003 collected $5.04 from pot
ozone2003: doesn't show hand 
*** SUMMARY ***
Total pot $5.04 | Rake $0 
Seat 1: 32rrew folded before Flop (didn't bet)
Seat 2: DancerNN1 folded before Flop (didn't bet)
Seat 3: xxxZeka folded before Flop (didn't bet)
Seat 4: iRLM folded before Flop (didn't bet)
Seat 6: matiko09 folded before Flop (didn't bet)
Seat 7: stds st (button) folded before Flop
Seat 8: ozone2003 (small blind) collected ($5.04)
Seat 9: ipashutapkom (big blind) folded before Flop





PokerStars Hand #154364179905:  Hold'em No Limit ($0.50/$1.00 USD) - 2016/06/06 13:26:35 CET [2016/06/06 7:26:35 ET]
Table 'Wezen II' 9-max Seat #3 is the button
Seat 1: matiko09 ($100 in chips) 
Seat 2: Mr.Grigoriy ($111.12 in chips) 
Seat 3: Dickyxxx ($100 in chips) 
Seat 4: xxxibgdrgn ($196.50 in chips) 
Seat 5: stds st ($41.33 in chips) 
Seat 6: Eskimo Fox ($103 in chips) 
Seat 7: KDJAll3 ($79.08 in chips) 
Seat 8: o.miro ($105 in chips) 
Seat 9: Cogss ($107.70 in chips) 
xxxibgdrgn: posts small blind $0.50
stds st: posts big blind $1
*** HOLE CARDS ***
Dealt to matiko09 [2s 9s]
Eskimo Fox: folds 
KDJAll3: folds 
o.miro: folds 
Cogss: folds 
matiko09: folds 
Mr.Grigoriy: folds 
Dickyxxx: folds 
xxxibgdrgn: folds 
Uncalled bet ($0.50) returned to stds st
stds st collected $1 from pot
stds st: doesn't show hand 
*** SUMMARY ***
Total pot $1 | Rake $0 
Seat 1: matiko09 folded before Flop (didn't bet)
Seat 2: Mr.Grigoriy folded before Flop (didn't bet)
Seat 3: Dickyxxx (button) folded before Flop (didn't bet)
Seat 4: xxxibgdrgn (small blind) folded before Flop
Seat 5: stds st (big blind) collected ($1)
Seat 6: Eskimo Fox folded before Flop (didn't bet)
Seat 7: KDJAll3 folded before Flop (didn't bet)
Seat 8: o.miro folded before Flop (didn't bet)
Seat 9: Cogss folded before Flop (didn't bet)





PokerStars Hand #154364183519:  Hold'em No Limit ($0.50/$1.00 USD) - 2016/06/06 13:26:43 CET [2016/06/06 7:26:43 ET]
Table 'Heze' 9-max Seat #4 is the button
Seat 1: matiko09 ($171.67 in chips) 
Seat 2: xxxibgdrgn ($100 in chips) 
Seat 3: Dickyxxx ($103.18 in chips) 
Seat 4: Eskimo Fox ($100 in chips) 
Seat 5: stds st ($37 in chips) 
Seat 6: yfcq36 ($140.95 in chips) 
Seat 7: 32rrew ($158.97 in chips) 
Seat 8: PacPacBum ($118.20 in chips) 
Seat 9: Mr.Grigoriy ($130.71 in chips) 
stds st: posts small blind $0.50
yfcq36: posts big blind $1
*** HOLE CARDS ***
Dealt to matiko09 [5c 6h]
32rrew: folds 
PacPacBum: folds 
Mr.Grigoriy: folds 
matiko09: folds 
xxxibgdrgn: raises $2 to $3
Dickyxxx: folds 
Eskimo Fox: folds 
stds st: folds 
yfcq36: folds 
Uncalled bet ($2) returned to xxxibgdrgn
xxxibgdrgn collected $2.50 from pot
xxxibgdrgn: doesn't show hand 
*** SUMMARY ***
Total pot $2.50 | Rake $0 
Seat 1: matiko09 folded before Flop (didn't bet)
Seat 2: xxxibgdrgn collected ($2.50)
Seat 3: Dickyxxx folded before Flop (didn't bet)
Seat 4: Eskimo Fox (button) folded before Flop (didn't bet)
Seat 5: stds st (small blind) folded before Flop
Seat 6: yfcq36 (big blind) folded before Flop
Seat 7: 32rrew folded before Flop (didn't bet)
Seat 8: PacPacBum folded before Flop (didn't bet)
Seat 9: Mr.Grigoriy folded before Flop (didn't bet)





PokerStars Hand #154364183887:  Hold'em No Limit ($0.50/$1.00 USD) - 2016/06/06 13:26:44 CET [2016/06/06 7:26:44 ET]
Table 'Williams' 9-max Seat #8 is the button
Seat 1: xhinostrabli ($82 in chips) 
Seat 2: matiko09 ($174.51 in chips) 
Seat 3: granbunny ($69.56 in chips) 
Seat 4: Mr.Grigoriy ($106.12 in chips) 
Seat 5: xxxibgdrgn ($100 in chips) 
Seat 6: xxxZeka ($126.38 in chips) 
Seat 7: Eskimo Fox ($117.94 in chips) 
Seat 8: Dickyxxx ($104 in chips) 
Seat 9: stds st ($67.76 in chips) 
stds st: posts small blind $0.50
xhinostrabli: posts big blind $1
*** HOLE CARDS ***
Dealt to matiko09 [Js 9h]
matiko09: folds 
granbunny: raises $2 to $3
Mr.Grigoriy: folds 
xxxibgdrgn: folds 
xxxZeka: calls $3
Eskimo Fox: folds 
Dickyxxx: folds 
stds st: folds 
xhinostrabli: folds 
*** FLOP *** [7c Jc 8d]
granbunny: checks 
xxxZeka: checks 
*** TURN *** [7c Jc 8d] [6c]
granbunny: bets $6
xxxZeka: raises $12.74 to $18.74
granbunny: folds 
Uncalled bet ($12.74) returned to xxxZeka
xxxZeka collected $18.52 from pot
*** SUMMARY ***
Total pot $19.50 | Rake $0.98 
Board [7c Jc 8d 6c]
Seat 1: xhinostrabli (big blind) folded before Flop
Seat 2: matiko09 folded before Flop (didn't bet)
Seat 3: granbunny folded on the Turn
Seat 4: Mr.Grigoriy folded before Flop (didn't bet)
Seat 5: xxxibgdrgn folded before Flop (didn't bet)
Seat 6: xxxZeka collected ($18.52)
Seat 7: Eskimo Fox folded before Flop (didn't bet)
Seat 8: Dickyxxx (button) folded before Flop (didn't bet)
Seat 9: stds st (small blind) folded before Flop





PokerStars Hand #154364184145:  Hold'em No Limit ($0.50/$1.00 USD) - 2016/06/06 13:26:44 CET [2016/06/06 7:26:44 ET]
Table 'Smither' 9-max Seat #8 is the button
Seat 1: PacPacBum ($171.80 in chips) 
Seat 2: matiko09 ($101.50 in chips) 
Seat 3: stds st ($37 in chips) 
Seat 4: Dantist1122 ($100 in chips) 
Seat 6: mooose100 ($89.70 in chips) 
Seat 7: vanilica ($126.05 in chips) 
Seat 8: ozone2003 ($100 in chips) 
PacPacBum: posts small blind $0.50
matiko09: posts big blind $1
Dickyxxx: sits out 
*** HOLE CARDS ***
Dealt to matiko09 [7d 6h]
stds st: folds 
Dantist1122: raises $2 to $3
mooose100: folds 
vanilica: folds 
ozone2003: folds 
PacPacBum: folds 
matiko09: folds 
Uncalled bet ($2) returned to Dantist1122
Dantist1122 collected $2.50 from pot
Dantist1122: doesn't show hand 
*** SUMMARY ***
Total pot $2.50 | Rake $0 
Seat 1: PacPacBum (small blind) folded before Flop
Seat 2: matiko09 (big blind) folded before Flop
Seat 3: stds st folded before Flop (didn't bet)
Seat 4: Dantist1122 collected ($2.50)
Seat 6: mooose100 folded before Flop (didn't bet)
Seat 7: vanilica folded before Flop (didn't bet)
Seat 8: ozone2003 (button) folded before Flop (didn't bet)





PokerStars Hand #154364187986:  Hold'em No Limit ($0.50/$1.00 USD) - 2016/06/06 13:26:53 CET [2016/06/06 7:26:53 ET]
Table 'Safara' 9-max Seat #4 is the button
Seat 1: Dickyxxx ($100 in chips) 
Seat 2: ozone2003 ($100 in chips) 
Seat 3: erd33 ($163.43 in chips) 
Seat 4: xxxibgdrgn ($102.38 in chips) 
Seat 5: perezzi10 ($44.40 in chips) 
Seat 6: matiko09 ($133.28 in chips) 
Seat 7: PacPacBum ($122.53 in chips) 
Seat 8: o.miro ($150.23 in chips) 
Seat 9: R1aki ($102.72 in chips) 
perezzi10: posts small blind $0.50
matiko09: posts big blind $1
*** HOLE CARDS ***
Dealt to matiko09 [Kh Ad]
PacPacBum: raises $1.04 to $2.04
o.miro: folds 
R1aki: folds 
Dickyxxx: raises $5.96 to $8
ozone2003: folds 
erd33: folds 
xxxibgdrgn: folds 
perezzi10: folds 
matiko09: folds 
PacPacBum: folds 
Uncalled bet ($5.96) returned to Dickyxxx
Dickyxxx collected $5.58 from pot
Dickyxxx: doesn't show hand 
*** SUMMARY ***
Total pot $5.58 | Rake $0 
Seat 1: Dickyxxx collected ($5.58)
Seat 2: ozone2003 folded before Flop (didn't bet)
Seat 3: erd33 folded before Flop (didn't bet)
Seat 4: xxxibgdrgn (button) folded before Flop (didn't bet)
Seat 5: perezzi10 (small blind) folded before Flop
Seat 6: matiko09 (big blind) folded before Flop
Seat 7: PacPacBum folded before Flop
Seat 8: o.miro folded before Flop (didn't bet)
Seat 9: R1aki folded before Flop (didn't bet)





PokerStars Hand #154364192326:  Hold'em No Limit ($0.50/$1.00 USD) - 2016/06/06 13:27:03 CET [2016/06/06 7:27:03 ET]
Table 'Chaldaea II' 9-max Seat #5 is the button
Seat 2: Mr.Grigoriy ($102.50 in chips) 
Seat 4: mooose100 ($144.71 in chips) 
Seat 5: stds st ($38.50 in chips) 
Seat 6: PacPacBum ($109.86 in chips) 
Seat 7: xxxibgdrgn ($106.02 in chips) 
Seat 8: 32rrew ($101 in chips) 
Seat 9: matiko09 ($101.50 in chips) 
PacPacBum: posts small blind $0.50
xxxibgdrgn: posts big blind $1
ozone2003: sits out 
*** HOLE CARDS ***
Dealt to matiko09 [5h 5s]
32rrew: folds 
matiko09: raises $2 to $3
Mr.Grigoriy: folds 
mooose100: folds 
stds st: calls $3
PacPacBum: folds 
xxxibgdrgn: folds 
*** FLOP *** [9d Ks 4h]
matiko09: checks 
stds st: bets $3.91
matiko09: calls $3.91
*** TURN *** [9d Ks 4h] [3h]
matiko09: checks 
stds st: checks 
*** RIVER *** [9d Ks 4h 3h] [5c]
matiko09: bets $9
stds st: folds 
Uncalled bet ($9) returned to matiko09
matiko09 collected $14.55 from pot
matiko09: doesn't show hand 
*** SUMMARY ***
Total pot $15.32 | Rake $0.77 
Board [9d Ks 4h 3h 5c]
Seat 2: Mr.Grigoriy folded before Flop (didn't bet)
Seat 4: mooose100 folded before Flop (didn't bet)
Seat 5: stds st (button) folded on the River
Seat 6: PacPacBum (small blind) folded before Flop
Seat 7: xxxibgdrgn (big blind) folded before Flop
Seat 8: 32rrew folded before Flop (didn't bet)
Seat 9: matiko09 collected ($14.55)





PokerStars Hand #154364192153:  Hold'em No Limit ($0.50/$1.00 USD) - 2016/06/06 13:27:03 CET [2016/06/06 7:27:03 ET]
Table 'Wezen II' 9-max Seat #4 is the button
Seat 1: matiko09 ($100 in chips) 
Seat 2: Mr.Grigoriy ($111.12 in chips) 
Seat 3: Dickyxxx ($100 in chips) 
Seat 4: xxxibgdrgn ($196 in chips) 
Seat 5: stds st ($41.83 in chips) 
Seat 6: Eskimo Fox ($103 in chips) 
Seat 7: KDJAll3 ($79.08 in chips) 
Seat 8: o.miro ($105 in chips) 
Seat 9: Cogss ($107.70 in chips) 
stds st: posts small blind $0.50
Eskimo Fox: posts big blind $1
*** HOLE CARDS ***
Dealt to matiko09 [Jh 6c]
KDJAll3: folds 
o.miro: folds 
Cogss: calls $1
matiko09: folds 
Mr.Grigoriy: folds 
Dickyxxx: folds 
xxxibgdrgn: raises $3 to $4
stds st: folds 
Eskimo Fox: folds 
Cogss: folds 
Uncalled bet ($3) returned to xxxibgdrgn
xxxibgdrgn collected $3.50 from pot
xxxibgdrgn: doesn't show hand 
*** SUMMARY ***
Total pot $3.50 | Rake $0 
Seat 1: matiko09 folded before Flop (didn't bet)
Seat 2: Mr.Grigoriy folded before Flop (didn't bet)
Seat 3: Dickyxxx folded before Flop (didn't bet)
Seat 4: xxxibgdrgn (button) collected ($3.50)
Seat 5: stds st (small blind) folded before Flop
Seat 6: Eskimo Fox (big blind) folded before Flop
Seat 7: KDJAll3 folded before Flop (didn't bet)
Seat 8: o.miro folded before Flop (didn't bet)
Seat 9: Cogss folded before Flop





PokerStars Hand #154364196242:  Hold'em No Limit ($0.50/$1.00 USD) - 2016/06/06 13:27:12 CET [2016/06/06 7:27:12 ET]
Table 'Sheliak' 9-max Seat #8 is the button
Seat 1: 32rrew ($102.50 in chips) 
Seat 2: DancerNN1 ($105.24 in chips) 
Seat 3: xxxZeka ($120.80 in chips) 
Seat 6: matiko09 ($109.99 in chips) 
Seat 7: stds st ($42.62 in chips) 
Seat 8: ozone2003 ($103.02 in chips) 
Seat 9: ipashutapkom ($48 in chips) 
ipashutapkom: posts small blind $0.50
32rrew: posts big blind $1
*** HOLE CARDS ***
Dealt to matiko09 [5h 9c]
hurtNCYDE leaves the table
DancerNN1: folds 
Dickyxxx joins the table at seat #4 
DancerNN1 leaves the table
xxxZeka: folds 
matiko09: folds 
stds st: folds 
ozone2003: raises $1.20 to $2.20
ipashutapkom: folds 
32rrew: calls $1.20
*** FLOP *** [Jh 8s Jc]
32rrew: checks 
ozone2003: checks 
*** TURN *** [Jh 8s Jc] [3h]
32rrew: checks 
ozone2003: checks 
*** RIVER *** [Jh 8s Jc 3h] [Ah]
32rrew: checks 
ozone2003: bets $2.94
32rrew: calls $2.94
*** SHOW DOWN ***
ozone2003: shows [Th 8h] (a flush, Ace high)
32rrew: mucks hand 
ozone2003 collected $10.24 from pot
*** SUMMARY ***
Total pot $10.78 | Rake $0.54 
Board [Jh 8s Jc 3h Ah]
Seat 1: 32rrew (big blind) mucked [Ac 5c]
Seat 2: DancerNN1 folded before Flop (didn't bet)
Seat 3: xxxZeka folded before Flop (didn't bet)
Seat 6: matiko09 folded before Flop (didn't bet)
Seat 7: stds st folded before Flop (didn't bet)
Seat 8: ozone2003 (button) showed [Th 8h] and won ($10.24) with a flush, Ace high
Seat 9: ipashutapkom (small blind) folded before Flop





PokerStars Hand #154364197501:  Hold'em No Limit ($0.50/$1.00 USD) - 2016/06/06 13:27:15 CET [2016/06/06 7:27:15 ET]
Table 'Heze' 9-max Seat #5 is the button
Seat 1: matiko09 ($171.67 in chips) 
Seat 2: xxxibgdrgn ($101.50 in chips) 
Seat 3: Dickyxxx ($103.18 in chips) 
Seat 4: Eskimo Fox ($100 in chips) 
Seat 5: stds st ($36.50 in chips) 
Seat 6: yfcq36 ($139.95 in chips) 
Seat 7: 32rrew ($158.97 in chips) 
Seat 8: PacPacBum ($118.20 in chips) 
Seat 9: Mr.Grigoriy ($130.71 in chips) 
yfcq36: posts small blind $0.50
32rrew: posts big blind $1
*** HOLE CARDS ***
Dealt to matiko09 [5s Qc]
PacPacBum: folds 
Mr.Grigoriy: folds 
matiko09: folds 
xxxibgdrgn: folds 
Dickyxxx: folds 
Eskimo Fox: folds 
stds st: raises $1.02 to $2.02
yfcq36: folds 
32rrew: folds 
Uncalled bet ($1.02) returned to stds st
stds st collected $2.50 from pot
stds st: doesn't show hand 
*** SUMMARY ***
Total pot $2.50 | Rake $0 
Seat 1: matiko09 folded before Flop (didn't bet)
Seat 2: xxxibgdrgn folded before Flop (didn't bet)
Seat 3: Dickyxxx folded before Flop (didn't bet)
Seat 4: Eskimo Fox folded before Flop (didn't bet)
Seat 5: stds st (button) collected ($2.50)
Seat 6: yfcq36 (small blind) folded before Flop
Seat 7: 32rrew (big blind) folded before Flop
Seat 8: PacPacBum folded before Flop (didn't bet)
Seat 9: Mr.Grigoriy folded before Flop (didn't bet)





PokerStars Hand #154364203140:  Hold'em No Limit (€0.50/€1.00 EUR) - 2016/06/06 13:27:28 CET [2016/06/06 7:27:28 ET]
Table 'Lesath' 9-max Seat #1 is the button
Seat 1: o.miro (€111.90 in chips) 
Seat 2: thecurv (€106.82 in chips) 
Seat 3: ozone2003 (€201.14 in chips) 
Seat 5: matiko09 (€113.47 in chips) 
Seat 7: Mr.Grigoriy (€100 in chips) 
Seat 8: stds st (€62.36 in chips) 
Seat 9: 72nloses (€39.34 in chips) 
thecurv: posts small blind €0.50
ozone2003: posts big blind €1
Dickyxxx: sits out 
*** HOLE CARDS ***
Dealt to matiko09 [4d Jh]
matiko09: folds 
Mr.Grigoriy: folds 
stds st: folds 
72nloses: raises €38.34 to €39.34 and is all-in
o.miro: folds 
thecurv: folds 
ozone2003: folds 
Uncalled bet (€38.34) returned to 72nloses
72nloses collected €2.50 from pot
*** SUMMARY ***
Total pot €2.50 | Rake €0 
Seat 1: o.miro (button) folded before Flop (didn't bet)
Seat 2: thecurv (small blind) folded before Flop
Seat 3: ozone2003 (big blind) folded before Flop
Seat 5: matiko09 folded before Flop (didn't bet)
Seat 7: Mr.Grigoriy folded before Flop (didn't bet)
Seat 8: stds st folded before Flop (didn't bet)
Seat 9: 72nloses collected (€2.50)





PokerStars Hand #154364203460:  Hold'em No Limit ($0.50/$1.00 USD) - 2016/06/06 13:27:29 CET [2016/06/06 7:27:29 ET]
Table 'Smither' 9-max Seat #1 is the button
Seat 1: PacPacBum ($171.30 in chips) 
Seat 2: matiko09 ($100.50 in chips) 
Seat 3: stds st ($37 in chips) 
Seat 4: Dantist1122 ($101.50 in chips) 
Seat 6: mooose100 ($89.70 in chips) 
Seat 7: vanilica ($126.05 in chips) 
Seat 8: ozone2003 ($100 in chips) 
matiko09: posts small blind $0.50
stds st: posts big blind $1
Dickyxxx: sits out 
*** HOLE CARDS ***
Dealt to matiko09 [Th 5c]
Dantist1122: folds 
Dantist1122 leaves the table
Mr.Grigoriy joins the table at seat #4 
mooose100: calls $1
vanilica: folds 
ozone2003: folds 
PacPacBum: raises $3 to $4
matiko09: folds 
stds st: folds 
mooose100: calls $3
*** FLOP *** [7c Qs 3s]
mooose100: checks 
PacPacBum: checks 
*** TURN *** [7c Qs 3s] [6c]
mooose100: bets $4.51
PacPacBum: folds 
Uncalled bet ($4.51) returned to mooose100
mooose100 collected $9.02 from pot
mooose100: doesn't show hand 
*** SUMMARY ***
Total pot $9.50 | Rake $0.48 
Board [7c Qs 3s 6c]
Seat 1: PacPacBum (button) folded on the Turn
Seat 2: matiko09 (small blind) folded before Flop
Seat 3: stds st (big blind) folded before Flop
Seat 4: Dantist1122 folded before Flop (didn't bet)
Seat 6: mooose100 collected ($9.02)
Seat 7: vanilica folded before Flop (didn't bet)
Seat 8: ozone2003 folded before Flop (didn't bet)





PokerStars Hand #154364210054:  Hold'em No Limit ($0.50/$1.00 USD) - 2016/06/06 13:27:44 CET [2016/06/06 7:27:44 ET]
Table 'Oppavia' 9-max Seat #9 is the button
Seat 1: xxxZeka ($100 in chips) 
Seat 2: o.miro ($101.50 in chips) 
Seat 3: thecurv ($126 in chips) 
Seat 4: vanilica ($113.23 in chips) 
Seat 5: Eskimo Fox ($100 in chips) 
Seat 6: stds st ($44.50 in chips) 
Seat 7: chenlongn ($76.50 in chips) 
Seat 8: matiko09 ($104.18 in chips) 
Seat 9: Soundust_007 ($36 in chips) 
xxxZeka: posts small blind $0.50
o.miro: posts big blind $1
*** HOLE CARDS ***
Dealt to matiko09 [3s 2s]
thecurv: folds 
vanilica: folds 
Eskimo Fox: raises $2 to $3
stds st: folds 
chenlongn: folds 
matiko09: folds 
Soundust_007: raises $33 to $36 and is all-in
xxxZeka: folds 
o.miro: folds 
Eskimo Fox: calls $33
*** FLOP *** [3c Jh 3d]
*** TURN *** [3c Jh 3d] [Qs]
*** RIVER *** [3c Jh 3d Qs] [5d]
*** SHOW DOWN ***
Eskimo Fox: shows [As Kd] (a pair of Threes)
Soundust_007: shows [Tc Ts] (two pair, Tens and Threes)
Soundust_007 collected $71 from pot
*** SUMMARY ***
Total pot $73.50 | Rake $2.50 
Board [3c Jh 3d Qs 5d]
Seat 1: xxxZeka (small blind) folded before Flop
Seat 2: o.miro (big blind) folded before Flop
Seat 3: thecurv folded before Flop (didn't bet)
Seat 4: vanilica folded before Flop (didn't bet)
Seat 5: Eskimo Fox showed [As Kd] and lost with a pair of Threes
Seat 6: stds st folded before Flop (didn't bet)
Seat 7: chenlongn folded before Flop (didn't bet)
Seat 8: matiko09 folded before Flop (didn't bet)
Seat 9: Soundust_007 (button) showed [Tc Ts] and won ($71) with two pair, Tens and Threes





PokerStars Hand #154364214078:  Hold'em No Limit ($0.50/$1.00 USD) - 2016/06/06 13:27:53 CET [2016/06/06 7:27:53 ET]
Table 'Gajdariya' 9-max Seat #7 is the button
Seat 1: matiko09 ($135.09 in chips) 
Seat 2: Dickyxxx ($107.52 in chips) 
Seat 3: mooose100 ($98.92 in chips) 
Seat 5: stds st ($64.83 in chips) 
Seat 6: vanilica ($100 in chips) 
Seat 7: hurtNCYDE ($110.59 in chips) 
Seat 8: Mr.Grigoriy ($173.91 in chips) 
Seat 9: PacPacBum ($111.73 in chips) 
Mr.Grigoriy: posts small blind $0.50
PacPacBum: posts big blind $1
ozone2003: sits out 
*** HOLE CARDS ***
Dealt to matiko09 [Jh 3h]
matiko09: folds 
Dickyxxx: raises $2 to $3
mooose100: folds 
stds st: folds 
vanilica: folds 
hurtNCYDE: folds 
Mr.Grigoriy: calls $2.50
PacPacBum: folds 
*** FLOP *** [Jc 2s Tc]
Mr.Grigoriy: checks 
Dickyxxx: bets $4.25
Mr.Grigoriy: raises $9.25 to $13.50
Dickyxxx: calls $9.25
*** TURN *** [Jc 2s Tc] [Qs]
Mr.Grigoriy: checks 
Dickyxxx: checks 
*** RIVER *** [Jc 2s Tc Qs] [Ad]
Mr.Grigoriy: checks 
Dickyxxx: bets $16.79
Mr.Grigoriy: folds 
Uncalled bet ($16.79) returned to Dickyxxx
Dickyxxx collected $32.30 from pot
Dickyxxx: doesn't show hand 
*** SUMMARY ***
Total pot $34 | Rake $1.70 
Board [Jc 2s Tc Qs Ad]
Seat 1: matiko09 folded before Flop (didn't bet)
Seat 2: Dickyxxx collected ($32.30)
Seat 3: mooose100 folded before Flop (didn't bet)
Seat 5: stds st folded before Flop (didn't bet)
Seat 6: vanilica folded before Flop (didn't bet)
Seat 7: hurtNCYDE (button) folded before Flop (didn't bet)
Seat 8: Mr.Grigoriy (small blind) folded on the River
Seat 9: PacPacBum (big blind) folded before Flop





PokerStars Hand #154364215130:  Hold'em No Limit ($0.50/$1.00 USD) - 2016/06/06 13:27:55 CET [2016/06/06 7:27:55 ET]
Table 'Safara' 9-max Seat #5 is the button
Seat 1: Dickyxxx ($103.54 in chips) 
Seat 2: ozone2003 ($100 in chips) 
Seat 3: erd33 ($163.43 in chips) 
Seat 4: xxxibgdrgn ($102.38 in chips) 
Seat 5: perezzi10 ($43.90 in chips) 
Seat 6: matiko09 ($132.28 in chips) 
Seat 7: PacPacBum ($120.49 in chips) 
Seat 8: o.miro ($150.23 in chips) 
Seat 9: R1aki ($102.72 in chips) 
matiko09: posts small blind $0.50
PacPacBum: posts big blind $1
*** HOLE CARDS ***
Dealt to matiko09 [5h 2h]
o.miro: folds 
R1aki: folds 
Dickyxxx: folds 
ozone2003: folds 
erd33: folds 
xxxibgdrgn: folds 
perezzi10: folds 
matiko09: folds 
Uncalled bet ($0.50) returned to PacPacBum
PacPacBum collected $1 from pot
PacPacBum: doesn't show hand 
*** SUMMARY ***
Total pot $1 | Rake $0 
Seat 1: Dickyxxx folded before Flop (didn't bet)
Seat 2: ozone2003 folded before Flop (didn't bet)
Seat 3: erd33 folded before Flop (didn't bet)
Seat 4: xxxibgdrgn folded before Flop (didn't bet)
Seat 5: perezzi10 (button) folded before Flop (didn't bet)
Seat 6: matiko09 (small blind) folded before Flop
Seat 7: PacPacBum (big blind) collected ($1)
Seat 8: o.miro folded before Flop (didn't bet)
Seat 9: R1aki folded before Flop (didn't bet)





PokerStars Hand #154364215132:  Hold'em No Limit ($0.50/$1.00 USD) - 2016/06/06 13:27:55 CET [2016/06/06 7:27:55 ET]
Table 'Wezen II' 9-max Seat #5 is the button
Seat 1: matiko09 ($100 in chips) 
Seat 2: Mr.Grigoriy ($111.12 in chips) 
Seat 3: Dickyxxx ($100 in chips) 
Seat 4: xxxibgdrgn ($198.50 in chips) 
Seat 5: stds st ($41.33 in chips) 
Seat 6: Eskimo Fox ($102 in chips) 
Seat 7: KDJAll3 ($79.08 in chips) 
Seat 8: o.miro ($105 in chips) 
Seat 9: Cogss ($106.70 in chips) 
Eskimo Fox: posts small blind $0.50
KDJAll3: posts big blind $1
*** HOLE CARDS ***
Dealt to matiko09 [Kh 5d]
o.miro: raises $2 to $3
Cogss: folds 
matiko09: folds 
Mr.Grigoriy: folds 
Dickyxxx: folds 
xxxibgdrgn: folds 
stds st: folds 
Eskimo Fox: calls $2.50
KDJAll3: folds 
*** FLOP *** [Kc Ts Kd]
Eskimo Fox: checks 
o.miro: bets $2.26
Eskimo Fox: folds 
Uncalled bet ($2.26) returned to o.miro
o.miro collected $6.65 from pot
o.miro: doesn't show hand 
*** SUMMARY ***
Total pot $7 | Rake $0.35 
Board [Kc Ts Kd]
Seat 1: matiko09 folded before Flop (didn't bet)
Seat 2: Mr.Grigoriy folded before Flop (didn't bet)
Seat 3: Dickyxxx folded before Flop (didn't bet)
Seat 4: xxxibgdrgn folded before Flop (didn't bet)
Seat 5: stds st (button) folded before Flop (didn't bet)
Seat 6: Eskimo Fox (small blind) folded on the Flop
Seat 7: KDJAll3 (big blind) folded before Flop
Seat 8: o.miro collected ($6.65)
Seat 9: Cogss folded before Flop (didn't bet)





PokerStars Hand #154364217751:  Hold'em No Limit ($0.50/$1.00 USD) - 2016/06/06 13:28:01 CET [2016/06/06 7:28:01 ET]
Table 'Irmgard II' 9-max Seat #4 is the button
Seat 3: stds st ($37.37 in chips) 
Seat 4: Dickyxxx ($100 in chips) 
Seat 7: 32rrew ($146.08 in chips) 
Seat 8: matiko09 ($152.31 in chips) 
Seat 9: PacPacBum ($104.42 in chips) 
32rrew: posts small blind $0.50
matiko09: posts big blind $1
*** HOLE CARDS ***
Dealt to matiko09 [Ah 2c]
PacPacBum: folds 
Dantist1122 leaves the table
stds st: folds 
Dickyxxx: raises $2 to $3
32rrew: folds 
matiko09: folds 
Uncalled bet ($2) returned to Dickyxxx
Dickyxxx collected $2.50 from pot
Dickyxxx: doesn't show hand 
*** SUMMARY ***
Total pot $2.50 | Rake $0 
Seat 3: stds st folded before Flop (didn't bet)
Seat 4: Dickyxxx (button) collected ($2.50)
Seat 7: 32rrew (small blind) folded before Flop
Seat 8: matiko09 (big blind) folded before Flop
Seat 9: PacPacBum folded before Flop (didn't bet)





PokerStars Hand #154364219220:  Hold'em No Limit ($0.50/$1.00 USD) - 2016/06/06 13:28:05 CET [2016/06/06 7:28:05 ET]
Table 'Heze' 9-max Seat #6 is the button
Seat 1: matiko09 ($171.67 in chips) 
Seat 2: xxxibgdrgn ($101.50 in chips) 
Seat 3: Dickyxxx ($103.18 in chips) 
Seat 4: Eskimo Fox ($100 in chips) 
Seat 5: stds st ($38 in chips) 
Seat 6: yfcq36 ($139.45 in chips) 
Seat 7: 32rrew ($157.97 in chips) 
Seat 8: PacPacBum ($118.20 in chips) 
Seat 9: Mr.Grigoriy ($130.71 in chips) 
32rrew: posts small blind $0.50
PacPacBum: posts big blind $1
*** HOLE CARDS ***
Dealt to matiko09 [6h Kd]
Mr.Grigoriy: folds 
matiko09: folds 
xxxibgdrgn: raises $2 to $3
Dickyxxx: raises $6 to $9
Eskimo Fox: folds 
stds st: folds 
yfcq36: folds 
32rrew: folds 
PacPacBum: folds 
xxxibgdrgn: folds 
Uncalled bet ($6) returned to Dickyxxx
Dickyxxx collected $7.50 from pot
Dickyxxx: doesn't show hand 
*** SUMMARY ***
Total pot $7.50 | Rake $0 
Seat 1: matiko09 folded before Flop (didn't bet)
Seat 2: xxxibgdrgn folded before Flop
Seat 3: Dickyxxx collected ($7.50)
Seat 4: Eskimo Fox folded before Flop (didn't bet)
Seat 5: stds st folded before Flop (didn't bet)
Seat 6: yfcq36 (button) folded before Flop (didn't bet)
Seat 7: 32rrew (small blind) folded before Flop
Seat 8: PacPacBum (big blind) folded before Flop
Seat 9: Mr.Grigoriy folded before Flop (didn't bet)





PokerStars Hand #154364220441:  Hold'em No Limit ($0.50/$1.00 USD) - 2016/06/06 13:28:08 CET [2016/06/06 7:28:08 ET]
Table 'Williams' 9-max Seat #9 is the button
Seat 1: xhinostrabli ($81 in chips) 
Seat 2: matiko09 ($174.51 in chips) 
Seat 3: granbunny ($60.56 in chips) 
Seat 4: Mr.Grigoriy ($106.12 in chips) 
Seat 5: xxxibgdrgn ($100 in chips) 
Seat 6: xxxZeka ($135.90 in chips) 
Seat 7: Eskimo Fox ($117.94 in chips) 
Seat 8: Dickyxxx ($104 in chips) 
Seat 9: stds st ($67.26 in chips) 
xhinostrabli: posts small blind $0.50
matiko09: posts big blind $1
*** HOLE CARDS ***
Dealt to matiko09 [4h Js]
granbunny: folds 
Mr.Grigoriy: folds 
xxxibgdrgn: folds 
xxxZeka: folds 
Eskimo Fox: folds 
Dickyxxx: folds 
stds st: folds 
xhinostrabli: folds 
Uncalled bet ($0.50) returned to matiko09
matiko09 collected $1 from pot
matiko09: doesn't show hand 
*** SUMMARY ***
Total pot $1 | Rake $0 
Seat 1: xhinostrabli (small blind) folded before Flop
Seat 2: matiko09 (big blind) collected ($1)
Seat 3: granbunny folded before Flop (didn't bet)
Seat 4: Mr.Grigoriy folded before Flop (didn't bet)
Seat 5: xxxibgdrgn folded before Flop (didn't bet)
Seat 6: xxxZeka folded before Flop (didn't bet)
Seat 7: Eskimo Fox folded before Flop (didn't bet)
Seat 8: Dickyxxx folded before Flop (didn't bet)
Seat 9: stds st (button) folded before Flop (didn't bet)





PokerStars Hand #154364223819:  Hold'em No Limit ($0.50/$1.00 USD) - 2016/06/06 13:28:15 CET [2016/06/06 7:28:15 ET]
Table 'Chaldaea II' 9-max Seat #6 is the button
Seat 2: Mr.Grigoriy ($102.50 in chips) 
Seat 4: mooose100 ($144.71 in chips) 
Seat 5: stds st ($31.59 in chips) 
Seat 6: PacPacBum ($109.36 in chips) 
Seat 7: xxxibgdrgn ($105.02 in chips) 
Seat 8: 32rrew ($101 in chips) 
Seat 9: matiko09 ($109.14 in chips) 
xxxibgdrgn: posts small blind $0.50
32rrew: posts big blind $1
ozone2003: sits out 
*** HOLE CARDS ***
Dealt to matiko09 [6h 7c]
matiko09: folds 
Mr.Grigoriy: folds 
mooose100: folds 
stds st: folds 
PacPacBum: folds 
xxxibgdrgn: folds 
Uncalled bet ($0.50) returned to 32rrew
32rrew collected $1 from pot
32rrew: doesn't show hand 
*** SUMMARY ***
Total pot $1 | Rake $0 
Seat 2: Mr.Grigoriy folded before Flop (didn't bet)
Seat 4: mooose100 folded before Flop (didn't bet)
Seat 5: stds st folded before Flop (didn't bet)
Seat 6: PacPacBum (button) folded before Flop (didn't bet)
Seat 7: xxxibgdrgn (small blind) folded before Flop
Seat 8: 32rrew (big blind) collected ($1)
Seat 9: matiko09 folded before Flop (didn't bet)





PokerStars Hand #154364225187:  Hold'em No Limit ($0.50/$1.00 USD) - 2016/06/06 13:28:18 CET [2016/06/06 7:28:18 ET]
Table 'Safara' 9-max Seat #6 is the button
Seat 1: Dickyxxx ($103.54 in chips) 
Seat 2: ozone2003 ($100 in chips) 
Seat 3: erd33 ($163.43 in chips) 
Seat 4: xxxibgdrgn ($102.38 in chips) 
Seat 5: perezzi10 ($43.90 in chips) 
Seat 6: matiko09 ($131.78 in chips) 
Seat 7: PacPacBum ($120.99 in chips) 
Seat 8: o.miro ($150.23 in chips) 
Seat 9: R1aki ($102.72 in chips) 
PacPacBum: posts small blind $0.50
o.miro: posts big blind $1
*** HOLE CARDS ***
Dealt to matiko09 [Js 8c]
R1aki: folds 
Dickyxxx: folds 
ozone2003: folds 
erd33: folds 
xxxibgdrgn: folds 
perezzi10: calls $1
matiko09: folds 
PacPacBum: folds 
o.miro: checks 
*** FLOP *** [Jc 6s 5h]
o.miro: checks 
perezzi10: checks 
*** TURN *** [Jc 6s 5h] [3c]
o.miro: checks 
perezzi10: checks 
*** RIVER *** [Jc 6s 5h 3c] [Qs]
o.miro: bets $2
perezzi10: folds 
Uncalled bet ($2) returned to o.miro
o.miro collected $2.38 from pot
o.miro: doesn't show hand 
*** SUMMARY ***
Total pot $2.50 | Rake $0.12 
Board [Jc 6s 5h 3c Qs]
Seat 1: Dickyxxx folded before Flop (didn't bet)
Seat 2: ozone2003 folded before Flop (didn't bet)
Seat 3: erd33 folded before Flop (didn't bet)
Seat 4: xxxibgdrgn folded before Flop (didn't bet)
Seat 5: perezzi10 folded on the River
Seat 6: matiko09 (button) folded before Flop (didn't bet)
Seat 7: PacPacBum (small blind) folded before Flop
Seat 8: o.miro (big blind) collected ($2.38)
Seat 9: R1aki folded before Flop (didn't bet)





PokerStars Hand #154364226608:  Hold'em No Limit ($0.50/$1.00 USD) - 2016/06/06 13:28:22 CET [2016/06/06 7:28:22 ET]
Table 'Oppavia' 9-max Seat #1 is the button
Seat 1: xxxZeka ($100 in chips) 
Seat 2: o.miro ($100.50 in chips) 
Seat 3: thecurv ($126 in chips) 
Seat 4: vanilica ($113.23 in chips) 
Seat 5: Eskimo Fox ($100 in chips) 
Seat 6: stds st ($44.50 in chips) 
Seat 7: chenlongn ($76.50 in chips) 
Seat 8: matiko09 ($104.18 in chips) 
Seat 9: Soundust_007 ($71 in chips) 
o.miro: posts small blind $0.50
thecurv: posts big blind $1
*** HOLE CARDS ***
Dealt to matiko09 [5s Kh]
vanilica: folds 
Eskimo Fox: folds 
stds st: folds 
chenlongn: folds 
matiko09: folds 
Soundust_007: folds 
xxxZeka: folds 
o.miro: folds 
Uncalled bet ($0.50) returned to thecurv
thecurv collected $1 from pot
thecurv: doesn't show hand 
*** SUMMARY ***
Total pot $1 | Rake $0 
Seat 1: xxxZeka (button) folded before Flop (didn't bet)
Seat 2: o.miro (small blind) folded before Flop
Seat 3: thecurv (big blind) collected ($1)
Seat 4: vanilica folded before Flop (didn't bet)
Seat 5: Eskimo Fox folded before Flop (didn't bet)
Seat 6: stds st folded before Flop (didn't bet)
Seat 7: chenlongn folded before Flop (didn't bet)
Seat 8: matiko09 folded before Flop (didn't bet)
Seat 9: Soundust_007 folded before Flop (didn't bet)





PokerStars Hand #154364229003:  Hold'em No Limit (€0.50/€1.00 EUR) - 2016/06/06 13:28:27 CET [2016/06/06 7:28:27 ET]
Table 'Lesath' 9-max Seat #2 is the button
Seat 1: o.miro (€111.90 in chips) 
Seat 2: thecurv (€106.32 in chips) 
Seat 3: ozone2003 (€200.14 in chips) 
Seat 5: matiko09 (€113.47 in chips) 
Seat 7: Mr.Grigoriy (€100 in chips) 
Seat 8: stds st (€62.36 in chips) 
Seat 9: 72nloses (€40.84 in chips) 
ozone2003: posts small blind €0.50
matiko09: posts big blind €1
Dickyxxx: sits out 
*** HOLE CARDS ***
Dealt to matiko09 [9h 8s]
Mr.Grigoriy: folds 
stds st: folds 
72nloses: folds 
o.miro: folds 
thecurv: folds 
ozone2003: raises €1.95 to €2.95
matiko09: folds 
Uncalled bet (€1.95) returned to ozone2003
ozone2003 collected €2 from pot
ozone2003: doesn't show hand 
*** SUMMARY ***
Total pot €2 | Rake €0 
Seat 1: o.miro folded before Flop (didn't bet)
Seat 2: thecurv (button) folded before Flop (didn't bet)
Seat 3: ozone2003 (small blind) collected (€2)
Seat 5: matiko09 (big blind) folded before Flop
Seat 7: Mr.Grigoriy folded before Flop (didn't bet)
Seat 8: stds st folded before Flop (didn't bet)
Seat 9: 72nloses folded before Flop (didn't bet)





PokerStars Hand #154364229781:  Hold'em No Limit ($0.50/$1.00 USD) - 2016/06/06 13:28:29 CET [2016/06/06 7:28:29 ET]
Table 'Irmgard II' 9-max Seat #7 is the button
Seat 3: stds st ($37.37 in chips) 
Seat 4: Dickyxxx ($101.50 in chips) 
Seat 7: 32rrew ($145.58 in chips) 
Seat 8: matiko09 ($151.31 in chips) 
Seat 9: PacPacBum ($104.42 in chips) 
matiko09: posts small blind $0.50
PacPacBum: posts big blind $1
*** HOLE CARDS ***
Dealt to matiko09 [Jh 3h]
stds st: folds 
Dickyxxx: folds 
32rrew: raises $1.50 to $2.50
matiko09: folds 
PacPacBum: raises $5.50 to $8
32rrew: calls $5.50
*** FLOP *** [Th 4s Kc]
PacPacBum: bets $8.46
32rrew: calls $8.46
*** TURN *** [Th 4s Kc] [Js]
PacPacBum: bets $17.14
32rrew: calls $17.14
*** RIVER *** [Th 4s Kc Js] [5s]
PacPacBum: bets $70.82 and is all-in
32rrew: calls $70.82
*** SHOW DOWN ***
PacPacBum: shows [Ks Qs] (a flush, King high)
32rrew: mucks hand 
PacPacBum collected $206.84 from pot
*** SUMMARY ***
Total pot $209.34 | Rake $2.50 
Board [Th 4s Kc Js 5s]
Seat 3: stds st folded before Flop (didn't bet)
Seat 4: Dickyxxx folded before Flop (didn't bet)
Seat 7: 32rrew (button) mucked [As Qd]
Seat 8: matiko09 (small blind) folded before Flop
Seat 9: PacPacBum (big blind) showed [Ks Qs] and won ($206.84) with a flush, King high





PokerStars Hand #154364234008:  Hold'em No Limit ($0.50/$1.00 USD) - 2016/06/06 13:28:38 CET [2016/06/06 7:28:38 ET]
Table 'Chaldaea II' 9-max Seat #7 is the button
Seat 2: Mr.Grigoriy ($102.50 in chips) 
Seat 4: mooose100 ($144.71 in chips) 
Seat 5: stds st ($31.59 in chips) 
Seat 6: PacPacBum ($109.36 in chips) 
Seat 7: xxxibgdrgn ($104.52 in chips) 
Seat 8: 32rrew ($101.50 in chips) 
Seat 9: matiko09 ($109.14 in chips) 
32rrew: posts small blind $0.50
matiko09: posts big blind $1
ozone2003: sits out 
*** HOLE CARDS ***
Dealt to matiko09 [Jh 6h]
Mr.Grigoriy: folds 
mooose100: calls $1
stds st: raises $2 to $3
PacPacBum: folds 
xxxibgdrgn: calls $3
32rrew: folds 
matiko09: folds 
mooose100: calls $2
*** FLOP *** [4d 3c Ks]
mooose100: checks 
stds st: checks 
xxxibgdrgn: checks 
*** TURN *** [4d 3c Ks] [Qd]
mooose100: checks 
stds st: bets $5.98
xxxibgdrgn: folds 
mooose100: folds 
Uncalled bet ($5.98) returned to stds st
stds st collected $9.98 from pot
stds st: doesn't show hand 
*** SUMMARY ***
Total pot $10.50 | Rake $0.52 
Board [4d 3c Ks Qd]
Seat 2: Mr.Grigoriy folded before Flop (didn't bet)
Seat 4: mooose100 folded on the Turn
Seat 5: stds st collected ($9.98)
Seat 6: PacPacBum folded before Flop (didn't bet)
Seat 7: xxxibgdrgn (button) folded on the Turn
Seat 8: 32rrew (small blind) folded before Flop
Seat 9: matiko09 (big blind) folded before Flop





PokerStars Hand #154364235091:  Hold'em No Limit ($0.50/$1.00 USD) - 2016/06/06 13:28:41 CET [2016/06/06 7:28:41 ET]
Table 'Smither' 9-max Seat #2 is the button
Seat 1: PacPacBum ($167.30 in chips) 
Seat 2: matiko09 ($100 in chips) 
Seat 3: stds st ($36 in chips) 
Seat 4: Mr.Grigoriy ($112.13 in chips) 
Seat 6: mooose100 ($94.72 in chips) 
Seat 7: vanilica ($126.05 in chips) 
Seat 8: ozone2003 ($100 in chips) 
stds st: posts small blind $0.50
Mr.Grigoriy: posts big blind $1
Dickyxxx: sits out 
*** HOLE CARDS ***
Dealt to matiko09 [9d 3c]
mooose100: folds 
vanilica: folds 
ozone2003: folds 
PacPacBum: raises $1.04 to $2.04
matiko09: folds 
stds st: folds 
Mr.Grigoriy: calls $1.04
*** FLOP *** [8s 6h 7s]
Mr.Grigoriy: checks 
PacPacBum: bets $1.52
Mr.Grigoriy: raises $4.98 to $6.50
PacPacBum: folds 
Uncalled bet ($4.98) returned to Mr.Grigoriy
Mr.Grigoriy collected $7.24 from pot
Mr.Grigoriy: doesn't show hand 
*** SUMMARY ***
Total pot $7.62 | Rake $0.38 
Board [8s 6h 7s]
Seat 1: PacPacBum folded on the Flop
Seat 2: matiko09 (button) folded before Flop (didn't bet)
Seat 3: stds st (small blind) folded before Flop
Seat 4: Mr.Grigoriy (big blind) collected ($7.24)
Seat 6: mooose100 folded before Flop (didn't bet)
Seat 7: vanilica folded before Flop (didn't bet)
Seat 8: ozone2003 folded before Flop (didn't bet)





PokerStars Hand #154364235512:  Hold'em No Limit ($0.50/$1.00 USD) - 2016/06/06 13:28:42 CET [2016/06/06 7:28:42 ET]
Table 'Williams' 9-max Seat #1 is the button
Seat 1: xhinostrabli ($80.50 in chips) 
Seat 2: matiko09 ($175.01 in chips) 
Seat 3: granbunny ($60.56 in chips) 
Seat 4: Mr.Grigoriy ($106.12 in chips) 
Seat 5: xxxibgdrgn ($100 in chips) 
Seat 6: xxxZeka ($135.90 in chips) 
Seat 7: Eskimo Fox ($117.94 in chips) 
Seat 8: Dickyxxx ($104 in chips) 
Seat 9: stds st ($67.26 in chips) 
matiko09: posts small blind $0.50
granbunny: posts big blind $1
*** HOLE CARDS ***
Dealt to matiko09 [3d 6c]
Mr.Grigoriy: folds 
xxxibgdrgn: folds 
xxxZeka: folds 
Eskimo Fox: folds 
Dickyxxx: folds 
stds st: folds 
xhinostrabli: folds 
matiko09: folds 
Uncalled bet ($0.50) returned to granbunny
granbunny collected $1 from pot
granbunny: doesn't show hand 
*** SUMMARY ***
Total pot $1 | Rake $0 
Seat 1: xhinostrabli (button) folded before Flop (didn't bet)
Seat 2: matiko09 (small blind) folded before Flop
Seat 3: granbunny (big blind) collected ($1)
Seat 4: Mr.Grigoriy folded before Flop (didn't bet)
Seat 5: xxxibgdrgn folded before Flop (didn't bet)
Seat 6: xxxZeka folded before Flop (didn't bet)
Seat 7: Eskimo Fox folded before Flop (didn't bet)
Seat 8: Dickyxxx folded before Flop (didn't bet)
Seat 9: stds st folded before Flop (didn't bet)





PokerStars Hand #154364235669:  Hold'em No Limit ($0.50/$1.00 USD) - 2016/06/06 13:28:42 CET [2016/06/06 7:28:42 ET]
Table 'Sheliak' 9-max Seat #9 is the button
Seat 1: 32rrew ($100 in chips) 
Seat 3: xxxZeka ($120.80 in chips) 
Seat 6: matiko09 ($109.99 in chips) 
Seat 7: stds st ($42.62 in chips) 
Seat 8: ozone2003 ($108.12 in chips) 
Seat 9: ipashutapkom ($47.50 in chips) 
32rrew: posts small blind $0.50
xxxZeka: posts big blind $1
Dickyxxx: sits out 
*** HOLE CARDS ***
Dealt to matiko09 [Ks 4d]
matiko09: folds 
xhinostrabli joins the table at seat #2 
stds st: folds 
ozone2003: folds 
ipashutapkom: raises $1.26 to $2.26
32rrew: folds 
xxxZeka: folds 
Uncalled bet ($1.26) returned to ipashutapkom
ipashutapkom collected $2.50 from pot
ipashutapkom: doesn't show hand 
*** SUMMARY ***
Total pot $2.50 | Rake $0 
Seat 1: 32rrew (small blind) folded before Flop
Seat 3: xxxZeka (big blind) folded before Flop
Seat 6: matiko09 folded before Flop (didn't bet)
Seat 7: stds st folded before Flop (didn't bet)
Seat 8: ozone2003 folded before Flop (didn't bet)
Seat 9: ipashutapkom (button) collected ($2.50)





PokerStars Hand #154364236302:  Hold'em No Limit ($0.50/$1.00 USD) - 2016/06/06 13:28:43 CET [2016/06/06 7:28:43 ET]
Table 'Wezen II' 9-max Seat #6 is the button
Seat 1: matiko09 ($100 in chips) 
Seat 2: Mr.Grigoriy ($111.12 in chips) 
Seat 3: Dickyxxx ($100 in chips) 
Seat 4: xxxibgdrgn ($198.50 in chips) 
Seat 5: stds st ($41.33 in chips) 
Seat 6: Eskimo Fox ($100 in chips) 
Seat 7: KDJAll3 ($78.08 in chips) 
Seat 8: o.miro ($108.65 in chips) 
Seat 9: Cogss ($106.70 in chips) 
KDJAll3: posts small blind $0.50
o.miro: posts big blind $1
*** HOLE CARDS ***
Dealt to matiko09 [Qs 4h]
Cogss: raises $1 to $2
matiko09: folds 
Mr.Grigoriy: folds 
Dickyxxx: raises $6 to $8
xxxibgdrgn: folds 
stds st: folds 
Eskimo Fox: folds 
KDJAll3: folds 
o.miro: folds 
Cogss: calls $6
*** FLOP *** [9s 3h 2d]
Cogss: checks 
Dickyxxx: bets $10.63
Cogss: folds 
Uncalled bet ($10.63) returned to Dickyxxx
Dickyxxx collected $16.62 from pot
Dickyxxx: doesn't show hand 
*** SUMMARY ***
Total pot $17.50 | Rake $0.88 
Board [9s 3h 2d]
Seat 1: matiko09 folded before Flop (didn't bet)
Seat 2: Mr.Grigoriy folded before Flop (didn't bet)
Seat 3: Dickyxxx collected ($16.62)
Seat 4: xxxibgdrgn folded before Flop (didn't bet)
Seat 5: stds st folded before Flop (didn't bet)
Seat 6: Eskimo Fox (button) folded before Flop (didn't bet)
Seat 7: KDJAll3 (small blind) folded before Flop
Seat 8: o.miro (big blind) folded before Flop
Seat 9: Cogss folded on the Flop





PokerStars Hand #154364236698:  Hold'em No Limit ($0.50/$1.00 USD) - 2016/06/06 13:28:44 CET [2016/06/06 7:28:44 ET]
Table 'Heze' 9-max Seat #7 is the button
Seat 1: matiko09 ($171.67 in chips) 
Seat 2: xxxibgdrgn ($100 in chips) 
Seat 3: Dickyxxx ($107.68 in chips) 
Seat 4: Eskimo Fox ($100 in chips) 
Seat 5: stds st ($38 in chips) 
Seat 6: yfcq36 ($139.45 in chips) 
Seat 7: 32rrew ($157.47 in chips) 
Seat 8: PacPacBum ($117.20 in chips) 
Seat 9: Mr.Grigoriy ($130.71 in chips) 
PacPacBum: posts small blind $0.50
Mr.Grigoriy: posts big blind $1
*** HOLE CARDS ***
Dealt to matiko09 [6h 7d]
matiko09: folds 
xxxibgdrgn: folds 
Dickyxxx: folds 
Eskimo Fox: folds 
stds st: folds 
yfcq36: folds 
32rrew: folds 
PacPacBum: folds 
Uncalled bet ($0.50) returned to Mr.Grigoriy
Mr.Grigoriy collected $1 from pot
Mr.Grigoriy: doesn't show hand 
*** SUMMARY ***
Total pot $1 | Rake $0 
Seat 1: matiko09 folded before Flop (didn't bet)
Seat 2: xxxibgdrgn folded before Flop (didn't bet)
Seat 3: Dickyxxx folded before Flop (didn't bet)
Seat 4: Eskimo Fox folded before Flop (didn't bet)
Seat 5: stds st folded before Flop (didn't bet)
Seat 6: yfcq36 folded before Flop (didn't bet)
Seat 7: 32rrew (button) folded before Flop (didn't bet)
Seat 8: PacPacBum (small blind) folded before Flop
Seat 9: Mr.Grigoriy (big blind) collected ($1)





PokerStars Hand #154364238427:  Hold'em No Limit ($0.50/$1.00 USD) - 2016/06/06 13:28:48 CET [2016/06/06 7:28:48 ET]
Table 'Oppavia' 9-max Seat #2 is the button
Seat 1: xxxZeka ($100 in chips) 
Seat 2: o.miro ($100 in chips) 
Seat 3: thecurv ($126.50 in chips) 
Seat 5: Eskimo Fox ($100 in chips) 
Seat 6: stds st ($44.50 in chips) 
Seat 7: chenlongn ($76.50 in chips) 
Seat 8: matiko09 ($104.18 in chips) 
Seat 9: Soundust_007 ($71 in chips) 
thecurv: posts small blind $0.50
vanilica: is sitting out 
vanilica leaves the table
Eskimo Fox: posts big blind $1
*** HOLE CARDS ***
Dealt to matiko09 [Qc Kc]
ozone2003 joins the table at seat #4 
stds st: folds 
chenlongn: folds 
matiko09: raises $2 to $3
Soundust_007: folds 
xxxZeka: folds 
o.miro: calls $3
thecurv: calls $2.50
Eskimo Fox: folds 
*** FLOP *** [7d 4s Kh]
thecurv: checks 
matiko09: bets $6
o.miro: folds 
thecurv: folds 
Uncalled bet ($6) returned to matiko09
matiko09 collected $9.50 from pot
matiko09: doesn't show hand 
*** SUMMARY ***
Total pot $10 | Rake $0.50 
Board [7d 4s Kh]
Seat 1: xxxZeka folded before Flop (didn't bet)
Seat 2: o.miro (button) folded on the Flop
Seat 3: thecurv (small blind) folded on the Flop
Seat 5: Eskimo Fox (big blind) folded before Flop
Seat 6: stds st folded before Flop (didn't bet)
Seat 7: chenlongn folded before Flop (didn't bet)
Seat 8: matiko09 collected ($9.50)
Seat 9: Soundust_007 folded before Flop (didn't bet)





PokerStars Hand #154364245962:  Hold'em No Limit ($0.50/$1.00 USD) - 2016/06/06 13:29:05 CET [2016/06/06 7:29:05 ET]
Table 'Heze' 9-max Seat #8 is the button
Seat 1: matiko09 ($171.67 in chips) 
Seat 2: xxxibgdrgn ($100 in chips) 
Seat 3: Dickyxxx ($107.68 in chips) 
Seat 4: Eskimo Fox ($100 in chips) 
Seat 5: stds st ($38 in chips) 
Seat 6: yfcq36 ($139.45 in chips) 
Seat 7: 32rrew ($157.47 in chips) 
Seat 8: PacPacBum ($116.70 in chips) 
Seat 9: Mr.Grigoriy ($131.21 in chips) 
Mr.Grigoriy: posts small blind $0.50
matiko09: posts big blind $1
*** HOLE CARDS ***
Dealt to matiko09 [Qc Qd]
xxxibgdrgn: folds 
Dickyxxx: folds 
Eskimo Fox: folds 
stds st: raises $1.50 to $2.50
yfcq36: folds 
32rrew: folds 
PacPacBum: folds 
Mr.Grigoriy: folds 
matiko09: raises $5.50 to $8
stds st: folds 
Uncalled bet ($5.50) returned to matiko09
matiko09 collected $5.50 from pot
matiko09: doesn't show hand 
*** SUMMARY ***
Total pot $5.50 | Rake $0 
Seat 1: matiko09 (big blind) collected ($5.50)
Seat 2: xxxibgdrgn folded before Flop (didn't bet)
Seat 3: Dickyxxx folded before Flop (didn't bet)
Seat 4: Eskimo Fox folded before Flop (didn't bet)
Seat 5: stds st folded before Flop
Seat 6: yfcq36 folded before Flop (didn't bet)
Seat 7: 32rrew folded before Flop (didn't bet)
Seat 8: PacPacBum (button) folded before Flop (didn't bet)
Seat 9: Mr.Grigoriy (small blind) folded before Flop





PokerStars Hand #154364246380:  Hold'em No Limit (€0.50/€1.00 EUR) - 2016/06/06 13:29:07 CET [2016/06/06 7:29:07 ET]
Table 'Lesath' 9-max Seat #3 is the button
Seat 1: o.miro (€111.90 in chips) 
Seat 2: thecurv (€106.32 in chips) 
Seat 3: ozone2003 (€201.14 in chips) 
Seat 5: matiko09 (€112.47 in chips) 
Seat 6: Dickyxxx (€100 in chips) 
Seat 7: Mr.Grigoriy (€100 in chips) 
Seat 8: stds st (€62.36 in chips) 
Seat 9: 72nloses (€40.84 in chips) 
matiko09: posts small blind €0.50
Dickyxxx: posts big blind €1
*** HOLE CARDS ***
Dealt to matiko09 [2s 5c]
Mr.Grigoriy: folds 
stds st: raises €1.50 to €2.50
72nloses: folds 
o.miro: folds 
thecurv: folds 
ozone2003: folds 
matiko09: folds 
Dickyxxx: folds 
Uncalled bet (€1.50) returned to stds st
stds st collected €2.50 from pot
stds st: doesn't show hand 
*** SUMMARY ***
Total pot €2.50 | Rake €0 
Seat 1: o.miro folded before Flop (didn't bet)
Seat 2: thecurv folded before Flop (didn't bet)
Seat 3: ozone2003 (button) folded before Flop (didn't bet)
Seat 5: matiko09 (small blind) folded before Flop
Seat 6: Dickyxxx (big blind) folded before Flop
Seat 7: Mr.Grigoriy folded before Flop (didn't bet)
Seat 8: stds st collected (€2.50)
Seat 9: 72nloses folded before Flop (didn't bet)





PokerStars Hand #154364249574:  Hold'em No Limit ($0.50/$1.00 USD) - 2016/06/06 13:29:14 CET [2016/06/06 7:29:14 ET]
Table 'Sheliak' 9-max Seat #1 is the button
Seat 1: 32rrew ($100 in chips) 
Seat 3: xxxZeka ($119.80 in chips) 
Seat 4: Dickyxxx ($100 in chips) 
Seat 6: matiko09 ($109.99 in chips) 
Seat 7: stds st ($42.62 in chips) 
Seat 8: ozone2003 ($108.12 in chips) 
Seat 9: ipashutapkom ($49 in chips) 
xhinostrabli will be allowed to play after the button
xxxZeka: posts small blind $0.50
Dickyxxx: posts big blind $1
*** HOLE CARDS ***
Dealt to matiko09 [9h Ts]
matiko09: folds 
stds st: folds 
ozone2003: raises $2 to $3
ipashutapkom: folds 
32rrew: folds 
xxxZeka: folds 
Dickyxxx: calls $2
*** FLOP *** [4h 4c Kh]
Dickyxxx: checks 
ozone2003: bets $6.18
Dickyxxx: calls $6.18
*** TURN *** [4h 4c Kh] [6s]
Dickyxxx: checks 
ozone2003: bets $16.29
Dickyxxx: folds 
Uncalled bet ($16.29) returned to ozone2003
ozone2003 collected $17.92 from pot
ozone2003: doesn't show hand 
*** SUMMARY ***
Total pot $18.86 | Rake $0.94 
Board [4h 4c Kh 6s]
Seat 1: 32rrew (button) folded before Flop (didn't bet)
Seat 3: xxxZeka (small blind) folded before Flop
Seat 4: Dickyxxx (big blind) folded on the Turn
Seat 6: matiko09 folded before Flop (didn't bet)
Seat 7: stds st folded before Flop (didn't bet)
Seat 8: ozone2003 collected ($17.92)
Seat 9: ipashutapkom folded before Flop (didn't bet)





PokerStars Hand #154364254091:  Hold'em No Limit ($0.50/$1.00 USD) - 2016/06/06 13:29:24 CET [2016/06/06 7:29:24 ET]
Table 'Safara' 9-max Seat #7 is the button
Seat 1: Dickyxxx ($103.54 in chips) 
Seat 2: ozone2003 ($100 in chips) 
Seat 3: erd33 ($163.43 in chips) 
Seat 4: xxxibgdrgn ($102.38 in chips) 
Seat 5: perezzi10 ($42.90 in chips) 
Seat 6: matiko09 ($131.78 in chips) 
Seat 7: PacPacBum ($120.49 in chips) 
Seat 8: o.miro ($151.61 in chips) 
Seat 9: R1aki ($102.72 in chips) 
o.miro: posts small blind $0.50
R1aki: posts big blind $1
*** HOLE CARDS ***
Dealt to matiko09 [6s 2s]
Dickyxxx: folds 
ozone2003: folds 
erd33: raises $2 to $3
xxxibgdrgn: folds 
perezzi10: calls $3
matiko09: folds 
PacPacBum: folds 
o.miro: folds 
R1aki: calls $2
*** FLOP *** [8h Jc 5s]
R1aki: checks 
erd33: checks 
perezzi10: checks 
*** TURN *** [8h Jc 5s] [8c]
R1aki: checks 
erd33: checks 
perezzi10: checks 
*** RIVER *** [8h Jc 5s 8c] [9c]
R1aki: checks 
erd33: bets $5
perezzi10: calls $5
R1aki: folds 
*** SHOW DOWN ***
erd33: shows [Ts Qs] (a straight, Eight to Queen)
perezzi10: mucks hand 
erd33 collected $18.52 from pot
*** SUMMARY ***
Total pot $19.50 | Rake $0.98 
Board [8h Jc 5s 8c 9c]
Seat 1: Dickyxxx folded before Flop (didn't bet)
Seat 2: ozone2003 folded before Flop (didn't bet)
Seat 3: erd33 showed [Ts Qs] and won ($18.52) with a straight, Eight to Queen
Seat 4: xxxibgdrgn folded before Flop (didn't bet)
Seat 5: perezzi10 mucked [Qc 9d]
Seat 6: matiko09 folded before Flop (didn't bet)
Seat 7: PacPacBum (button) folded before Flop (didn't bet)
Seat 8: o.miro (small blind) folded before Flop
Seat 9: R1aki (big blind) folded on the River





PokerStars Hand #154364255481:  Hold'em No Limit ($0.50/$1.00 USD) - 2016/06/06 13:29:28 CET [2016/06/06 7:29:28 ET]
Table 'Williams' 9-max Seat #2 is the button
Seat 1: xhinostrabli ($80.50 in chips) 
Seat 2: matiko09 ($174.51 in chips) 
Seat 3: granbunny ($61.06 in chips) 
Seat 4: Mr.Grigoriy ($106.12 in chips) 
Seat 5: xxxibgdrgn ($100 in chips) 
Seat 6: xxxZeka ($135.90 in chips) 
Seat 7: Eskimo Fox ($117.94 in chips) 
Seat 8: Dickyxxx ($104 in chips) 
Seat 9: stds st ($67.26 in chips) 
granbunny: posts small blind $0.50
Mr.Grigoriy: posts big blind $1
*** HOLE CARDS ***
Dealt to matiko09 [Ad 4s]
xxxibgdrgn: folds 
xxxZeka: folds 
Eskimo Fox: folds 
Dickyxxx: folds 
stds st: folds 
xhinostrabli: raises $1 to $2
matiko09: folds 
granbunny: folds 
Mr.Grigoriy: calls $1
*** FLOP *** [4c 5d As]
Mr.Grigoriy: checks 
xhinostrabli: bets $2.14
Mr.Grigoriy: folds 
Uncalled bet ($2.14) returned to xhinostrabli
xhinostrabli collected $4.28 from pot
*** SUMMARY ***
Total pot $4.50 | Rake $0.22 
Board [4c 5d As]
Seat 1: xhinostrabli collected ($4.28)
Seat 2: matiko09 (button) folded before Flop (didn't bet)
Seat 3: granbunny (small blind) folded before Flop
Seat 4: Mr.Grigoriy (big blind) folded on the Flop
Seat 5: xxxibgdrgn folded before Flop (didn't bet)
Seat 6: xxxZeka folded before Flop (didn't bet)
Seat 7: Eskimo Fox folded before Flop (didn't bet)
Seat 8: Dickyxxx folded before Flop (didn't bet)
Seat 9: stds st folded before Flop (didn't bet)





PokerStars Hand #154364256840:  Hold'em No Limit ($0.50/$1.00 USD) - 2016/06/06 13:29:31 CET [2016/06/06 7:29:31 ET]
Table 'Oppavia' 9-max Seat #3 is the button
Seat 1: xxxZeka ($100 in chips) 
Seat 2: o.miro ($100 in chips) 
Seat 3: thecurv ($123.50 in chips) 
Seat 5: Eskimo Fox ($100 in chips) 
Seat 6: stds st ($44.50 in chips) 
Seat 7: chenlongn ($76.50 in chips) 
Seat 8: matiko09 ($110.68 in chips) 
Seat 9: Soundust_007 ($71 in chips) 
ozone2003 will be allowed to play after the button
Eskimo Fox: posts small blind $0.50
stds st: posts big blind $1
*** HOLE CARDS ***
Dealt to matiko09 [5s 4s]
chenlongn: folds 
matiko09: folds 
Soundust_007: folds 
xxxZeka: raises $2 to $3
o.miro: folds 
thecurv: folds 
Eskimo Fox: folds 
stds st: folds 
Uncalled bet ($2) returned to xxxZeka
xxxZeka collected $2.50 from pot
*** SUMMARY ***
Total pot $2.50 | Rake $0 
Seat 1: xxxZeka collected ($2.50)
Seat 2: o.miro folded before Flop (didn't bet)
Seat 3: thecurv (button) folded before Flop (didn't bet)
Seat 5: Eskimo Fox (small blind) folded before Flop
Seat 6: stds st (big blind) folded before Flop
Seat 7: chenlongn folded before Flop (didn't bet)
Seat 8: matiko09 folded before Flop (didn't bet)
Seat 9: Soundust_007 folded before Flop (didn't bet)





PokerStars Hand #154364258031:  Hold'em No Limit (€0.50/€1.00 EUR) - 2016/06/06 13:29:33 CET [2016/06/06 7:29:33 ET]
Table 'Lesath' 9-max Seat #5 is the button
Seat 1: o.miro (€111.90 in chips) 
Seat 2: thecurv (€106.32 in chips) 
Seat 3: ozone2003 (€201.14 in chips) 
Seat 5: matiko09 (€111.97 in chips) 
Seat 6: Dickyxxx (€100 in chips) 
Seat 7: Mr.Grigoriy (€100 in chips) 
Seat 8: stds st (€63.86 in chips) 
Seat 9: 72nloses (€40.84 in chips) 
Dickyxxx: posts small blind €0.50
Mr.Grigoriy: posts big blind €1
*** HOLE CARDS ***
Dealt to matiko09 [2d Qs]
stds st: folds 
72nloses: folds 
o.miro: raises €2 to €3
thecurv: folds 
ozone2003: folds 
matiko09: folds 
Dickyxxx: folds 
Mr.Grigoriy: folds 
Uncalled bet (€2) returned to o.miro
o.miro collected €2.50 from pot
o.miro: doesn't show hand 
*** SUMMARY ***
Total pot €2.50 | Rake €0 
Seat 1: o.miro collected (€2.50)
Seat 2: thecurv folded before Flop (didn't bet)
Seat 3: ozone2003 folded before Flop (didn't bet)
Seat 5: matiko09 (button) folded before Flop (didn't bet)
Seat 6: Dickyxxx (small blind) folded before Flop
Seat 7: Mr.Grigoriy (big blind) folded before Flop
Seat 8: stds st folded before Flop (didn't bet)
Seat 9: 72nloses folded before Flop (didn't bet)





PokerStars Hand #154364261047:  Hold'em No Limit ($0.50/$1.00 USD) - 2016/06/06 13:29:40 CET [2016/06/06 7:29:40 ET]
Table 'Irmgard II' 9-max Seat #8 is the button
Seat 4: Dickyxxx ($101.50 in chips) 
Seat 7: 32rrew ($100 in chips) 
Seat 8: matiko09 ($150.81 in chips) 
Seat 9: PacPacBum ($206.84 in chips) 
PacPacBum: posts small blind $0.50
stds st: is sitting out 
Dickyxxx: posts big blind $1
*** HOLE CARDS ***
Dealt to matiko09 [Js Jh]
32rrew: folds 
matiko09: raises $1.27 to $2.27
PacPacBum: folds 
Dickyxxx: calls $1.27
*** FLOP *** [6h 3s Ks]
Dickyxxx: checks 
matiko09: checks 
*** TURN *** [6h 3s Ks] [Td]
Dickyxxx: bets $3.06
matiko09: calls $3.06
*** RIVER *** [6h 3s Ks Td] [Qh]
arctur17 joins the table at seat #5 
Dickyxxx: bets $6.78
oliwood2 joins the table at seat #6 
matiko09: calls $6.78
*** SHOW DOWN ***
Dickyxxx: shows [Th Kc] (two pair, Kings and Tens)
matiko09: mucks hand 
Dickyxxx collected $23.72 from pot
*** SUMMARY ***
Total pot $24.72 | Rake $1 
Board [6h 3s Ks Td Qh]
Seat 4: Dickyxxx (big blind) showed [Th Kc] and won ($23.72) with two pair, Kings and Tens
Seat 7: 32rrew folded before Flop (didn't bet)
Seat 8: matiko09 (button) mucked [Js Jh]
Seat 9: PacPacBum (small blind) folded before Flop





PokerStars Hand #154364266168:  Hold'em No Limit ($0.50/$1.00 USD) - 2016/06/06 13:29:52 CET [2016/06/06 7:29:52 ET]
Table 'Smither' 9-max Seat #3 is the button
Seat 1: PacPacBum ($163.74 in chips) 
Seat 2: matiko09 ($100 in chips) 
Seat 3: stds st ($35.50 in chips) 
Seat 4: Mr.Grigoriy ($115.81 in chips) 
Seat 5: Dickyxxx ($100 in chips) 
Seat 6: mooose100 ($94.72 in chips) 
Seat 7: vanilica ($126.05 in chips) 
Seat 8: ozone2003 ($100 in chips) 
Mr.Grigoriy: posts small blind $0.50
Dickyxxx: posts big blind $1
*** HOLE CARDS ***
Dealt to matiko09 [2c Qd]
mooose100: folds 
vanilica: folds 
ozone2003: folds 
PacPacBum: raises $2 to $3
matiko09: folds 
stds st: raises $4.50 to $7.50
Mr.Grigoriy: folds 
Dickyxxx: folds 
PacPacBum: raises $156.24 to $163.74 and is all-in
stds st: calls $28 and is all-in
Uncalled bet ($128.24) returned to PacPacBum
*** FIRST FLOP *** [7c 2s 6c]
*** FIRST TURN *** [7c 2s 6c] [5s]
*** FIRST RIVER *** [7c 2s 6c 5s] [4h]
*** SECOND FLOP *** [Jh Kd As]
*** SECOND TURN *** [Jh Kd As] [7h]
*** SECOND RIVER *** [Jh Kd As 7h] [9c]
*** FIRST SHOW DOWN ***
PacPacBum: shows [Ad Ac] (a pair of Aces)
stds st: mucks hand 
PacPacBum collected $35 from pot
*** SECOND SHOW DOWN ***
PacPacBum: shows [Ad Ac] (three of a kind, Aces)
stds st: mucks hand 
PacPacBum collected $35 from pot
*** SUMMARY ***
Total pot $72.50 | Rake $2.50 
Hand was run twice
FIRST Board [7c 2s 6c 5s 4h]
SECOND Board [Jh Kd As 7h 9c]
Seat 1: PacPacBum showed [Ad Ac] and won ($35) with a pair of Aces, and won ($35) with three of a kind, Aces
Seat 2: matiko09 folded before Flop (didn't bet)
Seat 3: stds st (button) mucked [Jd Js]
Seat 4: Mr.Grigoriy (small blind) folded before Flop
Seat 5: Dickyxxx (big blind) folded before Flop
Seat 6: mooose100 folded before Flop (didn't bet)
Seat 7: vanilica folded before Flop (didn't bet)
Seat 8: ozone2003 folded before Flop (didn't bet)





PokerStars Hand #154364266640:  Hold'em No Limit ($0.50/$1.00 USD) - 2016/06/06 13:29:53 CET [2016/06/06 7:29:53 ET]
Table 'Heze' 9-max Seat #9 is the button
Seat 1: matiko09 ($174.67 in chips) 
Seat 2: xxxibgdrgn ($100 in chips) 
Seat 3: Dickyxxx ($107.68 in chips) 
Seat 4: Eskimo Fox ($100 in chips) 
Seat 5: stds st ($35.50 in chips) 
Seat 6: yfcq36 ($139.45 in chips) 
Seat 7: 32rrew ($157.47 in chips) 
Seat 8: PacPacBum ($116.70 in chips) 
Seat 9: Mr.Grigoriy ($130.71 in chips) 
matiko09: posts small blind $0.50
xxxibgdrgn: posts big blind $1
*** HOLE CARDS ***
Dealt to matiko09 [5h 2s]
Dickyxxx: folds 
Eskimo Fox: folds 
stds st: folds 
yfcq36: folds 
32rrew: folds 
PacPacBum: folds 
Mr.Grigoriy: raises $1.50 to $2.50
matiko09: folds 
xxxibgdrgn: folds 
Uncalled bet ($1.50) returned to Mr.Grigoriy
Mr.Grigoriy collected $2.50 from pot
Mr.Grigoriy: doesn't show hand 
*** SUMMARY ***
Total pot $2.50 | Rake $0 
Seat 1: matiko09 (small blind) folded before Flop
Seat 2: xxxibgdrgn (big blind) folded before Flop
Seat 3: Dickyxxx folded before Flop (didn't bet)
Seat 4: Eskimo Fox folded before Flop (didn't bet)
Seat 5: stds st folded before Flop (didn't bet)
Seat 6: yfcq36 folded before Flop (didn't bet)
Seat 7: 32rrew folded before Flop (didn't bet)
Seat 8: PacPacBum folded before Flop (didn't bet)
Seat 9: Mr.Grigoriy (button) collected ($2.50)





PokerStars Hand #154364267841:  Hold'em No Limit (€0.50/€1.00 EUR) - 2016/06/06 13:29:56 CET [2016/06/06 7:29:56 ET]
Table 'Lesath' 9-max Seat #6 is the button
Seat 1: o.miro (€113.40 in chips) 
Seat 2: thecurv (€106.32 in chips) 
Seat 3: ozone2003 (€201.14 in chips) 
Seat 5: matiko09 (€111.97 in chips) 
Seat 6: Dickyxxx (€100 in chips) 
Seat 7: Mr.Grigoriy (€100 in chips) 
Seat 9: 72nloses (€40.84 in chips) 
Mr.Grigoriy: posts small blind €0.50
stds st: is sitting out 
72nloses: posts big blind €1
*** HOLE CARDS ***
Dealt to matiko09 [7s 4h]
o.miro: folds 
thecurv: folds 
ozone2003: folds 
matiko09: folds 
Dickyxxx has timed out
Dickyxxx: folds 
Mr.Grigoriy: folds 
Uncalled bet (€0.50) returned to 72nloses
72nloses collected €1 from pot
*** SUMMARY ***
Total pot €1 | Rake €0 
Seat 1: o.miro folded before Flop (didn't bet)
Seat 2: thecurv folded before Flop (didn't bet)
Seat 3: ozone2003 folded before Flop (didn't bet)
Seat 5: matiko09 folded before Flop (didn't bet)
Seat 6: Dickyxxx (button) folded before Flop (didn't bet)
Seat 7: Mr.Grigoriy (small blind) folded before Flop
Seat 9: 72nloses (big blind) collected (€1)





PokerStars Hand #154364274632:  Hold'em No Limit ($0.50/$1.00 USD) - 2016/06/06 13:30:10 CET [2016/06/06 7:30:10 ET]
Table 'Oppavia' 9-max Seat #5 is the button
Seat 1: xxxZeka ($101.50 in chips) 
Seat 2: o.miro ($100 in chips) 
Seat 3: thecurv ($123.50 in chips) 
Seat 5: Eskimo Fox ($100 in chips) 
Seat 6: stds st ($43.50 in chips) 
Seat 7: chenlongn ($76.50 in chips) 
Seat 8: matiko09 ($110.68 in chips) 
Seat 9: Soundust_007 ($71 in chips) 
stds st: posts small blind $0.50
chenlongn: posts big blind $1
ozone2003: sits out 
*** HOLE CARDS ***
Dealt to matiko09 [6d 2c]
matiko09: folds 
Soundust_007: folds 
xxxZeka: folds 
o.miro: folds 
thecurv: folds 
Eskimo Fox: folds 
stds st: folds 
Uncalled bet ($0.50) returned to chenlongn
chenlongn collected $1 from pot
chenlongn: doesn't show hand 
*** SUMMARY ***
Total pot $1 | Rake $0 
Seat 1: xxxZeka folded before Flop (didn't bet)
Seat 2: o.miro folded before Flop (didn't bet)
Seat 3: thecurv folded before Flop (didn't bet)
Seat 5: Eskimo Fox (button) folded before Flop (didn't bet)
Seat 6: stds st (small blind) folded before Flop
Seat 7: chenlongn (big blind) collected ($1)
Seat 8: matiko09 folded before Flop (didn't bet)
Seat 9: Soundust_007 folded before Flop (didn't bet)





PokerStars Hand #154364280156:  Hold'em No Limit ($0.50/$1.00 USD) - 2016/06/06 13:30:23 CET [2016/06/06 7:30:23 ET]
Table 'Chaldaea II' 9-max Seat #8 is the button
Seat 1: ozone2003 ($120.21 in chips) 
Seat 2: Mr.Grigoriy ($102.50 in chips) 
Seat 4: mooose100 ($141.71 in chips) 
Seat 5: stds st ($38.57 in chips) 
Seat 6: PacPacBum ($109.36 in chips) 
Seat 7: xxxibgdrgn ($101.52 in chips) 
Seat 8: 32rrew ($101 in chips) 
Seat 9: matiko09 ($108.14 in chips) 
matiko09: posts small blind $0.50
ozone2003: posts big blind $1
*** HOLE CARDS ***
Dealt to matiko09 [Tc 7d]
Mr.Grigoriy: folds 
mooose100: calls $1
stds st: raises $2.50 to $3.50
PacPacBum: folds 
xxxibgdrgn: folds 
32rrew: folds 
matiko09: folds 
ozone2003: folds 
mooose100: calls $2.50
*** FLOP *** [Kd 8h 3d]
mooose100: checks 
stds st: bets $6.50
mooose100: raises $6.50 to $13
stds st: raises $22.07 to $35.07 and is all-in
mooose100: folds 
Uncalled bet ($22.07) returned to stds st
stds st collected $32.78 from pot
stds st: doesn't show hand 
*** SUMMARY ***
Total pot $34.50 | Rake $1.72 
Board [Kd 8h 3d]
Seat 1: ozone2003 (big blind) folded before Flop
Seat 2: Mr.Grigoriy folded before Flop (didn't bet)
Seat 4: mooose100 folded on the Flop
Seat 5: stds st collected ($32.78)
Seat 6: PacPacBum folded before Flop (didn't bet)
Seat 7: xxxibgdrgn folded before Flop (didn't bet)
Seat 8: 32rrew (button) folded before Flop (didn't bet)
Seat 9: matiko09 (small blind) folded before Flop





PokerStars Hand #154364282310:  Hold'em No Limit ($0.50/$1.00 USD) - 2016/06/06 13:30:28 CET [2016/06/06 7:30:28 ET]
Table 'Wezen II' 9-max Seat #7 is the button
Seat 1: matiko09 ($100 in chips) 
Seat 2: Mr.Grigoriy ($111.12 in chips) 
Seat 3: Dickyxxx ($108.62 in chips) 
Seat 4: xxxibgdrgn ($198.50 in chips) 
Seat 5: stds st ($41.33 in chips) 
Seat 6: Eskimo Fox ($100 in chips) 
Seat 7: KDJAll3 ($77.58 in chips) 
Seat 8: o.miro ($107.65 in chips) 
Seat 9: Cogss ($98.70 in chips) 
o.miro: posts small blind $0.50
Cogss: posts big blind $1
*** HOLE CARDS ***
Dealt to matiko09 [3c 5c]
matiko09: folds 
Mr.Grigoriy: folds 
Dickyxxx: folds 
xxxibgdrgn: folds 
stds st: raises $1.50 to $2.50
Eskimo Fox: folds 
KDJAll3: folds 
o.miro: folds 
Cogss: calls $1.50
*** FLOP *** [6h 5h 5d]
Cogss: checks 
stds st: bets $3.13
Cogss: folds 
Uncalled bet ($3.13) returned to stds st
stds st collected $5.22 from pot
stds st: doesn't show hand 
*** SUMMARY ***
Total pot $5.50 | Rake $0.28 
Board [6h 5h 5d]
Seat 1: matiko09 folded before Flop (didn't bet)
Seat 2: Mr.Grigoriy folded before Flop (didn't bet)
Seat 3: Dickyxxx folded before Flop (didn't bet)
Seat 4: xxxibgdrgn folded before Flop (didn't bet)
Seat 5: stds st collected ($5.22)
Seat 6: Eskimo Fox folded before Flop (didn't bet)
Seat 7: KDJAll3 (button) folded before Flop (didn't bet)
Seat 8: o.miro (small blind) folded before Flop
Seat 9: Cogss (big blind) folded on the Flop





PokerStars Hand #154364282851:  Hold'em No Limit (€0.50/€1.00 EUR) - 2016/06/06 13:30:29 CET [2016/06/06 7:30:29 ET]
Table 'Lesath' 9-max Seat #7 is the button
Seat 1: o.miro (€113.40 in chips) 
Seat 2: thecurv (€106.32 in chips) 
Seat 3: ozone2003 (€201.14 in chips) 
Seat 5: matiko09 (€111.97 in chips) 
Seat 6: Dickyxxx (€100 in chips) 
Seat 7: Mr.Grigoriy (€100 in chips) 
Seat 9: 72nloses (€41.34 in chips) 
72nloses: posts small blind €0.50
o.miro: posts big blind €1
*** HOLE CARDS ***
Dealt to matiko09 [Qc Ac]
thecurv: folds 
ozone2003: folds 
matiko09: raises €2 to €3
Dickyxxx: calls €3
Mr.Grigoriy: folds 
72nloses: folds 
o.miro: calls €2
*** FLOP *** [Tc 2d 5c]
o.miro: checks 
matiko09: bets €5.86
Dickyxxx: folds 
o.miro: calls €5.86
*** TURN *** [Tc 2d 5c] [7s]
o.miro: checks 
matiko09: bets €13
o.miro: calls €13
*** RIVER *** [Tc 2d 5c 7s] [5d]
o.miro: checks 
matiko09: bets €33
o.miro: folds 
Uncalled bet (€33) returned to matiko09
matiko09 collected €44.97 from pot
matiko09: doesn't show hand 
*** SUMMARY ***
Total pot €47.22 | Rake €2.25 
Board [Tc 2d 5c 7s 5d]
Seat 1: o.miro (big blind) folded on the River
Seat 2: thecurv folded before Flop (didn't bet)
Seat 3: ozone2003 folded before Flop (didn't bet)
Seat 5: matiko09 collected (€44.97)
Seat 6: Dickyxxx folded on the Flop
Seat 7: Mr.Grigoriy (button) folded before Flop (didn't bet)
Seat 9: 72nloses (small blind) folded before Flop





PokerStars Hand #154364284849:  Hold'em No Limit ($0.50/$1.00 USD) - 2016/06/06 13:30:33 CET [2016/06/06 7:30:33 ET]
Table 'Safara' 9-max Seat #8 is the button
Seat 1: Dickyxxx ($103.54 in chips) 
Seat 2: ozone2003 ($100 in chips) 
Seat 3: erd33 ($173.95 in chips) 
Seat 4: xxxibgdrgn ($102.38 in chips) 
Seat 5: perezzi10 ($34.90 in chips) 
Seat 6: matiko09 ($131.78 in chips) 
Seat 7: PacPacBum ($120.49 in chips) 
Seat 8: o.miro ($151.11 in chips) 
Seat 9: R1aki ($100 in chips) 
R1aki: posts small blind $0.50
Dickyxxx: posts big blind $1
*** HOLE CARDS ***
Dealt to matiko09 [7h Qc]
ozone2003: folds 
erd33: raises $1 to $2
xxxibgdrgn: folds 
perezzi10: folds 
matiko09: folds 
PacPacBum: folds 
o.miro: calls $2
R1aki: folds 
Dickyxxx: folds 
*** FLOP *** [6s 7s 4d]
erd33: checks 
o.miro: checks 
*** TURN *** [6s 7s 4d] [Tc]
erd33: bets $2
o.miro: folds 
Uncalled bet ($2) returned to erd33
erd33 collected $5.22 from pot
*** SUMMARY ***
Total pot $5.50 | Rake $0.28 
Board [6s 7s 4d Tc]
Seat 1: Dickyxxx (big blind) folded before Flop
Seat 2: ozone2003 folded before Flop (didn't bet)
Seat 3: erd33 collected ($5.22)
Seat 4: xxxibgdrgn folded before Flop (didn't bet)
Seat 5: perezzi10 folded before Flop (didn't bet)
Seat 6: matiko09 folded before Flop (didn't bet)
Seat 7: PacPacBum folded before Flop (didn't bet)
Seat 8: o.miro (button) folded on the Turn
Seat 9: R1aki (small blind) folded before Flop





PokerStars Hand #154364288981:  Hold'em No Limit ($0.50/$1.00 USD) - 2016/06/06 13:30:42 CET [2016/06/06 7:30:42 ET]
Table 'Oppavia' 9-max Seat #6 is the button
Seat 1: xxxZeka ($101.50 in chips) 
Seat 2: o.miro ($100 in chips) 
Seat 3: thecurv ($123.50 in chips) 
Seat 5: Eskimo Fox ($100 in chips) 
Seat 6: stds st ($43 in chips) 
Seat 7: chenlongn ($77 in chips) 
Seat 8: matiko09 ($110.68 in chips) 
Seat 9: Soundust_007 ($71 in chips) 
chenlongn: posts small blind $0.50
matiko09: posts big blind $1
ozone2003: sits out 
*** HOLE CARDS ***
Dealt to matiko09 [7d Qh]
Soundust_007: folds 
xxxZeka: folds 
o.miro: folds 
thecurv: folds 
Eskimo Fox: folds 
stds st: raises $1.02 to $2.02
chenlongn: folds 
ozone2003 leaves the table
Mr.Grigoriy joins the table at seat #4 
matiko09: folds 
Uncalled bet ($1.02) returned to stds st
stds st collected $2.50 from pot
stds st: doesn't show hand 
*** SUMMARY ***
Total pot $2.50 | Rake $0 
Seat 1: xxxZeka folded before Flop (didn't bet)
Seat 2: o.miro folded before Flop (didn't bet)
Seat 3: thecurv folded before Flop (didn't bet)
Seat 5: Eskimo Fox folded before Flop (didn't bet)
Seat 6: stds st (button) collected ($2.50)
Seat 7: chenlongn (small blind) folded before Flop
Seat 8: matiko09 (big blind) folded before Flop
Seat 9: Soundust_007 folded before Flop (didn't bet)





PokerStars Hand #154364289077:  Hold'em No Limit ($0.50/$1.00 USD) - 2016/06/06 13:30:43 CET [2016/06/06 7:30:43 ET]
Table 'Heze' 9-max Seat #1 is the button
Seat 1: matiko09 ($174.17 in chips) 
Seat 2: xxxibgdrgn ($100 in chips) 
Seat 3: Dickyxxx ($107.68 in chips) 
Seat 4: Eskimo Fox ($100 in chips) 
Seat 5: stds st ($35.50 in chips) 
Seat 6: yfcq36 ($139.45 in chips) 
Seat 7: 32rrew ($157.47 in chips) 
Seat 8: PacPacBum ($116.70 in chips) 
Seat 9: Mr.Grigoriy ($132.21 in chips) 
xxxibgdrgn: posts small blind $0.50
Dickyxxx: posts big blind $1
*** HOLE CARDS ***
Dealt to matiko09 [Ah Ks]
Eskimo Fox: folds 
stds st: folds 
yfcq36: folds 
32rrew: raises $2 to $3
PacPacBum: folds 
Mr.Grigoriy: folds 
matiko09: raises $7 to $10
xxxibgdrgn: folds 
Dickyxxx: folds 
32rrew: folds 
Uncalled bet ($7) returned to matiko09
matiko09 collected $7.50 from pot
matiko09: doesn't show hand 
*** SUMMARY ***
Total pot $7.50 | Rake $0 
Seat 1: matiko09 (button) collected ($7.50)
Seat 2: xxxibgdrgn (small blind) folded before Flop
Seat 3: Dickyxxx (big blind) folded before Flop
Seat 4: Eskimo Fox folded before Flop (didn't bet)
Seat 5: stds st folded before Flop (didn't bet)
Seat 6: yfcq36 folded before Flop (didn't bet)
Seat 7: 32rrew folded before Flop
Seat 8: PacPacBum folded before Flop (didn't bet)
Seat 9: Mr.Grigoriy folded before Flop (didn't bet)





PokerStars Hand #154364289536:  Hold'em No Limit ($0.50/$1.00 USD) - 2016/06/06 13:30:44 CET [2016/06/06 7:30:44 ET]
Table 'Gajdariya' 9-max Seat #8 is the button
Seat 1: matiko09 ($135.09 in chips) 
Seat 2: Dickyxxx ($123.32 in chips) 
Seat 3: mooose100 ($98.92 in chips) 
Seat 5: stds st ($64.83 in chips) 
Seat 6: vanilica ($100 in chips) 
Seat 7: hurtNCYDE ($110.59 in chips) 
Seat 8: Mr.Grigoriy ($157.41 in chips) 
Seat 9: PacPacBum ($110.73 in chips) 
PacPacBum: posts small blind $0.50
matiko09: posts big blind $1
ozone2003: sits out 
*** HOLE CARDS ***
Dealt to matiko09 [5c 9c]
Dickyxxx: folds 
mooose100: folds 
stds st: raises $1.50 to $2.50
vanilica: folds 
hurtNCYDE: folds 
Mr.Grigoriy: calls $2.50
PacPacBum: folds 
matiko09: folds 
*** FLOP *** [8h 9d Kh]
stds st: checks 
Mr.Grigoriy: bets $4.14
stds st: folds 
Uncalled bet ($4.14) returned to Mr.Grigoriy
Mr.Grigoriy collected $6.18 from pot
Mr.Grigoriy: doesn't show hand 
*** SUMMARY ***
Total pot $6.50 | Rake $0.32 
Board [8h 9d Kh]
Seat 1: matiko09 (big blind) folded before Flop
Seat 2: Dickyxxx folded before Flop (didn't bet)
Seat 3: mooose100 folded before Flop (didn't bet)
Seat 5: stds st folded on the Flop
Seat 6: vanilica folded before Flop (didn't bet)
Seat 7: hurtNCYDE folded before Flop (didn't bet)
Seat 8: Mr.Grigoriy (button) collected ($6.18)
Seat 9: PacPacBum (small blind) folded before Flop





PokerStars Hand #154364291148:  Hold'em No Limit ($0.50/$1.00 USD) - 2016/06/06 13:30:47 CET [2016/06/06 7:30:47 ET]
Table 'Williams' 9-max Seat #3 is the button
Seat 1: xhinostrabli ($82.78 in chips) 
Seat 2: matiko09 ($174.51 in chips) 
Seat 3: granbunny ($60.56 in chips) 
Seat 4: Mr.Grigoriy ($104.12 in chips) 
Seat 5: xxxibgdrgn ($100 in chips) 
Seat 6: xxxZeka ($135.90 in chips) 
Seat 7: Eskimo Fox ($117.94 in chips) 
Seat 8: Dickyxxx ($104 in chips) 
Seat 9: stds st ($67.26 in chips) 
Mr.Grigoriy: posts small blind $0.50
xxxibgdrgn: posts big blind $1
*** HOLE CARDS ***
Dealt to matiko09 [Qd 4h]
xxxZeka: folds 
Eskimo Fox: folds 
Dickyxxx: folds 
stds st: folds 
xhinostrabli: folds 
matiko09: folds 
granbunny: folds 
Mr.Grigoriy: raises $2 to $3
xxxibgdrgn: folds 
Uncalled bet ($2) returned to Mr.Grigoriy
Mr.Grigoriy collected $2 from pot
Mr.Grigoriy: doesn't show hand 
*** SUMMARY ***
Total pot $2 | Rake $0 
Seat 1: xhinostrabli folded before Flop (didn't bet)
Seat 2: matiko09 folded before Flop (didn't bet)
Seat 3: granbunny (button) folded before Flop (didn't bet)
Seat 4: Mr.Grigoriy (small blind) collected ($2)
Seat 5: xxxibgdrgn (big blind) folded before Flop
Seat 6: xxxZeka folded before Flop (didn't bet)
Seat 7: Eskimo Fox folded before Flop (didn't bet)
Seat 8: Dickyxxx folded before Flop (didn't bet)
Seat 9: stds st folded before Flop (didn't bet)





PokerStars Hand #154364291288:  Hold'em No Limit ($0.50/$1.00 USD) - 2016/06/06 13:30:48 CET [2016/06/06 7:30:48 ET]
Table 'Sheliak' 9-max Seat #3 is the button
Seat 1: 32rrew ($100 in chips) 
Seat 2: xhinostrabli ($80 in chips) 
Seat 3: xxxZeka ($119.30 in chips) 
Seat 4: Dickyxxx ($100 in chips) 
Seat 6: matiko09 ($109.99 in chips) 
Seat 7: stds st ($42.62 in chips) 
Seat 8: ozone2003 ($116.86 in chips) 
Seat 9: ipashutapkom ($49 in chips) 
Dickyxxx: posts small blind $0.50
matiko09: posts big blind $1
xhinostrabli: posts big blind $1
*** HOLE CARDS ***
Dealt to matiko09 [Js 6h]
stds st: folds 
ozone2003: folds 
ipashutapkom: folds 
32rrew: folds 
xhinostrabli: checks 
xxxZeka: folds 
Dickyxxx: folds 
matiko09: checks 
*** FLOP *** [9h 2h Jd]
matiko09: bets $1.55
xhinostrabli: folds 
Uncalled bet ($1.55) returned to matiko09
matiko09 collected $2.38 from pot
matiko09: doesn't show hand 
*** SUMMARY ***
Total pot $2.50 | Rake $0.12 
Board [9h 2h Jd]
Seat 1: 32rrew folded before Flop (didn't bet)
Seat 2: xhinostrabli folded on the Flop
Seat 3: xxxZeka (button) folded before Flop (didn't bet)
Seat 4: Dickyxxx (small blind) folded before Flop
Seat 6: matiko09 (big blind) collected ($2.38)
Seat 7: stds st folded before Flop (didn't bet)
Seat 8: ozone2003 folded before Flop (didn't bet)
Seat 9: ipashutapkom folded before Flop (didn't bet)





PokerStars Hand #154364297313:  Hold'em No Limit ($0.50/$1.00 USD) - 2016/06/06 13:31:01 CET [2016/06/06 7:31:01 ET]
Table 'Smither' 9-max Seat #4 is the button
Seat 1: PacPacBum ($198.24 in chips) 
Seat 2: matiko09 ($100 in chips) 
Seat 3: stds st ($40 in chips) 
Seat 4: Mr.Grigoriy ($115.31 in chips) 
Seat 5: Dickyxxx ($100 in chips) 
Seat 6: mooose100 ($94.72 in chips) 
Seat 7: vanilica ($126.05 in chips) 
Seat 8: ozone2003 ($100 in chips) 
Dickyxxx: posts small blind $0.50
mooose100: posts big blind $1
*** HOLE CARDS ***
Dealt to matiko09 [8c 7d]
vanilica: folds 
ozone2003: folds 
PacPacBum: folds 
matiko09: folds 
stds st: folds 
Mr.Grigoriy: raises $1 to $2
Dickyxxx: folds 
mooose100: calls $1
*** FLOP *** [Jh Ad Ts]
mooose100: checks 
Mr.Grigoriy: bets $3.03
mooose100: folds 
Uncalled bet ($3.03) returned to Mr.Grigoriy
Mr.Grigoriy collected $4.28 from pot
Mr.Grigoriy: doesn't show hand 
*** SUMMARY ***
Total pot $4.50 | Rake $0.22 
Board [Jh Ad Ts]
Seat 1: PacPacBum folded before Flop (didn't bet)
Seat 2: matiko09 folded before Flop (didn't bet)
Seat 3: stds st folded before Flop (didn't bet)
Seat 4: Mr.Grigoriy (button) collected ($4.28)
Seat 5: Dickyxxx (small blind) folded before Flop
Seat 6: mooose100 (big blind) folded on the Flop
Seat 7: vanilica folded before Flop (didn't bet)
Seat 8: ozone2003 folded before Flop (didn't bet)





PokerStars Hand #154364302034:  Hold'em No Limit ($0.50/$1.00 USD) - 2016/06/06 13:31:12 CET [2016/06/06 7:31:12 ET]
Table 'Irmgard II' 9-max Seat #9 is the button
Seat 4: Dickyxxx ($113.11 in chips) 
Seat 5: arctur17 ($100 in chips) 
Seat 7: 32rrew ($100 in chips) 
Seat 8: matiko09 ($138.70 in chips) 
Seat 9: PacPacBum ($206.34 in chips) 
xxxZeka will be allowed to play after the button
Dickyxxx: posts small blind $0.50
arctur17: posts big blind $1
oliwood2: sits out 
*** HOLE CARDS ***
Dealt to matiko09 [9d Ac]
32rrew: folds 
matiko09: raises $1.50 to $2.50
PacPacBum: folds 
Dickyxxx: folds 
arctur17: folds 
Uncalled bet ($1.50) returned to matiko09
matiko09 collected $2.50 from pot
matiko09: doesn't show hand 
*** SUMMARY ***
Total pot $2.50 | Rake $0 
Seat 4: Dickyxxx (small blind) folded before Flop
Seat 5: arctur17 (big blind) folded before Flop
Seat 7: 32rrew folded before Flop (didn't bet)
Seat 8: matiko09 collected ($2.50)
Seat 9: PacPacBum (button) folded before Flop (didn't bet)





PokerStars Hand #154364306607:  Hold'em No Limit ($0.50/$1.00 USD) - 2016/06/06 13:31:22 CET [2016/06/06 7:31:22 ET]
Table 'Williams' 9-max Seat #4 is the button
Seat 1: xhinostrabli ($82.78 in chips) 
Seat 2: matiko09 ($174.51 in chips) 
Seat 3: granbunny ($60.56 in chips) 
Seat 4: Mr.Grigoriy ($105.12 in chips) 
Seat 5: xxxibgdrgn ($100 in chips) 
Seat 6: xxxZeka ($135.90 in chips) 
Seat 7: Eskimo Fox ($117.94 in chips) 
Seat 8: Dickyxxx ($104 in chips) 
Seat 9: stds st ($67.26 in chips) 
xxxibgdrgn: posts small blind $0.50
xxxZeka: posts big blind $1
*** HOLE CARDS ***
Dealt to matiko09 [Ad 2h]
Eskimo Fox: folds 
Dickyxxx: folds 
stds st: raises $1.50 to $2.50
xhinostrabli: folds 
matiko09: folds 
granbunny: folds 
Mr.Grigoriy: folds 
xxxibgdrgn: raises $6.50 to $9
xxxZeka: folds 
stds st: folds 
Uncalled bet ($6.50) returned to xxxibgdrgn
xxxibgdrgn collected $6 from pot
xxxibgdrgn: doesn't show hand 
*** SUMMARY ***
Total pot $6 | Rake $0 
Seat 1: xhinostrabli folded before Flop (didn't bet)
Seat 2: matiko09 folded before Flop (didn't bet)
Seat 3: granbunny folded before Flop (didn't bet)
Seat 4: Mr.Grigoriy (button) folded before Flop (didn't bet)
Seat 5: xxxibgdrgn (small blind) collected ($6)
Seat 6: xxxZeka (big blind) folded before Flop
Seat 7: Eskimo Fox folded before Flop (didn't bet)
Seat 8: Dickyxxx folded before Flop (didn't bet)
Seat 9: stds st folded before Flop





PokerStars Hand #154364306507:  Hold'em No Limit ($0.50/$1.00 USD) - 2016/06/06 13:31:22 CET [2016/06/06 7:31:22 ET]
Table 'Safara' 9-max Seat #9 is the button
Seat 1: Dickyxxx ($102.54 in chips) 
Seat 2: ozone2003 ($100 in chips) 
Seat 3: erd33 ($177.17 in chips) 
Seat 4: xxxibgdrgn ($102.38 in chips) 
Seat 5: perezzi10 ($34.90 in chips) 
Seat 6: matiko09 ($131.78 in chips) 
Seat 7: PacPacBum ($120.49 in chips) 
Seat 8: o.miro ($149.11 in chips) 
Seat 9: R1aki ($100 in chips) 
Dickyxxx: posts small blind $0.50
ozone2003: posts big blind $1
*** HOLE CARDS ***
Dealt to matiko09 [5h 6d]
erd33: raises $1 to $2
xxxibgdrgn: folds 
perezzi10: calls $2
matiko09: folds 
PacPacBum: folds 
o.miro: folds 
R1aki: raises $9.50 to $11.50
Dickyxxx: folds 
ozone2003: folds 
erd33: folds 
perezzi10: calls $9.50
*** FLOP *** [Th 2d 7h]
perezzi10: bets $23.40 and is all-in
R1aki: calls $23.40
*** TURN *** [Th 2d 7h] [5d]
*** RIVER *** [Th 2d 7h 5d] [9h]
*** SHOW DOWN ***
perezzi10: shows [8h 8c] (a pair of Eights)
R1aki: shows [Ah Qd] (high card Ace)
perezzi10 collected $70.80 from pot
*** SUMMARY ***
Total pot $73.30 | Rake $2.50 
Board [Th 2d 7h 5d 9h]
Seat 1: Dickyxxx (small blind) folded before Flop
Seat 2: ozone2003 (big blind) folded before Flop
Seat 3: erd33 folded before Flop
Seat 4: xxxibgdrgn folded before Flop (didn't bet)
Seat 5: perezzi10 showed [8h 8c] and won ($70.80) with a pair of Eights
Seat 6: matiko09 folded before Flop (didn't bet)
Seat 7: PacPacBum folded before Flop (didn't bet)
Seat 8: o.miro folded before Flop (didn't bet)
Seat 9: R1aki (button) showed [Ah Qd] and lost with high card Ace





PokerStars Hand #154364309767:  Hold'em No Limit ($0.50/$1.00 USD) - 2016/06/06 13:31:29 CET [2016/06/06 7:31:29 ET]
Table 'Oppavia' 9-max Seat #7 is the button
Seat 1: xxxZeka ($101.50 in chips) 
Seat 2: o.miro ($100 in chips) 
Seat 3: thecurv ($123.50 in chips) 
Seat 5: Eskimo Fox ($100 in chips) 
Seat 6: stds st ($44.50 in chips) 
Seat 7: chenlongn ($76.50 in chips) 
Seat 8: matiko09 ($109.68 in chips) 
Seat 9: Soundust_007 ($71 in chips) 
matiko09: posts small blind $0.50
Soundust_007: posts big blind $1
Mr.Grigoriy: sits out 
*** HOLE CARDS ***
Dealt to matiko09 [Jc Qc]
xxxZeka: folds 
o.miro: folds 
thecurv: folds 
Eskimo Fox: folds 
stds st: folds 
chenlongn: folds 
matiko09: raises $2 to $3
Soundust_007: folds 
Uncalled bet ($2) returned to matiko09
matiko09 collected $2 from pot
matiko09: doesn't show hand 
*** SUMMARY ***
Total pot $2 | Rake $0 
Seat 1: xxxZeka folded before Flop (didn't bet)
Seat 2: o.miro folded before Flop (didn't bet)
Seat 3: thecurv folded before Flop (didn't bet)
Seat 5: Eskimo Fox folded before Flop (didn't bet)
Seat 6: stds st folded before Flop (didn't bet)
Seat 7: chenlongn (button) folded before Flop (didn't bet)
Seat 8: matiko09 (small blind) collected ($2)
Seat 9: Soundust_007 (big blind) folded before Flop





PokerStars Hand #154364314645:  Hold'em No Limit ($0.50/$1.00 USD) - 2016/06/06 13:31:40 CET [2016/06/06 7:31:40 ET]
Table 'Irmgard II' 9-max Seat #4 is the button
Seat 4: Dickyxxx ($112.61 in chips) 
Seat 5: arctur17 ($99 in chips) 
Seat 6: oliwood2 ($50 in chips) 
Seat 7: 32rrew ($100 in chips) 
Seat 8: matiko09 ($140.20 in chips) 
Seat 9: PacPacBum ($206.34 in chips) 
arctur17: posts small blind $0.50
oliwood2: posts big blind $1
xxxZeka: sits out 
*** HOLE CARDS ***
Dealt to matiko09 [Ts 8d]
32rrew: raises $2 to $3
matiko09: folds 
PacPacBum: folds 
Dickyxxx: folds 
arctur17: folds 
oliwood2: folds 
Uncalled bet ($2) returned to 32rrew
32rrew collected $2.50 from pot
32rrew: doesn't show hand 
*** SUMMARY ***
Total pot $2.50 | Rake $0 
Seat 4: Dickyxxx (button) folded before Flop (didn't bet)
Seat 5: arctur17 (small blind) folded before Flop
Seat 6: oliwood2 (big blind) folded before Flop
Seat 7: 32rrew collected ($2.50)
Seat 8: matiko09 folded before Flop (didn't bet)
Seat 9: PacPacBum folded before Flop (didn't bet)





PokerStars Hand #154364314671:  Hold'em No Limit ($0.50/$1.00 USD) - 2016/06/06 13:31:40 CET [2016/06/06 7:31:40 ET]
Table 'Heze' 9-max Seat #2 is the button
Seat 1: matiko09 ($178.67 in chips) 
Seat 2: xxxibgdrgn ($100 in chips) 
Seat 3: Dickyxxx ($106.68 in chips) 
Seat 4: Eskimo Fox ($100 in chips) 
Seat 5: stds st ($35.50 in chips) 
Seat 6: yfcq36 ($139.45 in chips) 
Seat 7: 32rrew ($154.47 in chips) 
Seat 8: PacPacBum ($116.70 in chips) 
Seat 9: Mr.Grigoriy ($132.21 in chips) 
Dickyxxx: posts small blind $0.50
Eskimo Fox: posts big blind $1
*** HOLE CARDS ***
Dealt to matiko09 [Qd 9s]
stds st: raises $1.50 to $2.50
yfcq36: folds 
32rrew: folds 
PacPacBum: folds 
Mr.Grigoriy: folds 
matiko09: folds 
xxxibgdrgn: folds 
Dickyxxx: folds 
Eskimo Fox: folds 
Uncalled bet ($1.50) returned to stds st
stds st collected $2.50 from pot
*** SUMMARY ***
Total pot $2.50 | Rake $0 
Seat 1: matiko09 folded before Flop (didn't bet)
Seat 2: xxxibgdrgn (button) folded before Flop (didn't bet)
Seat 3: Dickyxxx (small blind) folded before Flop
Seat 4: Eskimo Fox (big blind) folded before Flop
Seat 5: stds st collected ($2.50)
Seat 6: yfcq36 folded before Flop (didn't bet)
Seat 7: 32rrew folded before Flop (didn't bet)
Seat 8: PacPacBum folded before Flop (didn't bet)
Seat 9: Mr.Grigoriy folded before Flop (didn't bet)





PokerStars Hand #154364315861:  Hold'em No Limit ($0.50/$1.00 USD) - 2016/06/06 13:31:42 CET [2016/06/06 7:31:42 ET]
Table 'Wezen II' 9-max Seat #8 is the button
Seat 1: matiko09 ($100 in chips) 
Seat 2: Mr.Grigoriy ($111.12 in chips) 
Seat 3: Dickyxxx ($108.62 in chips) 
Seat 4: xxxibgdrgn ($198.50 in chips) 
Seat 5: stds st ($44.05 in chips) 
Seat 6: Eskimo Fox ($100 in chips) 
Seat 7: KDJAll3 ($77.58 in chips) 
Seat 8: o.miro ($107.15 in chips) 
Seat 9: Cogss ($96.20 in chips) 
Cogss: posts small blind $0.50
matiko09: posts big blind $1
*** HOLE CARDS ***
Dealt to matiko09 [9d 7s]
Mr.Grigoriy: folds 
Dickyxxx: folds 
xxxibgdrgn: folds 
stds st: raises $1.50 to $2.50
Eskimo Fox: folds 
KDJAll3: calls $2.50
o.miro: calls $2.50
Cogss: folds 
matiko09: folds 
*** FLOP *** [Js 5h 8s]
stds st: checks 
KDJAll3: bets $3
o.miro: calls $3
stds st: folds 
*** TURN *** [Js 5h 8s] [6s]
KDJAll3: bets $6
o.miro: calls $6
*** RIVER *** [Js 5h 8s 6s] [8c]
KDJAll3: bets $14
o.miro: folds 
Uncalled bet ($14) returned to KDJAll3
KDJAll3 collected $25.65 from pot
KDJAll3: doesn't show hand 
*** SUMMARY ***
Total pot $27 | Rake $1.35 
Board [Js 5h 8s 6s 8c]
Seat 1: matiko09 (big blind) folded before Flop
Seat 2: Mr.Grigoriy folded before Flop (didn't bet)
Seat 3: Dickyxxx folded before Flop (didn't bet)
Seat 4: xxxibgdrgn folded before Flop (didn't bet)
Seat 5: stds st folded on the Flop
Seat 6: Eskimo Fox folded before Flop (didn't bet)
Seat 7: KDJAll3 collected ($25.65)
Seat 8: o.miro (button) folded on the River
Seat 9: Cogss (small blind) folded before Flop





PokerStars Hand #154364316542:  Hold'em No Limit ($0.50/$1.00 USD) - 2016/06/06 13:31:44 CET [2016/06/06 7:31:44 ET]
Table 'Sheliak' 9-max Seat #4 is the button
Seat 1: 32rrew ($100 in chips) 
Seat 2: xhinostrabli ($79 in chips) 
Seat 3: xxxZeka ($119.30 in chips) 
Seat 4: Dickyxxx ($100 in chips) 
Seat 6: matiko09 ($111.37 in chips) 
Seat 7: stds st ($42.62 in chips) 
Seat 8: ozone2003 ($116.86 in chips) 
Seat 9: ipashutapkom ($49 in chips) 
matiko09: posts small blind $0.50
stds st: posts big blind $1
*** HOLE CARDS ***
Dealt to matiko09 [8d Ac]
ozone2003: folds 
ipashutapkom: folds 
ozone2003 leaves the table
32rrew: folds 
hurtNCYDE joins the table at seat #8 
hurtNCYDE leaves the table
xhinostrabli: folds 
xxxZeka: folds 
Dickyxxx: raises $2 to $3
matiko09: folds 
stds st: folds 
Uncalled bet ($2) returned to Dickyxxx
Dickyxxx collected $2.50 from pot
Dickyxxx: doesn't show hand 
*** SUMMARY ***
Total pot $2.50 | Rake $0 
Seat 1: 32rrew folded before Flop (didn't bet)
Seat 2: xhinostrabli folded before Flop (didn't bet)
Seat 3: xxxZeka folded before Flop (didn't bet)
Seat 4: Dickyxxx (button) collected ($2.50)
Seat 6: matiko09 (small blind) folded before Flop
Seat 7: stds st (big blind) folded before Flop
Seat 8: ozone2003 folded before Flop (didn't bet)
Seat 9: ipashutapkom folded before Flop (didn't bet)





PokerStars Hand #154364320282:  Hold'em No Limit ($0.50/$1.00 USD) - 2016/06/06 13:31:52 CET [2016/06/06 7:31:52 ET]
Table 'Chaldaea II' 9-max Seat #9 is the button
Seat 1: ozone2003 ($119.21 in chips) 
Seat 2: Mr.Grigoriy ($102.50 in chips) 
Seat 4: mooose100 ($125.21 in chips) 
Seat 5: stds st ($54.85 in chips) 
Seat 6: PacPacBum ($109.36 in chips) 
Seat 7: xxxibgdrgn ($101.52 in chips) 
Seat 8: 32rrew ($101 in chips) 
Seat 9: matiko09 ($107.64 in chips) 
ozone2003: posts small blind $0.50
Mr.Grigoriy: posts big blind $1
*** HOLE CARDS ***
Dealt to matiko09 [6c 4h]
mooose100: calls $1
stds st: folds 
PacPacBum: folds 
xxxibgdrgn: raises $3 to $4
32rrew: folds 
matiko09: folds 
ozone2003: folds 
Mr.Grigoriy: folds 
mooose100: calls $3
*** FLOP *** [4s Kh 5c]
mooose100: checks 
xxxibgdrgn: bets $6
mooose100: folds 
Uncalled bet ($6) returned to xxxibgdrgn
xxxibgdrgn collected $9.02 from pot
xxxibgdrgn: doesn't show hand 
*** SUMMARY ***
Total pot $9.50 | Rake $0.48 
Board [4s Kh 5c]
Seat 1: ozone2003 (small blind) folded before Flop
Seat 2: Mr.Grigoriy (big blind) folded before Flop
Seat 4: mooose100 folded on the Flop
Seat 5: stds st folded before Flop (didn't bet)
Seat 6: PacPacBum folded before Flop (didn't bet)
Seat 7: xxxibgdrgn collected ($9.02)
Seat 8: 32rrew folded before Flop (didn't bet)
Seat 9: matiko09 (button) folded before Flop (didn't bet)





PokerStars Hand #154364322290:  Hold'em No Limit ($0.50/$1.00 USD) - 2016/06/06 13:31:57 CET [2016/06/06 7:31:57 ET]
Table 'Irmgard II' 9-max Seat #5 is the button
Seat 4: Dickyxxx ($112.61 in chips) 
Seat 5: arctur17 ($98.50 in chips) 
Seat 6: oliwood2 ($49 in chips) 
Seat 8: matiko09 ($140.20 in chips) 
Seat 9: PacPacBum ($206.34 in chips) 
oliwood2: posts small blind $0.50
32rrew: is sitting out 
matiko09: posts big blind $1
xxxZeka: sits out 
*** HOLE CARDS ***
Dealt to matiko09 [Qd 6h]
32rrew leaves the table
PacPacBum: folds 
Dickyxxx: folds 
o.miro joins the table at seat #7 
arctur17: raises $1 to $2
oliwood2: raises $5 to $7
matiko09: folds 
arctur17: calls $5
*** FLOP *** [Qh 9c Qs]
oliwood2: bets $9
arctur17: calls $9
*** TURN *** [Qh 9c Qs] [8s]
oliwood2: checks 
arctur17: checks 
*** RIVER *** [Qh 9c Qs 8s] [3s]
oliwood2: checks 
arctur17: bets $17
oliwood2: raises $16 to $33 and is all-in
arctur17: calls $16
*** SHOW DOWN ***
oliwood2: shows [Ac Jc] (a pair of Queens)
arctur17: shows [Ks Ts] (a flush, King high)
arctur17 collected $96.50 from pot
*** SUMMARY ***
Total pot $99 | Rake $2.50 
Board [Qh 9c Qs 8s 3s]
Seat 4: Dickyxxx folded before Flop (didn't bet)
Seat 5: arctur17 (button) showed [Ks Ts] and won ($96.50) with a flush, King high
Seat 6: oliwood2 (small blind) showed [Ac Jc] and lost with a pair of Queens
Seat 8: matiko09 (big blind) folded before Flop
Seat 9: PacPacBum folded before Flop (didn't bet)





PokerStars Hand #154364324631:  Hold'em No Limit ($0.50/$1.00 USD) - 2016/06/06 13:32:02 CET [2016/06/06 7:32:02 ET]
Table 'Smither' 9-max Seat #5 is the button
Seat 1: PacPacBum ($198.24 in chips) 
Seat 2: matiko09 ($100 in chips) 
Seat 3: stds st ($40 in chips) 
Seat 4: Mr.Grigoriy ($117.59 in chips) 
Seat 5: Dickyxxx ($100 in chips) 
Seat 6: mooose100 ($92.72 in chips) 
Seat 7: vanilica ($126.05 in chips) 
Seat 8: ozone2003 ($100 in chips) 
mooose100: posts small blind $0.50
vanilica: posts big blind $1
*** HOLE CARDS ***
Dealt to matiko09 [Qs As]
ozone2003: folds 
PacPacBum: folds 
matiko09: raises $2 to $3
stds st: folds 
Mr.Grigoriy: folds 
Dickyxxx: calls $3
mooose100: folds 
vanilica: raises $10 to $13
matiko09: calls $10
Dickyxxx: folds 
*** FLOP *** [4s 3s 6d]
vanilica: checks 
matiko09: bets $18
vanilica: folds 
Uncalled bet ($18) returned to matiko09
matiko09 collected $28.02 from pot
matiko09: doesn't show hand 
*** SUMMARY ***
Total pot $29.50 | Rake $1.48 
Board [4s 3s 6d]
Seat 1: PacPacBum folded before Flop (didn't bet)
Seat 2: matiko09 collected ($28.02)
Seat 3: stds st folded before Flop (didn't bet)
Seat 4: Mr.Grigoriy folded before Flop (didn't bet)
Seat 5: Dickyxxx (button) folded before Flop
Seat 6: mooose100 (small blind) folded before Flop
Seat 7: vanilica (big blind) folded on the Flop
Seat 8: ozone2003 folded before Flop (didn't bet)





PokerStars Hand #154364325889:  Hold'em No Limit ($0.50/$1.00 USD) - 2016/06/06 13:32:05 CET [2016/06/06 7:32:05 ET]
Table 'Gajdariya' 9-max Seat #9 is the button
Seat 1: matiko09 ($134.09 in chips) 
Seat 2: Dickyxxx ($123.32 in chips) 
Seat 3: mooose100 ($98.92 in chips) 
Seat 5: stds st ($62.33 in chips) 
Seat 6: vanilica ($100 in chips) 
Seat 7: hurtNCYDE ($110.59 in chips) 
Seat 8: Mr.Grigoriy ($161.09 in chips) 
Seat 9: PacPacBum ($110.23 in chips) 
matiko09: posts small blind $0.50
Dickyxxx: posts big blind $1
ozone2003: sits out 
*** HOLE CARDS ***
Dealt to matiko09 [7s 6h]
mooose100: folds 
stds st: folds 
vanilica: folds 
hurtNCYDE: raises $1.50 to $2.50
Mr.Grigoriy: folds 
PacPacBum: folds 
matiko09: folds 
Dickyxxx: raises $6.50 to $9
hurtNCYDE: raises $10.50 to $19.50
Dickyxxx: raises $103.82 to $123.32 and is all-in
hurtNCYDE: folds 
Uncalled bet ($103.82) returned to Dickyxxx
Dickyxxx collected $39.50 from pot
Dickyxxx: doesn't show hand 
*** SUMMARY ***
Total pot $39.50 | Rake $0 
Seat 1: matiko09 (small blind) folded before Flop
Seat 2: Dickyxxx (big blind) collected ($39.50)
Seat 3: mooose100 folded before Flop (didn't bet)
Seat 5: stds st folded before Flop (didn't bet)
Seat 6: vanilica folded before Flop (didn't bet)
Seat 7: hurtNCYDE folded before Flop
Seat 8: Mr.Grigoriy folded before Flop (didn't bet)
Seat 9: PacPacBum (button) folded before Flop (didn't bet)





PokerStars Hand #154364326571:  Hold'em No Limit ($0.50/$1.00 USD) - 2016/06/06 13:32:06 CET [2016/06/06 7:32:06 ET]
Table 'Safara' 9-max Seat #1 is the button
Seat 1: Dickyxxx ($102.04 in chips) 
Seat 2: ozone2003 ($100 in chips) 
Seat 3: erd33 ($175.17 in chips) 
Seat 4: xxxibgdrgn ($102.38 in chips) 
Seat 5: perezzi10 ($70.80 in chips) 
Seat 6: matiko09 ($131.78 in chips) 
Seat 7: PacPacBum ($120.49 in chips) 
Seat 8: o.miro ($149.11 in chips) 
Seat 9: R1aki ($100 in chips) 
ozone2003: posts small blind $0.50
erd33: posts big blind $1
*** HOLE CARDS ***
Dealt to matiko09 [Tc 9s]
xxxibgdrgn: raises $2 to $3
perezzi10: folds 
matiko09: folds 
PacPacBum: folds 
o.miro: folds 
R1aki: folds 
Dickyxxx: folds 
ozone2003: folds 
erd33: folds 
Uncalled bet ($2) returned to xxxibgdrgn
xxxibgdrgn collected $2.50 from pot
xxxibgdrgn: doesn't show hand 
*** SUMMARY ***
Total pot $2.50 | Rake $0 
Seat 1: Dickyxxx (button) folded before Flop (didn't bet)
Seat 2: ozone2003 (small blind) folded before Flop
Seat 3: erd33 (big blind) folded before Flop
Seat 4: xxxibgdrgn collected ($2.50)
Seat 5: perezzi10 folded before Flop (didn't bet)
Seat 6: matiko09 folded before Flop (didn't bet)
Seat 7: PacPacBum folded before Flop (didn't bet)
Seat 8: o.miro folded before Flop (didn't bet)
Seat 9: R1aki folded before Flop (didn't bet)





PokerStars Hand #154364327941:  Hold'em No Limit ($0.50/$1.00 USD) - 2016/06/06 13:32:09 CET [2016/06/06 7:32:09 ET]
Table 'Oppavia' 9-max Seat #8 is the button
Seat 1: xxxZeka ($101.50 in chips) 
Seat 2: o.miro ($100 in chips) 
Seat 3: thecurv ($123.50 in chips) 
Seat 5: Eskimo Fox ($100 in chips) 
Seat 6: stds st ($44.50 in chips) 
Seat 7: chenlongn ($76.50 in chips) 
Seat 8: matiko09 ($110.68 in chips) 
Seat 9: Soundust_007 ($70 in chips) 
Soundust_007: posts small blind $0.50
xxxZeka: posts big blind $1
Mr.Grigoriy: sits out 
*** HOLE CARDS ***
Dealt to matiko09 [5c 5d]
o.miro: folds 
thecurv: folds 
Eskimo Fox: folds 
stds st: folds 
chenlongn: raises $1 to $2
matiko09: calls $2
Soundust_007: folds 
xxxZeka: calls $1
*** FLOP *** [Th 2h 6c]
xxxZeka: bets $4.63
chenlongn: folds 
matiko09: folds 
Uncalled bet ($4.63) returned to xxxZeka
xxxZeka collected $6.18 from pot
*** SUMMARY ***
Total pot $6.50 | Rake $0.32 
Board [Th 2h 6c]
Seat 1: xxxZeka (big blind) collected ($6.18)
Seat 2: o.miro folded before Flop (didn't bet)
Seat 3: thecurv folded before Flop (didn't bet)
Seat 5: Eskimo Fox folded before Flop (didn't bet)
Seat 6: stds st folded before Flop (didn't bet)
Seat 7: chenlongn folded on the Flop
Seat 8: matiko09 (button) folded on the Flop
Seat 9: Soundust_007 (small blind) folded before Flop





PokerStars Hand #154364328950:  Hold'em No Limit ($0.50/$1.00 USD) - 2016/06/06 13:32:12 CET [2016/06/06 7:32:12 ET]
Table 'Williams' 9-max Seat #5 is the button
Seat 1: xhinostrabli ($82.78 in chips) 
Seat 2: matiko09 ($174.51 in chips) 
Seat 3: granbunny ($60.56 in chips) 
Seat 4: Mr.Grigoriy ($105.12 in chips) 
Seat 5: xxxibgdrgn ($103.50 in chips) 
Seat 6: xxxZeka ($134.90 in chips) 
Seat 7: Eskimo Fox ($117.94 in chips) 
Seat 8: Dickyxxx ($104 in chips) 
Seat 9: stds st ($64.76 in chips) 
xxxZeka: posts small blind $0.50
Eskimo Fox: posts big blind $1
*** HOLE CARDS ***
Dealt to matiko09 [8d 9h]
Dickyxxx: folds 
stds st: folds 
xhinostrabli: folds 
matiko09: folds 
granbunny: folds 
Mr.Grigoriy: folds 
xxxibgdrgn: folds 
xxxZeka: folds 
Uncalled bet ($0.50) returned to Eskimo Fox
Eskimo Fox collected $1 from pot
Eskimo Fox: doesn't show hand 
*** SUMMARY ***
Total pot $1 | Rake $0 
Seat 1: xhinostrabli folded before Flop (didn't bet)
Seat 2: matiko09 folded before Flop (didn't bet)
Seat 3: granbunny folded before Flop (didn't bet)
Seat 4: Mr.Grigoriy folded before Flop (didn't bet)
Seat 5: xxxibgdrgn (button) folded before Flop (didn't bet)
Seat 6: xxxZeka (small blind) folded before Flop
Seat 7: Eskimo Fox (big blind) collected ($1)
Seat 8: Dickyxxx folded before Flop (didn't bet)
Seat 9: stds st folded before Flop (didn't bet)





PokerStars Hand #154364334482:  Hold'em No Limit ($0.50/$1.00 USD) - 2016/06/06 13:32:24 CET [2016/06/06 7:32:24 ET]
Table 'Sheliak' 9-max Seat #6 is the button
Seat 1: 32rrew ($100 in chips) 
Seat 2: xhinostrabli ($79 in chips) 
Seat 3: xxxZeka ($119.30 in chips) 
Seat 4: Dickyxxx ($101.50 in chips) 
Seat 6: matiko09 ($110.87 in chips) 
Seat 7: stds st ($41.62 in chips) 
stds st: posts small blind $0.50
ipashutapkom: is sitting out 
32rrew: posts big blind $1
*** HOLE CARDS ***
Dealt to matiko09 [Js Ah]
ipashutapkom leaves the table
xhinostrabli: raises $1 to $2
xxxZeka: folds 
Dickyxxx: folds 
matiko09: raises $4 to $6
stds st: folds 
32rrew: folds 
xhinostrabli: folds 
Uncalled bet ($4) returned to matiko09
matiko09 collected $5.50 from pot
matiko09: doesn't show hand 
*** SUMMARY ***
Total pot $5.50 | Rake $0 
Seat 1: 32rrew (big blind) folded before Flop
Seat 2: xhinostrabli folded before Flop
Seat 3: xxxZeka folded before Flop (didn't bet)
Seat 4: Dickyxxx folded before Flop (didn't bet)
Seat 6: matiko09 (button) collected ($5.50)
Seat 7: stds st (small blind) folded before Flop





PokerStars Hand #154364335574:  Hold'em No Limit ($0.50/$1.00 USD) - 2016/06/06 13:32:26 CET [2016/06/06 7:32:26 ET]
Table 'Safara' 9-max Seat #2 is the button
Seat 1: Dickyxxx ($102.04 in chips) 
Seat 2: ozone2003 ($100 in chips) 
Seat 3: erd33 ($174.17 in chips) 
Seat 4: xxxibgdrgn ($103.88 in chips) 
Seat 5: perezzi10 ($70.80 in chips) 
Seat 6: matiko09 ($131.78 in chips) 
Seat 7: PacPacBum ($120.49 in chips) 
Seat 8: o.miro ($149.11 in chips) 
Seat 9: R1aki ($100 in chips) 
erd33: posts small blind $0.50
xxxibgdrgn: posts big blind $1
*** HOLE CARDS ***
Dealt to matiko09 [Jc Kc]
perezzi10: folds 
matiko09: raises $2 to $3
PacPacBum: folds 
o.miro: folds 
R1aki: folds 
Dickyxxx: folds 
ozone2003: folds 
erd33: calls $2.50
xxxibgdrgn: folds 
*** FLOP *** [5s Qs Qc]
erd33: checks 
matiko09: bets $4
erd33: folds 
Uncalled bet ($4) returned to matiko09
matiko09 collected $6.65 from pot
matiko09: doesn't show hand 
*** SUMMARY ***
Total pot $7 | Rake $0.35 
Board [5s Qs Qc]
Seat 1: Dickyxxx folded before Flop (didn't bet)
Seat 2: ozone2003 (button) folded before Flop (didn't bet)
Seat 3: erd33 (small blind) folded on the Flop
Seat 4: xxxibgdrgn (big blind) folded before Flop
Seat 5: perezzi10 folded before Flop (didn't bet)
Seat 6: matiko09 collected ($6.65)
Seat 7: PacPacBum folded before Flop (didn't bet)
Seat 8: o.miro folded before Flop (didn't bet)
Seat 9: R1aki folded before Flop (didn't bet)





PokerStars Hand #154364336577:  Hold'em No Limit ($0.50/$1.00 USD) - 2016/06/06 13:32:29 CET [2016/06/06 7:32:29 ET]
Table 'Heze' 9-max Seat #3 is the button
Seat 1: matiko09 ($178.67 in chips) 
Seat 2: xxxibgdrgn ($100 in chips) 
Seat 3: Dickyxxx ($106.18 in chips) 
Seat 4: Eskimo Fox ($100 in chips) 
Seat 5: stds st ($37 in chips) 
Seat 6: yfcq36 ($139.45 in chips) 
Seat 7: 32rrew ($154.47 in chips) 
Seat 8: PacPacBum ($116.70 in chips) 
Seat 9: Mr.Grigoriy ($132.21 in chips) 
Eskimo Fox: posts small blind $0.50
stds st: posts big blind $1
*** HOLE CARDS ***
Dealt to matiko09 [3s 6h]
yfcq36: folds 
32rrew: folds 
PacPacBum: folds 
Mr.Grigoriy: folds 
matiko09: folds 
xxxibgdrgn: folds 
Dickyxxx: raises $2 to $3
Eskimo Fox: calls $2.50
stds st: folds 
*** FLOP *** [7d 2s 8h]
Eskimo Fox: checks 
Dickyxxx: bets $4.25
Eskimo Fox: folds 
Uncalled bet ($4.25) returned to Dickyxxx
Dickyxxx collected $6.65 from pot
Dickyxxx: doesn't show hand 
*** SUMMARY ***
Total pot $7 | Rake $0.35 
Board [7d 2s 8h]
Seat 1: matiko09 folded before Flop (didn't bet)
Seat 2: xxxibgdrgn folded before Flop (didn't bet)
Seat 3: Dickyxxx (button) collected ($6.65)
Seat 4: Eskimo Fox (small blind) folded on the Flop
Seat 5: stds st (big blind) folded before Flop
Seat 6: yfcq36 folded before Flop (didn't bet)
Seat 7: 32rrew folded before Flop (didn't bet)
Seat 8: PacPacBum folded before Flop (didn't bet)
Seat 9: Mr.Grigoriy folded before Flop (didn't bet)





PokerStars Hand #154364339348:  Hold'em No Limit (€0.50/€1.00 EUR) - 2016/06/06 13:32:35 CET [2016/06/06 7:32:35 ET]
Table 'Lesath' 9-max Seat #9 is the button
Seat 1: o.miro (€100 in chips) 
Seat 2: thecurv (€106.32 in chips) 
Seat 3: ozone2003 (€201.14 in chips) 
Seat 5: matiko09 (€135.08 in chips) 
Seat 6: Dickyxxx (€100 in chips) 
Seat 7: Mr.Grigoriy (€100 in chips) 
Seat 9: 72nloses (€40.84 in chips) 
o.miro: posts small blind €0.50
thecurv: posts big blind €1
*** HOLE CARDS ***
Dealt to matiko09 [2s 5h]
ozone2003: folds 
matiko09: folds 
Dickyxxx: folds 
Mr.Grigoriy: raises €1.50 to €2.50
72nloses: calls €2.50
o.miro: folds 
thecurv: calls €1.50
*** FLOP *** [7s 2h 8d]
thecurv: checks 
Mr.Grigoriy: bets €5.40
72nloses: folds 
thecurv: folds 
Uncalled bet (€5.40) returned to Mr.Grigoriy
Mr.Grigoriy collected €7.60 from pot
Mr.Grigoriy: doesn't show hand 
*** SUMMARY ***
Total pot €8 | Rake €0.40 
Board [7s 2h 8d]
Seat 1: o.miro (small blind) folded before Flop
Seat 2: thecurv (big blind) folded on the Flop
Seat 3: ozone2003 folded before Flop (didn't bet)
Seat 5: matiko09 folded before Flop (didn't bet)
Seat 6: Dickyxxx folded before Flop (didn't bet)
Seat 7: Mr.Grigoriy collected (€7.60)
Seat 9: 72nloses (button) folded on the Flop





PokerStars Hand #154364340401:  Hold'em No Limit ($0.50/$1.00 USD) - 2016/06/06 13:32:37 CET [2016/06/06 7:32:37 ET]
Table 'Williams' 9-max Seat #6 is the button
Seat 1: xhinostrabli ($82.78 in chips) 
Seat 2: matiko09 ($174.51 in chips) 
Seat 3: granbunny ($60.56 in chips) 
Seat 4: Mr.Grigoriy ($105.12 in chips) 
Seat 5: xxxibgdrgn ($103.50 in chips) 
Seat 6: xxxZeka ($134.40 in chips) 
Seat 7: Eskimo Fox ($118.44 in chips) 
Seat 8: Dickyxxx ($104 in chips) 
Seat 9: stds st ($64.76 in chips) 
Eskimo Fox: posts small blind $0.50
Dickyxxx: posts big blind $1
*** HOLE CARDS ***
Dealt to matiko09 [5s 3c]
stds st: folds 
xhinostrabli: raises $1 to $2
matiko09: folds 
granbunny: folds 
Mr.Grigoriy: folds 
xxxibgdrgn: folds 
xxxZeka: folds 
Eskimo Fox: calls $1.50
Dickyxxx: calls $1
*** FLOP *** [7d As Jd]
Eskimo Fox: checks 
Dickyxxx: checks 
xhinostrabli: bets $2.85
Eskimo Fox: calls $2.85
Dickyxxx: folds 
*** TURN *** [7d As Jd] [Jc]
Eskimo Fox: checks 
xhinostrabli: checks 
*** RIVER *** [7d As Jd Jc] [7c]
Eskimo Fox: checks 
xhinostrabli: checks 
*** SHOW DOWN ***
Eskimo Fox: shows [Kc Tc] (two pair, Jacks and Sevens)
xhinostrabli: shows [6c Ac] (two pair, Aces and Jacks)
xhinostrabli collected $11.12 from pot
*** SUMMARY ***
Total pot $11.70 | Rake $0.58 
Board [7d As Jd Jc 7c]
Seat 1: xhinostrabli showed [6c Ac] and won ($11.12) with two pair, Aces and Jacks
Seat 2: matiko09 folded before Flop (didn't bet)
Seat 3: granbunny folded before Flop (didn't bet)
Seat 4: Mr.Grigoriy folded before Flop (didn't bet)
Seat 5: xxxibgdrgn folded before Flop (didn't bet)
Seat 6: xxxZeka (button) folded before Flop (didn't bet)
Seat 7: Eskimo Fox (small blind) showed [Kc Tc] and lost with two pair, Jacks and Sevens
Seat 8: Dickyxxx (big blind) folded on the Flop
Seat 9: stds st folded before Flop (didn't bet)





PokerStars Hand #154364345855:  Hold'em No Limit ($0.50/$1.00 USD) - 2016/06/06 13:32:49 CET [2016/06/06 7:32:49 ET]
Table 'Irmgard II' 9-max Seat #6 is the button
Seat 1: xxxZeka ($101.50 in chips) 
Seat 4: Dickyxxx ($112.61 in chips) 
Seat 5: arctur17 ($146 in chips) 
Seat 6: oliwood2 ($40 in chips) 
Seat 8: matiko09 ($139.20 in chips) 
o.miro will be allowed to play after the button
matiko09: posts small blind $0.50
PacPacBum: is sitting out 
xxxZeka: posts big blind $1
*** HOLE CARDS ***
Dealt to matiko09 [8s 2s]
PacPacBum leaves the table
Dickyxxx: folds 
hurtNCYDE joins the table at seat #9 
arctur17: folds 
oliwood2: folds 
matiko09: folds 
Uncalled bet ($0.50) returned to xxxZeka
hurtNCYDE leaves the table
xxxZeka collected $1 from pot
*** SUMMARY ***
Total pot $1 | Rake $0 
Seat 1: xxxZeka (big blind) collected ($1)
Seat 4: Dickyxxx folded before Flop (didn't bet)
Seat 5: arctur17 folded before Flop (didn't bet)
Seat 6: oliwood2 (button) folded before Flop (didn't bet)
Seat 8: matiko09 (small blind) folded before Flop





PokerStars Hand #154364351545:  Hold'em No Limit ($0.50/$1.00 USD) - 2016/06/06 13:33:02 CET [2016/06/06 7:33:02 ET]
Table 'Sheliak' 9-max Seat #7 is the button
Seat 1: 32rrew ($100 in chips) 
Seat 2: xhinostrabli ($77 in chips) 
Seat 3: xxxZeka ($119.30 in chips) 
Seat 4: Dickyxxx ($101.50 in chips) 
Seat 6: matiko09 ($114.37 in chips) 
Seat 7: stds st ($41.12 in chips) 
32rrew: posts small blind $0.50
xhinostrabli: posts big blind $1
*** HOLE CARDS ***
Dealt to matiko09 [3s Jc]
xxxZeka: folds 
Dickyxxx: folds 
matiko09: folds 
stds st: folds 
32rrew: folds 
Uncalled bet ($0.50) returned to xhinostrabli
xhinostrabli collected $1 from pot
*** SUMMARY ***
Total pot $1 | Rake $0 
Seat 1: 32rrew (small blind) folded before Flop
Seat 2: xhinostrabli (big blind) collected ($1)
Seat 3: xxxZeka folded before Flop (didn't bet)
Seat 4: Dickyxxx folded before Flop (didn't bet)
Seat 6: matiko09 folded before Flop (didn't bet)
Seat 7: stds st (button) folded before Flop (didn't bet)





PokerStars Hand #154364351580:  Hold'em No Limit ($0.50/$1.00 USD) - 2016/06/06 13:33:02 CET [2016/06/06 7:33:02 ET]
Table 'Safara' 9-max Seat #3 is the button
Seat 1: Dickyxxx ($102.04 in chips) 
Seat 2: ozone2003 ($100 in chips) 
Seat 3: erd33 ($171.17 in chips) 
Seat 4: xxxibgdrgn ($102.88 in chips) 
Seat 5: perezzi10 ($70.80 in chips) 
Seat 6: matiko09 ($135.43 in chips) 
Seat 7: PacPacBum ($120.49 in chips) 
Seat 8: o.miro ($149.11 in chips) 
Seat 9: R1aki ($100 in chips) 
xxxibgdrgn: posts small blind $0.50
perezzi10: posts big blind $1
*** HOLE CARDS ***
Dealt to matiko09 [5d Qs]
matiko09: folds 
PacPacBum: folds 
o.miro: folds 
R1aki: folds 
Dickyxxx: folds 
ozone2003: folds 
erd33: folds 
xxxibgdrgn: raises $2 to $3
perezzi10: folds 
Uncalled bet ($2) returned to xxxibgdrgn
xxxibgdrgn collected $2 from pot
xxxibgdrgn: doesn't show hand 
*** SUMMARY ***
Total pot $2 | Rake $0 
Seat 1: Dickyxxx folded before Flop (didn't bet)
Seat 2: ozone2003 folded before Flop (didn't bet)
Seat 3: erd33 (button) folded before Flop (didn't bet)
Seat 4: xxxibgdrgn (small blind) collected ($2)
Seat 5: perezzi10 (big blind) folded before Flop
Seat 6: matiko09 folded before Flop (didn't bet)
Seat 7: PacPacBum folded before Flop (didn't bet)
Seat 8: o.miro folded before Flop (didn't bet)
Seat 9: R1aki folded before Flop (didn't bet)





PokerStars Hand #154364352020:  Hold'em No Limit ($0.50/$1.00 USD) - 2016/06/06 13:33:03 CET [2016/06/06 7:33:03 ET]
Table 'Irmgard II' 9-max Seat #8 is the button
Seat 1: xxxZeka ($102 in chips) 
Seat 4: Dickyxxx ($112.61 in chips) 
Seat 5: arctur17 ($146 in chips) 
Seat 6: oliwood2 ($40 in chips) 
Seat 8: matiko09 ($138.70 in chips) 
xxxZeka: posts small blind $0.50
hammerwife was removed from the table for failing to post
Dickyxxx: posts big blind $1
o.miro: sits out 
*** HOLE CARDS ***
Dealt to matiko09 [Kd 4d]
arctur17: folds 
oliwood2: folds 
matiko09: raises $1.27 to $2.27
oliwood2 said, "little idiot"
xxxZeka: folds 
Dickyxxx: folds 
Uncalled bet ($1.27) returned to matiko09
matiko09 collected $2.50 from pot
matiko09: doesn't show hand 
*** SUMMARY ***
Total pot $2.50 | Rake $0 
Seat 1: xxxZeka (small blind) folded before Flop
Seat 4: Dickyxxx (big blind) folded before Flop
Seat 5: arctur17 folded before Flop (didn't bet)
Seat 6: oliwood2 folded before Flop (didn't bet)
Seat 8: matiko09 (button) collected ($2.50)





PokerStars Hand #154364355962:  Hold'em No Limit (€0.50/€1.00 EUR) - 2016/06/06 13:33:12 CET [2016/06/06 7:33:12 ET]
Table 'Lesath' 9-max Seat #1 is the button
Seat 1: o.miro (€100 in chips) 
Seat 2: thecurv (€103.82 in chips) 
Seat 3: ozone2003 (€201.14 in chips) 
Seat 5: matiko09 (€135.08 in chips) 
Seat 6: Dickyxxx (€100 in chips) 
Seat 7: Mr.Grigoriy (€105.10 in chips) 
Seat 9: 72nloses (€38.34 in chips) 
thecurv: posts small blind €0.50
ozone2003: posts big blind €1
*** HOLE CARDS ***
Dealt to matiko09 [2s Th]
matiko09: folds 
Dickyxxx: folds 
Mr.Grigoriy: folds 
72nloses: folds 
o.miro: raises €1.20 to €2.20
thecurv: folds 
ozone2003: raises €5.80 to €8
stds st leaves the table
ipashutapkom joins the table at seat #8 
ipashutapkom leaves the table
o.miro: raises €12 to €20
ozone2003: raises €181.14 to €201.14 and is all-in
o.miro: folds 
Uncalled bet (€181.14) returned to ozone2003
ozone2003 collected €40.50 from pot
ozone2003: doesn't show hand 
*** SUMMARY ***
Total pot €40.50 | Rake €0 
Seat 1: o.miro (button) folded before Flop
Seat 2: thecurv (small blind) folded before Flop
Seat 3: ozone2003 (big blind) collected (€40.50)
Seat 5: matiko09 folded before Flop (didn't bet)
Seat 6: Dickyxxx folded before Flop (didn't bet)
Seat 7: Mr.Grigoriy folded before Flop (didn't bet)
Seat 9: 72nloses folded before Flop (didn't bet)





PokerStars Hand #154364356234:  Hold'em No Limit ($0.50/$1.00 USD) - 2016/06/06 13:33:13 CET [2016/06/06 7:33:13 ET]
Table 'Gajdariya' 9-max Seat #1 is the button
Seat 1: matiko09 ($133.59 in chips) 
Seat 2: Dickyxxx ($143.32 in chips) 
Seat 3: mooose100 ($98.92 in chips) 
Seat 5: stds st ($62.33 in chips) 
Seat 6: vanilica ($100 in chips) 
Seat 7: hurtNCYDE ($100 in chips) 
Seat 8: Mr.Grigoriy ($161.09 in chips) 
Seat 9: PacPacBum ($110.23 in chips) 
Dickyxxx: posts small blind $0.50
mooose100: posts big blind $1
ozone2003: sits out 
*** HOLE CARDS ***
Dealt to matiko09 [6h Qd]
stds st: folds 
vanilica: raises $1.85 to $2.85
hurtNCYDE: folds 
Mr.Grigoriy: folds 
PacPacBum: folds 
matiko09: folds 
Dickyxxx: folds 
mooose100: folds 
Uncalled bet ($1.85) returned to vanilica
vanilica collected $2.50 from pot
vanilica: doesn't show hand 
*** SUMMARY ***
Total pot $2.50 | Rake $0 
Seat 1: matiko09 (button) folded before Flop (didn't bet)
Seat 2: Dickyxxx (small blind) folded before Flop
Seat 3: mooose100 (big blind) folded before Flop
Seat 5: stds st folded before Flop (didn't bet)
Seat 6: vanilica collected ($2.50)
Seat 7: hurtNCYDE folded before Flop (didn't bet)
Seat 8: Mr.Grigoriy folded before Flop (didn't bet)
Seat 9: PacPacBum folded before Flop (didn't bet)





PokerStars Hand #154364360527:  Hold'em No Limit ($0.50/$1.00 USD) - 2016/06/06 13:33:22 CET [2016/06/06 7:33:22 ET]
Table 'Oppavia' 9-max Seat #9 is the button
Seat 1: xxxZeka ($105.68 in chips) 
Seat 2: o.miro ($100 in chips) 
Seat 3: thecurv ($123.50 in chips) 
Seat 5: Eskimo Fox ($100 in chips) 
Seat 6: stds st ($44.50 in chips) 
Seat 7: chenlongn ($74.50 in chips) 
Seat 8: matiko09 ($108.68 in chips) 
Seat 9: Soundust_007 ($69.50 in chips) 
xxxZeka: posts small blind $0.50
o.miro: posts big blind $1
Mr.Grigoriy: sits out 
*** HOLE CARDS ***
Dealt to matiko09 [Th 2s]
thecurv: folds 
Eskimo Fox: folds 
stds st: folds 
chenlongn: folds 
matiko09: folds 
Soundust_007: folds 
xxxZeka: folds 
Uncalled bet ($0.50) returned to o.miro
o.miro collected $1 from pot
o.miro: doesn't show hand 
*** SUMMARY ***
Total pot $1 | Rake $0 
Seat 1: xxxZeka (small blind) folded before Flop
Seat 2: o.miro (big blind) collected ($1)
Seat 3: thecurv folded before Flop (didn't bet)
Seat 5: Eskimo Fox folded before Flop (didn't bet)
Seat 6: stds st folded before Flop (didn't bet)
Seat 7: chenlongn folded before Flop (didn't bet)
Seat 8: matiko09 folded before Flop (didn't bet)
Seat 9: Soundust_007 (button) folded before Flop (didn't bet)





PokerStars Hand #154364361121:  Hold'em No Limit ($0.50/$1.00 USD) - 2016/06/06 13:33:24 CET [2016/06/06 7:33:24 ET]
Table 'Irmgard II' 9-max Seat #1 is the button
Seat 1: xxxZeka ($101.50 in chips) 
Seat 4: Dickyxxx ($111.61 in chips) 
Seat 5: arctur17 ($146 in chips) 
Seat 6: oliwood2 ($40 in chips) 
Seat 8: matiko09 ($140.20 in chips) 
Dickyxxx: posts small blind $0.50
arctur17: posts big blind $1
o.miro: sits out 
*** HOLE CARDS ***
Dealt to matiko09 [6c 2c]
oliwood2: folds 
Steelpaper joins the table at seat #9 
matiko09: folds 
xxxZeka: folds 
Dickyxxx: folds 
Uncalled bet ($0.50) returned to arctur17
arctur17 collected $1 from pot
arctur17: doesn't show hand 
*** SUMMARY ***
Total pot $1 | Rake $0 
Seat 1: xxxZeka (button) folded before Flop (didn't bet)
Seat 4: Dickyxxx (small blind) folded before Flop
Seat 5: arctur17 (big blind) collected ($1)
Seat 6: oliwood2 folded before Flop (didn't bet)
Seat 8: matiko09 folded before Flop (didn't bet)





PokerStars Hand #154364361715:  Hold'em No Limit ($0.50/$1.00 USD) - 2016/06/06 13:33:25 CET [2016/06/06 7:33:25 ET]
Table 'Chaldaea II' 9-max Seat #1 is the button
Seat 1: ozone2003 ($118.71 in chips) 
Seat 2: Mr.Grigoriy ($101.50 in chips) 
Seat 4: mooose100 ($121.21 in chips) 
Seat 5: stds st ($54.85 in chips) 
Seat 6: PacPacBum ($109.36 in chips) 
Seat 7: xxxibgdrgn ($106.54 in chips) 
Seat 8: 32rrew ($101 in chips) 
Seat 9: matiko09 ($107.64 in chips) 
Mr.Grigoriy: posts small blind $0.50
mooose100: posts big blind $1
*** HOLE CARDS ***
Dealt to matiko09 [As 6h]
stds st: raises $1.50 to $2.50
PacPacBum: folds 
xxxibgdrgn: folds 
32rrew: folds 
matiko09: raises $6.50 to $9
ozone2003: folds 
Mr.Grigoriy: folds 
mooose100: folds 
stds st: folds 
Uncalled bet ($6.50) returned to matiko09
matiko09 collected $6.50 from pot
matiko09: doesn't show hand 
*** SUMMARY ***
Total pot $6.50 | Rake $0 
Seat 1: ozone2003 (button) folded before Flop (didn't bet)
Seat 2: Mr.Grigoriy (small blind) folded before Flop
Seat 4: mooose100 (big blind) folded before Flop
Seat 5: stds st folded before Flop
Seat 6: PacPacBum folded before Flop (didn't bet)
Seat 7: xxxibgdrgn folded before Flop (didn't bet)
Seat 8: 32rrew folded before Flop (didn't bet)
Seat 9: matiko09 collected ($6.50)





PokerStars Hand #154364363876:  Hold'em No Limit ($0.50/$1.00 USD) - 2016/06/06 13:33:30 CET [2016/06/06 7:33:30 ET]
Table 'Smither' 9-max Seat #6 is the button
Seat 1: PacPacBum ($198.24 in chips) 
Seat 2: matiko09 ($115.02 in chips) 
Seat 3: stds st ($40 in chips) 
Seat 4: Mr.Grigoriy ($117.59 in chips) 
Seat 5: Dickyxxx ($100 in chips) 
Seat 6: mooose100 ($92.22 in chips) 
Seat 7: vanilica ($113.05 in chips) 
Seat 8: ozone2003 ($100 in chips) 
vanilica: posts small blind $0.50
ozone2003: posts big blind $1
*** HOLE CARDS ***
Dealt to matiko09 [3h Ts]
PacPacBum: raises $1.04 to $2.04
matiko09: folds 
stds st: folds 
Mr.Grigoriy: folds 
Dickyxxx: calls $2.04
mooose100: folds 
vanilica: folds 
ozone2003: folds 
*** FLOP *** [As Qd 7s]
PacPacBum: bets $2.86
Dickyxxx: calls $2.86
*** TURN *** [As Qd 7s] [6c]
PacPacBum: bets $5.79
Dickyxxx: folds 
Uncalled bet ($5.79) returned to PacPacBum
PacPacBum collected $10.74 from pot
PacPacBum: doesn't show hand 
*** SUMMARY ***
Total pot $11.30 | Rake $0.56 
Board [As Qd 7s 6c]
Seat 1: PacPacBum collected ($10.74)
Seat 2: matiko09 folded before Flop (didn't bet)
Seat 3: stds st folded before Flop (didn't bet)
Seat 4: Mr.Grigoriy folded before Flop (didn't bet)
Seat 5: Dickyxxx folded on the Turn
Seat 6: mooose100 (button) folded before Flop (didn't bet)
Seat 7: vanilica (small blind) folded before Flop
Seat 8: ozone2003 (big blind) folded before Flop





PokerStars Hand #154364365822:  Hold'em No Limit ($0.50/$1.00 USD) - 2016/06/06 13:33:34 CET [2016/06/06 7:33:34 ET]
Table 'Sheliak' 9-max Seat #1 is the button
Seat 1: 32rrew ($100 in chips) 
Seat 2: xhinostrabli ($77.50 in chips) 
Seat 3: xxxZeka ($119.30 in chips) 
Seat 4: Dickyxxx ($101.50 in chips) 
Seat 6: matiko09 ($114.37 in chips) 
Seat 7: stds st ($41.12 in chips) 
xhinostrabli: posts small blind $0.50
xxxZeka: posts big blind $1
*** HOLE CARDS ***
Dealt to matiko09 [3s 8h]
Dickyxxx: folds 
Steelpaper joins the table at seat #9 
matiko09: folds 
stds st: folds 
32rrew: raises $1.50 to $2.50
xhinostrabli: calls $2
xxxZeka: calls $1.50
*** FLOP *** [Kh Ks 2s]
xhinostrabli: checks 
oliwood2 joins the table at seat #8 
xxxZeka: checks 
32rrew: checks 
*** TURN *** [Kh Ks 2s] [Jd]
xhinostrabli: checks 
xxxZeka: checks 
32rrew: checks 
*** RIVER *** [Kh Ks 2s Jd] [Qc]
xhinostrabli: checks 
xxxZeka: bets $4.74
32rrew: folds 
xhinostrabli: folds 
Uncalled bet ($4.74) returned to xxxZeka
xxxZeka collected $7.12 from pot
*** SUMMARY ***
Total pot $7.50 | Rake $0.38 
Board [Kh Ks 2s Jd Qc]
Seat 1: 32rrew (button) folded on the River
Seat 2: xhinostrabli (small blind) folded on the River
Seat 3: xxxZeka (big blind) collected ($7.12)
Seat 4: Dickyxxx folded before Flop (didn't bet)
Seat 6: matiko09 folded before Flop (didn't bet)
Seat 7: stds st folded before Flop (didn't bet)





PokerStars Hand #154364366494:  Hold'em No Limit ($0.50/$1.00 USD) - 2016/06/06 13:33:36 CET [2016/06/06 7:33:36 ET]
Table 'Safara' 9-max Seat #4 is the button
Seat 1: Dickyxxx ($102.04 in chips) 
Seat 2: ozone2003 ($100 in chips) 
Seat 3: erd33 ($171.17 in chips) 
Seat 4: xxxibgdrgn ($103.88 in chips) 
Seat 5: perezzi10 ($69.80 in chips) 
Seat 6: matiko09 ($135.43 in chips) 
Seat 7: PacPacBum ($120.49 in chips) 
Seat 8: o.miro ($149.11 in chips) 
Seat 9: R1aki ($100 in chips) 
perezzi10: posts small blind $0.50
matiko09: posts big blind $1
*** HOLE CARDS ***
Dealt to matiko09 [Jc Kh]
PacPacBum: folds 
o.miro: folds 
R1aki: folds 
Dickyxxx: folds 
ozone2003: folds 
erd33: raises $1 to $2
xxxibgdrgn: folds 
perezzi10: folds 
matiko09: calls $1
*** FLOP *** [8c 3h Js]
matiko09: checks 
erd33: checks 
*** TURN *** [8c 3h Js] [Ad]
matiko09: checks 
erd33: bets $3
matiko09: calls $3
*** RIVER *** [8c 3h Js Ad] [7d]
matiko09: checks 
erd33: bets $6
matiko09: folds 
Uncalled bet ($6) returned to erd33
erd33 collected $9.98 from pot
*** SUMMARY ***
Total pot $10.50 | Rake $0.52 
Board [8c 3h Js Ad 7d]
Seat 1: Dickyxxx folded before Flop (didn't bet)
Seat 2: ozone2003 folded before Flop (didn't bet)
Seat 3: erd33 collected ($9.98)
Seat 4: xxxibgdrgn (button) folded before Flop (didn't bet)
Seat 5: perezzi10 (small blind) folded before Flop
Seat 6: matiko09 (big blind) folded on the River
Seat 7: PacPacBum folded before Flop (didn't bet)
Seat 8: o.miro folded before Flop (didn't bet)
Seat 9: R1aki folded before Flop (didn't bet)





PokerStars Hand #154364366943:  Hold'em No Limit ($0.50/$1.00 USD) - 2016/06/06 13:33:37 CET [2016/06/06 7:33:37 ET]
Table 'Irmgard II' 9-max Seat #4 is the button
Seat 1: xxxZeka ($101.50 in chips) 
Seat 4: Dickyxxx ($111.11 in chips) 
Seat 5: arctur17 ($146.50 in chips) 
Seat 6: oliwood2 ($40 in chips) 
Seat 8: matiko09 ($140.20 in chips) 
Seat 9: Steelpaper ($81 in chips) 
arctur17: posts small blind $0.50
oliwood2: posts big blind $1
o.miro: sits out 
Steelpaper: posts big blind $1
*** HOLE CARDS ***
Dealt to matiko09 [3h Qh]
matiko09: folds 
Steelpaper: raises $2 to $3
xxxZeka: folds 
Dickyxxx: folds 
arctur17: folds 
oliwood2: folds 
Uncalled bet ($2) returned to Steelpaper
Steelpaper collected $2.50 from pot
Steelpaper: doesn't show hand 
*** SUMMARY ***
Total pot $2.50 | Rake $0 
Seat 1: xxxZeka folded before Flop (didn't bet)
Seat 4: Dickyxxx (button) folded before Flop (didn't bet)
Seat 5: arctur17 (small blind) folded before Flop
Seat 6: oliwood2 (big blind) folded before Flop
Seat 8: matiko09 folded before Flop (didn't bet)
Seat 9: Steelpaper collected ($2.50)





PokerStars Hand #154364367554:  Hold'em No Limit ($0.50/$1.00 USD) - 2016/06/06 13:33:38 CET [2016/06/06 7:33:38 ET]
Table 'Gajdariya' 9-max Seat #2 is the button
Seat 1: matiko09 ($133.59 in chips) 
Seat 2: Dickyxxx ($142.82 in chips) 
Seat 3: mooose100 ($97.92 in chips) 
Seat 4: ozone2003 ($100 in chips) 
Seat 5: stds st ($62.33 in chips) 
Seat 6: vanilica ($101.50 in chips) 
Seat 7: hurtNCYDE ($100 in chips) 
Seat 8: Mr.Grigoriy ($161.09 in chips) 
Seat 9: PacPacBum ($110.23 in chips) 
mooose100: posts small blind $0.50
ozone2003: posts big blind $1
*** HOLE CARDS ***
Dealt to matiko09 [9h Kd]
stds st: folds 
vanilica: folds 
hurtNCYDE: folds 
Mr.Grigoriy: folds 
PacPacBum: folds 
matiko09: raises $1.50 to $2.50
Dickyxxx: folds 
mooose100: folds 
ozone2003: calls $1.50
*** FLOP *** [9d Td 3d]
ozone2003: checks 
matiko09: checks 
*** TURN *** [9d Td 3d] [9c]
ozone2003: bets $4.29
matiko09: calls $4.29
*** RIVER *** [9d Td 3d 9c] [4h]
ozone2003: bets $15.43
matiko09: calls $15.43
*** SHOW DOWN ***
ozone2003: shows [3c 3s] (a full house, Threes full of Nines)
matiko09: mucks hand 
ozone2003 collected $42.69 from pot
*** SUMMARY ***
Total pot $44.94 | Rake $2.25 
Board [9d Td 3d 9c 4h]
Seat 1: matiko09 mucked [9h Kd]
Seat 2: Dickyxxx (button) folded before Flop (didn't bet)
Seat 3: mooose100 (small blind) folded before Flop
Seat 4: ozone2003 (big blind) showed [3c 3s] and won ($42.69) with a full house, Threes full of Nines
Seat 5: stds st folded before Flop (didn't bet)
Seat 6: vanilica folded before Flop (didn't bet)
Seat 7: hurtNCYDE folded before Flop (didn't bet)
Seat 8: Mr.Grigoriy folded before Flop (didn't bet)
Seat 9: PacPacBum folded before Flop (didn't bet)





PokerStars Hand #154364367903:  Hold'em No Limit ($0.50/$1.00 USD) - 2016/06/06 13:33:39 CET [2016/06/06 7:33:39 ET]
Table 'Heze' 9-max Seat #4 is the button
Seat 1: matiko09 ($178.67 in chips) 
Seat 2: xxxibgdrgn ($100 in chips) 
Seat 3: Dickyxxx ($109.83 in chips) 
Seat 4: Eskimo Fox ($100 in chips) 
Seat 5: stds st ($36 in chips) 
Seat 7: 32rrew ($154.47 in chips) 
Seat 8: PacPacBum ($116.70 in chips) 
Seat 9: Mr.Grigoriy ($132.21 in chips) 
stds st: posts small blind $0.50
yfcq36: is sitting out 
32rrew: posts big blind $1
*** HOLE CARDS ***
Dealt to matiko09 [8h Ts]
PacPacBum: folds 
Mr.Grigoriy: raises $2 to $3
matiko09: folds 
xxxibgdrgn: folds 
Dickyxxx: folds 
Eskimo Fox: folds 
stds st: folds 
32rrew: folds 
Uncalled bet ($2) returned to Mr.Grigoriy
Mr.Grigoriy collected $2.50 from pot
Mr.Grigoriy: doesn't show hand 
*** SUMMARY ***
Total pot $2.50 | Rake $0 
Seat 1: matiko09 folded before Flop (didn't bet)
Seat 2: xxxibgdrgn folded before Flop (didn't bet)
Seat 3: Dickyxxx folded before Flop (didn't bet)
Seat 4: Eskimo Fox (button) folded before Flop (didn't bet)
Seat 5: stds st (small blind) folded before Flop
Seat 7: 32rrew (big blind) folded before Flop
Seat 8: PacPacBum folded before Flop (didn't bet)
Seat 9: Mr.Grigoriy collected ($2.50)





PokerStars Hand #154364370397:  Hold'em No Limit ($0.50/$1.00 USD) - 2016/06/06 13:33:44 CET [2016/06/06 7:33:44 ET]
Table 'Oppavia' 9-max Seat #1 is the button
Seat 1: xxxZeka ($105.18 in chips) 
Seat 2: o.miro ($100.50 in chips) 
Seat 3: thecurv ($123.50 in chips) 
Seat 5: Eskimo Fox ($100 in chips) 
Seat 6: stds st ($44.50 in chips) 
Seat 7: chenlongn ($74.50 in chips) 
Seat 8: matiko09 ($108.68 in chips) 
Seat 9: Soundust_007 ($69.50 in chips) 
o.miro: posts small blind $0.50
thecurv: posts big blind $1
Mr.Grigoriy: sits out 
*** HOLE CARDS ***
Dealt to matiko09 [Td Qs]
Eskimo Fox: folds 
stds st: folds 
chenlongn: folds 
matiko09: folds 
Soundust_007: folds 
xxxZeka: raises $1.50 to $2.50
o.miro: raises $7 to $9.50
thecurv: folds 
xxxZeka: calls $7
*** FLOP *** [4c 6d Jc]
o.miro: checks 
xxxZeka: bets $11
o.miro: calls $11
*** TURN *** [4c 6d Jc] [2s]
o.miro: checks 
xxxZeka: checks 
*** RIVER *** [4c 6d Jc 2s] [6s]
o.miro: bets $29
xxxZeka: folds 
Uncalled bet ($29) returned to o.miro
o.miro collected $39.90 from pot
o.miro: doesn't show hand 
*** SUMMARY ***
Total pot $42 | Rake $2.10 
Board [4c 6d Jc 2s 6s]
Seat 1: xxxZeka (button) folded on the River
Seat 2: o.miro (small blind) collected ($39.90)
Seat 3: thecurv (big blind) folded before Flop
Seat 5: Eskimo Fox folded before Flop (didn't bet)
Seat 6: stds st folded before Flop (didn't bet)
Seat 7: chenlongn folded before Flop (didn't bet)
Seat 8: matiko09 folded before Flop (didn't bet)
Seat 9: Soundust_007 folded before Flop (didn't bet)





PokerStars Hand #154364371875:  Hold'em No Limit ($0.50/$1.00 USD) - 2016/06/06 13:33:48 CET [2016/06/06 7:33:48 ET]
Table 'Wezen II' 9-max Seat #9 is the button
Seat 1: matiko09 ($100 in chips) 
Seat 2: Mr.Grigoriy ($111.12 in chips) 
Seat 3: Dickyxxx ($108.62 in chips) 
Seat 4: xxxibgdrgn ($198.50 in chips) 
Seat 5: stds st ($41.55 in chips) 
Seat 6: Eskimo Fox ($100 in chips) 
Seat 7: KDJAll3 ($91.73 in chips) 
Seat 8: o.miro ($100 in chips) 
Seat 9: Cogss ($95.70 in chips) 
matiko09: posts small blind $0.50
Mr.Grigoriy: posts big blind $1
*** HOLE CARDS ***
Dealt to matiko09 [5h Ah]
Dickyxxx: folds 
xxxibgdrgn: raises $2 to $3
stds st: folds 
Eskimo Fox: folds 
KDJAll3: folds 
o.miro: folds 
Cogss: folds 
matiko09: folds 
Mr.Grigoriy: folds 
Uncalled bet ($2) returned to xxxibgdrgn
xxxibgdrgn collected $2.50 from pot
xxxibgdrgn: doesn't show hand 
*** SUMMARY ***
Total pot $2.50 | Rake $0 
Seat 1: matiko09 (small blind) folded before Flop
Seat 2: Mr.Grigoriy (big blind) folded before Flop
Seat 3: Dickyxxx folded before Flop (didn't bet)
Seat 4: xxxibgdrgn collected ($2.50)
Seat 5: stds st folded before Flop (didn't bet)
Seat 6: Eskimo Fox folded before Flop (didn't bet)
Seat 7: KDJAll3 folded before Flop (didn't bet)
Seat 8: o.miro folded before Flop (didn't bet)
Seat 9: Cogss (button) folded before Flop (didn't bet)





PokerStars Hand #154364376374:  Hold'em No Limit ($0.50/$1.00 USD) - 2016/06/06 13:33:58 CET [2016/06/06 7:33:58 ET]
Table 'Williams' 9-max Seat #7 is the button
Seat 1: xhinostrabli ($89.05 in chips) 
Seat 2: matiko09 ($174.51 in chips) 
Seat 3: granbunny ($60.56 in chips) 
Seat 4: Mr.Grigoriy ($105.12 in chips) 
Seat 5: xxxibgdrgn ($103.50 in chips) 
Seat 6: xxxZeka ($134.40 in chips) 
Seat 7: Eskimo Fox ($113.59 in chips) 
Seat 8: Dickyxxx ($102 in chips) 
Seat 9: stds st ($64.76 in chips) 
Dickyxxx: posts small blind $0.50
stds st: posts big blind $1
*** HOLE CARDS ***
Dealt to matiko09 [3c 6s]
xhinostrabli: folds 
matiko09: folds 
granbunny: raises $2 to $3
Mr.Grigoriy: folds 
xxxibgdrgn: raises $6 to $9
xxxZeka: folds 
Eskimo Fox: folds 
Dickyxxx: folds 
stds st: folds 
granbunny: folds 
Uncalled bet ($6) returned to xxxibgdrgn
xxxibgdrgn collected $7.50 from pot
xxxibgdrgn: doesn't show hand 
*** SUMMARY ***
Total pot $7.50 | Rake $0 
Seat 1: xhinostrabli folded before Flop (didn't bet)
Seat 2: matiko09 folded before Flop (didn't bet)
Seat 3: granbunny folded before Flop
Seat 4: Mr.Grigoriy folded before Flop (didn't bet)
Seat 5: xxxibgdrgn collected ($7.50)
Seat 6: xxxZeka folded before Flop (didn't bet)
Seat 7: Eskimo Fox (button) folded before Flop (didn't bet)
Seat 8: Dickyxxx (small blind) folded before Flop
Seat 9: stds st (big blind) folded before Flop





PokerStars Hand #154364378967:  Hold'em No Limit ($0.50/$1.00 USD) - 2016/06/06 13:34:03 CET [2016/06/06 7:34:03 ET]
Table 'Chaldaea II' 9-max Seat #2 is the button
Seat 1: ozone2003 ($118.71 in chips) 
Seat 2: Mr.Grigoriy ($101 in chips) 
Seat 4: mooose100 ($120.21 in chips) 
Seat 5: stds st ($52.35 in chips) 
Seat 6: PacPacBum ($109.36 in chips) 
Seat 7: xxxibgdrgn ($106.54 in chips) 
Seat 8: 32rrew ($101 in chips) 
Seat 9: matiko09 ($111.64 in chips) 
mooose100: posts small blind $0.50
stds st: posts big blind $1
*** HOLE CARDS ***
Dealt to matiko09 [9d Ac]
PacPacBum: folds 
xxxibgdrgn: folds 
32rrew: folds 
matiko09: folds 
ozone2003: folds 
Mr.Grigoriy: folds 
mooose100: raises $2 to $3
stds st: folds 
Uncalled bet ($2) returned to mooose100
mooose100 collected $2 from pot
*** SUMMARY ***
Total pot $2 | Rake $0 
Seat 1: ozone2003 folded before Flop (didn't bet)
Seat 2: Mr.Grigoriy (button) folded before Flop (didn't bet)
Seat 4: mooose100 (small blind) collected ($2)
Seat 5: stds st (big blind) folded before Flop
Seat 6: PacPacBum folded before Flop (didn't bet)
Seat 7: xxxibgdrgn folded before Flop (didn't bet)
Seat 8: 32rrew folded before Flop (didn't bet)
Seat 9: matiko09 folded before Flop (didn't bet)





PokerStars Hand #154364381706:  Hold'em No Limit ($0.50/$1.00 USD) - 2016/06/06 13:34:10 CET [2016/06/06 7:34:10 ET]
Table 'Irmgard II' 9-max Seat #5 is the button
Seat 1: xxxZeka ($101.50 in chips) 
Seat 4: Dickyxxx ($111.11 in chips) 
Seat 5: arctur17 ($146 in chips) 
Seat 6: oliwood2 ($40 in chips) 
Seat 7: o.miro ($100 in chips) 
Seat 8: matiko09 ($140.20 in chips) 
Seat 9: Steelpaper ($82.50 in chips) 
oliwood2: posts small blind $0.50
o.miro: posts big blind $1
stds st: sits out 
*** HOLE CARDS ***
Dealt to matiko09 [4c 7d]
matiko09: folds 
Steelpaper: folds 
xxxZeka: raises $2 to $3
Dickyxxx: folds 
arctur17: folds 
oliwood2: folds 
o.miro: folds 
Uncalled bet ($2) returned to xxxZeka
xxxZeka collected $2.50 from pot
*** SUMMARY ***
Total pot $2.50 | Rake $0 
Seat 1: xxxZeka collected ($2.50)
Seat 4: Dickyxxx folded before Flop (didn't bet)
Seat 5: arctur17 (button) folded before Flop (didn't bet)
Seat 6: oliwood2 (small blind) folded before Flop
Seat 7: o.miro (big blind) folded before Flop
Seat 8: matiko09 folded before Flop (didn't bet)
Seat 9: Steelpaper folded before Flop (didn't bet)





PokerStars Hand #154364383057:  Hold'em No Limit ($0.50/$1.00 USD) - 2016/06/06 13:34:13 CET [2016/06/06 7:34:13 ET]
Table 'Smither' 9-max Seat #7 is the button
Seat 1: PacPacBum ($204.08 in chips) 
Seat 2: matiko09 ($115.02 in chips) 
Seat 3: stds st ($40 in chips) 
Seat 4: Mr.Grigoriy ($117.59 in chips) 
Seat 5: Dickyxxx ($100 in chips) 
Seat 6: mooose100 ($92.22 in chips) 
Seat 7: vanilica ($112.55 in chips) 
Seat 8: ozone2003 ($100 in chips) 
ozone2003: posts small blind $0.50
PacPacBum: posts big blind $1
*** HOLE CARDS ***
Dealt to matiko09 [4c Kh]
matiko09: folds 
stds st: folds 
Mr.Grigoriy: folds 
Dickyxxx: raises $2 to $3
mooose100: folds 
vanilica: folds 
ozone2003: folds 
PacPacBum: folds 
Uncalled bet ($2) returned to Dickyxxx
Dickyxxx collected $2.50 from pot
Dickyxxx: doesn't show hand 
*** SUMMARY ***
Total pot $2.50 | Rake $0 
Seat 1: PacPacBum (big blind) folded before Flop
Seat 2: matiko09 folded before Flop (didn't bet)
Seat 3: stds st folded before Flop (didn't bet)
Seat 4: Mr.Grigoriy folded before Flop (didn't bet)
Seat 5: Dickyxxx collected ($2.50)
Seat 6: mooose100 folded before Flop (didn't bet)
Seat 7: vanilica (button) folded before Flop (didn't bet)
Seat 8: ozone2003 (small blind) folded before Flop





PokerStars Hand #154364384366:  Hold'em No Limit ($0.50/$1.00 USD) - 2016/06/06 13:34:16 CET [2016/06/06 7:34:16 ET]
Table 'Heze' 9-max Seat #5 is the button
Seat 1: matiko09 ($178.67 in chips) 
Seat 2: xxxibgdrgn ($100 in chips) 
Seat 3: Dickyxxx ($109.83 in chips) 
Seat 4: Eskimo Fox ($100 in chips) 
Seat 5: stds st ($35.50 in chips) 
Seat 7: 32rrew ($153.47 in chips) 
Seat 8: PacPacBum ($116.70 in chips) 
Seat 9: Mr.Grigoriy ($133.71 in chips) 
32rrew: posts small blind $0.50
PacPacBum: posts big blind $1
*** HOLE CARDS ***
Dealt to matiko09 [7d Ad]
Mr.Grigoriy: folds 
matiko09: folds 
xxxibgdrgn: folds 
Dickyxxx: folds 
Eskimo Fox: raises $1.50 to $2.50
stds st: folds 
32rrew: folds 
PacPacBum: folds 
Uncalled bet ($1.50) returned to Eskimo Fox
Eskimo Fox collected $2.50 from pot
Eskimo Fox: doesn't show hand 
*** SUMMARY ***
Total pot $2.50 | Rake $0 
Seat 1: matiko09 folded before Flop (didn't bet)
Seat 2: xxxibgdrgn folded before Flop (didn't bet)
Seat 3: Dickyxxx folded before Flop (didn't bet)
Seat 4: Eskimo Fox collected ($2.50)
Seat 5: stds st (button) folded before Flop (didn't bet)
Seat 7: 32rrew (small blind) folded before Flop
Seat 8: PacPacBum (big blind) folded before Flop
Seat 9: Mr.Grigoriy folded before Flop (didn't bet)





PokerStars Hand #154364390095:  Hold'em No Limit ($0.50/$1.00 USD) - 2016/06/06 13:34:29 CET [2016/06/06 7:34:29 ET]
Table 'Wezen II' 9-max Seat #1 is the button
Seat 1: matiko09 ($100 in chips) 
Seat 2: Mr.Grigoriy ($110.12 in chips) 
Seat 3: Dickyxxx ($108.62 in chips) 
Seat 4: xxxibgdrgn ($200 in chips) 
Seat 5: stds st ($41.55 in chips) 
Seat 6: Eskimo Fox ($100 in chips) 
Seat 7: KDJAll3 ($91.73 in chips) 
Seat 8: o.miro ($100 in chips) 
Seat 9: Cogss ($95.70 in chips) 
Mr.Grigoriy: posts small blind $0.50
Dickyxxx: posts big blind $1
*** HOLE CARDS ***
Dealt to matiko09 [Qh 3d]
xxxibgdrgn: folds 
stds st: folds 
Eskimo Fox: folds 
KDJAll3: raises $1 to $2
o.miro: raises $5.50 to $7.50
Cogss: folds 
matiko09: folds 
Mr.Grigoriy: folds 
Dickyxxx: folds 
KDJAll3: calls $5.50
*** FLOP *** [5d 6c 2s]
KDJAll3: bets $6
o.miro: calls $6
*** TURN *** [5d 6c 2s] [9s]
KDJAll3: bets $12
o.miro: folds 
Uncalled bet ($12) returned to KDJAll3
KDJAll3 collected $27.08 from pot
KDJAll3: doesn't show hand 
*** SUMMARY ***
Total pot $28.50 | Rake $1.42 
Board [5d 6c 2s 9s]
Seat 1: matiko09 (button) folded before Flop (didn't bet)
Seat 2: Mr.Grigoriy (small blind) folded before Flop
Seat 3: Dickyxxx (big blind) folded before Flop
Seat 4: xxxibgdrgn folded before Flop (didn't bet)
Seat 5: stds st folded before Flop (didn't bet)
Seat 6: Eskimo Fox folded before Flop (didn't bet)
Seat 7: KDJAll3 collected ($27.08)
Seat 8: o.miro folded on the Turn
Seat 9: Cogss folded before Flop (didn't bet)





PokerStars Hand #154364390733:  Hold'em No Limit (€0.50/€1.00 EUR) - 2016/06/06 13:34:30 CET [2016/06/06 7:34:30 ET]
Table 'Lesath' 9-max Seat #2 is the button
Seat 1: o.miro (€100 in chips) 
Seat 2: thecurv (€103.32 in chips) 
Seat 3: ozone2003 (€221.64 in chips) 
Seat 5: matiko09 (€135.08 in chips) 
Seat 6: Dickyxxx (€100 in chips) 
Seat 7: Mr.Grigoriy (€105.10 in chips) 
Seat 9: 72nloses (€38.34 in chips) 
ozone2003: posts small blind €0.50
matiko09: posts big blind €1
*** HOLE CARDS ***
Dealt to matiko09 [Js 8h]
Dickyxxx: folds 
hurtNCYDE joins the table at seat #8 
hurtNCYDE leaves the table
Mr.Grigoriy: raises €2 to €3
72nloses: folds 
o.miro: folds 
thecurv: folds 
ozone2003: folds 
matiko09: folds 
Uncalled bet (€2) returned to Mr.Grigoriy
Mr.Grigoriy collected €2.50 from pot
Mr.Grigoriy: doesn't show hand 
*** SUMMARY ***
Total pot €2.50 | Rake €0 
Seat 1: o.miro folded before Flop (didn't bet)
Seat 2: thecurv (button) folded before Flop (didn't bet)
Seat 3: ozone2003 (small blind) folded before Flop
Seat 5: matiko09 (big blind) folded before Flop
Seat 6: Dickyxxx folded before Flop (didn't bet)
Seat 7: Mr.Grigoriy collected (€2.50)
Seat 9: 72nloses folded before Flop (didn't bet)





PokerStars Hand #154364393337:  Hold'em No Limit ($0.50/$1.00 USD) - 2016/06/06 13:34:36 CET [2016/06/06 7:34:36 ET]
Table 'Irmgard II' 9-max Seat #6 is the button
Seat 1: xxxZeka ($103 in chips) 
Seat 4: Dickyxxx ($111.11 in chips) 
Seat 5: arctur17 ($146 in chips) 
Seat 6: oliwood2 ($40 in chips) 
Seat 7: o.miro ($100 in chips) 
Seat 8: matiko09 ($140.20 in chips) 
Seat 9: Steelpaper ($82.50 in chips) 
o.miro: posts small blind $0.50
matiko09: posts big blind $1
stds st: sits out 
*** HOLE CARDS ***
Dealt to matiko09 [8c 4s]
Steelpaper has timed out
Steelpaper: folds 
xxxZeka: folds 
hurtNCYDE joins the table at seat #2 
Dickyxxx: folds 
arctur17: folds 
oliwood2: folds 
o.miro: raises $2 to $3
matiko09: folds 
Uncalled bet ($2) returned to o.miro
o.miro collected $2 from pot
o.miro: doesn't show hand 
*** SUMMARY ***
Total pot $2 | Rake $0 
Seat 1: xxxZeka folded before Flop (didn't bet)
Seat 4: Dickyxxx folded before Flop (didn't bet)
Seat 5: arctur17 folded before Flop (didn't bet)
Seat 6: oliwood2 (button) folded before Flop (didn't bet)
Seat 7: o.miro (small blind) collected ($2)
Seat 8: matiko09 (big blind) folded before Flop
Seat 9: Steelpaper folded before Flop (didn't bet)





PokerStars Hand #154364395740:  Hold'em No Limit ($0.50/$1.00 USD) - 2016/06/06 13:34:41 CET [2016/06/06 7:34:41 ET]
Table 'Chaldaea II' 9-max Seat #4 is the button
Seat 1: ozone2003 ($118.71 in chips) 
Seat 2: Mr.Grigoriy ($101 in chips) 
Seat 4: mooose100 ($121.21 in chips) 
Seat 5: stds st ($51.35 in chips) 
Seat 6: PacPacBum ($109.36 in chips) 
Seat 7: xxxibgdrgn ($106.54 in chips) 
Seat 8: 32rrew ($101 in chips) 
Seat 9: matiko09 ($111.64 in chips) 
stds st: posts small blind $0.50
PacPacBum: posts big blind $1
*** HOLE CARDS ***
Dealt to matiko09 [7h Jd]
xxxibgdrgn: folds 
32rrew: folds 
matiko09: folds 
ozone2003: folds 
Mr.Grigoriy: folds 
mooose100: folds 
stds st: folds 
Uncalled bet ($0.50) returned to PacPacBum
PacPacBum collected $1 from pot
PacPacBum: doesn't show hand 
*** SUMMARY ***
Total pot $1 | Rake $0 
Seat 1: ozone2003 folded before Flop (didn't bet)
Seat 2: Mr.Grigoriy folded before Flop (didn't bet)
Seat 4: mooose100 (button) folded before Flop (didn't bet)
Seat 5: stds st (small blind) folded before Flop
Seat 6: PacPacBum (big blind) collected ($1)
Seat 7: xxxibgdrgn folded before Flop (didn't bet)
Seat 8: 32rrew folded before Flop (didn't bet)
Seat 9: matiko09 folded before Flop (didn't bet)





PokerStars Hand #154364396811:  Hold'em No Limit ($0.50/$1.00 USD) - 2016/06/06 13:34:44 CET [2016/06/06 7:34:44 ET]
Table 'Gajdariya' 9-max Seat #3 is the button
Seat 1: matiko09 ($111.37 in chips) 
Seat 2: Dickyxxx ($142.82 in chips) 
Seat 3: mooose100 ($97.42 in chips) 
Seat 4: ozone2003 ($120.47 in chips) 
Seat 5: stds st ($62.33 in chips) 
Seat 6: vanilica ($101.50 in chips) 
Seat 7: hurtNCYDE ($100 in chips) 
Seat 8: Mr.Grigoriy ($161.09 in chips) 
Seat 9: PacPacBum ($110.23 in chips) 
ozone2003: posts small blind $0.50
stds st: posts big blind $1
*** HOLE CARDS ***
Dealt to matiko09 [Qc 4c]
vanilica: raises $1.85 to $2.85
hurtNCYDE: folds 
Mr.Grigoriy: folds 
PacPacBum: folds 
matiko09: folds 
Dickyxxx: calls $2.85
mooose100: folds 
ozone2003: folds 
stds st: calls $1.85
*** FLOP *** [4s 3c Th]
stds st: checks 
vanilica: checks 
Dickyxxx: bets $5.50
stds st: folds 
vanilica: folds 
Uncalled bet ($5.50) returned to Dickyxxx
Dickyxxx collected $8.60 from pot
Dickyxxx: doesn't show hand 
*** SUMMARY ***
Total pot $9.05 | Rake $0.45 
Board [4s 3c Th]
Seat 1: matiko09 folded before Flop (didn't bet)
Seat 2: Dickyxxx collected ($8.60)
Seat 3: mooose100 (button) folded before Flop (didn't bet)
Seat 4: ozone2003 (small blind) folded before Flop
Seat 5: stds st (big blind) folded on the Flop
Seat 6: vanilica folded on the Flop
Seat 7: hurtNCYDE folded before Flop (didn't bet)
Seat 8: Mr.Grigoriy folded before Flop (didn't bet)
Seat 9: PacPacBum folded before Flop (didn't bet)





PokerStars Hand #154364398803:  Hold'em No Limit ($0.50/$1.00 USD) - 2016/06/06 13:34:48 CET [2016/06/06 7:34:48 ET]
Table 'Safara' 9-max Seat #5 is the button
Seat 1: Dickyxxx ($102.04 in chips) 
Seat 2: ozone2003 ($100 in chips) 
Seat 3: erd33 ($176.15 in chips) 
Seat 4: xxxibgdrgn ($103.88 in chips) 
Seat 5: perezzi10 ($69.30 in chips) 
Seat 6: matiko09 ($130.43 in chips) 
Seat 7: PacPacBum ($120.49 in chips) 
Seat 8: o.miro ($149.11 in chips) 
Seat 9: R1aki ($100 in chips) 
matiko09: posts small blind $0.50
PacPacBum: posts big blind $1
*** HOLE CARDS ***
Dealt to matiko09 [9c 6s]
o.miro: folds 
R1aki: folds 
Dickyxxx: folds 
ozone2003: folds 
erd33: folds 
xxxibgdrgn: folds 
perezzi10: folds 
matiko09: folds 
Uncalled bet ($0.50) returned to PacPacBum
PacPacBum collected $1 from pot
PacPacBum: doesn't show hand 
*** SUMMARY ***
Total pot $1 | Rake $0 
Seat 1: Dickyxxx folded before Flop (didn't bet)
Seat 2: ozone2003 folded before Flop (didn't bet)
Seat 3: erd33 folded before Flop (didn't bet)
Seat 4: xxxibgdrgn folded before Flop (didn't bet)
Seat 5: perezzi10 (button) folded before Flop (didn't bet)
Seat 6: matiko09 (small blind) folded before Flop
Seat 7: PacPacBum (big blind) collected ($1)
Seat 8: o.miro folded before Flop (didn't bet)
Seat 9: R1aki folded before Flop (didn't bet)





PokerStars Hand #154364400531:  Hold'em No Limit ($0.50/$1.00 USD) - 2016/06/06 13:34:52 CET [2016/06/06 7:34:52 ET]
Table 'Heze' 9-max Seat #7 is the button
Seat 1: matiko09 ($178.67 in chips) 
Seat 2: xxxibgdrgn ($100 in chips) 
Seat 3: Dickyxxx ($109.83 in chips) 
Seat 4: Eskimo Fox ($101.50 in chips) 
Seat 5: stds st ($35.50 in chips) 
Seat 7: 32rrew ($152.97 in chips) 
Seat 8: PacPacBum ($115.70 in chips) 
Seat 9: Mr.Grigoriy ($133.71 in chips) 
PacPacBum: posts small blind $0.50
Mr.Grigoriy: posts big blind $1
*** HOLE CARDS ***
Dealt to matiko09 [5h Ts]
matiko09: folds 
xxxibgdrgn: folds 
Dickyxxx: folds 
Eskimo Fox: raises $1.50 to $2.50
stds st: folds 
32rrew: folds 
PacPacBum: calls $2
Mr.Grigoriy: calls $1.50
*** FLOP *** [4c Th 9c]
PacPacBum: checks 
Mr.Grigoriy: checks 
Eskimo Fox: checks 
*** TURN *** [4c Th 9c] [4s]
PacPacBum: checks 
Mr.Grigoriy: checks 
Eskimo Fox: bets $4.50
PacPacBum: calls $4.50
Mr.Grigoriy: folds 
*** RIVER *** [4c Th 9c 4s] [Tc]
PacPacBum: checks 
Eskimo Fox: checks 
*** SHOW DOWN ***
PacPacBum: shows [9s 9h] (a full house, Nines full of Tens)
Eskimo Fox: mucks hand 
PacPacBum collected $15.68 from pot
*** SUMMARY ***
Total pot $16.50 | Rake $0.82 
Board [4c Th 9c 4s Tc]
Seat 1: matiko09 folded before Flop (didn't bet)
Seat 2: xxxibgdrgn folded before Flop (didn't bet)
Seat 3: Dickyxxx folded before Flop (didn't bet)
Seat 4: Eskimo Fox mucked [Js Qs]
Seat 5: stds st folded before Flop (didn't bet)
Seat 7: 32rrew (button) folded before Flop (didn't bet)
Seat 8: PacPacBum (small blind) showed [9s 9h] and won ($15.68) with a full house, Nines full of Tens
Seat 9: Mr.Grigoriy (big blind) folded on the Turn





PokerStars Hand #154364401835:  Hold'em No Limit ($0.50/$1.00 USD) - 2016/06/06 13:34:55 CET [2016/06/06 7:34:55 ET]
Table 'Smither' 9-max Seat #8 is the button
Seat 1: PacPacBum ($203.08 in chips) 
Seat 2: matiko09 ($115.02 in chips) 
Seat 3: stds st ($40 in chips) 
Seat 4: Mr.Grigoriy ($117.59 in chips) 
Seat 5: Dickyxxx ($101.50 in chips) 
Seat 6: mooose100 ($92.22 in chips) 
Seat 7: vanilica ($112.55 in chips) 
Seat 8: ozone2003 ($100 in chips) 
PacPacBum: posts small blind $0.50
matiko09: posts big blind $1
*** HOLE CARDS ***
Dealt to matiko09 [2s Kd]
stds st: folds 
Mr.Grigoriy: folds 
Dickyxxx: folds 
mooose100: calls $1
vanilica: folds 
ozone2003: folds 
PacPacBum: folds 
matiko09: checks 
*** FLOP *** [9d 4d 5s]
matiko09: checks 
mooose100: bets $2.38
matiko09: folds 
Uncalled bet ($2.38) returned to mooose100
mooose100 collected $2.38 from pot
mooose100: doesn't show hand 
*** SUMMARY ***
Total pot $2.50 | Rake $0.12 
Board [9d 4d 5s]
Seat 1: PacPacBum (small blind) folded before Flop
Seat 2: matiko09 (big blind) folded on the Flop
Seat 3: stds st folded before Flop (didn't bet)
Seat 4: Mr.Grigoriy folded before Flop (didn't bet)
Seat 5: Dickyxxx folded before Flop (didn't bet)
Seat 6: mooose100 collected ($2.38)
Seat 7: vanilica folded before Flop (didn't bet)
Seat 8: ozone2003 (button) folded before Flop (didn't bet)





PokerStars Hand #154364402630:  Hold'em No Limit ($0.50/$1.00 USD) - 2016/06/06 13:34:57 CET [2016/06/06 7:34:57 ET]
Table 'Williams' 9-max Seat #8 is the button
Seat 1: xhinostrabli ($89.05 in chips) 
Seat 2: matiko09 ($174.51 in chips) 
Seat 3: granbunny ($57.56 in chips) 
Seat 4: Mr.Grigoriy ($105.12 in chips) 
Seat 5: xxxibgdrgn ($108 in chips) 
Seat 6: xxxZeka ($134.40 in chips) 
Seat 7: Eskimo Fox ($113.59 in chips) 
Seat 8: Dickyxxx ($101.50 in chips) 
Seat 9: stds st ($63.76 in chips) 
stds st: posts small blind $0.50
xhinostrabli: posts big blind $1
*** HOLE CARDS ***
Dealt to matiko09 [6h Qc]
matiko09: folds 
granbunny: folds 
Mr.Grigoriy: folds 
xxxibgdrgn: folds 
xxxZeka: folds 
Eskimo Fox: folds 
Dickyxxx: raises $2 to $3
stds st: folds 
xhinostrabli: folds 
Uncalled bet ($2) returned to Dickyxxx
Dickyxxx collected $2.50 from pot
Dickyxxx: doesn't show hand 
*** SUMMARY ***
Total pot $2.50 | Rake $0 
Seat 1: xhinostrabli (big blind) folded before Flop
Seat 2: matiko09 folded before Flop (didn't bet)
Seat 3: granbunny folded before Flop (didn't bet)
Seat 4: Mr.Grigoriy folded before Flop (didn't bet)
Seat 5: xxxibgdrgn folded before Flop (didn't bet)
Seat 6: xxxZeka folded before Flop (didn't bet)
Seat 7: Eskimo Fox folded before Flop (didn't bet)
Seat 8: Dickyxxx (button) collected ($2.50)
Seat 9: stds st (small blind) folded before Flop





PokerStars Hand #154364404147:  Hold'em No Limit (€0.50/€1.00 EUR) - 2016/06/06 13:35:00 CET [2016/06/06 7:35:00 ET]
Table 'Lesath' 9-max Seat #3 is the button
Seat 1: o.miro (€100 in chips) 
Seat 2: thecurv (€103.32 in chips) 
Seat 3: ozone2003 (€221.14 in chips) 
Seat 5: matiko09 (€134.08 in chips) 
Seat 6: Dickyxxx (€100 in chips) 
Seat 7: Mr.Grigoriy (€106.60 in chips) 
Seat 9: 72nloses (€38.34 in chips) 
matiko09: posts small blind €0.50
Dickyxxx: posts big blind €1
*** HOLE CARDS ***
Dealt to matiko09 [5d Qh]
Mr.Grigoriy: folds 
72nloses: folds 
o.miro: folds 
thecurv: folds 
ozone2003: folds 
matiko09: folds 
Uncalled bet (€0.50) returned to Dickyxxx
Dickyxxx collected €1 from pot
Dickyxxx: doesn't show hand 
*** SUMMARY ***
Total pot €1 | Rake €0 
Seat 1: o.miro folded before Flop (didn't bet)
Seat 2: thecurv folded before Flop (didn't bet)
Seat 3: ozone2003 (button) folded before Flop (didn't bet)
Seat 5: matiko09 (small blind) folded before Flop
Seat 6: Dickyxxx (big blind) collected (€1)
Seat 7: Mr.Grigoriy folded before Flop (didn't bet)
Seat 9: 72nloses folded before Flop (didn't bet)





PokerStars Hand #154364405789:  Hold'em No Limit ($0.50/$1.00 USD) - 2016/06/06 13:35:04 CET [2016/06/06 7:35:04 ET]
Table 'Chaldaea II' 9-max Seat #5 is the button
Seat 1: ozone2003 ($118.71 in chips) 
Seat 2: Mr.Grigoriy ($101 in chips) 
Seat 4: mooose100 ($121.21 in chips) 
Seat 5: stds st ($50.85 in chips) 
Seat 6: PacPacBum ($109.86 in chips) 
Seat 7: xxxibgdrgn ($106.54 in chips) 
Seat 8: 32rrew ($101 in chips) 
Seat 9: matiko09 ($111.64 in chips) 
PacPacBum: posts small blind $0.50
xxxibgdrgn: posts big blind $1
*** HOLE CARDS ***
Dealt to matiko09 [Tc Ah]
32rrew: folds 
matiko09: folds 
ozone2003: folds 
Mr.Grigoriy: folds 
mooose100: folds 
stds st: raises $1.02 to $2.02
PacPacBum: folds 
xxxibgdrgn: folds 
Uncalled bet ($1.02) returned to stds st
stds st collected $2.50 from pot
stds st: doesn't show hand 
*** SUMMARY ***
Total pot $2.50 | Rake $0 
Seat 1: ozone2003 folded before Flop (didn't bet)
Seat 2: Mr.Grigoriy folded before Flop (didn't bet)
Seat 4: mooose100 folded before Flop (didn't bet)
Seat 5: stds st (button) collected ($2.50)
Seat 6: PacPacBum (small blind) folded before Flop
Seat 7: xxxibgdrgn (big blind) folded before Flop
Seat 8: 32rrew folded before Flop (didn't bet)
Seat 9: matiko09 folded before Flop (didn't bet)





PokerStars Hand #154364412256:  Hold'em No Limit ($0.50/$1.00 USD) - 2016/06/06 13:35:18 CET [2016/06/06 7:35:18 ET]
Table 'Sheliak' 9-max Seat #2 is the button
Seat 1: 32rrew ($100 in chips) 
Seat 2: xhinostrabli ($75 in chips) 
Seat 3: xxxZeka ($123.92 in chips) 
Seat 4: Dickyxxx ($101.50 in chips) 
Seat 6: matiko09 ($114.37 in chips) 
Seat 7: stds st ($41.12 in chips) 
xxxZeka: posts small blind $0.50
Dickyxxx: posts big blind $1
oliwood2: sits out 
Steelpaper: sits out 
*** HOLE CARDS ***
Dealt to matiko09 [7s Kc]
matiko09: folds 
stds st: folds 
32rrew: folds 
xhinostrabli: raises $1 to $2
xxxZeka: raises $5 to $7
Dickyxxx: calls $6
xhinostrabli: folds 
*** FLOP *** [3c Ac 3d]
xxxZeka: checks 
Dickyxxx: checks 
*** TURN *** [3c Ac 3d] [2c]
xxxZeka: checks 
Dickyxxx: checks 
*** RIVER *** [3c Ac 3d 2c] [6c]
xxxZeka: bets $9
Dickyxxx: folds 
Uncalled bet ($9) returned to xxxZeka
xxxZeka collected $15.20 from pot
*** SUMMARY ***
Total pot $16 | Rake $0.80 
Board [3c Ac 3d 2c 6c]
Seat 1: 32rrew folded before Flop (didn't bet)
Seat 2: xhinostrabli (button) folded before Flop
Seat 3: xxxZeka (small blind) collected ($15.20)
Seat 4: Dickyxxx (big blind) folded on the River
Seat 6: matiko09 folded before Flop (didn't bet)
Seat 7: stds st folded before Flop (didn't bet)





PokerStars Hand #154364413845:  Hold'em No Limit ($0.50/$1.00 USD) - 2016/06/06 13:35:22 CET [2016/06/06 7:35:22 ET]
Table 'Safara' 9-max Seat #6 is the button
Seat 1: Dickyxxx ($102.04 in chips) 
Seat 2: ozone2003 ($100 in chips) 
Seat 3: erd33 ($176.15 in chips) 
Seat 4: xxxibgdrgn ($103.88 in chips) 
Seat 5: perezzi10 ($69.30 in chips) 
Seat 6: matiko09 ($129.93 in chips) 
Seat 7: PacPacBum ($120.99 in chips) 
Seat 8: o.miro ($149.11 in chips) 
Seat 9: R1aki ($100 in chips) 
PacPacBum: posts small blind $0.50
o.miro: posts big blind $1
*** HOLE CARDS ***
Dealt to matiko09 [3d 9s]
R1aki: folds 
Dickyxxx: folds 
ozone2003: folds 
erd33: raises $2 to $3
xxxibgdrgn: folds 
perezzi10: calls $3
matiko09: folds 
PacPacBum: folds 
o.miro: folds 
*** FLOP *** [6c Kd 4s]
erd33: checks 
perezzi10: checks 
*** TURN *** [6c Kd 4s] [2s]
erd33: checks 
perezzi10: checks 
*** RIVER *** [6c Kd 4s 2s] [8d]
erd33: checks 
perezzi10: checks 
*** SHOW DOWN ***
erd33: shows [Qh Th] (high card King)
perezzi10: shows [Ad 4h] (a pair of Fours)
perezzi10 collected $7.12 from pot
*** SUMMARY ***
Total pot $7.50 | Rake $0.38 
Board [6c Kd 4s 2s 8d]
Seat 1: Dickyxxx folded before Flop (didn't bet)
Seat 2: ozone2003 folded before Flop (didn't bet)
Seat 3: erd33 showed [Qh Th] and lost with high card King
Seat 4: xxxibgdrgn folded before Flop (didn't bet)
Seat 5: perezzi10 showed [Ad 4h] and won ($7.12) with a pair of Fours
Seat 6: matiko09 (button) folded before Flop (didn't bet)
Seat 7: PacPacBum (small blind) folded before Flop
Seat 8: o.miro (big blind) folded before Flop
Seat 9: R1aki folded before Flop (didn't bet)





PokerStars Hand #154364414215:  Hold'em No Limit ($0.50/$1.00 USD) - 2016/06/06 13:35:23 CET [2016/06/06 7:35:23 ET]
Table 'Irmgard II' 9-max Seat #7 is the button
Seat 1: xxxZeka ($103 in chips) 
Seat 4: Dickyxxx ($111.11 in chips) 
Seat 5: arctur17 ($146 in chips) 
Seat 6: oliwood2 ($40 in chips) 
Seat 7: o.miro ($101 in chips) 
Seat 8: matiko09 ($139.20 in chips) 
Seat 9: Steelpaper ($82.50 in chips) 
matiko09: posts small blind $0.50
Steelpaper: posts big blind $1
hurtNCYDE: sits out 
stds st: sits out 
*** HOLE CARDS ***
Dealt to matiko09 [Qh 7c]
xxxZeka: folds 
Dickyxxx: folds 
arctur17: folds 
oliwood2: folds 
o.miro: raises $1.50 to $2.50
matiko09: folds 
Steelpaper: calls $1.50
*** FLOP *** [2c Qc 3s]
Steelpaper: bets $5.22
o.miro: folds 
Uncalled bet ($5.22) returned to Steelpaper
Steelpaper collected $5.22 from pot
Steelpaper: doesn't show hand 
*** SUMMARY ***
Total pot $5.50 | Rake $0.28 
Board [2c Qc 3s]
Seat 1: xxxZeka folded before Flop (didn't bet)
Seat 4: Dickyxxx folded before Flop (didn't bet)
Seat 5: arctur17 folded before Flop (didn't bet)
Seat 6: oliwood2 folded before Flop (didn't bet)
Seat 7: o.miro (button) folded on the Flop
Seat 8: matiko09 (small blind) folded before Flop
Seat 9: Steelpaper (big blind) collected ($5.22)





PokerStars Hand #154364415296:  Hold'em No Limit ($0.50/$1.00 USD) - 2016/06/06 13:35:25 CET [2016/06/06 7:35:25 ET]
Table 'Chaldaea II' 9-max Seat #6 is the button
Seat 1: ozone2003 ($118.71 in chips) 
Seat 2: Mr.Grigoriy ($101 in chips) 
Seat 4: mooose100 ($121.21 in chips) 
Seat 5: stds st ($52.35 in chips) 
Seat 6: PacPacBum ($109.36 in chips) 
Seat 7: xxxibgdrgn ($105.54 in chips) 
Seat 8: 32rrew ($101 in chips) 
Seat 9: matiko09 ($111.64 in chips) 
xxxibgdrgn: posts small blind $0.50
32rrew: posts big blind $1
*** HOLE CARDS ***
Dealt to matiko09 [Ah 9c]
matiko09: folds 
ozone2003: folds 
Mr.Grigoriy: folds 
mooose100: calls $1
stds st: folds 
PacPacBum: folds 
xxxibgdrgn: folds 
32rrew: raises $4 to $5
mooose100: calls $4
*** FLOP *** [3s Jh Ts]
32rrew: checks 
mooose100: bets $9.98
32rrew: raises $17.02 to $27
mooose100: folds 
Uncalled bet ($17.02) returned to 32rrew
32rrew collected $28.94 from pot
32rrew: doesn't show hand 
*** SUMMARY ***
Total pot $30.46 | Rake $1.52 
Board [3s Jh Ts]
Seat 1: ozone2003 folded before Flop (didn't bet)
Seat 2: Mr.Grigoriy folded before Flop (didn't bet)
Seat 4: mooose100 folded on the Flop
Seat 5: stds st folded before Flop (didn't bet)
Seat 6: PacPacBum (button) folded before Flop (didn't bet)
Seat 7: xxxibgdrgn (small blind) folded before Flop
Seat 8: 32rrew (big blind) collected ($28.94)
Seat 9: matiko09 folded before Flop (didn't bet)





PokerStars Hand #154364415808:  Hold'em No Limit (€0.50/€1.00 EUR) - 2016/06/06 13:35:27 CET [2016/06/06 7:35:27 ET]
Table 'Lesath' 9-max Seat #5 is the button
Seat 1: o.miro (€100 in chips) 
Seat 2: thecurv (€103.32 in chips) 
Seat 3: ozone2003 (€221.14 in chips) 
Seat 5: matiko09 (€133.58 in chips) 
Seat 6: Dickyxxx (€100.50 in chips) 
Seat 7: Mr.Grigoriy (€106.60 in chips) 
Seat 9: 72nloses (€38.34 in chips) 
Dickyxxx: posts small blind €0.50
Mr.Grigoriy: posts big blind €1
*** HOLE CARDS ***
Dealt to matiko09 [6s Td]
72nloses: folds 
o.miro: folds 
thecurv: raises €1 to €2
ozone2003: folds 
matiko09: folds 
Dickyxxx: folds 
Mr.Grigoriy: folds 
Uncalled bet (€1) returned to thecurv
thecurv collected €2.50 from pot
thecurv: doesn't show hand 
*** SUMMARY ***
Total pot €2.50 | Rake €0 
Seat 1: o.miro folded before Flop (didn't bet)
Seat 2: thecurv collected (€2.50)
Seat 3: ozone2003 folded before Flop (didn't bet)
Seat 5: matiko09 (button) folded before Flop (didn't bet)
Seat 6: Dickyxxx (small blind) folded before Flop
Seat 7: Mr.Grigoriy (big blind) folded before Flop
Seat 9: 72nloses folded before Flop (didn't bet)





PokerStars Hand #154364416427:  Hold'em No Limit ($0.50/$1.00 USD) - 2016/06/06 13:35:28 CET [2016/06/06 7:35:28 ET]
Table 'Gajdariya' 9-max Seat #4 is the button
Seat 1: matiko09 ($111.37 in chips) 
Seat 2: Dickyxxx ($148.57 in chips) 
Seat 3: mooose100 ($97.42 in chips) 
Seat 4: ozone2003 ($119.97 in chips) 
Seat 5: stds st ($59.48 in chips) 
Seat 6: vanilica ($100 in chips) 
Seat 7: hurtNCYDE ($100 in chips) 
Seat 8: Mr.Grigoriy ($161.09 in chips) 
Seat 9: PacPacBum ($110.23 in chips) 
stds st: posts small blind $0.50
vanilica: posts big blind $1
*** HOLE CARDS ***
Dealt to matiko09 [Kh 2h]
hurtNCYDE: folds 
Mr.Grigoriy: folds 
PacPacBum: folds 
matiko09: folds 
Dickyxxx: raises $2 to $3
mooose100: calls $3
ozone2003: calls $3
stds st: folds 
vanilica: folds 
*** FLOP *** [5h Jh 9h]
Dickyxxx: checks 
mooose100: checks 
ozone2003: bets $8.06
Dickyxxx: folds 
mooose100: folds 
Uncalled bet ($8.06) returned to ozone2003
ozone2003 collected $9.98 from pot
ozone2003: doesn't show hand 
*** SUMMARY ***
Total pot $10.50 | Rake $0.52 
Board [5h Jh 9h]
Seat 1: matiko09 folded before Flop (didn't bet)
Seat 2: Dickyxxx folded on the Flop
Seat 3: mooose100 folded on the Flop
Seat 4: ozone2003 (button) collected ($9.98)
Seat 5: stds st (small blind) folded before Flop
Seat 6: vanilica (big blind) folded before Flop
Seat 7: hurtNCYDE folded before Flop (didn't bet)
Seat 8: Mr.Grigoriy folded before Flop (didn't bet)
Seat 9: PacPacBum folded before Flop (didn't bet)





PokerStars Hand #154364418380:  Hold'em No Limit ($0.50/$1.00 USD) - 2016/06/06 13:35:32 CET [2016/06/06 7:35:32 ET]
Table 'Smither' 9-max Seat #1 is the button
Seat 1: PacPacBum ($202.58 in chips) 
Seat 2: matiko09 ($114.02 in chips) 
Seat 3: stds st ($40 in chips) 
Seat 4: Mr.Grigoriy ($117.59 in chips) 
Seat 5: Dickyxxx ($101.50 in chips) 
Seat 6: mooose100 ($93.60 in chips) 
Seat 7: vanilica ($112.55 in chips) 
Seat 8: ozone2003 ($100 in chips) 
matiko09: posts small blind $0.50
stds st: posts big blind $1
*** HOLE CARDS ***
Dealt to matiko09 [7h Kc]
Mr.Grigoriy: raises $2 to $3
Dickyxxx: folds 
mooose100: calls $3
vanilica: calls $3
ozone2003: folds 
PacPacBum: folds 
matiko09: folds 
stds st: calls $2
*** FLOP *** [7d Th 5c]
stds st: checks 
Mr.Grigoriy: checks 
mooose100: checks 
vanilica: checks 
*** TURN *** [7d Th 5c] [6s]
stds st: checks 
Mr.Grigoriy: bets $7.65
mooose100: folds 
vanilica: folds 
stds st: folds 
Uncalled bet ($7.65) returned to Mr.Grigoriy
Mr.Grigoriy collected $11.88 from pot
Mr.Grigoriy: doesn't show hand 
*** SUMMARY ***
Total pot $12.50 | Rake $0.62 
Board [7d Th 5c 6s]
Seat 1: PacPacBum (button) folded before Flop (didn't bet)
Seat 2: matiko09 (small blind) folded before Flop
Seat 3: stds st (big blind) folded on the Turn
Seat 4: Mr.Grigoriy collected ($11.88)
Seat 5: Dickyxxx folded before Flop (didn't bet)
Seat 6: mooose100 folded on the Turn
Seat 7: vanilica folded on the Turn
Seat 8: ozone2003 folded before Flop (didn't bet)





PokerStars Hand #154364420404:  Hold'em No Limit ($0.50/$1.00 USD) - 2016/06/06 13:35:37 CET [2016/06/06 7:35:37 ET]
Table 'Williams' 9-max Seat #9 is the button
Seat 1: xhinostrabli ($88.05 in chips) 
Seat 2: matiko09 ($174.51 in chips) 
Seat 3: granbunny ($57.56 in chips) 
Seat 4: Mr.Grigoriy ($105.12 in chips) 
Seat 5: xxxibgdrgn ($108 in chips) 
Seat 6: xxxZeka ($134.40 in chips) 
Seat 7: Eskimo Fox ($113.59 in chips) 
Seat 8: Dickyxxx ($103 in chips) 
Seat 9: stds st ($63.26 in chips) 
xhinostrabli: posts small blind $0.50
matiko09: posts big blind $1
*** HOLE CARDS ***
Dealt to matiko09 [7d Qs]
granbunny: folds 
Mr.Grigoriy: folds 
xxxibgdrgn: folds 
xxxZeka: raises $2 to $3
Eskimo Fox: folds 
Dickyxxx: folds 
stds st: folds 
xhinostrabli: calls $2.50
matiko09: folds 
*** FLOP *** [5s 5c 2s]
xhinostrabli: checks 
xxxZeka: bets $4
xhinostrabli: calls $4
*** TURN *** [5s 5c 2s] [Qc]
xhinostrabli: checks 
xxxZeka: bets $9.49
xhinostrabli: calls $9.49
*** RIVER *** [5s 5c 2s Qc] [Ac]
xhinostrabli: checks 
xxxZeka: checks 
*** SHOW DOWN ***
xhinostrabli: shows [Js Jh] (two pair, Jacks and Fives)
xxxZeka: shows [Kd As] (two pair, Aces and Fives)
xxxZeka collected $32.28 from pot
*** SUMMARY ***
Total pot $33.98 | Rake $1.70 
Board [5s 5c 2s Qc Ac]
Seat 1: xhinostrabli (small blind) showed [Js Jh] and lost with two pair, Jacks and Fives
Seat 2: matiko09 (big blind) folded before Flop
Seat 3: granbunny folded before Flop (didn't bet)
Seat 4: Mr.Grigoriy folded before Flop (didn't bet)
Seat 5: xxxibgdrgn folded before Flop (didn't bet)
Seat 6: xxxZeka showed [Kd As] and won ($32.28) with two pair, Aces and Fives
Seat 7: Eskimo Fox folded before Flop (didn't bet)
Seat 8: Dickyxxx folded before Flop (didn't bet)
Seat 9: stds st (button) folded before Flop (didn't bet)





PokerStars Hand #154364432726:  Hold'em No Limit ($0.50/$1.00 USD) - 2016/06/06 13:36:04 CET [2016/06/06 7:36:04 ET]
Table 'Wezen II' 9-max Seat #2 is the button
Seat 1: matiko09 ($100 in chips) 
Seat 2: Mr.Grigoriy ($109.62 in chips) 
Seat 3: Dickyxxx ($107.62 in chips) 
Seat 4: xxxibgdrgn ($200 in chips) 
Seat 5: stds st ($41.55 in chips) 
Seat 6: Eskimo Fox ($100 in chips) 
Seat 7: KDJAll3 ($105.31 in chips) 
Seat 8: o.miro ($100 in chips) 
Seat 9: Cogss ($95.70 in chips) 
Dickyxxx: posts small blind $0.50
xxxibgdrgn: posts big blind $1
*** HOLE CARDS ***
Dealt to matiko09 [Qh 6d]
stds st: folds 
Eskimo Fox: folds 
KDJAll3: folds 
o.miro: folds 
Cogss: folds 
matiko09: folds 
Mr.Grigoriy: raises $1.50 to $2.50
Dickyxxx: folds 
xxxibgdrgn: folds 
Uncalled bet ($1.50) returned to Mr.Grigoriy
Mr.Grigoriy collected $2.50 from pot
Mr.Grigoriy: doesn't show hand 
*** SUMMARY ***
Total pot $2.50 | Rake $0 
Seat 1: matiko09 folded before Flop (didn't bet)
Seat 2: Mr.Grigoriy (button) collected ($2.50)
Seat 3: Dickyxxx (small blind) folded before Flop
Seat 4: xxxibgdrgn (big blind) folded before Flop
Seat 5: stds st folded before Flop (didn't bet)
Seat 6: Eskimo Fox folded before Flop (didn't bet)
Seat 7: KDJAll3 folded before Flop (didn't bet)
Seat 8: o.miro folded before Flop (didn't bet)
Seat 9: Cogss folded before Flop (didn't bet)





PokerStars Hand #154364433701:  Hold'em No Limit (€0.50/€1.00 EUR) - 2016/06/06 13:36:06 CET [2016/06/06 7:36:06 ET]
Table 'Lesath' 9-max Seat #6 is the button
Seat 1: o.miro (€100 in chips) 
Seat 2: thecurv (€104.82 in chips) 
Seat 3: ozone2003 (€221.14 in chips) 
Seat 5: matiko09 (€133.58 in chips) 
Seat 6: Dickyxxx (€100 in chips) 
Seat 7: Mr.Grigoriy (€105.60 in chips) 
Seat 9: 72nloses (€38.34 in chips) 
Mr.Grigoriy: posts small blind €0.50
72nloses: posts big blind €1
*** HOLE CARDS ***
Dealt to matiko09 [As Ah]
o.miro: folds 
thecurv: folds 
ozone2003: folds 
matiko09: raises €1.50 to €2.50
Dickyxxx: calls €2.50
Mr.Grigoriy: folds 
72nloses: raises €8 to €10.50
matiko09: raises €8 to €18.50
Dickyxxx: folds 
72nloses: raises €19.84 to €38.34 and is all-in
matiko09: calls €19.84
*** FLOP *** [Qs 9h Th]
*** TURN *** [Qs 9h Th] [9c]
*** RIVER *** [Qs 9h Th 9c] [4c]
*** SHOW DOWN ***
72nloses: shows [Kc Kd] (two pair, Kings and Nines)
matiko09: shows [As Ah] (two pair, Aces and Nines)
matiko09 collected €77.43 from pot
*** SUMMARY ***
Total pot €79.68 | Rake €2.25 
Board [Qs 9h Th 9c 4c]
Seat 1: o.miro folded before Flop (didn't bet)
Seat 2: thecurv folded before Flop (didn't bet)
Seat 3: ozone2003 folded before Flop (didn't bet)
Seat 5: matiko09 showed [As Ah] and won (€77.43) with two pair, Aces and Nines
Seat 6: Dickyxxx (button) folded before Flop
Seat 7: Mr.Grigoriy (small blind) folded before Flop
Seat 9: 72nloses (big blind) showed [Kc Kd] and lost with two pair, Kings and Nines





PokerStars Hand #154364433756:  Hold'em No Limit ($0.50/$1.00 USD) - 2016/06/06 13:36:06 CET [2016/06/06 7:36:06 ET]
Table 'Irmgard II' 9-max Seat #8 is the button
Seat 1: xxxZeka ($103 in chips) 
Seat 4: Dickyxxx ($111.11 in chips) 
Seat 5: arctur17 ($146 in chips) 
Seat 6: oliwood2 ($40 in chips) 
Seat 7: o.miro ($100 in chips) 
Seat 8: matiko09 ($138.70 in chips) 
Seat 9: Steelpaper ($85.22 in chips) 
Steelpaper: posts small blind $0.50
xxxZeka: posts big blind $1
hurtNCYDE: sits out 
stds st: sits out 
*** HOLE CARDS ***
Dealt to matiko09 [Jh Kc]
Dickyxxx: folds 
arctur17: raises $1 to $2
oliwood2: calls $2
o.miro: folds 
matiko09: calls $2
Steelpaper: folds 
xxxZeka: folds 
*** FLOP *** [9s 6d Jd]
arctur17: checks 
oliwood2: checks 
matiko09: bets $4.62
arctur17: folds 
oliwood2: folds 
Uncalled bet ($4.62) returned to matiko09
matiko09 collected $7.12 from pot
matiko09: doesn't show hand 
*** SUMMARY ***
Total pot $7.50 | Rake $0.38 
Board [9s 6d Jd]
Seat 1: xxxZeka (big blind) folded before Flop
Seat 4: Dickyxxx folded before Flop (didn't bet)
Seat 5: arctur17 folded on the Flop
Seat 6: oliwood2 folded on the Flop
Seat 7: o.miro folded before Flop (didn't bet)
Seat 8: matiko09 (button) collected ($7.12)
Seat 9: Steelpaper (small blind) folded before Flop





PokerStars Hand #154364434151:  Hold'em No Limit ($0.50/$1.00 USD) - 2016/06/06 13:36:07 CET [2016/06/06 7:36:07 ET]
Table 'Oppavia' 9-max Seat #2 is the button
Seat 1: xxxZeka ($100 in chips) 
Seat 2: o.miro ($119.90 in chips) 
Seat 3: thecurv ($122.50 in chips) 
Seat 4: Mr.Grigoriy ($100 in chips) 
Seat 5: Eskimo Fox ($100 in chips) 
Seat 6: stds st ($44.50 in chips) 
Seat 7: chenlongn ($74.50 in chips) 
Seat 8: matiko09 ($108.68 in chips) 
Seat 9: Soundust_007 ($69.50 in chips) 
thecurv: posts small blind $0.50
Mr.Grigoriy: posts big blind $1
*** HOLE CARDS ***
Dealt to matiko09 [2c 9c]
Eskimo Fox: folds 
stds st: folds 
chenlongn: raises $1 to $2
matiko09: folds 
Soundust_007: folds 
xxxZeka: folds 
o.miro: calls $2
thecurv: folds 
Mr.Grigoriy: folds 
*** FLOP *** [4s Ts 2d]
chenlongn: bets $2.61
o.miro: folds 
Uncalled bet ($2.61) returned to chenlongn
chenlongn collected $5.22 from pot
chenlongn: doesn't show hand 
*** SUMMARY ***
Total pot $5.50 | Rake $0.28 
Board [4s Ts 2d]
Seat 1: xxxZeka folded before Flop (didn't bet)
Seat 2: o.miro (button) folded on the Flop
Seat 3: thecurv (small blind) folded before Flop
Seat 4: Mr.Grigoriy (big blind) folded before Flop
Seat 5: Eskimo Fox folded before Flop (didn't bet)
Seat 6: stds st folded before Flop (didn't bet)
Seat 7: chenlongn collected ($5.22)
Seat 8: matiko09 folded before Flop (didn't bet)
Seat 9: Soundust_007 folded before Flop (didn't bet)





PokerStars Hand #154364439216:  Hold'em No Limit ($0.50/$1.00 USD) - 2016/06/06 13:36:18 CET [2016/06/06 7:36:18 ET]
Table 'Safara' 9-max Seat #7 is the button
Seat 1: Dickyxxx ($102.04 in chips) 
Seat 2: ozone2003 ($100 in chips) 
Seat 3: erd33 ($173.15 in chips) 
Seat 4: xxxibgdrgn ($103.88 in chips) 
Seat 5: perezzi10 ($73.42 in chips) 
Seat 6: matiko09 ($129.93 in chips) 
Seat 7: PacPacBum ($120.49 in chips) 
Seat 8: o.miro ($148.11 in chips) 
Seat 9: R1aki ($100 in chips) 
o.miro: posts small blind $0.50
R1aki: posts big blind $1
*** HOLE CARDS ***
Dealt to matiko09 [Js Ts]
Dickyxxx: folds 
ozone2003: folds 
erd33: folds 
xxxibgdrgn: folds 
perezzi10: calls $1
matiko09: raises $3 to $4
PacPacBum: folds 
o.miro: calls $3.50
R1aki: folds 
perezzi10: calls $3
*** FLOP *** [4s Qh Kh]
o.miro: checks 
perezzi10: checks 
matiko09: bets $8
o.miro: folds 
perezzi10: folds 
Uncalled bet ($8) returned to matiko09
matiko09 collected $12.35 from pot
matiko09: doesn't show hand 
*** SUMMARY ***
Total pot $13 | Rake $0.65 
Board [4s Qh Kh]
Seat 1: Dickyxxx folded before Flop (didn't bet)
Seat 2: ozone2003 folded before Flop (didn't bet)
Seat 3: erd33 folded before Flop (didn't bet)
Seat 4: xxxibgdrgn folded before Flop (didn't bet)
Seat 5: perezzi10 folded on the Flop
Seat 6: matiko09 collected ($12.35)
Seat 7: PacPacBum (button) folded before Flop (didn't bet)
Seat 8: o.miro (small blind) folded on the Flop
Seat 9: R1aki (big blind) folded before Flop





PokerStars Hand #154364444398:  Hold'em No Limit ($0.50/$1.00 USD) - 2016/06/06 13:36:30 CET [2016/06/06 7:36:30 ET]
Table 'Sheliak' 9-max Seat #3 is the button
Seat 1: 32rrew ($100 in chips) 
Seat 2: xhinostrabli ($73 in chips) 
Seat 3: xxxZeka ($132.12 in chips) 
Seat 4: Dickyxxx ($100 in chips) 
Seat 6: matiko09 ($114.37 in chips) 
Seat 7: stds st ($41.12 in chips) 
Seat 9: Steelpaper ($81 in chips) 
Dickyxxx: posts small blind $0.50
matiko09: posts big blind $1
oliwood2: sits out 
Steelpaper: posts big blind $1
*** HOLE CARDS ***
Dealt to matiko09 [Kh Tc]
stds st: folds 
Steelpaper: checks 
32rrew: folds 
xhinostrabli: folds 
xxxZeka: folds 
Dickyxxx: folds 
matiko09: checks 
*** FLOP *** [Qd 5d 7h]
matiko09: checks 
Steelpaper: checks 
*** TURN *** [Qd 5d 7h] [Ac]
matiko09: checks 
Steelpaper: checks 
*** RIVER *** [Qd 5d 7h Ac] [3s]
matiko09: checks 
Steelpaper: checks 
*** SHOW DOWN ***
matiko09: shows [Kh Tc] (high card Ace)
Steelpaper: mucks hand 
matiko09 collected $2.38 from pot
*** SUMMARY ***
Total pot $2.50 | Rake $0.12 
Board [Qd 5d 7h Ac 3s]
Seat 1: 32rrew folded before Flop (didn't bet)
Seat 2: xhinostrabli folded before Flop (didn't bet)
Seat 3: xxxZeka (button) folded before Flop (didn't bet)
Seat 4: Dickyxxx (small blind) folded before Flop
Seat 6: matiko09 (big blind) showed [Kh Tc] and won ($2.38) with high card Ace
Seat 7: stds st folded before Flop (didn't bet)
Seat 9: Steelpaper mucked [2d 8h]





PokerStars Hand #154364445997:  Hold'em No Limit ($0.50/$1.00 USD) - 2016/06/06 13:36:33 CET [2016/06/06 7:36:33 ET]
Table 'Heze' 9-max Seat #8 is the button
Seat 1: matiko09 ($178.67 in chips) 
Seat 2: xxxibgdrgn ($100 in chips) 
Seat 3: Dickyxxx ($109.83 in chips) 
Seat 4: Eskimo Fox ($100 in chips) 
Seat 5: stds st ($35.50 in chips) 
Seat 7: 32rrew ($152.97 in chips) 
Seat 8: PacPacBum ($124.38 in chips) 
Seat 9: Mr.Grigoriy ($131.21 in chips) 
Mr.Grigoriy: posts small blind $0.50
matiko09: posts big blind $1
*** HOLE CARDS ***
Dealt to matiko09 [Td 5s]
xxxibgdrgn: folds 
Dickyxxx: folds 
Eskimo Fox: raises $2 to $3
stds st: folds 
32rrew: folds 
PacPacBum: calls $3
Mr.Grigoriy: folds 
matiko09: folds 
*** FLOP *** [Qd Qc Jd]
Eskimo Fox: checks 
PacPacBum: checks 
*** TURN *** [Qd Qc Jd] [Kd]
Eskimo Fox: checks 
PacPacBum: checks 
*** RIVER *** [Qd Qc Jd Kd] [Jc]
Eskimo Fox: checks 
PacPacBum: checks 
*** SHOW DOWN ***
Eskimo Fox: shows [6s 6h] (two pair, Queens and Jacks)
PacPacBum: shows [7c 7d] (two pair, Queens and Jacks)
Eskimo Fox collected $3.56 from pot
PacPacBum collected $3.56 from pot
*** SUMMARY ***
Total pot $7.50 | Rake $0.38 
Board [Qd Qc Jd Kd Jc]
Seat 1: matiko09 (big blind) folded before Flop
Seat 2: xxxibgdrgn folded before Flop (didn't bet)
Seat 3: Dickyxxx folded before Flop (didn't bet)
Seat 4: Eskimo Fox showed [6s 6h] and won ($3.56) with two pair, Queens and Jacks
Seat 5: stds st folded before Flop (didn't bet)
Seat 7: 32rrew folded before Flop (didn't bet)
Seat 8: PacPacBum (button) showed [7c 7d] and won ($3.56) with two pair, Queens and Jacks
Seat 9: Mr.Grigoriy (small blind) folded before Flop





PokerStars Hand #154364447585:  Hold'em No Limit ($0.50/$1.00 USD) - 2016/06/06 13:36:37 CET [2016/06/06 7:36:37 ET]
Table 'Wezen II' 9-max Seat #3 is the button
Seat 1: matiko09 ($100 in chips) 
Seat 2: Mr.Grigoriy ($111.12 in chips) 
Seat 3: Dickyxxx ($107.12 in chips) 
Seat 4: xxxibgdrgn ($199 in chips) 
Seat 5: stds st ($41.55 in chips) 
Seat 6: Eskimo Fox ($100 in chips) 
Seat 7: KDJAll3 ($105.31 in chips) 
Seat 8: o.miro ($100 in chips) 
Seat 9: Cogss ($95.70 in chips) 
xxxibgdrgn: posts small blind $0.50
stds st: posts big blind $1
*** HOLE CARDS ***
Dealt to matiko09 [4c 6d]
Eskimo Fox: folds 
KDJAll3: folds 
o.miro: folds 
Cogss: raises $1 to $2
matiko09: folds 
Mr.Grigoriy: folds 
Dickyxxx: folds 
xxxibgdrgn: folds 
stds st: folds 
Uncalled bet ($1) returned to Cogss
Cogss collected $2.50 from pot
*** SUMMARY ***
Total pot $2.50 | Rake $0 
Seat 1: matiko09 folded before Flop (didn't bet)
Seat 2: Mr.Grigoriy folded before Flop (didn't bet)
Seat 3: Dickyxxx (button) folded before Flop (didn't bet)
Seat 4: xxxibgdrgn (small blind) folded before Flop
Seat 5: stds st (big blind) folded before Flop
Seat 6: Eskimo Fox folded before Flop (didn't bet)
Seat 7: KDJAll3 folded before Flop (didn't bet)
Seat 8: o.miro folded before Flop (didn't bet)
Seat 9: Cogss collected ($2.50)





PokerStars Hand #154364453173:  Hold'em No Limit ($0.50/$1.00 USD) - 2016/06/06 13:36:49 CET [2016/06/06 7:36:49 ET]
Table 'Gajdariya' 9-max Seat #5 is the button
Seat 1: matiko09 ($111.37 in chips) 
Seat 2: Dickyxxx ($145.57 in chips) 
Seat 3: mooose100 ($94.42 in chips) 
Seat 4: ozone2003 ($126.95 in chips) 
Seat 5: stds st ($58.98 in chips) 
Seat 6: vanilica ($100 in chips) 
Seat 7: hurtNCYDE ($100 in chips) 
Seat 8: Mr.Grigoriy ($161.09 in chips) 
Seat 9: PacPacBum ($110.23 in chips) 
vanilica: posts small blind $0.50
hurtNCYDE: posts big blind $1
*** HOLE CARDS ***
Dealt to matiko09 [8d 2h]
Mr.Grigoriy: folds 
PacPacBum: folds 
matiko09: folds 
Dickyxxx: folds 
mooose100: calls $1
ozone2003: folds 
stds st: folds 
vanilica: calls $0.50
hurtNCYDE: raises $5 to $6
mooose100: folds 
vanilica: folds 
Uncalled bet ($5) returned to hurtNCYDE
hurtNCYDE collected $3 from pot
hurtNCYDE: doesn't show hand 
*** SUMMARY ***
Total pot $3 | Rake $0 
Seat 1: matiko09 folded before Flop (didn't bet)
Seat 2: Dickyxxx folded before Flop (didn't bet)
Seat 3: mooose100 folded before Flop
Seat 4: ozone2003 folded before Flop (didn't bet)
Seat 5: stds st (button) folded before Flop (didn't bet)
Seat 6: vanilica (small blind) folded before Flop
Seat 7: hurtNCYDE (big blind) collected ($3)
Seat 8: Mr.Grigoriy folded before Flop (didn't bet)
Seat 9: PacPacBum folded before Flop (didn't bet)





PokerStars Hand #154364457837:  Hold'em No Limit ($0.50/$1.00 USD) - 2016/06/06 13:37:00 CET [2016/06/06 7:37:00 ET]
Table 'Smither' 9-max Seat #2 is the button
Seat 1: PacPacBum ($202.58 in chips) 
Seat 2: matiko09 ($113.52 in chips) 
Seat 3: stds st ($37 in chips) 
Seat 4: Mr.Grigoriy ($126.47 in chips) 
Seat 5: Dickyxxx ($101.50 in chips) 
Seat 6: mooose100 ($90.60 in chips) 
Seat 7: vanilica ($109.55 in chips) 
Seat 8: ozone2003 ($100 in chips) 
stds st: posts small blind $0.50
Mr.Grigoriy: posts big blind $1
*** HOLE CARDS ***
Dealt to matiko09 [5d Kc]
Dickyxxx: folds 
mooose100: calls $1
vanilica: raises $2.59 to $3.59
ozone2003: calls $3.59
PacPacBum: folds 
matiko09: folds 
stds st: folds 
Mr.Grigoriy: folds 
mooose100: calls $2.59
*** FLOP *** [Jd Qh 2d]
mooose100: checks 
vanilica: checks 
ozone2003: checks 
*** TURN *** [Jd Qh 2d] [Kh]
mooose100: checks 
vanilica: bets $8.62
ozone2003: folds 
mooose100: folds 
Uncalled bet ($8.62) returned to vanilica
vanilica collected $11.66 from pot
vanilica: doesn't show hand 
*** SUMMARY ***
Total pot $12.27 | Rake $0.61 
Board [Jd Qh 2d Kh]
Seat 1: PacPacBum folded before Flop (didn't bet)
Seat 2: matiko09 (button) folded before Flop (didn't bet)
Seat 3: stds st (small blind) folded before Flop
Seat 4: Mr.Grigoriy (big blind) folded before Flop
Seat 5: Dickyxxx folded before Flop (didn't bet)
Seat 6: mooose100 folded on the Turn
Seat 7: vanilica collected ($11.66)
Seat 8: ozone2003 folded on the Turn





PokerStars Hand #154364458788:  Hold'em No Limit ($0.50/$1.00 USD) - 2016/06/06 13:37:02 CET [2016/06/06 7:37:02 ET]
Table 'Chaldaea II' 9-max Seat #7 is the button
Seat 1: ozone2003 ($118.71 in chips) 
Seat 2: Mr.Grigoriy ($101 in chips) 
Seat 4: mooose100 ($106.23 in chips) 
Seat 5: stds st ($52.35 in chips) 
Seat 6: PacPacBum ($109.36 in chips) 
Seat 7: xxxibgdrgn ($105.04 in chips) 
Seat 8: 32rrew ($114.96 in chips) 
Seat 9: matiko09 ($111.64 in chips) 
32rrew: posts small blind $0.50
matiko09: posts big blind $1
*** HOLE CARDS ***
Dealt to matiko09 [Ac 8s]
ozone2003: folds 
Mr.Grigoriy: folds 
mooose100: folds 
stds st: raises $1.50 to $2.50
PacPacBum: folds 
xxxibgdrgn: raises $6.50 to $9
32rrew: folds 
matiko09: folds 
stds st: folds 
Uncalled bet ($6.50) returned to xxxibgdrgn
xxxibgdrgn collected $6.50 from pot
xxxibgdrgn: doesn't show hand 
*** SUMMARY ***
Total pot $6.50 | Rake $0 
Seat 1: ozone2003 folded before Flop (didn't bet)
Seat 2: Mr.Grigoriy folded before Flop (didn't bet)
Seat 4: mooose100 folded before Flop (didn't bet)
Seat 5: stds st folded before Flop
Seat 6: PacPacBum folded before Flop (didn't bet)
Seat 7: xxxibgdrgn (button) collected ($6.50)
Seat 8: 32rrew (small blind) folded before Flop
Seat 9: matiko09 (big blind) folded before Flop





PokerStars Hand #154364459626:  Hold'em No Limit ($0.50/$1.00 USD) - 2016/06/06 13:37:04 CET [2016/06/06 7:37:04 ET]
Table 'Irmgard II' 9-max Seat #9 is the button
Seat 1: xxxZeka ($102 in chips) 
Seat 2: hurtNCYDE ($100 in chips) 
Seat 4: Dickyxxx ($111.11 in chips) 
Seat 5: arctur17 ($144 in chips) 
Seat 6: oliwood2 ($40 in chips) 
Seat 7: o.miro ($100 in chips) 
Seat 8: matiko09 ($143.82 in chips) 
Seat 9: Steelpaper ($84.72 in chips) 
xxxZeka: posts small blind $0.50
hurtNCYDE: posts big blind $1
stds st: sits out 
*** HOLE CARDS ***
Dealt to matiko09 [Qd Ts]
Dickyxxx: folds 
arctur17: folds 
oliwood2: folds 
o.miro: folds 
matiko09: raises $1.50 to $2.50
Steelpaper: folds 
xxxZeka: folds 
hurtNCYDE: folds 
Uncalled bet ($1.50) returned to matiko09
matiko09 collected $2.50 from pot
matiko09: doesn't show hand 
*** SUMMARY ***
Total pot $2.50 | Rake $0 
Seat 1: xxxZeka (small blind) folded before Flop
Seat 2: hurtNCYDE (big blind) folded before Flop
Seat 4: Dickyxxx folded before Flop (didn't bet)
Seat 5: arctur17 folded before Flop (didn't bet)
Seat 6: oliwood2 folded before Flop (didn't bet)
Seat 7: o.miro folded before Flop (didn't bet)
Seat 8: matiko09 collected ($2.50)
Seat 9: Steelpaper (button) folded before Flop (didn't bet)





PokerStars Hand #154364460111:  Hold'em No Limit ($0.50/$1.00 USD) - 2016/06/06 13:37:05 CET [2016/06/06 7:37:05 ET]
Table 'Safara' 9-max Seat #8 is the button
Seat 1: Dickyxxx ($102.04 in chips) 
Seat 2: ozone2003 ($100 in chips) 
Seat 3: erd33 ($173.15 in chips) 
Seat 4: xxxibgdrgn ($103.88 in chips) 
Seat 5: perezzi10 ($69.42 in chips) 
Seat 6: matiko09 ($138.28 in chips) 
Seat 7: PacPacBum ($120.49 in chips) 
Seat 8: o.miro ($144.11 in chips) 
Seat 9: R1aki ($100 in chips) 
R1aki: posts small blind $0.50
Dickyxxx: posts big blind $1
*** HOLE CARDS ***
Dealt to matiko09 [Ah 5c]
ozone2003: raises $2 to $3
erd33: folds 
xxxibgdrgn: folds 
perezzi10: calls $3
matiko09: folds 
PacPacBum: folds 
o.miro: folds 
R1aki: folds 
Dickyxxx: calls $2
*** FLOP *** [4c Td 9c]
Dickyxxx: checks 
ozone2003: checks 
perezzi10: bets $3
Dickyxxx: folds 
ozone2003: calls $3
*** TURN *** [4c Td 9c] [Kd]
ozone2003: checks 
perezzi10: bets $3
ozone2003: calls $3
*** RIVER *** [4c Td 9c Kd] [3h]
ozone2003: checks 
perezzi10: bets $17
ozone2003: folds 
Uncalled bet ($17) returned to perezzi10
perezzi10 collected $20.42 from pot
*** SUMMARY ***
Total pot $21.50 | Rake $1.08 
Board [4c Td 9c Kd 3h]
Seat 1: Dickyxxx (big blind) folded on the Flop
Seat 2: ozone2003 folded on the River
Seat 3: erd33 folded before Flop (didn't bet)
Seat 4: xxxibgdrgn folded before Flop (didn't bet)
Seat 5: perezzi10 collected ($20.42)
Seat 6: matiko09 folded before Flop (didn't bet)
Seat 7: PacPacBum folded before Flop (didn't bet)
Seat 8: o.miro (button) folded before Flop (didn't bet)
Seat 9: R1aki (small blind) folded before Flop





PokerStars Hand #154364467002:  Hold'em No Limit ($0.50/$1.00 USD) - 2016/06/06 13:37:20 CET [2016/06/06 7:37:20 ET]
Table 'Wezen II' 9-max Seat #4 is the button
Seat 1: matiko09 ($100 in chips) 
Seat 2: Mr.Grigoriy ($111.12 in chips) 
Seat 3: Dickyxxx ($107.12 in chips) 
Seat 4: xxxibgdrgn ($198.50 in chips) 
Seat 5: stds st ($40.55 in chips) 
Seat 6: Eskimo Fox ($100 in chips) 
Seat 7: KDJAll3 ($105.31 in chips) 
Seat 8: o.miro ($100 in chips) 
Seat 9: Cogss ($97.20 in chips) 
stds st: posts small blind $0.50
Eskimo Fox: posts big blind $1
*** HOLE CARDS ***
Dealt to matiko09 [Td Ad]
KDJAll3: folds 
o.miro: folds 
Cogss: folds 
matiko09: raises $2 to $3
Mr.Grigoriy: calls $3
Dickyxxx: folds 
xxxibgdrgn: folds 
stds st: folds 
Eskimo Fox: calls $2
*** FLOP *** [9c 7c As]
Eskimo Fox: checks 
matiko09: checks 
Mr.Grigoriy: checks 
*** TURN *** [9c 7c As] [7s]
Eskimo Fox: checks 
matiko09: bets $4.69
Mr.Grigoriy: folds 
Eskimo Fox: calls $4.69
*** RIVER *** [9c 7c As 7s] [6h]
Eskimo Fox: checks 
matiko09: checks 
*** SHOW DOWN ***
Eskimo Fox: shows [Jd Jh] (two pair, Jacks and Sevens)
matiko09: shows [Td Ad] (two pair, Aces and Sevens)
matiko09 collected $17.94 from pot
*** SUMMARY ***
Total pot $18.88 | Rake $0.94 
Board [9c 7c As 7s 6h]
Seat 1: matiko09 showed [Td Ad] and won ($17.94) with two pair, Aces and Sevens
Seat 2: Mr.Grigoriy folded on the Turn
Seat 3: Dickyxxx folded before Flop (didn't bet)
Seat 4: xxxibgdrgn (button) folded before Flop (didn't bet)
Seat 5: stds st (small blind) folded before Flop
Seat 6: Eskimo Fox (big blind) showed [Jd Jh] and lost with two pair, Jacks and Sevens
Seat 7: KDJAll3 folded before Flop (didn't bet)
Seat 8: o.miro folded before Flop (didn't bet)
Seat 9: Cogss folded before Flop (didn't bet)





PokerStars Hand #154364467114:  Hold'em No Limit (€0.50/€1.00 EUR) - 2016/06/06 13:37:21 CET [2016/06/06 7:37:21 ET]
Table 'Lesath' 9-max Seat #7 is the button
Seat 1: o.miro (€100 in chips) 
Seat 2: thecurv (€104.82 in chips) 
Seat 3: ozone2003 (€221.14 in chips) 
Seat 5: matiko09 (€172.67 in chips) 
Seat 6: Dickyxxx (€100 in chips) 
Seat 7: Mr.Grigoriy (€105.10 in chips) 
Seat 9: 72nloses (€100 in chips) 
72nloses: posts small blind €0.50
o.miro: posts big blind €1
*** HOLE CARDS ***
Dealt to matiko09 [3c 6d]
thecurv: folds 
ozone2003: folds 
matiko09: folds 
Dickyxxx: raises €2 to €3
Mr.Grigoriy: calls €3
72nloses: folds 
o.miro: folds 
*** FLOP *** [5d 6c Ac]
Dickyxxx: bets €4.55
Mr.Grigoriy: calls €4.55
*** TURN *** [5d 6c Ac] [Qc]
Dickyxxx: bets €10.09
Mr.Grigoriy: folds 
Uncalled bet (€10.09) returned to Dickyxxx
Dickyxxx collected €15.77 from pot
Dickyxxx: doesn't show hand 
*** SUMMARY ***
Total pot €16.60 | Rake €0.83 
Board [5d 6c Ac Qc]
Seat 1: o.miro (big blind) folded before Flop
Seat 2: thecurv folded before Flop (didn't bet)
Seat 3: ozone2003 folded before Flop (didn't bet)
Seat 5: matiko09 folded before Flop (didn't bet)
Seat 6: Dickyxxx collected (€15.77)
Seat 7: Mr.Grigoriy (button) folded on the Turn
Seat 9: 72nloses (small blind) folded before Flop





PokerStars Hand #154364470340:  Hold'em No Limit ($0.50/$1.00 USD) - 2016/06/06 13:37:28 CET [2016/06/06 7:37:28 ET]
Table 'Irmgard II' 9-max Seat #1 is the button
Seat 1: xxxZeka ($101.50 in chips) 
Seat 2: hurtNCYDE ($100 in chips) 
Seat 3: stds st ($37.37 in chips) 
Seat 4: Dickyxxx ($111.11 in chips) 
Seat 5: arctur17 ($144 in chips) 
Seat 6: oliwood2 ($40 in chips) 
Seat 7: o.miro ($100 in chips) 
Seat 8: matiko09 ($145.32 in chips) 
Seat 9: Steelpaper ($84.72 in chips) 
hurtNCYDE: posts small blind $0.50
stds st: posts big blind $1
*** HOLE CARDS ***
Dealt to matiko09 [7h 3s]
Dickyxxx: folds 
arctur17: folds 
oliwood2: raises $2.50 to $3.50
o.miro: folds 
matiko09: folds 
Steelpaper: calls $3.50
xxxZeka: folds 
hurtNCYDE: folds 
stds st: folds 
*** FLOP *** [Ks Qc 8s]
oliwood2: bets $6
Steelpaper: calls $6
*** TURN *** [Ks Qc 8s] [9c]
oliwood2: checks 
Steelpaper: bets $9.74
oliwood2: calls $9.74
*** RIVER *** [Ks Qc 8s 9c] [8h]
oliwood2: checks 
Steelpaper: checks 
*** SHOW DOWN ***
oliwood2: shows [Ah Qh] (two pair, Queens and Eights)
Steelpaper: shows [Ad Qd] (two pair, Queens and Eights)
oliwood2 collected $18.99 from pot
Steelpaper collected $18.99 from pot
*** SUMMARY ***
Total pot $39.98 | Rake $2 
Board [Ks Qc 8s 9c 8h]
Seat 1: xxxZeka (button) folded before Flop (didn't bet)
Seat 2: hurtNCYDE (small blind) folded before Flop
Seat 3: stds st (big blind) folded before Flop
Seat 4: Dickyxxx folded before Flop (didn't bet)
Seat 5: arctur17 folded before Flop (didn't bet)
Seat 6: oliwood2 showed [Ah Qh] and won ($18.99) with two pair, Queens and Eights
Seat 7: o.miro folded before Flop (didn't bet)
Seat 8: matiko09 folded before Flop (didn't bet)
Seat 9: Steelpaper showed [Ad Qd] and won ($18.99) with two pair, Queens and Eights





PokerStars Hand #154364470798:  Hold'em No Limit ($0.50/$1.00 USD) - 2016/06/06 13:37:29 CET [2016/06/06 7:37:29 ET]
Table 'Oppavia' 9-max Seat #3 is the button
Seat 1: xxxZeka ($100 in chips) 
Seat 2: o.miro ($117.90 in chips) 
Seat 3: thecurv ($122 in chips) 
Seat 4: Mr.Grigoriy ($100 in chips) 
Seat 5: Eskimo Fox ($100 in chips) 
Seat 6: stds st ($44.50 in chips) 
Seat 7: chenlongn ($77.72 in chips) 
Seat 8: matiko09 ($108.68 in chips) 
Seat 9: Soundust_007 ($69.50 in chips) 
Mr.Grigoriy: posts small blind $0.50
Eskimo Fox: posts big blind $1
*** HOLE CARDS ***
Dealt to matiko09 [Jd Ac]
stds st: folds 
chenlongn: folds 
matiko09: raises $2 to $3
Soundust_007: calls $3
xxxZeka: folds 
o.miro: folds 
thecurv: calls $3
Mr.Grigoriy: folds 
Eskimo Fox: calls $2
*** FLOP *** [4d Kh 3d]
Eskimo Fox: checks 
matiko09: checks 
Soundust_007: bets $3
thecurv: folds 
Eskimo Fox: folds 
matiko09: folds 
Uncalled bet ($3) returned to Soundust_007
Soundust_007 collected $11.88 from pot
Soundust_007: doesn't show hand 
*** SUMMARY ***
Total pot $12.50 | Rake $0.62 
Board [4d Kh 3d]
Seat 1: xxxZeka folded before Flop (didn't bet)
Seat 2: o.miro folded before Flop (didn't bet)
Seat 3: thecurv (button) folded on the Flop
Seat 4: Mr.Grigoriy (small blind) folded before Flop
Seat 5: Eskimo Fox (big blind) folded on the Flop
Seat 6: stds st folded before Flop (didn't bet)
Seat 7: chenlongn folded before Flop (didn't bet)
Seat 8: matiko09 folded on the Flop
Seat 9: Soundust_007 collected ($11.88)





PokerStars Hand #154364470989:  Hold'em No Limit ($0.50/$1.00 USD) - 2016/06/06 13:37:29 CET [2016/06/06 7:37:29 ET]
Table 'Sheliak' 9-max Seat #4 is the button
Seat 1: 32rrew ($100 in chips) 
Seat 2: xhinostrabli ($73 in chips) 
Seat 3: xxxZeka ($132.12 in chips) 
Seat 4: Dickyxxx ($100 in chips) 
Seat 6: matiko09 ($115.75 in chips) 
Seat 7: stds st ($41.12 in chips) 
Seat 9: Steelpaper ($80 in chips) 
matiko09: posts small blind $0.50
stds st: posts big blind $1
oliwood2: sits out 
*** HOLE CARDS ***
Dealt to matiko09 [6d 8s]
Steelpaper: folds 
32rrew: folds 
xhinostrabli: folds 
xxxZeka: folds 
Dickyxxx: folds 
matiko09: folds 
Uncalled bet ($0.50) returned to stds st
stds st collected $1 from pot
stds st: doesn't show hand 
*** SUMMARY ***
Total pot $1 | Rake $0 
Seat 1: 32rrew folded before Flop (didn't bet)
Seat 2: xhinostrabli folded before Flop (didn't bet)
Seat 3: xxxZeka folded before Flop (didn't bet)
Seat 4: Dickyxxx (button) folded before Flop (didn't bet)
Seat 6: matiko09 (small blind) folded before Flop
Seat 7: stds st (big blind) collected ($1)
Seat 9: Steelpaper folded before Flop (didn't bet)





PokerStars Hand #154364472217:  Hold'em No Limit ($0.50/$1.00 USD) - 2016/06/06 13:37:32 CET [2016/06/06 7:37:32 ET]
Table 'Williams' 9-max Seat #1 is the button
Seat 1: xhinostrabli ($71.56 in chips) 
Seat 2: matiko09 ($173.51 in chips) 
Seat 3: granbunny ($57.56 in chips) 
Seat 4: Mr.Grigoriy ($105.12 in chips) 
Seat 5: xxxibgdrgn ($108 in chips) 
Seat 6: xxxZeka ($150.19 in chips) 
Seat 7: Eskimo Fox ($113.59 in chips) 
Seat 8: Dickyxxx ($103 in chips) 
Seat 9: stds st ($63.26 in chips) 
matiko09: posts small blind $0.50
granbunny: posts big blind $1
*** HOLE CARDS ***
Dealt to matiko09 [Tc 5d]
Mr.Grigoriy: folds 
xxxibgdrgn: folds 
xxxZeka: folds 
Eskimo Fox: folds 
Dickyxxx: folds 
stds st: folds 
xhinostrabli: folds 
matiko09: folds 
Uncalled bet ($0.50) returned to granbunny
granbunny collected $1 from pot
granbunny: doesn't show hand 
*** SUMMARY ***
Total pot $1 | Rake $0 
Seat 1: xhinostrabli (button) folded before Flop (didn't bet)
Seat 2: matiko09 (small blind) folded before Flop
Seat 3: granbunny (big blind) collected ($1)
Seat 4: Mr.Grigoriy folded before Flop (didn't bet)
Seat 5: xxxibgdrgn folded before Flop (didn't bet)
Seat 6: xxxZeka folded before Flop (didn't bet)
Seat 7: Eskimo Fox folded before Flop (didn't bet)
Seat 8: Dickyxxx folded before Flop (didn't bet)
Seat 9: stds st folded before Flop (didn't bet)





PokerStars Hand #154364476765:  Hold'em No Limit ($0.50/$1.00 USD) - 2016/06/06 13:37:42 CET [2016/06/06 7:37:42 ET]
Table 'Gajdariya' 9-max Seat #6 is the button
Seat 1: matiko09 ($111.37 in chips) 
Seat 2: Dickyxxx ($145.57 in chips) 
Seat 3: mooose100 ($93.42 in chips) 
Seat 4: ozone2003 ($126.95 in chips) 
Seat 5: stds st ($58.98 in chips) 
Seat 6: vanilica ($100 in chips) 
Seat 7: hurtNCYDE ($102 in chips) 
Seat 8: Mr.Grigoriy ($161.09 in chips) 
Seat 9: PacPacBum ($110.23 in chips) 
hurtNCYDE: posts small blind $0.50
Mr.Grigoriy: posts big blind $1
*** HOLE CARDS ***
Dealt to matiko09 [Ac 2s]
PacPacBum: raises $2 to $3
matiko09: folds 
Dickyxxx: folds 
mooose100: folds 
ozone2003: folds 
stds st: folds 
vanilica: folds 
hurtNCYDE: folds 
Mr.Grigoriy: folds 
Uncalled bet ($2) returned to PacPacBum
PacPacBum collected $2.50 from pot
PacPacBum: doesn't show hand 
*** SUMMARY ***
Total pot $2.50 | Rake $0 
Seat 1: matiko09 folded before Flop (didn't bet)
Seat 2: Dickyxxx folded before Flop (didn't bet)
Seat 3: mooose100 folded before Flop (didn't bet)
Seat 4: ozone2003 folded before Flop (didn't bet)
Seat 5: stds st folded before Flop (didn't bet)
Seat 6: vanilica (button) folded before Flop (didn't bet)
Seat 7: hurtNCYDE (small blind) folded before Flop
Seat 8: Mr.Grigoriy (big blind) folded before Flop
Seat 9: PacPacBum collected ($2.50)





PokerStars Hand #154364481544:  Hold'em No Limit ($0.50/$1.00 USD) - 2016/06/06 13:37:53 CET [2016/06/06 7:37:53 ET]
Table 'Sheliak' 9-max Seat #6 is the button
Seat 1: 32rrew ($100 in chips) 
Seat 2: xhinostrabli ($73 in chips) 
Seat 3: xxxZeka ($132.12 in chips) 
Seat 4: Dickyxxx ($100 in chips) 
Seat 6: matiko09 ($115.25 in chips) 
Seat 7: stds st ($41.62 in chips) 
Seat 8: oliwood2 ($47 in chips) 
Seat 9: Steelpaper ($80 in chips) 
stds st: posts small blind $0.50
oliwood2: posts big blind $1
*** HOLE CARDS ***
Dealt to matiko09 [Th 3d]
Steelpaper: folds 
32rrew: folds 
xhinostrabli: folds 
xxxZeka: raises $2 to $3
Dickyxxx: folds 
matiko09: folds 
stds st: folds 
oliwood2: folds 
Uncalled bet ($2) returned to xxxZeka
xxxZeka collected $2.50 from pot
*** SUMMARY ***
Total pot $2.50 | Rake $0 
Seat 1: 32rrew folded before Flop (didn't bet)
Seat 2: xhinostrabli folded before Flop (didn't bet)
Seat 3: xxxZeka collected ($2.50)
Seat 4: Dickyxxx folded before Flop (didn't bet)
Seat 6: matiko09 (button) folded before Flop (didn't bet)
Seat 7: stds st (small blind) folded before Flop
Seat 8: oliwood2 (big blind) folded before Flop
Seat 9: Steelpaper folded before Flop (didn't bet)





PokerStars Hand #154364482508:  Hold'em No Limit ($0.50/$1.00 USD) - 2016/06/06 13:37:55 CET [2016/06/06 7:37:55 ET]
Table 'Williams' 9-max Seat #2 is the button
Seat 1: xhinostrabli ($71.56 in chips) 
Seat 2: matiko09 ($173.01 in chips) 
Seat 3: granbunny ($58.06 in chips) 
Seat 4: Mr.Grigoriy ($105.12 in chips) 
Seat 5: xxxibgdrgn ($108 in chips) 
Seat 6: xxxZeka ($150.19 in chips) 
Seat 7: Eskimo Fox ($113.59 in chips) 
Seat 8: Dickyxxx ($103 in chips) 
Seat 9: stds st ($63.26 in chips) 
granbunny: posts small blind $0.50
Mr.Grigoriy: posts big blind $1
*** HOLE CARDS ***
Dealt to matiko09 [Jd 7d]
xxxibgdrgn: raises $2 to $3
xxxZeka: folds 
Eskimo Fox: folds 
Dickyxxx: folds 
stds st: folds 
xhinostrabli: raises $7.50 to $10.50
matiko09: folds 
granbunny: folds 
Mr.Grigoriy: folds 
xxxibgdrgn: folds 
Uncalled bet ($7.50) returned to xhinostrabli
xhinostrabli collected $7.50 from pot
*** SUMMARY ***
Total pot $7.50 | Rake $0 
Seat 1: xhinostrabli collected ($7.50)
Seat 2: matiko09 (button) folded before Flop (didn't bet)
Seat 3: granbunny (small blind) folded before Flop
Seat 4: Mr.Grigoriy (big blind) folded before Flop
Seat 5: xxxibgdrgn folded before Flop
Seat 6: xxxZeka folded before Flop (didn't bet)
Seat 7: Eskimo Fox folded before Flop (didn't bet)
Seat 8: Dickyxxx folded before Flop (didn't bet)
Seat 9: stds st folded before Flop (didn't bet)





PokerStars Hand #154364487324:  Hold'em No Limit ($0.50/$1.00 USD) - 2016/06/06 13:38:06 CET [2016/06/06 7:38:06 ET]
Table 'Heze' 9-max Seat #9 is the button
Seat 1: matiko09 ($177.67 in chips) 
Seat 3: Dickyxxx ($109.83 in chips) 
Seat 4: Eskimo Fox ($100.56 in chips) 
Seat 5: stds st ($35.50 in chips) 
Seat 7: 32rrew ($152.97 in chips) 
Seat 8: PacPacBum ($124.94 in chips) 
Seat 9: Mr.Grigoriy ($130.71 in chips) 
matiko09: posts small blind $0.50
xxxibgdrgn: is sitting out 
Dickyxxx: posts big blind $1
*** HOLE CARDS ***
Dealt to matiko09 [Tc Td]
Eskimo Fox: folds 
stds st: folds 
32rrew: folds 
PacPacBum: folds 
Mr.Grigoriy: raises $1 to $2
matiko09: raises $6 to $8
Dickyxxx: calls $7
Mr.Grigoriy: folds 
*** FLOP *** [Jc Qs 2h]
matiko09: checks 
Dickyxxx: checks 
*** TURN *** [Jc Qs 2h] [9s]
matiko09: checks 
Dickyxxx: checks 
*** RIVER *** [Jc Qs 2h 9s] [Kd]
matiko09: bets $10
Dickyxxx: folds 
Uncalled bet ($10) returned to matiko09
matiko09 collected $17.10 from pot
matiko09: doesn't show hand 
*** SUMMARY ***
Total pot $18 | Rake $0.90 
Board [Jc Qs 2h 9s Kd]
Seat 1: matiko09 (small blind) collected ($17.10)
Seat 3: Dickyxxx (big blind) folded on the River
Seat 4: Eskimo Fox folded before Flop (didn't bet)
Seat 5: stds st folded before Flop (didn't bet)
Seat 7: 32rrew folded before Flop (didn't bet)
Seat 8: PacPacBum folded before Flop (didn't bet)
Seat 9: Mr.Grigoriy (button) folded before Flop





PokerStars Hand #154364490515:  Hold'em No Limit ($0.50/$1.00 USD) - 2016/06/06 13:38:13 CET [2016/06/06 7:38:13 ET]
Table 'Chaldaea II' 9-max Seat #8 is the button
Seat 1: ozone2003 ($118.71 in chips) 
Seat 2: Mr.Grigoriy ($101 in chips) 
Seat 4: mooose100 ($106.23 in chips) 
Seat 5: stds st ($49.85 in chips) 
Seat 6: PacPacBum ($109.36 in chips) 
Seat 7: xxxibgdrgn ($109.04 in chips) 
Seat 8: 32rrew ($114.46 in chips) 
Seat 9: matiko09 ($110.64 in chips) 
matiko09: posts small blind $0.50
ozone2003: posts big blind $1
*** HOLE CARDS ***
Dealt to matiko09 [6d 8h]
Mr.Grigoriy: folds 
mooose100: calls $1
stds st: folds 
PacPacBum: folds 
xxxibgdrgn: folds 
32rrew: folds 
matiko09: folds 
ozone2003: raises $3 to $4
mooose100: calls $3
*** FLOP *** [5c 7d Th]
ozone2003: bets $7
mooose100: folds 
Uncalled bet ($7) returned to ozone2003
ozone2003 collected $8.08 from pot
ozone2003: doesn't show hand 
*** SUMMARY ***
Total pot $8.50 | Rake $0.42 
Board [5c 7d Th]
Seat 1: ozone2003 (big blind) collected ($8.08)
Seat 2: Mr.Grigoriy folded before Flop (didn't bet)
Seat 4: mooose100 folded on the Flop
Seat 5: stds st folded before Flop (didn't bet)
Seat 6: PacPacBum folded before Flop (didn't bet)
Seat 7: xxxibgdrgn folded before Flop (didn't bet)
Seat 8: 32rrew (button) folded before Flop (didn't bet)
Seat 9: matiko09 (small blind) folded before Flop





PokerStars Hand #154364491926:  Hold'em No Limit ($0.50/$1.00 USD) - 2016/06/06 13:38:16 CET [2016/06/06 7:38:16 ET]
Table 'Sheliak' 9-max Seat #7 is the button
Seat 1: 32rrew ($100 in chips) 
Seat 2: xhinostrabli ($73 in chips) 
Seat 3: xxxZeka ($133.62 in chips) 
Seat 4: Dickyxxx ($100 in chips) 
Seat 6: matiko09 ($115.25 in chips) 
Seat 7: stds st ($41.12 in chips) 
Seat 8: oliwood2 ($46 in chips) 
Seat 9: Steelpaper ($80 in chips) 
oliwood2: posts small blind $0.50
Steelpaper: posts big blind $1
*** HOLE CARDS ***
Dealt to matiko09 [Qh 4c]
32rrew: folds 
xhinostrabli: folds 
xxxZeka: folds 
Dickyxxx: raises $2 to $3
matiko09: folds 
stds st: folds 
oliwood2: folds 
Steelpaper: folds 
Uncalled bet ($2) returned to Dickyxxx
Dickyxxx collected $2.50 from pot
Dickyxxx: doesn't show hand 
*** SUMMARY ***
Total pot $2.50 | Rake $0 
Seat 1: 32rrew folded before Flop (didn't bet)
Seat 2: xhinostrabli folded before Flop (didn't bet)
Seat 3: xxxZeka folded before Flop (didn't bet)
Seat 4: Dickyxxx collected ($2.50)
Seat 6: matiko09 folded before Flop (didn't bet)
Seat 7: stds st (button) folded before Flop (didn't bet)
Seat 8: oliwood2 (small blind) folded before Flop
Seat 9: Steelpaper (big blind) folded before Flop





PokerStars Hand #154364494987:  Hold'em No Limit ($0.50/$1.00 USD) - 2016/06/06 13:38:23 CET [2016/06/06 7:38:23 ET]
Table 'Smither' 9-max Seat #3 is the button
Seat 1: PacPacBum ($202.58 in chips) 
Seat 2: matiko09 ($113.52 in chips) 
Seat 3: stds st ($36.50 in chips) 
Seat 4: Mr.Grigoriy ($125.47 in chips) 
Seat 5: Dickyxxx ($101.50 in chips) 
Seat 6: mooose100 ($87.01 in chips) 
Seat 7: vanilica ($117.62 in chips) 
Seat 8: ozone2003 ($100 in chips) 
Mr.Grigoriy: posts small blind $0.50
Dickyxxx: posts big blind $1
*** HOLE CARDS ***
Dealt to matiko09 [Ad 5s]
mooose100: folds 
vanilica: folds 
ozone2003: folds 
PacPacBum: raises $1.50 to $2.50
matiko09: raises $6.50 to $9
stds st: folds 
Mr.Grigoriy: folds 
Dickyxxx: folds 
PacPacBum: folds 
Uncalled bet ($6.50) returned to matiko09
matiko09 collected $6.50 from pot
matiko09: doesn't show hand 
*** SUMMARY ***
Total pot $6.50 | Rake $0 
Seat 1: PacPacBum folded before Flop
Seat 2: matiko09 collected ($6.50)
Seat 3: stds st (button) folded before Flop (didn't bet)
Seat 4: Mr.Grigoriy (small blind) folded before Flop
Seat 5: Dickyxxx (big blind) folded before Flop
Seat 6: mooose100 folded before Flop (didn't bet)
Seat 7: vanilica folded before Flop (didn't bet)
Seat 8: ozone2003 folded before Flop (didn't bet)





PokerStars Hand #154364499324:  Hold'em No Limit ($0.50/$1.00 USD) - 2016/06/06 13:38:32 CET [2016/06/06 7:38:32 ET]
Table 'Safara' 9-max Seat #9 is the button
Seat 1: Dickyxxx ($100 in chips) 
Seat 2: ozone2003 ($100 in chips) 
Seat 3: erd33 ($173.15 in chips) 
Seat 4: xxxibgdrgn ($103.88 in chips) 
Seat 5: perezzi10 ($80.84 in chips) 
Seat 6: matiko09 ($138.28 in chips) 
Seat 7: PacPacBum ($120.49 in chips) 
Seat 8: o.miro ($144.11 in chips) 
Seat 9: R1aki ($100 in chips) 
Dickyxxx: posts small blind $0.50
ozone2003: posts big blind $1
*** HOLE CARDS ***
Dealt to matiko09 [2h Td]
erd33: raises $1 to $2
xxxibgdrgn: calls $2
perezzi10: calls $2
matiko09: folds 
PacPacBum: folds 
o.miro: raises $12 to $14
R1aki: calls $14
Dickyxxx: folds 
ozone2003: folds 
erd33: folds 
xxxibgdrgn: calls $12
perezzi10: folds 
*** FLOP *** [Kh Th 8h]
xxxibgdrgn: checks 
o.miro: bets $19
R1aki: calls $19
xxxibgdrgn: folds 
*** TURN *** [Kh Th 8h] [6s]
o.miro: bets $111.11 and is all-in
R1aki: folds 
Uncalled bet ($111.11) returned to o.miro
o.miro collected $83 from pot
o.miro: doesn't show hand 
*** SUMMARY ***
Total pot $85.50 | Rake $2.50 
Board [Kh Th 8h 6s]
Seat 1: Dickyxxx (small blind) folded before Flop
Seat 2: ozone2003 (big blind) folded before Flop
Seat 3: erd33 folded before Flop
Seat 4: xxxibgdrgn folded on the Flop
Seat 5: perezzi10 folded before Flop
Seat 6: matiko09 folded before Flop (didn't bet)
Seat 7: PacPacBum folded before Flop (didn't bet)
Seat 8: o.miro collected ($83)
Seat 9: R1aki (button) folded on the Turn





PokerStars Hand #154364499948:  Hold'em No Limit (€0.50/€1.00 EUR) - 2016/06/06 13:38:34 CET [2016/06/06 7:38:34 ET]
Table 'Lesath' 9-max Seat #9 is the button
Seat 1: o.miro (€100 in chips) 
Seat 2: thecurv (€104.82 in chips) 
Seat 3: ozone2003 (€221.14 in chips) 
Seat 5: matiko09 (€172.67 in chips) 
Seat 6: Dickyxxx (€108.22 in chips) 
Seat 7: Mr.Grigoriy (€100 in chips) 
Seat 9: 72nloses (€99.50 in chips) 
o.miro: posts small blind €0.50
thecurv: posts big blind €1
*** HOLE CARDS ***
Dealt to matiko09 [Ks 2d]
ozone2003: folds 
matiko09: folds 
Dickyxxx: folds 
Mr.Grigoriy: folds 
72nloses: raises €3 to €4
o.miro: calls €3.50
thecurv: folds 
*** FLOP *** [Td 5s 9h]
o.miro: checks 
72nloses: bets €8.55
o.miro: calls €8.55
*** TURN *** [Td 5s 9h] [Ad]
vanilica joins the table at seat #8 
o.miro: checks 
72nloses: checks 
*** RIVER *** [Td 5s 9h Ad] [5d]
o.miro: checks 
72nloses: checks 
*** SHOW DOWN ***
o.miro: shows [Tc Jc] (two pair, Tens and Fives)
72nloses: mucks hand 
o.miro collected €24.80 from pot
*** SUMMARY ***
Total pot €26.10 | Rake €1.30 
Board [Td 5s 9h Ad 5d]
Seat 1: o.miro (small blind) showed [Tc Jc] and won (€24.80) with two pair, Tens and Fives
Seat 2: thecurv (big blind) folded before Flop
Seat 3: ozone2003 folded before Flop (didn't bet)
Seat 5: matiko09 folded before Flop (didn't bet)
Seat 6: Dickyxxx folded before Flop (didn't bet)
Seat 7: Mr.Grigoriy folded before Flop (didn't bet)
Seat 9: 72nloses (button) mucked [Kd Jh]





PokerStars Hand #154364502214:  Hold'em No Limit ($0.50/$1.00 USD) - 2016/06/06 13:38:39 CET [2016/06/06 7:38:39 ET]
Table 'Gajdariya' 9-max Seat #7 is the button
Seat 1: matiko09 ($111.37 in chips) 
Seat 2: Dickyxxx ($145.57 in chips) 
Seat 3: mooose100 ($93.42 in chips) 
Seat 4: ozone2003 ($126.95 in chips) 
Seat 5: stds st ($58.98 in chips) 
Seat 6: vanilica ($100 in chips) 
Seat 7: hurtNCYDE ($101.50 in chips) 
Seat 8: Mr.Grigoriy ($160.09 in chips) 
Seat 9: PacPacBum ($111.73 in chips) 
Mr.Grigoriy: posts small blind $0.50
PacPacBum: posts big blind $1
*** HOLE CARDS ***
Dealt to matiko09 [7s 8h]
matiko09: folds 
Dickyxxx: folds 
mooose100: calls $1
ozone2003: folds 
stds st: folds 
vanilica: folds 
hurtNCYDE: folds 
Mr.Grigoriy: folds 
PacPacBum: checks 
*** FLOP *** [4d Ad 2c]
PacPacBum: checks 
mooose100: checks 
*** TURN *** [4d Ad 2c] [Ah]
PacPacBum: checks 
mooose100: bets $1.19
PacPacBum: folds 
Uncalled bet ($1.19) returned to mooose100
mooose100 collected $2.38 from pot
mooose100: doesn't show hand 
*** SUMMARY ***
Total pot $2.50 | Rake $0.12 
Board [4d Ad 2c Ah]
Seat 1: matiko09 folded before Flop (didn't bet)
Seat 2: Dickyxxx folded before Flop (didn't bet)
Seat 3: mooose100 collected ($2.38)
Seat 4: ozone2003 folded before Flop (didn't bet)
Seat 5: stds st folded before Flop (didn't bet)
Seat 6: vanilica folded before Flop (didn't bet)
Seat 7: hurtNCYDE (button) folded before Flop (didn't bet)
Seat 8: Mr.Grigoriy (small blind) folded before Flop
Seat 9: PacPacBum (big blind) folded on the Turn





PokerStars Hand #154364504444:  Hold'em No Limit ($0.50/$1.00 USD) - 2016/06/06 13:38:44 CET [2016/06/06 7:38:44 ET]
Table 'Sheliak' 9-max Seat #8 is the button
Seat 1: 32rrew ($100 in chips) 
Seat 2: xhinostrabli ($73 in chips) 
Seat 3: xxxZeka ($133.62 in chips) 
Seat 4: Dickyxxx ($101.50 in chips) 
Seat 6: matiko09 ($115.25 in chips) 
Seat 7: stds st ($41.12 in chips) 
Seat 8: oliwood2 ($45.50 in chips) 
Seat 9: Steelpaper ($79 in chips) 
Steelpaper: posts small blind $0.50
32rrew: posts big blind $1
*** HOLE CARDS ***
Dealt to matiko09 [3s Qh]
xhinostrabli: folds 
xxxZeka: raises $2 to $3
Dickyxxx: folds 
matiko09: folds 
stds st: folds 
oliwood2: folds 
Steelpaper: folds 
32rrew: folds 
Uncalled bet ($2) returned to xxxZeka
xxxZeka collected $2.50 from pot
*** SUMMARY ***
Total pot $2.50 | Rake $0 
Seat 1: 32rrew (big blind) folded before Flop
Seat 2: xhinostrabli folded before Flop (didn't bet)
Seat 3: xxxZeka collected ($2.50)
Seat 4: Dickyxxx folded before Flop (didn't bet)
Seat 6: matiko09 folded before Flop (didn't bet)
Seat 7: stds st folded before Flop (didn't bet)
Seat 8: oliwood2 (button) folded before Flop (didn't bet)
Seat 9: Steelpaper (small blind) folded before Flop





PokerStars Hand #154364506360:  Hold'em No Limit ($0.50/$1.00 USD) - 2016/06/06 13:38:48 CET [2016/06/06 7:38:48 ET]
Table 'Oppavia' 9-max Seat #4 is the button
Seat 1: xxxZeka ($100 in chips) 
Seat 2: o.miro ($117.90 in chips) 
Seat 3: thecurv ($119 in chips) 
Seat 4: Mr.Grigoriy ($100 in chips) 
Seat 5: Eskimo Fox ($100 in chips) 
Seat 6: stds st ($44.50 in chips) 
Seat 7: chenlongn ($77.72 in chips) 
Seat 8: matiko09 ($105.68 in chips) 
Seat 9: Soundust_007 ($78.38 in chips) 
Eskimo Fox: posts small blind $0.50
stds st: posts big blind $1
*** HOLE CARDS ***
Dealt to matiko09 [Ad Jd]
chenlongn: folds 
matiko09: raises $2 to $3
Soundust_007: folds 
xxxZeka: folds 
o.miro: folds 
thecurv: folds 
Mr.Grigoriy: raises $6 to $9
Eskimo Fox: folds 
stds st: folds 
matiko09: folds 
Uncalled bet ($6) returned to Mr.Grigoriy
Mr.Grigoriy collected $7.50 from pot
Mr.Grigoriy: doesn't show hand 
*** SUMMARY ***
Total pot $7.50 | Rake $0 
Seat 1: xxxZeka folded before Flop (didn't bet)
Seat 2: o.miro folded before Flop (didn't bet)
Seat 3: thecurv folded before Flop (didn't bet)
Seat 4: Mr.Grigoriy (button) collected ($7.50)
Seat 5: Eskimo Fox (small blind) folded before Flop
Seat 6: stds st (big blind) folded before Flop
Seat 7: chenlongn folded before Flop (didn't bet)
Seat 8: matiko09 folded before Flop
Seat 9: Soundust_007 folded before Flop (didn't bet)





PokerStars Hand #154364508689:  Hold'em No Limit ($0.50/$1.00 USD) - 2016/06/06 13:38:53 CET [2016/06/06 7:38:53 ET]
Table 'Irmgard II' 9-max Seat #2 is the button
Seat 1: xxxZeka ($101.50 in chips) 
Seat 2: hurtNCYDE ($100 in chips) 
Seat 3: stds st ($36.37 in chips) 
Seat 4: Dickyxxx ($111.11 in chips) 
Seat 5: arctur17 ($144 in chips) 
Seat 6: oliwood2 ($40 in chips) 
Seat 7: o.miro ($100 in chips) 
Seat 8: matiko09 ($145.32 in chips) 
Seat 9: Steelpaper ($84.47 in chips) 
stds st: posts small blind $0.50
Dickyxxx: posts big blind $1
*** HOLE CARDS ***
Dealt to matiko09 [2c Ac]
arctur17: folds 
oliwood2: folds 
o.miro: folds 
matiko09: folds 
Steelpaper: folds 
xxxZeka: raises $2 to $3
hurtNCYDE: folds 
stds st: folds 
Dickyxxx: folds 
Uncalled bet ($2) returned to xxxZeka
xxxZeka collected $2.50 from pot
*** SUMMARY ***
Total pot $2.50 | Rake $0 
Seat 1: xxxZeka collected ($2.50)
Seat 2: hurtNCYDE (button) folded before Flop (didn't bet)
Seat 3: stds st (small blind) folded before Flop
Seat 4: Dickyxxx (big blind) folded before Flop
Seat 5: arctur17 folded before Flop (didn't bet)
Seat 6: oliwood2 folded before Flop (didn't bet)
Seat 7: o.miro folded before Flop (didn't bet)
Seat 8: matiko09 folded before Flop (didn't bet)
Seat 9: Steelpaper folded before Flop (didn't bet)





PokerStars Hand #154364512743:  Hold'em No Limit ($0.50/$1.00 USD) - 2016/06/06 13:39:02 CET [2016/06/06 7:39:02 ET]
Table 'Williams' 9-max Seat #3 is the button
Seat 1: xhinostrabli ($76.06 in chips) 
Seat 2: matiko09 ($173.01 in chips) 
Seat 3: granbunny ($57.56 in chips) 
Seat 4: Mr.Grigoriy ($104.12 in chips) 
Seat 5: xxxibgdrgn ($105 in chips) 
Seat 6: xxxZeka ($150.19 in chips) 
Seat 7: Eskimo Fox ($113.59 in chips) 
Seat 8: Dickyxxx ($103 in chips) 
Seat 9: stds st ($63.26 in chips) 
Mr.Grigoriy: posts small blind $0.50
xxxibgdrgn: posts big blind $1
*** HOLE CARDS ***
Dealt to matiko09 [Td Ac]
xxxZeka: folds 
Eskimo Fox: raises $2 to $3
Dickyxxx: folds 
stds st: folds 
xhinostrabli: folds 
matiko09: folds 
granbunny: calls $3
Mr.Grigoriy: folds 
xxxibgdrgn: folds 
*** FLOP *** [Ts Js 7h]
Eskimo Fox: checks 
granbunny: checks 
*** TURN *** [Ts Js 7h] [3c]
Eskimo Fox: checks 
granbunny: bets $7
Eskimo Fox: calls $7
*** RIVER *** [Ts Js 7h 3c] [Jc]
Eskimo Fox: checks 
granbunny: checks 
*** SHOW DOWN ***
Eskimo Fox: shows [9c 9s] (two pair, Jacks and Nines)
granbunny: mucks hand 
Eskimo Fox collected $20.42 from pot
*** SUMMARY ***
Total pot $21.50 | Rake $1.08 
Board [Ts Js 7h 3c Jc]
Seat 1: xhinostrabli folded before Flop (didn't bet)
Seat 2: matiko09 folded before Flop (didn't bet)
Seat 3: granbunny (button) mucked [Ad 3d]
Seat 4: Mr.Grigoriy (small blind) folded before Flop
Seat 5: xxxibgdrgn (big blind) folded before Flop
Seat 6: xxxZeka folded before Flop (didn't bet)
Seat 7: Eskimo Fox showed [9c 9s] and won ($20.42) with two pair, Jacks and Nines
Seat 8: Dickyxxx folded before Flop (didn't bet)
Seat 9: stds st folded before Flop (didn't bet)





PokerStars Hand #154364515838:  Hold'em No Limit ($0.50/$1.00 USD) - 2016/06/06 13:39:09 CET [2016/06/06 7:39:09 ET]
Table 'Sheliak' 9-max Seat #9 is the button
Seat 1: 32rrew ($100 in chips) 
Seat 2: xhinostrabli ($73 in chips) 
Seat 3: xxxZeka ($135.12 in chips) 
Seat 4: Dickyxxx ($101.50 in chips) 
Seat 6: matiko09 ($115.25 in chips) 
Seat 7: stds st ($41.12 in chips) 
Seat 8: oliwood2 ($45.50 in chips) 
Seat 9: Steelpaper ($78.50 in chips) 
32rrew: posts small blind $0.50
xhinostrabli: posts big blind $1
*** HOLE CARDS ***
Dealt to matiko09 [Ad 9c]
xxxZeka: folds 
Dickyxxx: folds 
matiko09: folds 
stds st: folds 
oliwood2: folds 
Steelpaper: folds 
32rrew: folds 
Uncalled bet ($0.50) returned to xhinostrabli
xhinostrabli collected $1 from pot
*** SUMMARY ***
Total pot $1 | Rake $0 
Seat 1: 32rrew (small blind) folded before Flop
Seat 2: xhinostrabli (big blind) collected ($1)
Seat 3: xxxZeka folded before Flop (didn't bet)
Seat 4: Dickyxxx folded before Flop (didn't bet)
Seat 6: matiko09 folded before Flop (didn't bet)
Seat 7: stds st folded before Flop (didn't bet)
Seat 8: oliwood2 folded before Flop (didn't bet)
Seat 9: Steelpaper (button) folded before Flop (didn't bet)





PokerStars Hand #154364516339:  Hold'em No Limit ($0.50/$1.00 USD) - 2016/06/06 13:39:10 CET [2016/06/06 7:39:10 ET]
Table 'Smither' 9-max Seat #4 is the button
Seat 1: PacPacBum ($200.08 in chips) 
Seat 2: matiko09 ($117.52 in chips) 
Seat 3: stds st ($36.50 in chips) 
Seat 4: Mr.Grigoriy ($124.97 in chips) 
Seat 5: Dickyxxx ($100.50 in chips) 
Seat 6: mooose100 ($87.01 in chips) 
Seat 7: vanilica ($117.62 in chips) 
Seat 8: ozone2003 ($100 in chips) 
Dickyxxx: posts small blind $0.50
mooose100: posts big blind $1
*** HOLE CARDS ***
Dealt to matiko09 [8h Tc]
vanilica: folds 
ozone2003: folds 
PacPacBum: raises $2 to $3
matiko09: folds 
stds st: folds 
Mr.Grigoriy: folds 
Dickyxxx: folds 
mooose100: calls $2
*** FLOP *** [5s 3d Ac]
mooose100: checks 
PacPacBum: checks 
*** TURN *** [5s 3d Ac] [6h]
mooose100: checks 
PacPacBum: bets $4.26
mooose100: raises $4.26 to $8.52
PacPacBum: calls $4.26
*** RIVER *** [5s 3d Ac 6h] [7h]
mooose100: bets $22.36
PacPacBum: folds 
Uncalled bet ($22.36) returned to mooose100
mooose100 collected $22.36 from pot
mooose100: doesn't show hand 
*** SUMMARY ***
Total pot $23.54 | Rake $1.18 
Board [5s 3d Ac 6h 7h]
Seat 1: PacPacBum folded on the River
Seat 2: matiko09 folded before Flop (didn't bet)
Seat 3: stds st folded before Flop (didn't bet)
Seat 4: Mr.Grigoriy (button) folded before Flop (didn't bet)
Seat 5: Dickyxxx (small blind) folded before Flop
Seat 6: mooose100 (big blind) collected ($22.36)
Seat 7: vanilica folded before Flop (didn't bet)
Seat 8: ozone2003 folded before Flop (didn't bet)





PokerStars Hand #154364517613:  Hold'em No Limit ($0.50/$1.00 USD) - 2016/06/06 13:39:13 CET [2016/06/06 7:39:13 ET]
Table 'Chaldaea II' 9-max Seat #9 is the button
Seat 1: ozone2003 ($122.79 in chips) 
Seat 2: Mr.Grigoriy ($101 in chips) 
Seat 4: mooose100 ($102.23 in chips) 
Seat 5: stds st ($49.85 in chips) 
Seat 6: PacPacBum ($109.36 in chips) 
Seat 7: xxxibgdrgn ($109.04 in chips) 
Seat 8: 32rrew ($114.46 in chips) 
Seat 9: matiko09 ($110.14 in chips) 
ozone2003: posts small blind $0.50
Mr.Grigoriy: posts big blind $1
*** HOLE CARDS ***
Dealt to matiko09 [5c Kc]
mooose100: calls $1
stds st: folds 
PacPacBum: folds 
xxxibgdrgn: folds 
32rrew: folds 
matiko09: raises $3 to $4
ozone2003: folds 
Mr.Grigoriy: folds 
mooose100: calls $3
*** FLOP *** [6s 9d 3h]
mooose100: checks 
matiko09: bets $5
mooose100: folds 
Uncalled bet ($5) returned to matiko09
matiko09 collected $9.02 from pot
matiko09: doesn't show hand 
*** SUMMARY ***
Total pot $9.50 | Rake $0.48 
Board [6s 9d 3h]
Seat 1: ozone2003 (small blind) folded before Flop
Seat 2: Mr.Grigoriy (big blind) folded before Flop
Seat 4: mooose100 folded on the Flop
Seat 5: stds st folded before Flop (didn't bet)
Seat 6: PacPacBum folded before Flop (didn't bet)
Seat 7: xxxibgdrgn folded before Flop (didn't bet)
Seat 8: 32rrew folded before Flop (didn't bet)
Seat 9: matiko09 (button) collected ($9.02)





PokerStars Hand #154364526616:  Hold'em No Limit ($0.50/$1.00 USD) - 2016/06/06 13:39:33 CET [2016/06/06 7:39:33 ET]
Table 'Irmgard II' 9-max Seat #3 is the button
Seat 1: xxxZeka ($103 in chips) 
Seat 2: hurtNCYDE ($100 in chips) 
Seat 3: stds st ($35.87 in chips) 
Seat 4: Dickyxxx ($110.11 in chips) 
Seat 5: arctur17 ($144 in chips) 
Seat 6: oliwood2 ($40 in chips) 
Seat 7: o.miro ($100 in chips) 
Seat 8: matiko09 ($145.32 in chips) 
Seat 9: Steelpaper ($84.47 in chips) 
Dickyxxx: posts small blind $0.50
arctur17: posts big blind $1
*** HOLE CARDS ***
Dealt to matiko09 [8s Td]
oliwood2: folds 
o.miro: folds 
matiko09: folds 
Steelpaper: raises $2 to $3
xxxZeka: folds 
hurtNCYDE: folds 
stds st: folds 
Dickyxxx: folds 
arctur17: folds 
Uncalled bet ($2) returned to Steelpaper
Steelpaper collected $2.50 from pot
Steelpaper: doesn't show hand 
*** SUMMARY ***
Total pot $2.50 | Rake $0 
Seat 1: xxxZeka folded before Flop (didn't bet)
Seat 2: hurtNCYDE folded before Flop (didn't bet)
Seat 3: stds st (button) folded before Flop (didn't bet)
Seat 4: Dickyxxx (small blind) folded before Flop
Seat 5: arctur17 (big blind) folded before Flop
Seat 6: oliwood2 folded before Flop (didn't bet)
Seat 7: o.miro folded before Flop (didn't bet)
Seat 8: matiko09 folded before Flop (didn't bet)
Seat 9: Steelpaper collected ($2.50)





PokerStars Hand #154364526606:  Hold'em No Limit (€0.25/€0.50 EUR) - 2016/06/06 13:39:33 CET [2016/06/06 7:39:33 ET]
Table 'Qinghai II' 6-max Seat #2 is the button
Seat 1: ragewear22 (€24.79 in chips) 
Seat 2: semen500 (€52.25 in chips) 
Seat 3: fun duncan (€68 in chips) 
Seat 4: matiko09 (€50 in chips) 
Seat 5: RastyGordo3 (€129.08 in chips) 
Seat 6: ASReikb2kpro (€61.44 in chips) 
fun duncan: posts small blind €0.25
matiko09: posts big blind €0.50
*** HOLE CARDS ***
Dealt to matiko09 [7s Kd]
RastyGordo3: folds 
ASReikb2kpro: raises €1 to €1.50
ragewear22: raises €2.50 to €4
semen500: folds 
fun duncan: calls €3.75
matiko09: folds 
ASReikb2kpro: calls €2.50
*** FLOP *** [Qs 7h 3s]
fun duncan: checks 
ASReikb2kpro: checks 
ragewear22: bets €20.79 and is all-in
fun duncan: folds 
ASReikb2kpro: calls €20.79
*** TURN *** [Qs 7h 3s] [6s]
*** RIVER *** [Qs 7h 3s 6s] [Js]
*** SHOW DOWN ***
ASReikb2kpro: shows [Qh Ah] (a pair of Queens)
ragewear22: shows [6c 6h] (three of a kind, Sixes)
ragewear22 collected €52.28 from pot
*** SUMMARY ***
Total pot €54.08 | Rake €1.80 
Board [Qs 7h 3s 6s Js]
Seat 1: ragewear22 showed [6c 6h] and won (€52.28) with three of a kind, Sixes
Seat 2: semen500 (button) folded before Flop (didn't bet)
Seat 3: fun duncan (small blind) folded on the Flop
Seat 4: matiko09 (big blind) folded before Flop
Seat 5: RastyGordo3 folded before Flop (didn't bet)
Seat 6: ASReikb2kpro showed [Qh Ah] and lost with a pair of Queens





PokerStars Hand #154364527259:  Hold'em No Limit ($0.50/$1.00 USD) - 2016/06/06 13:39:35 CET [2016/06/06 7:39:35 ET]
Table 'Siegma' 9-max Seat #7 is the button
Seat 1: Mr.Grigoriy ($100 in chips) 
Seat 3: R1aki ($141.30 in chips) 
Seat 4: ozone2003 ($110.96 in chips) 
Seat 5: arctur17 ($100 in chips) 
Seat 6: stds st ($56.73 in chips) 
Seat 7: nviss ($14.70 in chips) 
Seat 8: hurtNCYDE ($100 in chips) 
Seat 9: matiko09 ($109.50 in chips) 
hurtNCYDE: posts small blind $0.50
matiko09: posts big blind $1
*** HOLE CARDS ***
Dealt to matiko09 [4s 3s]
Mr.Grigoriy: folds 
R1aki: folds 
ozone2003: folds 
arctur17: folds 
stds st: folds 
nviss: folds 
hurtNCYDE: raises $1.50 to $2.50
matiko09: raises $6.50 to $9
hurtNCYDE: folds 
Uncalled bet ($6.50) returned to matiko09
matiko09 collected $5 from pot
matiko09: doesn't show hand 
*** SUMMARY ***
Total pot $5 | Rake $0 
Seat 1: Mr.Grigoriy folded before Flop (didn't bet)
Seat 3: R1aki folded before Flop (didn't bet)
Seat 4: ozone2003 folded before Flop (didn't bet)
Seat 5: arctur17 folded before Flop (didn't bet)
Seat 6: stds st folded before Flop (didn't bet)
Seat 7: nviss (button) folded before Flop (didn't bet)
Seat 8: hurtNCYDE (small blind) folded before Flop
Seat 9: matiko09 (big blind) collected ($5)





PokerStars Hand #154364530694:  Hold'em No Limit ($0.50/$1.00 USD) - 2016/06/06 13:39:42 CET [2016/06/06 7:39:42 ET]
Table 'Wezen II' 9-max Seat #5 is the button
Seat 1: matiko09 ($110.25 in chips) 
Seat 2: Mr.Grigoriy ($108.12 in chips) 
Seat 3: Dickyxxx ($107.12 in chips) 
Seat 4: xxxibgdrgn ($198.50 in chips) 
Seat 5: stds st ($40.05 in chips) 
Seat 6: Eskimo Fox ($100 in chips) 
Seat 8: o.miro ($100 in chips) 
Seat 9: Cogss ($97.20 in chips) 
Eskimo Fox: posts small blind $0.50
KDJAll3: is sitting out 
o.miro: posts big blind $1
*** HOLE CARDS ***
Dealt to matiko09 [9h 3h]
Cogss: folds 
matiko09: folds 
Mr.Grigoriy: folds 
Dickyxxx: folds 
xxxibgdrgn: folds 
stds st: folds 
Eskimo Fox: folds 
Uncalled bet ($0.50) returned to o.miro
o.miro collected $1 from pot
o.miro: doesn't show hand 
*** SUMMARY ***
Total pot $1 | Rake $0 
Seat 1: matiko09 folded before Flop (didn't bet)
Seat 2: Mr.Grigoriy folded before Flop (didn't bet)
Seat 3: Dickyxxx folded before Flop (didn't bet)
Seat 4: xxxibgdrgn folded before Flop (didn't bet)
Seat 5: stds st (button) folded before Flop (didn't bet)
Seat 6: Eskimo Fox (small blind) folded before Flop
Seat 8: o.miro (big blind) collected ($1)
Seat 9: Cogss folded before Flop (didn't bet)





PokerStars Hand #154364531018:  Hold'em No Limit ($0.50/$1.00 USD) - 2016/06/06 13:39:43 CET [2016/06/06 7:39:43 ET]
Table 'Heze' 9-max Seat #1 is the button
Seat 1: matiko09 ($186.77 in chips) 
Seat 3: Dickyxxx ($101.83 in chips) 
Seat 4: Eskimo Fox ($100.56 in chips) 
Seat 5: stds st ($35.50 in chips) 
Seat 7: 32rrew ($152.97 in chips) 
Seat 8: PacPacBum ($124.94 in chips) 
Seat 9: Mr.Grigoriy ($128.71 in chips) 
Dickyxxx: posts small blind $0.50
Eskimo Fox: posts big blind $1
*** HOLE CARDS ***
Dealt to matiko09 [6d Qs]
stds st: folds 
32rrew: raises $2 to $3
PacPacBum: folds 
Mr.Grigoriy: folds 
matiko09: folds 
Dickyxxx: folds 
Eskimo Fox: folds 
Uncalled bet ($2) returned to 32rrew
32rrew collected $2.50 from pot
32rrew: doesn't show hand 
*** SUMMARY ***
Total pot $2.50 | Rake $0 
Seat 1: matiko09 (button) folded before Flop (didn't bet)
Seat 3: Dickyxxx (small blind) folded before Flop
Seat 4: Eskimo Fox (big blind) folded before Flop
Seat 5: stds st folded before Flop (didn't bet)
Seat 7: 32rrew collected ($2.50)
Seat 8: PacPacBum folded before Flop (didn't bet)
Seat 9: Mr.Grigoriy folded before Flop (didn't bet)





PokerStars Hand #154364537032:  Hold'em No Limit ($0.50/$1.00 USD) - 2016/06/06 13:39:56 CET [2016/06/06 7:39:56 ET]
Table 'Chaldaea II' 9-max Seat #1 is the button
Seat 1: ozone2003 ($122.29 in chips) 
Seat 2: Mr.Grigoriy ($100 in chips) 
Seat 4: mooose100 ($98.23 in chips) 
Seat 5: stds st ($49.85 in chips) 
Seat 6: PacPacBum ($109.36 in chips) 
Seat 7: xxxibgdrgn ($109.04 in chips) 
Seat 8: 32rrew ($114.46 in chips) 
Seat 9: matiko09 ($115.16 in chips) 
Mr.Grigoriy: posts small blind $0.50
mooose100: posts big blind $1
*** HOLE CARDS ***
Dealt to matiko09 [Ts 2s]
stds st: folds 
PacPacBum: folds 
xxxibgdrgn: folds 
32rrew: folds 
matiko09: folds 
ozone2003: folds 
Mr.Grigoriy: raises $1 to $2
mooose100: folds 
Uncalled bet ($1) returned to Mr.Grigoriy
Mr.Grigoriy collected $2 from pot
Mr.Grigoriy: doesn't show hand 
*** SUMMARY ***
Total pot $2 | Rake $0 
Seat 1: ozone2003 (button) folded before Flop (didn't bet)
Seat 2: Mr.Grigoriy (small blind) collected ($2)
Seat 4: mooose100 (big blind) folded before Flop
Seat 5: stds st folded before Flop (didn't bet)
Seat 6: PacPacBum folded before Flop (didn't bet)
Seat 7: xxxibgdrgn folded before Flop (didn't bet)
Seat 8: 32rrew folded before Flop (didn't bet)
Seat 9: matiko09 folded before Flop (didn't bet)





PokerStars Hand #154364538518:  Hold'em No Limit ($0.50/$1.00 USD) - 2016/06/06 13:40:00 CET [2016/06/06 7:40:00 ET]
Table 'Sheliak' 9-max Seat #1 is the button
Seat 1: 32rrew ($100 in chips) 
Seat 2: xhinostrabli ($73.50 in chips) 
Seat 3: xxxZeka ($135.12 in chips) 
Seat 4: Dickyxxx ($101.50 in chips) 
Seat 6: matiko09 ($115.25 in chips) 
Seat 7: stds st ($41.12 in chips) 
Seat 8: oliwood2 ($45.50 in chips) 
Seat 9: Steelpaper ($78.50 in chips) 
xhinostrabli: posts small blind $0.50
xxxZeka: posts big blind $1
*** HOLE CARDS ***
Dealt to matiko09 [Js 5d]
Dickyxxx: folds 
matiko09: folds 
stds st: raises $1.50 to $2.50
oliwood2: folds 
Steelpaper: calls $2.50
32rrew: calls $2.50
hammerwife leaves the table
xhinostrabli: folds 
Mr.Grigoriy joins the table at seat #5 
xxxZeka: folds 
*** FLOP *** [7s Kh 8s]
stds st: checks 
Steelpaper: checks 
32rrew: bets $5.69
stds st: calls $5.69
Steelpaper: calls $5.69
*** TURN *** [7s Kh 8s] [6d]
stds st: checks 
Steelpaper: checks 
32rrew: checks 
*** RIVER *** [7s Kh 8s 6d] [8h]
stds st: checks 
Steelpaper: checks 
32rrew: checks 
*** SHOW DOWN ***
stds st: shows [9s As] (a pair of Eights)
Steelpaper: shows [Th Ts] (two pair, Tens and Eights)
32rrew: shows [Kc 9c] (two pair, Kings and Eights)
32rrew collected $24.77 from pot
*** SUMMARY ***
Total pot $26.07 | Rake $1.30 
Board [7s Kh 8s 6d 8h]
Seat 1: 32rrew (button) showed [Kc 9c] and won ($24.77) with two pair, Kings and Eights
Seat 2: xhinostrabli (small blind) folded before Flop
Seat 3: xxxZeka (big blind) folded before Flop
Seat 4: Dickyxxx folded before Flop (didn't bet)
Seat 6: matiko09 folded before Flop (didn't bet)
Seat 7: stds st showed [9s As] and lost with a pair of Eights
Seat 8: oliwood2 folded before Flop (didn't bet)
Seat 9: Steelpaper showed [Th Ts] and lost with two pair, Tens and Eights





PokerStars Hand #154364542843:  Hold'em No Limit ($0.50/$1.00 USD) - 2016/06/06 13:40:09 CET [2016/06/06 7:40:09 ET]
Table 'Siegma' 9-max Seat #8 is the button
Seat 1: Mr.Grigoriy ($100 in chips) 
Seat 3: R1aki ($141.30 in chips) 
Seat 4: ozone2003 ($110.96 in chips) 
Seat 5: arctur17 ($100 in chips) 
Seat 6: stds st ($56.73 in chips) 
Seat 7: nviss ($14.70 in chips) 
Seat 8: hurtNCYDE ($100 in chips) 
Seat 9: matiko09 ($112 in chips) 
matiko09: posts small blind $0.50
Mr.Grigoriy: posts big blind $1
*** HOLE CARDS ***
Dealt to matiko09 [2d 8c]
R1aki: folds 
ozone2003: folds 
arctur17: folds 
stds st: folds 
nviss: folds 
hurtNCYDE: raises $1.50 to $2.50
matiko09: folds 
Mr.Grigoriy: folds 
Uncalled bet ($1.50) returned to hurtNCYDE
hurtNCYDE collected $2.50 from pot
*** SUMMARY ***
Total pot $2.50 | Rake $0 
Seat 1: Mr.Grigoriy (big blind) folded before Flop
Seat 3: R1aki folded before Flop (didn't bet)
Seat 4: ozone2003 folded before Flop (didn't bet)
Seat 5: arctur17 folded before Flop (didn't bet)
Seat 6: stds st folded before Flop (didn't bet)
Seat 7: nviss folded before Flop (didn't bet)
Seat 8: hurtNCYDE (button) collected ($2.50)
Seat 9: matiko09 (small blind) folded before Flop





PokerStars Hand #154364543265:  Hold'em No Limit (€0.50/€1.00 EUR) - 2016/06/06 13:40:10 CET [2016/06/06 7:40:10 ET]
Table 'Lesath' 9-max Seat #1 is the button
Seat 1: o.miro (€112.25 in chips) 
Seat 2: thecurv (€103.82 in chips) 
Seat 5: matiko09 (€172.67 in chips) 
Seat 6: Dickyxxx (€108.22 in chips) 
Seat 7: Mr.Grigoriy (€100 in chips) 
Seat 9: 72nloses (€86.95 in chips) 
thecurv: posts small blind €0.50
ozone2003: is sitting out 
matiko09: posts big blind €1
ozone2003 leaves the table
vanilica: sits out 
*** HOLE CARDS ***
Dealt to matiko09 [6h Ts]
Dickyxxx: folds 
Mr.Grigoriy: folds 
72nloses: raises €4 to €5
o.miro: calls €5
hurtNCYDE joins the table at seat #3 
thecurv: folds 
matiko09: folds 
*** FLOP *** [2h 7s 5s]
72nloses: bets €15
o.miro: calls €15
*** TURN *** [2h 7s 5s] [Js]
72nloses: bets €66.95 and is all-in
o.miro: calls €66.95
*** RIVER *** [2h 7s 5s Js] [4c]
*** SHOW DOWN ***
72nloses: shows [Kd Qs] (high card King)
o.miro: shows [7h 7d] (three of a kind, Sevens)
o.miro collected €173.15 from pot
*** SUMMARY ***
Total pot €175.40 | Rake €2.25 
Board [2h 7s 5s Js 4c]
Seat 1: o.miro (button) showed [7h 7d] and won (€173.15) with three of a kind, Sevens
Seat 2: thecurv (small blind) folded before Flop
Seat 5: matiko09 (big blind) folded before Flop
Seat 6: Dickyxxx folded before Flop (didn't bet)
Seat 7: Mr.Grigoriy folded before Flop (didn't bet)
Seat 9: 72nloses showed [Kd Qs] and lost with high card King





PokerStars Hand #154364543662:  Hold'em No Limit ($0.50/$1.00 USD) - 2016/06/06 13:40:11 CET [2016/06/06 7:40:11 ET]
Table 'Irmgard II' 9-max Seat #4 is the button
Seat 1: xxxZeka ($103 in chips) 
Seat 2: hurtNCYDE ($100 in chips) 
Seat 3: stds st ($35.87 in chips) 
Seat 4: Dickyxxx ($109.61 in chips) 
Seat 5: arctur17 ($143 in chips) 
Seat 6: oliwood2 ($40 in chips) 
Seat 7: o.miro ($100 in chips) 
Seat 8: matiko09 ($145.32 in chips) 
Seat 9: Steelpaper ($85.97 in chips) 
arctur17: posts small blind $0.50
oliwood2: posts big blind $1
*** HOLE CARDS ***
Dealt to matiko09 [5h Kh]
o.miro: folds 
matiko09: folds 
Steelpaper: folds 
xxxZeka: folds 
hurtNCYDE: folds 
stds st: folds 
Dickyxxx: folds 
arctur17: folds 
Uncalled bet ($0.50) returned to oliwood2
oliwood2 collected $1 from pot
oliwood2: doesn't show hand 
*** SUMMARY ***
Total pot $1 | Rake $0 
Seat 1: xxxZeka folded before Flop (didn't bet)
Seat 2: hurtNCYDE folded before Flop (didn't bet)
Seat 3: stds st folded before Flop (didn't bet)
Seat 4: Dickyxxx (button) folded before Flop (didn't bet)
Seat 5: arctur17 (small blind) folded before Flop
Seat 6: oliwood2 (big blind) collected ($1)
Seat 7: o.miro folded before Flop (didn't bet)
Seat 8: matiko09 folded before Flop (didn't bet)
Seat 9: Steelpaper folded before Flop (didn't bet)





PokerStars Hand #154364551005:  Hold'em No Limit ($0.50/$1.00 USD) - 2016/06/06 13:40:27 CET [2016/06/06 7:40:27 ET]
Table 'Wezen II' 9-max Seat #6 is the button
Seat 1: matiko09 ($110.25 in chips) 
Seat 2: Mr.Grigoriy ($108.12 in chips) 
Seat 3: Dickyxxx ($107.12 in chips) 
Seat 4: xxxibgdrgn ($198.50 in chips) 
Seat 5: stds st ($40.05 in chips) 
Seat 6: Eskimo Fox ($100 in chips) 
Seat 8: o.miro ($100.50 in chips) 
Seat 9: Cogss ($97.20 in chips) 
o.miro: posts small blind $0.50
Cogss: posts big blind $1
*** HOLE CARDS ***
Dealt to matiko09 [3c 4c]
matiko09: folds 
Mr.Grigoriy: folds 
Dickyxxx: folds 
xxxibgdrgn: raises $2 to $3
stds st: raises $4.50 to $7.50
Eskimo Fox: folds 
o.miro: folds 
Cogss: calls $6.50
xxxibgdrgn: calls $4.50
*** FLOP *** [6d Td 6h]
Cogss: checks 
xxxibgdrgn: checks 
stds st: checks 
*** TURN *** [6d Td 6h] [Js]
Cogss: checks 
xxxibgdrgn: checks 
stds st: checks 
*** RIVER *** [6d Td 6h Js] [3s]
Cogss: checks 
xxxibgdrgn: checks 
stds st: checks 
*** SHOW DOWN ***
Cogss: shows [Qd Ad] (a pair of Sixes)
xxxibgdrgn: shows [7c 7h] (two pair, Sevens and Sixes)
stds st: mucks hand 
xxxibgdrgn collected $21.85 from pot
*** SUMMARY ***
Total pot $23 | Rake $1.15 
Board [6d Td 6h Js 3s]
Seat 1: matiko09 folded before Flop (didn't bet)
Seat 2: Mr.Grigoriy folded before Flop (didn't bet)
Seat 3: Dickyxxx folded before Flop (didn't bet)
Seat 4: xxxibgdrgn showed [7c 7h] and won ($21.85) with two pair, Sevens and Sixes
Seat 5: stds st mucked [Kh As]
Seat 6: Eskimo Fox (button) folded before Flop (didn't bet)
Seat 8: o.miro (small blind) folded before Flop
Seat 9: Cogss (big blind) showed [Qd Ad] and lost with a pair of Sixes





PokerStars Hand #154364553325:  Hold'em No Limit ($0.50/$1.00 USD) - 2016/06/06 13:40:33 CET [2016/06/06 7:40:33 ET]
Table 'Chaldaea II' 9-max Seat #2 is the button
Seat 1: ozone2003 ($122.29 in chips) 
Seat 2: Mr.Grigoriy ($101 in chips) 
Seat 4: mooose100 ($97.23 in chips) 
Seat 5: stds st ($49.85 in chips) 
Seat 6: PacPacBum ($109.36 in chips) 
Seat 7: xxxibgdrgn ($109.04 in chips) 
Seat 8: 32rrew ($114.46 in chips) 
Seat 9: matiko09 ($115.16 in chips) 
hammerwife will be allowed to play after the button
mooose100: posts small blind $0.50
stds st: posts big blind $1
*** HOLE CARDS ***
Dealt to matiko09 [3s 8c]
PacPacBum: folds 
xxxibgdrgn: raises $2 to $3
32rrew: folds 
matiko09: folds 
ozone2003: folds 
Mr.Grigoriy: folds 
mooose100: folds 
stds st: calls $2
*** FLOP *** [2d 7d 3h]
stds st: checks 
xxxibgdrgn: bets $4
stds st: calls $4
*** TURN *** [2d 7d 3h] [5c]
stds st: checks 
xxxibgdrgn: bets $9
stds st: calls $9
*** RIVER *** [2d 7d 3h 5c] [4d]
stds st: checks 
xxxibgdrgn: checks 
*** SHOW DOWN ***
stds st: shows [8h 8s] (a pair of Eights)
xxxibgdrgn: shows [Qc Ah] (a straight, Ace to Five)
xxxibgdrgn collected $30.88 from pot
*** SUMMARY ***
Total pot $32.50 | Rake $1.62 
Board [2d 7d 3h 5c 4d]
Seat 1: ozone2003 folded before Flop (didn't bet)
Seat 2: Mr.Grigoriy (button) folded before Flop (didn't bet)
Seat 4: mooose100 (small blind) folded before Flop
Seat 5: stds st (big blind) showed [8h 8s] and lost with a pair of Eights
Seat 6: PacPacBum folded before Flop (didn't bet)
Seat 7: xxxibgdrgn showed [Qc Ah] and won ($30.88) with a straight, Ace to Five
Seat 8: 32rrew folded before Flop (didn't bet)
Seat 9: matiko09 folded before Flop (didn't bet)





PokerStars Hand #154364554751:  Hold'em No Limit ($0.50/$1.00 USD) - 2016/06/06 13:40:36 CET [2016/06/06 7:40:36 ET]
Table 'Heze' 9-max Seat #3 is the button
Seat 1: matiko09 ($186.77 in chips) 
Seat 3: Dickyxxx ($101.33 in chips) 
Seat 4: Eskimo Fox ($100 in chips) 
Seat 5: stds st ($35.50 in chips) 
Seat 7: 32rrew ($154.47 in chips) 
Seat 8: PacPacBum ($124.94 in chips) 
Seat 9: Mr.Grigoriy ($128.71 in chips) 
Eskimo Fox: posts small blind $0.50
stds st: posts big blind $1
*** HOLE CARDS ***
Dealt to matiko09 [3d 4s]
32rrew: folds 
PacPacBum: folds 
Mr.Grigoriy: folds 
matiko09: folds 
Dickyxxx: folds 
Eskimo Fox: folds 
Uncalled bet ($0.50) returned to stds st
stds st collected $1 from pot
stds st: doesn't show hand 
*** SUMMARY ***
Total pot $1 | Rake $0 
Seat 1: matiko09 folded before Flop (didn't bet)
Seat 3: Dickyxxx (button) folded before Flop (didn't bet)
Seat 4: Eskimo Fox (small blind) folded before Flop
Seat 5: stds st (big blind) collected ($1)
Seat 7: 32rrew folded before Flop (didn't bet)
Seat 8: PacPacBum folded before Flop (didn't bet)
Seat 9: Mr.Grigoriy folded before Flop (didn't bet)





PokerStars Hand #154364556044:  Hold'em No Limit ($0.50/$1.00 USD) - 2016/06/06 13:40:39 CET [2016/06/06 7:40:39 ET]
Table 'Siegma' 9-max Seat #9 is the button
Seat 1: Mr.Grigoriy ($100 in chips) 
Seat 2: hammerwife ($130.34 in chips) 
Seat 3: R1aki ($141.30 in chips) 
Seat 4: ozone2003 ($110.96 in chips) 
Seat 5: arctur17 ($100 in chips) 
Seat 6: stds st ($56.73 in chips) 
Seat 7: nviss ($14.70 in chips) 
Seat 8: hurtNCYDE ($101.50 in chips) 
Seat 9: matiko09 ($111.50 in chips) 
Mr.Grigoriy: posts small blind $0.50
hammerwife: posts big blind $1
*** HOLE CARDS ***
Dealt to matiko09 [9c 6d]
R1aki: folds 
ozone2003: folds 
arctur17: folds 
stds st: folds 
nviss: raises $1 to $2
hurtNCYDE: folds 
matiko09: folds 
Mr.Grigoriy: folds 
hammerwife: calls $1
*** FLOP *** [2c 4d Td]
hammerwife: checks 
nviss: bets $3
hammerwife: folds 
Uncalled bet ($3) returned to nviss
nviss collected $4.28 from pot
*** SUMMARY ***
Total pot $4.50 | Rake $0.22 
Board [2c 4d Td]
Seat 1: Mr.Grigoriy (small blind) folded before Flop
Seat 2: hammerwife (big blind) folded on the Flop
Seat 3: R1aki folded before Flop (didn't bet)
Seat 4: ozone2003 folded before Flop (didn't bet)
Seat 5: arctur17 folded before Flop (didn't bet)
Seat 6: stds st folded before Flop (didn't bet)
Seat 7: nviss collected ($4.28)
Seat 8: hurtNCYDE folded before Flop (didn't bet)
Seat 9: matiko09 (button) folded before Flop (didn't bet)





PokerStars Hand #154364561291:  Hold'em No Limit ($0.50/$1.00 USD) - 2016/06/06 13:40:50 CET [2016/06/06 7:40:50 ET]
Table 'Safara' 9-max Seat #1 is the button
Seat 1: Dickyxxx ($100 in chips) 
Seat 2: ozone2003 ($100 in chips) 
Seat 3: erd33 ($171.15 in chips) 
Seat 4: xxxibgdrgn ($100 in chips) 
Seat 5: perezzi10 ($78.84 in chips) 
Seat 6: matiko09 ($138.28 in chips) 
Seat 7: PacPacBum ($120.49 in chips) 
Seat 8: o.miro ($194.11 in chips) 
Seat 9: R1aki ($100 in chips) 
ozone2003: posts small blind $0.50
erd33: posts big blind $1
*** HOLE CARDS ***
Dealt to matiko09 [Js 5h]
xxxibgdrgn: folds 
perezzi10: calls $1
matiko09: folds 
PacPacBum: raises $3 to $4
o.miro: folds 
R1aki: folds 
Dickyxxx: folds 
ozone2003: folds 
erd33: folds 
perezzi10: folds 
Uncalled bet ($3) returned to PacPacBum
PacPacBum collected $3.50 from pot
PacPacBum: doesn't show hand 
*** SUMMARY ***
Total pot $3.50 | Rake $0 
Seat 1: Dickyxxx (button) folded before Flop (didn't bet)
Seat 2: ozone2003 (small blind) folded before Flop
Seat 3: erd33 (big blind) folded before Flop
Seat 4: xxxibgdrgn folded before Flop (didn't bet)
Seat 5: perezzi10 folded before Flop
Seat 6: matiko09 folded before Flop (didn't bet)
Seat 7: PacPacBum collected ($3.50)
Seat 8: o.miro folded before Flop (didn't bet)
Seat 9: R1aki folded before Flop (didn't bet)





PokerStars Hand #154364565831:  Hold'em No Limit ($0.50/$1.00 USD) - 2016/06/06 13:41:00 CET [2016/06/06 7:41:00 ET]
Table 'Heze' 9-max Seat #4 is the button
Seat 1: matiko09 ($186.77 in chips) 
Seat 3: Dickyxxx ($101.33 in chips) 
Seat 4: Eskimo Fox ($100 in chips) 
Seat 5: stds st ($36 in chips) 
Seat 8: PacPacBum ($124.94 in chips) 
Seat 9: Mr.Grigoriy ($128.71 in chips) 
stds st: posts small blind $0.50
32rrew: is sitting out 
32rrew leaves the table
PacPacBum: posts big blind $1
*** HOLE CARDS ***
Dealt to matiko09 [5c Jc]
Mr.Grigoriy: raises $2 to $3
xxxZeka joins the table at seat #7 
matiko09: folds 
Dickyxxx: folds 
Eskimo Fox: folds 
stds st: folds 
PacPacBum: folds 
Uncalled bet ($2) returned to Mr.Grigoriy
Mr.Grigoriy collected $2.50 from pot
Mr.Grigoriy: doesn't show hand 
*** SUMMARY ***
Total pot $2.50 | Rake $0 
Seat 1: matiko09 folded before Flop (didn't bet)
Seat 3: Dickyxxx folded before Flop (didn't bet)
Seat 4: Eskimo Fox (button) folded before Flop (didn't bet)
Seat 5: stds st (small blind) folded before Flop
Seat 8: PacPacBum (big blind) folded before Flop
Seat 9: Mr.Grigoriy collected ($2.50)





PokerStars Hand #154364566101:  Hold'em No Limit (€0.25/€0.50 EUR) - 2016/06/06 13:41:01 CET [2016/06/06 7:41:01 ET]
Table 'Qinghai II' 6-max Seat #3 is the button
Seat 1: ragewear22 (€52.28 in chips) 
Seat 2: semen500 (€52.25 in chips) 
Seat 3: fun duncan (€64 in chips) 
Seat 4: matiko09 (€50 in chips) 
Seat 5: RastyGordo3 (€129.08 in chips) 
Seat 6: ASReikb2kpro (€50 in chips) 
matiko09: posts small blind €0.25
RastyGordo3: posts big blind €0.50
*** HOLE CARDS ***
Dealt to matiko09 [Ac 8h]
ASReikb2kpro: raises €1 to €1.50
ragewear22: folds 
ragewear22 leaves the table
semen500: folds 
fun duncan: folds 
matiko09: folds 
RastyGordo3: folds 
Uncalled bet (€1) returned to ASReikb2kpro
ASReikb2kpro collected €1.25 from pot
ASReikb2kpro: doesn't show hand 
*** SUMMARY ***
Total pot €1.25 | Rake €0 
Seat 1: ragewear22 folded before Flop (didn't bet)
Seat 2: semen500 folded before Flop (didn't bet)
Seat 3: fun duncan (button) folded before Flop (didn't bet)
Seat 4: matiko09 (small blind) folded before Flop
Seat 5: RastyGordo3 (big blind) folded before Flop
Seat 6: ASReikb2kpro collected (€1.25)





PokerStars Hand #154364570281:  Hold'em No Limit ($0.50/$1.00 USD) - 2016/06/06 13:41:10 CET [2016/06/06 7:41:10 ET]
Table 'Williams' 9-max Seat #4 is the button
Seat 1: xhinostrabli ($76.06 in chips) 
Seat 2: matiko09 ($173.01 in chips) 
Seat 3: granbunny ($47.56 in chips) 
Seat 4: Mr.Grigoriy ($103.62 in chips) 
Seat 5: xxxibgdrgn ($104 in chips) 
Seat 6: xxxZeka ($150.19 in chips) 
Seat 7: Eskimo Fox ($124.01 in chips) 
Seat 8: Dickyxxx ($103 in chips) 
Seat 9: stds st ($63.26 in chips) 
xxxibgdrgn: posts small blind $0.50
xxxZeka: posts big blind $1
*** HOLE CARDS ***
Dealt to matiko09 [As Td]
Eskimo Fox: folds 
Dickyxxx: folds 
stds st: folds 
xhinostrabli: raises $1 to $2
matiko09: folds 
granbunny: folds 
Mr.Grigoriy: folds 
xxxibgdrgn: folds 
xxxZeka: folds 
Uncalled bet ($1) returned to xhinostrabli
xhinostrabli collected $2.50 from pot
*** SUMMARY ***
Total pot $2.50 | Rake $0 
Seat 1: xhinostrabli collected ($2.50)
Seat 2: matiko09 folded before Flop (didn't bet)
Seat 3: granbunny folded before Flop (didn't bet)
Seat 4: Mr.Grigoriy (button) folded before Flop (didn't bet)
Seat 5: xxxibgdrgn (small blind) folded before Flop
Seat 6: xxxZeka (big blind) folded before Flop
Seat 7: Eskimo Fox folded before Flop (didn't bet)
Seat 8: Dickyxxx folded before Flop (didn't bet)
Seat 9: stds st folded before Flop (didn't bet)





PokerStars Hand #154364572618:  Hold'em No Limit ($0.50/$1.00 USD) - 2016/06/06 13:41:16 CET [2016/06/06 7:41:16 ET]
Table 'Smither' 9-max Seat #5 is the button
Seat 1: PacPacBum ($188.56 in chips) 
Seat 2: matiko09 ($117.52 in chips) 
Seat 3: stds st ($36.50 in chips) 
Seat 4: Mr.Grigoriy ($124.97 in chips) 
Seat 5: Dickyxxx ($100 in chips) 
Seat 6: mooose100 ($97.85 in chips) 
Seat 7: vanilica ($117.62 in chips) 
Seat 8: ozone2003 ($100 in chips) 
mooose100: posts small blind $0.50
vanilica: posts big blind $1
hammerwife: sits out 
*** HOLE CARDS ***
Dealt to matiko09 [Jd 3d]
ozone2003: folds 
PacPacBum: folds 
matiko09: folds 
stds st has timed out
stds st: folds 
Mr.Grigoriy: raises $1.50 to $2.50
Dickyxxx: calls $2.50
mooose100: raises $8.50 to $11
vanilica: folds 
Mr.Grigoriy: calls $8.50
Dickyxxx: calls $8.50
*** FLOP *** [Qs 8h 5c]
mooose100: checks 
Mr.Grigoriy: bets $16.10
Dickyxxx: folds 
mooose100: folds 
Uncalled bet ($16.10) returned to Mr.Grigoriy
Mr.Grigoriy collected $32.30 from pot
Mr.Grigoriy: doesn't show hand 
*** SUMMARY ***
Total pot $34 | Rake $1.70 
Board [Qs 8h 5c]
Seat 1: PacPacBum folded before Flop (didn't bet)
Seat 2: matiko09 folded before Flop (didn't bet)
Seat 3: stds st folded before Flop (didn't bet)
Seat 4: Mr.Grigoriy collected ($32.30)
Seat 5: Dickyxxx (button) folded on the Flop
Seat 6: mooose100 (small blind) folded on the Flop
Seat 7: vanilica (big blind) folded before Flop
Seat 8: ozone2003 folded before Flop (didn't bet)





PokerStars Hand #154364575451:  Hold'em No Limit ($0.50/$1.00 USD) - 2016/06/06 13:41:22 CET [2016/06/06 7:41:22 ET]
Table 'Siegma' 9-max Seat #1 is the button
Seat 1: Mr.Grigoriy ($100 in chips) 
Seat 2: hammerwife ($128.34 in chips) 
Seat 3: R1aki ($141.30 in chips) 
Seat 4: ozone2003 ($110.96 in chips) 
Seat 5: arctur17 ($100 in chips) 
Seat 6: stds st ($56.73 in chips) 
Seat 7: nviss ($16.98 in chips) 
Seat 8: hurtNCYDE ($101.50 in chips) 
Seat 9: matiko09 ($111.50 in chips) 
hammerwife: posts small blind $0.50
R1aki: posts big blind $1
*** HOLE CARDS ***
Dealt to matiko09 [8d 8h]
ozone2003: folds 
arctur17: folds 
stds st has timed out
stds st: folds 
nviss: raises $1 to $2
hurtNCYDE: folds 
matiko09: calls $2
Mr.Grigoriy: folds 
hammerwife: raises $11 to $13
R1aki: folds 
nviss: raises $3.98 to $16.98 and is all-in
matiko09: folds 
hammerwife: calls $3.98
*** FIRST FLOP *** [9s 7d Th]
*** FIRST TURN *** [9s 7d Th] [6s]
*** FIRST RIVER *** [9s 7d Th 6s] [Kh]
*** SECOND FLOP *** [6h Ks 8s]
*** SECOND TURN *** [6h Ks 8s] [Ts]
*** SECOND RIVER *** [6h Ks 8s Ts] [9d]
*** FIRST SHOW DOWN ***
hammerwife: shows [Ah Qh] (high card Ace)
nviss: shows [Qc Jh] (a straight, Nine to King)
nviss collected $17.56 from pot
*** SECOND SHOW DOWN ***
hammerwife: shows [Ah Qh] (high card Ace)
nviss: shows [Qc Jh] (a straight, Nine to King)
nviss collected $17.55 from pot
*** SUMMARY ***
Total pot $36.96 | Rake $1.85 
Hand was run twice
FIRST Board [9s 7d Th 6s Kh]
SECOND Board [6h Ks 8s Ts 9d]
Seat 1: Mr.Grigoriy (button) folded before Flop (didn't bet)
Seat 2: hammerwife (small blind) showed [Ah Qh] and lost with high card Ace, and lost with high card Ace
Seat 3: R1aki (big blind) folded before Flop
Seat 4: ozone2003 folded before Flop (didn't bet)
Seat 5: arctur17 folded before Flop (didn't bet)
Seat 6: stds st folded before Flop (didn't bet)
Seat 7: nviss showed [Qc Jh] and won ($17.56) with a straight, Nine to King, and won ($17.55) with a straight, Nine to King
Seat 8: hurtNCYDE folded before Flop (didn't bet)
Seat 9: matiko09 folded before Flop





PokerStars Hand #154364577675:  Hold'em No Limit ($0.50/$1.00 USD) - 2016/06/06 13:41:27 CET [2016/06/06 7:41:27 ET]
Table 'Heze' 9-max Seat #5 is the button
Seat 1: matiko09 ($186.77 in chips) 
Seat 3: Dickyxxx ($101.33 in chips) 
Seat 4: Eskimo Fox ($100 in chips) 
Seat 5: stds st ($35.50 in chips) 
Seat 8: PacPacBum ($123.94 in chips) 
Seat 9: Mr.Grigoriy ($130.21 in chips) 
PacPacBum: posts small blind $0.50
Mr.Grigoriy: posts big blind $1
*** HOLE CARDS ***
Dealt to matiko09 [7s Kc]
matiko09: folds 
Dickyxxx: folds 
Eskimo Fox: folds 
stds st: folds 
PacPacBum: raises $1.04 to $2.04
Mr.Grigoriy: calls $1.04
*** FLOP *** [Jc 4s 4d]
PacPacBum: checks 
Mr.Grigoriy: checks 
*** TURN *** [Jc 4s 4d] [6s]
PacPacBum: checks 
Mr.Grigoriy: checks 
*** RIVER *** [Jc 4s 4d 6s] [7d]
PacPacBum: bets $2.09
Mr.Grigoriy: folds 
Uncalled bet ($2.09) returned to PacPacBum
PacPacBum collected $3.88 from pot
PacPacBum: doesn't show hand 
*** SUMMARY ***
Total pot $4.08 | Rake $0.20 
Board [Jc 4s 4d 6s 7d]
Seat 1: matiko09 folded before Flop (didn't bet)
Seat 3: Dickyxxx folded before Flop (didn't bet)
Seat 4: Eskimo Fox folded before Flop (didn't bet)
Seat 5: stds st (button) folded before Flop (didn't bet)
Seat 8: PacPacBum (small blind) collected ($3.88)
Seat 9: Mr.Grigoriy (big blind) folded on the River





PokerStars Hand #154364578081:  Hold'em No Limit (€0.50/€1.00 EUR) - 2016/06/06 13:41:28 CET [2016/06/06 7:41:28 ET]
Table 'Lesath' 9-max Seat #2 is the button
Seat 1: o.miro (€198.45 in chips) 
Seat 2: thecurv (€103.32 in chips) 
Seat 5: matiko09 (€171.67 in chips) 
Seat 6: Dickyxxx (€108.22 in chips) 
Seat 7: Mr.Grigoriy (€100 in chips) 
Seat 9: 72nloses (€70.58 in chips) 
hurtNCYDE will be allowed to play after the button
hammerwife will be allowed to play after the button
matiko09: posts small blind €0.50
Dickyxxx: posts big blind €1
vanilica: sits out 
*** HOLE CARDS ***
Dealt to matiko09 [Ah Ks]
Mr.Grigoriy: folds 
72nloses: raises €2.50 to €3.50
o.miro: folds 
thecurv: folds 
matiko09: raises €10.50 to €14
Dickyxxx: folds 
72nloses: calls €10.50
*** FLOP *** [Qh 6c 8s]
matiko09: checks 
72nloses: checks 
*** TURN *** [Qh 6c 8s] [Qs]
matiko09: checks 
72nloses: checks 
*** RIVER *** [Qh 6c 8s Qs] [9s]
matiko09: checks 
72nloses: checks 
*** SHOW DOWN ***
matiko09: shows [Ah Ks] (a pair of Queens)
72nloses: mucks hand 
matiko09 collected €27.55 from pot
*** SUMMARY ***
Total pot €29 | Rake €1.45 
Board [Qh 6c 8s Qs 9s]
Seat 1: o.miro folded before Flop (didn't bet)
Seat 2: thecurv (button) folded before Flop (didn't bet)
Seat 5: matiko09 (small blind) showed [Ah Ks] and won (€27.55) with a pair of Queens
Seat 6: Dickyxxx (big blind) folded before Flop
Seat 7: Mr.Grigoriy folded before Flop (didn't bet)
Seat 9: 72nloses mucked [4c Kc]





PokerStars Hand #154364580126:  Hold'em No Limit ($0.50/$1.00 USD) - 2016/06/06 13:41:33 CET [2016/06/06 7:41:33 ET]
Table 'Safara' 9-max Seat #2 is the button
Seat 1: Dickyxxx ($100 in chips) 
Seat 2: ozone2003 ($100 in chips) 
Seat 3: erd33 ($170.15 in chips) 
Seat 4: xxxibgdrgn ($100 in chips) 
Seat 5: perezzi10 ($77.84 in chips) 
Seat 6: matiko09 ($138.28 in chips) 
Seat 7: PacPacBum ($122.99 in chips) 
Seat 8: o.miro ($194.11 in chips) 
Seat 9: R1aki ($100 in chips) 
erd33: posts small blind $0.50
xxxibgdrgn: posts big blind $1
*** HOLE CARDS ***
Dealt to matiko09 [Js 3h]
perezzi10: calls $1
matiko09: folds 
PacPacBum: folds 
o.miro: folds 
R1aki: raises $3 to $4
Dickyxxx: folds 
ozone2003: folds 
erd33: folds 
xxxibgdrgn: folds 
perezzi10: folds 
Uncalled bet ($3) returned to R1aki
R1aki collected $3.50 from pot
R1aki: doesn't show hand 
*** SUMMARY ***
Total pot $3.50 | Rake $0 
Seat 1: Dickyxxx folded before Flop (didn't bet)
Seat 2: ozone2003 (button) folded before Flop (didn't bet)
Seat 3: erd33 (small blind) folded before Flop
Seat 4: xxxibgdrgn (big blind) folded before Flop
Seat 5: perezzi10 folded before Flop
Seat 6: matiko09 folded before Flop (didn't bet)
Seat 7: PacPacBum folded before Flop (didn't bet)
Seat 8: o.miro folded before Flop (didn't bet)
Seat 9: R1aki collected ($3.50)





PokerStars Hand #154364581599:  Hold'em No Limit (€0.25/€0.50 EUR) - 2016/06/06 13:41:36 CET [2016/06/06 7:41:36 ET]
Table 'Qinghai II' 6-max Seat #4 is the button
Seat 2: semen500 (€52.25 in chips) 
Seat 3: fun duncan (€64 in chips) 
Seat 4: matiko09 (€50 in chips) 
Seat 5: RastyGordo3 (€128.58 in chips) 
Seat 6: ASReikb2kpro (€50.75 in chips) 
RastyGordo3: posts small blind €0.25
ASReikb2kpro: posts big blind €0.50
*** HOLE CARDS ***
Dealt to matiko09 [4h Kd]
sergbest2005 joins the table at seat #1 
semen500: folds 
fun duncan: folds 
matiko09: folds 
RastyGordo3: folds 
Uncalled bet (€0.25) returned to ASReikb2kpro
ASReikb2kpro collected €0.50 from pot
ASReikb2kpro: doesn't show hand 
*** SUMMARY ***
Total pot €0.50 | Rake €0 
Seat 2: semen500 folded before Flop (didn't bet)
Seat 3: fun duncan folded before Flop (didn't bet)
Seat 4: matiko09 (button) folded before Flop (didn't bet)
Seat 5: RastyGordo3 (small blind) folded before Flop
Seat 6: ASReikb2kpro (big blind) collected (€0.50)





PokerStars Hand #154364591135:  Hold'em No Limit ($0.50/$1.00 USD) - 2016/06/06 13:41:57 CET [2016/06/06 7:41:57 ET]
Table 'Safara' 9-max Seat #3 is the button
Seat 1: Dickyxxx ($100 in chips) 
Seat 2: ozone2003 ($100 in chips) 
Seat 3: erd33 ($169.65 in chips) 
Seat 4: xxxibgdrgn ($100 in chips) 
Seat 5: perezzi10 ($76.84 in chips) 
Seat 6: matiko09 ($138.28 in chips) 
Seat 7: PacPacBum ($122.99 in chips) 
Seat 8: o.miro ($194.11 in chips) 
Seat 9: R1aki ($102.50 in chips) 
xxxibgdrgn: posts small blind $0.50
perezzi10: posts big blind $1
*** HOLE CARDS ***
Dealt to matiko09 [Jd Ad]
matiko09: raises $2 to $3
PacPacBum: folds 
o.miro: folds 
R1aki: folds 
Dickyxxx: folds 
ozone2003: raises $6 to $9
erd33: folds 
xxxibgdrgn: folds 
perezzi10: folds 
matiko09: folds 
Uncalled bet ($6) returned to ozone2003
ozone2003 collected $7.50 from pot
ozone2003: doesn't show hand 
*** SUMMARY ***
Total pot $7.50 | Rake $0 
Seat 1: Dickyxxx folded before Flop (didn't bet)
Seat 2: ozone2003 collected ($7.50)
Seat 3: erd33 (button) folded before Flop (didn't bet)
Seat 4: xxxibgdrgn (small blind) folded before Flop
Seat 5: perezzi10 (big blind) folded before Flop
Seat 6: matiko09 folded before Flop
Seat 7: PacPacBum folded before Flop (didn't bet)
Seat 8: o.miro folded before Flop (didn't bet)
Seat 9: R1aki folded before Flop (didn't bet)





PokerStars Hand #154364592093:  Hold'em No Limit ($0.50/$1.00 USD) - 2016/06/06 13:41:59 CET [2016/06/06 7:41:59 ET]
Table 'Williams' 9-max Seat #5 is the button
Seat 1: xhinostrabli ($77.56 in chips) 
Seat 2: matiko09 ($173.01 in chips) 
Seat 3: granbunny ($47.56 in chips) 
Seat 4: Mr.Grigoriy ($103.62 in chips) 
Seat 5: xxxibgdrgn ($103.50 in chips) 
Seat 6: xxxZeka ($149.19 in chips) 
Seat 7: Eskimo Fox ($124.01 in chips) 
Seat 8: Dickyxxx ($103 in chips) 
Seat 9: stds st ($63.26 in chips) 
xxxZeka: posts small blind $0.50
Eskimo Fox: posts big blind $1
*** HOLE CARDS ***
Dealt to matiko09 [Js 9s]
Dickyxxx: folds 
stds st: folds 
xhinostrabli: folds 
matiko09: folds 
granbunny: raises $2 to $3
Mr.Grigoriy: folds 
xxxibgdrgn: folds 
xxxZeka: raises $5 to $8
Eskimo Fox: folds 
granbunny: calls $5
*** FLOP *** [7c 6c 8s]
xxxZeka: bets $14
granbunny: raises $25.56 to $39.56 and is all-in
xxxZeka: calls $25.56
*** TURN *** [7c 6c 8s] [8d]
*** RIVER *** [7c 6c 8s 8d] [8h]
*** SHOW DOWN ***
xxxZeka: shows [Jd Jh] (a full house, Eights full of Jacks)
granbunny: shows [Ah 7s] (a full house, Eights full of Sevens)
xxxZeka collected $93.62 from pot
*** SUMMARY ***
Total pot $96.12 | Rake $2.50 
Board [7c 6c 8s 8d 8h]
Seat 1: xhinostrabli folded before Flop (didn't bet)
Seat 2: matiko09 folded before Flop (didn't bet)
Seat 3: granbunny showed [Ah 7s] and lost with a full house, Eights full of Sevens
Seat 4: Mr.Grigoriy folded before Flop (didn't bet)
Seat 5: xxxibgdrgn (button) folded before Flop (didn't bet)
Seat 6: xxxZeka (small blind) showed [Jd Jh] and won ($93.62) with a full house, Eights full of Jacks
Seat 7: Eskimo Fox (big blind) folded before Flop
Seat 8: Dickyxxx folded before Flop (didn't bet)
Seat 9: stds st folded before Flop (didn't bet)





PokerStars Hand #154364596113:  Hold'em No Limit ($0.50/$1.00 USD) - 2016/06/06 13:42:08 CET [2016/06/06 7:42:08 ET]
Table 'Sheliak' 9-max Seat #2 is the button
Seat 1: 32rrew ($116.58 in chips) 
Seat 2: xhinostrabli ($73 in chips) 
Seat 3: xxxZeka ($134.12 in chips) 
Seat 4: Dickyxxx ($101.50 in chips) 
Seat 6: matiko09 ($115.25 in chips) 
Seat 7: stds st ($32.93 in chips) 
Seat 8: oliwood2 ($45.50 in chips) 
Seat 9: Steelpaper ($70.31 in chips) 
xxxZeka: posts small blind $0.50
Dickyxxx: posts big blind $1
*** HOLE CARDS ***
Dealt to matiko09 [Td 4s]
matiko09: folds 
stds st: folds 
oliwood2: folds 
Steelpaper: folds 
32rrew: folds 
xhinostrabli: raises $2 to $3
xxxZeka: folds 
Dickyxxx: folds 
Uncalled bet ($2) returned to xhinostrabli
xhinostrabli collected $2.50 from pot
*** SUMMARY ***
Total pot $2.50 | Rake $0 
Seat 1: 32rrew folded before Flop (didn't bet)
Seat 2: xhinostrabli (button) collected ($2.50)
Seat 3: xxxZeka (small blind) folded before Flop
Seat 4: Dickyxxx (big blind) folded before Flop
Seat 6: matiko09 folded before Flop (didn't bet)
Seat 7: stds st folded before Flop (didn't bet)
Seat 8: oliwood2 folded before Flop (didn't bet)
Seat 9: Steelpaper folded before Flop (didn't bet)





PokerStars Hand #154364602404:  Hold'em No Limit (€0.25/€0.50 EUR) - 2016/06/06 13:42:22 CET [2016/06/06 7:42:22 ET]
Table 'Qinghai II' 6-max Seat #5 is the button
Seat 1: sergbest2005 (€50 in chips) 
Seat 2: semen500 (€52.25 in chips) 
Seat 3: fun duncan (€64 in chips) 
Seat 4: matiko09 (€50 in chips) 
Seat 5: RastyGordo3 (€128.33 in chips) 
Seat 6: ASReikb2kpro (€51 in chips) 
ASReikb2kpro: posts small blind €0.25
sergbest2005: posts big blind €0.50
*** HOLE CARDS ***
Dealt to matiko09 [Qh Ah]
semen500: folds 
fun duncan: folds 
matiko09: raises €0.75 to €1.25
RastyGordo3: folds 
ASReikb2kpro: folds 
sergbest2005: folds 
Uncalled bet (€0.75) returned to matiko09
matiko09 collected €1.25 from pot
matiko09: doesn't show hand 
*** SUMMARY ***
Total pot €1.25 | Rake €0 
Seat 1: sergbest2005 (big blind) folded before Flop
Seat 2: semen500 folded before Flop (didn't bet)
Seat 3: fun duncan folded before Flop (didn't bet)
Seat 4: matiko09 collected (€1.25)
Seat 5: RastyGordo3 (button) folded before Flop (didn't bet)
Seat 6: ASReikb2kpro (small blind) folded before Flop





PokerStars Hand #154364603600:  Hold'em No Limit ($0.50/$1.00 USD) - 2016/06/06 13:42:25 CET [2016/06/06 7:42:25 ET]
Table 'Safara' 9-max Seat #4 is the button
Seat 1: Dickyxxx ($100 in chips) 
Seat 2: ozone2003 ($104.50 in chips) 
Seat 3: erd33 ($169.65 in chips) 
Seat 4: xxxibgdrgn ($100 in chips) 
Seat 5: perezzi10 ($75.84 in chips) 
Seat 6: matiko09 ($135.28 in chips) 
Seat 7: PacPacBum ($122.99 in chips) 
Seat 8: o.miro ($194.11 in chips) 
Seat 9: R1aki ($102.50 in chips) 
perezzi10: posts small blind $0.50
matiko09: posts big blind $1
*** HOLE CARDS ***
Dealt to matiko09 [Jc 2s]
PacPacBum: folds 
o.miro: folds 
R1aki: folds 
Dickyxxx: folds 
ozone2003: folds 
erd33: raises $3 to $4
xxxibgdrgn: folds 
perezzi10: folds 
matiko09: folds 
Uncalled bet ($3) returned to erd33
erd33 collected $2.50 from pot
*** SUMMARY ***
Total pot $2.50 | Rake $0 
Seat 1: Dickyxxx folded before Flop (didn't bet)
Seat 2: ozone2003 folded before Flop (didn't bet)
Seat 3: erd33 collected ($2.50)
Seat 4: xxxibgdrgn (button) folded before Flop (didn't bet)
Seat 5: perezzi10 (small blind) folded before Flop
Seat 6: matiko09 (big blind) folded before Flop
Seat 7: PacPacBum folded before Flop (didn't bet)
Seat 8: o.miro folded before Flop (didn't bet)
Seat 9: R1aki folded before Flop (didn't bet)





PokerStars Hand #154364604126:  Hold'em No Limit ($0.50/$1.00 USD) - 2016/06/06 13:42:26 CET [2016/06/06 7:42:26 ET]
Table 'Wezen II' 9-max Seat #8 is the button
Seat 1: matiko09 ($110.25 in chips) 
Seat 2: Mr.Grigoriy ($108.12 in chips) 
Seat 3: Dickyxxx ($107.12 in chips) 
Seat 4: xxxibgdrgn ($212.85 in chips) 
Seat 5: stds st ($32.55 in chips) 
Seat 6: Eskimo Fox ($100 in chips) 
Seat 8: o.miro ($100 in chips) 
Seat 9: Cogss ($89.70 in chips) 
Cogss: posts small blind $0.50
matiko09: posts big blind $1
*** HOLE CARDS ***
Dealt to matiko09 [Kh Qs]
Mr.Grigoriy: folds 
Dickyxxx: folds 
xxxibgdrgn: folds 
stds st: folds 
Eskimo Fox: raises $1.50 to $2.50
o.miro: folds 
Cogss: calls $2
matiko09: raises $7.50 to $10
Eskimo Fox: folds 
Cogss: calls $7.50
*** FLOP *** [5c Qh 7h]
Cogss: checks 
matiko09: bets $13
Cogss: calls $13
*** TURN *** [5c Qh 7h] [8d]
Cogss: checks 
matiko09: bets $31
Cogss: calls $31
*** RIVER *** [5c Qh 7h 8d] [6c]
Cogss: bets $35.70 and is all-in
matiko09: calls $35.70
*** SHOW DOWN ***
Cogss: shows [6h 5h] (two pair, Sixes and Fives)
matiko09: mucks hand 
Cogss collected $179.40 from pot
*** SUMMARY ***
Total pot $181.90 | Rake $2.50 
Board [5c Qh 7h 8d 6c]
Seat 1: matiko09 (big blind) mucked [Kh Qs]
Seat 2: Mr.Grigoriy folded before Flop (didn't bet)
Seat 3: Dickyxxx folded before Flop (didn't bet)
Seat 4: xxxibgdrgn folded before Flop (didn't bet)
Seat 5: stds st folded before Flop (didn't bet)
Seat 6: Eskimo Fox folded before Flop
Seat 8: o.miro (button) folded before Flop (didn't bet)
Seat 9: Cogss (small blind) showed [6h 5h] and won ($179.40) with two pair, Sixes and Fives





PokerStars Hand #154364606094:  Hold'em No Limit ($0.50/$1.00 USD) - 2016/06/06 13:42:31 CET [2016/06/06 7:42:31 ET]
Table 'Siegma' 9-max Seat #2 is the button
Seat 1: Mr.Grigoriy ($100 in chips) 
Seat 2: hammerwife ($111.36 in chips) 
Seat 3: R1aki ($140.30 in chips) 
Seat 5: arctur17 ($100 in chips) 
Seat 6: stds st ($56.73 in chips) 
Seat 7: nviss ($35.11 in chips) 
Seat 8: hurtNCYDE ($101.50 in chips) 
Seat 9: matiko09 ($109.50 in chips) 
R1aki: posts small blind $0.50
ozone2003: is sitting out 
ozone2003 leaves the table
arctur17: posts big blind $1
*** HOLE CARDS ***
Dealt to matiko09 [Kd 2h]
stds st: raises $1.50 to $2.50
nviss: folds 
hurtNCYDE: folds 
matiko09: folds 
Mr.Grigoriy: folds 
hammerwife: folds 
R1aki: folds 
arctur17: folds 
Uncalled bet ($1.50) returned to stds st
stds st collected $2.50 from pot
stds st: doesn't show hand 
*** SUMMARY ***
Total pot $2.50 | Rake $0 
Seat 1: Mr.Grigoriy folded before Flop (didn't bet)
Seat 2: hammerwife (button) folded before Flop (didn't bet)
Seat 3: R1aki (small blind) folded before Flop
Seat 5: arctur17 (big blind) folded before Flop
Seat 6: stds st collected ($2.50)
Seat 7: nviss folded before Flop (didn't bet)
Seat 8: hurtNCYDE folded before Flop (didn't bet)
Seat 9: matiko09 folded before Flop (didn't bet)





PokerStars Hand #154364610412:  Hold'em No Limit ($0.50/$1.00 USD) - 2016/06/06 13:42:40 CET [2016/06/06 7:42:40 ET]
Table 'Heze' 9-max Seat #8 is the button
Seat 1: matiko09 ($186.77 in chips) 
Seat 3: Dickyxxx ($101.33 in chips) 
Seat 4: Eskimo Fox ($100 in chips) 
Seat 5: stds st ($35.50 in chips) 
Seat 8: PacPacBum ($125.78 in chips) 
Seat 9: Mr.Grigoriy ($128.17 in chips) 
Mr.Grigoriy: posts small blind $0.50
matiko09: posts big blind $1
*** HOLE CARDS ***
Dealt to matiko09 [6s Td]
Dickyxxx: folds 
Eskimo Fox: folds 
stds st: folds 
PacPacBum: folds 
Mr.Grigoriy: folds 
Uncalled bet ($0.50) returned to matiko09
matiko09 collected $1 from pot
matiko09: doesn't show hand 
*** SUMMARY ***
Total pot $1 | Rake $0 
Seat 1: matiko09 (big blind) collected ($1)
Seat 3: Dickyxxx folded before Flop (didn't bet)
Seat 4: Eskimo Fox folded before Flop (didn't bet)
Seat 5: stds st folded before Flop (didn't bet)
Seat 8: PacPacBum (button) folded before Flop (didn't bet)
Seat 9: Mr.Grigoriy (small blind) folded before Flop





PokerStars Hand #154364612690:  Hold'em No Limit (€0.25/€0.50 EUR) - 2016/06/06 13:42:45 CET [2016/06/06 7:42:45 ET]
Table 'Qinghai II' 6-max Seat #6 is the button
Seat 1: sergbest2005 (€50 in chips) 
Seat 2: semen500 (€52.25 in chips) 
Seat 3: fun duncan (€64 in chips) 
Seat 4: matiko09 (€50.75 in chips) 
Seat 5: RastyGordo3 (€128.33 in chips) 
Seat 6: ASReikb2kpro (€50.75 in chips) 
sergbest2005: posts small blind €0.25
semen500: posts big blind €0.50
*** HOLE CARDS ***
Dealt to matiko09 [3d Ah]
fun duncan: folds 
matiko09: folds 
RastyGordo3: folds 
ASReikb2kpro: raises €0.75 to €1.25
sergbest2005: folds 
semen500: calls €0.75
*** FLOP *** [3h 7s Qc]
semen500: checks 
ASReikb2kpro: checks 
*** TURN *** [3h 7s Qc] [6h]
semen500: bets €1.75
ASReikb2kpro: folds 
Uncalled bet (€1.75) returned to semen500
semen500 collected €2.61 from pot
semen500: doesn't show hand 
*** SUMMARY ***
Total pot €2.75 | Rake €0.14 
Board [3h 7s Qc 6h]
Seat 1: sergbest2005 (small blind) folded before Flop
Seat 2: semen500 (big blind) collected (€2.61)
Seat 3: fun duncan folded before Flop (didn't bet)
Seat 4: matiko09 folded before Flop (didn't bet)
Seat 5: RastyGordo3 folded before Flop (didn't bet)
Seat 6: ASReikb2kpro (button) folded on the Turn





PokerStars Hand #154364613702:  Hold'em No Limit ($0.50/$1.00 USD) - 2016/06/06 13:42:48 CET [2016/06/06 7:42:48 ET]
Table 'Chaldaea II' 9-max Seat #4 is the button
Seat 1: ozone2003 ($122.29 in chips) 
Seat 2: Mr.Grigoriy ($101 in chips) 
Seat 4: mooose100 ($96.73 in chips) 
Seat 5: stds st ($33.85 in chips) 
Seat 6: PacPacBum ($109.36 in chips) 
Seat 7: xxxibgdrgn ($123.92 in chips) 
Seat 8: 32rrew ($114.46 in chips) 
Seat 9: matiko09 ($115.16 in chips) 
stds st: posts small blind $0.50
PacPacBum: posts big blind $1
hammerwife: sits out 
*** HOLE CARDS ***
Dealt to matiko09 [3d Tc]
xxxibgdrgn: folds 
32rrew: folds 
matiko09: folds 
ozone2003: folds 
Mr.Grigoriy: folds 
mooose100: raises $2 to $3
stds st: folds 
PacPacBum: folds 
Uncalled bet ($2) returned to mooose100
mooose100 collected $2.50 from pot
mooose100: doesn't show hand 
*** SUMMARY ***
Total pot $2.50 | Rake $0 
Seat 1: ozone2003 folded before Flop (didn't bet)
Seat 2: Mr.Grigoriy folded before Flop (didn't bet)
Seat 4: mooose100 (button) collected ($2.50)
Seat 5: stds st (small blind) folded before Flop
Seat 6: PacPacBum (big blind) folded before Flop
Seat 7: xxxibgdrgn folded before Flop (didn't bet)
Seat 8: 32rrew folded before Flop (didn't bet)
Seat 9: matiko09 folded before Flop (didn't bet)





PokerStars Hand #154364619516:  Hold'em No Limit ($0.50/$1.00 USD) - 2016/06/06 13:43:01 CET [2016/06/06 7:43:01 ET]
Table 'Heze' 9-max Seat #9 is the button
Seat 1: matiko09 ($187.27 in chips) 
Seat 3: Dickyxxx ($101.33 in chips) 
Seat 4: Eskimo Fox ($100 in chips) 
Seat 5: stds st ($35.50 in chips) 
Seat 8: PacPacBum ($125.78 in chips) 
Seat 9: Mr.Grigoriy ($127.67 in chips) 
matiko09: posts small blind $0.50
Dickyxxx: posts big blind $1
*** HOLE CARDS ***
Dealt to matiko09 [Ks 7d]
Eskimo Fox: folds 
stds st: folds 
PacPacBum: folds 
Mr.Grigoriy: raises $2 to $3
matiko09: folds 
Dickyxxx: folds 
Uncalled bet ($2) returned to Mr.Grigoriy
Mr.Grigoriy collected $2.50 from pot
Mr.Grigoriy: doesn't show hand 
*** SUMMARY ***
Total pot $2.50 | Rake $0 
Seat 1: matiko09 (small blind) folded before Flop
Seat 3: Dickyxxx (big blind) folded before Flop
Seat 4: Eskimo Fox folded before Flop (didn't bet)
Seat 5: stds st folded before Flop (didn't bet)
Seat 8: PacPacBum folded before Flop (didn't bet)
Seat 9: Mr.Grigoriy (button) collected ($2.50)





PokerStars Hand #154364621410:  Hold'em No Limit ($0.50/$1.00 USD) - 2016/06/06 13:43:05 CET [2016/06/06 7:43:05 ET]
Table 'Siegma' 9-max Seat #3 is the button
Seat 1: Mr.Grigoriy ($100 in chips) 
Seat 2: hammerwife ($111.36 in chips) 
Seat 3: R1aki ($139.80 in chips) 
Seat 5: arctur17 ($99 in chips) 
Seat 6: stds st ($58.23 in chips) 
Seat 7: nviss ($35.11 in chips) 
Seat 8: hurtNCYDE ($101.50 in chips) 
Seat 9: matiko09 ($109.50 in chips) 
arctur17: posts small blind $0.50
stds st: posts big blind $1
*** HOLE CARDS ***
Dealt to matiko09 [Qd Kd]
nviss: folds 
hurtNCYDE: folds 
matiko09: raises $2 to $3
Mr.Grigoriy: folds 
hammerwife: folds 
Dantist1122 joins the table at seat #4 
R1aki: folds 
arctur17: folds 
stds st: folds 
Uncalled bet ($2) returned to matiko09
matiko09 collected $2.50 from pot
matiko09: doesn't show hand 
*** SUMMARY ***
Total pot $2.50 | Rake $0 
Seat 1: Mr.Grigoriy folded before Flop (didn't bet)
Seat 2: hammerwife folded before Flop (didn't bet)
Seat 3: R1aki (button) folded before Flop (didn't bet)
Seat 5: arctur17 (small blind) folded before Flop
Seat 6: stds st (big blind) folded before Flop
Seat 7: nviss folded before Flop (didn't bet)
Seat 8: hurtNCYDE folded before Flop (didn't bet)
Seat 9: matiko09 collected ($2.50)





PokerStars Hand #154364622022:  Hold'em No Limit ($0.50/$1.00 USD) - 2016/06/06 13:43:06 CET [2016/06/06 7:43:06 ET]
Table 'Safara' 9-max Seat #5 is the button
Seat 1: Dickyxxx ($100 in chips) 
Seat 2: ozone2003 ($104.50 in chips) 
Seat 3: erd33 ($171.15 in chips) 
Seat 4: xxxibgdrgn ($100 in chips) 
Seat 5: perezzi10 ($75.34 in chips) 
Seat 6: matiko09 ($134.28 in chips) 
Seat 7: PacPacBum ($122.99 in chips) 
Seat 8: o.miro ($194.11 in chips) 
Seat 9: R1aki ($102.50 in chips) 
matiko09: posts small blind $0.50
PacPacBum: posts big blind $1
*** HOLE CARDS ***
Dealt to matiko09 [9s 2h]
o.miro: folds 
R1aki: folds 
Dickyxxx: folds 
ozone2003: folds 
erd33: raises $4 to $5
xxxibgdrgn: folds 
perezzi10: folds 
matiko09: folds 
PacPacBum: folds 
Uncalled bet ($4) returned to erd33
erd33 collected $2.50 from pot
*** SUMMARY ***
Total pot $2.50 | Rake $0 
Seat 1: Dickyxxx folded before Flop (didn't bet)
Seat 2: ozone2003 folded before Flop (didn't bet)
Seat 3: erd33 collected ($2.50)
Seat 4: xxxibgdrgn folded before Flop (didn't bet)
Seat 5: perezzi10 (button) folded before Flop (didn't bet)
Seat 6: matiko09 (small blind) folded before Flop
Seat 7: PacPacBum (big blind) folded before Flop
Seat 8: o.miro folded before Flop (didn't bet)
Seat 9: R1aki folded before Flop (didn't bet)





PokerStars Hand #154364622293:  Hold'em No Limit (€0.50/€1.00 EUR) - 2016/06/06 13:43:07 CET [2016/06/06 7:43:07 ET]
Table 'Lesath' 9-max Seat #5 is the button
Seat 1: o.miro (€198.45 in chips) 
Seat 2: thecurv (€103.32 in chips) 
Seat 5: matiko09 (€185.22 in chips) 
Seat 6: Dickyxxx (€107.22 in chips) 
Seat 7: Mr.Grigoriy (€100 in chips) 
Seat 9: 72nloses (€56.58 in chips) 
Dickyxxx: posts small blind €0.50
Mr.Grigoriy: posts big blind €1
vanilica: sits out 
hurtNCYDE: sits out 
hammerwife: sits out 
*** HOLE CARDS ***
Dealt to matiko09 [3s Jh]
72nloses: calls €1
o.miro: folds 
thecurv: folds 
matiko09: folds 
Dickyxxx: folds 
Mr.Grigoriy: checks 
*** FLOP *** [2c As 2d]
Mr.Grigoriy: checks 
72nloses: bets €2.38
Mr.Grigoriy: folds 
Uncalled bet (€2.38) returned to 72nloses
72nloses collected €2.38 from pot
*** SUMMARY ***
Total pot €2.50 | Rake €0.12 
Board [2c As 2d]
Seat 1: o.miro folded before Flop (didn't bet)
Seat 2: thecurv folded before Flop (didn't bet)
Seat 5: matiko09 (button) folded before Flop (didn't bet)
Seat 6: Dickyxxx (small blind) folded before Flop
Seat 7: Mr.Grigoriy (big blind) folded on the Flop
Seat 9: 72nloses collected (€2.38)





PokerStars Hand #154364622403:  Hold'em No Limit ($0.50/$1.00 USD) - 2016/06/06 13:43:07 CET [2016/06/06 7:43:07 ET]
Table 'Williams' 9-max Seat #6 is the button
Seat 1: xhinostrabli ($77.56 in chips) 
Seat 2: matiko09 ($173.01 in chips) 
Seat 4: Mr.Grigoriy ($103.62 in chips) 
Seat 5: xxxibgdrgn ($103.50 in chips) 
Seat 6: xxxZeka ($195.25 in chips) 
Seat 7: Eskimo Fox ($123.01 in chips) 
Seat 8: Dickyxxx ($103 in chips) 
Seat 9: stds st ($63.26 in chips) 
Eskimo Fox: posts small blind $0.50
Dickyxxx: posts big blind $1
*** HOLE CARDS ***
Dealt to matiko09 [Tc 5c]
stds st: folds 
granbunny leaves the table
hurtNCYDE joins the table at seat #3 
xhinostrabli: folds 
hurtNCYDE leaves the table
matiko09: folds 
Mr.Grigoriy: folds 
xxxibgdrgn: folds 
xxxZeka: raises $1.50 to $2.50
Eskimo Fox: folds 
Dickyxxx: folds 
Uncalled bet ($1.50) returned to xxxZeka
xxxZeka collected $2.50 from pot
*** SUMMARY ***
Total pot $2.50 | Rake $0 
Seat 1: xhinostrabli folded before Flop (didn't bet)
Seat 2: matiko09 folded before Flop (didn't bet)
Seat 4: Mr.Grigoriy folded before Flop (didn't bet)
Seat 5: xxxibgdrgn folded before Flop (didn't bet)
Seat 6: xxxZeka (button) collected ($2.50)
Seat 7: Eskimo Fox (small blind) folded before Flop
Seat 8: Dickyxxx (big blind) folded before Flop
Seat 9: stds st folded before Flop (didn't bet)





PokerStars Hand #154364626357:  Hold'em No Limit ($0.50/$1.00 USD) - 2016/06/06 13:43:16 CET [2016/06/06 7:43:16 ET]
Table 'Smither' 9-max Seat #6 is the button
Seat 1: PacPacBum ($188.56 in chips) 
Seat 2: matiko09 ($117.52 in chips) 
Seat 3: stds st ($36.50 in chips) 
Seat 4: Mr.Grigoriy ($146.27 in chips) 
Seat 5: Dickyxxx ($100 in chips) 
Seat 6: mooose100 ($86.85 in chips) 
Seat 7: vanilica ($116.62 in chips) 
Seat 9: hammerwife ($123.25 in chips) 
vanilica: posts small blind $0.50
ozone2003: is sitting out 
ozone2003 leaves the table
hammerwife: posts big blind $1
*** HOLE CARDS ***
Dealt to matiko09 [2h 4d]
ipashutapkom joins the table at seat #8 
PacPacBum: folds 
matiko09: folds 
stds st: folds 
Mr.Grigoriy: folds 
Dickyxxx: folds 
mooose100: raises $2 to $3
vanilica: folds 
hammerwife: calls $2
*** FLOP *** [3s 4c 7h]
hammerwife: checks 
mooose100: bets $6.18
hammerwife: folds 
Uncalled bet ($6.18) returned to mooose100
mooose100 collected $6.18 from pot
mooose100: doesn't show hand 
*** SUMMARY ***
Total pot $6.50 | Rake $0.32 
Board [3s 4c 7h]
Seat 1: PacPacBum folded before Flop (didn't bet)
Seat 2: matiko09 folded before Flop (didn't bet)
Seat 3: stds st folded before Flop (didn't bet)
Seat 4: Mr.Grigoriy folded before Flop (didn't bet)
Seat 5: Dickyxxx folded before Flop (didn't bet)
Seat 6: mooose100 (button) collected ($6.18)
Seat 7: vanilica (small blind) folded before Flop
Seat 9: hammerwife (big blind) folded on the Flop





PokerStars Hand #154364627870:  Hold'em No Limit ($0.50/$1.00 USD) - 2016/06/06 13:43:20 CET [2016/06/06 7:43:20 ET]
Table 'Chaldaea II' 9-max Seat #5 is the button
Seat 1: ozone2003 ($122.29 in chips) 
Seat 2: Mr.Grigoriy ($101 in chips) 
Seat 4: mooose100 ($98.23 in chips) 
Seat 5: stds st ($33.35 in chips) 
Seat 6: PacPacBum ($108.36 in chips) 
Seat 7: xxxibgdrgn ($123.92 in chips) 
Seat 8: 32rrew ($114.46 in chips) 
Seat 9: matiko09 ($115.16 in chips) 
PacPacBum: posts small blind $0.50
xxxibgdrgn: posts big blind $1
hammerwife: sits out 
*** HOLE CARDS ***
Dealt to matiko09 [Th 4d]
32rrew: folds 
matiko09: folds 
ozone2003: folds 
Mr.Grigoriy: folds 
mooose100: calls $1
stds st: folds 
PacPacBum: folds 
xxxibgdrgn: checks 
*** FLOP *** [9d 6c 9h]
xxxibgdrgn: bets $1.50
mooose100: calls $1.50
*** TURN *** [9d 6c 9h] [9s]
xxxibgdrgn: checks 
mooose100: bets $5.22
xxxibgdrgn: calls $5.22
*** RIVER *** [9d 6c 9h 9s] [4c]
xxxibgdrgn: checks 
mooose100: checks 
*** SHOW DOWN ***
xxxibgdrgn: shows [As 6h] (a full house, Nines full of Sixes)
mooose100: mucks hand 
xxxibgdrgn collected $15.14 from pot
*** SUMMARY ***
Total pot $15.94 | Rake $0.80 
Board [9d 6c 9h 9s 4c]
Seat 1: ozone2003 folded before Flop (didn't bet)
Seat 2: Mr.Grigoriy folded before Flop (didn't bet)
Seat 4: mooose100 mucked [7h 8c]
Seat 5: stds st (button) folded before Flop (didn't bet)
Seat 6: PacPacBum (small blind) folded before Flop
Seat 7: xxxibgdrgn (big blind) showed [As 6h] and won ($15.14) with a full house, Nines full of Sixes
Seat 8: 32rrew folded before Flop (didn't bet)
Seat 9: matiko09 folded before Flop (didn't bet)





PokerStars Hand #154364635156:  Hold'em No Limit ($0.50/$1.00 USD) - 2016/06/06 13:43:36 CET [2016/06/06 7:43:36 ET]
Table 'Safara' 9-max Seat #6 is the button
Seat 1: Dickyxxx ($100 in chips) 
Seat 2: ozone2003 ($104.50 in chips) 
Seat 3: erd33 ($172.65 in chips) 
Seat 4: xxxibgdrgn ($100 in chips) 
Seat 5: perezzi10 ($75.34 in chips) 
Seat 6: matiko09 ($133.78 in chips) 
Seat 7: PacPacBum ($121.99 in chips) 
Seat 8: o.miro ($194.11 in chips) 
Seat 9: R1aki ($102.50 in chips) 
PacPacBum: posts small blind $0.50
o.miro: posts big blind $1
*** HOLE CARDS ***
Dealt to matiko09 [5s 8d]
R1aki: folds 
Dickyxxx: folds 
ozone2003: folds 
erd33: folds 
xxxibgdrgn: folds 
perezzi10: calls $1
matiko09: folds 
PacPacBum: folds 
o.miro: checks 
*** FLOP *** [2c 7c 2s]
o.miro: checks 
perezzi10: checks 
*** TURN *** [2c 7c 2s] [As]
o.miro: checks 
perezzi10: checks 
*** RIVER *** [2c 7c 2s As] [7d]
o.miro: bets $1.50
perezzi10: folds 
Uncalled bet ($1.50) returned to o.miro
o.miro collected $2.38 from pot
o.miro: doesn't show hand 
*** SUMMARY ***
Total pot $2.50 | Rake $0.12 
Board [2c 7c 2s As 7d]
Seat 1: Dickyxxx folded before Flop (didn't bet)
Seat 2: ozone2003 folded before Flop (didn't bet)
Seat 3: erd33 folded before Flop (didn't bet)
Seat 4: xxxibgdrgn folded before Flop (didn't bet)
Seat 5: perezzi10 folded on the River
Seat 6: matiko09 (button) folded before Flop (didn't bet)
Seat 7: PacPacBum (small blind) folded before Flop
Seat 8: o.miro (big blind) collected ($2.38)
Seat 9: R1aki folded before Flop (didn't bet)





PokerStars Hand #154364637178:  Hold'em No Limit ($0.50/$1.00 USD) - 2016/06/06 13:43:41 CET [2016/06/06 7:43:41 ET]
Table 'Heze' 9-max Seat #1 is the button
Seat 1: matiko09 ($186.77 in chips) 
Seat 3: Dickyxxx ($100.33 in chips) 
Seat 4: Eskimo Fox ($100 in chips) 
Seat 5: stds st ($35.50 in chips) 
Seat 8: PacPacBum ($125.78 in chips) 
Seat 9: Mr.Grigoriy ($129.17 in chips) 
Dickyxxx: posts small blind $0.50
Eskimo Fox: posts big blind $1
*** HOLE CARDS ***
Dealt to matiko09 [7d Ad]
stds st: folds 
PacPacBum: raises $1.04 to $2.04
Mr.Grigoriy: folds 
matiko09: raises $5.96 to $8
Dickyxxx: folds 
Eskimo Fox: folds 
PacPacBum: folds 
Uncalled bet ($5.96) returned to matiko09
matiko09 collected $5.58 from pot
matiko09: doesn't show hand 
*** SUMMARY ***
Total pot $5.58 | Rake $0 
Seat 1: matiko09 (button) collected ($5.58)
Seat 3: Dickyxxx (small blind) folded before Flop
Seat 4: Eskimo Fox (big blind) folded before Flop
Seat 5: stds st folded before Flop (didn't bet)
Seat 8: PacPacBum folded before Flop
Seat 9: Mr.Grigoriy folded before Flop (didn't bet)





PokerStars Hand #154364638899:  Hold'em No Limit (€0.25/€0.50 EUR) - 2016/06/06 13:43:45 CET [2016/06/06 7:43:45 ET]
Table 'Qinghai II' 6-max Seat #1 is the button
Seat 1: sergbest2005 (€50 in chips) 
Seat 2: semen500 (€53.61 in chips) 
Seat 3: fun duncan (€64 in chips) 
Seat 4: matiko09 (€50.75 in chips) 
Seat 5: RastyGordo3 (€128.33 in chips) 
Seat 6: ASReikb2kpro (€50 in chips) 
semen500: posts small blind €0.25
fun duncan: posts big blind €0.50
*** HOLE CARDS ***
Dealt to matiko09 [6d Kh]
matiko09: folds 
RastyGordo3: folds 
ASReikb2kpro: raises €0.75 to €1.25
sergbest2005: calls €1.25
semen500: raises €4.75 to €6
fun duncan: folds 
ASReikb2kpro: folds 
sergbest2005: folds 
Uncalled bet (€4.75) returned to semen500
semen500 collected €4.25 from pot
semen500: doesn't show hand 
*** SUMMARY ***
Total pot €4.25 | Rake €0 
Seat 1: sergbest2005 (button) folded before Flop
Seat 2: semen500 (small blind) collected (€4.25)
Seat 3: fun duncan (big blind) folded before Flop
Seat 4: matiko09 folded before Flop (didn't bet)
Seat 5: RastyGordo3 folded before Flop (didn't bet)
Seat 6: ASReikb2kpro folded before Flop





PokerStars Hand #154364639380:  Hold'em No Limit ($0.50/$1.00 USD) - 2016/06/06 13:43:46 CET [2016/06/06 7:43:46 ET]
Table 'Wezen II' 9-max Seat #9 is the button
Seat 1: matiko09 ($100 in chips) 
Seat 2: Mr.Grigoriy ($108.12 in chips) 
Seat 3: Dickyxxx ($107.12 in chips) 
Seat 4: xxxibgdrgn ($212.85 in chips) 
Seat 5: stds st ($32.55 in chips) 
Seat 6: Eskimo Fox ($100 in chips) 
Seat 8: o.miro ($100 in chips) 
Seat 9: Cogss ($179.40 in chips) 
matiko09: posts small blind $0.50
Mr.Grigoriy: posts big blind $1
*** HOLE CARDS ***
Dealt to matiko09 [6c 3c]
Dickyxxx: folds 
xxxibgdrgn: folds 
stds st: folds 
Eskimo Fox: folds 
o.miro: folds 
Cogss: raises $1 to $2
matiko09: folds 
Mr.Grigoriy: folds 
Uncalled bet ($1) returned to Cogss
Cogss collected $2.50 from pot
*** SUMMARY ***
Total pot $2.50 | Rake $0 
Seat 1: matiko09 (small blind) folded before Flop
Seat 2: Mr.Grigoriy (big blind) folded before Flop
Seat 3: Dickyxxx folded before Flop (didn't bet)
Seat 4: xxxibgdrgn folded before Flop (didn't bet)
Seat 5: stds st folded before Flop (didn't bet)
Seat 6: Eskimo Fox folded before Flop (didn't bet)
Seat 8: o.miro folded before Flop (didn't bet)
Seat 9: Cogss (button) collected ($2.50)





PokerStars Hand #154364640323:  Hold'em No Limit ($0.50/$1.00 USD) - 2016/06/06 13:43:48 CET [2016/06/06 7:43:48 ET]
Table 'Williams' 9-max Seat #7 is the button
Seat 1: xhinostrabli ($77.56 in chips) 
Seat 2: matiko09 ($173.01 in chips) 
Seat 4: Mr.Grigoriy ($103.62 in chips) 
Seat 5: xxxibgdrgn ($103.50 in chips) 
Seat 6: xxxZeka ($196.75 in chips) 
Seat 7: Eskimo Fox ($122.51 in chips) 
Seat 8: Dickyxxx ($102 in chips) 
Seat 9: stds st ($63.26 in chips) 
Dickyxxx: posts small blind $0.50
stds st: posts big blind $1
*** HOLE CARDS ***
Dealt to matiko09 [8s 3c]
xhinostrabli: folds 
matiko09: folds 
Mr.Grigoriy: folds 
xxxibgdrgn: folds 
xxxZeka: folds 
Eskimo Fox: folds 
Dickyxxx: folds 
Uncalled bet ($0.50) returned to stds st
stds st collected $1 from pot
stds st: doesn't show hand 
*** SUMMARY ***
Total pot $1 | Rake $0 
Seat 1: xhinostrabli folded before Flop (didn't bet)
Seat 2: matiko09 folded before Flop (didn't bet)
Seat 4: Mr.Grigoriy folded before Flop (didn't bet)
Seat 5: xxxibgdrgn folded before Flop (didn't bet)
Seat 6: xxxZeka folded before Flop (didn't bet)
Seat 7: Eskimo Fox (button) folded before Flop (didn't bet)
Seat 8: Dickyxxx (small blind) folded before Flop
Seat 9: stds st (big blind) collected ($1)





PokerStars Hand #154364644496:  Hold'em No Limit ($0.50/$1.00 USD) - 2016/06/06 13:43:57 CET [2016/06/06 7:43:57 ET]
Table 'Smither' 9-max Seat #7 is the button
Seat 1: PacPacBum ($188.56 in chips) 
Seat 2: matiko09 ($117.52 in chips) 
Seat 3: stds st ($36.50 in chips) 
Seat 4: Mr.Grigoriy ($146.27 in chips) 
Seat 5: Dickyxxx ($100 in chips) 
Seat 6: mooose100 ($90.03 in chips) 
Seat 7: vanilica ($116.12 in chips) 
Seat 9: hammerwife ($120.25 in chips) 
ipashutapkom will be allowed to play after the button
hammerwife: posts small blind $0.50
PacPacBum: posts big blind $1
*** HOLE CARDS ***
Dealt to matiko09 [Ts 5c]
matiko09: folds 
stds st: folds 
Mr.Grigoriy: folds 
Dickyxxx: raises $2 to $3
mooose100: folds 
vanilica: raises $6 to $9
hammerwife: folds 
PacPacBum: folds 
Dickyxxx: calls $6
*** FLOP *** [Qd Kd Jc]
Dickyxxx: checks 
vanilica: bets $11.11
Dickyxxx: calls $11.11
*** TURN *** [Qd Kd Jc] [8c]
Dickyxxx: checks 
vanilica: bets $23.77
Dickyxxx: folds 
Uncalled bet ($23.77) returned to vanilica
vanilica collected $39.63 from pot
vanilica: doesn't show hand 
*** SUMMARY ***
Total pot $41.72 | Rake $2.09 
Board [Qd Kd Jc 8c]
Seat 1: PacPacBum (big blind) folded before Flop
Seat 2: matiko09 folded before Flop (didn't bet)
Seat 3: stds st folded before Flop (didn't bet)
Seat 4: Mr.Grigoriy folded before Flop (didn't bet)
Seat 5: Dickyxxx folded on the Turn
Seat 6: mooose100 folded before Flop (didn't bet)
Seat 7: vanilica (button) collected ($39.63)
Seat 9: hammerwife (small blind) folded before Flop





PokerStars Hand #154364644170:  Hold'em No Limit ($0.50/$1.00 USD) - 2016/06/06 13:43:57 CET [2016/06/06 7:43:57 ET]
Table 'Siegma' 9-max Seat #5 is the button
Seat 1: Mr.Grigoriy ($100 in chips) 
Seat 2: hammerwife ($111.36 in chips) 
Seat 3: R1aki ($139.80 in chips) 
Seat 5: arctur17 ($98.50 in chips) 
Seat 6: stds st ($57.23 in chips) 
Seat 7: nviss ($35.11 in chips) 
Seat 8: hurtNCYDE ($101.50 in chips) 
Seat 9: matiko09 ($111 in chips) 
stds st: posts small blind $0.50
nviss: posts big blind $1
Dantist1122: sits out 
*** HOLE CARDS ***
Dealt to matiko09 [Kd 6d]
hurtNCYDE: raises $1.50 to $2.50
matiko09: folds 
Mr.Grigoriy: folds 
hammerwife: folds 
R1aki: folds 
arctur17: folds 
stds st: folds 
nviss: folds 
Uncalled bet ($1.50) returned to hurtNCYDE
hurtNCYDE collected $2.50 from pot
*** SUMMARY ***
Total pot $2.50 | Rake $0 
Seat 1: Mr.Grigoriy folded before Flop (didn't bet)
Seat 2: hammerwife folded before Flop (didn't bet)
Seat 3: R1aki folded before Flop (didn't bet)
Seat 5: arctur17 (button) folded before Flop (didn't bet)
Seat 6: stds st (small blind) folded before Flop
Seat 7: nviss (big blind) folded before Flop
Seat 8: hurtNCYDE collected ($2.50)
Seat 9: matiko09 folded before Flop (didn't bet)





PokerStars Hand #154364646733:  Hold'em No Limit (€0.50/€1.00 EUR) - 2016/06/06 13:44:02 CET [2016/06/06 7:44:02 ET]
Table 'Lesath' 9-max Seat #6 is the button
Seat 1: o.miro (€198.45 in chips) 
Seat 2: thecurv (€103.32 in chips) 
Seat 5: matiko09 (€185.22 in chips) 
Seat 6: Dickyxxx (€106.72 in chips) 
Seat 7: Mr.Grigoriy (€100 in chips) 
Seat 8: vanilica (€100 in chips) 
Seat 9: 72nloses (€57.96 in chips) 
Mr.Grigoriy: posts small blind €0.50
vanilica: posts big blind €1
hurtNCYDE: sits out 
hammerwife: sits out 
*** HOLE CARDS ***
Dealt to matiko09 [Ks 5h]
72nloses: calls €1
o.miro: folds 
thecurv: folds 
matiko09: folds 
Dickyxxx: folds 
Mr.Grigoriy: calls €0.50
vanilica: checks 
*** FLOP *** [6c 8d Js]
Mr.Grigoriy: checks 
vanilica: checks 
72nloses: checks 
*** TURN *** [6c 8d Js] [9c]
Mr.Grigoriy: checks 
vanilica: bets €2.85
72nloses: calls €2.85
Mr.Grigoriy: folds 
*** RIVER *** [6c 8d Js 9c] [4c]
vanilica: checks 
72nloses: bets €8.26
vanilica: calls €8.26
*** SHOW DOWN ***
72nloses: shows [Kc 2c] (a flush, King high)
vanilica: mucks hand 
72nloses collected €23.96 from pot
*** SUMMARY ***
Total pot €25.22 | Rake €1.26 
Board [6c 8d Js 9c 4c]
Seat 1: o.miro folded before Flop (didn't bet)
Seat 2: thecurv folded before Flop (didn't bet)
Seat 5: matiko09 folded before Flop (didn't bet)
Seat 6: Dickyxxx (button) folded before Flop (didn't bet)
Seat 7: Mr.Grigoriy (small blind) folded on the Turn
Seat 8: vanilica (big blind) mucked [Jc 6d]
Seat 9: 72nloses showed [Kc 2c] and won (€23.96) with a flush, King high





PokerStars Hand #154364652428:  Hold'em No Limit ($0.50/$1.00 USD) - 2016/06/06 13:44:15 CET [2016/06/06 7:44:15 ET]
Table 'Williams' 9-max Seat #8 is the button
Seat 1: xhinostrabli ($77.56 in chips) 
Seat 2: matiko09 ($173.01 in chips) 
Seat 4: Mr.Grigoriy ($103.62 in chips) 
Seat 5: xxxibgdrgn ($103.50 in chips) 
Seat 6: xxxZeka ($196.75 in chips) 
Seat 7: Eskimo Fox ($122.51 in chips) 
Seat 8: Dickyxxx ($101.50 in chips) 
Seat 9: stds st ($63.76 in chips) 
stds st: posts small blind $0.50
xhinostrabli: posts big blind $1
*** HOLE CARDS ***
Dealt to matiko09 [4h Td]
matiko09: folds 
Mr.Grigoriy: folds 
xxxibgdrgn: raises $2 to $3
xxxZeka: folds 
Eskimo Fox: folds 
Dickyxxx: folds 
stds st: folds 
xhinostrabli: folds 
Uncalled bet ($2) returned to xxxibgdrgn
xxxibgdrgn collected $2.50 from pot
gabi_igna joins the table at seat #3 
xxxibgdrgn: doesn't show hand 
*** SUMMARY ***
Total pot $2.50 | Rake $0 
Seat 1: xhinostrabli (big blind) folded before Flop
Seat 2: matiko09 folded before Flop (didn't bet)
Seat 4: Mr.Grigoriy folded before Flop (didn't bet)
Seat 5: xxxibgdrgn collected ($2.50)
Seat 6: xxxZeka folded before Flop (didn't bet)
Seat 7: Eskimo Fox folded before Flop (didn't bet)
Seat 8: Dickyxxx (button) folded before Flop (didn't bet)
Seat 9: stds st (small blind) folded before Flop





PokerStars Hand #154364653544:  Hold'em No Limit ($0.50/$1.00 USD) - 2016/06/06 13:44:17 CET [2016/06/06 7:44:17 ET]
Table 'Heze' 9-max Seat #3 is the button
Seat 1: matiko09 ($190.31 in chips) 
Seat 3: Dickyxxx ($100 in chips) 
Seat 4: Eskimo Fox ($100 in chips) 
Seat 5: stds st ($35.50 in chips) 
Seat 8: PacPacBum ($123.74 in chips) 
Seat 9: Mr.Grigoriy ($129.17 in chips) 
Eskimo Fox: posts small blind $0.50
stds st: posts big blind $1
*** HOLE CARDS ***
Dealt to matiko09 [Jc Jd]
PacPacBum: folds 
Mr.Grigoriy: raises $2 to $3
matiko09: calls $3
Dickyxxx: calls $3
Eskimo Fox: calls $2.50
stds st: folds 
*** FLOP *** [3s Qs Kc]
Eskimo Fox: checks 
Mr.Grigoriy: checks 
matiko09: checks 
Dickyxxx: checks 
*** TURN *** [3s Qs Kc] [8h]
Eskimo Fox: checks 
Mr.Grigoriy: checks 
matiko09: checks 
Dickyxxx: checks 
*** RIVER *** [3s Qs Kc 8h] [4c]
Eskimo Fox: checks 
Mr.Grigoriy: checks 
matiko09: checks 
Dickyxxx: checks 
*** SHOW DOWN ***
Eskimo Fox: shows [8d Td] (a pair of Eights)
Mr.Grigoriy: mucks hand 
matiko09: shows [Jc Jd] (a pair of Jacks)
Dickyxxx: mucks hand 
matiko09 collected $12.35 from pot
*** SUMMARY ***
Total pot $13 | Rake $0.65 
Board [3s Qs Kc 8h 4c]
Seat 1: matiko09 showed [Jc Jd] and won ($12.35) with a pair of Jacks
Seat 3: Dickyxxx (button) mucked [2d 2c]
Seat 4: Eskimo Fox (small blind) showed [8d Td] and lost with a pair of Eights
Seat 5: stds st (big blind) folded before Flop
Seat 8: PacPacBum folded before Flop (didn't bet)
Seat 9: Mr.Grigoriy mucked [Tc 9c]





PokerStars Hand #154364653590:  Hold'em No Limit (€0.25/€0.50 EUR) - 2016/06/06 13:44:18 CET [2016/06/06 7:44:18 ET]
Table 'Qinghai II' 6-max Seat #2 is the button
Seat 1: sergbest2005 (€50 in chips) 
Seat 2: semen500 (€56.61 in chips) 
Seat 3: fun duncan (€63.50 in chips) 
Seat 4: matiko09 (€50.75 in chips) 
Seat 5: RastyGordo3 (€128.33 in chips) 
Seat 6: ASReikb2kpro (€50 in chips) 
fun duncan: posts small blind €0.25
matiko09: posts big blind €0.50
*** HOLE CARDS ***
Dealt to matiko09 [Kh 6c]
RastyGordo3: folds 
ASReikb2kpro: folds 
sergbest2005: folds 
semen500: raises €0.52 to €1.02
fun duncan: calls €0.77
matiko09: folds 
*** FLOP *** [Qc Qs 3d]
fun duncan: checks 
semen500: checks 
*** TURN *** [Qc Qs 3d] [5c]
fun duncan: checks 
semen500: bets €1.20
fun duncan: folds 
Uncalled bet (€1.20) returned to semen500
semen500 collected €2.41 from pot
semen500: doesn't show hand 
*** SUMMARY ***
Total pot €2.54 | Rake €0.13 
Board [Qc Qs 3d 5c]
Seat 1: sergbest2005 folded before Flop (didn't bet)
Seat 2: semen500 (button) collected (€2.41)
Seat 3: fun duncan (small blind) folded on the Turn
Seat 4: matiko09 (big blind) folded before Flop
Seat 5: RastyGordo3 folded before Flop (didn't bet)
Seat 6: ASReikb2kpro folded before Flop (didn't bet)





PokerStars Hand #154364655534:  Hold'em No Limit ($0.50/$1.00 USD) - 2016/06/06 13:44:22 CET [2016/06/06 7:44:22 ET]
Table 'Siegma' 9-max Seat #6 is the button
Seat 1: Mr.Grigoriy ($100 in chips) 
Seat 2: hammerwife ($111.36 in chips) 
Seat 3: R1aki ($139.80 in chips) 
Seat 5: arctur17 ($98.50 in chips) 
Seat 6: stds st ($56.73 in chips) 
Seat 7: nviss ($34.11 in chips) 
Seat 8: hurtNCYDE ($103 in chips) 
Seat 9: matiko09 ($111 in chips) 
nviss: posts small blind $0.50
hurtNCYDE: posts big blind $1
Dantist1122: sits out 
*** HOLE CARDS ***
Dealt to matiko09 [9c 9d]
matiko09: raises $2 to $3
Mr.Grigoriy: folds 
hammerwife: raises $6 to $9
R1aki: folds 
arctur17: folds 
stds st: folds 
nviss: folds 
hurtNCYDE: folds 
matiko09: calls $6
*** FLOP *** [Kc Ks Kh]
matiko09: checks 
hammerwife: bets $9.50
matiko09: calls $9.50
*** TURN *** [Kc Ks Kh] [4d]
matiko09: checks 
hammerwife: bets $18.29
matiko09: calls $18.29
*** RIVER *** [Kc Ks Kh 4d] [6s]
matiko09: checks 
hammerwife: bets $74.57 and is all-in
matiko09: folds 
Uncalled bet ($74.57) returned to hammerwife
hammerwife collected $72.58 from pot
hammerwife: doesn't show hand 
*** SUMMARY ***
Total pot $75.08 | Rake $2.50 
Board [Kc Ks Kh 4d 6s]
Seat 1: Mr.Grigoriy folded before Flop (didn't bet)
Seat 2: hammerwife collected ($72.58)
Seat 3: R1aki folded before Flop (didn't bet)
Seat 5: arctur17 folded before Flop (didn't bet)
Seat 6: stds st (button) folded before Flop (didn't bet)
Seat 7: nviss (small blind) folded before Flop
Seat 8: hurtNCYDE (big blind) folded before Flop
Seat 9: matiko09 folded on the River





PokerStars Hand #154364659254:  Hold'em No Limit ($0.50/$1.00 USD) - 2016/06/06 13:44:30 CET [2016/06/06 7:44:30 ET]
Table 'Chaldaea II' 9-max Seat #6 is the button
Seat 1: ozone2003 ($122.29 in chips) 
Seat 2: Mr.Grigoriy ($101 in chips) 
Seat 4: mooose100 ($90.51 in chips) 
Seat 5: stds st ($33.35 in chips) 
Seat 6: PacPacBum ($107.86 in chips) 
Seat 7: xxxibgdrgn ($131.34 in chips) 
Seat 9: matiko09 ($115.16 in chips) 
xxxibgdrgn: posts small blind $0.50
32rrew: is sitting out 
32rrew leaves the table
matiko09: posts big blind $1
hammerwife: sits out 
*** HOLE CARDS ***
Dealt to matiko09 [4h 3c]
xxxZeka joins the table at seat #8 
ozone2003: folds 
Mr.Grigoriy: folds 
ozone2003 leaves the table
mooose100: calls $1
stds st: folds 
hurtNCYDE joins the table at seat #1 
hurtNCYDE leaves the table
PacPacBum: folds 
xxxibgdrgn: raises $3 to $4
matiko09: folds 
mooose100: calls $3
*** FLOP *** [Ks 4c 5c]
xxxibgdrgn: checks 
mooose100: bets $4.27
xxxibgdrgn: calls $4.27
*** TURN *** [Ks 4c 5c] [6s]
xxxibgdrgn: checks 
mooose100: checks 
*** RIVER *** [Ks 4c 5c 6s] [6h]
gabi_igna joins the table at seat #1 
xxxibgdrgn: checks 
mooose100: checks 
*** SHOW DOWN ***
xxxibgdrgn: shows [7d 7h] (two pair, Sevens and Sixes)
mooose100: mucks hand 
xxxibgdrgn collected $16.66 from pot
*** SUMMARY ***
Total pot $17.54 | Rake $0.88 
Board [Ks 4c 5c 6s 6h]
Seat 1: ozone2003 folded before Flop (didn't bet)
Seat 2: Mr.Grigoriy folded before Flop (didn't bet)
Seat 4: mooose100 mucked [Ad Ts]
Seat 5: stds st folded before Flop (didn't bet)
Seat 6: PacPacBum (button) folded before Flop (didn't bet)
Seat 7: xxxibgdrgn (small blind) showed [7d 7h] and won ($16.66) with two pair, Sevens and Sixes
Seat 9: matiko09 (big blind) folded before Flop





PokerStars Hand #154364662737:  Hold'em No Limit ($0.50/$1.00 USD) - 2016/06/06 13:44:38 CET [2016/06/06 7:44:38 ET]
Table 'Wezen II' 9-max Seat #1 is the button
Seat 1: matiko09 ($100 in chips) 
Seat 2: Mr.Grigoriy ($107.12 in chips) 
Seat 3: Dickyxxx ($107.12 in chips) 
Seat 4: xxxibgdrgn ($212.85 in chips) 
Seat 5: stds st ($32.55 in chips) 
Seat 6: Eskimo Fox ($100 in chips) 
Seat 8: o.miro ($100 in chips) 
Seat 9: Cogss ($180.90 in chips) 
Mr.Grigoriy: posts small blind $0.50
Dickyxxx: posts big blind $1
*** HOLE CARDS ***
Dealt to matiko09 [3s 3d]
xxxibgdrgn: folds 
stds st: folds 
Eskimo Fox: folds 
o.miro: folds 
Cogss: folds 
matiko09: raises $1.27 to $2.27
Mr.Grigoriy: folds 
Dickyxxx: folds 
Uncalled bet ($1.27) returned to matiko09
matiko09 collected $2.50 from pot
matiko09: doesn't show hand 
*** SUMMARY ***
Total pot $2.50 | Rake $0 
Seat 1: matiko09 (button) collected ($2.50)
Seat 2: Mr.Grigoriy (small blind) folded before Flop
Seat 3: Dickyxxx (big blind) folded before Flop
Seat 4: xxxibgdrgn folded before Flop (didn't bet)
Seat 5: stds st folded before Flop (didn't bet)
Seat 6: Eskimo Fox folded before Flop (didn't bet)
Seat 8: o.miro folded before Flop (didn't bet)
Seat 9: Cogss folded before Flop (didn't bet)





PokerStars Hand #154364665847:  Hold'em No Limit ($0.50/$1.00 USD) - 2016/06/06 13:44:45 CET [2016/06/06 7:44:45 ET]
Table 'Williams' 9-max Seat #9 is the button
Seat 1: xhinostrabli ($76.56 in chips) 
Seat 2: matiko09 ($173.01 in chips) 
Seat 4: Mr.Grigoriy ($103.62 in chips) 
Seat 5: xxxibgdrgn ($105 in chips) 
Seat 6: xxxZeka ($196.75 in chips) 
Seat 7: Eskimo Fox ($122.51 in chips) 
Seat 8: Dickyxxx ($101.50 in chips) 
Seat 9: stds st ($63.26 in chips) 
xhinostrabli: posts small blind $0.50
matiko09: posts big blind $1
gabi_igna: sits out 
*** HOLE CARDS ***
Dealt to matiko09 [6d 6h]
Mr.Grigoriy: folds 
xxxibgdrgn: folds 
xxxZeka: raises $2 to $3
Eskimo Fox: folds 
Dickyxxx: folds 
stds st: folds 
xhinostrabli: folds 
matiko09: calls $2
*** FLOP *** [9s 9c Th]
matiko09: checks 
xxxZeka: checks 
*** TURN *** [9s 9c Th] [2s]
matiko09: bets $3.21
xxxZeka: folds 
Uncalled bet ($3.21) returned to matiko09
matiko09 collected $6.18 from pot
matiko09: doesn't show hand 
*** SUMMARY ***
Total pot $6.50 | Rake $0.32 
Board [9s 9c Th 2s]
Seat 1: xhinostrabli (small blind) folded before Flop
Seat 2: matiko09 (big blind) collected ($6.18)
Seat 4: Mr.Grigoriy folded before Flop (didn't bet)
Seat 5: xxxibgdrgn folded before Flop (didn't bet)
Seat 6: xxxZeka folded on the Turn
Seat 7: Eskimo Fox folded before Flop (didn't bet)
Seat 8: Dickyxxx folded before Flop (didn't bet)
Seat 9: stds st (button) folded before Flop (didn't bet)





PokerStars Hand #154364672063:  Hold'em No Limit ($0.50/$1.00 USD) - 2016/06/06 13:44:59 CET [2016/06/06 7:44:59 ET]
Table 'Smither' 9-max Seat #9 is the button
Seat 1: PacPacBum ($187.56 in chips) 
Seat 2: matiko09 ($117.52 in chips) 
Seat 3: stds st ($36.50 in chips) 
Seat 4: Mr.Grigoriy ($146.27 in chips) 
Seat 5: Dickyxxx ($100 in chips) 
Seat 6: mooose100 ($90.03 in chips) 
Seat 7: vanilica ($135.64 in chips) 
Seat 9: hammerwife ($119.75 in chips) 
PacPacBum: posts small blind $0.50
matiko09: posts big blind $1
ipashutapkom: sits out 
*** HOLE CARDS ***
Dealt to matiko09 [Js Kc]
stds st: folds 
Mr.Grigoriy: folds 
Dickyxxx: folds 
mooose100: folds 
vanilica: folds 
hammerwife: folds 
PacPacBum: folds 
Uncalled bet ($0.50) returned to matiko09
matiko09 collected $1 from pot
matiko09: doesn't show hand 
*** SUMMARY ***
Total pot $1 | Rake $0 
Seat 1: PacPacBum (small blind) folded before Flop
Seat 2: matiko09 (big blind) collected ($1)
Seat 3: stds st folded before Flop (didn't bet)
Seat 4: Mr.Grigoriy folded before Flop (didn't bet)
Seat 5: Dickyxxx folded before Flop (didn't bet)
Seat 6: mooose100 folded before Flop (didn't bet)
Seat 7: vanilica folded before Flop (didn't bet)
Seat 9: hammerwife (button) folded before Flop (didn't bet)





PokerStars Hand #154364677629:  Hold'em No Limit ($0.50/$1.00 USD) - 2016/06/06 13:45:11 CET [2016/06/06 7:45:11 ET]
Table 'Safara' 9-max Seat #7 is the button
Seat 1: Dickyxxx ($100 in chips) 
Seat 2: ozone2003 ($104.50 in chips) 
Seat 3: erd33 ($172.65 in chips) 
Seat 4: xxxibgdrgn ($100 in chips) 
Seat 5: perezzi10 ($74.34 in chips) 
Seat 6: matiko09 ($133.78 in chips) 
Seat 7: PacPacBum ($121.49 in chips) 
Seat 8: o.miro ($195.49 in chips) 
Seat 9: R1aki ($102.50 in chips) 
o.miro: posts small blind $0.50
R1aki: posts big blind $1
*** HOLE CARDS ***
Dealt to matiko09 [4h 8s]
Dickyxxx: folds 
ozone2003: folds 
erd33: raises $1 to $2
xxxibgdrgn: folds 
perezzi10: calls $2
matiko09: folds 
PacPacBum: folds 
o.miro: folds 
R1aki: folds 
*** FLOP *** [7s Js 9c]
erd33: bets $2
perezzi10: calls $2
*** TURN *** [7s Js 9c] [8c]
erd33: checks 
perezzi10: bets $2
erd33: calls $2
*** RIVER *** [7s Js 9c 8c] [Jd]
erd33: checks 
perezzi10: bets $15
erd33: folds 
Uncalled bet ($15) returned to perezzi10
perezzi10 collected $12.82 from pot
perezzi10: shows [9d]
*** SUMMARY ***
Total pot $13.50 | Rake $0.68 
Board [7s Js 9c 8c Jd]
Seat 1: Dickyxxx folded before Flop (didn't bet)
Seat 2: ozone2003 folded before Flop (didn't bet)
Seat 3: erd33 folded on the River
Seat 4: xxxibgdrgn folded before Flop (didn't bet)
Seat 5: perezzi10 collected ($12.82)
Seat 6: matiko09 folded before Flop (didn't bet)
Seat 7: PacPacBum (button) folded before Flop (didn't bet)
Seat 8: o.miro (small blind) folded before Flop
Seat 9: R1aki (big blind) folded before Flop





PokerStars Hand #154364681697:  Hold'em No Limit ($0.50/$1.00 USD) - 2016/06/06 13:45:20 CET [2016/06/06 7:45:20 ET]
Table 'Wezen II' 9-max Seat #2 is the button
Seat 1: matiko09 ($101.50 in chips) 
Seat 2: Mr.Grigoriy ($106.62 in chips) 
Seat 3: Dickyxxx ($106.12 in chips) 
Seat 4: xxxibgdrgn ($212.85 in chips) 
Seat 5: stds st ($32.55 in chips) 
Seat 6: Eskimo Fox ($100 in chips) 
Seat 8: o.miro ($100 in chips) 
Seat 9: Cogss ($180.90 in chips) 
Dickyxxx: posts small blind $0.50
xxxibgdrgn: posts big blind $1
*** HOLE CARDS ***
Dealt to matiko09 [3c 4h]
stds st: folds 
Eskimo Fox: folds 
o.miro: folds 
Cogss: raises $1 to $2
matiko09: folds 
Mr.Grigoriy: raises $5 to $7
Dickyxxx: folds 
xxxibgdrgn: folds 
Cogss: calls $5
*** FLOP *** [Ks 2c Jh]
Cogss: checks 
Mr.Grigoriy: bets $9.86
Cogss: folds 
Uncalled bet ($9.86) returned to Mr.Grigoriy
Mr.Grigoriy collected $14.72 from pot
Mr.Grigoriy: doesn't show hand 
*** SUMMARY ***
Total pot $15.50 | Rake $0.78 
Board [Ks 2c Jh]
Seat 1: matiko09 folded before Flop (didn't bet)
Seat 2: Mr.Grigoriy (button) collected ($14.72)
Seat 3: Dickyxxx (small blind) folded before Flop
Seat 4: xxxibgdrgn (big blind) folded before Flop
Seat 5: stds st folded before Flop (didn't bet)
Seat 6: Eskimo Fox folded before Flop (didn't bet)
Seat 8: o.miro folded before Flop (didn't bet)
Seat 9: Cogss folded on the Flop





PokerStars Hand #154364688513:  Hold'em No Limit (€0.25/€0.50 EUR) - 2016/06/06 13:45:35 CET [2016/06/06 7:45:35 ET]
Table 'Qinghai II' 6-max Seat #3 is the button
Seat 1: sergbest2005 (€50 in chips) 
Seat 2: semen500 (€58 in chips) 
Seat 3: fun duncan (€62.48 in chips) 
Seat 4: matiko09 (€50.25 in chips) 
Seat 6: ASReikb2kpro (€50 in chips) 
matiko09: posts small blind €0.25
RastyGordo3: is sitting out 
RastyGordo3 leaves the table
ASReikb2kpro: posts big blind €0.50
*** HOLE CARDS ***
Dealt to matiko09 [2d 4h]
MrLimaN joins the table at seat #5 
sergbest2005: folds 
semen500: folds 
fun duncan: folds 
matiko09: folds 
Uncalled bet (€0.25) returned to ASReikb2kpro
ASReikb2kpro collected €0.50 from pot
ASReikb2kpro: doesn't show hand 
*** SUMMARY ***
Total pot €0.50 | Rake €0 
Seat 1: sergbest2005 folded before Flop (didn't bet)
Seat 2: semen500 folded before Flop (didn't bet)
Seat 3: fun duncan (button) folded before Flop (didn't bet)
Seat 4: matiko09 (small blind) folded before Flop
Seat 6: ASReikb2kpro (big blind) collected (€0.50)





PokerStars Hand #154364689656:  Hold'em No Limit ($0.50/$1.00 USD) - 2016/06/06 13:45:38 CET [2016/06/06 7:45:38 ET]
Table 'Smither' 9-max Seat #1 is the button
Seat 1: PacPacBum ($187.06 in chips) 
Seat 2: matiko09 ($118.02 in chips) 
Seat 3: stds st ($36.50 in chips) 
Seat 4: Mr.Grigoriy ($146.27 in chips) 
Seat 5: Dickyxxx ($100 in chips) 
Seat 6: mooose100 ($90.03 in chips) 
Seat 7: vanilica ($135.64 in chips) 
Seat 9: hammerwife ($119.75 in chips) 
matiko09: posts small blind $0.50
stds st: posts big blind $1
ipashutapkom: sits out 
*** HOLE CARDS ***
Dealt to matiko09 [7s Qs]
Mr.Grigoriy: folds 
Dickyxxx: folds 
mooose100: folds 
vanilica: folds 
hammerwife: folds 
PacPacBum: raises $1.04 to $2.04
matiko09: folds 
stds st: raises $3.96 to $6
PacPacBum: folds 
Uncalled bet ($3.96) returned to stds st
stds st collected $4.58 from pot
stds st: doesn't show hand 
*** SUMMARY ***
Total pot $4.58 | Rake $0 
Seat 1: PacPacBum (button) folded before Flop
Seat 2: matiko09 (small blind) folded before Flop
Seat 3: stds st (big blind) collected ($4.58)
Seat 4: Mr.Grigoriy folded before Flop (didn't bet)
Seat 5: Dickyxxx folded before Flop (didn't bet)
Seat 6: mooose100 folded before Flop (didn't bet)
Seat 7: vanilica folded before Flop (didn't bet)
Seat 9: hammerwife folded before Flop (didn't bet)





PokerStars Hand #154364693184:  Hold'em No Limit (€0.25/€0.50 EUR) - 2016/06/06 13:45:46 CET [2016/06/06 7:45:46 ET]
Table 'Qinghai II' 6-max Seat #4 is the button
Seat 1: sergbest2005 (€50 in chips) 
Seat 2: semen500 (€58 in chips) 
Seat 3: fun duncan (€62.48 in chips) 
Seat 4: matiko09 (€50 in chips) 
Seat 6: ASReikb2kpro (€50.25 in chips) 
MrLimaN will be allowed to play after the button
ASReikb2kpro: posts small blind €0.25
sergbest2005: posts big blind €0.50
*** HOLE CARDS ***
Dealt to matiko09 [Th Ad]
semen500: folds 
semen500 leaves the table
m3Dyyy joins the table at seat #2 
fun duncan has timed out
fun duncan: folds 
matiko09: raises €0.63 to €1.13
fun duncan leaves the table
TIoxepStars joins the table at seat #3 
TIoxepStars leaves the table
ASReikb2kpro: folds 
sergbest2005: calls €0.63
*** FLOP *** [Qd Ks 8c]
sergbest2005: checks 
matiko09: bets €1.55
sergbest2005: folds 
Uncalled bet (€1.55) returned to matiko09
matiko09 collected €2.38 from pot
matiko09: doesn't show hand 
*** SUMMARY ***
Total pot €2.51 | Rake €0.13 
Board [Qd Ks 8c]
Seat 1: sergbest2005 (big blind) folded on the Flop
Seat 2: semen500 folded before Flop (didn't bet)
Seat 3: fun duncan folded before Flop (didn't bet)
Seat 4: matiko09 (button) collected (€2.38)
Seat 6: ASReikb2kpro (small blind) folded before Flop





PokerStars Hand #154364696302:  Hold'em No Limit (€0.50/€1.00 EUR) - 2016/06/06 13:45:53 CET [2016/06/06 7:45:53 ET]
Table 'Lesath' 9-max Seat #7 is the button
Seat 1: o.miro (€198.45 in chips) 
Seat 2: thecurv (€103.32 in chips) 
Seat 5: matiko09 (€185.22 in chips) 
Seat 6: Dickyxxx (€106.72 in chips) 
Seat 7: Mr.Grigoriy (€100 in chips) 
Seat 8: vanilica (€100 in chips) 
Seat 9: 72nloses (€69.81 in chips) 
vanilica: posts small blind €0.50
72nloses: posts big blind €1
hurtNCYDE: sits out 
hammerwife: sits out 
*** HOLE CARDS ***
Dealt to matiko09 [5d Jh]
o.miro: raises €2 to €3
thecurv: calls €3
matiko09: folds 
Dickyxxx: folds 
Mr.Grigoriy: folds 
vanilica: folds 
72nloses: calls €2
*** FLOP *** [3s Td Ts]
72nloses: checks 
o.miro: checks 
thecurv: bets €6.01
72nloses: folds 
o.miro: folds 
Uncalled bet (€6.01) returned to thecurv
thecurv collected €9.02 from pot
thecurv: doesn't show hand 
*** SUMMARY ***
Total pot €9.50 | Rake €0.48 
Board [3s Td Ts]
Seat 1: o.miro folded on the Flop
Seat 2: thecurv collected (€9.02)
Seat 5: matiko09 folded before Flop (didn't bet)
Seat 6: Dickyxxx folded before Flop (didn't bet)
Seat 7: Mr.Grigoriy (button) folded before Flop (didn't bet)
Seat 8: vanilica (small blind) folded before Flop
Seat 9: 72nloses (big blind) folded on the Flop





PokerStars Hand #154364697772:  Hold'em No Limit ($0.50/$1.00 USD) - 2016/06/06 13:45:56 CET [2016/06/06 7:45:56 ET]
Table 'Yarilo' 9-max Seat #9 is the button
Seat 1: xxxZeka ($100.08 in chips) 
Seat 2: matiko09 ($100 in chips) 
Seat 3: TBEinc ($93.18 in chips) 
Seat 4: stds st ($37.84 in chips) 
Seat 5: Dantist1122 ($116.88 in chips) 
Seat 6: marty byrnes ($59.79 in chips) 
Seat 7: Dickyxxx ($124.07 in chips) 
Seat 8: hammerwife ($100 in chips) 
Seat 9: vanilica ($112.82 in chips) 
xxxZeka: posts small blind $0.50
matiko09: posts big blind $1
*** HOLE CARDS ***
Dealt to matiko09 [4h 5c]
TBEinc: folds 
stds st: folds 
Dantist1122: folds 
marty byrnes: calls $1
Dickyxxx: folds 
hammerwife: folds 
vanilica: folds 
xxxZeka: folds 
matiko09: checks 
*** FLOP *** [Qh 9h Td]
matiko09: checks 
marty byrnes: checks 
*** TURN *** [Qh 9h Td] [2c]
matiko09: checks 
marty byrnes: checks 
*** RIVER *** [Qh 9h Td 2c] [Kd]
matiko09: checks 
marty byrnes: checks 
*** SHOW DOWN ***
matiko09: shows [4h 5c] (high card King)
marty byrnes: shows [Ad 7h] (high card Ace)
marty byrnes collected $2.38 from pot
*** SUMMARY ***
Total pot $2.50 | Rake $0.12 
Board [Qh 9h Td 2c Kd]
Seat 1: xxxZeka (small blind) folded before Flop
Seat 2: matiko09 (big blind) showed [4h 5c] and lost with high card King
Seat 3: TBEinc folded before Flop (didn't bet)
Seat 4: stds st folded before Flop (didn't bet)
Seat 5: Dantist1122 folded before Flop (didn't bet)
Seat 6: marty byrnes showed [Ad 7h] and won ($2.38) with high card Ace
Seat 7: Dickyxxx folded before Flop (didn't bet)
Seat 8: hammerwife folded before Flop (didn't bet)
Seat 9: vanilica (button) folded before Flop (didn't bet)





PokerStars Hand #154364698246:  Hold'em No Limit ($0.50/$1.00 USD) - 2016/06/06 13:45:57 CET [2016/06/06 7:45:57 ET]
Table 'Williams' 9-max Seat #1 is the button
Seat 1: xhinostrabli ($76.06 in chips) 
Seat 2: matiko09 ($176.19 in chips) 
Seat 3: gabi_igna ($100 in chips) 
Seat 4: Mr.Grigoriy ($103.62 in chips) 
Seat 5: xxxibgdrgn ($105 in chips) 
Seat 6: xxxZeka ($193.75 in chips) 
Seat 7: Eskimo Fox ($122.51 in chips) 
Seat 8: Dickyxxx ($101.50 in chips) 
Seat 9: stds st ($63.26 in chips) 
matiko09: posts small blind $0.50
gabi_igna: posts big blind $1
*** HOLE CARDS ***
Dealt to matiko09 [Jd 5s]
Mr.Grigoriy: folds 
xxxibgdrgn: folds 
xxxZeka: folds 
Eskimo Fox: folds 
Dickyxxx: folds 
stds st: folds 
xhinostrabli: folds 
matiko09: folds 
Uncalled bet ($0.50) returned to gabi_igna
gabi_igna collected $1 from pot
gabi_igna: doesn't show hand 
*** SUMMARY ***
Total pot $1 | Rake $0 
Seat 1: xhinostrabli (button) folded before Flop (didn't bet)
Seat 2: matiko09 (small blind) folded before Flop
Seat 3: gabi_igna (big blind) collected ($1)
Seat 4: Mr.Grigoriy folded before Flop (didn't bet)
Seat 5: xxxibgdrgn folded before Flop (didn't bet)
Seat 6: xxxZeka folded before Flop (didn't bet)
Seat 7: Eskimo Fox folded before Flop (didn't bet)
Seat 8: Dickyxxx folded before Flop (didn't bet)
Seat 9: stds st folded before Flop (didn't bet)





PokerStars Hand #154364699821:  Hold'em No Limit ($0.50/$1.00 USD) - 2016/06/06 13:46:00 CET [2016/06/06 7:46:00 ET]
Table 'Safara' 9-max Seat #8 is the button
Seat 1: Dickyxxx ($100 in chips) 
Seat 2: ozone2003 ($104.50 in chips) 
Seat 3: erd33 ($166.65 in chips) 
Seat 4: xxxibgdrgn ($100 in chips) 
Seat 5: perezzi10 ($81.16 in chips) 
Seat 6: matiko09 ($133.78 in chips) 
Seat 7: PacPacBum ($121.49 in chips) 
Seat 8: o.miro ($194.99 in chips) 
Seat 9: R1aki ($101.50 in chips) 
R1aki: posts small blind $0.50
Dickyxxx: posts big blind $1
*** HOLE CARDS ***
Dealt to matiko09 [Qs 7s]
ozone2003: folds 
ozone2003 leaves the table
erd33: folds 
hurtNCYDE joins the table at seat #2 
hurtNCYDE leaves the table
xxxibgdrgn: folds 
Dantist1122 joins the table at seat #2 
perezzi10: calls $1
matiko09: folds 
PacPacBum: folds 
o.miro: folds 
R1aki: folds 
Dickyxxx: checks 
*** FLOP *** [4h 3c 5s]
Dickyxxx: checks 
perezzi10: checks 
*** TURN *** [4h 3c 5s] [2h]
Dickyxxx: checks 
perezzi10: checks 
*** RIVER *** [4h 3c 5s 2h] [7c]
Dickyxxx: checks 
perezzi10: checks 
*** SHOW DOWN ***
Dickyxxx: shows [7h 9c] (a pair of Sevens)
perezzi10: mucks hand 
Dickyxxx collected $2.38 from pot
*** SUMMARY ***
Total pot $2.50 | Rake $0.12 
Board [4h 3c 5s 2h 7c]
Seat 1: Dickyxxx (big blind) showed [7h 9c] and won ($2.38) with a pair of Sevens
Seat 2: ozone2003 folded before Flop (didn't bet)
Seat 3: erd33 folded before Flop (didn't bet)
Seat 4: xxxibgdrgn folded before Flop (didn't bet)
Seat 5: perezzi10 mucked [Qh Th]
Seat 6: matiko09 folded before Flop (didn't bet)
Seat 7: PacPacBum folded before Flop (didn't bet)
Seat 8: o.miro (button) folded before Flop (didn't bet)
Seat 9: R1aki (small blind) folded before Flop





PokerStars Hand #154364710422:  Hold'em No Limit ($0.50/$1.00 USD) - 2016/06/06 13:46:24 CET [2016/06/06 7:46:24 ET]
Table 'Siegma' 9-max Seat #7 is the button
Seat 1: Mr.Grigoriy ($100 in chips) 
Seat 2: hammerwife ($147.15 in chips) 
Seat 3: R1aki ($139.80 in chips) 
Seat 5: arctur17 ($98.50 in chips) 
Seat 6: stds st ($56.73 in chips) 
Seat 7: nviss ($33.61 in chips) 
Seat 8: hurtNCYDE ($102 in chips) 
Seat 9: matiko09 ($100 in chips) 
hurtNCYDE: posts small blind $0.50
matiko09: posts big blind $1
Dantist1122: sits out 
*** HOLE CARDS ***
Dealt to matiko09 [Td Jc]
Mr.Grigoriy: folds 
hammerwife: folds 
R1aki: folds 
arctur17: folds 
stds st: folds 
nviss: folds 
hurtNCYDE: folds 
Uncalled bet ($0.50) returned to matiko09
matiko09 collected $1 from pot
matiko09: doesn't show hand 
*** SUMMARY ***
Total pot $1 | Rake $0 
Seat 1: Mr.Grigoriy folded before Flop (didn't bet)
Seat 2: hammerwife folded before Flop (didn't bet)
Seat 3: R1aki folded before Flop (didn't bet)
Seat 5: arctur17 folded before Flop (didn't bet)
Seat 6: stds st folded before Flop (didn't bet)
Seat 7: nviss (button) folded before Flop (didn't bet)
Seat 8: hurtNCYDE (small blind) folded before Flop
Seat 9: matiko09 (big blind) collected ($1)





PokerStars Hand #154364712446:  Hold'em No Limit ($0.50/$1.00 USD) - 2016/06/06 13:46:29 CET [2016/06/06 7:46:29 ET]
Table 'Heze' 9-max Seat #4 is the button
Seat 1: matiko09 ($199.66 in chips) 
Seat 3: Dickyxxx ($100 in chips) 
Seat 4: Eskimo Fox ($100 in chips) 
Seat 5: stds st ($34.50 in chips) 
Seat 8: PacPacBum ($123.74 in chips) 
Seat 9: Mr.Grigoriy ($126.17 in chips) 
stds st: posts small blind $0.50
PacPacBum: posts big blind $1
*** HOLE CARDS ***
Dealt to matiko09 [Th 9c]
Mr.Grigoriy: folds 
matiko09: folds 
Dickyxxx: raises $2 to $3
Eskimo Fox: folds 
stds st: folds 
PacPacBum: folds 
Uncalled bet ($2) returned to Dickyxxx
Dickyxxx collected $2.50 from pot
Dickyxxx: doesn't show hand 
*** SUMMARY ***
Total pot $2.50 | Rake $0 
Seat 1: matiko09 folded before Flop (didn't bet)
Seat 3: Dickyxxx collected ($2.50)
Seat 4: Eskimo Fox (button) folded before Flop (didn't bet)
Seat 5: stds st (small blind) folded before Flop
Seat 8: PacPacBum (big blind) folded before Flop
Seat 9: Mr.Grigoriy folded before Flop (didn't bet)





PokerStars Hand #154364713513:  Hold'em No Limit ($0.50/$1.00 USD) - 2016/06/06 13:46:31 CET [2016/06/06 7:46:31 ET]
Table 'Smither' 9-max Seat #2 is the button
Seat 1: PacPacBum ($185.02 in chips) 
Seat 2: matiko09 ($117.52 in chips) 
Seat 3: stds st ($39.04 in chips) 
Seat 4: Mr.Grigoriy ($146.27 in chips) 
Seat 5: Dickyxxx ($100 in chips) 
Seat 6: mooose100 ($90.03 in chips) 
Seat 7: vanilica ($135.64 in chips) 
Seat 9: hammerwife ($119.75 in chips) 
stds st: posts small blind $0.50
Mr.Grigoriy: posts big blind $1
ipashutapkom: sits out 
*** HOLE CARDS ***
Dealt to matiko09 [9s 6s]
Dickyxxx: folds 
mooose100: calls $1
vanilica: folds 
hammerwife: folds 
PacPacBum: folds 
matiko09: raises $3 to $4
stds st: folds 
Mr.Grigoriy: folds 
mooose100: calls $3
*** FLOP *** [5c 9h Kc]
mooose100: checks 
matiko09: checks 
*** TURN *** [5c 9h Kc] [8s]
mooose100: bets $9.02
matiko09: calls $9.02
*** RIVER *** [5c 9h Kc 8s] [Ks]
mooose100: bets $13.08
matiko09: calls $13.08
*** SHOW DOWN ***
mooose100: shows [Jc Th] (a pair of Kings)
matiko09: shows [9s 6s] (two pair, Kings and Nines)
matiko09 collected $51.20 from pot
*** SUMMARY ***
Total pot $53.70 | Rake $2.50 
Board [5c 9h Kc 8s Ks]
Seat 1: PacPacBum folded before Flop (didn't bet)
Seat 2: matiko09 (button) showed [9s 6s] and won ($51.20) with two pair, Kings and Nines
Seat 3: stds st (small blind) folded before Flop
Seat 4: Mr.Grigoriy (big blind) folded before Flop
Seat 5: Dickyxxx folded before Flop (didn't bet)
Seat 6: mooose100 showed [Jc Th] and lost with a pair of Kings
Seat 7: vanilica folded before Flop (didn't bet)
Seat 9: hammerwife folded before Flop (didn't bet)





PokerStars Hand #154364713976:  Hold'em No Limit ($0.50/$1.00 USD) - 2016/06/06 13:46:32 CET [2016/06/06 7:46:32 ET]
Table 'Chaldaea II' 9-max Seat #7 is the button
Seat 1: gabi_igna ($100 in chips) 
Seat 2: Mr.Grigoriy ($101 in chips) 
Seat 4: mooose100 ($82.24 in chips) 
Seat 5: stds st ($33.35 in chips) 
Seat 6: PacPacBum ($107.86 in chips) 
Seat 7: xxxibgdrgn ($139.73 in chips) 
Seat 9: matiko09 ($114.16 in chips) 
xxxZeka will be allowed to play after the button
matiko09: posts small blind $0.50
gabi_igna: posts big blind $1
hammerwife: sits out 
*** HOLE CARDS ***
Dealt to matiko09 [7c 7h]
Mr.Grigoriy: folds 
mooose100: calls $1
stds st: folds 
PacPacBum: folds 
xxxibgdrgn has timed out
xxxibgdrgn: folds 
matiko09: raises $3 to $4
gabi_igna: folds 
mooose100: calls $3
*** FLOP *** [Qd Jd 2h]
matiko09: checks 
mooose100: bets $8.55
matiko09: folds 
Uncalled bet ($8.55) returned to mooose100
mooose100 collected $8.55 from pot
mooose100: doesn't show hand 
*** SUMMARY ***
Total pot $9 | Rake $0.45 
Board [Qd Jd 2h]
Seat 1: gabi_igna (big blind) folded before Flop
Seat 2: Mr.Grigoriy folded before Flop (didn't bet)
Seat 4: mooose100 collected ($8.55)
Seat 5: stds st folded before Flop (didn't bet)
Seat 6: PacPacBum folded before Flop (didn't bet)
Seat 7: xxxibgdrgn (button) folded before Flop (didn't bet)
Seat 9: matiko09 (small blind) folded on the Flop





PokerStars Hand #154364716214:  Hold'em No Limit ($0.50/$1.00 USD) - 2016/06/06 13:46:37 CET [2016/06/06 7:46:37 ET]
Table 'Yarilo' 9-max Seat #1 is the button
Seat 1: xxxZeka ($100 in chips) 
Seat 2: matiko09 ($100 in chips) 
Seat 3: TBEinc ($93.18 in chips) 
Seat 4: stds st ($37.84 in chips) 
Seat 5: Dantist1122 ($116.88 in chips) 
Seat 6: marty byrnes ($61.17 in chips) 
Seat 7: Dickyxxx ($124.07 in chips) 
Seat 8: hammerwife ($100 in chips) 
Seat 9: vanilica ($112.82 in chips) 
matiko09: posts small blind $0.50
TBEinc: posts big blind $1
*** HOLE CARDS ***
Dealt to matiko09 [3s 2s]
stds st: folds 
Dantist1122: folds 
marty byrnes: raises $2 to $3
Dickyxxx: raises $6 to $9
hammerwife: folds 
vanilica: folds 
xxxZeka: folds 
matiko09: folds 
TBEinc: folds 
marty byrnes: calls $6
*** FLOP *** [Kd 4d 5c]
marty byrnes: checks 
Dickyxxx: bets $11.85
marty byrnes: raises $40.32 to $52.17 and is all-in
Dickyxxx: calls $40.32
*** TURN *** [Kd 4d 5c] [2h]
*** RIVER *** [Kd 4d 5c 2h] [3d]
*** SHOW DOWN ***
marty byrnes: shows [Kh Jh] (a pair of Kings)
Dickyxxx: shows [Qs Kc] (a pair of Kings - Queen kicker)
Dickyxxx collected $121.34 from pot
*** SUMMARY ***
Total pot $123.84 | Rake $2.50 
Board [Kd 4d 5c 2h 3d]
Seat 1: xxxZeka (button) folded before Flop (didn't bet)
Seat 2: matiko09 (small blind) folded before Flop
Seat 3: TBEinc (big blind) folded before Flop
Seat 4: stds st folded before Flop (didn't bet)
Seat 5: Dantist1122 folded before Flop (didn't bet)
Seat 6: marty byrnes showed [Kh Jh] and lost with a pair of Kings
Seat 7: Dickyxxx showed [Qs Kc] and won ($121.34) with a pair of Kings
Seat 8: hammerwife folded before Flop (didn't bet)
Seat 9: vanilica folded before Flop (didn't bet)





PokerStars Hand #154364716840:  Hold'em No Limit ($0.50/$1.00 USD) - 2016/06/06 13:46:39 CET [2016/06/06 7:46:39 ET]
Table 'Siegma' 9-max Seat #8 is the button
Seat 1: Mr.Grigoriy ($100 in chips) 
Seat 2: hammerwife ($147.15 in chips) 
Seat 3: R1aki ($139.80 in chips) 
Seat 5: arctur17 ($98.50 in chips) 
Seat 6: stds st ($56.73 in chips) 
Seat 7: nviss ($33.61 in chips) 
Seat 8: hurtNCYDE ($101.50 in chips) 
Seat 9: matiko09 ($100.50 in chips) 
matiko09: posts small blind $0.50
Mr.Grigoriy: posts big blind $1
Dantist1122: sits out 
*** HOLE CARDS ***
Dealt to matiko09 [8c 7h]
hammerwife: folds 
R1aki: folds 
arctur17: folds 
stds st: folds 
nviss: folds 
hurtNCYDE: raises $1.50 to $2.50
matiko09: folds 
Mr.Grigoriy: folds 
Uncalled bet ($1.50) returned to hurtNCYDE
hurtNCYDE collected $2.50 from pot
*** SUMMARY ***
Total pot $2.50 | Rake $0 
Seat 1: Mr.Grigoriy (big blind) folded before Flop
Seat 2: hammerwife folded before Flop (didn't bet)
Seat 3: R1aki folded before Flop (didn't bet)
Seat 5: arctur17 folded before Flop (didn't bet)
Seat 6: stds st folded before Flop (didn't bet)
Seat 7: nviss folded before Flop (didn't bet)
Seat 8: hurtNCYDE (button) collected ($2.50)
Seat 9: matiko09 (small blind) folded before Flop





PokerStars Hand #154364717561:  Hold'em No Limit ($0.50/$1.00 USD) - 2016/06/06 13:46:40 CET [2016/06/06 7:46:40 ET]
Table 'Wezen II' 9-max Seat #3 is the button
Seat 1: matiko09 ($101.50 in chips) 
Seat 2: Mr.Grigoriy ($114.34 in chips) 
Seat 3: Dickyxxx ($105.62 in chips) 
Seat 4: xxxibgdrgn ($211.85 in chips) 
Seat 5: stds st ($32.55 in chips) 
Seat 6: Eskimo Fox ($100 in chips) 
Seat 8: o.miro ($100 in chips) 
Seat 9: Cogss ($173.90 in chips) 
xxxibgdrgn: posts small blind $0.50
stds st: posts big blind $1
*** HOLE CARDS ***
Dealt to matiko09 [Ac 9s]
Eskimo Fox: raises $2 to $3
o.miro: folds 
Cogss: folds 
matiko09: folds 
Mr.Grigoriy: folds 
Dickyxxx: folds 
xxxibgdrgn: folds 
stds st: folds 
Uncalled bet ($2) returned to Eskimo Fox
Eskimo Fox collected $2.50 from pot
Eskimo Fox: doesn't show hand 
*** SUMMARY ***
Total pot $2.50 | Rake $0 
Seat 1: matiko09 folded before Flop (didn't bet)
Seat 2: Mr.Grigoriy folded before Flop (didn't bet)
Seat 3: Dickyxxx (button) folded before Flop (didn't bet)
Seat 4: xxxibgdrgn (small blind) folded before Flop
Seat 5: stds st (big blind) folded before Flop
Seat 6: Eskimo Fox collected ($2.50)
Seat 8: o.miro folded before Flop (didn't bet)
Seat 9: Cogss folded before Flop (didn't bet)





PokerStars Hand #154364718989:  Hold'em No Limit ($0.50/$1.00 USD) - 2016/06/06 13:46:43 CET [2016/06/06 7:46:43 ET]
Table 'Safara' 9-max Seat #9 is the button
Seat 1: Dickyxxx ($101.38 in chips) 
Seat 2: Dantist1122 ($100 in chips) 
Seat 3: erd33 ($166.65 in chips) 
Seat 4: xxxibgdrgn ($100 in chips) 
Seat 5: perezzi10 ($80.16 in chips) 
Seat 6: matiko09 ($133.78 in chips) 
Seat 7: PacPacBum ($121.49 in chips) 
Seat 8: o.miro ($194.99 in chips) 
Seat 9: R1aki ($101 in chips) 
Dickyxxx: posts small blind $0.50
Dantist1122: posts big blind $1
*** HOLE CARDS ***
Dealt to matiko09 [5c Kc]
erd33: folds 
xxxibgdrgn: folds 
perezzi10: folds 
matiko09: folds 
PacPacBum: folds 
o.miro: folds 
R1aki: raises $1.50 to $2.50
Dickyxxx: folds 
Dantist1122: folds 
Uncalled bet ($1.50) returned to R1aki
R1aki collected $2.50 from pot
R1aki: doesn't show hand 
*** SUMMARY ***
Total pot $2.50 | Rake $0 
Seat 1: Dickyxxx (small blind) folded before Flop
Seat 2: Dantist1122 (big blind) folded before Flop
Seat 3: erd33 folded before Flop (didn't bet)
Seat 4: xxxibgdrgn folded before Flop (didn't bet)
Seat 5: perezzi10 folded before Flop (didn't bet)
Seat 6: matiko09 folded before Flop (didn't bet)
Seat 7: PacPacBum folded before Flop (didn't bet)
Seat 8: o.miro folded before Flop (didn't bet)
Seat 9: R1aki (button) collected ($2.50)





PokerStars Hand #154364719417:  Hold'em No Limit ($0.50/$1.00 USD) - 2016/06/06 13:46:44 CET [2016/06/06 7:46:44 ET]
Table 'Williams' 9-max Seat #2 is the button
Seat 1: xhinostrabli ($76.06 in chips) 
Seat 2: matiko09 ($175.69 in chips) 
Seat 3: gabi_igna ($100.50 in chips) 
Seat 4: Mr.Grigoriy ($103.62 in chips) 
Seat 5: xxxibgdrgn ($105 in chips) 
Seat 6: xxxZeka ($193.75 in chips) 
Seat 7: Eskimo Fox ($122.51 in chips) 
Seat 8: Dickyxxx ($101.50 in chips) 
Seat 9: stds st ($63.26 in chips) 
gabi_igna: posts small blind $0.50
Mr.Grigoriy: posts big blind $1
*** HOLE CARDS ***
Dealt to matiko09 [8c As]
xxxibgdrgn: folds 
xxxZeka: folds 
Eskimo Fox: folds 
Dickyxxx: folds 
stds st: folds 
xhinostrabli: raises $1 to $2
matiko09: folds 
gabi_igna: folds 
Mr.Grigoriy: calls $1
*** FLOP *** [7c 8s Qs]
Mr.Grigoriy: checks 
xhinostrabli: bets $2.14
Mr.Grigoriy: raises $5.36 to $7.50
xhinostrabli: folds 
Uncalled bet ($5.36) returned to Mr.Grigoriy
Mr.Grigoriy collected $8.34 from pot
Mr.Grigoriy: doesn't show hand 
*** SUMMARY ***
Total pot $8.78 | Rake $0.44 
Board [7c 8s Qs]
Seat 1: xhinostrabli folded on the Flop
Seat 2: matiko09 (button) folded before Flop (didn't bet)
Seat 3: gabi_igna (small blind) folded before Flop
Seat 4: Mr.Grigoriy (big blind) collected ($8.34)
Seat 5: xxxibgdrgn folded before Flop (didn't bet)
Seat 6: xxxZeka folded before Flop (didn't bet)
Seat 7: Eskimo Fox folded before Flop (didn't bet)
Seat 8: Dickyxxx folded before Flop (didn't bet)
Seat 9: stds st folded before Flop (didn't bet)





PokerStars Hand #154364724646:  Hold'em No Limit (€0.50/€1.00 EUR) - 2016/06/06 13:46:56 CET [2016/06/06 7:46:56 ET]
Table 'Lesath' 9-max Seat #8 is the button
Seat 1: o.miro (€195.45 in chips) 
Seat 2: thecurv (€109.34 in chips) 
Seat 5: matiko09 (€185.22 in chips) 
Seat 6: Dickyxxx (€106.72 in chips) 
Seat 7: Mr.Grigoriy (€100 in chips) 
Seat 8: vanilica (€100 in chips) 
Seat 9: 72nloses (€66.81 in chips) 
72nloses: posts small blind €0.50
o.miro: posts big blind €1
hurtNCYDE: sits out 
hammerwife: sits out 
*** HOLE CARDS ***
Dealt to matiko09 [6c 2h]
thecurv: folds 
matiko09: folds 
Dickyxxx: folds 
Mr.Grigoriy: folds 
vanilica: folds 
72nloses: folds 
Uncalled bet (€0.50) returned to o.miro
o.miro collected €1 from pot
o.miro: doesn't show hand 
*** SUMMARY ***
Total pot €1 | Rake €0 
Seat 1: o.miro (big blind) collected (€1)
Seat 2: thecurv folded before Flop (didn't bet)
Seat 5: matiko09 folded before Flop (didn't bet)
Seat 6: Dickyxxx folded before Flop (didn't bet)
Seat 7: Mr.Grigoriy folded before Flop (didn't bet)
Seat 8: vanilica (button) folded before Flop (didn't bet)
Seat 9: 72nloses (small blind) folded before Flop





PokerStars Hand #154364726505:  Hold'em No Limit (€0.25/€0.50 EUR) - 2016/06/06 13:47:00 CET [2016/06/06 7:47:00 ET]
Table 'Qinghai II' 6-max Seat #6 is the button
Seat 1: sergbest2005 (€50 in chips) 
Seat 4: matiko09 (€51.25 in chips) 
Seat 6: ASReikb2kpro (€50 in chips) 
sergbest2005: posts small blind €0.25
matiko09: posts big blind €0.50
MrLimaN: sits out 
*** HOLE CARDS ***
Dealt to matiko09 [Qs Jh]
ASReikb2kpro: folds 
sergbest2005: folds 
Uncalled bet (€0.25) returned to matiko09
matiko09 collected €0.50 from pot
matiko09: doesn't show hand 
*** SUMMARY ***
Total pot €0.50 | Rake €0 
Seat 1: sergbest2005 (small blind) folded before Flop
Seat 4: matiko09 (big blind) collected (€0.50)
Seat 6: ASReikb2kpro (button) folded before Flop (didn't bet)





PokerStars Hand #154364727264:  Hold'em No Limit ($0.50/$1.00 USD) - 2016/06/06 13:47:02 CET [2016/06/06 7:47:02 ET]
Table 'Heze' 9-max Seat #5 is the button
Seat 1: matiko09 ($199.66 in chips) 
Seat 3: Dickyxxx ($101.50 in chips) 
Seat 4: Eskimo Fox ($100 in chips) 
Seat 5: stds st ($34 in chips) 
Seat 8: PacPacBum ($122.74 in chips) 
PacPacBum: posts small blind $0.50
Mr.Grigoriy: is sitting out 
matiko09: posts big blind $1
*** HOLE CARDS ***
Dealt to matiko09 [5s 4d]
Dickyxxx: folds 
Eskimo Fox: folds 
stds st: folds 
PacPacBum: raises $1.04 to $2.04
matiko09: folds 
Uncalled bet ($1.04) returned to PacPacBum
PacPacBum collected $2 from pot
PacPacBum: doesn't show hand 
*** SUMMARY ***
Total pot $2 | Rake $0 
Seat 1: matiko09 (big blind) folded before Flop
Seat 3: Dickyxxx folded before Flop (didn't bet)
Seat 4: Eskimo Fox folded before Flop (didn't bet)
Seat 5: stds st (button) folded before Flop (didn't bet)
Seat 8: PacPacBum (small blind) collected ($2)





PokerStars Hand #154364728080:  Hold'em No Limit ($0.50/$1.00 USD) - 2016/06/06 13:47:04 CET [2016/06/06 7:47:04 ET]
Table 'Siegma' 9-max Seat #9 is the button
Seat 1: Mr.Grigoriy ($100 in chips) 
Seat 2: hammerwife ($147.15 in chips) 
Seat 3: R1aki ($139.80 in chips) 
Seat 5: arctur17 ($98.50 in chips) 
Seat 6: stds st ($56.73 in chips) 
Seat 7: nviss ($33.61 in chips) 
Seat 8: hurtNCYDE ($103 in chips) 
Seat 9: matiko09 ($100 in chips) 
Mr.Grigoriy: posts small blind $0.50
hammerwife: posts big blind $1
Dantist1122: sits out 
*** HOLE CARDS ***
Dealt to matiko09 [4c Qh]
R1aki: folds 
R1aki leaves the table
arctur17: folds 
stds st: raises $1.50 to $2.50
vanilica joins the table at seat #3 
nviss has timed out
nviss: folds 
hurtNCYDE: folds 
matiko09: folds 
Mr.Grigoriy: folds 
hammerwife: folds 
Uncalled bet ($1.50) returned to stds st
stds st collected $2.50 from pot
stds st: doesn't show hand 
*** SUMMARY ***
Total pot $2.50 | Rake $0 
Seat 1: Mr.Grigoriy (small blind) folded before Flop
Seat 2: hammerwife (big blind) folded before Flop
Seat 3: R1aki folded before Flop (didn't bet)
Seat 5: arctur17 folded before Flop (didn't bet)
Seat 6: stds st collected ($2.50)
Seat 7: nviss folded before Flop (didn't bet)
Seat 8: hurtNCYDE folded before Flop (didn't bet)
Seat 9: matiko09 (button) folded before Flop (didn't bet)





PokerStars Hand #154364731430:  Hold'em No Limit ($0.50/$1.00 USD) - 2016/06/06 13:47:11 CET [2016/06/06 7:47:11 ET]
Table 'Safara' 9-max Seat #1 is the button
Seat 1: Dickyxxx ($100.88 in chips) 
Seat 2: Dantist1122 ($100 in chips) 
Seat 3: erd33 ($166.65 in chips) 
Seat 4: xxxibgdrgn ($100 in chips) 
Seat 5: perezzi10 ($80.16 in chips) 
Seat 6: matiko09 ($133.78 in chips) 
Seat 7: PacPacBum ($121.49 in chips) 
Seat 8: o.miro ($194.99 in chips) 
Seat 9: R1aki ($102.50 in chips) 
Dantist1122: posts small blind $0.50
erd33: posts big blind $1
*** HOLE CARDS ***
Dealt to matiko09 [7c 2h]
xxxibgdrgn: folds 
perezzi10: calls $1
xxxibgdrgn leaves the table
matiko09: folds 
PacPacBum: raises $3 to $4
stds st joins the table at seat #4 
o.miro: folds 
R1aki: raises $9.50 to $13.50
Dickyxxx: folds 
Dantist1122: folds 
erd33: folds 
perezzi10: folds 
PacPacBum: folds 
Uncalled bet ($9.50) returned to R1aki
R1aki collected $10.50 from pot
R1aki: doesn't show hand 
*** SUMMARY ***
Total pot $10.50 | Rake $0 
Seat 1: Dickyxxx (button) folded before Flop (didn't bet)
Seat 2: Dantist1122 (small blind) folded before Flop
Seat 3: erd33 (big blind) folded before Flop
Seat 4: xxxibgdrgn folded before Flop (didn't bet)
Seat 5: perezzi10 folded before Flop
Seat 6: matiko09 folded before Flop (didn't bet)
Seat 7: PacPacBum folded before Flop
Seat 8: o.miro folded before Flop (didn't bet)
Seat 9: R1aki collected ($10.50)





PokerStars Hand #154364732046:  Hold'em No Limit (€0.25/€0.50 EUR) - 2016/06/06 13:47:13 CET [2016/06/06 7:47:13 ET]
Table 'Qinghai II' 6-max Seat #1 is the button
Seat 1: sergbest2005 (€50 in chips) 
Seat 4: matiko09 (€51.50 in chips) 
Seat 5: MrLimaN (€50 in chips) 
Seat 6: ASReikb2kpro (€50 in chips) 
matiko09: posts small blind €0.25
MrLimaN: posts big blind €0.50
*** HOLE CARDS ***
Dealt to matiko09 [8c 8d]
pat1abor86 joins the table at seat #3 
pat1abor86 leaves the table
ASReikb2kpro: folds 
sergbest2005: raises €0.50 to €1
matiko09: raises €2.50 to €3.50
MrLimaN: folds 
sergbest2005: folds 
Uncalled bet (€2.50) returned to matiko09
matiko09 collected €2.50 from pot
matiko09: doesn't show hand 
*** SUMMARY ***
Total pot €2.50 | Rake €0 
Seat 1: sergbest2005 (button) folded before Flop
Seat 4: matiko09 (small blind) collected (€2.50)
Seat 5: MrLimaN (big blind) folded before Flop
Seat 6: ASReikb2kpro folded before Flop (didn't bet)





PokerStars Hand #154364735375:  Hold'em No Limit ($0.50/$1.00 USD) - 2016/06/06 13:47:20 CET [2016/06/06 7:47:20 ET]
Table 'Wezen II' 9-max Seat #4 is the button
Seat 1: matiko09 ($101.50 in chips) 
Seat 2: Mr.Grigoriy ($114.34 in chips) 
Seat 3: Dickyxxx ($105.62 in chips) 
Seat 4: xxxibgdrgn ($211.35 in chips) 
Seat 5: stds st ($31.55 in chips) 
Seat 6: Eskimo Fox ($101.50 in chips) 
Seat 8: o.miro ($100 in chips) 
Seat 9: Cogss ($173.90 in chips) 
stds st: posts small blind $0.50
Eskimo Fox: posts big blind $1
*** HOLE CARDS ***
Dealt to matiko09 [6d Ad]
o.miro: folds 
Cogss: folds 
matiko09: folds 
Mr.Grigoriy: folds 
Dickyxxx: folds 
xxxibgdrgn: raises $1.50 to $2.50
stds st: folds 
Eskimo Fox: folds 
Uncalled bet ($1.50) returned to xxxibgdrgn
xxxibgdrgn collected $2.50 from pot
xxxibgdrgn: doesn't show hand 
*** SUMMARY ***
Total pot $2.50 | Rake $0 
Seat 1: matiko09 folded before Flop (didn't bet)
Seat 2: Mr.Grigoriy folded before Flop (didn't bet)
Seat 3: Dickyxxx folded before Flop (didn't bet)
Seat 4: xxxibgdrgn (button) collected ($2.50)
Seat 5: stds st (small blind) folded before Flop
Seat 6: Eskimo Fox (big blind) folded before Flop
Seat 8: o.miro folded before Flop (didn't bet)
Seat 9: Cogss folded before Flop (didn't bet)





PokerStars Hand #154364740023:  Hold'em No Limit ($0.50/$1.00 USD) - 2016/06/06 13:47:30 CET [2016/06/06 7:47:30 ET]
Table 'Heze' 9-max Seat #8 is the button
Seat 1: matiko09 ($198.66 in chips) 
Seat 3: Dickyxxx ($101.50 in chips) 
Seat 4: Eskimo Fox ($100 in chips) 
Seat 5: stds st ($34 in chips) 
Seat 8: PacPacBum ($123.74 in chips) 
matiko09: posts small blind $0.50
Dickyxxx: posts big blind $1
*** HOLE CARDS ***
Dealt to matiko09 [6s 3c]
Eskimo Fox: folds 
stds st: folds 
Eskimo Fox leaves the table
hurtNCYDE joins the table at seat #4 
hurtNCYDE leaves the table
PacPacBum: raises $1.04 to $2.04
xxxibgdrgn leaves the table
matiko09: folds 
Dickyxxx: folds 
Uncalled bet ($1.04) returned to PacPacBum
PacPacBum collected $2.50 from pot
PacPacBum: doesn't show hand 
*** SUMMARY ***
Total pot $2.50 | Rake $0 
Seat 1: matiko09 (small blind) folded before Flop
Seat 3: Dickyxxx (big blind) folded before Flop
Seat 4: Eskimo Fox folded before Flop (didn't bet)
Seat 5: stds st folded before Flop (didn't bet)
Seat 8: PacPacBum (button) collected ($2.50)





PokerStars Hand #154364741416:  Hold'em No Limit ($0.50/$1.00 USD) - 2016/06/06 13:47:33 CET [2016/06/06 7:47:33 ET]
Table 'Yarilo' 9-max Seat #2 is the button
Seat 1: xxxZeka ($100 in chips) 
Seat 2: matiko09 ($100 in chips) 
Seat 3: TBEinc ($92.18 in chips) 
Seat 4: stds st ($37.84 in chips) 
Seat 5: Dantist1122 ($116.88 in chips) 
Seat 7: Dickyxxx ($184.24 in chips) 
Seat 8: hammerwife ($100 in chips) 
Seat 9: vanilica ($112.82 in chips) 
TBEinc: posts small blind $0.50
stds st: posts big blind $1
*** HOLE CARDS ***
Dealt to matiko09 [6s 2d]
Dantist1122: folds 
Dickyxxx: folds 
marty byrnes leaves the table
hammerwife: folds 
vanilica: folds 
xxxZeka: raises $2 to $3
matiko09: folds 
hurtNCYDE joins the table at seat #6 
hurtNCYDE leaves the table
TBEinc: raises $5.50 to $8.50
stds st: folds 
xxxZeka: calls $5.50
*** FLOP *** [Jd 8s 2s]
vatraman joins the table at seat #6 
vatraman leaves the table
TBEinc: bets $14
gabi_igna joins the table at seat #6 
xxxZeka: folds 
Uncalled bet ($14) returned to TBEinc
TBEinc collected $17.10 from pot
*** SUMMARY ***
Total pot $18 | Rake $0.90 
Board [Jd 8s 2s]
Seat 1: xxxZeka folded on the Flop
Seat 2: matiko09 (button) folded before Flop (didn't bet)
Seat 3: TBEinc (small blind) collected ($17.10)
Seat 4: stds st (big blind) folded before Flop
Seat 5: Dantist1122 folded before Flop (didn't bet)
Seat 7: Dickyxxx folded before Flop (didn't bet)
Seat 8: hammerwife folded before Flop (didn't bet)
Seat 9: vanilica folded before Flop (didn't bet)





PokerStars Hand #154364746540:  Hold'em No Limit ($0.50/$1.00 USD) - 2016/06/06 13:47:45 CET [2016/06/06 7:47:45 ET]
Table 'Safara' 9-max Seat #2 is the button
Seat 1: Dickyxxx ($100.88 in chips) 
Seat 2: Dantist1122 ($100 in chips) 
Seat 3: erd33 ($165.65 in chips) 
Seat 4: stds st ($40 in chips) 
Seat 5: perezzi10 ($79.16 in chips) 
Seat 6: matiko09 ($133.78 in chips) 
Seat 7: PacPacBum ($117.49 in chips) 
Seat 8: o.miro ($194.99 in chips) 
Seat 9: R1aki ($109 in chips) 
erd33: posts small blind $0.50
stds st: posts big blind $1
*** HOLE CARDS ***
Dealt to matiko09 [5s Ah]
perezzi10: raises $3 to $4
matiko09: folds 
PacPacBum: folds 
o.miro: calls $4
R1aki: folds 
Dickyxxx: folds 
Dantist1122: folds 
erd33: folds 
stds st: folds 
*** FLOP *** [Th Ad 7c]
perezzi10: bets $2
o.miro: calls $2
*** TURN *** [Th Ad 7c] [4h]
perezzi10: checks 
o.miro: checks 
*** RIVER *** [Th Ad 7c 4h] [2s]
perezzi10: bets $6
o.miro: calls $6
*** SHOW DOWN ***
perezzi10: shows [Kc Kh] (a pair of Kings)
o.miro: mucks hand 
perezzi10 collected $24.22 from pot
*** SUMMARY ***
Total pot $25.50 | Rake $1.28 
Board [Th Ad 7c 4h 2s]
Seat 1: Dickyxxx folded before Flop (didn't bet)
Seat 2: Dantist1122 (button) folded before Flop (didn't bet)
Seat 3: erd33 (small blind) folded before Flop
Seat 4: stds st (big blind) folded before Flop
Seat 5: perezzi10 showed [Kc Kh] and won ($24.22) with a pair of Kings
Seat 6: matiko09 folded before Flop (didn't bet)
Seat 7: PacPacBum folded before Flop (didn't bet)
Seat 8: o.miro mucked [7s 8s]
Seat 9: R1aki folded before Flop (didn't bet)





PokerStars Hand #154364746957:  Hold'em No Limit ($0.50/$1.00 USD) - 2016/06/06 13:47:46 CET [2016/06/06 7:47:46 ET]
Table 'Chaldaea II' 9-max Seat #9 is the button
Seat 1: gabi_igna ($100 in chips) 
Seat 2: Mr.Grigoriy ($101 in chips) 
Seat 4: mooose100 ($86.79 in chips) 
Seat 5: stds st ($33.35 in chips) 
Seat 6: PacPacBum ($107.86 in chips) 
Seat 7: xxxibgdrgn ($139.73 in chips) 
Seat 9: matiko09 ($110.16 in chips) 
gabi_igna: posts small blind $0.50
Mr.Grigoriy: posts big blind $1
hammerwife: sits out 
xxxZeka: sits out 
*** HOLE CARDS ***
Dealt to matiko09 [5d Ad]
mooose100 has timed out
mooose100: folds 
stds st: folds 
PacPacBum: folds 
xxxibgdrgn: folds 
matiko09: raises $1.27 to $2.27
gabi_igna: folds 
Mr.Grigoriy: raises $6.23 to $8.50
matiko09: folds 
Uncalled bet ($6.23) returned to Mr.Grigoriy
Mr.Grigoriy collected $5.04 from pot
Mr.Grigoriy: doesn't show hand 
*** SUMMARY ***
Total pot $5.04 | Rake $0 
Seat 1: gabi_igna (small blind) folded before Flop
Seat 2: Mr.Grigoriy (big blind) collected ($5.04)
Seat 4: mooose100 folded before Flop (didn't bet)
Seat 5: stds st folded before Flop (didn't bet)
Seat 6: PacPacBum folded before Flop (didn't bet)
Seat 7: xxxibgdrgn folded before Flop (didn't bet)
Seat 9: matiko09 (button) folded before Flop





PokerStars Hand #154364748017:  Hold'em No Limit (€0.50/€1.00 EUR) - 2016/06/06 13:47:48 CET [2016/06/06 7:47:48 ET]
Table 'Lesath' 9-max Seat #9 is the button
Seat 1: o.miro (€195.95 in chips) 
Seat 2: thecurv (€109.34 in chips) 
Seat 5: matiko09 (€185.22 in chips) 
Seat 6: Dickyxxx (€106.72 in chips) 
Seat 7: Mr.Grigoriy (€100 in chips) 
Seat 8: vanilica (€100 in chips) 
Seat 9: 72nloses (€66.31 in chips) 
o.miro: posts small blind €0.50
thecurv: posts big blind €1
hurtNCYDE: sits out 
hammerwife: sits out 
*** HOLE CARDS ***
Dealt to matiko09 [Qd 3h]
matiko09: folds 
Dickyxxx: folds 
Mr.Grigoriy: folds 
vanilica: folds 
72nloses: folds 
o.miro: folds 
Uncalled bet (€0.50) returned to thecurv
thecurv collected €1 from pot
thecurv: doesn't show hand 
*** SUMMARY ***
Total pot €1 | Rake €0 
Seat 1: o.miro (small blind) folded before Flop
Seat 2: thecurv (big blind) collected (€1)
Seat 5: matiko09 folded before Flop (didn't bet)
Seat 6: Dickyxxx folded before Flop (didn't bet)
Seat 7: Mr.Grigoriy folded before Flop (didn't bet)
Seat 8: vanilica folded before Flop (didn't bet)
Seat 9: 72nloses (button) folded before Flop (didn't bet)





PokerStars Hand #154364753023:  Hold'em No Limit ($0.50/$1.00 USD) - 2016/06/06 13:47:59 CET [2016/06/06 7:47:59 ET]
Table 'Heze' 9-max Seat #1 is the button
Seat 1: matiko09 ($198.16 in chips) 
Seat 3: Dickyxxx ($100.50 in chips) 
Seat 5: stds st ($34 in chips) 
Seat 8: PacPacBum ($125.24 in chips) 
Dickyxxx: posts small blind $0.50
stds st: posts big blind $1
*** HOLE CARDS ***
Dealt to matiko09 [7s 6d]
PacPacBum: folds 
matiko09: folds 
Dickyxxx: folds 
Uncalled bet ($0.50) returned to stds st
stds st collected $1 from pot
stds st: doesn't show hand 
*** SUMMARY ***
Total pot $1 | Rake $0 
Seat 1: matiko09 (button) folded before Flop (didn't bet)
Seat 3: Dickyxxx (small blind) folded before Flop
Seat 5: stds st (big blind) collected ($1)
Seat 8: PacPacBum folded before Flop (didn't bet)





PokerStars Hand #154364753971:  Hold'em No Limit ($0.50/$1.00 USD) - 2016/06/06 13:48:01 CET [2016/06/06 7:48:01 ET]
Table 'Siegma' 9-max Seat #1 is the button
Seat 1: Mr.Grigoriy ($100 in chips) 
Seat 2: hammerwife ($146.15 in chips) 
Seat 3: vanilica ($101.50 in chips) 
Seat 5: arctur17 ($98.50 in chips) 
Seat 6: stds st ($58.23 in chips) 
Seat 7: nviss ($33.61 in chips) 
Seat 8: hurtNCYDE ($103 in chips) 
Seat 9: matiko09 ($100 in chips) 
hammerwife: posts small blind $0.50
vanilica: posts big blind $1
Dantist1122: sits out 
*** HOLE CARDS ***
Dealt to matiko09 [8s Ks]
arctur17: folds 
stds st: folds 
nviss: folds 
hurtNCYDE: folds 
matiko09: raises $1.50 to $2.50
Mr.Grigoriy: folds 
hammerwife: folds 
vanilica: folds 
Uncalled bet ($1.50) returned to matiko09
matiko09 collected $2.50 from pot
matiko09: doesn't show hand 
*** SUMMARY ***
Total pot $2.50 | Rake $0 
Seat 1: Mr.Grigoriy (button) folded before Flop (didn't bet)
Seat 2: hammerwife (small blind) folded before Flop
Seat 3: vanilica (big blind) folded before Flop
Seat 5: arctur17 folded before Flop (didn't bet)
Seat 6: stds st folded before Flop (didn't bet)
Seat 7: nviss folded before Flop (didn't bet)
Seat 8: hurtNCYDE folded before Flop (didn't bet)
Seat 9: matiko09 collected ($2.50)





PokerStars Hand #154364757515:  Hold'em No Limit ($0.50/$1.00 USD) - 2016/06/06 13:48:09 CET [2016/06/06 7:48:09 ET]
Table 'Williams' 9-max Seat #3 is the button
Seat 1: xhinostrabli ($71.92 in chips) 
Seat 2: matiko09 ($175.69 in chips) 
Seat 3: gabi_igna ($100 in chips) 
Seat 4: Mr.Grigoriy ($107.82 in chips) 
Seat 5: xxxibgdrgn ($105 in chips) 
Seat 6: xxxZeka ($193.75 in chips) 
Seat 7: Eskimo Fox ($122.51 in chips) 
Seat 8: Dickyxxx ($101.50 in chips) 
Seat 9: stds st ($63.26 in chips) 
Mr.Grigoriy: posts small blind $0.50
xxxibgdrgn: posts big blind $1
*** HOLE CARDS ***
Dealt to matiko09 [7h 3d]
xxxZeka: folds 
Eskimo Fox: folds 
Dickyxxx: folds 
stds st: folds 
xhinostrabli: raises $1 to $2
matiko09: folds 
gabi_igna: folds 
Mr.Grigoriy: folds 
xxxibgdrgn: folds 
Uncalled bet ($1) returned to xhinostrabli
xhinostrabli collected $2.50 from pot
*** SUMMARY ***
Total pot $2.50 | Rake $0 
Seat 1: xhinostrabli collected ($2.50)
Seat 2: matiko09 folded before Flop (didn't bet)
Seat 3: gabi_igna (button) folded before Flop (didn't bet)
Seat 4: Mr.Grigoriy (small blind) folded before Flop
Seat 5: xxxibgdrgn (big blind) folded before Flop
Seat 6: xxxZeka folded before Flop (didn't bet)
Seat 7: Eskimo Fox folded before Flop (didn't bet)
Seat 8: Dickyxxx folded before Flop (didn't bet)
Seat 9: stds st folded before Flop (didn't bet)





PokerStars Hand #154364758093:  Hold'em No Limit ($0.50/$1.00 USD) - 2016/06/06 13:48:10 CET [2016/06/06 7:48:10 ET]
Table 'Wezen II' 9-max Seat #5 is the button
Seat 1: matiko09 ($101.50 in chips) 
Seat 2: Mr.Grigoriy ($114.34 in chips) 
Seat 3: Dickyxxx ($105.62 in chips) 
Seat 4: xxxibgdrgn ($212.85 in chips) 
Seat 5: stds st ($31.05 in chips) 
Seat 6: Eskimo Fox ($100.50 in chips) 
Seat 9: Cogss ($173.90 in chips) 
Eskimo Fox: posts small blind $0.50
o.miro: is sitting out 
Cogss: posts big blind $1
*** HOLE CARDS ***
Dealt to matiko09 [7h 7d]
o.miro leaves the table
hurtNCYDE joins the table at seat #8 
hurtNCYDE leaves the table
hammerwife joins the table at seat #8 
matiko09: raises $2 to $3
Mr.Grigoriy: folds 
Dickyxxx: folds 
xxxibgdrgn: folds 
stds st: folds 
Eskimo Fox: folds 
Cogss: folds 
Uncalled bet ($2) returned to matiko09
matiko09 collected $2.50 from pot
matiko09: doesn't show hand 
*** SUMMARY ***
Total pot $2.50 | Rake $0 
Seat 1: matiko09 collected ($2.50)
Seat 2: Mr.Grigoriy folded before Flop (didn't bet)
Seat 3: Dickyxxx folded before Flop (didn't bet)
Seat 4: xxxibgdrgn folded before Flop (didn't bet)
Seat 5: stds st (button) folded before Flop (didn't bet)
Seat 6: Eskimo Fox (small blind) folded before Flop
Seat 9: Cogss (big blind) folded before Flop





PokerStars Hand #154364758411:  Hold'em No Limit ($0.50/$1.00 USD) - 2016/06/06 13:48:11 CET [2016/06/06 7:48:11 ET]
Table 'Heze' 9-max Seat #3 is the button
Seat 1: matiko09 ($198.16 in chips) 
Seat 3: Dickyxxx ($100 in chips) 
Seat 5: stds st ($34.50 in chips) 
Seat 8: PacPacBum ($125.24 in chips) 
stds st: posts small blind $0.50
PacPacBum: posts big blind $1
*** HOLE CARDS ***
Dealt to matiko09 [9s 9d]
matiko09: raises $1.50 to $2.50
gabi_igna joins the table at seat #2 
Dickyxxx: folds 
Mr.Grigoriy leaves the table
stepan0605 joins the table at seat #9 
stds st: raises $4 to $6.50
PacPacBum: folds 
matiko09: raises $6.50 to $13
stds st: calls $6.50
*** FLOP *** [Th 8h 2h]
stds st: checks 
matiko09: bets $23
hurtNCYDE joins the table at seat #4 
hurtNCYDE leaves the table
stds st: folds 
Uncalled bet ($23) returned to matiko09
stepan0605 leaves the table
matiko09 collected $26 from pot
matiko09: doesn't show hand 
*** SUMMARY ***
Total pot $27 | Rake $1 
Board [Th 8h 2h]
Seat 1: matiko09 collected ($26)
Seat 3: Dickyxxx (button) folded before Flop (didn't bet)
Seat 5: stds st (small blind) folded on the Flop
Seat 8: PacPacBum (big blind) folded before Flop





PokerStars Hand #154364767022:  Hold'em No Limit (€0.50/€1.00 EUR) - 2016/06/06 13:48:30 CET [2016/06/06 7:48:30 ET]
Table 'Lesath' 9-max Seat #1 is the button
Seat 1: o.miro (€195.45 in chips) 
Seat 2: thecurv (€109.84 in chips) 
Seat 3: hurtNCYDE (€100 in chips) 
Seat 5: matiko09 (€185.22 in chips) 
Seat 6: Dickyxxx (€106.72 in chips) 
Seat 7: Mr.Grigoriy (€100 in chips) 
Seat 8: vanilica (€100 in chips) 
Seat 9: 72nloses (€66.31 in chips) 
thecurv: posts small blind €0.50
hurtNCYDE: posts big blind €1
hammerwife: sits out 
*** HOLE CARDS ***
Dealt to matiko09 [8s 3d]
matiko09: folds 
Dickyxxx: folds 
Mr.Grigoriy: folds 
vanilica: folds 
72nloses: raises €2.50 to €3.50
o.miro: folds 
thecurv: folds 
hurtNCYDE: folds 
Uncalled bet (€2.50) returned to 72nloses
72nloses collected €2.50 from pot
*** SUMMARY ***
Total pot €2.50 | Rake €0 
Seat 1: o.miro (button) folded before Flop (didn't bet)
Seat 2: thecurv (small blind) folded before Flop
Seat 3: hurtNCYDE (big blind) folded before Flop
Seat 5: matiko09 folded before Flop (didn't bet)
Seat 6: Dickyxxx folded before Flop (didn't bet)
Seat 7: Mr.Grigoriy folded before Flop (didn't bet)
Seat 8: vanilica folded before Flop (didn't bet)
Seat 9: 72nloses collected (€2.50)





PokerStars Hand #154364767205:  Hold'em No Limit ($0.50/$1.00 USD) - 2016/06/06 13:48:31 CET [2016/06/06 7:48:31 ET]
Table 'Siegma' 9-max Seat #2 is the button
Seat 1: Mr.Grigoriy ($100 in chips) 
Seat 2: hammerwife ($145.65 in chips) 
Seat 3: vanilica ($100.50 in chips) 
Seat 4: Dantist1122 ($100 in chips) 
Seat 5: arctur17 ($98.50 in chips) 
Seat 6: stds st ($58.23 in chips) 
Seat 7: nviss ($33.61 in chips) 
Seat 8: hurtNCYDE ($103 in chips) 
Seat 9: matiko09 ($101.50 in chips) 
vanilica: posts small blind $0.50
Dantist1122: posts big blind $1
*** HOLE CARDS ***
Dealt to matiko09 [2c 6d]
arctur17: folds 
stds st: folds 
nviss: folds 
hurtNCYDE: folds 
matiko09: folds 
Mr.Grigoriy: raises $1.50 to $2.50
hammerwife: raises $6 to $8.50
vanilica: folds 
Dantist1122: folds 
Mr.Grigoriy: folds 
Uncalled bet ($6) returned to hammerwife
hammerwife collected $6.50 from pot
hammerwife: doesn't show hand 
*** SUMMARY ***
Total pot $6.50 | Rake $0 
Seat 1: Mr.Grigoriy folded before Flop
Seat 2: hammerwife (button) collected ($6.50)
Seat 3: vanilica (small blind) folded before Flop
Seat 4: Dantist1122 (big blind) folded before Flop
Seat 5: arctur17 folded before Flop (didn't bet)
Seat 6: stds st folded before Flop (didn't bet)
Seat 7: nviss folded before Flop (didn't bet)
Seat 8: hurtNCYDE folded before Flop (didn't bet)
Seat 9: matiko09 folded before Flop (didn't bet)





PokerStars Hand #154364771391:  Hold'em No Limit ($0.50/$1.00 USD) - 2016/06/06 13:48:40 CET [2016/06/06 7:48:40 ET]
Table 'Williams' 9-max Seat #4 is the button
Seat 1: xhinostrabli ($73.42 in chips) 
Seat 2: matiko09 ($175.69 in chips) 
Seat 3: gabi_igna ($100 in chips) 
Seat 4: Mr.Grigoriy ($107.32 in chips) 
Seat 5: xxxibgdrgn ($104 in chips) 
Seat 6: xxxZeka ($193.75 in chips) 
Seat 7: Eskimo Fox ($122.51 in chips) 
Seat 8: Dickyxxx ($101.50 in chips) 
Seat 9: stds st ($63.26 in chips) 
xxxibgdrgn: posts small blind $0.50
xxxZeka: posts big blind $1
*** HOLE CARDS ***
Dealt to matiko09 [Ac 7c]
Eskimo Fox: folds 
Dickyxxx: folds 
Eskimo Fox leaves the table
stds st: raises $1.50 to $2.50
hurtNCYDE joins the table at seat #7 
hurtNCYDE leaves the table
stepan0605 joins the table at seat #7 
xhinostrabli: folds 
matiko09: folds 
gabi_igna: calls $2.50
Mr.Grigoriy: folds 
xxxibgdrgn: folds 
xxxZeka: folds 
*** FLOP *** [6d Ks 2s]
stds st: bets $4
gabi_igna: folds 
Uncalled bet ($4) returned to stds st
stds st collected $6.18 from pot
stds st: doesn't show hand 
*** SUMMARY ***
Total pot $6.50 | Rake $0.32 
Board [6d Ks 2s]
Seat 1: xhinostrabli folded before Flop (didn't bet)
Seat 2: matiko09 folded before Flop (didn't bet)
Seat 3: gabi_igna folded on the Flop
Seat 4: Mr.Grigoriy (button) folded before Flop (didn't bet)
Seat 5: xxxibgdrgn (small blind) folded before Flop
Seat 6: xxxZeka (big blind) folded before Flop
Seat 7: Eskimo Fox folded before Flop (didn't bet)
Seat 8: Dickyxxx folded before Flop (didn't bet)
Seat 9: stds st collected ($6.18)





PokerStars Hand #154364771251:  Hold'em No Limit ($0.50/$1.00 USD) - 2016/06/06 13:48:40 CET [2016/06/06 7:48:40 ET]
Table 'Safara' 9-max Seat #3 is the button
Seat 1: Dickyxxx ($100.88 in chips) 
Seat 2: Dantist1122 ($100 in chips) 
Seat 3: erd33 ($165.15 in chips) 
Seat 4: stds st ($39 in chips) 
Seat 5: perezzi10 ($91.38 in chips) 
Seat 6: matiko09 ($133.78 in chips) 
Seat 7: PacPacBum ($117.49 in chips) 
Seat 8: o.miro ($182.99 in chips) 
Seat 9: R1aki ($109 in chips) 
stds st: posts small blind $0.50
perezzi10: posts big blind $1
*** HOLE CARDS ***
Dealt to matiko09 [Tc Kc]
matiko09: raises $2 to $3
PacPacBum: folds 
o.miro: folds 
R1aki: folds 
Dickyxxx: folds 
Dantist1122: folds 
erd33: calls $3
stds st: folds 
perezzi10: calls $2
*** FLOP *** [9c Kh 6d]
perezzi10: checks 
matiko09: bets $5
erd33: calls $5
perezzi10: folds 
*** TURN *** [9c Kh 6d] [Jd]
matiko09: checks 
erd33: bets $10
matiko09: calls $10
*** RIVER *** [9c Kh 6d Jd] [3d]
matiko09: checks 
erd33: checks 
*** SHOW DOWN ***
matiko09: shows [Tc Kc] (a pair of Kings)
erd33: shows [9s 9d] (three of a kind, Nines)
erd33 collected $37.52 from pot
*** SUMMARY ***
Total pot $39.50 | Rake $1.98 
Board [9c Kh 6d Jd 3d]
Seat 1: Dickyxxx folded before Flop (didn't bet)
Seat 2: Dantist1122 folded before Flop (didn't bet)
Seat 3: erd33 (button) showed [9s 9d] and won ($37.52) with three of a kind, Nines
Seat 4: stds st (small blind) folded before Flop
Seat 5: perezzi10 (big blind) folded on the Flop
Seat 6: matiko09 showed [Tc Kc] and lost with a pair of Kings
Seat 7: PacPacBum folded before Flop (didn't bet)
Seat 8: o.miro folded before Flop (didn't bet)
Seat 9: R1aki folded before Flop (didn't bet)





PokerStars Hand #154364773535:  Hold'em No Limit ($0.50/$1.00 USD) - 2016/06/06 13:48:45 CET [2016/06/06 7:48:45 ET]
Table 'Chaldaea II' 9-max Seat #1 is the button
Seat 1: gabi_igna ($100 in chips) 
Seat 2: Mr.Grigoriy ($103.77 in chips) 
Seat 3: hammerwife ($100 in chips) 
Seat 4: mooose100 ($86.79 in chips) 
Seat 5: stds st ($33.35 in chips) 
Seat 6: PacPacBum ($107.86 in chips) 
Seat 7: xxxibgdrgn ($139.73 in chips) 
Seat 9: matiko09 ($107.89 in chips) 
Mr.Grigoriy: posts small blind $0.50
hammerwife: posts big blind $1
xxxZeka: sits out 
*** HOLE CARDS ***
Dealt to matiko09 [Js 7c]
mooose100 has timed out
mooose100: folds 
stds st: folds 
PacPacBum: folds 
xxxibgdrgn: folds 
matiko09: folds 
gabi_igna: raises $1.50 to $2.50
Mr.Grigoriy: folds 
hammerwife: folds 
Uncalled bet ($1.50) returned to gabi_igna
gabi_igna collected $2.50 from pot
gabi_igna: doesn't show hand 
*** SUMMARY ***
Total pot $2.50 | Rake $0 
Seat 1: gabi_igna (button) collected ($2.50)
Seat 2: Mr.Grigoriy (small blind) folded before Flop
Seat 3: hammerwife (big blind) folded before Flop
Seat 4: mooose100 folded before Flop (didn't bet)
Seat 5: stds st folded before Flop (didn't bet)
Seat 6: PacPacBum folded before Flop (didn't bet)
Seat 7: xxxibgdrgn folded before Flop (didn't bet)
Seat 9: matiko09 folded before Flop (didn't bet)





PokerStars Hand #154364775647:  Hold'em No Limit ($0.50/$1.00 USD) - 2016/06/06 13:48:50 CET [2016/06/06 7:48:50 ET]
Table 'Wezen II' 9-max Seat #6 is the button
Seat 1: matiko09 ($103 in chips) 
Seat 2: Mr.Grigoriy ($114.34 in chips) 
Seat 3: Dickyxxx ($105.62 in chips) 
Seat 4: xxxibgdrgn ($212.85 in chips) 
Seat 5: stds st ($31.05 in chips) 
Seat 6: Eskimo Fox ($100 in chips) 
Seat 9: Cogss ($172.90 in chips) 
hammerwife will be allowed to play after the button
Cogss: posts small blind $0.50
matiko09: posts big blind $1
*** HOLE CARDS ***
Dealt to matiko09 [2c 7h]
Mr.Grigoriy: folds 
Dickyxxx: folds 
xxxibgdrgn: folds 
stds st: folds 
Eskimo Fox: raises $1.50 to $2.50
Cogss: folds 
matiko09: folds 
Uncalled bet ($1.50) returned to Eskimo Fox
Eskimo Fox collected $2.50 from pot
Eskimo Fox: doesn't show hand 
*** SUMMARY ***
Total pot $2.50 | Rake $0 
Seat 1: matiko09 (big blind) folded before Flop
Seat 2: Mr.Grigoriy folded before Flop (didn't bet)
Seat 3: Dickyxxx folded before Flop (didn't bet)
Seat 4: xxxibgdrgn folded before Flop (didn't bet)
Seat 5: stds st folded before Flop (didn't bet)
Seat 6: Eskimo Fox (button) collected ($2.50)
Seat 9: Cogss (small blind) folded before Flop





PokerStars Hand #154364780505:  Hold'em No Limit (€0.50/€1.00 EUR) - 2016/06/06 13:49:00 CET [2016/06/06 7:49:00 ET]
Table 'Lesath' 9-max Seat #2 is the button
Seat 1: o.miro (€195.45 in chips) 
Seat 2: thecurv (€109.34 in chips) 
Seat 3: hurtNCYDE (€100 in chips) 
Seat 4: hammerwife (€124.61 in chips) 
Seat 5: matiko09 (€185.22 in chips) 
Seat 6: Dickyxxx (€106.72 in chips) 
Seat 7: Mr.Grigoriy (€100 in chips) 
Seat 8: vanilica (€100 in chips) 
Seat 9: 72nloses (€67.81 in chips) 
hurtNCYDE: posts small blind €0.50
hammerwife: posts big blind €1
*** HOLE CARDS ***
Dealt to matiko09 [5s 9s]
matiko09: folds 
Dickyxxx: folds 
Mr.Grigoriy: folds 
vanilica: raises €1.50 to €2.50
72nloses: folds 
o.miro: folds 
thecurv: folds 
hurtNCYDE: folds 
hammerwife: calls €1.50
*** FLOP *** [6c Js 4c]
hammerwife: checks 
vanilica: checks 
*** TURN *** [6c Js 4c] [7c]
hammerwife: checks 
vanilica: bets €3.13
hammerwife: raises €8.87 to €12
vanilica: folds 
Uncalled bet (€8.87) returned to hammerwife
hammerwife collected €11.17 from pot
hammerwife: doesn't show hand 
*** SUMMARY ***
Total pot €11.76 | Rake €0.59 
Board [6c Js 4c 7c]
Seat 1: o.miro folded before Flop (didn't bet)
Seat 2: thecurv (button) folded before Flop (didn't bet)
Seat 3: hurtNCYDE (small blind) folded before Flop
Seat 4: hammerwife (big blind) collected (€11.17)
Seat 5: matiko09 folded before Flop (didn't bet)
Seat 6: Dickyxxx folded before Flop (didn't bet)
Seat 7: Mr.Grigoriy folded before Flop (didn't bet)
Seat 8: vanilica folded on the Turn
Seat 9: 72nloses folded before Flop (didn't bet)





PokerStars Hand #154364780657:  Hold'em No Limit ($0.50/$1.00 USD) - 2016/06/06 13:49:01 CET [2016/06/06 7:49:01 ET]
Table 'Smither' 9-max Seat #3 is the button
Seat 1: PacPacBum ($185.02 in chips) 
Seat 2: matiko09 ($142.62 in chips) 
Seat 3: stds st ($38.54 in chips) 
Seat 4: Mr.Grigoriy ($145.27 in chips) 
Seat 5: Dickyxxx ($100 in chips) 
Seat 6: mooose100 ($63.93 in chips) 
Seat 7: vanilica ($135.64 in chips) 
Seat 9: hammerwife ($119.75 in chips) 
Mr.Grigoriy: posts small blind $0.50
Dickyxxx: posts big blind $1
ipashutapkom: sits out 
*** HOLE CARDS ***
Dealt to matiko09 [Kh 9c]
mooose100: folds 
vanilica: raises $1.85 to $2.85
hammerwife: folds 
PacPacBum: folds 
matiko09: folds 
stds st: folds 
Mr.Grigoriy: folds 
Dickyxxx: folds 
Uncalled bet ($1.85) returned to vanilica
vanilica collected $2.50 from pot
vanilica: doesn't show hand 
*** SUMMARY ***
Total pot $2.50 | Rake $0 
Seat 1: PacPacBum folded before Flop (didn't bet)
Seat 2: matiko09 folded before Flop (didn't bet)
Seat 3: stds st (button) folded before Flop (didn't bet)
Seat 4: Mr.Grigoriy (small blind) folded before Flop
Seat 5: Dickyxxx (big blind) folded before Flop
Seat 6: mooose100 folded before Flop (didn't bet)
Seat 7: vanilica collected ($2.50)
Seat 9: hammerwife folded before Flop (didn't bet)





PokerStars Hand #154364787410:  Hold'em No Limit ($0.50/$1.00 USD) - 2016/06/06 13:49:16 CET [2016/06/06 7:49:16 ET]
Table 'Yarilo' 9-max Seat #3 is the button
Seat 1: xxxZeka ($100 in chips) 
Seat 2: matiko09 ($100 in chips) 
Seat 3: TBEinc ($100.78 in chips) 
Seat 4: stds st ($36.84 in chips) 
Seat 5: Dantist1122 ($116.88 in chips) 
Seat 7: Dickyxxx ($184.24 in chips) 
Seat 8: hammerwife ($100 in chips) 
Seat 9: vanilica ($112.82 in chips) 
stds st: posts small blind $0.50
Dantist1122: posts big blind $1
gabi_igna: sits out 
*** HOLE CARDS ***
Dealt to matiko09 [9d 4d]
Dickyxxx: folds 
hammerwife: folds 
vanilica: folds 
xxxZeka: folds 
matiko09: folds 
TBEinc: folds 
stds st: folds 
Uncalled bet ($0.50) returned to Dantist1122
Dantist1122 collected $1 from pot
Dantist1122: doesn't show hand 
*** SUMMARY ***
Total pot $1 | Rake $0 
Seat 1: xxxZeka folded before Flop (didn't bet)
Seat 2: matiko09 folded before Flop (didn't bet)
Seat 3: TBEinc (button) folded before Flop (didn't bet)
Seat 4: stds st (small blind) folded before Flop
Seat 5: Dantist1122 (big blind) collected ($1)
Seat 7: Dickyxxx folded before Flop (didn't bet)
Seat 8: hammerwife folded before Flop (didn't bet)
Seat 9: vanilica folded before Flop (didn't bet)





PokerStars Hand #154364791094:  Hold'em No Limit ($0.50/$1.00 USD) - 2016/06/06 13:49:24 CET [2016/06/06 7:49:24 ET]
Table 'Wezen II' 9-max Seat #9 is the button
Seat 1: matiko09 ($102 in chips) 
Seat 2: Mr.Grigoriy ($114.34 in chips) 
Seat 3: Dickyxxx ($105.62 in chips) 
Seat 4: xxxibgdrgn ($212.85 in chips) 
Seat 5: stds st ($31.05 in chips) 
Seat 6: Eskimo Fox ($101.50 in chips) 
Seat 8: hammerwife ($100 in chips) 
Seat 9: Cogss ($172.40 in chips) 
matiko09: posts small blind $0.50
Mr.Grigoriy: posts big blind $1
hammerwife: posts big blind $1
*** HOLE CARDS ***
Dealt to matiko09 [2d Ks]
Dickyxxx: folds 
xxxibgdrgn: raises $3 to $4
stds st: folds 
Eskimo Fox: folds 
hammerwife: folds 
Cogss: folds 
matiko09: folds 
Mr.Grigoriy: folds 
Uncalled bet ($3) returned to xxxibgdrgn
xxxibgdrgn collected $3.50 from pot
xxxibgdrgn: doesn't show hand 
*** SUMMARY ***
Total pot $3.50 | Rake $0 
Seat 1: matiko09 (small blind) folded before Flop
Seat 2: Mr.Grigoriy (big blind) folded before Flop
Seat 3: Dickyxxx folded before Flop (didn't bet)
Seat 4: xxxibgdrgn collected ($3.50)
Seat 5: stds st folded before Flop (didn't bet)
Seat 6: Eskimo Fox folded before Flop (didn't bet)
Seat 8: hammerwife folded before Flop
Seat 9: Cogss (button) folded before Flop (didn't bet)





PokerStars Hand #154364792869:  Hold'em No Limit ($0.50/$1.00 USD) - 2016/06/06 13:49:28 CET [2016/06/06 7:49:28 ET]
Table 'Siegma' 9-max Seat #3 is the button
Seat 1: Mr.Grigoriy ($100 in chips) 
Seat 2: hammerwife ($149.65 in chips) 
Seat 3: vanilica ($100 in chips) 
Seat 4: Dantist1122 ($100 in chips) 
Seat 5: arctur17 ($98.50 in chips) 
Seat 6: stds st ($58.23 in chips) 
Seat 7: nviss ($33.61 in chips) 
Seat 8: hurtNCYDE ($103 in chips) 
Seat 9: matiko09 ($101.50 in chips) 
Dantist1122: posts small blind $0.50
arctur17: posts big blind $1
*** HOLE CARDS ***
Dealt to matiko09 [9d 8h]
stds st: folds 
nviss: folds 
hurtNCYDE: folds 
matiko09: folds 
Mr.Grigoriy: folds 
hammerwife: folds 
vanilica: folds 
Dantist1122: raises $1.05 to $2.05
arctur17: folds 
Uncalled bet ($1.05) returned to Dantist1122
Dantist1122 collected $2 from pot
Dantist1122: doesn't show hand 
*** SUMMARY ***
Total pot $2 | Rake $0 
Seat 1: Mr.Grigoriy folded before Flop (didn't bet)
Seat 2: hammerwife folded before Flop (didn't bet)
Seat 3: vanilica (button) folded before Flop (didn't bet)
Seat 4: Dantist1122 (small blind) collected ($2)
Seat 5: arctur17 (big blind) folded before Flop
Seat 6: stds st folded before Flop (didn't bet)
Seat 7: nviss folded before Flop (didn't bet)
Seat 8: hurtNCYDE folded before Flop (didn't bet)
Seat 9: matiko09 folded before Flop (didn't bet)





PokerStars Hand #154364794766:  Hold'em No Limit ($0.50/$1.00 USD) - 2016/06/06 13:49:32 CET [2016/06/06 7:49:32 ET]
Table 'Smither' 9-max Seat #4 is the button
Seat 1: PacPacBum ($185.02 in chips) 
Seat 2: matiko09 ($142.62 in chips) 
Seat 3: stds st ($38.54 in chips) 
Seat 4: Mr.Grigoriy ($144.77 in chips) 
Seat 5: Dickyxxx ($100 in chips) 
Seat 6: mooose100 ($63.93 in chips) 
Seat 7: vanilica ($137.14 in chips) 
Seat 9: hammerwife ($119.75 in chips) 
Dickyxxx: posts small blind $0.50
mooose100: posts big blind $1
ipashutapkom: sits out 
*** HOLE CARDS ***
Dealt to matiko09 [8h 3h]
vanilica: folds 
hammerwife: raises $2 to $3
PacPacBum: folds 
matiko09: folds 
stds st: raises $4.50 to $7.50
Mr.Grigoriy: folds 
Dickyxxx: folds 
mooose100: folds 
hammerwife: folds 
Uncalled bet ($4.50) returned to stds st
stds st collected $7.50 from pot
stds st: doesn't show hand 
*** SUMMARY ***
Total pot $7.50 | Rake $0 
Seat 1: PacPacBum folded before Flop (didn't bet)
Seat 2: matiko09 folded before Flop (didn't bet)
Seat 3: stds st collected ($7.50)
Seat 4: Mr.Grigoriy (button) folded before Flop (didn't bet)
Seat 5: Dickyxxx (small blind) folded before Flop
Seat 6: mooose100 (big blind) folded before Flop
Seat 7: vanilica folded before Flop (didn't bet)
Seat 9: hammerwife folded before Flop





PokerStars Hand #154364795784:  Hold'em No Limit ($0.50/$1.00 USD) - 2016/06/06 13:49:34 CET [2016/06/06 7:49:34 ET]
Table 'Chaldaea II' 9-max Seat #2 is the button
Seat 1: gabi_igna ($101.50 in chips) 
Seat 2: Mr.Grigoriy ($103.27 in chips) 
Seat 3: hammerwife ($100 in chips) 
Seat 5: stds st ($33.35 in chips) 
Seat 6: PacPacBum ($107.86 in chips) 
Seat 7: xxxibgdrgn ($139.73 in chips) 
Seat 9: matiko09 ($107.89 in chips) 
hammerwife: posts small blind $0.50
stds st: posts big blind $1
xxxZeka: sits out 
*** HOLE CARDS ***
Dealt to matiko09 [7s Jh]
PacPacBum: folds 
xxxibgdrgn: folds 
matiko09: folds 
gabi_igna: raises $1.50 to $2.50
Mr.Grigoriy: folds 
hammerwife: folds 
stds st: folds 
Uncalled bet ($1.50) returned to gabi_igna
gabi_igna collected $2.50 from pot
gabi_igna: doesn't show hand 
*** SUMMARY ***
Total pot $2.50 | Rake $0 
Seat 1: gabi_igna collected ($2.50)
Seat 2: Mr.Grigoriy (button) folded before Flop (didn't bet)
Seat 3: hammerwife (small blind) folded before Flop
Seat 5: stds st (big blind) folded before Flop
Seat 6: PacPacBum folded before Flop (didn't bet)
Seat 7: xxxibgdrgn folded before Flop (didn't bet)
Seat 9: matiko09 folded before Flop (didn't bet)





PokerStars Hand #154364795544:  Hold'em No Limit ($0.50/$1.00 USD) - 2016/06/06 13:49:34 CET [2016/06/06 7:49:34 ET]
Table 'Heze' 9-max Seat #5 is the button
Seat 1: matiko09 ($211.16 in chips) 
Seat 3: Dickyxxx ($100 in chips) 
Seat 5: stds st ($40 in chips) 
Seat 8: PacPacBum ($124.24 in chips) 
PacPacBum: posts small blind $0.50
matiko09: posts big blind $1
R1aki joins the table at seat #9 
gabi_igna: sits out 
*** HOLE CARDS ***
Dealt to matiko09 [5c 4s]
Dickyxxx: folds 
rlukkk joins the table at seat #4 
stds st: folds 
PacPacBum: raises $1.04 to $2.04
matiko09: folds 
Uncalled bet ($1.04) returned to PacPacBum
PacPacBum collected $2 from pot
PacPacBum: doesn't show hand 
*** SUMMARY ***
Total pot $2 | Rake $0 
Seat 1: matiko09 (big blind) folded before Flop
Seat 3: Dickyxxx folded before Flop (didn't bet)
Seat 5: stds st (button) folded before Flop (didn't bet)
Seat 8: PacPacBum (small blind) collected ($2)





PokerStars Hand #154364798959:  Hold'em No Limit ($0.50/$1.00 USD) - 2016/06/06 13:49:41 CET [2016/06/06 7:49:41 ET]
Table 'Yarilo' 9-max Seat #4 is the button
Seat 1: xxxZeka ($100 in chips) 
Seat 2: matiko09 ($100 in chips) 
Seat 3: TBEinc ($100.78 in chips) 
Seat 4: stds st ($36.34 in chips) 
Seat 5: Dantist1122 ($117.38 in chips) 
Seat 6: gabi_igna ($100 in chips) 
Seat 7: Dickyxxx ($184.24 in chips) 
Seat 8: hammerwife ($100 in chips) 
Seat 9: vanilica ($112.82 in chips) 
Dantist1122: posts small blind $0.50
gabi_igna: posts big blind $1
*** HOLE CARDS ***
Dealt to matiko09 [Ts Jc]
Dickyxxx: folds 
hammerwife: folds 
vanilica: raises $1.85 to $2.85
xxxZeka: folds 
matiko09: folds 
TBEinc: calls $2.85
stds st: folds 
Dantist1122: folds 
gabi_igna: folds 
*** FLOP *** [7d Td 9s]
vanilica: bets $5.06
TBEinc: folds 
Uncalled bet ($5.06) returned to vanilica
vanilica collected $6.84 from pot
vanilica: doesn't show hand 
*** SUMMARY ***
Total pot $7.20 | Rake $0.36 
Board [7d Td 9s]
Seat 1: xxxZeka folded before Flop (didn't bet)
Seat 2: matiko09 folded before Flop (didn't bet)
Seat 3: TBEinc folded on the Flop
Seat 4: stds st (button) folded before Flop (didn't bet)
Seat 5: Dantist1122 (small blind) folded before Flop
Seat 6: gabi_igna (big blind) folded before Flop
Seat 7: Dickyxxx folded before Flop (didn't bet)
Seat 8: hammerwife folded before Flop (didn't bet)
Seat 9: vanilica collected ($6.84)





PokerStars Hand #154364801038:  Hold'em No Limit ($0.50/$1.00 USD) - 2016/06/06 13:49:46 CET [2016/06/06 7:49:46 ET]
Table 'Williams' 9-max Seat #5 is the button
Seat 1: xhinostrabli ($73.42 in chips) 
Seat 2: matiko09 ($175.69 in chips) 
Seat 3: gabi_igna ($100 in chips) 
Seat 4: Mr.Grigoriy ($107.32 in chips) 
Seat 5: xxxibgdrgn ($103.50 in chips) 
Seat 6: xxxZeka ($192.75 in chips) 
Seat 7: stepan0605 ($100 in chips) 
Seat 8: Dickyxxx ($101.50 in chips) 
Seat 9: stds st ($66.94 in chips) 
xxxZeka: posts small blind $0.50
stepan0605: posts big blind $1
*** HOLE CARDS ***
Dealt to matiko09 [Td Ac]
Dickyxxx: folds 
stds st: folds 
xhinostrabli: folds 
matiko09: raises $2 to $3
gabi_igna: folds 
Mr.Grigoriy: folds 
xxxibgdrgn: calls $3
xxxZeka: folds 
stepan0605: raises $13 to $16
matiko09: folds 
xxxibgdrgn: folds 
Uncalled bet ($13) returned to stepan0605
stepan0605 collected $9.50 from pot
stepan0605: doesn't show hand 
*** SUMMARY ***
Total pot $9.50 | Rake $0 
Seat 1: xhinostrabli folded before Flop (didn't bet)
Seat 2: matiko09 folded before Flop
Seat 3: gabi_igna folded before Flop (didn't bet)
Seat 4: Mr.Grigoriy folded before Flop (didn't bet)
Seat 5: xxxibgdrgn (button) folded before Flop
Seat 6: xxxZeka (small blind) folded before Flop
Seat 7: stepan0605 (big blind) collected ($9.50)
Seat 8: Dickyxxx folded before Flop (didn't bet)
Seat 9: stds st folded before Flop (didn't bet)





PokerStars Hand #154364801626:  Hold'em No Limit ($0.50/$1.00 USD) - 2016/06/06 13:49:47 CET [2016/06/06 7:49:47 ET]
Table 'Safara' 9-max Seat #4 is the button
Seat 1: Dickyxxx ($100.88 in chips) 
Seat 2: Dantist1122 ($100 in chips) 
Seat 3: erd33 ($184.67 in chips) 
Seat 4: stds st ($38.50 in chips) 
Seat 5: perezzi10 ($88.38 in chips) 
Seat 6: matiko09 ($115.78 in chips) 
Seat 7: PacPacBum ($117.49 in chips) 
Seat 8: o.miro ($182.99 in chips) 
Seat 9: R1aki ($109 in chips) 
perezzi10: posts small blind $0.50
matiko09: posts big blind $1
*** HOLE CARDS ***
Dealt to matiko09 [5s 6c]
PacPacBum: folds 
o.miro: folds 
R1aki: folds 
Dickyxxx: folds 
Dantist1122: raises $2 to $3
erd33: folds 
stds st: raises $4.50 to $7.50
perezzi10: folds 
matiko09: folds 
Dantist1122: folds 
Uncalled bet ($4.50) returned to stds st
stds st collected $7.50 from pot
stds st: doesn't show hand 
*** SUMMARY ***
Total pot $7.50 | Rake $0 
Seat 1: Dickyxxx folded before Flop (didn't bet)
Seat 2: Dantist1122 folded before Flop
Seat 3: erd33 folded before Flop (didn't bet)
Seat 4: stds st (button) collected ($7.50)
Seat 5: perezzi10 (small blind) folded before Flop
Seat 6: matiko09 (big blind) folded before Flop
Seat 7: PacPacBum folded before Flop (didn't bet)
Seat 8: o.miro folded before Flop (didn't bet)
Seat 9: R1aki folded before Flop (didn't bet)





PokerStars Hand #154364805341:  Hold'em No Limit (€0.50/€1.00 EUR) - 2016/06/06 13:49:55 CET [2016/06/06 7:49:55 ET]
Table 'Lesath' 9-max Seat #3 is the button
Seat 1: o.miro (€195.45 in chips) 
Seat 2: thecurv (€109.34 in chips) 
Seat 3: hurtNCYDE (€100 in chips) 
Seat 4: hammerwife (€130.15 in chips) 
Seat 5: matiko09 (€185.22 in chips) 
Seat 6: Dickyxxx (€106.72 in chips) 
Seat 7: Mr.Grigoriy (€100 in chips) 
Seat 8: vanilica (€100 in chips) 
Seat 9: 72nloses (€67.81 in chips) 
hammerwife: posts small blind €0.50
matiko09: posts big blind €1
*** HOLE CARDS ***
Dealt to matiko09 [Kh Qs]
Dickyxxx: folds 
Mr.Grigoriy: folds 
vanilica: folds 
72nloses: raises €3 to €4
o.miro: folds 
thecurv: folds 
hurtNCYDE: folds 
hammerwife: folds 
matiko09: calls €3
*** FLOP *** [6c 8d 5d]
matiko09: checks 
72nloses: checks 
*** TURN *** [6c 8d 5d] [2h]
matiko09: checks 
72nloses: checks 
*** RIVER *** [6c 8d 5d 2h] [Th]
matiko09: checks 
72nloses: checks 
*** SHOW DOWN ***
matiko09: shows [Kh Qs] (high card King)
72nloses: shows [Js Ac] (high card Ace)
72nloses collected €8.08 from pot
*** SUMMARY ***
Total pot €8.50 | Rake €0.42 
Board [6c 8d 5d 2h Th]
Seat 1: o.miro folded before Flop (didn't bet)
Seat 2: thecurv folded before Flop (didn't bet)
Seat 3: hurtNCYDE (button) folded before Flop (didn't bet)
Seat 4: hammerwife (small blind) folded before Flop
Seat 5: matiko09 (big blind) showed [Kh Qs] and lost with high card King
Seat 6: Dickyxxx folded before Flop (didn't bet)
Seat 7: Mr.Grigoriy folded before Flop (didn't bet)
Seat 8: vanilica folded before Flop (didn't bet)
Seat 9: 72nloses showed [Js Ac] and won (€8.08) with high card Ace





PokerStars Hand #154364805868:  Hold'em No Limit ($0.50/$1.00 USD) - 2016/06/06 13:49:57 CET [2016/06/06 7:49:57 ET]
Table 'Heze' 9-max Seat #8 is the button
Seat 1: matiko09 ($210.16 in chips) 
Seat 2: gabi_igna ($100 in chips) 
Seat 3: Dickyxxx ($100 in chips) 
Seat 5: stds st ($40 in chips) 
Seat 8: PacPacBum ($125.24 in chips) 
R1aki will be allowed to play after the button
matiko09: posts small blind $0.50
gabi_igna: posts big blind $1
*** HOLE CARDS ***
Dealt to matiko09 [6h 5h]
rlukkk leaves the table
Dickyxxx: folds 
R1aki leaves the table
stds st: folds 
PacPacBum: raises $1.04 to $2.04
matiko09: raises $6.96 to $9
gabi_igna: folds 
PacPacBum: folds 
Uncalled bet ($6.96) returned to matiko09
matiko09 collected $5.08 from pot
matiko09: doesn't show hand 
*** SUMMARY ***
Total pot $5.08 | Rake $0 
Seat 1: matiko09 (small blind) collected ($5.08)
Seat 2: gabi_igna (big blind) folded before Flop
Seat 3: Dickyxxx folded before Flop (didn't bet)
Seat 5: stds st folded before Flop (didn't bet)
Seat 8: PacPacBum (button) folded before Flop





PokerStars Hand #154364807602:  Hold'em No Limit ($0.50/$1.00 USD) - 2016/06/06 13:50:01 CET [2016/06/06 7:50:01 ET]
Table 'Siegma' 9-max Seat #4 is the button
Seat 1: Mr.Grigoriy ($100 in chips) 
Seat 2: hammerwife ($149.65 in chips) 
Seat 3: vanilica ($100 in chips) 
Seat 4: Dantist1122 ($101 in chips) 
Seat 5: arctur17 ($97.50 in chips) 
Seat 6: stds st ($58.23 in chips) 
Seat 7: nviss ($33.61 in chips) 
Seat 8: hurtNCYDE ($103 in chips) 
Seat 9: matiko09 ($101.50 in chips) 
arctur17: posts small blind $0.50
stds st: posts big blind $1
*** HOLE CARDS ***
Dealt to matiko09 [Ad 7d]
nviss: folds 
hurtNCYDE: folds 
matiko09: folds 
Mr.Grigoriy: folds 
hammerwife: folds 
vanilica: folds 
Dantist1122: raises $1.05 to $2.05
arctur17: folds 
stds st: folds 
Uncalled bet ($1.05) returned to Dantist1122
Dantist1122 collected $2.50 from pot
Dantist1122: doesn't show hand 
*** SUMMARY ***
Total pot $2.50 | Rake $0 
Seat 1: Mr.Grigoriy folded before Flop (didn't bet)
Seat 2: hammerwife folded before Flop (didn't bet)
Seat 3: vanilica folded before Flop (didn't bet)
Seat 4: Dantist1122 (button) collected ($2.50)
Seat 5: arctur17 (small blind) folded before Flop
Seat 6: stds st (big blind) folded before Flop
Seat 7: nviss folded before Flop (didn't bet)
Seat 8: hurtNCYDE folded before Flop (didn't bet)
Seat 9: matiko09 folded before Flop (didn't bet)





PokerStars Hand #154364808802:  Hold'em No Limit ($0.50/$1.00 USD) - 2016/06/06 13:50:03 CET [2016/06/06 7:50:03 ET]
Table 'Chaldaea II' 9-max Seat #3 is the button
Seat 1: gabi_igna ($103 in chips) 
Seat 2: Mr.Grigoriy ($103.27 in chips) 
Seat 3: hammerwife ($100 in chips) 
Seat 5: stds st ($32.35 in chips) 
Seat 6: PacPacBum ($107.86 in chips) 
Seat 7: xxxibgdrgn ($139.73 in chips) 
Seat 9: matiko09 ($107.89 in chips) 
stds st: posts small blind $0.50
PacPacBum: posts big blind $1
xxxZeka: sits out 
*** HOLE CARDS ***
Dealt to matiko09 [Qd 5d]
xxxibgdrgn: folds 
matiko09: folds 
gabi_igna: folds 
Mr.Grigoriy: raises $1.50 to $2.50
hammerwife: folds 
stds st: folds 
PacPacBum: folds 
Uncalled bet ($1.50) returned to Mr.Grigoriy
Mr.Grigoriy collected $2.50 from pot
Mr.Grigoriy: doesn't show hand 
*** SUMMARY ***
Total pot $2.50 | Rake $0 
Seat 1: gabi_igna folded before Flop (didn't bet)
Seat 2: Mr.Grigoriy collected ($2.50)
Seat 3: hammerwife (button) folded before Flop (didn't bet)
Seat 5: stds st (small blind) folded before Flop
Seat 6: PacPacBum (big blind) folded before Flop
Seat 7: xxxibgdrgn folded before Flop (didn't bet)
Seat 9: matiko09 folded before Flop (didn't bet)





PokerStars Hand #154364809489:  Hold'em No Limit ($0.50/$1.00 USD) - 2016/06/06 13:50:05 CET [2016/06/06 7:50:05 ET]
Table 'Wezen II' 9-max Seat #1 is the button
Seat 1: matiko09 ($101.50 in chips) 
Seat 2: Mr.Grigoriy ($113.34 in chips) 
Seat 3: Dickyxxx ($105.62 in chips) 
Seat 4: xxxibgdrgn ($215.35 in chips) 
Seat 5: stds st ($31.05 in chips) 
Seat 6: Eskimo Fox ($101.50 in chips) 
Seat 8: hammerwife ($100 in chips) 
Seat 9: Cogss ($172.40 in chips) 
Mr.Grigoriy: posts small blind $0.50
Dickyxxx: posts big blind $1
*** HOLE CARDS ***
Dealt to matiko09 [5h Ac]
xxxibgdrgn: raises $2 to $3
stds st: folds 
Eskimo Fox: folds 
hammerwife: folds 
Cogss: folds 
matiko09: folds 
Mr.Grigoriy: folds 
Dickyxxx: calls $2
*** FLOP *** [Jd Td Qh]
Dickyxxx: checks 
xxxibgdrgn: bets $4
Dickyxxx: calls $4
*** TURN *** [Jd Td Qh] [9d]
Dickyxxx: checks 
xxxibgdrgn: bets $9
Dickyxxx: calls $9
*** RIVER *** [Jd Td Qh 9d] [3c]
Dickyxxx: checks 
xxxibgdrgn: bets $23
Dickyxxx: folds 
Uncalled bet ($23) returned to xxxibgdrgn
xxxibgdrgn collected $30.88 from pot
xxxibgdrgn: doesn't show hand 
*** SUMMARY ***
Total pot $32.50 | Rake $1.62 
Board [Jd Td Qh 9d 3c]
Seat 1: matiko09 (button) folded before Flop (didn't bet)
Seat 2: Mr.Grigoriy (small blind) folded before Flop
Seat 3: Dickyxxx (big blind) folded on the River
Seat 4: xxxibgdrgn collected ($30.88)
Seat 5: stds st folded before Flop (didn't bet)
Seat 6: Eskimo Fox folded before Flop (didn't bet)
Seat 8: hammerwife folded before Flop (didn't bet)
Seat 9: Cogss folded before Flop (didn't bet)





PokerStars Hand #154364812779:  Hold'em No Limit ($0.50/$1.00 USD) - 2016/06/06 13:50:12 CET [2016/06/06 7:50:12 ET]
Table 'Smither' 9-max Seat #5 is the button
Seat 1: PacPacBum ($185.02 in chips) 
Seat 2: matiko09 ($142.62 in chips) 
Seat 3: stds st ($43.04 in chips) 
Seat 4: Mr.Grigoriy ($144.77 in chips) 
Seat 5: Dickyxxx ($100 in chips) 
Seat 6: mooose100 ($100 in chips) 
Seat 7: vanilica ($137.14 in chips) 
Seat 9: hammerwife ($116.75 in chips) 
mooose100: posts small blind $0.50
vanilica: posts big blind $1
ipashutapkom: sits out 
*** HOLE CARDS ***
Dealt to matiko09 [5c Ts]
hammerwife: folds 
PacPacBum: raises $1.50 to $2.50
matiko09: folds 
stds st: folds 
Mr.Grigoriy: folds 
Dickyxxx: calls $2.50
mooose100: folds 
vanilica: folds 
*** FLOP *** [6d 7s 8d]
PacPacBum: checks 
Dickyxxx: checks 
*** TURN *** [6d 7s 8d] [5s]
PacPacBum: checks 
Dickyxxx: checks 
*** RIVER *** [6d 7s 8d 5s] [Jc]
PacPacBum: checks 
Dickyxxx: checks 
*** SHOW DOWN ***
PacPacBum: shows [5h Ah] (a pair of Fives)
Dickyxxx: mucks hand 
PacPacBum collected $6.18 from pot
*** SUMMARY ***
Total pot $6.50 | Rake $0.32 
Board [6d 7s 8d 5s Jc]
Seat 1: PacPacBum showed [5h Ah] and won ($6.18) with a pair of Fives
Seat 2: matiko09 folded before Flop (didn't bet)
Seat 3: stds st folded before Flop (didn't bet)
Seat 4: Mr.Grigoriy folded before Flop (didn't bet)
Seat 5: Dickyxxx (button) mucked [Ac Kh]
Seat 6: mooose100 (small blind) folded before Flop
Seat 7: vanilica (big blind) folded before Flop
Seat 9: hammerwife folded before Flop (didn't bet)





PokerStars Hand #154364817620:  Hold'em No Limit ($0.50/$1.00 USD) - 2016/06/06 13:50:23 CET [2016/06/06 7:50:23 ET]
Table 'Heze' 9-max Seat #1 is the button
Seat 1: matiko09 ($213.20 in chips) 
Seat 2: gabi_igna ($100 in chips) 
Seat 3: Dickyxxx ($100 in chips) 
Seat 5: stds st ($40 in chips) 
Seat 8: PacPacBum ($123.20 in chips) 
gabi_igna: posts small blind $0.50
Dickyxxx: posts big blind $1
*** HOLE CARDS ***
Dealt to matiko09 [6s Ac]
stds st: folds 
snow937022 joins the table at seat #4 
stepan0605 joins the table at seat #9 
PacPacBum: folds 
matiko09: raises $1.27 to $2.27
gabi_igna: raises $5.73 to $8
Dickyxxx: folds 
matiko09: folds 
Uncalled bet ($5.73) returned to gabi_igna
gabi_igna collected $5.54 from pot
gabi_igna: doesn't show hand 
*** SUMMARY ***
Total pot $5.54 | Rake $0 
Seat 1: matiko09 (button) folded before Flop
Seat 2: gabi_igna (small blind) collected ($5.54)
Seat 3: Dickyxxx (big blind) folded before Flop
Seat 5: stds st folded before Flop (didn't bet)
Seat 8: PacPacBum folded before Flop (didn't bet)





PokerStars Hand #154364825493:  Hold'em No Limit ($0.50/$1.00 USD) - 2016/06/06 13:50:40 CET [2016/06/06 7:50:40 ET]
Table 'Chaldaea II' 9-max Seat #5 is the button
Seat 1: gabi_igna ($103 in chips) 
Seat 2: Mr.Grigoriy ($104.77 in chips) 
Seat 3: hammerwife ($100 in chips) 
Seat 5: stds st ($31.85 in chips) 
Seat 6: PacPacBum ($106.86 in chips) 
Seat 7: xxxibgdrgn ($139.73 in chips) 
Seat 9: matiko09 ($107.89 in chips) 
PacPacBum: posts small blind $0.50
xxxibgdrgn: posts big blind $1
xxxZeka: sits out 
mooose100: sits out 
*** HOLE CARDS ***
Dealt to matiko09 [Jh 4h]
matiko09: folds 
gabi_igna: folds 
Mr.Grigoriy: folds 
hammerwife: folds 
stds st: folds 
PacPacBum: raises $1.50 to $2.50
xxxibgdrgn: calls $1.50
*** FLOP *** [8s Ad Kd]
PacPacBum: checks 
xxxibgdrgn: checks 
*** TURN *** [8s Ad Kd] [4s]
PacPacBum: bets $2.56
xxxibgdrgn: folds 
Uncalled bet ($2.56) returned to PacPacBum
PacPacBum collected $4.75 from pot
PacPacBum: doesn't show hand 
*** SUMMARY ***
Total pot $5 | Rake $0.25 
Board [8s Ad Kd 4s]
Seat 1: gabi_igna folded before Flop (didn't bet)
Seat 2: Mr.Grigoriy folded before Flop (didn't bet)
Seat 3: hammerwife folded before Flop (didn't bet)
Seat 5: stds st (button) folded before Flop (didn't bet)
Seat 6: PacPacBum (small blind) collected ($4.75)
Seat 7: xxxibgdrgn (big blind) folded on the Turn
Seat 9: matiko09 folded before Flop (didn't bet)





PokerStars Hand #154364829498:  Hold'em No Limit ($0.50/$1.00 USD) - 2016/06/06 13:50:49 CET [2016/06/06 7:50:49 ET]
Table 'Siegma' 9-max Seat #5 is the button
Seat 1: Mr.Grigoriy ($100 in chips) 
Seat 2: hammerwife ($149.65 in chips) 
Seat 3: vanilica ($100 in chips) 
Seat 4: Dantist1122 ($102.50 in chips) 
Seat 5: arctur17 ($97 in chips) 
Seat 6: stds st ($57.23 in chips) 
Seat 7: nviss ($33.61 in chips) 
Seat 8: hurtNCYDE ($103 in chips) 
Seat 9: matiko09 ($101.50 in chips) 
stds st: posts small blind $0.50
nviss: posts big blind $1
*** HOLE CARDS ***
Dealt to matiko09 [Js 8h]
hurtNCYDE: folds 
matiko09: folds 
Mr.Grigoriy: folds 
hammerwife: folds 
vanilica: raises $1.50 to $2.50
Dantist1122: folds 
arctur17: folds 
stds st: raises $4.50 to $7
nviss: folds 
vanilica: raises $9 to $16
stds st: folds 
Uncalled bet ($9) returned to vanilica
vanilica collected $15 from pot
vanilica: doesn't show hand 
*** SUMMARY ***
Total pot $15 | Rake $0 
Seat 1: Mr.Grigoriy folded before Flop (didn't bet)
Seat 2: hammerwife folded before Flop (didn't bet)
Seat 3: vanilica collected ($15)
Seat 4: Dantist1122 folded before Flop (didn't bet)
Seat 5: arctur17 (button) folded before Flop (didn't bet)
Seat 6: stds st (small blind) folded before Flop
Seat 7: nviss (big blind) folded before Flop
Seat 8: hurtNCYDE folded before Flop (didn't bet)
Seat 9: matiko09 folded before Flop (didn't bet)





PokerStars Hand #154364832273:  Hold'em No Limit ($0.50/$1.00 USD) - 2016/06/06 13:50:55 CET [2016/06/06 7:50:55 ET]
Table 'Heze' 9-max Seat #2 is the button
Seat 1: matiko09 ($210.93 in chips) 
Seat 2: gabi_igna ($103.27 in chips) 
Seat 3: Dickyxxx ($100 in chips) 
Seat 4: snow937022 ($100 in chips) 
Seat 5: stds st ($40 in chips) 
Seat 8: PacPacBum ($123.20 in chips) 
Dickyxxx: posts small blind $0.50
snow937022: posts big blind $1
stepan0605: sits out 
*** HOLE CARDS ***
Dealt to matiko09 [2s 8h]
stds st: folds 
PacPacBum: folds 
matiko09: folds 
gabi_igna: raises $1.50 to $2.50
Dickyxxx: folds 
snow937022: folds 
Uncalled bet ($1.50) returned to gabi_igna
gabi_igna collected $2.50 from pot
gabi_igna: doesn't show hand 
*** SUMMARY ***
Total pot $2.50 | Rake $0 
Seat 1: matiko09 folded before Flop (didn't bet)
Seat 2: gabi_igna (button) collected ($2.50)
Seat 3: Dickyxxx (small blind) folded before Flop
Seat 4: snow937022 (big blind) folded before Flop
Seat 5: stds st folded before Flop (didn't bet)
Seat 8: PacPacBum folded before Flop (didn't bet)





PokerStars Hand #154364833472:  Hold'em No Limit ($0.50/$1.00 USD) - 2016/06/06 13:50:58 CET [2016/06/06 7:50:58 ET]
Table 'Safara' 9-max Seat #5 is the button
Seat 1: Dickyxxx ($100.88 in chips) 
Seat 2: Dantist1122 ($100 in chips) 
Seat 3: erd33 ($184.67 in chips) 
Seat 4: stds st ($43 in chips) 
Seat 5: perezzi10 ($87.88 in chips) 
Seat 6: matiko09 ($114.78 in chips) 
Seat 7: PacPacBum ($117.49 in chips) 
Seat 8: o.miro ($182.99 in chips) 
Seat 9: R1aki ($109 in chips) 
matiko09: posts small blind $0.50
PacPacBum: posts big blind $1
*** HOLE CARDS ***
Dealt to matiko09 [6d 3d]
o.miro: folds 
R1aki: folds 
Dickyxxx: folds 
Dantist1122: folds 
erd33: raises $3 to $4
stds st: folds 
perezzi10: calls $4
matiko09: folds 
PacPacBum: folds 
*** FLOP *** [9s Tc Qs]
erd33: checks 
perezzi10: checks 
*** TURN *** [9s Tc Qs] [Kd]
erd33: bets $1
perezzi10: calls $1
*** RIVER *** [9s Tc Qs Kd] [Ad]
erd33: bets $1
perezzi10: folds 
Uncalled bet ($1) returned to erd33
erd33 collected $10.92 from pot
*** SUMMARY ***
Total pot $11.50 | Rake $0.58 
Board [9s Tc Qs Kd Ad]
Seat 1: Dickyxxx folded before Flop (didn't bet)
Seat 2: Dantist1122 folded before Flop (didn't bet)
Seat 3: erd33 collected ($10.92)
Seat 4: stds st folded before Flop (didn't bet)
Seat 5: perezzi10 (button) folded on the River
Seat 6: matiko09 (small blind) folded before Flop
Seat 7: PacPacBum (big blind) folded before Flop
Seat 8: o.miro folded before Flop (didn't bet)
Seat 9: R1aki folded before Flop (didn't bet)





PokerStars Hand #154364836693:  Hold'em No Limit ($0.50/$1.00 USD) - 2016/06/06 13:51:05 CET [2016/06/06 7:51:05 ET]
Table 'Yarilo' 9-max Seat #5 is the button
Seat 1: xxxZeka ($100 in chips) 
Seat 2: matiko09 ($100 in chips) 
Seat 3: TBEinc ($97.93 in chips) 
Seat 4: stds st ($36.34 in chips) 
Seat 5: Dantist1122 ($116.88 in chips) 
Seat 6: gabi_igna ($100 in chips) 
Seat 7: Dickyxxx ($184.24 in chips) 
Seat 8: hammerwife ($100 in chips) 
Seat 9: vanilica ($116.81 in chips) 
gabi_igna: posts small blind $0.50
Dickyxxx: posts big blind $1
*** HOLE CARDS ***
Dealt to matiko09 [As Qs]
hammerwife: folds 
vanilica: raises $1.85 to $2.85
xxxZeka: folds 
matiko09: calls $2.85
TBEinc: folds 
stds st: calls $2.85
Dantist1122: folds 
hammerwife leaves the table
stepan0605 joins the table at seat #8 
gabi_igna: folds 
Dickyxxx: folds 
*** FLOP *** [2c 4d Ac]
vanilica: checks 
matiko09: bets $6
stds st: folds 
vanilica: calls $6
*** TURN *** [2c 4d Ac] [Ad]
vanilica: checks 
matiko09: checks 
*** RIVER *** [2c 4d Ac Ad] [7h]
vanilica: checks 
matiko09: bets $12
vanilica: folds 
Uncalled bet ($12) returned to matiko09
matiko09 collected $20.95 from pot
matiko09: doesn't show hand 
*** SUMMARY ***
Total pot $22.05 | Rake $1.10 
Board [2c 4d Ac Ad 7h]
Seat 1: xxxZeka folded before Flop (didn't bet)
Seat 2: matiko09 collected ($20.95)
Seat 3: TBEinc folded before Flop (didn't bet)
Seat 4: stds st folded on the Flop
Seat 5: Dantist1122 (button) folded before Flop (didn't bet)
Seat 6: gabi_igna (small blind) folded before Flop
Seat 7: Dickyxxx (big blind) folded before Flop
Seat 8: hammerwife folded before Flop (didn't bet)
Seat 9: vanilica folded on the River





PokerStars Hand #154364838128:  Hold'em No Limit (€0.50/€1.00 EUR) - 2016/06/06 13:51:08 CET [2016/06/06 7:51:08 ET]
Table 'Lesath' 9-max Seat #4 is the button
Seat 1: o.miro (€195.45 in chips) 
Seat 2: thecurv (€109.34 in chips) 
Seat 3: hurtNCYDE (€100 in chips) 
Seat 4: hammerwife (€129.65 in chips) 
Seat 5: matiko09 (€181.22 in chips) 
Seat 6: Dickyxxx (€106.72 in chips) 
Seat 7: Mr.Grigoriy (€100 in chips) 
Seat 8: vanilica (€100 in chips) 
Seat 9: 72nloses (€71.89 in chips) 
matiko09: posts small blind €0.50
Dickyxxx: posts big blind €1
*** HOLE CARDS ***
Dealt to matiko09 [2h 6h]
Mr.Grigoriy: raises €2 to €3
vanilica: folds 
72nloses: folds 
o.miro: folds 
thecurv: folds 
hurtNCYDE: folds 
hammerwife: folds 
matiko09: folds 
Dickyxxx: folds 
Uncalled bet (€2) returned to Mr.Grigoriy
Mr.Grigoriy collected €2.50 from pot
Mr.Grigoriy: doesn't show hand 
*** SUMMARY ***
Total pot €2.50 | Rake €0 
Seat 1: o.miro folded before Flop (didn't bet)
Seat 2: thecurv folded before Flop (didn't bet)
Seat 3: hurtNCYDE folded before Flop (didn't bet)
Seat 4: hammerwife (button) folded before Flop (didn't bet)
Seat 5: matiko09 (small blind) folded before Flop
Seat 6: Dickyxxx (big blind) folded before Flop
Seat 7: Mr.Grigoriy collected (€2.50)
Seat 8: vanilica folded before Flop (didn't bet)
Seat 9: 72nloses folded before Flop (didn't bet)





PokerStars Hand #154364845809:  Hold'em No Limit ($0.50/$1.00 USD) - 2016/06/06 13:51:25 CET [2016/06/06 7:51:25 ET]
Table 'Williams' 9-max Seat #6 is the button
Seat 1: xhinostrabli ($73.42 in chips) 
Seat 2: matiko09 ($172.69 in chips) 
Seat 3: gabi_igna ($100 in chips) 
Seat 4: Mr.Grigoriy ($107.32 in chips) 
Seat 5: xxxibgdrgn ($100.50 in chips) 
Seat 6: xxxZeka ($192.25 in chips) 
Seat 7: stepan0605 ($106.50 in chips) 
Seat 8: Dickyxxx ($101.50 in chips) 
Seat 9: stds st ($66.94 in chips) 
stepan0605: posts small blind $0.50
Dickyxxx: posts big blind $1
*** HOLE CARDS ***
Dealt to matiko09 [6h Ah]
stds st: folds 
xhinostrabli: raises $2 to $3
matiko09: folds 
gabi_igna: folds 
Mr.Grigoriy: folds 
xxxibgdrgn: folds 
xxxZeka: folds 
stepan0605: folds 
Dickyxxx: folds 
Uncalled bet ($2) returned to xhinostrabli
xhinostrabli collected $2.50 from pot
*** SUMMARY ***
Total pot $2.50 | Rake $0 
Seat 1: xhinostrabli collected ($2.50)
Seat 2: matiko09 folded before Flop (didn't bet)
Seat 3: gabi_igna folded before Flop (didn't bet)
Seat 4: Mr.Grigoriy folded before Flop (didn't bet)
Seat 5: xxxibgdrgn folded before Flop (didn't bet)
Seat 6: xxxZeka (button) folded before Flop (didn't bet)
Seat 7: stepan0605 (small blind) folded before Flop
Seat 8: Dickyxxx (big blind) folded before Flop
Seat 9: stds st folded before Flop (didn't bet)





PokerStars Hand #154364850869:  Hold'em No Limit (€0.50/€1.00 EUR) - 2016/06/06 13:51:36 CET [2016/06/06 7:51:36 ET]
Table 'Lesath' 9-max Seat #5 is the button
Seat 1: o.miro (€195.45 in chips) 
Seat 2: thecurv (€109.34 in chips) 
Seat 3: hurtNCYDE (€100 in chips) 
Seat 4: hammerwife (€129.65 in chips) 
Seat 5: matiko09 (€180.72 in chips) 
Seat 6: Dickyxxx (€105.72 in chips) 
Seat 7: Mr.Grigoriy (€101.50 in chips) 
Seat 8: vanilica (€100 in chips) 
Seat 9: 72nloses (€71.89 in chips) 
Dickyxxx: posts small blind €0.50
Mr.Grigoriy: posts big blind €1
*** HOLE CARDS ***
Dealt to matiko09 [8d 6d]
vanilica: folds 
72nloses: folds 
o.miro: folds 
thecurv: folds 
hurtNCYDE: folds 
hammerwife: folds 
matiko09: raises €1.27 to €2.27
Dickyxxx: folds 
Mr.Grigoriy: calls €1.27
*** FLOP *** [Qd 4c Th]
Mr.Grigoriy: checks 
matiko09: bets €3.11
Mr.Grigoriy: folds 
Uncalled bet (€3.11) returned to matiko09
matiko09 collected €4.79 from pot
matiko09: doesn't show hand 
*** SUMMARY ***
Total pot €5.04 | Rake €0.25 
Board [Qd 4c Th]
Seat 1: o.miro folded before Flop (didn't bet)
Seat 2: thecurv folded before Flop (didn't bet)
Seat 3: hurtNCYDE folded before Flop (didn't bet)
Seat 4: hammerwife folded before Flop (didn't bet)
Seat 5: matiko09 (button) collected (€4.79)
Seat 6: Dickyxxx (small blind) folded before Flop
Seat 7: Mr.Grigoriy (big blind) folded on the Flop
Seat 8: vanilica folded before Flop (didn't bet)
Seat 9: 72nloses folded before Flop (didn't bet)





PokerStars Hand #154364851658:  Hold'em No Limit ($0.50/$1.00 USD) - 2016/06/06 13:51:38 CET [2016/06/06 7:51:38 ET]
Table 'Siegma' 9-max Seat #6 is the button
Seat 1: Mr.Grigoriy ($100 in chips) 
Seat 2: hammerwife ($149.65 in chips) 
Seat 3: vanilica ($108 in chips) 
Seat 4: Dantist1122 ($102.50 in chips) 
Seat 5: arctur17 ($97 in chips) 
Seat 6: stds st ($50.23 in chips) 
Seat 7: nviss ($32.61 in chips) 
Seat 8: hurtNCYDE ($103 in chips) 
Seat 9: matiko09 ($101.50 in chips) 
nviss: posts small blind $0.50
hurtNCYDE: posts big blind $1
*** HOLE CARDS ***
Dealt to matiko09 [3c 6h]
matiko09: folds 
Mr.Grigoriy: folds 
hammerwife: raises $2 to $3
vanilica: folds 
Dantist1122: folds 
arctur17: folds 
stds st: folds 
nviss: calls $2.50
hurtNCYDE: folds 
*** FLOP *** [3s 7d 9c]
nviss: checks 
hammerwife: bets $3.32
nviss: calls $3.32
*** TURN *** [3s 7d 9c] [6c]
nviss: checks 
hammerwife: checks 
*** RIVER *** [3s 7d 9c 6c] [Jc]
nviss: checks 
hammerwife: bets $10
nviss: calls $10
*** SHOW DOWN ***
hammerwife: shows [Kh Qs] (high card King)
nviss: shows [8h 9h] (a pair of Nines)
nviss collected $31.96 from pot
*** SUMMARY ***
Total pot $33.64 | Rake $1.68 
Board [3s 7d 9c 6c Jc]
Seat 1: Mr.Grigoriy folded before Flop (didn't bet)
Seat 2: hammerwife showed [Kh Qs] and lost with high card King
Seat 3: vanilica folded before Flop (didn't bet)
Seat 4: Dantist1122 folded before Flop (didn't bet)
Seat 5: arctur17 folded before Flop (didn't bet)
Seat 6: stds st (button) folded before Flop (didn't bet)
Seat 7: nviss (small blind) showed [8h 9h] and won ($31.96) with a pair of Nines
Seat 8: hurtNCYDE (big blind) folded before Flop
Seat 9: matiko09 folded before Flop (didn't bet)





PokerStars Hand #154364851862:  Hold'em No Limit ($0.50/$1.00 USD) - 2016/06/06 13:51:38 CET [2016/06/06 7:51:38 ET]
Table 'Smither' 9-max Seat #6 is the button
Seat 1: PacPacBum ($188.70 in chips) 
Seat 2: matiko09 ($142.62 in chips) 
Seat 3: stds st ($43.04 in chips) 
Seat 4: Mr.Grigoriy ($144.77 in chips) 
Seat 5: Dickyxxx ($100 in chips) 
Seat 6: mooose100 ($99.50 in chips) 
Seat 7: vanilica ($136.14 in chips) 
Seat 8: ipashutapkom ($53.58 in chips) 
Seat 9: hammerwife ($116.75 in chips) 
vanilica: posts small blind $0.50
ipashutapkom: posts big blind $1
*** HOLE CARDS ***
Dealt to matiko09 [Kc Qs]
hammerwife: folds 
PacPacBum: folds 
matiko09: raises $2 to $3
stds st: folds 
Mr.Grigoriy: folds 
Dickyxxx: folds 
mooose100: folds 
vanilica: folds 
ipashutapkom: calls $2
*** FLOP *** [8s Ad Qd]
ipashutapkom: checks 
matiko09: checks 
*** TURN *** [8s Ad Qd] [9s]
ipashutapkom: bets $1.79
matiko09: calls $1.79
*** RIVER *** [8s Ad Qd 9s] [8c]
ipashutapkom: checks 
matiko09: checks 
*** SHOW DOWN ***
ipashutapkom: shows [9c Tc] (two pair, Nines and Eights)
matiko09: shows [Kc Qs] (two pair, Queens and Eights)
matiko09 collected $9.58 from pot
*** SUMMARY ***
Total pot $10.08 | Rake $0.50 
Board [8s Ad Qd 9s 8c]
Seat 1: PacPacBum folded before Flop (didn't bet)
Seat 2: matiko09 showed [Kc Qs] and won ($9.58) with two pair, Queens and Eights
Seat 3: stds st folded before Flop (didn't bet)
Seat 4: Mr.Grigoriy folded before Flop (didn't bet)
Seat 5: Dickyxxx folded before Flop (didn't bet)
Seat 6: mooose100 (button) folded before Flop (didn't bet)
Seat 7: vanilica (small blind) folded before Flop
Seat 8: ipashutapkom (big blind) showed [9c Tc] and lost with two pair, Nines and Eights
Seat 9: hammerwife folded before Flop (didn't bet)





PokerStars Hand #154364853615:  Hold'em No Limit ($0.50/$1.00 USD) - 2016/06/06 13:51:42 CET [2016/06/06 7:51:42 ET]
Table 'Heze' 9-max Seat #3 is the button
Seat 1: matiko09 ($210.93 in chips) 
Seat 2: gabi_igna ($104.77 in chips) 
Seat 3: Dickyxxx ($100 in chips) 
Seat 4: snow937022 ($100 in chips) 
Seat 5: stds st ($40 in chips) 
Seat 8: PacPacBum ($123.20 in chips) 
snow937022: posts small blind $0.50
stds st: posts big blind $1
xxxZeka: sits out 
stepan0605: sits out 
*** HOLE CARDS ***
Dealt to matiko09 [Qh 6h]
PacPacBum: raises $2 to $3
matiko09: folds 
gabi_igna: folds 
Dickyxxx: folds 
snow937022: folds 
stds st: folds 
Uncalled bet ($2) returned to PacPacBum
PacPacBum collected $2.50 from pot
PacPacBum: doesn't show hand 
*** SUMMARY ***
Total pot $2.50 | Rake $0 
Seat 1: matiko09 folded before Flop (didn't bet)
Seat 2: gabi_igna folded before Flop (didn't bet)
Seat 3: Dickyxxx (button) folded before Flop (didn't bet)
Seat 4: snow937022 (small blind) folded before Flop
Seat 5: stds st (big blind) folded before Flop
Seat 8: PacPacBum collected ($2.50)





PokerStars Hand #154364856562:  Hold'em No Limit ($0.50/$1.00 USD) - 2016/06/06 13:51:48 CET [2016/06/06 7:51:48 ET]
Table 'Chaldaea II' 9-max Seat #6 is the button
Seat 1: gabi_igna ($103 in chips) 
Seat 2: Mr.Grigoriy ($104.77 in chips) 
Seat 3: hammerwife ($100 in chips) 
Seat 4: mooose100 ($86.79 in chips) 
Seat 5: stds st ($31.85 in chips) 
Seat 6: PacPacBum ($109.11 in chips) 
Seat 7: xxxibgdrgn ($137.23 in chips) 
Seat 8: xxxZeka ($111.21 in chips) 
Seat 9: matiko09 ($107.89 in chips) 
xxxibgdrgn: posts small blind $0.50
xxxZeka: posts big blind $1
mooose100: posts small & big blinds $1.50
*** HOLE CARDS ***
Dealt to matiko09 [Qs 4c]
matiko09: folds 
gabi_igna: raises $3 to $4
Mr.Grigoriy: folds 
hammerwife: folds 
mooose100: folds 
stds st: folds 
PacPacBum: folds 
xxxibgdrgn: folds 
xxxZeka: folds 
Uncalled bet ($3) returned to gabi_igna
gabi_igna collected $4 from pot
gabi_igna: doesn't show hand 
*** SUMMARY ***
Total pot $4 | Rake $0 
Seat 1: gabi_igna collected ($4)
Seat 2: Mr.Grigoriy folded before Flop (didn't bet)
Seat 3: hammerwife folded before Flop (didn't bet)
Seat 4: mooose100 folded before Flop
Seat 5: stds st folded before Flop (didn't bet)
Seat 6: PacPacBum (button) folded before Flop (didn't bet)
Seat 7: xxxibgdrgn (small blind) folded before Flop
Seat 8: xxxZeka (big blind) folded before Flop
Seat 9: matiko09 folded before Flop (didn't bet)





PokerStars Hand #154364859106:  Hold'em No Limit ($0.50/$1.00 USD) - 2016/06/06 13:51:54 CET [2016/06/06 7:51:54 ET]
Table 'Safara' 9-max Seat #6 is the button
Seat 1: Dickyxxx ($100.88 in chips) 
Seat 2: Dantist1122 ($100 in chips) 
Seat 3: erd33 ($190.59 in chips) 
Seat 4: stds st ($43 in chips) 
Seat 5: perezzi10 ($82.88 in chips) 
Seat 6: matiko09 ($114.28 in chips) 
Seat 7: PacPacBum ($116.49 in chips) 
Seat 8: o.miro ($182.99 in chips) 
Seat 9: R1aki ($109 in chips) 
PacPacBum: posts small blind $0.50
o.miro: posts big blind $1
*** HOLE CARDS ***
Dealt to matiko09 [As 4d]
R1aki: folds 
Dickyxxx: folds 
Dantist1122: raises $2 to $3
erd33: folds 
stds st: folds 
perezzi10: folds 
matiko09: folds 
PacPacBum: folds 
o.miro: folds 
Uncalled bet ($2) returned to Dantist1122
Dantist1122 collected $2.50 from pot
Dantist1122: doesn't show hand 
*** SUMMARY ***
Total pot $2.50 | Rake $0 
Seat 1: Dickyxxx folded before Flop (didn't bet)
Seat 2: Dantist1122 collected ($2.50)
Seat 3: erd33 folded before Flop (didn't bet)
Seat 4: stds st folded before Flop (didn't bet)
Seat 5: perezzi10 folded before Flop (didn't bet)
Seat 6: matiko09 (button) folded before Flop (didn't bet)
Seat 7: PacPacBum (small blind) folded before Flop
Seat 8: o.miro (big blind) folded before Flop
Seat 9: R1aki folded before Flop (didn't bet)





PokerStars Hand #154364860783:  Hold'em No Limit ($0.50/$1.00 USD) - 2016/06/06 13:51:58 CET [2016/06/06 7:51:58 ET]
Table 'Williams' 9-max Seat #7 is the button
Seat 1: xhinostrabli ($74.92 in chips) 
Seat 2: matiko09 ($172.69 in chips) 
Seat 3: gabi_igna ($100 in chips) 
Seat 4: Mr.Grigoriy ($107.32 in chips) 
Seat 5: xxxibgdrgn ($100.50 in chips) 
Seat 6: xxxZeka ($192.25 in chips) 
Seat 7: stepan0605 ($106 in chips) 
Seat 8: Dickyxxx ($100.50 in chips) 
Seat 9: stds st ($66.94 in chips) 
Dickyxxx: posts small blind $0.50
stds st: posts big blind $1
*** HOLE CARDS ***
Dealt to matiko09 [Jc 7d]
xhinostrabli: folds 
matiko09: folds 
gabi_igna: raises $2 to $3
Mr.Grigoriy: folds 
xxxibgdrgn: calls $3
xxxZeka: folds 
stepan0605: folds 
Dickyxxx: folds 
stds st: folds 
*** FLOP *** [3d 6d 9h]
gabi_igna: bets $4
xxxibgdrgn: folds 
Uncalled bet ($4) returned to gabi_igna
gabi_igna collected $7.12 from pot
gabi_igna: doesn't show hand 
*** SUMMARY ***
Total pot $7.50 | Rake $0.38 
Board [3d 6d 9h]
Seat 1: xhinostrabli folded before Flop (didn't bet)
Seat 2: matiko09 folded before Flop (didn't bet)
Seat 3: gabi_igna collected ($7.12)
Seat 4: Mr.Grigoriy folded before Flop (didn't bet)
Seat 5: xxxibgdrgn folded on the Flop
Seat 6: xxxZeka folded before Flop (didn't bet)
Seat 7: stepan0605 (button) folded before Flop (didn't bet)
Seat 8: Dickyxxx (small blind) folded before Flop
Seat 9: stds st (big blind) folded before Flop





PokerStars Hand #154364861368:  Hold'em No Limit ($0.50/$1.00 USD) - 2016/06/06 13:51:59 CET [2016/06/06 7:51:59 ET]
Table 'Hyperion II' 9-max Seat #5 is the button
Seat 5: mono123viva ($77.73 in chips) 
Seat 6: vanilica ($100 in chips) 
Seat 7: matiko09 ($100 in chips) 
vanilica: posts small blind $0.50
matiko09: posts big blind $1
kopik001: sits out 
R1aki: sits out 
kingbob708: sits out 
ilaviiitech: sits out 
TAIFU007: sits out 
*** HOLE CARDS ***
Dealt to matiko09 [6s Kh]
mono123viva: raises $2 to $3
vanilica: folds 
matiko09: folds 
Uncalled bet ($2) returned to mono123viva
mono123viva collected $2.50 from pot
*** SUMMARY ***
Total pot $2.50 | Rake $0 
Seat 5: mono123viva (button) collected ($2.50)
Seat 6: vanilica (small blind) folded before Flop
Seat 7: matiko09 (big blind) folded before Flop





PokerStars Hand #154364864471:  Hold'em No Limit ($0.50/$1.00 USD) - 2016/06/06 13:52:06 CET [2016/06/06 7:52:06 ET]
Table 'Wezen II' 9-max Seat #2 is the button
Seat 1: matiko09 ($101.50 in chips) 
Seat 2: Mr.Grigoriy ($112.84 in chips) 
Seat 3: Dickyxxx ($100 in chips) 
Seat 4: xxxibgdrgn ($230.23 in chips) 
Seat 5: stds st ($31.05 in chips) 
Seat 6: Eskimo Fox ($101.50 in chips) 
Seat 8: hammerwife ($100 in chips) 
Seat 9: Cogss ($172.40 in chips) 
Dickyxxx: posts small blind $0.50
xxxibgdrgn: posts big blind $1
*** HOLE CARDS ***
Dealt to matiko09 [7d 8s]
stds st: raises $1.50 to $2.50
Eskimo Fox: folds 
hammerwife: folds 
Cogss: calls $2.50
matiko09: folds 
Mr.Grigoriy: folds 
Dickyxxx: folds 
xxxibgdrgn: folds 
*** FLOP *** [6h 5d 9c]
stds st: bets $3.70
Cogss: calls $3.70
*** TURN *** [6h 5d 9c] [4c]
stds st: bets $24.85 and is all-in
Cogss: calls $24.85
*** RIVER *** [6h 5d 9c 4c] [Jc]
*** SHOW DOWN ***
stds st: shows [Th 9h] (a pair of Nines)
Cogss: shows [4h As] (a pair of Fours)
stds st collected $61.10 from pot
*** SUMMARY ***
Total pot $63.60 | Rake $2.50 
Board [6h 5d 9c 4c Jc]
Seat 1: matiko09 folded before Flop (didn't bet)
Seat 2: Mr.Grigoriy (button) folded before Flop (didn't bet)
Seat 3: Dickyxxx (small blind) folded before Flop
Seat 4: xxxibgdrgn (big blind) folded before Flop
Seat 5: stds st showed [Th 9h] and won ($61.10) with a pair of Nines
Seat 6: Eskimo Fox folded before Flop (didn't bet)
Seat 8: hammerwife folded before Flop (didn't bet)
Seat 9: Cogss showed [4h As] and lost with a pair of Fours





PokerStars Hand #154364868950:  Hold'em No Limit ($0.50/$1.00 USD) - 2016/06/06 13:52:16 CET [2016/06/06 7:52:16 ET]
Table 'Hyperion II' 9-max Seat #6 is the button
Seat 1: kingbob708 ($80 in chips) 
Seat 4: TAIFU007 ($80 in chips) 
Seat 5: mono123viva ($79.23 in chips) 
Seat 6: vanilica ($100 in chips) 
Seat 7: matiko09 ($100 in chips) 
Seat 8: kopik001 ($80.03 in chips) 
matiko09: posts small blind $0.50
kopik001: posts big blind $1
R1aki: sits out 
kingbob708: posts big blind $1
ilaviiitech: sits out 
hammerwife: sits out 
TAIFU007: posts big blind $1
*** HOLE CARDS ***
Dealt to matiko09 [Td 2s]
kingbob708: checks 
TAIFU007: raises $2 to $3
mono123viva: folds 
vanilica: calls $3
matiko09: folds 
kopik001: calls $2
kingbob708: calls $2
*** FLOP *** [6h Qh 4d]
kopik001: checks 
kingbob708: checks 
TAIFU007: checks 
vanilica: bets $8.79
kopik001: folds 
kingbob708: folds 
TAIFU007: folds 
Uncalled bet ($8.79) returned to vanilica
vanilica collected $11.88 from pot
vanilica: doesn't show hand 
kingbob708 leaves the table
*** SUMMARY ***
Total pot $12.50 | Rake $0.62 
Board [6h Qh 4d]
Seat 1: kingbob708 folded on the Flop
Seat 4: TAIFU007 folded on the Flop
Seat 5: mono123viva folded before Flop (didn't bet)
Seat 6: vanilica (button) collected ($11.88)
Seat 7: matiko09 (small blind) folded before Flop
Seat 8: kopik001 (big blind) folded on the Flop





